Gene,Position,A,T,G,C,Coverage,Consensus
1-PB2,1,163,0,0,0,163,A
1-PB2,2,0,163,0,0,163,T
1-PB2,3,0,0,163,0,163,G
1-PB2,4,0,1,163,0,164,G
1-PB2,5,163,0,0,0,163,A
1-PB2,6,164,0,0,0,164,A
1-PB2,7,162,0,2,0,164,A
1-PB2,8,0,0,179,0,179,G
1-PB2,9,179,0,0,0,179,A
1-PB2,10,180,0,0,0,180,A
1-PB2,11,0,184,0,0,184,T
1-PB2,12,185,0,0,0,185,A
1-PB2,13,183,0,1,0,184,A
1-PB2,14,187,0,0,0,187,A
1-PB2,15,185,0,0,0,185,A
1-PB2,16,0,0,190,0,190,G
1-PB2,17,186,0,1,0,187,A
1-PB2,18,192,0,0,0,192,A
1-PB2,19,0,0,0,196,196,C
1-PB2,20,0,195,0,0,195,T
1-PB2,21,201,0,0,0,201,A
1-PB2,22,0,0,0,201,201,C
1-PB2,23,0,0,204,0,204,G
1-PB2,24,0,0,204,0,204,G
1-PB2,25,202,0,0,0,202,A
1-PB2,26,208,0,0,0,208,A
1-PB2,27,0,208,0,1,209,T
1-PB2,28,0,0,0,210,210,C
1-PB2,29,0,211,0,0,211,T
1-PB2,30,0,0,212,0,212,G
1-PB2,31,212,0,0,0,212,A
1-PB2,32,0,213,0,0,213,T
1-PB2,33,0,0,212,0,212,G
1-PB2,34,0,217,0,0,217,T
1-PB2,35,0,0,0,216,216,C
1-PB2,36,0,0,218,0,218,G
1-PB2,37,0,0,0,216,216,C
1-PB2,38,215,0,1,0,216,A
1-PB2,39,1,0,231,0,232,G
1-PB2,40,0,236,0,0,236,T
1-PB2,41,0,0,0,237,237,C
1-PB2,42,0,235,0,0,235,T
1-PB2,43,0,0,0,235,235,C
1-PB2,44,0,0,235,0,235,G
1-PB2,45,0,0,0,239,239,C
1-PB2,46,239,0,0,0,239,A
1-PB2,47,0,0,0,243,243,C
1-PB2,48,0,243,0,0,243,T
1-PB2,49,0,0,0,255,255,C
1-PB2,50,0,0,257,0,257,G
1-PB2,51,0,0,0,258,258,C
1-PB2,52,0,0,258,0,258,G
1-PB2,53,256,0,0,0,256,A
1-PB2,54,0,0,261,0,261,G
1-PB2,55,272,0,0,0,272,A
1-PB2,56,0,270,0,0,270,T
1-PB2,57,271,0,0,0,271,A
1-PB2,58,0,0,0,271,271,C
1-PB2,59,0,268,0,0,268,T
1-PB2,60,0,0,273,0,273,G
1-PB2,61,273,0,1,0,274,A
1-PB2,62,0,0,0,273,273,C
1-PB2,63,274,0,0,0,274,A
1-PB2,64,272,0,0,0,272,A
1-PB2,65,277,0,0,0,277,A
1-PB2,66,284,0,0,0,284,A
1-PB2,67,282,0,0,0,282,A
1-PB2,68,0,0,0,287,287,C
1-PB2,69,0,0,0,286,286,C
1-PB2,70,300,0,0,0,300,A
1-PB2,71,0,0,0,303,303,C
1-PB2,72,303,0,0,0,303,A
1-PB2,73,0,0,312,0,312,G
1-PB2,74,0,314,0,0,314,T
1-PB2,75,0,0,325,0,325,G
1-PB2,76,0,0,324,0,324,G
1-PB2,77,326,0,1,0,327,A
1-PB2,78,0,0,0,344,344,C
1-PB2,79,0,0,0,337,337,C
1-PB2,80,345,0,0,0,345,A
1-PB2,81,0,344,0,0,344,T
1-PB2,82,343,0,0,0,343,A
1-PB2,83,0,343,0,0,343,T
1-PB2,84,0,0,343,0,343,G
1-PB2,85,0,0,348,0,348,G
1-PB2,86,0,0,0,351,351,C
1-PB2,87,0,0,0,348,348,C
1-PB2,88,349,0,0,0,349,A
1-PB2,89,0,358,0,0,358,T
1-PB2,90,361,0,0,0,361,A
1-PB2,91,372,0,0,0,372,A
1-PB2,92,0,368,0,0,368,T
1-PB2,93,1,372,0,0,373,T
1-PB2,94,374,0,0,0,374,A
1-PB2,95,374,0,0,0,374,A
1-PB2,96,1,0,385,0,386,G
1-PB2,97,384,1,0,0,385,A
1-PB2,98,382,0,0,0,382,A
1-PB2,99,0,0,401,1,402,G
1-PB2,100,0,395,0,1,396,T
1-PB2,101,399,0,0,0,399,A
1-PB2,102,0,0,0,400,400,C
1-PB2,103,400,0,0,0,400,A
1-PB2,104,1,0,0,413,414,C
1-PB2,105,410,0,0,0,410,A
1-PB2,106,0,410,0,0,410,T
1-PB2,107,1,0,0,412,413,C
1-PB2,108,1,0,408,0,409,G
1-PB2,109,0,0,406,0,406,G
1-PB2,110,0,0,407,0,407,G
1-PB2,111,0,0,408,0,408,G
1-PB2,112,406,0,0,0,406,A
1-PB2,113,0,0,411,0,411,G
1-PB2,114,407,0,1,0,408,A
1-PB2,115,0,1,0,415,416,C
1-PB2,116,416,0,0,0,416,A
1-PB2,117,0,0,422,0,422,G
1-PB2,118,0,0,431,0,431,G
1-PB2,119,432,0,0,0,432,A
1-PB2,120,432,0,0,0,432,A
1-PB2,121,431,0,0,0,431,A
1-PB2,122,433,0,0,0,433,A
1-PB2,123,0,0,435,1,436,G
1-PB2,124,433,0,1,0,434,A
1-PB2,125,435,0,0,0,435,A
1-PB2,126,0,0,0,434,434,C
1-PB2,127,1,0,0,431,432,C
1-PB2,128,2,0,0,431,433,C
1-PB2,129,0,0,437,0,437,G
1-PB2,130,0,438,0,0,438,T
1-PB2,131,0,0,0,437,437,C
1-PB2,132,443,0,2,0,445,A
1-PB2,133,0,0,0,452,452,C
1-PB2,134,0,448,0,0,448,T
1-PB2,135,0,446,0,0,446,T
1-PB2,136,451,0,0,0,451,A
1-PB2,137,0,0,463,0,463,G
1-PB2,138,0,0,465,0,465,G
1-PB2,139,465,0,0,0,465,A
1-PB2,140,0,466,0,0,466,T
1-PB2,141,0,1,464,0,465,G
1-PB2,142,470,0,0,0,470,A
1-PB2,143,470,0,0,0,470,A
1-PB2,144,470,2,0,0,472,A
1-PB2,145,0,472,0,0,472,T
1-PB2,146,0,0,477,0,477,G
1-PB2,147,0,0,480,0,480,G
1-PB2,148,480,1,0,0,481,A
1-PB2,149,0,482,0,0,482,T
1-PB2,150,0,0,478,0,478,G
1-PB2,151,481,0,0,0,481,A
1-PB2,152,0,482,0,0,482,T
1-PB2,153,0,0,483,0,483,G
1-PB2,154,0,0,484,0,484,G
1-PB2,155,0,0,0,483,483,C
1-PB2,156,482,0,0,0,482,A
1-PB2,157,488,0,0,1,489,A
1-PB2,158,0,488,0,0,488,T
1-PB2,159,0,0,499,0,499,G
1-PB2,160,502,0,0,0,502,A
1-PB2,161,500,0,2,0,502,A
1-PB2,162,501,0,0,0,501,A
1-PB2,163,0,507,0,0,507,T
1-PB2,164,507,0,0,0,507,A
1-PB2,165,1,0,0,516,517,C
1-PB2,166,0,0,0,510,510,C
1-PB2,167,0,1,0,512,513,C
1-PB2,168,508,0,0,0,508,A
1-PB2,169,505,1,0,0,506,A
1-PB2,170,1,504,0,0,505,T
1-PB2,171,0,1,0,506,507,C
1-PB2,172,506,1,0,0,507,A
1-PB2,173,0,0,0,513,513,C
1-PB2,174,0,510,0,1,511,T
1-PB2,175,0,0,509,0,509,G
1-PB2,176,0,0,0,512,512,C
1-PB2,177,0,511,0,0,511,T
1-PB2,178,1,0,510,0,511,G
1-PB2,179,508,0,0,0,508,A
1-PB2,180,0,0,0,515,515,C
1-PB2,181,517,0,0,0,517,A
1-PB2,182,507,0,0,0,507,A
1-PB2,183,507,0,0,0,507,A
1-PB2,184,509,0,0,0,509,A
1-PB2,185,0,0,517,0,517,G
1-PB2,186,0,0,517,0,517,G
1-PB2,187,513,1,0,0,514,A
1-PB2,188,0,514,0,0,514,T
1-PB2,189,510,0,1,0,511,A
1-PB2,190,519,0,0,0,519,A
1-PB2,191,0,0,0,526,526,C
1-PB2,192,524,0,0,0,524,A
1-PB2,193,0,0,526,0,526,G
1-PB2,194,521,0,0,0,521,A
1-PB2,195,520,0,0,0,520,A
1-PB2,196,517,1,0,0,518,A
1-PB2,197,0,520,0,0,520,T
1-PB2,198,0,1,519,0,520,G
1-PB2,199,0,0,528,0,528,G
1-PB2,200,0,523,0,0,523,T
1-PB2,201,0,522,0,0,522,T
1-PB2,202,0,0,0,522,522,C
1-PB2,203,0,1,0,516,517,C
1-PB2,204,0,0,524,0,524,G
1-PB2,205,0,0,527,0,527,G
1-PB2,206,527,0,1,0,528,A
1-PB2,207,0,0,529,0,529,G
1-PB2,208,530,0,0,0,530,A
1-PB2,209,0,0,539,1,540,G
1-PB2,210,536,1,0,0,537,A
1-PB2,211,537,0,1,0,538,A
1-PB2,212,540,0,0,0,540,A
1-PB2,213,0,539,0,0,539,T
1-PB2,214,0,0,539,0,539,G
1-PB2,215,542,0,0,0,542,A
1-PB2,216,537,1,0,0,538,A
1-PB2,217,0,1,0,537,538,C
1-PB2,218,531,0,0,0,531,A
1-PB2,219,537,0,0,0,537,A
1-PB2,220,0,0,546,0,546,G
1-PB2,221,0,0,552,0,552,G
1-PB2,222,554,0,0,0,554,A
1-PB2,223,0,0,0,550,550,C
1-PB2,224,552,0,1,0,553,A
1-PB2,225,552,0,0,0,552,A
1-PB2,226,580,0,0,0,580,A
1-PB2,227,1,0,0,583,584,C
1-PB2,228,0,578,0,1,579,T
1-PB2,229,0,0,0,599,599,C
1-PB2,230,0,582,0,0,582,T
1-PB2,231,586,0,0,0,586,A
1-PB2,232,0,585,0,0,585,T
1-PB2,233,2,0,587,0,589,G
1-PB2,234,0,1,596,0,597,G
1-PB2,235,574,0,2,0,576,A
1-PB2,236,0,0,578,0,578,G
1-PB2,237,0,576,0,0,576,T
1-PB2,238,566,0,0,0,566,A
1-PB2,239,568,1,0,0,569,A
1-PB2,240,565,1,0,0,566,A
1-PB2,241,566,0,1,0,567,A
1-PB2,242,0,565,0,0,565,T
1-PB2,243,0,0,557,0,557,G
1-PB2,244,553,0,0,0,553,A
1-PB2,245,0,0,555,0,555,G
1-PB2,246,0,551,0,0,551,T
1-PB2,247,0,0,553,0,553,G
1-PB2,248,563,0,0,0,563,A
1-PB2,249,1,574,0,1,576,T
1-PB2,250,0,0,575,0,575,G
1-PB2,251,0,0,0,576,576,C
1-PB2,252,0,573,0,0,573,T
1-PB2,253,1,0,592,0,593,G
1-PB2,254,0,0,593,0,593,G
1-PB2,255,603,0,0,0,603,A
1-PB2,256,0,600,0,0,600,T
1-PB2,257,0,0,0,602,602,C
1-PB2,258,611,0,0,0,611,A
1-PB2,259,0,0,625,0,625,G
1-PB2,260,625,0,0,0,625,A
1-PB2,261,0,622,0,0,622,T
1-PB2,262,606,0,1,0,607,A
1-PB2,263,0,0,618,0,618,G
1-PB2,264,615,0,1,0,616,A
1-PB2,265,0,0,626,0,626,G
1-PB2,266,0,617,0,0,617,T
1-PB2,267,0,0,613,0,613,G
1-PB2,268,596,0,4,0,600,A
1-PB2,269,0,604,0,0,604,T
1-PB2,270,0,0,618,0,618,G
1-PB2,271,0,0,633,0,633,G
1-PB2,272,0,623,0,1,624,T
1-PB2,273,621,0,0,0,621,A
1-PB2,274,0,610,0,2,612,T
1-PB2,275,0,0,0,611,611,C
1-PB2,276,632,0,1,0,633,A
1-PB2,277,0,0,0,645,645,C
1-PB2,278,0,0,0,644,644,C
1-PB2,279,0,635,0,0,635,T
1-PB2,280,0,630,0,1,631,T
1-PB2,281,0,631,0,1,632,T
1-PB2,282,0,0,637,0,637,G
1-PB2,283,0,0,635,1,636,G
1-PB2,284,0,0,0,640,640,C
1-PB2,285,0,626,0,0,626,T
1-PB2,286,1,0,623,0,624,G
1-PB2,287,0,619,0,0,619,T
1-PB2,288,1,0,615,0,616,G
1-PB2,289,625,0,0,0,625,A
1-PB2,290,0,0,0,627,627,C
1-PB2,291,628,0,0,0,628,A
1-PB2,292,0,626,0,0,626,T
1-PB2,293,0,0,626,0,626,G
1-PB2,294,1,0,637,0,638,G
1-PB2,295,0,639,0,0,639,T
1-PB2,296,0,0,638,0,638,G
1-PB2,297,1,0,648,0,649,G
1-PB2,298,646,0,0,0,646,A
1-PB2,299,650,0,1,0,651,A
1-PB2,300,0,650,0,0,650,T
1-PB2,301,648,0,0,0,648,A
1-PB2,302,0,0,653,0,653,G
1-PB2,303,636,1,0,0,637,A
1-PB2,304,636,0,2,0,638,A
1-PB2,305,637,0,0,0,637,A
1-PB2,306,0,624,0,0,624,T
1-PB2,307,0,0,626,0,626,G
1-PB2,308,0,0,621,1,622,G
1-PB2,309,625,0,1,0,626,A
1-PB2,310,0,0,0,626,626,C
1-PB2,311,0,0,0,622,622,C
1-PB2,312,0,0,0,618,618,C
1-PB2,313,0,0,626,0,626,G
1-PB2,314,0,630,0,0,630,T
1-PB2,315,0,0,646,0,646,G
1-PB2,316,646,1,0,0,647,A
1-PB2,317,0,0,0,646,646,C
1-PB2,318,646,0,0,0,646,A
1-PB2,319,647,0,0,0,647,A
1-PB2,320,638,0,0,0,638,A
1-PB2,321,0,650,0,0,650,T
1-PB2,322,653,0,0,0,653,A
1-PB2,323,0,0,0,653,653,C
1-PB2,324,0,0,635,0,635,G
1-PB2,325,0,0,646,0,646,G
1-PB2,326,0,644,0,1,645,T
1-PB2,327,1,0,0,649,650,C
1-PB2,328,0,0,0,648,648,C
1-PB2,329,642,0,0,0,642,A
1-PB2,330,0,643,0,0,643,T
1-PB2,331,0,643,1,0,644,T
1-PB2,332,690,0,0,0,690,A
1-PB2,333,0,0,0,686,686,C
1-PB2,334,0,0,0,681,681,C
1-PB2,335,0,0,0,681,681,C
1-PB2,336,679,0,0,0,679,A
1-PB2,337,678,0,0,0,678,A
1-PB2,338,680,0,0,0,680,A
1-PB2,339,675,0,0,0,675,A
1-PB2,340,0,0,674,0,674,G
1-PB2,341,0,639,0,0,639,T
1-PB2,342,0,0,646,0,646,G
1-PB2,343,0,642,0,2,644,T
1-PB2,344,644,0,0,0,644,A
1-PB2,345,0,0,0,643,643,C
1-PB2,346,637,0,2,0,639,A
1-PB2,347,638,0,0,0,638,A
1-PB2,348,632,0,0,0,632,A
1-PB2,349,639,0,0,0,639,A
1-PB2,350,0,0,0,639,639,C
1-PB2,351,0,639,0,0,639,T
1-PB2,352,0,640,0,0,640,T
1-PB2,353,643,0,0,0,643,A
1-PB2,354,0,644,0,0,644,T
1-PB2,355,0,641,0,0,641,T
1-PB2,356,0,637,0,1,638,T
1-PB2,357,0,0,0,640,640,C
1-PB2,358,2,0,637,0,639,G
1-PB2,359,640,0,0,0,640,A
1-PB2,360,0,0,0,642,642,C
1-PB2,361,640,0,0,0,640,A
1-PB2,362,642,1,0,0,643,A
1-PB2,363,650,0,0,0,650,A
1-PB2,364,0,0,657,0,657,G
1-PB2,365,0,656,0,0,656,T
1-PB2,366,0,0,0,657,657,C
1-PB2,367,0,0,657,0,657,G
1-PB2,368,655,0,0,0,655,A
1-PB2,369,657,0,1,0,658,A
1-PB2,370,656,0,1,0,657,A
1-PB2,371,0,0,666,0,666,G
1-PB2,372,0,0,670,0,670,G
1-PB2,373,0,666,0,1,667,T
1-PB2,374,0,662,0,0,662,T
1-PB2,375,0,0,662,0,662,G
1-PB2,376,660,1,0,0,661,A
1-PB2,377,660,0,0,0,660,A
1-PB2,378,664,0,0,0,664,A
1-PB2,379,0,0,0,673,673,C
1-PB2,380,669,0,0,0,669,A
1-PB2,381,0,666,0,0,666,T
1-PB2,382,0,1,662,0,663,G
1-PB2,383,0,0,662,0,662,G
1-PB2,384,662,0,0,1,663,A
1-PB2,385,672,0,0,0,672,A
1-PB2,386,0,0,0,683,683,C
1-PB2,387,0,0,0,688,688,C
1-PB2,388,0,682,0,0,682,T
1-PB2,389,0,684,0,0,684,T
1-PB2,390,1,681,0,2,684,T
1-PB2,391,0,0,681,0,681,G
1-PB2,392,0,0,682,0,682,G
1-PB2,393,0,0,0,687,687,C
1-PB2,394,0,0,0,679,679,C
1-PB2,395,0,0,0,679,679,C
1-PB2,396,0,655,0,0,655,T
1-PB2,397,0,0,665,0,665,G
1-PB2,398,0,665,0,0,665,T
1-PB2,399,0,664,0,0,664,T
1-PB2,400,0,0,0,664,664,C
1-PB2,401,659,0,0,0,659,A
1-PB2,402,1,657,0,0,658,T
1-PB2,403,0,658,0,0,658,T
1-PB2,404,0,654,0,0,654,T
1-PB2,405,0,658,0,1,659,T
1-PB2,406,646,0,0,0,646,A
1-PB2,407,0,0,644,0,644,G
1-PB2,408,644,0,0,0,644,A
1-PB2,409,642,0,1,1,644,A
1-PB2,410,644,0,0,0,644,A
1-PB2,411,0,642,1,1,644,T
1-PB2,412,0,0,0,643,643,C
1-PB2,413,642,0,0,0,642,A
1-PB2,414,641,0,0,0,641,A
1-PB2,415,0,0,645,0,645,G
1-PB2,416,0,642,0,0,642,T
1-PB2,417,0,0,0,645,645,C
1-PB2,418,651,0,0,0,651,A
1-PB2,419,654,0,0,0,654,A
1-PB2,420,0,0,656,0,656,G
1-PB2,421,656,0,0,0,656,A
1-PB2,422,0,657,0,0,657,T
1-PB2,423,659,0,1,0,660,A
1-PB2,424,1,0,0,661,662,C
1-PB2,425,0,1,659,0,660,G
1-PB2,426,0,0,0,674,674,C
1-PB2,427,667,0,0,0,667,A
1-PB2,428,0,0,670,0,670,G
1-PB2,429,669,0,0,0,669,A
1-PB2,430,676,0,0,0,676,A
1-PB2,431,0,0,688,0,688,G
1-PB2,432,676,0,0,0,676,A
1-PB2,433,0,0,678,0,678,G
1-PB2,434,0,677,0,0,677,T
1-PB2,435,676,0,0,0,676,A
1-PB2,436,0,0,682,0,682,G
1-PB2,437,671,1,1,0,673,A
1-PB2,438,0,0,0,704,704,C
1-PB2,439,694,0,0,0,694,A
1-PB2,440,0,670,0,1,671,T
1-PB2,441,664,0,0,0,664,A
1-PB2,442,662,0,1,0,663,A
1-PB2,443,675,0,0,0,675,A
1-PB2,444,0,0,0,675,675,C
1-PB2,445,0,0,0,668,668,C
1-PB2,446,0,0,0,657,657,C
1-PB2,447,0,605,0,0,605,T
1-PB2,448,1,0,609,0,610,G
1-PB2,449,0,0,619,0,619,G
1-PB2,450,0,619,0,0,619,T
1-PB2,451,0,0,0,615,615,C
1-PB2,452,619,0,0,0,619,A
1-PB2,453,0,614,0,0,614,T
1-PB2,454,0,0,616,0,616,G
1-PB2,455,0,0,0,618,618,C
1-PB2,456,615,0,1,0,616,A
1-PB2,457,0,0,620,0,620,G
1-PB2,458,614,0,0,0,614,A
1-PB2,459,0,0,0,621,621,C
1-PB2,460,0,0,0,622,622,C
1-PB2,461,1,610,0,0,611,T
1-PB2,462,0,0,0,610,610,C
1-PB2,463,606,0,0,0,606,A
1-PB2,464,0,0,620,0,620,G
1-PB2,465,0,618,0,0,618,T
1-PB2,466,0,0,619,0,619,G
1-PB2,467,0,0,0,616,616,C
1-PB2,468,0,0,0,613,613,C
1-PB2,469,612,0,0,0,612,A
1-PB2,470,614,0,0,0,614,A
1-PB2,471,612,0,1,0,613,A
1-PB2,472,0,0,615,0,615,G
1-PB2,473,598,0,0,0,598,A
1-PB2,474,0,0,604,0,604,G
1-PB2,475,0,0,602,0,602,G
1-PB2,476,0,0,0,604,604,C
1-PB2,477,603,0,0,0,603,A
1-PB2,478,0,0,0,599,599,C
1-PB2,479,599,0,0,0,599,A
1-PB2,480,622,0,0,0,622,A
1-PB2,481,0,0,631,0,631,G
1-PB2,482,647,0,0,0,647,A
1-PB2,483,0,635,0,0,635,T
1-PB2,484,0,0,638,0,638,G
1-PB2,485,0,640,0,0,640,T
1-PB2,486,640,0,1,0,641,A
1-PB2,487,642,0,0,0,642,A
1-PB2,488,0,644,0,1,645,T
1-PB2,489,0,624,0,0,624,T
1-PB2,490,617,1,0,0,618,A
1-PB2,491,0,601,0,1,602,T
1-PB2,492,1,1,602,0,604,G
1-PB2,493,0,0,603,0,603,G
1-PB2,494,604,0,0,0,604,A
1-PB2,495,599,0,1,0,600,A
1-PB2,496,0,0,600,0,600,G
1-PB2,497,0,597,0,1,598,T
1-PB2,498,0,601,0,1,602,T
1-PB2,499,1,0,604,0,605,G
1-PB2,500,0,603,0,0,603,T
1-PB2,501,0,603,0,0,603,T
1-PB2,502,1,603,0,0,604,T
1-PB2,503,0,604,0,0,604,T
1-PB2,504,0,599,0,1,600,T
1-PB2,505,0,0,0,603,603,C
1-PB2,506,0,0,0,605,605,C
1-PB2,507,1,0,1,606,608,C
1-PB2,508,609,0,0,0,609,A
1-PB2,509,612,0,0,0,612,A
1-PB2,510,0,615,0,1,616,T
1-PB2,511,0,0,620,0,620,G
1-PB2,512,620,0,0,0,620,A
1-PB2,513,615,0,0,0,615,A
1-PB2,514,0,1,620,0,621,G
1-PB2,515,0,615,0,1,616,T
1-PB2,516,0,1,618,0,619,G
1-PB2,517,1,0,620,0,621,G
1-PB2,518,0,0,615,0,615,G
1-PB2,519,622,0,2,0,624,A
1-PB2,520,1,1,622,0,624,G
1-PB2,521,1,0,0,622,623,C
1-PB2,522,0,0,0,629,629,C
1-PB2,523,627,0,0,0,627,A
1-PB2,524,0,0,638,0,638,G
1-PB2,525,0,0,643,0,643,G
1-PB2,526,644,1,0,0,645,A
1-PB2,527,0,646,0,0,646,T
1-PB2,528,646,1,0,0,647,A
1-PB2,529,0,0,1,644,645,C
1-PB2,530,1,644,0,0,645,T
1-PB2,531,646,0,0,0,646,A
1-PB2,532,643,0,0,0,643,A
1-PB2,533,0,0,0,642,642,C
1-PB2,534,625,0,0,0,625,A
1-PB2,535,0,622,0,0,622,T
1-PB2,536,0,0,0,623,623,C
1-PB2,537,614,0,0,0,614,A
1-PB2,538,0,0,626,0,626,G
1-PB2,539,625,0,0,0,625,A
1-PB2,540,624,0,0,0,624,A
1-PB2,541,0,623,0,0,623,T
1-PB2,542,0,1,0,611,612,C
1-PB2,543,614,0,1,0,615,A
1-PB2,544,0,0,0,625,625,C
1-PB2,545,624,0,0,0,624,A
1-PB2,546,631,0,1,0,632,A
1-PB2,547,0,629,0,0,629,T
1-PB2,548,1,629,0,0,630,T
1-PB2,549,631,0,1,0,632,A
1-PB2,550,634,0,1,0,635,A
1-PB2,551,0,0,0,637,637,C
1-PB2,552,629,0,0,0,629,A
1-PB2,553,623,0,0,0,623,A
1-PB2,554,0,627,0,0,627,T
1-PB2,555,626,0,0,0,626,A
1-PB2,556,628,0,0,0,628,A
1-PB2,557,0,0,0,622,622,C
1-PB2,558,0,621,0,0,621,T
1-PB2,559,618,0,0,0,618,A
1-PB2,560,611,0,1,0,612,A
1-PB2,561,615,0,0,0,615,A
1-PB2,562,0,0,616,0,616,G
1-PB2,563,604,0,2,0,606,A
1-PB2,564,0,0,610,0,610,G
1-PB2,565,608,0,1,0,609,A
1-PB2,566,610,0,1,0,611,A
1-PB2,567,609,0,0,0,609,A
1-PB2,568,606,0,1,0,607,A
1-PB2,569,610,0,0,0,610,A
1-PB2,570,609,0,0,0,609,A
1-PB2,571,0,0,611,0,611,G
1-PB2,572,612,0,0,0,612,A
1-PB2,573,610,0,0,0,610,A
1-PB2,574,0,0,612,0,612,G
1-PB2,575,610,0,1,0,611,A
1-PB2,576,607,0,1,0,608,A
1-PB2,577,0,0,0,612,612,C
1-PB2,578,0,604,0,0,604,T
1-PB2,579,0,0,0,605,605,C
1-PB2,580,1,0,0,603,604,C
1-PB2,581,0,0,606,0,606,G
1-PB2,582,605,0,1,0,606,A
1-PB2,583,0,0,606,0,606,G
1-PB2,584,601,0,1,0,602,A
1-PB2,585,0,601,0,0,601,T
1-PB2,586,0,592,0,0,592,T
1-PB2,587,0,0,592,0,592,G
1-PB2,588,0,1,0,589,590,C
1-PB2,589,592,0,0,0,592,A
1-PB2,590,593,0,0,0,593,A
1-PB2,591,593,0,0,0,593,A
1-PB2,592,594,0,1,0,595,A
1-PB2,593,0,598,0,0,598,T
1-PB2,594,0,597,0,0,597,T
1-PB2,595,0,597,0,0,597,T
1-PB2,596,0,0,0,597,597,C
1-PB2,597,0,596,0,0,596,T
1-PB2,598,0,0,0,761,761,C
1-PB2,599,0,0,0,767,767,C
1-PB2,600,0,1,0,983,984,C
1-PB2,601,0,985,0,0,985,T
1-PB2,602,0,1020,0,1,1021,T
1-PB2,603,0,0,1031,0,1031,G
1-PB2,604,1038,0,1,0,1039,A
1-PB2,605,0,1067,0,0,1067,T
1-PB2,606,1,0,1114,0,1115,G
1-PB2,607,0,0,1417,0,1417,G
1-PB2,608,0,1501,0,0,1501,T
1-PB2,609,0,1504,0,0,1504,T
1-PB2,610,0,0,1750,1,1751,G
1-PB2,611,0,0,0,1767,1767,C
1-PB2,612,1841,0,0,0,1841,A
1-PB2,613,0,1848,0,0,1848,T
1-PB2,614,1877,1,0,6,1884,A
1-PB2,615,0,0,0,2039,2039,C
1-PB2,616,2494,1,0,1,2496,A
1-PB2,617,1,2580,0,3,2584,T
1-PB2,618,0,0,2800,0,2800,G
1-PB2,619,2,2781,0,1,2784,T
1-PB2,620,0,2793,0,0,2793,T
1-PB2,621,2793,0,0,0,2793,A
1-PB2,622,0,0,2798,0,2798,G
1-PB2,623,2852,1,1,0,2854,A
1-PB2,624,0,0,2912,0,2912,G
1-PB2,625,2855,1,0,0,2856,A
1-PB2,626,0,0,2879,0,2879,G
1-PB2,627,2864,2,1,0,2867,A
1-PB2,628,0,0,2896,0,2896,G
1-PB2,629,2910,1,1,0,2912,A
1-PB2,630,2916,0,2,0,2918,A
1-PB2,631,0,0,0,2950,2950,C
1-PB2,632,0,2948,0,1,2949,T
1-PB2,633,1,2948,0,1,2950,T
1-PB2,634,0,0,2956,0,2956,G
1-PB2,635,0,2957,0,1,2958,T
1-PB2,636,2959,0,0,0,2959,A
1-PB2,637,1,1,0,2945,2947,C
1-PB2,638,1,1,2947,0,2949,G
1-PB2,639,2953,0,1,0,2954,A
1-PB2,640,2950,0,0,0,2950,A
1-PB2,641,2985,0,1,0,2986,A
1-PB2,642,2981,0,0,0,2981,A
1-PB2,643,2985,0,1,2,2988,A
1-PB2,644,0,1,0,2993,2994,C
1-PB2,645,2994,0,1,0,2995,A
1-PB2,646,2999,0,2,0,3001,A
1-PB2,647,0,0,3014,0,3014,G
1-PB2,648,3016,0,1,1,3018,A
1-PB2,649,1,3014,2,3,3020,T
1-PB2,650,1,3021,0,0,3022,T
1-PB2,651,0,3023,0,0,3023,T
1-PB2,652,0,1,0,3040,3041,C
1-PB2,653,0,3045,0,2,3047,T
1-PB2,654,2,0,0,3045,3047,C
1-PB2,655,0,1,0,3039,3040,C
1-PB2,656,0,0,0,3050,3050,C
1-PB2,657,3055,0,0,0,3055,A
1-PB2,658,0,0,3106,0,3106,G
1-PB2,659,0,3102,0,1,3103,T
1-PB2,660,0,3096,1,2,3099,T
1-PB2,661,0,3099,0,1,3100,T
1-PB2,662,0,0,0,3115,3115,C
1-PB2,663,0,3114,0,3,3117,T
1-PB2,664,2,0,3116,0,3118,G
1-PB2,665,2,0,3106,0,3108,G
1-PB2,666,0,0,0,3113,3113,C
1-PB2,667,0,0,3108,0,3108,G
1-PB2,668,1,0,3168,0,3169,G
1-PB2,669,3173,0,0,0,3173,A
1-PB2,670,3179,2,1,0,3182,A
1-PB2,671,0,1,0,3189,3190,C
1-PB2,672,3211,0,2,0,3213,A
1-PB2,673,3216,1,1,0,3218,A
1-PB2,674,0,0,3374,0,3374,G
1-PB2,675,1,0,0,3464,3465,C
1-PB2,676,3505,0,3,1,3509,A
1-PB2,677,1,0,4554,0,4555,G
1-PB2,678,1,4555,0,0,4556,T
1-PB2,679,4588,1,4,0,4593,A
1-PB2,680,2,4594,0,1,4597,T
1-PB2,681,4612,1,3,0,4616,A
1-PB2,682,1,4615,0,1,4617,T
1-PB2,683,4592,0,1,0,4593,A
1-PB2,684,1,1,0,4645,4647,C
1-PB2,685,4511,0,0,0,4511,A
1-PB2,686,1,4354,1,2,4358,T
1-PB2,687,0,4239,0,1,4240,T
1-PB2,688,0,1,4248,1,4250,G
1-PB2,689,4240,2,4,1,4247,A
1-PB2,690,4241,0,0,0,4241,A
1-PB2,691,1,0,4306,0,4307,G
1-PB2,692,0,4290,1,0,4291,T
1-PB2,693,0,4277,1,0,4278,T
1-PB2,694,0,4279,0,2,4281,T
1-PB2,695,0,4283,0,0,4283,T
1-PB2,696,4323,2,4,3,4332,A
1-PB2,697,0,0,0,4367,4367,C
1-PB2,698,4382,0,0,0,4382,A
1-PB2,699,1,4369,0,3,4373,T
1-PB2,700,0,4365,0,0,4365,T
1-PB2,701,0,4365,0,1,4366,T
1-PB2,702,0,0,4436,0,4436,G
1-PB2,703,4456,0,4,0,4460,A
1-PB2,704,0,1,1,4485,4487,C
1-PB2,705,0,4475,0,1,4476,T
1-PB2,706,1,0,0,4473,4474,C
1-PB2,707,4466,1,4,0,4471,A
1-PB2,708,6,0,4448,0,4454,G
1-PB2,709,1,2,4566,0,4569,G
1-PB2,710,0,1,4585,0,4586,G
1-PB2,711,4604,1,1,0,4606,A
1-PB2,712,4598,0,7,3,4608,A
1-PB2,713,0,1,0,4610,4611,C
1-PB2,714,3,0,4661,0,4664,G
1-PB2,715,0,4665,0,2,4667,T
1-PB2,716,0,0,4697,0,4697,G
1-PB2,717,0,4674,0,4,4678,T
1-PB2,718,0,4673,0,1,4674,T
1-PB2,719,0,0,4691,0,4691,G
1-PB2,720,1,4,4678,0,4683,G
1-PB2,721,2,2,4757,1,4762,G
1-PB2,722,4742,1,3,0,4746,A
1-PB2,723,4730,1,1,0,4732,A
1-PB2,724,0,0,0,4874,4874,C
1-PB2,725,4856,2,0,0,4858,A
1-PB2,726,5018,0,0,1,5019,A
1-PB2,727,5030,0,1,1,5032,A
1-PB2,728,0,5083,0,1,5084,T
1-PB2,729,3,0,5148,0,5151,G
1-PB2,730,0,5125,0,2,5127,T
1-PB2,731,5129,0,1,0,5130,A
1-PB2,732,1,1,0,5138,5140,C
1-PB2,733,5058,1,3,0,5062,A
1-PB2,734,1,0,0,5059,5060,C
1-PB2,735,0,4926,0,3,4929,T
1-PB2,736,0,0,0,5402,5402,C
1-PB2,737,0,0,1,5404,5405,C
1-PB2,738,5488,3,5,0,5496,A
1-PB2,739,1,1,5546,0,5548,G
1-PB2,740,1,3,5675,1,5680,G
1-PB2,741,0,5662,0,4,5666,T
1-PB2,742,0,0,5667,0,5667,G
1-PB2,743,1,2,5543,0,5546,G
1-PB2,744,5487,1,5,0,5493,A
1-PB2,745,1,1,5528,0,5530,G
1-PB2,746,0,1,5539,0,5540,G
1-PB2,747,5484,1,5,0,5490,A
1-PB2,748,1,1,5539,0,5541,G
1-PB2,749,0,5455,0,1,5456,T
1-PB2,750,1,1,5492,0,5494,G
1-PB2,751,5492,0,4,0,5496,A
1-PB2,752,1,0,5542,0,5543,G
1-PB2,753,5,2,5564,1,5572,G
1-PB2,754,5534,0,1,0,5535,A
1-PB2,755,5541,1,4,0,5546,A
1-PB2,756,1,5552,0,0,5553,T
1-PB2,757,1,1,5533,0,5535,G
1-PB2,758,5534,1,5,0,5540,A
1-PB2,759,0,0,2,5526,5528,C
1-PB2,760,1,2,5530,0,5533,G
1-PB2,761,5608,2,2,0,5612,A
1-PB2,762,0,5590,1,1,5592,T
1-PB2,763,1,1,5626,0,5628,G
1-PB2,764,1,5613,0,5,5619,T
1-PB2,765,1,5583,0,1,5585,T
1-PB2,766,2,1,5638,0,5641,G
1-PB2,767,5640,0,6,0,5646,A
1-PB2,768,1,1,0,5640,5642,C
1-PB2,769,1,5,1,5628,5635,C
1-PB2,770,5565,0,1,0,5566,A
1-PB2,771,5581,0,2,0,5583,A
1-PB2,772,5586,0,4,0,5590,A
1-PB2,773,0,0,5729,0,5729,G
1-PB2,774,1,5,0,5735,5741,C
1-PB2,775,0,0,0,5722,5722,C
1-PB2,776,0,5743,0,5,5748,T
1-PB2,777,5764,0,0,0,5764,A
1-PB2,778,5759,0,1,0,5760,A
1-PB2,779,1,5770,0,2,5773,T
1-PB2,780,1,5759,1,0,5761,T
1-PB2,781,5713,1,1,0,5715,A
1-PB2,782,0,5605,0,0,5605,T
1-PB2,783,0,5585,0,1,5586,T
1-PB2,784,0,1,5550,0,5551,G
1-PB2,785,0,3,0,5549,5552,C
1-PB2,786,6,1,5553,0,5560,G
1-PB2,787,4,0,5689,0,5693,G
1-PB2,788,0,1,0,5688,5689,C
1-PB2,789,0,2,0,5737,5739,C
1-PB2,790,5738,1,1,0,5740,A
1-PB2,791,0,2,5796,0,5798,G
1-PB2,792,2,0,5850,0,5852,G
1-PB2,793,5859,1,5,0,5865,A
1-PB2,794,5886,1,6,0,5893,A
1-PB2,795,0,1,0,5919,5920,C
1-PB2,796,5892,0,5,0,5897,A
1-PB2,797,0,5999,1,0,6000,T
1-PB2,798,6108,0,3,0,6111,A
1-PB2,799,1,0,6166,0,6167,G
1-PB2,800,2,6115,0,4,6121,T
1-PB2,801,6091,0,0,1,6092,A
1-PB2,802,6069,1,2,1,6073,A
1-PB2,803,0,0,6085,0,6085,G
1-PB2,804,6047,2,2,0,6051,A
1-PB2,805,5972,2,1,1,5976,A
1-PB2,806,1,2,5955,0,5958,G
1-PB2,807,5821,0,1,0,5822,A
1-PB2,808,1,1,5818,0,5820,G
1-PB2,809,1,3,0,5833,5837,C
1-PB2,810,1,1,1,5821,5824,C
1-PB2,811,3,2,5832,0,5837,G
1-PB2,812,3,2,0,5888,5893,C
1-PB2,813,5929,1,0,0,5930,A
1-PB2,814,2,0,6355,0,6357,G
1-PB2,815,1,6349,0,3,6353,T
1-PB2,816,6381,0,0,0,6381,A
1-PB2,817,2,6350,0,1,6353,T
1-PB2,818,0,1,0,6421,6422,C
1-PB2,819,6404,0,5,0,6409,A
1-PB2,820,3,0,6425,0,6428,G
1-PB2,821,1,2,0,6418,6421,C
1-PB2,822,6176,1,1,1,6179,A
1-PB2,823,0,0,6122,0,6122,G
1-PB2,824,6165,0,0,0,6165,A
1-PB2,825,3,6162,1,2,6168,T
1-PB2,826,1,0,1,6196,6198,C
1-PB2,827,1,0,0,6193,6194,C
1-PB2,828,6205,0,1,0,6206,A
1-PB2,829,2,0,1,6225,6228,C
1-PB2,830,1,6217,0,0,6218,T
1-PB2,831,6234,0,3,0,6237,A
1-PB2,832,1,1,6231,0,6233,G
1-PB2,833,2,1,0,6169,6172,C
1-PB2,834,6175,0,2,0,6177,A
1-PB2,835,1,6229,0,2,6232,T
1-PB2,836,0,1,0,6219,6220,C
1-PB2,837,0,6189,0,2,6191,T
1-PB2,838,1,6223,1,2,6227,T
1-PB2,839,1,6232,0,2,6235,T
1-PB2,840,6217,3,0,0,6220,A
1-PB2,841,2,6231,0,1,6234,T
1-PB2,842,1,6213,0,1,6215,T
1-PB2,843,2,1,6206,0,6209,G
1-PB2,844,2,2,6186,1,6191,G
1-PB2,845,6171,1,4,0,6176,A
1-PB2,846,6122,1,2,0,6125,A
1-PB2,847,6237,1,1,0,6239,A
1-PB2,848,0,6234,1,0,6235,T
1-PB2,849,2,0,6337,0,6339,G
1-PB2,850,0,6330,0,8,6338,T
1-PB2,851,1,0,6326,1,6328,G
1-PB2,852,0,2,0,6315,6317,C
1-PB2,853,0,0,0,6302,6302,C
1-PB2,854,6321,0,2,1,6324,A
1-PB2,855,1,1,0,6320,6322,C
1-PB2,856,6252,0,4,0,6256,A
1-PB2,857,2,0,6346,0,6348,G
1-PB2,858,2,2,1,6264,6269,C
1-PB2,859,6264,0,6,0,6270,A
1-PB2,860,0,5,0,6271,6276,C
1-PB2,861,6265,0,2,1,6268,A
1-PB2,862,0,2,0,6309,6311,C
1-PB2,863,6291,1,2,0,6294,A
1-PB2,864,6298,1,2,1,6302,A
1-PB2,865,6294,0,6,0,6300,A
1-PB2,866,1,6130,1,0,6132,T
1-PB2,867,0,6126,0,3,6129,T
1-PB2,868,4,1,6097,1,6103,G
1-PB2,869,1,2,6085,0,6088,G
1-PB2,870,1,6,0,6095,6102,C
1-PB2,871,1,1,6033,1,6036,G
1-PB2,872,3,0,6075,2,6080,G
1-PB2,873,4,2,6066,2,6074,G
1-PB2,874,6082,1,2,1,6086,A
1-PB2,875,0,4,0,6079,6083,C
1-PB2,876,6093,0,1,0,6094,A
1-PB2,877,6094,0,1,0,6095,A
1-PB2,878,5943,0,2,1,5946,A
1-PB2,879,5934,5,1,0,5940,A
1-PB2,880,6028,0,1,2,6031,A
1-PB2,881,1,6025,0,2,6028,T
1-PB2,882,0,2,6038,0,6040,G
1-PB2,883,0,1,6050,0,6051,G
1-PB2,884,1,6049,1,2,6053,T
1-PB2,885,0,1,6044,0,6045,G
1-PB2,886,2,0,6048,0,6050,G
1-PB2,887,6046,1,6,0,6053,A
1-PB2,888,0,0,0,6063,6063,C
1-PB2,889,6037,1,1,0,6039,A
1-PB2,890,1,6997,0,2,7000,T
1-PB2,891,0,6976,0,5,6981,T
1-PB2,892,0,0,0,7024,7024,C
1-PB2,893,2,7007,1,5,7015,T
1-PB2,894,0,7018,0,1,7019,T
1-PB2,895,7022,0,2,0,7024,A
1-PB2,896,0,0,7058,0,7058,G
1-PB2,897,7039,2,1,0,7042,A
1-PB2,898,0,1,0,7041,7042,C
1-PB2,899,5985,1,2,0,5988,A
1-PB2,900,0,1,6122,0,6123,G
1-PB2,901,6089,1,12,0,6102,A
1-PB2,902,6116,1,3,0,6120,A
1-PB2,903,1,1,0,6098,6100,C
1-PB2,904,2,0,0,6109,6111,C
1-PB2,905,2,0,1,6094,6097,C
1-PB2,906,0,2,6109,1,6112,G
1-PB2,907,6125,1,1,1,6128,A
1-PB2,908,1,0,0,6151,6152,C
1-PB2,909,1,6066,2,1,6070,T
1-PB2,910,1,1,6122,0,6124,G
1-PB2,911,6115,0,2,1,6118,A
1-PB2,912,6150,0,11,0,6161,A
1-PB2,913,0,1,6177,0,6178,G
1-PB2,914,6146,2,4,0,6152,A
1-PB2,915,6152,0,5,0,6157,A
1-PB2,916,0,1,0,6151,6152,C
1-PB2,917,6104,1,3,0,6108,A
1-PB2,918,6134,1,3,1,6139,A
1-PB2,919,0,2,6198,0,6200,G
1-PB2,920,0,0,0,6248,6248,C
1-PB2,921,1,6208,0,1,6210,T
1-PB2,922,0,0,6297,1,6298,G
1-PB2,923,1,6280,1,0,6282,T
1-PB2,924,2,1,6388,1,6392,G
1-PB2,925,0,2,6600,0,6602,G
1-PB2,926,6606,1,8,1,6616,A
1-PB2,927,0,6588,1,3,6592,T
1-PB2,928,6531,0,2,1,6534,A
1-PB2,929,1,6453,0,0,6454,T
1-PB2,930,6689,2,0,1,6692,A
1-PB2,931,0,6580,0,0,6580,T
1-PB2,932,1,1,6567,0,6569,G
1-PB2,933,1,1,0,6501,6503,C
1-PB2,934,6210,1,1,2,6214,A
1-PB2,935,6208,0,0,0,6208,A
1-PB2,936,1,1,6198,0,6200,G
1-PB2,937,0,2,6224,0,6226,G
1-PB2,938,1,0,0,6227,6228,C
1-PB2,939,0,6084,1,4,6089,T
1-PB2,940,0,0,6124,0,6124,G
1-PB2,941,0,1,0,6129,6130,C
1-PB2,942,6125,0,3,0,6128,A
1-PB2,943,6137,1,4,1,6143,A
1-PB2,944,0,6102,0,0,6102,T
1-PB2,945,4,3,6121,1,6129,G
1-PB2,946,1,0,6082,2,6085,G
1-PB2,947,0,3,6085,0,6088,G
1-PB2,948,6100,0,0,0,6100,A
1-PB2,949,1,6078,0,1,6080,T
1-PB2,950,0,6046,0,4,6050,T
1-PB2,951,0,0,6064,0,6064,G
1-PB2,952,6039,1,4,0,6044,A
1-PB2,953,0,2,6106,1,6109,G
1-PB2,954,6055,0,0,0,6055,A
1-PB2,955,6002,1,3,0,6006,A
1-PB2,956,1,5935,0,2,5938,T
1-PB2,957,0,0,0,5953,5953,C
1-PB2,958,5949,0,4,0,5953,A
1-PB2,959,1,0,6012,0,6013,G
1-PB2,960,1,3,0,6000,6004,C
1-PB2,961,1,5963,0,2,5966,T
1-PB2,962,0,0,1,5953,5954,C
1-PB2,963,5950,0,0,0,5950,A
1-PB2,964,2,6065,0,2,6069,T
1-PB2,965,0,0,0,6082,6082,C
1-PB2,966,1,2,0,6126,6129,C
1-PB2,967,1,6103,0,6,6110,T
1-PB2,968,1,6071,0,4,6076,T
1-PB2,969,0,0,0,6089,6089,C
1-PB2,970,6080,0,7,0,6087,A
1-PB2,971,0,0,6178,0,6178,G
1-PB2,972,1,1,0,6163,6165,C
1-PB2,973,1,6041,1,6,6049,T
1-PB2,974,0,6057,0,1,6058,T
1-PB2,975,2,6010,0,1,6013,T
1-PB2,976,3,1,6019,0,6023,G
1-PB2,977,1,1,6029,0,6031,G
1-PB2,978,0,5966,0,47,6013,T
1-PB2,979,0,3,6044,0,6047,G
1-PB2,980,0,1,6040,0,6041,G
1-PB2,981,5,0,6099,0,6104,G
1-PB2,982,1,6070,0,3,6074,T
1-PB2,983,0,6068,1,1,6070,T
1-PB2,984,2,6070,0,0,6072,T
1-PB2,985,6115,0,4,0,6119,A
1-PB2,986,0,1,0,6139,6140,C
1-PB2,987,6149,2,1,0,6152,A
1-PB2,988,0,6129,0,1,6130,T
1-PB2,989,0,6029,0,3,6032,T
1-PB2,990,0,6021,0,1,6022,T
1-PB2,991,6021,3,2,0,6026,A
1-PB2,992,6019,0,0,0,6019,A
1-PB2,993,6025,0,3,0,6028,A
1-PB2,994,5993,1,7,0,6001,A
1-PB2,995,2,0,6056,0,6058,G
1-PB2,996,6017,0,1,0,6018,A
1-PB2,997,6025,1,1,0,6027,A
1-PB2,998,1,2,0,6037,6040,C
1-PB2,999,6021,1,2,1,6025,A
1-PB2,1000,6026,0,3,1,6030,A
1-PB2,1001,0,0,6034,0,6034,G
1-PB2,1002,1,1,0,6028,6030,C
1-PB2,1003,0,2,6021,0,6023,G
1-PB2,1004,3,1,6039,0,6043,G
1-PB2,1005,0,1,6057,1,6059,G
1-PB2,1006,2,6013,0,23,6038,T
1-PB2,1007,0,0,0,6024,6024,C
1-PB2,1008,6029,1,9,1,6040,A
1-PB2,1009,0,6018,0,2,6020,T
1-PB2,1010,0,0,0,6023,6023,C
1-PB2,1011,6004,1,3,0,6008,A
1-PB2,1012,2,0,6105,0,6107,G
1-PB2,1013,2,6025,2,2,6031,T
1-PB2,1014,0,1,0,6027,6028,C
1-PB2,1015,6033,0,6,0,6039,A
1-PB2,1016,6058,2,2,0,6062,A
1-PB2,1017,6054,0,3,0,6057,A
1-PB2,1018,6044,0,4,1,6049,A
1-PB2,1019,6071,1,1,0,6073,A
1-PB2,1020,6059,1,9,0,6069,A
1-PB2,1021,2,0,6100,0,6102,G
1-PB2,1022,6068,2,2,0,6072,A
1-PB2,1023,6059,2,2,0,6063,A
1-PB2,1024,0,2,6063,1,6066,G
1-PB2,1025,6055,0,2,0,6057,A
1-PB2,1026,5951,1,5,0,5957,A
1-PB2,1027,0,0,5962,0,5962,G
1-PB2,1028,5932,0,5,1,5938,A
1-PB2,1029,1,1,5948,0,5950,G
1-PB2,1030,1,0,6038,2,6041,G
1-PB2,1031,0,6041,1,0,6042,T
1-PB2,1032,0,0,6161,0,6161,G
1-PB2,1033,3,1,0,6195,6199,C
1-PB2,1034,1,6176,0,9,6186,T
1-PB2,1035,0,6211,0,2,6213,T
1-PB2,1036,6201,0,1,0,6202,A
1-PB2,1037,1,0,0,6209,6210,C
1-PB2,1038,6147,0,6,0,6153,A
1-PB2,1039,0,0,6163,0,6163,G
1-PB2,1040,3,0,6145,0,6148,G
1-PB2,1041,2,0,1,6038,6041,C
1-PB2,1042,5936,3,1,0,5940,A
1-PB2,1043,5955,1,2,1,5959,A
1-PB2,1044,0,6049,0,0,6049,T
1-PB2,1045,2,1,0,6107,6110,C
1-PB2,1046,2,6067,0,24,6093,T
1-PB2,1047,4,1,0,6075,6080,C
1-PB2,1048,1,1,0,6084,6086,C
1-PB2,1049,6081,0,1,0,6082,A
1-PB2,1050,6066,1,2,0,6069,A
1-PB2,1051,6079,2,3,1,6085,A
1-PB2,1052,1,3,0,6086,6090,C
1-PB2,1053,5906,2,1,0,5909,A
1-PB2,1054,0,5860,0,1,5861,T
1-PB2,1055,0,5840,1,1,5842,T
1-PB2,1056,0,0,5910,0,5910,G
1-PB2,1057,5906,1,5,1,5913,A
1-PB2,1058,5967,2,0,0,5969,A
1-PB2,1059,5978,0,2,0,5980,A
1-PB2,1060,5973,0,1,0,5974,A
1-PB2,1061,1,5971,1,1,5974,T
1-PB2,1062,5979,0,3,0,5982,A
1-PB2,1063,5970,0,3,1,5974,A
1-PB2,1064,0,1,6061,0,6062,G
1-PB2,1065,5954,0,7,2,5963,A
1-PB2,1066,0,0,6170,0,6170,G
1-PB2,1067,1,6092,0,4,6097,T
1-PB2,1068,6122,0,1,0,6123,A
1-PB2,1069,0,1,0,6265,6266,C
1-PB2,1070,6234,1,2,0,6237,A
1-PB2,1071,0,6230,1,0,6231,T
1-PB2,1072,1,0,6235,0,6236,G
1-PB2,1073,6150,1,4,0,6155,A
1-PB2,1074,1,1,6189,1,6192,G
1-PB2,1075,3,4,6210,1,6218,G
1-PB2,1076,1,1,6562,1,6565,G
1-PB2,1077,3,1,6592,1,6597,G
1-PB2,1078,1,6495,0,6,6502,T
1-PB2,1079,6512,2,1,0,6515,A
1-PB2,1080,1,6487,0,3,6491,T
1-PB2,1081,1,1,6520,0,6522,G
1-PB2,1082,6509,1,1,0,6511,A
1-PB2,1083,4,2,6476,3,6485,G
1-PB2,1084,1,1,6420,1,6423,G
1-PB2,1085,5860,1,2,0,5863,A
1-PB2,1086,3,2,6052,0,6057,G
1-PB2,1087,0,6048,0,3,6051,T
1-PB2,1088,4,6216,0,2,6222,T
1-PB2,1089,1,2,0,6249,6252,C
1-PB2,1090,6266,2,0,0,6268,A
1-PB2,1091,2,2,0,6279,6283,C
1-PB2,1092,6247,0,2,0,6249,A
1-PB2,1093,6274,1,2,0,6277,A
1-PB2,1094,2,6260,1,1,6264,T
1-PB2,1095,2,2,6097,0,6101,G
1-PB2,1096,2,1,6153,1,6157,G
1-PB2,1097,1,5999,0,4,6004,T
1-PB2,1098,1,0,6004,0,6005,G
1-PB2,1099,2,1,6022,0,6025,G
1-PB2,1100,2,0,6021,0,6023,G
1-PB2,1101,1,1,6063,0,6065,G
1-PB2,1102,6034,0,1,0,6035,A
1-PB2,1103,6050,0,3,0,6053,A
1-PB2,1104,6009,0,1,0,6010,A
1-PB2,1105,5883,1,4,0,5888,A
1-PB2,1106,2,4,5947,0,5953,G
1-PB2,1107,5931,0,5,1,5937,A
1-PB2,1108,1,0,5951,0,5952,G
1-PB2,1109,2,0,1,5942,5945,C
1-PB2,1110,5902,1,3,0,5906,A
1-PB2,1111,5910,1,5,0,5916,A
1-PB2,1112,1,3,0,6126,6130,C
1-PB2,1113,6135,0,1,0,6136,A
1-PB2,1114,2,0,6236,0,6238,G
1-PB2,1115,0,0,0,6175,6175,C
1-PB2,1116,0,6168,0,4,6172,T
1-PB2,1117,6343,0,0,0,6343,A
1-PB2,1118,0,6337,0,2,6339,T
1-PB2,1119,6358,1,2,0,6361,A
1-PB2,1120,0,0,0,6363,6363,C
1-PB2,1121,1,6043,0,0,6044,T
1-PB2,1122,6069,0,2,2,6073,A
1-PB2,1123,5921,0,5,1,5927,A
1-PB2,1124,0,0,5946,0,5946,G
1-PB2,1125,5931,1,1,1,5934,A
1-PB2,1126,5744,0,2,0,5746,A
1-PB2,1127,5740,0,2,0,5742,A
1-PB2,1128,5705,1,6,1,5713,A
1-PB2,1129,2,0,5707,1,5710,G
1-PB2,1130,1,1,0,5708,5710,C
1-PB2,1131,5689,0,1,0,5690,A
1-PB2,1132,5694,1,8,0,5703,A
1-PB2,1133,0,1,0,5715,5716,C
1-PB2,1134,2,1,0,5712,5715,C
1-PB2,1135,5712,3,2,1,5718,A
1-PB2,1136,0,1,5744,0,5745,G
1-PB2,1137,5741,0,0,0,5741,A
1-PB2,1138,5717,2,3,1,5723,A
1-PB2,1139,0,0,5791,0,5791,G
1-PB2,1140,5759,1,1,0,5761,A
1-PB2,1141,0,5752,0,0,5752,T
1-PB2,1142,0,5725,0,1,5726,T
1-PB2,1143,2,1,5732,0,5735,G
1-PB2,1144,1,0,5841,1,5843,G
1-PB2,1145,1,5800,0,7,5808,T
1-PB2,1146,2,5787,0,1,5790,T
1-PB2,1147,0,1,0,5799,5800,C
1-PB2,1148,5927,0,4,1,5932,A
1-PB2,1149,2,0,6205,0,6207,G
1-PB2,1150,1,0,0,6257,6258,C
1-PB2,1151,0,6246,1,4,6251,T
1-PB2,1152,0,1,0,6288,6289,C
1-PB2,1153,6215,3,0,0,6218,A
1-PB2,1154,0,6247,0,1,6248,T
1-PB2,1155,6249,2,1,1,6253,A
1-PB2,1156,1,0,6299,0,6300,G
1-PB2,1157,1,5970,0,1,5972,T
1-PB2,1158,1,2,5982,0,5985,G
1-PB2,1159,5799,2,8,0,5809,A
1-PB2,1160,1,0,5888,0,5889,G
1-PB2,1161,0,5836,0,3,5839,T
1-PB2,1162,24,0,5813,1,5838,G
1-PB2,1163,2,3,5913,1,5919,G
1-PB2,1164,5912,0,3,0,5915,A
1-PB2,1165,5873,1,3,0,5877,A
1-PB2,1166,0,0,5915,0,5915,G
1-PB2,1167,5825,0,3,0,5828,A
1-PB2,1168,2,1,5852,1,5856,G
1-PB2,1169,5801,0,5,1,5807,A
1-PB2,1170,1,1,0,5802,5804,C
1-PB2,1171,7,0,5806,1,5814,G
1-PB2,1172,5755,2,3,0,5760,A
1-PB2,1173,5778,2,4,0,5784,A
1-PB2,1174,0,0,1,5776,5777,C
1-PB2,1175,5748,0,1,7,5756,A
1-PB2,1176,3,0,6095,0,6098,G
1-PB2,1177,0,6069,0,7,6076,T
1-PB2,1178,0,1,0,6082,6083,C
1-PB2,1179,6075,1,2,0,6078,A
1-PB2,1180,6078,0,2,0,6080,A
1-PB2,1181,0,6080,0,0,6080,T
1-PB2,1182,6066,0,2,1,6069,A
1-PB2,1183,1,1,6064,1,6067,G
1-PB2,1184,0,2,0,6041,6043,C
1-PB2,1185,0,2,0,5822,5824,C
1-PB2,1186,5,1,5789,0,5795,G
1-PB2,1187,5797,2,0,1,5800,A
1-PB2,1188,5805,2,6,2,5815,A
1-PB2,1189,1,2,5883,0,5886,G
1-PB2,1190,1,0,0,6014,6015,C
1-PB2,1191,6020,0,2,1,6023,A
1-PB2,1192,6016,0,2,1,6019,A
1-PB2,1193,0,6017,1,3,6021,T
1-PB2,1194,6040,0,3,1,6044,A
1-PB2,1195,6115,1,0,3,6119,A
1-PB2,1196,3,6123,0,2,6128,T
1-PB2,1197,1,2,0,6090,6093,C
1-PB2,1198,0,0,6069,0,6069,G
1-PB2,1199,0,5920,2,3,5925,T
1-PB2,1200,0,0,5919,0,5919,G
1-PB2,1201,4,1,5966,0,5971,G
1-PB2,1202,1,2,0,5960,5963,C
1-PB2,1203,3,4,0,5955,5962,C
1-PB2,1204,5915,1,3,0,5919,A
1-PB2,1205,0,5910,0,15,5925,T
1-PB2,1206,1,0,5952,1,5954,G
1-PB2,1207,1,0,6041,0,6042,G
1-PB2,1208,0,6006,4,2,6012,T
1-PB2,1209,1,3,6037,1,6042,G
1-PB2,1210,0,5929,1,1,5931,T
1-PB2,1211,1,5914,1,5,5921,T
1-PB2,1212,0,5919,0,2,5921,T
1-PB2,1213,0,5926,1,2,5929,T
1-PB2,1214,0,0,1,5986,5987,C
1-PB2,1215,5972,2,7,1,5982,A
1-PB2,1216,3,0,0,6056,6059,C
1-PB2,1217,5966,0,3,0,5969,A
1-PB2,1218,5958,2,3,0,5963,A
1-PB2,1219,1,1,5962,0,5964,G
1-PB2,1220,5946,0,3,0,5949,A
1-PB2,1221,5834,2,44,0,5880,A
1-PB2,1222,1,0,5954,0,5955,G
1-PB2,1223,5943,0,1,0,5944,A
1-PB2,1224,1,5958,1,3,5963,T
1-PB2,1225,2,5891,0,1,5894,T
1-PB2,1226,0,1,5891,0,5892,G
1-PB2,1227,0,2,1,5815,5818,C
1-PB2,1228,5831,0,6,8,5845,A
1-PB2,1229,0,5899,0,0,5899,T
1-PB2,1230,0,0,6091,1,6092,G
1-PB2,1231,6121,1,3,0,6125,A
1-PB2,1232,1,6145,0,1,6147,T
1-PB2,1233,6128,0,3,1,6132,A
1-PB2,1234,6121,1,2,0,6124,A
1-PB2,1235,6120,0,0,1,6121,A
1-PB2,1236,6140,0,5,0,6145,A
1-PB2,1237,1,1,6143,0,6145,G
1-PB2,1238,1,1,0,6282,6284,C
1-PB2,1239,6327,0,3,1,6331,A
1-PB2,1240,0,0,6503,0,6503,G
1-PB2,1241,1,6474,3,1,6479,T
1-PB2,1242,2,6484,1,1,6488,T
1-PB2,1243,6487,1,1,0,6489,A
1-PB2,1244,0,1,6524,0,6525,G
1-PB2,1245,6461,0,20,2,6483,A
1-PB2,1246,0,2,6495,0,6497,G
1-PB2,1247,0,0,6468,0,6468,G
1-PB2,1248,0,6184,1,4,6189,T
1-PB2,1249,1,0,6186,0,6187,G
1-PB2,1250,6216,1,1,0,6218,A
1-PB2,1251,0,2,0,6224,6226,C
1-PB2,1252,1,0,1,6243,6245,C
1-PB2,1253,1,6210,0,10,6221,T
1-PB2,1254,1,1,6231,0,6233,G
1-PB2,1255,6227,1,1,1,6230,A
1-PB2,1256,6226,0,2,1,6229,A
1-PB2,1257,3,6216,0,0,6219,T
1-PB2,1258,1,6304,0,0,6305,T
1-PB2,1259,1,6315,0,2,6318,T
1-PB2,1260,1,3,0,6311,6315,C
1-PB2,1261,1,1,6317,1,6320,G
1-PB2,1262,0,6315,0,5,6320,T
1-PB2,1263,1,0,0,6320,6321,C
1-PB2,1264,6318,0,2,0,6320,A
1-PB2,1265,6327,0,2,0,6329,A
1-PB2,1266,1,2,0,6330,6333,C
1-PB2,1267,6246,3,0,1,6250,A
1-PB2,1268,0,0,6342,0,6342,G
1-PB2,1269,6303,1,6,1,6311,A
1-PB2,1270,1,2,6321,0,6324,G
1-PB2,1271,1,1,0,6325,6327,C
1-PB2,1272,6311,1,0,0,6312,A
1-PB2,1273,6394,1,2,0,6397,A
1-PB2,1274,6396,0,0,1,6397,A
1-PB2,1275,2,6370,0,2,6374,T
1-PB2,1276,1,13,0,6372,6386,C
1-PB2,1277,6320,1,4,0,6325,A
1-PB2,1278,2,1,6336,0,6339,G
1-PB2,1279,0,2,0,6342,6344,C
1-PB2,1280,3,0,6346,0,6349,G
1-PB2,1281,1,0,6708,1,6710,G
1-PB2,1282,0,6658,1,2,6661,T
1-PB2,1283,1,6658,0,2,6661,T
1-PB2,1284,2,0,6675,0,6677,G
1-PB2,1285,6677,2,8,1,6688,A
1-PB2,1286,6728,1,3,1,6733,A
1-PB2,1287,3,18,1,6759,6781,C
1-PB2,1288,1,2,0,6737,6740,C
1-PB2,1289,5,0,0,6787,6792,C
1-PB2,1290,2,3,0,6541,6546,C
1-PB2,1291,6575,1,2,0,6578,A
1-PB2,1292,0,6591,0,3,6594,T
1-PB2,1293,0,2,6601,0,6603,G
1-PB2,1294,0,4,0,6629,6633,C
1-PB2,1295,6597,2,1,0,6600,A
1-PB2,1296,3,6521,2,19,6545,T
1-PB2,1297,0,1,0,6516,6517,C
1-PB2,1298,6482,2,1,1,6486,A
1-PB2,1299,0,0,6555,0,6555,G
1-PB2,1300,0,0,0,6563,6563,C
1-PB2,1301,2,6518,2,42,6564,T
1-PB2,1302,1,6552,0,0,6553,T
1-PB2,1303,0,6538,0,1,6539,T
1-PB2,1304,1,6542,2,3,6548,T
1-PB2,1305,6548,0,4,0,6552,A
1-PB2,1306,6539,1,2,2,6544,A
1-PB2,1307,1,1,6553,1,6556,G
1-PB2,1308,4,2,6507,0,6513,G
1-PB2,1309,0,2,0,6471,6473,C
1-PB2,1310,6457,0,0,0,6457,A
1-PB2,1311,3,6435,0,4,6442,T
1-PB2,1312,1,6460,0,1,6462,T
1-PB2,1313,0,6465,3,3,6471,T
1-PB2,1314,0,6506,1,0,6507,T
1-PB2,1315,2,2,2,6497,6503,C
1-PB2,1316,6489,2,1,0,6492,A
1-PB2,1317,1,0,6496,0,6497,G
1-PB2,1318,6485,2,2,0,6489,A
1-PB2,1319,6474,0,3,0,6477,A
1-PB2,1320,6453,1,2,0,6456,A
1-PB2,1321,2,0,6468,0,6470,G
1-PB2,1322,6530,1,1,1,6533,A
1-PB2,1323,0,6523,0,3,6526,T
1-PB2,1324,1,1,6518,1,6521,G
1-PB2,1325,1,2,0,6531,6534,C
1-PB2,1326,2,0,6540,1,6543,G
1-PB2,1327,6550,0,0,1,6551,A
1-PB2,1328,6540,2,3,0,6545,A
1-PB2,1329,6540,2,1,0,6543,A
1-PB2,1330,1,1,6551,0,6553,G
1-PB2,1331,0,6488,1,5,6494,T
1-PB2,1332,1,1,6484,0,6486,G
1-PB2,1333,3,2,0,6469,6474,C
1-PB2,1334,1,6474,1,6,6482,T
1-PB2,1335,1,6478,0,1,6480,T
1-PB2,1336,1,6482,1,2,6486,T
1-PB2,1337,0,6487,0,4,6491,T
1-PB2,1338,1,6487,0,2,6490,T
1-PB2,1339,1,0,0,6495,6496,C
1-PB2,1340,6485,0,3,0,6488,A
1-PB2,1341,6496,0,0,1,6497,A
1-PB2,1342,6475,1,2,1,6479,A
1-PB2,1343,6504,0,0,0,6504,A
1-PB2,1344,1,6503,0,1,6505,T
1-PB2,1345,0,6501,0,1,6502,T
1-PB2,1346,1,3,6489,0,6493,G
1-PB2,1347,1,2,6503,0,6506,G
1-PB2,1348,1,0,6500,0,6501,G
1-PB2,1349,1,5,6572,0,6578,G
1-PB2,1350,6545,2,2,0,6549,A
1-PB2,1351,0,0,6673,0,6673,G
1-PB2,1352,0,6648,1,6,6655,T
1-PB2,1353,1,6646,0,0,6647,T
1-PB2,1354,2,0,6666,0,6668,G
1-PB2,1355,6667,0,9,1,6677,A
1-PB2,1356,6678,2,8,0,6688,A
1-PB2,1357,0,1,0,6830,6831,C
1-PB2,1358,6728,1,1,0,6730,A
1-PB2,1359,2,3,0,6880,6885,C
1-PB2,1360,6787,0,3,0,6790,A
1-PB2,1361,3,6807,0,5,6815,T
1-PB2,1362,3,7,0,6825,6835,C
1-PB2,1363,1,3,6823,0,6827,G
1-PB2,1364,6837,0,2,1,6840,A
1-PB2,1365,1,2,0,6836,6839,C
1-PB2,1366,6590,0,0,0,6590,A
1-PB2,1367,0,1,6763,1,6765,G
1-PB2,1368,1,6603,0,9,6613,T
1-PB2,1369,1,1,6712,1,6715,G
1-PB2,1370,0,6674,1,3,6678,T
1-PB2,1371,0,0,6677,0,6677,G
1-PB2,1372,6621,1,57,0,6679,A
1-PB2,1373,1,6639,1,2,6643,T
1-PB2,1374,1,2,6630,0,6633,G
1-PB2,1375,2,1,6621,1,6625,G
1-PB2,1376,1,2,6457,1,6461,G
1-PB2,1377,6405,0,3,0,6408,A
1-PB2,1378,6335,0,3,1,6339,A
1-PB2,1379,2,6321,0,3,6326,T
1-PB2,1380,1,0,6368,0,6369,G
1-PB2,1381,6386,1,1,0,6388,A
1-PB2,1382,1,6379,0,1,6381,T
1-PB2,1383,1,6349,0,1,6351,T
1-PB2,1384,2,0,6313,2,6317,G
1-PB2,1385,2,2,6430,0,6434,G
1-PB2,1386,6412,1,6,0,6419,A
1-PB2,1387,1,0,6464,1,6466,G
1-PB2,1388,0,6393,0,4,6397,T
1-PB2,1389,6333,2,1,0,6336,A
1-PB2,1390,0,6338,1,3,6342,T
1-PB2,1391,0,6385,0,2,6387,T
1-PB2,1392,6448,2,1,1,6452,A
1-PB2,1393,1,4,0,6443,6448,C
1-PB2,1394,0,4,0,6343,6347,C
1-PB2,1395,6287,0,0,1,6288,A
1-PB2,1396,0,1,6311,0,6312,G
1-PB2,1397,6397,1,2,0,6400,A
1-PB2,1398,0,6332,1,0,6333,T
1-PB2,1399,6255,0,1,0,6256,A
1-PB2,1400,1,6191,0,1,6193,T
1-PB2,1401,8,1,6143,0,6152,G
1-PB2,1402,6175,1,1,0,6177,A
1-PB2,1403,0,3,1,6203,6207,C
1-PB2,1404,0,6169,0,5,6174,T
1-PB2,1405,1,0,0,6172,6173,C
1-PB2,1406,1,2,0,6067,6070,C
1-PB2,1407,6091,2,3,1,6097,A
1-PB2,1408,6115,0,1,0,6116,A
1-PB2,1409,1,0,6246,0,6247,G
1-PB2,1410,2,4,2,6187,6195,C
1-PB2,1411,6189,2,1,0,6192,A
1-PB2,1412,2,1,0,6192,6195,C
1-PB2,1413,6118,0,6,0,6124,A
1-PB2,1414,1,0,6148,0,6149,G
1-PB2,1415,6123,2,2,0,6127,A
1-PB2,1416,1,0,6167,1,6169,G
1-PB2,1417,6159,0,1,1,6161,A
1-PB2,1418,1,5973,0,2,5976,T
1-PB2,1419,3,2,6036,0,6041,G
1-PB2,1420,0,6024,1,5,6030,T
1-PB2,1421,0,3,0,6016,6019,C
1-PB2,1422,6019,2,4,0,6025,A
1-PB2,1423,6007,0,0,0,6007,A
1-PB2,1424,3,5992,1,3,5999,T
1-PB2,1425,0,1,5985,1,5987,G
1-PB2,1426,5893,3,0,0,5896,A
1-PB2,1427,1,2,5914,0,5917,G
1-PB2,1428,5817,0,6,0,5823,A
1-PB2,1429,1,1,5832,0,5834,G
1-PB2,1430,0,0,6007,0,6007,G
1-PB2,1431,5994,1,2,1,5998,A
1-PB2,1432,6000,2,3,1,6006,A
1-PB2,1433,1,5997,0,4,6002,T
1-PB2,1434,6002,0,0,0,6002,A
1-PB2,1435,5998,1,0,0,5999,A
1-PB2,1436,1,1,5973,0,5975,G
1-PB2,1437,5956,1,1,0,5958,A
1-PB2,1438,5627,0,1,0,5628,A
1-PB2,1439,0,5621,1,0,5622,T
1-PB2,1440,0,0,0,5651,5651,C
1-PB2,1441,5646,0,6,0,5652,A
1-PB2,1442,1,0,5679,0,5680,G
1-PB2,1443,0,2,0,5679,5681,C
1-PB2,1444,5682,0,2,0,5684,A
1-PB2,1445,5676,2,2,0,5680,A
1-PB2,1446,5671,1,0,0,5672,A
1-PB2,1447,5683,0,2,2,5687,A
1-PB2,1448,0,5685,1,2,5688,T
1-PB2,1449,1,0,5681,1,5683,G
1-PB2,1450,0,2,5674,1,5677,G
1-PB2,1451,1,0,5701,0,5702,G
1-PB2,1452,1,5648,0,4,5653,T
1-PB2,1453,5,2,5660,1,5668,G
1-PB2,1454,0,5651,0,1,5652,T
1-PB2,1455,0,0,5658,1,5659,G
1-PB2,1456,1,2,5708,0,5711,G
1-PB2,1457,5716,0,2,1,5719,A
1-PB2,1458,0,5669,0,4,5673,T
1-PB2,1459,0,0,5704,3,5707,G
1-PB2,1460,5668,1,1,0,5670,A
1-PB2,1461,5677,1,0,0,5678,A
1-PB2,1462,1,5662,0,2,5665,T
1-PB2,1463,5633,1,0,0,5634,A
1-PB2,1464,0,0,1,5961,5962,C
1-PB2,1465,0,5811,0,6,5817,T
1-PB2,1466,0,1,0,5865,5866,C
1-PB2,1467,1,2,1,5859,5863,C
1-PB2,1468,5821,1,0,0,5822,A
1-PB2,1469,2,0,5971,0,5973,G
1-PB2,1470,0,5935,0,0,5935,T
1-PB2,1471,5974,0,1,0,5975,A
1-PB2,1472,2,1,0,5981,5984,C
1-PB2,1473,5317,1,1,1,5320,A
1-PB2,1474,0,1,5330,1,5332,G
1-PB2,1475,5201,0,3,0,5204,A
1-PB2,1476,0,0,5223,0,5223,G
1-PB2,1477,5086,0,5,0,5091,A
1-PB2,1478,1,1,4878,0,4880,G
1-PB2,1479,0,1,4853,0,4854,G
1-PB2,1480,1,1,4855,0,4857,G
1-PB2,1481,1,4803,0,5,4809,T
1-PB2,1482,3,0,4802,0,4805,G
1-PB2,1483,0,0,4813,0,4813,G
1-PB2,1484,0,4759,0,2,4761,T
1-PB2,1485,0,0,4888,0,4888,G
1-PB2,1486,1,0,4890,0,4891,G
1-PB2,1487,0,4776,0,1,4777,T
1-PB2,1488,0,4775,0,1,4776,T
1-PB2,1489,4719,1,1,0,4721,A
1-PB2,1490,1,1,4748,0,4750,G
1-PB2,1491,0,3,0,4738,4741,C
1-PB2,1492,4705,1,1,0,4707,A
1-PB2,1493,1,4701,1,0,4703,T
1-PB2,1494,0,4392,1,0,4393,T
1-PB2,1495,1,0,4393,0,4394,G
1-PB2,1496,4387,1,2,0,4390,A
1-PB2,1497,1,4393,0,2,4396,T
1-PB2,1498,0,1,0,4396,4397,C
1-PB2,1499,1,0,4348,0,4349,G
1-PB2,1500,1,0,4407,0,4408,G
1-PB2,1501,0,4400,0,1,4401,T
1-PB2,1502,0,4392,0,2,4394,T
1-PB2,1503,1,4402,0,1,4404,T
1-PB2,1504,1,4399,0,0,4400,T
1-PB2,1505,0,4403,0,1,4404,T
1-PB2,1506,1,0,4409,0,4410,G
1-PB2,1507,4389,0,7,0,4396,A
1-PB2,1508,0,0,4406,0,4406,G
1-PB2,1509,4258,0,2,1,4261,A
1-PB2,1510,0,0,4279,0,4279,G
1-PB2,1511,2,4271,1,4,4278,T
1-PB2,1512,1,4266,0,1,4268,T
1-PB2,1513,1,1,0,4271,4273,C
1-PB2,1514,1,0,4274,0,4275,G
1-PB2,1515,4277,0,5,0,4282,A
1-PB2,1516,0,2,4275,0,4277,G
1-PB2,1517,4276,0,2,0,4278,A
1-PB2,1518,1,1,0,4262,4264,C
1-PB2,1519,1,1,0,4216,4218,C
1-PB2,1520,4169,0,2,1,4172,A
1-PB2,1521,4193,2,0,1,4196,A
1-PB2,1522,1,0,0,4195,4196,C
1-PB2,1523,0,0,4209,0,4209,G
1-PB2,1524,0,4193,2,0,4195,T
1-PB2,1525,2,1,4190,0,4193,G
1-PB2,1526,0,0,4192,0,4192,G
1-PB2,1527,1,1,4198,0,4200,G
1-PB2,1528,4174,2,3,0,4179,A
1-PB2,1529,4173,1,1,0,4175,A
1-PB2,1530,1,3979,0,3,3983,T
1-PB2,1531,1,0,4088,0,4089,G
1-PB2,1532,3,4069,0,2,4074,T
1-PB2,1533,4067,0,0,0,4067,A
1-PB2,1534,0,4059,0,1,4060,T
1-PB2,1535,0,3991,1,2,3994,T
1-PB2,1536,4028,0,1,0,4029,A
1-PB2,1537,1,3995,0,1,3997,T
1-PB2,1538,0,3935,0,2,3937,T
1-PB2,1539,3930,0,2,0,3932,A
1-PB2,1540,0,3518,2,3,3523,T
1-PB2,1541,0,1,0,3584,3585,C
1-PB2,1542,0,3529,0,3,3532,T
1-PB2,1543,2,0,0,3528,3530,C
1-PB2,1544,0,0,0,3534,3534,C
1-PB2,1545,0,3421,3,1,3425,T
1-PB2,1546,0,0,3433,0,3433,G
1-PB2,1547,3421,1,0,1,3423,A
1-PB2,1548,0,0,3424,0,3424,G
1-PB2,1549,0,0,3423,0,3423,G
1-PB2,1550,2968,1,0,0,2969,A
1-PB2,1551,0,0,2996,0,2996,G
1-PB2,1552,0,0,2970,0,2970,G
1-PB2,1553,0,2899,0,3,2902,T
1-PB2,1554,0,0,0,2906,2906,C
1-PB2,1555,2879,0,0,0,2879,A
1-PB2,1556,0,0,2901,0,2901,G
1-PB2,1557,1,2893,0,1,2895,T
1-PB2,1558,1,0,2892,0,2893,G
1-PB2,1559,2892,0,3,0,2895,A
1-PB2,1560,2755,0,0,0,2755,A
1-PB2,1561,2764,0,2,0,2766,A
1-PB2,1562,0,0,0,2763,2763,C
1-PB2,1563,2724,0,0,0,2724,A
1-PB2,1564,0,0,0,2722,2722,C
1-PB2,1565,2552,0,9,0,2561,A
1-PB2,1566,0,0,2562,0,2562,G
1-PB2,1567,0,1,2548,1,2550,G
1-PB2,1568,1,1,2548,0,2550,G
1-PB2,1569,2536,1,2,1,2540,A
1-PB2,1570,2483,0,2,0,2485,A
1-PB2,1571,0,0,0,2492,2492,C
1-PB2,1572,0,2446,0,0,2446,T
1-PB2,1573,1,0,2442,0,2443,G
1-PB2,1574,2422,2,3,1,2428,A
1-PB2,1575,1,1,2424,1,2427,G
1-PB2,1576,2360,0,0,1,2361,A
1-PB2,1577,0,0,2181,0,2181,G
1-PB2,1578,2168,0,3,0,2171,A
1-PB2,1579,0,0,0,2166,2166,C
1-PB2,1580,0,2064,0,1,2065,T
1-PB2,1581,1,0,2076,0,2077,G
1-PB2,1582,2067,1,3,0,2071,A
1-PB2,1583,0,0,0,2066,2066,C
1-PB2,1584,2055,0,2,0,2057,A
1-PB2,1585,2054,0,0,0,2054,A
1-PB2,1586,0,2047,0,1,2048,T
1-PB2,1587,2030,0,1,0,2031,A
1-PB2,1588,2024,0,1,0,2025,A
1-PB2,1589,1,0,0,2027,2028,C
1-PB2,1590,0,1833,0,0,1833,T
1-PB2,1591,0,1813,0,0,1813,T
1-PB2,1592,1786,0,0,0,1786,A
1-PB2,1593,1,1779,0,0,1780,T
1-PB2,1594,0,1771,0,0,1771,T
1-PB2,1595,2,0,0,1771,1773,C
1-PB2,1596,1654,0,0,0,1654,A
1-PB2,1597,0,1649,0,0,1649,T
1-PB2,1598,0,0,0,1556,1556,C
1-PB2,1599,0,0,1558,0,1558,G
1-PB2,1600,0,1548,0,1,1549,T
1-PB2,1601,0,0,0,1540,1540,C
1-PB2,1602,1,1512,0,0,1513,T
1-PB2,1603,1531,0,2,0,1533,A
1-PB2,1604,1,1532,0,1,1534,T
1-PB2,1605,0,0,1533,0,1533,G
1-PB2,1606,1522,0,0,0,1522,A
1-PB2,1607,0,1465,0,0,1465,T
1-PB2,1608,0,0,1347,0,1347,G
1-PB2,1609,0,913,0,1,914,T
1-PB2,1610,0,1,897,1,899,G
1-PB2,1611,0,0,896,0,896,G
1-PB2,1612,2,0,880,0,882,G
1-PB2,1613,826,0,0,0,826,A
1-PB2,1614,0,0,812,0,812,G
1-PB2,1615,702,0,0,0,702,A
1-PB2,1616,0,684,0,0,684,T
1-PB2,1617,0,623,0,0,623,T
1-PB2,1618,613,0,0,0,613,A
1-PB2,1619,609,0,1,0,610,A
1-PB2,1620,0,0,0,597,597,C
1-PB2,1621,1,0,483,0,484,G
1-PB2,1622,0,0,461,0,461,G
1-PB2,1623,0,296,0,0,296,T
1-PB2,1624,1,1,0,280,282,C
1-PB2,1625,0,0,0,278,278,C
1-PB2,1626,0,240,0,0,240,T
1-PB2,1627,0,0,243,0,243,G
1-PB2,1628,243,0,0,0,243,A
1-PB2,1629,0,0,247,0,247,G
1-PB2,1630,0,247,0,0,247,T
1-PB2,1631,0,0,0,237,237,C
1-PB2,1632,0,0,236,0,236,G
1-PB2,1633,0,0,238,0,238,G
1-PB2,1634,0,238,0,0,238,T
1-PB2,1635,0,238,0,0,238,T
1-PB2,1636,0,0,0,233,233,C
1-PB2,1637,0,236,0,0,236,T
1-PB2,1638,0,0,247,0,247,G
1-PB2,1639,0,0,247,0,247,G
1-PB2,1640,1,247,0,0,248,T
1-PB2,1641,0,0,0,247,247,C
1-PB2,1642,238,0,0,0,238,A
1-PB2,1643,245,0,0,0,245,A
1-PB2,1644,0,246,0,0,246,T
1-PB2,1645,244,0,0,0,244,A
1-PB2,1646,1,0,0,248,249,C
1-PB2,1647,0,0,0,242,242,C
1-PB2,1648,1,242,0,0,243,T
1-PB2,1649,243,0,0,0,243,A
1-PB2,1650,0,243,0,0,243,T
1-PB2,1651,0,0,0,242,242,C
1-PB2,1652,234,0,0,0,234,A
1-PB2,1653,233,0,0,0,233,A
1-PB2,1654,0,234,0,0,234,T
1-PB2,1655,0,0,226,0,226,G
1-PB2,1656,0,0,226,0,226,G
1-PB2,1657,226,0,0,0,226,A
1-PB2,1658,0,219,0,0,219,T
1-PB2,1659,0,0,0,220,220,C
1-PB2,1660,223,0,0,0,223,A
1-PB2,1661,0,222,0,0,222,T
1-PB2,1662,0,0,0,221,221,C
1-PB2,1663,222,0,0,0,222,A
1-PB2,1664,0,0,221,0,221,G
1-PB2,1665,224,0,0,0,224,A
1-PB2,1666,222,0,0,0,222,A
1-PB2,1667,223,0,0,0,223,A
1-PB2,1668,0,224,0,0,224,T
1-PB2,1669,0,223,0,0,223,T
1-PB2,1670,0,0,221,0,221,G
1-PB2,1671,0,1,223,0,224,G
1-PB2,1672,0,0,223,0,223,G
1-PB2,1673,221,0,0,0,221,A
1-PB2,1674,221,0,0,0,221,A
1-PB2,1675,0,0,221,0,221,G
1-PB2,1676,0,0,0,222,222,C
1-PB2,1677,0,220,0,0,220,T
1-PB2,1678,222,0,0,0,222,A
1-PB2,1679,1,222,0,0,223,T
1-PB2,1680,0,0,0,222,222,C
1-PB2,1681,222,0,0,0,222,A
1-PB2,1682,223,0,0,0,223,A
1-PB2,1683,224,0,0,0,224,A
1-PB2,1684,226,0,0,0,226,A
1-PB2,1685,0,226,0,0,226,T
1-PB2,1686,0,224,0,0,224,T
1-PB2,1687,0,1,0,221,222,C
1-PB2,1688,223,0,0,0,223,A
1-PB2,1689,223,0,0,0,223,A
1-PB2,1690,0,223,0,0,223,T
1-PB2,1691,0,0,225,0,225,G
1-PB2,1692,0,0,227,0,227,G
1-PB2,1693,0,233,0,0,233,T
1-PB2,1694,0,0,0,232,232,C
1-PB2,1695,0,233,0,0,233,T
1-PB2,1696,0,0,0,232,232,C
1-PB2,1697,232,0,1,0,233,A
1-PB2,1698,0,0,233,0,233,G
1-PB2,1699,233,0,0,0,233,A
1-PB2,1700,231,0,0,0,231,A
1-PB2,1701,0,228,0,0,228,T
1-PB2,1702,0,0,0,221,221,C
1-PB2,1703,0,0,0,223,223,C
1-PB2,1704,0,224,0,0,224,T
1-PB2,1705,0,0,223,0,223,G
1-PB2,1706,0,0,0,222,222,C
1-PB2,1707,222,0,0,0,222,A
1-PB2,1708,227,0,0,0,227,A
1-PB2,1709,0,226,0,0,226,T
1-PB2,1710,0,0,229,0,229,G
1-PB2,1711,0,228,0,0,228,T
1-PB2,1712,0,220,0,0,220,T
1-PB2,1713,1,0,220,0,221,G
1-PB2,1714,0,223,0,0,223,T
1-PB2,1715,222,0,1,0,223,A
1-PB2,1716,0,0,0,223,223,C
1-PB2,1717,219,0,0,0,219,A
1-PB2,1718,221,0,0,0,221,A
1-PB2,1719,0,0,0,219,219,C
1-PB2,1720,213,0,0,0,213,A
1-PB2,1721,213,0,0,0,213,A
1-PB2,1722,213,0,0,0,213,A
1-PB2,1723,212,0,0,0,212,A
1-PB2,1724,0,212,0,0,212,T
1-PB2,1725,0,0,213,0,213,G
1-PB2,1726,0,0,213,0,213,G
1-PB2,1727,214,0,0,0,214,A
1-PB2,1728,214,0,0,0,214,A
1-PB2,1729,0,213,0,1,214,T
1-PB2,1730,0,211,0,0,211,T
1-PB2,1731,0,214,0,0,214,T
1-PB2,1732,0,0,212,0,212,G
1-PB2,1733,212,0,1,0,213,A
1-PB2,1734,213,0,1,0,214,A
1-PB2,1735,0,0,0,214,214,C
1-PB2,1736,0,1,0,213,214,C
1-PB2,1737,214,0,0,0,214,A
1-PB2,1738,0,217,0,0,217,T
1-PB2,1739,0,216,0,0,216,T
1-PB2,1740,0,217,0,0,217,T
1-PB2,1741,0,0,0,217,217,C
1-PB2,1742,216,0,0,0,216,A
1-PB2,1743,217,0,0,0,217,A
1-PB2,1744,0,215,0,0,215,T
1-PB2,1745,0,0,0,222,222,C
1-PB2,1746,0,221,0,0,221,T
1-PB2,1747,0,223,0,0,223,T
1-PB2,1748,0,224,0,0,224,T
1-PB2,1749,224,0,0,0,224,A
1-PB2,1750,0,0,226,0,226,G
1-PB2,1751,0,224,0,0,224,T
1-PB2,1752,0,0,0,229,229,C
1-PB2,1753,0,0,0,230,230,C
1-PB2,1754,0,0,0,226,226,C
1-PB2,1755,0,0,0,226,226,C
1-PB2,1756,229,0,0,0,229,A
1-PB2,1757,228,0,0,0,228,A
1-PB2,1758,0,0,234,0,234,G
1-PB2,1759,0,0,233,0,233,G
1-PB2,1760,0,0,0,235,235,C
1-PB2,1761,0,0,0,231,231,C
1-PB2,1762,231,0,0,0,231,A
1-PB2,1763,0,234,0,0,234,T
1-PB2,1764,0,233,0,0,233,T
1-PB2,1765,234,0,0,0,234,A
1-PB2,1766,0,0,233,0,233,G
1-PB2,1767,228,0,0,0,228,A
1-PB2,1768,233,0,0,0,233,A
1-PB2,1769,0,0,237,0,237,G
1-PB2,1770,0,0,0,239,239,C
1-PB2,1771,1,0,0,235,236,C
1-PB2,1772,236,0,1,0,237,A
1-PB2,1773,239,0,0,0,239,A
1-PB2,1774,0,240,0,1,241,T
1-PB2,1775,241,0,0,0,241,A
1-PB2,1776,0,0,0,240,240,C
1-PB2,1777,218,0,0,0,218,A
1-PB2,1778,1,0,218,0,219,G
1-PB2,1779,0,215,0,0,215,T
1-PB2,1780,0,0,216,0,216,G
1-PB2,1781,0,0,216,0,216,G
1-PB2,1782,0,1,217,0,218,G
1-PB2,1783,0,216,0,0,216,T
1-PB2,1784,0,214,0,0,214,T
1-PB2,1785,0,217,0,0,217,T
1-PB2,1786,1,0,219,0,220,G
1-PB2,1787,0,219,0,0,219,T
1-PB2,1788,0,0,0,218,218,C
1-PB2,1789,215,0,0,0,215,A
1-PB2,1790,0,0,216,0,216,G
1-PB2,1791,213,0,0,0,213,A
1-PB2,1792,213,0,0,0,213,A
1-PB2,1793,0,0,0,214,214,C
1-PB2,1794,0,205,0,0,205,T
1-PB2,1795,0,0,0,208,208,C
1-PB2,1796,0,209,0,0,209,T
1-PB2,1797,208,0,0,0,208,A
1-PB2,1798,0,209,0,0,209,T
1-PB2,1799,0,209,0,0,209,T
1-PB2,1800,0,0,0,209,209,C
1-PB2,1801,0,0,0,207,207,C
1-PB2,1802,203,0,1,0,204,A
1-PB2,1803,206,0,0,0,206,A
1-PB2,1804,0,0,0,204,204,C
1-PB2,1805,203,0,0,0,203,A
1-PB2,1806,202,0,0,0,202,A
1-PB2,1807,203,0,0,0,203,A
1-PB2,1808,0,203,0,0,203,T
1-PB2,1809,0,0,201,0,201,G
1-PB2,1810,199,0,0,0,199,A
1-PB2,1811,0,0,200,0,200,G
1-PB2,1812,199,0,0,0,199,A
1-PB2,1813,0,0,198,0,198,G
1-PB2,1814,198,0,0,0,198,A
1-PB2,1815,0,0,0,194,194,C
1-PB2,1816,0,0,198,0,198,G
1-PB2,1817,0,200,0,0,200,T
1-PB2,1818,202,0,0,0,202,A
1-PB2,1819,0,0,0,202,202,C
1-PB2,1820,0,197,0,0,197,T
1-PB2,1821,0,200,0,0,200,T
1-PB2,1822,0,0,199,0,199,G
1-PB2,1823,0,0,198,0,198,G
1-PB2,1824,0,0,197,0,197,G
1-PB2,1825,196,0,1,0,197,A
1-PB2,1826,0,0,0,197,197,C
1-PB2,1827,196,0,0,0,196,A
1-PB2,1828,0,199,0,0,199,T
1-PB2,1829,0,198,0,1,199,T
1-PB2,1830,0,199,0,0,199,T
1-PB2,1831,0,0,201,0,201,G
1-PB2,1832,199,0,0,0,199,A
1-PB2,1833,0,0,0,199,199,C
1-PB2,1834,201,0,0,0,201,A
1-PB2,1835,0,0,0,200,200,C
1-PB2,1836,0,0,0,203,203,C
1-PB2,1837,204,0,0,0,204,A
1-PB2,1838,0,0,0,203,203,C
1-PB2,1839,0,0,0,205,205,C
1-PB2,1840,0,0,0,205,205,C
1-PB2,1841,202,0,0,0,202,A
1-PB2,1842,0,0,205,0,205,G
1-PB2,1843,204,0,0,0,204,A
1-PB2,1844,0,210,0,0,210,T
1-PB2,1845,206,0,0,0,206,A
1-PB2,1846,201,0,0,0,201,A
1-PB2,1847,0,199,0,0,199,T
1-PB2,1848,198,0,0,0,198,A
1-PB2,1849,198,0,0,0,198,A
1-PB2,1850,197,0,0,0,197,A
1-PB2,1851,0,0,197,0,197,G
1-PB2,1852,0,0,0,195,195,C
1-PB2,1853,0,183,0,0,183,T
1-PB2,1854,0,184,0,0,184,T
1-PB2,1855,0,0,0,183,183,C
1-PB2,1856,0,181,0,1,182,T
1-PB2,1857,0,0,0,187,187,C
1-PB2,1858,0,0,0,187,187,C
1-PB2,1859,0,0,0,187,187,C
1-PB2,1860,0,184,0,0,184,T
1-PB2,1861,0,184,0,0,184,T
1-PB2,1862,0,184,0,0,184,T
1-PB2,1863,0,183,0,0,183,T
1-PB2,1864,0,0,183,0,183,G
1-PB2,1865,0,0,0,185,185,C
1-PB2,1866,185,0,0,0,185,A
1-PB2,1867,0,0,185,0,185,G
1-PB2,1868,0,0,0,184,184,C
1-PB2,1869,0,181,0,0,181,T
1-PB2,1870,0,0,184,0,184,G
1-PB2,1871,0,0,0,182,182,C
1-PB2,1872,0,182,0,0,182,T
1-PB2,1873,0,0,0,183,183,C
1-PB2,1874,0,0,0,184,184,C
1-PB2,1875,184,0,0,0,184,A
1-PB2,1876,0,0,0,183,183,C
1-PB2,1877,0,0,0,183,183,C
1-PB2,1878,182,0,0,0,182,A
1-PB2,1879,183,0,0,0,183,A
1-PB2,1880,181,0,0,0,181,A
1-PB2,1881,0,0,185,0,185,G
1-PB2,1882,0,0,0,185,185,C
1-PB2,1883,182,0,0,0,182,A
1-PB2,1884,182,0,0,0,182,A
1-PB2,1885,182,0,0,0,182,A
1-PB2,1886,0,0,184,0,184,G
1-PB2,1887,0,0,0,184,184,C
1-PB2,1888,182,0,0,0,182,A
1-PB2,1889,0,0,185,0,185,G
1-PB2,1890,184,0,0,0,184,A
1-PB2,1891,191,0,0,0,191,A
1-PB2,1892,0,191,0,0,191,T
1-PB2,1893,0,0,191,0,191,G
1-PB2,1894,0,0,0,190,190,C
1-PB2,1895,187,0,0,0,187,A
1-PB2,1896,0,0,188,0,188,G
1-PB2,1897,0,187,0,0,187,T
1-PB2,1898,0,192,0,1,193,T
1-PB2,1899,1,0,0,192,193,C
1-PB2,1900,0,190,0,0,190,T
1-PB2,1901,0,0,0,191,191,C
1-PB2,1902,0,192,0,0,192,T
1-PB2,1903,1,190,0,0,191,T
1-PB2,1904,0,0,0,190,190,C
1-PB2,1905,188,0,0,0,188,A
1-PB2,1906,0,0,0,187,187,C
1-PB2,1907,0,178,0,1,179,T
1-PB2,1908,0,0,182,0,182,G
1-PB2,1909,180,0,0,0,180,A
1-PB2,1910,0,0,0,177,177,C
1-PB2,1911,0,177,0,0,177,T
1-PB2,1912,0,0,179,0,179,G
1-PB2,1913,0,177,0,0,177,T
1-PB2,1914,0,0,179,0,179,G
1-PB2,1915,179,0,0,0,179,A
1-PB2,1916,178,0,1,0,179,A
1-PB2,1917,0,176,0,0,176,T
1-PB2,1918,0,0,177,0,177,G
1-PB2,1919,0,177,0,0,177,T
1-PB2,1920,0,0,178,0,178,G
1-PB2,1921,173,0,0,0,173,A
1-PB2,1922,0,0,174,0,174,G
1-PB2,1923,0,0,173,0,173,G
1-PB2,1924,0,0,172,0,172,G
1-PB2,1925,0,0,177,0,177,G
1-PB2,1926,174,0,0,0,174,A
1-PB2,1927,0,174,0,0,174,T
1-PB2,1928,0,0,0,174,174,C
1-PB2,1929,173,0,0,0,173,A
1-PB2,1930,0,0,174,0,174,G
1-PB2,1931,0,0,177,0,177,G
1-PB2,1932,0,0,174,0,174,G
1-PB2,1933,174,0,0,0,174,A
1-PB2,1934,0,162,0,0,162,T
1-PB2,1935,0,0,164,0,164,G
1-PB2,1936,163,0,0,0,163,A
1-PB2,1937,0,0,170,0,170,G
1-PB2,1938,169,0,0,0,169,A
1-PB2,1939,163,0,0,0,163,A
1-PB2,1940,0,164,0,0,164,T
1-PB2,1941,164,0,0,0,164,A
1-PB2,1942,0,0,0,166,166,C
1-PB2,1943,0,163,0,1,164,T
1-PB2,1944,0,163,0,0,163,T
1-PB2,1945,0,0,163,0,163,G
1-PB2,1946,0,157,0,0,157,T
1-PB2,1947,158,0,0,0,158,A
1-PB2,1948,157,0,0,0,157,A
1-PB2,1949,0,0,154,0,154,G
1-PB2,1950,0,0,155,0,155,G
1-PB2,1951,0,0,150,0,150,G
1-PB2,1952,0,0,151,0,151,G
1-PB2,1953,0,0,0,153,153,C
1-PB2,1954,153,0,0,0,153,A
1-PB2,1955,158,0,0,0,158,A
1-PB2,1956,0,157,0,0,157,T
1-PB2,1957,0,158,0,0,158,T
1-PB2,1958,0,0,0,157,157,C
1-PB2,1959,0,157,0,0,157,T
1-PB2,1960,0,0,0,160,160,C
1-PB2,1961,0,0,0,160,160,C
1-PB2,1962,0,161,0,0,161,T
1-PB2,1963,0,0,167,0,167,G
1-PB2,1964,0,164,0,0,164,T
1-PB2,1965,164,0,0,0,164,A
1-PB2,1966,0,166,0,0,166,T
1-PB2,1967,0,164,0,0,164,T
1-PB2,1968,0,0,0,164,164,C
1-PB2,1969,160,1,0,0,161,A
1-PB2,1970,162,0,0,0,162,A
1-PB2,1971,0,0,0,164,164,C
1-PB2,1972,0,160,0,0,160,T
1-PB2,1973,159,1,0,0,160,A
1-PB2,1974,0,0,0,166,166,C
1-PB2,1975,166,0,0,0,166,A
1-PB2,1976,166,0,0,0,166,A
1-PB2,1977,0,0,0,164,164,C
1-PB2,1978,163,0,0,0,163,A
1-PB2,1979,159,0,0,0,159,A
1-PB2,1980,0,0,161,0,161,G
1-PB2,1981,161,0,0,0,161,A
1-PB2,1982,0,0,0,161,161,C
1-PB2,1983,0,0,0,159,159,C
1-PB2,1984,159,0,0,0,159,A
1-PB2,1985,0,0,0,163,163,C
1-PB2,1986,0,163,0,0,163,T
1-PB2,1987,163,0,0,0,163,A
1-PB2,1988,163,0,0,0,163,A
1-PB2,1989,163,0,0,0,163,A
1-PB2,1990,163,0,0,0,163,A
1-PB2,1991,0,0,165,0,165,G
1-PB2,1992,164,0,0,0,164,A
1-PB2,1993,0,0,0,165,165,C
1-PB2,1994,0,158,0,0,158,T
1-PB2,1995,158,0,0,0,158,A
1-PB2,1996,158,0,0,0,158,A
1-PB2,1997,0,0,0,157,157,C
1-PB2,1998,157,0,0,0,157,A
1-PB2,1999,159,0,0,0,159,A
1-PB2,2000,0,157,0,0,157,T
1-PB2,2001,0,155,0,0,155,T
1-PB2,2002,0,0,0,157,157,C
1-PB2,2003,0,152,0,0,152,T
1-PB2,2004,0,0,0,156,156,C
1-PB2,2005,0,0,157,0,157,G
1-PB2,2006,0,0,157,0,157,G
1-PB2,2007,157,0,0,0,157,A
1-PB2,2008,157,0,0,0,157,A
1-PB2,2009,157,0,0,0,157,A
1-PB2,2010,156,0,0,0,156,A
1-PB2,2011,0,0,156,0,156,G
1-PB2,2012,156,0,0,0,156,A
1-PB2,2013,0,156,0,0,156,T
1-PB2,2014,0,0,156,0,156,G
1-PB2,2015,0,0,0,155,155,C
1-PB2,2016,0,0,0,155,155,C
1-PB2,2017,0,0,155,0,155,G
1-PB2,2018,0,0,155,0,155,G
1-PB2,2019,0,0,0,153,153,C
1-PB2,2020,154,0,0,0,154,A
1-PB2,2021,0,0,0,158,158,C
1-PB2,2022,0,157,0,0,157,T
1-PB2,2023,0,157,0,0,157,T
1-PB2,2024,0,158,0,0,158,T
1-PB2,2025,157,0,0,0,157,A
1-PB2,2026,159,0,0,0,159,A
1-PB2,2027,0,158,0,0,158,T
1-PB2,2028,0,156,0,1,157,T
1-PB2,2029,0,0,157,0,157,G
1-PB2,2030,153,0,0,0,153,A
1-PB2,2031,154,0,0,0,154,A
1-PB2,2032,0,0,155,0,155,G
1-PB2,2033,156,0,0,0,156,A
1-PB2,2034,0,0,0,156,156,C
1-PB2,2035,0,0,0,157,157,C
1-PB2,2036,0,0,0,157,157,C
1-PB2,2037,158,0,0,0,158,A
1-PB2,2038,0,0,161,0,161,G
1-PB2,2039,157,0,1,0,158,A
1-PB2,2040,0,160,0,0,160,T
1-PB2,2041,0,0,158,0,158,G
1-PB2,2042,156,0,0,0,156,A
1-PB2,2043,155,0,0,0,155,A
1-PB2,2044,156,0,1,0,157,A
1-PB2,2045,0,0,159,0,159,G
1-PB2,2046,0,0,0,158,158,C
1-PB2,2047,158,0,0,0,158,A
1-PB2,2048,0,0,0,160,160,C
1-PB2,2049,159,0,0,0,159,A
1-PB2,2050,0,156,0,1,157,T
1-PB2,2051,0,0,1,159,160,C
1-PB2,2052,0,0,0,162,162,C
1-PB2,2053,0,0,163,0,163,G
1-PB2,2054,0,0,163,0,163,G
1-PB2,2055,161,0,0,0,161,A
1-PB2,2056,0,0,166,0,166,G
1-PB2,2057,0,162,0,0,162,T
1-PB2,2058,0,0,164,0,164,G
1-PB2,2059,0,0,164,0,164,G
1-PB2,2060,163,0,0,0,163,A
1-PB2,2061,156,0,0,0,156,A
1-PB2,2062,0,156,1,0,157,T
1-PB2,2063,0,0,0,157,157,C
1-PB2,2064,0,0,0,158,158,C
1-PB2,2065,0,0,158,0,158,G
1-PB2,2066,0,0,0,158,158,C
1-PB2,2067,157,0,0,0,157,A
1-PB2,2068,0,0,165,0,165,G
1-PB2,2069,0,164,0,0,164,T
1-PB2,2070,0,0,0,167,167,C
1-PB2,2071,0,166,0,0,166,T
1-PB2,2072,0,166,0,0,166,T
1-PB2,2073,1,0,163,0,164,G
1-PB2,2074,166,0,0,0,166,A
1-PB2,2075,0,0,166,0,166,G
1-PB2,2076,165,0,0,0,165,A
1-PB2,2077,0,0,157,0,157,G
1-PB2,2078,0,0,158,0,158,G
1-PB2,2079,0,0,158,0,158,G
1-PB2,2080,0,155,0,0,155,T
1-PB2,2081,0,155,0,0,155,T
1-PB2,2082,0,156,0,0,156,T
1-PB2,2083,0,0,0,156,156,C
1-PB2,2084,0,154,0,0,154,T
1-PB2,2085,0,0,0,160,160,C
1-PB2,2086,162,0,0,0,162,A
1-PB2,2087,0,160,0,0,160,T
1-PB2,2088,0,159,0,0,159,T
1-PB2,2089,157,0,0,0,157,A
1-PB2,2090,0,159,0,0,159,T
1-PB2,2091,156,0,0,0,156,A
1-PB2,2092,0,0,157,0,157,G
1-PB2,2093,0,0,156,0,156,G
1-PB2,2094,1,148,0,0,149,T
1-PB2,2095,147,0,0,0,147,A
1-PB2,2096,148,0,0,0,148,A
1-PB2,2097,0,0,147,0,147,G
1-PB2,2098,0,0,147,0,147,G
1-PB2,2099,145,0,0,0,145,A
1-PB2,2100,138,0,0,0,138,A
1-PB2,2101,0,0,139,0,139,G
1-PB2,2102,136,0,0,0,136,A
1-PB2,2103,0,0,0,138,138,C
1-PB2,2104,135,0,0,0,135,A
1-PB2,2105,0,0,135,0,135,G
1-PB2,2106,135,0,0,0,135,A
1-PB2,2107,134,0,0,0,134,A
1-PB2,2108,0,0,134,0,134,G
1-PB2,2109,0,0,129,0,129,G
1-PB2,2110,0,140,0,0,140,T
1-PB2,2111,140,0,0,0,140,A
1-PB2,2112,0,0,0,140,140,C
1-PB2,2113,0,0,139,0,139,G
1-PB2,2114,0,0,142,0,142,G
1-PB2,2115,144,0,0,0,144,A
1-PB2,2116,0,0,0,140,140,C
1-PB2,2117,0,0,0,141,141,C
1-PB2,2118,135,0,0,0,135,A
1-PB2,2119,0,0,143,0,143,G
1-PB2,2120,0,0,0,142,142,C
1-PB2,2121,143,0,0,0,143,A
1-PB2,2122,0,144,0,0,144,T
1-PB2,2123,0,139,0,0,139,T
1-PB2,2124,138,0,0,0,138,A
1-PB2,2125,139,0,0,0,139,A
1-PB2,2126,1,0,138,0,139,G
1-PB2,2127,0,0,0,138,138,C
1-PB2,2128,128,0,0,0,128,A
1-PB2,2129,0,133,0,0,133,T
1-PB2,2130,0,0,0,132,132,C
1-PB2,2131,133,0,0,0,133,A
1-PB2,2132,133,0,0,0,133,A
1-PB2,2133,0,133,0,0,133,T
1-PB2,2134,0,0,133,0,133,G
1-PB2,2135,132,0,0,0,132,A
1-PB2,2136,131,0,0,0,131,A
1-PB2,2137,0,0,0,131,131,C
1-PB2,2138,0,127,0,0,127,T
1-PB2,2139,0,0,128,0,128,G
1-PB2,2140,125,0,0,0,125,A
1-PB2,2141,0,0,127,0,127,G
1-PB2,2142,0,0,0,126,126,C
1-PB2,2143,126,0,0,0,126,A
1-PB2,2144,129,0,0,0,129,A
1-PB2,2145,0,0,0,129,129,C
1-PB2,2146,0,0,0,126,126,C
1-PB2,2147,0,126,0,0,126,T
1-PB2,2148,0,123,0,0,123,T
1-PB2,2149,0,0,123,0,123,G
1-PB2,2150,0,0,0,123,123,C
1-PB2,2151,122,0,0,0,122,A
1-PB2,2152,123,0,0,0,123,A
1-PB2,2153,117,0,0,0,117,A
1-PB2,2154,116,0,0,0,116,A
1-PB2,2155,0,0,115,0,115,G
1-PB2,2156,0,0,116,0,116,G
1-PB2,2157,0,0,116,0,116,G
1-PB2,2158,0,0,116,0,116,G
1-PB2,2159,115,0,0,0,115,A
1-PB2,2160,116,0,0,0,116,A
1-PB2,2161,116,0,0,0,116,A
1-PB2,2162,117,0,0,0,117,A
1-PB2,2163,0,0,118,0,118,G
1-PB2,2164,0,0,117,0,117,G
1-PB2,2165,0,0,0,117,117,C
1-PB2,2166,0,116,0,0,116,T
1-PB2,2167,115,0,0,0,115,A
1-PB2,2168,115,0,0,0,115,A
1-PB2,2169,0,115,0,0,115,T
1-PB2,2170,0,0,114,0,114,G
1-PB2,2171,0,114,0,0,114,T
1-PB2,2172,0,0,112,0,112,G
1-PB2,2173,0,0,0,112,112,C
1-PB2,2174,0,113,0,0,113,T
1-PB2,2175,114,0,0,0,114,A
1-PB2,2176,114,0,0,0,114,A
1-PB2,2177,0,114,0,0,114,T
1-PB2,2178,0,0,0,113,113,C
1-PB2,2179,1,0,106,0,107,G
1-PB2,2180,0,0,107,0,107,G
1-PB2,2181,0,0,108,0,108,G
1-PB2,2182,0,1,0,108,109,C
1-PB2,2183,107,0,0,0,107,A
1-PB2,2184,107,0,0,0,107,A
1-PB2,2185,0,0,106,0,106,G
1-PB2,2186,0,0,107,0,107,G
1-PB2,2187,107,0,0,0,107,A
1-PB2,2188,0,0,106,0,106,G
1-PB2,2189,102,0,0,0,102,A
1-PB2,2190,0,0,0,100,100,C
1-PB2,2191,0,0,100,0,100,G
1-PB2,2192,0,98,0,0,98,T
1-PB2,2193,0,0,100,0,100,G
1-PB2,2194,0,0,100,0,100,G
1-PB2,2195,0,96,0,0,96,T
1-PB2,2196,0,0,96,0,96,G
1-PB2,2197,0,95,0,0,95,T
1-PB2,2198,0,95,0,0,95,T
1-PB2,2199,0,0,96,0,96,G
1-PB2,2200,1,0,95,0,96,G
1-PB2,2201,0,94,0,0,94,T
1-PB2,2202,91,0,0,0,91,A
1-PB2,2203,91,0,0,0,91,A
1-PB2,2204,0,86,0,0,86,T
1-PB2,2205,0,0,85,0,85,G
1-PB2,2206,84,0,0,0,84,A
1-PB2,2207,83,0,0,0,83,A
1-PB2,2208,83,0,0,0,83,A
1-PB2,2209,0,0,0,83,83,C
1-PB2,2210,0,0,83,0,83,G
1-PB2,2211,83,0,0,0,83,A
1-PB2,2212,83,0,0,0,83,A
1-PB2,2213,81,0,0,0,81,A
1-PB2,2214,83,0,0,0,83,A
1-PB2,2215,0,0,0,83,83,C
1-PB2,2216,0,0,82,0,82,G
1-PB2,2217,0,0,83,0,83,G
1-PB2,2218,0,0,82,0,82,G
1-PB2,2219,83,0,0,0,83,A
1-PB2,2220,0,0,0,83,83,C
1-PB2,2221,0,83,0,0,83,T
1-PB2,2222,0,0,0,84,84,C
1-PB2,2223,0,84,0,0,84,T
1-PB2,2224,84,0,0,0,84,A
1-PB2,2225,0,0,84,0,84,G
1-PB2,2226,0,0,0,83,83,C
1-PB2,2227,82,0,0,0,82,A
1-PB2,2228,0,82,0,0,82,T
1-PB2,2229,81,0,0,0,81,A
1-PB2,2230,0,0,0,81,81,C
1-PB2,2231,0,69,0,0,69,T
1-PB2,2232,0,69,0,0,69,T
1-PB2,2233,68,0,0,0,68,A
1-PB2,2234,0,0,0,67,67,C
1-PB2,2235,0,65,0,0,65,T
1-PB2,2236,0,0,64,0,64,G
1-PB2,2237,64,0,0,0,64,A
1-PB2,2238,0,0,0,63,63,C
1-PB2,2239,58,0,0,0,58,A
1-PB2,2240,0,0,59,0,59,G
1-PB2,2241,0,0,0,59,59,C
1-PB2,2242,0,0,0,58,58,C
1-PB2,2243,57,0,0,0,57,A
1-PB2,2244,0,0,57,0,57,G
1-PB2,2245,55,0,1,0,56,A
1-PB2,2246,0,0,0,56,56,C
1-PB2,2247,52,0,0,0,52,A
1-PB2,2248,0,0,51,0,51,G
1-PB2,2249,0,0,0,50,50,C
1-PB2,2250,0,0,50,0,50,G
1-PB2,2251,50,0,0,0,50,A
1-PB2,2252,0,0,0,49,49,C
1-PB2,2253,0,0,0,47,47,C
1-PB2,2254,47,0,0,0,47,A
1-PB2,2255,47,0,0,0,47,A
1-PB2,2256,47,0,0,0,47,A
1-PB2,2257,46,0,0,0,46,A
1-PB2,2258,0,0,47,0,47,G
1-PB2,2259,45,0,0,0,45,A
1-PB2,2260,45,0,0,0,45,A
1-PB2,2261,0,44,0,0,44,T
1-PB2,2262,0,45,0,0,45,T
1-PB2,2263,0,0,0,45,45,C
1-PB2,2264,0,0,45,0,45,G
1-PB2,2265,0,0,45,0,45,G
1-PB2,2266,45,0,0,0,45,A
1-PB2,2267,0,43,0,0,43,T
1-PB2,2268,0,0,43,0,43,G
1-PB2,2269,0,0,41,0,41,G
1-PB2,2270,0,0,0,42,42,C
1-PB2,2271,0,0,0,42,42,C
1-PB2,2272,42,0,0,0,42,A
1-PB2,2273,0,42,0,0,42,T
1-PB2,2274,0,0,0,42,42,C
1-PB2,2275,42,0,0,0,42,A
1-PB2,2276,42,0,0,0,42,A
1-PB2,2277,0,42,0,0,42,T
1-PB2,2278,0,41,0,0,41,T
1-PB2,2279,39,0,0,0,39,A
1-PB2,2280,37,0,0,0,37,A
2-PB1,1,395,0,0,0,395,A
2-PB1,2,0,397,0,0,397,T
2-PB1,3,0,0,406,0,406,G
2-PB1,4,0,0,438,0,438,G
2-PB1,5,491,0,0,0,491,A
2-PB1,6,0,534,0,0,534,T
2-PB1,7,0,0,539,0,539,G
2-PB1,8,1,538,0,1,540,T
2-PB1,9,0,1,0,561,562,C
2-PB1,10,565,0,0,0,565,A
2-PB1,11,582,0,0,0,582,A
2-PB1,12,0,581,0,0,581,T
2-PB1,13,0,0,0,584,584,C
2-PB1,14,0,0,0,635,635,C
2-PB1,15,1,0,649,0,650,G
2-PB1,16,739,0,1,0,740,A
2-PB1,17,0,1,0,752,753,C
2-PB1,18,0,754,0,1,755,T
2-PB1,19,0,0,0,863,863,C
2-PB1,20,0,864,0,0,864,T
2-PB1,21,872,0,0,0,872,A
2-PB1,22,1,0,0,875,876,C
2-PB1,23,0,875,0,1,876,T
2-PB1,24,0,0,998,0,998,G
2-PB1,25,0,1012,0,0,1012,T
2-PB1,26,0,1012,0,1,1013,T
2-PB1,27,0,0,0,1010,1010,C
2-PB1,28,0,0,0,1012,1012,C
2-PB1,29,0,1162,0,1,1163,T
2-PB1,30,1168,0,0,0,1168,A
2-PB1,31,1167,0,0,0,1167,A
2-PB1,32,1184,0,0,0,1184,A
2-PB1,33,0,0,1187,0,1187,G
2-PB1,34,0,1,1198,0,1199,G
2-PB1,35,0,1209,0,0,1209,T
2-PB1,36,0,1208,0,1,1209,T
2-PB1,37,0,0,1,1203,1204,C
2-PB1,38,0,0,0,1204,1204,C
2-PB1,39,1208,0,2,0,1210,A
2-PB1,40,0,0,1226,0,1226,G
2-PB1,41,0,0,1,1223,1224,C
2-PB1,42,1,0,1227,0,1228,G
2-PB1,43,0,0,0,1225,1225,C
2-PB1,44,1228,0,1,0,1229,A
2-PB1,45,1230,0,1,0,1231,A
2-PB1,46,1234,0,0,0,1234,A
2-PB1,47,1241,0,0,0,1241,A
2-PB1,48,0,1250,0,0,1250,T
2-PB1,49,0,0,1312,0,1312,G
2-PB1,50,0,0,0,1316,1316,C
2-PB1,51,0,1,0,1320,1321,C
2-PB1,52,1328,0,0,0,1328,A
2-PB1,53,0,1328,0,0,1328,T
2-PB1,54,1425,0,2,0,1427,A
2-PB1,55,1432,0,0,0,1432,A
2-PB1,56,0,0,1501,0,1501,G
2-PB1,57,0,0,0,1501,1501,C
2-PB1,58,1500,0,0,0,1500,A
2-PB1,59,0,0,0,1557,1557,C
2-PB1,60,1557,0,1,0,1558,A
2-PB1,61,1639,0,0,0,1639,A
2-PB1,62,0,0,1,1639,1640,C
2-PB1,63,1642,0,0,0,1642,A
2-PB1,64,0,1659,0,1,1660,T
2-PB1,65,0,1650,0,1,1651,T
2-PB1,66,1,0,0,2143,2144,C
2-PB1,67,0,0,0,2149,2149,C
2-PB1,68,1,0,0,2185,2186,C
2-PB1,69,0,2206,0,2,2208,T
2-PB1,70,0,2208,0,1,2209,T
2-PB1,71,2441,0,0,0,2441,A
2-PB1,72,0,2444,0,0,2444,T
2-PB1,73,2538,0,0,0,2538,A
2-PB1,74,0,0,0,2585,2585,C
2-PB1,75,0,2515,0,1,2516,T
2-PB1,76,0,0,2543,0,2543,G
2-PB1,77,1,0,2540,0,2541,G
2-PB1,78,2537,1,3,0,2541,A
2-PB1,79,1,0,2541,0,2542,G
2-PB1,80,2513,2,5,0,2520,A
2-PB1,81,1,0,0,2505,2506,C
2-PB1,82,1,1,0,2716,2718,C
2-PB1,83,1,1,1,2719,2722,C
2-PB1,84,0,2726,1,4,2731,T
2-PB1,85,0,0,0,2973,2973,C
2-PB1,86,0,1,0,2985,2986,C
2-PB1,87,3009,0,1,2,3012,A
2-PB1,88,0,3014,0,0,3014,T
2-PB1,89,3003,1,2,0,3006,A
2-PB1,90,0,1,0,3009,3010,C
2-PB1,91,2984,0,3,0,2987,A
2-PB1,92,1,0,3115,0,3116,G
2-PB1,93,0,2,0,3130,3132,C
2-PB1,94,0,1,0,3109,3110,C
2-PB1,95,3119,0,0,0,3119,A
2-PB1,96,0,3125,0,0,3125,T
2-PB1,97,0,0,3125,0,3125,G
2-PB1,98,1,0,3298,0,3299,G
2-PB1,99,3328,2,0,1,3331,A
2-PB1,100,3332,0,5,0,3337,A
2-PB1,101,0,0,0,3350,3350,C
2-PB1,102,3340,0,1,0,3341,A
2-PB1,103,0,0,3414,0,3414,G
2-PB1,104,0,0,3463,0,3463,G
2-PB1,105,3450,0,16,0,3466,A
2-PB1,106,3484,0,1,0,3485,A
2-PB1,107,0,0,0,3498,3498,C
2-PB1,108,3493,0,3,0,3496,A
2-PB1,109,1,1,3957,0,3959,G
2-PB1,110,0,0,3951,1,3952,G
2-PB1,111,2,0,4025,1,4028,G
2-PB1,112,0,4020,0,0,4020,T
2-PB1,113,4009,0,1,0,4010,A
2-PB1,114,1,1,0,4046,4048,C
2-PB1,115,4181,1,0,0,4182,A
2-PB1,116,0,0,0,4346,4346,C
2-PB1,117,1,1,0,4321,4323,C
2-PB1,118,4216,1,1,0,4218,A
2-PB1,119,0,4209,0,2,4211,T
2-PB1,120,0,0,4219,1,4220,G
2-PB1,121,1,0,4227,0,4228,G
2-PB1,122,4225,1,4,0,4230,A
2-PB1,123,1,0,0,4242,4243,C
2-PB1,124,4167,0,0,0,4167,A
2-PB1,125,1,1,1,4238,4241,C
2-PB1,126,4237,0,3,0,4240,A
2-PB1,127,0,1,4333,1,4335,G
2-PB1,128,1,4333,0,1,4335,T
2-PB1,129,1,1,0,4473,4475,C
2-PB1,130,4458,0,3,0,4461,A
2-PB1,131,4492,1,1,1,4495,A
2-PB1,132,0,0,0,4498,4498,C
2-PB1,133,4481,0,2,0,4483,A
2-PB1,134,1,1,4549,0,4551,G
2-PB1,135,4491,2,2,0,4495,A
2-PB1,136,4488,0,2,1,4491,A
2-PB1,137,0,3,0,4482,4485,C
2-PB1,138,4426,0,2,0,4428,A
2-PB1,139,0,1,0,4525,4526,C
2-PB1,140,4511,2,3,0,4516,A
2-PB1,141,0,1,0,4703,4704,C
2-PB1,142,1,0,0,4703,4704,C
2-PB1,143,4715,0,0,0,4715,A
2-PB1,144,4726,2,2,1,4731,A
2-PB1,145,0,4845,0,1,4846,T
2-PB1,146,4963,1,0,0,4964,A
2-PB1,147,0,4963,0,1,4964,T
2-PB1,148,2,4923,1,2,4928,T
2-PB1,149,0,0,0,4937,4937,C
2-PB1,150,4861,1,3,0,4865,A
2-PB1,151,1,2,4868,0,4871,G
2-PB1,152,4836,1,2,0,4839,A
2-PB1,153,0,0,4858,0,4858,G
2-PB1,154,4774,0,1,0,4775,A
2-PB1,155,6,4,4704,1,4715,G
2-PB1,156,3,1,4709,0,4713,G
2-PB1,157,0,2,4853,1,4856,G
2-PB1,158,0,1,4853,0,4854,G
2-PB1,159,1,1,4887,0,4889,G
2-PB1,160,4874,0,2,1,4877,A
2-PB1,161,4889,1,5,0,4895,A
2-PB1,162,2,0,4917,0,4919,G
2-PB1,163,3,4897,0,2,4902,T
2-PB1,164,1,2,4891,1,4895,G
2-PB1,165,1,0,4872,0,4873,G
2-PB1,166,4862,2,8,0,4872,A
2-PB1,167,0,0,0,4899,4899,C
2-PB1,168,1,1,4903,0,4905,G
2-PB1,169,4940,1,1,0,4942,A
2-PB1,170,0,0,0,4979,4979,C
2-PB1,171,4955,0,1,1,4957,A
2-PB1,172,4962,2,1,0,4965,A
2-PB1,173,4998,1,1,0,5000,A
2-PB1,174,0,5060,0,0,5060,T
2-PB1,175,5073,0,3,0,5076,A
2-PB1,176,0,3,1,5083,5087,C
2-PB1,177,5042,1,2,0,5045,A
2-PB1,178,1,0,5050,1,5052,G
2-PB1,179,5022,0,2,1,5025,A
2-PB1,180,5068,0,2,0,5070,A
2-PB1,181,5073,0,1,2,5076,A
2-PB1,182,0,1,0,5084,5085,C
2-PB1,183,0,5032,0,2,5034,T
2-PB1,184,2,3,5018,0,5023,G
2-PB1,185,0,0,5013,3,5016,G
2-PB1,186,0,0,5001,0,5001,G
2-PB1,187,3,2,5001,1,5007,G
2-PB1,188,1,0,0,5021,5022,C
2-PB1,189,5010,1,1,0,5012,A
2-PB1,190,2,0,0,5212,5214,C
2-PB1,191,2,1,1,5201,5205,C
2-PB1,192,2,1,0,5209,5212,C
2-PB1,193,1,3,0,5222,5226,C
2-PB1,194,5238,1,0,0,5239,A
2-PB1,195,5276,1,2,0,5279,A
2-PB1,196,0,1,0,5288,5289,C
2-PB1,197,1,5265,1,1,5268,T
2-PB1,198,0,0,0,5281,5281,C
2-PB1,199,5084,2,3,0,5089,A
2-PB1,200,5171,0,4,0,5175,A
2-PB1,201,0,1,0,5161,5162,C
2-PB1,202,0,1,0,5146,5147,C
2-PB1,203,1,4,0,5161,5166,C
2-PB1,204,5144,0,1,0,5145,A
2-PB1,205,5155,0,1,0,5156,A
2-PB1,206,0,5180,0,1,5181,T
2-PB1,207,1,5178,2,3,5184,T
2-PB1,208,1,0,5192,0,5193,G
2-PB1,209,5159,0,2,0,5161,A
2-PB1,210,0,5172,0,2,5174,T
2-PB1,211,1,1,5161,0,5163,G
2-PB1,212,1,1,5186,0,5188,G
2-PB1,213,5239,0,8,0,5247,A
2-PB1,214,1,1,0,5268,5270,C
2-PB1,215,0,0,0,5252,5252,C
2-PB1,216,5251,0,2,0,5253,A
2-PB1,217,0,1,0,5356,5357,C
2-PB1,218,0,5340,0,3,5343,T
2-PB1,219,5424,1,2,0,5427,A
2-PB1,220,1,2,0,5480,5483,C
2-PB1,221,1,0,0,5422,5423,C
2-PB1,222,0,5356,0,1,5357,T
2-PB1,223,0,0,5372,1,5373,G
2-PB1,224,5358,1,2,0,5361,A
2-PB1,225,0,1,5398,0,5399,G
2-PB1,226,0,1,5372,0,5373,G
2-PB1,227,5334,1,0,1,5336,A
2-PB1,228,0,5310,1,0,5311,T
2-PB1,229,5262,1,1,0,5264,A
2-PB1,230,5260,0,0,1,5261,A
2-PB1,231,2,5255,0,1,5258,T
2-PB1,232,1,1,5257,0,5259,G
2-PB1,233,5262,0,2,0,5264,A
2-PB1,234,5240,0,1,0,5241,A
2-PB1,235,0,0,0,5250,5250,C
2-PB1,236,0,0,0,5187,5187,C
2-PB1,237,5203,0,1,0,5204,A
2-PB1,238,5205,0,1,0,5206,A
2-PB1,239,0,0,5246,0,5246,G
2-PB1,240,1,5236,0,2,5239,T
2-PB1,241,2,1,5257,0,5260,G
2-PB1,242,0,2,5345,0,5347,G
2-PB1,243,5333,0,1,0,5334,A
2-PB1,244,0,5322,1,1,5324,T
2-PB1,245,5333,0,0,0,5333,A
2-PB1,246,1,5421,1,1,5424,T
2-PB1,247,1,2,5443,1,5447,G
2-PB1,248,1,0,0,5446,5447,C
2-PB1,249,5450,1,3,0,5454,A
2-PB1,250,0,1,0,5580,5581,C
2-PB1,251,5472,1,1,0,5474,A
2-PB1,252,5545,2,1,1,5549,A
2-PB1,253,5548,0,3,0,5551,A
2-PB1,254,0,0,1,5562,5563,C
2-PB1,255,5398,0,1,0,5399,A
2-PB1,256,0,1,5472,0,5473,G
2-PB1,257,5444,1,1,0,5446,A
2-PB1,258,0,0,0,5450,5450,C
2-PB1,259,2,5309,0,0,5311,T
2-PB1,260,0,0,5406,0,5406,G
2-PB1,261,0,5343,1,6,5350,T
2-PB1,262,1,1,5590,2,5594,G
2-PB1,263,3,5572,0,0,5575,T
2-PB1,264,1,1,1,5601,5604,C
2-PB1,265,1,0,0,5601,5602,C
2-PB1,266,3,5576,0,0,5579,T
2-PB1,267,0,0,5566,0,5566,G
2-PB1,268,1,2,5569,0,5572,G
2-PB1,269,5463,1,1,0,5465,A
2-PB1,270,1,0,5575,0,5576,G
2-PB1,271,1,0,5417,0,5418,G
2-PB1,272,0,0,1,5428,5429,C
2-PB1,273,0,5394,0,2,5396,T
2-PB1,274,5405,1,3,0,5409,A
2-PB1,275,0,5418,0,2,5420,T
2-PB1,276,0,1,5403,1,5405,G
2-PB1,277,0,0,5402,0,5402,G
2-PB1,278,1,2,0,5390,5393,C
2-PB1,279,0,0,0,5340,5340,C
2-PB1,280,0,5279,1,1,5281,T
2-PB1,281,1,5555,0,4,5560,T
2-PB1,282,2,0,0,5573,5575,C
2-PB1,283,0,0,0,5582,5582,C
2-PB1,284,1,5573,0,1,5575,T
2-PB1,285,3,5562,1,0,5566,T
2-PB1,286,0,0,5593,0,5593,G
2-PB1,287,5582,0,2,0,5584,A
2-PB1,288,5589,0,2,0,5591,A
2-PB1,289,0,0,5589,2,5591,G
2-PB1,290,5349,0,1,0,5350,A
2-PB1,291,5387,1,1,0,5389,A
2-PB1,292,0,5386,0,1,5387,T
2-PB1,293,1,2,1,5384,5388,C
2-PB1,294,0,0,1,5378,5379,C
2-PB1,295,1,1,0,5386,5388,C
2-PB1,296,5392,1,8,1,5402,A
2-PB1,297,0,2,0,5429,5431,C
2-PB1,298,2,1,0,5422,5425,C
2-PB1,299,1,1,0,5436,5438,C
2-PB1,300,5371,2,0,1,5374,A
2-PB1,301,1,1,5415,0,5417,G
2-PB1,302,1,1,5438,0,5440,G
2-PB1,303,0,5418,0,2,5420,T
2-PB1,304,5445,1,1,0,5447,A
2-PB1,305,1,5416,1,2,5420,T
2-PB1,306,0,0,0,5450,5450,C
2-PB1,307,1,5457,1,3,5462,T
2-PB1,308,0,5457,2,1,5460,T
2-PB1,309,3,5435,2,0,5440,T
2-PB1,310,2,3,5421,0,5426,G
2-PB1,311,5389,0,4,0,5393,A
2-PB1,312,1,0,5395,1,5397,G
2-PB1,313,5335,1,0,1,5337,A
2-PB1,314,5358,1,1,0,5360,A
2-PB1,315,0,1,0,5389,5390,C
2-PB1,316,1,5321,1,2,5325,T
2-PB1,317,3,1,1,5318,5323,C
2-PB1,318,5326,0,1,0,5327,A
2-PB1,319,1,5328,2,1,5332,T
2-PB1,320,3,2,5331,0,5336,G
2-PB1,321,3,1,0,5403,5407,C
2-PB1,322,2,0,0,5418,5420,C
2-PB1,323,1,5398,0,2,5401,T
2-PB1,324,1,5347,2,2,5352,T
2-PB1,325,1,1,5372,0,5374,G
2-PB1,326,5403,1,1,0,5405,A
2-PB1,327,5401,1,1,1,5404,A
2-PB1,328,5388,0,2,1,5391,A
2-PB1,329,3,5,0,5432,5440,C
2-PB1,330,5301,2,0,1,5304,A
2-PB1,331,5325,0,2,0,5327,A
2-PB1,332,0,5332,0,1,5333,T
2-PB1,333,0,0,5325,2,5327,G
2-PB1,334,1,1,5325,0,5327,G
2-PB1,335,5261,1,4,0,5266,A
2-PB1,336,5260,0,2,1,5263,A
2-PB1,337,2,0,5255,0,5257,G
2-PB1,338,0,0,0,5255,5255,C
2-PB1,339,0,0,0,5220,5220,C
2-PB1,340,1,2,5263,0,5266,G
2-PB1,341,1,5244,0,4,5249,T
2-PB1,342,1,5258,1,1,5261,T
2-PB1,343,0,0,1,5305,5306,C
2-PB1,344,5309,0,5,0,5314,A
2-PB1,345,5380,1,3,0,5384,A
2-PB1,346,0,1,0,5382,5383,C
2-PB1,347,5382,1,1,0,5384,A
2-PB1,348,1,2,5435,0,5438,G
2-PB1,349,5342,0,5,0,5347,A
2-PB1,350,0,0,0,5352,5352,C
2-PB1,351,5340,1,1,1,5343,A
2-PB1,352,5400,0,1,0,5401,A
2-PB1,353,2,1,5475,0,5478,G
2-PB1,354,0,2,5412,0,5414,G
2-PB1,355,0,0,5452,0,5452,G
2-PB1,356,0,5335,0,2,5337,T
2-PB1,357,0,0,5330,0,5330,G
2-PB1,358,0,0,5337,2,5339,G
2-PB1,359,5331,2,9,0,5342,A
2-PB1,360,0,2,0,5347,5349,C
2-PB1,361,5220,1,10,0,5231,A
2-PB1,362,5291,1,2,0,5294,A
2-PB1,363,5279,0,2,0,5281,A
2-PB1,364,2,0,0,5283,5285,C
2-PB1,365,0,5267,1,2,5270,T
2-PB1,366,5271,0,1,0,5272,A
2-PB1,367,5307,0,5,2,5314,A
2-PB1,368,2,1,0,5317,5320,C
2-PB1,369,1,0,1,5305,5307,C
2-PB1,370,2,0,0,5308,5310,C
2-PB1,371,5123,1,3,0,5127,A
2-PB1,372,5122,0,3,2,5127,A
2-PB1,373,0,0,5123,0,5123,G
2-PB1,374,1,0,5121,0,5122,G
2-PB1,375,1,5115,0,0,5116,T
2-PB1,376,3,1,0,5054,5058,C
2-PB1,377,2,0,5063,0,5065,G
2-PB1,378,0,2,0,5047,5049,C
2-PB1,379,3,1,0,5059,5063,C
2-PB1,380,5055,1,2,0,5058,A
2-PB1,381,5023,0,1,1,5025,A
2-PB1,382,5144,0,1,0,5145,A
2-PB1,383,0,1,0,5155,5156,C
2-PB1,384,1,5148,1,1,5151,T
2-PB1,385,1,5171,0,1,5173,T
2-PB1,386,5174,0,1,0,5175,A
2-PB1,387,0,5184,0,2,5186,T
2-PB1,388,0,0,5195,1,5196,G
2-PB1,389,5187,1,1,0,5189,A
2-PB1,390,1,5156,1,1,5159,T
2-PB1,391,1,5016,0,2,5019,T
2-PB1,392,1,0,5003,0,5004,G
2-PB1,393,0,2,5005,0,5007,G
2-PB1,394,5066,0,3,0,5069,A
2-PB1,395,0,3,0,5067,5070,C
2-PB1,396,5019,0,0,0,5019,A
2-PB1,397,0,4996,1,2,4999,T
2-PB1,398,0,5045,0,0,5045,T
2-PB1,399,5061,2,0,0,5063,A
2-PB1,400,5059,2,0,0,5061,A
2-PB1,401,5050,0,1,1,5052,A
2-PB1,402,0,1,1,5062,5064,C
2-PB1,403,4946,0,1,1,4948,A
2-PB1,404,0,0,4980,0,4980,G
2-PB1,405,4948,1,0,1,4950,A
2-PB1,406,4952,2,1,1,4956,A
2-PB1,407,4953,0,1,0,4954,A
2-PB1,408,0,4900,1,2,4903,T
2-PB1,409,1,3,0,4908,4912,C
2-PB1,410,4905,2,0,0,4907,A
2-PB1,411,4911,0,3,0,4914,A
2-PB1,412,1,0,0,4899,4900,C
2-PB1,413,0,1,0,4872,4873,C
2-PB1,414,4,1,4885,0,4890,G
2-PB1,415,1,1,4895,0,4897,G
2-PB1,416,0,2,1,4916,4919,C
2-PB1,417,4910,0,1,1,4912,A
2-PB1,418,0,1,4901,1,4903,G
2-PB1,419,0,1,0,4948,4949,C
2-PB1,420,4947,0,2,0,4949,A
2-PB1,421,4949,0,1,0,4950,A
2-PB1,422,0,1,1,4968,4970,C
2-PB1,423,0,4941,0,4,4945,T
2-PB1,424,2,1,5115,0,5118,G
2-PB1,425,0,2,1,5094,5097,C
2-PB1,426,5101,7,1,0,5109,A
2-PB1,427,1,5099,0,2,5102,T
2-PB1,428,0,5021,0,1,5022,T
2-PB1,429,5337,0,2,6,5345,A
2-PB1,430,0,0,5361,0,5361,G
2-PB1,431,2,3,0,5333,5338,C
2-PB1,432,0,1,0,5331,5332,C
2-PB1,433,5102,2,1,0,5105,A
2-PB1,434,5133,0,0,0,5133,A
2-PB1,435,1,0,0,5160,5161,C
2-PB1,436,5158,1,0,0,5159,A
2-PB1,437,0,1,0,5254,5255,C
2-PB1,438,1,0,0,4778,4779,C
2-PB1,439,4765,1,0,0,4766,A
2-PB1,440,0,4760,0,1,4761,T
2-PB1,441,4761,1,2,0,4764,A
2-PB1,442,0,1,4766,0,4767,G
2-PB1,443,4737,0,0,1,4738,A
2-PB1,444,4671,0,0,0,4671,A
2-PB1,445,0,0,4703,0,4703,G
2-PB1,446,0,4555,2,1,4558,T
2-PB1,447,0,4546,0,2,4548,T
2-PB1,448,5,4523,0,1,4529,T
2-PB1,449,1,4554,0,0,4555,T
2-PB1,450,0,4553,2,1,4556,T
2-PB1,451,4558,0,0,0,4558,A
2-PB1,452,0,1,4552,0,4553,G
2-PB1,453,4535,2,0,0,4537,A
2-PB1,454,0,4521,0,0,4521,T
2-PB1,455,0,3,1,4468,4472,C
2-PB1,456,0,2,4492,0,4494,G
2-PB1,457,4501,1,0,1,4503,A
2-PB1,458,4511,2,0,0,4513,A
2-PB1,459,0,3,0,4524,4527,C
2-PB1,460,3,0,4538,0,4541,G
2-PB1,461,0,1,4714,0,4715,G
2-PB1,462,4724,0,0,1,4725,A
2-PB1,463,0,4715,0,0,4715,T
2-PB1,464,1,4711,0,3,4715,T
2-PB1,465,4712,0,9,0,4721,A
2-PB1,466,4720,0,2,0,4722,A
2-PB1,467,0,0,0,4741,4741,C
2-PB1,468,4695,2,2,0,4699,A
2-PB1,469,2,1,4743,0,4746,G
2-PB1,470,1,2,372,4149,4524,C
2-PB1,471,0,4534,2,1,4537,T
2-PB1,472,4532,0,2,0,4534,A
2-PB1,473,4535,0,1,0,4536,A
2-PB1,474,1,4531,0,0,4532,T
2-PB1,475,1,0,4580,0,4581,G
2-PB1,476,4539,2,0,0,4541,A
2-PB1,477,4547,0,0,0,4547,A
2-PB1,478,0,4472,0,0,4472,T
2-PB1,479,1,0,0,4479,4480,C
2-PB1,480,4460,1,14,0,4475,A
2-PB1,481,0,1,4467,0,4468,G
2-PB1,482,0,0,4472,0,4472,G
2-PB1,483,4441,1,1,0,4443,A
2-PB1,484,4381,0,1,0,4382,A
2-PB1,485,0,0,4554,0,4554,G
2-PB1,486,1,1,4563,0,4565,G
2-PB1,487,0,1,0,4560,4561,C
2-PB1,488,1,4546,2,4,4553,T
2-PB1,489,4564,0,2,0,4566,A
2-PB1,490,4565,1,5,0,4571,A
2-PB1,491,0,4571,0,2,4573,T
2-PB1,492,4580,0,0,0,4580,A
2-PB1,493,1,0,4591,0,4592,G
2-PB1,494,4309,0,1,0,4310,A
2-PB1,495,2,4257,1,1,4261,T
2-PB1,496,0,4275,0,1,4276,T
2-PB1,497,1,4286,0,1,4288,T
2-PB1,498,2,0,0,4415,4417,C
2-PB1,499,2,0,0,4417,4419,C
2-PB1,500,0,4409,0,0,4409,T
2-PB1,501,1,1,0,4409,4411,C
2-PB1,502,4412,2,2,3,4419,A
2-PB1,503,4430,0,1,0,4431,A
2-PB1,504,2,0,4459,3,4464,G
2-PB1,505,1,0,4516,0,4517,G
2-PB1,506,4511,0,0,0,4511,A
2-PB1,507,0,4340,1,2,4343,T
2-PB1,508,2,0,4390,1,4393,G
2-PB1,509,0,4384,0,0,4384,T
2-PB1,510,1,0,4432,0,4433,G
2-PB1,511,4429,0,5,0,4434,A
2-PB1,512,1,4411,0,2,4414,T
2-PB1,513,0,0,4397,0,4397,G
2-PB1,514,0,0,4338,0,4338,G
2-PB1,515,4343,1,0,0,4344,A
2-PB1,516,4341,0,1,0,4342,A
2-PB1,517,0,4310,0,3,4313,T
2-PB1,518,1,0,0,4317,4318,C
2-PB1,519,4259,1,1,0,4261,A
2-PB1,520,4276,0,0,0,4276,A
2-PB1,521,1,4277,0,0,4278,T
2-PB1,522,0,0,4316,0,4316,G
2-PB1,523,0,0,4336,1,4337,G
2-PB1,524,4340,1,1,0,4342,A
2-PB1,525,1,4342,0,1,4344,T
2-PB1,526,4337,1,1,0,4339,A
2-PB1,527,4340,0,0,0,4340,A
2-PB1,528,4331,0,1,1,4333,A
2-PB1,529,1,1,4368,0,4370,G
2-PB1,530,4340,1,2,0,4343,A
2-PB1,531,0,0,4310,1,4311,G
2-PB1,532,0,1,4305,0,4306,G
2-PB1,533,4288,0,1,1,4290,A
2-PB1,534,4294,1,0,0,4295,A
2-PB1,535,4301,1,4,0,4306,A
2-PB1,536,0,4306,0,1,4307,T
2-PB1,537,4,0,4377,1,4382,G
2-PB1,538,1,2,4373,0,4376,G
2-PB1,539,4340,1,5,0,4346,A
2-PB1,540,0,0,4366,0,4366,G
2-PB1,541,4333,1,1,0,4335,A
2-PB1,542,1,4394,0,15,4410,T
2-PB1,543,4399,1,7,0,4407,A
2-PB1,544,4442,1,0,0,4443,A
2-PB1,545,0,0,1,4458,4459,C
2-PB1,546,4357,2,3,0,4362,A
2-PB1,547,4385,0,0,0,4385,A
2-PB1,548,1,1,0,4380,4382,C
2-PB1,549,4346,1,6,0,4353,A
2-PB1,550,0,0,0,4350,4350,C
2-PB1,551,4270,0,1,0,4271,A
2-PB1,552,0,0,0,4311,4311,C
2-PB1,553,0,4243,1,4,4248,T
2-PB1,554,1,4244,0,1,4246,T
2-PB1,555,0,4259,1,2,4262,T
2-PB1,556,1,0,0,4254,4255,C
2-PB1,557,4259,1,0,1,4261,A
2-PB1,558,4255,2,5,1,4263,A
2-PB1,559,4260,1,5,0,4266,A
2-PB1,560,1,1,4315,0,4317,G
2-PB1,561,4260,0,0,0,4260,A
2-PB1,562,4274,1,0,0,4275,A
2-PB1,563,4265,1,1,1,4268,A
2-PB1,564,4278,0,2,0,4280,A
2-PB1,565,4276,1,3,1,4281,A
2-PB1,566,0,1,4309,0,4310,G
2-PB1,567,0,3,4302,0,4305,G
2-PB1,568,4261,2,2,0,4265,A
2-PB1,569,0,2,4360,0,4362,G
2-PB1,570,4350,0,1,0,4351,A
2-PB1,571,0,1,4517,0,4518,G
2-PB1,572,1,4510,0,1,4512,T
2-PB1,573,4492,0,1,0,4493,A
2-PB1,574,4538,1,0,0,4539,A
2-PB1,575,0,2,4559,0,4561,G
2-PB1,576,0,0,4602,0,4602,G
2-PB1,577,7,0,4601,0,4608,G
2-PB1,578,4533,0,0,0,4533,A
2-PB1,579,0,1,0,4577,4578,C
2-PB1,580,4442,0,0,0,4442,A
2-PB1,581,4458,0,2,0,4460,A
2-PB1,582,1,0,0,4458,4459,C
2-PB1,583,4438,0,9,1,4448,A
2-PB1,584,0,4408,0,1,4409,T
2-PB1,585,0,0,4386,0,4386,G
2-PB1,586,4385,0,6,1,4392,A
2-PB1,587,0,0,1,4385,4386,C
2-PB1,588,2,1,0,4338,4341,C
2-PB1,589,4344,0,0,0,4344,A
2-PB1,590,4366,0,2,0,4368,A
2-PB1,591,1,0,4398,0,4399,G
2-PB1,592,4395,0,1,0,4396,A
2-PB1,593,4385,0,2,0,4387,A
2-PB1,594,4356,0,0,0,4356,A
2-PB1,595,4350,1,2,0,4353,A
2-PB1,596,1,4329,2,0,4332,T
2-PB1,597,1,0,4331,0,4332,G
2-PB1,598,3,3,4325,0,4331,G
2-PB1,599,2,4313,0,1,4316,T
2-PB1,600,1,0,1,4255,4257,C
2-PB1,601,4295,1,0,0,4296,A
2-PB1,602,0,2,0,4400,4402,C
2-PB1,603,161,1,4271,1,4434,G
2-PB1,604,1,2,0,4533,4536,C
2-PB1,605,4559,0,2,0,4561,A
2-PB1,606,4690,1,1,0,4692,A
2-PB1,607,4678,1,3,0,4682,A
2-PB1,608,1,0,4991,0,4992,G
2-PB1,609,4979,0,6,0,4985,A
2-PB1,610,5005,2,2,0,5009,A
2-PB1,611,1,2,0,5099,5102,C
2-PB1,612,5041,0,1,1,5043,A
2-PB1,613,5062,0,3,0,5065,A
2-PB1,614,1,5051,0,1,5053,T
2-PB1,615,4998,0,4,0,5002,A
2-PB1,616,1,3,5011,1,5016,G
2-PB1,617,0,3,4846,1,4850,G
2-PB1,618,2,1,4856,0,4859,G
2-PB1,619,4848,0,1,0,4849,A
2-PB1,620,4781,1,3,1,4786,A
2-PB1,621,1,0,4835,0,4836,G
2-PB1,622,4837,0,3,0,4840,A
2-PB1,623,4831,0,1,1,4833,A
2-PB1,624,4850,0,1,0,4851,A
2-PB1,625,4861,1,3,1,4866,A
2-PB1,626,4955,1,2,0,4958,A
2-PB1,627,4958,2,1,0,4961,A
2-PB1,628,1,0,0,4967,4968,C
2-PB1,629,4956,0,0,0,4956,A
2-PB1,630,4947,1,3,0,4951,A
2-PB1,631,4923,2,3,0,4928,A
2-PB1,632,0,1,5031,0,5032,G
2-PB1,633,5018,1,3,1,5023,A
2-PB1,634,0,0,5205,0,5205,G
2-PB1,635,1,5158,0,1,5160,T
2-PB1,636,1,0,5871,0,5872,G
2-PB1,637,5871,0,5,0,5876,A
2-PB1,638,5877,2,1,2,5882,A
2-PB1,639,0,5964,0,0,5964,T
2-PB1,640,5986,0,1,0,5987,A
2-PB1,641,5980,1,2,0,5983,A
2-PB1,642,2,1,5984,0,5987,G
2-PB1,643,5878,0,1,0,5879,A
2-PB1,644,0,1,5900,0,5901,G
2-PB1,645,5582,1,3,0,5586,A
2-PB1,646,1,0,5618,0,5619,G
2-PB1,647,0,0,5615,0,5615,G
2-PB1,648,1,0,1,5608,5610,C
2-PB1,649,1,5612,0,1,5614,T
2-PB1,650,5777,1,0,0,5778,A
2-PB1,651,1,1,1,6051,6054,C
2-PB1,652,1,1,0,6074,6076,C
2-PB1,653,0,6108,0,5,6113,T
2-PB1,654,6311,0,1,0,6312,A
2-PB1,655,6286,1,3,1,6291,A
2-PB1,656,0,6293,0,0,6293,T
2-PB1,657,6278,0,0,1,6279,A
2-PB1,658,6263,0,0,0,6263,A
2-PB1,659,0,0,6268,0,6268,G
2-PB1,660,6076,0,2,0,6078,A
2-PB1,661,3,0,6129,0,6132,G
2-PB1,662,0,0,0,6128,6128,C
2-PB1,663,0,6051,0,2,6053,T
2-PB1,664,2,6068,0,1,6071,T
2-PB1,665,2,6073,0,2,6077,T
2-PB1,666,0,1,6083,0,6084,G
2-PB1,667,6175,0,2,0,6177,A
2-PB1,668,0,0,1,6217,6218,C
2-PB1,669,6182,1,1,0,6184,A
2-PB1,670,0,6152,0,2,6154,T
2-PB1,671,1,6121,0,0,6122,T
2-PB1,672,3,0,6279,0,6282,G
2-PB1,673,6265,4,3,0,6272,A
2-PB1,674,6277,2,4,0,6283,A
2-PB1,675,1,2,0,6290,6293,C
2-PB1,676,6248,1,2,0,6251,A
2-PB1,677,0,0,0,6258,6258,C
2-PB1,678,1,2,6240,0,6243,G
2-PB1,679,6241,1,9,0,6251,A
2-PB1,680,1,6249,0,2,6252,T
2-PB1,681,1,1,6333,2,6337,G
2-PB1,682,6351,0,4,0,6355,A
2-PB1,683,3,1,0,6357,6361,C
2-PB1,684,1,0,0,6350,6351,C
2-PB1,685,6365,0,2,0,6367,A
2-PB1,686,6448,0,0,1,6449,A
2-PB1,687,6458,0,1,0,6459,A
2-PB1,688,3,2,6616,0,6621,G
2-PB1,689,6685,0,3,1,6689,A
2-PB1,690,1,6616,1,3,6621,T
2-PB1,691,2,1,6630,1,6634,G
2-PB1,692,0,1,0,6614,6615,C
2-PB1,693,6615,2,4,0,6621,A
2-PB1,694,1,0,6671,1,6673,G
2-PB1,695,6571,2,5,0,6578,A
2-PB1,696,2,1,6602,1,6606,G
2-PB1,697,6438,0,3,1,6442,A
2-PB1,698,0,2,6437,0,6439,G
2-PB1,699,6372,0,4,0,6376,A
2-PB1,700,1,0,6383,0,6384,G
2-PB1,701,3,0,6369,0,6372,G
2-PB1,702,1,2,1,6366,6370,C
2-PB1,703,6352,1,2,1,6356,A
2-PB1,704,6368,2,3,0,6373,A
2-PB1,705,6392,0,4,0,6396,A
2-PB1,706,2,6402,0,1,6405,T
2-PB1,707,1,6407,0,3,6411,T
2-PB1,708,6414,5,4,0,6423,A
2-PB1,709,6397,0,1,1,6399,A
2-PB1,710,6419,1,0,0,6420,A
2-PB1,711,6436,0,1,2,6439,A
2-PB1,712,6440,0,1,0,6441,A
2-PB1,713,1,2,6448,0,6451,G
2-PB1,714,6402,1,3,0,6406,A
2-PB1,715,6393,1,2,1,6397,A
2-PB1,716,0,1,6495,0,6496,G
2-PB1,717,1,0,6610,0,6611,G
2-PB1,718,0,0,6609,0,6609,G
2-PB1,719,3,3,1,6649,6656,C
2-PB1,720,0,6653,0,8,6661,T
2-PB1,721,6710,0,0,1,6711,A
2-PB1,722,1,6805,0,4,6810,T
2-PB1,723,1,6807,1,4,6813,T
2-PB1,724,4,0,6840,0,6844,G
2-PB1,725,0,3,0,6804,6807,C
2-PB1,726,6643,2,5,0,6650,A
2-PB1,727,6667,0,4,0,6671,A
2-PB1,728,0,1,1,6666,6668,C
2-PB1,729,6654,1,2,0,6657,A
2-PB1,730,4,1,0,6652,6657,C
2-PB1,731,3,0,0,6525,6528,C
2-PB1,732,1,3,0,6530,6534,C
2-PB1,733,1,2,6512,1,6516,G
2-PB1,734,3,2,6522,0,6527,G
2-PB1,735,2,0,6547,1,6550,G
2-PB1,736,6572,2,1,1,6576,A
2-PB1,737,1,6517,2,3,6523,T
2-PB1,738,3,1,6534,0,6538,G
2-PB1,739,1,0,0,6517,6518,C
2-PB1,740,6603,1,2,2,6608,A
2-PB1,741,6703,1,1,3,6708,A
2-PB1,742,6774,1,3,0,6778,A
2-PB1,743,0,6767,0,0,6767,T
2-PB1,744,0,6772,1,1,6774,T
2-PB1,745,6730,0,2,1,6733,A
2-PB1,746,1,0,6731,1,6733,G
2-PB1,747,6673,2,6,1,6682,A
2-PB1,748,0,4,6718,0,6722,G
2-PB1,749,0,1,6651,0,6652,G
2-PB1,750,2,2,6821,0,6825,G
2-PB1,751,0,6838,0,3,6841,T
2-PB1,752,0,6835,0,2,6837,T
2-PB1,753,1,3,0,6860,6864,C
2-PB1,754,2,0,6950,0,6952,G
2-PB1,755,0,6937,2,11,6950,T
2-PB1,756,1,0,6956,0,6957,G
2-PB1,757,1,6935,1,3,6940,T
2-PB1,758,6901,3,3,0,6907,A
2-PB1,759,1,0,1,6891,6893,C
2-PB1,760,2,6555,2,1,6560,T
2-PB1,761,0,6588,0,0,6588,T
2-PB1,762,0,0,0,6553,6553,C
2-PB1,763,0,0,6504,0,6504,G
2-PB1,764,1,6484,0,1,6486,T
2-PB1,765,1,6485,0,2,6488,T
2-PB1,766,0,0,6484,1,6485,G
2-PB1,767,6484,1,2,2,6489,A
2-PB1,768,6483,0,2,0,6485,A
2-PB1,769,6536,1,0,1,6538,A
2-PB1,770,0,1,0,6553,6554,C
2-PB1,771,1,6511,0,2,6514,T
2-PB1,772,3,6489,0,1,6493,T
2-PB1,773,1,6503,0,1,6505,T
2-PB1,774,6619,0,5,1,6625,A
2-PB1,775,2,0,6637,0,6639,G
2-PB1,776,1,0,0,6650,6651,C
2-PB1,777,1,6633,0,2,6636,T
2-PB1,778,6578,1,1,0,6580,A
2-PB1,779,0,1,6566,0,6567,G
2-PB1,780,6564,3,1,0,6568,A
2-PB1,781,6564,1,1,0,6566,A
2-PB1,782,2,0,6569,0,6571,G
2-PB1,783,2,2,0,6444,6448,C
2-PB1,784,6453,3,1,0,6457,A
2-PB1,785,0,6426,0,2,6428,T
2-PB1,786,1,6436,0,1,6438,T
2-PB1,787,2,6425,0,6,6433,T
2-PB1,788,2,0,6440,0,6442,G
2-PB1,789,0,1,0,6425,6426,C
2-PB1,790,1,0,6431,0,6432,G
2-PB1,791,6421,0,1,0,6422,A
2-PB1,792,6394,2,1,0,6397,A
2-PB1,793,6400,4,2,0,6406,A
2-PB1,794,6611,0,7,0,6618,A
2-PB1,795,2,1,6686,0,6689,G
2-PB1,796,0,0,0,6698,6698,C
2-PB1,797,1,6689,0,3,6693,T
2-PB1,798,0,6685,0,1,6686,T
2-PB1,799,1,1,6700,0,6702,G
2-PB1,800,6693,1,3,1,6698,A
2-PB1,801,6696,1,3,0,6700,A
2-PB1,802,2,3,0,6723,6728,C
2-PB1,803,6564,0,0,0,6564,A
2-PB1,804,1,0,7174,0,7175,G
2-PB1,805,1,7132,0,0,7133,T
2-PB1,806,0,3,0,7143,7146,C
2-PB1,807,0,7138,1,10,7149,T
2-PB1,808,3,0,7156,0,7159,G
2-PB1,809,0,3,7158,0,7161,G
2-PB1,810,7164,1,2,2,7169,A
2-PB1,811,1,2,0,7185,7188,C
2-PB1,812,0,6921,9,2,6932,T
2-PB1,813,1,6436,0,1,6438,T
2-PB1,814,2,1,1,6423,6427,C
2-PB1,815,0,1,0,6432,6433,C
2-PB1,816,1,2,6462,0,6465,G
2-PB1,817,1,1,6481,1,6484,G
2-PB1,818,0,6438,0,2,6440,T
2-PB1,819,1,6422,0,0,6423,T
2-PB1,820,1,0,6405,0,6406,G
2-PB1,821,0,0,6444,0,6444,G
2-PB1,822,1,2,6484,0,6487,G
2-PB1,823,0,4,6480,1,6485,G
2-PB1,824,1,1,6498,0,6500,G
2-PB1,825,1,6463,0,2,6466,T
2-PB1,826,6431,0,3,0,6434,A
2-PB1,827,6464,0,4,1,6469,A
2-PB1,828,0,6470,0,2,6472,T
2-PB1,829,1,0,6494,1,6496,G
2-PB1,830,6435,1,2,0,6438,A
2-PB1,831,6357,0,3,0,6360,A
2-PB1,832,6373,2,1,0,6376,A
2-PB1,833,6344,1,2,0,6347,A
2-PB1,834,1,0,6348,0,6349,G
2-PB1,835,6289,1,1,1,6292,A
2-PB1,836,6246,0,8,1,6255,A
2-PB1,837,4,0,6272,0,6276,G
2-PB1,838,4,4,6242,0,6250,G
2-PB1,839,1,4,0,6233,6238,C
2-PB1,840,1,3,0,6232,6236,C
2-PB1,841,6239,2,0,0,6241,A
2-PB1,842,6237,0,2,0,6239,A
2-PB1,843,6245,0,2,0,6247,A
2-PB1,844,0,0,0,6246,6246,C
2-PB1,845,1,6234,0,4,6239,T
2-PB1,846,0,0,6295,0,6295,G
2-PB1,847,3,0,6290,0,6293,G
2-PB1,848,1,3,0,6287,6291,C
2-PB1,849,6296,2,3,0,6301,A
2-PB1,850,6293,2,5,0,6300,A
2-PB1,851,6301,0,2,0,6303,A
2-PB1,852,0,6309,0,0,6309,T
2-PB1,853,1,0,6324,0,6325,G
2-PB1,854,0,6290,1,5,6296,T
2-PB1,855,1,6153,0,1,6155,T
2-PB1,856,0,1,6165,0,6166,G
2-PB1,857,1,6139,0,1,6141,T
2-PB1,858,0,2,6153,0,6155,G
2-PB1,859,6150,1,2,0,6153,A
2-PB1,860,0,0,6177,1,6178,G
2-PB1,861,6157,3,2,0,6162,A
2-PB1,862,6128,1,1,0,6130,A
2-PB1,863,6128,1,2,1,6132,A
2-PB1,864,6144,0,2,0,6146,A
2-PB1,865,6171,0,3,0,6174,A
2-PB1,866,0,6145,0,2,6147,T
2-PB1,867,0,1,6145,0,6146,G
2-PB1,868,6134,2,1,0,6137,A
2-PB1,869,1,6077,0,0,6078,T
2-PB1,870,0,0,6135,0,6135,G
2-PB1,871,6134,0,7,0,6141,A
2-PB1,872,0,0,0,6180,6180,C
2-PB1,873,0,6172,0,1,6173,T
2-PB1,874,6159,0,2,0,6161,A
2-PB1,875,6203,2,1,0,6206,A
2-PB1,876,0,6191,1,0,6192,T
2-PB1,877,1,6261,0,3,6265,T
2-PB1,878,1,1,0,6293,6295,C
2-PB1,879,6267,4,1,1,6273,A
2-PB1,880,0,0,0,6282,6282,C
2-PB1,881,6214,0,0,0,6214,A
2-PB1,882,6217,0,6,0,6223,A
2-PB1,883,0,0,6225,0,6225,G
2-PB1,884,6306,2,6,0,6314,A
2-PB1,885,1,2,0,6312,6315,C
2-PB1,886,6228,4,5,1,6238,A
2-PB1,887,0,1,0,6238,6239,C
2-PB1,888,6171,2,1,1,6175,A
2-PB1,889,0,0,6211,0,6211,G
2-PB1,890,6167,1,3,0,6171,A
2-PB1,891,0,2,6202,0,6204,G
2-PB1,892,0,1,0,6174,6175,C
2-PB1,893,1,6024,0,5,6030,T
2-PB1,894,2,6078,0,5,6085,T
2-PB1,895,2,6074,0,1,6077,T
2-PB1,896,3,0,0,6102,6105,C
2-PB1,897,1,6079,0,1,6081,T
2-PB1,898,2,6026,3,1,6032,T
2-PB1,899,2,6018,2,6,6028,T
2-PB1,900,0,1,0,6036,6037,C
2-PB1,901,6023,1,8,0,6032,A
2-PB1,902,0,2,0,6035,6037,C
2-PB1,903,5897,0,57,1,5955,A
2-PB1,904,5972,0,3,0,5975,A
2-PB1,905,1,5986,1,4,5992,T
2-PB1,906,2,0,1,6061,6064,C
2-PB1,907,6079,1,2,0,6082,A
2-PB1,908,0,2,0,6099,6101,C
2-PB1,909,0,6056,1,1,6058,T
2-PB1,910,0,4,6082,0,6086,G
2-PB1,911,3,0,6053,1,6057,G
2-PB1,912,5,3,6204,1,6213,G
2-PB1,913,1,0,6206,0,6207,G
2-PB1,914,6108,0,2,1,6111,A
2-PB1,915,4,1,0,5871,5876,C
2-PB1,916,5924,0,4,0,5928,A
2-PB1,917,6223,1,5,0,6229,A
2-PB1,918,1,0,0,6257,6258,C
2-PB1,919,6236,0,2,0,6238,A
2-PB1,920,0,0,0,6225,6225,C
2-PB1,921,1,5924,0,2,5927,T
2-PB1,922,5943,1,0,0,5944,A
2-PB1,923,5929,0,3,0,5932,A
2-PB1,924,1,1,5979,0,5981,G
2-PB1,925,1,5942,0,2,5945,T
2-PB1,926,1,0,5485,0,5486,G
2-PB1,927,2,1,5453,0,5456,G
2-PB1,928,5432,0,1,0,5433,A
2-PB1,929,5440,1,4,1,5446,A
2-PB1,930,0,5444,0,2,5446,T
2-PB1,931,1,1,5408,0,5410,G
2-PB1,932,5403,0,1,0,5404,A
2-PB1,933,5319,0,1,0,5320,A
2-PB1,934,5317,0,5,0,5322,A
2-PB1,935,5310,0,2,0,5312,A
2-PB1,936,2,0,0,5261,5263,C
2-PB1,937,1,0,0,5341,5342,C
2-PB1,938,5343,0,0,3,5346,A
2-PB1,939,5332,0,0,1,5333,A
2-PB1,940,5324,0,3,1,5328,A
2-PB1,941,5340,0,1,0,5341,A
2-PB1,942,2,2,0,5350,5354,C
2-PB1,943,1,0,0,5303,5304,C
2-PB1,944,2,0,1,5281,5284,C
2-PB1,945,1,5269,0,4,5274,T
2-PB1,946,3,5,0,5275,5283,C
2-PB1,947,0,2,5277,1,5280,G
2-PB1,948,5287,0,1,1,5289,A
2-PB1,949,5286,0,0,1,5287,A
2-PB1,950,1,5271,0,1,5273,T
2-PB1,951,1,0,5271,1,5273,G
2-PB1,952,2,5234,0,3,5239,T
2-PB1,953,1,5220,4,0,5225,T
2-PB1,954,1,5228,0,0,5229,T
2-PB1,955,0,5220,0,0,5220,T
2-PB1,956,1,5227,0,0,5228,T
2-PB1,957,2,2,5217,2,5223,G
2-PB1,958,1,0,5213,0,5214,G
2-PB1,959,0,4,1,5201,5206,C
2-PB1,960,2,1,5176,0,5179,G
2-PB1,961,5171,1,0,0,5172,A
2-PB1,962,0,5281,0,0,5281,T
2-PB1,963,1,0,5427,0,5428,G
2-PB1,964,5622,0,4,0,5626,A
2-PB1,965,1,5641,0,0,5642,T
2-PB1,966,1,5634,0,0,5635,T
2-PB1,967,5657,0,2,0,5659,A
2-PB1,968,0,1,0,5662,5663,C
2-PB1,969,5686,0,3,0,5689,A
2-PB1,970,2,5673,0,2,5677,T
2-PB1,971,5328,0,2,0,5330,A
2-PB1,972,1,0,0,5344,5345,C
2-PB1,973,4732,0,1,1,4734,A
2-PB1,974,0,4735,0,2,4737,T
2-PB1,975,1,0,0,4722,4723,C
2-PB1,976,4698,1,5,0,4704,A
2-PB1,977,2,0,0,4717,4719,C
2-PB1,978,4667,1,2,0,4670,A
2-PB1,979,4670,0,3,0,4673,A
2-PB1,980,4662,0,1,0,4663,A
2-PB1,981,0,0,4466,0,4466,G
2-PB1,982,4627,1,2,0,4630,A
2-PB1,983,4632,1,3,0,4636,A
2-PB1,984,0,4638,0,3,4641,T
2-PB1,985,0,1,1,4619,4621,C
2-PB1,986,4629,0,1,0,4630,A
2-PB1,987,4656,1,0,0,4657,A
2-PB1,988,2,0,0,4666,4668,C
2-PB1,989,1,0,0,4663,4664,C
2-PB1,990,1,4354,0,0,4355,T
2-PB1,991,0,0,4390,0,4390,G
2-PB1,992,4365,1,1,0,4367,A
2-PB1,993,0,0,4370,0,4370,G
2-PB1,994,1,4342,0,1,4344,T
2-PB1,995,1,0,4220,1,4222,G
2-PB1,996,2,1,4468,0,4471,G
2-PB1,997,0,4431,0,0,4431,T
2-PB1,998,3,4428,0,1,4432,T
2-PB1,999,2,1,0,4433,4436,C
2-PB1,1000,4357,1,1,0,4359,A
2-PB1,1001,0,0,4437,0,4437,G
2-PB1,1002,4435,0,2,1,4438,A
2-PB1,1003,4434,1,2,0,4437,A
2-PB1,1004,4415,0,0,0,4415,A
2-PB1,1005,0,0,0,3900,3900,C
2-PB1,1006,3953,0,0,0,3953,A
2-PB1,1007,1,3947,3,0,3951,T
2-PB1,1008,2,0,1,3986,3989,C
2-PB1,1009,1,1,0,3995,3997,C
2-PB1,1010,0,3794,1,4,3799,T
2-PB1,1011,0,0,3817,0,3817,G
2-PB1,1012,3796,0,1,0,3797,A
2-PB1,1013,1,1,3845,0,3847,G
2-PB1,1014,0,1,0,3807,3808,C
2-PB1,1015,3672,1,2,0,3675,A
2-PB1,1016,0,3687,0,2,3689,T
2-PB1,1017,0,0,0,3659,3659,C
2-PB1,1018,2,0,3658,0,3660,G
2-PB1,1019,0,1,0,3753,3754,C
2-PB1,1020,3775,0,0,0,3775,A
2-PB1,1021,0,0,0,3883,3883,C
2-PB1,1022,1,0,0,3875,3876,C
2-PB1,1023,3879,0,2,0,3881,A
2-PB1,1024,3944,1,1,0,3946,A
2-PB1,1025,1,3937,1,1,3940,T
2-PB1,1026,3940,0,0,0,3940,A
2-PB1,1027,3935,0,1,0,3936,A
2-PB1,1028,1,3809,0,0,3810,T
2-PB1,1029,0,0,3825,0,3825,G
2-PB1,1030,1,3754,0,1,3756,T
2-PB1,1031,0,3730,0,0,3730,T
2-PB1,1032,0,2,0,3739,3741,C
2-PB1,1033,0,3720,0,1,3721,T
2-PB1,1034,1,0,0,3729,3730,C
2-PB1,1035,3732,0,0,1,3733,A
2-PB1,1036,3723,0,3,2,3728,A
2-PB1,1037,3723,0,1,2,3726,A
2-PB1,1038,1,1,1,3738,3741,C
2-PB1,1039,3718,1,1,0,3720,A
2-PB1,1040,3713,0,1,0,3714,A
2-PB1,1041,3708,1,2,0,3711,A
2-PB1,1042,3726,1,1,0,3728,A
2-PB1,1043,0,3768,1,0,3769,T
2-PB1,1044,1,1,3780,0,3782,G
2-PB1,1045,1,0,3783,0,3784,G
2-PB1,1046,1,2,0,3769,3772,C
2-PB1,1047,3770,1,0,0,3771,A
2-PB1,1048,3781,1,3,0,3785,A
2-PB1,1049,0,0,3809,0,3809,G
2-PB1,1050,3822,2,2,0,3826,A
2-PB1,1051,0,2,0,3833,3835,C
2-PB1,1052,0,3796,0,0,3796,T
2-PB1,1053,1,1,3851,0,3853,G
2-PB1,1054,0,1,3858,0,3859,G
2-PB1,1055,1,1,3878,0,3880,G
2-PB1,1056,3881,1,2,0,3884,A
2-PB1,1057,3875,0,0,1,3876,A
2-PB1,1058,3854,2,3,1,3860,A
2-PB1,1059,3844,1,1,0,3846,A
2-PB1,1060,0,1,3967,0,3968,G
2-PB1,1061,0,0,3967,0,3967,G
2-PB1,1062,3952,0,2,0,3954,A
2-PB1,1063,0,3941,0,2,3943,T
2-PB1,1064,3930,0,2,0,3932,A
2-PB1,1065,1,0,0,3932,3933,C
2-PB1,1066,3961,0,0,0,3961,A
2-PB1,1067,0,3959,0,0,3959,T
2-PB1,1068,3,0,3977,0,3980,G
2-PB1,1069,0,3891,0,2,3893,T
2-PB1,1070,1,3895,0,0,3896,T
2-PB1,1071,2,2,0,3873,3877,C
2-PB1,1072,0,0,3878,0,3878,G
2-PB1,1073,3888,1,2,0,3891,A
2-PB1,1074,0,1,3960,0,3961,G
2-PB1,1075,3921,1,1,0,3923,A
2-PB1,1076,2,0,3956,1,3959,G
2-PB1,1077,0,3944,0,0,3944,T
2-PB1,1078,3926,1,3,0,3930,A
2-PB1,1079,3929,0,8,0,3937,A
2-PB1,1080,0,2,3951,0,3953,G
2-PB1,1081,3947,0,4,0,3951,A
2-PB1,1082,0,1,3999,0,4000,G
2-PB1,1083,3900,1,2,0,3903,A
2-PB1,1084,3929,1,1,0,3931,A
2-PB1,1085,0,3907,0,0,3907,T
2-PB1,1086,0,1,3894,0,3895,G
2-PB1,1087,3897,0,4,0,3901,A
2-PB1,1088,3867,2,14,0,3883,A
2-PB1,1089,1,2,3894,0,3897,G
2-PB1,1090,1,0,0,3874,3875,C
2-PB1,1091,0,3834,0,2,3836,T
2-PB1,1092,2,0,0,3859,3861,C
2-PB1,1093,0,1,0,3849,3850,C
2-PB1,1094,0,0,3859,0,3859,G
2-PB1,1095,1,1,3866,0,3868,G
2-PB1,1096,3870,1,3,0,3874,A
2-PB1,1097,0,3,0,3918,3921,C
2-PB1,1098,3929,1,4,0,3934,A
2-PB1,1099,0,0,0,3967,3967,C
2-PB1,1100,3962,0,2,0,3964,A
2-PB1,1101,3958,0,4,1,3963,A
2-PB1,1102,3955,0,0,0,3955,A
2-PB1,1103,1,3960,0,2,3963,T
2-PB1,1104,3968,0,0,0,3968,A
2-PB1,1105,0,1,1,3951,3953,C
2-PB1,1106,0,2,0,3925,3927,C
2-PB1,1107,3,3881,0,1,3885,T
2-PB1,1108,2,1,3919,1,3923,G
2-PB1,1109,1,0,0,3922,3923,C
2-PB1,1110,3922,0,1,0,3923,A
2-PB1,1111,0,0,3927,1,3928,G
2-PB1,1112,3907,0,0,2,3909,A
2-PB1,1113,3894,1,2,0,3897,A
2-PB1,1114,3919,0,1,0,3920,A
2-PB1,1115,0,3924,0,0,3924,T
2-PB1,1116,0,2,3919,0,3921,G
2-PB1,1117,1,1,0,3908,3910,C
2-PB1,1118,0,3911,0,1,3912,T
2-PB1,1119,3965,1,1,0,3967,A
2-PB1,1120,0,1,3959,0,3960,G
2-PB1,1121,0,0,0,3958,3958,C
2-PB1,1122,3962,1,1,1,3965,A
2-PB1,1123,3947,0,1,1,3949,A
2-PB1,1124,1,0,3928,1,3930,G
2-PB1,1125,2,0,0,3925,3927,C
2-PB1,1126,3882,0,0,0,3882,A
2-PB1,1127,1,3941,0,4,3946,T
2-PB1,1128,0,3949,0,4,3953,T
2-PB1,1129,1,2,4031,0,4034,G
2-PB1,1130,4068,0,1,0,4069,A
2-PB1,1131,0,0,1,4056,4057,C
2-PB1,1132,1,0,0,4074,4075,C
2-PB1,1133,0,3999,1,2,4002,T
2-PB1,1134,1,0,4060,1,4062,G
2-PB1,1135,4071,0,2,1,4074,A
2-PB1,1136,4076,1,2,1,4080,A
2-PB1,1137,0,0,4131,1,4132,G
2-PB1,1138,1,3996,1,2,4000,T
2-PB1,1139,4022,0,0,1,4023,A
2-PB1,1140,0,3990,1,1,3992,T
2-PB1,1141,1,3998,0,3,4002,T
2-PB1,1142,0,4003,0,1,4004,T
2-PB1,1143,0,0,0,3970,3970,C
2-PB1,1144,3959,1,2,0,3962,A
2-PB1,1145,3966,1,0,0,3967,A
2-PB1,1146,1,3911,0,1,3913,T
2-PB1,1147,1,1,3920,1,3923,G
2-PB1,1148,3901,3,0,0,3904,A
2-PB1,1149,3922,2,0,0,3924,A
2-PB1,1150,0,3905,1,2,3908,T
2-PB1,1151,1,0,0,3938,3939,C
2-PB1,1152,3936,0,4,0,3940,A
2-PB1,1153,3946,1,0,0,3947,A
2-PB1,1154,0,0,0,3932,3932,C
2-PB1,1155,3937,1,1,0,3939,A
2-PB1,1156,3923,0,1,0,3924,A
2-PB1,1157,0,0,3912,0,3912,G
2-PB1,1158,0,0,3931,0,3931,G
2-PB1,1159,3927,0,0,1,3928,A
2-PB1,1160,3911,0,2,0,3913,A
2-PB1,1161,2,0,3915,1,3918,G
2-PB1,1162,3906,0,0,0,3906,A
2-PB1,1163,3910,1,2,0,3913,A
2-PB1,1164,3910,0,0,0,3910,A
2-PB1,1165,3907,1,3,0,3911,A
2-PB1,1166,0,3891,0,0,3891,T
2-PB1,1167,0,3861,1,0,3862,T
2-PB1,1168,0,1,3870,1,3872,G
2-PB1,1169,3858,0,5,0,3863,A
2-PB1,1170,0,0,3873,0,3873,G
2-PB1,1171,3872,0,1,0,3873,A
2-PB1,1172,3902,1,1,0,3904,A
2-PB1,1173,3938,0,1,0,3939,A
2-PB1,1174,3952,0,3,0,3955,A
2-PB1,1175,0,3953,0,0,3953,T
2-PB1,1176,3947,0,1,0,3948,A
2-PB1,1177,3944,0,1,0,3945,A
2-PB1,1178,1,1,3963,0,3965,G
2-PB1,1179,0,1,3963,0,3964,G
2-PB1,1180,2,0,0,3951,3953,C
2-PB1,1181,4,1,1,3940,3946,C
2-PB1,1182,1,3912,1,3,3917,T
2-PB1,1183,0,1,0,4235,4236,C
2-PB1,1184,1,4268,0,2,4271,T
2-PB1,1185,1,4277,1,0,4279,T
2-PB1,1186,0,0,1,4325,4326,C
2-PB1,1187,0,4299,0,1,4300,T
2-PB1,1188,4310,0,0,0,4310,A
2-PB1,1189,4317,1,2,0,4320,A
2-PB1,1190,1,4309,0,0,4310,T
2-PB1,1191,4332,1,2,0,4335,A
2-PB1,1192,0,0,4193,0,4193,G
2-PB1,1193,3999,0,1,0,4000,A
2-PB1,1194,0,3991,0,0,3991,T
2-PB1,1195,0,0,3922,2,3924,G
2-PB1,1196,1,1,3908,0,3910,G
2-PB1,1197,3798,0,3,0,3801,A
2-PB1,1198,3896,0,1,0,3897,A
2-PB1,1199,0,0,0,3902,3902,C
2-PB1,1200,3901,2,1,0,3904,A
2-PB1,1201,0,0,3982,0,3982,G
2-PB1,1202,0,2,0,3958,3960,C
2-PB1,1203,3974,1,0,0,3975,A
2-PB1,1204,1,4074,0,4,4079,T
2-PB1,1205,2,0,0,3995,3997,C
2-PB1,1206,4030,0,2,0,4032,A
2-PB1,1207,0,4031,0,0,4031,T
2-PB1,1208,0,4009,0,1,4010,T
2-PB1,1209,1,0,4009,0,4010,G
2-PB1,1210,3902,0,6,0,3908,A
2-PB1,1211,0,0,4033,0,4033,G
2-PB1,1212,0,1,0,4014,4015,C
2-PB1,1213,0,0,0,3926,3926,C
2-PB1,1214,1,1,0,3992,3994,C
2-PB1,1215,1,3945,1,3,3950,T
2-PB1,1216,3,0,4035,0,4038,G
2-PB1,1217,0,0,4093,0,4093,G
2-PB1,1218,4097,0,4,1,4102,A
2-PB1,1219,4160,0,1,0,4161,A
2-PB1,1220,0,4020,0,3,4023,T
2-PB1,1221,0,0,4106,0,4106,G
2-PB1,1222,4173,0,2,0,4175,A
2-PB1,1223,1,4134,0,2,4137,T
2-PB1,1224,0,0,4152,1,4153,G
2-PB1,1225,4116,0,0,0,4116,A
2-PB1,1226,0,4056,0,1,4057,T
2-PB1,1227,0,1,4060,1,4062,G
2-PB1,1228,2,3,4105,0,4110,G
2-PB1,1229,0,0,4130,1,4131,G
2-PB1,1230,3,0,0,4086,4089,C
2-PB1,1231,4097,1,2,0,4100,A
2-PB1,1232,0,4109,1,1,4111,T
2-PB1,1233,0,0,4223,0,4223,G
2-PB1,1234,0,4232,0,3,4235,T
2-PB1,1235,1,4247,0,3,4251,T
2-PB1,1236,0,0,0,4258,4258,C
2-PB1,1237,4206,2,1,0,4209,A
2-PB1,1238,4218,0,2,1,4221,A
2-PB1,1239,0,1,0,4217,4218,C
2-PB1,1240,4237,1,1,0,4239,A
2-PB1,1241,0,4225,1,0,4226,T
2-PB1,1242,1,0,4285,0,4286,G
2-PB1,1243,1,0,0,4285,4286,C
2-PB1,1244,0,4288,0,1,4289,T
2-PB1,1245,4320,0,0,1,4321,A
2-PB1,1246,4311,0,1,0,4312,A
2-PB1,1247,1,0,4432,0,4433,G
2-PB1,1248,1,4431,0,2,4434,T
2-PB1,1249,4397,1,1,0,4399,A
2-PB1,1250,0,0,0,4398,4398,C
2-PB1,1251,4299,0,4,0,4303,A
2-PB1,1252,1,0,4664,0,4665,G
2-PB1,1253,0,4659,1,2,4662,T
2-PB1,1254,0,4648,0,2,4650,T
2-PB1,1255,0,4657,1,0,4658,T
2-PB1,1256,0,4584,0,1,4585,T
2-PB1,1257,4582,1,4,1,4588,A
2-PB1,1258,0,0,4585,0,4585,G
2-PB1,1259,1,3,4577,0,4581,G
2-PB1,1260,4468,2,4,0,4474,A
2-PB1,1261,0,1,4438,0,4439,G
2-PB1,1262,0,4479,0,1,4480,T
2-PB1,1263,0,0,0,4477,4477,C
2-PB1,1264,0,4487,1,0,4488,T
2-PB1,1265,1,0,0,4487,4488,C
2-PB1,1266,1,0,4501,0,4502,G
2-PB1,1267,4628,2,0,0,4630,A
2-PB1,1268,0,4630,1,1,4632,T
2-PB1,1269,4649,1,0,1,4651,A
2-PB1,1270,0,0,0,4645,4645,C
2-PB1,1271,0,4547,3,3,4553,T
2-PB1,1272,1,0,4566,0,4567,G
2-PB1,1273,4554,1,0,1,4556,A
2-PB1,1274,4611,0,0,1,4612,A
2-PB1,1275,0,4606,1,1,4608,T
2-PB1,1276,1,2,0,4514,4517,C
2-PB1,1277,2,4500,1,0,4503,T
2-PB1,1278,2,4487,0,1,4490,T
2-PB1,1279,4,0,4506,0,4510,G
2-PB1,1280,0,0,4509,2,4511,G
2-PB1,1281,4497,0,7,1,4505,A
2-PB1,1282,0,0,0,4508,4508,C
2-PB1,1283,4452,2,3,0,4457,A
2-PB1,1284,4495,0,1,1,4497,A
2-PB1,1285,4508,1,2,0,4511,A
2-PB1,1286,4508,0,5,0,4513,A
2-PB1,1287,0,0,4585,0,4585,G
2-PB1,1288,4574,1,4,1,4580,A
2-PB1,1289,4569,0,4,0,4573,A
2-PB1,1290,4574,0,5,0,4579,A
2-PB1,1291,0,4580,0,0,4580,T
2-PB1,1292,4579,0,2,0,4581,A
2-PB1,1293,0,0,0,4697,4697,C
2-PB1,1294,4681,0,1,0,4682,A
2-PB1,1295,1,4,0,4695,4700,C
2-PB1,1296,0,1,0,4647,4648,C
2-PB1,1297,4648,1,1,0,4650,A
2-PB1,1298,4700,0,2,0,4702,A
2-PB1,1299,0,1,4829,0,4830,G
2-PB1,1300,4894,0,4,0,4898,A
2-PB1,1301,1,0,0,4924,4925,C
2-PB1,1302,4815,0,2,1,4818,A
2-PB1,1303,4959,1,3,0,4963,A
2-PB1,1304,0,1,0,4971,4972,C
2-PB1,1305,5032,0,0,0,5032,A
2-PB1,1306,1,5036,1,0,5038,T
2-PB1,1307,5010,0,2,1,5013,A
2-PB1,1308,0,1,0,5098,5099,C
2-PB1,1309,0,4944,0,2,4946,T
2-PB1,1310,0,0,5028,1,5029,G
2-PB1,1311,2,1,5027,0,5030,G
2-PB1,1312,1,4924,0,3,4928,T
2-PB1,1313,1,4,4912,0,4917,G
2-PB1,1314,0,0,4876,0,4876,G
2-PB1,1315,0,1,4894,0,4895,G
2-PB1,1316,4887,0,5,0,4892,A
2-PB1,1317,2,4801,0,0,4803,T
2-PB1,1318,1,0,4797,0,4798,G
2-PB1,1319,0,1,4797,0,4798,G
2-PB1,1320,0,1,4825,0,4826,G
2-PB1,1321,0,1,0,4902,4903,C
2-PB1,1322,3,4879,0,2,4884,T
2-PB1,1323,0,2,2,4894,4898,C
2-PB1,1324,0,1,0,4899,4900,C
2-PB1,1325,4903,1,2,0,4906,A
2-PB1,1326,4898,1,1,3,4903,A
2-PB1,1327,0,4881,0,1,4882,T
2-PB1,1328,0,0,7,4836,4843,C
2-PB1,1329,0,2,0,4806,4808,C
2-PB1,1330,0,4761,0,2,4763,T
2-PB1,1331,1,1,0,4751,4753,C
2-PB1,1332,0,1,0,4724,4725,C
2-PB1,1333,0,1,4732,0,4733,G
2-PB1,1334,4735,0,0,0,4735,A
2-PB1,1335,0,1,1,4726,4728,C
2-PB1,1336,0,0,4738,0,4738,G
2-PB1,1337,4763,0,1,0,4764,A
2-PB1,1338,2,4744,0,1,4747,T
2-PB1,1339,0,4743,0,0,4743,T
2-PB1,1340,0,4742,0,0,4742,T
2-PB1,1341,0,4745,0,5,4750,T
2-PB1,1342,5,1,4744,0,4750,G
2-PB1,1343,1,3,0,4730,4734,C
2-PB1,1344,2,18,0,4710,4730,C
2-PB1,1345,1,0,0,4850,4851,C
2-PB1,1346,1,4675,0,18,4694,T
2-PB1,1347,0,1,0,4935,4936,C
2-PB1,1348,4946,1,1,0,4948,A
2-PB1,1349,0,4944,1,1,4946,T
2-PB1,1350,4937,0,1,0,4938,A
2-PB1,1351,4788,0,3,0,4791,A
2-PB1,1352,1,4818,0,1,4820,T
2-PB1,1353,1,0,4839,0,4840,G
2-PB1,1354,4840,0,0,1,4841,A
2-PB1,1355,4840,0,0,0,4840,A
2-PB1,1356,0,4522,0,1,4523,T
2-PB1,1357,0,0,4514,0,4514,G
2-PB1,1358,1,2,0,4527,4530,C
2-PB1,1359,4556,2,1,0,4559,A
2-PB1,1360,1,3,0,4558,4562,C
2-PB1,1361,0,1,0,4550,4551,C
2-PB1,1362,4515,0,1,0,4516,A
2-PB1,1363,4522,0,0,0,4522,A
2-PB1,1364,4513,0,0,0,4513,A
2-PB1,1365,1,4396,0,2,4399,T
2-PB1,1366,1,1,0,4515,4517,C
2-PB1,1367,4542,0,1,0,4543,A
2-PB1,1368,0,4542,0,4,4546,T
2-PB1,1369,1,0,4549,0,4550,G
2-PB1,1370,4544,0,5,0,4549,A
2-PB1,1371,1,0,4576,0,4577,G
2-PB1,1372,2,3,4562,0,4567,G
2-PB1,1373,3,0,4588,0,4591,G
2-PB1,1374,4562,1,2,0,4565,A
2-PB1,1375,4644,0,2,0,4646,A
2-PB1,1376,0,4650,0,1,4651,T
2-PB1,1377,4662,0,1,0,4663,A
2-PB1,1378,0,0,0,4666,4666,C
2-PB1,1379,4673,0,3,0,4676,A
2-PB1,1380,4664,1,5,0,4670,A
2-PB1,1381,0,0,4652,0,4652,G
2-PB1,1382,0,0,0,4605,4605,C
2-PB1,1383,4576,1,2,1,4580,A
2-PB1,1384,0,0,4617,0,4617,G
2-PB1,1385,1,1,4622,0,4624,G
2-PB1,1386,4607,0,1,0,4608,A
2-PB1,1387,0,13,4622,0,4635,G
2-PB1,1388,2,4547,0,1,4550,T
2-PB1,1389,1,0,4629,1,4631,G
2-PB1,1390,1,1,4643,0,4645,G
2-PB1,1391,4636,0,6,0,4642,A
2-PB1,1392,1,4643,0,0,4644,T
2-PB1,1393,4568,1,1,0,4570,A
2-PB1,1394,1,0,4586,0,4587,G
2-PB1,1395,4666,0,1,0,4667,A
2-PB1,1396,0,4663,0,2,4665,T
2-PB1,1397,0,4649,0,1,4650,T
2-PB1,1398,1,0,0,4760,4761,C
2-PB1,1399,3,4739,0,0,4742,T
2-PB1,1400,4744,0,1,0,4745,A
2-PB1,1401,0,0,0,4741,4741,C
2-PB1,1402,4667,1,1,1,4670,A
2-PB1,1403,0,1,4663,0,4664,G
2-PB1,1404,0,3,4559,0,4562,G
2-PB1,1405,4629,1,1,0,4631,A
2-PB1,1406,0,0,0,4629,4629,C
2-PB1,1407,0,0,0,4523,4523,C
2-PB1,1408,2,4443,1,40,4486,T
2-PB1,1409,0,1,4499,0,4500,G
2-PB1,1410,1,2,1,4492,4496,C
2-PB1,1411,4502,0,2,1,4505,A
2-PB1,1412,4533,1,3,0,4537,A
2-PB1,1413,1,0,4535,1,4537,G
2-PB1,1414,0,4454,0,0,4454,T
2-PB1,1415,0,4457,0,1,4458,T
2-PB1,1416,4403,1,1,0,4405,A
2-PB1,1417,0,0,4420,0,4420,G
2-PB1,1418,0,4399,1,0,4400,T
2-PB1,1419,0,1,4397,0,4398,G
2-PB1,1420,1,1,4387,0,4389,G
2-PB1,1421,4,0,4416,0,4420,G
2-PB1,1422,4409,0,1,0,4410,A
2-PB1,1423,4424,1,1,0,4426,A
2-PB1,1424,1,4412,0,5,4418,T
2-PB1,1425,1,0,0,4421,4422,C
2-PB1,1426,4414,0,6,0,4420,A
2-PB1,1427,4423,3,2,0,4428,A
2-PB1,1428,1,1,0,4428,4430,C
2-PB1,1429,4413,1,2,0,4416,A
2-PB1,1430,0,4300,0,1,4301,T
2-PB1,1431,0,0,4309,0,4309,G
2-PB1,1432,4276,0,8,1,4285,A
2-PB1,1433,0,1,4328,0,4329,G
2-PB1,1434,0,1,0,4309,4310,C
2-PB1,1435,4307,0,0,0,4307,A
2-PB1,1436,4305,0,1,0,4306,A
2-PB1,1437,4307,1,1,0,4309,A
2-PB1,1438,4334,0,0,0,4334,A
2-PB1,1439,4329,0,2,0,4331,A
2-PB1,1440,0,0,4338,0,4338,G
2-PB1,1441,4281,0,0,0,4281,A
2-PB1,1442,4242,0,4,0,4246,A
2-PB1,1443,1,0,4383,0,4384,G
2-PB1,1444,0,4374,0,1,4375,T
2-PB1,1445,1,2,0,4383,4386,C
2-PB1,1446,2,0,1,4390,4393,C
2-PB1,1447,0,4376,0,0,4376,T
2-PB1,1448,4443,1,0,0,4444,A
2-PB1,1449,0,4430,0,3,4433,T
2-PB1,1450,4443,1,0,0,4444,A
2-PB1,1451,1,4441,0,1,4443,T
2-PB1,1452,4321,1,0,0,4322,A
2-PB1,1453,4330,0,0,1,4331,A
2-PB1,1454,4318,1,0,0,4319,A
2-PB1,1455,2,4308,0,2,4312,T
2-PB1,1456,4273,0,0,0,4273,A
2-PB1,1457,4244,0,3,1,4248,A
2-PB1,1458,4261,0,0,0,4261,A
2-PB1,1459,4263,0,2,2,4267,A
2-PB1,1460,0,0,0,4268,4268,C
2-PB1,1461,4075,0,2,0,4077,A
2-PB1,1462,2,1,4069,1,4073,G
2-PB1,1463,0,2,4061,1,4064,G
2-PB1,1464,1,0,4075,0,4076,G
2-PB1,1465,4083,0,2,0,4085,A
2-PB1,1466,0,0,1,4091,4092,C
2-PB1,1467,4061,0,0,0,4061,A
2-PB1,1468,0,4082,1,2,4085,T
2-PB1,1469,0,4069,0,3,4072,T
2-PB1,1470,2,4080,0,0,4082,T
2-PB1,1471,0,2,4068,0,4070,G
2-PB1,1472,4053,0,2,1,4056,A
2-PB1,1473,4056,0,2,0,4058,A
2-PB1,1474,1,4052,0,1,4054,T
2-PB1,1475,1,3978,0,1,3980,T
2-PB1,1476,0,1,0,3990,3991,C
2-PB1,1477,3955,2,1,0,3958,A
2-PB1,1478,0,0,0,3958,3958,C
2-PB1,1479,0,3947,0,1,3948,T
2-PB1,1480,3953,0,1,0,3954,A
2-PB1,1481,0,0,3953,0,3953,G
2-PB1,1482,0,1,1,3950,3952,C
2-PB1,1483,0,3931,0,9,3940,T
2-PB1,1484,0,3948,0,0,3948,T
2-PB1,1485,0,3931,0,1,3932,T
2-PB1,1486,2,3930,0,1,3933,T
2-PB1,1487,0,3937,1,0,3938,T
2-PB1,1488,0,3935,1,1,3937,T
2-PB1,1489,0,3927,0,1,3928,T
2-PB1,1490,3923,0,0,0,3923,A
2-PB1,1491,0,3911,0,1,3912,T
2-PB1,1492,0,3,0,3911,3914,C
2-PB1,1493,2,0,3924,0,3926,G
2-PB1,1494,4023,3,0,0,4026,A
2-PB1,1495,0,4035,0,0,4035,T
2-PB1,1496,4021,0,1,0,4022,A
2-PB1,1497,0,4053,0,4,4057,T
2-PB1,1498,1,1,4048,0,4050,G
2-PB1,1499,1,1,4053,0,4055,G
2-PB1,1500,4057,1,1,0,4059,A
2-PB1,1501,2,4047,0,0,4049,T
2-PB1,1502,0,4014,0,2,4016,T
2-PB1,1503,1,3894,1,2,3898,T
2-PB1,1504,1,0,3899,0,3900,G
2-PB1,1505,1,3871,0,2,3874,T
2-PB1,1506,2,1,3858,0,3861,G
2-PB1,1507,1,0,3862,0,3863,G
2-PB1,1508,0,1,1,3837,3839,C
2-PB1,1509,0,3832,0,2,3834,T
2-PB1,1510,3845,0,2,0,3847,A
2-PB1,1511,3864,1,0,0,3865,A
2-PB1,1512,0,3875,1,1,3877,T
2-PB1,1513,0,3883,0,2,3885,T
2-PB1,1514,0,3890,0,0,3890,T
2-PB1,1515,0,3895,0,1,3896,T
2-PB1,1516,3888,1,2,0,3891,A
2-PB1,1517,0,0,3914,0,3914,G
2-PB1,1518,2,1,1,3905,3909,C
2-PB1,1519,3900,0,2,0,3902,A
2-PB1,1520,0,3857,0,2,3859,T
2-PB1,1521,1,1,3813,0,3815,G
2-PB1,1522,0,1,3872,0,3873,G
2-PB1,1523,3854,0,3,1,3858,A
2-PB1,1524,0,0,3866,0,3866,G
2-PB1,1525,0,0,1,3854,3855,C
2-PB1,1526,0,3811,0,2,3813,T
2-PB1,1527,1,0,3818,0,3819,G
2-PB1,1528,2,0,0,3808,3810,C
2-PB1,1529,1,0,0,3801,3802,C
2-PB1,1530,3,0,0,3819,3822,C
2-PB1,1531,3689,2,1,0,3692,A
2-PB1,1532,0,0,3843,0,3843,G
2-PB1,1533,1,3835,0,0,3836,T
2-PB1,1534,0,3833,0,0,3833,T
2-PB1,1535,1,3823,1,0,3825,T
2-PB1,1536,0,3767,0,0,3767,T
2-PB1,1537,0,0,3754,0,3754,G
2-PB1,1538,1,0,3760,0,3761,G
2-PB1,1539,3737,1,1,0,3739,A
2-PB1,1540,1,0,3748,0,3749,G
2-PB1,1541,1,3416,0,0,3417,T
2-PB1,1542,3,0,3550,1,3554,G
2-PB1,1543,0,3535,0,3,3538,T
2-PB1,1544,1,1,0,3538,3540,C
2-PB1,1545,2,3539,1,2,3544,T
2-PB1,1546,0,1,3556,0,3557,G
2-PB1,1547,0,1,3580,0,3581,G
2-PB1,1548,3579,1,3,0,3583,A
2-PB1,1549,3581,0,4,0,3585,A
2-PB1,1550,0,3565,0,0,3565,T
2-PB1,1551,3220,0,1,1,3222,A
2-PB1,1552,3221,1,1,1,3224,A
2-PB1,1553,3224,0,2,1,3227,A
2-PB1,1554,0,0,0,3233,3233,C
2-PB1,1555,0,1,3193,0,3194,G
2-PB1,1556,3134,0,1,1,3136,A
2-PB1,1557,0,0,3140,0,3140,G
2-PB1,1558,0,3122,0,1,3123,T
2-PB1,1559,0,0,1,3135,3136,C
2-PB1,1560,3111,1,4,0,3116,A
2-PB1,1561,2,0,3150,0,3152,G
2-PB1,1562,0,1,0,3155,3156,C
2-PB1,1563,0,3147,1,3,3151,T
2-PB1,1564,0,0,3223,0,3223,G
2-PB1,1565,3189,0,3,0,3192,A
2-PB1,1566,0,3189,2,1,3192,T
2-PB1,1567,3192,0,3,0,3195,A
2-PB1,1568,0,3129,0,1,3130,T
2-PB1,1569,0,0,3143,0,3143,G
2-PB1,1570,2979,1,3,0,2983,A
2-PB1,1571,1,1,3029,0,3031,G
2-PB1,1572,0,0,5,3023,3028,C
2-PB1,1573,2791,0,0,0,2791,A
2-PB1,1574,0,2781,0,0,2781,T
2-PB1,1575,1,2772,0,1,2774,T
2-PB1,1576,1,0,2803,0,2804,G
2-PB1,1577,0,0,2908,0,2908,G
2-PB1,1578,2838,1,1,0,2840,A
2-PB1,1579,0,0,2848,0,2848,G
2-PB1,1580,0,2714,0,2,2716,T
2-PB1,1581,2697,0,2,0,2699,A
2-PB1,1582,2695,0,0,0,2695,A
2-PB1,1583,0,0,0,2706,2706,C
2-PB1,1584,2681,0,1,0,2682,A
2-PB1,1585,1,0,2723,0,2724,G
2-PB1,1586,2,2322,0,2,2326,T
2-PB1,1587,0,0,2345,0,2345,G
2-PB1,1588,2371,0,3,0,2374,A
2-PB1,1589,1,2367,0,0,2368,T
2-PB1,1590,2359,0,0,0,2359,A
2-PB1,1591,2354,0,0,0,2354,A
2-PB1,1592,2263,0,1,0,2264,A
2-PB1,1593,0,0,2280,0,2280,G
2-PB1,1594,2124,0,1,0,2125,A
2-PB1,1595,2123,0,0,0,2123,A
2-PB1,1596,0,0,0,2120,2120,C
2-PB1,1597,2017,2,0,1,2020,A
2-PB1,1598,2039,0,0,0,2039,A
2-PB1,1599,0,2,0,2037,2039,C
2-PB1,1600,2065,0,1,1,2067,A
2-PB1,1601,0,2065,3,0,2068,T
2-PB1,1602,0,1,1996,0,1997,G
2-PB1,1603,1996,0,2,0,1998,A
2-PB1,1604,0,1998,0,0,1998,T
2-PB1,1605,1963,0,0,0,1963,A
2-PB1,1606,1981,0,0,0,1981,A
2-PB1,1607,1957,0,0,0,1957,A
2-PB1,1608,0,0,0,1971,1971,C
2-PB1,1609,1818,1,0,0,1819,A
2-PB1,1610,1812,0,1,0,1813,A
2-PB1,1611,0,1764,0,1,1765,T
2-PB1,1612,0,0,1769,1,1770,G
2-PB1,1613,1811,3,3,0,1817,A
2-PB1,1614,0,0,0,1847,1847,C
2-PB1,1615,0,1,1,1800,1802,C
2-PB1,1616,0,1721,0,0,1721,T
2-PB1,1617,0,1653,0,1,1654,T
2-PB1,1618,1,1,1657,0,1659,G
2-PB1,1619,0,0,1696,0,1696,G
2-PB1,1620,1730,0,2,0,1732,A
2-PB1,1621,0,0,0,1830,1830,C
2-PB1,1622,0,0,0,1822,1822,C
2-PB1,1623,1808,0,0,0,1808,A
2-PB1,1624,1,0,1835,0,1836,G
2-PB1,1625,1,0,0,1842,1843,C
2-PB1,1626,1839,1,1,1,1842,A
2-PB1,1627,1841,0,0,0,1841,A
2-PB1,1628,0,0,0,1836,1836,C
2-PB1,1629,1826,0,0,0,1826,A
2-PB1,1630,0,0,1861,0,1861,G
2-PB1,1631,1,0,1,1854,1856,C
2-PB1,1632,0,0,0,1862,1862,C
2-PB1,1633,1,0,0,1866,1867,C
2-PB1,1634,1870,0,0,0,1870,A
2-PB1,1635,1864,0,0,0,1864,A
2-PB1,1636,1867,0,1,0,1868,A
2-PB1,1637,0,1868,0,0,1868,T
2-PB1,1638,0,0,1866,0,1866,G
2-PB1,1639,0,0,1847,0,1847,G
2-PB1,1640,1,1,0,1848,1850,C
2-PB1,1641,2,1838,0,1,1841,T
2-PB1,1642,0,1,0,1879,1880,C
2-PB1,1643,0,1874,0,2,1876,T
2-PB1,1644,0,0,0,1889,1889,C
2-PB1,1645,0,0,0,1895,1895,C
2-PB1,1646,1900,0,0,0,1900,A
2-PB1,1647,1908,1,1,0,1910,A
2-PB1,1648,0,1899,0,1,1900,T
2-PB1,1649,0,1886,0,0,1886,T
2-PB1,1650,0,0,1892,0,1892,G
2-PB1,1651,0,1853,0,3,1856,T
2-PB1,1652,0,1855,1,1,1857,T
2-PB1,1653,0,8,0,1852,1860,C
2-PB1,1654,1855,4,0,1,1860,A
2-PB1,1655,1,1855,0,1,1857,T
2-PB1,1656,0,0,0,1864,1864,C
2-PB1,1657,1868,0,1,0,1869,A
2-PB1,1658,1864,0,0,1,1865,A
2-PB1,1659,1861,0,5,0,1866,A
2-PB1,1660,0,0,1896,0,1896,G
2-PB1,1661,1893,0,0,0,1893,A
2-PB1,1662,0,1894,0,0,1894,T
2-PB1,1663,0,1900,0,0,1900,T
2-PB1,1664,1904,0,0,0,1904,A
2-PB1,1665,0,0,0,1937,1937,C
2-PB1,1666,1932,0,0,0,1932,A
2-PB1,1667,1,0,1958,0,1959,G
2-PB1,1668,1959,0,0,0,1959,A
2-PB1,1669,0,1996,0,0,1996,T
2-PB1,1670,2006,0,1,1,2008,A
2-PB1,1671,1,0,0,2116,2117,C
2-PB1,1672,2162,0,1,0,2163,A
2-PB1,1673,0,0,0,2291,2291,C
2-PB1,1674,2264,0,1,0,2265,A
2-PB1,1675,0,2286,0,0,2286,T
2-PB1,1676,2269,1,0,0,2270,A
2-PB1,1677,0,2267,0,1,2268,T
2-PB1,1678,2227,0,0,0,2227,A
2-PB1,1679,0,0,2226,0,2226,G
2-PB1,1680,0,0,2217,0,2217,G
2-PB1,1681,0,2112,0,2,2114,T
2-PB1,1682,0,0,2073,0,2073,G
2-PB1,1683,0,0,0,2148,2148,C
2-PB1,1684,0,0,0,2147,2147,C
2-PB1,1685,2172,0,1,0,2173,A
2-PB1,1686,0,2173,0,0,2173,T
2-PB1,1687,2183,1,0,0,2184,A
2-PB1,1688,0,0,2192,0,2192,G
2-PB1,1689,2139,1,4,0,2144,A
2-PB1,1690,1,1,2160,0,2162,G
2-PB1,1691,0,0,2146,0,2146,G
2-PB1,1692,2085,0,0,0,2085,A
2-PB1,1693,0,0,2092,0,2092,G
2-PB1,1694,2074,0,1,0,2075,A
2-PB1,1695,0,0,0,2081,2081,C
2-PB1,1696,2087,0,3,0,2090,A
2-PB1,1697,0,1,0,2125,2126,C
2-PB1,1698,2124,1,1,0,2126,A
2-PB1,1699,0,1,0,2122,2123,C
2-PB1,1700,2104,0,1,0,2105,A
2-PB1,1701,2109,0,0,0,2109,A
2-PB1,1702,2113,0,1,0,2114,A
2-PB1,1703,0,2043,0,71,2114,T
2-PB1,1704,3,0,0,2118,2121,C
2-PB1,1705,0,0,0,2122,2122,C
2-PB1,1706,2101,1,2,0,2104,A
2-PB1,1707,0,0,2113,0,2113,G
2-PB1,1708,2113,0,1,0,2114,A
2-PB1,1709,1,1,0,2126,2128,C
2-PB1,1710,0,0,2123,0,2123,G
2-PB1,1711,2105,2,0,0,2107,A
2-PB1,1712,0,1,2110,0,2111,G
2-PB1,1713,2111,1,0,0,2112,A
2-PB1,1714,2111,0,2,0,2113,A
2-PB1,1715,1,0,2123,0,2124,G
2-PB1,1716,2116,0,3,0,2119,A
2-PB1,1717,0,2112,0,4,2116,T
2-PB1,1718,0,0,0,2106,2106,C
2-PB1,1719,2110,0,0,0,2110,A
2-PB1,1720,0,2099,0,0,2099,T
2-PB1,1721,0,2099,0,0,2099,T
2-PB1,1722,0,2,1,2097,2100,C
2-PB1,1723,1,0,2107,0,2108,G
2-PB1,1724,2091,0,1,0,2092,A
2-PB1,1725,0,1,2100,1,2102,G
2-PB1,1726,2087,0,0,0,2087,A
2-PB1,1727,0,2168,0,1,2169,T
2-PB1,1728,2176,0,0,1,2177,A
2-PB1,1729,2174,0,2,0,2176,A
2-PB1,1730,2175,0,3,0,2178,A
2-PB1,1731,7,2,2175,0,2184,G
2-PB1,1732,2184,1,0,0,2185,A
2-PB1,1733,2139,1,1,1,2142,A
2-PB1,1734,0,0,2154,0,2154,G
2-PB1,1735,0,1,0,2153,2154,C
2-PB1,1736,2,2138,1,0,2141,T
2-PB1,1737,1,0,2152,0,2153,G
2-PB1,1738,0,2141,0,2,2143,T
2-PB1,1739,1,1,2136,0,2138,G
2-PB1,1740,0,0,2151,0,2151,G
2-PB1,1741,1,3,2158,0,2162,G
2-PB1,1742,2162,1,1,0,2164,A
2-PB1,1743,1,2140,0,1,2142,T
2-PB1,1744,1,0,0,2143,2144,C
2-PB1,1745,2146,1,0,0,2147,A
2-PB1,1746,2156,0,0,1,2157,A
2-PB1,1747,2167,1,1,0,2169,A
2-PB1,1748,0,2,0,2154,2156,C
2-PB1,1749,1,0,0,2160,2161,C
2-PB1,1750,0,0,0,2160,2160,C
2-PB1,1751,2153,0,0,0,2153,A
2-PB1,1752,2182,1,0,0,2183,A
2-PB1,1753,0,2173,0,1,2174,T
2-PB1,1754,0,0,0,2177,2177,C
2-PB1,1755,2157,1,1,0,2159,A
2-PB1,1756,2148,0,1,1,2150,A
2-PB1,1757,1,3,2157,0,2161,G
2-PB1,1758,1,0,2150,0,2151,G
2-PB1,1759,0,0,2155,0,2155,G
2-PB1,1760,0,2,0,2159,2161,C
2-PB1,1761,2131,1,1,0,2133,A
2-PB1,1762,0,1,2172,0,2173,G
2-PB1,1763,0,1,2186,2,2189,G
2-PB1,1764,2195,0,0,0,2195,A
2-PB1,1765,0,1,1,2215,2217,C
2-PB1,1766,0,2183,0,2,2185,T
2-PB1,1767,2263,1,1,0,2265,A
2-PB1,1768,0,2260,0,1,2261,T
2-PB1,1769,0,2262,0,0,2262,T
2-PB1,1770,0,0,2270,0,2270,G
2-PB1,1771,1,0,2291,0,2292,G
2-PB1,1772,0,2268,0,3,2271,T
2-PB1,1773,2277,0,1,0,2278,A
2-PB1,1774,0,2250,0,1,2251,T
2-PB1,1775,0,1,0,2263,2264,C
2-PB1,1776,2223,0,3,0,2226,A
2-PB1,1777,0,0,2247,2,2249,G
2-PB1,1778,2234,2,0,1,2237,A
2-PB1,1779,0,2231,0,0,2231,T
2-PB1,1780,0,2,2165,0,2167,G
2-PB1,1781,0,2,2152,0,2154,G
2-PB1,1782,0,1,2155,0,2156,G
2-PB1,1783,0,0,2152,0,2152,G
2-PB1,1784,1,0,2157,0,2158,G
2-PB1,1785,2154,0,1,0,2155,A
2-PB1,1786,1,1,0,2140,2142,C
2-PB1,1787,0,1,0,2137,2138,C
2-PB1,1788,2140,0,0,0,2140,A
2-PB1,1789,2265,0,0,0,2265,A
2-PB1,1790,2271,0,0,1,2272,A
2-PB1,1791,0,1,0,2311,2312,C
2-PB1,1792,1,2290,0,0,2291,T
2-PB1,1793,0,2282,0,0,2282,T
2-PB1,1794,2291,0,0,1,2292,A
2-PB1,1795,1,2288,0,4,2293,T
2-PB1,1796,2297,0,2,1,2300,A
2-PB1,1797,1,0,1,2301,2303,C
2-PB1,1798,2141,0,0,1,2142,A
2-PB1,1799,2151,0,1,0,2152,A
2-PB1,1800,1,2097,0,0,2098,T
2-PB1,1801,2128,0,0,0,2128,A
2-PB1,1802,0,2126,0,0,2126,T
2-PB1,1803,0,0,0,2114,2114,C
2-PB1,1804,0,1,2,2113,2116,C
2-PB1,1805,0,2,2115,0,2117,G
2-PB1,1806,0,1,2111,2,2114,G
2-PB1,1807,2118,0,0,0,2118,A
2-PB1,1808,2123,0,0,0,2123,A
2-PB1,1809,0,2126,0,0,2126,T
2-PB1,1810,0,2,0,2129,2131,C
2-PB1,1811,0,2127,2,1,2130,T
2-PB1,1812,0,2141,0,0,2141,T
2-PB1,1813,1,2,0,2140,2143,C
2-PB1,1814,2139,1,0,0,2140,A
2-PB1,1815,0,0,0,2145,2145,C
2-PB1,1816,2141,0,0,0,2141,A
2-PB1,1817,0,2275,0,0,2275,T
2-PB1,1818,1,0,0,2280,2281,C
2-PB1,1819,1,1,0,2289,2291,C
2-PB1,1820,0,2,1,2299,2302,C
2-PB1,1821,0,2301,0,2,2303,T
2-PB1,1822,0,0,2308,1,2309,G
2-PB1,1823,2303,0,1,0,2304,A
2-PB1,1824,2303,0,0,0,2303,A
2-PB1,1825,0,1,2302,0,2303,G
2-PB1,1826,0,2179,0,0,2179,T
2-PB1,1827,0,0,0,2186,2186,C
2-PB1,1828,0,2147,2,0,2149,T
2-PB1,1829,0,1,2199,1,2201,G
2-PB1,1830,0,0,0,2201,2201,C
2-PB1,1831,0,2204,0,2,2206,T
2-PB1,1832,0,2204,1,2,2207,T
2-PB1,1833,2207,0,0,0,2207,A
2-PB1,1834,2201,1,0,0,2202,A
2-PB1,1835,2211,0,2,0,2213,A
2-PB1,1836,0,1,2217,0,2218,G
2-PB1,1837,2,2188,0,3,2193,T
2-PB1,1838,0,1,2153,0,2154,G
2-PB1,1839,0,0,2184,2,2186,G
2-PB1,1840,0,0,2184,1,2185,G
2-PB1,1841,2169,0,2,0,2171,A
2-PB1,1842,0,1,2157,0,2158,G
2-PB1,1843,34,0,0,2123,2157,C
2-PB1,1844,0,2269,0,0,2269,T
2-PB1,1845,0,0,2267,0,2267,G
2-PB1,1846,2272,1,1,0,2274,A
2-PB1,1847,0,2270,0,0,2270,T
2-PB1,1848,0,0,2270,0,2270,G
2-PB1,1849,0,1,2270,0,2271,G
2-PB1,1850,2270,1,2,0,2273,A
2-PB1,1851,1,2258,0,0,2259,T
2-PB1,1852,1,0,2265,0,2266,G
2-PB1,1853,2256,1,0,0,2257,A
2-PB1,1854,0,0,2321,0,2321,G
2-PB1,1855,2310,0,2,0,2312,A
2-PB1,1856,2324,0,0,0,2324,A
2-PB1,1857,0,2327,0,0,2327,T
2-PB1,1858,0,2327,0,0,2327,T
2-PB1,1859,2333,0,1,0,2334,A
2-PB1,1860,1,2335,0,0,2336,T
2-PB1,1861,0,1,0,2341,2342,C
2-PB1,1862,1,0,2374,0,2375,G
2-PB1,1863,0,1,2353,0,2354,G
2-PB1,1864,0,1,2343,0,2344,G
2-PB1,1865,0,2,2340,1,2343,G
2-PB1,1866,2340,0,0,0,2340,A
2-PB1,1867,2343,0,0,0,2343,A
2-PB1,1868,0,0,2362,0,2362,G
2-PB1,1869,2406,0,0,0,2406,A
2-PB1,1870,1,1,0,2426,2428,C
2-PB1,1871,0,2402,1,0,2403,T
2-PB1,1872,1,2469,0,0,2470,T
2-PB1,1873,2,2476,0,2,2480,T
2-PB1,1874,1,0,2511,0,2512,G
2-PB1,1875,2,2509,1,0,2512,T
2-PB1,1876,2492,0,2,1,2495,A
2-PB1,1877,2489,1,1,0,2491,A
2-PB1,1878,0,2453,0,1,2454,T
2-PB1,1879,0,0,1,2486,2487,C
2-PB1,1880,1,1,0,2486,2488,C
2-PB1,1881,1,0,0,2494,2495,C
2-PB1,1882,2,0,0,2506,2508,C
2-PB1,1883,0,2501,0,3,2504,T
2-PB1,1884,0,0,2504,0,2504,G
2-PB1,1885,2504,0,0,0,2504,A
2-PB1,1886,2522,0,0,0,2522,A
2-PB1,1887,1,2528,1,1,2531,T
2-PB1,1888,1,0,0,2520,2521,C
2-PB1,1889,0,1,0,2514,2515,C
2-PB1,1890,1,1,0,2492,2494,C
2-PB1,1891,0,2487,0,1,2488,T
2-PB1,1892,2,2488,0,1,2491,T
2-PB1,1893,0,2496,0,1,2497,T
2-PB1,1894,0,0,2491,0,2491,G
2-PB1,1895,0,2486,0,0,2486,T
2-PB1,1896,1,0,0,2483,2484,C
2-PB1,1897,2464,1,3,0,2468,A
2-PB1,1898,1,3,2524,0,2528,G
2-PB1,1899,0,0,0,2523,2523,C
2-PB1,1900,0,0,0,2521,2521,C
2-PB1,1901,2528,0,0,0,2528,A
2-PB1,1902,0,2531,0,1,2532,T
2-PB1,1903,2536,0,0,0,2536,A
2-PB1,1904,2539,1,1,0,2541,A
2-PB1,1905,2541,0,2,0,2543,A
2-PB1,1906,0,0,2591,0,2591,G
2-PB1,1907,2540,1,0,0,2541,A
2-PB1,1908,2544,1,0,0,2545,A
2-PB1,1909,2543,0,0,0,2543,A
2-PB1,1910,0,2538,0,0,2538,T
2-PB1,1911,0,2535,0,0,2535,T
2-PB1,1912,1,0,2537,0,2538,G
2-PB1,1913,2520,0,2,0,2522,A
2-PB1,1914,1,0,2586,0,2587,G
2-PB1,1915,0,2607,0,0,2607,T
2-PB1,1916,0,0,0,2646,2646,C
2-PB1,1917,0,2635,0,0,2635,T
2-PB1,1918,0,0,2723,0,2723,G
2-PB1,1919,0,2721,0,0,2721,T
2-PB1,1920,2764,0,0,0,2764,A
2-PB1,1921,2756,0,3,0,2759,A
2-PB1,1922,2761,0,1,0,2762,A
2-PB1,1923,0,0,0,2773,2773,C
2-PB1,1924,2703,0,0,0,2703,A
2-PB1,1925,2805,1,0,0,2806,A
2-PB1,1926,0,2803,0,1,2804,T
2-PB1,1927,2,0,2800,0,2802,G
2-PB1,1928,0,0,0,2850,2850,C
2-PB1,1929,0,2811,0,2,2813,T
2-PB1,1930,0,1,2936,0,2937,G
2-PB1,1931,0,2946,0,1,2947,T
2-PB1,1932,3015,0,0,1,3016,A
2-PB1,1933,0,0,3024,0,3024,G
2-PB1,1934,0,2954,0,0,2954,T
2-PB1,1935,2936,0,1,0,2937,A
2-PB1,1936,2922,0,2,0,2924,A
2-PB1,1937,0,2902,0,0,2902,T
2-PB1,1938,4,0,2892,0,2896,G
2-PB1,1939,0,0,0,2860,2860,C
2-PB1,1940,0,2,0,2829,2831,C
2-PB1,1941,2801,0,1,0,2802,A
2-PB1,1942,0,1,2849,0,2850,G
2-PB1,1943,1,1,0,2965,2967,C
2-PB1,1944,2,0,1,2959,2962,C
2-PB1,1945,2,0,0,2954,2956,C
2-PB1,1946,2941,0,5,0,2946,A
2-PB1,1947,0,2927,0,24,2951,T
2-PB1,1948,0,1,2952,0,2953,G
2-PB1,1949,2,0,2954,0,2956,G
2-PB1,1950,1,2947,0,1,2949,T
2-PB1,1951,1,0,0,2931,2932,C
2-PB1,1952,0,0,0,2861,2861,C
2-PB1,1953,0,0,2900,0,2900,G
2-PB1,1954,3,0,2901,0,2904,G
2-PB1,1955,1,2,0,2881,2884,C
2-PB1,1956,0,2,0,2891,2893,C
2-PB1,1957,2896,1,0,0,2897,A
2-PB1,1958,2899,0,1,0,2900,A
2-PB1,1959,2902,1,0,1,2904,A
2-PB1,1960,2917,0,1,1,2919,A
2-PB1,1961,0,3,2960,0,2963,G
2-PB1,1962,0,2911,1,2,2914,T
2-PB1,1963,2930,0,1,0,2931,A
2-PB1,1964,0,2932,0,0,2932,T
2-PB1,1965,0,0,2940,0,2940,G
2-PB1,1966,0,2,3002,0,3004,G
2-PB1,1967,2987,1,0,0,2988,A
2-PB1,1968,3022,0,1,0,3023,A
2-PB1,1969,3,3014,0,3,3020,T
2-PB1,1970,2976,0,1,0,2977,A
2-PB1,1971,2,2964,1,5,2972,T
2-PB1,1972,0,0,2957,0,2957,G
2-PB1,1973,2970,0,4,0,2974,A
2-PB1,1974,0,2965,0,0,2965,T
2-PB1,1975,1,0,2893,0,2894,G
2-PB1,1976,0,0,0,2896,2896,C
2-PB1,1977,1,2833,0,0,2834,T
2-PB1,1978,0,0,2912,0,2912,G
2-PB1,1979,1,2913,0,1,2915,T
2-PB1,1980,2,2919,0,3,2924,T
2-PB1,1981,0,1,2916,0,2917,G
2-PB1,1982,0,1,0,2963,2964,C
2-PB1,1983,2962,0,0,0,2962,A
2-PB1,1984,3008,1,0,0,3009,A
2-PB1,1985,0,0,0,3027,3027,C
2-PB1,1986,0,3005,1,0,3006,T
2-PB1,1987,2997,0,1,0,2998,A
2-PB1,1988,0,0,0,2993,2993,C
2-PB1,1989,2986,0,2,0,2988,A
2-PB1,1990,0,2,0,2995,2997,C
2-PB1,1991,2939,0,0,1,2940,A
2-PB1,1992,0,2,0,3229,3231,C
2-PB1,1993,0,3184,0,3,3187,T
2-PB1,1994,0,1,1,3200,3202,C
2-PB1,1995,1,0,0,3200,3201,C
2-PB1,1996,0,3187,0,5,3192,T
2-PB1,1997,0,1,3190,0,3191,G
2-PB1,1998,0,0,3188,0,3188,G
2-PB1,1999,3181,1,0,0,3182,A
2-PB1,2000,0,3182,0,1,3183,T
2-PB1,2001,0,2949,0,1,2950,T
2-PB1,2002,1,0,1,3005,3007,C
2-PB1,2003,0,1,0,2984,2985,C
2-PB1,2004,1,2,0,2998,3001,C
2-PB1,2005,3012,0,1,0,3013,A
2-PB1,2006,3012,0,0,0,3012,A
2-PB1,2007,0,0,3024,0,3024,G
2-PB1,2008,3015,0,4,0,3019,A
2-PB1,2009,0,3,3015,0,3018,G
2-PB1,2010,1,1,3031,1,3034,G
2-PB1,2011,2967,1,3,0,2971,A
2-PB1,2012,2967,1,11,0,2979,A
2-PB1,2013,2,1,0,2974,2977,C
2-PB1,2014,0,1,0,2969,2970,C
2-PB1,2015,0,0,3016,0,3016,G
2-PB1,2016,0,0,0,3011,3011,C
2-PB1,2017,0,3005,0,2,3007,T
2-PB1,2018,0,0,0,3015,3015,C
2-PB1,2019,0,3001,1,0,3002,T
2-PB1,2020,3257,0,0,0,3257,A
2-PB1,2021,0,3257,0,2,3259,T
2-PB1,2022,0,3283,0,1,3284,T
2-PB1,2023,0,0,0,3291,3291,C
2-PB1,2024,0,3219,0,0,3219,T
2-PB1,2025,3220,0,0,0,3220,A
2-PB1,2026,3223,0,0,0,3223,A
2-PB1,2027,3234,0,1,0,3235,A
2-PB1,2028,0,0,0,3237,3237,C
2-PB1,2029,3052,0,0,0,3052,A
2-PB1,2030,0,2,0,3045,3047,C
2-PB1,2031,3008,1,1,0,3010,A
2-PB1,2032,3014,1,19,0,3034,A
2-PB1,2033,0,0,3058,1,3059,G
2-PB1,2034,1,0,0,3057,3058,C
2-PB1,2035,1,4,0,3059,3064,C
2-PB1,2036,3042,1,1,1,3045,A
2-PB1,2037,3037,0,0,0,3037,A
2-PB1,2038,3036,1,0,1,3038,A
2-PB1,2039,1,1,3066,0,3068,G
2-PB1,2040,0,1,3068,0,3069,G
2-PB1,2041,1,0,3033,0,3034,G
2-PB1,2042,1,0,3031,1,3033,G
2-PB1,2043,3017,0,3,0,3020,A
2-PB1,2044,3038,0,1,0,3039,A
2-PB1,2045,0,3038,0,0,3038,T
2-PB1,2046,0,3047,0,1,3048,T
2-PB1,2047,0,0,0,3063,3063,C
2-PB1,2048,0,3028,0,8,3036,T
2-PB1,2049,0,3029,0,1,3030,T
2-PB1,2050,0,1,3030,0,3031,G
2-PB1,2051,3032,1,3,0,3036,A
2-PB1,2052,0,0,3061,0,3061,G
2-PB1,2053,0,0,3040,0,3040,G
2-PB1,2054,3040,0,1,0,3041,A
2-PB1,2055,0,3036,0,1,3037,T
2-PB1,2056,0,0,3068,0,3068,G
2-PB1,2057,3060,1,4,0,3065,A
2-PB1,2058,3062,2,4,0,3068,A
2-PB1,2059,0,0,0,3089,3089,C
2-PB1,2060,3062,0,1,0,3063,A
2-PB1,2061,0,0,3112,0,3112,G
2-PB1,2062,3095,1,1,1,3098,A
2-PB1,2063,0,3088,1,2,3091,T
2-PB1,2064,0,0,3099,0,3099,G
2-PB1,2065,0,3148,0,1,3149,T
2-PB1,2066,3158,2,0,0,3160,A
2-PB1,2067,1,1,0,3163,3165,C
2-PB1,2068,0,1,0,3138,3139,C
2-PB1,2069,3110,1,1,0,3112,A
2-PB1,2070,0,0,3078,0,3078,G
2-PB1,2071,3025,0,1,0,3026,A
2-PB1,2072,3012,2,3,0,3017,A
2-PB1,2073,1,1,3031,0,3033,G
2-PB1,2074,1,2879,0,2,2882,T
2-PB1,2075,0,0,2880,1,2881,G
2-PB1,2076,0,1,0,2878,2879,C
2-PB1,2077,0,2879,0,3,2882,T
2-PB1,2078,0,0,2877,0,2877,G
2-PB1,2079,0,0,0,2870,2870,C
2-PB1,2080,2865,0,1,0,2866,A
2-PB1,2081,2870,1,2,0,2873,A
2-PB1,2082,0,0,0,2835,2835,C
2-PB1,2083,0,2823,0,1,2824,T
2-PB1,2084,0,2793,0,1,2794,T
2-PB1,2085,0,0,2793,0,2793,G
2-PB1,2086,0,2784,0,3,2787,T
2-PB1,2087,1,2778,0,0,2779,T
2-PB1,2088,0,0,0,2782,2782,C
2-PB1,2089,1,0,2779,0,2780,G
2-PB1,2090,2776,1,0,0,2777,A
2-PB1,2091,1,0,2776,0,2777,G
2-PB1,2092,2777,1,1,0,2779,A
2-PB1,2093,2781,0,0,1,2782,A
2-PB1,2094,2778,0,0,0,2778,A
2-PB1,2095,0,2771,0,1,2772,T
2-PB1,2096,0,2773,0,2,2775,T
2-PB1,2097,0,2773,0,1,2774,T
2-PB1,2098,0,2780,0,0,2780,T
2-PB1,2099,1,2774,0,1,2776,T
2-PB1,2100,0,0,0,2783,2783,C
2-PB1,2101,1,0,0,2775,2776,C
2-PB1,2102,0,0,0,2793,2793,C
2-PB1,2103,0,2785,1,0,2786,T
2-PB1,2104,2783,0,0,0,2783,A
2-PB1,2105,0,0,2803,0,2803,G
2-PB1,2106,0,2805,0,0,2805,T
2-PB1,2107,2831,0,0,1,2832,A
2-PB1,2108,0,0,2844,0,2844,G
2-PB1,2109,0,2817,0,3,2820,T
2-PB1,2110,0,2903,0,1,2904,T
2-PB1,2111,1,1,0,2914,2916,C
2-PB1,2112,2955,1,4,0,2960,A
2-PB1,2113,0,2965,0,0,2965,T
2-PB1,2114,2966,0,0,1,2967,A
2-PB1,2115,0,2965,0,2,2967,T
2-PB1,2116,2880,1,0,1,2882,A
2-PB1,2117,0,0,2867,0,2867,G
2-PB1,2118,1,0,2850,1,2852,G
2-PB1,2119,2579,0,1,0,2580,A
2-PB1,2120,0,0,2582,0,2582,G
2-PB1,2121,2441,0,1,0,2442,A
2-PB1,2122,1,0,1,2428,2430,C
2-PB1,2123,0,1,0,2361,2362,C
2-PB1,2124,0,1,2359,0,2360,G
2-PB1,2125,2360,0,0,0,2360,A
2-PB1,2126,0,2339,0,0,2339,T
2-PB1,2127,1,2347,0,1,2349,T
2-PB1,2128,0,1,2346,0,2347,G
2-PB1,2129,1,0,2349,0,2350,G
2-PB1,2130,2347,0,1,1,2349,A
2-PB1,2131,2352,0,1,0,2353,A
2-PB1,2132,1,2338,0,0,2339,T
2-PB1,2133,0,2348,0,0,2348,T
2-PB1,2134,0,2348,0,0,2348,T
2-PB1,2135,0,0,0,2351,2351,C
2-PB1,2136,1,2348,0,2,2351,T
2-PB1,2137,2334,1,5,0,2340,A
2-PB1,2138,1,0,2349,0,2350,G
2-PB1,2139,0,0,0,2344,2344,C
2-PB1,2140,2344,0,0,0,2344,A
2-PB1,2141,0,2340,0,2,2342,T
2-PB1,2142,0,0,2317,0,2317,G
2-PB1,2143,1,0,2383,0,2384,G
2-PB1,2144,0,2386,0,1,2387,T
2-PB1,2145,0,0,2385,0,2385,G
2-PB1,2146,1,0,2385,0,2386,G
2-PB1,2147,2343,0,14,0,2357,A
2-PB1,2148,0,2,2374,0,2376,G
2-PB1,2149,1,0,2369,0,2370,G
2-PB1,2150,0,0,0,2366,2366,C
2-PB1,2151,0,0,0,2334,2334,C
2-PB1,2152,2156,0,0,0,2156,A
2-PB1,2153,0,2158,0,0,2158,T
2-PB1,2154,0,1,2174,0,2175,G
2-PB1,2155,0,0,2179,0,2179,G
2-PB1,2156,0,2152,1,1,2154,T
2-PB1,2157,2038,0,0,0,2038,A
2-PB1,2158,2,2073,0,0,2075,T
2-PB1,2159,0,0,1,2080,2081,C
2-PB1,2160,0,2083,0,1,2084,T
2-PB1,2161,2024,1,2,1,2028,A
2-PB1,2162,0,0,2019,0,2019,G
2-PB1,2163,0,0,1928,0,1928,G
2-PB1,2164,1,0,1898,0,1899,G
2-PB1,2165,0,0,0,1857,1857,C
2-PB1,2166,0,2,0,1813,1815,C
2-PB1,2167,1,1,0,1796,1798,C
2-PB1,2168,1,0,1781,0,1782,G
2-PB1,2169,1,0,1786,0,1787,G
2-PB1,2170,1788,2,0,0,1790,A
2-PB1,2171,0,1793,0,0,1793,T
2-PB1,2172,1,1730,0,0,1731,T
2-PB1,2173,0,0,1714,0,1714,G
2-PB1,2174,1713,0,1,1,1715,A
2-PB1,2175,1,1716,0,1,1718,T
2-PB1,2176,0,0,1712,2,1714,G
2-PB1,2177,1,1,0,1698,1700,C
2-PB1,2178,0,0,0,1689,1689,C
2-PB1,2179,1673,0,2,0,1675,A
2-PB1,2180,0,0,1676,0,1676,G
2-PB1,2181,1673,0,0,0,1673,A
2-PB1,2182,1675,0,0,0,1675,A
2-PB1,2183,0,1673,0,0,1673,T
2-PB1,2184,0,1643,0,0,1643,T
2-PB1,2185,0,1,1648,0,1649,G
2-PB1,2186,1640,0,1,0,1641,A
2-PB1,2187,1,0,0,1633,1634,C
2-PB1,2188,0,1627,0,1,1628,T
2-PB1,2189,0,1617,0,0,1617,T
2-PB1,2190,0,0,0,1616,1616,C
2-PB1,2191,0,0,1613,0,1613,G
2-PB1,2192,1614,1,0,0,1615,A
2-PB1,2193,0,0,1582,0,1582,G
2-PB1,2194,0,1597,0,0,1597,T
2-PB1,2195,0,0,0,1595,1595,C
2-PB1,2196,1,1596,0,1,1598,T
2-PB1,2197,0,0,1597,0,1597,G
2-PB1,2198,0,0,1594,0,1594,G
2-PB1,2199,1597,0,0,0,1597,A
2-PB1,2200,1470,1,2,0,1473,A
2-PB1,2201,1,1,1469,0,1471,G
2-PB1,2202,0,0,1487,0,1487,G
2-PB1,2203,1490,0,1,0,1491,A
2-PB1,2204,0,1457,0,26,1483,T
2-PB1,2205,0,1480,1,1,1482,T
2-PB1,2206,1479,0,1,0,1480,A
2-PB1,2207,1474,1,1,1,1477,A
2-PB1,2208,0,0,1482,0,1482,G
2-PB1,2209,1470,0,1,0,1471,A
2-PB1,2210,1394,1,0,0,1395,A
2-PB1,2211,1,0,1303,0,1304,G
2-PB1,2212,0,0,1303,0,1303,G
2-PB1,2213,1307,0,0,0,1307,A
2-PB1,2214,1300,0,2,0,1302,A
2-PB1,2215,0,0,1302,0,1302,G
2-PB1,2216,1227,1,1,0,1229,A
2-PB1,2217,0,0,1231,0,1231,G
2-PB1,2218,0,1186,0,1,1187,T
2-PB1,2219,0,1180,1,0,1181,T
2-PB1,2220,0,0,0,1187,1187,C
2-PB1,2221,0,1156,1,1,1158,T
2-PB1,2222,0,0,0,1157,1157,C
2-PB1,2223,0,1146,0,2,1148,T
2-PB1,2224,0,0,1141,0,1141,G
2-PB1,2225,1117,0,0,0,1117,A
2-PB1,2226,0,0,1104,0,1104,G
2-PB1,2227,1091,0,1,0,1092,A
2-PB1,2228,0,1073,0,0,1073,T
2-PB1,2229,1,0,0,1025,1026,C
2-PB1,2230,1019,0,2,0,1021,A
2-PB1,2231,0,1016,0,0,1016,T
2-PB1,2232,1,0,1015,0,1016,G
2-PB1,2233,1003,0,1,0,1004,A
2-PB1,2234,0,0,944,0,944,G
2-PB1,2235,0,0,947,0,947,G
2-PB1,2236,946,0,1,0,947,A
2-PB1,2237,1,946,0,1,948,T
2-PB1,2238,0,0,0,927,927,C
2-PB1,2239,0,900,0,0,900,T
2-PB1,2240,0,0,900,1,901,G
2-PB1,2241,0,899,0,2,901,T
2-PB1,2242,0,894,0,2,896,T
2-PB1,2243,0,0,0,887,887,C
2-PB1,2244,0,0,0,830,830,C
2-PB1,2245,824,1,1,0,826,A
2-PB1,2246,0,0,0,826,826,C
2-PB1,2247,0,0,0,760,760,C
2-PB1,2248,733,0,0,0,733,A
2-PB1,2249,0,663,0,0,663,T
2-PB1,2250,0,640,0,0,640,T
2-PB1,2251,0,0,639,0,639,G
2-PB1,2252,634,0,0,0,634,A
2-PB1,2253,632,0,0,0,632,A
2-PB1,2254,0,0,632,0,632,G
2-PB1,2255,549,0,1,0,550,A
2-PB1,2256,548,0,0,0,548,A
2-PB1,2257,0,0,0,540,540,C
2-PB1,2258,0,516,0,0,516,T
2-PB1,2259,0,0,0,516,516,C
2-PB1,2260,490,0,0,0,490,A
2-PB1,2261,0,0,489,0,489,G
2-PB1,2262,487,0,0,0,487,A
2-PB1,2263,0,0,0,470,470,C
2-PB1,2264,0,0,460,0,460,G
2-PB1,2265,0,0,442,0,442,G
2-PB1,2266,0,0,0,445,445,C
2-PB1,2267,442,0,0,0,442,A
2-PB1,2268,442,0,0,0,442,A
2-PB1,2269,437,0,0,0,437,A
2-PB1,2270,436,1,0,0,437,A
2-PB1,2271,436,1,0,0,437,A
2-PB1,2272,0,430,0,0,430,T
2-PB1,2273,411,0,0,0,411,A
2-PB1,2274,411,0,0,0,411,A
3-PA,1,33,0,0,0,33,A
3-PA,2,0,33,0,0,33,T
3-PA,3,0,0,38,0,38,G
3-PA,4,0,0,38,0,38,G
3-PA,5,38,0,0,0,38,A
3-PA,6,37,0,0,0,37,A
3-PA,7,0,0,39,0,39,G
3-PA,8,42,0,0,0,42,A
3-PA,9,0,42,0,0,42,T
3-PA,10,0,42,0,0,42,T
3-PA,11,0,42,0,0,42,T
3-PA,12,0,42,0,0,42,T
3-PA,13,0,0,42,0,42,G
3-PA,14,0,42,0,0,42,T
3-PA,15,0,1,41,0,42,G
3-PA,16,0,0,0,42,42,C
3-PA,17,0,0,41,0,41,G
3-PA,18,0,0,42,0,42,G
3-PA,19,0,0,0,44,44,C
3-PA,20,44,0,0,0,44,A
3-PA,21,44,0,0,0,44,A
3-PA,22,0,45,0,0,45,T
3-PA,23,0,0,49,0,49,G
3-PA,24,0,0,0,51,51,C
3-PA,25,0,51,0,0,51,T
3-PA,26,0,51,0,0,51,T
3-PA,27,0,0,0,51,51,C
3-PA,28,51,0,0,0,51,A
3-PA,29,52,0,0,0,52,A
3-PA,30,0,0,0,56,56,C
3-PA,31,0,0,0,55,55,C
3-PA,32,0,0,0,56,56,C
3-PA,33,0,0,56,0,56,G
3-PA,34,55,1,0,0,56,A
3-PA,35,0,56,0,0,56,T
3-PA,36,0,0,56,0,56,G
3-PA,37,56,0,0,0,56,A
3-PA,38,0,58,0,0,58,T
3-PA,39,0,58,0,0,58,T
3-PA,40,0,0,57,0,57,G
3-PA,41,0,57,0,0,57,T
3-PA,42,0,0,0,57,57,C
3-PA,43,0,0,57,0,57,G
3-PA,44,56,0,0,0,56,A
3-PA,45,57,0,0,0,57,A
3-PA,46,0,0,0,57,57,C
3-PA,47,0,57,0,0,57,T
3-PA,48,0,57,0,0,57,T
3-PA,49,0,0,57,0,57,G
3-PA,50,0,0,0,57,57,C
3-PA,51,58,0,0,0,58,A
3-PA,52,0,0,59,0,59,G
3-PA,53,59,0,0,0,59,A
3-PA,54,60,0,0,0,60,A
3-PA,55,60,0,0,0,60,A
3-PA,56,60,0,0,0,60,A
3-PA,57,61,0,0,0,61,A
3-PA,58,0,0,61,0,61,G
3-PA,59,0,0,0,66,66,C
3-PA,60,66,0,0,0,66,A
3-PA,61,66,0,0,0,66,A
3-PA,62,0,66,0,0,66,T
3-PA,63,0,0,67,0,67,G
3-PA,64,69,0,0,0,69,A
3-PA,65,70,0,0,0,70,A
3-PA,66,69,0,0,0,69,A
3-PA,67,0,0,73,0,73,G
3-PA,68,76,0,0,0,76,A
3-PA,69,0,0,94,0,94,G
3-PA,70,0,94,0,0,94,T
3-PA,71,94,0,0,0,94,A
3-PA,72,0,94,0,0,94,T
3-PA,73,0,0,94,0,94,G
3-PA,74,0,0,96,0,96,G
3-PA,75,0,0,94,0,94,G
3-PA,76,0,0,94,0,94,G
3-PA,77,93,0,0,0,93,A
3-PA,78,0,0,94,0,94,G
3-PA,79,0,0,94,0,94,G
3-PA,80,94,0,0,0,94,A
3-PA,81,0,96,0,0,96,T
3-PA,82,0,0,0,95,95,C
3-PA,83,0,96,0,0,96,T
3-PA,84,0,0,96,0,96,G
3-PA,85,96,0,0,0,96,A
3-PA,86,96,0,0,0,96,A
3-PA,87,96,0,0,0,96,A
3-PA,88,97,0,0,0,97,A
3-PA,89,0,96,0,0,96,T
3-PA,90,0,97,0,0,97,T
3-PA,91,0,0,97,0,97,G
3-PA,92,96,0,1,0,97,A
3-PA,93,97,0,0,0,97,A
3-PA,94,97,0,0,0,97,A
3-PA,95,0,0,0,97,97,C
3-PA,96,0,0,0,95,95,C
3-PA,97,98,0,0,0,98,A
3-PA,98,97,0,0,0,97,A
3-PA,99,0,0,0,98,98,C
3-PA,100,98,0,0,0,98,A
3-PA,101,98,0,0,0,98,A
3-PA,102,99,0,0,0,99,A
3-PA,103,0,99,0,0,99,T
3-PA,104,0,99,0,0,99,T
3-PA,105,0,98,0,0,98,T
3-PA,106,0,0,100,0,100,G
3-PA,107,0,0,0,101,101,C
3-PA,108,100,1,0,0,101,A
3-PA,109,0,0,107,0,107,G
3-PA,110,0,0,0,106,106,C
3-PA,111,111,0,0,0,111,A
3-PA,112,111,0,0,0,111,A
3-PA,113,0,110,0,0,110,T
3-PA,114,113,0,0,0,113,A
3-PA,115,0,113,0,0,113,T
3-PA,116,0,0,112,0,112,G
3-PA,117,0,0,0,114,114,C
3-PA,118,111,0,1,0,112,A
3-PA,119,0,0,0,114,114,C
3-PA,120,0,112,0,0,112,T
3-PA,121,0,0,0,139,139,C
3-PA,122,143,0,0,0,143,A
3-PA,123,0,0,0,143,143,C
3-PA,124,0,142,0,0,142,T
3-PA,125,0,144,0,0,144,T
3-PA,126,0,0,144,0,144,G
3-PA,127,0,1,145,0,146,G
3-PA,128,146,0,0,0,146,A
3-PA,129,0,0,148,0,148,G
3-PA,130,0,0,147,0,147,G
3-PA,131,0,142,0,0,142,T
3-PA,132,0,0,143,0,143,G
3-PA,133,0,143,0,0,143,T
3-PA,134,0,0,146,0,146,G
3-PA,135,0,145,0,0,145,T
3-PA,136,0,145,0,0,145,T
3-PA,137,0,144,0,0,144,T
3-PA,138,0,0,0,145,145,C
3-PA,139,144,1,0,0,145,A
3-PA,140,0,144,0,0,144,T
3-PA,141,0,0,148,0,148,G
3-PA,142,0,146,0,0,146,T
3-PA,143,146,0,0,0,146,A
3-PA,144,0,149,0,0,149,T
3-PA,145,0,148,0,0,148,T
3-PA,146,0,0,0,149,149,C
3-PA,147,145,0,1,0,146,A
3-PA,148,0,0,147,1,148,G
3-PA,149,148,0,0,0,148,A
3-PA,150,0,148,0,0,148,T
3-PA,151,0,148,0,0,148,T
3-PA,152,0,149,0,0,149,T
3-PA,153,0,0,0,149,149,C
3-PA,154,0,0,0,153,153,C
3-PA,155,153,0,0,0,153,A
3-PA,156,0,153,0,0,153,T
3-PA,157,0,151,0,0,151,T
3-PA,158,0,150,0,0,150,T
3-PA,159,0,0,0,151,151,C
3-PA,160,151,0,0,0,151,A
3-PA,161,0,156,0,0,156,T
3-PA,162,0,0,0,156,156,C
3-PA,163,156,0,0,0,156,A
3-PA,164,156,0,0,0,156,A
3-PA,165,0,156,0,0,156,T
3-PA,166,0,0,161,0,161,G
3-PA,167,162,0,0,0,162,A
3-PA,168,161,0,0,0,161,A
3-PA,169,0,0,0,162,162,C
3-PA,170,161,0,0,0,161,A
3-PA,171,162,0,0,0,162,A
3-PA,172,0,0,164,0,164,G
3-PA,173,0,0,165,0,165,G
3-PA,174,0,0,0,164,164,C
3-PA,175,0,0,166,0,166,G
3-PA,176,176,0,1,0,177,A
3-PA,177,179,0,0,0,179,A
3-PA,178,0,178,0,0,178,T
3-PA,179,0,0,0,183,183,C
3-PA,180,183,0,0,0,183,A
3-PA,181,186,0,0,0,186,A
3-PA,182,0,186,0,0,186,T
3-PA,183,185,0,1,0,186,A
3-PA,184,0,0,189,0,189,G
3-PA,185,0,189,0,0,189,T
3-PA,186,0,0,197,0,197,G
3-PA,187,0,0,198,0,198,G
3-PA,188,0,194,0,2,196,T
3-PA,189,196,0,0,0,196,A
3-PA,190,0,0,200,0,200,G
3-PA,191,198,0,0,0,198,A
3-PA,192,200,0,0,0,200,A
3-PA,193,0,0,0,197,197,C
3-PA,194,0,196,0,0,196,T
3-PA,195,0,197,0,0,197,T
3-PA,196,0,0,198,0,198,G
3-PA,197,198,0,0,0,198,A
3-PA,198,0,0,0,198,198,C
3-PA,199,0,0,195,0,195,G
3-PA,200,204,0,0,0,204,A
3-PA,201,0,207,0,0,207,T
3-PA,202,0,0,0,211,211,C
3-PA,203,0,0,0,215,215,C
3-PA,204,215,0,0,0,215,A
3-PA,205,215,0,0,0,215,A
3-PA,206,215,0,0,0,215,A
3-PA,207,0,215,0,0,215,T
3-PA,208,0,0,214,0,214,G
3-PA,209,0,0,0,214,214,C
3-PA,210,214,0,0,0,214,A
3-PA,211,0,0,0,222,222,C
3-PA,212,0,222,0,0,222,T
3-PA,213,0,0,262,0,262,G
3-PA,214,0,262,0,0,262,T
3-PA,215,0,262,0,0,262,T
3-PA,216,262,0,0,0,262,A
3-PA,217,262,0,0,0,262,A
3-PA,218,263,0,0,0,263,A
3-PA,219,0,0,263,0,263,G
3-PA,220,0,1,0,261,262,C
3-PA,221,256,0,3,0,259,A
3-PA,222,0,0,0,258,258,C
3-PA,223,241,0,1,0,242,A
3-PA,224,0,0,246,0,246,G
3-PA,225,245,0,0,0,245,A
3-PA,226,0,245,0,0,245,T
3-PA,227,0,245,0,0,245,T
3-PA,228,0,245,0,0,245,T
3-PA,229,0,0,245,0,245,G
3-PA,230,246,0,0,0,246,A
3-PA,231,245,0,0,0,245,A
3-PA,232,247,0,0,0,247,A
3-PA,233,0,235,0,0,235,T
3-PA,234,235,0,0,0,235,A
3-PA,235,239,0,0,0,239,A
3-PA,236,0,238,0,0,238,T
3-PA,237,0,0,0,240,240,C
3-PA,238,1,0,238,0,239,G
3-PA,239,240,0,1,0,241,A
3-PA,240,0,0,242,0,242,G
3-PA,241,0,0,246,0,246,G
3-PA,242,0,0,245,0,245,G
3-PA,243,0,0,248,0,248,G
3-PA,244,246,0,0,0,246,A
3-PA,245,0,0,247,0,247,G
3-PA,246,258,0,0,0,258,A
3-PA,247,0,0,258,0,258,G
3-PA,248,262,0,0,0,262,A
3-PA,249,0,0,0,259,259,C
3-PA,250,261,0,0,0,261,A
3-PA,251,0,0,262,0,262,G
3-PA,252,264,0,0,0,264,A
3-PA,253,270,0,0,0,270,A
3-PA,254,0,0,0,270,270,C
3-PA,255,262,0,0,0,262,A
3-PA,256,261,0,0,0,261,A
3-PA,257,0,261,0,0,261,T
3-PA,258,0,0,288,0,288,G
3-PA,259,0,0,294,0,294,G
3-PA,260,0,0,0,293,293,C
3-PA,261,0,0,0,290,290,C
3-PA,262,0,287,0,0,287,T
3-PA,263,0,0,292,0,292,G
3-PA,264,0,0,294,0,294,G
3-PA,265,295,0,0,0,295,A
3-PA,266,0,0,0,301,301,C
3-PA,267,291,0,1,0,292,A
3-PA,268,0,0,327,0,327,G
3-PA,269,0,328,0,0,328,T
3-PA,270,331,0,0,0,331,A
3-PA,271,0,0,333,0,333,G
3-PA,272,0,327,0,0,327,T
3-PA,273,331,0,0,0,331,A
3-PA,274,330,0,0,0,330,A
3-PA,275,328,0,0,0,328,A
3-PA,276,0,0,0,334,334,C
3-PA,277,315,0,0,0,315,A
3-PA,278,0,0,319,0,319,G
3-PA,279,0,320,0,0,320,T
3-PA,280,324,0,0,1,325,A
3-PA,281,0,322,0,1,323,T
3-PA,282,0,0,0,330,330,C
3-PA,283,0,328,0,0,328,T
3-PA,284,0,0,327,0,327,G
3-PA,285,0,0,0,330,330,C
3-PA,286,328,0,0,0,328,A
3-PA,287,326,0,0,0,326,A
3-PA,288,0,0,0,329,329,C
3-PA,289,323,0,0,1,324,A
3-PA,290,0,0,0,333,333,C
3-PA,291,0,330,0,0,330,T
3-PA,292,329,0,0,1,330,A
3-PA,293,0,0,0,330,330,C
3-PA,294,0,328,0,0,328,T
3-PA,295,0,0,330,0,330,G
3-PA,296,0,0,330,0,330,G
3-PA,297,332,0,0,0,332,A
3-PA,298,0,0,333,0,333,G
3-PA,299,0,0,0,326,326,C
3-PA,300,0,325,0,0,325,T
3-PA,301,0,0,327,0,327,G
3-PA,302,0,0,327,0,327,G
3-PA,303,323,0,0,0,323,A
3-PA,304,327,0,0,0,327,A
3-PA,305,325,0,0,0,325,A
3-PA,306,325,0,0,0,325,A
3-PA,307,0,0,0,326,326,C
3-PA,308,0,0,0,324,324,C
3-PA,309,0,0,325,0,325,G
3-PA,310,324,0,0,0,324,A
3-PA,311,325,0,0,0,325,A
3-PA,312,0,0,324,0,324,G
3-PA,313,0,323,0,0,323,T
3-PA,314,0,325,0,0,325,T
3-PA,315,0,324,0,0,324,T
3-PA,316,0,0,0,325,325,C
3-PA,317,0,327,0,0,327,T
3-PA,318,327,0,0,0,327,A
3-PA,319,0,1,0,326,327,C
3-PA,320,0,1,0,326,327,C
3-PA,321,324,0,0,0,324,A
3-PA,322,0,0,328,0,328,G
3-PA,323,328,0,0,0,328,A
3-PA,324,0,330,0,0,330,T
3-PA,325,0,330,0,0,330,T
3-PA,326,0,328,0,0,328,T
3-PA,327,0,0,330,0,330,G
3-PA,328,0,330,0,0,330,T
3-PA,329,330,0,0,0,330,A
3-PA,330,0,329,0,0,329,T
3-PA,331,0,0,323,0,323,G
3-PA,332,336,0,1,0,337,A
3-PA,333,0,338,0,0,338,T
3-PA,334,0,337,0,0,337,T
3-PA,335,338,0,0,0,338,A
3-PA,336,0,0,0,332,332,C
3-PA,337,335,0,0,0,335,A
3-PA,338,336,0,0,0,336,A
3-PA,339,0,0,335,0,335,G
3-PA,340,0,0,336,0,336,G
3-PA,341,322,0,0,0,322,A
3-PA,342,0,0,325,0,325,G
3-PA,343,325,0,0,0,325,A
3-PA,344,323,0,0,0,323,A
3-PA,345,0,0,0,325,325,C
3-PA,346,324,0,0,0,324,A
3-PA,347,0,0,326,0,326,G
3-PA,348,326,0,0,0,326,A
3-PA,349,0,322,0,0,322,T
3-PA,350,0,323,0,0,323,T
3-PA,351,0,0,0,319,319,C
3-PA,352,320,0,0,0,320,A
3-PA,353,0,318,0,0,318,T
3-PA,354,0,0,0,319,319,C
3-PA,355,0,0,319,0,319,G
3-PA,356,314,0,0,0,314,A
3-PA,357,312,1,0,0,313,A
3-PA,358,312,0,0,0,312,A
3-PA,359,0,314,0,0,314,T
3-PA,360,0,313,0,0,313,T
3-PA,361,0,0,315,0,315,G
3-PA,362,0,0,312,0,312,G
3-PA,363,0,0,314,0,314,G
3-PA,364,0,0,314,0,314,G
3-PA,365,0,311,0,0,311,T
3-PA,366,310,0,0,0,310,A
3-PA,367,319,0,0,0,319,A
3-PA,368,0,0,0,328,328,C
3-PA,369,328,0,0,0,328,A
3-PA,370,326,0,0,0,326,A
3-PA,371,0,0,333,0,333,G
3-PA,372,0,0,333,0,333,G
3-PA,373,334,0,0,0,334,A
3-PA,374,0,0,338,0,338,G
3-PA,375,334,0,0,0,334,A
3-PA,376,0,0,337,0,337,G
3-PA,377,333,0,0,0,333,A
3-PA,378,331,0,0,0,331,A
3-PA,379,0,0,344,0,344,G
3-PA,380,0,341,0,1,342,T
3-PA,381,0,0,0,345,345,C
3-PA,382,0,0,0,341,341,C
3-PA,383,341,0,0,0,341,A
3-PA,384,1,0,0,352,353,C
3-PA,385,362,0,1,1,364,A
3-PA,386,0,369,0,0,369,T
3-PA,387,370,0,0,0,370,A
3-PA,388,0,361,0,1,362,T
3-PA,389,362,0,0,0,362,A
3-PA,390,0,358,0,0,358,T
3-PA,391,0,357,0,1,358,T
3-PA,392,367,0,0,0,367,A
3-PA,393,0,0,0,366,366,C
3-PA,394,0,0,0,355,355,C
3-PA,395,1,345,0,0,346,T
3-PA,396,0,339,0,0,339,T
3-PA,397,0,0,343,0,343,G
3-PA,398,343,0,0,0,343,A
3-PA,399,343,0,0,0,343,A
3-PA,400,339,0,0,0,339,A
3-PA,401,330,0,0,0,330,A
3-PA,402,0,0,335,0,335,G
3-PA,403,0,0,334,0,334,G
3-PA,404,0,1,0,332,333,C
3-PA,405,0,0,0,334,334,C
3-PA,406,335,0,0,0,335,A
3-PA,407,335,0,0,0,335,A
3-PA,408,0,336,0,0,336,T
3-PA,409,336,0,0,0,336,A
3-PA,410,336,0,0,0,336,A
3-PA,411,0,0,344,0,344,G
3-PA,412,340,0,0,0,340,A
3-PA,413,0,339,0,0,339,T
3-PA,414,0,340,0,0,340,T
3-PA,415,340,0,0,0,340,A
3-PA,416,339,0,0,0,339,A
3-PA,417,339,0,0,0,339,A
3-PA,418,0,340,0,0,340,T
3-PA,419,0,0,0,340,340,C
3-PA,420,0,333,0,0,333,T
3-PA,421,0,0,338,0,338,G
3-PA,422,337,0,1,0,338,A
3-PA,423,0,0,342,0,342,G
3-PA,424,343,0,1,0,344,A
3-PA,425,346,0,0,0,346,A
3-PA,426,0,0,0,347,347,C
3-PA,427,346,0,0,0,346,A
3-PA,428,0,0,0,347,347,C
3-PA,429,349,0,0,0,349,A
3-PA,430,0,0,0,347,347,C
3-PA,431,348,0,0,0,348,A
3-PA,432,0,0,0,359,359,C
3-PA,433,355,0,0,0,355,A
3-PA,434,0,356,0,0,356,T
3-PA,435,0,350,0,0,350,T
3-PA,436,0,1,0,352,353,C
3-PA,437,353,0,0,0,353,A
3-PA,438,1,0,0,355,356,C
3-PA,439,351,0,0,0,351,A
3-PA,440,0,350,0,0,350,T
3-PA,441,0,337,0,1,338,T
3-PA,442,0,341,0,0,341,T
3-PA,443,0,342,0,0,342,T
3-PA,444,0,0,0,344,344,C
3-PA,445,1,340,0,0,341,T
3-PA,446,0,0,0,344,344,C
3-PA,447,339,0,0,0,339,A
3-PA,448,0,338,0,0,338,T
3-PA,449,0,344,0,0,344,T
3-PA,450,0,0,0,346,346,C
3-PA,451,341,0,1,0,342,A
3-PA,452,0,0,0,347,347,C
3-PA,453,0,344,0,0,344,T
3-PA,454,0,0,351,0,351,G
3-PA,455,0,0,354,0,354,G
3-PA,456,0,0,353,0,353,G
3-PA,457,0,0,354,0,354,G
3-PA,458,350,1,1,0,352,A
3-PA,459,0,0,353,0,353,G
3-PA,460,0,0,356,0,356,G
3-PA,461,355,0,0,0,355,A
3-PA,462,355,0,0,0,355,A
3-PA,463,349,0,1,0,350,A
3-PA,464,1,345,0,0,346,T
3-PA,465,0,0,344,0,344,G
3-PA,466,0,0,347,0,347,G
3-PA,467,0,1,0,344,345,C
3-PA,468,0,0,0,345,345,C
3-PA,469,344,1,0,0,345,A
3-PA,470,0,0,0,345,345,C
3-PA,471,345,0,1,0,346,A
3-PA,472,347,0,0,0,347,A
3-PA,473,347,0,0,0,347,A
3-PA,474,0,0,345,0,345,G
3-PA,475,0,0,344,0,344,G
3-PA,476,0,2,0,342,344,C
3-PA,477,343,0,0,0,343,A
3-PA,478,0,0,347,0,347,G
3-PA,479,349,0,0,0,349,A
3-PA,480,0,0,0,353,353,C
3-PA,481,0,350,0,0,350,T
3-PA,482,350,0,0,0,350,A
3-PA,483,0,0,0,347,347,C
3-PA,484,343,0,1,0,344,A
3-PA,485,0,0,0,343,343,C
3-PA,486,0,332,0,0,332,T
3-PA,487,0,0,0,327,327,C
3-PA,488,0,325,0,0,325,T
3-PA,489,0,0,0,324,324,C
3-PA,490,1,0,321,1,323,G
3-PA,491,325,0,0,0,325,A
3-PA,492,0,0,0,322,322,C
3-PA,493,0,0,321,1,322,G
3-PA,494,321,0,0,0,321,A
3-PA,495,0,0,322,0,322,G
3-PA,496,0,0,319,0,319,G
3-PA,497,319,0,0,0,319,A
3-PA,498,319,0,0,0,319,A
3-PA,499,314,0,0,1,315,A
3-PA,500,0,0,314,0,314,G
3-PA,501,0,1,0,314,315,C
3-PA,502,316,0,0,0,316,A
3-PA,503,0,0,325,0,325,G
3-PA,504,0,0,329,0,329,G
3-PA,505,0,0,328,0,328,G
3-PA,506,0,0,0,329,329,C
3-PA,507,0,326,0,0,326,T
3-PA,508,328,0,0,0,328,A
3-PA,509,0,0,336,0,336,G
3-PA,510,0,0,348,0,348,G
3-PA,511,348,0,0,0,348,A
3-PA,512,0,336,0,0,336,T
3-PA,513,0,331,0,0,331,T
3-PA,514,328,0,0,1,329,A
3-PA,515,329,0,1,0,330,A
3-PA,516,0,0,332,0,332,G
3-PA,517,332,0,0,0,332,A
3-PA,518,0,0,0,332,332,C
3-PA,519,0,0,0,307,307,C
3-PA,520,306,0,0,0,306,A
3-PA,521,0,0,309,0,309,G
3-PA,522,0,0,310,0,310,G
3-PA,523,0,0,0,307,307,C
3-PA,524,0,306,0,1,307,T
3-PA,525,0,0,327,0,327,G
3-PA,526,0,327,0,0,327,T
3-PA,527,0,326,0,0,326,T
3-PA,528,0,328,0,0,328,T
3-PA,529,330,0,0,0,330,A
3-PA,530,2,0,0,330,332,C
3-PA,531,0,0,0,326,326,C
3-PA,532,326,1,0,0,327,A
3-PA,533,0,327,0,0,327,T
3-PA,534,314,0,0,0,314,A
3-PA,535,312,0,0,0,312,A
3-PA,536,0,0,317,0,317,G
3-PA,537,318,0,0,0,318,A
3-PA,538,0,0,0,317,317,C
3-PA,539,311,0,0,0,311,A
3-PA,540,309,0,1,0,310,A
3-PA,541,0,0,314,0,314,G
3-PA,542,314,0,0,0,314,A
3-PA,543,313,0,0,0,313,A
3-PA,544,312,0,1,0,313,A
3-PA,545,0,304,0,0,304,T
3-PA,546,0,0,314,0,314,G
3-PA,547,0,0,312,0,312,G
3-PA,548,0,0,0,314,314,C
3-PA,549,0,0,0,312,312,C
3-PA,550,311,0,0,0,311,A
3-PA,551,317,0,0,0,317,A
3-PA,552,0,1,0,315,316,C
3-PA,553,313,0,0,0,313,A
3-PA,554,0,0,314,0,314,G
3-PA,555,301,0,0,0,301,A
3-PA,556,0,0,303,0,303,G
3-PA,557,0,0,302,0,302,G
3-PA,558,0,0,0,304,304,C
3-PA,559,0,0,0,307,307,C
3-PA,560,0,295,0,0,295,T
3-PA,561,0,0,0,297,297,C
3-PA,562,0,295,0,1,296,T
3-PA,563,0,1,295,0,296,G
3-PA,564,0,0,295,0,295,G
3-PA,565,0,0,296,0,296,G
3-PA,566,292,0,0,0,292,A
3-PA,567,0,284,0,0,284,T
3-PA,568,0,283,0,0,283,T
3-PA,569,0,0,0,297,297,C
3-PA,570,0,0,0,290,290,C
3-PA,571,0,286,0,0,286,T
3-PA,572,0,283,0,0,283,T
3-PA,573,0,286,0,0,286,T
3-PA,574,0,0,0,285,285,C
3-PA,575,0,0,286,0,286,G
3-PA,576,0,286,1,0,287,T
3-PA,577,0,0,0,286,286,C
3-PA,578,275,0,0,0,275,A
3-PA,579,0,0,293,1,294,G
3-PA,580,0,292,0,1,293,T
3-PA,581,0,0,0,293,293,C
3-PA,582,0,0,0,290,290,C
3-PA,583,0,0,290,0,290,G
3-PA,584,290,0,0,0,290,A
3-PA,585,289,0,1,0,290,A
3-PA,586,291,0,0,0,291,A
3-PA,587,0,0,289,0,289,G
3-PA,588,281,0,0,0,281,A
3-PA,589,0,0,284,0,284,G
3-PA,590,0,0,284,0,284,G
3-PA,591,0,0,0,284,284,C
3-PA,592,0,0,284,0,284,G
3-PA,593,283,0,0,0,283,A
3-PA,594,282,0,0,0,282,A
3-PA,595,0,0,284,0,284,G
3-PA,596,284,0,0,0,284,A
3-PA,597,284,0,0,0,284,A
3-PA,598,283,0,0,0,283,A
3-PA,599,0,0,0,286,286,C
3-PA,600,283,0,1,0,284,A
3-PA,601,287,0,0,0,287,A
3-PA,602,0,287,0,0,287,T
3-PA,603,0,285,0,0,285,T
3-PA,604,1,0,283,0,284,G
3-PA,605,285,0,0,0,285,A
3-PA,606,284,0,0,0,284,A
3-PA,607,0,0,283,0,283,G
3-PA,608,278,0,0,0,278,A
3-PA,609,281,0,0,0,281,A
3-PA,610,279,0,0,0,279,A
3-PA,611,279,0,0,0,279,A
3-PA,612,281,0,0,0,281,A
3-PA,613,0,279,0,0,279,T
3-PA,614,0,280,0,0,280,T
3-PA,615,0,280,0,0,280,T
3-PA,616,0,0,281,0,281,G
3-PA,617,279,0,1,0,280,A
3-PA,618,279,1,0,0,280,A
3-PA,619,281,0,0,0,281,A
3-PA,620,0,284,0,0,284,T
3-PA,621,0,0,0,308,308,C
3-PA,622,310,0,0,0,310,A
3-PA,623,0,0,0,315,315,C
3-PA,624,316,0,0,0,316,A
3-PA,625,0,0,319,0,319,G
3-PA,626,0,0,326,0,326,G
3-PA,627,326,0,0,0,326,A
3-PA,628,332,0,0,0,332,A
3-PA,629,0,0,0,338,338,C
3-PA,630,0,314,0,0,314,T
3-PA,631,328,0,0,0,328,A
3-PA,632,0,324,0,0,324,T
3-PA,633,0,0,328,0,328,G
3-PA,634,0,1,0,327,328,C
3-PA,635,0,0,324,0,324,G
3-PA,636,0,0,0,320,320,C
3-PA,637,321,0,0,0,321,A
3-PA,638,0,1,327,0,328,G
3-PA,639,0,0,324,0,324,G
3-PA,640,0,0,0,326,326,C
3-PA,641,0,326,0,0,326,T
3-PA,642,0,324,0,0,324,T
3-PA,643,2,0,326,0,328,G
3-PA,644,0,0,0,328,328,C
3-PA,645,0,0,0,327,327,C
3-PA,646,0,0,331,0,331,G
3-PA,647,332,0,0,0,332,A
3-PA,648,0,0,0,332,332,C
3-PA,649,0,0,0,332,332,C
3-PA,650,331,0,0,0,331,A
3-PA,651,332,0,0,0,332,A
3-PA,652,331,0,0,0,331,A
3-PA,653,0,0,334,0,334,G
3-PA,654,0,333,0,0,333,T
3-PA,655,1,0,0,329,330,C
3-PA,656,0,330,0,0,330,T
3-PA,657,0,0,0,329,329,C
3-PA,658,0,0,0,333,333,C
3-PA,659,0,1,0,335,336,C
3-PA,660,336,0,0,0,336,A
3-PA,661,0,0,0,336,336,C
3-PA,662,0,0,0,327,327,C
3-PA,663,0,0,326,0,326,G
3-PA,664,327,0,0,0,327,A
3-PA,665,327,0,0,0,327,A
3-PA,666,0,0,0,329,329,C
3-PA,667,0,328,0,0,328,T
3-PA,668,0,335,0,0,335,T
3-PA,669,0,0,0,339,339,C
3-PA,670,0,337,0,0,337,T
3-PA,671,1,0,1,339,341,C
3-PA,672,0,0,0,336,336,C
3-PA,673,0,335,0,0,335,T
3-PA,674,0,0,339,0,339,G
3-PA,675,0,0,0,337,337,C
3-PA,676,0,0,0,336,336,C
3-PA,677,0,332,0,0,332,T
3-PA,678,0,329,0,0,329,T
3-PA,679,0,0,328,0,328,G
3-PA,680,328,0,0,0,328,A
3-PA,681,1,0,327,0,328,G
3-PA,682,327,0,1,0,328,A
3-PA,683,328,0,0,0,328,A
3-PA,684,0,331,0,0,331,T
3-PA,685,0,332,0,0,332,T
3-PA,686,0,332,0,0,332,T
3-PA,687,0,334,0,0,334,T
3-PA,688,334,0,0,0,334,A
3-PA,689,0,0,334,0,334,G
3-PA,690,331,0,0,0,331,A
3-PA,691,0,0,343,0,343,G
3-PA,692,0,0,0,336,336,C
3-PA,693,0,0,0,341,341,C
3-PA,694,0,350,0,0,350,T
3-PA,695,359,0,1,0,360,A
3-PA,696,0,360,0,0,360,T
3-PA,697,0,0,360,0,360,G
3-PA,698,0,362,0,0,362,T
3-PA,699,0,0,364,0,364,G
3-PA,700,1,0,356,0,357,G
3-PA,701,355,0,0,0,355,A
3-PA,702,0,353,0,0,353,T
3-PA,703,0,0,344,0,344,G
3-PA,704,0,0,352,0,352,G
3-PA,705,337,17,0,0,354,A
3-PA,706,0,352,0,0,352,T
3-PA,707,0,351,1,0,352,T
3-PA,708,0,0,0,348,348,C
3-PA,709,0,0,350,0,350,G
3-PA,710,353,0,0,0,353,A
3-PA,711,353,0,0,0,353,A
3-PA,712,0,0,0,354,354,C
3-PA,713,0,1,0,340,341,C
3-PA,714,0,0,344,0,344,G
3-PA,715,344,0,0,0,344,A
3-PA,716,343,0,0,0,343,A
3-PA,717,0,0,0,348,348,C
3-PA,718,0,0,348,0,348,G
3-PA,719,0,0,355,0,355,G
3-PA,720,1,0,0,354,355,C
3-PA,721,0,354,0,0,354,T
3-PA,722,0,0,365,0,365,G
3-PA,723,0,0,0,367,367,C
3-PA,724,367,0,0,0,367,A
3-PA,725,0,368,0,0,368,T
3-PA,726,0,364,0,0,364,T
3-PA,727,0,0,362,0,362,G
3-PA,728,350,0,0,0,350,A
3-PA,729,0,0,353,0,353,G
3-PA,730,0,1,352,0,353,G
3-PA,731,0,0,351,0,351,G
3-PA,732,0,0,0,349,349,C
3-PA,733,343,0,0,0,343,A
3-PA,734,344,0,1,0,345,A
3-PA,735,1,0,345,0,346,G
3-PA,736,0,0,0,348,348,C
3-PA,737,0,349,0,0,349,T
3-PA,738,0,348,0,1,349,T
3-PA,739,0,349,1,1,351,T
3-PA,740,0,1,0,347,348,C
3-PA,741,0,349,0,0,349,T
3-PA,742,0,0,0,350,350,C
3-PA,743,351,0,0,0,351,A
3-PA,744,344,0,0,0,344,A
3-PA,745,347,0,0,0,347,A
3-PA,746,0,343,0,0,343,T
3-PA,747,0,0,349,0,349,G
3-PA,748,0,347,0,0,347,T
3-PA,749,0,0,1,351,352,C
3-PA,750,0,0,0,350,350,C
3-PA,751,352,0,0,0,352,A
3-PA,752,351,1,0,0,352,A
3-PA,753,352,0,0,0,352,A
3-PA,754,0,0,356,0,356,G
3-PA,755,357,0,0,0,357,A
3-PA,756,350,0,0,0,350,A
3-PA,757,0,0,352,0,352,G
3-PA,758,0,346,0,0,346,T
3-PA,759,1,0,345,0,346,G
3-PA,760,343,0,0,0,343,A
3-PA,761,344,0,0,0,344,A
3-PA,762,0,344,0,0,344,T
3-PA,763,0,0,345,0,345,G
3-PA,764,0,0,0,344,344,C
3-PA,765,0,0,0,345,345,C
3-PA,766,0,1,0,345,346,C
3-PA,767,346,0,0,0,346,A
3-PA,768,348,0,0,0,348,A
3-PA,769,350,0,0,0,350,A
3-PA,770,0,350,0,0,350,T
3-PA,771,0,346,0,0,346,T
3-PA,772,0,0,345,0,345,G
3-PA,773,342,0,1,0,343,A
3-PA,774,344,0,0,0,344,A
3-PA,775,0,0,0,345,345,C
3-PA,776,0,0,0,344,344,C
3-PA,777,0,342,0,0,342,T
3-PA,778,0,342,0,0,342,T
3-PA,779,0,345,0,0,345,T
3-PA,780,0,352,0,0,352,T
3-PA,781,0,0,0,353,353,C
3-PA,782,0,352,0,0,352,T
3-PA,783,0,0,352,0,352,G
3-PA,784,350,0,0,0,350,A
3-PA,785,355,0,0,0,355,A
3-PA,786,0,0,356,0,356,G
3-PA,787,349,0,0,0,349,A
3-PA,788,0,0,0,348,348,C
3-PA,789,337,0,0,0,337,A
3-PA,790,341,0,0,0,341,A
3-PA,791,0,0,0,375,375,C
3-PA,792,376,0,1,0,377,A
3-PA,793,0,0,0,377,377,C
3-PA,794,0,0,0,370,370,C
3-PA,795,370,0,0,0,370,A
3-PA,796,369,0,0,0,369,A
3-PA,797,0,0,369,0,369,G
3-PA,798,369,0,0,0,369,A
3-PA,799,0,0,0,367,367,C
3-PA,800,0,0,0,323,323,C
3-PA,801,318,0,1,0,319,A
3-PA,802,320,0,0,0,320,A
3-PA,803,0,320,0,0,320,T
3-PA,804,0,0,0,321,321,C
3-PA,805,319,0,0,0,319,A
3-PA,806,316,0,0,0,316,A
3-PA,807,314,0,1,0,315,A
3-PA,808,0,0,0,323,323,C
3-PA,809,0,318,0,0,318,T
3-PA,810,0,322,0,0,322,T
3-PA,811,0,0,0,322,322,C
3-PA,812,1,0,0,323,324,C
3-PA,813,0,0,326,0,326,G
3-PA,814,325,0,0,0,325,A
3-PA,815,328,0,0,0,328,A
3-PA,816,0,328,0,0,328,T
3-PA,817,0,0,323,0,323,G
3-PA,818,0,0,326,0,326,G
3-PA,819,328,0,0,0,328,A
3-PA,820,0,0,0,327,327,C
3-PA,821,0,0,0,327,327,C
3-PA,822,0,338,0,0,338,T
3-PA,823,0,0,0,349,349,C
3-PA,824,0,0,0,350,350,C
3-PA,825,0,349,0,0,349,T
3-PA,826,0,354,0,0,354,T
3-PA,827,0,0,368,0,368,G
3-PA,828,1,364,0,0,365,T
3-PA,829,0,367,0,1,368,T
3-PA,830,367,0,0,0,367,A
3-PA,831,0,347,0,0,347,T
3-PA,832,0,0,1,344,345,C
3-PA,833,336,0,0,0,336,A
3-PA,834,0,0,338,0,338,G
3-PA,835,0,0,0,338,338,C
3-PA,836,0,0,323,0,323,G
3-PA,837,0,0,324,0,324,G
3-PA,838,0,324,0,0,324,T
3-PA,839,0,0,0,324,324,C
3-PA,840,0,0,0,325,325,C
3-PA,841,326,0,0,0,326,A
3-PA,842,326,0,0,0,326,A
3-PA,843,330,0,0,0,330,A
3-PA,844,0,330,0,0,330,T
3-PA,845,0,327,0,0,327,T
3-PA,846,0,0,0,327,327,C
3-PA,847,0,0,0,324,324,C
3-PA,848,0,325,0,0,325,T
3-PA,849,0,0,0,326,326,C
3-PA,850,0,0,0,326,326,C
3-PA,851,0,323,0,0,323,T
3-PA,852,0,0,322,0,322,G
3-PA,853,321,0,0,0,321,A
3-PA,854,0,323,0,0,323,T
3-PA,855,0,0,320,0,320,G
3-PA,856,0,0,314,0,314,G
3-PA,857,311,0,0,0,311,A
3-PA,858,0,309,0,0,309,T
3-PA,859,0,0,308,0,308,G
3-PA,860,0,0,0,322,322,C
3-PA,861,0,317,0,0,317,T
3-PA,862,0,319,0,0,319,T
3-PA,863,0,319,0,0,319,T
3-PA,864,319,0,0,0,319,A
3-PA,865,319,0,0,0,319,A
3-PA,866,316,0,0,0,316,A
3-PA,867,318,0,0,0,318,A
3-PA,868,0,318,0,0,318,T
3-PA,869,0,279,0,0,279,T
3-PA,870,1,0,278,0,279,G
3-PA,871,281,0,0,0,281,A
3-PA,872,0,0,286,0,286,G
3-PA,873,0,0,0,285,285,C
3-PA,874,282,0,0,0,282,A
3-PA,875,0,286,0,0,286,T
3-PA,876,0,284,0,0,284,T
3-PA,877,0,0,286,0,286,G
3-PA,878,287,0,0,0,287,A
3-PA,879,278,0,2,0,280,A
3-PA,880,0,0,285,0,285,G
3-PA,881,286,0,0,0,286,A
3-PA,882,0,1,0,287,288,C
3-PA,883,0,0,0,287,287,C
3-PA,884,0,0,0,277,277,C
3-PA,885,268,0,8,0,276,A
3-PA,886,281,0,0,0,281,A
3-PA,887,0,0,292,0,292,G
3-PA,888,0,295,0,1,296,T
3-PA,889,0,0,0,295,295,C
3-PA,890,297,0,0,0,297,A
3-PA,891,0,0,0,294,294,C
3-PA,892,0,0,296,0,296,G
3-PA,893,300,0,0,0,300,A
3-PA,894,298,0,0,0,298,A
3-PA,895,0,1,302,0,303,G
3-PA,896,0,0,303,0,303,G
3-PA,897,300,0,0,0,300,A
3-PA,898,0,0,299,0,299,G
3-PA,899,299,0,1,0,300,A
3-PA,900,299,0,3,0,302,A
3-PA,901,0,0,302,0,302,G
3-PA,902,0,0,301,0,301,G
3-PA,903,294,0,1,0,295,A
3-PA,904,298,0,1,0,299,A
3-PA,905,0,300,0,0,300,T
3-PA,906,0,0,0,303,303,C
3-PA,907,0,0,0,327,327,C
3-PA,908,0,0,0,332,332,C
3-PA,909,335,0,0,0,335,A
3-PA,910,0,336,0,0,336,T
3-PA,911,0,336,0,0,336,T
3-PA,912,343,0,0,0,343,A
3-PA,913,0,343,0,0,343,T
3-PA,914,345,0,0,0,345,A
3-PA,915,0,343,0,0,343,T
3-PA,916,0,0,321,0,321,G
3-PA,917,321,0,1,0,322,A
3-PA,918,0,321,0,0,321,T
3-PA,919,0,0,322,0,322,G
3-PA,920,0,0,0,324,324,C
3-PA,921,0,0,323,0,323,G
3-PA,922,322,1,0,0,323,A
3-PA,923,0,325,0,0,325,T
3-PA,924,1,0,0,322,323,C
3-PA,925,323,0,0,0,323,A
3-PA,926,299,0,25,0,324,A
3-PA,927,0,0,323,0,323,G
3-PA,928,0,321,0,0,321,T
3-PA,929,0,0,324,0,324,G
3-PA,930,0,1,0,325,326,C
3-PA,931,326,0,0,0,326,A
3-PA,932,0,327,0,0,327,T
3-PA,933,326,0,0,0,326,A
3-PA,934,332,0,0,0,332,A
3-PA,935,330,0,1,0,331,A
3-PA,936,330,0,0,0,330,A
3-PA,937,330,0,0,0,330,A
3-PA,938,1,0,0,330,331,C
3-PA,939,326,0,0,0,326,A
3-PA,940,0,328,0,0,328,T
3-PA,941,0,327,0,0,327,T
3-PA,942,0,0,0,328,328,C
3-PA,943,0,324,0,0,324,T
3-PA,944,0,325,0,0,325,T
3-PA,945,0,325,0,0,325,T
3-PA,946,0,0,327,0,327,G
3-PA,947,0,1,324,0,325,G
3-PA,948,328,0,1,0,329,A
3-PA,949,0,324,0,0,324,T
3-PA,950,0,0,330,0,330,G
3-PA,951,0,0,334,0,334,G
3-PA,952,334,0,0,0,334,A
3-PA,953,333,0,0,0,333,A
3-PA,954,333,0,0,0,333,A
3-PA,955,0,0,333,0,333,G
3-PA,956,332,0,0,0,332,A
3-PA,957,0,0,329,0,329,G
3-PA,958,0,0,1,355,356,C
3-PA,959,0,0,0,364,364,C
3-PA,960,0,368,0,0,368,T
3-PA,961,0,379,0,0,379,T
3-PA,962,388,0,0,0,388,A
3-PA,963,0,387,0,0,387,T
3-PA,964,385,0,0,0,385,A
3-PA,965,0,391,0,1,392,T
3-PA,966,362,0,0,0,362,A
3-PA,967,0,0,365,0,365,G
3-PA,968,0,362,0,0,362,T
3-PA,969,0,0,0,361,361,C
3-PA,970,355,0,0,0,355,A
3-PA,971,353,0,0,0,353,A
3-PA,972,353,0,0,0,353,A
3-PA,973,1,0,0,353,354,C
3-PA,974,0,0,0,352,352,C
3-PA,975,347,0,0,0,347,A
3-PA,976,0,0,0,348,348,C
3-PA,977,349,0,0,0,349,A
3-PA,978,0,0,0,348,348,C
3-PA,979,0,0,349,0,349,G
3-PA,980,347,0,0,0,347,A
3-PA,981,350,0,0,0,350,A
3-PA,982,347,0,0,0,347,A
3-PA,983,345,1,0,0,346,A
3-PA,984,0,1,351,0,352,G
3-PA,985,0,0,354,0,354,G
3-PA,986,0,0,355,0,355,G
3-PA,987,355,0,0,0,355,A
3-PA,988,353,1,0,0,354,A
3-PA,989,0,354,0,0,354,T
3-PA,990,353,0,0,0,353,A
3-PA,991,355,0,0,0,355,A
3-PA,992,355,0,0,0,355,A
3-PA,993,0,350,0,1,351,T
3-PA,994,0,352,0,0,352,T
3-PA,995,0,0,0,354,354,C
3-PA,996,356,0,0,0,356,A
3-PA,997,357,0,0,0,357,A
3-PA,998,357,0,0,0,357,A
3-PA,999,0,358,0,0,358,T
3-PA,1000,0,361,0,0,361,T
3-PA,1001,361,0,0,1,362,A
3-PA,1002,0,0,0,362,362,C
3-PA,1003,0,0,0,361,361,C
3-PA,1004,0,358,0,0,358,T
3-PA,1005,0,1,361,0,362,G
3-PA,1006,0,0,0,365,365,C
3-PA,1007,0,366,0,0,366,T
3-PA,1008,0,0,378,0,378,G
3-PA,1009,0,375,0,0,375,T
3-PA,1010,0,0,0,377,377,C
3-PA,1011,378,0,0,0,378,A
3-PA,1012,1,376,0,0,377,T
3-PA,1013,0,0,378,0,378,G
3-PA,1014,0,0,377,0,377,G
3-PA,1015,374,0,0,0,374,A
3-PA,1016,376,0,0,0,376,A
3-PA,1017,368,0,0,0,368,A
3-PA,1018,1,0,0,373,374,C
3-PA,1019,373,0,0,0,373,A
3-PA,1020,375,0,0,0,375,A
3-PA,1021,0,0,376,0,376,G
3-PA,1022,0,377,0,0,377,T
3-PA,1023,371,0,0,0,371,A
3-PA,1024,0,0,0,374,374,C
3-PA,1025,0,371,0,0,371,T
3-PA,1026,0,0,372,0,372,G
3-PA,1027,1,369,0,0,370,T
3-PA,1028,0,0,0,372,372,C
3-PA,1029,369,0,1,0,370,A
3-PA,1030,0,0,371,0,371,G
3-PA,1031,372,1,0,0,373,A
3-PA,1032,371,0,0,0,371,A
3-PA,1033,0,375,0,0,375,T
3-PA,1034,0,372,0,0,372,T
3-PA,1035,0,0,374,0,374,G
3-PA,1036,1,0,0,374,375,C
3-PA,1037,373,0,0,0,373,A
3-PA,1038,0,0,375,0,375,G
3-PA,1039,1,0,369,0,370,G
3-PA,1040,375,0,0,0,375,A
3-PA,1041,0,1,0,373,374,C
3-PA,1042,372,0,0,0,372,A
3-PA,1043,0,377,0,0,377,T
3-PA,1044,0,377,0,0,377,T
3-PA,1045,0,0,376,0,376,G
3-PA,1046,377,0,0,0,377,A
3-PA,1047,377,0,0,0,377,A
3-PA,1048,375,0,1,0,376,A
3-PA,1049,375,0,0,0,375,A
3-PA,1050,0,374,0,0,374,T
3-PA,1051,0,0,378,0,378,G
3-PA,1052,374,0,0,0,374,A
3-PA,1053,0,0,380,0,380,G
3-PA,1054,1,0,379,0,380,G
3-PA,1055,378,2,0,0,380,A
3-PA,1056,0,0,380,0,380,G
3-PA,1057,380,0,0,0,380,A
3-PA,1058,378,0,2,0,380,A
3-PA,1059,0,0,380,0,380,G
3-PA,1060,0,0,377,0,377,G
3-PA,1061,0,391,0,0,391,T
3-PA,1062,0,389,0,0,389,T
3-PA,1063,0,0,0,389,389,C
3-PA,1064,0,0,0,391,391,C
3-PA,1065,392,0,0,0,392,A
3-PA,1066,389,1,0,1,391,A
3-PA,1067,0,0,391,0,391,G
3-PA,1068,0,0,392,0,392,G
3-PA,1069,388,1,0,0,389,A
3-PA,1070,1,0,0,389,390,C
3-PA,1071,0,390,0,0,390,T
3-PA,1072,390,0,0,0,390,A
3-PA,1073,389,0,0,0,389,A
3-PA,1074,388,0,1,0,389,A
3-PA,1075,387,0,0,1,388,A
3-PA,1076,389,0,0,0,389,A
3-PA,1077,0,0,0,382,382,C
3-PA,1078,381,0,0,0,381,A
3-PA,1079,0,377,0,0,377,T
3-PA,1080,0,0,380,0,380,G
3-PA,1081,381,0,0,0,381,A
3-PA,1082,379,0,0,0,379,A
3-PA,1083,0,0,383,0,383,G
3-PA,1084,381,0,0,0,381,A
3-PA,1085,384,0,0,0,384,A
3-PA,1086,381,0,1,0,382,A
3-PA,1087,383,0,0,0,383,A
3-PA,1088,0,1,0,382,383,C
3-PA,1089,0,0,383,0,383,G
3-PA,1090,382,0,0,0,382,A
3-PA,1091,0,0,386,0,386,G
3-PA,1092,0,382,0,0,382,T
3-PA,1093,0,0,0,392,392,C
3-PA,1094,389,0,0,0,389,A
3-PA,1095,397,0,1,0,398,A
3-PA,1096,0,1,0,396,397,C
3-PA,1097,0,396,0,0,396,T
3-PA,1098,0,0,400,0,400,G
3-PA,1099,399,0,0,0,399,A
3-PA,1100,398,0,0,0,398,A
3-PA,1101,0,0,398,0,398,G
3-PA,1102,0,394,0,0,394,T
3-PA,1103,0,0,395,0,395,G
3-PA,1104,0,0,393,0,393,G
3-PA,1105,0,1,393,0,394,G
3-PA,1106,0,0,0,395,395,C
3-PA,1107,0,388,0,0,388,T
3-PA,1108,0,0,0,395,395,C
3-PA,1109,0,393,0,0,393,T
3-PA,1110,0,393,0,0,393,T
3-PA,1111,0,0,394,0,394,G
3-PA,1112,0,0,403,0,403,G
3-PA,1113,0,398,0,1,399,T
3-PA,1114,0,0,399,0,399,G
3-PA,1115,395,0,0,0,395,A
3-PA,1116,398,0,0,0,398,A
3-PA,1117,395,0,0,0,395,A
3-PA,1118,397,0,0,0,397,A
3-PA,1119,0,0,0,401,401,C
3-PA,1120,393,0,0,0,393,A
3-PA,1121,0,395,0,0,395,T
3-PA,1122,0,0,391,0,391,G
3-PA,1123,0,0,395,0,395,G
3-PA,1124,0,0,0,400,400,C
3-PA,1125,400,0,0,0,400,A
3-PA,1126,1,0,0,403,404,C
3-PA,1127,0,0,0,397,397,C
3-PA,1128,408,0,1,0,409,A
3-PA,1129,0,0,412,0,412,G
3-PA,1130,413,0,0,0,413,A
3-PA,1131,0,0,417,0,417,G
3-PA,1132,409,0,0,0,409,A
3-PA,1133,406,0,0,0,406,A
3-PA,1134,0,0,406,0,406,G
3-PA,1135,0,0,403,0,403,G
3-PA,1136,0,403,0,0,403,T
3-PA,1137,389,0,1,0,390,A
3-PA,1138,0,0,391,0,391,G
3-PA,1139,389,0,0,0,389,A
3-PA,1140,0,0,0,390,390,C
3-PA,1141,0,386,0,0,386,T
3-PA,1142,1,389,0,0,390,T
3-PA,1143,0,389,0,0,389,T
3-PA,1144,0,0,393,0,393,G
3-PA,1145,393,0,0,0,393,A
3-PA,1146,394,0,0,0,394,A
3-PA,1147,392,0,0,0,392,A
3-PA,1148,389,0,0,0,389,A
3-PA,1149,0,0,0,394,394,C
3-PA,1150,0,396,0,0,396,T
3-PA,1151,0,0,402,0,402,G
3-PA,1152,0,0,0,402,402,C
3-PA,1153,400,0,0,0,400,A
3-PA,1154,0,145,253,1,399,G
3-PA,1155,396,0,1,0,397,A
3-PA,1156,0,0,411,0,411,G
3-PA,1157,412,0,0,0,412,A
3-PA,1158,0,0,0,407,407,C
3-PA,1159,407,0,0,0,407,A
3-PA,1160,0,403,0,0,403,T
3-PA,1161,404,0,0,0,404,A
3-PA,1162,403,0,1,0,404,A
3-PA,1163,0,0,404,0,404,G
3-PA,1164,0,0,0,403,403,C
3-PA,1165,0,0,391,0,391,G
3-PA,1166,396,0,0,0,396,A
3-PA,1167,0,391,0,0,391,T
3-PA,1168,0,393,0,0,393,T
3-PA,1169,0,393,0,0,393,T
3-PA,1170,0,0,394,0,394,G
3-PA,1171,393,0,0,0,393,A
3-PA,1172,393,0,2,0,395,A
3-PA,1173,0,0,398,0,398,G
3-PA,1174,0,0,0,402,402,C
3-PA,1175,398,0,0,0,398,A
3-PA,1176,423,0,0,0,423,A
3-PA,1177,0,425,0,0,425,T
3-PA,1178,426,1,0,0,427,A
3-PA,1179,0,433,0,0,433,T
3-PA,1180,0,1,430,0,431,G
3-PA,1181,438,0,1,0,439,A
3-PA,1182,0,440,0,0,440,T
3-PA,1183,431,0,0,0,431,A
3-PA,1184,0,0,433,0,433,G
3-PA,1185,0,413,0,0,413,T
3-PA,1186,0,1,412,0,413,G
3-PA,1187,413,0,1,0,414,A
3-PA,1188,0,0,0,409,409,C
3-PA,1189,0,0,409,0,409,G
3-PA,1190,413,0,0,0,413,A
3-PA,1191,413,0,0,0,413,A
3-PA,1192,0,0,0,413,413,C
3-PA,1193,0,0,0,412,412,C
3-PA,1194,0,410,0,0,410,T
3-PA,1195,0,0,420,0,420,G
3-PA,1196,418,0,0,1,419,A
3-PA,1197,417,0,0,1,418,A
3-PA,1198,0,421,0,0,421,T
3-PA,1199,0,417,0,1,418,T
3-PA,1200,416,0,2,0,418,A
3-PA,1201,418,0,0,0,418,A
3-PA,1202,0,0,418,0,418,G
3-PA,1203,1,0,418,0,419,G
3-PA,1204,0,414,0,0,414,T
3-PA,1205,0,0,0,415,415,C
3-PA,1206,418,0,0,0,418,A
3-PA,1207,0,0,0,432,432,C
3-PA,1208,0,432,0,0,432,T
3-PA,1209,1,432,1,0,434,T
3-PA,1210,0,434,0,0,434,T
3-PA,1211,0,0,0,433,433,C
3-PA,1212,432,0,1,0,433,A
3-PA,1213,430,0,1,1,432,A
3-PA,1214,0,0,440,0,440,G
3-PA,1215,0,0,0,438,438,C
3-PA,1216,0,426,0,0,426,T
3-PA,1217,0,0,440,0,440,G
3-PA,1218,0,0,440,0,440,G
3-PA,1219,445,0,0,0,445,A
3-PA,1220,0,448,0,0,448,T
3-PA,1221,449,0,0,0,449,A
3-PA,1222,0,0,0,452,452,C
3-PA,1223,446,0,1,0,447,A
3-PA,1224,0,0,455,0,455,G
3-PA,1225,453,0,0,0,453,A
3-PA,1226,444,1,0,0,445,A
3-PA,1227,0,443,0,0,443,T
3-PA,1228,0,0,436,0,436,G
3-PA,1229,430,0,1,0,431,A
3-PA,1230,0,0,440,0,440,G
3-PA,1231,0,437,0,0,437,T
3-PA,1232,0,435,0,0,435,T
3-PA,1233,0,0,0,448,448,C
3-PA,1234,453,0,0,0,453,A
3-PA,1235,454,0,0,0,454,A
3-PA,1236,0,0,0,455,455,C
3-PA,1237,450,0,0,0,450,A
3-PA,1238,450,0,0,0,450,A
3-PA,1239,0,1,449,0,450,G
3-PA,1240,0,0,446,0,446,G
3-PA,1241,0,0,0,451,451,C
3-PA,1242,0,1,0,448,449,C
3-PA,1243,0,444,0,0,444,T
3-PA,1244,0,0,448,0,448,G
3-PA,1245,0,449,0,0,449,T
3-PA,1246,0,0,462,0,462,G
3-PA,1247,459,0,4,0,463,A
3-PA,1248,0,0,456,0,456,G
3-PA,1249,1,0,0,454,455,C
3-PA,1250,0,449,0,1,450,T
3-PA,1251,470,0,0,0,470,A
3-PA,1252,471,0,0,0,471,A
3-PA,1253,0,0,0,470,470,C
3-PA,1254,0,466,0,0,466,T
3-PA,1255,0,0,462,7,469,G
3-PA,1256,469,0,0,0,469,A
3-PA,1257,1,467,0,0,468,T
3-PA,1258,0,471,0,0,471,T
3-PA,1259,0,0,0,473,473,C
3-PA,1260,486,2,0,0,488,A
3-PA,1261,0,2,498,0,500,G
3-PA,1262,0,499,0,1,500,T
3-PA,1263,0,0,0,502,502,C
3-PA,1264,0,501,0,0,501,T
3-PA,1265,0,0,521,0,521,G
3-PA,1266,0,0,522,0,522,G
3-PA,1267,522,0,0,0,522,A
3-PA,1268,0,523,0,0,523,T
3-PA,1269,494,0,0,0,494,A
3-PA,1270,0,1,494,0,495,G
3-PA,1271,487,0,1,0,488,A
3-PA,1272,0,0,492,0,492,G
3-PA,1273,0,0,0,491,491,C
3-PA,1274,0,477,0,0,477,T
3-PA,1275,0,0,0,479,479,C
3-PA,1276,0,0,478,0,478,G
3-PA,1277,480,0,0,0,480,A
3-PA,1278,0,478,0,0,478,T
3-PA,1279,0,0,478,0,478,G
3-PA,1280,486,0,0,0,486,A
3-PA,1281,484,0,0,0,484,A
3-PA,1282,484,0,0,0,484,A
3-PA,1283,0,484,0,0,484,T
3-PA,1284,0,481,1,1,483,T
3-PA,1285,0,0,487,0,487,G
3-PA,1286,0,0,488,0,488,G
3-PA,1287,485,0,0,0,485,A
3-PA,1288,0,0,482,0,482,G
3-PA,1289,481,0,0,0,481,A
3-PA,1290,1,0,488,0,489,G
3-PA,1291,0,0,490,0,490,G
3-PA,1292,495,0,0,0,495,A
3-PA,1293,0,1,0,493,494,C
3-PA,1294,0,0,495,0,495,G
3-PA,1295,0,494,0,0,494,T
3-PA,1296,498,0,1,0,499,A
3-PA,1297,0,0,504,0,504,G
3-PA,1298,0,0,0,510,510,C
3-PA,1299,0,0,0,507,507,C
3-PA,1300,0,0,0,507,507,C
3-PA,1301,2,0,0,504,506,C
3-PA,1302,507,0,0,0,507,A
3-PA,1303,522,0,0,0,522,A
3-PA,1304,0,522,0,0,522,T
3-PA,1305,0,518,0,0,518,T
3-PA,1306,0,0,518,0,518,G
3-PA,1307,514,0,0,0,514,A
3-PA,1308,0,0,512,0,512,G
3-PA,1309,1,0,0,510,511,C
3-PA,1310,513,0,0,0,513,A
3-PA,1311,0,0,0,524,524,C
3-PA,1312,512,0,0,0,512,A
3-PA,1313,0,522,0,1,523,T
3-PA,1314,0,523,0,0,523,T
3-PA,1315,0,0,526,0,526,G
3-PA,1316,0,0,0,525,525,C
3-PA,1317,519,0,0,0,519,A
3-PA,1318,522,0,0,0,522,A
3-PA,1319,0,0,525,0,525,G
3-PA,1320,0,0,0,517,517,C
3-PA,1321,517,0,0,0,517,A
3-PA,1322,0,503,0,0,503,T
3-PA,1323,0,0,503,0,503,G
3-PA,1324,500,0,0,0,500,A
3-PA,1325,1,0,502,0,503,G
3-PA,1326,502,0,0,0,502,A
3-PA,1327,500,0,1,0,501,A
3-PA,1328,0,0,501,0,501,G
3-PA,1329,0,0,499,0,499,G
3-PA,1330,500,0,0,0,500,A
3-PA,1331,501,0,0,0,501,A
3-PA,1332,0,504,0,0,504,T
3-PA,1333,0,504,0,0,504,T
3-PA,1334,500,0,0,1,501,A
3-PA,1335,0,507,0,0,507,T
3-PA,1336,0,505,0,0,505,T
3-PA,1337,0,505,0,0,505,T
3-PA,1338,0,0,0,504,504,C
3-PA,1339,501,0,0,0,501,A
3-PA,1340,0,0,0,514,514,C
3-PA,1341,510,0,0,0,510,A
3-PA,1342,0,0,513,0,513,G
3-PA,1343,0,0,0,512,512,C
3-PA,1344,512,0,1,0,513,A
3-PA,1345,0,0,514,0,514,G
3-PA,1346,513,1,0,0,514,A
3-PA,1347,495,0,1,0,496,A
3-PA,1348,0,0,505,0,505,G
3-PA,1349,0,505,0,0,505,T
3-PA,1350,0,0,509,0,509,G
3-PA,1351,0,506,0,1,507,T
3-PA,1352,1,0,0,505,506,C
3-PA,1353,1,0,0,512,513,C
3-PA,1354,0,0,0,512,512,C
3-PA,1355,514,0,0,0,514,A
3-PA,1356,0,524,0,0,524,T
3-PA,1357,0,519,0,0,519,T
3-PA,1358,0,0,524,0,524,G
3-PA,1359,0,519,0,0,519,T
3-PA,1360,513,0,0,0,513,A
3-PA,1361,0,0,513,0,513,G
3-PA,1362,508,0,0,0,508,A
3-PA,1363,0,0,510,0,510,G
3-PA,1364,0,0,0,510,510,C
3-PA,1365,1,0,0,500,501,C
3-PA,1366,513,0,1,0,514,A
3-PA,1367,0,0,0,510,510,C
3-PA,1368,0,511,0,0,511,T
3-PA,1369,0,1,511,0,512,G
3-PA,1370,512,0,0,0,512,A
3-PA,1371,508,0,0,0,508,A
3-PA,1372,0,531,0,0,531,T
3-PA,1373,541,0,0,0,541,A
3-PA,1374,0,0,0,543,543,C
3-PA,1375,533,0,0,0,533,A
3-PA,1376,0,533,0,0,533,T
3-PA,1377,530,1,0,0,531,A
3-PA,1378,531,1,0,0,532,A
3-PA,1379,0,530,0,0,530,T
3-PA,1380,0,0,524,0,524,G
3-PA,1381,519,0,0,0,519,A
3-PA,1382,511,0,0,0,511,A
3-PA,1383,0,2,508,0,510,G
3-PA,1384,0,3,507,0,510,G
3-PA,1385,0,0,508,1,509,G
3-PA,1386,0,1,513,0,514,G
3-PA,1387,0,1,521,0,522,G
3-PA,1388,0,516,0,0,516,T
3-PA,1389,516,0,0,0,516,A
3-PA,1390,0,522,0,0,522,T
3-PA,1391,531,0,0,0,531,A
3-PA,1392,0,0,0,575,575,C
3-PA,1393,562,0,0,0,562,A
3-PA,1394,0,551,0,0,551,T
3-PA,1395,0,551,0,0,551,T
3-PA,1396,546,0,0,0,546,A
3-PA,1397,552,0,0,0,552,A
3-PA,1398,0,0,0,556,556,C
3-PA,1399,545,0,0,0,545,A
3-PA,1400,0,0,0,545,545,C
3-PA,1401,1,500,0,0,501,T
3-PA,1402,0,0,522,0,522,G
3-PA,1403,0,0,0,519,519,C
3-PA,1404,0,0,0,519,519,C
3-PA,1405,0,0,0,522,522,C
3-PA,1406,0,504,0,0,504,T
3-PA,1407,0,0,509,0,509,G
3-PA,1408,0,0,0,511,511,C
3-PA,1409,0,507,0,0,507,T
3-PA,1410,0,0,0,525,525,C
3-PA,1411,511,0,0,0,511,A
3-PA,1412,512,0,0,0,512,A
3-PA,1413,0,518,0,0,518,T
3-PA,1414,0,0,519,0,519,G
3-PA,1415,0,0,0,516,516,C
3-PA,1416,504,0,1,0,505,A
3-PA,1417,0,504,0,0,504,T
3-PA,1418,0,0,0,502,502,C
3-PA,1419,0,0,0,510,510,C
3-PA,1420,0,493,0,0,493,T
3-PA,1421,0,0,497,0,497,G
3-PA,1422,0,498,0,0,498,T
3-PA,1423,0,0,500,0,500,G
3-PA,1424,0,0,0,500,500,C
3-PA,1425,494,0,0,0,494,A
3-PA,1426,0,0,503,0,503,G
3-PA,1427,0,0,0,500,500,C
3-PA,1428,490,0,0,0,490,A
3-PA,1429,492,0,0,0,492,A
3-PA,1430,0,474,0,0,474,T
3-PA,1431,0,0,473,0,473,G
3-PA,1432,0,0,472,0,472,G
3-PA,1433,473,0,0,0,473,A
3-PA,1434,0,0,0,472,472,C
3-PA,1435,0,0,468,0,468,G
3-PA,1436,475,0,0,0,475,A
3-PA,1437,1,473,0,0,474,T
3-PA,1438,0,473,0,1,474,T
3-PA,1439,0,471,0,1,472,T
3-PA,1440,0,471,0,1,472,T
3-PA,1441,0,0,0,472,472,C
3-PA,1442,475,0,0,1,476,A
3-PA,1443,476,0,0,0,476,A
3-PA,1444,0,0,0,474,474,C
3-PA,1445,1,469,0,0,470,T
3-PA,1446,471,0,0,0,471,A
3-PA,1447,470,0,0,0,470,A
3-PA,1448,0,469,0,0,469,T
3-PA,1449,0,467,0,2,469,T
3-PA,1450,1,0,0,469,470,C
3-PA,1451,0,0,0,471,471,C
3-PA,1452,0,0,0,469,469,C
3-PA,1453,467,0,1,0,468,A
3-PA,1454,0,476,0,1,477,T
3-PA,1455,0,0,477,0,477,G
3-PA,1456,480,0,0,0,480,A
3-PA,1457,0,479,0,0,479,T
3-PA,1458,480,0,1,0,481,A
3-PA,1459,479,0,0,0,479,A
3-PA,1460,0,0,480,0,480,G
3-PA,1461,0,452,0,0,452,T
3-PA,1462,467,0,0,0,467,A
3-PA,1463,465,1,0,0,466,A
3-PA,1464,0,0,478,0,478,G
3-PA,1465,0,472,0,0,472,T
3-PA,1466,0,0,473,0,473,G
3-PA,1467,0,0,0,472,472,C
3-PA,1468,467,0,0,0,467,A
3-PA,1469,1,0,476,0,477,G
3-PA,1470,476,0,1,0,477,A
3-PA,1471,479,0,0,0,479,A
3-PA,1472,0,0,1,480,481,C
3-PA,1473,0,462,0,0,462,T
3-PA,1474,466,0,0,0,466,A
3-PA,1475,463,0,0,0,463,A
3-PA,1476,466,0,0,0,466,A
3-PA,1477,1,0,465,0,466,G
3-PA,1478,443,0,1,0,444,A
3-PA,1479,0,0,448,0,448,G
3-PA,1480,0,0,437,0,437,G
3-PA,1481,0,0,438,0,438,G
3-PA,1482,433,0,0,0,433,A
3-PA,1483,428,0,0,0,428,A
3-PA,1484,0,0,428,0,428,G
3-PA,1485,0,0,429,0,429,G
3-PA,1486,0,0,0,427,427,C
3-PA,1487,0,0,428,0,428,G
3-PA,1488,426,0,0,0,426,A
3-PA,1489,423,0,0,0,423,A
3-PA,1490,427,0,0,0,427,A
3-PA,1491,426,0,1,0,427,A
3-PA,1492,425,0,1,0,426,A
3-PA,1493,0,0,0,426,426,C
3-PA,1494,0,0,0,422,422,C
3-PA,1495,424,0,0,0,424,A
3-PA,1496,429,0,0,0,429,A
3-PA,1497,0,431,0,0,431,T
3-PA,1498,0,430,0,0,430,T
3-PA,1499,0,431,0,0,431,T
3-PA,1500,431,0,1,0,432,A
3-PA,1501,0,432,0,0,432,T
3-PA,1502,428,0,0,0,428,A
3-PA,1503,0,427,0,0,427,T
3-PA,1504,0,0,425,0,425,G
3-PA,1505,0,1,422,0,423,G
3-PA,1506,422,0,0,0,422,A
3-PA,1507,0,422,0,0,422,T
3-PA,1508,0,417,0,0,417,T
3-PA,1509,0,1,0,419,420,C
3-PA,1510,422,0,1,0,423,A
3-PA,1511,0,427,0,0,427,T
3-PA,1512,0,0,0,429,429,C
3-PA,1513,425,0,0,0,425,A
3-PA,1514,0,422,0,0,422,T
3-PA,1515,418,0,0,0,418,A
3-PA,1516,418,0,0,0,418,A
3-PA,1517,418,0,0,0,418,A
3-PA,1518,0,0,416,0,416,G
3-PA,1519,0,0,413,0,413,G
3-PA,1520,0,0,411,0,411,G
3-PA,1521,410,0,0,0,410,A
3-PA,1522,405,0,0,0,405,A
3-PA,1523,0,0,407,0,407,G
3-PA,1524,404,0,0,0,404,A
3-PA,1525,0,408,0,0,408,T
3-PA,1526,0,0,0,404,404,C
3-PA,1527,0,401,0,1,402,T
3-PA,1528,0,0,0,412,412,C
3-PA,1529,414,0,0,0,414,A
3-PA,1530,0,415,0,0,415,T
3-PA,1531,0,416,0,0,416,T
3-PA,1532,0,407,0,0,407,T
3-PA,1533,406,0,0,0,406,A
3-PA,1534,404,1,0,0,405,A
3-PA,1535,0,0,406,0,406,G
3-PA,1536,0,0,416,0,416,G
3-PA,1537,400,0,0,0,400,A
3-PA,1538,401,0,0,0,401,A
3-PA,1539,0,402,1,0,403,T
3-PA,1540,0,0,405,0,405,G
3-PA,1541,416,0,1,0,417,A
3-PA,1542,0,0,0,414,414,C
3-PA,1543,415,1,0,0,416,A
3-PA,1544,0,0,0,415,415,C
3-PA,1545,406,0,0,0,406,A
3-PA,1546,0,0,410,0,410,G
3-PA,1547,407,0,1,0,408,A
3-PA,1548,0,0,0,409,409,C
3-PA,1549,0,1,400,0,401,G
3-PA,1550,0,366,0,0,366,T
3-PA,1551,1,0,366,0,367,G
3-PA,1552,0,0,370,0,370,G
3-PA,1553,0,371,0,0,371,T
3-PA,1554,371,0,1,0,372,A
3-PA,1555,368,0,0,0,368,A
3-PA,1556,371,0,0,0,371,A
3-PA,1557,0,370,0,0,370,T
3-PA,1558,0,367,0,0,367,T
3-PA,1559,0,367,0,0,367,T
3-PA,1560,0,360,0,0,360,T
3-PA,1561,0,0,360,0,360,G
3-PA,1562,0,360,0,1,361,T
3-PA,1563,0,0,360,0,360,G
3-PA,1564,358,1,0,0,359,A
3-PA,1565,0,0,360,0,360,G
3-PA,1566,0,0,0,359,359,C
3-PA,1567,360,0,0,0,360,A
3-PA,1568,0,360,0,0,360,T
3-PA,1569,0,0,360,0,360,G
3-PA,1570,0,0,364,0,364,G
3-PA,1571,364,0,0,0,364,A
3-PA,1572,0,0,365,0,365,G
3-PA,1573,0,362,0,0,362,T
3-PA,1574,0,357,0,0,357,T
3-PA,1575,1,357,0,0,358,T
3-PA,1576,0,361,0,0,361,T
3-PA,1577,0,1,0,360,361,C
3-PA,1578,0,358,0,1,359,T
3-PA,1579,0,0,0,358,358,C
3-PA,1580,0,350,0,0,350,T
3-PA,1581,0,0,0,349,349,C
3-PA,1582,348,0,1,0,349,A
3-PA,1583,0,0,0,349,349,C
3-PA,1584,0,336,0,0,336,T
3-PA,1585,0,0,339,0,339,G
3-PA,1586,342,0,1,0,343,A
3-PA,1587,0,0,0,350,350,C
3-PA,1588,0,1,0,347,348,C
3-PA,1589,0,0,0,342,342,C
3-PA,1590,0,0,342,0,342,G
3-PA,1591,343,0,0,0,343,A
3-PA,1592,0,0,348,0,348,G
3-PA,1593,347,0,0,0,347,A
3-PA,1594,0,0,0,346,346,C
3-PA,1595,0,342,0,1,343,T
3-PA,1596,0,328,0,0,328,T
3-PA,1597,0,0,331,0,331,G
3-PA,1598,329,0,0,0,329,A
3-PA,1599,0,0,332,0,332,G
3-PA,1600,0,0,0,331,331,C
3-PA,1601,0,0,0,324,324,C
3-PA,1602,332,0,0,0,332,A
3-PA,1603,0,0,0,334,334,C
3-PA,1604,333,0,0,0,333,A
3-PA,1605,0,332,0,0,332,T
3-PA,1606,332,0,1,0,333,A
3-PA,1607,331,0,0,0,331,A
3-PA,1608,331,0,0,0,331,A
3-PA,1609,0,328,0,0,328,T
3-PA,1610,1,0,328,0,329,G
3-PA,1611,0,0,322,0,322,G
3-PA,1612,0,0,324,0,324,G
3-PA,1613,318,0,0,0,318,A
3-PA,1614,0,0,321,0,321,G
3-PA,1615,317,0,0,0,317,A
3-PA,1616,314,0,0,0,314,A
3-PA,1617,317,0,0,0,317,A
3-PA,1618,0,316,0,0,316,T
3-PA,1619,318,0,0,0,318,A
3-PA,1620,1,1,0,317,319,C
3-PA,1621,0,292,0,1,293,T
3-PA,1622,0,0,299,0,299,G
3-PA,1623,0,288,0,0,288,T
3-PA,1624,1,0,312,0,313,G
3-PA,1625,0,305,0,0,305,T
3-PA,1626,0,0,0,306,306,C
3-PA,1627,0,0,0,307,307,C
3-PA,1628,0,305,0,0,305,T
3-PA,1629,0,309,0,0,309,T
3-PA,1630,0,0,312,0,312,G
3-PA,1631,319,0,0,0,319,A
3-PA,1632,0,0,322,0,322,G
3-PA,1633,311,0,0,0,311,A
3-PA,1634,0,310,0,0,310,T
3-PA,1635,304,0,0,0,304,A
3-PA,1636,0,0,311,0,311,G
3-PA,1637,0,0,312,0,312,G
3-PA,1638,313,0,0,0,313,A
3-PA,1639,0,0,313,0,313,G
3-PA,1640,311,0,0,0,311,A
3-PA,1641,0,311,0,0,311,T
3-PA,1642,313,0,0,0,313,A
3-PA,1643,0,314,0,0,314,T
3-PA,1644,0,0,320,0,320,G
3-PA,1645,0,319,0,0,319,T
3-PA,1646,0,315,0,0,315,T
3-PA,1647,317,0,0,0,317,A
3-PA,1648,0,0,0,314,314,C
3-PA,1649,0,312,0,0,312,T
3-PA,1650,312,0,0,0,312,A
3-PA,1651,311,0,0,0,311,A
3-PA,1652,0,0,311,0,311,G
3-PA,1653,306,0,0,0,306,A
3-PA,1654,301,0,0,0,301,A
3-PA,1655,0,0,295,0,295,G
3-PA,1656,0,295,0,0,295,T
3-PA,1657,0,0,295,0,295,G
3-PA,1658,0,0,0,297,297,C
3-PA,1659,0,0,1,295,296,C
3-PA,1660,296,0,0,0,296,A
3-PA,1661,0,293,0,0,293,T
3-PA,1662,293,0,1,0,294,A
3-PA,1663,0,0,295,0,295,G
3-PA,1664,0,0,293,0,293,G
3-PA,1665,0,0,0,294,294,C
3-PA,1666,0,0,0,295,295,C
3-PA,1667,293,0,0,0,293,A
3-PA,1668,294,0,0,0,294,A
3-PA,1669,294,0,0,0,294,A
3-PA,1670,0,295,0,0,295,T
3-PA,1671,0,294,0,0,294,T
3-PA,1672,0,294,0,0,294,T
3-PA,1673,0,0,0,292,292,C
3-PA,1674,286,1,0,0,287,A
3-PA,1675,288,0,0,0,288,A
3-PA,1676,0,0,289,0,289,G
3-PA,1677,0,0,290,0,290,G
3-PA,1678,0,0,0,289,289,C
3-PA,1679,0,0,0,289,289,C
3-PA,1680,0,0,289,0,289,G
3-PA,1681,293,0,0,0,293,A
3-PA,1682,0,294,0,0,294,T
3-PA,1683,0,0,299,0,299,G
3-PA,1684,0,301,0,0,301,T
3-PA,1685,0,310,0,0,310,T
3-PA,1686,0,0,0,311,311,C
3-PA,1687,0,311,0,0,311,T
3-PA,1688,0,313,0,0,313,T
3-PA,1689,0,0,315,0,315,G
3-PA,1690,1,308,0,0,309,T
3-PA,1691,311,0,0,0,311,A
3-PA,1692,0,303,0,0,303,T
3-PA,1693,0,0,301,0,301,G
3-PA,1694,0,295,0,0,295,T
3-PA,1695,0,0,294,0,294,G
3-PA,1696,293,0,0,0,293,A
3-PA,1697,0,0,292,0,292,G
3-PA,1698,0,0,291,0,291,G
3-PA,1699,290,0,0,0,290,A
3-PA,1700,0,0,0,291,291,C
3-PA,1701,289,0,0,0,289,A
3-PA,1702,288,0,0,0,288,A
3-PA,1703,289,0,0,0,289,A
3-PA,1704,0,0,0,291,291,C
3-PA,1705,0,0,290,0,290,G
3-PA,1706,0,0,293,0,293,G
3-PA,1707,295,0,0,0,295,A
3-PA,1708,294,0,0,0,294,A
3-PA,1709,0,0,0,295,295,C
3-PA,1710,294,0,0,0,294,A
3-PA,1711,0,295,0,0,295,T
3-PA,1712,0,0,0,295,295,C
3-PA,1713,293,0,0,0,293,A
3-PA,1714,293,0,1,0,294,A
3-PA,1715,291,0,0,0,291,A
3-PA,1716,0,0,294,0,294,G
3-PA,1717,0,0,295,0,295,G
3-PA,1718,0,294,0,0,294,T
3-PA,1719,0,0,0,292,292,C
3-PA,1720,294,0,0,0,294,A
3-PA,1721,295,0,0,0,295,A
3-PA,1722,294,0,0,0,294,A
3-PA,1723,295,0,0,0,295,A
3-PA,1724,0,292,0,1,293,T
3-PA,1725,0,0,297,0,297,G
3-PA,1726,297,0,0,0,297,A
3-PA,1727,294,0,1,0,295,A
3-PA,1728,0,0,293,0,293,G
3-PA,1729,0,293,0,0,293,T
3-PA,1730,0,0,298,0,298,G
3-PA,1731,1,0,300,0,301,G
3-PA,1732,0,0,302,0,302,G
3-PA,1733,0,0,307,0,307,G
3-PA,1734,303,0,0,0,303,A
3-PA,1735,303,0,0,0,303,A
3-PA,1736,0,302,0,0,302,T
3-PA,1737,0,0,304,0,304,G
3-PA,1738,0,0,307,0,307,G
3-PA,1739,303,0,2,0,305,A
3-PA,1740,0,0,309,0,309,G
3-PA,1741,304,0,0,0,304,A
3-PA,1742,0,300,0,0,300,T
3-PA,1743,0,0,300,0,300,G
3-PA,1744,301,0,0,0,301,A
3-PA,1745,0,0,300,0,300,G
3-PA,1746,301,0,0,0,301,A
3-PA,1747,0,0,0,295,295,C
3-PA,1748,0,0,295,0,295,G
3-PA,1749,0,294,0,0,294,T
3-PA,1750,0,294,0,0,294,T
3-PA,1751,0,0,299,0,299,G
3-PA,1752,0,1,0,298,299,C
3-PA,1753,0,0,0,296,296,C
3-PA,1754,0,297,0,0,297,T
3-PA,1755,0,295,0,0,295,T
3-PA,1756,0,0,0,302,302,C
3-PA,1757,0,304,0,0,304,T
3-PA,1758,0,302,0,0,302,T
3-PA,1759,0,1,0,303,304,C
3-PA,1760,297,0,0,0,297,A
3-PA,1761,0,0,299,0,299,G
3-PA,1762,0,298,0,0,298,T
3-PA,1763,0,0,0,299,299,C
3-PA,1764,296,0,0,0,296,A
3-PA,1765,0,0,0,311,311,C
3-PA,1766,0,313,0,0,313,T
3-PA,1767,0,0,0,310,310,C
3-PA,1768,0,0,0,312,312,C
3-PA,1769,313,0,0,0,313,A
3-PA,1770,0,0,313,0,313,G
3-PA,1771,0,0,0,311,311,C
3-PA,1772,309,0,0,0,309,A
3-PA,1773,0,1,311,0,312,G
3-PA,1774,288,0,0,0,288,A
3-PA,1775,0,286,0,0,286,T
3-PA,1776,0,0,0,290,290,C
3-PA,1777,0,0,290,0,290,G
3-PA,1778,289,0,0,0,289,A
3-PA,1779,0,0,289,0,289,G
3-PA,1780,286,0,0,0,286,A
3-PA,1781,0,0,289,0,289,G
3-PA,1782,0,0,0,286,286,C
3-PA,1783,286,0,0,0,286,A
3-PA,1784,0,289,0,0,289,T
3-PA,1785,0,0,298,0,298,G
3-PA,1786,303,1,0,0,304,A
3-PA,1787,0,304,0,0,304,T
3-PA,1788,0,305,0,1,306,T
3-PA,1789,0,0,306,0,306,G
3-PA,1790,305,0,0,0,305,A
3-PA,1791,306,0,0,0,306,A
3-PA,1792,0,0,306,0,306,G
3-PA,1793,0,0,0,305,305,C
3-PA,1794,0,1,0,297,298,C
3-PA,1795,0,0,297,0,297,G
3-PA,1796,297,0,0,0,297,A
3-PA,1797,0,0,298,0,298,G
3-PA,1798,0,295,0,0,295,T
3-PA,1799,0,0,0,296,296,C
3-PA,1800,0,0,0,297,297,C
3-PA,1801,0,294,0,1,295,T
3-PA,1802,0,0,0,299,299,C
3-PA,1803,0,0,300,0,300,G
3-PA,1804,0,0,307,0,307,G
3-PA,1805,0,306,0,0,306,T
3-PA,1806,0,305,0,0,305,T
3-PA,1807,305,0,0,0,305,A
3-PA,1808,303,0,0,0,303,A
3-PA,1809,303,0,0,0,303,A
3-PA,1810,0,0,309,0,309,G
3-PA,1811,305,0,0,0,305,A
3-PA,1812,0,0,305,0,305,G
3-PA,1813,296,0,0,0,296,A
3-PA,1814,296,1,0,0,297,A
3-PA,1815,284,0,13,0,297,A
3-PA,1816,0,0,298,0,298,G
3-PA,1817,295,0,0,0,295,A
3-PA,1818,0,0,0,297,297,C
3-PA,1819,293,0,1,0,294,A
3-PA,1820,0,293,0,0,293,T
3-PA,1821,0,0,294,0,294,G
3-PA,1822,297,0,0,0,297,A
3-PA,1823,0,0,0,297,297,C
3-PA,1824,0,0,0,296,296,C
3-PA,1825,293,0,0,0,293,A
3-PA,1826,294,0,0,0,294,A
3-PA,1827,292,0,0,0,292,A
3-PA,1828,0,0,293,0,293,G
3-PA,1829,290,0,0,0,290,A
3-PA,1830,0,0,291,0,291,G
3-PA,1831,0,286,0,0,286,T
3-PA,1832,0,283,0,0,283,T
3-PA,1833,0,280,0,0,280,T
3-PA,1834,0,284,0,0,284,T
3-PA,1835,0,284,0,0,284,T
3-PA,1836,0,286,0,0,286,T
3-PA,1837,0,0,283,0,283,G
3-PA,1838,285,0,0,0,285,A
3-PA,1839,0,0,283,0,283,G
3-PA,1840,284,0,0,0,284,A
3-PA,1841,284,0,1,0,285,A
3-PA,1842,0,281,0,0,281,T
3-PA,1843,285,0,0,0,285,A
3-PA,1844,289,0,0,0,289,A
3-PA,1845,293,0,0,0,293,A
3-PA,1846,0,291,0,0,291,T
3-PA,1847,0,0,0,292,292,C
3-PA,1848,290,0,1,0,291,A
3-PA,1849,0,0,292,0,292,G
3-PA,1850,291,0,0,0,291,A
3-PA,1851,291,0,0,0,291,A
3-PA,1852,1,0,292,0,293,G
3-PA,1853,0,0,0,283,283,C
3-PA,1854,281,0,0,0,281,A
3-PA,1855,0,277,0,0,277,T
3-PA,1856,0,0,279,0,279,G
3-PA,1857,0,0,279,0,279,G
3-PA,1858,0,0,0,276,276,C
3-PA,1859,0,0,0,283,283,C
3-PA,1860,0,0,0,281,281,C
3-PA,1861,289,0,0,0,289,A
3-PA,1862,0,290,0,0,290,T
3-PA,1863,0,291,0,0,291,T
3-PA,1864,0,0,291,0,291,G
3-PA,1865,0,0,292,0,292,G
3-PA,1866,0,0,288,0,288,G
3-PA,1867,0,0,287,0,287,G
3-PA,1868,277,0,0,0,277,A
3-PA,1869,0,0,281,0,281,G
3-PA,1870,0,277,0,0,277,T
3-PA,1871,0,0,0,284,284,C
3-PA,1872,0,0,0,301,301,C
3-PA,1873,0,0,0,300,300,C
3-PA,1874,0,0,0,300,300,C
3-PA,1875,1,0,0,300,301,C
3-PA,1876,299,0,0,0,299,A
3-PA,1877,300,0,0,0,300,A
3-PA,1878,0,0,298,0,298,G
3-PA,1879,0,0,299,0,299,G
3-PA,1880,0,0,302,0,302,G
3-PA,1881,281,0,0,0,281,A
3-PA,1882,0,0,282,0,282,G
3-PA,1883,0,282,0,0,282,T
3-PA,1884,0,0,280,0,280,G
3-PA,1885,0,0,283,1,284,G
3-PA,1886,283,0,0,0,283,A
3-PA,1887,284,0,0,0,284,A
3-PA,1888,0,0,284,0,284,G
3-PA,1889,282,0,0,0,282,A
3-PA,1890,284,0,0,0,284,A
3-PA,1891,0,0,278,1,279,G
3-PA,1892,0,0,282,0,282,G
3-PA,1893,0,280,0,0,280,T
3-PA,1894,0,280,0,0,280,T
3-PA,1895,0,0,0,277,277,C
3-PA,1896,0,0,0,279,279,C
3-PA,1897,280,0,0,0,280,A
3-PA,1898,0,279,0,0,279,T
3-PA,1899,0,279,0,0,279,T
3-PA,1900,1,0,277,0,278,G
3-PA,1901,0,0,276,0,276,G
3-PA,1902,0,0,276,0,276,G
3-PA,1903,273,1,0,0,274,A
3-PA,1904,273,0,0,0,273,A
3-PA,1905,272,0,0,0,272,A
3-PA,1906,0,0,282,0,282,G
3-PA,1907,0,281,0,0,281,T
3-PA,1908,0,0,0,285,285,C
3-PA,1909,0,281,0,1,282,T
3-PA,1910,0,0,286,0,286,G
3-PA,1911,0,286,0,0,286,T
3-PA,1912,283,0,0,0,283,A
3-PA,1913,0,0,285,0,285,G
3-PA,1914,0,0,279,0,279,G
3-PA,1915,266,0,0,0,266,A
3-PA,1916,0,0,0,264,264,C
3-PA,1917,0,262,0,0,262,T
3-PA,1918,0,0,0,274,274,C
3-PA,1919,0,274,0,0,274,T
3-PA,1920,276,0,0,0,276,A
3-PA,1921,0,275,0,0,275,T
3-PA,1922,0,273,0,0,273,T
3-PA,1923,0,0,282,0,282,G
3-PA,1924,0,0,282,0,282,G
3-PA,1925,0,0,0,280,280,C
3-PA,1926,0,279,0,0,279,T
3-PA,1927,262,0,0,0,262,A
3-PA,1928,265,0,0,0,265,A
3-PA,1929,0,0,267,0,267,G
3-PA,1930,0,268,0,0,268,T
3-PA,1931,0,0,0,268,268,C
3-PA,1932,264,0,0,0,264,A
3-PA,1933,0,0,273,0,273,G
3-PA,1934,0,273,0,0,273,T
3-PA,1935,279,0,0,1,280,A
3-PA,1936,0,278,0,1,279,T
3-PA,1937,0,278,0,0,278,T
3-PA,1938,0,0,0,277,277,C
3-PA,1939,272,0,0,0,272,A
3-PA,1940,272,0,0,0,272,A
3-PA,1941,0,272,0,0,272,T
3-PA,1942,261,0,0,0,261,A
3-PA,1943,0,0,266,0,266,G
3-PA,1944,0,1,0,264,265,C
3-PA,1945,0,0,0,269,269,C
3-PA,1946,0,259,0,1,260,T
3-PA,1947,0,0,262,0,262,G
3-PA,1948,0,262,0,0,262,T
3-PA,1949,261,0,0,0,261,A
3-PA,1950,0,262,0,0,262,T
3-PA,1951,0,0,260,0,260,G
3-PA,1952,0,0,0,259,259,C
3-PA,1953,252,0,0,0,252,A
3-PA,1954,0,252,0,0,252,T
3-PA,1955,0,0,0,251,251,C
3-PA,1956,246,1,0,0,247,A
3-PA,1957,0,0,0,249,249,C
3-PA,1958,0,0,0,249,249,C
3-PA,1959,248,0,0,0,248,A
3-PA,1960,0,1,0,246,247,C
3-PA,1961,247,0,0,1,248,A
3-PA,1962,248,0,0,0,248,A
3-PA,1963,0,247,0,0,247,T
3-PA,1964,0,246,0,0,246,T
3-PA,1965,0,0,247,0,247,G
3-PA,1966,0,0,241,0,241,G
3-PA,1967,241,0,0,0,241,A
3-PA,1968,241,0,0,0,241,A
3-PA,1969,0,0,238,0,238,G
3-PA,1970,0,0,237,0,237,G
3-PA,1971,237,0,0,0,237,A
3-PA,1972,0,235,0,0,235,T
3-PA,1973,0,235,0,0,235,T
3-PA,1974,0,235,0,0,235,T
3-PA,1975,0,234,0,0,234,T
3-PA,1976,0,0,0,235,235,C
3-PA,1977,235,0,0,0,235,A
3-PA,1978,0,0,235,0,235,G
3-PA,1979,0,0,0,234,234,C
3-PA,1980,0,0,234,0,234,G
3-PA,1981,0,0,233,0,233,G
3-PA,1982,233,0,0,0,233,A
3-PA,1983,0,0,236,0,236,G
3-PA,1984,0,235,0,0,235,T
3-PA,1985,0,0,0,236,236,C
3-PA,1986,235,0,0,0,235,A
3-PA,1987,236,0,0,0,236,A
3-PA,1988,0,0,235,0,235,G
3-PA,1989,235,1,0,0,236,A
3-PA,1990,232,0,1,0,233,A
3-PA,1991,235,0,0,0,235,A
3-PA,1992,233,0,0,0,233,A
3-PA,1993,0,0,0,233,233,C
3-PA,1994,0,227,0,0,227,T
3-PA,1995,0,1,226,0,227,G
3-PA,1996,0,0,0,225,225,C
3-PA,1997,0,225,0,0,225,T
3-PA,1998,0,0,0,228,228,C
3-PA,1999,0,0,0,226,226,C
3-PA,2000,0,225,0,1,226,T
3-PA,2001,0,227,0,0,227,T
3-PA,2002,0,0,225,0,225,G
3-PA,2003,0,226,0,0,226,T
3-PA,2004,0,222,0,0,222,T
3-PA,2005,0,0,222,0,222,G
3-PA,2006,0,222,0,0,222,T
3-PA,2007,0,221,0,0,221,T
3-PA,2008,0,0,0,221,221,C
3-PA,2009,213,0,0,0,213,A
3-PA,2010,0,0,213,0,213,G
3-PA,2011,1,0,211,0,212,G
3-PA,2012,0,0,0,216,216,C
3-PA,2013,0,215,0,0,215,T
3-PA,2014,0,0,0,219,219,C
3-PA,2015,0,218,0,0,218,T
3-PA,2016,0,219,0,0,219,T
3-PA,2017,219,0,0,0,219,A
3-PA,2018,0,0,219,0,219,G
3-PA,2019,0,1,214,0,215,G
3-PA,2020,1,0,211,0,212,G
3-PA,2021,210,0,0,0,210,A
3-PA,2022,0,0,0,211,211,C
3-PA,2023,198,0,0,0,198,A
3-PA,2024,202,0,0,0,202,A
3-PA,2025,0,0,0,204,204,C
3-PA,2026,0,0,0,202,202,C
3-PA,2027,0,204,0,0,204,T
3-PA,2028,0,0,0,201,201,C
3-PA,2029,0,0,202,0,202,G
3-PA,2030,203,0,0,0,203,A
3-PA,2031,204,0,0,0,204,A
3-PA,2032,0,0,0,205,205,C
3-PA,2033,0,0,0,199,199,C
3-PA,2034,1,196,0,0,197,T
3-PA,2035,0,0,196,0,196,G
3-PA,2036,0,0,195,0,195,G
3-PA,2037,0,0,195,0,195,G
3-PA,2038,195,0,0,0,195,A
3-PA,2039,0,0,0,190,190,C
3-PA,2040,0,0,0,190,190,C
3-PA,2041,0,187,0,0,187,T
3-PA,2042,0,187,0,0,187,T
3-PA,2043,0,186,0,0,186,T
3-PA,2044,0,0,187,0,187,G
3-PA,2045,188,0,0,0,188,A
3-PA,2046,0,187,0,0,187,T
3-PA,2047,0,0,0,186,186,C
3-PA,2048,0,179,0,0,179,T
3-PA,2049,0,179,0,0,179,T
3-PA,2050,1,0,177,0,178,G
3-PA,2051,0,0,179,0,179,G
3-PA,2052,0,0,177,0,177,G
3-PA,2053,0,0,177,0,177,G
3-PA,2054,0,0,174,0,174,G
3-PA,2055,0,0,175,0,175,G
3-PA,2056,0,0,0,174,174,C
3-PA,2057,0,175,0,0,175,T
3-PA,2058,180,0,1,0,181,A
3-PA,2059,0,181,0,0,181,T
3-PA,2060,180,0,0,0,180,A
3-PA,2061,0,181,0,0,181,T
3-PA,2062,0,0,176,0,176,G
3-PA,2063,173,1,0,0,174,A
3-PA,2064,173,0,0,0,173,A
3-PA,2065,0,0,174,0,174,G
3-PA,2066,0,0,0,175,175,C
3-PA,2067,164,0,0,0,164,A
3-PA,2068,167,0,0,0,167,A
3-PA,2069,0,168,0,0,168,T
3-PA,2070,0,168,0,0,168,T
3-PA,2071,0,0,167,0,167,G
3-PA,2072,168,0,0,0,168,A
3-PA,2073,0,0,168,0,168,G
3-PA,2074,0,0,167,0,167,G
3-PA,2075,159,0,0,0,159,A
3-PA,2076,0,0,160,0,160,G
3-PA,2077,0,151,0,0,151,T
3-PA,2078,0,0,151,0,151,G
3-PA,2079,0,0,0,150,150,C
3-PA,2080,0,0,0,149,149,C
3-PA,2081,0,150,0,0,150,T
3-PA,2082,0,0,152,0,152,G
3-PA,2083,152,0,0,0,152,A
3-PA,2084,0,150,0,0,150,T
3-PA,2085,0,140,0,0,140,T
3-PA,2086,141,0,0,0,141,A
3-PA,2087,141,0,0,0,141,A
3-PA,2088,0,139,0,0,139,T
3-PA,2089,0,0,139,0,139,G
3-PA,2090,137,0,0,0,137,A
3-PA,2091,0,130,0,0,130,T
3-PA,2092,0,0,0,130,130,C
3-PA,2093,0,0,0,128,128,C
3-PA,2094,0,0,0,129,129,C
3-PA,2095,0,128,0,0,128,T
3-PA,2096,0,0,129,0,129,G
3-PA,2097,0,0,129,0,129,G
3-PA,2098,0,0,129,0,129,G
3-PA,2099,0,126,0,0,126,T
3-PA,2100,0,121,0,0,121,T
3-PA,2101,0,121,0,0,121,T
3-PA,2102,1,120,0,0,121,T
3-PA,2103,0,0,122,0,122,G
3-PA,2104,0,0,0,121,121,C
3-PA,2105,0,120,0,1,121,T
3-PA,2106,0,0,0,121,121,C
3-PA,2107,114,0,0,0,114,A
3-PA,2108,113,0,1,0,114,A
3-PA,2109,0,115,0,0,115,T
3-PA,2110,0,0,115,0,115,G
3-PA,2111,0,0,0,116,116,C
3-PA,2112,0,0,115,0,115,G
3-PA,2113,0,114,0,0,114,T
3-PA,2114,0,0,0,116,116,C
3-PA,2115,0,113,0,0,113,T
3-PA,2116,0,115,0,0,115,T
3-PA,2117,0,0,115,0,115,G
3-PA,2118,0,0,115,0,115,G
3-PA,2119,0,115,0,0,115,T
3-PA,2120,0,114,0,0,114,T
3-PA,2121,0,0,0,108,108,C
3-PA,2122,105,0,0,0,105,A
3-PA,2123,106,0,0,0,106,A
3-PA,2124,0,0,0,106,106,C
3-PA,2125,0,105,0,0,105,T
3-PA,2126,0,0,0,106,106,C
3-PA,2127,0,0,0,102,102,C
3-PA,2128,0,100,0,0,100,T
3-PA,2129,0,100,0,0,100,T
3-PA,2130,0,0,0,100,100,C
3-PA,2131,0,0,0,100,100,C
3-PA,2132,0,100,0,0,100,T
3-PA,2133,0,0,100,0,100,G
3-PA,2134,100,0,0,0,100,A
3-PA,2135,0,0,0,98,98,C
3-PA,2136,94,0,0,0,94,A
3-PA,2137,0,0,0,85,85,C
3-PA,2138,82,0,0,0,82,A
3-PA,2139,0,81,0,0,81,T
3-PA,2140,0,0,82,0,82,G
3-PA,2141,0,0,0,80,80,C
3-PA,2142,80,0,0,0,80,A
3-PA,2143,0,80,0,0,80,T
3-PA,2144,0,80,0,0,80,T
3-PA,2145,80,0,0,0,80,A
3-PA,2146,79,0,0,0,79,A
3-PA,2147,80,0,0,0,80,A
3-PA,2148,79,0,0,0,79,A
3-PA,2149,0,79,0,0,79,T
3-PA,2150,66,0,0,0,66,A
3-PA,2151,0,0,66,0,66,G
4-HA,1,63,0,0,0,63,A
4-HA,2,0,63,0,0,63,T
4-HA,3,0,0,64,0,64,G
4-HA,4,64,0,0,0,64,A
4-HA,5,65,0,0,0,65,A
4-HA,6,0,0,77,0,77,G
4-HA,7,77,0,0,0,77,A
4-HA,8,0,0,0,83,83,C
4-HA,9,0,82,0,0,82,T
4-HA,10,83,0,0,0,83,A
4-HA,11,0,89,0,0,89,T
4-HA,12,0,0,0,90,90,C
4-HA,13,90,0,0,0,90,A
4-HA,14,0,91,0,0,91,T
4-HA,15,0,90,0,0,90,T
4-HA,16,0,0,103,0,103,G
4-HA,17,0,0,0,104,104,C
4-HA,18,0,103,0,0,103,T
4-HA,19,0,104,0,0,104,T
4-HA,20,0,104,0,0,104,T
4-HA,21,0,0,112,0,112,G
4-HA,22,114,0,0,0,114,A
4-HA,23,0,0,120,0,120,G
4-HA,24,0,0,0,119,119,C
4-HA,25,0,121,0,0,121,T
4-HA,26,128,0,0,0,128,A
4-HA,27,0,0,0,131,131,C
4-HA,28,132,0,0,0,132,A
4-HA,29,0,146,0,0,146,T
4-HA,30,0,145,0,0,145,T
4-HA,31,0,0,0,147,147,C
4-HA,32,0,147,0,0,147,T
4-HA,33,150,0,0,0,150,A
4-HA,34,0,150,0,0,150,T
4-HA,35,0,0,150,0,150,G
4-HA,36,0,151,0,0,151,T
4-HA,37,0,0,0,151,151,C
4-HA,38,0,151,0,0,151,T
4-HA,39,0,0,151,0,151,G
4-HA,40,0,0,150,0,150,G
4-HA,41,0,150,0,0,150,T
4-HA,42,0,151,0,1,152,T
4-HA,43,0,152,0,0,152,T
4-HA,44,0,153,0,0,153,T
4-HA,45,0,1,0,152,153,C
4-HA,46,0,0,153,0,153,G
4-HA,47,0,0,0,158,158,C
4-HA,48,0,157,0,0,157,T
4-HA,49,0,0,0,158,158,C
4-HA,50,158,0,0,0,158,A
4-HA,51,158,0,0,0,158,A
4-HA,52,157,0,0,0,157,A
4-HA,53,158,0,0,0,158,A
4-HA,54,159,0,0,0,159,A
4-HA,55,0,0,0,160,160,C
4-HA,56,0,158,0,0,158,T
4-HA,57,0,158,0,0,158,T
4-HA,58,0,0,0,159,159,C
4-HA,59,0,0,0,158,158,C
4-HA,60,0,159,0,0,159,T
4-HA,61,0,0,159,0,159,G
4-HA,62,0,0,158,0,158,G
4-HA,63,157,0,0,0,157,A
4-HA,64,167,1,0,0,168,A
4-HA,65,167,0,0,0,167,A
4-HA,66,0,169,0,0,169,T
4-HA,67,0,0,170,0,170,G
4-HA,68,169,0,0,0,169,A
4-HA,69,0,0,0,172,172,C
4-HA,70,171,0,0,0,171,A
4-HA,71,172,0,0,0,172,A
4-HA,72,0,0,0,175,175,C
4-HA,73,175,0,0,0,175,A
4-HA,74,0,0,178,0,178,G
4-HA,75,0,0,0,177,177,C
4-HA,76,176,0,0,0,176,A
4-HA,77,0,0,0,180,180,C
4-HA,78,1,0,179,0,180,G
4-HA,79,0,0,183,0,183,G
4-HA,80,0,0,0,183,183,C
4-HA,81,182,0,0,0,182,A
4-HA,82,183,0,0,0,183,A
4-HA,83,0,0,0,183,183,C
4-HA,84,0,0,186,0,186,G
4-HA,85,0,0,0,186,186,C
4-HA,86,0,185,0,0,185,T
4-HA,87,0,0,190,0,190,G
4-HA,88,0,188,0,0,188,T
4-HA,89,0,0,202,0,202,G
4-HA,90,0,0,0,203,203,C
4-HA,91,0,0,0,206,206,C
4-HA,92,0,205,0,0,205,T
4-HA,93,0,202,0,0,202,T
4-HA,94,0,0,205,0,205,G
4-HA,95,0,0,207,0,207,G
4-HA,96,0,0,211,0,211,G
4-HA,97,0,0,0,211,211,C
4-HA,98,210,0,0,0,210,A
4-HA,99,0,0,0,212,212,C
4-HA,100,0,0,0,212,212,C
4-HA,101,236,0,0,0,236,A
4-HA,102,0,236,0,0,236,T
4-HA,103,0,0,234,0,234,G
4-HA,104,0,0,0,237,237,C
4-HA,105,237,0,0,0,237,A
4-HA,106,0,0,255,0,255,G
4-HA,107,0,255,0,0,255,T
4-HA,108,256,0,0,0,256,A
4-HA,109,0,0,0,255,255,C
4-HA,110,0,0,0,248,248,C
4-HA,111,247,0,1,0,248,A
4-HA,112,248,0,0,0,248,A
4-HA,113,248,0,0,0,248,A
4-HA,114,0,0,0,249,249,C
4-HA,115,0,0,241,0,241,G
4-HA,116,0,2,242,0,244,G
4-HA,117,243,0,0,0,243,A
4-HA,118,244,0,1,0,245,A
4-HA,119,0,0,0,243,243,C
4-HA,120,0,0,245,0,245,G
4-HA,121,245,0,0,0,245,A
4-HA,122,0,246,0,0,246,T
4-HA,123,246,0,0,0,246,A
4-HA,124,0,0,249,0,249,G
4-HA,125,0,248,0,0,248,T
4-HA,126,0,0,247,0,247,G
4-HA,127,247,0,0,0,247,A
4-HA,128,247,0,0,0,247,A
4-HA,129,248,0,0,0,248,A
4-HA,130,247,0,0,0,247,A
4-HA,131,0,0,0,249,249,C
4-HA,132,250,0,0,0,250,A
4-HA,133,251,0,0,0,251,A
4-HA,134,0,250,0,0,250,T
4-HA,135,0,0,0,250,250,C
4-HA,136,250,0,0,0,250,A
4-HA,137,0,0,0,251,251,C
4-HA,138,0,0,252,0,252,G
4-HA,139,251,0,0,0,251,A
4-HA,140,251,0,0,0,251,A
4-HA,141,0,249,0,0,249,T
4-HA,142,0,0,251,0,251,G
4-HA,143,250,0,0,0,250,A
4-HA,144,0,0,0,250,250,C
4-HA,145,0,0,0,249,249,C
4-HA,146,251,0,0,0,251,A
4-HA,147,254,0,0,0,254,A
4-HA,148,253,1,0,0,254,A
4-HA,149,0,254,0,0,254,T
4-HA,150,0,255,0,0,255,T
4-HA,151,0,0,257,0,257,G
4-HA,152,253,0,0,0,253,A
4-HA,153,254,0,0,0,254,A
4-HA,154,0,0,255,0,255,G
4-HA,155,0,256,0,0,256,T
4-HA,156,0,266,0,0,266,T
4-HA,157,267,0,0,0,267,A
4-HA,158,0,0,0,270,270,C
4-HA,159,0,271,0,1,272,T
4-HA,160,273,0,0,0,273,A
4-HA,161,278,0,0,0,278,A
4-HA,162,0,279,0,0,279,T
4-HA,163,0,0,279,0,279,G
4-HA,164,0,0,0,295,295,C
4-HA,165,0,286,0,0,286,T
4-HA,166,289,0,0,0,289,A
4-HA,167,0,0,0,287,287,C
4-HA,168,0,287,0,0,287,T
4-HA,169,0,0,285,0,285,G
4-HA,170,282,0,0,0,282,A
4-HA,171,0,0,283,0,283,G
4-HA,172,0,0,0,284,284,C
4-HA,173,0,270,0,0,270,T
4-HA,174,0,0,277,0,277,G
4-HA,175,0,0,280,0,280,G
4-HA,176,0,279,0,0,279,T
4-HA,177,0,278,0,1,279,T
4-HA,178,0,0,0,276,276,C
4-HA,179,275,0,1,0,276,A
4-HA,180,0,0,279,0,279,G
4-HA,181,278,0,0,0,278,A
4-HA,182,0,0,288,0,288,G
4-HA,183,0,285,0,0,285,T
4-HA,184,0,285,0,0,285,T
4-HA,185,1,0,0,286,287,C
4-HA,186,0,0,0,288,288,C
4-HA,187,0,287,0,1,288,T
4-HA,188,0,0,0,290,290,C
4-HA,189,289,0,0,0,289,A
4-HA,190,289,1,0,0,290,A
4-HA,191,0,0,0,293,293,C
4-HA,192,288,0,1,0,289,A
4-HA,193,0,0,291,0,291,G
4-HA,194,0,0,293,0,293,G
4-HA,195,0,291,0,0,291,T
4-HA,196,0,0,292,0,292,G
4-HA,197,292,0,0,0,292,A
4-HA,198,292,1,0,0,293,A
4-HA,199,295,0,2,0,297,A
4-HA,200,0,296,0,0,296,T
4-HA,201,297,0,0,0,297,A
4-HA,202,0,294,0,0,294,T
4-HA,203,0,0,294,0,294,G
4-HA,204,0,0,0,293,293,C
4-HA,205,0,0,294,0,294,G
4-HA,206,292,0,1,0,293,A
4-HA,207,0,0,0,294,294,C
4-HA,208,290,0,0,0,290,A
4-HA,209,0,0,311,0,311,G
4-HA,210,1,310,0,0,311,T
4-HA,211,0,0,0,314,314,C
4-HA,212,0,0,0,314,314,C
4-HA,213,0,312,0,0,312,T
4-HA,214,1,0,0,318,319,C
4-HA,215,318,0,1,0,319,A
4-HA,216,0,319,0,0,319,T
4-HA,217,0,0,0,320,320,C
4-HA,218,305,0,0,1,306,A
4-HA,219,0,0,310,0,310,G
4-HA,220,309,0,0,0,309,A
4-HA,221,0,308,0,0,308,T
4-HA,222,0,0,0,308,308,C
4-HA,223,0,0,0,302,302,C
4-HA,224,0,300,0,0,300,T
4-HA,225,0,303,0,0,303,T
4-HA,226,0,0,303,0,303,G
4-HA,227,303,0,0,0,303,A
4-HA,228,0,300,0,0,300,T
4-HA,229,0,0,305,0,305,G
4-HA,230,0,0,305,0,305,G
4-HA,231,301,0,0,0,301,A
4-HA,232,0,0,303,0,303,G
4-HA,233,302,0,0,1,303,A
4-HA,234,305,0,0,0,305,A
4-HA,235,305,0,0,0,305,A
4-HA,236,304,0,0,0,304,A
4-HA,237,0,0,0,305,305,C
4-HA,238,0,301,0,1,302,T
4-HA,239,0,0,303,0,303,G
4-HA,240,0,0,0,304,304,C
4-HA,241,303,0,0,0,303,A
4-HA,242,0,0,0,308,308,C
4-HA,243,306,0,0,1,307,A
4-HA,244,0,0,0,351,351,C
4-HA,245,0,349,0,0,349,T
4-HA,246,357,0,0,0,357,A
4-HA,247,356,0,0,0,356,A
4-HA,248,0,360,0,0,360,T
4-HA,249,358,0,0,0,358,A
4-HA,250,0,0,361,0,361,G
4-HA,251,352,0,1,0,353,A
4-HA,252,0,354,0,0,354,T
4-HA,253,0,0,332,0,332,G
4-HA,254,0,0,0,332,332,C
4-HA,255,0,333,0,0,333,T
4-HA,256,0,0,0,348,348,C
4-HA,257,0,348,0,0,348,T
4-HA,258,360,0,0,0,360,A
4-HA,259,0,359,0,0,359,T
4-HA,260,0,357,0,0,357,T
4-HA,261,0,0,357,0,357,G
4-HA,262,0,0,353,0,353,G
4-HA,263,0,0,352,0,352,G
4-HA,264,347,0,1,0,348,A
4-HA,265,0,0,339,0,339,G
4-HA,266,335,0,1,0,336,A
4-HA,267,0,0,0,343,343,C
4-HA,268,1,0,0,344,345,C
4-HA,269,1,0,0,346,347,C
4-HA,270,0,342,0,0,342,T
4-HA,271,0,0,0,345,345,C
4-HA,272,347,0,0,0,347,A
4-HA,273,0,0,362,0,362,G
4-HA,274,0,362,0,0,362,T
4-HA,275,0,0,366,0,366,G
4-HA,276,0,354,0,0,354,T
4-HA,277,0,0,350,0,350,G
4-HA,278,351,0,0,0,351,A
4-HA,279,0,348,0,0,348,T
4-HA,280,0,0,348,0,348,G
4-HA,281,0,0,347,0,347,G
4-HA,282,0,1,0,343,344,C
4-HA,283,0,1,0,338,339,C
4-HA,284,0,343,0,0,343,T
4-HA,285,0,0,0,343,343,C
4-HA,286,0,0,0,345,345,C
4-HA,287,346,0,0,0,346,A
4-HA,288,345,0,0,0,345,A
4-HA,289,346,0,0,0,346,A
4-HA,290,345,0,0,0,345,A
4-HA,291,0,0,0,344,344,C
4-HA,292,346,0,0,0,346,A
4-HA,293,347,0,0,0,347,A
4-HA,294,0,0,344,0,344,G
4-HA,295,349,0,0,0,349,A
4-HA,296,348,0,0,0,348,A
4-HA,297,347,0,0,0,347,A
4-HA,298,0,349,0,0,349,T
4-HA,299,0,1,348,0,349,G
4-HA,300,0,0,347,0,347,G
4-HA,301,0,0,347,0,347,G
4-HA,302,351,0,0,0,351,A
4-HA,303,0,0,0,349,349,C
4-HA,304,0,0,0,344,344,C
4-HA,305,0,349,0,1,350,T
4-HA,306,0,346,0,0,346,T
4-HA,307,0,349,0,0,349,T
4-HA,308,0,353,0,0,353,T
4-HA,309,0,353,0,0,353,T
4-HA,310,0,0,354,0,354,G
4-HA,311,0,353,0,1,354,T
4-HA,312,0,354,0,0,354,T
4-HA,313,0,0,352,0,352,G
4-HA,314,348,0,0,0,348,A
4-HA,315,349,0,0,0,349,A
4-HA,316,0,0,0,351,351,C
4-HA,317,0,0,351,0,351,G
4-HA,318,0,0,0,359,359,C
4-HA,319,357,0,0,0,357,A
4-HA,320,0,0,357,0,357,G
4-HA,321,0,0,0,359,359,C
4-HA,322,359,0,0,0,359,A
4-HA,323,360,0,0,0,360,A
4-HA,324,359,0,0,0,359,A
4-HA,325,0,0,370,0,370,G
4-HA,326,0,0,0,371,371,C
4-HA,327,0,0,0,368,368,C
4-HA,328,0,365,0,0,365,T
4-HA,329,367,1,0,0,368,A
4-HA,330,0,0,0,373,373,C
4-HA,331,372,0,0,0,372,A
4-HA,332,0,0,370,0,370,G
4-HA,333,0,0,0,371,371,C
4-HA,334,364,0,0,0,364,A
4-HA,335,366,0,0,0,366,A
4-HA,336,0,0,0,374,374,C
4-HA,337,0,376,0,0,376,T
4-HA,338,1,0,375,0,376,G
4-HA,339,0,373,0,0,373,T
4-HA,340,0,370,0,0,370,T
4-HA,341,374,0,0,0,374,A
4-HA,342,0,0,0,393,393,C
4-HA,343,1,0,0,392,393,C
4-HA,344,0,1,0,398,399,C
4-HA,345,0,376,0,0,376,T
4-HA,346,0,376,0,0,376,T
4-HA,347,380,0,0,0,380,A
4-HA,348,0,379,1,0,380,T
4-HA,349,0,0,380,0,380,G
4-HA,350,377,0,0,0,377,A
4-HA,351,0,349,0,0,349,T
4-HA,352,0,0,356,0,356,G
4-HA,353,0,347,0,0,347,T
4-HA,354,0,0,347,0,347,G
4-HA,355,0,0,0,348,348,C
4-HA,356,1,0,0,348,349,C
4-HA,357,0,0,355,0,355,G
4-HA,358,0,0,357,0,357,G
4-HA,359,355,0,0,0,355,A
4-HA,360,0,357,0,0,357,T
4-HA,361,0,348,0,0,348,T
4-HA,362,351,0,0,0,351,A
4-HA,363,0,350,0,0,350,T
4-HA,364,0,0,350,0,350,G
4-HA,365,0,1,0,349,350,C
4-HA,366,0,1,0,348,349,C
4-HA,367,0,348,0,0,348,T
4-HA,368,0,0,0,369,369,C
4-HA,369,0,0,0,372,372,C
4-HA,370,0,0,0,375,375,C
4-HA,371,0,372,0,0,372,T
4-HA,372,0,373,0,0,373,T
4-HA,373,370,0,0,0,370,A
4-HA,374,0,0,381,0,381,G
4-HA,375,0,0,382,0,382,G
4-HA,376,0,377,0,0,377,T
4-HA,377,0,1,0,363,364,C
4-HA,378,360,0,0,0,360,A
4-HA,379,0,0,0,372,372,C
4-HA,380,0,372,0,0,372,T
4-HA,381,372,0,0,0,372,A
4-HA,382,0,0,371,0,371,G
4-HA,383,0,366,0,0,366,T
4-HA,384,0,363,0,0,363,T
4-HA,385,0,0,366,0,366,G
4-HA,386,0,0,0,364,364,C
4-HA,387,0,0,0,363,363,C
4-HA,388,0,354,0,1,355,T
4-HA,389,0,0,0,357,357,C
4-HA,390,362,0,0,0,362,A
4-HA,391,0,363,0,0,363,T
4-HA,392,0,0,0,363,363,C
4-HA,393,0,0,0,363,363,C
4-HA,394,0,0,365,0,365,G
4-HA,395,0,0,369,0,369,G
4-HA,396,0,0,0,369,369,C
4-HA,397,373,0,0,0,373,A
4-HA,398,0,0,0,377,377,C
4-HA,399,369,0,0,0,369,A
4-HA,400,0,0,0,369,369,C
4-HA,401,0,369,0,0,369,T
4-HA,402,0,0,365,0,365,G
4-HA,403,0,0,370,0,370,G
4-HA,404,366,0,0,0,366,A
4-HA,405,0,0,370,0,370,G
4-HA,406,0,364,0,0,364,T
4-HA,407,0,357,0,0,357,T
4-HA,408,0,0,0,358,358,C
4-HA,409,361,0,0,0,361,A
4-HA,410,361,0,0,0,361,A
4-HA,411,0,0,0,360,360,C
4-HA,412,357,0,0,0,357,A
4-HA,413,359,0,0,0,359,A
4-HA,414,0,355,0,0,355,T
4-HA,415,0,0,353,0,353,G
4-HA,416,352,0,0,0,352,A
4-HA,417,352,0,1,0,353,A
4-HA,418,354,0,1,0,355,A
4-HA,419,0,0,354,0,354,G
4-HA,420,0,0,0,357,357,C
4-HA,421,0,356,0,1,357,T
4-HA,422,0,356,0,0,356,T
4-HA,423,0,0,0,355,355,C
4-HA,424,355,0,0,0,355,A
4-HA,425,357,0,0,0,357,A
4-HA,426,0,358,0,0,358,T
4-HA,427,0,355,0,0,355,T
4-HA,428,0,0,349,0,349,G
4-HA,429,0,0,352,0,352,G
4-HA,430,0,1,0,350,351,C
4-HA,431,0,0,0,376,376,C
4-HA,432,0,375,0,2,377,T
4-HA,433,0,0,376,0,376,G
4-HA,434,1,0,378,0,379,G
4-HA,435,377,0,0,0,377,A
4-HA,436,0,0,378,0,378,G
4-HA,437,0,366,0,1,367,T
4-HA,438,0,0,0,353,353,C
4-HA,439,358,0,0,0,358,A
4-HA,440,0,0,0,359,359,C
4-HA,441,0,358,0,0,358,T
4-HA,442,0,0,0,357,357,C
4-HA,443,355,0,0,0,355,A
4-HA,444,356,0,1,0,357,A
4-HA,445,355,0,0,0,355,A
4-HA,446,355,0,0,0,355,A
4-HA,447,0,0,0,356,356,C
4-HA,448,0,0,355,0,355,G
4-HA,449,0,0,366,0,366,G
4-HA,450,369,0,0,0,369,A
4-HA,451,367,0,0,0,367,A
4-HA,452,0,0,0,368,368,C
4-HA,453,367,0,0,0,367,A
4-HA,454,367,0,0,0,367,A
4-HA,455,0,0,372,0,372,G
4-HA,456,0,0,0,369,369,C
4-HA,457,0,366,0,0,366,T
4-HA,458,0,0,0,370,370,C
4-HA,459,0,367,0,0,367,T
4-HA,460,0,0,369,0,369,G
4-HA,461,0,1,0,371,372,C
4-HA,462,0,370,0,0,370,T
4-HA,463,0,375,0,0,375,T
4-HA,464,0,0,385,0,385,G
4-HA,465,0,0,0,385,385,C
4-HA,466,384,0,0,0,384,A
4-HA,467,0,381,0,0,381,T
4-HA,468,381,0,0,0,381,A
4-HA,469,378,0,1,0,379,A
4-HA,470,0,0,381,0,381,G
4-HA,471,0,1,381,0,382,G
4-HA,472,376,0,0,0,376,A
4-HA,473,0,0,371,0,371,G
4-HA,474,368,0,1,0,369,A
4-HA,475,0,375,0,0,375,T
4-HA,476,0,0,0,380,380,C
4-HA,477,0,381,0,1,382,T
4-HA,478,382,0,1,0,383,A
4-HA,479,381,0,0,0,381,A
4-HA,480,0,381,0,0,381,T
4-HA,481,381,0,0,0,381,A
4-HA,482,371,0,0,0,371,A
4-HA,483,0,0,0,372,372,C
4-HA,484,359,0,0,0,359,A
4-HA,485,0,0,361,0,361,G
4-HA,486,0,351,0,0,351,T
4-HA,487,0,356,0,0,356,T
4-HA,488,0,353,0,0,353,T
4-HA,489,0,1,0,363,364,C
4-HA,490,0,364,0,1,365,T
4-HA,491,0,366,0,0,366,T
4-HA,492,0,366,0,1,367,T
4-HA,493,365,0,0,0,365,A
4-HA,494,0,0,365,0,365,G
4-HA,495,0,366,0,0,366,T
4-HA,496,362,0,0,0,362,A
4-HA,497,0,0,362,0,362,G
4-HA,498,350,0,0,0,350,A
4-HA,499,0,350,0,0,350,T
4-HA,500,0,347,0,0,347,T
4-HA,501,0,0,354,0,354,G
4-HA,502,353,0,0,0,353,A
4-HA,503,352,0,0,0,352,A
4-HA,504,0,351,0,0,351,T
4-HA,505,0,347,0,0,347,T
4-HA,506,0,1,345,0,346,G
4-HA,507,0,0,345,1,346,G
4-HA,508,0,347,0,0,347,T
4-HA,509,0,346,0,0,346,T
4-HA,510,0,0,344,0,344,G
4-HA,511,344,0,0,0,344,A
4-HA,512,0,0,0,341,341,C
4-HA,513,0,0,0,342,342,C
4-HA,514,0,0,0,341,341,C
4-HA,515,337,0,0,0,337,A
4-HA,516,0,0,0,342,342,C
4-HA,517,0,342,0,0,342,T
4-HA,518,0,343,0,0,343,T
4-HA,519,342,0,1,0,343,A
4-HA,520,341,1,0,0,342,A
4-HA,521,343,0,0,0,343,A
4-HA,522,345,0,0,0,345,A
4-HA,523,0,352,0,0,352,T
4-HA,524,0,351,0,1,352,T
4-HA,525,0,0,0,352,352,C
4-HA,526,349,0,0,0,349,A
4-HA,527,348,0,1,0,349,A
4-HA,528,349,0,0,0,349,A
4-HA,529,0,349,0,0,349,T
4-HA,530,351,0,0,0,351,A
4-HA,531,0,0,0,351,351,C
4-HA,532,0,0,0,342,342,C
4-HA,533,0,0,0,342,342,C
4-HA,534,340,0,0,0,340,A
4-HA,535,0,0,369,0,369,G
4-HA,536,0,0,0,370,370,C
4-HA,537,371,0,0,0,371,A
4-HA,538,0,371,0,0,371,T
4-HA,539,0,368,0,0,368,T
4-HA,540,370,0,0,0,370,A
4-HA,541,378,0,0,0,378,A
4-HA,542,379,0,0,0,379,A
4-HA,543,0,0,0,381,381,C
4-HA,544,0,0,375,0,375,G
4-HA,545,0,367,0,0,367,T
4-HA,546,0,0,366,0,366,G
4-HA,547,368,0,0,0,368,A
4-HA,548,0,0,0,367,367,C
4-HA,549,0,360,0,1,361,T
4-HA,550,366,0,0,1,367,A
4-HA,551,0,366,0,0,366,T
4-HA,552,0,0,369,0,369,G
4-HA,553,0,0,0,368,368,C
4-HA,554,0,1,0,364,365,C
4-HA,555,363,0,1,0,364,A
4-HA,556,365,0,0,0,365,A
4-HA,557,370,0,0,1,371,A
4-HA,558,0,0,0,371,371,C
4-HA,559,357,0,0,0,357,A
4-HA,560,360,0,0,0,360,A
4-HA,561,0,357,0,0,357,T
4-HA,562,0,0,357,0,357,G
4-HA,563,356,0,1,0,357,A
4-HA,564,356,0,0,0,356,A
4-HA,565,0,0,0,350,350,C
4-HA,566,354,0,0,0,354,A
4-HA,567,355,0,0,0,355,A
4-HA,568,0,356,0,0,356,T
4-HA,569,0,355,0,0,355,T
4-HA,570,0,356,0,0,356,T
4-HA,571,0,0,355,0,355,G
4-HA,572,355,1,0,0,356,A
4-HA,573,0,0,0,355,355,C
4-HA,574,355,0,0,0,355,A
4-HA,575,354,0,0,0,354,A
4-HA,576,361,0,0,0,361,A
4-HA,577,0,362,0,0,362,T
4-HA,578,1,362,0,0,363,T
4-HA,579,0,0,367,0,367,G
4-HA,580,0,366,0,0,366,T
4-HA,581,365,0,1,0,366,A
4-HA,582,0,0,0,375,375,C
4-HA,583,373,0,0,0,373,A
4-HA,584,0,382,0,0,382,T
4-HA,585,0,376,0,0,376,T
4-HA,586,0,376,0,1,377,T
4-HA,587,0,0,376,0,376,G
4-HA,588,0,0,373,0,373,G
4-HA,589,0,0,375,0,375,G
4-HA,590,0,0,375,0,375,G
4-HA,591,0,0,369,0,369,G
4-HA,592,0,0,374,0,374,G
4-HA,593,0,369,0,0,369,T
4-HA,594,1,367,0,0,368,T
4-HA,595,0,0,0,369,369,C
4-HA,596,370,0,0,0,370,A
4-HA,597,0,0,1,370,371,C
4-HA,598,0,0,0,371,371,C
4-HA,599,371,0,0,0,371,A
4-HA,600,0,0,0,375,375,C
4-HA,601,0,0,0,368,368,C
4-HA,602,1,0,0,366,367,C
4-HA,603,0,0,367,0,367,G
4-HA,604,0,0,382,0,382,G
4-HA,605,0,0,384,0,384,G
4-HA,606,0,382,0,0,382,T
4-HA,607,382,0,0,0,382,A
4-HA,608,0,0,0,379,379,C
4-HA,609,0,1,374,0,375,G
4-HA,610,0,0,379,0,379,G
4-HA,611,378,0,0,0,378,A
4-HA,612,0,0,0,380,380,C
4-HA,613,352,0,0,0,352,A
4-HA,614,352,0,0,0,352,A
4-HA,615,0,352,0,0,352,T
4-HA,616,0,0,354,0,354,G
4-HA,617,353,0,0,0,353,A
4-HA,618,0,0,0,353,353,C
4-HA,619,0,0,0,345,345,C
4-HA,620,344,0,1,0,345,A
4-HA,621,345,0,0,0,345,A
4-HA,622,350,0,0,0,350,A
4-HA,623,0,348,0,1,349,T
4-HA,624,0,0,0,351,351,C
4-HA,625,0,343,0,0,343,T
4-HA,626,0,343,0,0,343,T
4-HA,627,0,0,0,344,344,C
4-HA,628,0,0,0,343,343,C
4-HA,629,0,340,0,0,340,T
4-HA,630,0,1,341,0,342,G
4-HA,631,0,336,0,0,336,T
4-HA,632,341,0,0,0,341,A
4-HA,633,0,340,0,0,340,T
4-HA,634,0,0,344,0,344,G
4-HA,635,0,0,0,346,346,C
4-HA,636,0,342,0,0,342,T
4-HA,637,0,0,0,345,345,C
4-HA,638,344,0,0,0,344,A
4-HA,639,345,0,0,0,345,A
4-HA,640,0,0,345,0,345,G
4-HA,641,0,0,0,345,345,C
4-HA,642,345,0,0,0,345,A
4-HA,643,0,343,0,0,343,T
4-HA,644,0,0,0,339,339,C
4-HA,645,340,0,0,0,340,A
4-HA,646,0,0,342,0,342,G
4-HA,647,0,0,343,0,343,G
4-HA,648,341,0,0,0,341,A
4-HA,649,339,0,0,0,339,A
4-HA,650,1,0,335,0,336,G
4-HA,651,338,0,0,0,338,A
4-HA,652,346,0,0,0,346,A
4-HA,653,0,345,0,0,345,T
4-HA,654,0,0,0,345,345,C
4-HA,655,344,0,0,0,344,A
4-HA,656,0,0,0,345,345,C
4-HA,657,344,0,1,0,345,A
4-HA,658,0,0,351,0,351,G
4-HA,659,0,347,0,0,347,T
4-HA,660,0,0,0,351,351,C
4-HA,661,0,345,0,1,346,T
4-HA,662,0,0,0,349,349,C
4-HA,663,0,349,0,0,349,T
4-HA,664,349,0,0,0,349,A
4-HA,665,0,0,0,348,348,C
4-HA,666,0,0,0,348,348,C
4-HA,667,340,0,0,0,340,A
4-HA,668,344,0,0,0,344,A
4-HA,669,341,0,0,0,341,A
4-HA,670,340,0,0,0,340,A
4-HA,671,0,0,338,0,338,G
4-HA,672,329,0,0,0,329,A
4-HA,673,328,0,0,0,328,A
4-HA,674,1,0,328,0,329,G
4-HA,675,0,0,0,329,329,C
4-HA,676,0,0,0,328,328,C
4-HA,677,332,0,0,0,332,A
4-HA,678,335,0,0,0,335,A
4-HA,679,0,1,0,334,335,C
4-HA,680,336,0,0,0,336,A
4-HA,681,336,0,0,0,336,A
4-HA,682,335,0,0,0,335,A
4-HA,683,0,0,0,340,340,C
4-HA,684,0,335,0,0,335,T
4-HA,685,0,0,336,0,336,G
4-HA,686,0,336,0,0,336,T
4-HA,687,334,0,0,0,334,A
4-HA,688,335,0,0,0,335,A
4-HA,689,0,336,0,0,336,T
4-HA,690,0,0,0,335,335,C
4-HA,691,0,0,0,339,339,C
4-HA,692,0,0,0,334,334,C
4-HA,693,0,0,336,0,336,G
4-HA,694,333,0,0,0,333,A
4-HA,695,332,0,1,0,333,A
4-HA,696,0,337,0,1,338,T
4-HA,697,336,0,0,0,336,A
4-HA,698,0,334,0,0,334,T
4-HA,699,0,0,0,330,330,C
4-HA,700,0,0,331,0,331,G
4-HA,701,0,0,338,0,338,G
4-HA,702,338,0,0,0,338,A
4-HA,703,0,341,0,0,341,T
4-HA,704,0,0,0,341,341,C
4-HA,705,0,341,0,0,341,T
4-HA,706,343,0,0,0,343,A
4-HA,707,0,0,345,0,345,G
4-HA,708,346,0,0,0,346,A
4-HA,709,0,0,0,346,346,C
4-HA,710,0,0,0,330,330,C
4-HA,711,0,1,0,331,332,C
4-HA,712,327,0,0,0,327,A
4-HA,713,0,1,352,0,353,G
4-HA,714,353,0,0,0,353,A
4-HA,715,1,0,356,0,357,G
4-HA,716,0,354,0,0,354,T
4-HA,717,352,0,0,0,352,A
4-HA,718,351,0,0,0,351,A
4-HA,719,0,0,355,0,355,G
4-HA,720,1,0,358,0,359,G
4-HA,721,353,0,0,0,353,A
4-HA,722,332,0,0,0,332,A
4-HA,723,0,332,0,0,332,T
4-HA,724,330,0,1,0,331,A
4-HA,725,0,329,0,0,329,T
4-HA,726,0,0,0,337,337,C
4-HA,727,0,0,0,336,336,C
4-HA,728,0,0,0,334,334,C
4-HA,729,0,331,0,0,331,T
4-HA,730,333,0,0,0,333,A
4-HA,731,0,0,333,0,333,G
4-HA,732,0,0,0,334,334,C
4-HA,733,330,0,0,0,330,A
4-HA,734,0,1,340,0,341,G
4-HA,735,339,0,0,0,339,A
4-HA,736,339,0,0,0,339,A
4-HA,737,0,338,0,0,338,T
4-HA,738,339,0,0,0,339,A
4-HA,739,339,0,1,0,340,A
4-HA,740,0,0,339,0,339,G
4-HA,741,0,0,0,339,339,C
4-HA,742,338,0,0,0,338,A
4-HA,743,0,329,0,0,329,T
4-HA,744,0,0,0,348,348,C
4-HA,745,0,346,0,0,346,T
4-HA,746,350,0,0,0,350,A
4-HA,747,0,349,0,0,349,T
4-HA,748,0,347,0,0,347,T
4-HA,749,0,0,345,0,345,G
4-HA,750,0,0,344,0,344,G
4-HA,751,343,0,0,0,343,A
4-HA,752,0,0,0,342,342,C
4-HA,753,318,0,0,0,318,A
4-HA,754,325,0,2,0,327,A
4-HA,755,0,349,0,0,349,T
4-HA,756,358,0,0,0,358,A
4-HA,757,0,0,378,0,378,G
4-HA,758,0,374,0,0,374,T
4-HA,759,376,0,0,0,376,A
4-HA,760,374,0,0,0,374,A
4-HA,761,397,0,0,0,397,A
4-HA,762,406,0,0,0,406,A
4-HA,763,0,1,0,421,422,C
4-HA,764,0,0,0,410,410,C
4-HA,765,0,0,405,2,407,G
4-HA,766,0,0,415,1,416,G
4-HA,767,0,0,434,0,434,G
4-HA,768,435,0,0,0,435,A
4-HA,769,0,0,438,1,439,G
4-HA,770,460,0,0,0,460,A
4-HA,771,0,0,0,460,460,C
4-HA,772,456,0,0,3,459,A
4-HA,773,0,460,0,0,460,T
4-HA,774,466,0,0,0,466,A
4-HA,775,0,0,0,483,483,C
4-HA,776,0,479,1,0,480,T
4-HA,777,0,493,0,0,493,T
4-HA,778,0,499,0,0,499,T
4-HA,779,0,496,0,1,497,T
4-HA,780,0,0,512,0,512,G
4-HA,781,513,0,0,0,513,A
4-HA,782,0,512,0,0,512,T
4-HA,783,0,554,0,0,554,T
4-HA,784,551,0,0,0,551,A
4-HA,785,554,0,0,0,554,A
4-HA,786,2,0,1,571,574,C
4-HA,787,573,0,1,0,574,A
4-HA,788,0,0,632,0,632,G
4-HA,789,0,0,0,631,631,C
4-HA,790,634,0,0,0,634,A
4-HA,791,0,0,0,635,635,C
4-HA,792,632,0,1,0,633,A
4-HA,793,0,0,659,0,659,G
4-HA,794,0,0,657,0,657,G
4-HA,795,1,1,700,0,702,G
4-HA,796,699,0,0,0,699,A
4-HA,797,725,0,1,0,726,A
4-HA,798,0,728,0,1,729,T
4-HA,799,1,0,0,733,734,C
4-HA,800,0,747,0,0,747,T
4-HA,801,748,0,1,0,749,A
4-HA,802,747,0,0,0,747,A
4-HA,803,0,745,0,1,746,T
4-HA,804,0,722,0,0,722,T
4-HA,805,0,0,737,0,737,G
4-HA,806,0,0,0,791,791,C
4-HA,807,0,853,0,0,853,T
4-HA,808,0,0,0,904,904,C
4-HA,809,0,0,0,907,907,C
4-HA,810,0,906,0,0,906,T
4-HA,811,911,0,1,0,912,A
4-HA,812,0,0,913,0,913,G
4-HA,813,0,2,924,0,926,G
4-HA,814,0,0,936,0,936,G
4-HA,815,0,0,935,0,935,G
4-HA,816,0,920,0,0,920,T
4-HA,817,0,912,0,0,912,T
4-HA,818,918,0,1,0,919,A
4-HA,819,0,0,0,946,946,C
4-HA,820,0,943,0,1,944,T
4-HA,821,0,953,0,0,953,T
4-HA,822,0,0,0,950,950,C
4-HA,823,947,0,0,0,947,A
4-HA,824,950,0,0,0,950,A
4-HA,825,955,0,0,0,955,A
4-HA,826,966,0,1,0,967,A
4-HA,827,0,969,0,0,969,T
4-HA,828,964,0,1,0,965,A
4-HA,829,0,0,0,964,964,C
4-HA,830,0,0,964,0,964,G
4-HA,831,971,0,0,0,971,A
4-HA,832,971,0,0,1,972,A
4-HA,833,0,0,998,0,998,G
4-HA,834,0,996,0,0,996,T
4-HA,835,0,0,1006,0,1006,G
4-HA,836,0,0,1009,0,1009,G
4-HA,837,0,0,1012,1,1013,G
4-HA,838,1009,1,0,0,1010,A
4-HA,839,1010,0,0,0,1010,A
4-HA,840,1017,1,0,0,1018,A
4-HA,841,1018,0,2,1,1021,A
4-HA,842,0,0,1041,0,1041,G
4-HA,843,0,0,0,1047,1047,C
4-HA,844,0,1044,0,0,1044,T
4-HA,845,0,0,0,1064,1064,C
4-HA,846,1065,0,0,0,1065,A
4-HA,847,1076,1,1,0,1078,A
4-HA,848,0,1080,0,0,1080,T
4-HA,849,1104,0,0,0,1104,A
4-HA,850,1104,0,0,0,1104,A
4-HA,851,0,1100,0,0,1100,T
4-HA,852,0,0,1106,0,1106,G
4-HA,853,1108,0,0,0,1108,A
4-HA,854,0,0,1174,0,1174,G
4-HA,855,1174,1,0,0,1175,A
4-HA,856,0,1175,0,0,1175,T
4-HA,857,0,1,0,1208,1209,C
4-HA,858,1205,0,1,1,1207,A
4-HA,859,0,0,1260,0,1260,G
4-HA,860,1260,0,0,0,1260,A
4-HA,861,1,1257,0,0,1258,T
4-HA,862,0,0,1257,0,1257,G
4-HA,863,0,0,0,1235,1235,C
4-HA,864,1234,0,4,0,1238,A
4-HA,865,0,0,0,1271,1271,C
4-HA,866,0,0,0,1265,1265,C
4-HA,867,0,0,0,1269,1269,C
4-HA,868,1258,0,0,0,1258,A
4-HA,869,0,1256,0,0,1256,T
4-HA,870,0,1256,0,0,1256,T
4-HA,871,1,0,1279,0,1280,G
4-HA,872,0,0,1282,0,1282,G
4-HA,873,0,0,0,1278,1278,C
4-HA,874,1275,0,0,0,1275,A
4-HA,875,1274,0,0,0,1274,A
4-HA,876,1291,0,0,0,1291,A
4-HA,877,0,1295,0,0,1295,T
4-HA,878,0,0,1300,0,1300,G
4-HA,879,0,0,0,1300,1300,C
4-HA,880,1291,0,0,0,1291,A
4-HA,881,1325,0,0,0,1325,A
4-HA,882,0,1326,0,0,1326,T
4-HA,883,0,1342,0,1,1343,T
4-HA,884,0,0,0,1342,1342,C
4-HA,885,0,1323,0,0,1323,T
4-HA,886,0,0,1347,0,1347,G
4-HA,887,1344,0,0,0,1344,A
4-HA,888,1348,0,1,0,1349,A
4-HA,889,0,1347,0,1,1348,T
4-HA,890,0,0,1335,0,1335,G
4-HA,891,0,1,0,1343,1344,C
4-HA,892,1339,1,0,0,1340,A
4-HA,893,0,1336,0,1,1337,T
4-HA,894,0,0,0,1332,1332,C
4-HA,895,1330,0,1,0,1331,A
4-HA,896,0,0,0,1330,1330,C
4-HA,897,1,0,1319,1,1321,G
4-HA,898,0,1,0,1357,1358,C
4-HA,899,2,0,1,1357,1360,C
4-HA,900,1385,0,0,0,1385,A
4-HA,901,1388,0,0,0,1388,A
4-HA,902,1382,0,1,0,1383,A
4-HA,903,0,1373,0,0,1373,T
4-HA,904,0,0,1394,0,1394,G
4-HA,905,0,1,1398,0,1399,G
4-HA,906,1402,0,0,0,1402,A
4-HA,907,1401,0,0,0,1401,A
4-HA,908,0,0,1416,0,1416,G
4-HA,909,0,0,0,1403,1403,C
4-HA,910,1406,0,0,0,1406,A
4-HA,911,1,1411,0,0,1412,T
4-HA,912,0,1410,0,0,1410,T
4-HA,913,0,0,0,1459,1459,C
4-HA,914,0,0,0,1453,1453,C
4-HA,915,0,0,0,1454,1454,C
4-HA,916,1455,0,0,0,1455,A
4-HA,917,1481,0,0,0,1481,A
4-HA,918,0,1511,0,1,1512,T
4-HA,919,0,1,1509,0,1510,G
4-HA,920,1506,1,2,0,1509,A
4-HA,921,0,0,0,1517,1517,C
4-HA,922,1483,0,0,0,1483,A
4-HA,923,1487,0,0,0,1487,A
4-HA,924,1487,0,0,0,1487,A
4-HA,925,0,0,0,1506,1506,C
4-HA,926,0,1,0,1490,1491,C
4-HA,927,1467,1,1,0,1469,A
4-HA,928,0,1475,0,0,1475,T
4-HA,929,0,1467,0,1,1468,T
4-HA,930,0,0,0,1476,1476,C
4-HA,931,0,1,0,1473,1474,C
4-HA,932,1468,0,1,0,1469,A
4-HA,933,1472,0,0,0,1472,A
4-HA,934,1470,0,0,0,1470,A
4-HA,935,1506,0,0,0,1506,A
4-HA,936,0,1501,0,0,1501,T
4-HA,937,0,0,1512,1,1513,G
4-HA,938,0,1510,0,0,1510,T
4-HA,939,1513,0,0,0,1513,A
4-HA,940,1515,0,2,0,1517,A
4-HA,941,1516,0,1,0,1517,A
4-HA,942,0,0,0,1521,1521,C
4-HA,943,1506,0,0,0,1506,A
4-HA,944,1,0,1541,0,1542,G
4-HA,945,0,1,1548,0,1549,G
4-HA,946,1590,0,1,0,1591,A
4-HA,947,0,1588,0,0,1588,T
4-HA,948,0,1,0,1619,1620,C
4-HA,949,1631,0,0,0,1631,A
4-HA,950,0,1,0,1714,1715,C
4-HA,951,1713,0,1,0,1714,A
4-HA,952,0,1761,0,0,1761,T
4-HA,953,1729,0,0,0,1729,A
4-HA,954,0,0,0,1720,1720,C
4-HA,955,0,0,1682,0,1682,G
4-HA,956,0,1,1688,0,1689,G
4-HA,957,0,0,1677,1,1678,G
4-HA,958,1,0,1686,0,1687,G
4-HA,959,1,0,0,1660,1661,C
4-HA,960,0,0,0,1652,1652,C
4-HA,961,1,1611,0,2,1614,T
4-HA,962,0,0,1794,0,1794,G
4-HA,963,0,1801,0,0,1801,T
4-HA,964,0,1,0,1804,1805,C
4-HA,965,2,0,1,1790,1793,C
4-HA,966,0,0,0,1805,1805,C
4-HA,967,1798,1,1,0,1800,A
4-HA,968,0,0,1812,0,1812,G
4-HA,969,1806,0,0,1,1807,A
4-HA,970,0,1810,0,0,1810,T
4-HA,971,1692,0,1,0,1693,A
4-HA,972,0,1683,0,0,1683,T
4-HA,973,0,0,1698,0,1698,G
4-HA,974,0,1693,0,0,1693,T
4-HA,975,0,1680,0,1,1681,T
4-HA,976,1701,0,1,0,1702,A
4-HA,977,1686,1,0,0,1687,A
4-HA,978,0,6,1696,0,1702,G
4-HA,979,0,1,0,1700,1701,C
4-HA,980,1677,0,3,0,1680,A
4-HA,981,1676,0,0,0,1676,A
4-HA,982,1664,0,1,0,1665,A
4-HA,983,1667,0,0,0,1667,A
4-HA,984,0,0,0,1668,1668,C
4-HA,985,1650,0,0,0,1650,A
4-HA,986,0,0,0,1661,1661,C
4-HA,987,0,1643,0,0,1643,T
4-HA,988,0,0,0,1648,1648,C
4-HA,989,0,1649,0,0,1649,T
4-HA,990,1,0,1654,0,1655,G
4-HA,991,1653,0,0,0,1653,A
4-HA,992,1655,0,0,0,1655,A
4-HA,993,1646,0,0,1,1647,A
4-HA,994,0,1635,0,0,1635,T
4-HA,995,0,1628,0,0,1628,T
4-HA,996,1,1,1644,0,1646,G
4-HA,997,0,0,1645,0,1645,G
4-HA,998,0,0,0,1649,1649,C
4-HA,999,1637,1,1,0,1639,A
4-HA,1000,1638,0,1,0,1639,A
4-HA,1001,0,0,0,1641,1641,C
4-HA,1002,1631,0,2,1,1634,A
4-HA,1003,1,0,1652,0,1653,G
4-HA,1004,0,1,1641,0,1642,G
4-HA,1005,1,0,1638,0,1639,G
4-HA,1006,1634,0,0,0,1634,A
4-HA,1007,0,1631,0,2,1633,T
4-HA,1008,0,0,1640,0,1640,G
4-HA,1009,1,0,0,1635,1636,C
4-HA,1010,0,0,1640,0,1640,G
4-HA,1011,1663,1,0,0,1664,A
4-HA,1012,1644,0,0,1,1645,A
4-HA,1013,1643,0,0,0,1643,A
4-HA,1014,0,1628,0,0,1628,T
4-HA,1015,1,0,1652,0,1653,G
4-HA,1016,1,1651,1,0,1653,T
4-HA,1017,1648,0,1,0,1649,A
4-HA,1018,0,1,1,1646,1648,C
4-HA,1019,0,0,1,1629,1630,C
4-HA,1020,1615,0,0,0,1615,A
4-HA,1021,1,1,1617,0,1619,G
4-HA,1022,1580,1,0,0,1581,A
4-HA,1023,0,0,1598,0,1598,G
4-HA,1024,1560,0,1,0,1561,A
4-HA,1025,1552,0,0,0,1552,A
4-HA,1026,1563,0,0,0,1563,A
4-HA,1027,0,0,0,1559,1559,C
4-HA,1028,1507,0,0,0,1507,A
4-HA,1029,1558,0,1,0,1559,A
4-HA,1030,1553,0,0,0,1553,A
4-HA,1031,0,0,0,1568,1568,C
4-HA,1032,0,1549,0,0,1549,T
4-HA,1033,1511,0,0,0,1511,A
4-HA,1034,1,0,1527,0,1528,G
4-HA,1035,1513,0,0,0,1513,A
4-HA,1036,2,0,1567,0,1569,G
4-HA,1037,1,0,1558,0,1559,G
4-HA,1038,0,1,1,1530,1532,C
4-HA,1039,1528,0,0,0,1528,A
4-HA,1040,0,1539,0,1,1540,T
4-HA,1041,1558,0,1,0,1559,A
4-HA,1042,0,1555,0,0,1555,T
4-HA,1043,0,1546,0,1,1547,T
4-HA,1044,0,1547,0,1,1548,T
4-HA,1045,1,0,1496,0,1497,G
4-HA,1046,0,0,1498,0,1498,G
4-HA,1047,0,2,0,1489,1491,C
4-HA,1048,1,0,1491,0,1492,G
4-HA,1049,0,0,0,1479,1479,C
4-HA,1050,1461,0,0,0,1461,A
4-HA,1051,1484,1,0,0,1485,A
4-HA,1052,0,1482,0,0,1482,T
4-HA,1053,0,0,0,1484,1484,C
4-HA,1054,2,0,1486,0,1488,G
4-HA,1055,0,0,0,1468,1468,C
4-HA,1056,1,0,1476,0,1477,G
4-HA,1057,0,1,1489,0,1490,G
4-HA,1058,1,0,1498,0,1499,G
4-HA,1059,0,1491,1,1,1493,T
4-HA,1060,0,1469,0,0,1469,T
4-HA,1061,0,1468,0,0,1468,T
4-HA,1062,0,0,0,1465,1465,C
4-HA,1063,1469,0,1,0,1470,A
4-HA,1064,1,1473,0,0,1474,T
4-HA,1065,1472,0,1,0,1473,A
4-HA,1066,0,0,1496,0,1496,G
4-HA,1067,1454,0,0,0,1454,A
4-HA,1068,1466,0,0,0,1466,A
4-HA,1069,1466,0,2,0,1468,A
4-HA,1070,1487,0,1,0,1488,A
4-HA,1071,0,1493,0,0,1493,T
4-HA,1072,0,0,1529,0,1529,G
4-HA,1073,1,0,1544,0,1545,G
4-HA,1074,2,1528,0,0,1530,T
4-HA,1075,0,1508,0,0,1508,T
4-HA,1076,0,0,1517,0,1517,G
4-HA,1077,0,1,1574,0,1575,G
4-HA,1078,2,0,1598,0,1600,G
4-HA,1079,1600,0,2,1,1603,A
4-HA,1080,0,0,1640,0,1640,G
4-HA,1081,1,3,1648,0,1652,G
4-HA,1082,1,0,1857,0,1858,G
4-HA,1083,1851,0,0,0,1851,A
4-HA,1084,1890,0,2,0,1892,A
4-HA,1085,1,1893,0,1,1895,T
4-HA,1086,0,1,1910,0,1911,G
4-HA,1087,1,0,1947,0,1948,G
4-HA,1088,0,1931,1,2,1934,T
4-HA,1089,2,1,1939,0,1942,G
4-HA,1090,0,1,1932,0,1933,G
4-HA,1091,1909,1,1,0,1911,A
4-HA,1092,1,1916,0,0,1917,T
4-HA,1093,1,0,1974,0,1975,G
4-HA,1094,0,1,2014,0,2015,G
4-HA,1095,0,2004,0,1,2005,T
4-HA,1096,1,1967,0,0,1968,T
4-HA,1097,1,0,1974,0,1975,G
4-HA,1098,0,0,2019,0,2019,G
4-HA,1099,0,2012,0,0,2012,T
4-HA,1100,2013,0,0,0,2013,A
4-HA,1101,0,0,0,1939,1939,C
4-HA,1102,1,1,1956,1,1959,G
4-HA,1103,1,1,2039,0,2041,G
4-HA,1104,1,2036,0,1,2038,T
4-HA,1105,1,2035,0,1,2037,T
4-HA,1106,0,2034,0,1,2035,T
4-HA,1107,0,0,0,2011,2011,C
4-HA,1108,2014,0,1,0,2015,A
4-HA,1109,1,0,2013,0,2014,G
4-HA,1110,0,1,2012,0,2013,G
4-HA,1111,0,0,0,2016,2016,C
4-HA,1112,1973,0,0,0,1973,A
4-HA,1113,1,1986,0,2,1989,T
4-HA,1114,0,0,0,2003,2003,C
4-HA,1115,2004,0,0,1,2005,A
4-HA,1116,2002,0,0,0,2002,A
4-HA,1117,2001,0,0,1,2002,A
4-HA,1118,2015,0,0,1,2016,A
4-HA,1119,0,2021,0,1,2022,T
4-HA,1120,0,2017,0,1,2018,T
4-HA,1121,0,0,0,2020,2020,C
4-HA,1122,1,2012,0,1,2014,T
4-HA,1123,0,1,2021,0,2022,G
4-HA,1124,2010,0,1,0,2011,A
4-HA,1125,0,4,2025,0,2029,G
4-HA,1126,1,1,2028,0,2030,G
4-HA,1127,1,0,2054,0,2055,G
4-HA,1128,2047,0,0,0,2047,A
4-HA,1129,2050,0,1,0,2051,A
4-HA,1130,1,0,2042,0,2043,G
4-HA,1131,2077,0,1,0,2078,A
4-HA,1132,1,0,2100,0,2101,G
4-HA,1133,1,0,2101,2,2104,G
4-HA,1134,2107,0,5,0,2112,A
4-HA,1135,0,1,0,2107,2108,C
4-HA,1136,2095,1,0,0,2096,A
4-HA,1137,2098,0,0,0,2098,A
4-HA,1138,0,0,2099,0,2099,G
4-HA,1139,0,1,0,2109,2110,C
4-HA,1140,2095,0,3,0,2098,A
4-HA,1141,0,0,2161,0,2161,G
4-HA,1142,0,0,0,2160,2160,C
4-HA,1143,2155,0,1,0,2156,A
4-HA,1144,0,2,2184,0,2186,G
4-HA,1145,2163,0,0,0,2163,A
4-HA,1146,1,2241,0,0,2242,T
4-HA,1147,0,0,0,2244,2244,C
4-HA,1148,0,2227,0,7,2234,T
4-HA,1149,0,0,0,2266,2266,C
4-HA,1150,2259,0,1,0,2260,A
4-HA,1151,2262,1,0,0,2263,A
4-HA,1152,2260,0,0,0,2260,A
4-HA,1153,2220,0,2,0,2222,A
4-HA,1154,0,0,2232,0,2232,G
4-HA,1155,1,0,0,2208,2209,C
4-HA,1156,2206,0,0,0,2206,A
4-HA,1157,0,0,0,2263,2263,C
4-HA,1158,0,2252,0,3,2255,T
4-HA,1159,0,1,0,2257,2258,C
4-HA,1160,2254,0,0,0,2254,A
4-HA,1161,2315,1,0,1,2317,A
4-HA,1162,0,0,2317,0,2317,G
4-HA,1163,0,0,0,2310,2310,C
4-HA,1164,2298,0,3,0,2301,A
4-HA,1165,0,1,2314,0,2315,G
4-HA,1166,0,0,0,2277,2277,C
4-HA,1167,2270,0,1,0,2271,A
4-HA,1168,2263,0,0,0,2263,A
4-HA,1169,0,2270,0,0,2270,T
4-HA,1170,0,1,1,2229,2231,C
4-HA,1171,0,1,2238,0,2239,G
4-HA,1172,2238,1,0,0,2239,A
4-HA,1173,1,2231,0,1,2233,T
4-HA,1174,0,0,0,2227,2227,C
4-HA,1175,2223,0,0,0,2223,A
4-HA,1176,2276,0,1,0,2277,A
4-HA,1177,2277,0,1,0,2278,A
4-HA,1178,0,2276,0,0,2276,T
4-HA,1179,0,0,0,2287,2287,C
4-HA,1180,2262,0,0,0,2262,A
4-HA,1181,2273,0,1,0,2274,A
4-HA,1182,0,2278,0,1,2279,T
4-HA,1183,2,1,2283,0,2286,G
4-HA,1184,0,0,2275,0,2275,G
4-HA,1185,0,0,2255,0,2255,G
4-HA,1186,2258,1,2,0,2261,A
4-HA,1187,2264,0,1,0,2265,A
4-HA,1188,0,1,2301,0,2302,G
4-HA,1189,0,0,0,2303,2303,C
4-HA,1190,0,2299,0,2,2301,T
4-HA,1191,0,0,2396,2,2398,G
4-HA,1192,2396,0,1,1,2398,A
4-HA,1193,2395,1,1,0,2397,A
4-HA,1194,0,2393,0,0,2393,T
4-HA,1195,2360,0,0,0,2360,A
4-HA,1196,0,0,2359,1,2360,G
4-HA,1197,2227,0,1,0,2228,A
4-HA,1198,0,2239,0,0,2239,T
4-HA,1199,1,2234,0,0,2235,T
4-HA,1200,0,0,2241,0,2241,G
4-HA,1201,2248,1,0,0,2249,A
4-HA,1202,0,2237,0,0,2237,T
4-HA,1203,2,1,1,2242,2246,C
4-HA,1204,3,0,2251,0,2254,G
4-HA,1205,3,0,2252,0,2255,G
4-HA,1206,1,0,2255,0,2256,G
4-HA,1207,2254,0,0,0,2254,A
4-HA,1208,2249,0,0,0,2249,A
4-HA,1209,2250,0,0,0,2250,A
4-HA,1210,2250,0,2,1,2253,A
4-HA,1211,0,0,0,2263,2263,C
4-HA,1212,1,1,1,2259,2262,C
4-HA,1213,2252,1,2,0,2255,A
4-HA,1214,2256,0,0,0,2256,A
4-HA,1215,0,0,0,2258,2258,C
4-HA,1216,1,0,2259,0,2260,G
4-HA,1217,2263,1,0,1,2265,A
4-HA,1218,1,0,2259,0,2260,G
4-HA,1219,2257,0,1,0,2258,A
4-HA,1220,2261,0,0,0,2261,A
4-HA,1221,2259,0,1,0,2260,A
4-HA,1222,0,2271,0,1,2272,T
4-HA,1223,0,2265,0,0,2265,T
4-HA,1224,1,0,0,2268,2269,C
4-HA,1225,0,0,0,2265,2265,C
4-HA,1226,2271,0,0,1,2272,A
4-HA,1227,0,2266,0,1,2267,T
4-HA,1228,0,0,0,2270,2270,C
4-HA,1229,2258,0,2,2,2262,A
4-HA,1230,0,0,2288,0,2288,G
4-HA,1231,2278,0,0,0,2278,A
4-HA,1232,0,2281,0,1,2282,T
4-HA,1233,0,2261,0,2,2263,T
4-HA,1234,0,0,2289,0,2289,G
4-HA,1235,2291,0,0,0,2291,A
4-HA,1236,2293,0,0,0,2293,A
4-HA,1237,2292,0,0,1,2293,A
4-HA,1238,2294,0,0,0,2294,A
4-HA,1239,2258,0,1,0,2259,A
4-HA,1240,0,0,2264,0,2264,G
4-HA,1241,2267,0,0,0,2267,A
4-HA,1242,2277,0,1,0,2278,A
4-HA,1243,0,2261,1,0,2262,T
4-HA,1244,0,2264,0,0,2264,T
4-HA,1245,0,0,0,2275,2275,C
4-HA,1246,0,2276,0,0,2276,T
4-HA,1247,1,0,0,2270,2271,C
4-HA,1248,2272,0,0,0,2272,A
4-HA,1249,0,1,2274,0,2275,G
4-HA,1250,2274,0,0,0,2274,A
4-HA,1251,2264,0,0,0,2264,A
4-HA,1252,0,0,2287,0,2287,G
4-HA,1253,0,2271,0,0,2271,T
4-HA,1254,1,1,0,2276,2278,C
4-HA,1255,0,0,2281,1,2282,G
4-HA,1256,2280,3,1,0,2284,A
4-HA,1257,2279,1,2,0,2282,A
4-HA,1258,0,0,2280,0,2280,G
4-HA,1259,0,0,2291,0,2291,G
4-HA,1260,1,0,2292,0,2293,G
4-HA,1261,2269,0,4,0,2273,A
4-HA,1262,1,0,2286,0,2287,G
4-HA,1263,2285,0,1,0,2286,A
4-HA,1264,2447,0,0,0,2447,A
4-HA,1265,2,2456,0,1,2459,T
4-HA,1266,0,2454,0,0,2454,T
4-HA,1267,0,2,1,2453,2456,C
4-HA,1268,2437,1,0,0,2438,A
4-HA,1269,0,0,2442,0,2442,G
4-HA,1270,0,0,2445,0,2445,G
4-HA,1271,2441,0,0,0,2441,A
4-HA,1272,0,0,0,2450,2450,C
4-HA,1273,0,0,0,2329,2329,C
4-HA,1274,1,2321,0,2,2324,T
4-HA,1275,0,2317,0,19,2336,T
4-HA,1276,0,0,2358,0,2358,G
4-HA,1277,2352,0,2,1,2355,A
4-HA,1278,0,0,2430,0,2430,G
4-HA,1279,2427,1,0,0,2428,A
4-HA,1280,2418,0,0,0,2418,A
4-HA,1281,2417,1,1,0,2419,A
4-HA,1282,0,2395,0,0,2395,T
4-HA,1283,2514,1,0,0,2515,A
4-HA,1284,0,2519,1,0,2520,T
4-HA,1285,1,0,2547,0,2548,G
4-HA,1286,0,2546,0,4,2550,T
4-HA,1287,0,2495,0,0,2495,T
4-HA,1288,0,2,2507,1,2510,G
4-HA,1289,2487,1,3,0,2491,A
4-HA,1290,0,1,2509,0,2510,G
4-HA,1291,0,2,2500,1,2503,G
4-HA,1292,2459,1,5,0,2465,A
4-HA,1293,0,0,0,2513,2513,C
4-HA,1294,2492,0,0,0,2492,A
4-HA,1295,0,0,0,2534,2534,C
4-HA,1296,0,0,0,2537,2537,C
4-HA,1297,2540,0,1,1,2542,A
4-HA,1298,2592,0,1,0,2593,A
4-HA,1299,2589,0,1,0,2590,A
4-HA,1300,2614,2,0,0,2616,A
4-HA,1301,0,2616,1,1,2618,T
4-HA,1302,2571,0,1,0,2572,A
4-HA,1303,0,1,2575,1,2577,G
4-HA,1304,2540,0,1,0,2541,A
4-HA,1305,1,2575,0,0,2576,T
4-HA,1306,0,0,0,2578,2578,C
4-HA,1307,0,2541,0,1,2542,T
4-HA,1308,0,0,0,2603,2603,C
4-HA,1309,0,2596,0,3,2599,T
4-HA,1310,2,2,2678,0,2682,G
4-HA,1311,0,0,2751,1,2752,G
4-HA,1312,0,2745,0,1,2746,T
4-HA,1313,0,0,0,2746,2746,C
4-HA,1314,2063,0,698,0,2761,A
4-HA,1315,0,2774,0,0,2774,T
4-HA,1316,2773,1,1,0,2775,A
4-HA,1317,0,1,1,2762,2764,C
4-HA,1318,2693,0,0,0,2693,A
4-HA,1319,2714,0,2,0,2716,A
4-HA,1320,0,1,0,2626,2627,C
4-HA,1321,1,0,2620,0,2621,G
4-HA,1322,0,1,0,2624,2625,C
4-HA,1323,4,2,2594,0,2600,G
4-HA,1324,0,3,2603,0,2606,G
4-HA,1325,2602,0,0,0,2602,A
4-HA,1326,0,0,2638,0,2638,G
4-HA,1327,0,0,0,2636,2636,C
4-HA,1328,0,2628,0,3,2631,T
4-HA,1329,0,2653,0,0,2653,T
4-HA,1330,0,0,0,2653,2653,C
4-HA,1331,0,2668,0,1,2669,T
4-HA,1332,0,2672,0,0,2672,T
4-HA,1333,0,0,2666,0,2666,G
4-HA,1334,1,2651,0,4,2656,T
4-HA,1335,0,2603,0,4,2607,T
4-HA,1336,1,0,2671,0,2672,G
4-HA,1337,0,0,0,2662,2662,C
4-HA,1338,1,1,0,2655,2657,C
4-HA,1339,1,1,0,2672,2674,C
4-HA,1340,0,2666,0,2,2668,T
4-HA,1341,0,0,2700,0,2700,G
4-HA,1342,0,0,2707,0,2707,G
4-HA,1343,2702,0,1,0,2703,A
4-HA,1344,0,0,2717,0,2717,G
4-HA,1345,2657,0,2,0,2659,A
4-HA,1346,2667,1,0,0,2668,A
4-HA,1347,0,0,0,2701,2701,C
4-HA,1348,1,0,0,2700,2701,C
4-HA,1349,2703,0,2,0,2705,A
4-HA,1350,2810,1,0,0,2811,A
4-HA,1351,0,0,0,2839,2839,C
4-HA,1352,2853,0,0,0,2853,A
4-HA,1353,0,2856,0,0,2856,T
4-HA,1354,2846,0,0,0,2846,A
4-HA,1355,0,1,0,2887,2888,C
4-HA,1356,2828,0,2,0,2830,A
4-HA,1357,2828,0,1,0,2829,A
4-HA,1358,0,2820,0,2,2822,T
4-HA,1359,0,2718,0,1,2719,T
4-HA,1360,0,0,2752,0,2752,G
4-HA,1361,2762,0,1,0,2763,A
4-HA,1362,0,2750,1,1,2752,T
4-HA,1363,0,0,0,2766,2766,C
4-HA,1364,0,2716,0,1,2717,T
4-HA,1365,2741,0,0,0,2741,A
4-HA,1366,2741,2,0,0,2743,A
4-HA,1367,0,0,0,2742,2742,C
4-HA,1368,0,2710,2,0,2712,T
4-HA,1369,0,0,2691,0,2691,G
4-HA,1370,2683,1,4,0,2688,A
4-HA,1371,0,0,0,2689,2689,C
4-HA,1372,0,2684,1,1,2686,T
4-HA,1373,0,0,0,2689,2689,C
4-HA,1374,2679,0,1,0,2680,A
4-HA,1375,1,0,2721,0,2722,G
4-HA,1376,2718,1,0,0,2719,A
4-HA,1377,2718,1,3,0,2722,A
4-HA,1378,2716,0,1,0,2717,A
4-HA,1379,0,2700,0,1,2701,T
4-HA,1380,0,1,2720,0,2721,G
4-HA,1381,2728,0,0,0,2728,A
4-HA,1382,2724,1,1,0,2726,A
4-HA,1383,0,0,0,2725,2725,C
4-HA,1384,2682,2,0,1,2685,A
4-HA,1385,2686,0,1,0,2687,A
4-HA,1386,2682,0,0,0,2682,A
4-HA,1387,0,0,0,2695,2695,C
4-HA,1388,0,2679,0,0,2679,T
4-HA,1389,0,1,2679,0,2680,G
4-HA,1390,0,2649,0,4,2653,T
4-HA,1391,1,2656,0,1,2658,T
4-HA,1392,0,2657,0,3,2660,T
4-HA,1393,0,1,2660,1,2662,G
4-HA,1394,2656,1,1,0,2658,A
4-HA,1395,2659,0,0,1,2660,A
4-HA,1396,2649,0,0,1,2650,A
4-HA,1397,2647,0,0,0,2647,A
4-HA,1398,2634,0,2,0,2636,A
4-HA,1399,2646,1,1,0,2648,A
4-HA,1400,1,0,0,2655,2656,C
4-HA,1401,2653,0,2,0,2655,A
4-HA,1402,2658,0,0,0,2658,A
4-HA,1403,2658,1,0,0,2659,A
4-HA,1404,1,0,2666,0,2667,G
4-HA,1405,2674,0,1,0,2675,A
4-HA,1406,2664,0,2,0,2666,A
4-HA,1407,0,0,2664,0,2664,G
4-HA,1408,0,0,0,2658,2658,C
4-HA,1409,2665,0,0,0,2665,A
4-HA,1410,2679,0,1,1,2681,A
4-HA,1411,0,0,1,2676,2677,C
4-HA,1412,0,2665,0,1,2666,T
4-HA,1413,1,1,2678,0,2680,G
4-HA,1414,2663,0,1,1,2665,A
4-HA,1415,0,0,2692,0,2692,G
4-HA,1416,0,0,2696,1,2697,G
4-HA,1417,2,1,2688,1,2692,G
4-HA,1418,2681,0,2,0,2683,A
4-HA,1419,2673,0,0,0,2673,A
4-HA,1420,2669,0,1,0,2670,A
4-HA,1421,2687,3,2,0,2692,A
4-HA,1422,0,2686,0,0,2686,T
4-HA,1423,1,0,2694,0,2695,G
4-HA,1424,0,0,0,2692,2692,C
4-HA,1425,0,2658,0,2,2660,T
4-HA,1426,2,1,2661,0,2664,G
4-HA,1427,2659,0,2,0,2661,A
4-HA,1428,1,0,2796,0,2797,G
4-HA,1429,0,1,2818,0,2819,G
4-HA,1430,2783,0,1,0,2784,A
4-HA,1431,0,2776,0,0,2776,T
4-HA,1432,2763,0,1,0,2764,A
4-HA,1433,1,2749,0,0,2750,T
4-HA,1434,2,0,2768,1,2771,G
4-HA,1435,0,0,2785,0,2785,G
4-HA,1436,0,0,2786,0,2786,G
4-HA,1437,0,1,1,2629,2631,C
4-HA,1438,2581,1,1,0,2583,A
4-HA,1439,2582,0,0,0,2582,A
4-HA,1440,0,2584,0,1,2585,T
4-HA,1441,2,0,2594,0,2596,G
4-HA,1442,0,0,2596,0,2596,G
4-HA,1443,1,2563,0,1,2565,T
4-HA,1444,1,2484,0,0,2485,T
4-HA,1445,0,0,2490,0,2490,G
4-HA,1446,0,2514,0,0,2514,T
4-HA,1447,0,2505,0,2,2507,T
4-HA,1448,2,2512,0,1,2515,T
4-HA,1449,0,1,0,2510,2511,C
4-HA,1450,2493,0,0,0,2493,A
4-HA,1451,2499,1,1,0,2501,A
4-HA,1452,2502,0,0,0,2502,A
4-HA,1453,2512,0,0,0,2512,A
4-HA,1454,1,2506,0,0,2507,T
4-HA,1455,2469,0,1,0,2470,A
4-HA,1456,0,2480,0,0,2480,T
4-HA,1457,2476,0,1,0,2477,A
4-HA,1458,0,0,1,2496,2497,C
4-HA,1459,0,1,0,2489,2490,C
4-HA,1460,2488,0,2,0,2490,A
4-HA,1461,0,2,0,2495,2497,C
4-HA,1462,2485,0,1,0,2486,A
4-HA,1463,2492,0,0,0,2492,A
4-HA,1464,2488,0,1,1,2490,A
4-HA,1465,0,2490,0,0,2490,T
4-HA,1466,0,0,2498,0,2498,G
4-HA,1467,1,2464,0,1,2466,T
4-HA,1468,0,0,2474,0,2474,G
4-HA,1469,2480,2,1,0,2483,A
4-HA,1470,0,1,0,2475,2476,C
4-HA,1471,2450,0,0,0,2450,A
4-HA,1472,2440,0,1,0,2441,A
4-HA,1473,0,2479,0,0,2479,T
4-HA,1474,2,0,2502,0,2504,G
4-HA,1475,0,0,0,2489,2489,C
4-HA,1476,0,0,0,2491,2491,C
4-HA,1477,0,2477,0,2,2479,T
4-HA,1478,0,1,2568,1,2570,G
4-HA,1479,0,0,0,2565,2565,C
4-HA,1480,2569,1,1,1,2572,A
4-HA,1481,2,2566,0,1,2569,T
4-HA,1482,2463,0,0,0,2463,A
4-HA,1483,0,0,2463,0,2463,G
4-HA,1484,1,0,2452,0,2453,G
4-HA,1485,2444,1,1,1,2447,A
4-HA,1486,1,2441,0,1,2443,T
4-HA,1487,0,0,0,2302,2302,C
4-HA,1488,2308,0,1,0,2309,A
4-HA,1489,2309,1,2,0,2312,A
4-HA,1490,0,2312,0,1,2313,T
4-HA,1491,0,0,0,2315,2315,C
4-HA,1492,2270,1,1,0,2272,A
4-HA,1493,2,1,2278,0,2281,G
4-HA,1494,2280,1,0,0,2281,A
4-HA,1495,2282,0,1,0,2283,A
4-HA,1496,2282,0,0,0,2282,A
4-HA,1497,0,2274,0,0,2274,T
4-HA,1498,1,0,2265,0,2266,G
4-HA,1499,2,0,2270,0,2272,G
4-HA,1500,2272,0,0,0,2272,A
4-HA,1501,2284,0,1,0,2285,A
4-HA,1502,0,0,0,2265,2265,C
4-HA,1503,0,2251,0,0,2251,T
4-HA,1504,0,2257,0,0,2257,T
4-HA,1505,2256,0,1,0,2257,A
4-HA,1506,0,2260,0,0,2260,T
4-HA,1507,0,1,2257,0,2258,G
4-HA,1508,2237,0,18,0,2255,A
4-HA,1509,0,0,0,2255,2255,C
4-HA,1510,1,0,0,2230,2231,C
4-HA,1511,2222,0,0,0,2222,A
4-HA,1512,0,0,0,2263,2263,C
4-HA,1513,1,0,2306,0,2307,G
4-HA,1514,2350,1,0,0,2351,A
4-HA,1515,0,2377,0,1,2378,T
4-HA,1516,0,1,2444,0,2445,G
4-HA,1517,0,2429,0,2,2431,T
4-HA,1518,2494,0,2,0,2496,A
4-HA,1519,0,2495,0,0,2495,T
4-HA,1520,2486,0,1,0,2487,A
4-HA,1521,0,2,0,2479,2481,C
4-HA,1522,2164,0,12,0,2176,A
4-HA,1523,0,0,2194,0,2194,G
4-HA,1524,2050,0,0,0,2050,A
4-HA,1525,0,0,1970,0,1970,G
4-HA,1526,1958,1,0,0,1959,A
4-HA,1527,0,1782,0,0,1782,T
4-HA,1528,0,0,1777,0,1777,G
4-HA,1529,1773,0,1,1,1775,A
4-HA,1530,1769,0,0,0,1769,A
4-HA,1531,0,0,1828,0,1828,G
4-HA,1532,1,0,0,1788,1789,C
4-HA,1533,1779,1,0,0,1780,A
4-HA,1534,0,1771,1,0,1772,T
4-HA,1535,0,1771,0,0,1771,T
4-HA,1536,1777,1,0,0,1778,A
4-HA,1537,1778,0,0,0,1778,A
4-HA,1538,1776,0,0,0,1776,A
4-HA,1539,0,0,0,1775,1775,C
4-HA,1540,1710,0,1,0,1711,A
4-HA,1541,1704,0,6,0,1710,A
4-HA,1542,0,0,0,1707,1707,C
4-HA,1543,1,0,0,1698,1699,C
4-HA,1544,0,0,1697,0,1697,G
4-HA,1545,0,0,1725,0,1725,G
4-HA,1546,0,1727,0,1,1728,T
4-HA,1547,0,1724,0,1,1725,T
4-HA,1548,0,0,0,1723,1723,C
4-HA,1549,0,0,0,1725,1725,C
4-HA,1550,1719,0,0,0,1719,A
4-HA,1551,0,0,1740,0,1740,G
4-HA,1552,1734,0,1,0,1735,A
4-HA,1553,1,1732,0,0,1733,T
4-HA,1554,0,0,0,1659,1659,C
4-HA,1555,1641,0,1,0,1642,A
4-HA,1556,1643,1,1,0,1645,A
4-HA,1557,1,0,1640,0,1641,G
4-HA,1558,0,0,1636,0,1636,G
4-HA,1559,0,0,1635,0,1635,G
4-HA,1560,1567,1,3,0,1571,A
4-HA,1561,0,0,1578,0,1578,G
4-HA,1562,0,1578,0,1,1579,T
4-HA,1563,1,1578,0,0,1579,T
4-HA,1564,0,0,1593,1,1594,G
4-HA,1565,1583,0,1,0,1584,A
4-HA,1566,0,0,1593,0,1593,G
4-HA,1567,0,0,0,1595,1595,C
4-HA,1568,1,1577,0,1,1579,T
4-HA,1569,0,0,1584,0,1584,G
4-HA,1570,1568,0,1,0,1569,A
4-HA,1571,1574,0,2,1,1577,A
4-HA,1572,0,0,1580,0,1580,G
4-HA,1573,0,1534,0,1,1535,T
4-HA,1574,0,0,0,1533,1533,C
4-HA,1575,1508,0,1,0,1509,A
4-HA,1576,0,0,1507,0,1507,G
4-HA,1577,0,0,1506,0,1506,G
4-HA,1578,1,0,1473,0,1474,G
4-HA,1579,0,1521,0,1,1522,T
4-HA,1580,1523,0,1,0,1524,A
4-HA,1581,0,0,0,1519,1519,C
4-HA,1582,1514,0,0,0,1514,A
4-HA,1583,1516,0,0,0,1516,A
4-HA,1584,1511,1,1,0,1513,A
4-HA,1585,0,1,1516,0,1517,G
4-HA,1586,1458,0,0,0,1458,A
4-HA,1587,0,1412,0,0,1412,T
4-HA,1588,0,1391,0,1,1392,T
4-HA,1589,0,0,1380,0,1380,G
4-HA,1590,1,1,1385,0,1387,G
4-HA,1591,1384,0,0,0,1384,A
4-HA,1592,2,1392,1,0,1395,T
4-HA,1593,0,0,0,1379,1379,C
4-HA,1594,0,0,0,1361,1361,C
4-HA,1595,0,1348,0,0,1348,T
4-HA,1596,1351,0,0,0,1351,A
4-HA,1597,1,1350,0,1,1352,T
4-HA,1598,1,0,1351,0,1352,G
4-HA,1599,0,0,1348,0,1348,G
4-HA,1600,1317,0,0,0,1317,A
4-HA,1601,0,1307,0,0,1307,T
4-HA,1602,1,1300,0,0,1301,T
4-HA,1603,0,1285,0,1,1286,T
4-HA,1604,0,0,0,1288,1288,C
4-HA,1605,0,0,0,1287,1287,C
4-HA,1606,0,1275,0,1,1276,T
4-HA,1607,0,1267,0,0,1267,T
4-HA,1608,0,1256,0,1,1257,T
4-HA,1609,0,1,1260,0,1261,G
4-HA,1610,0,0,0,1264,1264,C
4-HA,1611,0,0,0,1263,1263,C
4-HA,1612,1252,0,1,0,1253,A
4-HA,1613,1,1246,0,0,1247,T
4-HA,1614,1255,0,0,0,1255,A
4-HA,1615,0,1255,0,0,1255,T
4-HA,1616,1,0,0,1250,1251,C
4-HA,1617,1250,0,0,0,1250,A
4-HA,1618,0,1218,0,0,1218,T
4-HA,1619,1,0,1219,0,1220,G
4-HA,1620,1,1210,0,2,1213,T
4-HA,1621,0,1196,0,1,1197,T
4-HA,1622,0,1196,0,0,1196,T
4-HA,1623,0,1162,0,1,1163,T
4-HA,1624,0,1163,0,0,1163,T
4-HA,1625,0,1159,0,2,1161,T
4-HA,1626,0,0,1165,0,1165,G
4-HA,1627,0,0,0,1159,1159,C
4-HA,1628,0,1132,0,3,1135,T
4-HA,1629,0,1136,0,0,1136,T
4-HA,1630,0,1130,0,0,1130,T
4-HA,1631,0,1,1144,0,1145,G
4-HA,1632,0,1144,0,0,1144,T
4-HA,1633,0,0,1145,0,1145,G
4-HA,1634,0,1142,0,1,1143,T
4-HA,1635,1,1112,0,1,1114,T
4-HA,1636,0,0,1115,0,1115,G
4-HA,1637,0,0,0,1117,1117,C
4-HA,1638,0,1108,0,1,1109,T
4-HA,1639,1,1106,0,1,1108,T
4-HA,1640,0,1033,0,0,1033,T
4-HA,1641,0,1,1041,0,1042,G
4-HA,1642,0,1043,0,0,1043,T
4-HA,1643,1,1033,0,0,1034,T
4-HA,1644,0,0,1038,0,1038,G
4-HA,1645,0,0,1008,0,1008,G
4-HA,1646,0,0,1008,0,1008,G
4-HA,1647,0,0,1011,0,1011,G
4-HA,1648,0,970,0,0,970,T
4-HA,1649,0,963,0,0,963,T
4-HA,1650,1,0,0,935,936,C
4-HA,1651,934,0,0,0,934,A
4-HA,1652,1,936,0,0,937,T
4-HA,1653,0,0,0,930,930,C
4-HA,1654,924,0,0,0,924,A
4-HA,1655,0,901,0,0,901,T
4-HA,1656,0,0,893,0,893,G
4-HA,1657,0,872,0,0,872,T
4-HA,1658,0,0,860,0,860,G
4-HA,1659,0,0,829,0,829,G
4-HA,1660,0,0,827,0,827,G
4-HA,1661,0,0,0,810,810,C
4-HA,1662,0,0,0,780,780,C
4-HA,1663,0,715,0,0,715,T
4-HA,1664,1,0,716,0,717,G
4-HA,1665,0,1,0,710,711,C
4-HA,1666,0,0,0,717,717,C
4-HA,1667,708,0,0,0,708,A
4-HA,1668,703,0,0,0,703,A
4-HA,1669,702,0,0,0,702,A
4-HA,1670,703,0,1,0,704,A
4-HA,1671,699,0,4,0,703,A
4-HA,1672,0,0,700,0,700,G
4-HA,1673,0,1,676,0,677,G
4-HA,1674,0,0,0,669,669,C
4-HA,1675,670,0,0,0,670,A
4-HA,1676,669,0,1,0,670,A
4-HA,1677,1,0,0,669,670,C
4-HA,1678,669,0,0,0,669,A
4-HA,1679,0,668,0,0,668,T
4-HA,1680,0,657,0,0,657,T
4-HA,1681,636,0,1,0,637,A
4-HA,1682,1,0,628,0,629,G
4-HA,1683,0,0,629,0,629,G
4-HA,1684,0,606,0,1,607,T
4-HA,1685,1,0,543,0,544,G
4-HA,1686,0,0,0,524,524,C
4-HA,1687,519,0,0,0,519,A
4-HA,1688,518,0,0,0,518,A
4-HA,1689,0,1,0,518,519,C
4-HA,1690,502,0,0,0,502,A
4-HA,1691,1,490,0,0,491,T
4-HA,1692,0,458,0,0,458,T
4-HA,1693,0,459,0,0,459,T
4-HA,1694,0,0,457,0,457,G
4-HA,1695,1,0,0,453,454,C
4-HA,1696,453,0,0,0,453,A
4-HA,1697,0,420,0,0,420,T
4-HA,1698,0,407,0,0,407,T
4-HA,1699,0,395,0,0,395,T
4-HA,1700,0,0,394,0,394,G
4-HA,1701,369,0,0,0,369,A
5-NP,1,87,0,0,0,87,A
5-NP,2,0,88,0,0,88,T
5-NP,3,0,0,88,0,88,G
5-NP,4,0,0,88,0,88,G
5-NP,5,0,0,0,88,88,C
5-NP,6,0,1,91,0,92,G
5-NP,7,0,96,0,0,96,T
5-NP,8,0,0,0,98,98,C
5-NP,9,0,0,0,100,100,C
5-NP,10,0,0,0,101,101,C
5-NP,11,101,0,0,0,101,A
5-NP,12,101,0,0,0,101,A
5-NP,13,0,0,100,0,100,G
5-NP,14,0,0,102,0,102,G
5-NP,15,0,0,0,103,103,C
5-NP,16,102,0,0,0,102,A
5-NP,17,0,0,0,104,104,C
5-NP,18,0,0,0,104,104,C
5-NP,19,103,0,0,0,103,A
5-NP,20,104,0,0,0,104,A
5-NP,21,103,0,0,0,103,A
5-NP,22,0,0,0,104,104,C
5-NP,23,0,0,103,0,103,G
5-NP,24,0,0,108,0,108,G
5-NP,25,0,110,0,0,110,T
5-NP,26,0,0,0,116,116,C
5-NP,27,0,115,0,0,115,T
5-NP,28,0,116,0,0,116,T
5-NP,29,117,0,0,0,117,A
5-NP,30,0,117,0,0,117,T
5-NP,31,0,0,117,0,117,G
5-NP,32,117,0,0,0,117,A
5-NP,33,117,0,0,0,117,A
5-NP,34,0,0,0,118,118,C
5-NP,35,115,0,0,0,115,A
5-NP,36,0,0,126,0,126,G
5-NP,37,125,0,0,0,125,A
5-NP,38,0,125,0,0,125,T
5-NP,39,0,0,126,0,126,G
5-NP,40,0,0,127,0,127,G
5-NP,41,128,0,0,0,128,A
5-NP,42,126,0,0,0,126,A
5-NP,43,127,0,0,0,127,A
5-NP,44,0,0,0,127,127,C
5-NP,45,0,127,0,0,127,T
5-NP,46,0,0,128,0,128,G
5-NP,47,128,0,0,0,128,A
5-NP,48,0,127,0,1,128,T
5-NP,49,0,0,128,0,128,G
5-NP,50,0,0,128,0,128,G
5-NP,51,0,0,127,0,127,G
5-NP,52,0,0,127,0,127,G
5-NP,53,127,0,0,0,127,A
5-NP,54,0,125,0,0,125,T
5-NP,55,0,0,0,128,128,C
5-NP,56,0,0,128,0,128,G
5-NP,57,0,0,0,129,129,C
5-NP,58,0,0,0,129,129,C
5-NP,59,127,0,1,0,128,A
5-NP,60,0,0,129,0,129,G
5-NP,61,128,0,0,0,128,A
5-NP,62,129,0,1,0,130,A
5-NP,63,0,130,0,0,130,T
5-NP,64,0,0,128,0,128,G
5-NP,65,0,0,0,131,131,C
5-NP,66,130,0,0,0,130,A
5-NP,67,133,0,0,0,133,A
5-NP,68,0,0,0,132,132,C
5-NP,69,0,132,0,0,132,T
5-NP,70,0,0,134,0,134,G
5-NP,71,136,0,1,0,137,A
5-NP,72,0,0,140,0,140,G
5-NP,73,141,0,0,0,141,A
5-NP,74,0,138,0,0,138,T
5-NP,75,0,139,0,0,139,T
5-NP,76,139,0,0,0,139,A
5-NP,77,0,0,142,0,142,G
5-NP,78,0,0,139,0,139,G
5-NP,79,0,0,141,0,141,G
5-NP,80,0,0,0,143,143,C
5-NP,81,142,0,0,0,142,A
5-NP,82,0,143,0,0,143,T
5-NP,83,0,0,0,143,143,C
5-NP,84,0,1,0,141,142,C
5-NP,85,0,0,144,0,144,G
5-NP,86,1,145,0,0,146,T
5-NP,87,0,0,0,146,146,C
5-NP,88,0,0,147,0,147,G
5-NP,89,0,0,148,0,148,G
5-NP,90,0,0,148,0,148,G
5-NP,91,148,0,0,0,148,A
5-NP,92,147,0,0,0,147,A
5-NP,93,0,0,146,0,146,G
5-NP,94,145,0,0,0,145,A
5-NP,95,0,145,0,0,145,T
5-NP,96,0,1,145,0,146,G
5-NP,97,147,0,0,0,147,A
5-NP,98,0,147,0,0,147,T
5-NP,99,0,148,0,0,148,T
5-NP,100,0,0,148,0,148,G
5-NP,101,149,0,0,0,149,A
5-NP,102,0,150,0,0,150,T
5-NP,103,0,0,150,0,150,G
5-NP,104,0,0,156,0,156,G
5-NP,105,157,0,0,0,157,A
5-NP,106,157,0,0,0,157,A
5-NP,107,0,156,0,0,156,T
5-NP,108,0,157,0,0,157,T
5-NP,109,0,0,157,0,157,G
5-NP,110,0,0,157,0,157,G
5-NP,111,0,0,156,0,156,G
5-NP,112,155,0,0,0,155,A
5-NP,113,0,0,151,0,151,G
5-NP,114,0,0,147,0,147,G
5-NP,115,0,157,0,0,157,T
5-NP,116,0,159,0,0,159,T
5-NP,117,0,0,0,160,160,C
5-NP,118,0,160,0,0,160,T
5-NP,119,164,0,0,0,164,A
5-NP,120,0,0,0,163,163,C
5-NP,121,171,0,0,0,171,A
5-NP,122,0,170,0,1,171,T
5-NP,123,0,0,0,169,169,C
5-NP,124,0,0,0,171,171,C
5-NP,125,170,0,0,0,170,A
5-NP,126,176,0,0,0,176,A
5-NP,127,176,0,0,0,176,A
5-NP,128,0,173,0,0,173,T
5-NP,129,0,0,173,0,173,G
5-NP,130,0,170,0,0,170,T
5-NP,131,0,0,172,0,172,G
5-NP,132,0,0,0,174,174,C
5-NP,133,174,0,0,0,174,A
5-NP,134,0,0,0,173,173,C
5-NP,135,0,171,0,0,171,T
5-NP,136,0,0,175,0,175,G
5-NP,137,178,0,0,0,178,A
5-NP,138,180,0,0,0,180,A
5-NP,139,0,0,0,180,180,C
5-NP,140,0,180,0,0,180,T
5-NP,141,0,180,0,0,180,T
5-NP,142,177,0,1,0,178,A
5-NP,143,178,0,0,0,178,A
5-NP,144,176,0,0,0,176,A
5-NP,145,0,0,0,178,178,C
5-NP,146,0,167,0,0,167,T
5-NP,147,0,0,0,167,167,C
5-NP,148,168,0,1,0,169,A
5-NP,149,0,0,171,0,171,G
5-NP,150,0,173,0,0,173,T
5-NP,151,0,0,178,0,178,G
5-NP,152,180,0,0,0,180,A
5-NP,153,0,180,0,0,180,T
5-NP,154,0,0,0,182,182,C
5-NP,155,184,0,0,0,184,A
5-NP,156,0,184,0,0,184,T
5-NP,157,0,0,184,0,184,G
5-NP,158,181,0,0,0,181,A
5-NP,159,183,0,0,0,183,A
5-NP,160,0,0,184,0,184,G
5-NP,161,0,0,180,0,180,G
5-NP,162,0,0,181,0,181,G
5-NP,163,0,0,0,183,183,C
5-NP,164,0,0,183,0,183,G
5-NP,165,0,0,186,0,186,G
5-NP,166,0,185,0,0,185,T
5-NP,167,0,186,0,0,186,T
5-NP,168,0,0,185,0,185,G
5-NP,169,202,0,0,0,202,A
5-NP,170,0,201,0,1,202,T
5-NP,171,0,0,0,202,202,C
5-NP,172,0,0,0,203,203,C
5-NP,173,203,0,0,0,203,A
5-NP,174,0,0,203,0,203,G
5-NP,175,203,0,0,0,203,A
5-NP,176,203,0,0,0,203,A
5-NP,177,0,0,0,204,204,C
5-NP,178,190,0,0,0,190,A
5-NP,179,0,0,194,0,194,G
5-NP,180,0,0,0,195,195,C
5-NP,181,0,192,0,1,193,T
5-NP,182,0,194,0,1,195,T
5-NP,183,0,0,193,0,193,G
5-NP,184,193,0,1,0,194,A
5-NP,185,0,1,0,194,195,C
5-NP,186,193,0,0,0,193,A
5-NP,187,195,0,0,0,195,A
5-NP,188,0,194,0,0,194,T
5-NP,189,198,0,0,0,198,A
5-NP,190,0,0,198,0,198,G
5-NP,191,198,0,0,0,198,A
5-NP,192,0,0,199,0,199,G
5-NP,193,197,0,0,0,197,A
5-NP,194,200,0,0,0,200,A
5-NP,195,199,0,0,0,199,A
5-NP,196,202,0,0,0,202,A
5-NP,197,0,201,0,0,201,T
5-NP,198,0,0,200,0,200,G
5-NP,199,0,0,201,0,201,G
5-NP,200,0,200,0,0,200,T
5-NP,201,198,0,0,0,198,A
5-NP,202,0,0,0,198,198,C
5-NP,203,0,198,0,0,198,T
5-NP,204,0,0,0,201,201,C
5-NP,205,0,196,0,0,196,T
5-NP,206,0,0,0,197,197,C
5-NP,207,0,197,0,0,197,T
5-NP,208,0,0,198,0,198,G
5-NP,209,0,0,0,198,198,C
5-NP,210,0,198,0,0,198,T
5-NP,211,0,197,0,0,197,T
5-NP,212,0,198,0,0,198,T
5-NP,213,0,195,0,0,195,T
5-NP,214,0,0,194,0,194,G
5-NP,215,195,0,0,0,195,A
5-NP,216,0,196,0,0,196,T
5-NP,217,0,0,196,0,196,G
5-NP,218,196,0,0,0,196,A
5-NP,219,196,0,0,0,196,A
5-NP,220,197,0,0,0,197,A
5-NP,221,0,0,197,0,197,G
5-NP,222,198,0,0,0,198,A
5-NP,223,197,0,0,0,197,A
5-NP,224,0,0,196,0,196,G
5-NP,225,0,0,206,0,206,G
5-NP,226,207,0,0,0,207,A
5-NP,227,207,0,0,0,207,A
5-NP,228,0,208,0,0,208,T
5-NP,229,208,0,0,0,208,A
5-NP,230,207,0,0,0,207,A
5-NP,231,210,0,0,0,210,A
5-NP,232,0,210,0,0,210,T
5-NP,233,214,0,0,0,214,A
5-NP,234,0,0,0,215,215,C
5-NP,235,0,0,0,208,208,C
5-NP,236,0,206,0,0,206,T
5-NP,237,0,0,207,0,207,G
5-NP,238,0,0,207,0,207,G
5-NP,239,207,0,0,0,207,A
5-NP,240,207,0,0,0,207,A
5-NP,241,0,0,208,0,208,G
5-NP,242,208,0,0,0,208,A
5-NP,243,206,0,0,0,206,A
5-NP,244,0,0,0,207,207,C
5-NP,245,207,0,1,0,208,A
5-NP,246,0,0,0,216,216,C
5-NP,247,0,0,0,214,214,C
5-NP,248,0,0,0,214,214,C
5-NP,249,0,0,0,214,214,C
5-NP,250,214,0,0,0,214,A
5-NP,251,0,0,215,0,215,G
5-NP,252,0,0,0,214,214,C
5-NP,253,0,0,214,0,214,G
5-NP,254,0,0,0,214,214,C
5-NP,255,0,0,210,0,210,G
5-NP,256,0,0,212,0,212,G
5-NP,257,0,0,211,0,211,G
5-NP,258,0,0,213,0,213,G
5-NP,259,214,0,0,0,214,A
5-NP,260,213,0,0,0,213,A
5-NP,261,211,0,0,0,211,A
5-NP,262,0,0,210,0,210,G
5-NP,263,211,0,0,0,211,A
5-NP,264,0,210,0,0,210,T
5-NP,265,0,0,0,210,210,C
5-NP,266,0,0,0,208,208,C
5-NP,267,0,0,0,212,212,C
5-NP,268,212,0,0,0,212,A
5-NP,269,210,0,0,0,210,A
5-NP,270,0,0,213,0,213,G
5-NP,271,213,0,0,0,213,A
5-NP,272,213,0,1,0,214,A
5-NP,273,214,0,0,0,214,A
5-NP,274,215,0,0,0,215,A
5-NP,275,0,0,0,216,216,C
5-NP,276,0,215,0,1,216,T
5-NP,277,0,0,213,0,213,G
5-NP,278,0,0,215,0,215,G
5-NP,279,0,0,213,0,213,G
5-NP,280,0,0,212,0,212,G
5-NP,281,0,0,209,0,209,G
5-NP,282,0,0,212,1,213,G
5-NP,283,0,0,0,229,229,C
5-NP,284,0,0,0,227,227,C
5-NP,285,0,0,0,228,228,C
5-NP,286,260,0,0,0,260,A
5-NP,287,0,261,0,0,261,T
5-NP,288,270,0,0,0,270,A
5-NP,289,0,271,0,0,271,T
5-NP,290,266,0,0,0,266,A
5-NP,291,1,0,0,264,265,C
5-NP,292,247,0,0,0,247,A
5-NP,293,0,0,247,0,247,G
5-NP,294,0,0,247,0,247,G
5-NP,295,215,0,0,0,215,A
5-NP,296,0,0,218,0,218,G
5-NP,297,211,0,0,0,211,A
5-NP,298,0,0,214,0,214,G
5-NP,299,0,214,0,0,214,T
5-NP,300,213,0,0,0,213,A
5-NP,301,0,0,215,0,215,G
5-NP,302,210,0,0,0,210,A
5-NP,303,0,212,0,0,212,T
5-NP,304,0,0,210,0,210,G
5-NP,305,0,0,213,0,213,G
5-NP,306,212,0,0,0,212,A
5-NP,307,212,0,0,0,212,A
5-NP,308,211,0,0,0,211,A
5-NP,309,212,0,0,0,212,A
5-NP,310,0,210,0,0,210,T
5-NP,311,0,0,210,0,210,G
5-NP,312,0,0,210,0,210,G
5-NP,313,210,0,0,0,210,A
5-NP,314,0,210,0,0,210,T
5-NP,315,0,0,212,0,212,G
5-NP,316,212,0,0,0,212,A
5-NP,317,0,0,211,0,211,G
5-NP,318,0,0,213,0,213,G
5-NP,319,0,0,235,0,235,G
5-NP,320,286,0,0,0,286,A
5-NP,321,298,0,0,0,298,A
5-NP,322,0,0,0,363,363,C
5-NP,323,0,366,0,0,366,T
5-NP,324,0,0,0,400,400,C
5-NP,325,1,0,439,0,440,G
5-NP,326,0,476,0,0,476,T
5-NP,327,1,0,0,502,503,C
5-NP,328,0,1,0,860,861,C
5-NP,329,0,865,0,0,865,T
5-NP,330,0,895,0,0,895,T
5-NP,331,0,896,0,1,897,T
5-NP,332,908,1,0,0,909,A
5-NP,333,0,911,0,2,913,T
5-NP,334,0,0,915,0,915,G
5-NP,335,933,0,3,0,936,A
5-NP,336,0,0,0,948,948,C
5-NP,337,941,0,0,0,941,A
5-NP,338,952,0,0,0,952,A
5-NP,339,981,0,1,0,982,A
5-NP,340,0,0,1148,0,1148,G
5-NP,341,1146,0,2,0,1148,A
5-NP,342,1151,0,0,0,1151,A
5-NP,343,1,1,1352,0,1354,G
5-NP,344,1379,0,0,1,1380,A
5-NP,345,1393,0,0,0,1393,A
5-NP,346,1391,0,1,0,1392,A
5-NP,347,0,1394,0,0,1394,T
5-NP,348,1400,1,0,0,1401,A
5-NP,349,1405,0,0,0,1405,A
5-NP,350,1,0,1459,0,1460,G
5-NP,351,0,1,1459,0,1460,G
5-NP,352,0,0,0,1462,1462,C
5-NP,353,2,0,1462,0,1464,G
5-NP,354,1489,0,1,0,1490,A
5-NP,355,1560,0,1,0,1561,A
5-NP,356,0,1579,0,0,1579,T
5-NP,357,0,0,0,1582,1582,C
5-NP,358,0,1581,0,0,1581,T
5-NP,359,0,1,1585,0,1586,G
5-NP,360,0,1,1593,0,1594,G
5-NP,361,0,0,1,1609,1610,C
5-NP,362,3,0,1604,0,1607,G
5-NP,363,0,0,0,1611,1611,C
5-NP,364,0,0,0,1616,1616,C
5-NP,365,1621,0,3,0,1624,A
5-NP,366,1700,0,1,0,1701,A
5-NP,367,0,0,1816,0,1816,G
5-NP,368,0,0,0,1819,1819,C
5-NP,369,0,2,0,1882,1884,C
5-NP,370,1897,0,1,0,1898,A
5-NP,371,1962,0,2,0,1964,A
5-NP,372,1,0,0,2036,2037,C
5-NP,373,2042,0,0,0,2042,A
5-NP,374,2147,1,0,0,2148,A
5-NP,375,0,2173,0,1,2174,T
5-NP,376,0,0,2316,0,2316,G
5-NP,377,1,0,2323,0,2324,G
5-NP,378,1,2324,1,1,2327,T
5-NP,379,1,0,2341,0,2342,G
5-NP,380,2338,0,0,0,2338,A
5-NP,381,0,0,2479,0,2479,G
5-NP,382,0,1,2487,0,2488,G
5-NP,383,2581,1,0,0,2582,A
5-NP,384,1,3127,0,1,3129,T
5-NP,385,1,0,3240,1,3242,G
5-NP,386,0,0,0,3255,3255,C
5-NP,387,1,3254,0,4,3259,T
5-NP,388,3292,0,0,0,3292,A
5-NP,389,0,1,0,3410,3411,C
5-NP,390,3461,0,0,0,3461,A
5-NP,391,1,3459,0,1,3461,T
5-NP,392,0,0,0,3464,3464,C
5-NP,393,0,3404,1,1,3406,T
5-NP,394,0,0,3719,0,3719,G
5-NP,395,1,0,3898,1,3900,G
5-NP,396,0,3902,0,3,3905,T
5-NP,397,0,1,0,3920,3921,C
5-NP,398,0,3913,0,2,3915,T
5-NP,399,4022,0,1,0,4023,A
5-NP,400,4030,0,0,0,4030,A
5-NP,401,0,0,1,4079,4080,C
5-NP,402,0,4076,0,2,4078,T
5-NP,403,0,1,1,4159,4161,C
5-NP,404,4181,0,1,0,4182,A
5-NP,405,0,0,0,4469,4469,C
5-NP,406,4463,2,0,0,4465,A
5-NP,407,1,4494,0,0,4495,T
5-NP,408,4482,0,0,0,4482,A
5-NP,409,4510,1,2,0,4513,A
5-NP,410,0,4536,0,2,4538,T
5-NP,411,0,1,4612,0,4613,G
5-NP,412,4613,1,0,0,4614,A
5-NP,413,1,4588,0,0,4589,T
5-NP,414,2,4573,0,0,4575,T
5-NP,415,3,4581,0,3,4587,T
5-NP,416,2,3,4569,1,4575,G
5-NP,417,0,0,4599,0,4599,G
5-NP,418,0,3,0,4605,4608,C
5-NP,419,4616,0,1,0,4617,A
5-NP,420,0,4629,0,1,4630,T
5-NP,421,1,4625,1,1,4628,T
5-NP,422,1,0,0,4632,4633,C
5-NP,423,0,1,0,4655,4656,C
5-NP,424,4744,0,2,0,4746,A
5-NP,425,4763,3,0,0,4766,A
5-NP,426,0,4768,0,1,4769,T
5-NP,427,0,4765,0,0,4765,T
5-NP,428,2,4759,1,2,4764,T
5-NP,429,0,0,4818,0,4818,G
5-NP,430,4802,4,2,0,4808,A
5-NP,431,4827,0,3,0,4830,A
5-NP,432,0,4870,0,1,4871,T
5-NP,433,1,0,4855,0,4856,G
5-NP,434,5124,0,4,0,5128,A
5-NP,435,2,5136,1,0,5139,T
5-NP,436,1,0,5163,1,5165,G
5-NP,437,0,1,0,5351,5352,C
5-NP,438,5347,0,2,0,5349,A
5-NP,439,5641,0,2,0,5643,A
5-NP,440,0,2,0,5655,5657,C
5-NP,441,5764,1,1,0,5766,A
5-NP,442,0,5931,0,1,5932,T
5-NP,443,5877,1,3,1,5882,A
5-NP,444,0,0,0,5986,5986,C
5-NP,445,1,0,0,5975,5976,C
5-NP,446,5910,0,0,0,5910,A
5-NP,447,0,0,5992,0,5992,G
5-NP,448,5917,1,1,0,5919,A
5-NP,449,1,1,6091,0,6093,G
5-NP,450,0,2,6084,1,6087,G
5-NP,451,6068,2,2,1,6073,A
5-NP,452,0,0,0,6124,6124,C
5-NP,453,6087,2,3,0,6092,A
5-NP,454,6086,0,3,0,6089,A
5-NP,455,1,1,6117,1,6120,G
5-NP,456,6076,0,8,0,6084,A
5-NP,457,0,0,6141,0,6141,G
5-NP,458,0,0,0,6140,6140,C
5-NP,459,0,6110,0,9,6119,T
5-NP,460,1,2,0,6149,6152,C
5-NP,461,1,6139,0,1,6141,T
5-NP,462,1,6157,1,1,6160,T
5-NP,463,0,3,6182,0,6185,G
5-NP,464,1,6173,0,1,6175,T
5-NP,465,0,6166,0,11,6177,T
5-NP,466,0,3,1,6155,6159,C
5-NP,467,0,1,6158,0,6159,G
5-NP,468,6313,2,1,0,6316,A
5-NP,469,6329,10,2,0,6341,A
5-NP,470,1,0,0,6388,6389,C
5-NP,471,0,6396,0,2,6398,T
5-NP,472,0,0,6511,0,6511,G
5-NP,473,1,1,6552,1,6555,G
5-NP,474,6534,15,3,0,6552,A
5-NP,475,6573,0,1,0,6574,A
5-NP,476,0,6575,0,1,6576,T
5-NP,477,1,2,6600,2,6605,G
5-NP,478,1,1,6638,0,6640,G
5-NP,479,6712,2,4,0,6718,A
5-NP,480,0,6796,0,0,6796,T
5-NP,481,2,1,0,6824,6827,C
5-NP,482,1,2,1,6839,6843,C
5-NP,483,0,4,1,6867,6872,C
5-NP,484,6918,1,6,1,6926,A
5-NP,485,1,2,7008,0,7011,G
5-NP,486,7024,0,1,1,7026,A
5-NP,487,7017,0,1,1,7019,A
5-NP,488,1,6950,1,0,6952,T
5-NP,489,0,2,7061,0,7063,G
5-NP,490,0,7030,0,3,7033,T
5-NP,491,3,0,7066,0,7069,G
5-NP,492,1,1,1,7063,7066,C
5-NP,493,1,7042,1,5,7049,T
5-NP,494,0,0,0,7519,7519,C
5-NP,495,0,7473,0,4,7477,T
5-NP,496,0,2,2,7830,7834,C
5-NP,497,1,7824,0,1,7826,T
5-NP,498,0,1,7853,1,7855,G
5-NP,499,7908,2,4,3,7917,A
5-NP,500,1,7899,0,1,7901,T
5-NP,501,6,1,7912,0,7919,G
5-NP,502,1,1,1,7902,7905,C
5-NP,503,7731,3,5,0,7739,A
5-NP,504,0,3,7981,0,7984,G
5-NP,505,1,1,7831,0,7833,G
5-NP,506,2,2,7972,0,7976,G
5-NP,507,0,1,1,7959,7961,C
5-NP,508,0,7930,0,4,7934,T
5-NP,509,1,0,0,7978,7979,C
5-NP,510,2,0,7977,0,7979,G
5-NP,511,8113,3,2,0,8118,A
5-NP,512,1,1,0,8121,8123,C
5-NP,513,2,8013,0,3,8018,T
5-NP,514,1,0,0,8481,8482,C
5-NP,515,3,8463,0,0,8466,T
5-NP,516,2,6,1,9901,9910,C
5-NP,517,3,4,2,9911,9920,C
5-NP,518,0,1,0,9935,9936,C
5-NP,519,2,9934,0,2,9938,T
5-NP,520,9892,1,5,1,9899,A
5-NP,521,1,4,9887,0,9892,G
5-NP,522,9888,2,4,0,9894,A
5-NP,523,9647,2,4,0,9653,A
5-NP,524,0,2,9674,0,9676,G
5-NP,525,2,1,9605,1,9609,G
5-NP,526,2,9519,0,5,9526,T
5-NP,527,2,5,0,9495,9502,C
5-NP,528,3,4,1,9505,9513,C
5-NP,529,1,1,9520,0,9522,G
5-NP,530,1,1,9585,0,9587,G
5-NP,531,9553,2,6,0,9561,A
5-NP,532,0,1,9678,0,9679,G
5-NP,533,2,0,0,9719,9721,C
5-NP,534,0,9635,1,9,9645,T
5-NP,535,5,3,9639,0,9647,G
5-NP,536,0,1,0,9699,9700,C
5-NP,537,9684,2,10,2,9698,A
5-NP,538,0,1,9711,1,9713,G
5-NP,539,1,3,9759,1,9764,G
5-NP,540,2,9768,0,3,9773,T
5-NP,541,1,2,9702,0,9705,G
5-NP,542,0,5,0,9749,9754,C
5-NP,543,1,9750,0,3,9754,T
5-NP,544,2,1,9771,0,9774,G
5-NP,545,2,2,0,9769,9773,C
5-NP,546,9881,1,2,19,9903,A
5-NP,547,2,0,10119,0,10121,G
5-NP,548,1,10045,1,4,10051,T
5-NP,549,1,0,0,10096,10097,C
5-NP,550,10073,2,0,1,10076,A
5-NP,551,10060,2,7,4,10073,A
5-NP,552,10059,0,8,1,10068,A
5-NP,553,2,3,10133,0,10138,G
5-NP,554,1,0,10181,2,10184,G
5-NP,555,10176,1,7,1,10185,A
5-NP,556,10130,1,3,1,10135,A
5-NP,557,1,10127,0,7,10135,T
5-NP,558,2,5,1,10136,10144,C
5-NP,559,5,3,10141,1,10150,G
5-NP,560,2,1,10451,0,10454,G
5-NP,561,2,1,10475,0,10478,G
5-NP,562,10456,3,5,0,10464,A
5-NP,563,2,0,0,10487,10489,C
5-NP,564,10414,3,3,0,10420,A
5-NP,565,10691,2,6,1,10700,A
5-NP,566,4,10738,2,4,10748,T
5-NP,567,0,1,10821,0,10822,G
5-NP,568,0,1,11099,0,11100,G
5-NP,569,3,11157,0,4,11164,T
5-NP,570,0,1,11211,1,11213,G
5-NP,571,11208,2,4,0,11214,A
5-NP,572,1,11170,1,7,11179,T
5-NP,573,6,1,11179,3,11189,G
5-NP,574,2,3,11255,0,11260,G
5-NP,575,11248,2,5,0,11255,A
5-NP,576,11256,0,3,0,11259,A
5-NP,577,1,0,0,11236,11237,C
5-NP,578,1,10960,2,1,10964,T
5-NP,579,1,1,11489,1,11492,G
5-NP,580,11473,4,5,0,11482,A
5-NP,581,1,11461,1,4,11467,T
5-NP,582,1,2,0,11496,11499,C
5-NP,583,11333,4,3,2,11342,A
5-NP,584,1,2,11617,0,11620,G
5-NP,585,11612,1,3,1,11617,A
5-NP,586,11614,1,1,1,11617,A
5-NP,587,3,11605,0,1,11609,T
5-NP,588,0,2,11286,1,11289,G
5-NP,589,11240,1,2,0,11243,A
5-NP,590,3,11492,0,8,11503,T
5-NP,591,2,1,0,11529,11532,C
5-NP,592,11542,2,2,0,11546,A
5-NP,593,11529,2,1,1,11533,A
5-NP,594,11540,1,4,2,11547,A
5-NP,595,1,1,0,11552,11554,C
5-NP,596,2,4,11520,2,11528,G
5-NP,597,2,5,11593,4,11604,G
5-NP,598,4,6,11560,1,11571,G
5-NP,599,3,3,11630,2,11638,G
5-NP,600,7,2,11642,2,11653,G
5-NP,601,11636,3,5,0,11644,A
5-NP,602,4,11552,1,4,11561,T
5-NP,603,3,0,0,11555,11558,C
5-NP,604,11574,0,6,0,11580,A
5-NP,605,11589,2,4,0,11595,A
5-NP,606,1,0,0,11521,11522,C
5-NP,607,2,0,11472,1,11475,G
5-NP,608,11440,0,5,0,11445,A
5-NP,609,5,11429,0,1,11435,T
5-NP,610,2,1,0,11442,11445,C
5-NP,611,1,1,11457,1,11460,G
5-NP,612,11438,6,2,1,11447,A
5-NP,613,11429,1,2,0,11432,A
5-NP,614,11433,3,3,0,11439,A
5-NP,615,0,11511,2,1,11514,T
5-NP,616,0,11503,2,3,11508,T
5-NP,617,0,11476,2,3,11481,T
5-NP,618,1,11538,2,2,11543,T
5-NP,619,2,11561,1,1,11565,T
5-NP,620,3,1,11574,1,11579,G
5-NP,621,3,1,11570,0,11574,G
5-NP,622,11486,2,10,1,11499,A
5-NP,623,1,2,11600,0,11603,G
5-NP,624,11466,1,0,0,11467,A
5-NP,625,1,2,12060,1,12064,G
5-NP,626,4,1,12112,0,12117,G
5-NP,627,2,12080,1,7,12090,T
5-NP,628,5,0,12129,0,12134,G
5-NP,629,12113,1,11,3,12128,A
5-NP,630,2,3,12198,3,12206,G
5-NP,631,12167,0,13,0,12180,A
5-NP,632,12133,0,13,3,12149,A
5-NP,633,0,12093,3,3,12099,T
5-NP,634,6,4,11748,3,11761,G
5-NP,635,3,2,11694,1,11700,G
5-NP,636,5,1,11708,1,11715,G
5-NP,637,2,38,0,11638,11678,C
5-NP,638,1,3,11690,2,11696,G
5-NP,639,0,1,11752,0,11753,G
5-NP,640,11735,0,4,0,11739,A
5-NP,641,11741,2,7,2,11752,A
5-NP,642,11899,2,5,2,11908,A
5-NP,643,11933,0,5,8,11946,A
5-NP,644,0,3,0,12005,12008,C
5-NP,645,11991,1,1,0,11993,A
5-NP,646,11980,0,4,0,11984,A
5-NP,647,0,1,11992,0,11993,G
5-NP,648,11753,3,3,0,11759,A
5-NP,649,11798,1,4,0,11803,A
5-NP,650,3,2,12014,1,12020,G
5-NP,651,3,11998,0,4,12005,T
5-NP,652,1,2,12518,0,12521,G
5-NP,653,1,2,1,12492,12496,C
5-NP,654,2,12520,0,9,12531,T
5-NP,655,1,12552,0,1,12554,T
5-NP,656,12684,4,1,0,12689,A
5-NP,657,4,12693,1,3,12701,T
5-NP,658,4,3,12738,1,12746,G
5-NP,659,12469,3,13,0,12485,A
5-NP,660,1,1,12534,0,12536,G
5-NP,661,12038,2,6,1,12047,A
5-NP,662,0,1,12089,0,12090,G
5-NP,663,12062,0,2,0,12064,A
5-NP,664,12176,1,1,0,12178,A
5-NP,665,4,12083,1,1,12089,T
5-NP,666,2,1,12256,2,12261,G
5-NP,667,2,12212,1,5,12220,T
5-NP,668,4,2,12247,0,12253,G
5-NP,669,4,4,0,12207,12215,C
5-NP,670,12184,1,7,0,12192,A
5-NP,671,12212,2,12,2,12228,A
5-NP,672,0,0,0,12214,12214,C
5-NP,673,12103,1,5,0,12109,A
5-NP,674,1,12237,3,1,12242,T
5-NP,675,4,12097,2,12,12115,T
5-NP,676,0,1,1,12246,12248,C
5-NP,677,5,12200,1,2,12208,T
5-NP,678,1,12207,2,3,12213,T
5-NP,679,12225,0,3,0,12228,A
5-NP,680,12174,2,0,0,12176,A
5-NP,681,12164,1,5,0,12170,A
5-NP,682,2,6,12153,0,12161,G
5-NP,683,2,5,12027,0,12034,G
5-NP,684,1,1,11960,1,11963,G
5-NP,685,12008,1,6,0,12015,A
5-NP,686,12016,0,2,1,12019,A
5-NP,687,12198,1,0,0,12199,A
5-NP,688,1,12190,3,4,12198,T
5-NP,689,3,12190,1,2,12196,T
5-NP,690,3,12244,0,3,12250,T
5-NP,691,2,1,2,12245,12250,C
5-NP,692,12253,1,3,0,12257,A
5-NP,693,12247,3,5,1,12256,A
5-NP,694,12239,2,8,2,12251,A
5-NP,695,1,3,0,12385,12389,C
5-NP,696,12249,2,4,0,12255,A
5-NP,697,0,0,12518,0,12518,G
5-NP,698,4,1,0,12546,12551,C
5-NP,699,2,12535,1,6,12544,T
5-NP,700,2,1,12743,0,12746,G
5-NP,701,1,9,0,12691,12701,C
5-NP,702,12811,2,4,1,12818,A
5-NP,703,2,1,0,12813,12816,C
5-NP,704,12701,2,3,0,12706,A
5-NP,705,12714,0,46,0,12760,A
5-NP,706,12476,1,8,0,12485,A
5-NP,707,1,2,12963,0,12966,G
5-NP,708,12904,5,13,0,12922,A
5-NP,709,19,0,13073,0,13092,G
5-NP,710,0,0,1,13085,13086,C
5-NP,711,13075,2,2,0,13079,A
5-NP,712,13426,0,4,1,13431,A
5-NP,713,1,13422,0,3,13426,T
5-NP,714,3,1,13444,2,13450,G
5-NP,715,2,1,13495,1,13499,G
5-NP,716,4,13092,1,19,13116,T
5-NP,717,4,0,13202,1,13207,G
5-NP,718,0,1,13267,0,13268,G
5-NP,719,13293,1,6,0,13300,A
5-NP,720,5,13245,2,7,13259,T
5-NP,721,2,2,0,12883,12887,C
5-NP,722,12936,0,5,0,12941,A
5-NP,723,13112,2,1,3,13118,A
5-NP,724,1,2,13150,0,13153,G
5-NP,725,4,13038,0,1,13043,T
5-NP,726,2,2,13067,0,13071,G
5-NP,727,12893,1,6,0,12900,A
5-NP,728,1,4,12962,0,12967,G
5-NP,729,12937,0,12,1,12950,A
5-NP,730,2,2,12956,0,12960,G
5-NP,731,12873,2,5,1,12881,A
5-NP,732,12639,0,2,0,12641,A
5-NP,733,12681,2,11,0,12694,A
5-NP,734,1,0,12762,1,12764,G
5-NP,735,2,12716,0,0,12718,T
5-NP,736,0,3,1,12723,12727,C
5-NP,737,6,3,12683,1,12693,G
5-NP,738,1,1,12708,3,12713,G
5-NP,739,12698,1,7,0,12706,A
5-NP,740,12775,3,2,0,12780,A
5-NP,741,2,3,0,12798,12803,C
5-NP,742,5,4,1,12701,12711,C
5-NP,743,1,4,0,12768,12773,C
5-NP,744,12769,0,10,0,12779,A
5-NP,745,7,4,12824,2,12837,G
5-NP,746,0,4,12826,1,12831,G
5-NP,747,12780,1,3,1,12785,A
5-NP,748,12779,1,6,0,12786,A
5-NP,749,12725,0,4,3,12732,A
5-NP,750,1,2,0,12752,12755,C
5-NP,751,1,1,12739,1,12742,G
5-NP,752,4,2,1,12727,12734,C
5-NP,753,1,12708,0,3,12712,T
5-NP,754,2,3,12734,0,12739,G
5-NP,755,12693,6,1,1,12701,A
5-NP,756,0,1,12849,0,12850,G
5-NP,757,12854,4,1,2,12861,A
5-NP,758,2,12846,0,0,12848,T
5-NP,759,2,3,1,12727,12733,C
5-NP,760,5,4,12739,1,12749,G
5-NP,761,12736,2,6,0,12744,A
5-NP,762,12739,1,3,0,12743,A
5-NP,763,7,0,12763,0,12770,G
5-NP,764,12780,1,1,0,12782,A
5-NP,765,3,12651,0,5,12659,T
5-NP,766,1,0,0,12726,12727,C
5-NP,767,1,12717,0,4,12722,T
5-NP,768,0,4,1,12801,12806,C
5-NP,769,12832,1,4,0,12837,A
5-NP,770,0,12824,0,1,12825,T
5-NP,771,12843,1,0,0,12844,A
5-NP,772,1,12822,1,2,12826,T
5-NP,773,1,12761,0,4,12766,T
5-NP,774,1,12723,1,5,12730,T
5-NP,775,1,12607,0,2,12610,T
5-NP,776,1,12647,0,2,12650,T
5-NP,777,12667,2,1,1,12671,A
5-NP,778,3,0,12657,0,12660,G
5-NP,779,3,2,1,12658,12664,C
5-NP,780,12610,0,5,1,12616,A
5-NP,781,12584,3,1,2,12590,A
5-NP,782,2,2,12969,0,12973,G
5-NP,783,12958,2,5,0,12965,A
5-NP,784,0,12982,1,0,12983,T
5-NP,785,5,1,1,13014,13021,C
5-NP,786,57,12854,0,77,12988,T
5-NP,787,0,1,13298,1,13300,G
5-NP,788,1,2,1,13328,13332,C
5-NP,789,13345,0,3,1,13349,A
5-NP,790,0,13479,1,3,13483,T
5-NP,791,2,12990,0,5,12997,T
5-NP,792,0,1,13710,0,13711,G
5-NP,793,13991,2,3,0,13996,A
5-NP,794,4,13965,0,2,13971,T
5-NP,795,13993,1,3,0,13997,A
5-NP,796,1,13770,1,2,13774,T
5-NP,797,2,13676,2,5,13685,T
5-NP,798,3,2,13757,0,13762,G
5-NP,799,13612,1,11,1,13625,A
5-NP,800,0,2,13734,0,13736,G
5-NP,801,13053,3,21,0,13077,A
5-NP,802,2,3,12828,0,12833,G
5-NP,803,3,2,13004,1,13010,G
5-NP,804,12971,1,1,0,12973,A
5-NP,805,3,12967,1,4,12975,T
5-NP,806,1,1,1,12998,13001,C
5-NP,807,12933,6,2,0,12941,A
5-NP,808,0,1,13017,0,13018,G
5-NP,809,6,12939,1,9,12955,T
5-NP,810,0,12868,0,5,12873,T
5-NP,811,3,2,12859,0,12864,G
5-NP,812,3,3,2,12733,12741,C
5-NP,813,2,12714,1,9,12726,T
5-NP,814,0,4,0,12782,12786,C
5-NP,815,12789,2,5,0,12796,A
5-NP,816,2,2,2,12794,12800,C
5-NP,817,12755,0,2,0,12757,A
5-NP,818,12812,0,2,0,12814,A
5-NP,819,12854,0,3,1,12858,A
5-NP,820,0,12828,1,2,12831,T
5-NP,821,3,0,1,12843,12847,C
5-NP,822,1,12794,2,4,12801,T
5-NP,823,0,12790,0,3,12793,T
5-NP,824,5,0,12806,0,12811,G
5-NP,825,3,3,0,12793,12799,C
5-NP,826,2,1,1,12996,13000,C
5-NP,827,0,12949,2,8,12959,T
5-NP,828,13041,0,2,0,13043,A
5-NP,829,2,4,1,13013,13020,C
5-NP,830,3,1,1,13029,13034,C
5-NP,831,2,12960,0,8,12970,T
5-NP,832,6,1,13180,1,13188,G
5-NP,833,4,4,0,13129,13137,C
5-NP,834,5,3,1,13121,13130,C
5-NP,835,2,12925,0,14,12941,T
5-NP,836,5,2,13118,1,13126,G
5-NP,837,3,13034,1,6,13044,T
5-NP,838,3,4,13209,0,13216,G
5-NP,839,1,4,1,13289,13295,C
5-NP,840,6,0,13498,0,13504,G
5-NP,841,0,13292,0,3,13295,T
5-NP,842,13252,2,7,2,13263,A
5-NP,843,0,13269,0,2,13271,T
5-NP,844,4,2,13244,0,13250,G
5-NP,845,0,0,13788,0,13788,G
5-NP,846,13731,1,13,0,13745,A
5-NP,847,4,5,4,13492,13505,C
5-NP,848,1,1,0,13501,13503,C
5-NP,849,5,13288,0,3,13296,T
5-NP,850,2,0,13894,0,13896,G
5-NP,851,2,3,0,13899,13904,C
5-NP,852,13912,1,11,0,13924,A
5-NP,853,1,0,14154,0,14155,G
5-NP,854,2,13356,0,6,13364,T
5-NP,855,13866,2,1,0,13869,A
5-NP,856,2,13817,2,3,13824,T
5-NP,857,3,1,3,13716,13723,C
5-NP,858,1,1,1,13754,13757,C
5-NP,859,13120,2,4,0,13126,A
5-NP,860,2,1,13189,0,13192,G
5-NP,861,1,13117,1,5,13124,T
5-NP,862,2,3,13239,0,13244,G
5-NP,863,2,7,13201,0,13210,G
5-NP,864,2,2,12958,2,12964,G
5-NP,865,1,12960,0,2,12963,T
5-NP,866,12937,0,2,1,12940,A
5-NP,867,2,2,1,12911,12916,C
5-NP,868,2,1,12887,0,12890,G
5-NP,869,12814,2,6,2,12824,A
5-NP,870,2,3,0,12819,12824,C
5-NP,871,2,12458,1,4,12465,T
5-NP,872,6,12475,2,0,12483,T
5-NP,873,0,1,0,12457,12458,C
5-NP,874,1,2,12450,0,12453,G
5-NP,875,12455,1,10,2,12468,A
5-NP,876,12450,1,6,1,12458,A
5-NP,877,12479,2,3,1,12485,A
5-NP,878,12456,1,2,2,12461,A
5-NP,879,12428,3,3,1,12435,A
5-NP,880,3,0,12495,1,12499,G
5-NP,881,12439,3,14,2,12458,A
5-NP,882,3,5,12560,0,12568,G
5-NP,883,4,3,12608,0,12615,G
5-NP,884,3,3,12650,0,12656,G
5-NP,885,12687,6,4,1,12698,A
5-NP,886,3,12691,1,1,12696,T
5-NP,887,12756,0,3,0,12759,A
5-NP,888,3,12751,2,3,12759,T
5-NP,889,3,12823,2,1,12829,T
5-NP,890,2,0,1,12915,12918,C
5-NP,891,0,0,1,12832,12833,C
5-NP,892,2,12646,0,3,12651,T
5-NP,893,0,12644,0,3,12647,T
5-NP,894,2,2,12777,1,12782,G
5-NP,895,1,0,12859,0,12860,G
5-NP,896,1,12804,0,2,12807,T
5-NP,897,1,1,12742,2,12746,G
5-NP,898,1,3,12699,0,12703,G
5-NP,899,3,0,13300,4,13307,G
5-NP,900,13280,0,9,2,13291,A
5-NP,901,13292,2,2,0,13296,A
5-NP,902,1,13303,0,0,13304,T
5-NP,903,13070,1,2,0,13073,A
5-NP,904,1,2,13076,0,13079,G
5-NP,905,12983,0,17,0,13000,A
5-NP,906,0,1,0,12952,12953,C
5-NP,907,8,3,1,12822,12834,C
5-NP,908,3,0,0,12336,12339,C
5-NP,909,0,12426,2,18,12446,T
5-NP,910,2,12458,2,5,12467,T
5-NP,911,4,12447,0,21,12472,T
5-NP,912,1,5,0,12480,12486,C
5-NP,913,12435,5,4,0,12444,A
5-NP,914,12434,0,4,0,12438,A
5-NP,915,12414,5,2,0,12421,A
5-NP,916,0,2,0,12445,12447,C
5-NP,917,1,12124,0,2,12127,T
5-NP,918,12052,1,2,1,12056,A
5-NP,919,0,0,1,12161,12162,C
5-NP,920,1,12094,4,5,12104,T
5-NP,921,1,12092,2,3,12098,T
5-NP,922,2,3,1,12138,12144,C
5-NP,923,12128,2,4,0,12134,A
5-NP,924,12132,0,2,1,12135,A
5-NP,925,12097,1,4,0,12102,A
5-NP,926,12108,0,2,0,12110,A
5-NP,927,0,12015,1,3,12019,T
5-NP,928,11878,3,5,0,11886,A
5-NP,929,0,2,11981,0,11983,G
5-NP,930,5,5,0,11997,12007,C
5-NP,931,4,7,1,12125,12137,C
5-NP,932,12149,1,1,0,12151,A
5-NP,933,12174,0,4,0,12178,A
5-NP,934,12497,1,2,1,12501,A
5-NP,935,2,12504,0,1,12507,T
5-NP,936,12562,1,1,0,12564,A
5-NP,937,1,12551,0,1,12553,T
5-NP,938,12393,0,3,0,12396,A
5-NP,939,3,1,0,12410,12414,C
5-NP,940,12107,2,3,0,12112,A
5-NP,941,2,0,12414,0,12416,G
5-NP,942,0,1,0,12375,12376,C
5-NP,943,0,12019,1,5,12025,T
5-NP,944,2,12102,0,5,12109,T
5-NP,945,12169,3,0,1,12173,A
5-NP,946,12169,2,4,1,12176,A
5-NP,947,0,12160,2,3,12165,T
5-NP,948,1,5,0,12158,12164,C
5-NP,949,11833,0,8,2,11843,A
5-NP,950,1,2,11948,0,11951,G
5-NP,951,11963,0,8,1,11972,A
5-NP,952,3,3,0,12006,12012,C
5-NP,953,4,0,1,11903,11908,C
5-NP,954,1,11770,0,3,11774,T
5-NP,955,11846,0,0,1,11847,A
5-NP,956,11845,0,0,1,11846,A
5-NP,957,0,3,0,11889,11892,C
5-NP,958,4,0,11888,0,11892,G
5-NP,959,11598,3,5,1,11607,A
5-NP,960,4,2,11623,1,11630,G
5-NP,961,11496,1,13,0,11510,A
5-NP,962,11625,3,2,1,11631,A
5-NP,963,1,11611,0,1,11613,T
5-NP,964,2,3,5,11482,11492,C
5-NP,965,1,1,0,11506,11508,C
5-NP,966,11328,1,12,0,11341,A
5-NP,967,4,1,11407,0,11412,G
5-NP,968,3,1,0,11398,11402,C
5-NP,969,11498,1,5,0,11504,A
5-NP,970,0,1,0,11552,11553,C
5-NP,971,11396,1,5,0,11402,A
5-NP,972,1,3,0,11410,11414,C
5-NP,973,11386,0,6,0,11392,A
5-NP,974,11436,2,7,0,11445,A
5-NP,975,1,1,11477,0,11479,G
5-NP,976,11303,3,6,0,11312,A
5-NP,977,1,4,11353,0,11358,G
5-NP,978,3,11127,0,7,11137,T
5-NP,979,2,2,1,11114,11119,C
5-NP,980,11104,0,9,0,11113,A
5-NP,981,4,0,11109,1,11114,G
5-NP,982,0,3,0,11077,11080,C
5-NP,983,0,10987,0,6,10993,T
5-NP,984,2,0,11123,0,11125,G
5-NP,985,6,0,11177,0,11183,G
5-NP,986,0,11134,0,3,11137,T
5-NP,987,2,0,11176,1,11179,G
5-NP,988,0,11061,0,6,11067,T
5-NP,989,1,4,11060,0,11065,G
5-NP,990,3,0,11054,0,11057,G
5-NP,991,11008,1,5,1,11015,A
5-NP,992,2,11029,0,4,11035,T
5-NP,993,3,0,10566,1,10570,G
5-NP,994,3,2,10511,0,10516,G
5-NP,995,1,0,2,10473,10476,C
5-NP,996,10388,1,2,0,10391,A
5-NP,997,2,10370,0,6,10378,T
5-NP,998,5,1,10290,1,10297,G
5-NP,999,1,6,0,10346,10353,C
5-NP,1000,2,0,0,10379,10381,C
5-NP,1001,10368,0,3,0,10371,A
5-NP,1002,0,10329,0,5,10334,T
5-NP,1003,1,10208,0,2,10211,T
5-NP,1004,0,0,0,10252,10252,C
5-NP,1005,2,10124,0,2,10128,T
5-NP,1006,1,0,10123,0,10124,G
5-NP,1007,2,5,0,10098,10105,C
5-NP,1008,1,9875,0,7,9883,T
5-NP,1009,1,0,9933,1,9935,G
5-NP,1010,0,0,0,9795,9795,C
5-NP,1011,9801,0,2,0,9803,A
5-NP,1012,0,9792,1,2,9795,T
5-NP,1013,2,9725,0,4,9731,T
5-NP,1014,1,9722,0,2,9725,T
5-NP,1015,3,1,9720,2,9726,G
5-NP,1016,9708,1,0,2,9711,A
5-NP,1017,9710,1,4,0,9715,A
5-NP,1018,2,1,9754,0,9757,G
5-NP,1019,9653,1,1,0,9655,A
5-NP,1020,1,9608,0,1,9610,T
5-NP,1021,2,9596,0,2,9600,T
5-NP,1022,1,9603,0,2,9606,T
5-NP,1023,9603,2,2,0,9607,A
5-NP,1024,9605,3,2,1,9611,A
5-NP,1025,2,1,9617,1,9621,G
5-NP,1026,9591,2,3,1,9597,A
5-NP,1027,3,9570,0,3,9576,T
5-NP,1028,2,9393,0,2,9397,T
5-NP,1029,1,0,9444,2,9447,G
5-NP,1030,2,9432,1,4,9439,T
5-NP,1031,1,9433,1,0,9435,T
5-NP,1032,9427,1,2,0,9430,A
5-NP,1033,9426,1,3,1,9431,A
5-NP,1034,0,4,9450,1,9455,G
5-NP,1035,1,3,0,9461,9465,C
5-NP,1036,0,9236,1,10,9247,T
5-NP,1037,1,9249,0,2,9252,T
5-NP,1038,0,1,1,9259,9261,C
5-NP,1039,9253,0,3,0,9256,A
5-NP,1040,2,9235,2,3,9242,T
5-NP,1041,0,2,1,9248,9251,C
5-NP,1042,9098,1,1,1,9101,A
5-NP,1043,0,1,9102,0,9103,G
5-NP,1044,8939,1,9,0,8949,A
5-NP,1045,2,3,8950,0,8955,G
5-NP,1046,3,1,8900,0,8904,G
5-NP,1047,4,0,8832,0,8836,G
5-NP,1048,8839,1,17,0,8857,A
5-NP,1049,1,1,0,8852,8854,C
5-NP,1050,8854,0,1,0,8855,A
5-NP,1051,8865,2,0,1,8868,A
5-NP,1052,8863,0,3,0,8866,A
5-NP,1053,8856,3,6,0,8865,A
5-NP,1054,0,0,8889,1,8890,G
5-NP,1055,0,8621,0,1,8622,T
5-NP,1056,8570,1,1,0,8572,A
5-NP,1057,3,8521,1,5,8530,T
5-NP,1058,2,2,0,8513,8517,C
5-NP,1059,2,8431,1,9,8443,T
5-NP,1060,2,2,0,8459,8463,C
5-NP,1061,3,0,1,8382,8386,C
5-NP,1062,2,8303,0,1,8306,T
5-NP,1063,1,2,0,8255,8258,C
5-NP,1064,2,2,8244,0,8248,G
5-NP,1065,1,1,8248,0,8250,G
5-NP,1066,4,6,8240,1,8251,G
5-NP,1067,1,2,8207,1,8211,G
5-NP,1068,5,0,8188,0,8193,G
5-NP,1069,8048,0,0,0,8048,A
5-NP,1070,8045,1,1,1,8048,A
5-NP,1071,8047,3,4,0,8054,A
5-NP,1072,0,1,0,8078,8079,C
5-NP,1073,0,8026,1,5,8032,T
5-NP,1074,1,0,8064,1,8066,G
5-NP,1075,3,7966,1,4,7974,T
5-NP,1076,2,2,0,7980,7984,C
5-NP,1077,8044,0,2,0,8046,A
5-NP,1078,8074,1,2,0,8077,A
5-NP,1079,0,0,0,8088,8088,C
5-NP,1080,0,8071,0,1,8072,T
5-NP,1081,7877,0,1,0,7878,A
5-NP,1082,0,0,7895,0,7895,G
5-NP,1083,7702,3,5,0,7710,A
5-NP,1084,1,0,7717,0,7718,G
5-NP,1085,1,0,7678,1,7680,G
5-NP,1086,7170,0,6,0,7176,A
5-NP,1087,0,0,7242,0,7242,G
5-NP,1088,0,7129,1,3,7133,T
5-NP,1089,7138,0,1,0,7139,A
5-NP,1090,0,1,0,7134,7135,C
5-NP,1091,7027,1,1,0,7029,A
5-NP,1092,7025,0,1,0,7026,A
5-NP,1093,6946,0,3,0,6949,A
5-NP,1094,3,6861,0,0,6864,T
5-NP,1095,2,6813,0,1,6816,T
5-NP,1096,2,1,6546,0,6549,G
5-NP,1097,0,1,0,6438,6439,C
5-NP,1098,2,6390,1,8,6401,T
5-NP,1099,2,6389,0,3,6394,T
5-NP,1100,3,0,1,6396,6400,C
5-NP,1101,6394,1,3,0,6398,A
5-NP,1102,6395,1,0,0,6396,A
5-NP,1103,6398,0,0,1,6399,A
5-NP,1104,1,6401,0,0,6402,T
5-NP,1105,0,0,6399,0,6399,G
5-NP,1106,6275,1,5,0,6281,A
5-NP,1107,0,1,6287,0,6288,G
5-NP,1108,6291,0,5,0,6296,A
5-NP,1109,6278,0,2,0,6280,A
5-NP,1110,3,1,0,6257,6261,C
5-NP,1111,6161,2,3,0,6166,A
5-NP,1112,1,6156,0,1,6158,T
5-NP,1113,1,2,6165,0,6168,G
5-NP,1114,2,0,6176,0,6178,G
5-NP,1115,6172,0,2,0,6174,A
5-NP,1116,0,5985,0,2,5987,T
5-NP,1117,5886,0,1,0,5887,A
5-NP,1118,5990,1,0,1,5992,A
5-NP,1119,0,5824,0,1,5825,T
5-NP,1120,5762,2,0,0,5764,A
5-NP,1121,2,5719,0,1,5722,T
5-NP,1122,0,2,5180,0,5182,G
5-NP,1123,1,1,5009,0,5011,G
5-NP,1124,2,2,4984,0,4988,G
5-NP,1125,4979,0,1,1,4981,A
5-NP,1126,2,4966,1,1,4970,T
5-NP,1127,1,0,0,3936,3937,C
5-NP,1128,3887,0,0,1,3888,A
5-NP,1129,3898,0,2,2,3902,A
5-NP,1130,0,1,3894,0,3895,G
5-NP,1131,0,0,0,3897,3897,C
5-NP,1132,3748,1,1,1,3751,A
5-NP,1133,1,1,0,3761,3763,C
5-NP,1134,0,3648,0,0,3648,T
5-NP,1135,0,0,0,3662,3662,C
5-NP,1136,0,3642,2,2,3646,T
5-NP,1137,1,3595,0,1,3597,T
5-NP,1138,1,0,3594,0,3595,G
5-NP,1139,3552,0,6,1,3559,A
5-NP,1140,3563,0,2,0,3565,A
5-NP,1141,1,1,0,3557,3559,C
5-NP,1142,0,2620,0,0,2620,T
5-NP,1143,1,1,2633,0,2635,G
5-NP,1144,2491,0,1,1,2493,A
5-NP,1145,0,0,2495,0,2495,G
5-NP,1146,2493,0,2,0,2495,A
5-NP,1147,2411,1,1,0,2413,A
5-NP,1148,0,0,2420,0,2420,G
5-NP,1149,0,0,0,2286,2286,C
5-NP,1150,2,1,2273,0,2276,G
5-NP,1151,2,0,2272,0,2274,G
5-NP,1152,1,1,2170,0,2172,G
5-NP,1153,0,2129,0,0,2129,T
5-NP,1154,2046,0,0,0,2046,A
5-NP,1155,0,1,0,2033,2034,C
5-NP,1156,1,1316,0,0,1317,T
5-NP,1157,0,0,1268,0,1268,G
5-NP,1158,0,0,1186,0,1186,G
5-NP,1159,2,0,1138,1,1141,G
5-NP,1160,0,0,0,1111,1111,C
5-NP,1161,0,0,0,935,935,C
5-NP,1162,935,0,0,0,935,A
5-NP,1163,0,934,0,0,934,T
5-NP,1164,932,0,0,0,932,A
5-NP,1165,931,0,1,0,932,A
5-NP,1166,1,0,918,0,919,G
5-NP,1167,0,0,936,0,936,G
5-NP,1168,920,0,0,0,920,A
5-NP,1169,0,0,0,918,918,C
5-NP,1170,0,0,0,923,923,C
5-NP,1171,916,0,0,0,916,A
5-NP,1172,0,0,944,0,944,G
5-NP,1173,0,0,949,1,950,G
5-NP,1174,942,1,0,0,943,A
5-NP,1175,0,0,950,0,950,G
5-NP,1176,1,911,0,0,912,T
5-NP,1177,0,0,919,0,919,G
5-NP,1178,0,0,930,0,930,G
5-NP,1179,929,0,1,0,930,A
5-NP,1180,0,0,927,0,927,G
5-NP,1181,0,0,908,1,909,G
5-NP,1182,900,0,0,0,900,A
5-NP,1183,902,0,0,0,902,A
5-NP,1184,894,0,1,0,895,A
5-NP,1185,1,0,0,901,902,C
5-NP,1186,898,0,0,0,898,A
5-NP,1187,0,0,0,906,906,C
5-NP,1188,0,890,0,0,890,T
5-NP,1189,910,0,0,0,910,A
5-NP,1190,913,0,0,0,913,A
5-NP,1191,0,910,0,0,910,T
5-NP,1192,1,0,0,912,913,C
5-NP,1193,903,0,1,0,904,A
5-NP,1194,918,0,0,0,918,A
5-NP,1195,0,0,0,924,924,C
5-NP,1196,892,0,0,0,892,A
5-NP,1197,1,1,893,0,895,G
5-NP,1198,874,0,0,0,874,A
5-NP,1199,0,1,875,0,876,G
5-NP,1200,0,0,877,0,877,G
5-NP,1201,0,0,864,0,864,G
5-NP,1202,0,0,0,864,864,C
5-NP,1203,0,0,0,863,863,C
5-NP,1204,0,852,1,0,853,T
5-NP,1205,1,0,0,863,864,C
5-NP,1206,0,1,0,862,863,C
5-NP,1207,0,0,866,0,866,G
5-NP,1208,1,0,0,864,865,C
5-NP,1209,855,0,1,0,856,A
5-NP,1210,0,0,906,0,906,G
5-NP,1211,0,0,906,0,906,G
5-NP,1212,0,0,0,907,907,C
5-NP,1213,0,0,0,907,907,C
5-NP,1214,899,0,0,0,899,A
5-NP,1215,903,0,0,0,903,A
5-NP,1216,905,0,0,0,905,A
5-NP,1217,0,0,0,914,914,C
5-NP,1218,0,0,0,916,916,C
5-NP,1219,864,0,0,0,864,A
5-NP,1220,0,0,880,0,880,G
5-NP,1221,0,869,0,0,869,T
5-NP,1222,0,0,866,0,866,G
5-NP,1223,0,866,0,0,866,T
5-NP,1224,0,0,860,0,860,G
5-NP,1225,0,0,0,865,865,C
5-NP,1226,861,0,0,0,861,A
5-NP,1227,869,1,0,0,870,A
5-NP,1228,0,0,0,869,869,C
5-NP,1229,1,0,0,865,866,C
5-NP,1230,0,854,0,1,855,T
5-NP,1231,855,0,1,0,856,A
5-NP,1232,0,0,0,860,860,C
5-NP,1233,0,0,861,0,861,G
5-NP,1234,0,856,0,0,856,T
5-NP,1235,0,865,0,1,866,T
5-NP,1236,0,859,0,1,860,T
5-NP,1237,1,854,0,1,856,T
5-NP,1238,0,0,0,858,858,C
5-NP,1239,0,851,0,0,851,T
5-NP,1240,0,0,877,0,877,G
5-NP,1241,1,875,0,0,876,T
5-NP,1242,877,0,0,0,877,A
5-NP,1243,0,0,0,886,886,C
5-NP,1244,870,0,0,0,870,A
5-NP,1245,871,0,1,0,872,A
5-NP,1246,873,0,0,0,873,A
5-NP,1247,0,0,876,0,876,G
5-NP,1248,871,0,0,0,871,A
5-NP,1249,856,1,0,0,857,A
5-NP,1250,855,0,0,0,855,A
5-NP,1251,1,0,0,854,855,C
5-NP,1252,0,0,0,846,846,C
5-NP,1253,0,844,0,1,845,T
5-NP,1254,0,0,0,846,846,C
5-NP,1255,0,0,0,846,846,C
5-NP,1256,0,0,0,847,847,C
5-NP,1257,846,0,0,0,846,A
5-NP,1258,0,847,0,0,847,T
5-NP,1259,0,848,0,0,848,T
5-NP,1260,0,850,0,0,850,T
5-NP,1261,0,0,848,0,848,G
5-NP,1262,847,1,0,0,848,A
5-NP,1263,845,0,0,0,845,A
5-NP,1264,847,0,1,0,848,A
5-NP,1265,843,0,0,0,843,A
5-NP,1266,0,0,853,0,853,G
5-NP,1267,0,851,0,0,851,T
5-NP,1268,0,0,0,850,850,C
5-NP,1269,853,0,0,0,853,A
5-NP,1270,856,0,0,1,857,A
5-NP,1271,1,0,0,856,857,C
5-NP,1272,0,0,0,860,860,C
5-NP,1273,860,1,0,0,861,A
5-NP,1274,0,860,0,2,862,T
5-NP,1275,0,0,0,854,854,C
5-NP,1276,847,0,0,0,847,A
5-NP,1277,1,849,0,0,850,T
5-NP,1278,1,0,848,0,849,G
5-NP,1279,0,0,851,0,851,G
5-NP,1280,0,1,0,850,851,C
5-NP,1281,833,0,0,0,833,A
5-NP,1282,0,0,834,0,834,G
5-NP,1283,0,0,0,823,823,C
5-NP,1284,820,1,1,0,822,A
5-NP,1285,0,823,0,0,823,T
5-NP,1286,0,808,0,1,809,T
5-NP,1287,0,0,0,817,817,C
5-NP,1288,811,0,2,0,813,A
5-NP,1289,0,1,0,817,818,C
5-NP,1290,0,816,0,1,817,T
5-NP,1291,0,0,821,0,821,G
5-NP,1292,0,0,830,0,830,G
5-NP,1293,828,0,0,0,828,A
5-NP,1294,828,0,0,0,828,A
5-NP,1295,831,0,0,0,831,A
5-NP,1296,0,824,0,0,824,T
5-NP,1297,817,0,5,0,822,A
5-NP,1298,0,0,0,818,818,C
5-NP,1299,0,0,810,0,810,G
5-NP,1300,0,0,814,0,814,G
5-NP,1301,788,0,0,0,788,A
5-NP,1302,0,1,797,0,798,G
5-NP,1303,1,0,797,0,798,G
5-NP,1304,0,0,801,0,801,G
5-NP,1305,799,0,1,0,800,A
5-NP,1306,799,0,0,0,799,A
5-NP,1307,0,0,797,0,797,G
5-NP,1308,795,0,0,0,795,A
5-NP,1309,793,0,0,0,793,A
5-NP,1310,0,1,0,802,803,C
5-NP,1311,0,783,1,0,784,T
5-NP,1312,0,792,0,2,794,T
5-NP,1313,0,0,0,795,795,C
5-NP,1314,795,0,1,0,796,A
5-NP,1315,0,0,799,0,799,G
5-NP,1316,794,0,0,0,794,A
5-NP,1317,0,0,0,794,794,C
5-NP,1318,792,0,1,0,793,A
5-NP,1319,0,779,0,0,779,T
5-NP,1320,0,0,779,0,779,G
5-NP,1321,771,0,0,0,771,A
5-NP,1322,0,0,774,0,774,G
5-NP,1323,0,0,770,0,770,G
5-NP,1324,0,0,765,0,765,G
5-NP,1325,0,0,0,764,764,C
5-NP,1326,755,0,3,0,758,A
5-NP,1327,0,0,758,0,758,G
5-NP,1328,755,1,1,0,757,A
5-NP,1329,760,0,0,0,760,A
5-NP,1330,760,0,0,0,760,A
5-NP,1331,0,750,0,0,750,T
5-NP,1332,0,0,0,750,750,C
5-NP,1333,744,0,0,0,744,A
5-NP,1334,0,744,1,0,745,T
5-NP,1335,750,0,0,0,750,A
5-NP,1336,743,0,0,0,743,A
5-NP,1337,1,0,748,0,749,G
5-NP,1338,737,0,0,0,737,A
5-NP,1339,749,0,0,0,749,A
5-NP,1340,0,739,0,0,739,T
5-NP,1341,0,0,743,0,743,G
5-NP,1342,741,0,0,0,741,A
5-NP,1343,0,739,0,0,739,T
5-NP,1344,0,0,738,0,738,G
5-NP,1345,0,0,738,0,738,G
5-NP,1346,714,0,0,0,714,A
5-NP,1347,707,0,0,0,707,A
5-NP,1348,0,0,692,0,692,G
5-NP,1349,0,0,696,0,696,G
5-NP,1350,0,686,0,1,687,T
5-NP,1351,2,0,685,0,687,G
5-NP,1352,0,0,0,689,689,C
5-NP,1353,687,0,0,0,687,A
5-NP,1354,687,0,0,0,687,A
5-NP,1355,683,0,0,0,683,A
5-NP,1356,692,0,0,0,692,A
5-NP,1357,0,0,0,691,691,C
5-NP,1358,0,0,0,680,680,C
5-NP,1359,670,0,0,0,670,A
5-NP,1360,0,0,674,0,674,G
5-NP,1361,672,0,0,0,672,A
5-NP,1362,671,0,0,0,671,A
5-NP,1363,1,0,673,0,674,G
5-NP,1364,672,0,0,0,672,A
5-NP,1365,650,0,1,0,651,A
5-NP,1366,0,0,654,0,654,G
5-NP,1367,0,650,0,0,650,T
5-NP,1368,2,0,653,0,655,G
5-NP,1369,0,645,1,0,646,T
5-NP,1370,0,0,0,653,653,C
5-NP,1371,652,0,0,0,652,A
5-NP,1372,0,652,0,0,652,T
5-NP,1373,0,649,1,0,650,T
5-NP,1374,0,0,1,654,655,C
5-NP,1375,0,0,0,640,640,C
5-NP,1376,0,0,642,0,642,G
5-NP,1377,0,0,645,0,645,G
5-NP,1378,0,0,644,0,644,G
5-NP,1379,0,0,645,1,646,G
5-NP,1380,0,0,645,0,645,G
5-NP,1381,620,0,0,0,620,A
5-NP,1382,0,0,618,0,618,G
5-NP,1383,0,1,617,0,618,G
5-NP,1384,0,0,618,0,618,G
5-NP,1385,0,0,617,0,617,G
5-NP,1386,614,0,1,0,615,A
5-NP,1387,0,0,617,0,617,G
5-NP,1388,0,608,0,0,608,T
5-NP,1389,0,607,0,0,607,T
5-NP,1390,0,611,0,0,611,T
5-NP,1391,0,609,0,0,609,T
5-NP,1392,0,0,0,607,607,C
5-NP,1393,0,0,605,0,605,G
5-NP,1394,600,0,0,0,600,A
5-NP,1395,0,0,602,0,602,G
5-NP,1396,0,0,0,592,592,C
5-NP,1397,0,586,0,2,588,T
5-NP,1398,0,0,0,591,591,C
5-NP,1399,0,581,1,1,583,T
5-NP,1400,0,0,0,588,588,C
5-NP,1401,590,0,0,0,590,A
5-NP,1402,0,0,592,0,592,G
5-NP,1403,588,0,0,0,588,A
5-NP,1404,0,0,0,581,581,C
5-NP,1405,0,0,582,0,582,G
5-NP,1406,571,0,0,1,572,A
5-NP,1407,0,0,566,0,566,G
5-NP,1408,558,0,0,0,558,A
5-NP,1409,553,0,0,0,553,A
5-NP,1410,0,1,550,0,551,G
5-NP,1411,0,0,546,0,546,G
5-NP,1412,1,0,0,541,542,C
5-NP,1413,540,0,0,0,540,A
5-NP,1414,542,0,0,0,542,A
5-NP,1415,0,0,0,540,540,C
5-NP,1416,0,0,535,1,536,G
5-NP,1417,537,0,1,0,538,A
5-NP,1418,536,0,2,0,538,A
5-NP,1419,0,0,0,536,536,C
5-NP,1420,0,0,0,528,528,C
5-NP,1421,1,0,0,521,522,C
5-NP,1422,0,0,523,0,523,G
5-NP,1423,521,0,1,0,522,A
5-NP,1424,0,522,0,0,522,T
5-NP,1425,0,0,0,508,508,C
5-NP,1426,0,0,510,0,510,G
5-NP,1427,0,502,0,0,502,T
5-NP,1428,0,0,500,0,500,G
5-NP,1429,0,0,0,500,500,C
5-NP,1430,0,0,0,503,503,C
5-NP,1431,0,0,0,503,503,C
5-NP,1432,0,491,0,1,492,T
5-NP,1433,0,2,0,506,508,C
5-NP,1434,0,506,0,0,506,T
5-NP,1435,0,505,0,0,505,T
5-NP,1436,2,501,0,1,504,T
5-NP,1437,0,497,0,0,497,T
5-NP,1438,0,0,495,0,495,G
5-NP,1439,497,0,0,0,497,A
5-NP,1440,0,489,0,0,489,T
5-NP,1441,489,0,0,0,489,A
5-NP,1442,1,401,0,0,402,T
5-NP,1443,0,1,405,0,406,G
5-NP,1444,402,0,0,1,403,A
5-NP,1445,0,0,405,0,405,G
5-NP,1446,0,404,0,0,404,T
5-NP,1447,392,0,0,0,392,A
5-NP,1448,393,0,1,0,394,A
5-NP,1449,0,390,0,0,390,T
5-NP,1450,0,1,389,0,390,G
5-NP,1451,389,0,0,0,389,A
5-NP,1452,339,0,0,0,339,A
5-NP,1453,0,1,336,0,337,G
5-NP,1454,0,1,318,0,319,G
5-NP,1455,315,0,0,0,315,A
5-NP,1456,0,310,0,0,310,T
5-NP,1457,0,0,0,314,314,C
5-NP,1458,0,306,0,0,306,T
5-NP,1459,0,306,0,0,306,T
5-NP,1460,307,0,0,1,308,A
5-NP,1461,0,307,0,0,307,T
5-NP,1462,0,302,0,0,302,T
5-NP,1463,0,297,0,0,297,T
5-NP,1464,0,0,0,284,284,C
5-NP,1465,0,280,0,0,280,T
5-NP,1466,0,280,0,0,280,T
5-NP,1467,0,0,0,281,281,C
5-NP,1468,0,0,278,0,278,G
5-NP,1469,0,0,277,0,277,G
5-NP,1470,279,0,0,1,280,A
5-NP,1471,0,0,279,0,279,G
5-NP,1472,277,0,0,1,278,A
5-NP,1473,0,0,0,275,275,C
5-NP,1474,255,0,0,0,255,A
5-NP,1475,254,0,0,0,254,A
5-NP,1476,0,253,0,0,253,T
5-NP,1477,0,1,253,0,254,G
5-NP,1478,0,0,0,254,254,C
5-NP,1479,248,0,0,0,248,A
5-NP,1480,0,0,248,0,248,G
5-NP,1481,247,0,0,0,247,A
5-NP,1482,234,0,1,0,235,A
5-NP,1483,0,0,235,0,235,G
5-NP,1484,130,0,0,0,130,A
5-NP,1485,0,0,130,0,130,G
5-NP,1486,0,123,0,0,123,T
5-NP,1487,121,0,0,0,121,A
5-NP,1488,0,0,0,121,121,C
5-NP,1489,0,0,112,0,112,G
5-NP,1490,112,0,0,0,112,A
5-NP,1491,0,0,0,110,110,C
5-NP,1492,72,0,0,0,72,A
5-NP,1493,70,1,0,0,71,A
5-NP,1494,0,50,0,0,50,T
5-NP,1495,0,47,0,0,47,T
5-NP,1496,47,0,0,0,47,A
5-NP,1497,46,0,0,0,46,A
6-NA,1,8,0,0,0,8,A
6-NA,2,0,8,0,0,8,T
6-NA,3,0,0,8,0,8,G
6-NA,4,8,0,0,0,8,A
6-NA,5,9,0,0,0,9,A
6-NA,6,0,9,0,0,9,T
6-NA,7,0,0,0,9,9,C
6-NA,8,0,0,0,9,9,C
6-NA,9,9,0,0,0,9,A
6-NA,10,9,0,0,0,9,A
6-NA,11,9,0,0,0,9,A
6-NA,12,0,9,0,0,9,T
6-NA,13,0,0,0,9,9,C
6-NA,14,9,0,0,0,9,A
6-NA,15,9,0,0,0,9,A
6-NA,16,9,0,0,0,9,A
6-NA,17,9,0,0,0,9,A
6-NA,18,0,0,9,0,9,G
6-NA,19,9,0,0,0,9,A
6-NA,20,0,9,0,0,9,T
6-NA,21,9,0,0,0,9,A
6-NA,22,9,0,0,0,9,A
6-NA,23,0,10,0,0,10,T
6-NA,24,10,0,0,0,10,A
6-NA,25,11,0,0,0,11,A
6-NA,26,0,0,0,12,12,C
6-NA,27,0,0,12,0,12,G
6-NA,28,12,0,0,0,12,A
6-NA,29,0,12,0,0,12,T
6-NA,30,0,12,0,0,12,T
6-NA,31,0,0,12,0,12,G
6-NA,32,0,0,12,0,12,G
6-NA,33,0,0,0,12,12,C
6-NA,34,0,12,0,0,12,T
6-NA,35,0,0,0,13,13,C
6-NA,36,0,13,0,0,13,T
6-NA,37,0,0,13,0,13,G
6-NA,38,0,13,0,0,13,T
6-NA,39,0,13,0,0,13,T
6-NA,40,0,13,0,0,13,T
6-NA,41,0,0,0,13,13,C
6-NA,42,0,13,0,0,13,T
6-NA,43,0,0,0,13,13,C
6-NA,44,0,13,0,0,13,T
6-NA,45,0,0,0,13,13,C
6-NA,46,13,0,0,0,13,A
6-NA,47,0,0,0,15,15,C
6-NA,48,0,0,0,15,15,C
6-NA,49,15,0,0,0,15,A
6-NA,50,0,15,0,0,15,T
6-NA,51,0,17,0,0,17,T
6-NA,52,0,17,0,0,17,T
6-NA,53,0,0,0,17,17,C
6-NA,54,0,0,0,17,17,C
6-NA,55,17,0,0,0,17,A
6-NA,56,0,0,0,17,17,C
6-NA,57,17,0,0,0,17,A
6-NA,58,18,0,0,0,18,A
6-NA,59,0,18,0,0,18,T
6-NA,60,18,0,0,0,18,A
6-NA,61,0,18,0,0,18,T
6-NA,62,0,0,18,0,18,G
6-NA,63,0,0,0,19,19,C
6-NA,64,0,19,0,0,19,T
6-NA,65,0,19,0,0,19,T
6-NA,66,0,0,0,19,19,C
6-NA,67,0,19,0,0,19,T
6-NA,68,0,19,0,0,19,T
6-NA,69,0,0,0,19,19,C
6-NA,70,19,0,0,0,19,A
6-NA,71,0,21,0,0,21,T
6-NA,72,0,0,21,0,21,G
6-NA,73,0,0,0,21,21,C
6-NA,74,21,0,0,0,21,A
6-NA,75,21,0,0,0,21,A
6-NA,76,21,0,0,0,21,A
6-NA,77,0,24,0,0,24,T
6-NA,78,0,24,0,0,24,T
6-NA,79,0,0,24,0,24,G
6-NA,80,0,0,0,24,24,C
6-NA,81,0,0,0,24,24,C
6-NA,82,25,0,0,0,25,A
6-NA,83,0,25,0,0,25,T
6-NA,84,0,0,0,27,27,C
6-NA,85,0,27,0,0,27,T
6-NA,86,0,27,0,0,27,T
6-NA,87,0,0,28,0,28,G
6-NA,88,28,0,0,0,28,A
6-NA,89,0,29,0,0,29,T
6-NA,90,28,0,0,0,28,A
6-NA,91,29,0,0,0,29,A
6-NA,92,0,0,0,32,32,C
6-NA,93,0,33,0,0,33,T
6-NA,94,34,0,0,0,34,A
6-NA,95,0,0,0,35,35,C
6-NA,96,0,35,0,0,35,T
6-NA,97,0,0,35,0,35,G
6-NA,98,0,35,0,0,35,T
6-NA,99,34,0,1,0,35,A
6-NA,100,35,0,0,0,35,A
6-NA,101,0,0,0,34,34,C
6-NA,102,34,0,0,0,34,A
6-NA,103,0,34,0,0,34,T
6-NA,104,0,34,0,0,34,T
6-NA,105,0,0,34,0,34,G
6-NA,106,0,0,0,34,34,C
6-NA,107,34,0,0,0,34,A
6-NA,108,0,34,0,0,34,T
6-NA,109,0,34,0,0,34,T
6-NA,110,0,34,0,0,34,T
6-NA,111,0,0,0,34,34,C
6-NA,112,34,0,0,0,34,A
6-NA,113,33,0,1,0,34,A
6-NA,114,0,0,34,0,34,G
6-NA,115,0,0,0,34,34,C
6-NA,116,34,0,0,0,34,A
6-NA,117,36,0,0,0,36,A
6-NA,118,0,36,0,0,36,T
6-NA,119,36,0,0,0,36,A
6-NA,120,0,36,0,0,36,T
6-NA,121,0,0,38,0,38,G
6-NA,122,38,0,0,0,38,A
6-NA,123,38,0,0,0,38,A
6-NA,124,0,38,0,0,38,T
6-NA,125,0,38,0,0,38,T
6-NA,126,0,0,0,38,38,C
6-NA,127,37,0,0,0,37,A
6-NA,128,37,0,0,0,37,A
6-NA,129,0,0,0,37,37,C
6-NA,130,0,0,0,36,36,C
6-NA,131,0,0,0,38,38,C
6-NA,132,0,0,0,38,38,C
6-NA,133,0,0,0,40,40,C
6-NA,134,0,0,0,40,40,C
6-NA,135,0,0,0,39,39,C
6-NA,136,0,0,0,39,39,C
6-NA,137,0,0,0,40,40,C
6-NA,138,40,0,0,0,40,A
6-NA,139,40,0,0,0,40,A
6-NA,140,40,0,0,0,40,A
6-NA,141,0,0,0,41,41,C
6-NA,142,40,0,0,0,40,A
6-NA,143,41,0,0,0,41,A
6-NA,144,0,1,0,40,41,C
6-NA,145,0,0,0,41,41,C
6-NA,146,43,0,0,0,43,A
6-NA,147,42,0,0,0,42,A
6-NA,148,0,0,46,0,46,G
6-NA,149,0,46,0,0,46,T
6-NA,150,0,0,46,0,46,G
6-NA,151,47,0,0,0,47,A
6-NA,152,0,47,0,0,47,T
6-NA,153,0,0,47,0,47,G
6-NA,154,0,0,0,47,47,C
6-NA,155,0,46,0,0,46,T
6-NA,156,0,0,47,0,47,G
6-NA,157,0,46,0,0,46,T
6-NA,158,0,0,49,0,49,G
6-NA,159,0,49,0,0,49,T
6-NA,160,0,0,49,0,49,G
6-NA,161,49,0,0,0,49,A
6-NA,162,50,0,0,0,50,A
6-NA,163,0,0,0,49,49,C
6-NA,164,0,0,0,51,51,C
6-NA,165,52,0,0,0,52,A
6-NA,166,52,0,0,0,52,A
6-NA,167,0,0,0,55,55,C
6-NA,168,55,0,0,0,55,A
6-NA,169,54,0,0,0,54,A
6-NA,170,0,54,0,0,54,T
6-NA,171,55,0,0,0,55,A
6-NA,172,55,0,0,0,55,A
6-NA,173,0,55,0,0,55,T
6-NA,174,55,0,0,0,55,A
6-NA,175,0,0,55,0,55,G
6-NA,176,52,0,0,0,52,A
6-NA,177,54,0,0,0,54,A
6-NA,178,54,0,0,0,54,A
6-NA,179,0,0,54,0,54,G
6-NA,180,57,0,0,0,57,A
6-NA,181,57,0,0,0,57,A
6-NA,182,57,0,1,0,58,A
6-NA,183,0,0,0,57,57,C
6-NA,184,58,0,0,0,58,A
6-NA,185,0,58,0,0,58,T
6-NA,186,60,0,0,0,60,A
6-NA,187,60,0,0,0,60,A
6-NA,188,0,0,0,61,61,C
6-NA,189,61,0,0,0,61,A
6-NA,190,0,0,63,0,63,G
6-NA,191,63,0,0,0,63,A
6-NA,192,0,0,62,0,62,G
6-NA,193,60,0,0,0,60,A
6-NA,194,0,61,0,0,61,T
6-NA,195,61,0,0,0,61,A
6-NA,196,0,0,61,0,61,G
6-NA,197,0,61,0,0,61,T
6-NA,198,0,0,61,0,61,G
6-NA,199,0,61,0,0,61,T
6-NA,200,61,0,0,0,61,A
6-NA,201,0,61,0,0,61,T
6-NA,202,0,0,0,61,61,C
6-NA,203,0,61,0,0,61,T
6-NA,204,0,0,66,0,66,G
6-NA,205,65,0,1,0,66,A
6-NA,206,0,0,0,66,66,C
6-NA,207,0,0,0,66,66,C
6-NA,208,66,0,0,0,66,A
6-NA,209,66,0,0,0,66,A
6-NA,210,0,0,0,68,68,C
6-NA,211,68,0,0,0,68,A
6-NA,212,0,0,0,70,70,C
6-NA,213,0,0,0,70,70,C
6-NA,214,72,0,0,0,72,A
6-NA,215,0,0,0,73,73,C
6-NA,216,0,0,0,72,72,C
6-NA,217,72,0,1,0,73,A
6-NA,218,0,74,0,0,74,T
6-NA,219,73,0,0,0,73,A
6-NA,220,0,0,72,0,72,G
6-NA,221,73,0,0,0,73,A
6-NA,222,0,0,74,0,74,G
6-NA,223,73,0,0,0,73,A
6-NA,224,69,0,0,0,69,A
6-NA,225,0,0,68,0,68,G
6-NA,226,0,0,68,0,68,G
6-NA,227,69,0,0,0,69,A
6-NA,228,69,0,0,0,69,A
6-NA,229,70,0,0,0,70,A
6-NA,230,0,70,0,0,70,T
6-NA,231,70,0,0,0,70,A
6-NA,232,0,70,0,0,70,T
6-NA,233,0,0,70,0,70,G
6-NA,234,0,0,0,72,72,C
6-NA,235,0,0,0,72,72,C
6-NA,236,0,0,0,71,71,C
6-NA,237,0,0,0,70,70,C
6-NA,238,71,0,0,0,71,A
6-NA,239,73,0,0,0,73,A
6-NA,240,73,0,0,0,73,A
6-NA,241,0,0,0,72,72,C
6-NA,242,0,73,0,0,73,T
6-NA,243,72,0,0,0,72,A
6-NA,244,0,0,72,0,72,G
6-NA,245,0,0,0,72,72,C
6-NA,246,72,0,0,0,72,A
6-NA,247,0,0,73,0,73,G
6-NA,248,72,0,0,0,72,A
6-NA,249,72,0,0,0,72,A
6-NA,250,0,72,0,0,72,T
6-NA,251,72,0,0,0,72,A
6-NA,252,0,0,0,72,72,C
6-NA,253,72,0,0,0,72,A
6-NA,254,0,0,71,0,71,G
6-NA,255,72,0,0,0,72,A
6-NA,256,71,0,0,0,71,A
6-NA,257,71,0,0,0,71,A
6-NA,258,0,68,0,0,68,T
6-NA,259,0,69,0,0,69,T
6-NA,260,0,0,69,0,69,G
6-NA,261,0,0,69,0,69,G
6-NA,262,0,68,0,0,68,T
6-NA,263,0,0,0,68,68,C
6-NA,264,68,0,0,0,68,A
6-NA,265,68,0,0,0,68,A
6-NA,266,67,0,0,0,67,A
6-NA,267,0,0,68,0,68,G
6-NA,268,0,0,0,67,67,C
6-NA,269,0,0,0,69,69,C
6-NA,270,0,0,67,0,67,G
6-NA,271,0,0,0,69,69,C
6-NA,272,69,0,0,0,69,A
6-NA,273,71,0,0,0,71,A
6-NA,274,0,71,0,0,71,T
6-NA,275,0,0,71,0,71,G
6-NA,276,0,70,0,0,70,T
6-NA,277,0,0,70,0,70,G
6-NA,278,70,0,0,0,70,A
6-NA,279,0,0,0,71,71,C
6-NA,280,70,0,0,0,70,A
6-NA,281,0,68,0,0,68,T
6-NA,282,0,69,0,0,69,T
6-NA,283,70,0,0,0,70,A
6-NA,284,0,0,0,70,70,C
6-NA,285,70,0,0,0,70,A
6-NA,286,0,1,70,0,71,G
6-NA,287,0,0,71,0,71,G
6-NA,288,68,0,0,0,68,A
6-NA,289,0,70,0,0,70,T
6-NA,290,0,68,0,0,68,T
6-NA,291,0,67,0,0,67,T
6-NA,292,0,0,66,1,67,G
6-NA,293,0,0,0,66,66,C
6-NA,294,67,0,0,0,67,A
6-NA,295,0,0,0,67,67,C
6-NA,296,0,0,0,66,66,C
6-NA,297,0,66,0,0,66,T
6-NA,298,0,66,0,0,66,T
6-NA,299,0,66,0,0,66,T
6-NA,300,0,66,0,0,66,T
6-NA,301,0,68,0,0,68,T
6-NA,302,0,0,0,68,68,C
6-NA,303,0,68,0,0,68,T
6-NA,304,67,0,0,0,67,A
6-NA,305,67,0,0,0,67,A
6-NA,306,0,0,69,0,69,G
6-NA,307,0,0,69,0,69,G
6-NA,308,70,0,0,0,70,A
6-NA,309,0,0,0,71,71,C
6-NA,310,71,0,0,0,71,A
6-NA,311,72,0,0,0,72,A
6-NA,312,0,72,0,0,72,T
6-NA,313,0,72,0,0,72,T
6-NA,314,0,0,0,72,72,C
6-NA,315,0,0,72,0,72,G
6-NA,316,71,0,0,0,71,A
6-NA,317,0,73,0,0,73,T
6-NA,318,0,73,0,0,73,T
6-NA,319,73,0,0,0,73,A
6-NA,320,0,0,74,0,74,G
6-NA,321,0,1,73,0,74,G
6-NA,322,0,0,0,73,73,C
6-NA,323,0,73,0,0,73,T
6-NA,324,0,74,0,0,74,T
6-NA,325,0,74,0,0,74,T
6-NA,326,0,0,0,75,75,C
6-NA,327,0,0,0,75,75,C
6-NA,328,0,0,75,0,75,G
6-NA,329,0,0,0,74,74,C
6-NA,330,0,74,0,0,74,T
6-NA,331,0,0,75,0,75,G
6-NA,332,0,0,76,0,76,G
6-NA,333,0,76,0,0,76,T
6-NA,334,0,0,75,0,75,G
6-NA,335,0,0,76,0,76,G
6-NA,336,0,0,76,0,76,G
6-NA,337,0,0,76,0,76,G
6-NA,338,72,1,0,0,73,A
6-NA,339,0,0,0,77,77,C
6-NA,340,76,0,0,0,76,A
6-NA,341,0,77,0,0,77,T
6-NA,342,0,0,0,76,76,C
6-NA,343,0,73,0,0,73,T
6-NA,344,0,0,73,0,73,G
6-NA,345,0,0,73,0,73,G
6-NA,346,0,0,74,0,74,G
6-NA,347,0,73,0,1,74,T
6-NA,348,0,0,73,0,73,G
6-NA,349,72,0,0,0,72,A
6-NA,350,0,0,0,73,73,C
6-NA,351,73,0,0,0,73,A
6-NA,352,72,1,0,0,73,A
6-NA,353,0,0,73,0,73,G
6-NA,354,72,0,0,0,72,A
6-NA,355,0,0,77,0,77,G
6-NA,356,27,49,0,0,76,T
6-NA,357,81,0,0,0,81,A
6-NA,358,0,0,0,98,98,C
6-NA,359,0,0,0,99,99,C
6-NA,360,0,99,0,0,99,T
6-NA,361,0,99,0,0,99,T
6-NA,362,98,0,0,1,99,A
6-NA,363,0,101,0,0,101,T
6-NA,364,0,0,103,0,103,G
6-NA,365,0,102,0,0,102,T
6-NA,366,0,0,102,0,102,G
6-NA,367,0,99,0,0,99,T
6-NA,368,0,0,0,98,98,C
6-NA,369,99,0,1,0,100,A
6-NA,370,0,100,0,0,100,T
6-NA,371,0,0,100,0,100,G
6-NA,372,0,0,0,99,99,C
6-NA,373,0,2,95,0,97,G
6-NA,374,109,1,0,0,110,A
6-NA,375,0,110,0,0,110,T
6-NA,376,0,0,0,112,112,C
6-NA,377,0,1,0,111,112,C
6-NA,378,0,116,0,1,117,T
6-NA,379,0,0,116,0,116,G
6-NA,380,110,0,7,0,117,A
6-NA,381,0,0,0,116,116,C
6-NA,382,117,0,0,0,117,A
6-NA,383,115,0,0,0,115,A
6-NA,384,0,0,118,0,118,G
6-NA,385,0,118,0,0,118,T
6-NA,386,0,0,119,0,119,G
6-NA,387,0,120,0,0,120,T
6-NA,388,0,120,0,0,120,T
6-NA,389,120,0,0,0,120,A
6-NA,390,0,120,0,0,120,T
6-NA,391,0,0,0,123,123,C
6-NA,392,123,0,0,0,123,A
6-NA,393,123,0,0,0,123,A
6-NA,394,0,122,0,0,122,T
6-NA,395,0,120,0,0,120,T
6-NA,396,0,121,0,0,121,T
6-NA,397,0,0,120,0,120,G
6-NA,398,0,0,0,124,124,C
6-NA,399,0,0,0,122,122,C
6-NA,400,0,0,0,122,122,C
6-NA,401,0,123,0,0,123,T
6-NA,402,0,123,0,0,123,T
6-NA,403,0,0,124,0,124,G
6-NA,404,0,0,125,0,125,G
6-NA,405,125,0,0,0,125,A
6-NA,406,0,0,0,125,125,C
6-NA,407,121,0,0,0,121,A
6-NA,408,0,0,123,0,123,G
6-NA,409,0,0,123,0,123,G
6-NA,410,0,0,129,0,129,G
6-NA,411,129,0,0,0,129,A
6-NA,412,128,0,0,0,128,A
6-NA,413,0,0,0,128,128,C
6-NA,414,130,0,0,0,130,A
6-NA,415,142,0,0,0,142,A
6-NA,416,0,0,0,142,142,C
6-NA,417,144,0,0,0,144,A
6-NA,418,0,0,0,143,143,C
6-NA,419,0,142,0,0,142,T
6-NA,420,142,0,0,0,142,A
6-NA,421,143,0,0,0,143,A
6-NA,422,144,0,0,0,144,A
6-NA,423,0,0,0,144,144,C
6-NA,424,141,0,0,0,141,A
6-NA,425,140,0,0,0,140,A
6-NA,426,0,0,0,141,141,C
6-NA,427,0,0,142,0,142,G
6-NA,428,0,142,0,0,142,T
6-NA,429,0,0,142,0,142,G
6-NA,430,0,0,0,143,143,C
6-NA,431,141,1,0,0,142,A
6-NA,432,0,142,0,0,142,T
6-NA,433,0,144,0,0,144,T
6-NA,434,0,0,0,148,148,C
6-NA,435,152,0,0,0,152,A
6-NA,436,154,0,0,0,154,A
6-NA,437,153,0,0,0,153,A
6-NA,438,0,154,0,0,154,T
6-NA,439,153,0,0,0,153,A
6-NA,440,155,0,0,0,155,A
6-NA,441,0,0,0,157,157,C
6-NA,442,157,0,0,0,157,A
6-NA,443,0,0,0,158,158,C
6-NA,444,152,0,1,0,153,A
6-NA,445,0,0,179,0,179,G
6-NA,446,0,179,0,0,179,T
6-NA,447,182,0,0,0,182,A
6-NA,448,0,1,0,181,182,C
6-NA,449,0,0,182,0,182,G
6-NA,450,0,188,0,0,188,T
6-NA,451,0,0,189,0,189,G
6-NA,452,190,0,0,0,190,A
6-NA,453,0,192,0,0,192,T
6-NA,454,174,0,0,0,174,A
6-NA,455,0,0,172,0,172,G
6-NA,456,0,0,175,0,175,G
6-NA,457,174,1,0,0,175,A
6-NA,458,0,0,0,179,179,C
6-NA,459,0,0,0,170,170,C
6-NA,460,0,0,0,172,172,C
6-NA,461,1,0,0,172,173,C
6-NA,462,0,175,0,0,175,T
6-NA,463,0,177,0,0,177,T
6-NA,464,177,0,0,0,177,A
6-NA,465,0,173,0,0,173,T
6-NA,466,0,0,0,174,174,C
6-NA,467,0,0,174,0,174,G
6-NA,468,0,0,173,0,173,G
6-NA,469,172,0,0,0,172,A
6-NA,470,0,0,0,175,175,C
6-NA,471,0,0,0,178,178,C
6-NA,472,0,0,0,185,185,C
6-NA,473,0,186,0,0,186,T
6-NA,474,191,0,0,0,191,A
6-NA,475,0,189,0,0,189,T
6-NA,476,0,192,0,0,192,T
6-NA,477,0,0,192,0,192,G
6-NA,478,192,1,0,0,193,A
6-NA,479,0,194,0,0,194,T
6-NA,480,0,0,197,0,197,G
6-NA,481,195,0,0,0,195,A
6-NA,482,196,0,1,0,197,A
6-NA,483,0,197,0,0,197,T
6-NA,484,0,0,202,0,202,G
6-NA,485,209,0,0,0,209,A
6-NA,486,1,0,209,0,210,G
6-NA,487,0,210,0,0,210,T
6-NA,488,0,210,0,0,210,T
6-NA,489,209,0,0,0,209,A
6-NA,490,0,0,210,0,210,G
6-NA,491,0,0,210,0,210,G
6-NA,492,0,211,0,0,211,T
6-NA,493,0,0,213,0,213,G
6-NA,494,0,207,0,0,207,T
6-NA,495,0,207,0,0,207,T
6-NA,496,0,0,0,210,210,C
6-NA,497,0,0,0,214,214,C
6-NA,498,0,213,0,1,214,T
6-NA,499,0,213,0,0,213,T
6-NA,500,0,215,0,0,215,T
6-NA,501,0,214,0,0,214,T
6-NA,502,0,0,0,215,215,C
6-NA,503,214,0,0,0,214,A
6-NA,504,0,219,0,1,220,T
6-NA,505,0,0,0,219,219,C
6-NA,506,0,219,0,0,219,T
6-NA,507,0,0,220,0,220,G
6-NA,508,0,0,219,0,219,G
6-NA,509,0,0,219,0,219,G
6-NA,510,0,0,223,0,223,G
6-NA,511,222,0,0,0,222,A
6-NA,512,0,0,0,222,222,C
6-NA,513,0,0,0,221,221,C
6-NA,514,222,0,0,0,222,A
6-NA,515,225,0,0,0,225,A
6-NA,516,0,0,226,0,226,G
6-NA,517,1,0,0,223,224,C
6-NA,518,225,0,0,0,225,A
6-NA,519,225,0,0,0,225,A
6-NA,520,0,0,227,0,227,G
6-NA,521,0,224,0,0,224,T
6-NA,522,0,0,227,0,227,G
6-NA,523,0,224,0,0,224,T
6-NA,524,0,0,225,0,225,G
6-NA,525,0,0,0,223,223,C
6-NA,526,225,0,0,0,225,A
6-NA,527,0,225,0,0,225,T
6-NA,528,1,0,222,0,223,G
6-NA,529,0,0,231,0,231,G
6-NA,530,0,0,0,229,229,C
6-NA,531,231,0,0,0,231,A
6-NA,532,0,229,0,0,229,T
6-NA,533,0,0,229,0,229,G
6-NA,534,0,0,300,0,300,G
6-NA,535,0,301,0,0,301,T
6-NA,536,0,0,0,300,300,C
6-NA,537,0,0,0,323,323,C
6-NA,538,352,0,0,0,352,A
6-NA,539,0,1,438,0,439,G
6-NA,540,0,0,0,446,446,C
6-NA,541,0,446,0,0,446,T
6-NA,542,1,1,0,456,458,C
6-NA,543,458,0,0,0,458,A
6-NA,544,493,0,0,0,493,A
6-NA,545,0,0,503,0,503,G
6-NA,546,0,511,0,0,511,T
6-NA,547,0,510,0,0,510,T
6-NA,548,1,0,520,0,521,G
6-NA,549,0,519,0,2,521,T
6-NA,550,0,2,0,517,519,C
6-NA,551,521,0,0,0,521,A
6-NA,552,0,0,0,547,547,C
6-NA,553,0,0,547,0,547,G
6-NA,554,590,0,0,0,590,A
6-NA,555,0,593,0,0,593,T
6-NA,556,0,0,648,0,648,G
6-NA,557,1,0,662,1,664,G
6-NA,558,659,2,0,0,661,A
6-NA,559,664,0,1,0,665,A
6-NA,560,694,0,0,0,694,A
6-NA,561,702,0,0,0,702,A
6-NA,562,0,0,729,0,729,G
6-NA,563,0,0,0,731,731,C
6-NA,564,731,0,0,0,731,A
6-NA,565,0,737,0,0,737,T
6-NA,566,0,1,770,0,771,G
6-NA,567,0,0,797,0,797,G
6-NA,568,0,0,0,818,818,C
6-NA,569,0,815,0,2,817,T
6-NA,570,0,0,835,0,835,G
6-NA,571,0,1,0,835,836,C
6-NA,572,845,0,0,0,845,A
6-NA,573,0,929,0,0,929,T
6-NA,574,1,0,942,0,943,G
6-NA,575,0,973,0,3,976,T
6-NA,576,1,1019,0,0,1020,T
6-NA,577,0,1026,0,0,1026,T
6-NA,578,0,0,1172,0,1172,G
6-NA,579,0,1174,0,0,1174,T
6-NA,580,1174,1,1,0,1176,A
6-NA,581,0,1183,0,0,1183,T
6-NA,582,1189,0,1,0,1190,A
6-NA,583,1200,0,2,0,1202,A
6-NA,584,1,0,0,1198,1199,C
6-NA,585,0,0,1198,0,1198,G
6-NA,586,1,0,1207,1,1209,G
6-NA,587,0,1,1199,0,1200,G
6-NA,588,0,0,1207,0,1207,G
6-NA,589,0,1,1215,0,1216,G
6-NA,590,1210,0,2,0,1212,A
6-NA,591,0,1226,0,0,1226,T
6-NA,592,0,0,1242,0,1242,G
6-NA,593,1256,0,2,0,1258,A
6-NA,594,0,1264,0,0,1264,T
6-NA,595,1263,0,1,0,1264,A
6-NA,596,1297,0,0,0,1297,A
6-NA,597,1307,0,0,0,1307,A
6-NA,598,1310,0,0,3,1313,A
6-NA,599,1321,1,0,0,1322,A
6-NA,600,0,1319,0,0,1319,T
6-NA,601,0,0,1324,0,1324,G
6-NA,602,0,1,0,1326,1327,C
6-NA,603,1324,0,3,0,1327,A
6-NA,604,1337,1,0,0,1338,A
6-NA,605,0,0,0,1367,1367,C
6-NA,606,0,1369,0,0,1369,T
6-NA,607,0,1,1373,0,1374,G
6-NA,608,0,0,0,1374,1374,C
6-NA,609,0,1378,0,0,1378,T
6-NA,610,1384,0,1,0,1385,A
6-NA,611,0,1,1380,0,1381,G
6-NA,612,0,0,0,1413,1413,C
6-NA,613,1,1409,0,1,1411,T
6-NA,614,0,1421,0,0,1421,T
6-NA,615,0,0,0,1453,1453,C
6-NA,616,1459,2,2,0,1463,A
6-NA,617,1,1471,0,0,1472,T
6-NA,618,0,1474,0,0,1474,T
6-NA,619,0,1486,0,0,1486,T
6-NA,620,1502,0,0,0,1502,A
6-NA,621,0,0,0,1521,1521,C
6-NA,622,1521,1,0,0,1522,A
6-NA,623,1548,0,0,0,1548,A
6-NA,624,0,1551,1,0,1552,T
6-NA,625,0,2,1554,0,1556,G
6-NA,626,0,1,1558,0,1559,G
6-NA,627,0,0,1551,0,1551,G
6-NA,628,1552,1,1,0,1554,A
6-NA,629,0,0,1612,0,1612,G
6-NA,630,0,0,1639,0,1639,G
6-NA,631,0,0,0,1877,1877,C
6-NA,632,0,1874,0,2,1876,T
6-NA,633,0,1911,1,1,1913,T
6-NA,634,1,0,1933,0,1934,G
6-NA,635,1,1936,1,0,1938,T
6-NA,636,1979,1,2,0,1982,A
6-NA,637,0,0,2002,0,2002,G
6-NA,638,1968,1,1,0,1970,A
6-NA,639,0,1986,1,1,1988,T
6-NA,640,1912,1,0,0,1913,A
6-NA,641,0,0,1919,0,1919,G
6-NA,642,0,1900,0,0,1900,T
6-NA,643,18,1,1862,0,1881,G
6-NA,644,0,1997,0,0,1997,T
6-NA,645,0,1994,0,2,1996,T
6-NA,646,1,0,2037,0,2038,G
6-NA,647,0,2036,0,2,2038,T
6-NA,648,0,2044,1,1,2046,T
6-NA,649,0,2037,1,2,2040,T
6-NA,650,0,0,0,2032,2032,C
6-NA,651,2025,0,3,0,2028,A
6-NA,652,1,2027,0,0,2028,T
6-NA,653,0,1,2030,0,2031,G
6-NA,654,0,0,2231,0,2231,G
6-NA,655,0,2227,0,0,2227,T
6-NA,656,1,1,0,2234,2236,C
6-NA,657,0,0,0,2232,2232,C
6-NA,658,2235,1,1,0,2237,A
6-NA,659,2260,0,0,0,2260,A
6-NA,660,2258,1,0,0,2259,A
6-NA,661,0,0,2269,0,2269,G
6-NA,662,2258,0,0,1,2259,A
6-NA,663,2211,0,0,0,2211,A
6-NA,664,2218,0,0,0,2218,A
6-NA,665,1,2220,0,1,2222,T
6-NA,666,0,0,0,2310,2310,C
6-NA,667,1,0,0,2308,2309,C
6-NA,668,0,2302,0,3,2305,T
6-NA,669,0,0,0,2308,2308,C
6-NA,670,2302,0,3,0,2305,A
6-NA,671,0,0,2339,0,2339,G
6-NA,672,0,0,2341,0,2341,G
6-NA,673,2425,0,0,0,2425,A
6-NA,674,1,0,1,2437,2439,C
6-NA,675,2,0,0,2405,2407,C
6-NA,676,0,3,0,2409,2412,C
6-NA,677,2411,0,0,1,2412,A
6-NA,678,0,2,2417,0,2419,G
6-NA,679,0,2,2423,1,2426,G
6-NA,680,2437,2,3,0,2442,A
6-NA,681,1,0,2496,0,2497,G
6-NA,682,0,2460,1,2,2463,T
6-NA,683,0,1,0,2467,2468,C
6-NA,684,2472,1,2,0,2475,A
6-NA,685,1,2,2504,0,2507,G
6-NA,686,2500,0,3,0,2503,A
6-NA,687,2505,1,0,0,2506,A
6-NA,688,0,2490,0,3,2493,T
6-NA,689,1,1,2494,0,2496,G
6-NA,690,1,1,0,2520,2522,C
6-NA,691,2,0,2523,0,2525,G
6-NA,692,0,2521,0,0,2521,T
6-NA,693,0,1,0,2496,2497,C
6-NA,694,0,2547,0,0,2547,T
6-NA,695,1,1,2633,0,2635,G
6-NA,696,0,2646,0,1,2647,T
6-NA,697,2643,0,0,0,2643,A
6-NA,698,1,2647,0,0,2648,T
6-NA,699,2,1,0,2627,2630,C
6-NA,700,2629,1,0,0,2630,A
6-NA,701,2629,0,0,0,2629,A
6-NA,702,0,2626,0,1,2627,T
6-NA,703,2,0,2629,0,2631,G
6-NA,704,0,0,2638,0,2638,G
6-NA,705,2678,0,1,0,2679,A
6-NA,706,2679,1,4,0,2684,A
6-NA,707,1,1,0,2708,2710,C
6-NA,708,1,2737,0,1,2739,T
6-NA,709,0,2737,1,2,2740,T
6-NA,710,0,0,2834,0,2834,G
6-NA,711,1,2837,0,0,2838,T
6-NA,712,2832,2,2,1,2837,A
6-NA,713,0,0,1,2899,2900,C
6-NA,714,2849,1,1,1,2852,A
6-NA,715,0,1,3102,0,3103,G
6-NA,716,1,3085,0,0,3086,T
6-NA,717,3218,0,0,0,3218,A
6-NA,718,0,0,3238,1,3239,G
6-NA,719,0,3205,0,3,3208,T
6-NA,720,3209,0,0,0,3209,A
6-NA,721,3206,0,0,0,3206,A
6-NA,722,1,3195,0,1,3197,T
6-NA,723,1,0,3216,0,3217,G
6-NA,724,3183,0,2,0,3185,A
6-NA,725,0,1,0,3213,3214,C
6-NA,726,0,3153,0,1,3154,T
6-NA,727,0,1,3178,2,3181,G
6-NA,728,3179,1,2,2,3184,A
6-NA,729,0,3214,0,0,3214,T
6-NA,730,0,2,3212,0,3214,G
6-NA,731,0,2,3193,0,3195,G
6-NA,732,0,0,3222,0,3222,G
6-NA,733,3183,0,1,0,3184,A
6-NA,734,1,0,3185,2,3188,G
6-NA,735,1,3173,0,2,3176,T
6-NA,736,1,0,3255,0,3256,G
6-NA,737,1,0,0,3324,3325,C
6-NA,738,0,3320,0,1,3321,T
6-NA,739,0,3320,1,1,3322,T
6-NA,740,1,3,0,3311,3315,C
6-NA,741,3323,1,1,0,3325,A
6-NA,742,0,1,3328,0,3329,G
6-NA,743,3,1,3321,0,3325,G
6-NA,744,2,0,3194,0,3196,G
6-NA,745,3244,1,1,0,3246,A
6-NA,746,3243,0,2,0,3245,A
6-NA,747,3255,0,5,0,3260,A
6-NA,748,0,0,3306,1,3307,G
6-NA,749,1,2,0,3305,3308,C
6-NA,750,1,3294,0,0,3295,T
6-NA,751,0,5,3288,1,3294,G
6-NA,752,3294,0,0,0,3294,A
6-NA,753,0,3319,2,2,3323,T
6-NA,754,3330,0,1,1,3332,A
6-NA,755,0,0,0,3448,3448,C
6-NA,756,0,3436,0,0,3436,T
6-NA,757,3433,0,1,0,3434,A
6-NA,758,3428,0,0,1,3429,A
6-NA,759,3430,0,1,0,3431,A
6-NA,760,3518,0,2,1,3521,A
6-NA,761,0,3519,1,0,3520,T
6-NA,762,3515,0,5,1,3521,A
6-NA,763,2,0,0,3533,3535,C
6-NA,764,0,3438,0,1,3439,T
6-NA,765,3492,0,1,1,3494,A
6-NA,766,0,3487,1,1,3489,T
6-NA,767,0,3663,1,2,3666,T
6-NA,768,0,1,0,3696,3697,C
6-NA,769,3643,3,1,0,3647,A
6-NA,770,1,3641,1,2,3645,T
6-NA,771,0,3671,0,0,3671,T
6-NA,772,0,1,3680,0,3681,G
6-NA,773,3669,1,1,0,3671,A
6-NA,774,0,0,3673,0,3673,G
6-NA,775,0,0,3675,0,3675,G
6-NA,776,3552,1,0,3,3556,A
6-NA,777,1,1,3628,0,3630,G
6-NA,778,0,2,3628,0,3630,G
6-NA,779,2,3,3644,0,3649,G
6-NA,780,0,0,3654,0,3654,G
6-NA,781,3632,1,3,2,3638,A
6-NA,782,3643,1,4,1,3649,A
6-NA,783,3647,1,1,0,3649,A
6-NA,784,3636,1,1,1,3639,A
6-NA,785,1,3649,0,2,3652,T
6-NA,786,0,1,0,3636,3637,C
6-NA,787,1,1,3673,0,3675,G
6-NA,788,1,3665,0,1,3667,T
6-NA,789,1,3665,0,0,3666,T
6-NA,790,1,1,0,3673,3675,C
6-NA,791,3668,0,1,0,3669,A
6-NA,792,0,4003,0,0,4003,T
6-NA,793,3998,0,3,0,4001,A
6-NA,794,0,0,0,4029,4029,C
6-NA,795,1,4017,0,3,4021,T
6-NA,796,4025,1,5,0,4031,A
6-NA,797,2,0,4032,0,4034,G
6-NA,798,0,1,0,4033,4034,C
6-NA,799,4035,0,0,1,4036,A
6-NA,800,1,0,0,4072,4073,C
6-NA,801,3890,0,1,0,3891,A
6-NA,802,1,3957,0,1,3959,T
6-NA,803,2,3929,1,0,3932,T
6-NA,804,0,2,4246,0,4248,G
6-NA,805,2,4228,0,1,4231,T
6-NA,806,2,5,1,4226,4234,C
6-NA,807,4232,0,2,0,4234,A
6-NA,808,1,0,4237,0,4238,G
6-NA,809,1,0,4240,0,4241,G
6-NA,810,4234,2,1,0,4237,A
6-NA,811,4175,1,1,0,4177,A
6-NA,812,0,1,4236,0,4237,G
6-NA,813,0,4040,0,2,4042,T
6-NA,814,0,0,4072,0,4072,G
6-NA,815,0,0,0,4071,4071,C
6-NA,816,0,4064,1,2,4067,T
6-NA,817,0,0,0,4079,4079,C
6-NA,818,4066,1,2,0,4069,A
6-NA,819,0,1,4110,0,4111,G
6-NA,820,1,3,0,4109,4113,C
6-NA,821,4102,0,3,1,4106,A
6-NA,822,0,4109,0,2,4111,T
6-NA,823,0,0,4255,0,4255,G
6-NA,824,0,4268,0,1,4269,T
6-NA,825,0,1,0,4258,4259,C
6-NA,826,1,1,4259,0,4261,G
6-NA,827,4249,0,0,0,4249,A
6-NA,828,0,1,4235,0,4236,G
6-NA,829,9,1,4242,0,4252,G
6-NA,830,4210,0,2,0,4212,A
6-NA,831,0,1,4280,0,4281,G
6-NA,832,0,4180,0,2,4182,T
6-NA,833,2,0,4223,0,4225,G
6-NA,834,0,0,0,4274,4274,C
6-NA,835,2,4259,1,1,4263,T
6-NA,836,0,1,1,4267,4269,C
6-NA,837,0,4209,0,0,4209,T
6-NA,838,0,4260,0,2,4262,T
6-NA,839,2,1,4265,1,4269,G
6-NA,840,0,1,0,4268,4269,C
6-NA,841,0,4245,0,7,4252,T
6-NA,842,4253,0,1,1,4255,A
6-NA,843,0,4187,2,1,4190,T
6-NA,844,0,0,1,4230,4231,C
6-NA,845,1,1,0,4234,4236,C
6-NA,846,0,4237,1,0,4238,T
6-NA,847,1,1,2,4351,4355,C
6-NA,848,0,1,4366,0,4367,G
6-NA,849,4406,0,1,0,4407,A
6-NA,850,2,4406,0,3,4411,T
6-NA,851,4423,0,0,0,4423,A
6-NA,852,1,4409,0,3,4413,T
6-NA,853,1,0,2,4390,4393,C
6-NA,854,2,2,0,4393,4397,C
6-NA,855,2,4374,1,5,4382,T
6-NA,856,0,1,4353,0,4354,G
6-NA,857,2,2,4332,0,4336,G
6-NA,858,0,3,0,4318,4321,C
6-NA,859,0,0,4424,0,4424,G
6-NA,860,0,4447,0,1,4448,T
6-NA,861,0,1,0,4448,4449,C
6-NA,862,4456,1,1,1,4459,A
6-NA,863,0,0,4479,0,4479,G
6-NA,864,4461,0,2,0,4463,A
6-NA,865,1,4436,0,0,4437,T
6-NA,866,1,0,4454,0,4455,G
6-NA,867,2,4447,0,3,4452,T
6-NA,868,0,1,4461,0,4462,G
6-NA,869,0,4460,0,2,4462,T
6-NA,870,0,0,0,4509,4509,C
6-NA,871,5,4503,0,3,4511,T
6-NA,872,3,1,4532,0,4536,G
6-NA,873,0,1,1,4526,4528,C
6-NA,874,4524,1,2,1,4528,A
6-NA,875,444,1,4078,1,4524,G
6-NA,876,4454,2,3,0,4459,A
6-NA,877,1,0,4485,0,4486,G
6-NA,878,4485,2,4,0,4491,A
6-NA,879,1,1,0,4520,4522,C
6-NA,880,4499,0,1,0,4500,A
6-NA,881,4558,1,2,0,4561,A
6-NA,882,1,3,0,4620,4624,C
6-NA,883,0,4623,0,1,4624,T
6-NA,884,4,0,4628,0,4632,G
6-NA,885,1,1,4628,0,4630,G
6-NA,886,4612,0,0,1,4613,A
6-NA,887,4603,0,3,1,4607,A
6-NA,888,4527,0,4,0,4531,A
6-NA,889,0,1,4619,0,4620,G
6-NA,890,0,1,4612,0,4613,G
6-NA,891,0,2,0,4614,4616,C
6-NA,892,2,4593,0,5,4600,T
6-NA,893,2,1,2,4739,4744,C
6-NA,894,0,1,0,4804,4805,C
6-NA,895,4825,0,1,0,4826,A
6-NA,896,4822,3,0,0,4825,A
6-NA,897,1,4830,0,1,4832,T
6-NA,898,4704,0,2,0,4706,A
6-NA,899,3,0,4681,0,4684,G
6-NA,900,2,1,4681,0,4684,G
6-NA,901,3,3,1,4690,4697,C
6-NA,902,3,0,0,4622,4625,C
6-NA,903,0,0,1,4572,4573,C
6-NA,904,4657,1,1,0,4659,A
6-NA,905,0,4690,0,4,4694,T
6-NA,906,1,1,0,4697,4699,C
6-NA,907,0,0,4708,0,4708,G
6-NA,908,0,4692,0,1,4693,T
6-NA,909,4634,0,1,1,4636,A
6-NA,910,0,0,4752,0,4752,G
6-NA,911,4769,0,1,1,4771,A
6-NA,912,1,4803,0,0,4804,T
6-NA,913,4727,0,0,0,4727,A
6-NA,914,0,4686,0,0,4686,T
6-NA,915,4692,0,0,0,4692,A
6-NA,916,4692,0,1,1,4694,A
6-NA,917,4825,0,3,1,4829,A
6-NA,918,2,0,0,4989,4991,C
6-NA,919,4883,1,1,0,4885,A
6-NA,920,0,4890,0,0,4890,T
6-NA,921,4858,1,0,0,4859,A
6-NA,922,4859,1,1,2,4863,A
6-NA,923,4855,0,1,1,4857,A
6-NA,924,0,2,4917,0,4919,G
6-NA,925,1,2,4944,1,4948,G
6-NA,926,4786,2,43,0,4831,A
6-NA,927,1,4853,0,7,4861,T
6-NA,928,0,0,0,4876,4876,C
6-NA,929,4910,0,1,0,4911,A
6-NA,930,1,4923,1,1,4926,T
6-NA,931,4907,0,3,0,4910,A
6-NA,932,0,0,4956,0,4956,G
6-NA,933,0,1,0,4905,4906,C
6-NA,934,4834,2,2,0,4838,A
6-NA,935,1,4735,1,1,4738,T
6-NA,936,4,4747,1,1,4753,T
6-NA,937,0,0,4886,1,4887,G
6-NA,938,1,4883,1,2,4887,T
6-NA,939,0,4973,0,1,4974,T
6-NA,940,1,4968,1,1,4971,T
6-NA,941,1,0,0,4967,4968,C
6-NA,942,0,1,1,4988,4990,C
6-NA,943,5056,1,1,0,5058,A
6-NA,944,1,1,5121,0,5123,G
6-NA,945,2,5106,0,3,5111,T
6-NA,946,0,5011,0,3,5014,T
6-NA,947,5018,0,3,0,5021,A
6-NA,948,0,5002,1,0,5003,T
6-NA,949,2,0,5005,0,5007,G
6-NA,950,0,4985,0,2,4987,T
6-NA,951,1,0,5008,0,5009,G
6-NA,952,4,4930,0,0,4934,T
6-NA,953,0,0,5049,0,5049,G
6-NA,954,2,5036,0,3,5041,T
6-NA,955,1,5026,1,2,5030,T
6-NA,956,0,2,0,5031,5033,C
6-NA,957,4994,1,2,1,4998,A
6-NA,958,1,0,5028,0,5029,G
6-NA,959,0,0,5046,0,5046,G
6-NA,960,5008,0,1,0,5009,A
6-NA,961,3,0,0,5024,5027,C
6-NA,962,0,4907,0,2,4909,T
6-NA,963,0,4934,0,1,4935,T
6-NA,964,0,1,5192,0,5193,G
6-NA,965,0,5183,1,2,5186,T
6-NA,966,2,5180,0,3,5185,T
6-NA,967,1,2,5180,0,5183,G
6-NA,968,1,1,5200,0,5202,G
6-NA,969,5209,2,8,0,5219,A
6-NA,970,2,1,5271,1,5275,G
6-NA,971,5258,3,5,0,5266,A
6-NA,972,0,1,1,5266,5268,C
6-NA,973,5089,2,4,0,5095,A
6-NA,974,2,2,0,5118,5122,C
6-NA,975,5135,1,1,0,5137,A
6-NA,976,1,1,0,5158,5160,C
6-NA,977,3,1,0,5116,5120,C
6-NA,978,2,1,0,5140,5143,C
6-NA,979,5123,1,3,1,5128,A
6-NA,980,1,2,5156,0,5159,G
6-NA,981,5152,0,1,0,5153,A
6-NA,982,5176,0,2,0,5178,A
6-NA,983,5154,0,2,0,5156,A
6-NA,984,5145,1,0,0,5146,A
6-NA,985,5125,0,0,0,5125,A
6-NA,986,5130,0,1,1,5132,A
6-NA,987,0,1,0,5139,5140,C
6-NA,988,1,0,5142,1,5144,G
6-NA,989,5130,2,3,0,5135,A
6-NA,990,0,2,0,5132,5134,C
6-NA,991,5120,0,2,0,5122,A
6-NA,992,1,1,5167,0,5169,G
6-NA,993,1,1,0,5384,5386,C
6-NA,994,0,5367,0,1,5368,T
6-NA,995,3,1,0,5373,5377,C
6-NA,996,0,1,0,5398,5399,C
6-NA,997,5408,0,4,0,5412,A
6-NA,998,2,1,5466,0,5469,G
6-NA,999,2,1,0,5460,5463,C
6-NA,1000,5443,2,0,0,5445,A
6-NA,1001,0,0,5438,0,5438,G
6-NA,1002,0,5238,0,1,5239,T
6-NA,1003,5246,1,0,0,5247,A
6-NA,1004,1,1,5250,1,5253,G
6-NA,1005,1,1,0,5280,5282,C
6-NA,1006,1,0,0,5300,5301,C
6-NA,1007,5242,1,2,1,5246,A
6-NA,1008,1,5243,0,4,5248,T
6-NA,1009,2,5240,0,0,5242,T
6-NA,1010,0,0,5389,0,5389,G
6-NA,1011,2,5358,1,3,5364,T
6-NA,1012,1,5346,0,3,5350,T
6-NA,1013,10,5329,0,0,5339,T
6-NA,1014,0,0,5296,0,5296,G
6-NA,1015,4,1,5362,1,5368,G
6-NA,1016,5356,0,1,0,5357,A
6-NA,1017,1,5426,0,0,5427,T
6-NA,1018,2,0,0,5422,5424,C
6-NA,1019,0,0,1,5324,5325,C
6-NA,1020,11,5333,0,2,5346,T
6-NA,1021,5314,0,45,1,5360,A
6-NA,1022,5376,0,1,0,5377,A
6-NA,1023,0,3,0,5463,5466,C
6-NA,1024,5361,0,2,0,5363,A
6-NA,1025,5434,1,2,0,5437,A
6-NA,1026,0,5423,0,1,5424,T
6-NA,1027,0,2,5515,1,5518,G
6-NA,1028,5501,0,0,0,5501,A
6-NA,1029,5473,1,3,0,5477,A
6-NA,1030,0,0,5512,0,5512,G
6-NA,1031,5468,1,1,1,5471,A
6-NA,1032,5372,0,4,0,5376,A
6-NA,1033,2,1,5398,0,5401,G
6-NA,1034,2,0,5400,0,5402,G
6-NA,1035,0,5352,0,3,5355,T
6-NA,1036,3,0,5336,0,5339,G
6-NA,1037,3,1,5511,1,5516,G
6-NA,1038,3,5503,1,2,5509,T
6-NA,1039,1,1,1,5492,5495,C
6-NA,1040,5502,0,0,0,5502,A
6-NA,1041,0,5491,0,2,5493,T
6-NA,1042,0,4,5499,0,5503,G
6-NA,1043,0,2,5536,1,5539,G
6-NA,1044,5503,0,1,0,5504,A
6-NA,1045,1,2,5648,0,5651,G
6-NA,1046,1,5442,0,3,5446,T
6-NA,1047,1,0,5452,0,5453,G
6-NA,1048,5446,1,5,0,5452,A
6-NA,1049,5453,0,2,1,5456,A
6-NA,1050,5454,0,6,1,5461,A
6-NA,1051,0,1,5475,0,5476,G
6-NA,1052,0,0,5453,0,5453,G
6-NA,1053,0,3,0,5429,5432,C
6-NA,1054,0,5304,0,7,5311,T
6-NA,1055,1,0,5314,0,5315,G
6-NA,1056,0,1,5323,0,5324,G
6-NA,1057,4,1,5354,2,5361,G
6-NA,1058,5,2,1,5379,5387,C
6-NA,1059,2,0,0,5376,5378,C
6-NA,1060,1,5342,1,3,5347,T
6-NA,1061,0,5354,0,5,5359,T
6-NA,1062,0,5369,0,1,5370,T
6-NA,1063,3,1,5381,1,5386,G
6-NA,1064,5372,1,4,1,5378,A
6-NA,1065,3,5336,0,0,5339,T
6-NA,1066,2,1,5270,1,5274,G
6-NA,1067,5232,2,3,0,5237,A
6-NA,1068,0,5255,0,2,5257,T
6-NA,1069,0,2,5282,1,5285,G
6-NA,1070,3,0,5368,2,5373,G
6-NA,1071,5364,1,3,1,5369,A
6-NA,1072,5370,2,1,1,5374,A
6-NA,1073,5367,1,1,0,5369,A
6-NA,1074,0,4873,0,486,5359,T
6-NA,1075,2,2,5369,0,5373,G
6-NA,1076,5366,0,3,1,5370,A
6-NA,1077,0,1,0,5369,5370,C
6-NA,1078,2,0,5397,0,5399,G
6-NA,1079,0,5243,2,0,5245,T
6-NA,1080,1,1,5274,0,5276,G
6-NA,1081,0,5267,2,3,5272,T
6-NA,1082,1,0,5277,1,5279,G
6-NA,1083,0,2,5324,0,5326,G
6-NA,1084,5281,3,1,0,5285,A
6-NA,1085,2,5299,1,1,5303,T
6-NA,1086,0,1,5292,0,5293,G
6-NA,1087,3,2,5271,0,5276,G
6-NA,1088,4,0,5308,0,5312,G
6-NA,1089,5270,1,1,0,5272,A
6-NA,1090,5267,0,4,1,5272,A
6-NA,1091,2,2,5275,0,5279,G
6-NA,1092,5208,0,3,0,5211,A
6-NA,1093,5212,1,2,0,5215,A
6-NA,1094,1,3,0,5187,5191,C
6-NA,1095,1,0,5175,0,5176,G
6-NA,1096,5167,0,1,0,5168,A
6-NA,1097,2,5101,0,0,5103,T
6-NA,1098,1,0,0,5102,5103,C
6-NA,1099,5120,0,1,0,5121,A
6-NA,1100,1,1,5135,0,5137,G
6-NA,1101,0,0,0,5128,5128,C
6-NA,1102,2,1,5136,0,5139,G
6-NA,1103,5114,2,1,0,5117,A
6-NA,1104,0,0,5113,0,5113,G
6-NA,1105,5108,0,1,0,5109,A
6-NA,1106,5131,2,1,0,5134,A
6-NA,1107,1,0,5173,0,5174,G
6-NA,1108,1,5146,0,3,5150,T
6-NA,1109,0,1,0,5104,5105,C
6-NA,1110,5106,0,2,0,5108,A
6-NA,1111,0,1,0,5309,5310,C
6-NA,1112,2,0,5308,0,5310,G
6-NA,1113,2,1,0,5311,5314,C
6-NA,1114,1,5288,0,1,5290,T
6-NA,1115,0,5297,1,2,5300,T
6-NA,1116,5237,1,1,0,5239,A
6-NA,1117,1,72,5317,1,5391,G
6-NA,1118,0,0,5393,1,5394,G
6-NA,1119,2,3,5496,0,5501,G
6-NA,1120,0,5181,0,4,5185,T
6-NA,1121,5112,0,2,1,5115,A
6-NA,1122,0,5102,0,4,5106,T
6-NA,1123,2,1,5095,1,5099,G
6-NA,1124,5082,0,4,1,5087,A
6-NA,1125,5080,0,1,0,5081,A
6-NA,1126,4912,1,1,0,4914,A
6-NA,1127,0,1,0,4923,4924,C
6-NA,1128,2,2,0,4842,4846,C
6-NA,1129,0,4794,1,5,4800,T
6-NA,1130,1,4798,0,2,4801,T
6-NA,1131,1,1,0,4812,4814,C
6-NA,1132,4801,0,1,0,4802,A
6-NA,1133,4802,0,0,0,4802,A
6-NA,1134,4785,3,3,0,4791,A
6-NA,1135,0,0,4844,0,4844,G
6-NA,1136,2,4770,0,2,4774,T
6-NA,1137,0,1,1,4806,4808,C
6-NA,1138,4917,2,4,0,4923,A
6-NA,1139,1,4936,0,1,4938,T
6-NA,1140,0,4932,0,1,4933,T
6-NA,1141,2,1,4929,0,4932,G
6-NA,1142,4930,1,2,0,4933,A
6-NA,1143,4962,0,4,0,4966,A
6-NA,1144,1,0,4929,1,4931,G
6-NA,1145,0,0,4936,0,4936,G
6-NA,1146,0,0,0,4907,4907,C
6-NA,1147,0,4759,0,1,4760,T
6-NA,1148,2,2,4802,0,4806,G
6-NA,1149,1,0,4865,0,4866,G
6-NA,1150,0,4850,0,11,4861,T
6-NA,1151,1,2,0,4842,4845,C
6-NA,1152,2,1,0,4803,4806,C
6-NA,1153,4833,1,2,0,4836,A
6-NA,1154,4862,1,3,1,4867,A
6-NA,1155,2,0,0,4846,4848,C
6-NA,1156,2,0,0,4843,4845,C
6-NA,1157,4641,2,3,8,4654,A
6-NA,1158,0,4695,0,3,4698,T
6-NA,1159,4698,0,2,0,4700,A
6-NA,1160,4705,0,3,1,4709,A
6-NA,1161,1,0,4746,1,4748,G
6-NA,1162,0,4687,0,14,4701,T
6-NA,1163,2,1,0,4686,4689,C
6-NA,1164,3,2,1,4628,4634,C
6-NA,1165,4646,0,0,0,4646,A
6-NA,1166,4637,1,0,0,4638,A
6-NA,1167,4633,0,1,0,4634,A
6-NA,1168,0,4643,2,0,4645,T
6-NA,1169,0,4616,1,1,4618,T
6-NA,1170,0,1,4603,0,4604,G
6-NA,1171,1,1,0,4601,4603,C
6-NA,1172,4594,1,2,0,4597,A
6-NA,1173,1,0,4617,0,4618,G
6-NA,1174,4599,2,3,0,4604,A
6-NA,1175,1,4683,0,0,4684,T
6-NA,1176,4689,0,0,0,4689,A
6-NA,1177,4684,4,1,0,4689,A
6-NA,1178,4689,1,2,2,4694,A
6-NA,1179,0,4678,0,2,4680,T
6-NA,1180,4665,0,1,0,4666,A
6-NA,1181,0,0,4672,0,4672,G
6-NA,1182,1,2,4646,0,4649,G
6-NA,1183,0,2,0,4632,4634,C
6-NA,1184,4522,0,3,1,4526,A
6-NA,1185,4567,1,1,0,4569,A
6-NA,1186,0,1,4623,0,4624,G
6-NA,1187,0,4614,1,3,4618,T
6-NA,1188,0,1,0,4608,4609,C
6-NA,1189,4636,0,2,0,4638,A
6-NA,1190,1,4631,0,1,4633,T
6-NA,1191,4653,2,1,0,4656,A
6-NA,1192,0,0,4671,0,4671,G
6-NA,1193,0,4667,0,0,4667,T
6-NA,1194,0,4561,0,2,4563,T
6-NA,1195,0,2,4516,0,4518,G
6-NA,1196,4513,2,1,0,4516,A
6-NA,1197,2,0,0,4510,4512,C
6-NA,1198,4462,1,0,0,4463,A
6-NA,1199,1,1,4533,0,4535,G
6-NA,1200,4481,0,3,0,4484,A
6-NA,1201,1,1,4636,0,4638,G
6-NA,1202,1,0,4586,0,4587,G
6-NA,1203,0,4583,0,0,4583,T
6-NA,1204,4563,0,2,0,4565,A
6-NA,1205,4567,0,0,1,4568,A
6-NA,1206,1,4570,0,0,4571,T
6-NA,1207,4567,0,2,0,4569,A
6-NA,1208,0,1,4502,0,4503,G
6-NA,1209,2,1,4445,0,4448,G
6-NA,1210,1,4191,0,2,4194,T
6-NA,1211,1,1,1,4156,4159,C
6-NA,1212,3,1,1,4179,4184,C
6-NA,1213,1,0,4177,0,4178,G
6-NA,1214,0,1,4194,0,4195,G
6-NA,1215,1,4180,0,1,4182,T
6-NA,1216,0,4183,0,0,4183,T
6-NA,1217,4163,0,0,0,4163,A
6-NA,1218,0,4130,0,0,4130,T
6-NA,1219,0,4141,0,1,4142,T
6-NA,1220,1,1,0,4132,4134,C
6-NA,1221,0,4050,0,1,4051,T
6-NA,1222,1,1,4078,0,4080,G
6-NA,1223,1,0,4081,0,4082,G
6-NA,1224,1,4088,0,1,4090,T
6-NA,1225,4088,0,1,0,4089,A
6-NA,1226,1,4052,1,1,4055,T
6-NA,1227,1,4063,0,1,4065,T
6-NA,1228,1,4048,0,1,4050,T
6-NA,1229,0,4076,0,2,4078,T
6-NA,1230,0,2,0,4076,4078,C
6-NA,1231,0,4023,0,8,4031,T
6-NA,1232,2,1,0,4044,4047,C
6-NA,1233,1,4032,0,2,4035,T
6-NA,1234,1,0,4091,1,4093,G
6-NA,1235,2,4018,0,65,4085,T
6-NA,1236,1,4065,0,2,4068,T
6-NA,1237,0,0,4065,0,4065,G
6-NA,1238,4017,0,4,0,4021,A
6-NA,1239,4013,0,4,0,4017,A
6-NA,1240,1,0,4038,0,4039,G
6-NA,1241,3,1,4004,1,4009,G
6-NA,1242,0,1,0,4017,4018,C
6-NA,1243,3952,0,2,0,3954,A
6-NA,1244,3952,0,4,0,3956,A
6-NA,1245,3967,1,1,2,3971,A
6-NA,1246,3973,0,6,1,3980,A
6-NA,1247,0,0,3987,0,3987,G
6-NA,1248,0,0,1,3986,3987,C
6-NA,1249,0,3923,0,5,3928,T
6-NA,1250,2,0,3972,1,3975,G
6-NA,1251,0,1,0,3963,3964,C
6-NA,1252,3983,2,1,0,3986,A
6-NA,1253,0,3974,0,3,3977,T
6-NA,1254,0,0,0,3923,3923,C
6-NA,1255,3919,0,1,0,3920,A
6-NA,1256,3926,0,0,0,3926,A
6-NA,1257,1,3912,0,1,3914,T
6-NA,1258,0,2,0,3913,3915,C
6-NA,1259,0,0,3866,0,3866,G
6-NA,1260,0,0,3908,0,3908,G
6-NA,1261,0,3895,0,1,3896,T
6-NA,1262,0,0,3918,0,3918,G
6-NA,1263,0,1,0,3931,3932,C
6-NA,1264,1,3902,0,3,3906,T
6-NA,1265,0,3945,0,1,3946,T
6-NA,1266,0,3948,1,1,3950,T
6-NA,1267,0,3962,0,2,3964,T
6-NA,1268,3980,0,2,0,3982,A
6-NA,1269,0,3824,0,0,3824,T
6-NA,1270,0,0,3834,0,3834,G
6-NA,1271,1,3781,0,2,3784,T
6-NA,1272,0,1,3740,0,3741,G
6-NA,1273,0,0,3773,0,3773,G
6-NA,1274,3683,0,1,0,3684,A
6-NA,1275,0,0,3711,0,3711,G
6-NA,1276,0,3696,0,2,3698,T
6-NA,1277,0,3661,0,0,3661,T
6-NA,1278,0,0,3712,1,3713,G
6-NA,1279,3701,2,2,0,3705,A
6-NA,1280,0,3694,0,0,3694,T
6-NA,1281,0,3562,1,1,3564,T
6-NA,1282,3565,1,1,0,3567,A
6-NA,1283,0,1,3589,0,3590,G
6-NA,1284,3,2,3586,0,3591,G
6-NA,1285,0,3,3573,0,3576,G
6-NA,1286,2,0,3558,3,3563,G
6-NA,1287,3445,1,0,0,3446,A
6-NA,1288,3438,0,2,0,3440,A
6-NA,1289,1,0,3452,0,3453,G
6-NA,1290,3448,0,1,0,3449,A
6-NA,1291,3445,0,0,0,3445,A
6-NA,1292,3405,0,2,0,3407,A
6-NA,1293,3383,1,2,0,3386,A
6-NA,1294,0,2,3393,0,3395,G
6-NA,1295,3363,0,3,0,3366,A
6-NA,1296,0,1,3363,0,3364,G
6-NA,1297,0,0,3366,1,3367,G
6-NA,1298,3334,0,3,0,3337,A
6-NA,1299,3333,0,4,0,3337,A
6-NA,1300,3343,0,0,0,3343,A
6-NA,1301,1,0,1,3356,3358,C
6-NA,1302,0,3346,1,1,3348,T
6-NA,1303,1,1,3358,0,3360,G
6-NA,1304,3349,0,0,0,3349,A
6-NA,1305,3341,0,1,0,3342,A
6-NA,1306,1,0,3363,0,3364,G
6-NA,1307,0,3335,0,3,3338,T
6-NA,1308,0,1,2,3368,3371,C
6-NA,1309,0,3358,0,2,3360,T
6-NA,1310,0,3339,0,1,3340,T
6-NA,1311,0,0,3342,0,3342,G
6-NA,1312,2,3321,0,3,3326,T
6-NA,1313,0,0,3321,0,3321,G
6-NA,1314,2,0,3311,0,3313,G
6-NA,1315,3287,0,1,0,3288,A
6-NA,1316,0,0,1,3307,3308,C
6-NA,1317,0,0,0,3209,3209,C
6-NA,1318,2,3192,0,11,3205,T
6-NA,1319,1,0,0,3212,3213,C
6-NA,1320,3207,0,3,0,3210,A
6-NA,1321,3209,0,1,0,3210,A
6-NA,1322,3207,0,0,0,3207,A
6-NA,1323,0,0,1,3230,3231,C
6-NA,1324,3139,0,0,1,3140,A
6-NA,1325,0,0,3175,0,3175,G
6-NA,1326,0,3138,0,1,3139,T
6-NA,1327,3132,0,1,0,3133,A
6-NA,1328,2,3124,1,1,3128,T
6-NA,1329,0,3075,0,0,3075,T
6-NA,1330,0,0,3091,0,3091,G
6-NA,1331,0,3077,1,2,3080,T
6-NA,1332,0,2968,0,1,2969,T
6-NA,1333,1,0,2974,0,2975,G
6-NA,1334,0,2752,0,1,2753,T
6-NA,1335,0,0,2756,0,2756,G
6-NA,1336,0,2734,0,2,2736,T
6-NA,1337,1,2696,0,1,2698,T
6-NA,1338,0,2710,0,1,2711,T
6-NA,1339,0,2643,0,0,2643,T
6-NA,1340,0,0,2647,0,2647,G
6-NA,1341,3,2638,0,2,2643,T
6-NA,1342,0,0,2625,1,2626,G
6-NA,1343,0,1,2622,0,2623,G
6-NA,1344,0,1,0,2591,2592,C
6-NA,1345,2581,1,3,0,2585,A
6-NA,1346,0,0,0,2597,2597,C
6-NA,1347,0,0,0,2589,2589,C
6-NA,1348,0,2587,0,1,2588,T
6-NA,1349,0,0,0,2587,2587,C
6-NA,1350,2581,0,2,0,2583,A
6-NA,1351,0,1,2604,0,2605,G
6-NA,1352,0,1,2611,0,2612,G
6-NA,1353,1,2599,0,5,2605,T
6-NA,1354,2573,0,8,0,2581,A
6-NA,1355,1,1,0,2455,2457,C
6-NA,1356,2440,0,1,0,2441,A
6-NA,1357,0,2434,0,0,2434,T
6-NA,1358,2364,0,6,0,2370,A
6-NA,1359,0,2364,0,0,2364,T
6-NA,1360,0,0,2205,0,2205,G
6-NA,1361,0,0,2205,0,2205,G
6-NA,1362,2181,0,1,0,2182,A
6-NA,1363,2164,1,0,0,2165,A
6-NA,1364,1,0,0,2138,2139,C
6-NA,1365,1766,0,0,0,1766,A
6-NA,1366,1,1,1757,0,1759,G
6-NA,1367,0,0,1756,0,1756,G
6-NA,1368,0,0,0,1765,1765,C
6-NA,1369,0,1751,0,1,1752,T
6-NA,1370,1,1,0,1649,1651,C
6-NA,1371,1643,0,2,0,1645,A
6-NA,1372,1,1639,0,2,1642,T
6-NA,1373,1,0,1639,1,1641,G
6-NA,1374,0,1,1641,0,1642,G
6-NA,1375,0,0,1,1570,1571,C
6-NA,1376,0,0,1,1557,1558,C
6-NA,1377,1,1476,0,0,1477,T
6-NA,1378,0,0,1474,0,1474,G
6-NA,1379,1479,0,0,0,1479,A
6-NA,1380,0,1477,0,0,1477,T
6-NA,1381,0,0,1442,0,1442,G
6-NA,1382,0,0,1411,0,1411,G
6-NA,1383,0,0,1322,0,1322,G
6-NA,1384,0,0,1322,0,1322,G
6-NA,1385,0,1,0,1303,1304,C
6-NA,1386,0,0,1297,0,1297,G
6-NA,1387,1,0,1281,0,1282,G
6-NA,1388,1265,1,2,0,1268,A
6-NA,1389,0,1,0,1265,1266,C
6-NA,1390,2,0,0,1217,1219,C
6-NA,1391,0,1218,0,2,1220,T
6-NA,1392,0,1,0,1222,1223,C
6-NA,1393,1223,0,0,0,1223,A
6-NA,1394,1222,0,0,0,1222,A
6-NA,1395,0,1219,0,1,1220,T
6-NA,1396,0,0,0,1157,1157,C
6-NA,1397,0,1102,0,0,1102,T
6-NA,1398,0,0,0,904,904,C
6-NA,1399,897,0,0,0,897,A
6-NA,1400,2,888,0,0,890,T
6-NA,1401,0,0,884,0,884,G
6-NA,1402,0,0,0,877,877,C
6-NA,1403,0,0,0,834,834,C
6-NA,1404,0,720,0,0,720,T
6-NA,1405,690,0,0,0,690,A
6-NA,1406,0,691,0,0,691,T
6-NA,1407,678,0,0,0,678,A
6-NA,1408,0,677,0,0,677,T
6-NA,1409,609,0,0,0,609,A
6-NA,1410,579,0,0,0,579,A
7-M,1,12,0,0,0,12,A
7-M,2,0,12,0,0,12,T
7-M,3,0,0,11,0,11,G
7-M,4,12,0,0,0,12,A
7-M,5,0,0,15,0,15,G
7-M,6,0,0,0,15,15,C
7-M,7,0,0,0,15,15,C
7-M,8,0,19,0,0,19,T
7-M,9,0,19,0,0,19,T
7-M,10,0,0,0,19,19,C
7-M,11,0,19,0,0,19,T
7-M,12,19,0,0,0,19,A
7-M,13,19,0,0,0,19,A
7-M,14,0,0,0,20,20,C
7-M,15,0,0,0,19,19,C
7-M,16,0,0,20,0,20,G
7-M,17,20,0,0,0,20,A
7-M,18,0,0,20,0,20,G
7-M,19,0,0,21,0,21,G
7-M,20,0,21,0,0,21,T
7-M,21,0,0,0,21,21,C
7-M,22,0,0,21,0,21,G
7-M,23,22,0,0,0,22,A
7-M,24,22,0,0,0,22,A
7-M,25,23,0,0,0,23,A
7-M,26,0,0,0,27,27,C
7-M,27,0,0,27,0,27,G
7-M,28,0,28,0,0,28,T
7-M,29,28,0,0,0,28,A
7-M,30,0,28,0,0,28,T
7-M,31,0,0,28,0,28,G
7-M,32,0,28,0,0,28,T
7-M,33,0,34,0,0,34,T
7-M,34,0,0,0,35,35,C
7-M,35,0,35,0,0,35,T
7-M,36,0,0,0,37,37,C
7-M,37,0,37,0,0,37,T
7-M,38,0,0,0,40,40,C
7-M,39,0,40,0,0,40,T
7-M,40,41,0,0,0,41,A
7-M,41,0,41,0,0,41,T
7-M,42,0,0,0,42,42,C
7-M,43,0,0,43,0,43,G
7-M,44,0,43,0,0,43,T
7-M,45,0,43,0,0,43,T
7-M,46,0,0,0,43,43,C
7-M,47,0,0,0,44,44,C
7-M,48,44,0,0,0,44,A
7-M,49,0,44,0,0,44,T
7-M,50,0,0,0,44,44,C
7-M,51,44,0,0,0,44,A
7-M,52,0,0,46,0,46,G
7-M,53,0,0,46,0,46,G
7-M,54,0,0,0,46,46,C
7-M,55,0,0,0,45,45,C
7-M,56,0,1,0,45,46,C
7-M,57,1,0,0,50,51,C
7-M,58,0,0,0,51,51,C
7-M,59,0,50,0,0,50,T
7-M,60,0,0,0,51,51,C
7-M,61,51,0,0,0,51,A
7-M,62,51,0,0,0,51,A
7-M,63,52,0,0,0,52,A
7-M,64,0,0,54,0,54,G
7-M,65,0,0,0,52,52,C
7-M,66,0,0,0,53,53,C
7-M,67,0,0,53,0,53,G
7-M,68,55,0,0,0,55,A
7-M,69,0,0,55,0,55,G
7-M,70,55,0,0,0,55,A
7-M,71,0,55,0,0,55,T
7-M,72,0,0,0,55,55,C
7-M,73,0,0,55,0,55,G
7-M,74,0,0,0,55,55,C
7-M,75,0,0,55,0,55,G
7-M,76,0,0,0,55,55,C
7-M,77,54,0,0,0,54,A
7-M,78,0,0,55,0,55,G
7-M,79,55,0,0,0,55,A
7-M,80,0,0,56,0,56,G
7-M,81,57,0,0,0,57,A
7-M,82,0,0,0,59,59,C
7-M,83,0,59,0,0,59,T
7-M,84,0,59,0,0,59,T
7-M,85,0,0,60,0,60,G
7-M,86,60,0,0,0,60,A
7-M,87,60,0,0,0,60,A
7-M,88,0,0,60,0,60,G
7-M,89,61,0,0,0,61,A
7-M,90,0,62,0,0,62,T
7-M,91,0,0,63,0,63,G
7-M,92,0,63,0,0,63,T
7-M,93,0,0,1,62,63,C
7-M,94,0,62,0,0,62,T
7-M,95,0,61,0,0,61,T
7-M,96,0,62,0,0,62,T
7-M,97,0,0,62,0,62,G
7-M,98,0,0,0,62,62,C
7-M,99,0,60,0,0,60,T
7-M,100,0,0,59,0,59,G
7-M,101,0,0,61,0,61,G
7-M,102,0,0,63,0,63,G
7-M,103,63,0,0,0,63,A
7-M,104,63,0,0,0,63,A
7-M,105,63,0,0,0,63,A
7-M,106,62,0,0,0,62,A
7-M,107,61,0,0,1,62,A
7-M,108,0,0,0,62,62,C
7-M,109,62,0,0,0,62,A
7-M,110,0,0,0,62,62,C
7-M,111,61,0,0,0,61,A
7-M,112,0,0,63,0,63,G
7-M,113,63,0,0,0,63,A
7-M,114,0,65,0,0,65,T
7-M,115,0,0,0,65,65,C
7-M,116,0,64,0,0,64,T
7-M,117,0,64,0,0,64,T
7-M,118,0,0,65,0,65,G
7-M,119,65,0,0,0,65,A
7-M,120,0,0,66,0,66,G
7-M,121,0,0,66,0,66,G
7-M,122,0,0,0,68,68,C
7-M,123,0,68,0,0,68,T
7-M,124,0,0,0,71,71,C
7-M,125,0,71,0,0,71,T
7-M,126,0,0,0,71,71,C
7-M,127,71,0,0,0,71,A
7-M,128,0,71,0,0,71,T
7-M,129,0,0,71,0,71,G
7-M,130,0,0,70,0,70,G
7-M,131,70,0,0,0,70,A
7-M,132,70,0,0,0,70,A
7-M,133,0,68,0,0,68,T
7-M,134,0,0,72,0,72,G
7-M,135,0,0,73,0,73,G
7-M,136,0,0,0,73,73,C
7-M,137,0,73,0,0,73,T
7-M,138,73,0,0,0,73,A
7-M,139,73,0,0,0,73,A
7-M,140,74,0,0,0,74,A
7-M,141,0,0,75,0,75,G
7-M,142,75,0,0,0,75,A
7-M,143,0,0,0,75,75,C
7-M,144,73,0,0,0,73,A
7-M,145,73,0,0,0,73,A
7-M,146,0,0,73,0,73,G
7-M,147,73,0,0,0,73,A
7-M,148,0,0,0,73,73,C
7-M,149,0,0,0,72,72,C
7-M,150,72,0,0,0,72,A
7-M,151,73,0,0,0,73,A
7-M,152,0,73,0,0,73,T
7-M,153,0,75,0,0,75,T
7-M,154,0,0,0,75,75,C
7-M,155,0,75,0,0,75,T
7-M,156,0,0,76,0,76,G
7-M,157,0,76,0,0,76,T
7-M,158,0,0,0,76,76,C
7-M,159,76,0,0,0,76,A
7-M,160,0,0,0,79,79,C
7-M,161,0,0,0,79,79,C
7-M,162,0,79,0,0,79,T
7-M,163,0,0,0,79,79,C
7-M,164,0,79,0,0,79,T
7-M,165,0,0,84,0,84,G
7-M,166,84,0,0,0,84,A
7-M,167,0,0,0,84,84,C
7-M,168,0,84,0,0,84,T
7-M,169,83,0,0,0,83,A
7-M,170,83,0,0,0,83,A
7-M,171,0,0,83,0,83,G
7-M,172,0,0,84,0,84,G
7-M,173,0,0,85,0,85,G
7-M,174,0,0,84,0,84,G
7-M,175,87,0,0,0,87,A
7-M,176,0,86,0,0,86,T
7-M,177,0,87,0,0,87,T
7-M,178,0,87,0,0,87,T
7-M,179,0,87,0,0,87,T
7-M,180,0,0,87,0,87,G
7-M,181,0,0,87,0,87,G
7-M,182,0,0,87,0,87,G
7-M,183,0,0,87,0,87,G
7-M,184,0,82,0,0,82,T
7-M,185,0,83,0,0,83,T
7-M,186,0,83,0,0,83,T
7-M,187,0,0,88,0,88,G
7-M,188,0,88,0,0,88,T
7-M,189,0,0,90,0,90,G
7-M,190,0,90,0,0,90,T
7-M,191,0,89,0,0,89,T
7-M,192,0,0,0,90,90,C
7-M,193,89,0,0,0,89,A
7-M,194,0,0,0,93,93,C
7-M,195,0,0,93,0,93,G
7-M,196,0,0,0,92,92,C
7-M,197,0,91,0,0,91,T
7-M,198,0,0,0,94,94,C
7-M,199,94,0,0,0,94,A
7-M,200,0,0,0,98,98,C
7-M,201,0,0,0,97,97,C
7-M,202,0,0,98,0,98,G
7-M,203,0,100,1,0,101,T
7-M,204,0,0,102,0,102,G
7-M,205,0,0,0,101,101,C
7-M,206,0,0,0,101,101,C
7-M,207,1,0,0,101,102,C
7-M,208,101,0,0,0,101,A
7-M,209,0,0,102,0,102,G
7-M,210,0,102,0,0,102,T
7-M,211,0,0,102,0,102,G
7-M,212,103,0,0,0,103,A
7-M,213,0,0,103,0,103,G
7-M,214,0,0,0,103,103,C
7-M,215,1,0,103,0,104,G
7-M,216,104,0,0,0,104,A
7-M,217,0,0,105,0,105,G
7-M,218,0,0,105,0,105,G
7-M,219,102,0,0,0,102,A
7-M,220,0,0,0,105,105,C
7-M,221,0,104,0,0,104,T
7-M,222,0,0,105,0,105,G
7-M,223,0,0,0,105,105,C
7-M,224,105,0,0,0,105,A
7-M,225,0,0,108,0,108,G
7-M,226,0,0,0,107,107,C
7-M,227,0,0,109,0,109,G
7-M,228,0,110,0,0,110,T
7-M,229,107,0,0,0,107,A
7-M,230,0,0,107,0,107,G
7-M,231,106,0,0,0,106,A
7-M,232,0,0,0,105,105,C
7-M,233,0,0,106,0,106,G
7-M,234,0,0,0,105,105,C
7-M,235,0,103,0,0,103,T
7-M,236,0,104,0,0,104,T
7-M,237,0,105,0,0,105,T
7-M,238,0,0,106,0,106,G
7-M,239,0,106,0,0,106,T
7-M,240,0,0,0,106,106,C
7-M,241,0,0,0,105,105,C
7-M,242,106,0,0,0,106,A
7-M,243,106,0,0,0,106,A
7-M,244,106,0,0,0,106,A
7-M,245,106,0,0,0,106,A
7-M,246,0,106,0,0,106,T
7-M,247,0,0,106,0,106,G
7-M,248,0,0,0,107,107,C
7-M,249,0,0,0,107,107,C
7-M,250,0,0,0,108,108,C
7-M,251,0,108,0,0,108,T
7-M,252,0,0,0,113,113,C
7-M,253,114,0,0,0,114,A
7-M,254,114,0,0,0,114,A
7-M,255,0,114,0,0,114,T
7-M,256,0,0,113,0,113,G
7-M,257,0,0,114,0,114,G
7-M,258,0,0,115,0,115,G
7-M,259,113,0,0,0,113,A
7-M,260,114,0,0,0,114,A
7-M,261,0,114,0,0,114,T
7-M,262,0,0,115,0,115,G
7-M,263,0,0,115,0,115,G
7-M,264,113,0,0,0,113,A
7-M,265,0,0,112,0,112,G
7-M,266,112,0,0,0,112,A
7-M,267,0,0,0,113,113,C
7-M,268,0,0,0,117,117,C
7-M,269,0,0,0,119,119,C
7-M,270,122,0,0,0,122,A
7-M,271,121,0,0,0,121,A
7-M,272,122,0,0,0,122,A
7-M,273,0,121,0,0,121,T
7-M,274,121,0,0,0,121,A
7-M,275,120,1,0,0,121,A
7-M,276,0,0,0,118,118,C
7-M,277,117,0,0,0,117,A
7-M,278,0,116,0,0,116,T
7-M,279,0,0,115,0,115,G
7-M,280,0,0,116,0,116,G
7-M,281,116,0,0,0,116,A
7-M,282,0,0,0,116,116,C
7-M,283,112,0,0,0,112,A
7-M,284,113,0,0,0,113,A
7-M,285,113,0,0,0,113,A
7-M,286,0,0,114,0,114,G
7-M,287,0,0,0,118,118,C
7-M,288,117,0,0,0,117,A
7-M,289,0,0,118,0,118,G
7-M,290,0,118,0,0,118,T
7-M,291,0,118,0,0,118,T
7-M,292,120,0,0,0,120,A
7-M,293,120,0,0,0,120,A
7-M,294,120,0,0,0,120,A
7-M,295,0,0,0,122,122,C
7-M,296,0,121,0,0,121,T
7-M,297,0,0,129,0,129,G
7-M,298,0,129,0,0,129,T
7-M,299,129,0,0,0,129,A
7-M,300,0,129,0,0,129,T
7-M,301,129,0,0,0,129,A
7-M,302,0,0,129,0,129,G
7-M,303,0,0,128,0,128,G
7-M,304,127,0,0,0,127,A
7-M,305,127,0,0,0,127,A
7-M,306,120,0,0,0,120,A
7-M,307,0,0,0,121,121,C
7-M,308,0,121,0,0,121,T
7-M,309,0,121,0,0,121,T
7-M,310,121,0,0,0,121,A
7-M,311,120,0,1,0,121,A
7-M,312,0,0,121,0,121,G
7-M,313,121,0,0,0,121,A
7-M,314,0,0,121,0,121,G
7-M,315,0,0,124,0,124,G
7-M,316,0,0,124,0,124,G
7-M,317,124,0,1,0,125,A
7-M,318,0,0,127,0,127,G
7-M,319,128,0,0,0,128,A
7-M,320,0,128,0,0,128,T
7-M,321,127,0,0,0,127,A
7-M,322,127,0,0,0,127,A
7-M,323,0,0,0,125,125,C
7-M,324,0,0,127,0,127,G
7-M,325,0,127,0,0,127,T
7-M,326,0,123,0,0,123,T
7-M,327,0,0,0,123,123,C
7-M,328,0,0,0,124,124,C
7-M,329,124,0,0,0,124,A
7-M,330,0,124,0,0,124,T
7-M,331,0,0,123,0,123,G
7-M,332,0,0,123,0,123,G
7-M,333,0,0,125,0,125,G
7-M,334,0,0,122,0,122,G
7-M,335,0,0,0,123,123,C
7-M,336,0,0,0,122,122,C
7-M,337,123,0,0,0,123,A
7-M,338,123,0,0,0,123,A
7-M,339,123,0,0,0,123,A
7-M,340,0,0,124,0,124,G
7-M,341,124,0,0,0,124,A
7-M,342,120,0,0,0,120,A
7-M,343,122,0,0,0,122,A
7-M,344,0,122,0,0,122,T
7-M,345,122,0,0,0,122,A
7-M,346,0,0,122,0,122,G
7-M,347,0,0,0,122,122,C
7-M,348,0,122,0,0,122,T
7-M,349,0,0,0,121,121,C
7-M,350,0,122,0,0,122,T
7-M,351,0,0,0,126,126,C
7-M,352,126,0,0,0,126,A
7-M,353,0,0,127,0,127,G
7-M,354,0,65,0,62,127,T
7-M,355,0,127,0,0,127,T
7-M,356,129,0,0,0,129,A
7-M,357,0,129,0,0,129,T
7-M,358,0,129,0,0,129,T
7-M,359,0,0,0,130,130,C
7-M,360,0,127,0,1,128,T
7-M,361,0,0,131,0,131,G
7-M,362,0,0,0,130,130,C
7-M,363,0,129,0,0,129,T
7-M,364,0,0,129,0,129,G
7-M,365,0,0,129,0,129,G
7-M,366,0,129,0,0,129,T
7-M,367,0,0,128,0,128,G
7-M,368,0,1,0,128,129,C
7-M,369,128,0,0,0,128,A
7-M,370,0,0,0,130,130,C
7-M,371,0,128,0,0,128,T
7-M,372,0,130,0,0,130,T
7-M,373,0,0,130,0,130,G
7-M,374,0,0,0,131,131,C
7-M,375,0,0,0,131,131,C
7-M,376,131,0,0,0,131,A
7-M,377,0,0,131,0,131,G
7-M,378,0,132,0,0,132,T
7-M,379,0,132,0,0,132,T
7-M,380,0,0,134,0,134,G
7-M,381,0,0,0,133,133,C
7-M,382,133,0,0,0,133,A
7-M,383,0,133,0,0,133,T
7-M,384,0,0,133,0,133,G
7-M,385,0,0,134,0,134,G
7-M,386,0,0,135,0,135,G
7-M,387,0,0,0,138,138,C
7-M,388,0,0,0,140,140,C
7-M,389,0,134,0,0,134,T
7-M,390,0,0,0,137,137,C
7-M,391,144,0,0,0,144,A
7-M,392,0,144,0,0,144,T
7-M,393,146,0,1,0,147,A
7-M,394,0,144,0,0,144,T
7-M,395,142,0,0,0,142,A
7-M,396,0,0,0,147,147,C
7-M,397,146,0,0,0,146,A
7-M,398,148,0,0,0,148,A
7-M,399,0,146,0,0,146,T
7-M,400,138,0,0,0,138,A
7-M,401,0,0,138,0,138,G
7-M,402,0,0,133,0,133,G
7-M,403,133,0,0,0,133,A
7-M,404,0,134,0,0,134,T
7-M,405,0,0,124,0,124,G
7-M,406,0,0,124,0,124,G
7-M,407,0,0,125,0,125,G
7-M,408,0,0,126,0,126,G
7-M,409,0,0,126,0,126,G
7-M,410,0,0,0,122,122,C
7-M,411,0,120,0,0,120,T
7-M,412,0,0,120,0,120,G
7-M,413,0,120,0,0,120,T
7-M,414,119,0,0,0,119,A
7-M,415,120,0,0,0,120,A
7-M,416,0,0,0,123,123,C
7-M,417,0,0,0,119,119,C
7-M,418,119,0,0,0,119,A
7-M,419,0,0,0,118,118,C
7-M,420,0,118,0,0,118,T
7-M,421,0,0,119,0,119,G
7-M,422,118,0,0,0,118,A
7-M,423,117,0,0,0,117,A
7-M,424,0,0,118,0,118,G
7-M,425,0,117,0,0,117,T
7-M,426,0,0,117,0,117,G
7-M,427,0,0,117,0,117,G
7-M,428,0,0,0,116,116,C
7-M,429,115,0,0,0,115,A
7-M,430,0,116,0,0,116,T
7-M,431,0,115,0,0,115,T
7-M,432,0,115,0,1,116,T
7-M,433,0,0,116,0,116,G
7-M,434,0,0,116,0,116,G
7-M,435,0,0,0,116,116,C
7-M,436,0,0,0,115,115,C
7-M,437,0,113,0,0,113,T
7-M,438,0,0,115,0,115,G
7-M,439,0,0,116,0,116,G
7-M,440,0,116,0,0,116,T
7-M,441,116,0,0,0,116,A
7-M,442,0,108,0,0,108,T
7-M,443,0,0,112,0,112,G
7-M,444,0,112,0,1,113,T
7-M,445,0,0,112,0,112,G
7-M,446,0,0,0,112,112,C
7-M,447,106,0,0,0,106,A
7-M,448,104,0,0,0,104,A
7-M,449,0,0,0,105,105,C
7-M,450,105,0,0,0,105,A
7-M,451,0,106,0,0,106,T
7-M,452,0,0,105,0,105,G
7-M,453,0,102,0,0,102,T
7-M,454,0,0,102,0,102,G
7-M,455,101,0,0,0,101,A
7-M,456,0,0,101,0,101,G
7-M,457,0,0,0,100,100,C
7-M,458,97,0,0,0,97,A
7-M,459,0,0,97,0,97,G
7-M,460,96,0,0,0,96,A
7-M,461,0,96,0,0,96,T
7-M,462,0,96,0,0,96,T
7-M,463,1,0,95,0,96,G
7-M,464,0,0,0,96,96,C
7-M,465,0,95,0,0,95,T
7-M,466,0,0,96,0,96,G
7-M,467,96,0,0,0,96,A
7-M,468,0,0,0,105,105,C
7-M,469,0,106,0,0,106,T
7-M,470,0,0,0,107,107,C
7-M,471,1,0,0,107,108,C
7-M,472,0,0,0,110,110,C
7-M,473,110,0,0,0,110,A
7-M,474,0,0,112,0,112,G
7-M,475,0,0,0,112,112,C
7-M,476,111,0,0,0,111,A
7-M,477,0,0,0,112,112,C
7-M,478,105,0,0,0,105,A
7-M,479,0,0,108,0,108,G
7-M,480,0,0,108,0,108,G
7-M,481,0,106,0,1,107,T
7-M,482,0,0,0,111,111,C
7-M,483,0,109,0,0,109,T
7-M,484,0,0,0,109,109,C
7-M,485,109,0,0,0,109,A
7-M,486,0,108,0,0,108,T
7-M,487,109,0,0,0,109,A
7-M,488,0,0,107,0,107,G
7-M,489,0,0,107,0,107,G
7-M,490,0,0,0,106,106,C
7-M,491,100,0,0,0,100,A
7-M,492,0,0,100,0,100,G
7-M,493,101,0,0,0,101,A
7-M,494,0,102,0,0,102,T
7-M,495,0,0,101,0,101,G
7-M,496,0,0,103,0,103,G
7-M,497,0,103,0,0,103,T
7-M,498,0,0,102,0,102,G
7-M,499,0,0,103,0,103,G
7-M,500,0,0,0,103,103,C
7-M,501,102,0,0,0,102,A
7-M,502,103,0,0,0,103,A
7-M,503,0,0,0,105,105,C
7-M,504,105,0,0,0,105,A
7-M,505,105,0,0,0,105,A
7-M,506,0,0,0,103,103,C
7-M,507,0,0,0,102,102,C
7-M,508,102,0,0,0,102,A
7-M,509,102,0,0,0,102,A
7-M,510,0,102,0,0,102,T
7-M,511,0,1,0,101,102,C
7-M,512,0,0,0,101,101,C
7-M,513,100,0,0,0,100,A
7-M,514,0,99,0,0,99,T
7-M,515,0,100,0,0,100,T
7-M,516,100,0,0,0,100,A
7-M,517,102,0,0,0,102,A
7-M,518,0,102,0,0,102,T
7-M,519,101,0,0,0,101,A
7-M,520,102,0,0,0,102,A
7-M,521,101,0,0,0,101,A
7-M,522,102,0,0,0,102,A
7-M,523,0,0,0,105,105,C
7-M,524,105,0,0,0,105,A
7-M,525,0,105,0,0,105,T
7-M,526,0,0,105,0,105,G
7-M,527,103,0,0,0,103,A
7-M,528,0,0,107,0,107,G
7-M,529,107,0,0,0,107,A
7-M,530,106,0,0,0,106,A
7-M,531,0,0,0,106,106,C
7-M,532,106,0,0,0,106,A
7-M,533,0,0,107,0,107,G
7-M,534,108,0,0,0,108,A
7-M,535,106,0,1,0,107,A
7-M,536,0,108,0,0,108,T
7-M,537,0,0,105,0,105,G
7-M,538,0,0,105,0,105,G
7-M,539,0,105,0,0,105,T
7-M,540,0,103,0,1,104,T
7-M,541,0,105,0,0,105,T
7-M,542,0,104,0,0,104,T
7-M,543,0,0,105,0,105,G
7-M,544,0,0,104,0,104,G
7-M,545,0,0,0,104,104,C
7-M,546,101,0,0,0,101,A
7-M,547,102,0,0,0,102,A
7-M,548,0,0,101,0,101,G
7-M,549,0,0,0,102,102,C
7-M,550,102,0,0,0,102,A
7-M,551,0,0,0,106,106,C
7-M,552,0,106,0,0,106,T
7-M,553,107,0,0,0,107,A
7-M,554,0,0,0,111,111,C
7-M,555,114,0,0,0,114,A
7-M,556,0,0,117,0,117,G
7-M,557,0,0,0,112,112,C
7-M,558,0,112,0,0,112,T
7-M,559,111,0,0,0,111,A
7-M,560,109,0,0,0,109,A
7-M,561,0,0,109,0,109,G
7-M,562,0,0,109,0,109,G
7-M,563,0,0,0,110,110,C
7-M,564,0,104,0,0,104,T
7-M,565,104,0,0,0,104,A
7-M,566,0,104,0,0,104,T
7-M,567,0,0,104,0,104,G
7-M,568,0,0,105,0,105,G
7-M,569,102,0,1,0,103,A
7-M,570,0,0,103,0,103,G
7-M,571,0,0,0,101,101,C
7-M,572,102,0,0,0,102,A
7-M,573,102,0,0,0,102,A
7-M,574,102,0,0,0,102,A
7-M,575,0,103,0,0,103,T
7-M,576,0,0,103,0,103,G
7-M,577,0,0,103,0,103,G
7-M,578,0,0,0,101,101,C
7-M,579,0,102,0,0,102,T
7-M,580,0,0,101,0,101,G
7-M,581,0,0,101,0,101,G
7-M,582,100,1,0,0,101,A
7-M,583,0,101,0,1,102,T
7-M,584,0,0,0,102,102,C
7-M,585,102,0,0,0,102,A
7-M,586,104,0,0,0,104,A
7-M,587,0,0,104,0,104,G
7-M,588,0,105,0,0,105,T
7-M,589,0,1,105,0,106,G
7-M,590,103,0,0,0,103,A
7-M,591,0,0,103,0,103,G
7-M,592,0,0,0,102,102,C
7-M,593,102,0,0,0,102,A
7-M,594,0,0,103,0,103,G
7-M,595,0,0,101,0,101,G
7-M,596,0,0,0,102,102,C
7-M,597,100,0,0,0,100,A
7-M,598,0,0,100,0,100,G
7-M,599,0,0,0,100,100,C
7-M,600,0,0,100,0,100,G
7-M,601,0,0,101,0,101,G
7-M,602,100,0,1,0,101,A
7-M,603,0,0,104,0,104,G
7-M,604,0,0,102,0,102,G
7-M,605,0,0,0,102,102,C
7-M,606,0,0,0,102,102,C
7-M,607,101,0,0,0,101,A
7-M,608,0,101,0,0,101,T
7-M,609,0,0,101,0,101,G
7-M,610,0,0,101,0,101,G
7-M,611,101,0,0,0,101,A
7-M,612,0,0,101,0,101,G
7-M,613,101,0,0,0,101,A
7-M,614,0,106,0,0,106,T
7-M,615,0,106,0,0,106,T
7-M,616,0,0,106,0,106,G
7-M,617,0,0,0,106,106,C
7-M,618,0,106,0,0,106,T
7-M,619,106,0,0,0,106,A
7-M,620,0,0,106,0,106,G
7-M,621,0,105,0,0,105,T
7-M,622,0,0,0,105,105,C
7-M,623,104,0,0,0,104,A
7-M,624,0,0,105,0,105,G
7-M,625,0,0,106,0,106,G
7-M,626,0,0,0,106,106,C
7-M,627,0,0,0,106,106,C
7-M,628,106,0,0,0,106,A
7-M,629,0,0,108,0,108,G
7-M,630,0,0,107,0,107,G
7-M,631,0,1,0,107,108,C
7-M,632,108,0,0,0,108,A
7-M,633,0,0,108,0,108,G
7-M,634,107,0,1,0,108,A
7-M,635,0,107,0,0,107,T
7-M,636,0,0,108,0,108,G
7-M,637,0,0,109,0,109,G
7-M,638,0,108,0,0,108,T
7-M,639,0,0,108,0,108,G
7-M,640,0,0,0,108,108,C
7-M,641,106,0,0,0,106,A
7-M,642,0,0,112,0,112,G
7-M,643,1,0,110,0,111,G
7-M,644,0,0,0,112,112,C
7-M,645,112,0,0,0,112,A
7-M,646,102,0,0,0,102,A
7-M,647,0,99,0,0,99,T
7-M,648,0,0,99,0,99,G
7-M,649,97,0,0,0,97,A
7-M,650,0,0,98,0,98,G
7-M,651,96,0,0,0,96,A
7-M,652,0,0,97,0,97,G
7-M,653,0,0,0,99,99,C
7-M,654,0,0,0,99,99,C
7-M,655,100,0,0,0,100,A
7-M,656,0,100,0,0,100,T
7-M,657,0,100,0,0,100,T
7-M,658,0,0,100,0,100,G
7-M,659,0,0,100,0,100,G
7-M,660,0,0,100,0,100,G
7-M,661,99,0,1,0,100,A
7-M,662,0,0,0,99,99,C
7-M,663,0,95,0,1,96,T
7-M,664,0,0,0,95,95,C
7-M,665,94,0,0,0,94,A
7-M,666,0,96,0,1,97,T
7-M,667,0,0,0,97,97,C
7-M,668,0,0,0,96,96,C
7-M,669,0,97,0,0,97,T
7-M,670,97,0,0,0,97,A
7-M,671,0,0,100,0,100,G
7-M,672,0,112,0,0,112,T
7-M,673,0,112,0,0,112,T
7-M,674,0,0,0,112,112,C
7-M,675,0,0,0,109,109,C
7-M,676,109,0,0,0,109,A
7-M,677,0,0,110,0,110,G
7-M,678,0,110,0,0,110,T
7-M,679,109,0,0,0,109,A
7-M,680,0,0,0,108,108,C
7-M,681,0,100,0,0,100,T
7-M,682,0,0,102,0,102,G
7-M,683,0,0,104,0,104,G
7-M,684,0,106,0,0,106,T
7-M,685,0,0,0,105,105,C
7-M,686,0,105,0,0,105,T
7-M,687,105,0,0,0,105,A
7-M,688,105,0,0,0,105,A
7-M,689,0,0,106,0,106,G
7-M,690,104,0,1,0,105,A
7-M,691,0,0,103,0,103,G
7-M,692,94,0,0,0,94,A
7-M,693,0,92,0,0,92,T
7-M,694,0,0,92,0,92,G
7-M,695,91,0,0,0,91,A
7-M,696,0,90,0,0,90,T
7-M,697,0,0,0,90,90,C
7-M,698,0,90,0,0,90,T
7-M,699,0,90,0,0,90,T
7-M,700,0,0,0,90,90,C
7-M,701,0,90,0,0,90,T
7-M,702,0,89,0,0,89,T
7-M,703,0,0,88,0,88,G
7-M,704,90,0,0,0,90,A
7-M,705,89,0,0,0,89,A
7-M,706,90,0,0,0,90,A
7-M,707,90,0,0,0,90,A
7-M,708,0,90,0,0,90,T
7-M,709,0,90,0,0,90,T
7-M,710,0,91,0,0,91,T
7-M,711,0,0,91,0,91,G
7-M,712,0,0,0,90,90,C
7-M,713,91,0,0,0,91,A
7-M,714,0,0,91,0,91,G
7-M,715,91,0,0,0,91,A
7-M,716,0,0,0,91,91,C
7-M,717,0,0,0,91,91,C
7-M,718,0,90,0,0,90,T
7-M,719,92,0,0,0,92,A
7-M,720,0,93,0,0,93,T
7-M,721,0,0,0,92,92,C
7-M,722,93,0,0,0,93,A
7-M,723,0,0,94,0,94,G
7-M,724,94,0,0,0,94,A
7-M,725,91,0,0,0,91,A
7-M,726,91,0,0,0,91,A
7-M,727,0,0,0,91,91,C
7-M,728,0,0,90,0,90,G
7-M,729,87,1,0,0,88,A
7-M,730,88,0,0,0,88,A
7-M,731,0,90,0,0,90,T
7-M,732,0,0,89,0,89,G
7-M,733,0,0,90,0,90,G
7-M,734,0,0,90,0,90,G
7-M,735,0,0,90,0,90,G
7-M,736,0,0,93,0,93,G
7-M,737,0,92,0,0,92,T
7-M,738,0,0,92,0,92,G
7-M,739,0,0,0,92,92,C
7-M,740,91,0,0,0,91,A
7-M,741,0,0,94,0,94,G
7-M,742,94,0,0,0,94,A
7-M,743,0,94,0,0,94,T
7-M,744,0,0,93,0,93,G
7-M,745,0,0,0,92,92,C
7-M,746,91,0,0,0,91,A
7-M,747,92,0,0,0,92,A
7-M,748,0,0,0,93,93,C
7-M,749,0,0,92,0,92,G
7-M,750,94,0,0,0,94,A
7-M,751,0,94,0,0,94,T
7-M,752,0,94,0,0,94,T
7-M,753,0,0,0,95,95,C
7-M,754,95,0,0,0,95,A
7-M,755,94,0,0,0,94,A
7-M,756,0,0,95,0,95,G
7-M,757,0,94,0,0,94,T
7-M,758,0,0,94,0,94,G
7-M,759,91,0,0,0,91,A
7-M,760,0,0,0,90,90,C
7-M,761,0,0,0,91,91,C
7-M,762,0,0,0,93,93,C
7-M,763,0,0,92,0,92,G
7-M,764,0,0,0,93,93,C
7-M,765,0,93,0,0,93,T
7-M,766,0,94,0,0,94,T
7-M,767,0,0,94,0,94,G
7-M,768,0,94,0,0,94,T
7-M,769,0,94,0,0,94,T
7-M,770,0,0,95,0,95,G
7-M,771,0,91,0,0,91,T
7-M,772,0,88,0,0,88,T
7-M,773,0,0,90,0,90,G
7-M,774,0,0,0,89,89,C
7-M,775,0,0,0,90,90,C
7-M,776,0,0,91,0,91,G
7-M,777,0,0,0,91,91,C
7-M,778,0,0,91,0,91,G
7-M,779,91,1,0,0,92,A
7-M,780,93,0,0,0,93,A
7-M,781,0,93,0,0,93,T
7-M,782,93,0,0,0,93,A
7-M,783,0,95,0,0,95,T
7-M,784,0,0,0,96,96,C
7-M,785,96,0,0,0,96,A
7-M,786,0,96,0,0,96,T
7-M,787,0,96,0,0,96,T
7-M,788,0,0,96,0,96,G
7-M,789,0,0,96,0,96,G
7-M,790,1,0,95,0,96,G
7-M,791,97,0,0,0,97,A
7-M,792,0,98,0,0,98,T
7-M,793,0,0,0,97,97,C
7-M,794,0,98,0,0,98,T
7-M,795,0,98,0,0,98,T
7-M,796,0,0,99,0,99,G
7-M,797,0,0,0,99,99,C
7-M,798,100,0,0,0,100,A
7-M,799,0,0,0,101,101,C
7-M,800,0,99,0,0,99,T
7-M,801,0,99,0,0,99,T
7-M,802,0,0,98,0,98,G
7-M,803,100,0,0,0,100,A
7-M,804,0,100,0,0,100,T
7-M,805,100,0,0,0,100,A
7-M,806,0,99,0,0,99,T
7-M,807,0,98,0,0,98,T
7-M,808,0,0,99,0,99,G
7-M,809,0,99,0,0,99,T
7-M,810,0,0,99,0,99,G
7-M,811,0,0,99,0,99,G
7-M,812,98,0,0,0,98,A
7-M,813,0,98,0,0,98,T
7-M,814,0,97,0,0,97,T
7-M,815,0,0,0,97,97,C
7-M,816,0,96,0,0,96,T
7-M,817,0,95,0,0,95,T
7-M,818,0,0,94,0,94,G
7-M,819,94,0,0,0,94,A
7-M,820,0,94,1,0,95,T
7-M,821,0,0,0,95,95,C
7-M,822,0,0,94,0,94,G
7-M,823,0,94,0,0,94,T
7-M,824,0,0,0,94,94,C
7-M,825,0,93,0,1,94,T
7-M,826,0,94,0,0,94,T
7-M,827,0,94,0,0,94,T
7-M,828,0,93,0,0,93,T
7-M,829,0,93,0,0,93,T
7-M,830,0,93,0,0,93,T
7-M,831,0,93,0,0,93,T
7-M,832,0,0,0,93,93,C
7-M,833,93,0,0,0,93,A
7-M,834,93,0,0,0,93,A
7-M,835,93,0,0,0,93,A
7-M,836,0,93,0,0,93,T
7-M,837,0,0,93,0,93,G
7-M,838,0,0,0,93,93,C
7-M,839,0,0,93,0,93,G
7-M,840,0,96,0,0,96,T
7-M,841,0,0,0,96,96,C
7-M,842,0,96,0,0,96,T
7-M,843,96,0,0,0,96,A
7-M,844,0,96,0,0,96,T
7-M,845,0,0,0,95,95,C
7-M,846,0,0,94,0,94,G
7-M,847,95,0,0,0,95,A
7-M,848,0,0,0,96,96,C
7-M,849,0,93,0,0,93,T
7-M,850,0,0,0,95,95,C
7-M,851,0,95,0,0,95,T
7-M,852,0,94,0,0,94,T
7-M,853,0,0,0,94,94,C
7-M,854,93,0,0,0,93,A
7-M,855,94,0,0,0,94,A
7-M,856,94,0,0,0,94,A
7-M,857,0,0,0,94,94,C
7-M,858,93,0,0,0,93,A
7-M,859,0,0,0,90,90,C
7-M,860,1,0,88,0,89,G
7-M,861,0,0,93,0,93,G
7-M,862,0,0,0,93,93,C
7-M,863,0,0,0,93,93,C
7-M,864,0,92,0,0,92,T
7-M,865,0,93,0,0,93,T
7-M,866,92,0,0,0,92,A
7-M,867,93,0,0,0,93,A
7-M,868,93,0,0,0,93,A
7-M,869,93,0,0,0,93,A
7-M,870,0,0,89,0,89,G
7-M,871,74,0,0,0,74,A
7-M,872,0,0,74,0,74,G
7-M,873,0,0,74,0,74,G
7-M,874,0,0,0,74,74,C
7-M,875,0,0,0,73,73,C
7-M,876,0,0,0,74,74,C
7-M,877,0,74,0,0,74,T
7-M,878,0,74,0,0,74,T
7-M,879,0,0,0,73,73,C
7-M,880,0,74,0,0,74,T
7-M,881,75,0,0,0,75,A
7-M,882,0,0,0,75,75,C
7-M,883,0,0,72,0,72,G
7-M,884,0,0,72,0,72,G
7-M,885,72,0,0,0,72,A
7-M,886,71,0,0,0,71,A
7-M,887,0,0,71,0,71,G
7-M,888,0,0,69,0,69,G
7-M,889,69,0,0,0,69,A
7-M,890,0,0,69,0,69,G
7-M,891,0,69,0,0,69,T
7-M,892,69,0,0,0,69,A
7-M,893,0,0,0,69,69,C
7-M,894,0,0,0,68,68,C
7-M,895,0,67,0,0,67,T
7-M,896,0,0,68,0,68,G
7-M,897,64,0,0,0,64,A
7-M,898,0,0,64,0,64,G
7-M,899,0,60,0,0,60,T
7-M,900,0,0,0,60,60,C
7-M,901,0,60,0,0,60,T
7-M,902,60,0,0,0,60,A
7-M,903,0,60,0,0,60,T
7-M,904,0,0,60,0,60,G
7-M,905,57,0,0,0,57,A
7-M,906,0,0,57,0,57,G
7-M,907,0,0,53,0,53,G
7-M,908,0,0,53,0,53,G
7-M,909,52,0,0,0,52,A
7-M,910,52,0,0,0,52,A
7-M,911,0,0,52,0,52,G
7-M,912,52,0,0,0,52,A
7-M,913,55,0,0,0,55,A
7-M,914,0,55,0,0,55,T
7-M,915,55,0,0,0,55,A
7-M,916,0,55,0,0,55,T
7-M,917,0,3,0,52,55,C
7-M,918,0,0,55,0,55,G
7-M,919,55,0,0,0,55,A
7-M,920,54,0,0,0,54,A
7-M,921,54,0,0,0,54,A
7-M,922,0,0,52,0,52,G
7-M,923,0,0,52,0,52,G
7-M,924,52,0,0,0,52,A
7-M,925,51,0,0,0,51,A
7-M,926,0,0,0,52,52,C
7-M,927,51,0,0,0,51,A
7-M,928,0,0,52,0,52,G
7-M,929,0,0,0,51,51,C
7-M,930,51,0,0,0,51,A
7-M,931,0,0,51,0,51,G
7-M,932,49,0,0,0,49,A
7-M,933,49,0,0,0,49,A
7-M,934,0,49,0,0,49,T
7-M,935,0,0,46,0,46,G
7-M,936,0,0,0,46,46,C
7-M,937,0,43,0,0,43,T
7-M,938,0,0,43,0,43,G
7-M,939,0,43,0,0,43,T
7-M,940,0,0,42,0,42,G
7-M,941,0,0,41,0,41,G
7-M,942,40,0,1,0,41,A
7-M,943,0,41,0,0,41,T
7-M,944,0,0,40,0,40,G
7-M,945,0,0,0,38,38,C
7-M,946,0,39,0,0,39,T
7-M,947,0,0,39,0,39,G
7-M,948,39,0,0,0,39,A
7-M,949,0,0,0,39,39,C
7-M,950,0,0,39,0,39,G
7-M,951,38,0,0,0,38,A
7-M,952,0,0,0,38,38,C
7-M,953,35,0,0,0,35,A
7-M,954,0,0,35,0,35,G
7-M,955,0,35,0,0,35,T
7-M,956,0,0,0,34,34,C
7-M,957,34,0,0,0,34,A
7-M,958,0,34,0,0,34,T
7-M,959,0,34,0,0,34,T
7-M,960,0,34,0,0,34,T
7-M,961,0,34,0,0,34,T
7-M,962,0,0,34,0,34,G
7-M,963,0,30,0,0,30,T
7-M,964,0,0,0,30,30,C
7-M,965,28,0,0,0,28,A
7-M,966,0,0,28,0,28,G
7-M,967,0,0,0,28,28,C
7-M,968,28,0,0,0,28,A
7-M,969,0,28,0,0,28,T
7-M,970,27,0,0,0,27,A
7-M,971,0,0,27,0,27,G
7-M,972,27,0,0,0,27,A
7-M,973,0,0,27,0,27,G
7-M,974,0,0,0,13,13,C
7-M,975,0,14,0,0,14,T
7-M,976,0,0,14,0,14,G
7-M,977,0,0,14,0,14,G
7-M,978,14,0,0,0,14,A
7-M,979,0,0,14,0,14,G
7-M,980,0,11,0,0,11,T
7-M,981,10,0,0,0,10,A
7-M,982,10,0,0,0,10,A
8-NS,1,791,0,0,0,791,A
8-NS,2,0,791,0,0,791,T
8-NS,3,0,0,857,0,857,G
8-NS,4,0,1,940,0,941,G
8-NS,5,1026,1,0,0,1027,A
8-NS,6,0,2148,0,0,2148,T
8-NS,7,0,2150,0,0,2150,T
8-NS,8,1,1,0,2207,2209,C
8-NS,9,0,1,0,2210,2211,C
8-NS,10,2212,0,2,0,2214,A
8-NS,11,2241,0,0,1,2242,A
8-NS,12,0,1,0,2242,2243,C
8-NS,13,2247,0,1,0,2248,A
8-NS,14,0,0,0,2264,2264,C
8-NS,15,0,2265,0,0,2265,T
8-NS,16,1,1,2536,0,2538,G
8-NS,17,0,2547,0,1,2548,T
8-NS,18,0,0,2573,0,2573,G
8-NS,19,0,2568,0,5,2573,T
8-NS,20,0,0,0,2576,2576,C
8-NS,21,2574,0,0,1,2575,A
8-NS,22,2575,0,0,1,2576,A
8-NS,23,0,0,2616,0,2616,G
8-NS,24,0,2684,0,0,2684,T
8-NS,25,2,2656,1,0,2659,T
8-NS,26,0,2701,0,0,2701,T
8-NS,27,0,1,0,2703,2704,C
8-NS,28,0,2,0,2710,2712,C
8-NS,29,2710,0,4,0,2714,A
8-NS,30,0,1,2739,0,2740,G
8-NS,31,1,0,2755,0,2756,G
8-NS,32,0,2758,0,1,2759,T
8-NS,33,2763,0,0,0,2763,A
8-NS,34,0,0,2788,0,2788,G
8-NS,35,2779,0,1,2,2782,A
8-NS,36,0,2798,0,0,2798,T
8-NS,37,0,2789,0,2,2791,T
8-NS,38,0,1,2834,0,2835,G
8-NS,39,0,0,0,2843,2843,C
8-NS,40,0,2839,0,2,2841,T
8-NS,41,0,2863,0,1,2864,T
8-NS,42,0,2871,0,1,2872,T
8-NS,43,0,1,0,2915,2916,C
8-NS,44,0,2920,0,1,2921,T
8-NS,45,0,2920,0,1,2921,T
8-NS,46,1,2919,0,2,2922,T
8-NS,47,1,3,2942,1,2947,G
8-NS,48,3,4,2938,0,2945,G
8-NS,49,1,1,0,2950,2952,C
8-NS,50,2948,0,0,0,2948,A
8-NS,51,0,2953,0,1,2954,T
8-NS,52,2993,0,0,0,2993,A
8-NS,53,1,3045,0,1,3047,T
8-NS,54,0,1,0,3050,3051,C
8-NS,55,0,3,1,3051,3055,C
8-NS,56,2,0,3052,0,3054,G
8-NS,57,0,2,3073,1,3076,G
8-NS,58,3076,0,1,0,3077,A
8-NS,59,3089,0,2,0,3091,A
8-NS,60,3094,0,2,0,3096,A
8-NS,61,0,0,0,3131,3131,C
8-NS,62,3134,0,1,0,3135,A
8-NS,63,3137,0,2,1,3140,A
8-NS,64,1,0,3278,0,3279,G
8-NS,65,0,3293,0,0,3293,T
8-NS,66,2,3285,0,3,3290,T
8-NS,67,0,0,3293,0,3293,G
8-NS,68,1,3290,1,0,3292,T
8-NS,69,3294,0,0,1,3295,A
8-NS,70,0,1,3292,0,3293,G
8-NS,71,3322,0,3,0,3325,A
8-NS,72,0,1,0,3354,3355,C
8-NS,73,0,1,0,3329,3330,C
8-NS,74,3330,0,3,0,3333,A
8-NS,75,3422,0,1,0,3423,A
8-NS,76,0,1,3537,0,3538,G
8-NS,77,3531,0,0,1,3532,A
8-NS,78,3529,0,1,1,3531,A
8-NS,79,3475,0,4,1,3480,A
8-NS,80,0,3545,0,1,3546,T
8-NS,81,0,0,3567,0,3567,G
8-NS,82,3561,1,4,0,3566,A
8-NS,83,0,0,3649,0,3649,G
8-NS,84,1,3624,0,0,3625,T
8-NS,85,0,0,3605,0,3605,G
8-NS,86,3610,0,0,0,3610,A
8-NS,87,0,3618,0,0,3618,T
8-NS,88,2,0,3700,0,3702,G
8-NS,89,0,3,0,3729,3732,C
8-NS,90,0,0,0,3757,3757,C
8-NS,91,1,0,0,3773,3774,C
8-NS,92,1,0,0,3751,3752,C
8-NS,93,3761,0,2,1,3764,A
8-NS,94,2,3820,0,3,3825,T
8-NS,95,0,3890,0,3,3893,T
8-NS,96,0,1,0,3914,3915,C
8-NS,97,0,0,0,3898,3898,C
8-NS,98,1,3894,1,0,3896,T
8-NS,99,0,3886,0,1,3887,T
8-NS,100,1,1,3881,0,3883,G
8-NS,101,3878,0,1,1,3880,A
8-NS,102,1,3879,0,3,3883,T
8-NS,103,1,0,0,3864,3865,C
8-NS,104,1,2,3854,0,3857,G
8-NS,105,1,2,3912,0,3915,G
8-NS,106,0,0,0,3920,3920,C
8-NS,107,0,3915,0,1,3916,T
8-NS,108,1,3925,0,0,3926,T
8-NS,109,0,1,0,3916,3917,C
8-NS,110,1,0,3935,3,3939,G
8-NS,111,0,2,0,3942,3944,C
8-NS,112,1,0,0,3938,3939,C
8-NS,113,2,1,3945,0,3948,G
8-NS,114,3926,3,0,1,3930,A
8-NS,115,0,0,4118,0,4118,G
8-NS,116,4115,1,1,0,4117,A
8-NS,117,0,4130,1,1,4132,T
8-NS,118,1,0,0,4142,4143,C
8-NS,119,4134,2,3,1,4140,A
8-NS,120,0,0,4151,0,4151,G
8-NS,121,4141,0,2,1,4144,A
8-NS,122,0,0,4170,0,4170,G
8-NS,123,2,0,4221,0,4223,G
8-NS,124,1,4253,0,0,4254,T
8-NS,125,1,4,1,4537,4543,C
8-NS,126,1,0,0,4547,4548,C
8-NS,127,1,1,0,4580,4582,C
8-NS,128,1,4587,0,2,4590,T
8-NS,129,4587,1,0,1,4589,A
8-NS,130,4587,0,3,2,4592,A
8-NS,131,0,4,4664,0,4668,G
8-NS,132,1,4,4650,1,4656,G
8-NS,133,0,1,4643,0,4644,G
8-NS,134,0,5,4549,1,4555,G
8-NS,135,4534,1,3,0,4538,A
8-NS,136,4555,0,3,0,4558,A
8-NS,137,1,0,4590,0,4591,G
8-NS,138,4682,1,5,0,4688,A
8-NS,139,1,0,4759,0,4760,G
8-NS,140,0,0,4751,0,4751,G
8-NS,141,0,1,2,4759,4762,C
8-NS,142,4743,3,4,0,4750,A
8-NS,143,4752,0,2,1,4755,A
8-NS,144,0,4765,0,1,4766,T
8-NS,145,4792,0,1,0,4793,A
8-NS,146,1,1,0,4874,4876,C
8-NS,147,1,4816,0,2,4819,T
8-NS,148,2,2,1,4809,4814,C
8-NS,149,1,4778,0,1,4780,T
8-NS,150,0,3,0,4805,4808,C
8-NS,151,2,2,4887,0,4891,G
8-NS,152,1,1,5186,0,5188,G
8-NS,153,0,5197,0,3,5200,T
8-NS,154,2,0,0,5205,5207,C
8-NS,155,1,5187,0,1,5189,T
8-NS,156,5239,2,1,0,5242,A
8-NS,157,1,0,5238,0,5239,G
8-NS,158,5239,1,4,0,5244,A
8-NS,159,0,1,0,5378,5379,C
8-NS,160,5310,0,1,0,5311,A
8-NS,161,1,5233,0,1,5235,T
8-NS,162,0,1,0,5225,5226,C
8-NS,163,5225,2,0,0,5227,A
8-NS,164,5224,2,1,0,5227,A
8-NS,165,5190,2,1,2,5195,A
8-NS,166,1,0,5207,0,5208,G
8-NS,167,1,1,0,5226,5228,C
8-NS,168,5167,0,2,0,5169,A
8-NS,169,1,1,5188,1,5191,G
8-NS,170,2,0,0,5188,5190,C
8-NS,171,0,1,0,5197,5198,C
8-NS,172,5232,2,0,0,5234,A
8-NS,173,1,2,0,5300,5303,C
8-NS,174,2,0,0,5299,5301,C
8-NS,175,0,0,0,5304,5304,C
8-NS,176,5373,1,1,0,5375,A
8-NS,177,0,5393,0,5,5398,T
8-NS,178,2,0,5396,0,5398,G
8-NS,179,0,5374,0,6,5380,T
8-NS,180,0,5358,0,4,5362,T
8-NS,181,2,1,5369,0,5372,G
8-NS,182,1,0,5342,0,5343,G
8-NS,183,5334,0,2,0,5336,A
8-NS,184,5330,2,1,0,5333,A
8-NS,185,5268,0,6,0,5274,A
8-NS,186,2,1,5314,0,5317,G
8-NS,187,0,0,0,5307,5307,C
8-NS,188,5311,0,1,0,5312,A
8-NS,189,5305,2,0,0,5307,A
8-NS,190,5307,0,0,0,5307,A
8-NS,191,1,5334,0,1,5336,T
8-NS,192,0,5345,0,1,5346,T
8-NS,193,1,0,5422,1,5424,G
8-NS,194,1,5427,0,1,5429,T
8-NS,195,5411,4,4,0,5419,A
8-NS,196,1,1,5416,0,5418,G
8-NS,197,5405,1,2,0,5408,A
8-NS,198,5406,1,1,0,5408,A
8-NS,199,5401,1,1,0,5403,A
8-NS,200,5375,2,3,1,5381,A
8-NS,201,0,3,5393,0,5396,G
8-NS,202,5370,0,1,1,5372,A
8-NS,203,0,5359,0,1,5360,T
8-NS,204,1,5356,2,2,5361,T
8-NS,205,0,1,0,5383,5384,C
8-NS,206,1,5389,0,2,5392,T
8-NS,207,1,1,5398,0,5400,G
8-NS,208,5393,0,1,1,5395,A
8-NS,209,5389,0,1,1,5391,A
8-NS,210,5385,1,1,0,5387,A
8-NS,211,4,2,5406,0,5412,G
8-NS,212,5406,0,1,1,5408,A
8-NS,213,5413,0,1,1,5415,A
8-NS,214,1,0,5441,1,5443,G
8-NS,215,5490,0,0,0,5490,A
8-NS,216,5515,0,1,1,5517,A
8-NS,217,0,5516,0,1,5517,T
8-NS,218,2,1,0,5555,5558,C
8-NS,219,0,5553,1,3,5557,T
8-NS,220,1,0,5566,0,5567,G
8-NS,221,5573,1,3,0,5577,A
8-NS,222,0,5569,1,2,5572,T
8-NS,223,2,2,5539,1,5544,G
8-NS,224,5494,2,3,0,5499,A
8-NS,225,1,1,5485,2,5489,G
8-NS,226,0,1,5472,1,5474,G
8-NS,227,1,0,0,5467,5468,C
8-NS,228,5477,0,1,0,5478,A
8-NS,229,0,1,0,5595,5596,C
8-NS,230,0,5582,1,1,5584,T
8-NS,231,3,5601,0,1,5605,T
8-NS,232,5631,1,2,0,5634,A
8-NS,233,5656,0,0,0,5656,A
8-NS,234,5628,0,1,0,5629,A
8-NS,235,5617,1,3,0,5621,A
8-NS,236,2,5622,0,0,5624,T
8-NS,237,1,1,5627,0,5629,G
8-NS,238,5623,1,1,2,5627,A
8-NS,239,1,3,0,5614,5618,C
8-NS,240,1,0,0,5586,5587,C
8-NS,241,5603,1,1,0,5605,A
8-NS,242,0,5591,0,1,5592,T
8-NS,243,1,0,5701,0,5702,G
8-NS,244,2,2,5776,1,5781,G
8-NS,245,2,5793,0,2,5797,T
8-NS,246,0,2,1,6061,6064,C
8-NS,247,0,6015,0,4,6019,T
8-NS,248,3,0,1,6085,6089,C
8-NS,249,0,4,0,6087,6091,C
8-NS,250,6109,1,3,0,6113,A
8-NS,251,1,1,0,6162,6164,C
8-NS,252,6058,0,2,1,6061,A
8-NS,253,2,2,0,6047,6051,C
8-NS,254,1,1,0,5995,5997,C
8-NS,255,1,5737,0,6,5744,T
8-NS,256,0,1,5783,0,5784,G
8-NS,257,1,0,0,5739,5740,C
8-NS,258,1,5710,0,3,5714,T
8-NS,259,0,5741,0,3,5744,T
8-NS,260,1,2,1,5708,5712,C
8-NS,261,1,2,5722,0,5725,G
8-NS,262,0,0,0,5710,5710,C
8-NS,263,4,0,5710,0,5714,G
8-NS,264,5962,3,1,0,5966,A
8-NS,265,0,5952,0,2,5954,T
8-NS,266,6122,1,4,0,6127,A
8-NS,267,0,1,1,6149,6151,C
8-NS,268,6140,1,1,0,6142,A
8-NS,269,0,6290,0,2,6292,T
8-NS,270,6240,1,1,1,6243,A
8-NS,271,6262,1,3,0,6266,A
8-NS,272,1,1,0,6263,6265,C
8-NS,273,0,6069,0,1,6070,T
8-NS,274,1,0,6136,0,6137,G
8-NS,275,6053,1,11,0,6065,A
8-NS,276,0,0,0,6091,6091,C
8-NS,277,6070,1,5,0,6076,A
8-NS,278,1,6012,0,6,6019,T
8-NS,279,1,1,6024,0,6026,G
8-NS,280,6024,1,2,0,6027,A
8-NS,281,0,1,0,6200,6201,C
8-NS,282,1,6174,0,2,6177,T
8-NS,283,6250,0,1,1,6252,A
8-NS,284,1,6220,1,8,6230,T
8-NS,285,1,6193,0,1,6195,T
8-NS,286,1,0,6198,0,6199,G
8-NS,287,6161,1,4,0,6166,A
8-NS,288,1,2,6147,1,6151,G
8-NS,289,0,1,6155,2,6158,G
8-NS,290,6018,1,2,0,6021,A
8-NS,291,6039,0,1,0,6040,A
8-NS,292,2,5937,0,1,5940,T
8-NS,293,1,5934,0,5,5940,T
8-NS,294,0,0,6035,0,6035,G
8-NS,295,1,6023,0,1,6025,T
8-NS,296,0,1,0,6032,6033,C
8-NS,297,6035,0,3,0,6038,A
8-NS,298,6033,1,1,0,6035,A
8-NS,299,0,0,6041,0,6041,G
8-NS,300,6054,1,3,1,6059,A
8-NS,301,6041,2,3,1,6047,A
8-NS,302,6060,0,5,0,6065,A
8-NS,303,0,1,0,6061,6062,C
8-NS,304,2,6007,0,1,6010,T
8-NS,305,2,1,6087,1,6091,G
8-NS,306,1,1,6183,0,6185,G
8-NS,307,0,6181,0,3,6184,T
8-NS,308,0,6163,3,6,6172,T
8-NS,309,1,0,0,6142,6143,C
8-NS,310,6150,0,3,0,6153,A
8-NS,311,1,6233,0,5,6239,T
8-NS,312,2,2,6284,1,6289,G
8-NS,313,2,0,1,6322,6325,C
8-NS,314,0,6261,0,3,6264,T
8-NS,315,6186,2,4,0,6192,A
8-NS,316,6198,2,1,0,6201,A
8-NS,317,1,6233,1,3,6238,T
8-NS,318,2,2,6230,1,6235,G
8-NS,319,1,1,0,6229,6231,C
8-NS,320,3,0,0,6178,6181,C
8-NS,321,0,1,0,6174,6175,C
8-NS,322,6166,3,0,0,6169,A
8-NS,323,6178,1,23,0,6202,A
8-NS,324,2,0,6220,0,6222,G
8-NS,325,3,0,0,6225,6228,C
8-NS,326,6180,2,1,0,6183,A
8-NS,327,0,0,6222,0,6222,G
8-NS,328,6196,3,1,0,6200,A
8-NS,329,6205,1,0,0,6206,A
8-NS,330,6204,0,4,0,6208,A
8-NS,331,0,0,6291,1,6292,G
8-NS,332,3,6245,1,1,6250,T
8-NS,333,2,2,6227,1,6232,G
8-NS,334,1,0,6226,0,6227,G
8-NS,335,6220,1,5,1,6227,A
8-NS,336,6188,0,5,0,6193,A
8-NS,337,1,1,6188,0,6190,G
8-NS,338,1,1,6213,1,6216,G
8-NS,339,6208,0,2,0,6210,A
8-NS,340,3,0,0,6221,6224,C
8-NS,341,1,0,0,6192,6193,C
8-NS,342,0,6188,0,2,6190,T
8-NS,343,0,0,0,6466,6466,C
8-NS,344,1,6467,1,1,6470,T
8-NS,345,0,6471,0,1,6472,T
8-NS,346,0,6475,1,0,6476,T
8-NS,347,6281,2,3,0,6286,A
8-NS,348,0,0,0,6446,6446,C
8-NS,349,6459,0,2,0,6461,A
8-NS,350,1,6451,1,5,6458,T
8-NS,351,0,2,0,6466,6468,C
8-NS,352,6337,0,1,0,6338,A
8-NS,353,0,0,6503,0,6503,G
8-NS,354,6472,0,1,4,6477,A
8-NS,355,6474,5,1,0,6480,A
8-NS,356,0,6473,0,0,6473,T
8-NS,357,1,0,6358,1,6360,G
8-NS,358,8,1,6414,1,6424,G
8-NS,359,6417,0,2,0,6419,A
8-NS,360,0,2,0,6416,6418,C
8-NS,361,0,1,1,6264,6266,C
8-NS,362,6187,1,3,1,6192,A
8-NS,363,1,1,6256,0,6258,G
8-NS,364,4,1,6240,0,6245,G
8-NS,365,2,2,1,6261,6266,C
8-NS,366,6214,1,2,0,6217,A
8-NS,367,6235,2,1,1,6239,A
8-NS,368,0,6236,2,1,6239,T
8-NS,369,0,0,0,6226,6226,C
8-NS,370,6233,1,1,0,6235,A
8-NS,371,2,6195,0,4,6201,T
8-NS,372,2,0,6147,0,6149,G
8-NS,373,2,1,6179,0,6182,G
8-NS,374,6154,1,3,1,6159,A
8-NS,375,1,0,6184,0,6185,G
8-NS,376,6127,1,1,0,6129,A
8-NS,377,6115,0,2,0,6117,A
8-NS,378,6134,1,1,0,6136,A
8-NS,379,6128,0,3,0,6131,A
8-NS,380,6137,5,7,1,6150,A
8-NS,381,1,1,0,6157,6159,C
8-NS,382,6102,1,1,0,6104,A
8-NS,383,1,6082,0,3,6086,T
8-NS,384,0,3,1,6057,6061,C
8-NS,385,6048,1,8,0,6057,A
8-NS,386,0,3,0,6024,6027,C
8-NS,387,1,0,6074,0,6075,G
8-NS,388,1,6072,0,7,6080,T
8-NS,389,2,6060,0,0,6062,T
8-NS,390,1,1,6068,0,6070,G
8-NS,391,6068,0,1,0,6069,A
8-NS,392,6056,0,4,0,6060,A
8-NS,393,6064,0,1,0,6065,A
8-NS,394,1,1,6084,0,6086,G
8-NS,395,2,0,0,6046,6048,C
8-NS,396,1,1,6054,0,6056,G
8-NS,397,6041,1,3,2,6047,A
8-NS,398,6053,1,2,0,6056,A
8-NS,399,1,6040,1,1,6043,T
8-NS,400,1,6044,0,2,6047,T
8-NS,401,2,6048,0,2,6052,T
8-NS,402,0,1,0,6053,6054,C
8-NS,403,6019,0,3,2,6024,A
8-NS,404,1,1,6033,0,6035,G
8-NS,405,2,6011,0,8,6021,T
8-NS,406,1,0,6016,1,6018,G
8-NS,407,1,6015,1,1,6018,T
8-NS,408,0,0,6049,0,6049,G
8-NS,409,6076,1,1,0,6078,A
8-NS,410,1,6073,0,0,6074,T
8-NS,411,0,6062,0,1,6063,T
8-NS,412,2,6064,0,1,6067,T
8-NS,413,1,6062,0,2,6065,T
8-NS,414,0,6064,0,1,6065,T
8-NS,415,1,1,6057,0,6059,G
8-NS,416,6078,0,2,0,6080,A
8-NS,417,0,1,0,6062,6063,C
8-NS,418,3,2,0,6014,6019,C
8-NS,419,1,0,6059,0,6060,G
8-NS,420,6462,1,2,0,6465,A
8-NS,421,3,2,0,6588,6593,C
8-NS,422,1,6589,1,1,6592,T
8-NS,423,6625,0,0,0,6625,A
8-NS,424,0,0,6624,1,6625,G
8-NS,425,6621,1,3,0,6625,A
8-NS,426,1,1,6687,1,6690,G
8-NS,427,6671,0,6,0,6677,A
8-NS,428,1,1,0,6813,6815,C
8-NS,429,2,2,1,6447,6452,C
8-NS,430,6266,1,4,1,6272,A
8-NS,431,1,6583,0,2,6586,T
8-NS,432,6556,1,1,1,6559,A
8-NS,433,0,1,7027,0,7028,G
8-NS,434,3,6977,1,2,6983,T
8-NS,435,6930,1,0,1,6932,A
8-NS,436,2,6921,1,2,6926,T
8-NS,437,0,6716,2,1,6719,T
8-NS,438,6944,0,3,1,6948,A
8-NS,439,1,1,1,6941,6944,C
8-NS,440,0,6659,2,2,6663,T
8-NS,441,6652,0,1,0,6653,A
8-NS,442,6049,2,2,1,6054,A
8-NS,443,3,0,6087,1,6091,G
8-NS,444,1,1,6056,1,6059,G
8-NS,445,0,2,6082,0,6084,G
8-NS,446,0,2,1,6006,6009,C
8-NS,447,0,5896,3,9,5908,T
8-NS,448,1,5887,4,4,5896,T
8-NS,449,0,5970,0,3,5973,T
8-NS,450,0,2,0,6001,6003,C
8-NS,451,6087,0,6,0,6093,A
8-NS,452,1,0,0,6098,6099,C
8-NS,453,0,1,0,6029,6030,C
8-NS,454,4,0,6031,0,6035,G
8-NS,455,6021,3,1,0,6025,A
8-NS,456,6022,0,0,0,6022,A
8-NS,457,0,0,6047,0,6047,G
8-NS,458,5971,0,3,1,5975,A
8-NS,459,1,5,5976,0,5982,G
8-NS,460,0,2,5884,0,5886,G
8-NS,461,3,0,5936,0,5939,G
8-NS,462,5921,1,8,0,5930,A
8-NS,463,2,0,5937,0,5939,G
8-NS,464,1,2,0,5910,5913,C
8-NS,465,5918,0,1,2,5921,A
8-NS,466,5926,2,4,0,5932,A
8-NS,467,0,5926,1,3,5930,T
8-NS,468,1,5904,0,1,5906,T
8-NS,469,0,1,5913,0,5914,G
8-NS,470,1,5858,0,1,5860,T
8-NS,471,2,5857,0,6,5865,T
8-NS,472,1,0,5858,0,5859,G
8-NS,473,0,0,5856,0,5856,G
8-NS,474,0,13,1,5860,5874,C
8-NS,475,0,1,5863,0,5864,G
8-NS,476,5868,0,3,0,5871,A
8-NS,477,5904,0,0,0,5904,A
8-NS,478,5926,0,1,0,5927,A
8-NS,479,0,5927,0,1,5928,T
8-NS,480,0,0,0,5947,5947,C
8-NS,481,1,5911,0,2,5914,T
8-NS,482,1,0,0,5931,5932,C
8-NS,483,5941,0,2,1,5944,A
8-NS,484,2,1,0,5945,5948,C
8-NS,485,0,0,2,5938,5940,C
8-NS,486,5892,1,1,0,5894,A
8-NS,487,1,5874,0,3,5878,T
8-NS,488,0,5856,0,3,5859,T
8-NS,489,1,0,5863,0,5864,G
8-NS,490,2,2,1,5850,5855,C
8-NS,491,0,3,0,5843,5846,C
8-NS,492,1,5848,0,6,5855,T
8-NS,493,3,5830,1,3,5837,T
8-NS,494,2,2,1,5860,5865,C
8-NS,495,0,5859,0,2,5861,T
8-NS,496,1,5854,1,1,5857,T
8-NS,497,1,5953,1,2,5957,T
8-NS,498,2,5931,0,3,5936,T
8-NS,499,1,1,0,5942,5944,C
8-NS,500,1,2,0,5939,5942,C
8-NS,501,5934,1,5,0,5940,A
8-NS,502,1,4,6006,0,6011,G
8-NS,503,1,1,5994,0,5996,G
8-NS,504,6113,1,0,0,6114,A
8-NS,505,1,2,0,6117,6120,C
8-NS,506,6122,0,1,1,6124,A
8-NS,507,2,6138,1,2,6143,T
8-NS,508,6156,1,1,0,6158,A
8-NS,509,1,1,0,6560,6562,C
8-NS,510,0,6534,0,1,6535,T
8-NS,511,6495,0,2,0,6497,A
8-NS,512,2,6477,0,1,6480,T
8-NS,513,0,6260,0,2,6262,T
8-NS,514,0,0,6254,1,6255,G
8-NS,515,6048,0,2,0,6050,A
8-NS,516,1,1,6051,1,6054,G
8-NS,517,0,1,6024,0,6025,G
8-NS,518,5475,0,0,0,5475,A
8-NS,519,0,5468,0,1,5469,T
8-NS,520,1,3,5418,0,5422,G
8-NS,521,1,5394,0,14,5409,T
8-NS,522,0,1,0,5415,5416,C
8-NS,523,5419,0,5,2,5426,A
8-NS,524,5423,0,2,0,5425,A
8-NS,525,5410,0,1,0,5411,A
8-NS,526,5403,0,0,0,5403,A
8-NS,527,5419,1,0,0,5420,A
8-NS,528,0,5396,0,1,5397,T
8-NS,529,0,1,5389,0,5390,G
8-NS,530,0,0,2,5420,5422,C
8-NS,531,5413,1,1,2,5417,A
8-NS,532,5436,2,1,0,5439,A
8-NS,533,1,5450,1,0,5452,T
8-NS,534,0,5450,1,2,5453,T
8-NS,535,0,2,5437,2,5441,G
8-NS,536,1,4,5393,1,5399,G
8-NS,537,0,1,5405,0,5406,G
8-NS,538,2,1,5444,0,5447,G
8-NS,539,2,5370,0,5,5377,T
8-NS,540,1,0,0,5430,5431,C
8-NS,541,0,2,0,5448,5450,C
8-NS,542,0,5441,0,5,5446,T
8-NS,543,0,0,0,5498,5498,C
8-NS,544,5481,4,2,0,5487,A
8-NS,545,2,5507,0,0,5509,T
8-NS,546,0,2,0,5513,5515,C
8-NS,547,1,2,5436,0,5439,G
8-NS,548,0,1,5447,2,5450,G
8-NS,549,5369,0,5,0,5374,A
8-NS,550,1,0,5356,0,5357,G
8-NS,551,1,1,5386,0,5388,G
8-NS,552,5313,2,1,1,5317,A
8-NS,553,1,0,0,5339,5340,C
8-NS,554,0,5329,0,1,5330,T
8-NS,555,1,5332,0,1,5334,T
8-NS,556,1,1,5350,0,5352,G
8-NS,557,5316,0,3,1,5320,A
8-NS,558,5318,0,2,0,5320,A
8-NS,559,2,5303,0,3,5308,T
8-NS,560,0,1,5210,0,5211,G
8-NS,561,0,1,5269,1,5271,G
8-NS,562,5217,0,2,0,5219,A
8-NS,563,5262,0,0,0,5262,A
8-NS,564,0,5401,0,2,5403,T
8-NS,565,0,1,5421,0,5422,G
8-NS,566,5441,2,0,0,5443,A
8-NS,567,1,5446,0,0,5447,T
8-NS,568,5430,0,5,0,5435,A
8-NS,569,5456,3,4,0,5463,A
8-NS,570,0,0,0,5398,5398,C
8-NS,571,5304,1,1,0,5306,A
8-NS,572,0,0,0,5325,5325,C
8-NS,573,4845,0,2,0,4847,A
8-NS,574,0,0,4919,0,4919,G
8-NS,575,0,4884,0,3,4887,T
8-NS,576,0,4881,0,4,4885,T
8-NS,577,0,0,0,4890,4890,C
8-NS,578,1,1,4851,0,4853,G
8-NS,579,4828,0,2,0,4830,A
8-NS,580,1,0,4833,0,4834,G
8-NS,581,1,4783,0,1,4785,T
8-NS,582,0,0,0,4798,4798,C
8-NS,583,2,4704,0,4,4710,T
8-NS,584,1,0,0,4747,4748,C
8-NS,585,0,4744,0,3,4747,T
8-NS,586,4755,0,0,0,4755,A
8-NS,587,4746,1,0,0,4747,A
8-NS,588,4731,0,1,0,4732,A
8-NS,589,4765,1,1,0,4767,A
8-NS,590,4768,1,0,0,4769,A
8-NS,591,0,4721,0,0,4721,T
8-NS,592,0,0,0,4759,4759,C
8-NS,593,0,4721,0,1,4722,T
8-NS,594,4743,1,2,0,4746,A
8-NS,595,0,3,0,4735,4738,C
8-NS,596,4738,0,0,0,4738,A
8-NS,597,0,0,4748,1,4749,G
8-NS,598,4652,0,1,0,4653,A
8-NS,599,0,0,4674,0,4674,G
8-NS,600,4671,1,0,0,4672,A
8-NS,601,0,4615,0,0,4615,T
8-NS,602,0,4618,0,2,4620,T
8-NS,603,1,1,0,4604,4606,C
8-NS,604,0,0,4616,0,4616,G
8-NS,605,0,1,0,4617,4618,C
8-NS,606,1,4595,0,1,4597,T
8-NS,607,0,4600,0,1,4601,T
8-NS,608,0,1,4580,1,4582,G
8-NS,609,1,0,4605,0,4606,G
8-NS,610,4602,0,1,0,4603,A
8-NS,611,0,0,4601,0,4601,G
8-NS,612,4581,1,1,0,4583,A
8-NS,613,4540,1,0,0,4541,A
8-NS,614,1,1,4601,0,4603,G
8-NS,615,1,1,0,4599,4601,C
8-NS,616,4596,0,11,0,4607,A
8-NS,617,0,0,4665,0,4665,G
8-NS,618,0,4607,1,1,4609,T
8-NS,619,4632,1,3,0,4636,A
8-NS,620,4626,2,1,0,4629,A
8-NS,621,2,4619,0,2,4623,T
8-NS,622,1,0,4635,0,4636,G
8-NS,623,4411,1,4,0,4416,A
8-NS,624,2,1,4507,0,4510,G
8-NS,625,4464,1,3,0,4468,A
8-NS,626,4335,3,0,0,4338,A
8-NS,627,2,4327,0,0,4329,T
8-NS,628,0,0,4258,0,4258,G
8-NS,629,1,0,4271,0,4272,G
8-NS,630,3,1,4261,0,4265,G
8-NS,631,1,2,4236,1,4240,G
8-NS,632,2,1,4266,1,4270,G
8-NS,633,4168,0,1,0,4169,A
8-NS,634,1,2,0,4198,4201,C
8-NS,635,1,1,1,4199,4202,C
8-NS,636,0,4149,0,5,4154,T
8-NS,637,1,1,0,4174,4176,C
8-NS,638,1,0,0,4190,4191,C
8-NS,639,4205,1,2,1,4209,A
8-NS,640,0,1,0,4201,4202,C
8-NS,641,0,4119,0,0,4119,T
8-NS,642,0,4103,0,1,4104,T
8-NS,643,3968,0,0,1,3969,A
8-NS,644,0,0,0,4002,4002,C
8-NS,645,0,3972,1,1,3974,T
8-NS,646,0,1,0,3943,3944,C
8-NS,647,1,1,0,3882,3884,C
8-NS,648,3879,2,0,0,3881,A
8-NS,649,3876,1,4,0,3881,A
8-NS,650,3877,1,1,0,3879,A
8-NS,651,3872,1,0,1,3874,A
8-NS,652,0,0,1,3874,3875,C
8-NS,653,3797,0,1,0,3798,A
8-NS,654,0,0,3798,0,3798,G
8-NS,655,3787,0,0,0,3787,A
8-NS,656,3788,0,0,0,3788,A
8-NS,657,3783,2,0,0,3785,A
8-NS,658,0,3,0,3782,3785,C
8-NS,659,1,1,3777,0,3779,G
8-NS,660,0,1,3783,0,3784,G
8-NS,661,1,2,3785,1,3789,G
8-NS,662,3791,0,0,0,3791,A
8-NS,663,3761,1,0,0,3762,A
8-NS,664,3756,0,7,2,3765,A
8-NS,665,0,3760,0,0,3760,T
8-NS,666,2,1,3788,0,3791,G
8-NS,667,1,0,3783,0,3784,G
8-NS,668,0,1,0,3757,3758,C
8-NS,669,0,0,3763,1,3764,G
8-NS,670,3740,0,3,0,3743,A
8-NS,671,0,0,3766,0,3766,G
8-NS,672,3762,0,0,0,3762,A
8-NS,673,3757,1,2,0,3760,A
8-NS,674,0,1,0,3778,3779,C
8-NS,675,3694,0,1,0,3695,A
8-NS,676,0,0,3697,0,3697,G
8-NS,677,2,2,0,3677,3681,C
8-NS,678,1,3685,0,0,3686,T
8-NS,679,3668,0,0,0,3668,A
8-NS,680,0,0,3622,0,3622,G
8-NS,681,0,0,3642,0,3642,G
8-NS,682,1,3624,1,1,3627,T
8-NS,683,1,3,0,3566,3570,C
8-NS,684,3569,0,0,0,3569,A
8-NS,685,3567,0,1,1,3569,A
8-NS,686,3571,0,0,0,3571,A
8-NS,687,3599,0,1,0,3600,A
8-NS,688,0,1,3606,0,3607,G
8-NS,689,0,3524,0,0,3524,T
8-NS,690,1,3502,0,0,3503,T
8-NS,691,0,3519,0,0,3519,T
8-NS,692,0,1,3528,0,3529,G
8-NS,693,3525,1,3,0,3529,A
8-NS,694,3517,0,9,0,3526,A
8-NS,695,0,1,3555,0,3556,G
8-NS,696,3482,0,0,0,3482,A
8-NS,697,0,0,3506,0,3506,G
8-NS,698,3505,0,1,0,3506,A
8-NS,699,1,3503,0,1,3505,T
8-NS,700,3512,0,1,0,3513,A
8-NS,701,3497,1,2,0,3500,A
8-NS,702,1,0,3496,0,3497,G
8-NS,703,3274,0,0,0,3274,A
8-NS,704,1,3280,0,0,3281,T
8-NS,705,1,1,3285,0,3287,G
8-NS,706,1,0,3291,0,3292,G
8-NS,707,0,2,0,3292,3294,C
8-NS,708,1,3268,1,1,3271,T
8-NS,709,3277,2,1,1,3281,A
8-NS,710,3267,0,1,0,3268,A
8-NS,711,0,3279,1,0,3280,T
8-NS,712,2,3272,0,2,3276,T
8-NS,713,1,1,3280,0,3282,G
8-NS,714,3222,0,0,0,3222,A
8-NS,715,3215,1,0,0,3216,A
8-NS,716,0,0,3215,0,3215,G
8-NS,717,3204,0,0,1,3205,A
8-NS,718,3157,0,1,1,3159,A
8-NS,719,0,0,3204,0,3204,G
8-NS,720,1,3136,0,3,3140,T
8-NS,721,2,0,3142,0,3144,G
8-NS,722,3110,0,2,0,3112,A
8-NS,723,0,1,3111,0,3112,G
8-NS,724,3116,0,1,1,3118,A
8-NS,725,0,0,0,3092,3092,C
8-NS,726,3070,0,4,0,3074,A
8-NS,727,0,1,0,3067,3068,C
8-NS,728,2849,1,2,0,2852,A
8-NS,729,0,0,2900,0,2900,G
8-NS,730,2874,0,0,0,2874,A
8-NS,731,1,2853,0,1,2855,T
8-NS,732,0,2850,0,1,2851,T
8-NS,733,2844,0,0,1,2845,A
8-NS,734,2842,0,0,0,2842,A
8-NS,735,2837,0,2,0,2839,A
8-NS,736,2827,0,1,0,2828,A
8-NS,737,2831,0,0,0,2831,A
8-NS,738,1,0,0,2728,2729,C
8-NS,739,2594,1,1,0,2596,A
8-NS,740,2605,1,0,0,2606,A
8-NS,741,0,0,0,2608,2608,C
8-NS,742,0,2591,0,2,2593,T
8-NS,743,2,1,2595,0,2598,G
8-NS,744,2592,0,1,0,2593,A
8-NS,745,2591,0,1,0,2592,A
8-NS,746,2590,1,0,2,2593,A
8-NS,747,2570,1,1,1,2573,A
8-NS,748,1,2571,0,0,2572,T
8-NS,749,2541,1,0,1,2543,A
8-NS,750,0,0,2541,0,2541,G
8-NS,751,1,2465,0,0,2466,T
8-NS,752,0,2470,1,0,2471,T
8-NS,753,0,2475,0,1,2476,T
8-NS,754,0,2484,0,0,2484,T
8-NS,755,0,1,2488,0,2489,G
8-NS,756,2494,1,0,0,2495,A
8-NS,757,2491,1,2,0,2494,A
8-NS,758,0,0,0,2493,2493,C
8-NS,759,2462,1,0,0,2463,A
8-NS,760,2476,0,0,0,2476,A
8-NS,761,2478,0,1,0,2479,A
8-NS,762,1,2477,0,0,2478,T
8-NS,763,2475,0,1,0,2476,A
8-NS,764,2461,0,1,0,2462,A
8-NS,765,1,0,0,2459,2460,C
8-NS,766,2437,1,1,1,2440,A
8-NS,767,0,2406,1,1,2408,T
8-NS,768,1,2363,0,0,2364,T
8-NS,769,0,0,0,2311,2311,C
8-NS,770,2285,0,0,0,2285,A
8-NS,771,0,2283,0,0,2283,T
8-NS,772,1,0,2285,0,2286,G
8-NS,773,0,1,0,2240,2241,C
8-NS,774,2204,0,1,0,2205,A
8-NS,775,2190,0,0,0,2190,A
8-NS,776,0,1,2186,0,2187,G
8-NS,777,0,0,0,2211,2211,C
8-NS,778,2168,0,0,0,2168,A
8-NS,779,0,2158,0,1,2159,T
8-NS,780,0,2149,0,0,2149,T
8-NS,781,2152,0,1,0,2153,A
8-NS,782,0,0,0,2153,2153,C
8-NS,783,2125,0,0,0,2125,A
8-NS,784,2094,1,0,0,2095,A
8-NS,785,1,0,0,2072,2073,C
8-NS,786,1,1706,0,1,1708,T
8-NS,787,0,0,1708,0,1708,G
8-NS,788,0,1,0,1664,1665,C
8-NS,789,0,1616,0,0,1616,T
8-NS,790,1,0,1624,0,1625,G
8-NS,791,0,1581,0,1,1582,T
8-NS,792,1,1581,0,0,1582,T
8-NS,793,0,1583,0,0,1583,T
8-NS,794,1,1,1560,0,1562,G
8-NS,795,1560,0,0,0,1560,A
8-NS,796,1541,1,0,0,1542,A
8-NS,797,0,1,1540,0,1541,G
8-NS,798,1,1521,0,1,1523,T
8-NS,799,1,0,1461,0,1462,G
8-NS,800,1,0,1470,0,1471,G
8-NS,801,1474,1,0,0,1475,A
8-NS,802,1474,0,0,0,1474,A
8-NS,803,0,0,0,1472,1472,C
8-NS,804,1420,0,1,0,1421,A
8-NS,805,0,0,1419,0,1419,G
8-NS,806,0,0,1387,1,1388,G
8-NS,807,1355,0,2,0,1357,A
8-NS,808,0,0,1353,0,1353,G
8-NS,809,1062,0,2,0,1064,A
8-NS,810,0,1059,0,1,1060,T
8-NS,811,1054,0,0,0,1054,A
8-NS,812,1037,0,1,0,1038,A
8-NS,813,1,0,1040,0,1041,G
8-NS,814,910,0,0,0,910,A
8-NS,815,901,0,0,0,901,A
8-NS,816,0,0,0,894,894,C
8-NS,817,0,756,0,0,756,T
8-NS,818,0,752,0,0,752,T
8-NS,819,0,748,0,1,749,T
8-NS,820,0,0,0,753,753,C
8-NS,821,0,746,0,1,747,T
8-NS,822,2,0,0,734,736,C
8-NS,823,719,0,0,0,719,A
8-NS,824,0,719,0,0,719,T
8-NS,825,0,700,0,1,701,T
8-NS,826,0,697,0,0,697,T
8-NS,827,0,0,0,696,696,C
8-NS,828,670,0,0,0,670,A
8-NS,829,0,0,668,0,668,G
8-NS,830,0,0,0,668,668,C
8-NS,831,1,627,0,1,629,T
8-NS,832,0,629,0,0,629,T
8-NS,833,602,0,0,0,602,A
8-NS,834,0,602,0,0,602,T
8-NS,835,0,599,0,0,599,T
8-NS,836,1,592,0,1,594,T
8-NS,837,575,0,0,0,575,A
8-NS,838,559,0,0,0,559,A
8-NS,839,0,547,0,0,547,T
8-NS,840,0,0,542,0,542,G
8-NS,841,518,0,1,0,519,A
8-NS,842,0,466,0,0,466,T
8-NS,843,454,0,0,0,454,A
8-NS,844,454,0,0,0,454,A
8-NS,845,452,0,0,0,452,A
8-NS,846,452,0,1,0,453,A
8-NS,847,450,0,0,0,450,A
8-NS,848,447,0,1,0,448,A
8-NS,849,0,0,0,446,446,C
8-NS,850,376,0,0,0,376,A
8-NS,851,0,0,0,370,370,C
8-NS,852,0,0,0,351,351,C
8-NS,853,0,0,0,339,339,C
8-NS,854,0,316,0,0,316,T
8-NS,855,0,308,0,0,308,T
8-NS,856,0,0,309,0,309,G
8-NS,857,0,300,0,0,300,T
8-NS,858,0,294,0,0,294,T
8-NS,859,0,287,0,0,287,T
8-NS,860,0,0,0,118,118,C
8-NS,861,1,77,0,0,78,T
8-NS,862,63,0,0,0,63,A
8-NS,863,0,0,0,63,63,C
