Gene,Position,A,T,G,C,Coverage,Consensus
1-PB2,1,378,0,0,0,378,A
1-PB2,2,0,377,0,0,377,T
1-PB2,3,0,0,387,0,387,G
1-PB2,4,0,3,388,0,391,G
1-PB2,5,390,0,0,0,390,A
1-PB2,6,389,0,0,0,389,A
1-PB2,7,389,0,0,0,389,A
1-PB2,8,0,1,426,0,427,G
1-PB2,9,428,0,0,0,428,A
1-PB2,10,429,0,0,0,429,A
1-PB2,11,0,440,0,0,440,T
1-PB2,12,439,0,0,0,439,A
1-PB2,13,440,0,0,0,440,A
1-PB2,14,443,0,0,0,443,A
1-PB2,15,441,1,0,1,443,A
1-PB2,16,0,2,455,0,457,G
1-PB2,17,459,0,1,0,460,A
1-PB2,18,462,0,0,0,462,A
1-PB2,19,0,0,0,470,470,C
1-PB2,20,0,470,0,0,470,T
1-PB2,21,476,0,0,0,476,A
1-PB2,22,0,0,0,476,476,C
1-PB2,23,1,1,475,0,477,G
1-PB2,24,0,0,485,0,485,G
1-PB2,25,484,1,0,0,485,A
1-PB2,26,504,0,0,0,504,A
1-PB2,27,0,503,0,1,504,T
1-PB2,28,0,0,0,505,505,C
1-PB2,29,0,505,0,1,506,T
1-PB2,30,0,0,510,0,510,G
1-PB2,31,514,0,0,0,514,A
1-PB2,32,0,514,0,0,514,T
1-PB2,33,0,0,516,0,516,G
1-PB2,34,0,520,0,1,521,T
1-PB2,35,1,0,0,518,519,C
1-PB2,36,0,0,519,0,519,G
1-PB2,37,1,0,0,519,520,C
1-PB2,38,519,0,0,0,519,A
1-PB2,39,0,1,543,0,544,G
1-PB2,40,0,548,0,1,549,T
1-PB2,41,3,0,0,548,551,C
1-PB2,42,0,549,0,0,549,T
1-PB2,43,0,1,0,550,551,C
1-PB2,44,0,0,552,0,552,G
1-PB2,45,0,0,0,551,551,C
1-PB2,46,549,0,3,0,552,A
1-PB2,47,0,0,0,562,562,C
1-PB2,48,0,557,0,0,557,T
1-PB2,49,0,1,0,573,574,C
1-PB2,50,0,0,574,0,574,G
1-PB2,51,0,0,0,576,576,C
1-PB2,52,0,0,578,0,578,G
1-PB2,53,579,0,1,0,580,A
1-PB2,54,0,0,582,0,582,G
1-PB2,55,595,0,0,0,595,A
1-PB2,56,0,593,0,0,593,T
1-PB2,57,595,0,1,0,596,A
1-PB2,58,1,0,0,594,595,C
1-PB2,59,0,586,0,0,586,T
1-PB2,60,2,1,595,0,598,G
1-PB2,61,598,0,0,0,598,A
1-PB2,62,0,0,0,607,607,C
1-PB2,63,606,0,0,0,606,A
1-PB2,64,607,0,0,0,607,A
1-PB2,65,622,0,0,0,622,A
1-PB2,66,628,0,0,0,628,A
1-PB2,67,630,0,0,0,630,A
1-PB2,68,1,0,1,631,633,C
1-PB2,69,1,0,0,631,632,C
1-PB2,70,655,0,1,0,656,A
1-PB2,71,0,0,0,668,668,C
1-PB2,72,668,0,1,0,669,A
1-PB2,73,0,0,691,0,691,G
1-PB2,74,0,684,0,0,684,T
1-PB2,75,0,0,704,0,704,G
1-PB2,76,0,0,712,0,712,G
1-PB2,77,715,0,2,0,717,A
1-PB2,78,0,0,0,749,749,C
1-PB2,79,2,0,0,743,745,C
1-PB2,80,763,0,0,0,763,A
1-PB2,81,0,760,0,0,760,T
1-PB2,82,758,0,0,0,758,A
1-PB2,83,1,755,0,0,756,T
1-PB2,84,0,0,756,0,756,G
1-PB2,85,0,0,768,0,768,G
1-PB2,86,0,0,0,767,767,C
1-PB2,87,2,0,0,748,750,C
1-PB2,88,751,0,0,0,751,A
1-PB2,89,0,775,0,0,775,T
1-PB2,90,773,0,1,0,774,A
1-PB2,91,810,0,0,0,810,A
1-PB2,92,0,811,0,0,811,T
1-PB2,93,1,808,0,0,809,T
1-PB2,94,805,0,0,0,805,A
1-PB2,95,802,0,0,0,802,A
1-PB2,96,792,0,0,0,792,A
1-PB2,97,816,0,1,0,817,A
1-PB2,98,818,0,4,0,822,A
1-PB2,99,0,0,847,0,847,G
1-PB2,100,0,842,0,0,842,T
1-PB2,101,843,0,0,0,843,A
1-PB2,102,0,0,0,845,845,C
1-PB2,103,848,0,0,0,848,A
1-PB2,104,0,0,0,868,868,C
1-PB2,105,873,0,0,0,873,A
1-PB2,106,0,882,0,0,882,T
1-PB2,107,1,0,0,877,878,C
1-PB2,108,0,2,874,0,876,G
1-PB2,109,0,1,873,0,874,G
1-PB2,110,0,2,871,0,873,G
1-PB2,111,0,2,874,0,876,G
1-PB2,112,871,0,0,0,871,A
1-PB2,113,0,1,869,0,870,G
1-PB2,114,862,0,1,0,863,A
1-PB2,115,1,0,0,868,869,C
1-PB2,116,862,0,1,0,863,A
1-PB2,117,1,2,870,0,873,G
1-PB2,118,0,1,895,0,896,G
1-PB2,119,897,0,0,0,897,A
1-PB2,120,894,0,0,0,894,A
1-PB2,121,896,0,0,1,897,A
1-PB2,122,893,0,1,0,894,A
1-PB2,123,0,0,896,0,896,G
1-PB2,124,890,0,1,0,891,A
1-PB2,125,886,0,4,1,891,A
1-PB2,126,0,0,0,888,888,C
1-PB2,127,0,0,0,885,885,C
1-PB2,128,1,0,0,883,884,C
1-PB2,129,1,0,885,0,886,G
1-PB2,130,0,885,0,0,885,T
1-PB2,131,0,0,0,887,887,C
1-PB2,132,890,1,0,0,891,A
1-PB2,133,0,0,0,903,903,C
1-PB2,134,0,898,0,1,899,T
1-PB2,135,0,897,0,0,897,T
1-PB2,136,893,0,1,0,894,A
1-PB2,137,0,1,910,1,912,G
1-PB2,138,1,0,913,0,914,G
1-PB2,139,909,0,1,0,910,A
1-PB2,140,0,914,0,0,914,T
1-PB2,141,8,2,910,0,920,G
1-PB2,142,924,0,2,0,926,A
1-PB2,143,926,0,0,0,926,A
1-PB2,144,927,0,2,0,929,A
1-PB2,145,0,924,0,1,925,T
1-PB2,146,2,0,924,0,926,G
1-PB2,147,1,1,925,0,927,G
1-PB2,148,926,0,0,0,926,A
1-PB2,149,0,931,0,1,932,T
1-PB2,150,0,1,925,0,926,G
1-PB2,151,919,0,1,0,920,A
1-PB2,152,0,922,0,1,923,T
1-PB2,153,1,0,920,0,921,G
1-PB2,154,0,1,923,0,924,G
1-PB2,155,0,0,0,920,920,C
1-PB2,156,913,0,1,0,914,A
1-PB2,157,924,1,0,0,925,A
1-PB2,158,0,931,0,0,931,T
1-PB2,159,0,0,971,1,972,G
1-PB2,160,968,1,2,0,971,A
1-PB2,161,966,2,1,0,969,A
1-PB2,162,976,0,0,0,976,A
1-PB2,163,0,978,0,0,978,T
1-PB2,164,990,0,0,0,990,A
1-PB2,165,0,1,0,1014,1015,C
1-PB2,166,3,0,0,1001,1004,C
1-PB2,167,4,0,0,1009,1013,C
1-PB2,168,1001,0,0,0,1001,A
1-PB2,169,1006,0,0,0,1006,A
1-PB2,170,0,1008,0,0,1008,T
1-PB2,171,2,0,0,1004,1006,C
1-PB2,172,996,0,1,0,997,A
1-PB2,173,0,0,0,1017,1017,C
1-PB2,174,0,1005,0,2,1007,T
1-PB2,175,0,0,1011,0,1011,G
1-PB2,176,0,0,0,1010,1010,C
1-PB2,177,0,1006,0,4,1010,T
1-PB2,178,0,3,1020,0,1023,G
1-PB2,179,1024,0,0,0,1024,A
1-PB2,180,0,0,0,1035,1035,C
1-PB2,181,1037,0,0,0,1037,A
1-PB2,182,1018,0,1,0,1019,A
1-PB2,183,1023,0,0,0,1023,A
1-PB2,184,1017,0,2,0,1019,A
1-PB2,185,0,0,1047,0,1047,G
1-PB2,186,1,2,1044,0,1047,G
1-PB2,187,1040,0,0,0,1040,A
1-PB2,188,0,1045,0,0,1045,T
1-PB2,189,1040,0,0,0,1040,A
1-PB2,190,1045,0,1,0,1046,A
1-PB2,191,0,1,0,1056,1057,C
1-PB2,192,1053,0,0,0,1053,A
1-PB2,193,0,1,1053,0,1054,G
1-PB2,194,1039,1,1,0,1041,A
1-PB2,195,1038,0,1,0,1039,A
1-PB2,196,1040,1,0,0,1041,A
1-PB2,197,0,1040,0,0,1040,T
1-PB2,198,0,1,1044,0,1045,G
1-PB2,199,0,1,1051,0,1052,G
1-PB2,200,0,1052,0,2,1054,T
1-PB2,201,0,1048,0,0,1048,T
1-PB2,202,3,0,0,1049,1052,C
1-PB2,203,0,1,0,1048,1049,C
1-PB2,204,0,3,1047,0,1050,G
1-PB2,205,0,1,1048,0,1049,G
1-PB2,206,1047,0,1,0,1048,A
1-PB2,207,0,1,1057,0,1058,G
1-PB2,208,1046,0,2,1,1049,A
1-PB2,209,0,0,1073,0,1073,G
1-PB2,210,1075,0,0,0,1075,A
1-PB2,211,1073,0,0,0,1073,A
1-PB2,212,1074,0,1,0,1075,A
1-PB2,213,0,1076,0,0,1076,T
1-PB2,214,0,6,1085,0,1091,G
1-PB2,215,1098,0,1,0,1099,A
1-PB2,216,1093,0,1,0,1094,A
1-PB2,217,1,0,0,1093,1094,C
1-PB2,218,1084,0,0,1,1085,A
1-PB2,219,1086,0,2,0,1088,A
1-PB2,220,0,1,1125,0,1126,G
1-PB2,221,1,0,1133,0,1134,G
1-PB2,222,1137,1,2,0,1140,A
1-PB2,223,0,1,0,1130,1131,C
1-PB2,224,1122,1,0,0,1123,A
1-PB2,225,1128,0,2,0,1130,A
1-PB2,226,1129,0,0,0,1129,A
1-PB2,227,0,0,0,1123,1123,C
1-PB2,228,1,0,1,1093,1095,C
1-PB2,229,3,0,0,1212,1215,C
1-PB2,230,0,1214,0,0,1214,T
1-PB2,231,1220,0,0,0,1220,A
1-PB2,232,0,1217,0,0,1217,T
1-PB2,233,0,3,1223,0,1226,G
1-PB2,234,0,3,1260,0,1263,G
1-PB2,235,1213,0,0,0,1213,A
1-PB2,236,0,0,1228,0,1228,G
1-PB2,237,0,1226,0,1,1227,T
1-PB2,238,1227,0,0,0,1227,A
1-PB2,239,1231,0,0,0,1231,A
1-PB2,240,1229,0,1,1,1231,A
1-PB2,241,1230,0,1,0,1231,A
1-PB2,242,0,1221,0,1,1222,T
1-PB2,243,0,2,1212,0,1214,G
1-PB2,244,1190,0,2,0,1192,A
1-PB2,245,0,1,1205,0,1206,G
1-PB2,246,0,1201,0,0,1201,T
1-PB2,247,0,0,1193,0,1193,G
1-PB2,248,1219,1,0,0,1220,A
1-PB2,249,2,1223,0,0,1225,T
1-PB2,250,0,0,1223,0,1223,G
1-PB2,251,0,2,0,1220,1222,C
1-PB2,252,0,1215,0,0,1215,T
1-PB2,253,0,2,1244,0,1246,G
1-PB2,254,2,0,1242,0,1244,G
1-PB2,255,1261,0,0,0,1261,A
1-PB2,256,0,1255,0,0,1255,T
1-PB2,257,1,0,0,1247,1248,C
1-PB2,258,1264,0,1,0,1265,A
1-PB2,259,1,0,1302,0,1303,G
1-PB2,260,1301,0,1,0,1302,A
1-PB2,261,0,1306,0,0,1306,T
1-PB2,262,1272,1,0,0,1273,A
1-PB2,263,20,1,1286,0,1307,G
1-PB2,264,1284,0,4,0,1288,A
1-PB2,265,1,1,1307,0,1309,G
1-PB2,266,0,1292,0,0,1292,T
1-PB2,267,1,1,1270,0,1272,G
1-PB2,268,1260,0,0,0,1260,A
1-PB2,269,0,1262,0,1,1263,T
1-PB2,270,0,3,1289,0,1292,G
1-PB2,271,0,0,1308,0,1308,G
1-PB2,272,0,1291,0,3,1294,T
1-PB2,273,1294,0,0,0,1294,A
1-PB2,274,0,1278,0,1,1279,T
1-PB2,275,1,0,1,1275,1277,C
1-PB2,276,1292,0,2,0,1294,A
1-PB2,277,1,1,0,1318,1320,C
1-PB2,278,0,0,0,1312,1312,C
1-PB2,279,0,1292,1,0,1293,T
1-PB2,280,0,1280,1,1,1282,T
1-PB2,281,0,1280,0,1,1281,T
1-PB2,282,1,3,1290,0,1294,G
1-PB2,283,0,1,1296,0,1297,G
1-PB2,284,1,1,0,1299,1301,C
1-PB2,285,0,1283,0,1,1284,T
1-PB2,286,0,0,1295,0,1295,G
1-PB2,287,1,1292,0,0,1293,T
1-PB2,288,1294,0,0,0,1294,A
1-PB2,289,1297,0,2,0,1299,A
1-PB2,290,0,0,0,1296,1296,C
1-PB2,291,1280,0,0,0,1280,A
1-PB2,292,0,1272,0,1,1273,T
1-PB2,293,0,3,1257,0,1260,G
1-PB2,294,1,3,1285,0,1289,G
1-PB2,295,0,1276,0,0,1276,T
1-PB2,296,1,1,1267,1,1270,G
1-PB2,297,1,2,1287,0,1290,G
1-PB2,298,1286,0,0,0,1286,A
1-PB2,299,1287,0,1,0,1288,A
1-PB2,300,0,1292,0,1,1293,T
1-PB2,301,1292,1,0,0,1293,A
1-PB2,302,1,0,1323,0,1324,G
1-PB2,303,1312,0,0,0,1312,A
1-PB2,304,1312,0,0,0,1312,A
1-PB2,305,1312,0,0,0,1312,A
1-PB2,306,0,1286,0,0,1286,T
1-PB2,307,0,7,1280,0,1287,G
1-PB2,308,1,2,1281,0,1284,G
1-PB2,309,1281,0,1,0,1282,A
1-PB2,310,0,0,0,1285,1285,C
1-PB2,311,1,1,0,1267,1269,C
1-PB2,312,5,0,0,1256,1261,C
1-PB2,313,0,0,1272,0,1272,G
1-PB2,314,0,1277,1,1,1279,T
1-PB2,315,0,1,1300,0,1301,G
1-PB2,316,1300,0,1,0,1301,A
1-PB2,317,0,0,0,1306,1306,C
1-PB2,318,1310,0,0,0,1310,A
1-PB2,319,1304,0,2,0,1306,A
1-PB2,320,0,1,1344,0,1345,G
1-PB2,321,0,1343,0,0,1343,T
1-PB2,322,1337,0,1,0,1338,A
1-PB2,323,0,0,0,1336,1336,C
1-PB2,324,0,5,1306,0,1311,G
1-PB2,325,0,0,1342,0,1342,G
1-PB2,326,0,1337,0,1,1338,T
1-PB2,327,1,0,0,1347,1348,C
1-PB2,328,0,0,0,1345,1345,C
1-PB2,329,1320,1,0,0,1321,A
1-PB2,330,1,1326,0,0,1327,T
1-PB2,331,0,1329,0,0,1329,T
1-PB2,332,1394,0,0,0,1394,A
1-PB2,333,0,0,0,1392,1392,C
1-PB2,334,5,0,0,1354,1359,C
1-PB2,335,6,0,0,1355,1361,C
1-PB2,336,1336,0,0,0,1336,A
1-PB2,337,1347,0,0,0,1347,A
1-PB2,338,1348,0,0,0,1348,A
1-PB2,339,1345,0,0,0,1345,A
1-PB2,340,1,0,1375,0,1376,G
1-PB2,341,0,1330,0,1,1331,T
1-PB2,342,0,1,1357,0,1358,G
1-PB2,343,0,1346,3,7,1356,T
1-PB2,344,1357,0,1,1,1359,A
1-PB2,345,0,0,0,1356,1356,C
1-PB2,346,1347,0,0,0,1347,A
1-PB2,347,1347,1,0,0,1348,A
1-PB2,348,1,1,1352,0,1354,G
1-PB2,349,1336,1,6,0,1343,A
1-PB2,350,4,0,0,1346,1350,C
1-PB2,351,0,1321,0,2,1323,T
1-PB2,352,0,1329,0,1,1330,T
1-PB2,353,1330,0,0,0,1330,A
1-PB2,354,0,1328,1,0,1329,T
1-PB2,355,0,1296,29,0,1325,T
1-PB2,356,0,1325,0,0,1325,T
1-PB2,357,1,0,0,1310,1311,C
1-PB2,358,1,5,1304,1,1311,G
1-PB2,359,1309,0,1,0,1310,A
1-PB2,360,0,0,0,1309,1309,C
1-PB2,361,1300,0,0,1,1301,A
1-PB2,362,1300,0,0,0,1300,A
1-PB2,363,1300,0,1,0,1301,A
1-PB2,364,0,1,1321,0,1322,G
1-PB2,365,0,1322,1,0,1323,T
1-PB2,366,3,0,0,1317,1320,C
1-PB2,367,0,3,1316,0,1319,G
1-PB2,368,1316,0,2,0,1318,A
1-PB2,369,1307,0,3,0,1310,A
1-PB2,370,1320,0,2,0,1322,A
1-PB2,371,0,0,1353,0,1353,G
1-PB2,372,0,0,1361,0,1361,G
1-PB2,373,0,1333,0,2,1335,T
1-PB2,374,0,1334,0,0,1334,T
1-PB2,375,1335,0,0,0,1335,A
1-PB2,376,1334,0,1,0,1335,A
1-PB2,377,1336,0,0,1,1337,A
1-PB2,378,1354,2,0,0,1356,A
1-PB2,379,0,1,0,1368,1369,C
1-PB2,380,1331,0,3,0,1334,A
1-PB2,381,0,1334,0,0,1334,T
1-PB2,382,0,1,1327,0,1328,G
1-PB2,383,0,2,1323,0,1325,G
1-PB2,384,1330,1,0,0,1331,A
1-PB2,385,1346,0,0,0,1346,A
1-PB2,386,2,0,0,1372,1374,C
1-PB2,387,2,0,0,1374,1376,C
1-PB2,388,0,1364,0,3,1367,T
1-PB2,389,0,1367,0,0,1367,T
1-PB2,390,0,1368,1,0,1369,T
1-PB2,391,0,1,1367,0,1368,G
1-PB2,392,0,0,1372,0,1372,G
1-PB2,393,0,1,0,1364,1365,C
1-PB2,394,3,1,0,1357,1361,C
1-PB2,395,6,0,0,1350,1356,C
1-PB2,396,1,1319,1,2,1323,T
1-PB2,397,0,0,1344,0,1344,G
1-PB2,398,0,1333,1,2,1336,T
1-PB2,399,0,1339,0,2,1341,T
1-PB2,400,2,1,0,1339,1342,C
1-PB2,401,1338,0,0,0,1338,A
1-PB2,402,0,1337,1,0,1338,T
1-PB2,403,0,1334,1,1,1336,T
1-PB2,404,0,1332,0,0,1332,T
1-PB2,405,0,1337,0,0,1337,T
1-PB2,406,1315,0,0,0,1315,A
1-PB2,407,0,1,1316,0,1317,G
1-PB2,408,1315,0,1,0,1316,A
1-PB2,409,1317,0,1,0,1318,A
1-PB2,410,1320,0,0,0,1320,A
1-PB2,411,0,1317,0,0,1317,T
1-PB2,412,3,0,0,1317,1320,C
1-PB2,413,1316,0,1,0,1317,A
1-PB2,414,1329,0,1,0,1330,A
1-PB2,415,0,0,1340,0,1340,G
1-PB2,416,0,1337,0,1,1338,T
1-PB2,417,6,0,1,1331,1338,C
1-PB2,418,1346,1,0,0,1347,A
1-PB2,419,1349,1,1,0,1351,A
1-PB2,420,1,2,1348,0,1351,G
1-PB2,421,1346,0,0,0,1346,A
1-PB2,422,0,1352,0,0,1352,T
1-PB2,423,1353,0,1,0,1354,A
1-PB2,424,0,0,0,1349,1349,C
1-PB2,425,0,0,1353,0,1353,G
1-PB2,426,1,0,0,1379,1380,C
1-PB2,427,1375,0,0,0,1375,A
1-PB2,428,0,1,1388,0,1389,G
1-PB2,429,1387,0,1,0,1388,A
1-PB2,430,1387,0,0,0,1387,A
1-PB2,431,0,2,1408,0,1410,G
1-PB2,432,1381,0,2,0,1383,A
1-PB2,433,0,1,1390,0,1391,G
1-PB2,434,0,1380,0,0,1380,T
1-PB2,435,1372,0,3,0,1375,A
1-PB2,436,0,1,1390,0,1391,G
1-PB2,437,1402,0,4,0,1406,A
1-PB2,438,1,0,0,1438,1439,C
1-PB2,439,1403,0,0,0,1403,A
1-PB2,440,0,1389,0,0,1389,T
1-PB2,441,1379,0,0,0,1379,A
1-PB2,442,1378,0,0,1,1379,A
1-PB2,443,1386,1,1,0,1388,A
1-PB2,444,0,0,0,1396,1396,C
1-PB2,445,3,0,0,1366,1369,C
1-PB2,446,4,0,0,1356,1360,C
1-PB2,447,0,1285,0,1,1286,T
1-PB2,448,0,2,1303,0,1305,G
1-PB2,449,0,0,1321,0,1321,G
1-PB2,450,1,1319,0,0,1320,T
1-PB2,451,3,0,0,1306,1309,C
1-PB2,452,1317,0,0,0,1317,A
1-PB2,453,0,1311,0,0,1311,T
1-PB2,454,0,0,1326,0,1326,G
1-PB2,455,0,0,0,1325,1325,C
1-PB2,456,1321,0,0,0,1321,A
1-PB2,457,0,2,1328,0,1330,G
1-PB2,458,1300,0,2,0,1302,A
1-PB2,459,0,0,0,1317,1317,C
1-PB2,460,0,0,0,1311,1311,C
1-PB2,461,0,1291,0,1,1292,T
1-PB2,462,2,1,1,1290,1294,C
1-PB2,463,1284,1,0,0,1285,A
1-PB2,464,0,2,1311,0,1313,G
1-PB2,465,1,1311,1,0,1313,T
1-PB2,466,0,0,1318,0,1318,G
1-PB2,467,1,0,0,1321,1322,C
1-PB2,468,2,0,0,1296,1298,C
1-PB2,469,1301,0,1,0,1302,A
1-PB2,470,1305,0,1,0,1306,A
1-PB2,471,1302,0,0,0,1302,A
1-PB2,472,0,3,1308,0,1311,G
1-PB2,473,1281,0,2,0,1283,A
1-PB2,474,0,2,1288,0,1290,G
1-PB2,475,1,1,1288,0,1290,G
1-PB2,476,1,0,0,1287,1288,C
1-PB2,477,1291,2,0,0,1293,A
1-PB2,478,1,0,0,1296,1297,C
1-PB2,479,1297,0,0,0,1297,A
1-PB2,480,1337,0,0,0,1337,A
1-PB2,481,0,2,1351,0,1353,G
1-PB2,482,1367,0,0,0,1367,A
1-PB2,483,0,1359,0,0,1359,T
1-PB2,484,0,0,1352,0,1352,G
1-PB2,485,0,1355,0,1,1356,T
1-PB2,486,1355,0,2,0,1357,A
1-PB2,487,1350,0,1,0,1351,A
1-PB2,488,0,1350,0,0,1350,T
1-PB2,489,4,0,0,1254,1258,C
1-PB2,490,1266,0,0,0,1266,A
1-PB2,491,0,1271,0,0,1271,T
1-PB2,492,0,1,1271,0,1272,G
1-PB2,493,0,0,1273,0,1273,G
1-PB2,494,1267,0,0,0,1267,A
1-PB2,495,1261,0,0,0,1261,A
1-PB2,496,1,0,1265,0,1266,G
1-PB2,497,1,1260,0,0,1261,T
1-PB2,498,0,1265,0,0,1265,T
1-PB2,499,0,0,1266,0,1266,G
1-PB2,500,0,1264,0,2,1266,T
1-PB2,501,1,1256,0,0,1257,T
1-PB2,502,2,1258,0,0,1260,T
1-PB2,503,0,1257,0,0,1257,T
1-PB2,504,0,1254,0,4,1258,T
1-PB2,505,2,0,1,1258,1261,C
1-PB2,506,3,0,0,1251,1254,C
1-PB2,507,3,0,0,1257,1260,C
1-PB2,508,1254,0,0,0,1254,A
1-PB2,509,1257,0,1,1,1259,A
1-PB2,510,1,1260,1,0,1262,T
1-PB2,511,0,2,1269,0,1271,G
1-PB2,512,1274,0,0,0,1274,A
1-PB2,513,1266,0,1,1,1268,A
1-PB2,514,0,0,1278,1,1279,G
1-PB2,515,0,1270,0,1,1271,T
1-PB2,516,0,5,1263,0,1268,G
1-PB2,517,2,4,1261,0,1267,G
1-PB2,518,0,1,1260,1,1262,G
1-PB2,519,1270,0,2,0,1272,A
1-PB2,520,0,0,1271,0,1271,G
1-PB2,521,1,1,0,1267,1269,C
1-PB2,522,0,0,0,1264,1264,C
1-PB2,523,1269,0,0,0,1269,A
1-PB2,524,0,0,1303,0,1303,G
1-PB2,525,0,1,1308,1,1310,G
1-PB2,526,1317,1,1,0,1319,A
1-PB2,527,0,1315,0,1,1316,T
1-PB2,528,1314,0,0,0,1314,A
1-PB2,529,1,1,0,1316,1318,C
1-PB2,530,0,1310,0,0,1310,T
1-PB2,531,1312,0,1,0,1313,A
1-PB2,532,1309,0,1,0,1310,A
1-PB2,533,1,0,0,1326,1327,C
1-PB2,534,1290,0,0,0,1290,A
1-PB2,535,0,1275,0,1,1276,T
1-PB2,536,1,0,0,1277,1278,C
1-PB2,537,1259,0,0,0,1259,A
1-PB2,538,1,3,1269,0,1273,G
1-PB2,539,1274,0,0,0,1274,A
1-PB2,540,1265,0,0,0,1265,A
1-PB2,541,0,1266,0,0,1266,T
1-PB2,542,1,1,0,1252,1254,C
1-PB2,543,1251,1,0,0,1252,A
1-PB2,544,0,0,0,1287,1287,C
1-PB2,545,1286,1,0,0,1287,A
1-PB2,546,1300,0,0,0,1300,A
1-PB2,547,0,1275,0,0,1275,T
1-PB2,548,0,1278,0,0,1278,T
1-PB2,549,1291,0,0,0,1291,A
1-PB2,550,1302,0,0,0,1302,A
1-PB2,551,0,0,0,1308,1308,C
1-PB2,552,1297,0,1,0,1298,A
1-PB2,553,1285,1,1,0,1287,A
1-PB2,554,0,1306,0,0,1306,T
1-PB2,555,1297,0,1,0,1298,A
1-PB2,556,1300,0,0,0,1300,A
1-PB2,557,0,0,0,1296,1296,C
1-PB2,558,0,1290,0,0,1290,T
1-PB2,559,1293,0,0,0,1293,A
1-PB2,560,1282,0,1,0,1283,A
1-PB2,561,1284,0,2,0,1286,A
1-PB2,562,0,5,1285,0,1290,G
1-PB2,563,1266,0,0,0,1266,A
1-PB2,564,1,1,1274,0,1276,G
1-PB2,565,1276,0,0,1,1277,A
1-PB2,566,1276,0,0,1,1277,A
1-PB2,567,1274,0,1,0,1275,A
1-PB2,568,1277,0,0,0,1277,A
1-PB2,569,1286,1,0,0,1287,A
1-PB2,570,1285,1,0,0,1286,A
1-PB2,571,0,0,1293,0,1293,G
1-PB2,572,1289,1,0,0,1290,A
1-PB2,573,1279,0,0,0,1279,A
1-PB2,574,0,1,1281,0,1282,G
1-PB2,575,1284,0,0,0,1284,A
1-PB2,576,1282,0,1,0,1283,A
1-PB2,577,0,0,0,1297,1297,C
1-PB2,578,0,1286,0,2,1288,T
1-PB2,579,5,1,0,1284,1290,C
1-PB2,580,4,1,1,1280,1286,C
1-PB2,581,0,2,1285,0,1287,G
1-PB2,582,1284,0,0,0,1284,A
1-PB2,583,0,1,1287,0,1288,G
1-PB2,584,1285,0,1,0,1286,A
1-PB2,585,0,1290,0,0,1290,T
1-PB2,586,0,1268,0,0,1268,T
1-PB2,587,1,0,1277,0,1278,G
1-PB2,588,0,2,0,1269,1271,C
1-PB2,589,1276,0,0,0,1276,A
1-PB2,590,1279,0,0,0,1279,A
1-PB2,591,1281,0,0,0,1281,A
1-PB2,592,1287,0,0,1,1288,A
1-PB2,593,0,1285,0,0,1285,T
1-PB2,594,0,1280,0,0,1280,T
1-PB2,595,0,1285,0,1,1286,T
1-PB2,596,1,0,0,1284,1285,C
1-PB2,597,0,1285,0,1,1286,T
1-PB2,598,1,0,0,1458,1459,C
1-PB2,599,5,0,0,1461,1466,C
1-PB2,600,6,0,0,1697,1703,C
1-PB2,601,0,1696,0,1,1697,T
1-PB2,602,1,1736,0,0,1737,T
1-PB2,603,0,2,1754,0,1756,G
1-PB2,604,1756,0,3,0,1759,A
1-PB2,605,0,1820,0,1,1821,T
1-PB2,606,0,2,1895,0,1897,G
1-PB2,607,0,2,2232,1,2235,G
1-PB2,608,0,2310,0,1,2311,T
1-PB2,609,0,2318,0,1,2319,T
1-PB2,610,0,1,2590,1,2592,G
1-PB2,611,2,1,0,2611,2614,C
1-PB2,612,2707,0,0,0,2707,A
1-PB2,613,0,2706,0,0,2706,T
1-PB2,614,2737,1,1,5,2744,A
1-PB2,615,0,2,1,2928,2931,C
1-PB2,616,3511,0,1,2,3514,A
1-PB2,617,0,3632,0,0,3632,T
1-PB2,618,1,2,3864,1,3868,G
1-PB2,619,2,3803,1,31,3837,T
1-PB2,620,0,3848,0,3,3851,T
1-PB2,621,3856,1,0,0,3857,A
1-PB2,622,0,6,3862,0,3868,G
1-PB2,623,3925,0,3,0,3928,A
1-PB2,624,1,12,3961,1,3975,G
1-PB2,625,3881,0,4,0,3885,A
1-PB2,626,0,4,3907,0,3911,G
1-PB2,627,3881,3,1,0,3885,A
1-PB2,628,2,5,3903,1,3911,G
1-PB2,629,3928,1,2,0,3931,A
1-PB2,630,3934,0,4,0,3938,A
1-PB2,631,1,0,0,3970,3971,C
1-PB2,632,1,3958,0,3,3962,T
1-PB2,633,1,3954,0,0,3955,T
1-PB2,634,0,0,3971,0,3971,G
1-PB2,635,1,3965,0,0,3966,T
1-PB2,636,3965,1,3,0,3969,A
1-PB2,637,2,3,0,3959,3964,C
1-PB2,638,3,7,3947,0,3957,G
1-PB2,639,3960,1,2,0,3963,A
1-PB2,640,3959,0,1,0,3960,A
1-PB2,641,4025,1,2,0,4028,A
1-PB2,642,4022,0,4,0,4026,A
1-PB2,643,4025,2,5,1,4033,A
1-PB2,644,1,0,0,4044,4045,C
1-PB2,645,4039,0,0,0,4039,A
1-PB2,646,4047,1,4,0,4052,A
1-PB2,647,2,3,4068,0,4073,G
1-PB2,648,4081,1,0,1,4083,A
1-PB2,649,1,4084,0,2,4087,T
1-PB2,650,1,4092,0,1,4094,T
1-PB2,651,0,4109,0,0,4109,T
1-PB2,652,5,0,0,4115,4120,C
1-PB2,653,1,4125,1,4,4131,T
1-PB2,654,8,26,0,4104,4138,C
1-PB2,655,7,0,0,4128,4135,C
1-PB2,656,8,2,0,4135,4145,C
1-PB2,657,4144,1,1,1,4147,A
1-PB2,658,0,0,4200,1,4201,G
1-PB2,659,0,4199,0,0,4199,T
1-PB2,660,1,4188,0,0,4189,T
1-PB2,661,2,1,4195,0,4198,G
1-PB2,662,0,1,0,4191,4192,C
1-PB2,663,2,4190,0,1,4193,T
1-PB2,664,0,4,4204,0,4208,G
1-PB2,665,2,1,4197,0,4200,G
1-PB2,666,3,7,0,4202,4212,C
1-PB2,667,5,5,4203,0,4213,G
1-PB2,668,1,10,4257,0,4268,G
1-PB2,669,4286,2,6,0,4294,A
1-PB2,670,4290,0,4,0,4294,A
1-PB2,671,1,0,0,4299,4300,C
1-PB2,672,4326,1,1,1,4329,A
1-PB2,673,4330,0,2,0,4332,A
1-PB2,674,0,1,4518,0,4519,G
1-PB2,675,2,1,0,4629,4632,C
1-PB2,676,4657,2,2,0,4661,A
1-PB2,677,1,3,5985,0,5989,G
1-PB2,678,0,5982,0,3,5985,T
1-PB2,679,6015,1,3,0,6019,A
1-PB2,680,2,6024,0,1,6027,T
1-PB2,681,6047,1,4,0,6052,A
1-PB2,682,0,6054,0,2,6056,T
1-PB2,683,5980,2,2,0,5984,A
1-PB2,684,1,3,1,6057,6062,C
1-PB2,685,5785,0,1,1,5787,A
1-PB2,686,2,5547,0,1,5550,T
1-PB2,687,0,5385,0,3,5388,T
1-PB2,688,1,11,5378,0,5390,G
1-PB2,689,5388,1,0,0,5389,A
1-PB2,690,5367,0,2,0,5369,A
1-PB2,691,1,3,5453,0,5457,G
1-PB2,692,0,5436,0,11,5447,T
1-PB2,693,0,5415,0,2,5417,T
1-PB2,694,1,5429,0,2,5432,T
1-PB2,695,0,5434,0,1,5435,T
1-PB2,696,5468,3,2,0,5473,A
1-PB2,697,0,0,0,5511,5511,C
1-PB2,698,5519,0,0,0,5519,A
1-PB2,699,1,5505,0,0,5506,T
1-PB2,700,2,5482,0,1,5485,T
1-PB2,701,1,5490,0,2,5493,T
1-PB2,702,0,10,5548,1,5559,G
1-PB2,703,5577,1,4,0,5582,A
1-PB2,704,0,1,0,5607,5608,C
1-PB2,705,1,5582,1,5,5589,T
1-PB2,706,7,0,0,5575,5582,C
1-PB2,707,5567,0,6,0,5573,A
1-PB2,708,0,19,5527,0,5546,G
1-PB2,709,0,10,5677,1,5688,G
1-PB2,710,1,9,5702,1,5713,G
1-PB2,711,5724,0,2,0,5726,A
1-PB2,712,5712,2,5,1,5720,A
1-PB2,713,2,0,0,5717,5719,C
1-PB2,714,1,3,5748,0,5752,G
1-PB2,715,0,5750,0,7,5757,T
1-PB2,716,2,0,5787,0,5789,G
1-PB2,717,1,5752,0,2,5755,T
1-PB2,718,1,5739,1,3,5744,T
1-PB2,719,1,18,5749,1,5769,G
1-PB2,720,1,13,5743,1,5758,G
1-PB2,721,1,11,5822,1,5835,G
1-PB2,722,5783,2,4,0,5789,A
1-PB2,723,5759,0,2,0,5761,A
1-PB2,724,3,2,0,5940,5945,C
1-PB2,725,5923,0,0,1,5924,A
1-PB2,726,6097,0,3,0,6100,A
1-PB2,727,6105,2,1,2,6110,A
1-PB2,728,2,6166,0,1,6169,T
1-PB2,729,2,2,6238,0,6242,G
1-PB2,730,1,6203,1,4,6209,T
1-PB2,731,6205,0,1,0,6206,A
1-PB2,732,2,0,0,6220,6222,C
1-PB2,733,6125,0,1,0,6126,A
1-PB2,734,2,2,0,6119,6123,C
1-PB2,735,0,5959,0,6,5965,T
1-PB2,736,11,1,0,6467,6479,C
1-PB2,737,10,0,1,6481,6492,C
1-PB2,738,6562,4,6,0,6572,A
1-PB2,739,4,4,6621,0,6629,G
1-PB2,740,0,2,6765,0,6767,G
1-PB2,741,1,6748,0,1,6750,T
1-PB2,742,1,10,6741,1,6753,G
1-PB2,743,0,9,6590,0,6599,G
1-PB2,744,6542,0,9,0,6551,A
1-PB2,745,1,10,6583,1,6595,G
1-PB2,746,0,11,6589,1,6601,G
1-PB2,747,6509,1,7,0,6517,A
1-PB2,748,1,1,6587,0,6589,G
1-PB2,749,2,6455,0,3,6460,T
1-PB2,750,2,4,6494,0,6500,G
1-PB2,751,6487,0,9,0,6496,A
1-PB2,752,2,7,6516,0,6525,G
1-PB2,753,0,8,6554,0,6562,G
1-PB2,754,6513,1,6,0,6520,A
1-PB2,755,6532,1,2,0,6535,A
1-PB2,756,1,6545,1,1,6548,T
1-PB2,757,0,14,6511,0,6525,G
1-PB2,758,6531,2,8,0,6541,A
1-PB2,759,0,5,1,6516,6522,C
1-PB2,760,1,8,6513,0,6522,G
1-PB2,761,6597,0,2,0,6599,A
1-PB2,762,0,6562,0,0,6562,T
1-PB2,763,1,2,6595,1,6599,G
1-PB2,764,0,6586,0,5,6591,T
1-PB2,765,1,6537,0,2,6540,T
1-PB2,766,3,12,6583,1,6599,G
1-PB2,767,6600,2,9,0,6611,A
1-PB2,768,0,4,0,6602,6606,C
1-PB2,769,13,1,1,6580,6595,C
1-PB2,770,6539,1,1,0,6541,A
1-PB2,771,6554,1,3,1,6559,A
1-PB2,772,6584,1,5,1,6591,A
1-PB2,773,6,3,6752,0,6761,G
1-PB2,774,3,3,0,6761,6767,C
1-PB2,775,3,2,0,6744,6749,C
1-PB2,776,0,6780,0,24,6804,T
1-PB2,777,6832,0,0,0,6832,A
1-PB2,778,6833,0,2,0,6835,A
1-PB2,779,2,6839,1,1,6843,T
1-PB2,780,0,6824,2,0,6826,T
1-PB2,781,6766,0,0,0,6766,A
1-PB2,782,1,6619,0,0,6620,T
1-PB2,783,2,6582,0,1,6585,T
1-PB2,784,1,1,6545,0,6547,G
1-PB2,785,2,3,0,6546,6551,C
1-PB2,786,4,5,6542,0,6551,G
1-PB2,787,4,0,6655,1,6660,G
1-PB2,788,2,1,0,6641,6644,C
1-PB2,789,5,1,0,6680,6686,C
1-PB2,790,6682,0,2,0,6684,A
1-PB2,791,1,8,6768,0,6777,G
1-PB2,792,1,11,6816,1,6829,G
1-PB2,793,6838,0,6,0,6844,A
1-PB2,794,6866,1,8,0,6875,A
1-PB2,795,1,3,1,6913,6918,C
1-PB2,796,6824,0,1,0,6825,A
1-PB2,797,0,6957,0,8,6965,T
1-PB2,798,7074,0,6,1,7081,A
1-PB2,799,2,2,7151,0,7155,G
1-PB2,800,0,7072,1,1,7074,T
1-PB2,801,7024,0,4,0,7028,A
1-PB2,802,7013,2,0,1,7016,A
1-PB2,803,0,10,7017,0,7027,G
1-PB2,804,6978,2,1,1,6982,A
1-PB2,805,6872,3,2,1,6878,A
1-PB2,806,1,10,6835,0,6846,G
1-PB2,807,6669,0,4,0,6673,A
1-PB2,808,9,0,6666,0,6675,G
1-PB2,809,2,8,0,6665,6675,C
1-PB2,810,5,2,1,6660,6668,C
1-PB2,811,1,1,6676,0,6678,G
1-PB2,812,0,1,0,6722,6723,C
1-PB2,813,6746,0,4,0,6750,A
1-PB2,814,1,0,7134,0,7135,G
1-PB2,815,1,7122,0,3,7126,T
1-PB2,816,7151,0,2,1,7154,A
1-PB2,817,0,7127,0,1,7128,T
1-PB2,818,13,2,0,7171,7186,C
1-PB2,819,7172,1,5,0,7178,A
1-PB2,820,3,0,7180,0,7183,G
1-PB2,821,0,3,1,7172,7176,C
1-PB2,822,6950,0,3,1,6954,A
1-PB2,823,0,15,6876,0,6891,G
1-PB2,824,6927,0,4,1,6932,A
1-PB2,825,2,6888,0,4,6894,T
1-PB2,826,6,0,0,6935,6941,C
1-PB2,827,10,0,1,6930,6941,C
1-PB2,828,6972,2,1,0,6975,A
1-PB2,829,4,2,1,6980,6987,C
1-PB2,830,0,6970,2,0,6972,T
1-PB2,831,7004,0,3,1,7008,A
1-PB2,832,3,1,6995,0,6999,G
1-PB2,833,2,2,0,6953,6957,C
1-PB2,834,6938,1,0,0,6939,A
1-PB2,835,0,6985,0,1,6986,T
1-PB2,836,2,0,1,7072,7075,C
1-PB2,837,0,7041,0,2,7043,T
1-PB2,838,0,7250,2,1,7253,T
1-PB2,839,0,7280,0,0,7280,T
1-PB2,840,7266,3,3,1,7273,A
1-PB2,841,1,7286,0,1,7288,T
1-PB2,842,1,7260,0,1,7262,T
1-PB2,843,4,11,7228,3,7246,G
1-PB2,844,1,12,7271,0,7284,G
1-PB2,845,7161,1,5,1,7168,A
1-PB2,846,3,8,7183,1,7195,G
1-PB2,847,7104,1,2,0,7107,A
1-PB2,848,1,7071,0,3,7075,T
1-PB2,849,0,0,7199,1,7200,G
1-PB2,850,1,7186,0,0,7187,T
1-PB2,851,4,1,7172,0,7177,G
1-PB2,852,1,2,0,7211,7214,C
1-PB2,853,12,0,1,7187,7200,C
1-PB2,854,7176,0,3,0,7179,A
1-PB2,855,5,1,0,7174,7180,C
1-PB2,856,7097,0,10,0,7107,A
1-PB2,857,2,4,7214,1,7221,G
1-PB2,858,1,2,0,7103,7106,C
1-PB2,859,7103,5,9,1,7118,A
1-PB2,860,1,0,0,7104,7105,C
1-PB2,861,7075,1,7,1,7084,A
1-PB2,862,3,3,0,7132,7138,C
1-PB2,863,7109,1,1,0,7111,A
1-PB2,864,7126,1,3,0,7130,A
1-PB2,865,7121,1,2,1,7125,A
1-PB2,866,0,6959,1,0,6960,T
1-PB2,867,1,6962,0,1,6964,T
1-PB2,868,1,7,6929,1,6938,G
1-PB2,869,2,0,6929,1,6932,G
1-PB2,870,4,3,0,6926,6933,C
1-PB2,871,0,8,6875,0,6883,G
1-PB2,872,1,15,6874,0,6890,G
1-PB2,873,6872,1,6,0,6879,A
1-PB2,874,7037,1,2,0,7040,A
1-PB2,875,1,0,0,7058,7059,C
1-PB2,876,7060,0,6,0,7066,A
1-PB2,877,7076,1,4,0,7081,A
1-PB2,878,2,15,7096,0,7113,G
1-PB2,879,4,8,7114,1,7127,G
1-PB2,880,7164,1,2,0,7167,A
1-PB2,881,1,6842,0,1,6844,T
1-PB2,882,3,3,6820,0,6826,G
1-PB2,883,2,2,6857,0,6861,G
1-PB2,884,1,6817,1,3,6822,T
1-PB2,885,2,7,6804,1,6814,G
1-PB2,886,1,7,6795,0,6803,G
1-PB2,887,6762,0,9,1,6772,A
1-PB2,888,2,4,0,6765,6771,C
1-PB2,889,6682,0,3,0,6685,A
1-PB2,890,4,7695,0,1,7700,T
1-PB2,891,1,7683,0,4,7688,T
1-PB2,892,14,2,1,7682,7699,C
1-PB2,893,1,7637,1,4,7643,T
1-PB2,894,0,7633,2,0,7635,T
1-PB2,895,7635,2,3,0,7640,A
1-PB2,896,1,17,7656,0,7674,G
1-PB2,897,7647,2,1,0,7650,A
1-PB2,898,2,60,0,7588,7650,C
1-PB2,899,6519,1,3,0,6523,A
1-PB2,900,0,7,6618,1,6626,G
1-PB2,901,6603,1,3,1,6608,A
1-PB2,902,6615,0,5,0,6620,A
1-PB2,903,3,3,1,6605,6612,C
1-PB2,904,8,0,0,6580,6588,C
1-PB2,905,16,2,0,6580,6598,C
1-PB2,906,2,21,6573,0,6596,G
1-PB2,907,6601,0,3,0,6604,A
1-PB2,908,1,0,0,6637,6638,C
1-PB2,909,1,6541,0,0,6542,T
1-PB2,910,2,3,6602,0,6607,G
1-PB2,911,6593,0,3,1,6597,A
1-PB2,912,6619,0,4,1,6624,A
1-PB2,913,2,11,6631,1,6645,G
1-PB2,914,6620,1,5,0,6626,A
1-PB2,915,6635,0,1,0,6636,A
1-PB2,916,0,0,0,6618,6618,C
1-PB2,917,6594,0,3,0,6597,A
1-PB2,918,6624,0,4,0,6628,A
1-PB2,919,2,2,6704,0,6708,G
1-PB2,920,0,2,0,6740,6742,C
1-PB2,921,2,6676,3,2,6683,T
1-PB2,922,1,0,6767,1,6769,G
1-PB2,923,0,6743,0,2,6745,T
1-PB2,924,3,14,6843,0,6860,G
1-PB2,925,0,1,7088,0,7089,G
1-PB2,926,7079,1,4,0,7084,A
1-PB2,927,1,7051,1,0,7053,T
1-PB2,928,6991,2,4,0,6997,A
1-PB2,929,0,6914,0,1,6915,T
1-PB2,930,7137,0,2,0,7139,A
1-PB2,931,0,7004,0,4,7008,T
1-PB2,932,2,1,6988,1,6992,G
1-PB2,933,1,1,0,6902,6904,C
1-PB2,934,6643,0,3,0,6646,A
1-PB2,935,6645,0,5,0,6650,A
1-PB2,936,0,6,6620,0,6626,G
1-PB2,937,0,2,6646,1,6649,G
1-PB2,938,2,1,0,6647,6650,C
1-PB2,939,1,6507,0,5,6513,T
1-PB2,940,3,0,6536,0,6539,G
1-PB2,941,1,1,0,6550,6552,C
1-PB2,942,6563,3,1,0,6567,A
1-PB2,943,6583,1,3,0,6587,A
1-PB2,944,0,6548,0,4,6552,T
1-PB2,945,2,21,6565,0,6588,G
1-PB2,946,3,10,6534,1,6548,G
1-PB2,947,0,11,6560,0,6571,G
1-PB2,948,6580,0,5,0,6585,A
1-PB2,949,0,6543,0,3,6546,T
1-PB2,950,0,6488,1,1,6490,T
1-PB2,951,2,14,6485,0,6501,G
1-PB2,952,6488,2,5,0,6495,A
1-PB2,953,0,9,6564,0,6573,G
1-PB2,954,6510,0,2,1,6513,A
1-PB2,955,6474,0,1,0,6475,A
1-PB2,956,0,6405,0,3,6408,T
1-PB2,957,14,0,1,6400,6415,C
1-PB2,958,6409,0,6,0,6415,A
1-PB2,959,1,0,6460,1,6462,G
1-PB2,960,1,0,0,6460,6461,C
1-PB2,961,1,6423,0,11,6435,T
1-PB2,962,17,1,1,6384,6403,C
1-PB2,963,6402,0,1,0,6403,A
1-PB2,964,4,6529,0,2,6535,T
1-PB2,965,4,1,0,6547,6552,C
1-PB2,966,12,0,1,6576,6589,C
1-PB2,967,2,6551,0,9,6562,T
1-PB2,968,3,6516,1,3,6523,T
1-PB2,969,5,1,0,6523,6529,C
1-PB2,970,6520,1,10,1,6532,A
1-PB2,971,2,0,6626,0,6628,G
1-PB2,972,1,2,0,6600,6603,C
1-PB2,973,0,6490,1,4,6495,T
1-PB2,974,1,6520,1,3,6525,T
1-PB2,975,0,6479,0,0,6479,T
1-PB2,976,0,6,6487,0,6493,G
1-PB2,977,2,0,6500,0,6502,G
1-PB2,978,0,6482,0,4,6486,T
1-PB2,979,2,12,6488,0,6502,G
1-PB2,980,2,13,6468,0,6483,G
1-PB2,981,3,3,6539,1,6546,G
1-PB2,982,2,6525,0,2,6529,T
1-PB2,983,0,6505,1,4,6510,T
1-PB2,984,0,6508,1,1,6510,T
1-PB2,985,6545,1,1,0,6547,A
1-PB2,986,0,1,0,6575,6576,C
1-PB2,987,6583,0,1,0,6584,A
1-PB2,988,1,6554,1,1,6557,T
1-PB2,989,0,6407,0,3,6410,T
1-PB2,990,0,6403,0,1,6404,T
1-PB2,991,6404,0,1,0,6405,A
1-PB2,992,6394,0,0,1,6395,A
1-PB2,993,6399,0,3,1,6403,A
1-PB2,994,6359,0,6,1,6366,A
1-PB2,995,2,11,6405,0,6418,G
1-PB2,996,6376,0,4,0,6380,A
1-PB2,997,6380,0,3,0,6383,A
1-PB2,998,0,1,0,6389,6390,C
1-PB2,999,6360,2,2,1,6365,A
1-PB2,1000,6361,0,6,0,6367,A
1-PB2,1001,0,1,6371,1,6373,G
1-PB2,1002,3,8,0,6369,6380,C
1-PB2,1003,4,22,6346,2,6374,G
1-PB2,1004,5,9,6374,0,6388,G
1-PB2,1005,2,1,6393,0,6396,G
1-PB2,1006,0,6346,0,24,6370,T
1-PB2,1007,18,0,0,6347,6365,C
1-PB2,1008,6373,0,5,1,6379,A
1-PB2,1009,1,6350,0,6,6357,T
1-PB2,1010,7,2,0,6354,6363,C
1-PB2,1011,6327,0,1,0,6328,A
1-PB2,1012,1,2,6411,0,6414,G
1-PB2,1013,0,6338,1,9,6348,T
1-PB2,1014,9,0,1,6342,6352,C
1-PB2,1015,6345,1,3,1,6350,A
1-PB2,1016,6367,0,1,1,6369,A
1-PB2,1017,6373,1,1,1,6376,A
1-PB2,1018,6363,1,0,1,6365,A
1-PB2,1019,6407,0,1,0,6408,A
1-PB2,1020,6397,2,7,0,6406,A
1-PB2,1021,0,2,6444,0,6446,G
1-PB2,1022,6406,0,2,0,6408,A
1-PB2,1023,6405,0,2,0,6407,A
1-PB2,1024,0,7,6401,0,6408,G
1-PB2,1025,6375,1,3,0,6379,A
1-PB2,1026,6228,2,8,0,6238,A
1-PB2,1027,0,4,6231,0,6235,G
1-PB2,1028,6190,1,16,0,6207,A
1-PB2,1029,1,4,6216,0,6221,G
1-PB2,1030,0,2,6323,1,6326,G
1-PB2,1031,0,6328,1,1,6330,T
1-PB2,1032,1,1,6419,1,6422,G
1-PB2,1033,3,0,0,6450,6453,C
1-PB2,1034,2,6433,1,8,6444,T
1-PB2,1035,0,6482,1,2,6485,T
1-PB2,1036,6471,2,0,1,6474,A
1-PB2,1037,5,0,0,6467,6472,C
1-PB2,1038,6418,1,2,0,6421,A
1-PB2,1039,2,5,6408,1,6416,G
1-PB2,1040,3,0,6406,0,6409,G
1-PB2,1041,5,4,0,6301,6310,C
1-PB2,1042,6237,2,2,1,6242,A
1-PB2,1043,6255,1,0,0,6256,A
1-PB2,1044,1,6364,0,3,6368,T
1-PB2,1045,9,0,0,6459,6468,C
1-PB2,1046,1,6441,0,8,6450,T
1-PB2,1047,12,2,0,6448,6462,C
1-PB2,1048,14,2,0,6458,6474,C
1-PB2,1049,6468,2,5,0,6475,A
1-PB2,1050,6463,0,3,0,6466,A
1-PB2,1051,6483,0,2,0,6485,A
1-PB2,1052,1,0,0,6545,6546,C
1-PB2,1053,6379,0,1,0,6380,A
1-PB2,1054,1,6293,0,2,6296,T
1-PB2,1055,1,6198,0,1,6200,T
1-PB2,1056,1,9,6194,0,6204,G
1-PB2,1057,6175,1,7,0,6183,A
1-PB2,1058,3,9,6080,1,6093,G
1-PB2,1059,6359,0,3,1,6363,A
1-PB2,1060,6364,0,2,0,6366,A
1-PB2,1061,1,6437,0,1,6439,T
1-PB2,1062,6425,1,1,0,6427,A
1-PB2,1063,6433,2,5,1,6441,A
1-PB2,1064,0,6,6627,1,6634,G
1-PB2,1065,6480,1,16,0,6497,A
1-PB2,1066,0,2,6697,0,6699,G
1-PB2,1067,2,6510,0,0,6512,T
1-PB2,1068,6550,1,1,0,6552,A
1-PB2,1069,5,2,0,6681,6688,C
1-PB2,1070,6603,1,2,0,6606,A
1-PB2,1071,1,6583,0,3,6587,T
1-PB2,1072,1,12,6565,0,6578,G
1-PB2,1073,6368,1,2,1,6372,A
1-PB2,1074,2,20,6422,0,6444,G
1-PB2,1075,2,26,6446,1,6475,G
1-PB2,1076,5,11,6700,0,6716,G
1-PB2,1077,2,0,6757,0,6759,G
1-PB2,1078,0,6651,0,3,6654,T
1-PB2,1079,6648,3,11,1,6663,A
1-PB2,1080,0,6632,1,3,6636,T
1-PB2,1081,1,5,6664,0,6670,G
1-PB2,1082,6637,1,6,0,6644,A
1-PB2,1083,2,9,6634,0,6645,G
1-PB2,1084,0,10,6597,3,6610,G
1-PB2,1085,6169,3,3,0,6175,A
1-PB2,1086,1,1,6370,0,6372,G
1-PB2,1087,0,6338,0,5,6343,T
1-PB2,1088,2,6507,0,4,6513,T
1-PB2,1089,26,2,0,6520,6548,C
1-PB2,1090,6542,2,3,0,6547,A
1-PB2,1091,3,3,1,6545,6552,C
1-PB2,1092,6529,1,2,0,6532,A
1-PB2,1093,6563,0,1,2,6566,A
1-PB2,1094,2,6564,0,1,6567,T
1-PB2,1095,0,11,6415,1,6427,G
1-PB2,1096,0,6,6458,0,6464,G
1-PB2,1097,0,6265,0,5,6270,T
1-PB2,1098,1,19,6257,0,6277,G
1-PB2,1099,1,14,6285,0,6300,G
1-PB2,1100,1,7,6284,0,6292,G
1-PB2,1101,4,6,6304,1,6315,G
1-PB2,1102,6276,2,1,0,6279,A
1-PB2,1103,6278,4,5,1,6288,A
1-PB2,1104,6254,1,6,1,6262,A
1-PB2,1105,6133,0,15,2,6150,A
1-PB2,1106,3,14,6207,0,6224,G
1-PB2,1107,6173,1,8,0,6182,A
1-PB2,1108,2,2,6196,0,6200,G
1-PB2,1109,2,1,0,6195,6198,C
1-PB2,1110,6149,2,1,0,6152,A
1-PB2,1111,6164,0,5,0,6169,A
1-PB2,1112,2,20,0,6341,6363,C
1-PB2,1113,6356,2,4,0,6362,A
1-PB2,1114,2,4,6479,0,6485,G
1-PB2,1115,0,4,0,6434,6438,C
1-PB2,1116,0,6421,0,1,6422,T
1-PB2,1117,6641,0,0,0,6641,A
1-PB2,1118,1,6625,0,1,6627,T
1-PB2,1119,6660,1,2,0,6663,A
1-PB2,1120,3,1,0,6673,6677,C
1-PB2,1121,1,6346,0,1,6348,T
1-PB2,1122,6391,1,0,0,6392,A
1-PB2,1123,6246,2,1,0,6249,A
1-PB2,1124,0,9,6262,0,6271,G
1-PB2,1125,6261,0,1,0,6262,A
1-PB2,1126,6057,3,1,1,6062,A
1-PB2,1127,6052,1,1,1,6055,A
1-PB2,1128,6036,0,13,0,6049,A
1-PB2,1129,1,2,6061,0,6064,G
1-PB2,1130,0,1,1,6063,6065,C
1-PB2,1131,6042,2,2,0,6046,A
1-PB2,1132,6059,0,4,2,6065,A
1-PB2,1133,4,0,0,6082,6086,C
1-PB2,1134,6,1,1,6073,6081,C
1-PB2,1135,6091,1,2,0,6094,A
1-PB2,1136,1,1,6113,0,6115,G
1-PB2,1137,6108,0,2,0,6110,A
1-PB2,1138,6107,2,6,0,6115,A
1-PB2,1139,1,8,6147,1,6157,G
1-PB2,1140,6133,1,2,1,6137,A
1-PB2,1141,1,6123,0,1,6125,T
1-PB2,1142,0,6053,0,3,6056,T
1-PB2,1143,1,11,6061,0,6073,G
1-PB2,1144,2,1,6180,1,6184,G
1-PB2,1145,0,6148,0,7,6155,T
1-PB2,1146,3,6134,0,5,6142,T
1-PB2,1147,14,0,0,6122,6136,C
1-PB2,1148,6102,1,3,0,6106,A
1-PB2,1149,6077,1,13,0,6091,A
1-PB2,1150,0,1,1,6522,6524,C
1-PB2,1151,1,6500,1,15,6517,T
1-PB2,1152,14,0,0,6551,6565,C
1-PB2,1153,6469,1,2,0,6472,A
1-PB2,1154,1,6472,1,4,6478,T
1-PB2,1155,6483,0,4,0,6487,A
1-PB2,1156,1,1,6517,0,6519,G
1-PB2,1157,0,6282,0,4,6286,T
1-PB2,1158,1,18,6340,1,6360,G
1-PB2,1159,6091,2,4,0,6097,A
1-PB2,1160,1,0,6162,0,6163,G
1-PB2,1161,0,6117,1,4,6122,T
1-PB2,1162,3,9,6093,2,6107,G
1-PB2,1163,0,3,6157,1,6161,G
1-PB2,1164,6145,2,3,0,6150,A
1-PB2,1165,6105,0,6,0,6111,A
1-PB2,1166,1,13,6123,1,6138,G
1-PB2,1167,6032,3,4,0,6039,A
1-PB2,1168,0,6,6068,0,6074,G
1-PB2,1169,6005,1,6,0,6012,A
1-PB2,1170,0,2,0,6017,6019,C
1-PB2,1171,4,23,5990,2,6019,G
1-PB2,1172,5971,1,3,0,5975,A
1-PB2,1173,5986,0,10,1,5997,A
1-PB2,1174,2,0,0,6005,6007,C
1-PB2,1175,5970,1,1,1,5973,A
1-PB2,1176,0,0,6246,0,6246,G
1-PB2,1177,1,6206,0,2,6209,T
1-PB2,1178,6,1,0,6205,6212,C
1-PB2,1179,6218,1,1,0,6220,A
1-PB2,1180,6207,0,2,0,6209,A
1-PB2,1181,1,6214,0,4,6219,T
1-PB2,1182,6200,0,6,2,6208,A
1-PB2,1183,0,2,6215,1,6218,G
1-PB2,1184,1,0,0,6190,6191,C
1-PB2,1185,6,3,0,5966,5975,C
1-PB2,1186,3,2,5933,0,5938,G
1-PB2,1187,5928,4,0,0,5932,A
1-PB2,1188,5958,0,1,0,5959,A
1-PB2,1189,0,0,6026,0,6026,G
1-PB2,1190,1,2,1,6123,6127,C
1-PB2,1191,6118,0,1,1,6120,A
1-PB2,1192,6102,1,4,0,6107,A
1-PB2,1193,0,6115,0,2,6117,T
1-PB2,1194,6149,0,1,0,6150,A
1-PB2,1195,6213,0,3,0,6216,A
1-PB2,1196,0,6183,1,0,6184,T
1-PB2,1197,5,1,1,6145,6152,C
1-PB2,1198,3,1,6118,0,6122,G
1-PB2,1199,1,5964,0,3,5968,T
1-PB2,1200,5,5,5947,1,5958,G
1-PB2,1201,2,1,5989,0,5992,G
1-PB2,1202,2,2,0,5974,5978,C
1-PB2,1203,11,1,2,5958,5972,C
1-PB2,1204,5908,0,0,0,5908,A
1-PB2,1205,0,5893,1,12,5906,T
1-PB2,1206,5,5,5911,0,5921,G
1-PB2,1207,4,1,6000,0,6005,G
1-PB2,1208,3,5956,1,2,5962,T
1-PB2,1209,1,0,5987,0,5988,G
1-PB2,1210,0,5790,5,2,5797,T
1-PB2,1211,0,5771,2,0,5773,T
1-PB2,1212,1,5771,1,3,5776,T
1-PB2,1213,0,5770,0,1,5771,T
1-PB2,1214,8,0,0,5831,5839,C
1-PB2,1215,5804,2,2,0,5808,A
1-PB2,1216,1,2,1,5922,5926,C
1-PB2,1217,5777,0,1,0,5778,A
1-PB2,1218,5739,0,0,0,5739,A
1-PB2,1219,2,5,5736,0,5743,G
1-PB2,1220,5724,0,3,0,5727,A
1-PB2,1221,5505,1,111,0,5617,A
1-PB2,1222,0,5,5699,0,5704,G
1-PB2,1223,5716,1,1,0,5718,A
1-PB2,1224,1,5727,0,3,5731,T
1-PB2,1225,1,5516,1,3,5521,T
1-PB2,1226,1,0,5516,2,5519,G
1-PB2,1227,0,1,0,5438,5439,C
1-PB2,1228,5464,2,5,1,5472,A
1-PB2,1229,1,5515,0,1,5517,T
1-PB2,1230,0,8,5731,1,5740,G
1-PB2,1231,5775,0,2,1,5778,A
1-PB2,1232,2,5798,2,0,5802,T
1-PB2,1233,5773,0,0,1,5774,A
1-PB2,1234,5775,0,0,0,5775,A
1-PB2,1235,5768,0,4,0,5772,A
1-PB2,1236,5777,1,3,1,5782,A
1-PB2,1237,1,0,5795,0,5796,G
1-PB2,1238,2,1,0,5870,5873,C
1-PB2,1239,5873,1,2,0,5876,A
1-PB2,1240,1,1,6063,0,6065,G
1-PB2,1241,0,6038,0,2,6040,T
1-PB2,1242,1,6041,1,2,6045,T
1-PB2,1243,6052,0,0,0,6052,A
1-PB2,1244,1,5,6077,0,6083,G
1-PB2,1245,6051,0,10,1,6062,A
1-PB2,1246,1,12,6053,0,6066,G
1-PB2,1247,1,2,6045,1,6049,G
1-PB2,1248,0,5789,1,3,5793,T
1-PB2,1249,3,18,5790,0,5811,G
1-PB2,1250,5812,0,5,1,5818,A
1-PB2,1251,1,2,0,5837,5840,C
1-PB2,1252,11,1,2,5833,5847,C
1-PB2,1253,0,5804,1,8,5813,T
1-PB2,1254,1,9,5836,0,5846,G
1-PB2,1255,5833,2,3,0,5838,A
1-PB2,1256,5836,0,3,1,5840,A
1-PB2,1257,0,5830,3,1,5834,T
1-PB2,1258,0,5875,0,3,5878,T
1-PB2,1259,1,5892,0,1,5894,T
1-PB2,1260,2,1,0,5889,5892,C
1-PB2,1261,4,1,5885,0,5890,G
1-PB2,1262,1,5882,0,6,5889,T
1-PB2,1263,11,1,2,5880,5894,C
1-PB2,1264,5887,0,2,0,5889,A
1-PB2,1265,5896,2,0,0,5898,A
1-PB2,1266,0,2,0,5889,5891,C
1-PB2,1267,5796,2,3,0,5801,A
1-PB2,1268,0,3,5889,0,5892,G
1-PB2,1269,5855,1,4,0,5860,A
1-PB2,1270,2,3,5872,0,5877,G
1-PB2,1271,5,2,1,5869,5877,C
1-PB2,1272,5861,1,0,0,5862,A
1-PB2,1273,5940,0,3,0,5943,A
1-PB2,1274,5941,1,3,2,5947,A
1-PB2,1275,1,5939,0,1,5941,T
1-PB2,1276,11,0,0,5941,5952,C
1-PB2,1277,5884,0,7,1,5892,A
1-PB2,1278,2,1,5889,0,5892,G
1-PB2,1279,2,3,0,5896,5901,C
1-PB2,1280,8,9,5886,0,5903,G
1-PB2,1281,0,3,6170,0,6173,G
1-PB2,1282,3,6119,1,6,6129,T
1-PB2,1283,0,6134,1,2,6137,T
1-PB2,1284,2,10,6128,0,6140,G
1-PB2,1285,6146,2,6,0,6154,A
1-PB2,1286,6196,0,6,0,6202,A
1-PB2,1287,3,2,1,6228,6234,C
1-PB2,1288,12,2,0,6185,6199,C
1-PB2,1289,11,1,0,6207,6219,C
1-PB2,1290,16,2,1,5988,6007,C
1-PB2,1291,6028,1,2,0,6031,A
1-PB2,1292,1,6064,1,4,6070,T
1-PB2,1293,2,2,6091,0,6095,G
1-PB2,1294,1,1,0,6102,6104,C
1-PB2,1295,6066,0,2,0,6068,A
1-PB2,1296,0,6005,0,6,6011,T
1-PB2,1297,7,0,0,6006,6013,C
1-PB2,1298,5963,0,1,0,5964,A
1-PB2,1299,3,1,6065,1,6070,G
1-PB2,1300,1,2,0,6088,6091,C
1-PB2,1301,0,6058,1,11,6070,T
1-PB2,1302,0,6076,2,0,6078,T
1-PB2,1303,0,6053,1,0,6054,T
1-PB2,1304,1,6065,0,0,6066,T
1-PB2,1305,6060,2,3,0,6065,A
1-PB2,1306,6054,0,6,0,6060,A
1-PB2,1307,1,3,6060,0,6064,G
1-PB2,1308,0,1,5993,1,5995,G
1-PB2,1309,1,3,0,5944,5948,C
1-PB2,1310,5926,0,1,0,5927,A
1-PB2,1311,3,5896,0,2,5901,T
1-PB2,1312,0,5942,0,1,5943,T
1-PB2,1313,0,5944,2,1,5947,T
1-PB2,1314,1,5975,0,1,5977,T
1-PB2,1315,5,0,0,5978,5983,C
1-PB2,1316,5968,1,5,0,5974,A
1-PB2,1317,0,7,5969,0,5976,G
1-PB2,1318,5950,2,4,2,5958,A
1-PB2,1319,5957,0,1,2,5960,A
1-PB2,1320,5934,2,7,0,5943,A
1-PB2,1321,0,5,5948,0,5953,G
1-PB2,1322,6009,0,0,0,6009,A
1-PB2,1323,3,6007,0,1,6011,T
1-PB2,1324,1,1,6009,0,6011,G
1-PB2,1325,2,4,0,6012,6018,C
1-PB2,1326,4,9,6004,1,6018,G
1-PB2,1327,6017,2,0,1,6020,A
1-PB2,1328,6009,0,2,0,6011,A
1-PB2,1329,6018,0,3,1,6022,A
1-PB2,1330,1,0,6015,0,6016,G
1-PB2,1331,0,5960,0,7,5967,T
1-PB2,1332,1,4,5953,0,5958,G
1-PB2,1333,2,1,0,5945,5948,C
1-PB2,1334,1,5941,1,3,5946,T
1-PB2,1335,1,5940,0,2,5943,T
1-PB2,1336,1,5948,0,0,5949,T
1-PB2,1337,0,5956,0,3,5959,T
1-PB2,1338,1,5957,0,1,5959,T
1-PB2,1339,4,1,0,5955,5960,C
1-PB2,1340,5957,0,8,0,5965,A
1-PB2,1341,5970,2,2,1,5975,A
1-PB2,1342,5978,0,1,1,5980,A
1-PB2,1343,5998,0,2,0,6000,A
1-PB2,1344,1,5977,1,2,5981,T
1-PB2,1345,0,5994,0,1,5995,T
1-PB2,1346,1,9,5982,2,5994,G
1-PB2,1347,1,16,5977,0,5994,G
1-PB2,1348,2,13,5968,0,5983,G
1-PB2,1349,3,10,6050,1,6064,G
1-PB2,1350,5996,1,3,0,6000,A
1-PB2,1351,1,2,6106,0,6109,G
1-PB2,1352,2,6086,0,3,6091,T
1-PB2,1353,1,6096,0,3,6100,T
1-PB2,1354,0,17,6097,0,6114,G
1-PB2,1355,6100,2,5,1,6108,A
1-PB2,1356,6110,0,13,0,6123,A
1-PB2,1357,0,0,0,6241,6241,C
1-PB2,1358,6143,1,0,0,6144,A
1-PB2,1359,2,1,0,6262,6265,C
1-PB2,1360,6168,0,4,1,6173,A
1-PB2,1361,1,6179,1,5,6186,T
1-PB2,1362,5,1,0,6196,6202,C
1-PB2,1363,1,12,6195,0,6208,G
1-PB2,1364,6230,0,8,0,6238,A
1-PB2,1365,2,3,0,6220,6225,C
1-PB2,1366,6017,1,3,0,6021,A
1-PB2,1367,0,0,6211,0,6211,G
1-PB2,1368,4,6061,0,4,6069,T
1-PB2,1369,0,0,6187,1,6188,G
1-PB2,1370,1,6159,0,2,6162,T
1-PB2,1371,0,7,6157,0,6164,G
1-PB2,1372,6160,0,2,0,6162,A
1-PB2,1373,0,6126,0,2,6128,T
1-PB2,1374,0,13,6130,2,6145,G
1-PB2,1375,3,7,6125,0,6135,G
1-PB2,1376,0,9,6037,1,6047,G
1-PB2,1377,5987,2,8,0,5997,A
1-PB2,1378,5924,0,3,0,5927,A
1-PB2,1379,1,5911,0,3,5915,T
1-PB2,1380,0,13,5962,0,5975,G
1-PB2,1381,5996,1,2,0,5999,A
1-PB2,1382,1,5993,2,1,5997,T
1-PB2,1383,0,5963,1,4,5968,T
1-PB2,1384,1,6,5932,0,5939,G
1-PB2,1385,0,12,6072,0,6084,G
1-PB2,1386,6053,1,7,0,6061,A
1-PB2,1387,0,1,6143,0,6144,G
1-PB2,1388,1,6070,1,3,6075,T
1-PB2,1389,6024,3,1,0,6028,A
1-PB2,1390,0,6025,1,6,6032,T
1-PB2,1391,0,6098,1,0,6099,T
1-PB2,1392,6159,1,1,0,6161,A
1-PB2,1393,3,2,0,6156,6161,C
1-PB2,1394,7,2,0,6015,6024,C
1-PB2,1395,5951,2,1,0,5954,A
1-PB2,1396,1,6,5988,0,5995,G
1-PB2,1397,6094,3,2,0,6099,A
1-PB2,1398,0,6054,3,3,6060,T
1-PB2,1399,6018,1,1,0,6020,A
1-PB2,1400,0,5960,0,2,5962,T
1-PB2,1401,0,18,5906,0,5924,G
1-PB2,1402,5914,1,7,0,5922,A
1-PB2,1403,1,2,0,5963,5966,C
1-PB2,1404,3,5931,0,5,5939,T
1-PB2,1405,7,1,0,5928,5936,C
1-PB2,1406,9,2,1,5856,5868,C
1-PB2,1407,5878,0,2,0,5880,A
1-PB2,1408,5896,0,9,0,5905,A
1-PB2,1409,0,1,6031,0,6032,G
1-PB2,1410,2,3,0,6016,6021,C
1-PB2,1411,5989,1,3,1,5994,A
1-PB2,1412,3,2,0,5963,5968,C
1-PB2,1413,5924,1,3,1,5929,A
1-PB2,1414,1,8,5945,0,5954,G
1-PB2,1415,5931,0,2,0,5933,A
1-PB2,1416,2,0,5987,0,5989,G
1-PB2,1417,5989,1,2,0,5992,A
1-PB2,1418,0,5779,1,1,5781,T
1-PB2,1419,1,1,5871,1,5874,G
1-PB2,1420,2,5849,0,1,5852,T
1-PB2,1421,11,1,0,5827,5839,C
1-PB2,1422,5855,0,3,0,5858,A
1-PB2,1423,5849,0,1,0,5850,A
1-PB2,1424,1,5836,0,1,5838,T
1-PB2,1425,2,10,5808,1,5821,G
1-PB2,1426,5721,1,2,0,5724,A
1-PB2,1427,0,4,5754,1,5759,G
1-PB2,1428,5630,1,11,1,5643,A
1-PB2,1429,0,4,5680,0,5684,G
1-PB2,1430,4,9,5889,0,5902,G
1-PB2,1431,5892,0,3,0,5895,A
1-PB2,1432,5904,1,4,0,5909,A
1-PB2,1433,0,5899,1,1,5901,T
1-PB2,1434,5901,1,1,0,5903,A
1-PB2,1435,5892,0,3,0,5895,A
1-PB2,1436,1,9,5885,0,5895,G
1-PB2,1437,5871,1,3,0,5875,A
1-PB2,1438,1,1,5884,1,5887,G
1-PB2,1439,0,5540,0,2,5542,T
1-PB2,1440,12,0,1,5542,5555,C
1-PB2,1441,5555,0,6,2,5563,A
1-PB2,1442,3,2,5592,0,5597,G
1-PB2,1443,1,3,0,5603,5607,C
1-PB2,1444,5599,1,0,0,5600,A
1-PB2,1445,5608,1,1,0,5610,A
1-PB2,1446,5586,1,2,0,5589,A
1-PB2,1447,5579,0,4,2,5585,A
1-PB2,1448,0,5570,1,1,5572,T
1-PB2,1449,1,19,5564,2,5586,G
1-PB2,1450,0,4,5584,0,5588,G
1-PB2,1451,0,1,5621,0,5622,G
1-PB2,1452,1,5520,0,11,5532,T
1-PB2,1453,1,1,5533,1,5536,G
1-PB2,1454,1,5513,0,4,5518,T
1-PB2,1455,3,11,5517,0,5531,G
1-PB2,1456,1,6,5585,0,5592,G
1-PB2,1457,5597,1,2,1,5601,A
1-PB2,1458,4,5572,0,0,5576,T
1-PB2,1459,0,12,5595,2,5609,G
1-PB2,1460,5571,1,2,0,5574,A
1-PB2,1461,5589,3,1,0,5593,A
1-PB2,1462,0,5568,1,1,5570,T
1-PB2,1463,5534,0,1,0,5535,A
1-PB2,1464,0,0,0,5863,5863,C
1-PB2,1465,2,5723,0,6,5731,T
1-PB2,1466,15,0,1,5775,5791,C
1-PB2,1467,3,4,1,5781,5789,C
1-PB2,1468,5735,0,0,0,5735,A
1-PB2,1469,2,3,5915,1,5921,G
1-PB2,1470,0,5889,0,2,5891,T
1-PB2,1471,5929,0,2,0,5931,A
1-PB2,1472,3,1,0,5947,5951,C
1-PB2,1473,5352,0,3,0,5355,A
1-PB2,1474,0,3,5372,1,5376,G
1-PB2,1475,5240,0,8,1,5249,A
1-PB2,1476,0,5,5267,0,5272,G
1-PB2,1477,5111,0,4,0,5115,A
1-PB2,1478,0,19,4881,0,4900,G
1-PB2,1479,0,5,4874,0,4879,G
1-PB2,1480,0,3,4887,0,4890,G
1-PB2,1481,2,4808,1,3,4814,T
1-PB2,1482,3,6,4792,0,4801,G
1-PB2,1483,1,1,4813,0,4815,G
1-PB2,1484,1,4780,2,0,4783,T
1-PB2,1485,0,4,4863,0,4867,G
1-PB2,1486,0,2,4868,0,4870,G
1-PB2,1487,0,4750,0,3,4753,T
1-PB2,1488,0,4745,0,2,4747,T
1-PB2,1489,4677,3,1,0,4681,A
1-PB2,1490,2,1,4709,0,4712,G
1-PB2,1491,0,2,0,4706,4708,C
1-PB2,1492,4673,0,5,1,4679,A
1-PB2,1493,0,4665,0,2,4667,T
1-PB2,1494,0,4425,0,0,4425,T
1-PB2,1495,0,3,4427,3,4433,G
1-PB2,1496,4420,0,1,1,4422,A
1-PB2,1497,0,4415,0,2,4417,T
1-PB2,1498,12,2,0,4409,4423,C
1-PB2,1499,2,6,4379,0,4387,G
1-PB2,1500,1,1,4445,0,4447,G
1-PB2,1501,0,4442,0,3,4445,T
1-PB2,1502,1,4440,1,0,4442,T
1-PB2,1503,1,4440,0,0,4441,T
1-PB2,1504,0,4434,0,1,4435,T
1-PB2,1505,1,4437,0,0,4438,T
1-PB2,1506,0,3,4435,0,4438,G
1-PB2,1507,4428,0,5,0,4433,A
1-PB2,1508,0,5,4457,0,4462,G
1-PB2,1509,4319,1,3,0,4323,A
1-PB2,1510,0,0,4361,0,4361,G
1-PB2,1511,0,4349,0,3,4352,T
1-PB2,1512,0,4345,0,1,4346,T
1-PB2,1513,4329,0,2,0,4331,A
1-PB2,1514,0,6,4345,0,4351,G
1-PB2,1515,4346,0,4,0,4350,A
1-PB2,1516,1,5,4355,0,4361,G
1-PB2,1517,4313,0,4,0,4317,A
1-PB2,1518,1,2,0,4306,4309,C
1-PB2,1519,7,2,0,4267,4276,C
1-PB2,1520,4179,0,4,0,4183,A
1-PB2,1521,4228,1,4,0,4233,A
1-PB2,1522,2,1,0,4232,4235,C
1-PB2,1523,1,0,4240,0,4241,G
1-PB2,1524,1,4229,0,0,4230,T
1-PB2,1525,0,7,4201,0,4208,G
1-PB2,1526,0,7,4215,0,4222,G
1-PB2,1527,4,4,4209,0,4217,G
1-PB2,1528,4188,0,1,0,4189,A
1-PB2,1529,4197,1,1,0,4199,A
1-PB2,1530,0,4070,0,1,4071,T
1-PB2,1531,2,0,4199,0,4201,G
1-PB2,1532,0,4175,0,1,4176,T
1-PB2,1533,4183,0,0,1,4184,A
1-PB2,1534,1,4175,0,3,4179,T
1-PB2,1535,0,4109,0,1,4110,T
1-PB2,1536,4148,1,1,0,4150,A
1-PB2,1537,0,4120,0,4,4124,T
1-PB2,1538,0,4061,0,1,4062,T
1-PB2,1539,4046,0,1,0,4047,A
1-PB2,1540,1,3562,0,4,3567,T
1-PB2,1541,2,0,0,3616,3618,C
1-PB2,1542,2,3579,0,1,3582,T
1-PB2,1543,10,1,0,3566,3577,C
1-PB2,1544,4,1,0,3578,3583,C
1-PB2,1545,0,3467,0,5,3472,T
1-PB2,1546,2,0,3480,0,3482,G
1-PB2,1547,3461,0,2,0,3463,A
1-PB2,1548,1,3,3464,0,3468,G
1-PB2,1549,0,4,3458,0,3462,G
1-PB2,1550,3039,0,2,0,3041,A
1-PB2,1551,0,3,3062,0,3065,G
1-PB2,1552,1,0,3030,0,3031,G
1-PB2,1553,1,2977,0,2,2980,T
1-PB2,1554,6,1,0,2977,2984,C
1-PB2,1555,2957,0,1,2,2960,A
1-PB2,1556,0,0,2989,0,2989,G
1-PB2,1557,0,2977,0,1,2978,T
1-PB2,1558,1,3,2978,0,2982,G
1-PB2,1559,2981,0,3,0,2984,A
1-PB2,1560,2866,1,0,0,2867,A
1-PB2,1561,2868,1,2,1,2872,A
1-PB2,1562,2,2,0,2871,2875,C
1-PB2,1563,2846,0,1,0,2847,A
1-PB2,1564,0,1,0,2847,2848,C
1-PB2,1565,2704,0,1,1,2706,A
1-PB2,1566,1,7,2708,0,2716,G
1-PB2,1567,0,4,2704,1,2709,G
1-PB2,1568,1,1,2709,0,2711,G
1-PB2,1569,2713,0,0,0,2713,A
1-PB2,1570,2663,0,2,0,2665,A
1-PB2,1571,0,0,0,2687,2687,C
1-PB2,1572,0,2628,0,3,2631,T
1-PB2,1573,1,2,2631,1,2635,G
1-PB2,1574,2608,1,2,0,2611,A
1-PB2,1575,0,2,2614,0,2616,G
1-PB2,1576,2547,0,5,0,2552,A
1-PB2,1577,0,16,2399,0,2415,G
1-PB2,1578,2405,0,1,0,2406,A
1-PB2,1579,1,0,0,2394,2395,C
1-PB2,1580,0,2285,0,1,2286,T
1-PB2,1581,0,1,2312,0,2313,G
1-PB2,1582,2296,0,2,0,2298,A
1-PB2,1583,0,2,0,2299,2301,C
1-PB2,1584,2281,0,1,0,2282,A
1-PB2,1585,2273,1,2,1,2277,A
1-PB2,1586,1,2261,1,0,2263,T
1-PB2,1587,2249,1,0,0,2250,A
1-PB2,1588,2249,0,0,0,2249,A
1-PB2,1589,2,1,0,2243,2246,C
1-PB2,1590,1,2044,0,1,2046,T
1-PB2,1591,0,1999,0,0,1999,T
1-PB2,1592,1950,0,1,1,1952,A
1-PB2,1593,1,1948,0,1,1950,T
1-PB2,1594,1,1939,0,0,1940,T
1-PB2,1595,5,1,0,1926,1932,C
1-PB2,1596,1753,0,2,0,1755,A
1-PB2,1597,1,1745,0,1,1747,T
1-PB2,1598,2,1,0,1632,1635,C
1-PB2,1599,1,0,1638,0,1639,G
1-PB2,1600,0,1636,0,2,1638,T
1-PB2,1601,2,1,0,1597,1600,C
1-PB2,1602,2,2,1593,0,1597,G
1-PB2,1603,1588,0,8,0,1596,A
1-PB2,1604,0,1601,0,1,1602,T
1-PB2,1605,0,0,1588,0,1588,G
1-PB2,1606,1577,0,2,0,1579,A
1-PB2,1607,1,1567,0,1,1569,T
1-PB2,1608,0,0,1549,0,1549,G
1-PB2,1609,0,1473,1,2,1476,T
1-PB2,1610,1,4,1462,0,1467,G
1-PB2,1611,0,0,1471,0,1471,G
1-PB2,1612,0,2,1463,0,1465,G
1-PB2,1613,1408,0,0,0,1408,A
1-PB2,1614,0,0,1373,0,1373,G
1-PB2,1615,1191,0,0,0,1191,A
1-PB2,1616,0,1131,0,1,1132,T
1-PB2,1617,0,1056,0,1,1057,T
1-PB2,1618,1050,0,0,0,1050,A
1-PB2,1619,1038,0,2,0,1040,A
1-PB2,1620,0,2,0,1014,1016,C
1-PB2,1621,0,2,859,0,861,G
1-PB2,1622,0,0,813,0,813,G
1-PB2,1623,0,532,0,1,533,T
1-PB2,1624,0,0,0,509,509,C
1-PB2,1625,1,0,0,507,508,C
1-PB2,1626,0,432,0,0,432,T
1-PB2,1627,0,0,433,0,433,G
1-PB2,1628,433,0,0,0,433,A
1-PB2,1629,0,0,433,0,433,G
1-PB2,1630,0,432,0,1,433,T
1-PB2,1631,1,0,0,420,421,C
1-PB2,1632,1,0,418,0,419,G
1-PB2,1633,0,1,423,0,424,G
1-PB2,1634,0,422,0,0,422,T
1-PB2,1635,0,423,0,0,423,T
1-PB2,1636,0,421,0,0,421,T
1-PB2,1637,0,417,0,0,417,T
1-PB2,1638,0,0,428,0,428,G
1-PB2,1639,0,0,432,0,432,G
1-PB2,1640,0,430,0,1,431,T
1-PB2,1641,3,0,0,426,429,C
1-PB2,1642,424,0,0,0,424,A
1-PB2,1643,440,0,0,0,440,A
1-PB2,1644,0,440,0,0,440,T
1-PB2,1645,442,0,0,0,442,A
1-PB2,1646,0,0,0,456,456,C
1-PB2,1647,1,0,0,441,442,C
1-PB2,1648,0,441,1,2,444,T
1-PB2,1649,448,0,0,0,448,A
1-PB2,1650,0,449,0,0,449,T
1-PB2,1651,1,0,0,447,448,C
1-PB2,1652,435,0,0,1,436,A
1-PB2,1653,438,0,0,0,438,A
1-PB2,1654,0,437,0,0,437,T
1-PB2,1655,0,0,425,0,425,G
1-PB2,1656,0,2,424,0,426,G
1-PB2,1657,423,0,1,0,424,A
1-PB2,1658,0,412,0,0,412,T
1-PB2,1659,0,0,0,411,411,C
1-PB2,1660,410,1,0,0,411,A
1-PB2,1661,0,412,0,0,412,T
1-PB2,1662,0,0,0,409,409,C
1-PB2,1663,412,0,0,0,412,A
1-PB2,1664,0,1,411,0,412,G
1-PB2,1665,405,1,0,0,406,A
1-PB2,1666,407,0,0,0,407,A
1-PB2,1667,408,0,0,0,408,A
1-PB2,1668,0,406,0,0,406,T
1-PB2,1669,0,404,0,0,404,T
1-PB2,1670,0,3,400,0,403,G
1-PB2,1671,0,1,399,0,400,G
1-PB2,1672,0,1,398,0,399,G
1-PB2,1673,400,0,0,0,400,A
1-PB2,1674,397,0,0,0,397,A
1-PB2,1675,0,0,394,0,394,G
1-PB2,1676,0,0,0,396,396,C
1-PB2,1677,0,396,0,0,396,T
1-PB2,1678,0,0,406,0,406,G
1-PB2,1679,0,401,0,1,402,T
1-PB2,1680,1,0,0,404,405,C
1-PB2,1681,405,0,0,0,405,A
1-PB2,1682,407,0,0,0,407,A
1-PB2,1683,402,0,1,1,404,A
1-PB2,1684,408,0,0,0,408,A
1-PB2,1685,0,408,0,1,409,T
1-PB2,1686,0,409,0,0,409,T
1-PB2,1687,0,1,0,408,409,C
1-PB2,1688,403,0,0,0,403,A
1-PB2,1689,403,0,0,0,403,A
1-PB2,1690,0,404,0,0,404,T
1-PB2,1691,0,1,403,0,404,G
1-PB2,1692,0,0,408,0,408,G
1-PB2,1693,0,420,0,0,420,T
1-PB2,1694,1,0,0,417,418,C
1-PB2,1695,0,419,0,1,420,T
1-PB2,1696,0,1,0,419,420,C
1-PB2,1697,419,0,1,0,420,A
1-PB2,1698,0,1,419,0,420,G
1-PB2,1699,418,0,0,0,418,A
1-PB2,1700,420,0,0,0,420,A
1-PB2,1701,0,414,0,0,414,T
1-PB2,1702,1,0,0,400,401,C
1-PB2,1703,0,0,0,407,407,C
1-PB2,1704,0,409,0,0,409,T
1-PB2,1705,0,1,406,1,408,G
1-PB2,1706,0,0,0,408,408,C
1-PB2,1707,406,0,0,0,406,A
1-PB2,1708,411,0,0,0,411,A
1-PB2,1709,0,407,0,0,407,T
1-PB2,1710,0,0,417,0,417,G
1-PB2,1711,0,418,0,0,418,T
1-PB2,1712,0,406,0,0,406,T
1-PB2,1713,1,0,410,0,411,G
1-PB2,1714,0,412,0,0,412,T
1-PB2,1715,412,0,0,0,412,A
1-PB2,1716,0,1,0,411,412,C
1-PB2,1717,405,0,0,0,405,A
1-PB2,1718,407,0,0,0,407,A
1-PB2,1719,0,1,0,402,403,C
1-PB2,1720,397,0,0,0,397,A
1-PB2,1721,397,0,0,0,397,A
1-PB2,1722,389,0,0,0,389,A
1-PB2,1723,393,0,0,0,393,A
1-PB2,1724,0,393,0,0,393,T
1-PB2,1725,0,1,390,1,392,G
1-PB2,1726,0,0,392,0,392,G
1-PB2,1727,389,0,0,0,389,A
1-PB2,1728,393,0,0,0,393,A
1-PB2,1729,0,393,0,0,393,T
1-PB2,1730,0,390,0,0,390,T
1-PB2,1731,0,391,0,0,391,T
1-PB2,1732,0,1,389,0,390,G
1-PB2,1733,391,1,0,0,392,A
1-PB2,1734,393,0,0,0,393,A
1-PB2,1735,0,0,0,391,391,C
1-PB2,1736,1,0,0,387,388,C
1-PB2,1737,391,0,0,0,391,A
1-PB2,1738,0,395,0,1,396,T
1-PB2,1739,0,395,0,0,395,T
1-PB2,1740,0,396,0,0,396,T
1-PB2,1741,0,0,0,394,394,C
1-PB2,1742,395,0,1,0,396,A
1-PB2,1743,397,0,0,0,397,A
1-PB2,1744,0,396,0,0,396,T
1-PB2,1745,0,0,0,403,403,C
1-PB2,1746,0,396,0,0,396,T
1-PB2,1747,0,391,0,0,391,T
1-PB2,1748,0,392,0,0,392,T
1-PB2,1749,391,0,0,0,391,A
1-PB2,1750,0,1,396,0,397,G
1-PB2,1751,0,396,0,0,396,T
1-PB2,1752,1,0,0,404,405,C
1-PB2,1753,2,0,0,403,405,C
1-PB2,1754,0,0,0,402,402,C
1-PB2,1755,0,0,0,402,402,C
1-PB2,1756,403,0,0,0,403,A
1-PB2,1757,402,0,0,0,402,A
1-PB2,1758,0,2,405,0,407,G
1-PB2,1759,0,0,402,0,402,G
1-PB2,1760,0,0,0,403,403,C
1-PB2,1761,0,0,0,396,396,C
1-PB2,1762,397,0,0,0,397,A
1-PB2,1763,0,401,0,0,401,T
1-PB2,1764,0,399,0,0,399,T
1-PB2,1765,401,0,0,0,401,A
1-PB2,1766,0,0,399,0,399,G
1-PB2,1767,386,0,0,0,386,A
1-PB2,1768,397,0,0,0,397,A
1-PB2,1769,1,0,399,0,400,G
1-PB2,1770,0,0,0,399,399,C
1-PB2,1771,0,0,0,399,399,C
1-PB2,1772,396,0,0,0,396,A
1-PB2,1773,401,0,0,0,401,A
1-PB2,1774,0,405,0,0,405,T
1-PB2,1775,407,0,0,0,407,A
1-PB2,1776,0,0,0,406,406,C
1-PB2,1777,376,0,0,0,376,A
1-PB2,1778,0,0,377,0,377,G
1-PB2,1779,0,368,0,0,368,T
1-PB2,1780,0,1,369,0,370,G
1-PB2,1781,0,1,369,0,370,G
1-PB2,1782,0,0,371,0,371,G
1-PB2,1783,0,368,0,0,368,T
1-PB2,1784,0,366,0,0,366,T
1-PB2,1785,0,369,0,0,369,T
1-PB2,1786,0,0,373,0,373,G
1-PB2,1787,0,373,0,1,374,T
1-PB2,1788,2,0,0,372,374,C
1-PB2,1789,365,0,3,0,368,A
1-PB2,1790,0,1,369,0,370,G
1-PB2,1791,368,0,0,0,368,A
1-PB2,1792,366,0,0,0,366,A
1-PB2,1793,0,0,0,367,367,C
1-PB2,1794,0,358,0,1,359,T
1-PB2,1795,1,0,0,369,370,C
1-PB2,1796,0,370,0,0,370,T
1-PB2,1797,370,0,0,0,370,A
1-PB2,1798,0,370,0,0,370,T
1-PB2,1799,0,368,0,0,368,T
1-PB2,1800,1,0,0,369,370,C
1-PB2,1801,0,1,0,366,367,C
1-PB2,1802,366,0,0,0,366,A
1-PB2,1803,366,0,2,0,368,A
1-PB2,1804,0,0,0,367,367,C
1-PB2,1805,364,0,0,0,364,A
1-PB2,1806,368,0,1,0,369,A
1-PB2,1807,369,0,0,0,369,A
1-PB2,1808,0,370,0,1,371,T
1-PB2,1809,0,1,369,0,370,G
1-PB2,1810,368,0,0,0,368,A
1-PB2,1811,0,1,370,0,371,G
1-PB2,1812,371,0,0,0,371,A
1-PB2,1813,0,0,371,0,371,G
1-PB2,1814,371,0,0,0,371,A
1-PB2,1815,0,0,0,366,366,C
1-PB2,1816,0,1,371,0,372,G
1-PB2,1817,0,373,0,0,373,T
1-PB2,1818,377,0,0,0,377,A
1-PB2,1819,0,0,0,380,380,C
1-PB2,1820,0,371,0,0,371,T
1-PB2,1821,0,369,0,0,369,T
1-PB2,1822,0,0,368,0,368,G
1-PB2,1823,0,0,371,0,371,G
1-PB2,1824,0,0,369,0,369,G
1-PB2,1825,366,0,0,0,366,A
1-PB2,1826,0,0,0,369,369,C
1-PB2,1827,366,0,0,0,366,A
1-PB2,1828,0,364,0,0,364,T
1-PB2,1829,0,363,0,1,364,T
1-PB2,1830,0,365,0,0,365,T
1-PB2,1831,0,0,362,0,362,G
1-PB2,1832,368,0,0,0,368,A
1-PB2,1833,0,0,0,368,368,C
1-PB2,1834,366,1,0,0,367,A
1-PB2,1835,0,0,0,368,368,C
1-PB2,1836,0,0,0,368,368,C
1-PB2,1837,371,0,0,0,371,A
1-PB2,1838,0,1,1,366,368,C
1-PB2,1839,1,0,0,371,372,C
1-PB2,1840,2,0,0,369,371,C
1-PB2,1841,365,0,0,0,365,A
1-PB2,1842,0,1,371,0,372,G
1-PB2,1843,376,0,0,0,376,A
1-PB2,1844,0,383,0,1,384,T
1-PB2,1845,380,0,0,0,380,A
1-PB2,1846,378,0,0,0,378,A
1-PB2,1847,0,376,0,1,377,T
1-PB2,1848,374,0,0,0,374,A
1-PB2,1849,376,0,0,0,376,A
1-PB2,1850,372,0,0,0,372,A
1-PB2,1851,0,0,378,0,378,G
1-PB2,1852,0,0,0,373,373,C
1-PB2,1853,0,360,0,0,360,T
1-PB2,1854,0,362,0,0,362,T
1-PB2,1855,1,0,0,361,362,C
1-PB2,1856,0,357,0,1,358,T
1-PB2,1857,1,0,0,367,368,C
1-PB2,1858,2,1,0,365,368,C
1-PB2,1859,1,0,0,368,369,C
1-PB2,1860,2,0,0,359,361,C
1-PB2,1861,0,372,0,1,373,T
1-PB2,1862,0,374,0,0,374,T
1-PB2,1863,0,375,0,0,375,T
1-PB2,1864,0,0,375,0,375,G
1-PB2,1865,0,0,0,376,376,C
1-PB2,1866,370,0,0,1,371,A
1-PB2,1867,0,0,372,0,372,G
1-PB2,1868,0,0,0,373,373,C
1-PB2,1869,0,363,0,1,364,T
1-PB2,1870,0,0,368,0,368,G
1-PB2,1871,0,0,0,369,369,C
1-PB2,1872,0,368,0,0,368,T
1-PB2,1873,1,0,0,368,369,C
1-PB2,1874,1,0,0,365,366,C
1-PB2,1875,367,0,0,0,367,A
1-PB2,1876,0,0,0,366,366,C
1-PB2,1877,1,0,0,361,362,C
1-PB2,1878,362,0,0,0,362,A
1-PB2,1879,360,0,1,0,361,A
1-PB2,1880,359,0,0,0,359,A
1-PB2,1881,0,0,362,0,362,G
1-PB2,1882,0,0,0,363,363,C
1-PB2,1883,356,0,0,0,356,A
1-PB2,1884,356,0,1,0,357,A
1-PB2,1885,356,0,1,0,357,A
1-PB2,1886,0,0,361,0,361,G
1-PB2,1887,1,0,0,361,362,C
1-PB2,1888,355,0,0,0,355,A
1-PB2,1889,0,0,354,0,354,G
1-PB2,1890,349,0,0,0,349,A
1-PB2,1891,353,0,0,1,354,A
1-PB2,1892,0,354,0,0,354,T
1-PB2,1893,0,0,354,0,354,G
1-PB2,1894,1,0,0,352,353,C
1-PB2,1895,348,0,0,0,348,A
1-PB2,1896,0,1,352,0,353,G
1-PB2,1897,0,354,0,0,354,T
1-PB2,1898,0,371,0,0,371,T
1-PB2,1899,0,0,0,371,371,C
1-PB2,1900,0,364,0,0,364,T
1-PB2,1901,0,0,0,374,374,C
1-PB2,1902,0,375,0,0,375,T
1-PB2,1903,0,372,0,0,372,T
1-PB2,1904,0,0,0,373,373,C
1-PB2,1905,367,0,0,0,367,A
1-PB2,1906,0,0,0,368,368,C
1-PB2,1907,0,359,0,0,359,T
1-PB2,1908,0,0,365,0,365,G
1-PB2,1909,362,0,0,0,362,A
1-PB2,1910,0,0,0,365,365,C
1-PB2,1911,0,364,0,0,364,T
1-PB2,1912,0,0,365,0,365,G
1-PB2,1913,0,364,0,0,364,T
1-PB2,1914,0,0,369,0,369,G
1-PB2,1915,367,0,0,0,367,A
1-PB2,1916,370,1,0,0,371,A
1-PB2,1917,0,362,0,0,362,T
1-PB2,1918,0,0,362,0,362,G
1-PB2,1919,0,347,0,1,348,T
1-PB2,1920,327,0,0,0,327,A
1-PB2,1921,328,0,0,0,328,A
1-PB2,1922,0,0,329,0,329,G
1-PB2,1923,328,0,0,0,328,A
1-PB2,1924,0,1,335,0,336,G
1-PB2,1925,0,0,341,0,341,G
1-PB2,1926,344,0,0,0,344,A
1-PB2,1927,0,342,0,0,342,T
1-PB2,1928,1,0,0,340,341,C
1-PB2,1929,340,0,0,0,340,A
1-PB2,1930,0,0,343,0,343,G
1-PB2,1931,0,1,342,0,343,G
1-PB2,1932,0,0,344,0,344,G
1-PB2,1933,344,0,0,0,344,A
1-PB2,1934,0,332,0,0,332,T
1-PB2,1935,0,0,331,1,332,G
1-PB2,1936,331,0,0,0,331,A
1-PB2,1937,0,0,337,0,337,G
1-PB2,1938,338,0,0,0,338,A
1-PB2,1939,331,0,0,0,331,A
1-PB2,1940,0,334,0,0,334,T
1-PB2,1941,334,0,0,1,335,A
1-PB2,1942,0,0,0,343,343,C
1-PB2,1943,0,341,0,0,341,T
1-PB2,1944,0,338,0,1,339,T
1-PB2,1945,0,0,342,0,342,G
1-PB2,1946,0,337,0,0,337,T
1-PB2,1947,336,0,0,0,336,A
1-PB2,1948,337,0,0,0,337,A
1-PB2,1949,0,1,328,0,329,G
1-PB2,1950,0,2,327,0,329,G
1-PB2,1951,0,1,327,0,328,G
1-PB2,1952,0,0,328,0,328,G
1-PB2,1953,0,0,0,330,330,C
1-PB2,1954,326,0,0,0,326,A
1-PB2,1955,333,0,0,0,333,A
1-PB2,1956,0,333,0,0,333,T
1-PB2,1957,0,332,0,0,332,T
1-PB2,1958,0,0,0,338,338,C
1-PB2,1959,0,327,0,0,327,T
1-PB2,1960,1,0,0,333,334,C
1-PB2,1961,0,0,0,333,333,C
1-PB2,1962,0,333,0,0,333,T
1-PB2,1963,0,0,339,0,339,G
1-PB2,1964,1,334,0,0,335,T
1-PB2,1965,336,0,0,0,336,A
1-PB2,1966,0,335,0,0,335,T
1-PB2,1967,0,330,0,0,330,T
1-PB2,1968,0,0,0,329,329,C
1-PB2,1969,322,1,1,0,324,A
1-PB2,1970,326,0,0,0,326,A
1-PB2,1971,0,1,0,325,326,C
1-PB2,1972,0,322,0,0,322,T
1-PB2,1973,324,0,0,0,324,A
1-PB2,1974,0,0,0,328,328,C
1-PB2,1975,328,0,0,0,328,A
1-PB2,1976,328,0,0,0,328,A
1-PB2,1977,0,0,0,327,327,C
1-PB2,1978,321,0,0,0,321,A
1-PB2,1979,319,0,0,0,319,A
1-PB2,1980,1,2,316,0,319,G
1-PB2,1981,318,0,2,0,320,A
1-PB2,1982,0,0,0,321,321,C
1-PB2,1983,0,1,0,309,310,C
1-PB2,1984,310,0,1,0,311,A
1-PB2,1985,1,0,0,319,320,C
1-PB2,1986,0,319,0,0,319,T
1-PB2,1987,318,0,0,0,318,A
1-PB2,1988,318,0,0,0,318,A
1-PB2,1989,317,0,1,0,318,A
1-PB2,1990,318,0,0,0,318,A
1-PB2,1991,0,1,320,0,321,G
1-PB2,1992,313,1,7,0,321,A
1-PB2,1993,0,0,0,323,323,C
1-PB2,1994,0,313,0,0,313,T
1-PB2,1995,312,0,0,0,312,A
1-PB2,1996,310,0,0,0,310,A
1-PB2,1997,0,0,0,311,311,C
1-PB2,1998,307,0,0,0,307,A
1-PB2,1999,307,0,0,0,307,A
1-PB2,2000,0,302,0,0,302,T
1-PB2,2001,0,303,0,0,303,T
1-PB2,2002,0,0,0,303,303,C
1-PB2,2003,0,302,0,0,302,T
1-PB2,2004,0,0,0,301,301,C
1-PB2,2005,0,1,301,0,302,G
1-PB2,2006,1,0,301,0,302,G
1-PB2,2007,302,0,0,0,302,A
1-PB2,2008,303,0,0,0,303,A
1-PB2,2009,302,0,0,0,302,A
1-PB2,2010,301,0,0,0,301,A
1-PB2,2011,0,0,303,0,303,G
1-PB2,2012,300,0,1,0,301,A
1-PB2,2013,0,302,0,0,302,T
1-PB2,2014,0,0,301,0,301,G
1-PB2,2015,0,0,0,301,301,C
1-PB2,2016,1,0,0,301,302,C
1-PB2,2017,0,0,300,0,300,G
1-PB2,2018,0,0,302,0,302,G
1-PB2,2019,0,0,0,301,301,C
1-PB2,2020,300,0,0,0,300,A
1-PB2,2021,0,0,0,303,303,C
1-PB2,2022,0,305,0,0,305,T
1-PB2,2023,0,304,0,0,304,T
1-PB2,2024,0,305,0,0,305,T
1-PB2,2025,306,0,0,0,306,A
1-PB2,2026,306,0,0,0,306,A
1-PB2,2027,0,308,0,0,308,T
1-PB2,2028,0,307,0,0,307,T
1-PB2,2029,0,0,308,0,308,G
1-PB2,2030,291,0,0,0,291,A
1-PB2,2031,291,0,0,0,291,A
1-PB2,2032,0,0,289,0,289,G
1-PB2,2033,293,0,0,0,293,A
1-PB2,2034,0,0,0,295,295,C
1-PB2,2035,0,0,0,293,293,C
1-PB2,2036,1,0,0,292,293,C
1-PB2,2037,294,0,0,0,294,A
1-PB2,2038,0,1,302,0,303,G
1-PB2,2039,302,1,0,0,303,A
1-PB2,2040,0,302,0,0,302,T
1-PB2,2041,0,0,301,0,301,G
1-PB2,2042,290,0,1,1,292,A
1-PB2,2043,291,1,0,0,292,A
1-PB2,2044,293,0,0,0,293,A
1-PB2,2045,0,0,291,0,291,G
1-PB2,2046,0,0,0,289,289,C
1-PB2,2047,287,0,0,0,287,A
1-PB2,2048,0,0,0,289,289,C
1-PB2,2049,290,0,0,0,290,A
1-PB2,2050,0,288,0,0,288,T
1-PB2,2051,0,0,0,293,293,C
1-PB2,2052,0,0,0,290,290,C
1-PB2,2053,0,0,290,0,290,G
1-PB2,2054,0,1,290,0,291,G
1-PB2,2055,289,0,0,0,289,A
1-PB2,2056,0,0,288,0,288,G
1-PB2,2057,0,283,0,0,283,T
1-PB2,2058,0,2,277,0,279,G
1-PB2,2059,0,0,280,0,280,G
1-PB2,2060,277,0,1,0,278,A
1-PB2,2061,0,0,278,0,278,G
1-PB2,2062,0,276,0,0,276,T
1-PB2,2063,0,0,0,271,271,C
1-PB2,2064,2,0,0,270,272,C
1-PB2,2065,0,0,272,0,272,G
1-PB2,2066,0,0,0,270,270,C
1-PB2,2067,0,0,0,272,272,C
1-PB2,2068,0,0,276,0,276,G
1-PB2,2069,0,275,0,1,276,T
1-PB2,2070,0,0,0,278,278,C
1-PB2,2071,0,279,0,0,279,T
1-PB2,2072,0,280,0,2,282,T
1-PB2,2073,0,1,281,0,282,G
1-PB2,2074,279,0,0,0,279,A
1-PB2,2075,0,0,280,0,280,G
1-PB2,2076,279,0,0,0,279,A
1-PB2,2077,0,1,269,0,270,G
1-PB2,2078,0,0,270,0,270,G
1-PB2,2079,0,0,270,0,270,G
1-PB2,2080,0,268,0,0,268,T
1-PB2,2081,0,268,0,0,268,T
1-PB2,2082,0,277,0,0,277,T
1-PB2,2083,0,0,0,277,277,C
1-PB2,2084,0,278,0,0,278,T
1-PB2,2085,0,0,0,290,290,C
1-PB2,2086,286,0,0,0,286,A
1-PB2,2087,0,281,0,0,281,T
1-PB2,2088,0,277,0,0,277,T
1-PB2,2089,277,0,0,0,277,A
1-PB2,2090,0,276,0,0,276,T
1-PB2,2091,274,0,0,0,274,A
1-PB2,2092,0,1,275,0,276,G
1-PB2,2093,0,0,276,0,276,G
1-PB2,2094,0,265,0,0,265,T
1-PB2,2095,265,0,0,0,265,A
1-PB2,2096,263,0,0,0,263,A
1-PB2,2097,0,1,265,0,266,G
1-PB2,2098,0,0,265,0,265,G
1-PB2,2099,265,0,0,0,265,A
1-PB2,2100,263,0,0,0,263,A
1-PB2,2101,0,0,263,0,263,G
1-PB2,2102,257,0,0,0,257,A
1-PB2,2103,0,0,0,258,258,C
1-PB2,2104,252,0,0,0,252,A
1-PB2,2105,0,0,253,0,253,G
1-PB2,2106,249,0,1,0,250,A
1-PB2,2107,248,0,0,0,248,A
1-PB2,2108,0,1,246,0,247,G
1-PB2,2109,0,0,240,0,240,G
1-PB2,2110,0,244,0,0,244,T
1-PB2,2111,246,0,0,0,246,A
1-PB2,2112,0,0,0,244,244,C
1-PB2,2113,0,1,242,0,243,G
1-PB2,2114,0,1,245,0,246,G
1-PB2,2115,243,0,0,0,243,A
1-PB2,2116,0,0,0,243,243,C
1-PB2,2117,0,0,0,239,239,C
1-PB2,2118,228,0,0,0,228,A
1-PB2,2119,0,0,237,0,237,G
1-PB2,2120,0,0,0,237,237,C
1-PB2,2121,237,0,1,0,238,A
1-PB2,2122,0,238,0,0,238,T
1-PB2,2123,0,228,0,0,228,T
1-PB2,2124,229,0,0,0,229,A
1-PB2,2125,229,0,0,0,229,A
1-PB2,2126,0,0,228,0,228,G
1-PB2,2127,1,1,0,228,230,C
1-PB2,2128,218,0,0,0,218,A
1-PB2,2129,0,226,0,0,226,T
1-PB2,2130,0,1,0,224,225,C
1-PB2,2131,227,0,0,0,227,A
1-PB2,2132,227,0,0,0,227,A
1-PB2,2133,0,226,0,0,226,T
1-PB2,2134,0,0,226,0,226,G
1-PB2,2135,218,0,0,0,218,A
1-PB2,2136,219,1,0,0,220,A
1-PB2,2137,0,0,0,220,220,C
1-PB2,2138,0,202,0,0,202,T
1-PB2,2139,0,0,207,0,207,G
1-PB2,2140,205,0,1,0,206,A
1-PB2,2141,0,0,207,0,207,G
1-PB2,2142,0,207,0,0,207,T
1-PB2,2143,205,0,0,0,205,A
1-PB2,2144,205,0,0,0,205,A
1-PB2,2145,0,0,0,208,208,C
1-PB2,2146,0,0,0,203,203,C
1-PB2,2147,0,202,0,0,202,T
1-PB2,2148,0,195,0,0,195,T
1-PB2,2149,0,0,195,0,195,G
1-PB2,2150,0,0,0,194,194,C
1-PB2,2151,195,0,0,0,195,A
1-PB2,2152,196,0,0,0,196,A
1-PB2,2153,191,0,0,0,191,A
1-PB2,2154,191,0,0,0,191,A
1-PB2,2155,0,0,191,0,191,G
1-PB2,2156,0,0,191,0,191,G
1-PB2,2157,0,0,191,0,191,G
1-PB2,2158,0,0,191,0,191,G
1-PB2,2159,190,0,0,0,190,A
1-PB2,2160,190,0,1,0,191,A
1-PB2,2161,191,0,0,0,191,A
1-PB2,2162,192,0,0,0,192,A
1-PB2,2163,0,0,195,0,195,G
1-PB2,2164,0,0,195,0,195,G
1-PB2,2165,0,0,0,194,194,C
1-PB2,2166,0,194,0,0,194,T
1-PB2,2167,191,0,0,0,191,A
1-PB2,2168,191,0,0,0,191,A
1-PB2,2169,0,192,0,0,192,T
1-PB2,2170,0,0,196,0,196,G
1-PB2,2171,0,192,0,0,192,T
1-PB2,2172,0,0,188,0,188,G
1-PB2,2173,0,0,0,185,185,C
1-PB2,2174,0,185,0,1,186,T
1-PB2,2175,185,1,0,0,186,A
1-PB2,2176,186,0,0,0,186,A
1-PB2,2177,0,186,0,0,186,T
1-PB2,2178,1,1,0,182,184,C
1-PB2,2179,0,1,181,0,182,G
1-PB2,2180,0,0,180,0,180,G
1-PB2,2181,0,0,181,0,181,G
1-PB2,2182,0,0,0,182,182,C
1-PB2,2183,182,0,0,0,182,A
1-PB2,2184,179,0,0,0,179,A
1-PB2,2185,0,0,179,0,179,G
1-PB2,2186,1,0,181,0,182,G
1-PB2,2187,180,0,0,0,180,A
1-PB2,2188,1,0,177,0,178,G
1-PB2,2189,175,0,0,0,175,A
1-PB2,2190,0,0,0,173,173,C
1-PB2,2191,0,0,174,0,174,G
1-PB2,2192,0,174,0,0,174,T
1-PB2,2193,0,0,171,0,171,G
1-PB2,2194,0,0,176,0,176,G
1-PB2,2195,0,173,0,0,173,T
1-PB2,2196,0,0,173,0,173,G
1-PB2,2197,0,166,0,0,166,T
1-PB2,2198,0,165,0,0,165,T
1-PB2,2199,0,0,168,0,168,G
1-PB2,2200,0,0,166,0,166,G
1-PB2,2201,0,166,0,0,166,T
1-PB2,2202,158,0,0,0,158,A
1-PB2,2203,153,0,0,0,153,A
1-PB2,2204,0,151,0,0,151,T
1-PB2,2205,0,0,148,0,148,G
1-PB2,2206,148,0,0,0,148,A
1-PB2,2207,148,0,0,0,148,A
1-PB2,2208,147,0,0,0,147,A
1-PB2,2209,0,0,0,145,145,C
1-PB2,2210,0,0,145,0,145,G
1-PB2,2211,145,0,0,0,145,A
1-PB2,2212,144,0,0,0,144,A
1-PB2,2213,144,0,0,0,144,A
1-PB2,2214,144,0,0,0,144,A
1-PB2,2215,0,0,0,144,144,C
1-PB2,2216,0,0,143,0,143,G
1-PB2,2217,0,1,142,0,143,G
1-PB2,2218,0,0,143,0,143,G
1-PB2,2219,144,0,0,0,144,A
1-PB2,2220,0,0,0,143,143,C
1-PB2,2221,0,142,0,0,142,T
1-PB2,2222,0,0,0,149,149,C
1-PB2,2223,0,150,0,0,150,T
1-PB2,2224,150,0,0,0,150,A
1-PB2,2225,0,0,150,0,150,G
1-PB2,2226,0,0,0,146,146,C
1-PB2,2227,148,0,0,0,148,A
1-PB2,2228,0,148,0,0,148,T
1-PB2,2229,145,0,0,0,145,A
1-PB2,2230,0,0,0,146,146,C
1-PB2,2231,0,122,0,0,122,T
1-PB2,2232,0,122,0,0,122,T
1-PB2,2233,118,0,0,0,118,A
1-PB2,2234,0,0,0,118,118,C
1-PB2,2235,0,117,0,0,117,T
1-PB2,2236,0,1,116,0,117,G
1-PB2,2237,113,0,0,0,113,A
1-PB2,2238,0,0,0,113,113,C
1-PB2,2239,104,0,1,0,105,A
1-PB2,2240,0,0,105,0,105,G
1-PB2,2241,0,0,0,105,105,C
1-PB2,2242,0,0,0,105,105,C
1-PB2,2243,104,0,0,0,104,A
1-PB2,2244,0,0,104,0,104,G
1-PB2,2245,104,0,0,0,104,A
1-PB2,2246,0,0,0,104,104,C
1-PB2,2247,101,0,0,0,101,A
1-PB2,2248,0,0,101,0,101,G
1-PB2,2249,0,1,0,92,93,C
1-PB2,2250,0,0,93,0,93,G
1-PB2,2251,93,0,0,0,93,A
1-PB2,2252,0,0,0,92,92,C
1-PB2,2253,2,0,0,90,92,C
1-PB2,2254,92,0,0,0,92,A
1-PB2,2255,92,0,0,0,92,A
1-PB2,2256,91,0,1,0,92,A
1-PB2,2257,92,0,0,0,92,A
1-PB2,2258,0,0,92,0,92,G
1-PB2,2259,88,0,0,0,88,A
1-PB2,2260,89,0,0,0,89,A
1-PB2,2261,0,87,1,0,88,T
1-PB2,2262,0,89,0,0,89,T
1-PB2,2263,0,0,1,88,89,C
1-PB2,2264,0,1,85,0,86,G
1-PB2,2265,0,0,86,0,86,G
1-PB2,2266,86,0,0,0,86,A
1-PB2,2267,0,82,0,0,82,T
1-PB2,2268,0,0,82,0,82,G
1-PB2,2269,0,0,82,0,82,G
1-PB2,2270,0,0,0,82,82,C
1-PB2,2271,1,1,0,80,82,C
1-PB2,2272,82,0,0,0,82,A
1-PB2,2273,0,82,0,0,82,T
1-PB2,2274,0,0,0,82,82,C
1-PB2,2275,82,0,0,0,82,A
1-PB2,2276,82,0,0,0,82,A
1-PB2,2277,0,82,0,0,82,T
1-PB2,2278,0,77,0,0,77,T
1-PB2,2279,74,0,0,0,74,A
1-PB2,2280,74,0,0,0,74,A
2-PB1,1,259,0,0,0,259,A
2-PB1,2,0,259,0,0,259,T
2-PB1,3,0,0,264,0,264,G
2-PB1,4,0,0,287,0,287,G
2-PB1,5,328,0,0,0,328,A
2-PB1,6,0,347,0,0,347,T
2-PB1,7,0,0,350,0,350,G
2-PB1,8,0,349,0,1,350,T
2-PB1,9,1,1,0,389,391,C
2-PB1,10,391,0,0,0,391,A
2-PB1,11,405,0,0,0,405,A
2-PB1,12,0,407,0,0,407,T
2-PB1,13,0,0,0,409,409,C
2-PB1,14,1,0,0,434,435,C
2-PB1,15,0,1,443,0,444,G
2-PB1,16,489,0,0,0,489,A
2-PB1,17,0,0,0,499,499,C
2-PB1,18,0,498,0,0,498,T
2-PB1,19,0,0,0,570,570,C
2-PB1,20,0,571,0,0,571,T
2-PB1,21,577,0,0,0,577,A
2-PB1,22,1,0,0,579,580,C
2-PB1,23,0,580,0,0,580,T
2-PB1,24,0,0,649,0,649,G
2-PB1,25,0,655,0,0,655,T
2-PB1,26,0,654,0,0,654,T
2-PB1,27,1,0,0,650,651,C
2-PB1,28,0,0,0,652,652,C
2-PB1,29,0,759,0,1,760,T
2-PB1,30,766,0,0,0,766,A
2-PB1,31,766,0,0,0,766,A
2-PB1,32,767,0,0,0,767,A
2-PB1,33,0,2,772,0,774,G
2-PB1,34,0,1,780,0,781,G
2-PB1,35,0,790,0,0,790,T
2-PB1,36,1,790,0,0,791,T
2-PB1,37,0,0,0,792,792,C
2-PB1,38,0,0,0,794,794,C
2-PB1,39,793,0,0,0,793,A
2-PB1,40,0,0,797,0,797,G
2-PB1,41,0,0,0,796,796,C
2-PB1,42,1,0,798,0,799,G
2-PB1,43,0,0,0,797,797,C
2-PB1,44,801,0,0,0,801,A
2-PB1,45,800,0,0,2,802,A
2-PB1,46,805,0,0,0,805,A
2-PB1,47,817,0,0,0,817,A
2-PB1,48,0,818,0,0,818,T
2-PB1,49,0,1,856,0,857,G
2-PB1,50,0,1,0,860,861,C
2-PB1,51,3,0,0,864,867,C
2-PB1,52,869,0,0,0,869,A
2-PB1,53,0,870,0,0,870,T
2-PB1,54,939,0,0,0,939,A
2-PB1,55,945,0,0,0,945,A
2-PB1,56,0,0,989,0,989,G
2-PB1,57,0,0,0,989,989,C
2-PB1,58,986,0,0,0,986,A
2-PB1,59,0,0,0,1027,1027,C
2-PB1,60,1027,0,0,0,1027,A
2-PB1,61,1106,0,1,0,1107,A
2-PB1,62,0,0,0,1109,1109,C
2-PB1,63,1101,0,1,0,1102,A
2-PB1,64,0,1120,0,0,1120,T
2-PB1,65,1,1110,0,0,1111,T
2-PB1,66,1,0,0,1358,1359,C
2-PB1,67,1,0,0,1363,1364,C
2-PB1,68,4,0,0,1364,1368,C
2-PB1,69,0,1386,0,0,1386,T
2-PB1,70,0,1384,0,0,1384,T
2-PB1,71,1512,0,0,0,1512,A
2-PB1,72,0,1527,0,0,1527,T
2-PB1,73,1537,0,0,0,1537,A
2-PB1,74,0,0,0,1562,1562,C
2-PB1,75,0,1521,0,1,1522,T
2-PB1,76,0,2,1532,0,1534,G
2-PB1,77,0,5,1537,0,1542,G
2-PB1,78,1539,1,0,0,1540,A
2-PB1,79,0,2,1542,0,1544,G
2-PB1,80,1548,0,0,0,1548,A
2-PB1,81,0,1554,0,1,1555,T
2-PB1,82,0,0,0,1638,1638,C
2-PB1,83,1,0,0,1638,1639,C
2-PB1,84,1,1639,0,2,1642,T
2-PB1,85,1,1,0,1741,1743,C
2-PB1,86,4,0,0,1743,1747,C
2-PB1,87,1766,1,0,0,1767,A
2-PB1,88,0,1767,0,0,1767,T
2-PB1,89,1768,0,0,0,1768,A
2-PB1,90,0,0,0,1775,1775,C
2-PB1,91,1749,0,0,0,1749,A
2-PB1,92,1,2,1815,0,1818,G
2-PB1,93,0,0,0,1824,1824,C
2-PB1,94,3,0,0,1820,1823,C
2-PB1,95,1822,1,1,0,1824,A
2-PB1,96,0,1823,0,0,1823,T
2-PB1,97,0,2,1820,0,1822,G
2-PB1,98,0,4,1924,0,1928,G
2-PB1,99,1950,1,0,0,1951,A
2-PB1,100,1951,2,3,0,1956,A
2-PB1,101,0,0,0,1952,1952,C
2-PB1,102,1931,0,2,0,1933,A
2-PB1,103,0,5,1975,1,1981,G
2-PB1,104,1,6,1994,0,2001,G
2-PB1,105,1998,0,2,0,2000,A
2-PB1,106,2015,0,0,0,2015,A
2-PB1,107,0,1,0,2021,2022,C
2-PB1,108,2012,0,0,0,2012,A
2-PB1,109,0,8,2219,0,2227,G
2-PB1,110,0,3,2221,0,2224,G
2-PB1,111,0,1,2281,0,2282,G
2-PB1,112,0,2270,0,4,2274,T
2-PB1,113,2271,0,0,0,2271,A
2-PB1,114,2,0,0,2289,2291,C
2-PB1,115,2362,0,1,0,2363,A
2-PB1,116,0,0,0,2467,2467,C
2-PB1,117,5,1,0,2451,2457,C
2-PB1,118,2402,0,1,0,2403,A
2-PB1,119,0,2396,0,2,2398,T
2-PB1,120,1,8,2394,0,2403,G
2-PB1,121,0,6,2405,1,2412,G
2-PB1,122,2419,0,0,0,2419,A
2-PB1,123,0,1,0,2426,2427,C
2-PB1,124,2387,1,1,0,2389,A
2-PB1,125,2,2,0,2436,2440,C
2-PB1,126,2434,0,2,0,2436,A
2-PB1,127,1,0,2472,0,2473,G
2-PB1,128,2,2471,0,0,2473,T
2-PB1,129,5,1,0,2518,2524,C
2-PB1,130,2519,0,2,0,2521,A
2-PB1,131,2547,1,1,0,2549,A
2-PB1,132,0,0,0,2548,2548,C
2-PB1,133,2533,2,0,0,2535,A
2-PB1,134,0,6,2567,0,2573,G
2-PB1,135,2531,1,1,0,2533,A
2-PB1,136,2526,0,1,1,2528,A
2-PB1,137,1,0,0,2529,2530,C
2-PB1,138,2485,0,2,0,2487,A
2-PB1,139,2,2,0,2478,2482,C
2-PB1,140,2476,0,1,0,2477,A
2-PB1,141,0,2455,0,1,2456,T
2-PB1,142,5,0,0,2664,2669,C
2-PB1,143,2675,0,0,0,2675,A
2-PB1,144,2706,0,1,1,2708,A
2-PB1,145,0,2747,0,0,2747,T
2-PB1,146,2837,0,0,0,2837,A
2-PB1,147,0,2840,0,0,2840,T
2-PB1,148,0,2803,0,0,2803,T
2-PB1,149,1,0,0,2805,2806,C
2-PB1,150,2761,0,2,0,2763,A
2-PB1,151,0,4,2760,0,2764,G
2-PB1,152,2745,1,0,0,2746,A
2-PB1,153,0,2,2749,0,2751,G
2-PB1,154,2685,1,2,0,2688,A
2-PB1,155,18,8,2629,0,2655,G
2-PB1,156,3,10,2638,0,2651,G
2-PB1,157,0,8,2758,0,2766,G
2-PB1,158,2,3,2759,0,2764,G
2-PB1,159,1,3,2779,0,2783,G
2-PB1,160,2771,0,2,1,2774,A
2-PB1,161,2776,0,9,0,2785,A
2-PB1,162,0,0,2805,0,2805,G
2-PB1,163,0,2783,1,0,2784,T
2-PB1,164,1,5,2767,0,2773,G
2-PB1,165,0,3,2772,0,2775,G
2-PB1,166,2763,0,5,0,2768,A
2-PB1,167,0,0,0,2779,2779,C
2-PB1,168,3,9,2779,0,2791,G
2-PB1,169,2802,1,0,0,2803,A
2-PB1,170,2,0,0,2833,2835,C
2-PB1,171,2827,1,0,0,2828,A
2-PB1,172,2829,0,2,0,2831,A
2-PB1,173,2848,0,0,0,2848,A
2-PB1,174,0,2897,0,0,2897,T
2-PB1,175,2902,1,2,0,2905,A
2-PB1,176,1,3,0,2907,2911,C
2-PB1,177,2887,0,0,0,2887,A
2-PB1,178,1,6,2894,0,2901,G
2-PB1,179,2885,0,1,0,2886,A
2-PB1,180,2916,1,0,0,2917,A
2-PB1,181,2920,0,0,0,2920,A
2-PB1,182,0,0,0,2913,2913,C
2-PB1,183,0,2883,0,0,2883,T
2-PB1,184,0,8,2866,0,2874,G
2-PB1,185,0,8,2856,0,2864,G
2-PB1,186,0,8,2860,2,2870,G
2-PB1,187,1,2,2863,0,2866,G
2-PB1,188,0,1,0,2871,2872,C
2-PB1,189,2860,0,2,0,2862,A
2-PB1,190,0,0,0,2965,2965,C
2-PB1,191,4,1,0,2955,2960,C
2-PB1,192,8,1,0,2946,2955,C
2-PB1,193,4,0,0,2960,2964,C
2-PB1,194,2975,0,1,0,2976,A
2-PB1,195,2995,0,0,0,2995,A
2-PB1,196,1,0,1,2990,2992,C
2-PB1,197,0,2984,0,1,2985,T
2-PB1,198,4,0,0,2990,2994,C
2-PB1,199,2904,0,1,1,2906,A
2-PB1,200,2965,0,1,0,2966,A
2-PB1,201,0,0,0,2972,2972,C
2-PB1,202,1,0,1,2952,2954,C
2-PB1,203,10,1,0,2953,2964,C
2-PB1,204,2941,0,0,0,2941,A
2-PB1,205,2953,0,0,0,2953,A
2-PB1,206,0,2954,0,0,2954,T
2-PB1,207,0,2947,0,2,2949,T
2-PB1,208,0,1,2960,0,2961,G
2-PB1,209,2923,1,3,0,2927,A
2-PB1,210,1,2927,0,1,2929,T
2-PB1,211,1,1,2920,0,2922,G
2-PB1,212,1,5,2949,1,2956,G
2-PB1,213,2982,0,4,0,2986,A
2-PB1,214,0,1,0,3003,3004,C
2-PB1,215,5,0,0,2984,2989,C
2-PB1,216,2977,1,3,1,2982,A
2-PB1,217,0,0,0,3042,3042,C
2-PB1,218,0,3040,0,0,3040,T
2-PB1,219,3083,0,2,0,3085,A
2-PB1,220,2,2,0,3111,3115,C
2-PB1,221,6,0,0,3088,3094,C
2-PB1,222,0,3044,0,1,3045,T
2-PB1,223,1,1,3072,0,3074,G
2-PB1,224,3059,1,0,1,3061,A
2-PB1,225,0,8,3081,0,3089,G
2-PB1,226,1,2,3091,0,3094,G
2-PB1,227,3089,1,0,0,3090,A
2-PB1,228,0,3089,0,1,3090,T
2-PB1,229,3049,0,0,0,3049,A
2-PB1,230,3048,1,1,1,3051,A
2-PB1,231,0,3055,0,0,3055,T
2-PB1,232,0,3,3044,0,3047,G
2-PB1,233,3048,1,1,0,3050,A
2-PB1,234,3024,0,2,0,3026,A
2-PB1,235,1,1,1,3018,3021,C
2-PB1,236,7,0,0,2974,2981,C
2-PB1,237,2989,0,0,0,2989,A
2-PB1,238,2989,0,1,0,2990,A
2-PB1,239,0,0,3012,0,3012,G
2-PB1,240,1,3011,0,1,3013,T
2-PB1,241,2,4,3012,0,3018,G
2-PB1,242,0,2,3066,0,3068,G
2-PB1,243,3068,3,1,0,3072,A
2-PB1,244,0,3063,0,0,3063,T
2-PB1,245,3069,0,3,0,3072,A
2-PB1,246,0,3120,0,1,3121,T
2-PB1,247,1,0,3135,0,3136,G
2-PB1,248,1,1,0,3138,3140,C
2-PB1,249,3140,0,0,0,3140,A
2-PB1,250,0,2,0,3241,3243,C
2-PB1,251,3194,2,0,0,3196,A
2-PB1,252,3245,0,0,0,3245,A
2-PB1,253,3248,1,2,0,3251,A
2-PB1,254,1,0,0,3256,3257,C
2-PB1,255,3175,1,1,1,3178,A
2-PB1,256,0,4,3209,0,3213,G
2-PB1,257,3202,1,3,1,3207,A
2-PB1,258,0,0,0,3212,3212,C
2-PB1,259,1,3131,0,0,3132,T
2-PB1,260,1,1,3201,0,3203,G
2-PB1,261,1,3158,0,2,3161,T
2-PB1,262,1,0,3297,0,3298,G
2-PB1,263,2,3292,1,2,3297,T
2-PB1,264,5,0,0,3308,3313,C
2-PB1,265,5,1,0,3299,3305,C
2-PB1,266,0,3280,0,0,3280,T
2-PB1,267,0,3,3270,0,3273,G
2-PB1,268,0,1,3271,0,3272,G
2-PB1,269,3223,0,2,0,3225,A
2-PB1,270,1,4,3264,0,3269,G
2-PB1,271,0,1,3212,0,3213,G
2-PB1,272,1,0,0,3222,3223,C
2-PB1,273,0,3207,0,1,3208,T
2-PB1,274,3222,2,1,0,3225,A
2-PB1,275,1,3217,0,2,3220,T
2-PB1,276,2,1,3215,0,3218,G
2-PB1,277,0,1,3208,0,3209,G
2-PB1,278,1,3,0,3206,3210,C
2-PB1,279,3,1,0,3165,3169,C
2-PB1,280,1,3148,0,0,3149,T
2-PB1,281,0,3338,0,1,3339,T
2-PB1,282,0,0,1,3339,3340,C
2-PB1,283,6,0,1,3339,3346,C
2-PB1,284,1,3345,0,0,3346,T
2-PB1,285,0,3329,0,2,3331,T
2-PB1,286,0,0,3354,0,3354,G
2-PB1,287,3347,1,3,0,3351,A
2-PB1,288,3355,0,1,0,3356,A
2-PB1,289,0,5,3355,0,3360,G
2-PB1,290,3215,0,0,0,3215,A
2-PB1,291,3237,0,0,0,3237,A
2-PB1,292,0,3224,0,1,3225,T
2-PB1,293,1,1,0,3236,3238,C
2-PB1,294,7,2,1,3225,3235,C
2-PB1,295,9,0,1,3224,3234,C
2-PB1,296,3242,0,2,0,3244,A
2-PB1,297,1,1,0,3259,3261,C
2-PB1,298,3,0,0,3249,3252,C
2-PB1,299,11,1,0,3247,3259,C
2-PB1,300,3214,0,1,1,3216,A
2-PB1,301,0,2,3228,0,3230,G
2-PB1,302,0,0,3249,0,3249,G
2-PB1,303,0,3234,0,1,3235,T
2-PB1,304,3251,0,2,0,3253,A
2-PB1,305,0,3242,1,1,3244,T
2-PB1,306,1,0,0,3252,3253,C
2-PB1,307,0,3257,0,2,3259,T
2-PB1,308,0,3259,0,1,3260,T
2-PB1,309,2,3238,0,4,3244,T
2-PB1,310,1,3,3237,0,3241,G
2-PB1,311,3211,2,3,0,3216,A
2-PB1,312,0,1,3220,0,3221,G
2-PB1,313,3188,1,1,0,3190,A
2-PB1,314,3204,0,2,0,3206,A
2-PB1,315,0,0,0,3229,3229,C
2-PB1,316,1,3180,1,4,3186,T
2-PB1,317,6,0,0,3189,3195,C
2-PB1,318,3195,0,0,0,3195,A
2-PB1,319,2,3194,0,0,3196,T
2-PB1,320,2,0,3199,0,3201,G
2-PB1,321,1,0,0,3256,3257,C
2-PB1,322,3,0,0,3248,3251,C
2-PB1,323,1,3243,1,1,3246,T
2-PB1,324,0,3225,0,0,3225,T
2-PB1,325,0,3,3243,0,3246,G
2-PB1,326,3264,0,0,0,3264,A
2-PB1,327,3261,0,1,1,3263,A
2-PB1,328,3264,0,1,1,3266,A
2-PB1,329,2,0,0,3284,3286,C
2-PB1,330,3223,2,1,0,3226,A
2-PB1,331,3240,1,0,0,3241,A
2-PB1,332,0,3242,0,0,3242,T
2-PB1,333,2,6,3234,0,3242,G
2-PB1,334,0,2,3238,0,3240,G
2-PB1,335,3201,0,2,0,3203,A
2-PB1,336,3200,1,2,0,3203,A
2-PB1,337,1,0,3201,0,3202,G
2-PB1,338,0,1,0,3189,3190,C
2-PB1,339,4,2,0,3174,3180,C
2-PB1,340,2,1,3204,0,3207,G
2-PB1,341,1,3192,1,6,3200,T
2-PB1,342,0,3203,0,2,3205,T
2-PB1,343,8,0,0,3213,3221,C
2-PB1,344,3226,1,1,0,3228,A
2-PB1,345,3259,0,0,0,3259,A
2-PB1,346,2,2,0,3259,3263,C
2-PB1,347,3252,0,1,0,3253,A
2-PB1,348,1,3,3279,0,3283,G
2-PB1,349,3230,1,3,0,3234,A
2-PB1,350,0,0,0,3233,3233,C
2-PB1,351,3224,1,2,0,3227,A
2-PB1,352,3244,0,4,0,3248,A
2-PB1,353,0,14,3258,0,3272,G
2-PB1,354,1,3,3227,0,3231,G
2-PB1,355,0,0,3243,0,3243,G
2-PB1,356,0,3170,0,1,3171,T
2-PB1,357,1,7,3157,1,3166,G
2-PB1,358,1,7,3163,0,3171,G
2-PB1,359,3163,0,5,0,3168,A
2-PB1,360,0,3,0,3176,3179,C
2-PB1,361,3117,2,1,0,3120,A
2-PB1,362,3154,0,2,0,3156,A
2-PB1,363,3155,0,0,0,3155,A
2-PB1,364,1,0,0,3148,3149,C
2-PB1,365,1,3141,0,0,3142,T
2-PB1,366,3128,0,1,0,3129,A
2-PB1,367,3155,0,1,0,3156,A
2-PB1,368,2,0,0,3160,3162,C
2-PB1,369,1,1,0,3154,3156,C
2-PB1,370,11,2,0,3143,3156,C
2-PB1,371,3092,0,2,0,3094,A
2-PB1,372,3098,0,1,0,3099,A
2-PB1,373,0,9,3086,0,3095,G
2-PB1,374,1,2,3097,0,3100,G
2-PB1,375,1,3102,0,1,3104,T
2-PB1,376,9,0,0,3076,3085,C
2-PB1,377,1,0,3086,0,3087,G
2-PB1,378,1,0,0,3081,3082,C
2-PB1,379,2,2,0,3090,3094,C
2-PB1,380,3092,0,0,0,3092,A
2-PB1,381,1,6,3138,0,3145,G
2-PB1,382,3192,0,2,0,3194,A
2-PB1,383,1,1,0,3192,3194,C
2-PB1,384,0,3174,0,0,3174,T
2-PB1,385,0,3168,0,2,3170,T
2-PB1,386,3166,1,0,0,3167,A
2-PB1,387,3,3171,1,1,3176,T
2-PB1,388,0,8,3175,0,3183,G
2-PB1,389,3167,0,1,0,3168,A
2-PB1,390,0,3097,3,1,3101,T
2-PB1,391,0,3001,0,0,3001,T
2-PB1,392,0,5,2988,0,2993,G
2-PB1,393,0,2,3002,0,3004,G
2-PB1,394,3033,0,3,0,3036,A
2-PB1,395,1,0,0,3033,3034,C
2-PB1,396,2994,0,0,0,2994,A
2-PB1,397,1,2974,1,0,2976,T
2-PB1,398,1,3004,0,1,3006,T
2-PB1,399,3022,1,1,0,3024,A
2-PB1,400,3017,0,2,0,3019,A
2-PB1,401,3016,0,3,1,3020,A
2-PB1,402,0,0,0,3013,3013,C
2-PB1,403,2949,2,1,0,2952,A
2-PB1,404,0,4,2971,0,2975,G
2-PB1,405,2956,2,1,0,2959,A
2-PB1,406,2963,0,3,0,2966,A
2-PB1,407,2960,0,1,0,2961,A
2-PB1,408,0,2938,0,1,2939,T
2-PB1,409,7,1,0,2935,2943,C
2-PB1,410,2936,0,0,1,2937,A
2-PB1,411,2946,1,1,0,2948,A
2-PB1,412,2,0,0,2941,2943,C
2-PB1,413,4,3,1,2916,2924,C
2-PB1,414,3,2,2921,1,2927,G
2-PB1,415,1,0,2924,0,2925,G
2-PB1,416,1,2,0,2936,2939,C
2-PB1,417,2937,0,2,0,2939,A
2-PB1,418,1,2,2936,0,2939,G
2-PB1,419,1,1,0,2950,2952,C
2-PB1,420,2955,0,1,0,2956,A
2-PB1,421,2957,1,0,0,2958,A
2-PB1,422,1,0,0,2968,2969,C
2-PB1,423,0,2949,0,1,2950,T
2-PB1,424,0,0,3056,1,3057,G
2-PB1,425,1,0,1,3057,3059,C
2-PB1,426,3058,1,0,0,3059,A
2-PB1,427,2,3050,0,0,3052,T
2-PB1,428,0,3009,0,1,3010,T
2-PB1,429,3157,0,3,1,3161,A
2-PB1,430,0,0,3169,0,3169,G
2-PB1,431,0,1,1,3152,3154,C
2-PB1,432,3,1,0,3152,3156,C
2-PB1,433,3037,0,2,0,3039,A
2-PB1,434,3065,0,0,0,3065,A
2-PB1,435,2,1,0,3070,3073,C
2-PB1,436,3078,1,0,0,3079,A
2-PB1,437,0,0,0,3163,3163,C
2-PB1,438,8,0,0,2960,2968,C
2-PB1,439,2957,0,2,0,2959,A
2-PB1,440,0,2954,0,1,2955,T
2-PB1,441,2953,0,0,0,2953,A
2-PB1,442,0,1,2958,0,2959,G
2-PB1,443,2944,0,0,0,2944,A
2-PB1,444,2891,0,1,0,2892,A
2-PB1,445,0,0,2909,0,2909,G
2-PB1,446,0,2810,0,1,2811,T
2-PB1,447,0,2817,0,1,2818,T
2-PB1,448,0,2803,0,0,2803,T
2-PB1,449,0,2813,1,1,2815,T
2-PB1,450,1,2819,0,1,2821,T
2-PB1,451,2810,2,0,1,2813,A
2-PB1,452,0,3,2808,0,2811,G
2-PB1,453,2792,1,1,0,2794,A
2-PB1,454,0,2783,0,1,2784,T
2-PB1,455,3,0,0,2739,2742,C
2-PB1,456,0,8,2740,0,2748,G
2-PB1,457,2750,1,1,0,2752,A
2-PB1,458,2749,0,1,0,2750,A
2-PB1,459,0,1,0,2765,2766,C
2-PB1,460,0,7,2755,0,2762,G
2-PB1,461,0,5,2863,1,2869,G
2-PB1,462,2867,1,2,0,2870,A
2-PB1,463,0,2864,1,0,2865,T
2-PB1,464,0,2875,0,0,2875,T
2-PB1,465,2861,0,2,1,2864,A
2-PB1,466,2861,0,1,0,2862,A
2-PB1,467,0,0,0,2869,2869,C
2-PB1,468,2853,0,2,0,2855,A
2-PB1,469,0,1,2880,0,2881,G
2-PB1,470,0,0,1,2781,2782,C
2-PB1,471,0,2765,0,2,2767,T
2-PB1,472,2760,0,6,1,2767,A
2-PB1,473,2766,0,1,0,2767,A
2-PB1,474,1,2767,0,2,2770,T
2-PB1,475,0,6,2794,1,2801,G
2-PB1,476,2789,1,0,0,2790,A
2-PB1,477,2790,0,0,0,2790,A
2-PB1,478,0,2735,0,2,2737,T
2-PB1,479,3,0,1,2746,2750,C
2-PB1,480,2733,1,1,0,2735,A
2-PB1,481,0,4,2731,0,2735,G
2-PB1,482,0,1,2732,1,2734,G
2-PB1,483,2729,2,0,0,2731,A
2-PB1,484,2688,0,0,1,2689,A
2-PB1,485,1,4,2808,0,2813,G
2-PB1,486,0,2,2814,0,2816,G
2-PB1,487,0,1,1,2813,2815,C
2-PB1,488,0,2804,0,1,2805,T
2-PB1,489,2813,0,0,0,2813,A
2-PB1,490,2816,0,0,0,2816,A
2-PB1,491,1,2820,0,0,2821,T
2-PB1,492,2824,0,0,1,2825,A
2-PB1,493,0,3,2830,0,2833,G
2-PB1,494,2656,0,0,0,2656,A
2-PB1,495,1,2616,0,1,2618,T
2-PB1,496,1,2611,0,3,2615,T
2-PB1,497,1,2617,0,3,2621,T
2-PB1,498,2,0,1,2699,2702,C
2-PB1,499,1,0,0,2711,2712,C
2-PB1,500,0,2698,0,3,2701,T
2-PB1,501,2,0,0,2711,2713,C
2-PB1,502,2708,0,0,1,2709,A
2-PB1,503,2719,1,0,0,2720,A
2-PB1,504,0,6,2711,0,2717,G
2-PB1,505,0,0,2746,0,2746,G
2-PB1,506,2745,1,1,0,2747,A
2-PB1,507,0,2636,0,0,2636,T
2-PB1,508,1,0,2662,0,2663,G
2-PB1,509,1,2647,1,1,2650,T
2-PB1,510,1,1,2678,0,2680,G
2-PB1,511,2681,0,1,0,2682,A
2-PB1,512,2,2666,1,2,2671,T
2-PB1,513,0,2,2657,0,2659,G
2-PB1,514,0,7,2637,0,2644,G
2-PB1,515,2647,1,0,0,2648,A
2-PB1,516,2652,0,0,0,2652,A
2-PB1,517,0,2613,1,1,2615,T
2-PB1,518,2,1,0,2618,2621,C
2-PB1,519,2597,0,3,0,2600,A
2-PB1,520,2608,0,1,0,2609,A
2-PB1,521,0,2605,0,2,2607,T
2-PB1,522,2,6,2633,0,2641,G
2-PB1,523,0,1,2645,0,2646,G
2-PB1,524,2643,1,1,0,2645,A
2-PB1,525,1,2636,0,1,2638,T
2-PB1,526,2636,0,1,0,2637,A
2-PB1,527,2630,0,1,0,2631,A
2-PB1,528,2625,0,1,1,2627,A
2-PB1,529,1,4,2640,0,2645,G
2-PB1,530,2619,0,1,0,2620,A
2-PB1,531,0,2,2605,0,2607,G
2-PB1,532,0,2,2589,0,2591,G
2-PB1,533,2576,0,4,0,2580,A
2-PB1,534,2580,0,2,0,2582,A
2-PB1,535,2580,0,3,0,2583,A
2-PB1,536,0,2582,0,0,2582,T
2-PB1,537,2,1,2632,0,2635,G
2-PB1,538,0,5,2618,0,2623,G
2-PB1,539,2595,1,1,0,2597,A
2-PB1,540,1,0,2607,0,2608,G
2-PB1,541,2574,0,0,0,2574,A
2-PB1,542,0,2641,1,0,2642,T
2-PB1,543,2638,0,2,0,2640,A
2-PB1,544,2657,1,1,0,2659,A
2-PB1,545,0,0,0,2669,2669,C
2-PB1,546,2630,0,0,0,2630,A
2-PB1,547,2640,0,0,0,2640,A
2-PB1,548,0,0,0,2632,2632,C
2-PB1,549,2604,0,1,0,2605,A
2-PB1,550,0,0,0,2606,2606,C
2-PB1,551,2565,0,1,0,2566,A
2-PB1,552,1,0,0,2578,2579,C
2-PB1,553,0,2539,0,15,2554,T
2-PB1,554,1,2546,0,3,2550,T
2-PB1,555,1,2556,0,1,2558,T
2-PB1,556,4,1,0,2544,2549,C
2-PB1,557,2561,0,1,0,2562,A
2-PB1,558,2564,0,1,1,2566,A
2-PB1,559,2567,0,0,0,2567,A
2-PB1,560,0,2,2596,0,2598,G
2-PB1,561,2562,0,1,0,2563,A
2-PB1,562,2569,0,0,0,2569,A
2-PB1,563,2570,0,0,0,2570,A
2-PB1,564,2567,0,1,0,2568,A
2-PB1,565,2569,0,4,0,2573,A
2-PB1,566,1,5,2584,0,2590,G
2-PB1,567,0,6,2586,0,2592,G
2-PB1,568,2543,0,5,0,2548,A
2-PB1,569,0,9,2593,0,2602,G
2-PB1,570,2593,0,1,0,2594,A
2-PB1,571,0,1,2664,1,2666,G
2-PB1,572,0,2664,0,1,2665,T
2-PB1,573,2665,0,2,0,2667,A
2-PB1,574,2671,1,4,1,2677,A
2-PB1,575,0,8,2666,0,2674,G
2-PB1,576,0,5,2688,0,2693,G
2-PB1,577,1,9,2686,0,2696,G
2-PB1,578,2646,0,4,0,2650,A
2-PB1,579,0,1,0,2670,2671,C
2-PB1,580,2593,0,1,0,2594,A
2-PB1,581,2606,1,0,1,2608,A
2-PB1,582,2,0,0,2606,2608,C
2-PB1,583,2603,0,0,0,2603,A
2-PB1,584,0,2588,0,0,2588,T
2-PB1,585,1,6,2558,0,2565,G
2-PB1,586,2562,0,7,0,2569,A
2-PB1,587,2,2,0,2562,2566,C
2-PB1,588,4,1,0,2540,2545,C
2-PB1,589,2538,0,3,0,2541,A
2-PB1,590,2552,0,0,0,2552,A
2-PB1,591,0,2,2557,0,2559,G
2-PB1,592,2560,0,2,0,2562,A
2-PB1,593,2561,0,1,0,2562,A
2-PB1,594,2544,0,0,0,2544,A
2-PB1,595,2547,1,1,0,2549,A
2-PB1,596,0,2536,3,3,2542,T
2-PB1,597,0,4,2541,1,2546,G
2-PB1,598,0,2,2540,0,2542,G
2-PB1,599,1,2519,0,4,2524,T
2-PB1,600,9,2,0,2490,2501,C
2-PB1,601,2522,0,1,0,2523,A
2-PB1,602,1,0,0,2890,2891,C
2-PB1,603,2991,1,0,0,2992,A
2-PB1,604,1,0,0,3039,3040,C
2-PB1,605,3034,0,0,1,3035,A
2-PB1,606,3294,0,1,2,3297,A
2-PB1,607,3281,0,1,1,3283,A
2-PB1,608,0,9,3570,0,3579,G
2-PB1,609,967,6,2465,1,3439,G
2-PB1,610,3555,0,0,0,3555,A
2-PB1,611,1,2,0,3755,3758,C
2-PB1,612,3766,4,0,0,3770,A
2-PB1,613,3826,0,0,0,3826,A
2-PB1,614,1,3809,0,0,3810,T
2-PB1,615,3769,0,5,0,3774,A
2-PB1,616,0,20,3768,1,3789,G
2-PB1,617,1,11,3661,0,3673,G
2-PB1,618,0,6,3669,1,3676,G
2-PB1,619,3675,0,1,0,3676,A
2-PB1,620,3650,1,0,0,3651,A
2-PB1,621,0,1,3712,0,3713,G
2-PB1,622,3696,0,11,0,3707,A
2-PB1,623,3724,0,0,0,3724,A
2-PB1,624,3751,0,0,0,3751,A
2-PB1,625,3776,0,4,1,3781,A
2-PB1,626,3926,0,5,1,3932,A
2-PB1,627,3932,1,4,5,3942,A
2-PB1,628,2,0,0,3956,3958,C
2-PB1,629,3944,0,0,1,3945,A
2-PB1,630,3943,0,1,0,3944,A
2-PB1,631,3934,1,3,0,3938,A
2-PB1,632,1,8,4050,0,4059,G
2-PB1,633,4058,0,2,0,4060,A
2-PB1,634,0,0,4291,0,4291,G
2-PB1,635,3,4243,0,1,4247,T
2-PB1,636,1,7,5213,0,5221,G
2-PB1,637,5231,0,3,0,5234,A
2-PB1,638,5245,0,4,0,5249,A
2-PB1,639,0,5356,0,6,5362,T
2-PB1,640,5374,0,1,0,5375,A
2-PB1,641,5398,0,7,0,5405,A
2-PB1,642,1,13,5401,1,5416,G
2-PB1,643,5314,0,5,0,5319,A
2-PB1,644,0,7,5348,1,5356,G
2-PB1,645,5176,1,4,0,5181,A
2-PB1,646,0,2,5228,0,5230,G
2-PB1,647,1,2,5219,2,5224,G
2-PB1,648,3,0,0,5234,5237,C
2-PB1,649,0,5237,0,2,5239,T
2-PB1,650,5429,1,3,1,5434,A
2-PB1,651,2,1,0,5771,5774,C
2-PB1,652,9,0,1,5795,5805,C
2-PB1,653,0,5856,1,2,5859,T
2-PB1,654,6125,1,1,1,6128,A
2-PB1,655,6113,1,2,0,6116,A
2-PB1,656,0,6124,0,1,6125,T
2-PB1,657,6109,0,2,1,6112,A
2-PB1,658,6096,1,2,1,6100,A
2-PB1,659,1,19,6101,0,6121,G
2-PB1,660,6010,0,3,2,6015,A
2-PB1,661,0,0,6070,1,6071,G
2-PB1,662,0,1,1,6101,6103,C
2-PB1,663,1,6052,0,5,6058,T
2-PB1,664,0,6078,0,0,6078,T
2-PB1,665,0,6079,0,2,6081,T
2-PB1,666,3,17,6064,1,6085,G
2-PB1,667,6178,2,13,0,6193,A
2-PB1,668,0,4,0,6229,6233,C
2-PB1,669,6215,0,1,0,6216,A
2-PB1,670,1,6204,0,4,6209,T
2-PB1,671,1,6190,0,0,6191,T
2-PB1,672,1,21,6293,0,6315,G
2-PB1,673,6307,3,5,0,6315,A
2-PB1,674,6320,1,6,0,6327,A
2-PB1,675,1,3,0,6341,6345,C
2-PB1,676,6312,2,3,1,6318,A
2-PB1,677,1,0,0,6327,6328,C
2-PB1,678,0,5,6306,0,6311,G
2-PB1,679,6336,1,8,0,6345,A
2-PB1,680,0,6346,0,1,6347,T
2-PB1,681,1,22,6452,0,6475,G
2-PB1,682,6484,0,8,0,6492,A
2-PB1,683,0,3,0,6534,6537,C
2-PB1,684,9,1,0,6501,6511,C
2-PB1,685,6519,1,3,1,6524,A
2-PB1,686,6614,3,2,0,6619,A
2-PB1,687,6621,1,7,1,6630,A
2-PB1,688,0,8,6804,0,6812,G
2-PB1,689,6894,1,4,2,6901,A
2-PB1,690,0,6819,1,1,6821,T
2-PB1,691,4,2,6832,1,6839,G
2-PB1,692,2,5,1,6813,6821,C
2-PB1,693,6803,1,14,0,6818,A
2-PB1,694,1,9,6870,0,6880,G
2-PB1,695,6815,1,4,0,6820,A
2-PB1,696,2,11,6831,0,6844,G
2-PB1,697,6673,1,1,1,6676,A
2-PB1,698,1,2,6656,0,6659,G
2-PB1,699,6608,3,10,0,6621,A
2-PB1,700,1,4,6631,1,6637,G
2-PB1,701,0,1,6642,0,6643,G
2-PB1,702,3,0,0,6628,6631,C
2-PB1,703,6625,1,2,0,6628,A
2-PB1,704,6646,4,1,0,6651,A
2-PB1,705,6695,1,1,0,6697,A
2-PB1,706,1,6725,0,0,6726,T
2-PB1,707,0,6730,0,1,6731,T
2-PB1,708,6738,2,2,0,6742,A
2-PB1,709,6717,0,4,0,6721,A
2-PB1,710,6741,0,4,0,6745,A
2-PB1,711,6768,0,1,1,6770,A
2-PB1,712,6768,1,3,0,6772,A
2-PB1,713,0,8,6782,0,6790,G
2-PB1,714,6738,3,0,3,6744,A
2-PB1,715,6719,0,8,0,6727,A
2-PB1,716,2,25,6801,0,6828,G
2-PB1,717,1,5,6970,0,6976,G
2-PB1,718,1,0,6981,0,6982,G
2-PB1,719,3,3,0,7027,7033,C
2-PB1,720,1,7025,1,4,7031,T
2-PB1,721,7075,0,2,0,7077,A
2-PB1,722,1,7192,1,5,7199,T
2-PB1,723,1,7191,2,2,7196,T
2-PB1,724,2,1,7244,0,7247,G
2-PB1,725,2,3,0,7199,7204,C
2-PB1,726,7040,1,15,0,7056,A
2-PB1,727,7072,0,4,2,7078,A
2-PB1,728,1,1,0,7078,7080,C
2-PB1,729,7085,0,4,0,7089,A
2-PB1,730,1,0,0,7094,7095,C
2-PB1,731,12,0,0,6950,6962,C
2-PB1,732,23,2,1,6942,6968,C
2-PB1,733,1,23,6942,0,6966,G
2-PB1,734,0,9,6976,0,6985,G
2-PB1,735,1,7,6987,0,6995,G
2-PB1,736,7019,0,4,0,7023,A
2-PB1,737,0,6990,0,2,6992,T
2-PB1,738,2,1,7017,2,7022,G
2-PB1,739,1,4,1,7003,7009,C
2-PB1,740,7118,3,2,0,7123,A
2-PB1,741,7238,4,5,0,7247,A
2-PB1,742,7327,0,1,1,7329,A
2-PB1,743,0,7347,0,0,7347,T
2-PB1,744,1,7345,0,1,7347,T
2-PB1,745,7310,0,3,0,7313,A
2-PB1,746,0,12,7303,0,7315,G
2-PB1,747,7247,0,8,0,7255,A
2-PB1,748,2,20,7285,0,7307,G
2-PB1,749,0,12,7203,0,7215,G
2-PB1,750,3,3,7402,1,7409,G
2-PB1,751,1,7405,0,1,7407,T
2-PB1,752,2,7398,0,1,7401,T
2-PB1,753,16,3,0,7418,7437,C
2-PB1,754,4,1,7529,1,7535,G
2-PB1,755,1,7527,0,12,7540,T
2-PB1,756,1,2,7542,0,7545,G
2-PB1,757,2,7518,0,4,7524,T
2-PB1,758,7452,0,45,0,7497,A
2-PB1,759,4,1,0,7483,7488,C
2-PB1,760,1,7185,0,5,7191,T
2-PB1,761,2,7234,0,2,7238,T
2-PB1,762,8,1,0,7211,7220,C
2-PB1,763,1,1,7187,0,7189,G
2-PB1,764,3,7166,1,3,7173,T
2-PB1,765,0,7166,0,3,7169,T
2-PB1,766,0,11,7170,0,7181,G
2-PB1,767,7172,0,2,0,7174,A
2-PB1,768,7157,0,8,0,7165,A
2-PB1,769,7217,2,8,2,7229,A
2-PB1,770,0,1,0,7265,7266,C
2-PB1,771,0,7214,0,4,7218,T
2-PB1,772,0,7190,0,0,7190,T
2-PB1,773,2,7197,0,3,7202,T
2-PB1,774,7334,1,3,0,7338,A
2-PB1,775,0,1,7360,1,7362,G
2-PB1,776,0,5,0,7365,7370,C
2-PB1,777,2,7364,0,3,7369,T
2-PB1,778,7312,2,1,1,7316,A
2-PB1,779,0,7,7295,0,7302,G
2-PB1,780,7299,2,3,1,7305,A
2-PB1,781,7293,0,9,0,7302,A
2-PB1,782,1,2,7323,0,7326,G
2-PB1,783,5,4,1,7218,7228,C
2-PB1,784,7221,0,2,0,7223,A
2-PB1,785,3,7192,3,1,7199,T
2-PB1,786,1,7191,0,3,7195,T
2-PB1,787,1,7204,0,1,7206,T
2-PB1,788,1,1,7218,0,7220,G
2-PB1,789,3,5,1,7208,7217,C
2-PB1,790,6,7,7214,1,7228,G
2-PB1,791,7212,1,0,1,7214,A
2-PB1,792,7179,2,1,0,7182,A
2-PB1,793,7182,2,1,3,7188,A
2-PB1,794,7358,1,6,0,7365,A
2-PB1,795,2,2,7461,0,7465,G
2-PB1,796,1,1,0,7481,7483,C
2-PB1,797,1,7466,0,4,7471,T
2-PB1,798,2,7467,1,1,7471,T
2-PB1,799,1,15,7470,0,7486,G
2-PB1,800,7477,1,10,0,7488,A
2-PB1,801,7483,1,5,0,7489,A
2-PB1,802,1,1,0,7518,7520,C
2-PB1,803,7400,0,5,1,7406,A
2-PB1,804,1,3,8058,0,8062,G
2-PB1,805,1,8004,1,2,8008,T
2-PB1,806,20,0,0,8017,8037,C
2-PB1,807,2,8021,0,9,8032,T
2-PB1,808,4,7,8049,1,8061,G
2-PB1,809,1,13,8044,1,8059,G
2-PB1,810,8072,1,7,1,8081,A
2-PB1,811,4,1,2,8092,8099,C
2-PB1,812,1,7855,1,4,7861,T
2-PB1,813,0,7480,0,3,7483,T
2-PB1,814,7,0,1,7452,7460,C
2-PB1,815,8,3,3,7450,7464,C
2-PB1,816,0,3,7502,0,7505,G
2-PB1,817,1,3,7540,1,7545,G
2-PB1,818,0,7490,0,2,7492,T
2-PB1,819,2,7494,1,1,7498,T
2-PB1,820,1,15,7461,0,7477,G
2-PB1,821,4,14,7489,0,7507,G
2-PB1,822,5,27,7511,0,7543,G
2-PB1,823,5,11,7521,1,7538,G
2-PB1,824,0,5,7588,0,7593,G
2-PB1,825,0,7516,0,3,7519,T
2-PB1,826,7516,0,3,1,7520,A
2-PB1,827,7564,0,6,1,7571,A
2-PB1,828,2,7573,0,0,7575,T
2-PB1,829,1,16,7584,1,7602,G
2-PB1,830,7528,2,1,0,7531,A
2-PB1,831,7461,0,2,0,7463,A
2-PB1,832,7472,0,0,0,7472,A
2-PB1,833,7443,2,6,0,7451,A
2-PB1,834,0,1,7448,0,7449,G
2-PB1,835,7379,0,4,1,7384,A
2-PB1,836,7311,1,4,1,7317,A
2-PB1,837,3,8,7350,1,7362,G
2-PB1,838,0,4,7327,0,7331,G
2-PB1,839,31,3,0,7268,7302,C
2-PB1,840,16,4,1,7276,7297,C
2-PB1,841,7333,0,2,1,7336,A
2-PB1,842,7330,0,1,2,7333,A
2-PB1,843,7333,1,2,0,7336,A
2-PB1,844,2,1,3,7333,7339,C
2-PB1,845,1,7333,0,6,7340,T
2-PB1,846,4,6,7421,0,7431,G
2-PB1,847,3,6,7427,0,7436,G
2-PB1,848,4,0,0,7431,7435,C
2-PB1,849,7448,3,1,1,7453,A
2-PB1,850,7453,0,2,0,7455,A
2-PB1,851,7462,0,0,0,7462,A
2-PB1,852,0,7461,0,3,7464,T
2-PB1,853,3,3,7475,0,7481,G
2-PB1,854,2,7446,0,0,7448,T
2-PB1,855,0,7296,0,3,7299,T
2-PB1,856,2,2,7309,2,7315,G
2-PB1,857,2,7286,0,3,7291,T
2-PB1,858,4,6,7302,0,7312,G
2-PB1,859,7304,0,7,0,7311,A
2-PB1,860,0,8,7332,0,7340,G
2-PB1,861,7314,0,4,0,7318,A
2-PB1,862,7287,0,0,1,7288,A
2-PB1,863,7289,0,4,1,7294,A
2-PB1,864,7313,2,1,2,7318,A
2-PB1,865,7348,1,4,2,7355,A
2-PB1,866,1,7335,0,0,7336,T
2-PB1,867,2,7,7317,0,7326,G
2-PB1,868,7314,0,4,1,7319,A
2-PB1,869,3,7239,0,3,7245,T
2-PB1,870,3,20,7280,1,7304,G
2-PB1,871,7315,1,3,1,7320,A
2-PB1,872,0,1,0,7399,7400,C
2-PB1,873,2,7355,1,2,7360,T
2-PB1,874,7357,0,2,2,7361,A
2-PB1,875,7423,2,2,0,7427,A
2-PB1,876,0,7418,0,0,7418,T
2-PB1,877,1,7518,0,6,7525,T
2-PB1,878,10,0,1,7569,7580,C
2-PB1,879,7560,3,5,0,7568,A
2-PB1,880,3,4,1,7588,7596,C
2-PB1,881,7511,1,2,0,7514,A
2-PB1,882,7522,1,6,0,7529,A
2-PB1,883,0,18,7523,0,7541,G
2-PB1,884,7625,1,9,0,7635,A
2-PB1,885,0,6,0,7627,7633,C
2-PB1,886,7553,2,4,1,7560,A
2-PB1,887,4,0,1,7550,7555,C
2-PB1,888,7501,1,4,1,7507,A
2-PB1,889,1,18,7537,1,7557,G
2-PB1,890,7517,1,10,0,7528,A
2-PB1,891,3,2,7575,0,7580,G
2-PB1,892,0,0,0,7543,7543,C
2-PB1,893,1,7374,0,11,7386,T
2-PB1,894,1,7479,1,6,7487,T
2-PB1,895,2,7487,1,4,7494,T
2-PB1,896,4,3,0,7518,7525,C
2-PB1,897,0,7500,0,6,7506,T
2-PB1,898,1,7481,1,1,7484,T
2-PB1,899,2,7472,2,9,7485,T
2-PB1,900,10,2,1,7480,7493,C
2-PB1,901,7470,3,0,2,7475,A
2-PB1,902,2,2,0,7525,7529,C
2-PB1,903,7443,1,3,0,7447,A
2-PB1,904,7503,0,0,0,7503,A
2-PB1,905,1,7578,0,6,7585,T
2-PB1,906,12,1,0,7678,7691,C
2-PB1,907,7725,1,1,2,7729,A
2-PB1,908,1,1,0,7767,7769,C
2-PB1,909,1,7734,0,5,7740,T
2-PB1,910,4,18,7738,0,7760,G
2-PB1,911,3,17,7723,0,7743,G
2-PB1,912,0,8,7966,0,7974,G
2-PB1,913,4,10,7944,0,7958,G
2-PB1,914,7822,2,8,0,7832,A
2-PB1,915,1,4,0,7566,7571,C
2-PB1,916,7657,2,9,0,7668,A
2-PB1,917,8152,1,3,0,8156,A
2-PB1,918,1,4,0,8242,8247,C
2-PB1,919,8237,1,3,0,8241,A
2-PB1,920,1,1,0,8231,8233,C
2-PB1,921,1,7902,0,4,7907,T
2-PB1,922,7944,0,2,1,7947,A
2-PB1,923,7934,1,2,3,7940,A
2-PB1,924,1,1,7992,0,7994,G
2-PB1,925,1,7954,0,0,7955,T
2-PB1,926,2,14,7468,0,7484,G
2-PB1,927,1,8,7426,0,7435,G
2-PB1,928,7390,1,3,0,7394,A
2-PB1,929,7405,2,2,1,7410,A
2-PB1,930,1,7399,0,3,7403,T
2-PB1,931,3,12,7366,1,7382,G
2-PB1,932,7363,2,5,2,7372,A
2-PB1,933,7283,1,1,1,7286,A
2-PB1,934,7333,1,3,0,7337,A
2-PB1,935,7366,5,0,1,7372,A
2-PB1,936,2,7326,2,1,7331,T
2-PB1,937,11,0,1,7327,7339,C
2-PB1,938,7331,1,4,0,7336,A
2-PB1,939,7331,0,3,0,7334,A
2-PB1,940,7319,1,8,0,7328,A
2-PB1,941,7320,1,1,1,7323,A
2-PB1,942,1,0,0,7342,7343,C
2-PB1,943,11,0,0,7289,7300,C
2-PB1,944,23,0,0,7277,7300,C
2-PB1,945,1,7280,0,6,7287,T
2-PB1,946,7,15,0,7291,7313,C
2-PB1,947,1,4,7310,1,7316,G
2-PB1,948,7296,1,1,0,7298,A
2-PB1,949,7308,0,2,0,7310,A
2-PB1,950,0,7296,0,2,7298,T
2-PB1,951,3,2,7332,0,7337,G
2-PB1,952,1,7279,2,11,7293,T
2-PB1,953,2,7257,4,4,7267,T
2-PB1,954,2,7278,0,3,7283,T
2-PB1,955,0,7280,0,3,7283,T
2-PB1,956,2,7294,0,1,7297,T
2-PB1,957,1,12,7269,2,7284,G
2-PB1,958,4,1,7257,1,7263,G
2-PB1,959,3,6,0,7250,7259,C
2-PB1,960,2,7,7227,1,7237,G
2-PB1,961,7225,1,1,0,7227,A
2-PB1,962,0,7467,0,2,7469,T
2-PB1,963,0,8,7765,0,7773,G
2-PB1,964,8193,1,1,0,8195,A
2-PB1,965,1,8215,2,3,8221,T
2-PB1,966,0,8215,0,2,8217,T
2-PB1,967,8276,0,4,1,8281,A
2-PB1,968,1,1,0,8294,8296,C
2-PB1,969,8344,0,4,0,8348,A
2-PB1,970,0,8323,0,4,8327,T
2-PB1,971,7916,4,6,0,7926,A
2-PB1,972,3,1,0,7998,8002,C
2-PB1,973,7308,0,0,0,7308,A
2-PB1,974,3,7302,0,4,7309,T
2-PB1,975,3,1,1,7276,7281,C
2-PB1,976,7267,2,3,0,7272,A
2-PB1,977,3,1,1,7307,7312,C
2-PB1,978,7249,1,2,0,7252,A
2-PB1,979,7254,1,1,0,7256,A
2-PB1,980,7233,3,5,0,7241,A
2-PB1,981,0,13,7016,1,7030,G
2-PB1,982,7361,0,1,0,7362,A
2-PB1,983,7391,0,4,1,7396,A
2-PB1,984,0,7397,0,1,7398,T
2-PB1,985,14,1,2,7369,7386,C
2-PB1,986,7409,1,2,1,7413,A
2-PB1,987,7452,1,5,1,7459,A
2-PB1,988,1,4,0,7469,7474,C
2-PB1,989,10,1,0,7470,7481,C
2-PB1,990,2,7150,0,3,7155,T
2-PB1,991,0,10,7220,0,7230,G
2-PB1,992,7188,2,4,1,7195,A
2-PB1,993,0,2,7215,0,7217,G
2-PB1,994,2,7179,0,0,7181,T
2-PB1,995,6,13,7045,0,7064,G
2-PB1,996,2,2,7461,1,7466,G
2-PB1,997,0,7438,0,3,7441,T
2-PB1,998,2,7430,2,9,7443,T
2-PB1,999,18,1,0,7437,7456,C
2-PB1,1000,7316,0,59,1,7376,A
2-PB1,1001,1,8,7513,0,7522,G
2-PB1,1002,7510,0,4,1,7515,A
2-PB1,1003,7523,0,4,1,7528,A
2-PB1,1004,7496,0,2,3,7501,A
2-PB1,1005,2,1,0,7106,7109,C
2-PB1,1006,7216,0,0,0,7216,A
2-PB1,1007,1,7197,0,6,7204,T
2-PB1,1008,7,1,1,7270,7279,C
2-PB1,1009,6,0,2,7292,7300,C
2-PB1,1010,2,7099,0,2,7103,T
2-PB1,1011,1,18,7109,1,7129,G
2-PB1,1012,7093,2,7,2,7104,A
2-PB1,1013,1,2,7164,1,7168,G
2-PB1,1014,2,2,0,7136,7140,C
2-PB1,1015,6972,2,1,1,6976,A
2-PB1,1016,3,6993,0,4,7000,T
2-PB1,1017,10,3,0,6930,6943,C
2-PB1,1018,5,3,6946,0,6954,G
2-PB1,1019,2,0,0,7136,7138,C
2-PB1,1020,7179,1,5,0,7185,A
2-PB1,1021,3,2,1,7413,7419,C
2-PB1,1022,19,1,0,7398,7418,C
2-PB1,1023,7418,2,12,0,7432,A
2-PB1,1024,7543,4,1,1,7549,A
2-PB1,1025,0,7542,0,2,7544,T
2-PB1,1026,7542,0,1,2,7545,A
2-PB1,1027,7535,1,1,1,7538,A
2-PB1,1028,3,7276,0,3,7282,T
2-PB1,1029,0,0,7303,1,7304,G
2-PB1,1030,3,7146,1,1,7151,T
2-PB1,1031,3,7087,0,9,7099,T
2-PB1,1032,14,2,1,7108,7125,C
2-PB1,1033,1,7088,1,3,7093,T
2-PB1,1034,6,3,1,7105,7115,C
2-PB1,1035,7108,2,2,3,7115,A
2-PB1,1036,7111,0,4,2,7117,A
2-PB1,1037,7120,1,4,1,7126,A
2-PB1,1038,2,0,0,7146,7148,C
2-PB1,1039,7104,1,3,2,7110,A
2-PB1,1040,7102,1,0,4,7107,A
2-PB1,1041,7082,0,5,1,7088,A
2-PB1,1042,7097,2,7,0,7106,A
2-PB1,1043,0,7101,1,0,7102,T
2-PB1,1044,3,19,7087,0,7109,G
2-PB1,1045,2,3,7088,0,7093,G
2-PB1,1046,2,2,0,7098,7102,C
2-PB1,1047,7082,1,1,0,7084,A
2-PB1,1048,7092,2,4,0,7098,A
2-PB1,1049,0,4,7094,0,7098,G
2-PB1,1050,7086,0,2,2,7090,A
2-PB1,1051,1,7024,0,1,7026,T
2-PB1,1052,0,7138,1,2,7141,T
2-PB1,1053,2,22,7168,1,7193,G
2-PB1,1054,3,5,7197,0,7205,G
2-PB1,1055,2,11,7225,0,7238,G
2-PB1,1056,7241,0,3,0,7244,A
2-PB1,1057,7229,0,0,1,7230,A
2-PB1,1058,7173,2,2,0,7177,A
2-PB1,1059,7135,1,20,1,7157,A
2-PB1,1060,1,12,7366,0,7379,G
2-PB1,1061,3,7,7383,0,7393,G
2-PB1,1062,7373,3,5,1,7382,A
2-PB1,1063,0,7340,0,4,7344,T
2-PB1,1064,7330,0,7,0,7337,A
2-PB1,1065,5,1,1,7353,7360,C
2-PB1,1066,7428,0,2,0,7430,A
2-PB1,1067,1,7409,0,1,7411,T
2-PB1,1068,1,2,7443,0,7446,G
2-PB1,1069,1,7272,0,8,7281,T
2-PB1,1070,0,7280,0,0,7280,T
2-PB1,1071,22,4,0,7231,7257,C
2-PB1,1072,1,15,7244,1,7261,G
2-PB1,1073,7265,0,6,0,7271,A
2-PB1,1074,0,13,7408,0,7421,G
2-PB1,1075,7330,2,8,0,7340,A
2-PB1,1076,1,2,7423,0,7426,G
2-PB1,1077,1,7366,0,0,7367,T
2-PB1,1078,7335,0,4,0,7339,A
2-PB1,1079,7347,0,8,0,7355,A
2-PB1,1080,2,12,7389,0,7403,G
2-PB1,1081,7372,1,8,1,7382,A
2-PB1,1082,0,9,7477,0,7486,G
2-PB1,1083,7298,3,3,0,7304,A
2-PB1,1084,7350,0,1,0,7351,A
2-PB1,1085,0,7272,1,2,7275,T
2-PB1,1086,0,10,7258,2,7270,G
2-PB1,1087,7258,2,4,1,7265,A
2-PB1,1088,7217,0,11,0,7228,A
2-PB1,1089,0,5,7246,0,7251,G
2-PB1,1090,0,3,0,7209,7212,C
2-PB1,1091,0,7114,0,5,7119,T
2-PB1,1092,14,1,0,7156,7171,C
2-PB1,1093,7,2,0,7150,7159,C
2-PB1,1094,7,6,7187,0,7200,G
2-PB1,1095,2,16,7193,0,7211,G
2-PB1,1096,7225,1,4,0,7230,A
2-PB1,1097,2,2,0,7338,7342,C
2-PB1,1098,7337,3,3,0,7343,A
2-PB1,1099,0,1,0,7401,7402,C
2-PB1,1100,7353,1,38,1,7393,A
2-PB1,1101,7406,1,4,1,7412,A
2-PB1,1102,7398,0,8,0,7406,A
2-PB1,1103,2,7426,1,1,7430,T
2-PB1,1104,7440,2,1,0,7443,A
2-PB1,1105,3,2,0,7414,7419,C
2-PB1,1106,10,2,0,7332,7344,C
2-PB1,1107,2,7250,0,13,7265,T
2-PB1,1108,2,1,7325,0,7328,G
2-PB1,1109,1,3,0,7335,7339,C
2-PB1,1110,7338,0,0,0,7338,A
2-PB1,1111,0,7,7334,0,7341,G
2-PB1,1112,7310,1,1,0,7312,A
2-PB1,1113,7289,0,2,0,7291,A
2-PB1,1114,7329,1,2,0,7332,A
2-PB1,1115,1,7306,1,2,7310,T
2-PB1,1116,1,1,7321,1,7324,G
2-PB1,1117,2,2,0,7294,7298,C
2-PB1,1118,0,7295,0,6,7301,T
2-PB1,1119,7395,1,8,0,7404,A
2-PB1,1120,1,0,7394,0,7395,G
2-PB1,1121,2,0,0,7392,7394,C
2-PB1,1122,7392,0,3,0,7395,A
2-PB1,1123,7363,0,2,0,7365,A
2-PB1,1124,0,1,7349,0,7350,G
2-PB1,1125,4,0,0,7329,7333,C
2-PB1,1126,7251,0,2,0,7253,A
2-PB1,1127,2,7402,1,4,7409,T
2-PB1,1128,1,7407,0,0,7408,T
2-PB1,1129,0,26,7578,0,7604,G
2-PB1,1130,7668,3,16,0,7687,A
2-PB1,1131,6,0,0,7672,7678,C
2-PB1,1132,6,1,1,7674,7682,C
2-PB1,1133,1,7517,1,6,7525,T
2-PB1,1134,1,1,7679,1,7682,G
2-PB1,1135,7690,2,4,0,7696,A
2-PB1,1136,7700,1,5,0,7706,A
2-PB1,1137,0,3,7804,0,7807,G
2-PB1,1138,1,7558,1,6,7566,T
2-PB1,1139,7612,0,2,1,7615,A
2-PB1,1140,1,7576,0,1,7578,T
2-PB1,1141,0,7571,2,4,7577,T
2-PB1,1142,0,7560,0,4,7564,T
2-PB1,1143,9,2,1,7463,7475,C
2-PB1,1144,7450,2,6,0,7458,A
2-PB1,1145,7457,1,3,1,7462,A
2-PB1,1146,0,7361,0,1,7362,T
2-PB1,1147,2,19,7372,0,7393,G
2-PB1,1148,7338,1,0,1,7340,A
2-PB1,1149,7361,0,3,2,7366,A
2-PB1,1150,1,7336,0,1,7338,T
2-PB1,1151,13,2,0,7377,7392,C
2-PB1,1152,7383,0,2,0,7385,A
2-PB1,1153,7404,1,4,0,7409,A
2-PB1,1154,1,2,0,7400,7403,C
2-PB1,1155,7389,0,2,0,7391,A
2-PB1,1156,7371,1,2,0,7374,A
2-PB1,1157,0,10,7356,0,7366,G
2-PB1,1158,1,6,7406,0,7413,G
2-PB1,1159,7403,2,3,1,7409,A
2-PB1,1160,7355,1,28,1,7385,A
2-PB1,1161,2,2,7388,0,7392,G
2-PB1,1162,7368,3,5,0,7376,A
2-PB1,1163,7386,1,0,1,7388,A
2-PB1,1164,7376,0,4,0,7380,A
2-PB1,1165,7325,2,59,0,7386,A
2-PB1,1166,1,7352,1,1,7355,T
2-PB1,1167,0,7262,1,1,7264,T
2-PB1,1168,0,9,7274,2,7285,G
2-PB1,1169,7267,4,6,0,7277,A
2-PB1,1170,2,5,7286,0,7293,G
2-PB1,1171,7276,0,3,0,7279,A
2-PB1,1172,7345,2,1,0,7348,A
2-PB1,1173,7460,2,1,2,7465,A
2-PB1,1174,7476,2,0,1,7479,A
2-PB1,1175,1,7482,0,1,7484,T
2-PB1,1176,7480,1,2,0,7483,A
2-PB1,1177,7457,3,9,0,7469,A
2-PB1,1178,0,7,7501,0,7508,G
2-PB1,1179,0,3,7489,0,7492,G
2-PB1,1180,4,0,0,7472,7476,C
2-PB1,1181,8,2,2,7446,7458,C
2-PB1,1182,1,7393,0,30,7424,T
2-PB1,1183,5,0,0,8419,8424,C
2-PB1,1184,1,8561,0,10,8572,T
2-PB1,1185,0,8613,0,1,8614,T
2-PB1,1186,4,1,0,8774,8779,C
2-PB1,1187,1,8748,1,4,8754,T
2-PB1,1188,8769,0,2,0,8771,A
2-PB1,1189,8776,0,4,1,8781,A
2-PB1,1190,0,8787,0,0,8787,T
2-PB1,1191,8797,0,1,2,8800,A
2-PB1,1192,0,6,8563,1,8570,G
2-PB1,1193,7829,0,7,1,7837,A
2-PB1,1194,1,7831,1,6,7839,T
2-PB1,1195,1,16,7676,0,7693,G
2-PB1,1196,4,0,7786,0,7790,G
2-PB1,1197,0,3,0,7773,7776,C
2-PB1,1198,7762,0,6,1,7769,A
2-PB1,1199,0,1,0,7789,7790,C
2-PB1,1200,7683,1,0,0,7684,A
2-PB1,1201,0,1,7933,0,7934,G
2-PB1,1202,4,1,1,7916,7922,C
2-PB1,1203,7939,2,1,0,7942,A
2-PB1,1204,1,8162,1,5,8169,T
2-PB1,1205,6,2,0,8090,8098,C
2-PB1,1206,8162,0,4,1,8167,A
2-PB1,1207,0,8158,0,1,8159,T
2-PB1,1208,0,8102,0,4,8106,T
2-PB1,1209,4,10,8082,0,8096,G
2-PB1,1210,7830,0,16,2,7848,A
2-PB1,1211,1,0,8035,0,8036,G
2-PB1,1212,0,5,2,8010,8017,C
2-PB1,1213,8,1,0,7928,7937,C
2-PB1,1214,26,3,0,8017,8046,C
2-PB1,1215,0,8004,3,11,8018,T
2-PB1,1216,0,8,8359,2,8369,G
2-PB1,1217,0,4,8517,1,8522,G
2-PB1,1218,8505,2,10,1,8518,A
2-PB1,1219,8692,1,4,0,8697,A
2-PB1,1220,1,8444,0,1,8446,T
2-PB1,1221,3,14,8653,0,8670,G
2-PB1,1222,8769,0,3,1,8773,A
2-PB1,1223,3,8738,2,2,8745,T
2-PB1,1224,1,11,8757,3,8772,G
2-PB1,1225,8691,4,5,1,8701,A
2-PB1,1226,0,8604,0,3,8607,T
2-PB1,1227,2,27,8599,0,8628,G
2-PB1,1228,3,11,8697,0,8711,G
2-PB1,1229,4,1,8720,1,8726,G
2-PB1,1230,6,2,0,8607,8615,C
2-PB1,1231,8635,1,5,0,8641,A
2-PB1,1232,1,8660,0,7,8668,T
2-PB1,1233,4,1,8933,0,8938,G
2-PB1,1234,1,8943,0,7,8951,T
2-PB1,1235,1,8993,1,3,8998,T
2-PB1,1236,21,5,0,8972,8998,C
2-PB1,1237,8925,0,5,1,8931,A
2-PB1,1238,8943,1,5,1,8950,A
2-PB1,1239,4,0,0,8958,8962,C
2-PB1,1240,8990,0,2,0,8992,A
2-PB1,1241,1,8995,0,3,8999,T
2-PB1,1242,1,2,9014,0,9017,G
2-PB1,1243,2,2,0,9013,9017,C
2-PB1,1244,1,9017,0,1,9019,T
2-PB1,1245,9084,0,3,1,9088,A
2-PB1,1246,9077,2,6,0,9085,A
2-PB1,1247,0,3,9256,2,9261,G
2-PB1,1248,3,9243,1,0,9247,T
2-PB1,1249,9196,2,2,2,9202,A
2-PB1,1250,0,6,1,9218,9225,C
2-PB1,1251,3,21,9177,0,9201,G
2-PB1,1252,1,4,9712,1,9718,G
2-PB1,1253,0,9703,1,9,9713,T
2-PB1,1254,1,9647,2,2,9652,T
2-PB1,1255,0,9656,1,1,9658,T
2-PB1,1256,0,9581,1,22,9604,T
2-PB1,1257,9607,1,8,0,9616,A
2-PB1,1258,2,16,9601,0,9619,G
2-PB1,1259,0,21,9585,0,9606,G
2-PB1,1260,9391,1,9,0,9401,A
2-PB1,1261,3,1,9332,0,9336,G
2-PB1,1262,2,9404,0,2,9408,T
2-PB1,1263,10,0,0,9429,9439,C
2-PB1,1264,1,9445,1,2,9449,T
2-PB1,1265,15,49,2,9374,9440,C
2-PB1,1266,4,15,9432,0,9451,G
2-PB1,1267,9729,3,3,2,9737,A
2-PB1,1268,1,9744,0,4,9749,T
2-PB1,1269,9763,4,1,0,9768,A
2-PB1,1270,3,1,0,9766,9770,C
2-PB1,1271,0,9576,0,18,9594,T
2-PB1,1272,1,17,9613,0,9631,G
2-PB1,1273,9613,4,2,0,9619,A
2-PB1,1274,9778,4,3,0,9785,A
2-PB1,1275,1,9789,0,1,9791,T
2-PB1,1276,4,1,2,9560,9567,C
2-PB1,1277,1,9538,0,6,9545,T
2-PB1,1278,1,9507,0,4,9512,T
2-PB1,1279,3,16,9490,1,9510,G
2-PB1,1280,5,17,9506,1,9529,G
2-PB1,1281,9502,2,12,0,9516,A
2-PB1,1282,4,0,1,9527,9532,C
2-PB1,1283,9384,0,6,1,9391,A
2-PB1,1284,9453,1,1,1,9456,A
2-PB1,1285,9444,1,34,1,9480,A
2-PB1,1286,9482,0,9,2,9493,A
2-PB1,1287,2,3,9662,0,9667,G
2-PB1,1288,9661,0,6,0,9667,A
2-PB1,1289,9635,2,5,0,9642,A
2-PB1,1290,9660,0,7,1,9668,A
2-PB1,1291,2,9653,1,4,9660,T
2-PB1,1292,9667,0,6,1,9674,A
2-PB1,1293,3,1,1,9947,9952,C
2-PB1,1294,9861,3,7,1,9872,A
2-PB1,1295,0,0,1,9916,9917,C
2-PB1,1296,15,0,1,9800,9816,C
2-PB1,1297,9759,0,2,1,9762,A
2-PB1,1298,9854,1,4,0,9859,A
2-PB1,1299,2,14,10108,0,10124,G
2-PB1,1300,10255,1,3,1,10260,A
2-PB1,1301,1,3,0,10325,10329,C
2-PB1,1302,10083,0,6,1,10090,A
2-PB1,1303,10396,0,10,0,10406,A
2-PB1,1304,3,5,0,10436,10444,C
2-PB1,1305,10626,0,6,0,10632,A
2-PB1,1306,0,10665,1,1,10667,T
2-PB1,1307,10572,1,5,0,10578,A
2-PB1,1308,6,1,0,10750,10757,C
2-PB1,1309,2,10422,1,4,10429,T
2-PB1,1310,6,19,10558,1,10584,G
2-PB1,1311,2,3,10573,0,10578,G
2-PB1,1312,4,10351,0,5,10360,T
2-PB1,1313,1,42,10297,0,10340,G
2-PB1,1314,1,16,10215,1,10233,G
2-PB1,1315,1,8,10270,0,10279,G
2-PB1,1316,10267,3,5,0,10275,A
2-PB1,1317,1,10061,0,5,10067,T
2-PB1,1318,4,42,10013,1,10060,G
2-PB1,1319,8,10,9984,0,10002,G
2-PB1,1320,1,3,10058,1,10063,G
2-PB1,1321,2,2,0,10179,10183,C
2-PB1,1322,1,10124,0,10,10135,T
2-PB1,1323,8,0,1,10167,10176,C
2-PB1,1324,16,2,1,10140,10159,C
2-PB1,1325,10160,0,4,0,10164,A
2-PB1,1326,10168,0,3,1,10172,A
2-PB1,1327,1,10140,1,2,10144,T
2-PB1,1328,6,0,1,10079,10086,C
2-PB1,1329,12,2,1,9989,10004,C
2-PB1,1330,0,9861,0,58,9919,T
2-PB1,1331,9,0,0,9907,9916,C
2-PB1,1332,10,6,1,9870,9887,C
2-PB1,1333,4,14,9871,0,9889,G
2-PB1,1334,9883,1,4,0,9888,A
2-PB1,1335,3,5,0,9864,9872,C
2-PB1,1336,4,19,9866,0,9889,G
2-PB1,1337,9980,1,1,0,9982,A
2-PB1,1338,0,9953,0,5,9958,T
2-PB1,1339,0,9945,1,2,9948,T
2-PB1,1340,0,9933,1,4,9938,T
2-PB1,1341,1,9962,0,3,9966,T
2-PB1,1342,38,2,9934,0,9974,G
2-PB1,1343,5,9,0,10005,10019,C
2-PB1,1344,14,6,0,10016,10036,C
2-PB1,1345,29,2,0,10258,10289,C
2-PB1,1346,1,10129,1,16,10147,T
2-PB1,1347,13,3,1,10522,10539,C
2-PB1,1348,10612,0,6,0,10618,A
2-PB1,1349,3,10637,0,10,10650,T
2-PB1,1350,10645,2,5,1,10653,A
2-PB1,1351,4,1,10757,0,10762,G
2-PB1,1352,1,10600,2,4,10607,T
2-PB1,1353,1,14,10645,0,10660,G
2-PB1,1354,10260,0,6,0,10266,A
2-PB1,1355,10275,1,5,0,10281,A
2-PB1,1356,1,9837,0,4,9842,T
2-PB1,1357,3,4,9784,1,9792,G
2-PB1,1358,8,11,0,9874,9893,C
2-PB1,1359,9893,4,12,0,9909,A
2-PB1,1360,7,3,0,9914,9924,C
2-PB1,1361,11,4,0,9853,9868,C
2-PB1,1362,9806,0,1,1,9808,A
2-PB1,1363,9807,0,5,1,9813,A
2-PB1,1364,9774,1,1,1,9777,A
2-PB1,1365,1,9543,0,5,9549,T
2-PB1,1366,22,3,0,9798,9823,C
2-PB1,1367,9849,2,3,0,9854,A
2-PB1,1368,0,9852,0,3,9855,T
2-PB1,1369,1,8,9858,0,9867,G
2-PB1,1370,9854,4,15,0,9873,A
2-PB1,1371,2,34,9883,0,9919,G
2-PB1,1372,5,18,9842,0,9865,G
2-PB1,1373,5,8,9908,0,9921,G
2-PB1,1374,9843,4,3,0,9850,A
2-PB1,1375,9958,1,5,0,9964,A
2-PB1,1376,1,9981,2,4,9988,T
2-PB1,1377,10001,2,6,1,10010,A
2-PB1,1378,3,1,0,10012,10016,C
2-PB1,1379,9992,1,1,0,9994,A
2-PB1,1380,9956,1,9,2,9968,A
2-PB1,1381,2,3,9937,1,9943,G
2-PB1,1382,2,2,0,9845,9849,C
2-PB1,1383,9790,1,4,0,9795,A
2-PB1,1384,4,13,9837,0,9854,G
2-PB1,1385,1,17,9846,0,9864,G
2-PB1,1386,9795,1,5,0,9801,A
2-PB1,1387,4,24,9839,0,9867,G
2-PB1,1388,3,9693,0,2,9698,T
2-PB1,1389,2,22,9760,0,9784,G
2-PB1,1390,2,5,9815,0,9822,G
2-PB1,1391,9800,0,9,1,9810,A
2-PB1,1392,2,9810,0,3,9815,T
2-PB1,1393,9664,2,3,0,9669,A
2-PB1,1394,0,9,9745,0,9754,G
2-PB1,1395,9839,1,1,0,9841,A
2-PB1,1396,1,9828,1,5,9835,T
2-PB1,1397,0,9798,1,2,9801,T
2-PB1,1398,16,0,0,10052,10068,C
2-PB1,1399,0,10012,0,1,10013,T
2-PB1,1400,10004,3,2,1,10010,A
2-PB1,1401,2,1,0,10011,10014,C
2-PB1,1402,9809,1,6,1,9817,A
2-PB1,1403,1,15,9814,1,9831,G
2-PB1,1404,0,16,9666,1,9683,G
2-PB1,1405,9768,1,7,1,9777,A
2-PB1,1406,2,2,0,9751,9755,C
2-PB1,1407,8,2,0,9511,9521,C
2-PB1,1408,3,9432,2,10,9447,T
2-PB1,1409,8,2,9471,0,9481,G
2-PB1,1410,0,2,1,9455,9458,C
2-PB1,1411,9483,0,3,0,9486,A
2-PB1,1412,9515,1,5,2,9523,A
2-PB1,1413,2,1,9554,0,9557,G
2-PB1,1414,1,9399,1,3,9404,T
2-PB1,1415,0,9394,1,4,9399,T
2-PB1,1416,9257,1,6,1,9265,A
2-PB1,1417,1,1,9297,1,9300,G
2-PB1,1418,1,9244,1,6,9252,T
2-PB1,1419,3,15,9218,0,9236,G
2-PB1,1420,3,11,9206,0,9220,G
2-PB1,1421,2,12,9222,2,9238,G
2-PB1,1422,9190,0,9,1,9200,A
2-PB1,1423,9215,5,4,0,9224,A
2-PB1,1424,2,9192,1,7,9202,T
2-PB1,1425,18,1,0,9207,9226,C
2-PB1,1426,9215,2,5,0,9222,A
2-PB1,1427,9223,3,4,0,9230,A
2-PB1,1428,1,2,0,9218,9221,C
2-PB1,1429,9216,2,2,1,9221,A
2-PB1,1430,1,9004,0,4,9009,T
2-PB1,1431,3,35,8975,1,9014,G
2-PB1,1432,9002,0,3,0,9005,A
2-PB1,1433,0,3,9052,0,9055,G
2-PB1,1434,4,4,0,9005,9013,C
2-PB1,1435,8983,0,2,0,8985,A
2-PB1,1436,8986,1,0,1,8988,A
2-PB1,1437,8988,0,1,0,8989,A
2-PB1,1438,9044,0,4,0,9048,A
2-PB1,1439,9044,0,2,0,9046,A
2-PB1,1440,1,6,9039,0,9046,G
2-PB1,1441,8898,3,6,2,8909,A
2-PB1,1442,8805,0,12,1,8818,A
2-PB1,1443,1,0,9094,0,9095,G
2-PB1,1444,5,9053,0,3,9061,T
2-PB1,1445,23,2,1,9030,9056,C
2-PB1,1446,9,2,1,9069,9081,C
2-PB1,1447,1,9038,0,4,9043,T
2-PB1,1448,9198,1,1,0,9200,A
2-PB1,1449,0,9170,1,2,9173,T
2-PB1,1450,9123,1,56,0,9180,A
2-PB1,1451,1,9182,0,0,9183,T
2-PB1,1452,8882,0,1,1,8884,A
2-PB1,1453,8894,1,1,0,8896,A
2-PB1,1454,8878,2,4,1,8885,A
2-PB1,1455,2,8852,2,1,8857,T
2-PB1,1456,8763,1,1,0,8765,A
2-PB1,1457,8675,3,2,0,8680,A
2-PB1,1458,8725,2,3,0,8730,A
2-PB1,1459,8726,0,6,0,8732,A
2-PB1,1460,1,1,1,8732,8735,C
2-PB1,1461,8253,0,5,0,8258,A
2-PB1,1462,2,19,8229,0,8250,G
2-PB1,1463,3,12,8232,2,8249,G
2-PB1,1464,1,16,8244,0,8261,G
2-PB1,1465,8251,3,10,0,8264,A
2-PB1,1466,1,5,0,8300,8306,C
2-PB1,1467,8235,1,1,0,8237,A
2-PB1,1468,0,8271,0,3,8274,T
2-PB1,1469,1,8255,1,6,8263,T
2-PB1,1470,0,8272,0,6,8278,T
2-PB1,1471,4,7,8274,1,8286,G
2-PB1,1472,8238,1,5,0,8244,A
2-PB1,1473,8253,2,4,0,8259,A
2-PB1,1474,1,8267,0,1,8269,T
2-PB1,1475,3,8068,0,8,8079,T
2-PB1,1476,14,1,0,8092,8107,C
2-PB1,1477,8036,0,3,0,8039,A
2-PB1,1478,4,1,2,8030,8037,C
2-PB1,1479,1,8043,0,3,8047,T
2-PB1,1480,8031,1,0,0,8032,A
2-PB1,1481,4,1,8023,0,8028,G
2-PB1,1482,2,1,0,8004,8007,C
2-PB1,1483,1,7934,0,12,7947,T
2-PB1,1484,2,8031,0,2,8035,T
2-PB1,1485,0,8001,0,0,8001,T
2-PB1,1486,6,8006,0,2,8014,T
2-PB1,1487,2,8002,0,4,8008,T
2-PB1,1488,0,8012,0,1,8013,T
2-PB1,1489,0,7973,0,2,7975,T
2-PB1,1490,7965,5,3,0,7973,A
2-PB1,1491,4,7939,0,1,7944,T
2-PB1,1492,8,4,0,7934,7946,C
2-PB1,1493,3,8,7982,1,7994,G
2-PB1,1494,8249,0,2,1,8252,A
2-PB1,1495,0,8271,0,4,8275,T
2-PB1,1496,8259,1,5,7,8272,A
2-PB1,1497,1,8320,0,3,8324,T
2-PB1,1498,1,17,8310,1,8329,G
2-PB1,1499,0,6,8361,1,8368,G
2-PB1,1500,8371,0,6,1,8378,A
2-PB1,1501,1,8294,1,1,8297,T
2-PB1,1502,1,8197,1,1,8200,T
2-PB1,1503,0,7982,0,1,7983,T
2-PB1,1504,5,4,7980,0,7989,G
2-PB1,1505,3,7953,0,3,7959,T
2-PB1,1506,3,15,7929,1,7948,G
2-PB1,1507,5,2,7940,0,7947,G
2-PB1,1508,1,2,0,7877,7880,C
2-PB1,1509,0,7873,0,3,7876,T
2-PB1,1510,7881,0,1,1,7883,A
2-PB1,1511,7935,1,1,0,7937,A
2-PB1,1512,0,7970,0,1,7971,T
2-PB1,1513,0,7971,0,3,7974,T
2-PB1,1514,0,7977,0,2,7979,T
2-PB1,1515,0,7974,0,0,7974,T
2-PB1,1516,7970,0,4,0,7974,A
2-PB1,1517,2,4,8025,0,8031,G
2-PB1,1518,3,0,0,8016,8019,C
2-PB1,1519,7993,1,2,0,7996,A
2-PB1,1520,0,7902,1,7,7910,T
2-PB1,1521,3,10,7766,1,7780,G
2-PB1,1522,0,15,7875,0,7890,G
2-PB1,1523,7847,0,5,1,7853,A
2-PB1,1524,1,0,7873,2,7876,G
2-PB1,1525,1,1,0,7837,7839,C
2-PB1,1526,0,7746,0,8,7754,T
2-PB1,1527,1,3,7805,2,7811,G
2-PB1,1528,2,3,0,7785,7790,C
2-PB1,1529,10,3,0,7762,7775,C
2-PB1,1530,27,2,0,7793,7822,C
2-PB1,1531,7626,2,2,2,7632,A
2-PB1,1532,1,1,7922,0,7924,G
2-PB1,1533,3,7899,0,9,7911,T
2-PB1,1534,0,7905,1,0,7906,T
2-PB1,1535,2,7898,0,2,7902,T
2-PB1,1536,0,7805,1,1,7807,T
2-PB1,1537,1,9,7791,0,7801,G
2-PB1,1538,0,13,7784,0,7797,G
2-PB1,1539,7758,4,8,0,7770,A
2-PB1,1540,2,0,7784,0,7786,G
2-PB1,1541,0,7064,0,2,7066,T
2-PB1,1542,2,2,7308,0,7312,G
2-PB1,1543,0,7299,0,2,7301,T
2-PB1,1544,9,0,0,7283,7292,C
2-PB1,1545,2,7292,0,10,7304,T
2-PB1,1546,2,5,7316,0,7323,G
2-PB1,1547,3,8,7387,0,7398,G
2-PB1,1548,7378,1,2,0,7381,A
2-PB1,1549,7392,1,3,1,7397,A
2-PB1,1550,2,7368,0,1,7371,T
2-PB1,1551,6766,0,0,0,6766,A
2-PB1,1552,6757,0,3,0,6760,A
2-PB1,1553,6748,2,6,1,6757,A
2-PB1,1554,1,3,0,6769,6773,C
2-PB1,1555,0,20,6669,0,6689,G
2-PB1,1556,6584,0,0,0,6584,A
2-PB1,1557,1,2,6587,0,6590,G
2-PB1,1558,0,6556,1,8,6565,T
2-PB1,1559,18,1,0,6572,6591,C
2-PB1,1560,6562,0,7,1,6570,A
2-PB1,1561,3,3,6622,0,6628,G
2-PB1,1562,4,3,0,6610,6617,C
2-PB1,1563,2,6599,1,5,6607,T
2-PB1,1564,1,2,6785,0,6788,G
2-PB1,1565,6724,2,6,1,6733,A
2-PB1,1566,1,6727,0,3,6731,T
2-PB1,1567,6737,0,5,0,6742,A
2-PB1,1568,1,6629,0,0,6630,T
2-PB1,1569,1,19,6633,0,6653,G
2-PB1,1570,6349,2,7,1,6359,A
2-PB1,1571,4,1,6418,0,6423,G
2-PB1,1572,2,1,1,6409,6413,C
2-PB1,1573,6008,0,2,0,6010,A
2-PB1,1574,0,5994,0,2,5996,T
2-PB1,1575,2,5978,0,2,5982,T
2-PB1,1576,3,11,6010,1,6025,G
2-PB1,1577,2,11,6163,1,6177,G
2-PB1,1578,6044,0,7,0,6051,A
2-PB1,1579,2,0,6067,0,6069,G
2-PB1,1580,0,5765,1,2,5768,T
2-PB1,1581,5736,0,1,0,5737,A
2-PB1,1582,5724,3,11,1,5739,A
2-PB1,1583,0,3,0,5761,5764,C
2-PB1,1584,5688,1,4,1,5694,A
2-PB1,1585,0,0,5776,0,5776,G
2-PB1,1586,0,4976,0,3,4979,T
2-PB1,1587,0,8,5023,1,5032,G
2-PB1,1588,5070,1,6,1,5078,A
2-PB1,1589,1,5055,2,3,5061,T
2-PB1,1590,5052,0,3,0,5055,A
2-PB1,1591,5042,0,2,0,5044,A
2-PB1,1592,4836,1,9,1,4847,A
2-PB1,1593,0,7,4883,0,4890,G
2-PB1,1594,4564,0,4,0,4568,A
2-PB1,1595,4546,0,4,0,4550,A
2-PB1,1596,1,4,0,4554,4559,C
2-PB1,1597,4334,0,6,0,4340,A
2-PB1,1598,4368,1,4,0,4373,A
2-PB1,1599,0,3,1,4385,4389,C
2-PB1,1600,4424,0,5,0,4429,A
2-PB1,1601,1,4410,14,0,4425,T
2-PB1,1602,2,4,4282,0,4288,G
2-PB1,1603,4278,0,6,0,4284,A
2-PB1,1604,1,4274,0,1,4276,T
2-PB1,1605,4184,0,3,0,4187,A
2-PB1,1606,4214,0,2,0,4216,A
2-PB1,1607,4131,1,4,1,4137,A
2-PB1,1608,1,1,1,4139,4142,C
2-PB1,1609,3868,0,0,0,3868,A
2-PB1,1610,3849,0,2,0,3851,A
2-PB1,1611,0,3715,0,0,3715,T
2-PB1,1612,0,12,3700,0,3712,G
2-PB1,1613,3803,1,1,0,3805,A
2-PB1,1614,1,2,0,3859,3862,C
2-PB1,1615,3,1,0,3729,3733,C
2-PB1,1616,1,3497,1,6,3505,T
2-PB1,1617,0,3371,0,0,3371,T
2-PB1,1618,1,6,3383,2,3392,G
2-PB1,1619,1,7,3434,0,3442,G
2-PB1,1620,3468,2,2,0,3472,A
2-PB1,1621,0,0,0,3509,3509,C
2-PB1,1622,4,1,0,3464,3469,C
2-PB1,1623,3432,1,5,0,3438,A
2-PB1,1624,0,2,3470,0,3472,G
2-PB1,1625,1,2,0,3473,3476,C
2-PB1,1626,3478,0,2,0,3480,A
2-PB1,1627,3471,2,1,0,3474,A
2-PB1,1628,0,0,0,3455,3455,C
2-PB1,1629,3428,0,2,0,3430,A
2-PB1,1630,1,2,3485,0,3488,G
2-PB1,1631,1,0,0,3478,3479,C
2-PB1,1632,5,1,1,3478,3485,C
2-PB1,1633,13,2,0,3469,3484,C
2-PB1,1634,3483,0,2,0,3485,A
2-PB1,1635,3482,1,2,0,3485,A
2-PB1,1636,3483,1,0,0,3484,A
2-PB1,1637,0,3486,0,2,3488,T
2-PB1,1638,1,3,3462,1,3467,G
2-PB1,1639,0,2,3428,1,3431,G
2-PB1,1640,1,1,0,3448,3450,C
2-PB1,1641,1,3411,0,2,3414,T
2-PB1,1642,3,0,0,3496,3499,C
2-PB1,1643,0,3486,0,3,3489,T
2-PB1,1644,4,0,0,3509,3513,C
2-PB1,1645,5,0,1,3526,3532,C
2-PB1,1646,3537,0,2,0,3539,A
2-PB1,1647,3546,0,1,0,3547,A
2-PB1,1648,0,3531,0,2,3533,T
2-PB1,1649,1,3501,0,0,3502,T
2-PB1,1650,0,0,3516,0,3516,G
2-PB1,1651,3,3457,0,2,3462,T
2-PB1,1652,0,3454,0,1,3455,T
2-PB1,1653,8,8,1,3445,3462,C
2-PB1,1654,3446,0,2,0,3448,A
2-PB1,1655,0,3446,0,3,3449,T
2-PB1,1656,3,0,0,3445,3448,C
2-PB1,1657,3455,1,1,0,3457,A
2-PB1,1658,3458,0,0,0,3458,A
2-PB1,1659,3444,0,5,0,3449,A
2-PB1,1660,0,6,3516,1,3523,G
2-PB1,1661,3519,0,1,2,3522,A
2-PB1,1662,1,3519,0,4,3524,T
2-PB1,1663,0,3527,0,1,3528,T
2-PB1,1664,3527,1,1,1,3530,A
2-PB1,1665,1,0,0,3586,3587,C
2-PB1,1666,3576,0,2,1,3579,A
2-PB1,1667,1,1,3619,0,3621,G
2-PB1,1668,3602,0,2,0,3604,A
2-PB1,1669,0,3672,0,0,3672,T
2-PB1,1670,3678,0,2,0,3680,A
2-PB1,1671,0,1,0,3890,3891,C
2-PB1,1672,3956,0,8,0,3964,A
2-PB1,1673,1,0,0,4236,4237,C
2-PB1,1674,4153,1,6,0,4160,A
2-PB1,1675,2,4185,0,2,4189,T
2-PB1,1676,4165,0,0,0,4165,A
2-PB1,1677,2,4148,0,1,4151,T
2-PB1,1678,4040,0,2,0,4042,A
2-PB1,1679,0,5,4034,0,4039,G
2-PB1,1680,0,1,3989,0,3990,G
2-PB1,1681,0,3819,0,2,3821,T
2-PB1,1682,3,1,3732,0,3736,G
2-PB1,1683,4,1,0,3887,3892,C
2-PB1,1684,8,2,1,3880,3891,C
2-PB1,1685,3932,0,2,0,3934,A
2-PB1,1686,1,3936,0,0,3937,T
2-PB1,1687,3937,0,1,0,3938,A
2-PB1,1688,0,5,3949,0,3954,G
2-PB1,1689,3872,0,1,0,3873,A
2-PB1,1690,1,4,3887,0,3892,G
2-PB1,1691,0,5,3884,1,3890,G
2-PB1,1692,3746,0,8,0,3754,A
2-PB1,1693,0,9,3760,0,3769,G
2-PB1,1694,3720,0,5,0,3725,A
2-PB1,1695,2,1,0,3734,3737,C
2-PB1,1696,3729,2,1,0,3732,A
2-PB1,1697,2,1,0,3773,3776,C
2-PB1,1698,3769,3,4,0,3776,A
2-PB1,1699,1,1,1,3780,3783,C
2-PB1,1700,3758,0,0,0,3758,A
2-PB1,1701,3801,1,0,0,3802,A
2-PB1,1702,3800,1,0,1,3802,A
2-PB1,1703,0,3794,1,3,3798,T
2-PB1,1704,5,0,0,3801,3806,C
2-PB1,1705,2,1,0,3795,3798,C
2-PB1,1706,3740,0,4,0,3744,A
2-PB1,1707,0,13,3732,0,3745,G
2-PB1,1708,3736,0,5,1,3742,A
2-PB1,1709,0,2,0,3864,3866,C
2-PB1,1710,1,4,3832,0,3837,G
2-PB1,1711,3825,1,0,0,3826,A
2-PB1,1712,0,3813,0,2,3815,T
2-PB1,1713,3841,0,2,0,3843,A
2-PB1,1714,3847,0,0,0,3847,A
2-PB1,1715,0,6,3854,0,3860,G
2-PB1,1716,3847,1,4,1,3853,A
2-PB1,1717,0,3840,0,2,3842,T
2-PB1,1718,4,2,0,3746,3752,C
2-PB1,1719,3751,0,6,0,3757,A
2-PB1,1720,0,3745,0,1,3746,T
2-PB1,1721,0,3751,0,1,3752,T
2-PB1,1722,7,0,0,3748,3755,C
2-PB1,1723,1,5,3753,0,3759,G
2-PB1,1724,3722,1,2,0,3725,A
2-PB1,1725,0,4,3737,0,3741,G
2-PB1,1726,3709,3,3,0,3715,A
2-PB1,1727,0,3860,0,1,3861,T
2-PB1,1728,3869,0,0,0,3869,A
2-PB1,1729,3882,0,1,0,3883,A
2-PB1,1730,3890,0,2,0,3892,A
2-PB1,1731,3,2,3898,0,3903,G
2-PB1,1732,3902,0,3,1,3906,A
2-PB1,1733,3792,0,3,0,3795,A
2-PB1,1734,0,0,3799,0,3799,G
2-PB1,1735,0,0,0,3814,3814,C
2-PB1,1736,1,3776,0,1,3778,T
2-PB1,1737,1,0,3799,0,3800,G
2-PB1,1738,1,3777,0,0,3778,T
2-PB1,1739,0,9,3754,0,3763,G
2-PB1,1740,2,3,3774,0,3779,G
2-PB1,1741,3,6,3804,0,3813,G
2-PB1,1742,3810,0,10,0,3820,A
2-PB1,1743,0,3796,0,1,3797,T
2-PB1,1744,7,0,1,3779,3787,C
2-PB1,1745,3786,0,3,0,3789,A
2-PB1,1746,3802,2,2,1,3807,A
2-PB1,1747,3838,0,0,0,3838,A
2-PB1,1748,0,1,0,3842,3843,C
2-PB1,1749,4,1,1,3818,3824,C
2-PB1,1750,16,2,0,3799,3817,C
2-PB1,1751,3812,0,2,0,3814,A
2-PB1,1752,3881,2,1,0,3884,A
2-PB1,1753,3,3867,0,3,3873,T
2-PB1,1754,9,0,0,3865,3874,C
2-PB1,1755,3840,0,3,1,3844,A
2-PB1,1756,3821,0,1,1,3823,A
2-PB1,1757,0,7,3867,1,3875,G
2-PB1,1758,1,5,3853,1,3860,G
2-PB1,1759,1,2,3862,0,3865,G
2-PB1,1760,2,1,1,3857,3861,C
2-PB1,1761,3790,0,4,0,3794,A
2-PB1,1762,1,12,3853,0,3866,G
2-PB1,1763,1,4,3886,0,3891,G
2-PB1,1764,3906,0,2,0,3908,A
2-PB1,1765,0,0,0,3944,3944,C
2-PB1,1766,0,3857,0,3,3860,T
2-PB1,1767,3886,0,0,1,3887,A
2-PB1,1768,0,3865,0,3,3868,T
2-PB1,1769,0,3874,0,0,3874,T
2-PB1,1770,1,6,3871,0,3878,G
2-PB1,1771,0,0,3817,0,3817,G
2-PB1,1772,0,3788,0,2,3790,T
2-PB1,1773,1,3702,1,4,3708,T
2-PB1,1774,0,3788,0,1,3789,T
2-PB1,1775,4,0,0,3795,3799,C
2-PB1,1776,3802,0,1,2,3805,A
2-PB1,1777,0,1,3807,0,3808,G
2-PB1,1778,3811,0,0,2,3813,A
2-PB1,1779,1,3781,0,1,3783,T
2-PB1,1780,2,13,3687,0,3702,G
2-PB1,1781,0,4,3696,0,3700,G
2-PB1,1782,1,10,3702,1,3714,G
2-PB1,1783,1,5,3723,0,3729,G
2-PB1,1784,2,6,3741,0,3749,G
2-PB1,1785,3739,0,6,0,3745,A
2-PB1,1786,1,0,1,3730,3732,C
2-PB1,1787,7,1,2,3719,3729,C
2-PB1,1788,3739,0,1,0,3740,A
2-PB1,1789,4022,1,1,1,4025,A
2-PB1,1790,4042,0,1,1,4044,A
2-PB1,1791,3,0,0,4116,4119,C
2-PB1,1792,1,4080,0,5,4086,T
2-PB1,1793,0,4070,0,1,4071,T
2-PB1,1794,4094,0,1,0,4095,A
2-PB1,1795,0,4093,0,3,4096,T
2-PB1,1796,4102,1,6,0,4109,A
2-PB1,1797,2,0,0,4109,4111,C
2-PB1,1798,3755,0,2,0,3757,A
2-PB1,1799,3758,2,1,0,3761,A
2-PB1,1800,0,3650,1,0,3651,T
2-PB1,1801,3692,0,0,0,3692,A
2-PB1,1802,0,3692,0,4,3696,T
2-PB1,1803,3,0,0,3685,3688,C
2-PB1,1804,3,2,0,3678,3683,C
2-PB1,1805,1,3,3678,1,3683,G
2-PB1,1806,0,2,3692,1,3695,G
2-PB1,1807,3694,0,0,0,3694,A
2-PB1,1808,3689,1,2,1,3693,A
2-PB1,1809,0,3691,0,2,3693,T
2-PB1,1810,4,0,0,3697,3701,C
2-PB1,1811,0,3679,1,4,3684,T
2-PB1,1812,1,3693,0,3,3697,T
2-PB1,1813,1,1,1,3695,3698,C
2-PB1,1814,3692,6,2,0,3700,A
2-PB1,1815,2,0,0,3711,3713,C
2-PB1,1816,3699,0,1,0,3700,A
2-PB1,1817,0,3984,1,1,3986,T
2-PB1,1818,6,1,1,3991,3999,C
2-PB1,1819,7,2,0,3991,4000,C
2-PB1,1820,12,0,1,3996,4009,C
2-PB1,1821,1,3996,0,6,4003,T
2-PB1,1822,0,2,4011,0,4013,G
2-PB1,1823,4003,0,1,1,4005,A
2-PB1,1824,3986,0,3,0,3989,A
2-PB1,1825,1,5,4002,0,4008,G
2-PB1,1826,0,3750,0,1,3751,T
2-PB1,1827,3,0,0,3744,3747,C
2-PB1,1828,0,3684,1,2,3687,T
2-PB1,1829,0,1,3773,0,3774,G
2-PB1,1830,0,0,0,3774,3774,C
2-PB1,1831,0,3759,0,2,3761,T
2-PB1,1832,2,3775,0,2,3779,T
2-PB1,1833,3776,0,1,0,3777,A
2-PB1,1834,3771,0,1,0,3772,A
2-PB1,1835,3777,0,1,0,3778,A
2-PB1,1836,3655,3,2,0,3660,A
2-PB1,1837,0,3710,1,0,3711,T
2-PB1,1838,0,11,3689,0,3700,G
2-PB1,1839,0,5,3716,0,3721,G
2-PB1,1840,3,9,3716,0,3728,G
2-PB1,1841,3693,0,28,0,3721,A
2-PB1,1842,0,0,3735,0,3735,G
2-PB1,1843,12,1,0,3706,3719,C
2-PB1,1844,0,3714,1,2,3717,T
2-PB1,1845,0,1,3725,1,3727,G
2-PB1,1846,3691,0,1,0,3692,A
2-PB1,1847,1,3700,1,1,3703,T
2-PB1,1848,0,5,3699,0,3704,G
2-PB1,1849,1,2,3717,1,3721,G
2-PB1,1850,3717,1,2,1,3721,A
2-PB1,1851,0,3708,1,2,3711,T
2-PB1,1852,0,7,3711,1,3719,G
2-PB1,1853,3699,0,2,0,3701,A
2-PB1,1854,2,6,3755,0,3763,G
2-PB1,1855,3767,0,1,0,3768,A
2-PB1,1856,3765,0,1,1,3767,A
2-PB1,1857,1,3746,1,0,3748,T
2-PB1,1858,0,3731,2,2,3735,T
2-PB1,1859,3741,0,1,0,3742,A
2-PB1,1860,1,3741,1,0,3743,T
2-PB1,1861,4,0,0,3739,3743,C
2-PB1,1862,2,10,3741,1,3754,G
2-PB1,1863,4,9,3715,0,3728,G
2-PB1,1864,2,6,3700,0,3708,G
2-PB1,1865,0,3,3717,0,3720,G
2-PB1,1866,3722,1,1,0,3724,A
2-PB1,1867,3723,0,2,0,3725,A
2-PB1,1868,1,5,3762,0,3768,G
2-PB1,1869,3810,0,1,0,3811,A
2-PB1,1870,0,1,0,3826,3827,C
2-PB1,1871,0,3785,0,0,3785,T
2-PB1,1872,1,3852,1,4,3858,T
2-PB1,1873,2,3858,0,1,3861,T
2-PB1,1874,1,1,3904,0,3906,G
2-PB1,1875,0,3903,0,1,3904,T
2-PB1,1876,3883,0,0,0,3883,A
2-PB1,1877,3861,0,1,0,3862,A
2-PB1,1878,0,3807,0,4,3811,T
2-PB1,1879,4,0,0,3838,3842,C
2-PB1,1880,5,0,1,3832,3838,C
2-PB1,1881,16,2,0,3797,3815,C
2-PB1,1882,9,1,1,3822,3833,C
2-PB1,1883,1,3820,2,2,3825,T
2-PB1,1884,0,5,3835,0,3840,G
2-PB1,1885,3838,0,0,0,3838,A
2-PB1,1886,3848,0,1,0,3849,A
2-PB1,1887,0,3853,0,3,3856,T
2-PB1,1888,6,0,0,3845,3851,C
2-PB1,1889,7,0,0,3837,3844,C
2-PB1,1890,10,0,0,3799,3809,C
2-PB1,1891,0,3797,0,10,3807,T
2-PB1,1892,0,3820,0,1,3821,T
2-PB1,1893,0,3815,0,1,3816,T
2-PB1,1894,0,0,3817,1,3818,G
2-PB1,1895,0,3800,0,1,3801,T
2-PB1,1896,10,2,2,3778,3792,C
2-PB1,1897,3735,0,2,1,3738,A
2-PB1,1898,1,3,3784,0,3788,G
2-PB1,1899,3,3,0,3780,3786,C
2-PB1,1900,3,0,0,3779,3782,C
2-PB1,1901,3788,0,1,0,3789,A
2-PB1,1902,2,3799,0,0,3801,T
2-PB1,1903,3798,0,0,1,3799,A
2-PB1,1904,3817,0,0,1,3818,A
2-PB1,1905,3815,1,1,0,3817,A
2-PB1,1906,0,3,3858,1,3862,G
2-PB1,1907,3760,1,1,0,3762,A
2-PB1,1908,3776,0,1,0,3777,A
2-PB1,1909,3780,0,1,0,3781,A
2-PB1,1910,0,3771,0,1,3772,T
2-PB1,1911,1,3762,0,2,3765,T
2-PB1,1912,0,7,3764,0,3771,G
2-PB1,1913,3746,0,3,0,3749,A
2-PB1,1914,0,0,3809,0,3809,G
2-PB1,1915,0,3790,0,3,3793,T
2-PB1,1916,6,0,0,3856,3862,C
2-PB1,1917,1,3836,0,2,3839,T
2-PB1,1918,1,1,3915,0,3917,G
2-PB1,1919,0,3915,0,2,3917,T
2-PB1,1920,3961,0,2,0,3963,A
2-PB1,1921,3966,0,0,0,3966,A
2-PB1,1922,3952,1,4,0,3957,A
2-PB1,1923,1,1,0,3965,3967,C
2-PB1,1924,3833,0,0,0,3833,A
2-PB1,1925,3921,0,2,0,3923,A
2-PB1,1926,0,3914,0,2,3916,T
2-PB1,1927,1,0,3897,0,3898,G
2-PB1,1928,1,0,1,3926,3928,C
2-PB1,1929,1,3855,0,5,3861,T
2-PB1,1930,2,0,3981,0,3983,G
2-PB1,1931,1,3985,1,0,3987,T
2-PB1,1932,4083,0,2,0,4085,A
2-PB1,1933,0,0,4088,0,4088,G
2-PB1,1934,1,3998,0,3,4002,T
2-PB1,1935,3975,0,2,0,3977,A
2-PB1,1936,3947,0,3,0,3950,A
2-PB1,1937,0,3912,1,0,3913,T
2-PB1,1938,2,3,3902,0,3907,G
2-PB1,1939,1,1,0,3854,3856,C
2-PB1,1940,4,0,0,3798,3802,C
2-PB1,1941,3743,0,2,0,3745,A
2-PB1,1942,1,2,3809,0,3812,G
2-PB1,1943,0,1,0,3858,3859,C
2-PB1,1944,5,1,1,3854,3861,C
2-PB1,1945,9,1,2,3843,3855,C
2-PB1,1946,3829,2,1,0,3832,A
2-PB1,1947,0,3840,0,1,3841,T
2-PB1,1948,0,3,3837,0,3840,G
2-PB1,1949,1,0,3887,0,3888,G
2-PB1,1950,0,3891,0,2,3893,T
2-PB1,1951,1,0,1,3788,3790,C
2-PB1,1952,6,1,0,3715,3722,C
2-PB1,1953,0,3694,2,5,3701,T
2-PB1,1954,3,0,3777,0,3780,G
2-PB1,1955,0,0,0,3762,3762,C
2-PB1,1956,6,1,0,3759,3766,C
2-PB1,1957,3760,2,3,0,3765,A
2-PB1,1958,3731,0,0,0,3731,A
2-PB1,1959,3730,1,0,0,3731,A
2-PB1,1960,3735,1,2,0,3738,A
2-PB1,1961,1,1,3789,0,3791,G
2-PB1,1962,0,3732,0,2,3734,T
2-PB1,1963,3728,0,1,1,3730,A
2-PB1,1964,0,3729,0,3,3732,T
2-PB1,1965,1,6,3719,0,3726,G
2-PB1,1966,0,2,3801,0,3803,G
2-PB1,1967,3783,0,0,0,3783,A
2-PB1,1968,3818,0,0,0,3818,A
2-PB1,1969,1,3787,0,2,3790,T
2-PB1,1970,3742,0,1,0,3743,A
2-PB1,1971,1,3734,0,1,3736,T
2-PB1,1972,1,3,3719,0,3723,G
2-PB1,1973,3724,0,5,0,3729,A
2-PB1,1974,1,3711,0,0,3712,T
2-PB1,1975,1,0,3602,0,3603,G
2-PB1,1976,0,1,0,3605,3606,C
2-PB1,1977,8,4,0,3548,3560,C
2-PB1,1978,0,2,3564,0,3566,G
2-PB1,1979,1,3558,0,4,3563,T
2-PB1,1980,0,3568,0,0,3568,T
2-PB1,1981,2,1,3565,0,3568,G
2-PB1,1982,2,5,0,3621,3628,C
2-PB1,1983,3619,0,6,0,3625,A
2-PB1,1984,3661,0,1,0,3662,A
2-PB1,1985,0,0,1,3688,3689,C
2-PB1,1986,0,3668,1,0,3669,T
2-PB1,1987,3672,0,3,0,3675,A
2-PB1,1988,1,1,0,3668,3670,C
2-PB1,1989,3660,1,6,0,3667,A
2-PB1,1990,3,0,0,3668,3671,C
2-PB1,1991,3560,1,0,0,3561,A
2-PB1,1992,0,0,1,3824,3825,C
2-PB1,1993,0,3759,1,3,3763,T
2-PB1,1994,5,0,1,3770,3776,C
2-PB1,1995,5,1,0,3768,3774,C
2-PB1,1996,1,3754,0,5,3760,T
2-PB1,1997,3,5,3743,1,3752,G
2-PB1,1998,3,6,3741,0,3750,G
2-PB1,1999,3741,0,1,0,3742,A
2-PB1,2000,0,3744,0,1,3745,T
2-PB1,2001,2,3392,0,3,3397,T
2-PB1,2002,5,2,0,3431,3438,C
2-PB1,2003,2,1,0,3419,3422,C
2-PB1,2004,3,0,0,3426,3429,C
2-PB1,2005,3433,0,0,0,3433,A
2-PB1,2006,3429,1,0,0,3430,A
2-PB1,2007,0,7,3424,0,3431,G
2-PB1,2008,3416,0,1,0,3417,A
2-PB1,2009,3,1,3408,0,3412,G
2-PB1,2010,0,3,3398,1,3402,G
2-PB1,2011,3344,1,3,1,3349,A
2-PB1,2012,3342,1,11,0,3354,A
2-PB1,2013,1,1,1,3351,3354,C
2-PB1,2014,0,0,0,3335,3335,C
2-PB1,2015,2,2,3384,0,3388,G
2-PB1,2016,0,0,0,3387,3387,C
2-PB1,2017,1,3388,0,0,3389,T
2-PB1,2018,4,1,0,3395,3400,C
2-PB1,2019,0,3376,0,2,3378,T
2-PB1,2020,3630,1,1,0,3632,A
2-PB1,2021,1,3624,1,4,3630,T
2-PB1,2022,0,3649,0,0,3649,T
2-PB1,2023,5,1,0,3648,3654,C
2-PB1,2024,1,3531,0,0,3532,T
2-PB1,2025,3529,0,3,0,3532,A
2-PB1,2026,3526,0,0,0,3526,A
2-PB1,2027,3525,1,1,0,3527,A
2-PB1,2028,0,0,0,3529,3529,C
2-PB1,2029,3272,1,2,0,3275,A
2-PB1,2030,1,2,0,3267,3270,C
2-PB1,2031,3229,1,0,1,3231,A
2-PB1,2032,3252,1,6,0,3259,A
2-PB1,2033,0,3,3272,1,3276,G
2-PB1,2034,2,1,1,3266,3270,C
2-PB1,2035,2,0,0,3276,3278,C
2-PB1,2036,3251,1,0,0,3252,A
2-PB1,2037,3256,0,1,1,3258,A
2-PB1,2038,3251,1,1,0,3253,A
2-PB1,2039,0,8,3261,0,3269,G
2-PB1,2040,1,8,3264,0,3273,G
2-PB1,2041,1,1,3227,0,3229,G
2-PB1,2042,1,3,3226,2,3232,G
2-PB1,2043,3227,0,0,0,3227,A
2-PB1,2044,3243,1,2,0,3246,A
2-PB1,2045,0,3230,1,0,3231,T
2-PB1,2046,0,3247,0,1,3248,T
2-PB1,2047,3,1,0,3260,3264,C
2-PB1,2048,1,3221,0,3,3225,T
2-PB1,2049,1,3232,0,0,3233,T
2-PB1,2050,0,3,3227,0,3230,G
2-PB1,2051,3228,0,6,0,3234,A
2-PB1,2052,0,5,3242,1,3248,G
2-PB1,2053,0,1,3242,0,3243,G
2-PB1,2054,3231,0,3,0,3234,A
2-PB1,2055,1,3214,0,1,3216,T
2-PB1,2056,1,1,3219,0,3221,G
2-PB1,2057,3213,0,5,0,3218,A
2-PB1,2058,3215,3,3,0,3221,A
2-PB1,2059,0,1,0,3238,3239,C
2-PB1,2060,3190,1,1,0,3192,A
2-PB1,2061,1,1,3227,1,3230,G
2-PB1,2062,3204,0,4,0,3208,A
2-PB1,2063,1,3198,0,3,3202,T
2-PB1,2064,3,0,3211,0,3214,G
2-PB1,2065,0,3237,0,2,3239,T
2-PB1,2066,3251,0,4,0,3255,A
2-PB1,2067,1,1,0,3248,3250,C
2-PB1,2068,6,1,0,3211,3218,C
2-PB1,2069,3184,0,0,0,3184,A
2-PB1,2070,1,2,3145,0,3148,G
2-PB1,2071,3110,0,2,0,3112,A
2-PB1,2072,3105,0,1,0,3106,A
2-PB1,2073,0,0,3118,0,3118,G
2-PB1,2074,0,2930,0,0,2930,T
2-PB1,2075,0,2,2926,1,2929,G
2-PB1,2076,0,1,0,2929,2930,C
2-PB1,2077,1,2916,0,6,2923,T
2-PB1,2078,0,1,2926,0,2927,G
2-PB1,2079,0,1,0,2914,2915,C
2-PB1,2080,2913,0,1,0,2914,A
2-PB1,2081,2914,0,1,0,2915,A
2-PB1,2082,0,1,0,2859,2860,C
2-PB1,2083,0,2856,0,2,2858,T
2-PB1,2084,1,2830,0,0,2831,T
2-PB1,2085,0,1,2826,0,2827,G
2-PB1,2086,0,2818,0,0,2818,T
2-PB1,2087,1,2819,0,0,2820,T
2-PB1,2088,3,0,2,2813,2818,C
2-PB1,2089,0,5,2805,0,2810,G
2-PB1,2090,2804,1,0,0,2805,A
2-PB1,2091,0,2,2803,0,2805,G
2-PB1,2092,2803,0,0,0,2803,A
2-PB1,2093,2804,0,0,0,2804,A
2-PB1,2094,2801,0,2,2,2805,A
2-PB1,2095,1,2799,0,0,2800,T
2-PB1,2096,1,2806,0,0,2807,T
2-PB1,2097,0,2802,1,2,2805,T
2-PB1,2098,0,2818,0,2,2820,T
2-PB1,2099,1,2806,1,1,2809,T
2-PB1,2100,1,0,0,2819,2820,C
2-PB1,2101,1,0,1,2831,2833,C
2-PB1,2102,11,0,0,2824,2835,C
2-PB1,2103,0,2819,1,1,2821,T
2-PB1,2104,2822,0,0,0,2822,A
2-PB1,2105,1,0,2841,0,2842,G
2-PB1,2106,0,2832,0,0,2832,T
2-PB1,2107,2855,0,0,1,2856,A
2-PB1,2108,2,1,2876,0,2879,G
2-PB1,2109,0,2845,0,1,2846,T
2-PB1,2110,1,2957,1,2,2961,T
2-PB1,2111,9,0,0,2958,2967,C
2-PB1,2112,3004,1,1,0,3006,A
2-PB1,2113,1,3011,0,0,3012,T
2-PB1,2114,3025,0,1,1,3027,A
2-PB1,2115,1,3020,0,2,3023,T
2-PB1,2116,2904,0,0,0,2904,A
2-PB1,2117,0,3,2888,0,2891,G
2-PB1,2118,1,1,2871,0,2873,G
2-PB1,2119,2551,0,1,0,2552,A
2-PB1,2120,0,9,2545,0,2554,G
2-PB1,2121,2393,1,0,0,2394,A
2-PB1,2122,2,1,0,2384,2387,C
2-PB1,2123,2,2,0,2290,2294,C
2-PB1,2124,0,0,2290,0,2290,G
2-PB1,2125,2281,1,0,0,2282,A
2-PB1,2126,0,2261,0,1,2262,T
2-PB1,2127,0,2266,0,0,2266,T
2-PB1,2128,0,1,2267,0,2268,G
2-PB1,2129,0,4,2264,0,2268,G
2-PB1,2130,2269,1,0,0,2270,A
2-PB1,2131,2272,1,0,0,2273,A
2-PB1,2132,0,2260,0,0,2260,T
2-PB1,2133,0,2263,0,0,2263,T
2-PB1,2134,0,2263,0,1,2264,T
2-PB1,2135,2,0,0,2260,2262,C
2-PB1,2136,0,2263,1,0,2264,T
2-PB1,2137,2256,0,1,0,2257,A
2-PB1,2138,0,0,2258,0,2258,G
2-PB1,2139,0,0,0,2246,2246,C
2-PB1,2140,2240,0,0,0,2240,A
2-PB1,2141,0,2225,0,0,2225,T
2-PB1,2142,0,1,2188,0,2189,G
2-PB1,2143,0,0,2239,0,2239,G
2-PB1,2144,1,2225,0,1,2227,T
2-PB1,2145,0,2,2222,0,2224,G
2-PB1,2146,0,3,2216,0,2219,G
2-PB1,2147,2187,0,4,0,2191,A
2-PB1,2148,0,3,2192,0,2195,G
2-PB1,2149,1,0,2195,0,2196,G
2-PB1,2150,0,1,0,2186,2187,C
2-PB1,2151,2,0,0,2174,2176,C
2-PB1,2152,2019,1,0,1,2021,A
2-PB1,2153,0,2011,0,3,2014,T
2-PB1,2154,1,1,2030,0,2032,G
2-PB1,2155,1,0,2041,0,2042,G
2-PB1,2156,0,1993,0,1,1994,T
2-PB1,2157,0,0,2018,0,2018,G
2-PB1,2158,0,1971,0,2,1973,T
2-PB1,2159,2,0,0,1956,1958,C
2-PB1,2160,1,1957,0,3,1961,T
2-PB1,2161,1934,0,1,0,1935,A
2-PB1,2162,2,3,1931,1,1937,G
2-PB1,2163,1,1,1885,0,1887,G
2-PB1,2164,0,0,1862,0,1862,G
2-PB1,2165,0,0,0,1830,1830,C
2-PB1,2166,2,0,0,1744,1746,C
2-PB1,2167,4,1,0,1710,1715,C
2-PB1,2168,1,4,1707,0,1712,G
2-PB1,2169,0,1,1713,0,1714,G
2-PB1,2170,1713,0,0,0,1713,A
2-PB1,2171,0,1707,0,1,1708,T
2-PB1,2172,1,1634,0,1,1636,T
2-PB1,2173,0,2,1621,0,1623,G
2-PB1,2174,1617,0,2,0,1619,A
2-PB1,2175,0,1618,0,0,1618,T
2-PB1,2176,0,0,1619,0,1619,G
2-PB1,2177,0,1,0,1604,1605,C
2-PB1,2178,1,0,0,1594,1595,C
2-PB1,2179,1589,0,1,0,1590,A
2-PB1,2180,0,1,1588,0,1589,G
2-PB1,2181,1590,0,0,1,1591,A
2-PB1,2182,1589,0,0,0,1589,A
2-PB1,2183,0,1582,0,1,1583,T
2-PB1,2184,0,1535,1,4,1540,T
2-PB1,2185,0,1,1542,0,1543,G
2-PB1,2186,1539,0,1,0,1540,A
2-PB1,2187,0,0,0,1538,1538,C
2-PB1,2188,0,1521,0,0,1521,T
2-PB1,2189,0,1504,0,0,1504,T
2-PB1,2190,4,0,0,1492,1496,C
2-PB1,2191,1,2,1493,0,1496,G
2-PB1,2192,1491,0,1,0,1492,A
2-PB1,2193,0,0,1460,0,1460,G
2-PB1,2194,0,2,0,1452,1454,C
2-PB1,2195,4,0,0,1472,1476,C
2-PB1,2196,0,1481,0,0,1481,T
2-PB1,2197,1,1,1480,1,1483,G
2-PB1,2198,0,0,1481,0,1481,G
2-PB1,2199,1482,1,1,0,1484,A
2-PB1,2200,1328,0,0,1,1329,A
2-PB1,2201,0,1,1327,0,1328,G
2-PB1,2202,0,1,1336,0,1337,G
2-PB1,2203,1337,0,1,0,1338,A
2-PB1,2204,0,1335,0,0,1335,T
2-PB1,2205,1,1332,0,0,1333,T
2-PB1,2206,1327,0,0,0,1327,A
2-PB1,2207,1324,0,0,0,1324,A
2-PB1,2208,1210,0,3,0,1213,A
2-PB1,2209,1217,0,2,1,1220,A
2-PB1,2210,1220,0,0,0,1220,A
2-PB1,2211,0,0,1216,0,1216,G
2-PB1,2212,0,0,1205,0,1205,G
2-PB1,2213,1209,0,0,1,1210,A
2-PB1,2214,1209,0,0,0,1209,A
2-PB1,2215,0,2,1206,0,1208,G
2-PB1,2216,1129,0,0,0,1129,A
2-PB1,2217,0,0,1131,0,1131,G
2-PB1,2218,0,1101,0,0,1101,T
2-PB1,2219,1,1097,0,0,1098,T
2-PB1,2220,1,1,0,1100,1102,C
2-PB1,2221,1,1078,1,0,1080,T
2-PB1,2222,3,1,0,1075,1079,C
2-PB1,2223,0,1073,0,0,1073,T
2-PB1,2224,1,1,1067,0,1069,G
2-PB1,2225,1048,0,2,0,1050,A
2-PB1,2226,0,1,1035,0,1036,G
2-PB1,2227,1024,0,0,0,1024,A
2-PB1,2228,0,993,0,0,993,T
2-PB1,2229,3,1,0,937,941,C
2-PB1,2230,945,0,0,0,945,A
2-PB1,2231,0,939,0,2,941,T
2-PB1,2232,0,2,940,0,942,G
2-PB1,2233,938,0,1,0,939,A
2-PB1,2234,931,0,1,0,932,A
2-PB1,2235,0,1,914,0,915,G
2-PB1,2236,902,0,1,0,903,A
2-PB1,2237,0,898,0,0,898,T
2-PB1,2238,0,0,0,890,890,C
2-PB1,2239,0,837,0,2,839,T
2-PB1,2240,0,0,847,0,847,G
2-PB1,2241,0,844,0,0,844,T
2-PB1,2242,2,838,0,0,840,T
2-PB1,2243,1,0,0,835,836,C
2-PB1,2244,0,0,0,796,796,C
2-PB1,2245,790,1,0,0,791,A
2-PB1,2246,2,0,0,793,795,C
2-PB1,2247,0,0,0,764,764,C
2-PB1,2248,746,0,0,0,746,A
2-PB1,2249,1,701,0,0,702,T
2-PB1,2250,0,677,0,1,678,T
2-PB1,2251,0,0,680,0,680,G
2-PB1,2252,677,1,1,0,679,A
2-PB1,2253,678,0,1,0,679,A
2-PB1,2254,0,0,676,0,676,G
2-PB1,2255,579,0,0,0,579,A
2-PB1,2256,575,0,0,1,576,A
2-PB1,2257,0,1,0,569,570,C
2-PB1,2258,0,545,2,1,548,T
2-PB1,2259,0,1,0,545,546,C
2-PB1,2260,517,0,2,0,519,A
2-PB1,2261,0,0,516,0,516,G
2-PB1,2262,516,0,1,0,517,A
2-PB1,2263,1,0,0,492,493,C
2-PB1,2264,1,1,478,0,480,G
2-PB1,2265,0,0,463,0,463,G
2-PB1,2266,0,0,0,462,462,C
2-PB1,2267,461,0,0,1,462,A
2-PB1,2268,462,0,0,0,462,A
2-PB1,2269,459,0,1,0,460,A
2-PB1,2270,460,1,0,0,461,A
2-PB1,2271,456,0,0,0,456,A
2-PB1,2272,0,432,0,0,432,T
2-PB1,2273,414,0,0,0,414,A
2-PB1,2274,411,0,0,0,411,A
3-PA,1,17,0,0,0,17,A
3-PA,2,0,17,0,0,17,T
3-PA,3,0,0,18,0,18,G
3-PA,4,0,0,18,0,18,G
3-PA,5,18,0,0,0,18,A
3-PA,6,18,0,0,0,18,A
3-PA,7,0,0,19,0,19,G
3-PA,8,20,0,0,0,20,A
3-PA,9,0,20,0,0,20,T
3-PA,10,0,20,0,0,20,T
3-PA,11,0,20,0,0,20,T
3-PA,12,0,21,0,0,21,T
3-PA,13,0,0,21,0,21,G
3-PA,14,0,21,0,0,21,T
3-PA,15,0,0,21,0,21,G
3-PA,16,0,0,0,22,22,C
3-PA,17,0,0,22,0,22,G
3-PA,18,25,0,0,0,25,A
3-PA,19,0,0,0,25,25,C
3-PA,20,25,0,0,0,25,A
3-PA,21,26,0,0,0,26,A
3-PA,22,0,27,0,0,27,T
3-PA,23,0,0,31,0,31,G
3-PA,24,0,0,0,31,31,C
3-PA,25,0,31,0,0,31,T
3-PA,26,0,31,0,0,31,T
3-PA,27,0,0,0,31,31,C
3-PA,28,32,0,0,0,32,A
3-PA,29,33,0,0,0,33,A
3-PA,30,0,0,0,33,33,C
3-PA,31,0,0,0,33,33,C
3-PA,32,0,0,0,33,33,C
3-PA,33,0,0,33,0,33,G
3-PA,34,33,0,0,0,33,A
3-PA,35,0,33,0,0,33,T
3-PA,36,0,0,33,0,33,G
3-PA,37,33,0,0,0,33,A
3-PA,38,0,34,0,0,34,T
3-PA,39,0,33,0,0,33,T
3-PA,40,0,0,33,0,33,G
3-PA,41,0,33,0,0,33,T
3-PA,42,0,0,0,33,33,C
3-PA,43,0,0,33,0,33,G
3-PA,44,34,0,0,0,34,A
3-PA,45,34,0,0,0,34,A
3-PA,46,0,0,0,34,34,C
3-PA,47,0,34,0,0,34,T
3-PA,48,0,34,0,0,34,T
3-PA,49,0,0,34,0,34,G
3-PA,50,0,0,0,33,33,C
3-PA,51,34,0,0,0,34,A
3-PA,52,0,0,34,0,34,G
3-PA,53,34,0,0,0,34,A
3-PA,54,8,0,25,0,33,G
3-PA,55,35,0,0,0,35,A
3-PA,56,36,0,0,0,36,A
3-PA,57,36,0,0,0,36,A
3-PA,58,0,0,36,0,36,G
3-PA,59,0,0,0,40,40,C
3-PA,60,40,0,0,0,40,A
3-PA,61,42,0,0,0,42,A
3-PA,62,0,42,0,0,42,T
3-PA,63,0,0,43,0,43,G
3-PA,64,44,0,0,0,44,A
3-PA,65,44,0,0,0,44,A
3-PA,66,44,0,0,0,44,A
3-PA,67,0,1,50,0,51,G
3-PA,68,51,0,0,0,51,A
3-PA,69,0,0,59,0,59,G
3-PA,70,0,59,0,0,59,T
3-PA,71,60,0,0,0,60,A
3-PA,72,0,60,0,0,60,T
3-PA,73,0,1,60,0,61,G
3-PA,74,0,0,61,0,61,G
3-PA,75,0,0,61,0,61,G
3-PA,76,0,0,61,0,61,G
3-PA,77,61,0,0,0,61,A
3-PA,78,0,0,61,0,61,G
3-PA,79,0,0,62,0,62,G
3-PA,80,62,0,0,0,62,A
3-PA,81,0,62,0,0,62,T
3-PA,82,0,0,0,62,62,C
3-PA,83,0,58,0,0,58,T
3-PA,84,0,0,59,0,59,G
3-PA,85,59,0,0,0,59,A
3-PA,86,59,0,0,0,59,A
3-PA,87,59,0,0,0,59,A
3-PA,88,59,0,0,0,59,A
3-PA,89,0,59,0,0,59,T
3-PA,90,0,59,0,0,59,T
3-PA,91,0,0,58,0,58,G
3-PA,92,59,0,0,0,59,A
3-PA,93,59,0,0,0,59,A
3-PA,94,59,0,0,0,59,A
3-PA,95,0,0,0,59,59,C
3-PA,96,59,0,0,0,59,A
3-PA,97,58,0,0,0,58,A
3-PA,98,59,0,0,0,59,A
3-PA,99,0,0,0,59,59,C
3-PA,100,59,0,0,0,59,A
3-PA,101,59,0,0,0,59,A
3-PA,102,60,0,0,0,60,A
3-PA,103,0,60,0,0,60,T
3-PA,104,0,60,0,0,60,T
3-PA,105,0,59,0,0,59,T
3-PA,106,0,0,59,0,59,G
3-PA,107,0,1,0,57,58,C
3-PA,108,59,0,0,0,59,A
3-PA,109,0,0,60,0,60,G
3-PA,110,0,0,0,63,63,C
3-PA,111,65,0,0,0,65,A
3-PA,112,65,0,0,0,65,A
3-PA,113,0,65,0,0,65,T
3-PA,114,67,0,0,0,67,A
3-PA,115,0,66,0,0,66,T
3-PA,116,0,0,68,0,68,G
3-PA,117,0,0,0,68,68,C
3-PA,118,67,0,0,0,67,A
3-PA,119,0,0,0,69,69,C
3-PA,120,0,69,0,0,69,T
3-PA,121,0,0,0,91,91,C
3-PA,122,97,0,0,0,97,A
3-PA,123,1,0,0,102,103,C
3-PA,124,0,103,0,0,103,T
3-PA,125,0,102,0,0,102,T
3-PA,126,0,0,102,0,102,G
3-PA,127,1,0,102,0,103,G
3-PA,128,102,0,0,0,102,A
3-PA,129,0,0,104,0,104,G
3-PA,130,0,0,104,0,104,G
3-PA,131,0,100,0,0,100,T
3-PA,132,0,0,105,0,105,G
3-PA,133,0,107,0,0,107,T
3-PA,134,0,0,108,0,108,G
3-PA,135,0,108,0,0,108,T
3-PA,136,0,108,0,0,108,T
3-PA,137,0,109,0,0,109,T
3-PA,138,0,0,0,109,109,C
3-PA,139,109,0,0,0,109,A
3-PA,140,0,111,0,0,111,T
3-PA,141,0,0,113,0,113,G
3-PA,142,0,111,0,0,111,T
3-PA,143,111,0,0,0,111,A
3-PA,144,0,110,0,0,110,T
3-PA,145,0,112,0,0,112,T
3-PA,146,0,0,0,112,112,C
3-PA,147,112,0,0,0,112,A
3-PA,148,0,0,113,0,113,G
3-PA,149,113,0,0,0,113,A
3-PA,150,0,113,0,0,113,T
3-PA,151,0,113,0,0,113,T
3-PA,152,0,113,0,0,113,T
3-PA,153,0,0,0,113,113,C
3-PA,154,0,0,0,127,127,C
3-PA,155,129,0,0,0,129,A
3-PA,156,0,130,0,0,130,T
3-PA,157,0,128,0,0,128,T
3-PA,158,0,129,0,0,129,T
3-PA,159,0,0,1,128,129,C
3-PA,160,128,0,1,0,129,A
3-PA,161,0,132,0,0,132,T
3-PA,162,0,0,0,132,132,C
3-PA,163,132,0,0,0,132,A
3-PA,164,134,0,0,0,134,A
3-PA,165,0,134,0,0,134,T
3-PA,166,0,0,134,0,134,G
3-PA,167,134,1,0,0,135,A
3-PA,168,134,0,0,0,134,A
3-PA,169,0,0,0,135,135,C
3-PA,170,134,0,0,0,134,A
3-PA,171,133,0,0,0,133,A
3-PA,172,0,0,134,0,134,G
3-PA,173,0,1,133,0,134,G
3-PA,174,0,0,0,135,135,C
3-PA,175,0,0,135,0,135,G
3-PA,176,142,0,0,0,142,A
3-PA,177,143,0,0,0,143,A
3-PA,178,0,147,0,0,147,T
3-PA,179,0,0,0,146,146,C
3-PA,180,147,0,0,0,147,A
3-PA,181,146,0,0,0,146,A
3-PA,182,0,149,0,0,149,T
3-PA,183,147,0,0,0,147,A
3-PA,184,0,0,153,0,153,G
3-PA,185,0,149,0,0,149,T
3-PA,186,0,0,149,0,149,G
3-PA,187,0,0,150,0,150,G
3-PA,188,0,149,0,0,149,T
3-PA,189,151,0,0,0,151,A
3-PA,190,0,0,153,0,153,G
3-PA,191,152,0,0,0,152,A
3-PA,192,150,0,0,0,150,A
3-PA,193,0,0,0,151,151,C
3-PA,194,0,147,0,0,147,T
3-PA,195,0,147,0,0,147,T
3-PA,196,0,0,149,0,149,G
3-PA,197,147,0,1,0,148,A
3-PA,198,0,1,0,148,149,C
3-PA,199,0,0,150,0,150,G
3-PA,200,151,0,0,0,151,A
3-PA,201,0,155,0,0,155,T
3-PA,202,0,1,0,155,156,C
3-PA,203,0,0,0,157,157,C
3-PA,204,156,0,0,0,156,A
3-PA,205,158,0,0,0,158,A
3-PA,206,156,0,0,0,156,A
3-PA,207,0,157,0,1,158,T
3-PA,208,0,0,157,0,157,G
3-PA,209,0,1,0,155,156,C
3-PA,210,156,0,0,0,156,A
3-PA,211,0,0,0,161,161,C
3-PA,212,0,159,0,1,160,T
3-PA,213,0,0,188,0,188,G
3-PA,214,0,187,0,0,187,T
3-PA,215,0,188,0,0,188,T
3-PA,216,188,0,0,0,188,A
3-PA,217,188,0,0,0,188,A
3-PA,218,188,0,0,0,188,A
3-PA,219,0,0,190,0,190,G
3-PA,220,0,0,0,188,188,C
3-PA,221,188,0,0,0,188,A
3-PA,222,0,1,0,183,184,C
3-PA,223,180,0,0,0,180,A
3-PA,224,0,0,186,0,186,G
3-PA,225,187,0,0,0,187,A
3-PA,226,0,186,0,0,186,T
3-PA,227,0,187,0,0,187,T
3-PA,228,0,185,0,0,185,T
3-PA,229,0,0,186,0,186,G
3-PA,230,189,0,0,0,189,A
3-PA,231,189,0,0,0,189,A
3-PA,232,188,0,0,0,188,A
3-PA,233,0,183,0,0,183,T
3-PA,234,180,0,0,0,180,A
3-PA,235,183,0,1,0,184,A
3-PA,236,0,184,0,0,184,T
3-PA,237,0,0,0,184,184,C
3-PA,238,2,0,182,0,184,G
3-PA,239,182,0,0,0,182,A
3-PA,240,0,0,185,0,185,G
3-PA,241,0,0,190,0,190,G
3-PA,242,0,0,190,0,190,G
3-PA,243,0,0,191,0,191,G
3-PA,244,188,0,0,0,188,A
3-PA,245,0,0,190,0,190,G
3-PA,246,195,0,0,0,195,A
3-PA,247,0,0,196,0,196,G
3-PA,248,194,0,0,0,194,A
3-PA,249,0,0,0,195,195,C
3-PA,250,194,0,0,0,194,A
3-PA,251,0,0,196,0,196,G
3-PA,252,196,0,0,0,196,A
3-PA,253,199,0,0,0,199,A
3-PA,254,0,0,0,198,198,C
3-PA,255,196,0,0,0,196,A
3-PA,256,197,0,0,0,197,A
3-PA,257,0,197,0,0,197,T
3-PA,258,1,2,202,0,205,G
3-PA,259,0,0,204,0,204,G
3-PA,260,0,0,0,205,205,C
3-PA,261,0,0,0,205,205,C
3-PA,262,0,204,0,0,204,T
3-PA,263,0,0,208,0,208,G
3-PA,264,0,0,209,0,209,G
3-PA,265,208,0,0,0,208,A
3-PA,266,0,0,0,209,209,C
3-PA,267,202,0,0,0,202,A
3-PA,268,0,0,200,0,200,G
3-PA,269,0,199,0,1,200,T
3-PA,270,0,0,197,0,197,G
3-PA,271,0,0,222,0,222,G
3-PA,272,1,221,0,0,222,T
3-PA,273,223,0,0,0,223,A
3-PA,274,223,0,0,0,223,A
3-PA,275,224,0,0,0,224,A
3-PA,276,0,0,0,229,229,C
3-PA,277,216,0,0,0,216,A
3-PA,278,0,0,221,0,221,G
3-PA,279,1,214,0,0,215,T
3-PA,280,219,0,2,0,221,A
3-PA,281,0,219,0,1,220,T
3-PA,282,0,0,0,224,224,C
3-PA,283,0,223,0,0,223,T
3-PA,284,1,0,222,0,223,G
3-PA,285,0,0,0,222,222,C
3-PA,286,223,0,0,0,223,A
3-PA,287,223,0,1,0,224,A
3-PA,288,0,0,0,226,226,C
3-PA,289,225,0,0,0,225,A
3-PA,290,0,0,0,233,233,C
3-PA,291,0,234,0,0,234,T
3-PA,292,236,0,0,0,236,A
3-PA,293,0,0,0,236,236,C
3-PA,294,0,234,0,0,234,T
3-PA,295,0,1,233,0,234,G
3-PA,296,0,0,235,0,235,G
3-PA,297,232,0,1,0,233,A
3-PA,298,0,0,233,0,233,G
3-PA,299,0,0,0,228,228,C
3-PA,300,0,226,0,0,226,T
3-PA,301,0,0,223,0,223,G
3-PA,302,0,0,224,0,224,G
3-PA,303,0,0,225,0,225,G
3-PA,304,224,0,0,0,224,A
3-PA,305,225,0,0,0,225,A
3-PA,306,225,0,0,0,225,A
3-PA,307,0,0,0,223,223,C
3-PA,308,0,0,0,222,222,C
3-PA,309,0,0,225,0,225,G
3-PA,310,224,0,0,0,224,A
3-PA,311,223,0,0,0,223,A
3-PA,312,0,0,225,0,225,G
3-PA,313,0,224,0,0,224,T
3-PA,314,0,223,0,0,223,T
3-PA,315,0,223,0,1,224,T
3-PA,316,0,0,0,224,224,C
3-PA,317,0,225,0,0,225,T
3-PA,318,228,0,0,0,228,A
3-PA,319,0,0,0,226,226,C
3-PA,320,0,0,0,228,228,C
3-PA,321,228,0,0,0,228,A
3-PA,322,0,0,234,0,234,G
3-PA,323,236,0,0,0,236,A
3-PA,324,1,235,0,0,236,T
3-PA,325,0,235,0,0,235,T
3-PA,326,0,236,0,0,236,T
3-PA,327,232,0,0,0,232,A
3-PA,328,0,233,0,0,233,T
3-PA,329,232,0,1,0,233,A
3-PA,330,0,233,0,0,233,T
3-PA,331,0,0,229,0,229,G
3-PA,332,239,0,0,0,239,A
3-PA,333,0,238,0,0,238,T
3-PA,334,0,239,0,0,239,T
3-PA,335,238,0,0,0,238,A
3-PA,336,0,0,0,241,241,C
3-PA,337,243,0,0,0,243,A
3-PA,338,242,0,0,0,242,A
3-PA,339,0,0,244,0,244,G
3-PA,340,0,0,247,0,247,G
3-PA,341,236,0,0,0,236,A
3-PA,342,0,1,236,0,237,G
3-PA,343,236,0,1,0,237,A
3-PA,344,237,0,0,0,237,A
3-PA,345,0,0,0,238,238,C
3-PA,346,233,0,0,0,233,A
3-PA,347,0,0,235,0,235,G
3-PA,348,235,0,0,0,235,A
3-PA,349,0,232,0,0,232,T
3-PA,350,0,231,0,0,231,T
3-PA,351,0,0,0,230,230,C
3-PA,352,230,0,0,0,230,A
3-PA,353,0,230,0,0,230,T
3-PA,354,0,0,0,231,231,C
3-PA,355,0,0,232,0,232,G
3-PA,356,232,0,0,0,232,A
3-PA,357,233,0,0,0,233,A
3-PA,358,231,0,0,0,231,A
3-PA,359,0,233,0,0,233,T
3-PA,360,0,231,0,0,231,T
3-PA,361,0,0,231,0,231,G
3-PA,362,0,1,230,0,231,G
3-PA,363,0,0,230,0,230,G
3-PA,364,0,0,234,0,234,G
3-PA,365,0,231,0,0,231,T
3-PA,366,0,1,235,0,236,G
3-PA,367,236,0,0,0,236,A
3-PA,368,0,0,0,240,240,C
3-PA,369,240,0,0,0,240,A
3-PA,370,240,0,0,0,240,A
3-PA,371,0,0,245,0,245,G
3-PA,372,0,1,242,0,243,G
3-PA,373,243,1,0,0,244,A
3-PA,374,0,0,242,1,243,G
3-PA,375,242,0,0,0,242,A
3-PA,376,0,0,244,0,244,G
3-PA,377,241,0,0,0,241,A
3-PA,378,239,0,0,1,240,A
3-PA,379,0,0,243,0,243,G
3-PA,380,0,243,0,0,243,T
3-PA,381,0,0,0,245,245,C
3-PA,382,1,0,0,247,248,C
3-PA,383,247,0,0,0,247,A
3-PA,384,0,0,0,250,250,C
3-PA,385,256,0,1,0,257,A
3-PA,386,0,265,0,0,265,T
3-PA,387,276,0,0,0,276,A
3-PA,388,0,268,0,0,268,T
3-PA,389,268,0,0,1,269,A
3-PA,390,0,268,0,0,268,T
3-PA,391,0,267,0,0,267,T
3-PA,392,280,0,0,0,280,A
3-PA,393,0,0,0,279,279,C
3-PA,394,1,0,0,269,270,C
3-PA,395,0,267,0,0,267,T
3-PA,396,0,258,0,0,258,T
3-PA,397,0,2,255,0,257,G
3-PA,398,256,0,0,0,256,A
3-PA,399,0,0,239,0,239,G
3-PA,400,239,0,2,0,241,A
3-PA,401,240,0,0,0,240,A
3-PA,402,1,0,241,0,242,G
3-PA,403,0,0,242,0,242,G
3-PA,404,0,0,0,239,239,C
3-PA,405,0,0,0,239,239,C
3-PA,406,240,0,0,0,240,A
3-PA,407,240,0,0,0,240,A
3-PA,408,0,239,0,0,239,T
3-PA,409,240,0,0,0,240,A
3-PA,410,240,0,0,0,240,A
3-PA,411,0,1,243,0,244,G
3-PA,412,242,0,0,0,242,A
3-PA,413,0,240,0,0,240,T
3-PA,414,0,240,0,0,240,T
3-PA,415,240,0,0,0,240,A
3-PA,416,240,0,0,0,240,A
3-PA,417,240,0,0,0,240,A
3-PA,418,0,235,0,0,235,T
3-PA,419,0,0,0,238,238,C
3-PA,420,0,232,0,0,232,T
3-PA,421,0,0,231,0,231,G
3-PA,422,230,0,0,0,230,A
3-PA,423,0,0,232,0,232,G
3-PA,424,232,0,0,0,232,A
3-PA,425,235,0,0,0,235,A
3-PA,426,0,0,0,236,236,C
3-PA,427,235,0,0,0,235,A
3-PA,428,0,0,0,236,236,C
3-PA,429,235,0,0,0,235,A
3-PA,430,0,0,0,237,237,C
3-PA,431,235,0,0,0,235,A
3-PA,432,0,0,0,238,238,C
3-PA,433,235,0,0,0,235,A
3-PA,434,0,235,0,0,235,T
3-PA,435,0,236,0,0,236,T
3-PA,436,0,0,0,237,237,C
3-PA,437,235,0,0,0,235,A
3-PA,438,0,0,0,238,238,C
3-PA,439,236,0,0,0,236,A
3-PA,440,0,235,0,0,235,T
3-PA,441,0,228,0,0,228,T
3-PA,442,1,230,0,0,231,T
3-PA,443,0,231,0,0,231,T
3-PA,444,0,0,0,232,232,C
3-PA,445,0,227,0,1,228,T
3-PA,446,0,0,0,229,229,C
3-PA,447,229,0,0,0,229,A
3-PA,448,0,229,0,0,229,T
3-PA,449,0,230,0,0,230,T
3-PA,450,1,0,0,232,233,C
3-PA,451,230,0,0,0,230,A
3-PA,452,0,0,0,233,233,C
3-PA,453,0,231,0,0,231,T
3-PA,454,0,0,230,0,230,G
3-PA,455,0,0,231,0,231,G
3-PA,456,224,0,1,0,225,A
3-PA,457,0,0,234,0,234,G
3-PA,458,233,0,0,0,233,A
3-PA,459,0,0,235,0,235,G
3-PA,460,0,0,235,0,235,G
3-PA,461,234,0,0,0,234,A
3-PA,462,233,0,0,0,233,A
3-PA,463,231,0,0,0,231,A
3-PA,464,0,229,0,0,229,T
3-PA,465,0,0,227,0,227,G
3-PA,466,0,0,229,0,229,G
3-PA,467,0,0,0,230,230,C
3-PA,468,0,0,0,229,229,C
3-PA,469,229,0,0,0,229,A
3-PA,470,0,0,0,231,231,C
3-PA,471,229,0,1,2,232,A
3-PA,472,234,0,0,0,234,A
3-PA,473,234,0,0,0,234,A
3-PA,474,0,1,232,0,233,G
3-PA,475,0,0,234,0,234,G
3-PA,476,0,0,0,235,235,C
3-PA,477,231,0,1,0,232,A
3-PA,478,0,2,234,0,236,G
3-PA,479,234,1,0,0,235,A
3-PA,480,0,0,0,236,236,C
3-PA,481,0,236,0,0,236,T
3-PA,482,235,0,0,0,235,A
3-PA,483,0,0,0,235,235,C
3-PA,484,233,0,0,0,233,A
3-PA,485,0,0,0,234,234,C
3-PA,486,0,225,0,0,225,T
3-PA,487,0,0,0,226,226,C
3-PA,488,0,226,0,0,226,T
3-PA,489,1,0,0,222,223,C
3-PA,490,0,1,221,0,222,G
3-PA,491,221,0,0,0,221,A
3-PA,492,0,0,0,220,220,C
3-PA,493,0,1,222,0,223,G
3-PA,494,219,0,0,0,219,A
3-PA,495,0,0,219,0,219,G
3-PA,496,0,1,216,0,217,G
3-PA,497,218,0,0,0,218,A
3-PA,498,218,0,0,0,218,A
3-PA,499,218,0,0,0,218,A
3-PA,500,0,0,218,0,218,G
3-PA,501,0,0,0,216,216,C
3-PA,502,211,1,0,0,212,A
3-PA,503,0,1,214,0,215,G
3-PA,504,0,0,212,0,212,G
3-PA,505,0,0,211,0,211,G
3-PA,506,0,0,0,211,211,C
3-PA,507,0,210,0,0,210,T
3-PA,508,209,0,0,0,209,A
3-PA,509,0,1,212,0,213,G
3-PA,510,0,0,226,0,226,G
3-PA,511,229,0,0,0,229,A
3-PA,512,0,223,0,0,223,T
3-PA,513,0,223,0,0,223,T
3-PA,514,223,0,0,0,223,A
3-PA,515,226,0,0,0,226,A
3-PA,516,0,0,227,0,227,G
3-PA,517,226,0,0,0,226,A
3-PA,518,0,0,0,227,227,C
3-PA,519,0,0,0,207,207,C
3-PA,520,207,0,0,0,207,A
3-PA,521,0,0,209,0,209,G
3-PA,522,2,0,207,0,209,G
3-PA,523,0,0,0,207,207,C
3-PA,524,0,202,0,0,202,T
3-PA,525,0,0,211,0,211,G
3-PA,526,0,209,0,0,209,T
3-PA,527,0,209,0,0,209,T
3-PA,528,0,211,0,0,211,T
3-PA,529,212,0,0,0,212,A
3-PA,530,0,1,0,209,210,C
3-PA,531,1,0,0,206,207,C
3-PA,532,207,0,0,0,207,A
3-PA,533,0,207,0,0,207,T
3-PA,534,197,0,0,0,197,A
3-PA,535,200,0,0,0,200,A
3-PA,536,0,1,200,0,201,G
3-PA,537,200,0,0,0,200,A
3-PA,538,0,0,0,202,202,C
3-PA,539,197,0,1,0,198,A
3-PA,540,198,0,0,0,198,A
3-PA,541,0,0,199,0,199,G
3-PA,542,200,0,0,0,200,A
3-PA,543,199,0,0,0,199,A
3-PA,544,198,0,0,0,198,A
3-PA,545,0,191,0,0,191,T
3-PA,546,0,0,192,0,192,G
3-PA,547,0,0,193,0,193,G
3-PA,548,0,0,0,194,194,C
3-PA,549,0,0,0,194,194,C
3-PA,550,194,0,0,0,194,A
3-PA,551,205,0,0,0,205,A
3-PA,552,0,0,0,207,207,C
3-PA,553,205,0,0,0,205,A
3-PA,554,0,0,205,0,205,G
3-PA,555,199,0,0,0,199,A
3-PA,556,0,1,203,0,204,G
3-PA,557,0,0,206,0,206,G
3-PA,558,0,0,0,203,203,C
3-PA,559,2,0,0,200,202,C
3-PA,560,0,201,0,0,201,T
3-PA,561,199,1,1,0,201,A
3-PA,562,0,203,0,0,203,T
3-PA,563,0,0,203,0,203,G
3-PA,564,0,0,204,0,204,G
3-PA,565,0,0,202,0,202,G
3-PA,566,196,0,0,0,196,A
3-PA,567,0,194,0,0,194,T
3-PA,568,0,191,0,0,191,T
3-PA,569,0,0,0,301,301,C
3-PA,570,0,0,0,301,301,C
3-PA,571,0,306,0,0,306,T
3-PA,572,0,308,0,0,308,T
3-PA,573,0,309,0,0,309,T
3-PA,574,0,3,0,323,326,C
3-PA,575,0,1,325,0,326,G
3-PA,576,0,327,0,0,327,T
3-PA,577,2,1,0,326,329,C
3-PA,578,324,0,0,0,324,A
3-PA,579,0,0,450,0,450,G
3-PA,580,0,453,0,0,453,T
3-PA,581,0,0,0,452,452,C
3-PA,582,0,0,0,457,457,C
3-PA,583,0,1,461,0,462,G
3-PA,584,464,0,0,0,464,A
3-PA,585,462,0,0,0,462,A
3-PA,586,465,0,0,0,465,A
3-PA,587,0,1,479,0,480,G
3-PA,588,474,0,0,0,474,A
3-PA,589,0,0,491,0,491,G
3-PA,590,0,0,494,0,494,G
3-PA,591,1,0,0,494,495,C
3-PA,592,1,1,496,0,498,G
3-PA,593,499,0,0,0,499,A
3-PA,594,500,0,1,0,501,A
3-PA,595,0,0,509,1,510,G
3-PA,596,516,0,0,0,516,A
3-PA,597,516,0,0,0,516,A
3-PA,598,510,0,0,0,510,A
3-PA,599,0,0,0,520,520,C
3-PA,600,520,0,0,0,520,A
3-PA,601,521,0,0,0,521,A
3-PA,602,0,518,0,0,518,T
3-PA,603,0,518,0,0,518,T
3-PA,604,0,1,518,0,519,G
3-PA,605,520,0,1,0,521,A
3-PA,606,518,0,0,0,518,A
3-PA,607,0,1,520,0,521,G
3-PA,608,520,1,0,0,521,A
3-PA,609,521,1,0,0,522,A
3-PA,610,522,0,0,0,522,A
3-PA,611,519,0,1,1,521,A
3-PA,612,521,0,1,1,523,A
3-PA,613,0,523,0,0,523,T
3-PA,614,0,521,0,0,521,T
3-PA,615,0,525,0,0,525,T
3-PA,616,0,0,524,0,524,G
3-PA,617,526,0,0,1,527,A
3-PA,618,527,1,1,0,529,A
3-PA,619,526,0,1,1,528,A
3-PA,620,0,547,0,0,547,T
3-PA,621,0,0,0,649,649,C
3-PA,622,655,0,0,1,656,A
3-PA,623,0,0,0,671,671,C
3-PA,624,666,0,0,0,666,A
3-PA,625,0,0,692,0,692,G
3-PA,626,0,1,740,0,741,G
3-PA,627,758,1,0,0,759,A
3-PA,628,776,0,0,0,776,A
3-PA,629,0,0,0,786,786,C
3-PA,630,0,776,0,3,779,T
3-PA,631,861,0,0,1,862,A
3-PA,632,0,888,0,0,888,T
3-PA,633,1,1,935,0,937,G
3-PA,634,0,0,0,936,936,C
3-PA,635,1,0,933,0,934,G
3-PA,636,0,932,0,2,934,T
3-PA,637,934,0,0,1,935,A
3-PA,638,0,0,941,0,941,G
3-PA,639,0,2,937,0,939,G
3-PA,640,0,0,0,938,938,C
3-PA,641,0,933,0,1,934,T
3-PA,642,0,924,0,1,925,T
3-PA,643,0,0,929,0,929,G
3-PA,644,0,0,0,935,935,C
3-PA,645,1,0,0,934,935,C
3-PA,646,0,3,949,0,952,G
3-PA,647,956,0,0,0,956,A
3-PA,648,0,0,0,964,964,C
3-PA,649,4,0,0,955,959,C
3-PA,650,962,0,0,1,963,A
3-PA,651,965,0,2,0,967,A
3-PA,652,965,0,0,1,966,A
3-PA,653,0,0,1001,0,1001,G
3-PA,654,0,999,1,0,1000,T
3-PA,655,2,0,0,1007,1009,C
3-PA,656,0,1002,0,0,1002,T
3-PA,657,2,0,0,1003,1005,C
3-PA,658,0,0,0,1010,1010,C
3-PA,659,1,0,0,1012,1013,C
3-PA,660,1016,0,0,0,1016,A
3-PA,661,0,1,1,1019,1021,C
3-PA,662,0,0,0,1011,1011,C
3-PA,663,0,3,1021,0,1024,G
3-PA,664,1041,0,0,1,1042,A
3-PA,665,1041,0,3,1,1045,A
3-PA,666,0,0,1,1052,1053,C
3-PA,667,1,1046,0,0,1047,T
3-PA,668,1,1077,0,1,1079,T
3-PA,669,3,0,0,1098,1101,C
3-PA,670,1,1089,2,2,1094,T
3-PA,671,5,0,0,1093,1098,C
3-PA,672,1,1,0,1096,1098,C
3-PA,673,0,1092,0,0,1092,T
3-PA,674,0,0,1114,0,1114,G
3-PA,675,2,0,0,1108,1110,C
3-PA,676,2,0,0,1114,1116,C
3-PA,677,1,1112,0,0,1113,T
3-PA,678,0,1108,0,1,1109,T
3-PA,679,0,2,1114,0,1116,G
3-PA,680,1115,0,0,1,1116,A
3-PA,681,0,1,1139,0,1140,G
3-PA,682,1139,0,2,1,1142,A
3-PA,683,1154,0,0,1,1155,A
3-PA,684,0,1195,0,0,1195,T
3-PA,685,0,1197,0,1,1198,T
3-PA,686,0,1200,0,0,1200,T
3-PA,687,0,1202,0,1,1203,T
3-PA,688,1197,0,0,0,1197,A
3-PA,689,3,0,1203,0,1206,G
3-PA,690,1202,0,0,0,1202,A
3-PA,691,0,1,1256,0,1257,G
3-PA,692,1,0,0,1249,1250,C
3-PA,693,1,1,0,1251,1253,C
3-PA,694,0,1283,0,0,1283,T
3-PA,695,1348,0,0,0,1348,A
3-PA,696,0,1347,1,0,1348,T
3-PA,697,0,0,1367,0,1367,G
3-PA,698,0,1366,1,2,1369,T
3-PA,699,0,3,1367,0,1370,G
3-PA,700,1,0,1366,0,1367,G
3-PA,701,1362,2,2,0,1366,A
3-PA,702,0,1360,0,0,1360,T
3-PA,703,0,2,1348,0,1350,G
3-PA,704,0,2,1406,0,1408,G
3-PA,705,1409,0,0,0,1409,A
3-PA,706,0,1402,1,0,1403,T
3-PA,707,0,1396,0,0,1396,T
3-PA,708,4,0,0,1393,1397,C
3-PA,709,0,6,1386,0,1392,G
3-PA,710,1393,0,0,0,1393,A
3-PA,711,1394,0,2,0,1396,A
3-PA,712,0,1,0,1409,1410,C
3-PA,713,1,1,0,1382,1384,C
3-PA,714,0,2,1386,0,1388,G
3-PA,715,1389,0,0,0,1389,A
3-PA,716,1392,0,1,0,1393,A
3-PA,717,0,2,0,1399,1401,C
3-PA,718,1,1,1394,0,1396,G
3-PA,719,2,1,1424,0,1427,G
3-PA,720,1,0,0,1431,1432,C
3-PA,721,0,1428,0,0,1428,T
3-PA,722,1,1,1474,0,1476,G
3-PA,723,0,0,0,1485,1485,C
3-PA,724,1497,1,1,0,1499,A
3-PA,725,0,1495,1,1,1497,T
3-PA,726,0,1492,0,0,1492,T
3-PA,727,0,1,1495,0,1496,G
3-PA,728,1468,0,1,0,1469,A
3-PA,729,0,5,1489,0,1494,G
3-PA,730,0,2,1487,0,1489,G
3-PA,731,1,1,1486,0,1488,G
3-PA,732,2,2,0,1477,1481,C
3-PA,733,1473,0,0,0,1473,A
3-PA,734,1476,0,1,0,1477,A
3-PA,735,2,0,1490,0,1492,G
3-PA,736,0,0,0,1500,1500,C
3-PA,737,0,1499,0,3,1502,T
3-PA,738,0,1508,0,0,1508,T
3-PA,739,0,1513,0,0,1513,T
3-PA,740,2,0,0,1520,1522,C
3-PA,741,0,1513,0,1,1514,T
3-PA,742,2,0,0,1520,1522,C
3-PA,743,1518,0,1,0,1519,A
3-PA,744,1514,0,0,0,1514,A
3-PA,745,1511,1,0,0,1512,A
3-PA,746,0,1508,0,1,1509,T
3-PA,747,0,1,1566,0,1567,G
3-PA,748,2,1558,0,3,1563,T
3-PA,749,1,0,0,1578,1579,C
3-PA,750,2,0,0,1583,1585,C
3-PA,751,1593,0,0,0,1593,A
3-PA,752,1596,1,0,0,1597,A
3-PA,753,1593,0,1,0,1594,A
3-PA,754,1,0,1627,0,1628,G
3-PA,755,1620,1,0,0,1621,A
3-PA,756,1593,0,1,0,1594,A
3-PA,757,0,0,1600,0,1600,G
3-PA,758,0,1589,0,2,1591,T
3-PA,759,1,3,1581,1,1586,G
3-PA,760,1587,0,0,1,1588,A
3-PA,761,1584,0,0,1,1585,A
3-PA,762,0,1592,0,1,1593,T
3-PA,763,2,0,1591,0,1593,G
3-PA,764,1,0,0,1603,1604,C
3-PA,765,1,0,0,1603,1604,C
3-PA,766,3,1,0,1603,1607,C
3-PA,767,1618,0,0,0,1618,A
3-PA,768,1636,1,0,0,1637,A
3-PA,769,1641,0,0,1,1642,A
3-PA,770,0,1644,0,1,1645,T
3-PA,771,0,1641,0,2,1643,T
3-PA,772,0,2,1643,0,1645,G
3-PA,773,1645,0,1,1,1647,A
3-PA,774,1645,0,2,0,1647,A
3-PA,775,1,1,0,1652,1654,C
3-PA,776,5,0,0,1648,1653,C
3-PA,777,0,1638,1,0,1639,T
3-PA,778,0,1687,1,2,1690,T
3-PA,779,1,1690,0,0,1691,T
3-PA,780,0,1715,2,0,1717,T
3-PA,781,3,0,0,1725,1728,C
3-PA,782,1,1725,0,0,1726,T
3-PA,783,1,0,1730,1,1732,G
3-PA,784,1722,0,2,0,1724,A
3-PA,785,1744,0,0,0,1744,A
3-PA,786,0,2,1755,0,1757,G
3-PA,787,1734,0,0,0,1734,A
3-PA,788,0,0,0,1745,1745,C
3-PA,789,1712,0,0,0,1712,A
3-PA,790,1735,0,2,0,1737,A
3-PA,791,0,0,0,1917,1917,C
3-PA,792,1922,2,2,0,1926,A
3-PA,793,0,0,0,1921,1921,C
3-PA,794,4,1,0,1906,1911,C
3-PA,795,1904,0,2,1,1907,A
3-PA,796,1903,0,5,0,1908,A
3-PA,797,1,3,1910,0,1914,G
3-PA,798,1914,0,1,0,1915,A
3-PA,799,0,2,0,1910,1912,C
3-PA,800,2,0,0,1814,1816,C
3-PA,801,1803,1,1,0,1805,A
3-PA,802,1806,0,0,1,1807,A
3-PA,803,0,1808,1,1,1810,T
3-PA,804,4,0,0,1805,1809,C
3-PA,805,1805,0,0,1,1806,A
3-PA,806,1799,0,0,0,1799,A
3-PA,807,1798,0,0,0,1798,A
3-PA,808,1,0,0,1820,1821,C
3-PA,809,0,1799,1,1,1801,T
3-PA,810,0,1813,1,0,1814,T
3-PA,811,2,2,0,1810,1814,C
3-PA,812,6,1,0,1813,1820,C
3-PA,813,2,4,1832,0,1838,G
3-PA,814,1836,0,1,0,1837,A
3-PA,815,1836,0,0,0,1836,A
3-PA,816,0,1842,1,0,1843,T
3-PA,817,0,7,1825,0,1832,G
3-PA,818,1,4,1831,0,1836,G
3-PA,819,1845,1,3,0,1849,A
3-PA,820,1,0,0,1852,1853,C
3-PA,821,0,1,0,1853,1854,C
3-PA,822,0,1931,1,1,1933,T
3-PA,823,2,0,0,1996,1998,C
3-PA,824,6,0,0,2003,2009,C
3-PA,825,0,1980,0,27,2007,T
3-PA,826,1,2024,0,0,2025,T
3-PA,827,1,0,2125,0,2126,G
3-PA,828,0,2116,0,3,2119,T
3-PA,829,0,2117,0,2,2119,T
3-PA,830,2114,0,0,0,2114,A
3-PA,831,0,2057,0,0,2057,T
3-PA,832,1,0,0,2049,2050,C
3-PA,833,2017,0,3,0,2020,A
3-PA,834,0,0,2017,0,2017,G
3-PA,835,0,0,0,2018,2018,C
3-PA,836,2,5,1967,0,1974,G
3-PA,837,2,0,2033,0,2035,G
3-PA,838,0,2038,0,2,2040,T
3-PA,839,4,0,0,2040,2044,C
3-PA,840,5,0,0,2040,2045,C
3-PA,841,2060,1,0,0,2061,A
3-PA,842,2071,0,0,0,2071,A
3-PA,843,2078,0,1,0,2079,A
3-PA,844,0,2081,0,1,2082,T
3-PA,845,0,2076,0,1,2077,T
3-PA,846,3,0,0,2075,2078,C
3-PA,847,0,0,0,2083,2083,C
3-PA,848,0,2079,0,3,2082,T
3-PA,849,1,0,0,2094,2095,C
3-PA,850,3,0,0,2097,2100,C
3-PA,851,0,2100,0,0,2100,T
3-PA,852,0,1,2123,0,2124,G
3-PA,853,2118,0,1,1,2120,A
3-PA,854,0,2122,0,0,2122,T
3-PA,855,1,3,2111,0,2115,G
3-PA,856,1,2,2094,0,2097,G
3-PA,857,2096,0,2,0,2098,A
3-PA,858,1,2081,1,2,2085,T
3-PA,859,1,1,2098,0,2100,G
3-PA,860,1,1,0,2194,2196,C
3-PA,861,0,2191,0,1,2192,T
3-PA,862,1,2197,0,2,2200,T
3-PA,863,1,2201,0,0,2202,T
3-PA,864,2202,0,1,0,2203,A
3-PA,865,2208,0,2,2,2212,A
3-PA,866,2211,0,1,0,2212,A
3-PA,867,2232,2,0,0,2234,A
3-PA,868,0,2229,1,0,2230,T
3-PA,869,0,2107,1,2,2110,T
3-PA,870,0,6,2109,0,2115,G
3-PA,871,2104,0,8,0,2112,A
3-PA,872,0,0,2140,0,2140,G
3-PA,873,0,1,0,2136,2137,C
3-PA,874,2138,0,0,0,2138,A
3-PA,875,0,2184,0,0,2184,T
3-PA,876,0,2176,0,1,2177,T
3-PA,877,1,2,2178,0,2181,G
3-PA,878,2182,0,2,0,2184,A
3-PA,879,2176,1,5,0,2182,A
3-PA,880,0,0,2200,0,2200,G
3-PA,881,2183,1,6,0,2190,A
3-PA,882,0,0,0,2212,2212,C
3-PA,883,3,0,0,2199,2202,C
3-PA,884,5,1,0,2169,2175,C
3-PA,885,2175,0,0,0,2175,A
3-PA,886,2246,0,1,0,2247,A
3-PA,887,2,2,2283,0,2287,G
3-PA,888,0,2289,2,1,2292,T
3-PA,889,7,0,0,2286,2293,C
3-PA,890,2288,0,2,0,2290,A
3-PA,891,0,0,0,2291,2291,C
3-PA,892,0,1,2287,0,2288,G
3-PA,893,2311,1,1,0,2313,A
3-PA,894,2310,0,6,1,2317,A
3-PA,895,0,4,2364,0,2368,G
3-PA,896,1,5,2352,0,2358,G
3-PA,897,2348,1,7,0,2356,A
3-PA,898,0,2,2372,0,2374,G
3-PA,899,2365,0,2,9,2376,A
3-PA,900,2376,1,2,0,2379,A
3-PA,901,0,11,2370,0,2381,G
3-PA,902,0,2,2361,0,2363,G
3-PA,903,0,1,2373,0,2374,G
3-PA,904,2318,0,2,0,2320,A
3-PA,905,1,2321,0,1,2323,T
3-PA,906,5,0,0,2325,2330,C
3-PA,907,3,1,1,2500,2505,C
3-PA,908,4,0,0,2537,2541,C
3-PA,909,2571,0,0,0,2571,A
3-PA,910,1,2571,0,1,2573,T
3-PA,911,0,2582,0,1,2583,T
3-PA,912,2636,0,1,0,2637,A
3-PA,913,2,2636,0,0,2638,T
3-PA,914,2633,0,0,0,2633,A
3-PA,915,0,2620,0,0,2620,T
3-PA,916,0,5,2362,1,2368,G
3-PA,917,2349,0,2,0,2351,A
3-PA,918,0,2326,0,1,2327,T
3-PA,919,0,0,2357,0,2357,G
3-PA,920,1,1,0,2325,2327,C
3-PA,921,1,5,2324,0,2330,G
3-PA,922,2342,0,1,0,2343,A
3-PA,923,0,2342,0,1,2343,T
3-PA,924,6,0,0,2338,2344,C
3-PA,925,2343,2,0,0,2345,A
3-PA,926,2335,0,0,0,2335,A
3-PA,927,1,1,2357,0,2359,G
3-PA,928,1,2338,0,0,2339,T
3-PA,929,1,0,2349,2,2352,G
3-PA,930,0,0,0,2359,2359,C
3-PA,931,2356,0,3,0,2359,A
3-PA,932,0,2366,0,0,2366,T
3-PA,933,2343,0,0,0,2343,A
3-PA,934,2390,1,1,0,2392,A
3-PA,935,2393,2,0,1,2396,A
3-PA,936,2382,0,1,0,2383,A
3-PA,937,2382,2,2,1,2387,A
3-PA,938,1,1,0,2384,2386,C
3-PA,939,2359,0,2,1,2362,A
3-PA,940,0,2369,0,0,2369,T
3-PA,941,0,2364,0,1,2365,T
3-PA,942,0,0,0,2377,2377,C
3-PA,943,0,2352,0,1,2353,T
3-PA,944,0,2351,0,0,2351,T
3-PA,945,0,2349,0,0,2349,T
3-PA,946,1,3,2349,0,2353,G
3-PA,947,0,1,2363,0,2364,G
3-PA,948,2360,0,2,0,2362,A
3-PA,949,0,2361,0,0,2361,T
3-PA,950,2,3,2375,0,2380,G
3-PA,951,2,1,2404,1,2408,G
3-PA,952,2405,0,1,0,2406,A
3-PA,953,2405,0,2,1,2408,A
3-PA,954,2408,2,1,1,2412,A
3-PA,955,1,1,2441,0,2443,G
3-PA,956,2430,0,1,0,2431,A
3-PA,957,2646,1,1,1,2649,A
3-PA,958,0,0,1,2690,2691,C
3-PA,959,3,0,0,2698,2701,C
3-PA,960,0,2682,0,1,2683,T
3-PA,961,0,2720,1,0,2721,T
3-PA,962,2738,0,0,0,2738,A
3-PA,963,0,2740,0,1,2741,T
3-PA,964,2719,0,0,0,2719,A
3-PA,965,0,2756,0,0,2756,T
3-PA,966,2533,0,2,0,2535,A
3-PA,967,0,2,2563,0,2565,G
3-PA,968,0,2536,0,1,2537,T
3-PA,969,5,0,0,2527,2532,C
3-PA,970,2499,0,0,0,2499,A
3-PA,971,2512,0,0,0,2512,A
3-PA,972,2514,0,2,0,2516,A
3-PA,973,0,0,0,2527,2527,C
3-PA,974,2,0,0,2486,2488,C
3-PA,975,2463,0,4,0,2467,A
3-PA,976,47,0,0,2427,2474,C
3-PA,977,2473,2,2,1,2478,A
3-PA,978,0,0,0,2498,2498,C
3-PA,979,0,2,2490,0,2492,G
3-PA,980,2482,0,1,0,2483,A
3-PA,981,2477,0,0,1,2478,A
3-PA,982,2466,0,1,1,2468,A
3-PA,983,2475,0,1,1,2477,A
3-PA,984,0,6,2480,0,2486,G
3-PA,985,2,4,2458,0,2464,G
3-PA,986,0,4,2471,0,2475,G
3-PA,987,2462,0,4,1,2467,A
3-PA,988,2460,0,2,0,2462,A
3-PA,989,0,2465,0,0,2465,T
3-PA,990,2466,0,1,0,2467,A
3-PA,991,2468,0,0,0,2468,A
3-PA,992,2481,0,1,0,2482,A
3-PA,993,0,2467,0,0,2467,T
3-PA,994,2,2460,0,1,2463,T
3-PA,995,7,2,0,2464,2473,C
3-PA,996,2476,0,0,0,2476,A
3-PA,997,2488,0,0,0,2488,A
3-PA,998,2493,0,0,0,2493,A
3-PA,999,0,2487,0,0,2487,T
3-PA,1000,0,2497,0,1,2498,T
3-PA,1001,2509,1,0,0,2510,A
3-PA,1002,1,0,0,2507,2508,C
3-PA,1003,4,1,0,2503,2508,C
3-PA,1004,0,2490,0,1,2491,T
3-PA,1005,2,0,2506,0,2508,G
3-PA,1006,1,0,1,2517,2519,C
3-PA,1007,1,2515,0,0,2516,T
3-PA,1008,0,0,2573,0,2573,G
3-PA,1009,0,2573,0,3,2576,T
3-PA,1010,7,1,1,2569,2578,C
3-PA,1011,2583,0,1,1,2585,A
3-PA,1012,0,2577,0,2,2579,T
3-PA,1013,0,3,2580,0,2583,G
3-PA,1014,0,3,2586,0,2589,G
3-PA,1015,2577,2,1,0,2580,A
3-PA,1016,2631,0,6,0,2637,A
3-PA,1017,0,0,2625,0,2625,G
3-PA,1018,0,0,0,2621,2621,C
3-PA,1019,2611,0,0,0,2611,A
3-PA,1020,2617,0,1,0,2618,A
3-PA,1021,0,1,2634,0,2635,G
3-PA,1022,0,2636,0,0,2636,T
3-PA,1023,2612,1,0,0,2613,A
3-PA,1024,0,1,0,2623,2624,C
3-PA,1025,0,2575,0,1,2576,T
3-PA,1026,0,0,2595,0,2595,G
3-PA,1027,2,2575,0,2,2579,T
3-PA,1028,6,2,1,2569,2578,C
3-PA,1029,2585,1,1,0,2587,A
3-PA,1030,1,2,2599,0,2602,G
3-PA,1031,2604,0,0,0,2604,A
3-PA,1032,2608,0,1,0,2609,A
3-PA,1033,0,2632,0,0,2632,T
3-PA,1034,0,2615,0,2,2617,T
3-PA,1035,1,1,2605,0,2607,G
3-PA,1036,0,0,1,2607,2608,C
3-PA,1037,2598,2,4,0,2604,A
3-PA,1038,2,5,2601,0,2608,G
3-PA,1039,0,3,2588,0,2591,G
3-PA,1040,2586,0,0,0,2586,A
3-PA,1041,1,2,0,2575,2578,C
3-PA,1042,0,0,2551,0,2551,G
3-PA,1043,0,2601,2,0,2603,T
3-PA,1044,0,2599,0,1,2600,T
3-PA,1045,1,1,2622,0,2624,G
3-PA,1046,2625,0,3,0,2628,A
3-PA,1047,2629,0,0,1,2630,A
3-PA,1048,2620,0,1,0,2621,A
3-PA,1049,2618,0,1,0,2619,A
3-PA,1050,1,2604,1,0,2606,T
3-PA,1051,0,6,2622,0,2628,G
3-PA,1052,2591,3,4,0,2598,A
3-PA,1053,0,5,2604,0,2609,G
3-PA,1054,1,4,2611,1,2617,G
3-PA,1055,2607,0,1,0,2608,A
3-PA,1056,0,1,2618,0,2619,G
3-PA,1057,2621,0,1,0,2622,A
3-PA,1058,2611,0,0,0,2611,A
3-PA,1059,0,3,2602,0,2605,G
3-PA,1060,3,0,2568,1,2572,G
3-PA,1061,1,2673,0,2,2676,T
3-PA,1062,0,2677,0,2,2679,T
3-PA,1063,4,2,0,2671,2677,C
3-PA,1064,5,1,0,2671,2677,C
3-PA,1065,2682,1,0,0,2683,A
3-PA,1066,2679,0,2,0,2681,A
3-PA,1067,69,5,2630,0,2704,G
3-PA,1068,0,5,2734,0,2739,G
3-PA,1069,2686,1,2,0,2689,A
3-PA,1070,0,0,0,2704,2704,C
3-PA,1071,0,2700,0,0,2700,T
3-PA,1072,2705,0,0,0,2705,A
3-PA,1073,2699,0,0,2,2701,A
3-PA,1074,2702,0,0,0,2702,A
3-PA,1075,2706,0,1,0,2707,A
3-PA,1076,2698,0,0,0,2698,A
3-PA,1077,1,0,0,2669,2670,C
3-PA,1078,2657,0,1,0,2658,A
3-PA,1079,0,2655,0,0,2655,T
3-PA,1080,0,0,2677,1,2678,G
3-PA,1081,2681,0,0,0,2681,A
3-PA,1082,2677,0,1,0,2678,A
3-PA,1083,1,2,2697,1,2701,G
3-PA,1084,2694,1,0,0,2695,A
3-PA,1085,2693,0,0,0,2693,A
3-PA,1086,2672,0,3,0,2675,A
3-PA,1087,2668,0,4,1,2673,A
3-PA,1088,2,1,0,2683,2686,C
3-PA,1089,0,8,2663,0,2671,G
3-PA,1090,2684,0,1,0,2685,A
3-PA,1091,1,2,2684,0,2687,G
3-PA,1092,1,2663,0,3,2667,T
3-PA,1093,9,0,0,2712,2721,C
3-PA,1094,2717,0,2,0,2719,A
3-PA,1095,2743,0,1,0,2744,A
3-PA,1096,0,0,0,2745,2745,C
3-PA,1097,0,2731,1,3,2735,T
3-PA,1098,0,1,2774,0,2775,G
3-PA,1099,2760,0,1,0,2761,A
3-PA,1100,2770,0,1,1,2772,A
3-PA,1101,2,0,2779,0,2781,G
3-PA,1102,0,2721,1,3,2725,T
3-PA,1103,1,11,2714,0,2726,G
3-PA,1104,1,3,2702,0,2706,G
3-PA,1105,0,1,2699,0,2700,G
3-PA,1106,1,0,0,2719,2720,C
3-PA,1107,0,2693,0,0,2693,T
3-PA,1108,2,1,0,2711,2714,C
3-PA,1109,1,2703,0,1,2705,T
3-PA,1110,1,2709,1,0,2711,T
3-PA,1111,1,5,2756,0,2762,G
3-PA,1112,1,1,2771,0,2773,G
3-PA,1113,0,2760,0,3,2763,T
3-PA,1114,2,3,2754,0,2759,G
3-PA,1115,2739,1,0,0,2740,A
3-PA,1116,2760,1,2,0,2763,A
3-PA,1117,2748,0,5,0,2753,A
3-PA,1118,2763,0,0,0,2763,A
3-PA,1119,0,1,0,2773,2774,C
3-PA,1120,2727,2,1,0,2730,A
3-PA,1121,1,2732,0,0,2733,T
3-PA,1122,0,5,2718,0,2723,G
3-PA,1123,2,1,2761,0,2764,G
3-PA,1124,0,1,0,2775,2776,C
3-PA,1125,2774,0,3,0,2777,A
3-PA,1126,0,3,0,2773,2776,C
3-PA,1127,3,1,0,2776,2780,C
3-PA,1128,2820,0,2,0,2822,A
3-PA,1129,0,2,2853,0,2855,G
3-PA,1130,2850,0,1,0,2851,A
3-PA,1131,0,1,2868,1,2870,G
3-PA,1132,2862,0,1,1,2864,A
3-PA,1133,2844,1,4,0,2849,A
3-PA,1134,0,6,2849,0,2855,G
3-PA,1135,0,1,2835,0,2836,G
3-PA,1136,1,2831,0,3,2835,T
3-PA,1137,2806,1,1,0,2808,A
3-PA,1138,0,5,2803,1,2809,G
3-PA,1139,2809,0,0,0,2809,A
3-PA,1140,1,2,0,2816,2819,C
3-PA,1141,1,2786,0,1,2788,T
3-PA,1142,0,2774,0,2,2776,T
3-PA,1143,0,2774,0,1,2775,T
3-PA,1144,50,6,2737,0,2793,G
3-PA,1145,2792,0,3,0,2795,A
3-PA,1146,2796,0,0,0,2796,A
3-PA,1147,2792,0,0,0,2792,A
3-PA,1148,2774,0,0,1,2775,A
3-PA,1149,0,1,0,2830,2831,C
3-PA,1150,1,2797,0,2,2800,T
3-PA,1151,1,0,2836,0,2837,G
3-PA,1152,0,0,0,2835,2835,C
3-PA,1153,2833,1,2,0,2836,A
3-PA,1154,0,3,2843,0,2846,G
3-PA,1155,2836,2,0,0,2838,A
3-PA,1156,0,5,2920,0,2925,G
3-PA,1157,2937,1,2,0,2940,A
3-PA,1158,0,0,0,2915,2915,C
3-PA,1159,2893,17,2,0,2912,A
3-PA,1160,1,2887,0,0,2888,T
3-PA,1161,2890,0,0,1,2891,A
3-PA,1162,2889,0,4,0,2893,A
3-PA,1163,0,1,2890,0,2891,G
3-PA,1164,1,1,0,2878,2880,C
3-PA,1165,0,6,2822,0,2828,G
3-PA,1166,2886,0,0,0,2886,A
3-PA,1167,1,2856,2,1,2860,T
3-PA,1168,0,2857,0,0,2857,T
3-PA,1169,0,2860,1,0,2861,T
3-PA,1170,0,3,2878,0,2881,G
3-PA,1171,2890,0,4,0,2894,A
3-PA,1172,2887,1,3,0,2891,A
3-PA,1173,0,0,2894,0,2894,G
3-PA,1174,3,0,0,2958,2961,C
3-PA,1175,2918,0,0,0,2918,A
3-PA,1176,3123,0,0,0,3123,A
3-PA,1177,0,3125,0,0,3125,T
3-PA,1178,3145,0,2,0,3147,A
3-PA,1179,1,3161,0,1,3163,T
3-PA,1180,1,6,3172,0,3179,G
3-PA,1181,3210,2,4,1,3217,A
3-PA,1182,1,3204,0,1,3206,T
3-PA,1183,3129,1,1,1,3132,A
3-PA,1184,0,1,3136,0,3137,G
3-PA,1185,0,2985,0,3,2988,T
3-PA,1186,0,8,2977,0,2985,G
3-PA,1187,2985,2,1,0,2988,A
3-PA,1188,0,0,0,2959,2959,C
3-PA,1189,1,6,2944,0,2951,G
3-PA,1190,2962,0,1,0,2963,A
3-PA,1191,2967,0,2,0,2969,A
3-PA,1192,0,0,0,2991,2991,C
3-PA,1193,2,0,0,2987,2989,C
3-PA,1194,0,2979,0,1,2980,T
3-PA,1195,0,6,3052,0,3058,G
3-PA,1196,3056,0,2,0,3058,A
3-PA,1197,3057,0,2,0,3059,A
3-PA,1198,3,3052,0,0,3055,T
3-PA,1199,0,3023,0,1,3024,T
3-PA,1200,3031,0,1,0,3032,A
3-PA,1201,2979,1,1,0,2981,A
3-PA,1202,0,3,2990,0,2993,G
3-PA,1203,2,2,2983,1,2988,G
3-PA,1204,0,2937,1,5,2943,T
3-PA,1205,10,1,1,2934,2946,C
3-PA,1206,2955,0,0,0,2955,A
3-PA,1207,0,1,0,3041,3042,C
3-PA,1208,0,3042,0,4,3046,T
3-PA,1209,0,3048,0,2,3050,T
3-PA,1210,0,3055,0,0,3055,T
3-PA,1211,6,0,0,3045,3051,C
3-PA,1212,3045,1,4,0,3050,A
3-PA,1213,3048,0,2,0,3050,A
3-PA,1214,0,1,3076,1,3078,G
3-PA,1215,1,0,0,3071,3072,C
3-PA,1216,0,3024,0,2,3026,T
3-PA,1217,2,4,3096,0,3102,G
3-PA,1218,2,3,3116,1,3122,G
3-PA,1219,3171,1,0,0,3172,A
3-PA,1220,1,3203,1,2,3207,T
3-PA,1221,3211,0,0,0,3211,A
3-PA,1222,0,0,0,3230,3230,C
3-PA,1223,3175,0,4,0,3179,A
3-PA,1224,0,3,3219,0,3222,G
3-PA,1225,3211,0,1,0,3212,A
3-PA,1226,3161,0,0,0,3161,A
3-PA,1227,0,3116,1,0,3117,T
3-PA,1228,1,9,3101,1,3112,G
3-PA,1229,3086,1,3,0,3090,A
3-PA,1230,2,0,3135,0,3137,G
3-PA,1231,0,3095,0,3,3098,T
3-PA,1232,0,3095,0,2,3097,T
3-PA,1233,14,0,0,3126,3140,C
3-PA,1234,3148,0,3,0,3151,A
3-PA,1235,3156,0,3,2,3161,A
3-PA,1236,0,1,0,3164,3165,C
3-PA,1237,3112,1,1,0,3114,A
3-PA,1238,3111,0,2,0,3113,A
3-PA,1239,2,4,3085,0,3091,G
3-PA,1240,2,6,3119,0,3127,G
3-PA,1241,2,0,0,3143,3145,C
3-PA,1242,1,1,0,3130,3132,C
3-PA,1243,0,3115,0,1,3116,T
3-PA,1244,0,1,3138,1,3140,G
3-PA,1245,1,3136,0,2,3139,T
3-PA,1246,1,11,3151,0,3163,G
3-PA,1247,3172,1,5,0,3178,A
3-PA,1248,1,1,3172,0,3174,G
3-PA,1249,1,0,0,3152,3153,C
3-PA,1250,0,3125,0,2,3127,T
3-PA,1251,3200,3,3,1,3207,A
3-PA,1252,3205,0,2,1,3208,A
3-PA,1253,0,1,0,3219,3220,C
3-PA,1254,0,3192,0,3,3195,T
3-PA,1255,0,6,3188,1,3195,G
3-PA,1256,3187,2,0,0,3189,A
3-PA,1257,0,3183,0,1,3184,T
3-PA,1258,1,3186,0,0,3187,T
3-PA,1259,5,0,0,3187,3192,C
3-PA,1260,3254,1,1,1,3257,A
3-PA,1261,0,1,3343,0,3344,G
3-PA,1262,0,3330,0,7,3337,T
3-PA,1263,3,2,0,3333,3338,C
3-PA,1264,3,3308,0,1,3312,T
3-PA,1265,0,4,3433,0,3437,G
3-PA,1266,0,4,3434,0,3438,G
3-PA,1267,3441,0,2,0,3443,A
3-PA,1268,1,3442,1,2,3446,T
3-PA,1269,3293,1,0,0,3294,A
3-PA,1270,0,8,3278,0,3286,G
3-PA,1271,3240,0,5,2,3247,A
3-PA,1272,0,1,3246,1,3248,G
3-PA,1273,0,0,0,3241,3241,C
3-PA,1274,0,3169,0,0,3169,T
3-PA,1275,5,1,0,3160,3166,C
3-PA,1276,2,3,3167,0,3172,G
3-PA,1277,3174,0,0,0,3174,A
3-PA,1278,1,3175,0,1,3177,T
3-PA,1279,1,1,3172,0,3174,G
3-PA,1280,3212,0,0,0,3212,A
3-PA,1281,3208,1,1,1,3211,A
3-PA,1282,3217,0,0,0,3217,A
3-PA,1283,0,3213,1,0,3214,T
3-PA,1284,1,3204,1,1,3207,T
3-PA,1285,0,5,3234,0,3239,G
3-PA,1286,0,7,3227,1,3235,G
3-PA,1287,3229,0,2,0,3231,A
3-PA,1288,0,4,3236,0,3240,G
3-PA,1289,3187,1,1,0,3189,A
3-PA,1290,2,7,3201,0,3210,G
3-PA,1291,0,2,3215,0,3217,G
3-PA,1292,3240,0,2,0,3242,A
3-PA,1293,0,2,0,3238,3240,C
3-PA,1294,1,1,3215,0,3217,G
3-PA,1295,0,3221,2,0,3223,T
3-PA,1296,3243,0,0,0,3243,A
3-PA,1297,1,2,3258,0,3261,G
3-PA,1298,1,1,0,3309,3311,C
3-PA,1299,1,1,0,3274,3276,C
3-PA,1300,11,0,0,3243,3254,C
3-PA,1301,8,1,2,3255,3266,C
3-PA,1302,3275,0,2,1,3278,A
3-PA,1303,3370,0,3,0,3373,A
3-PA,1304,0,3363,1,0,3364,T
3-PA,1305,1,3342,0,1,3344,T
3-PA,1306,3,7,3331,0,3341,G
3-PA,1307,3280,2,3,0,3285,A
3-PA,1308,1,2,3287,0,3290,G
3-PA,1309,1,0,0,3281,3282,C
3-PA,1310,3259,0,2,0,3261,A
3-PA,1311,0,0,0,3338,3338,C
3-PA,1312,3254,0,3,0,3257,A
3-PA,1313,0,3324,0,3,3327,T
3-PA,1314,1,3319,0,0,3320,T
3-PA,1315,0,1,3326,0,3327,G
3-PA,1316,2,3,0,3317,3322,C
3-PA,1317,3308,2,7,0,3317,A
3-PA,1318,3314,0,3,0,3317,A
3-PA,1319,2,2,3316,0,3320,G
3-PA,1320,1,2,0,3281,3284,C
3-PA,1321,3286,0,1,0,3287,A
3-PA,1322,0,3196,0,0,3196,T
3-PA,1323,0,4,3195,0,3199,G
3-PA,1324,3187,0,2,0,3189,A
3-PA,1325,1,4,3198,0,3203,G
3-PA,1326,3193,0,1,0,3194,A
3-PA,1327,3194,0,0,1,3195,A
3-PA,1328,0,7,3175,0,3182,G
3-PA,1329,1,4,3189,1,3195,G
3-PA,1330,3192,1,1,0,3194,A
3-PA,1331,3192,1,2,0,3195,A
3-PA,1332,2,3208,0,2,3212,T
3-PA,1333,0,3203,0,1,3204,T
3-PA,1334,3205,0,0,0,3205,A
3-PA,1335,0,3211,2,1,3214,T
3-PA,1336,1,3202,0,0,3203,T
3-PA,1337,0,3214,1,1,3216,T
3-PA,1338,4,0,0,3188,3192,C
3-PA,1339,3172,2,0,0,3174,A
3-PA,1340,2,1,0,3239,3242,C
3-PA,1341,3209,0,2,0,3211,A
3-PA,1342,0,1,3245,0,3246,G
3-PA,1343,1,0,0,3235,3236,C
3-PA,1344,3220,0,0,0,3220,A
3-PA,1345,1,5,3232,1,3239,G
3-PA,1346,3219,0,1,0,3220,A
3-PA,1347,1,7,3224,0,3232,G
3-PA,1348,0,1,3239,0,3240,G
3-PA,1349,2,3169,0,3,3174,T
3-PA,1350,0,0,3232,0,3232,G
3-PA,1351,0,3207,0,9,3216,T
3-PA,1352,6,1,0,3208,3215,C
3-PA,1353,3,0,0,3246,3249,C
3-PA,1354,5,2,1,3227,3235,C
3-PA,1355,3255,0,0,0,3255,A
3-PA,1356,0,3286,0,2,3288,T
3-PA,1357,0,3258,0,2,3260,T
3-PA,1358,0,1,3283,0,3284,G
3-PA,1359,0,3226,0,1,3227,T
3-PA,1360,3181,2,1,0,3184,A
3-PA,1361,0,3,3176,0,3179,G
3-PA,1362,3089,1,2,0,3092,A
3-PA,1363,0,0,3110,0,3110,G
3-PA,1364,1,0,0,3060,3061,C
3-PA,1365,3,1,0,3020,3024,C
3-PA,1366,3065,0,0,0,3065,A
3-PA,1367,2,0,0,3076,3078,C
3-PA,1368,1,3061,0,1,3063,T
3-PA,1369,0,5,3061,0,3066,G
3-PA,1370,3056,0,1,0,3057,A
3-PA,1371,2999,0,1,0,3000,A
3-PA,1372,1,3071,0,0,3072,T
3-PA,1373,3096,0,2,0,3098,A
3-PA,1374,1,0,0,3126,3127,C
3-PA,1375,3044,0,3,0,3047,A
3-PA,1376,1,3064,0,0,3065,T
3-PA,1377,3043,0,0,0,3043,A
3-PA,1378,3061,0,1,0,3062,A
3-PA,1379,1,3054,0,3,3058,T
3-PA,1380,1,2,3007,0,3010,G
3-PA,1381,2979,2,0,1,2982,A
3-PA,1382,2942,1,1,0,2944,A
3-PA,1383,0,14,2935,0,2949,G
3-PA,1384,1,7,2912,0,2920,G
3-PA,1385,0,10,2944,0,2954,G
3-PA,1386,0,1,2953,0,2954,G
3-PA,1387,1,0,2976,0,2977,G
3-PA,1388,0,2896,0,3,2899,T
3-PA,1389,2921,0,1,0,2922,A
3-PA,1390,0,2940,0,2,2942,T
3-PA,1391,2965,1,1,0,2967,A
3-PA,1392,0,1,0,3225,3226,C
3-PA,1393,3110,0,1,0,3111,A
3-PA,1394,1,3016,1,29,3047,T
3-PA,1395,0,3010,0,2,3012,T
3-PA,1396,2980,0,1,0,2981,A
3-PA,1397,3039,0,1,0,3040,A
3-PA,1398,0,0,0,3036,3036,C
3-PA,1399,2994,1,0,0,2995,A
3-PA,1400,1,0,0,2990,2991,C
3-PA,1401,0,2674,0,0,2674,T
3-PA,1402,1,0,2770,0,2771,G
3-PA,1403,2,1,0,2752,2755,C
3-PA,1404,4,0,0,2751,2755,C
3-PA,1405,11,0,1,2765,2777,C
3-PA,1406,3,2686,0,3,2692,T
3-PA,1407,2,2,2761,0,2765,G
3-PA,1408,2,0,0,2763,2765,C
3-PA,1409,0,2752,1,4,2757,T
3-PA,1410,8,2,0,2808,2818,C
3-PA,1411,2735,0,3,1,2739,A
3-PA,1412,2763,1,1,0,2765,A
3-PA,1413,0,2765,0,9,2774,T
3-PA,1414,1,1,2769,0,2771,G
3-PA,1415,0,1,0,2774,2775,C
3-PA,1416,2732,0,1,0,2733,A
3-PA,1417,0,2726,0,2,2728,T
3-PA,1418,4,0,0,2720,2724,C
3-PA,1419,3,2,0,2742,2747,C
3-PA,1420,1,2659,0,2,2662,T
3-PA,1421,0,0,2714,0,2714,G
3-PA,1422,0,2708,0,0,2708,T
3-PA,1423,0,1,2704,0,2705,G
3-PA,1424,2,0,0,2706,2708,C
3-PA,1425,2671,0,2,0,2673,A
3-PA,1426,1,4,2684,0,2689,G
3-PA,1427,0,1,0,2684,2685,C
3-PA,1428,2651,0,1,0,2652,A
3-PA,1429,2658,0,0,0,2658,A
3-PA,1430,0,2564,0,2,2566,T
3-PA,1431,0,4,2557,1,2562,G
3-PA,1432,1,3,2557,0,2561,G
3-PA,1433,2555,0,4,0,2559,A
3-PA,1434,1,2,0,2555,2558,C
3-PA,1435,1,3,2519,0,2523,G
3-PA,1436,2544,0,0,0,2544,A
3-PA,1437,0,2544,0,1,2545,T
3-PA,1438,0,2539,0,0,2539,T
3-PA,1439,0,2533,0,0,2533,T
3-PA,1440,0,2543,0,0,2543,T
3-PA,1441,5,3,0,2539,2547,C
3-PA,1442,2544,0,1,0,2545,A
3-PA,1443,2549,0,1,0,2550,A
3-PA,1444,1,0,0,2546,2547,C
3-PA,1445,1,2495,0,1,2497,T
3-PA,1446,2503,0,0,0,2503,A
3-PA,1447,2497,0,1,0,2498,A
3-PA,1448,0,2507,0,0,2507,T
3-PA,1449,0,2503,0,0,2503,T
3-PA,1450,5,0,0,2504,2509,C
3-PA,1451,3,0,0,2501,2504,C
3-PA,1452,1,0,0,2497,2498,C
3-PA,1453,2496,0,2,0,2498,A
3-PA,1454,2,2523,0,6,2531,T
3-PA,1455,0,4,2526,0,2530,G
3-PA,1456,2534,0,1,0,2535,A
3-PA,1457,0,2520,0,1,2521,T
3-PA,1458,2512,0,1,0,2513,A
3-PA,1459,2523,0,2,1,2526,A
3-PA,1460,17,0,2502,0,2519,G
3-PA,1461,0,0,0,2519,2519,C
3-PA,1462,2508,0,1,0,2509,A
3-PA,1463,2449,0,0,0,2449,A
3-PA,1464,1,0,2473,0,2474,G
3-PA,1465,2,2463,0,0,2465,T
3-PA,1466,0,0,2459,0,2459,G
3-PA,1467,1,1,0,2451,2453,C
3-PA,1468,2435,0,0,0,2435,A
3-PA,1469,0,3,2465,0,2468,G
3-PA,1470,2456,0,0,0,2456,A
3-PA,1471,2479,0,2,0,2481,A
3-PA,1472,2,1,0,2482,2485,C
3-PA,1473,0,2434,0,0,2434,T
3-PA,1474,2453,0,0,1,2454,A
3-PA,1475,2449,1,1,1,2452,A
3-PA,1476,2444,0,3,0,2447,A
3-PA,1477,0,3,2455,0,2458,G
3-PA,1478,2331,1,3,1,2336,A
3-PA,1479,0,15,2331,0,2346,G
3-PA,1480,0,3,2286,0,2289,G
3-PA,1481,0,2,2281,0,2283,G
3-PA,1482,2265,0,0,0,2265,A
3-PA,1483,2230,0,0,0,2230,A
3-PA,1484,0,0,2229,0,2229,G
3-PA,1485,0,1,2217,0,2218,G
3-PA,1486,0,0,0,2223,2223,C
3-PA,1487,0,2,2223,0,2225,G
3-PA,1488,2214,0,2,0,2216,A
3-PA,1489,2212,0,3,0,2215,A
3-PA,1490,2217,0,2,0,2219,A
3-PA,1491,2213,0,1,0,2214,A
3-PA,1492,2218,0,2,1,2221,A
3-PA,1493,0,0,0,2217,2217,C
3-PA,1494,3,0,0,2199,2202,C
3-PA,1495,2196,0,1,0,2197,A
3-PA,1496,2230,0,1,0,2231,A
3-PA,1497,0,2223,0,1,2224,T
3-PA,1498,0,2231,0,1,2232,T
3-PA,1499,0,2246,0,0,2246,T
3-PA,1500,2253,0,1,0,2254,A
3-PA,1501,0,2249,0,1,2250,T
3-PA,1502,2245,0,1,0,2246,A
3-PA,1503,0,2235,0,1,2236,T
3-PA,1504,0,9,2206,0,2215,G
3-PA,1505,0,5,2148,1,2154,G
3-PA,1506,1,1,2031,0,2033,G
3-PA,1507,0,2057,1,3,2061,T
3-PA,1508,2,2055,0,5,2062,T
3-PA,1509,4,0,0,2057,2061,C
3-PA,1510,2068,0,4,0,2072,A
3-PA,1511,0,2085,0,1,2086,T
3-PA,1512,9,0,0,2082,2091,C
3-PA,1513,2083,0,0,0,2083,A
3-PA,1514,0,2061,0,1,2062,T
3-PA,1515,2019,1,0,0,2020,A
3-PA,1516,2014,0,1,0,2015,A
3-PA,1517,2016,0,2,0,2018,A
3-PA,1518,0,7,2003,1,2011,G
3-PA,1519,2,1,1963,0,1966,G
3-PA,1520,0,0,1942,0,1942,G
3-PA,1521,1910,0,3,1,1914,A
3-PA,1522,1896,0,0,0,1896,A
3-PA,1523,1,0,1902,0,1903,G
3-PA,1524,1888,0,1,0,1889,A
3-PA,1525,0,1885,0,1,1886,T
3-PA,1526,2,0,0,1871,1873,C
3-PA,1527,0,1839,0,1,1840,T
3-PA,1528,6,0,0,1878,1884,C
3-PA,1529,1880,0,1,0,1881,A
3-PA,1530,0,1868,0,0,1868,T
3-PA,1531,2,1873,0,0,1875,T
3-PA,1532,0,1856,0,0,1856,T
3-PA,1533,1837,0,0,0,1837,A
3-PA,1534,1833,0,1,0,1834,A
3-PA,1535,2,2,1831,0,1835,G
3-PA,1536,1,2,1854,0,1857,G
3-PA,1537,1761,0,1,0,1762,A
3-PA,1538,1758,0,2,0,1760,A
3-PA,1539,0,1743,13,0,1756,T
3-PA,1540,0,6,1762,0,1768,G
3-PA,1541,1788,2,1,0,1791,A
3-PA,1542,0,1,0,1785,1786,C
3-PA,1543,1770,1,3,0,1774,A
3-PA,1544,2,1,0,1771,1774,C
3-PA,1545,1714,0,1,0,1715,A
3-PA,1546,0,1,1716,0,1717,G
3-PA,1547,1694,0,0,0,1694,A
3-PA,1548,0,0,0,1668,1668,C
3-PA,1549,0,0,1643,1,1644,G
3-PA,1550,0,1526,0,0,1526,T
3-PA,1551,0,5,1523,1,1529,G
3-PA,1552,0,0,1532,0,1532,G
3-PA,1553,0,1532,0,0,1532,T
3-PA,1554,1526,0,0,0,1526,A
3-PA,1555,1492,0,0,0,1492,A
3-PA,1556,1492,0,0,0,1492,A
3-PA,1557,0,1488,0,1,1489,T
3-PA,1558,0,1462,0,0,1462,T
3-PA,1559,0,1464,0,0,1464,T
3-PA,1560,0,1436,0,0,1436,T
3-PA,1561,1,0,1432,0,1433,G
3-PA,1562,0,1417,0,0,1417,T
3-PA,1563,0,4,1414,0,1418,G
3-PA,1564,1405,0,1,0,1406,A
3-PA,1565,2,0,1408,0,1410,G
3-PA,1566,0,0,0,1398,1398,C
3-PA,1567,1401,0,1,0,1402,A
3-PA,1568,0,1400,0,0,1400,T
3-PA,1569,0,6,1393,0,1399,G
3-PA,1570,1,0,1405,0,1406,G
3-PA,1571,1406,0,0,0,1406,A
3-PA,1572,0,0,1410,0,1410,G
3-PA,1573,0,1385,0,0,1385,T
3-PA,1574,0,1367,0,2,1369,T
3-PA,1575,0,1371,0,0,1371,T
3-PA,1576,0,1364,0,4,1368,T
3-PA,1577,1,0,2,1371,1374,C
3-PA,1578,0,1358,0,2,1360,T
3-PA,1579,3,0,0,1356,1359,C
3-PA,1580,1,1318,0,2,1321,T
3-PA,1581,2,0,0,1321,1323,C
3-PA,1582,1316,0,0,0,1316,A
3-PA,1583,0,1,0,1310,1311,C
3-PA,1584,0,1278,0,0,1278,T
3-PA,1585,0,7,1271,0,1278,G
3-PA,1586,1275,0,0,0,1275,A
3-PA,1587,1,0,0,1267,1268,C
3-PA,1588,1,1,0,1253,1255,C
3-PA,1589,8,0,0,1237,1245,C
3-PA,1590,0,2,1239,0,1241,G
3-PA,1591,1236,0,1,0,1237,A
3-PA,1592,0,2,1235,0,1237,G
3-PA,1593,1238,1,0,0,1239,A
3-PA,1594,0,0,0,1192,1192,C
3-PA,1595,0,1170,0,0,1170,T
3-PA,1596,0,1101,0,0,1101,T
3-PA,1597,0,2,1095,0,1097,G
3-PA,1598,1097,1,3,0,1101,A
3-PA,1599,0,0,1100,0,1100,G
3-PA,1600,0,1,0,1092,1093,C
3-PA,1601,3,1,0,1028,1032,C
3-PA,1602,1038,0,0,0,1038,A
3-PA,1603,1,2,0,1026,1029,C
3-PA,1604,1031,0,1,0,1032,A
3-PA,1605,0,1032,0,1,1033,T
3-PA,1606,1014,0,1,0,1015,A
3-PA,1607,1003,1,0,0,1004,A
3-PA,1608,1001,0,0,0,1001,A
3-PA,1609,0,990,0,1,991,T
3-PA,1610,0,3,982,0,985,G
3-PA,1611,0,0,852,0,852,G
3-PA,1612,0,0,833,0,833,G
3-PA,1613,807,0,0,0,807,A
3-PA,1614,2,0,797,0,799,G
3-PA,1615,778,0,1,0,779,A
3-PA,1616,765,0,0,0,765,A
3-PA,1617,762,0,0,0,762,A
3-PA,1618,0,762,0,0,762,T
3-PA,1619,745,0,0,0,745,A
3-PA,1620,1,0,0,735,736,C
3-PA,1621,0,408,0,0,408,T
3-PA,1622,0,0,413,0,413,G
3-PA,1623,0,263,0,0,263,T
3-PA,1624,0,0,265,0,265,G
3-PA,1625,0,243,0,0,243,T
3-PA,1626,0,0,0,137,137,C
3-PA,1627,1,0,0,125,126,C
3-PA,1628,0,118,0,0,118,T
3-PA,1629,0,120,0,0,120,T
3-PA,1630,0,0,117,0,117,G
3-PA,1631,117,0,0,0,117,A
3-PA,1632,0,0,117,0,117,G
3-PA,1633,111,0,0,0,111,A
3-PA,1634,1,111,0,0,112,T
3-PA,1635,111,0,0,0,111,A
3-PA,1636,0,0,113,0,113,G
3-PA,1637,0,0,113,0,113,G
3-PA,1638,111,0,0,0,111,A
3-PA,1639,0,1,109,0,110,G
3-PA,1640,110,0,0,0,110,A
3-PA,1641,0,110,0,0,110,T
3-PA,1642,110,0,0,0,110,A
3-PA,1643,0,110,0,0,110,T
3-PA,1644,0,0,112,0,112,G
3-PA,1645,0,109,0,0,109,T
3-PA,1646,0,109,0,0,109,T
3-PA,1647,111,0,0,0,111,A
3-PA,1648,0,0,0,111,111,C
3-PA,1649,0,108,0,0,108,T
3-PA,1650,109,0,0,0,109,A
3-PA,1651,108,0,0,0,108,A
3-PA,1652,0,0,109,0,109,G
3-PA,1653,103,0,5,0,108,A
3-PA,1654,103,0,0,0,103,A
3-PA,1655,0,0,101,0,101,G
3-PA,1656,0,101,0,0,101,T
3-PA,1657,0,0,101,0,101,G
3-PA,1658,0,0,0,102,102,C
3-PA,1659,0,0,0,103,103,C
3-PA,1660,103,0,0,0,103,A
3-PA,1661,0,102,0,0,102,T
3-PA,1662,102,0,0,0,102,A
3-PA,1663,0,0,102,0,102,G
3-PA,1664,0,0,102,0,102,G
3-PA,1665,0,0,0,100,100,C
3-PA,1666,1,0,0,98,99,C
3-PA,1667,100,0,0,0,100,A
3-PA,1668,99,0,0,0,99,A
3-PA,1669,100,0,0,0,100,A
3-PA,1670,0,101,0,0,101,T
3-PA,1671,0,100,0,0,100,T
3-PA,1672,0,101,0,0,101,T
3-PA,1673,1,0,0,100,101,C
3-PA,1674,99,0,0,0,99,A
3-PA,1675,99,0,0,0,99,A
3-PA,1676,0,0,99,0,99,G
3-PA,1677,0,0,100,0,100,G
3-PA,1678,0,0,0,99,99,C
3-PA,1679,0,0,0,96,96,C
3-PA,1680,96,0,0,0,96,A
3-PA,1681,97,0,0,0,97,A
3-PA,1682,0,98,0,0,98,T
3-PA,1683,0,0,99,0,99,G
3-PA,1684,0,101,0,0,101,T
3-PA,1685,0,103,0,0,103,T
3-PA,1686,0,0,0,106,106,C
3-PA,1687,0,104,0,0,104,T
3-PA,1688,0,104,0,0,104,T
3-PA,1689,96,0,0,0,96,A
3-PA,1690,0,96,0,1,97,T
3-PA,1691,97,0,0,0,97,A
3-PA,1692,0,98,0,0,98,T
3-PA,1693,0,0,97,0,97,G
3-PA,1694,0,87,0,0,87,T
3-PA,1695,0,0,87,0,87,G
3-PA,1696,84,0,1,0,85,A
3-PA,1697,0,0,87,0,87,G
3-PA,1698,0,0,87,0,87,G
3-PA,1699,86,0,1,0,87,A
3-PA,1700,0,0,0,86,86,C
3-PA,1701,85,0,0,0,85,A
3-PA,1702,85,0,0,0,85,A
3-PA,1703,85,0,0,0,85,A
3-PA,1704,0,0,0,85,85,C
3-PA,1705,0,0,83,0,83,G
3-PA,1706,0,0,85,0,85,G
3-PA,1707,84,0,0,0,84,A
3-PA,1708,84,0,0,0,84,A
3-PA,1709,0,0,0,84,84,C
3-PA,1710,84,0,0,0,84,A
3-PA,1711,0,84,0,0,84,T
3-PA,1712,0,0,0,82,82,C
3-PA,1713,82,0,0,0,82,A
3-PA,1714,83,0,0,0,83,A
3-PA,1715,83,0,0,0,83,A
3-PA,1716,0,1,83,0,84,G
3-PA,1717,0,0,84,0,84,G
3-PA,1718,0,83,0,0,83,T
3-PA,1719,0,0,0,83,83,C
3-PA,1720,83,0,0,0,83,A
3-PA,1721,84,0,0,0,84,A
3-PA,1722,83,0,0,0,83,A
3-PA,1723,84,0,0,0,84,A
3-PA,1724,0,84,0,0,84,T
3-PA,1725,0,0,82,0,82,G
3-PA,1726,82,0,0,0,82,A
3-PA,1727,81,0,0,0,81,A
3-PA,1728,82,0,0,0,82,A
3-PA,1729,0,82,0,0,82,T
3-PA,1730,0,1,82,0,83,G
3-PA,1731,0,0,83,0,83,G
3-PA,1732,0,0,83,0,83,G
3-PA,1733,0,0,84,0,84,G
3-PA,1734,80,0,0,0,80,A
3-PA,1735,81,0,0,0,81,A
3-PA,1736,0,81,0,0,81,T
3-PA,1737,0,0,80,0,80,G
3-PA,1738,0,0,80,0,80,G
3-PA,1739,76,0,0,0,76,A
3-PA,1740,0,0,78,0,78,G
3-PA,1741,78,0,0,0,78,A
3-PA,1742,0,78,0,0,78,T
3-PA,1743,0,0,78,0,78,G
3-PA,1744,77,0,0,0,77,A
3-PA,1745,0,0,76,0,76,G
3-PA,1746,80,0,0,0,80,A
3-PA,1747,0,0,0,79,79,C
3-PA,1748,0,0,80,0,80,G
3-PA,1749,0,77,0,0,77,T
3-PA,1750,0,78,0,0,78,T
3-PA,1751,0,0,80,0,80,G
3-PA,1752,0,0,0,78,78,C
3-PA,1753,0,0,0,80,80,C
3-PA,1754,0,81,0,0,81,T
3-PA,1755,0,0,0,82,82,C
3-PA,1756,0,0,0,85,85,C
3-PA,1757,0,83,0,1,84,T
3-PA,1758,0,85,0,0,85,T
3-PA,1759,0,0,0,85,85,C
3-PA,1760,85,0,0,0,85,A
3-PA,1761,0,0,85,0,85,G
3-PA,1762,0,85,0,0,85,T
3-PA,1763,0,0,0,86,86,C
3-PA,1764,84,0,0,0,84,A
3-PA,1765,0,0,0,86,86,C
3-PA,1766,0,86,0,0,86,T
3-PA,1767,1,0,0,83,84,C
3-PA,1768,0,0,0,84,84,C
3-PA,1769,85,0,0,0,85,A
3-PA,1770,0,0,84,0,84,G
3-PA,1771,0,0,0,85,85,C
3-PA,1772,84,0,0,0,84,A
3-PA,1773,0,0,84,0,84,G
3-PA,1774,82,0,0,0,82,A
3-PA,1775,0,83,0,0,83,T
3-PA,1776,0,0,0,83,83,C
3-PA,1777,0,0,83,0,83,G
3-PA,1778,82,0,0,0,82,A
3-PA,1779,0,0,83,0,83,G
3-PA,1780,83,0,0,0,83,A
3-PA,1781,0,0,83,0,83,G
3-PA,1782,0,0,0,82,82,C
3-PA,1783,82,0,0,0,82,A
3-PA,1784,0,82,0,0,82,T
3-PA,1785,0,0,85,0,85,G
3-PA,1786,86,0,0,0,86,A
3-PA,1787,0,87,0,0,87,T
3-PA,1788,0,87,0,0,87,T
3-PA,1789,0,0,87,0,87,G
3-PA,1790,87,0,0,0,87,A
3-PA,1791,87,0,0,0,87,A
3-PA,1792,0,0,87,0,87,G
3-PA,1793,0,0,0,86,86,C
3-PA,1794,0,0,0,86,86,C
3-PA,1795,0,0,85,0,85,G
3-PA,1796,84,0,0,0,84,A
3-PA,1797,0,0,85,0,85,G
3-PA,1798,0,86,0,0,86,T
3-PA,1799,0,0,0,86,86,C
3-PA,1800,0,0,0,86,86,C
3-PA,1801,0,85,1,0,86,T
3-PA,1802,0,0,0,85,85,C
3-PA,1803,0,0,86,0,86,G
3-PA,1804,0,0,89,0,89,G
3-PA,1805,0,89,0,0,89,T
3-PA,1806,0,88,0,0,88,T
3-PA,1807,88,0,0,0,88,A
3-PA,1808,88,0,0,0,88,A
3-PA,1809,88,0,0,0,88,A
3-PA,1810,0,0,89,0,89,G
3-PA,1811,89,0,0,0,89,A
3-PA,1812,0,0,90,0,90,G
3-PA,1813,88,0,0,0,88,A
3-PA,1814,88,0,0,0,88,A
3-PA,1815,88,1,0,0,89,A
3-PA,1816,0,0,90,0,90,G
3-PA,1817,90,0,0,0,90,A
3-PA,1818,0,0,0,88,88,C
3-PA,1819,87,0,0,0,87,A
3-PA,1820,0,87,0,0,87,T
3-PA,1821,0,0,90,0,90,G
3-PA,1822,90,0,0,0,90,A
3-PA,1823,0,0,0,89,89,C
3-PA,1824,0,0,0,89,89,C
3-PA,1825,90,0,0,0,90,A
3-PA,1826,91,0,0,0,91,A
3-PA,1827,90,0,0,0,90,A
3-PA,1828,0,0,92,0,92,G
3-PA,1829,92,0,0,0,92,A
3-PA,1830,0,0,92,0,92,G
3-PA,1831,0,90,1,0,91,T
3-PA,1832,0,89,0,0,89,T
3-PA,1833,0,90,0,0,90,T
3-PA,1834,0,89,0,0,89,T
3-PA,1835,0,90,0,0,90,T
3-PA,1836,0,89,0,0,89,T
3-PA,1837,0,0,90,0,90,G
3-PA,1838,87,0,0,0,87,A
3-PA,1839,0,0,91,0,91,G
3-PA,1840,92,0,0,0,92,A
3-PA,1841,92,0,0,0,92,A
3-PA,1842,0,92,0,0,92,T
3-PA,1843,92,0,0,0,92,A
3-PA,1844,93,0,0,0,93,A
3-PA,1845,94,0,0,0,94,A
3-PA,1846,0,94,0,0,94,T
3-PA,1847,0,0,0,94,94,C
3-PA,1848,95,0,0,0,95,A
3-PA,1849,0,0,97,0,97,G
3-PA,1850,96,0,0,0,96,A
3-PA,1851,96,0,0,0,96,A
3-PA,1852,0,0,96,0,96,G
3-PA,1853,0,0,0,95,95,C
3-PA,1854,96,0,0,0,96,A
3-PA,1855,0,95,0,0,95,T
3-PA,1856,0,0,96,0,96,G
3-PA,1857,0,0,96,0,96,G
3-PA,1858,0,0,0,96,96,C
3-PA,1859,0,0,0,99,99,C
3-PA,1860,0,0,0,100,100,C
3-PA,1861,98,0,0,0,98,A
3-PA,1862,0,99,0,0,99,T
3-PA,1863,0,100,0,0,100,T
3-PA,1864,0,0,99,0,99,G
3-PA,1865,0,0,100,0,100,G
3-PA,1866,0,1,96,0,97,G
3-PA,1867,0,0,94,0,94,G
3-PA,1868,90,0,0,0,90,A
3-PA,1869,0,0,90,0,90,G
3-PA,1870,0,90,0,0,90,T
3-PA,1871,0,0,0,91,91,C
3-PA,1872,1,0,0,93,94,C
3-PA,1873,0,0,0,94,94,C
3-PA,1874,0,0,0,95,95,C
3-PA,1875,1,0,0,94,95,C
3-PA,1876,95,0,0,0,95,A
3-PA,1877,95,0,0,0,95,A
3-PA,1878,0,0,95,0,95,G
3-PA,1879,0,0,94,0,94,G
3-PA,1880,0,0,95,0,95,G
3-PA,1881,79,0,0,0,79,A
3-PA,1882,0,0,79,0,79,G
3-PA,1883,0,79,0,0,79,T
3-PA,1884,0,0,80,0,80,G
3-PA,1885,0,0,80,0,80,G
3-PA,1886,80,0,0,0,80,A
3-PA,1887,80,0,0,0,80,A
3-PA,1888,0,0,80,0,80,G
3-PA,1889,78,0,0,0,78,A
3-PA,1890,77,0,0,0,77,A
3-PA,1891,0,0,79,0,79,G
3-PA,1892,0,0,79,0,79,G
3-PA,1893,0,78,0,0,78,T
3-PA,1894,0,77,0,0,77,T
3-PA,1895,1,0,0,76,77,C
3-PA,1896,0,0,0,77,77,C
3-PA,1897,77,0,0,0,77,A
3-PA,1898,0,76,0,0,76,T
3-PA,1899,0,76,0,0,76,T
3-PA,1900,0,0,77,0,77,G
3-PA,1901,0,1,76,0,77,G
3-PA,1902,0,0,78,0,78,G
3-PA,1903,77,0,0,0,77,A
3-PA,1904,77,0,0,0,77,A
3-PA,1905,76,1,0,0,77,A
3-PA,1906,0,0,83,0,83,G
3-PA,1907,0,83,0,0,83,T
3-PA,1908,1,0,0,82,83,C
3-PA,1909,0,83,0,0,83,T
3-PA,1910,0,0,83,0,83,G
3-PA,1911,0,83,0,0,83,T
3-PA,1912,83,0,0,0,83,A
3-PA,1913,0,0,84,0,84,G
3-PA,1914,0,1,83,0,84,G
3-PA,1915,82,0,0,0,82,A
3-PA,1916,0,0,0,82,82,C
3-PA,1917,0,79,0,0,79,T
3-PA,1918,0,0,0,83,83,C
3-PA,1919,0,83,0,0,83,T
3-PA,1920,83,0,0,0,83,A
3-PA,1921,0,82,0,0,82,T
3-PA,1922,0,81,0,0,81,T
3-PA,1923,0,0,81,0,81,G
3-PA,1924,0,0,81,0,81,G
3-PA,1925,0,0,0,80,80,C
3-PA,1926,0,78,0,0,78,T
3-PA,1927,72,0,0,0,72,A
3-PA,1928,73,0,0,0,73,A
3-PA,1929,0,0,73,0,73,G
3-PA,1930,0,73,0,0,73,T
3-PA,1931,0,0,0,73,73,C
3-PA,1932,71,0,0,0,71,A
3-PA,1933,0,0,74,0,74,G
3-PA,1934,0,74,0,0,74,T
3-PA,1935,78,0,0,0,78,A
3-PA,1936,0,78,0,0,78,T
3-PA,1937,0,80,0,0,80,T
3-PA,1938,0,0,0,80,80,C
3-PA,1939,79,0,0,0,79,A
3-PA,1940,80,0,0,0,80,A
3-PA,1941,0,80,0,0,80,T
3-PA,1942,69,0,0,0,69,A
3-PA,1943,0,0,71,0,71,G
3-PA,1944,0,0,0,71,71,C
3-PA,1945,0,0,0,70,70,C
3-PA,1946,0,69,0,0,69,T
3-PA,1947,0,0,72,0,72,G
3-PA,1948,0,72,0,0,72,T
3-PA,1949,71,0,1,0,72,A
3-PA,1950,0,72,0,0,72,T
3-PA,1951,0,0,71,0,71,G
3-PA,1952,0,0,0,70,70,C
3-PA,1953,69,0,1,0,70,A
3-PA,1954,0,70,0,0,70,T
3-PA,1955,0,0,0,70,70,C
3-PA,1956,70,0,0,0,70,A
3-PA,1957,0,0,0,72,72,C
3-PA,1958,0,0,0,71,71,C
3-PA,1959,72,0,0,0,72,A
3-PA,1960,0,0,0,74,74,C
3-PA,1961,72,0,0,0,72,A
3-PA,1962,72,0,0,0,72,A
3-PA,1963,0,71,0,0,71,T
3-PA,1964,0,70,0,0,70,T
3-PA,1965,0,1,70,0,71,G
3-PA,1966,0,0,71,0,71,G
3-PA,1967,68,0,1,0,69,A
3-PA,1968,71,0,0,0,71,A
3-PA,1969,0,0,71,0,71,G
3-PA,1970,0,0,73,0,73,G
3-PA,1971,71,0,0,0,71,A
3-PA,1972,0,72,0,0,72,T
3-PA,1973,0,70,0,0,70,T
3-PA,1974,0,72,0,0,72,T
3-PA,1975,0,72,0,0,72,T
3-PA,1976,0,0,0,72,72,C
3-PA,1977,72,0,0,0,72,A
3-PA,1978,0,0,72,0,72,G
3-PA,1979,0,0,0,71,71,C
3-PA,1980,0,0,72,0,72,G
3-PA,1981,0,0,72,0,72,G
3-PA,1982,71,0,0,0,71,A
3-PA,1983,0,0,71,0,71,G
3-PA,1984,0,71,0,0,71,T
3-PA,1985,0,0,0,75,75,C
3-PA,1986,75,0,0,0,75,A
3-PA,1987,74,0,1,0,75,A
3-PA,1988,0,0,75,0,75,G
3-PA,1989,75,0,0,0,75,A
3-PA,1990,75,0,0,0,75,A
3-PA,1991,74,0,0,0,74,A
3-PA,1992,72,0,2,0,74,A
3-PA,1993,0,0,0,74,74,C
3-PA,1994,0,70,0,0,70,T
3-PA,1995,0,0,70,0,70,G
3-PA,1996,0,0,0,70,70,C
3-PA,1997,0,70,0,0,70,T
3-PA,1998,0,0,0,70,70,C
3-PA,1999,0,0,0,69,69,C
3-PA,2000,0,67,0,0,67,T
3-PA,2001,0,69,0,0,69,T
3-PA,2002,0,0,69,0,69,G
3-PA,2003,0,69,0,0,69,T
3-PA,2004,0,69,0,0,69,T
3-PA,2005,0,0,69,0,69,G
3-PA,2006,0,69,0,0,69,T
3-PA,2007,0,69,0,0,69,T
3-PA,2008,0,0,0,69,69,C
3-PA,2009,68,0,0,0,68,A
3-PA,2010,0,0,69,0,69,G
3-PA,2011,0,0,69,0,69,G
3-PA,2012,0,0,0,70,70,C
3-PA,2013,0,71,0,0,71,T
3-PA,2014,1,0,0,70,71,C
3-PA,2015,0,71,0,0,71,T
3-PA,2016,0,70,0,0,70,T
3-PA,2017,71,0,0,0,71,A
3-PA,2018,0,0,71,0,71,G
3-PA,2019,0,0,71,0,71,G
3-PA,2020,0,0,68,0,68,G
3-PA,2021,66,0,2,0,68,A
3-PA,2022,0,0,0,68,68,C
3-PA,2023,62,0,0,0,62,A
3-PA,2024,64,0,0,0,64,A
3-PA,2025,0,0,0,66,66,C
3-PA,2026,0,0,0,66,66,C
3-PA,2027,0,66,0,0,66,T
3-PA,2028,0,0,0,66,66,C
3-PA,2029,0,0,66,0,66,G
3-PA,2030,66,0,0,0,66,A
3-PA,2031,66,0,0,0,66,A
3-PA,2032,0,0,0,67,67,C
3-PA,2033,0,0,0,63,63,C
3-PA,2034,0,63,0,0,63,T
3-PA,2035,0,0,63,0,63,G
3-PA,2036,0,0,63,0,63,G
3-PA,2037,0,0,63,0,63,G
3-PA,2038,63,0,0,0,63,A
3-PA,2039,1,0,0,62,63,C
3-PA,2040,0,0,0,65,65,C
3-PA,2041,0,66,0,0,66,T
3-PA,2042,0,66,0,0,66,T
3-PA,2043,0,65,0,0,65,T
3-PA,2044,0,0,65,0,65,G
3-PA,2045,66,0,0,0,66,A
3-PA,2046,0,66,0,0,66,T
3-PA,2047,0,0,0,65,65,C
3-PA,2048,0,66,0,0,66,T
3-PA,2049,0,66,0,0,66,T
3-PA,2050,0,0,66,0,66,G
3-PA,2051,0,0,66,0,66,G
3-PA,2052,0,0,65,0,65,G
3-PA,2053,0,1,65,0,66,G
3-PA,2054,0,0,64,0,64,G
3-PA,2055,0,0,65,0,65,G
3-PA,2056,0,0,0,64,64,C
3-PA,2057,0,64,0,0,64,T
3-PA,2058,65,0,0,0,65,A
3-PA,2059,0,65,0,0,65,T
3-PA,2060,65,0,0,0,65,A
3-PA,2061,0,65,0,0,65,T
3-PA,2062,0,0,64,0,64,G
3-PA,2063,62,0,0,0,62,A
3-PA,2064,63,0,0,0,63,A
3-PA,2065,0,0,62,0,62,G
3-PA,2066,0,0,0,63,63,C
3-PA,2067,58,0,0,0,58,A
3-PA,2068,61,0,0,0,61,A
3-PA,2069,0,60,0,0,60,T
3-PA,2070,0,61,0,0,61,T
3-PA,2071,0,0,61,0,61,G
3-PA,2072,60,1,0,0,61,A
3-PA,2073,0,0,61,0,61,G
3-PA,2074,0,0,60,0,60,G
3-PA,2075,60,0,0,0,60,A
3-PA,2076,0,0,60,0,60,G
3-PA,2077,0,56,0,0,56,T
3-PA,2078,0,0,56,0,56,G
3-PA,2079,1,0,0,55,56,C
3-PA,2080,0,0,0,56,56,C
3-PA,2081,0,56,0,0,56,T
3-PA,2082,1,0,55,0,56,G
3-PA,2083,56,0,0,0,56,A
3-PA,2084,0,56,0,0,56,T
3-PA,2085,0,54,0,0,54,T
3-PA,2086,53,0,0,0,53,A
3-PA,2087,53,0,0,0,53,A
3-PA,2088,0,52,0,0,52,T
3-PA,2089,0,0,52,0,52,G
3-PA,2090,53,0,0,0,53,A
3-PA,2091,0,50,0,1,51,T
3-PA,2092,0,0,0,51,51,C
3-PA,2093,1,0,0,51,52,C
3-PA,2094,0,0,0,52,52,C
3-PA,2095,0,52,0,0,52,T
3-PA,2096,0,0,52,0,52,G
3-PA,2097,0,0,52,0,52,G
3-PA,2098,0,0,52,0,52,G
3-PA,2099,0,52,0,0,52,T
3-PA,2100,0,50,0,0,50,T
3-PA,2101,0,50,0,0,50,T
3-PA,2102,0,48,0,0,48,T
3-PA,2103,0,0,49,0,49,G
3-PA,2104,1,0,0,48,49,C
3-PA,2105,0,48,0,0,48,T
3-PA,2106,0,0,0,48,48,C
3-PA,2107,46,0,0,0,46,A
3-PA,2108,46,0,0,0,46,A
3-PA,2109,0,46,0,0,46,T
3-PA,2110,0,0,46,0,46,G
3-PA,2111,0,0,0,46,46,C
3-PA,2112,0,0,45,0,45,G
3-PA,2113,0,45,0,0,45,T
3-PA,2114,0,0,0,45,45,C
3-PA,2115,0,45,0,0,45,T
3-PA,2116,0,45,0,0,45,T
3-PA,2117,0,0,45,0,45,G
3-PA,2118,0,0,44,0,44,G
3-PA,2119,0,45,0,0,45,T
3-PA,2120,0,45,0,0,45,T
3-PA,2121,0,0,0,45,45,C
3-PA,2122,43,0,0,0,43,A
3-PA,2123,44,0,0,0,44,A
3-PA,2124,0,0,0,44,44,C
3-PA,2125,0,44,0,0,44,T
3-PA,2126,0,0,0,43,43,C
3-PA,2127,0,0,0,42,42,C
3-PA,2128,0,41,0,0,41,T
3-PA,2129,0,41,0,0,41,T
3-PA,2130,0,0,0,41,41,C
3-PA,2131,0,0,0,41,41,C
3-PA,2132,0,40,0,0,40,T
3-PA,2133,0,0,40,0,40,G
3-PA,2134,40,0,0,0,40,A
3-PA,2135,0,0,0,39,39,C
3-PA,2136,38,0,0,0,38,A
3-PA,2137,0,0,0,35,35,C
3-PA,2138,33,0,0,0,33,A
3-PA,2139,0,34,0,0,34,T
3-PA,2140,0,0,34,0,34,G
3-PA,2141,0,0,0,34,34,C
3-PA,2142,34,0,0,0,34,A
3-PA,2143,0,34,0,0,34,T
3-PA,2144,0,34,0,0,34,T
3-PA,2145,34,0,0,0,34,A
3-PA,2146,34,0,0,0,34,A
3-PA,2147,34,0,0,0,34,A
3-PA,2148,34,0,0,0,34,A
3-PA,2149,0,34,0,0,34,T
3-PA,2150,24,0,0,0,24,A
3-PA,2151,0,0,24,0,24,G
4-HA,1,294,0,0,0,294,A
4-HA,2,0,295,0,0,295,T
4-HA,3,0,0,300,0,300,G
4-HA,4,300,1,0,0,301,A
4-HA,5,301,0,0,0,301,A
4-HA,6,0,0,338,0,338,G
4-HA,7,335,0,0,0,335,A
4-HA,8,0,0,0,362,362,C
4-HA,9,0,364,0,1,365,T
4-HA,10,372,0,1,0,373,A
4-HA,11,0,394,0,0,394,T
4-HA,12,1,0,0,397,398,C
4-HA,13,398,0,0,0,398,A
4-HA,14,0,399,0,0,399,T
4-HA,15,0,399,0,0,399,T
4-HA,16,0,1,436,0,437,G
4-HA,17,0,0,0,436,436,C
4-HA,18,0,438,0,0,438,T
4-HA,19,0,437,0,0,437,T
4-HA,20,0,440,0,0,440,T
4-HA,21,0,1,466,0,467,G
4-HA,22,467,0,0,0,467,A
4-HA,23,0,0,489,0,489,G
4-HA,24,0,0,0,493,493,C
4-HA,25,0,495,0,0,495,T
4-HA,26,539,0,0,0,539,A
4-HA,27,0,0,0,547,547,C
4-HA,28,557,0,1,0,558,A
4-HA,29,0,588,0,0,588,T
4-HA,30,0,587,0,0,587,T
4-HA,31,0,1,0,592,593,C
4-HA,32,0,592,0,0,592,T
4-HA,33,606,0,0,0,606,A
4-HA,34,0,606,0,1,607,T
4-HA,35,0,1,608,0,609,G
4-HA,36,0,607,0,0,607,T
4-HA,37,8,0,0,595,603,C
4-HA,38,0,603,0,0,603,T
4-HA,39,0,1,601,0,602,G
4-HA,40,2,0,601,0,603,G
4-HA,41,0,603,0,0,603,T
4-HA,42,0,605,0,2,607,T
4-HA,43,0,604,0,1,605,T
4-HA,44,0,608,0,1,609,T
4-HA,45,0,0,0,608,608,C
4-HA,46,0,0,608,0,608,G
4-HA,47,0,1,0,616,617,C
4-HA,48,0,616,0,1,617,T
4-HA,49,3,0,0,619,622,C
4-HA,50,619,0,0,0,619,A
4-HA,51,623,0,0,0,623,A
4-HA,52,619,0,0,0,619,A
4-HA,53,623,0,0,0,623,A
4-HA,54,620,0,1,0,621,A
4-HA,55,0,0,0,626,626,C
4-HA,56,0,622,0,0,622,T
4-HA,57,0,626,0,0,626,T
4-HA,58,0,0,0,626,626,C
4-HA,59,0,0,0,625,625,C
4-HA,60,0,627,0,0,627,T
4-HA,61,0,2,631,0,633,G
4-HA,62,1,1,629,0,631,G
4-HA,63,637,0,0,0,637,A
4-HA,64,633,0,0,13,646,A
4-HA,65,642,0,0,1,643,A
4-HA,66,0,650,0,1,651,T
4-HA,67,0,2,659,0,661,G
4-HA,68,661,0,1,0,662,A
4-HA,69,0,1,0,666,667,C
4-HA,70,667,0,0,0,667,A
4-HA,71,664,0,2,0,666,A
4-HA,72,0,1,0,672,673,C
4-HA,73,670,0,0,0,670,A
4-HA,74,0,0,676,0,676,G
4-HA,75,0,0,0,674,674,C
4-HA,76,673,0,1,0,674,A
4-HA,77,0,1,1,690,692,C
4-HA,78,0,2,690,0,692,G
4-HA,79,0,0,694,0,694,G
4-HA,80,0,0,0,695,695,C
4-HA,81,692,1,0,0,693,A
4-HA,82,703,0,0,0,703,A
4-HA,83,1,1,0,709,711,C
4-HA,84,0,1,716,0,717,G
4-HA,85,0,0,0,720,720,C
4-HA,86,0,712,0,0,712,T
4-HA,87,1,0,719,0,720,G
4-HA,88,0,715,0,0,715,T
4-HA,89,0,0,737,0,737,G
4-HA,90,0,0,0,748,748,C
4-HA,91,0,0,0,763,763,C
4-HA,92,0,754,0,0,754,T
4-HA,93,0,751,0,0,751,T
4-HA,94,0,3,749,0,752,G
4-HA,95,1,1,753,0,755,G
4-HA,96,0,0,764,0,764,G
4-HA,97,0,0,0,768,768,C
4-HA,98,765,0,1,0,766,A
4-HA,99,0,0,0,776,776,C
4-HA,100,2,0,0,767,769,C
4-HA,101,829,0,1,0,830,A
4-HA,102,0,830,0,0,830,T
4-HA,103,0,0,834,1,835,G
4-HA,104,0,0,0,836,836,C
4-HA,105,831,1,0,0,832,A
4-HA,106,1,0,890,1,892,G
4-HA,107,0,892,0,0,892,T
4-HA,108,898,0,0,0,898,A
4-HA,109,0,0,0,898,898,C
4-HA,110,1,0,0,877,878,C
4-HA,111,883,0,1,0,884,A
4-HA,112,877,1,0,0,878,A
4-HA,113,884,0,1,0,885,A
4-HA,114,0,0,0,889,889,C
4-HA,115,0,0,874,0,874,G
4-HA,116,0,1,886,0,887,G
4-HA,117,882,0,0,0,882,A
4-HA,118,882,0,4,0,886,A
4-HA,119,1,1,0,885,887,C
4-HA,120,1,1,882,0,884,G
4-HA,121,0,0,882,0,882,G
4-HA,122,0,916,0,0,916,T
4-HA,123,924,0,0,0,924,A
4-HA,124,0,0,926,0,926,G
4-HA,125,0,907,0,2,909,T
4-HA,126,1,2,913,0,916,G
4-HA,127,916,0,1,0,917,A
4-HA,128,916,1,1,0,918,A
4-HA,129,917,0,1,0,918,A
4-HA,130,897,0,0,1,898,A
4-HA,131,0,0,0,902,902,C
4-HA,132,903,0,0,0,903,A
4-HA,133,908,0,0,0,908,A
4-HA,134,0,904,0,1,905,T
4-HA,135,0,0,0,902,902,C
4-HA,136,905,0,0,0,905,A
4-HA,137,0,1,0,911,912,C
4-HA,138,0,2,909,1,912,G
4-HA,139,906,0,0,0,906,A
4-HA,140,909,0,0,0,909,A
4-HA,141,0,906,0,0,906,T
4-HA,142,0,0,908,0,908,G
4-HA,143,912,0,3,0,915,A
4-HA,144,1,0,0,913,914,C
4-HA,145,2,1,0,914,917,C
4-HA,146,923,0,0,0,923,A
4-HA,147,922,0,0,0,922,A
4-HA,148,925,0,0,0,925,A
4-HA,149,0,921,1,0,922,T
4-HA,150,0,919,1,1,921,T
4-HA,151,0,0,930,0,930,G
4-HA,152,924,0,1,0,925,A
4-HA,153,926,0,1,0,927,A
4-HA,154,0,0,935,0,935,G
4-HA,155,0,938,0,1,939,T
4-HA,156,0,965,0,0,965,T
4-HA,157,973,0,0,0,973,A
4-HA,158,0,0,0,978,978,C
4-HA,159,0,981,0,0,981,T
4-HA,160,977,0,0,0,977,A
4-HA,161,1001,0,0,0,1001,A
4-HA,162,0,1000,0,0,1000,T
4-HA,163,1,0,1000,0,1001,G
4-HA,164,0,0,0,1039,1039,C
4-HA,165,0,1033,0,1,1034,T
4-HA,166,1037,0,1,0,1038,A
4-HA,167,0,0,0,1037,1037,C
4-HA,168,0,1032,0,0,1032,T
4-HA,169,0,2,1032,0,1034,G
4-HA,170,1025,0,0,1,1026,A
4-HA,171,1,0,1033,0,1034,G
4-HA,172,1,0,0,1032,1033,C
4-HA,173,0,1013,0,1,1014,T
4-HA,174,0,2,1034,0,1036,G
4-HA,175,0,1,1049,1,1051,G
4-HA,176,1,1051,0,0,1052,T
4-HA,177,0,1052,0,1,1053,T
4-HA,178,2,0,1,1049,1052,C
4-HA,179,1050,1,0,0,1051,A
4-HA,180,0,2,1058,0,1060,G
4-HA,181,1056,0,0,0,1056,A
4-HA,182,1,1,1079,0,1081,G
4-HA,183,0,1075,0,0,1075,T
4-HA,184,1,1064,0,1,1066,T
4-HA,185,2,0,0,1070,1072,C
4-HA,186,1,0,0,1073,1074,C
4-HA,187,0,1068,0,0,1068,T
4-HA,188,1,0,0,1075,1076,C
4-HA,189,1071,0,0,0,1071,A
4-HA,190,1074,0,0,0,1074,A
4-HA,191,0,0,0,1081,1081,C
4-HA,192,1057,0,2,0,1059,A
4-HA,193,0,1,1087,0,1088,G
4-HA,194,1,0,1085,0,1086,G
4-HA,195,0,1082,0,1,1083,T
4-HA,196,1,0,1087,0,1088,G
4-HA,197,1089,0,1,0,1090,A
4-HA,198,1089,0,1,0,1090,A
4-HA,199,1124,0,1,0,1125,A
4-HA,200,0,1112,0,0,1112,T
4-HA,201,1126,0,0,0,1126,A
4-HA,202,1,1109,0,0,1110,T
4-HA,203,2,0,1109,0,1111,G
4-HA,204,0,2,0,1113,1115,C
4-HA,205,8,5,1104,0,1117,G
4-HA,206,1118,0,1,0,1119,A
4-HA,207,0,1,0,1117,1118,C
4-HA,208,1103,0,0,0,1103,A
4-HA,209,0,0,1168,0,1168,G
4-HA,210,0,1158,0,2,1160,T
4-HA,211,0,0,0,1184,1184,C
4-HA,212,1,1,0,1181,1183,C
4-HA,213,1,1174,0,2,1177,T
4-HA,214,3,0,0,1202,1205,C
4-HA,215,1206,0,0,0,1206,A
4-HA,216,0,1203,0,1,1204,T
4-HA,217,2,0,2,1204,1208,C
4-HA,218,1157,0,0,0,1157,A
4-HA,219,0,0,1168,0,1168,G
4-HA,220,1158,0,1,0,1159,A
4-HA,221,0,1156,0,1,1157,T
4-HA,222,3,0,0,1151,1154,C
4-HA,223,3,0,0,1136,1139,C
4-HA,224,0,1134,0,0,1134,T
4-HA,225,0,1134,0,0,1134,T
4-HA,226,0,0,1136,0,1136,G
4-HA,227,1132,0,1,0,1133,A
4-HA,228,1,1127,0,1,1129,T
4-HA,229,0,6,1126,0,1132,G
4-HA,230,0,0,1136,0,1136,G
4-HA,231,1131,0,0,0,1131,A
4-HA,232,1131,0,0,0,1131,A
4-HA,233,1132,0,1,0,1133,A
4-HA,234,1132,0,0,0,1132,A
4-HA,235,1131,0,0,0,1131,A
4-HA,236,1129,0,0,0,1129,A
4-HA,237,0,0,0,1135,1135,C
4-HA,238,0,1124,1,0,1125,T
4-HA,239,0,0,1131,1,1132,G
4-HA,240,1,0,0,1130,1131,C
4-HA,241,1132,0,1,0,1133,A
4-HA,242,1,0,0,1163,1164,C
4-HA,243,1160,1,1,0,1162,A
4-HA,244,1,0,0,1313,1314,C
4-HA,245,0,1305,0,3,1308,T
4-HA,246,1323,0,0,0,1323,A
4-HA,247,1325,0,0,0,1325,A
4-HA,248,0,1327,0,0,1327,T
4-HA,249,1327,0,0,1,1328,A
4-HA,250,0,0,1328,0,1328,G
4-HA,251,1307,0,0,0,1307,A
4-HA,252,0,1274,0,0,1274,T
4-HA,253,0,0,1203,0,1203,G
4-HA,254,1,0,0,1211,1212,C
4-HA,255,0,1200,0,1,1201,T
4-HA,256,2,0,0,1280,1282,C
4-HA,257,0,1276,0,1,1277,T
4-HA,258,1316,0,0,0,1316,A
4-HA,259,0,1313,0,1,1314,T
4-HA,260,1,1313,0,0,1314,T
4-HA,261,0,6,1314,1,1321,G
4-HA,262,0,3,1311,0,1314,G
4-HA,263,0,3,1320,0,1323,G
4-HA,264,1299,1,2,0,1302,A
4-HA,265,0,1,1276,1,1278,G
4-HA,266,1255,0,2,0,1257,A
4-HA,267,1,1,2,1354,1358,C
4-HA,268,4,0,0,1374,1378,C
4-HA,269,4,1,0,1379,1384,C
4-HA,270,1,1385,0,2,1388,T
4-HA,271,0,1,1,1416,1418,C
4-HA,272,1413,0,0,0,1413,A
4-HA,273,0,0,1510,0,1510,G
4-HA,274,0,1505,0,0,1505,T
4-HA,275,0,2,1522,0,1524,G
4-HA,276,0,1480,0,0,1480,T
4-HA,277,0,0,1477,0,1477,G
4-HA,278,1475,2,1,0,1478,A
4-HA,279,0,1479,0,0,1479,T
4-HA,280,0,3,1466,0,1469,G
4-HA,281,0,0,1475,0,1475,G
4-HA,282,0,2,0,1450,1452,C
4-HA,283,0,1448,0,2,1450,T
4-HA,284,0,1449,0,0,1449,T
4-HA,285,1,2,0,1455,1458,C
4-HA,286,3,0,0,1451,1454,C
4-HA,287,1461,0,0,0,1461,A
4-HA,288,1467,0,0,0,1467,A
4-HA,289,1469,0,0,0,1469,A
4-HA,290,1474,0,0,0,1474,A
4-HA,291,0,1477,0,0,1477,T
4-HA,292,1472,0,1,0,1473,A
4-HA,293,1483,0,0,0,1483,A
4-HA,294,0,1,1484,0,1485,G
4-HA,295,1497,0,0,0,1497,A
4-HA,296,1502,0,2,0,1504,A
4-HA,297,1500,0,0,0,1500,A
4-HA,298,0,1497,0,0,1497,T
4-HA,299,0,9,1487,0,1496,G
4-HA,300,1,4,1492,1,1498,G
4-HA,301,0,4,1499,0,1503,G
4-HA,302,1501,0,2,0,1503,A
4-HA,303,0,0,0,1506,1506,C
4-HA,304,1,1,0,1507,1509,C
4-HA,305,0,1531,0,0,1531,T
4-HA,306,0,1530,0,1,1531,T
4-HA,307,0,1531,0,0,1531,T
4-HA,308,1,1542,0,0,1543,T
4-HA,309,0,1543,0,0,1543,T
4-HA,310,0,0,1546,0,1546,G
4-HA,311,0,1548,0,1,1549,T
4-HA,312,1,1540,0,1,1542,T
4-HA,313,0,2,1536,0,1538,G
4-HA,314,1533,0,0,0,1533,A
4-HA,315,1540,0,1,1,1542,A
4-HA,316,0,0,0,1541,1541,C
4-HA,317,2,0,1536,0,1538,G
4-HA,318,0,0,0,1557,1557,C
4-HA,319,1551,0,1,2,1554,A
4-HA,320,0,0,1559,0,1559,G
4-HA,321,0,0,0,1558,1558,C
4-HA,322,1555,0,0,0,1555,A
4-HA,323,1556,0,0,0,1556,A
4-HA,324,1560,0,2,0,1562,A
4-HA,325,1,0,1641,0,1642,G
4-HA,326,0,0,0,1637,1637,C
4-HA,327,0,1,0,1639,1640,C
4-HA,328,0,1643,0,0,1643,T
4-HA,329,1638,0,1,0,1639,A
4-HA,330,0,0,0,1668,1668,C
4-HA,331,1665,0,2,0,1667,A
4-HA,332,1,1,1667,0,1669,G
4-HA,333,0,0,0,1662,1662,C
4-HA,334,1631,0,0,0,1631,A
4-HA,335,1643,0,0,0,1643,A
4-HA,336,0,0,0,1714,1714,C
4-HA,337,0,1705,0,0,1705,T
4-HA,338,0,1,1718,0,1719,G
4-HA,339,0,1705,0,1,1706,T
4-HA,340,0,1709,0,0,1709,T
4-HA,341,1716,0,0,0,1716,A
4-HA,342,1,0,0,1844,1845,C
4-HA,343,2,0,0,1850,1852,C
4-HA,344,8,1,1,1886,1896,C
4-HA,345,0,1843,1,2,1846,T
4-HA,346,0,1843,0,0,1843,T
4-HA,347,1846,0,1,0,1847,A
4-HA,348,0,1841,0,1,1842,T
4-HA,349,0,0,1841,0,1841,G
4-HA,350,1838,0,1,0,1839,A
4-HA,351,0,1723,0,0,1723,T
4-HA,352,0,0,1760,0,1760,G
4-HA,353,0,1724,0,0,1724,T
4-HA,354,1,0,1724,0,1725,G
4-HA,355,0,2,0,1723,1725,C
4-HA,356,2,2,0,1715,1719,C
4-HA,357,2,2,1762,0,1766,G
4-HA,358,1,2,1770,0,1773,G
4-HA,359,1781,0,0,0,1781,A
4-HA,360,0,1780,0,1,1781,T
4-HA,361,0,1747,0,0,1747,T
4-HA,362,1756,0,1,0,1757,A
4-HA,363,0,1755,0,0,1755,T
4-HA,364,0,0,1759,0,1759,G
4-HA,365,0,0,0,1757,1757,C
4-HA,366,3,0,1,1743,1747,C
4-HA,367,0,1770,0,0,1770,T
4-HA,368,1,0,0,1859,1860,C
4-HA,369,5,0,0,1872,1877,C
4-HA,370,7,0,0,1878,1885,C
4-HA,371,0,1880,0,0,1880,T
4-HA,372,0,1879,0,0,1879,T
4-HA,373,1881,0,1,1,1883,A
4-HA,374,1,1,1932,0,1934,G
4-HA,375,0,1,1940,0,1941,G
4-HA,376,0,1916,0,1,1917,T
4-HA,377,4,0,0,1882,1886,C
4-HA,378,1877,0,0,0,1877,A
4-HA,379,0,0,0,1917,1917,C
4-HA,380,1,1919,0,0,1920,T
4-HA,381,1915,0,1,0,1916,A
4-HA,382,1,0,1916,0,1917,G
4-HA,383,0,1884,0,0,1884,T
4-HA,384,0,1869,0,2,1871,T
4-HA,385,0,0,1892,0,1892,G
4-HA,386,0,0,0,1893,1893,C
4-HA,387,3,0,0,1885,1888,C
4-HA,388,0,1869,0,4,1873,T
4-HA,389,0,1,1,1877,1879,C
4-HA,390,1938,1,0,0,1939,A
4-HA,391,0,1947,0,0,1947,T
4-HA,392,0,0,0,1952,1952,C
4-HA,393,3,1,0,1946,1950,C
4-HA,394,1,4,1921,0,1926,G
4-HA,395,5,1,1934,0,1940,G
4-HA,396,0,1,0,1949,1950,C
4-HA,397,1968,1,1,0,1970,A
4-HA,398,0,0,0,1991,1991,C
4-HA,399,1954,0,2,0,1956,A
4-HA,400,1,0,0,1965,1966,C
4-HA,401,0,1959,0,1,1960,T
4-HA,402,0,4,1976,0,1980,G
4-HA,403,0,3,1984,0,1987,G
4-HA,404,1978,0,3,0,1981,A
4-HA,405,1,1,2011,0,2013,G
4-HA,406,1,1994,1,1,1997,T
4-HA,407,0,1987,0,1,1988,T
4-HA,408,0,1991,0,13,2004,T
4-HA,409,1996,0,0,0,1996,A
4-HA,410,1999,0,4,0,2003,A
4-HA,411,1,1,0,2020,2022,C
4-HA,412,1983,0,0,0,1983,A
4-HA,413,1978,0,6,0,1984,A
4-HA,414,1,1967,0,0,1968,T
4-HA,415,0,4,1966,0,1970,G
4-HA,416,1968,0,0,0,1968,A
4-HA,417,1961,1,1,0,1963,A
4-HA,418,1960,0,4,0,1964,A
4-HA,419,0,1,1975,0,1976,G
4-HA,420,0,0,0,1988,1988,C
4-HA,421,0,1979,0,2,1981,T
4-HA,422,0,1983,0,1,1984,T
4-HA,423,1,1,1,2009,2012,C
4-HA,424,2014,0,1,0,2015,A
4-HA,425,2010,0,0,0,2010,A
4-HA,426,0,2015,0,0,2015,T
4-HA,427,1,2004,0,0,2005,T
4-HA,428,1,8,2043,0,2052,G
4-HA,429,0,2,2070,0,2072,G
4-HA,430,2077,1,0,0,2078,A
4-HA,431,1,1,1,2073,2076,C
4-HA,432,1,2049,0,2,2052,T
4-HA,433,0,0,2063,0,2063,G
4-HA,434,0,3,2066,0,2069,G
4-HA,435,2062,3,1,0,2066,A
4-HA,436,0,0,2070,0,2070,G
4-HA,437,0,2036,0,0,2036,T
4-HA,438,4,0,1,2012,2017,C
4-HA,439,2039,0,0,0,2039,A
4-HA,440,0,0,0,2046,2046,C
4-HA,441,0,2043,1,1,2045,T
4-HA,442,3,0,0,2039,2042,C
4-HA,443,2020,0,0,0,2020,A
4-HA,444,2025,0,0,0,2025,A
4-HA,445,2023,0,0,0,2023,A
4-HA,446,2026,1,2,0,2029,A
4-HA,447,1,3,0,2034,2038,C
4-HA,448,2,7,2009,0,2018,G
4-HA,449,0,3,2049,0,2052,G
4-HA,450,2055,0,2,0,2057,A
4-HA,451,2051,0,5,0,2056,A
4-HA,452,0,0,0,2056,2056,C
4-HA,453,2050,0,0,0,2050,A
4-HA,454,2077,0,3,0,2080,A
4-HA,455,0,2,2088,0,2090,G
4-HA,456,1,0,0,2086,2087,C
4-HA,457,0,2076,0,0,2076,T
4-HA,458,2,0,0,2095,2097,C
4-HA,459,0,2085,0,0,2085,T
4-HA,460,1,0,2094,0,2095,G
4-HA,461,1,0,0,2101,2102,C
4-HA,462,0,2100,0,5,2105,T
4-HA,463,0,2156,1,1,2158,T
4-HA,464,1,1,2195,0,2197,G
4-HA,465,3,2,0,2214,2219,C
4-HA,466,2224,0,0,1,2225,A
4-HA,467,1,2202,0,0,2203,T
4-HA,468,2188,0,0,0,2188,A
4-HA,469,2171,0,2,0,2173,A
4-HA,470,2,6,2168,0,2176,G
4-HA,471,0,3,2170,0,2173,G
4-HA,472,2060,2,2,0,2064,A
4-HA,473,0,1,2031,0,2032,G
4-HA,474,2015,0,3,0,2018,A
4-HA,475,0,2060,0,0,2060,T
4-HA,476,0,0,0,2067,2067,C
4-HA,477,0,2069,1,0,2070,T
4-HA,478,2066,0,1,0,2067,A
4-HA,479,2059,0,0,0,2059,A
4-HA,480,2044,0,0,1,2045,A
4-HA,481,2049,0,0,1,2050,A
4-HA,482,2049,2,1,0,2052,A
4-HA,483,2,0,0,2060,2062,C
4-HA,484,1996,0,1,0,1997,A
4-HA,485,2,1,2025,0,2028,G
4-HA,486,0,2015,0,1,2016,T
4-HA,487,0,2063,0,0,2063,T
4-HA,488,1,2064,0,1,2066,T
4-HA,489,2,0,1,2112,2115,C
4-HA,490,0,2115,1,2,2118,T
4-HA,491,0,2115,0,1,2116,T
4-HA,492,0,2119,0,0,2119,T
4-HA,493,2112,2,1,0,2115,A
4-HA,494,0,1,2115,0,2116,G
4-HA,495,0,2117,0,0,2117,T
4-HA,496,2118,0,2,0,2120,A
4-HA,497,0,0,2121,0,2121,G
4-HA,498,2086,0,1,0,2087,A
4-HA,499,0,2085,0,1,2086,T
4-HA,500,0,2087,0,1,2088,T
4-HA,501,1,3,2133,0,2137,G
4-HA,502,2132,0,1,0,2133,A
4-HA,503,2134,0,0,0,2134,A
4-HA,504,0,2128,0,0,2128,T
4-HA,505,0,2115,0,0,2115,T
4-HA,506,0,5,2129,0,2134,G
4-HA,507,0,0,2140,0,2140,G
4-HA,508,0,2137,0,2,2139,T
4-HA,509,1,2134,0,1,2136,T
4-HA,510,0,7,2113,0,2120,G
4-HA,511,2116,0,10,0,2126,A
4-HA,512,2,1,2,2120,2125,C
4-HA,513,3,0,1,2113,2117,C
4-HA,514,10,0,0,2135,2145,C
4-HA,515,2145,0,1,0,2146,A
4-HA,516,0,8,0,2151,2159,C
4-HA,517,0,2157,0,0,2157,T
4-HA,518,0,2158,1,0,2159,T
4-HA,519,2159,1,1,0,2161,A
4-HA,520,2149,0,0,0,2149,A
4-HA,521,2145,0,0,0,2145,A
4-HA,522,2,0,0,2086,2088,C
4-HA,523,1,2148,0,1,2150,T
4-HA,524,0,2164,0,1,2165,T
4-HA,525,3,0,0,2178,2181,C
4-HA,526,2181,0,1,0,2182,A
4-HA,527,2177,0,1,0,2178,A
4-HA,528,2190,1,0,1,2192,A
4-HA,529,0,2190,0,0,2190,T
4-HA,530,2193,0,0,0,2193,A
4-HA,531,0,0,0,2186,2186,C
4-HA,532,0,2108,0,2,2110,T
4-HA,533,2,2,0,2152,2156,C
4-HA,534,2156,0,0,0,2156,A
4-HA,535,1,2,2250,0,2253,G
4-HA,536,0,0,0,2252,2252,C
4-HA,537,2239,0,0,0,2239,A
4-HA,538,0,2234,0,2,2236,T
4-HA,539,0,2213,0,2,2215,T
4-HA,540,0,6,2277,0,2283,G
4-HA,541,2286,0,2,0,2288,A
4-HA,542,2288,1,0,0,2289,A
4-HA,543,0,1,0,2288,2289,C
4-HA,544,0,0,2235,1,2236,G
4-HA,545,1,2240,0,1,2242,T
4-HA,546,0,6,2244,0,2250,G
4-HA,547,2252,0,0,0,2252,A
4-HA,548,1,1,1,2253,2256,C
4-HA,549,1,2186,0,0,2187,T
4-HA,550,2221,1,0,1,2223,A
4-HA,551,0,2212,0,2,2214,T
4-HA,552,0,0,2242,0,2242,G
4-HA,553,0,0,0,2238,2238,C
4-HA,554,1,0,0,2211,2212,C
4-HA,555,2214,0,0,1,2215,A
4-HA,556,2212,0,1,1,2214,A
4-HA,557,2237,2,0,1,2240,A
4-HA,558,0,0,0,2255,2255,C
4-HA,559,2203,0,0,0,2203,A
4-HA,560,2205,0,1,1,2207,A
4-HA,561,0,2197,0,0,2197,T
4-HA,562,0,7,2203,0,2210,G
4-HA,563,2200,1,5,0,2206,A
4-HA,564,2204,1,3,0,2208,A
4-HA,565,0,1,0,2167,2168,C
4-HA,566,2177,0,0,0,2177,A
4-HA,567,2199,1,0,0,2200,A
4-HA,568,0,2196,0,0,2196,T
4-HA,569,0,2199,0,0,2199,T
4-HA,570,1,2195,0,1,2197,T
4-HA,571,2,6,2195,0,2203,G
4-HA,572,2200,1,2,0,2203,A
4-HA,573,0,0,0,2206,2206,C
4-HA,574,2210,0,0,0,2210,A
4-HA,575,2214,0,0,0,2214,A
4-HA,576,2241,0,1,0,2242,A
4-HA,577,1,2257,0,1,2259,T
4-HA,578,0,2257,0,1,2258,T
4-HA,579,0,0,2271,0,2271,G
4-HA,580,0,2269,0,2,2271,T
4-HA,581,2274,1,2,0,2277,A
4-HA,582,0,0,0,2318,2318,C
4-HA,583,2326,0,0,0,2326,A
4-HA,584,0,2356,2,0,2358,T
4-HA,585,1,2326,0,1,2328,T
4-HA,586,0,2317,0,1,2318,T
4-HA,587,0,12,2295,0,2307,G
4-HA,588,0,12,2287,0,2299,G
4-HA,589,1,9,2289,0,2299,G
4-HA,590,0,6,2300,0,2306,G
4-HA,591,0,2,2281,0,2283,G
4-HA,592,0,0,2338,2,2340,G
4-HA,593,0,2313,1,3,2317,T
4-HA,594,0,2328,0,1,2329,T
4-HA,595,5,0,0,2331,2336,C
4-HA,596,2337,0,3,0,2340,A
4-HA,597,0,0,0,2354,2354,C
4-HA,598,2,0,0,2348,2350,C
4-HA,599,2350,0,0,0,2350,A
4-HA,600,1,1,0,2382,2384,C
4-HA,601,1,1,0,2347,2349,C
4-HA,602,6,0,0,2327,2333,C
4-HA,603,1,8,2330,0,2339,G
4-HA,604,1,3,2398,0,2402,G
4-HA,605,0,1,2412,0,2413,G
4-HA,606,0,2402,0,0,2402,T
4-HA,607,2402,0,0,0,2402,A
4-HA,608,0,18,0,2372,2390,C
4-HA,609,0,5,2366,0,2371,G
4-HA,610,0,3,2413,0,2416,G
4-HA,611,2397,0,20,0,2417,A
4-HA,612,0,0,0,2416,2416,C
4-HA,613,2358,0,1,1,2360,A
4-HA,614,2357,0,0,0,2357,A
4-HA,615,2351,0,0,0,2351,A
4-HA,616,0,5,2399,0,2404,G
4-HA,617,2408,0,1,0,2409,A
4-HA,618,0,0,0,2404,2404,C
4-HA,619,4,1,0,2370,2375,C
4-HA,620,2379,0,0,0,2379,A
4-HA,621,2371,0,1,1,2373,A
4-HA,622,2405,0,0,0,2405,A
4-HA,623,0,2406,0,0,2406,T
4-HA,624,4,1,0,2417,2422,C
4-HA,625,0,2383,0,2,2385,T
4-HA,626,0,2389,0,1,2390,T
4-HA,627,3,0,0,2406,2409,C
4-HA,628,0,0,0,2418,2418,C
4-HA,629,1,2411,0,1,2413,T
4-HA,630,0,1,2428,0,2429,G
4-HA,631,0,2380,0,15,2395,T
4-HA,632,2421,0,0,0,2421,A
4-HA,633,0,2402,0,3,2405,T
4-HA,634,2,0,2425,0,2427,G
4-HA,635,1,0,1,2429,2431,C
4-HA,636,1,2413,0,0,2414,T
4-HA,637,9,5,0,2400,2414,C
4-HA,638,2397,0,14,0,2411,A
4-HA,639,2398,0,4,0,2402,A
4-HA,640,4,0,2411,1,2416,G
4-HA,641,0,0,0,2409,2409,C
4-HA,642,2414,0,0,0,2414,A
4-HA,643,0,2383,0,0,2383,T
4-HA,644,0,1,0,2382,2383,C
4-HA,645,2378,0,3,0,2381,A
4-HA,646,0,1,2409,0,2410,G
4-HA,647,1,3,2408,0,2412,G
4-HA,648,2403,1,3,0,2407,A
4-HA,649,2393,0,3,0,2396,A
4-HA,650,1,6,2439,0,2446,G
4-HA,651,2446,0,1,0,2447,A
4-HA,652,2475,1,4,0,2480,A
4-HA,653,1,2490,0,0,2491,T
4-HA,654,4,0,0,2494,2498,C
4-HA,655,2466,0,1,0,2467,A
4-HA,656,0,1,0,2472,2473,C
4-HA,657,2457,0,3,0,2460,A
4-HA,658,0,1,2504,0,2505,G
4-HA,659,0,2478,0,1,2479,T
4-HA,660,5,0,0,2490,2495,C
4-HA,661,0,2465,0,1,2466,T
4-HA,662,5,0,0,2516,2521,C
4-HA,663,0,2518,1,1,2520,T
4-HA,664,2551,0,0,0,2551,A
4-HA,665,2,1,0,2540,2543,C
4-HA,666,1,2,0,2543,2546,C
4-HA,667,2502,0,1,0,2503,A
4-HA,668,2492,0,1,0,2493,A
4-HA,669,2486,1,2,0,2489,A
4-HA,670,2495,0,0,0,2495,A
4-HA,671,0,4,2487,0,2491,G
4-HA,672,2438,1,2,0,2441,A
4-HA,673,2432,0,2,0,2434,A
4-HA,674,1,2,2436,0,2439,G
4-HA,675,1,1,0,2436,2438,C
4-HA,676,1,0,0,2437,2438,C
4-HA,677,2437,2,2,0,2441,A
4-HA,678,2430,12,1,3,2446,A
4-HA,679,2,0,0,2445,2447,C
4-HA,680,2446,1,0,0,2447,A
4-HA,681,2433,2,0,14,2449,A
4-HA,682,2461,0,0,0,2461,A
4-HA,683,2,1,0,2525,2528,C
4-HA,684,1,2508,1,2,2512,T
4-HA,685,3,0,2522,0,2525,G
4-HA,686,0,2514,0,1,2515,T
4-HA,687,2511,0,2,0,2513,A
4-HA,688,2523,0,0,0,2523,A
4-HA,689,0,2504,0,0,2504,T
4-HA,690,3,1,0,2529,2533,C
4-HA,691,2,3,0,2529,2534,C
4-HA,692,6,0,0,2474,2480,C
4-HA,693,2,10,2472,1,2485,G
4-HA,694,2474,0,1,0,2475,A
4-HA,695,2485,0,0,0,2485,A
4-HA,696,1,2489,0,1,2491,T
4-HA,697,2495,0,1,0,2496,A
4-HA,698,1,2489,0,0,2490,T
4-HA,699,2,1,0,2474,2477,C
4-HA,700,4,6,2459,1,2470,G
4-HA,701,0,4,2525,0,2529,G
4-HA,702,2540,0,1,0,2541,A
4-HA,703,1,2554,1,0,2556,T
4-HA,704,2,1,0,2557,2560,C
4-HA,705,0,2555,0,1,2556,T
4-HA,706,2552,1,1,0,2554,A
4-HA,707,1,7,2571,0,2579,G
4-HA,708,2588,0,0,0,2588,A
4-HA,709,1,1,0,2579,2581,C
4-HA,710,2,0,0,2506,2508,C
4-HA,711,3,1,0,2507,2511,C
4-HA,712,2511,2,1,1,2515,A
4-HA,713,1,4,2639,0,2644,G
4-HA,714,2643,0,2,0,2645,A
4-HA,715,0,2,2682,0,2684,G
4-HA,716,0,2659,0,0,2659,T
4-HA,717,2629,0,0,1,2630,A
4-HA,718,2620,2,5,1,2628,A
4-HA,719,0,1,2663,1,2665,G
4-HA,720,0,1,2679,0,2680,G
4-HA,721,2633,0,1,0,2634,A
4-HA,722,2428,0,0,0,2428,A
4-HA,723,0,2415,0,2,2417,T
4-HA,724,2398,0,0,0,2398,A
4-HA,725,1,2379,0,1,2381,T
4-HA,726,3,0,0,2405,2408,C
4-HA,727,3,0,0,2400,2403,C
4-HA,728,10,0,0,2350,2360,C
4-HA,729,0,2344,0,1,2345,T
4-HA,730,2355,0,0,0,2355,A
4-HA,731,21,0,2336,0,2357,G
4-HA,732,1,0,0,2360,2361,C
4-HA,733,2311,0,1,1,2313,A
4-HA,734,0,1,2372,0,2373,G
4-HA,735,2356,0,0,1,2357,A
4-HA,736,2357,2,1,0,2360,A
4-HA,737,1,2357,0,1,2359,T
4-HA,738,2351,0,0,0,2351,A
4-HA,739,2355,0,1,0,2356,A
4-HA,740,2,0,2350,0,2352,G
4-HA,741,0,2,0,2340,2342,C
4-HA,742,2341,0,2,0,2343,A
4-HA,743,0,2284,1,2,2287,T
4-HA,744,1,0,0,2382,2383,C
4-HA,745,1,2379,0,0,2380,T
4-HA,746,2389,3,2,0,2394,A
4-HA,747,0,2387,0,2,2389,T
4-HA,748,0,2377,0,0,2377,T
4-HA,749,0,1,2391,0,2392,G
4-HA,750,1,1,2384,1,2387,G
4-HA,751,2381,0,4,0,2385,A
4-HA,752,0,1,0,2384,2385,C
4-HA,753,2172,1,1,0,2174,A
4-HA,754,2242,0,1,0,2243,A
4-HA,755,0,2342,0,0,2342,T
4-HA,756,2347,1,0,0,2348,A
4-HA,757,0,0,2400,0,2400,G
4-HA,758,0,2373,0,1,2374,T
4-HA,759,2372,0,0,0,2372,A
4-HA,760,2379,1,0,1,2381,A
4-HA,761,2431,0,0,0,2431,A
4-HA,762,2455,0,1,0,2456,A
4-HA,763,0,1,0,2480,2481,C
4-HA,764,2,1,0,2326,2329,C
4-HA,765,1,8,2309,0,2318,G
4-HA,766,0,1,2355,0,2356,G
4-HA,767,1,3,2387,0,2391,G
4-HA,768,2385,0,0,0,2385,A
4-HA,769,2,2,2411,1,2416,G
4-HA,770,2478,0,2,0,2480,A
4-HA,771,0,0,1,2478,2479,C
4-HA,772,2462,2,2,4,2470,A
4-HA,773,0,2482,0,0,2482,T
4-HA,774,2505,0,3,0,2508,A
4-HA,775,0,1,0,2561,2562,C
4-HA,776,0,2549,0,1,2550,T
4-HA,777,0,2581,0,0,2581,T
4-HA,778,1,2592,0,1,2594,T
4-HA,779,1,2583,0,1,2585,T
4-HA,780,0,8,2636,0,2644,G
4-HA,781,2655,0,0,0,2655,A
4-HA,782,0,2656,0,2,2658,T
4-HA,783,1,2748,1,1,2751,T
4-HA,784,2723,1,2,0,2726,A
4-HA,785,2740,0,1,0,2741,A
4-HA,786,1,0,0,2794,2795,C
4-HA,787,2775,0,1,0,2776,A
4-HA,788,0,1,2892,0,2893,G
4-HA,789,1,0,0,2866,2867,C
4-HA,790,2871,2,1,0,2874,A
4-HA,791,0,1,0,2900,2901,C
4-HA,792,2864,1,5,2,2872,A
4-HA,793,0,10,2914,0,2924,G
4-HA,794,1,4,2906,0,2911,G
4-HA,795,1,6,3018,0,3025,G
4-HA,796,3018,1,3,0,3022,A
4-HA,797,3058,1,2,0,3061,A
4-HA,798,1,3073,1,0,3075,T
4-HA,799,6,0,0,3076,3082,C
4-HA,800,0,3095,0,1,3096,T
4-HA,801,3115,0,1,0,3116,A
4-HA,802,3089,1,1,0,3091,A
4-HA,803,0,3086,0,0,3086,T
4-HA,804,1,3016,0,0,3017,T
4-HA,805,0,0,3056,0,3056,G
4-HA,806,0,13,0,3151,3164,C
4-HA,807,2,3275,0,5,3282,T
4-HA,808,8,0,0,3388,3396,C
4-HA,809,3,1,0,3393,3397,C
4-HA,810,0,3396,1,0,3397,T
4-HA,811,3399,0,0,0,3399,A
4-HA,812,0,19,3380,0,3399,G
4-HA,813,0,21,3417,0,3438,G
4-HA,814,0,4,3452,0,3456,G
4-HA,815,0,2,3420,0,3422,G
4-HA,816,0,3345,0,0,3345,T
4-HA,817,0,3316,0,0,3316,T
4-HA,818,3311,1,1,0,3313,A
4-HA,819,0,0,0,3387,3387,C
4-HA,820,1,3384,0,5,3390,T
4-HA,821,2,3404,1,1,3408,T
4-HA,822,2,1,0,3403,3406,C
4-HA,823,3393,1,1,0,3395,A
4-HA,824,3404,0,0,0,3404,A
4-HA,825,3398,0,0,1,3399,A
4-HA,826,3445,0,1,0,3446,A
4-HA,827,0,3441,0,0,3441,T
4-HA,828,3415,0,1,0,3416,A
4-HA,829,0,0,0,3411,3411,C
4-HA,830,2,6,3399,0,3407,G
4-HA,831,3407,2,1,0,3410,A
4-HA,832,3412,1,1,0,3414,A
4-HA,833,1,5,3462,0,3468,G
4-HA,834,0,3469,0,1,3470,T
4-HA,835,0,10,3476,0,3486,G
4-HA,836,3,6,3483,1,3493,G
4-HA,837,1,3,3502,0,3506,G
4-HA,838,3502,0,1,0,3503,A
4-HA,839,3498,0,2,0,3500,A
4-HA,840,3504,0,2,0,3506,A
4-HA,841,3492,0,8,0,3500,A
4-HA,842,0,1,3574,0,3575,G
4-HA,843,0,0,0,3571,3571,C
4-HA,844,1,3555,0,0,3556,T
4-HA,845,8,0,0,3615,3623,C
4-HA,846,3618,2,1,0,3621,A
4-HA,847,3661,1,1,0,3663,A
4-HA,848,0,3663,0,2,3665,T
4-HA,849,3716,0,0,1,3717,A
4-HA,850,3716,1,1,1,3719,A
4-HA,851,0,3647,0,3,3650,T
4-HA,852,0,12,3647,1,3660,G
4-HA,853,3640,0,2,0,3642,A
4-HA,854,0,4,3750,0,3754,G
4-HA,855,3748,0,1,0,3749,A
4-HA,856,0,3711,1,1,3713,T
4-HA,857,1,0,0,3794,3795,C
4-HA,858,3786,0,1,0,3787,A
4-HA,859,1,2,3861,0,3864,G
4-HA,860,3868,0,3,0,3871,A
4-HA,861,0,3847,0,0,3847,T
4-HA,862,1,3,3831,0,3835,G
4-HA,863,0,1,0,3795,3796,C
4-HA,864,3798,2,5,0,3805,A
4-HA,865,1,4,0,3887,3892,C
4-HA,866,2,0,0,3857,3859,C
4-HA,867,18,0,0,3863,3881,C
4-HA,868,3830,1,0,0,3831,A
4-HA,869,0,3824,0,3,3827,T
4-HA,870,0,3831,1,1,3833,T
4-HA,871,2,14,3855,0,3871,G
4-HA,872,3,1,3869,1,3874,G
4-HA,873,1,1,1,3868,3871,C
4-HA,874,3818,0,2,0,3820,A
4-HA,875,3811,0,2,0,3813,A
4-HA,876,3885,1,1,0,3887,A
4-HA,877,0,3869,16,1,3886,T
4-HA,878,0,0,3891,0,3891,G
4-HA,879,1,0,1,3891,3893,C
4-HA,880,3845,1,6,0,3852,A
4-HA,881,3954,0,1,0,3955,A
4-HA,882,1,3955,0,0,3956,T
4-HA,883,1,3975,1,1,3978,T
4-HA,884,3,0,0,3990,3993,C
4-HA,885,1,3936,1,1,3939,T
4-HA,886,0,8,3969,0,3977,G
4-HA,887,3973,2,2,0,3977,A
4-HA,888,3988,0,0,0,3988,A
4-HA,889,1,3983,0,3,3987,T
4-HA,890,0,2,3946,0,3948,G
4-HA,891,0,0,0,3979,3979,C
4-HA,892,3970,1,2,0,3973,A
4-HA,893,1,3959,0,3,3963,T
4-HA,894,4,0,0,3958,3962,C
4-HA,895,3956,0,3,0,3959,A
4-HA,896,0,6,0,4103,4109,C
4-HA,897,0,4092,1,5,4098,T
4-HA,898,7,1,0,4094,4102,C
4-HA,899,6,0,1,4082,4089,C
4-HA,900,4117,0,0,1,4118,A
4-HA,901,4121,0,0,0,4121,A
4-HA,902,4112,0,1,0,4113,A
4-HA,903,1,3957,1,1,3960,T
4-HA,904,2,7,3968,0,3977,G
4-HA,905,0,10,3983,0,3993,G
4-HA,906,3994,0,3,0,3997,A
4-HA,907,3989,0,5,0,3994,A
4-HA,908,1,1,3999,0,4001,G
4-HA,909,1,2,0,3954,3957,C
4-HA,910,3941,3,0,0,3944,A
4-HA,911,0,3942,0,1,3943,T
4-HA,912,1,3933,1,4,3939,T
4-HA,913,6,0,0,4065,4071,C
4-HA,914,6,2,0,4046,4054,C
4-HA,915,12,1,2,4045,4060,C
4-HA,916,4065,0,0,0,4065,A
4-HA,917,4132,0,2,1,4135,A
4-HA,918,1,4178,0,11,4190,T
4-HA,919,2,13,4184,0,4199,G
4-HA,920,4189,1,4,0,4194,A
4-HA,921,1,1,0,4195,4197,C
4-HA,922,4088,0,0,1,4089,A
4-HA,923,4094,0,1,1,4096,A
4-HA,924,4084,0,5,0,4089,A
4-HA,925,0,0,0,4123,4123,C
4-HA,926,5,0,0,4074,4079,C
4-HA,927,4025,1,1,0,4027,A
4-HA,928,2,4039,1,1,4043,T
4-HA,929,3,4033,1,2,4039,T
4-HA,930,6,1,0,4047,4054,C
4-HA,931,5,2,0,4043,4050,C
4-HA,932,4051,0,2,0,4053,A
4-HA,933,4054,0,0,1,4055,A
4-HA,934,4044,0,1,1,4046,A
4-HA,935,4138,1,0,0,4139,A
4-HA,936,0,4116,0,1,4117,T
4-HA,937,1,2,4136,0,4139,G
4-HA,938,0,4135,0,1,4136,T
4-HA,939,4146,0,0,1,4147,A
4-HA,940,4142,0,1,1,4144,A
4-HA,941,4148,1,1,1,4151,A
4-HA,942,1,0,0,4165,4166,C
4-HA,943,4094,0,0,1,4095,A
4-HA,944,0,5,4140,0,4145,G
4-HA,945,1,4,4158,0,4163,G
4-HA,946,4263,1,5,0,4269,A
4-HA,947,1,4247,1,6,4255,T
4-HA,948,3,4,0,4301,4308,C
4-HA,949,4332,1,4,2,4339,A
4-HA,950,4,1,0,4472,4477,C
4-HA,951,4481,0,0,0,4481,A
4-HA,952,0,4616,1,2,4619,T
4-HA,953,4522,1,3,1,4527,A
4-HA,954,1,1,0,4482,4484,C
4-HA,955,1,9,4371,0,4381,G
4-HA,956,2,9,4370,0,4381,G
4-HA,957,1,4,4346,0,4351,G
4-HA,958,1,0,4351,0,4352,G
4-HA,959,2,0,0,4272,4274,C
4-HA,960,0,2,0,4258,4260,C
4-HA,961,0,4185,0,3,4188,T
4-HA,962,1,0,4564,0,4565,G
4-HA,963,0,4570,0,5,4575,T
4-HA,964,4,0,1,4602,4607,C
4-HA,965,27,2,0,4573,4602,C
4-HA,966,7,2,0,4603,4612,C
4-HA,967,4565,0,27,0,4592,A
4-HA,968,3,0,4628,0,4631,G
4-HA,969,4621,2,1,0,4624,A
4-HA,970,1,4615,0,1,4617,T
4-HA,971,4305,1,0,0,4306,A
4-HA,972,0,4239,0,1,4240,T
4-HA,973,0,2,4272,0,4274,G
4-HA,974,1,4247,0,5,4253,T
4-HA,975,0,4191,0,1,4192,T
4-HA,976,4238,3,3,1,4245,A
4-HA,977,4187,2,1,0,4190,A
4-HA,978,1,8,4227,0,4236,G
4-HA,979,3,1,0,4232,4236,C
4-HA,980,4148,0,0,0,4148,A
4-HA,981,4145,0,1,0,4146,A
4-HA,982,4118,0,0,1,4119,A
4-HA,983,4119,0,1,2,4122,A
4-HA,984,1,1,0,4132,4134,C
4-HA,985,4092,1,1,0,4094,A
4-HA,986,1,0,0,4122,4123,C
4-HA,987,0,4051,0,6,4057,T
4-HA,988,11,1,0,4065,4077,C
4-HA,989,3,4076,0,5,4084,T
4-HA,990,1,8,4116,0,4125,G
4-HA,991,4114,2,3,0,4119,A
4-HA,992,4119,0,1,0,4120,A
4-HA,993,4114,1,3,0,4118,A
4-HA,994,0,4088,0,1,4089,T
4-HA,995,1,4041,0,1,4043,T
4-HA,996,1,5,4064,0,4070,G
4-HA,997,0,1,4056,0,4057,G
4-HA,998,1,0,0,4070,4071,C
4-HA,999,4044,1,2,0,4047,A
4-HA,1000,4054,0,2,2,4058,A
4-HA,1001,0,2,0,4058,4060,C
4-HA,1002,4050,0,3,0,4053,A
4-HA,1003,0,10,4089,0,4099,G
4-HA,1004,2,4,4076,1,4083,G
4-HA,1005,1,7,4054,0,4062,G
4-HA,1006,4068,1,2,0,4071,A
4-HA,1007,2,4040,0,0,4042,T
4-HA,1008,1,2,4045,0,4048,G
4-HA,1009,4,3,0,4039,4046,C
4-HA,1010,2,3,4053,0,4058,G
4-HA,1011,4095,0,1,0,4096,A
4-HA,1012,4012,0,2,0,4014,A
4-HA,1013,4049,1,1,0,4051,A
4-HA,1014,0,4002,0,3,4005,T
4-HA,1015,1,2,4061,1,4065,G
4-HA,1016,0,4071,0,1,4072,T
4-HA,1017,4055,0,1,0,4056,A
4-HA,1018,0,0,0,4050,4050,C
4-HA,1019,8,0,0,4030,4038,C
4-HA,1020,3960,2,4,0,3966,A
4-HA,1021,1,8,3974,0,3983,G
4-HA,1022,3892,3,2,0,3897,A
4-HA,1023,0,1,3929,0,3930,G
4-HA,1024,3863,0,2,0,3865,A
4-HA,1025,3855,0,1,0,3856,A
4-HA,1026,3856,0,6,0,3862,A
4-HA,1027,0,1,0,3860,3861,C
4-HA,1028,3790,1,1,0,3792,A
4-HA,1029,3871,0,1,1,3873,A
4-HA,1030,3865,0,4,0,3869,A
4-HA,1031,1,0,0,3892,3893,C
4-HA,1032,0,3854,0,3,3857,T
4-HA,1033,3792,0,2,1,3795,A
4-HA,1034,1,4,3800,0,3805,G
4-HA,1035,3765,0,2,0,3767,A
4-HA,1036,1,3,3856,0,3860,G
4-HA,1037,1,0,3840,0,3841,G
4-HA,1038,0,2,0,3792,3794,C
4-HA,1039,3786,1,1,0,3788,A
4-HA,1040,0,3791,1,0,3792,T
4-HA,1041,3823,0,0,1,3824,A
4-HA,1042,0,3804,1,0,3805,T
4-HA,1043,1,3790,0,0,3791,T
4-HA,1044,0,3798,0,0,3798,T
4-HA,1045,0,5,3645,1,3651,G
4-HA,1046,0,0,3659,0,3659,G
4-HA,1047,0,2,1,3647,3650,C
4-HA,1048,2,0,3642,0,3644,G
4-HA,1049,3,1,0,3615,3619,C
4-HA,1050,3598,1,0,0,3599,A
4-HA,1051,3622,1,0,0,3623,A
4-HA,1052,0,3615,0,0,3615,T
4-HA,1053,2,3,0,3615,3620,C
4-HA,1054,0,2,3624,0,3626,G
4-HA,1055,3,0,1,3613,3617,C
4-HA,1056,3,13,3604,0,3620,G
4-HA,1057,0,2,3640,0,3642,G
4-HA,1058,0,0,3656,0,3656,G
4-HA,1059,0,3646,0,1,3647,T
4-HA,1060,0,3595,0,2,3597,T
4-HA,1061,0,3601,0,3,3604,T
4-HA,1062,3,0,0,3616,3619,C
4-HA,1063,3630,0,2,0,3632,A
4-HA,1064,0,3632,2,1,3635,T
4-HA,1065,3636,0,1,0,3637,A
4-HA,1066,0,2,3694,1,3697,G
4-HA,1067,3586,1,1,0,3588,A
4-HA,1068,3592,1,2,0,3595,A
4-HA,1069,3589,0,0,0,3589,A
4-HA,1070,3627,1,2,0,3630,A
4-HA,1071,1,3620,0,1,3622,T
4-HA,1072,0,5,3679,0,3684,G
4-HA,1073,1,3,3708,0,3712,G
4-HA,1074,1,3672,1,1,3675,T
4-HA,1075,1,3612,0,0,3613,T
4-HA,1076,2,8,3614,0,3624,G
4-HA,1077,0,2,3668,1,3671,G
4-HA,1078,1,3,3694,0,3698,G
4-HA,1079,3661,0,5,0,3666,A
4-HA,1080,1,6,3668,1,3676,G
4-HA,1081,1,5,3645,1,3652,G
4-HA,1082,1,4,3734,0,3739,G
4-HA,1083,3727,0,2,1,3730,A
4-HA,1084,3766,1,3,0,3770,A
4-HA,1085,0,3761,1,1,3763,T
4-HA,1086,0,5,3784,0,3789,G
4-HA,1087,1,0,3849,0,3850,G
4-HA,1088,1,3814,1,0,3816,T
4-HA,1089,0,6,3792,0,3798,G
4-HA,1090,0,1,3786,0,3787,G
4-HA,1091,3701,2,0,0,3703,A
4-HA,1092,0,3713,2,1,3716,T
4-HA,1093,2,9,3762,0,3773,G
4-HA,1094,0,0,3809,0,3809,G
4-HA,1095,2,3768,1,1,3772,T
4-HA,1096,1,3696,0,1,3698,T
4-HA,1097,2,6,3695,0,3703,G
4-HA,1098,1,2,3764,1,3768,G
4-HA,1099,1,3768,0,1,3770,T
4-HA,1100,3755,0,3,0,3758,A
4-HA,1101,1,4,1,3580,3586,C
4-HA,1102,2,13,3594,0,3609,G
4-HA,1103,0,2,3719,0,3721,G
4-HA,1104,0,3715,0,4,3719,T
4-HA,1105,0,3702,0,2,3704,T
4-HA,1106,0,3704,0,2,3706,T
4-HA,1107,5,1,0,3650,3656,C
4-HA,1108,3646,0,8,0,3654,A
4-HA,1109,1,1,3654,0,3656,G
4-HA,1110,1,2,3645,1,3649,G
4-HA,1111,2,0,0,3646,3648,C
4-HA,1112,3516,0,1,1,3518,A
4-HA,1113,3,3572,1,2,3578,T
4-HA,1114,3,0,2,3566,3571,C
4-HA,1115,3580,0,1,0,3581,A
4-HA,1116,3579,3,2,0,3584,A
4-HA,1117,3591,0,1,0,3592,A
4-HA,1118,3607,0,2,0,3609,A
4-HA,1119,0,3613,1,0,3614,T
4-HA,1120,0,3598,1,0,3599,T
4-HA,1121,2,0,1,3612,3615,C
4-HA,1122,1,3578,0,3,3582,T
4-HA,1123,1,1,3594,0,3596,G
4-HA,1124,3592,0,1,0,3593,A
4-HA,1125,1,8,3603,1,3613,G
4-HA,1126,1,5,3607,0,3613,G
4-HA,1127,2,5,3632,0,3639,G
4-HA,1128,3635,0,1,1,3637,A
4-HA,1129,3619,1,13,0,3633,A
4-HA,1130,1,2,3594,0,3597,G
4-HA,1131,3627,0,7,0,3634,A
4-HA,1132,2,6,3672,0,3680,G
4-HA,1133,0,4,3691,1,3696,G
4-HA,1134,3671,0,8,0,3679,A
4-HA,1135,0,0,0,3673,3673,C
4-HA,1136,3653,0,2,0,3655,A
4-HA,1137,3650,0,4,0,3654,A
4-HA,1138,0,0,3660,0,3660,G
4-HA,1139,2,0,0,3670,3672,C
4-HA,1140,3615,0,1,0,3616,A
4-HA,1141,0,0,3621,0,3621,G
4-HA,1142,1,0,1,3610,3612,C
4-HA,1143,3601,0,0,0,3601,A
4-HA,1144,31,0,3609,0,3640,G
4-HA,1145,3614,0,0,0,3614,A
4-HA,1146,0,3704,0,0,3704,T
4-HA,1147,4,2,1,3722,3729,C
4-HA,1148,0,3694,0,3,3697,T
4-HA,1149,7,2,2,3728,3739,C
4-HA,1150,3721,0,0,0,3721,A
4-HA,1151,3710,1,1,2,3714,A
4-HA,1152,3719,0,1,1,3721,A
4-HA,1153,3640,0,12,1,3653,A
4-HA,1154,0,0,3656,2,3658,G
4-HA,1155,0,0,1,3603,3604,C
4-HA,1156,3585,0,0,0,3585,A
4-HA,1157,0,3,0,3651,3654,C
4-HA,1158,1,3632,0,3,3636,T
4-HA,1159,8,0,2,3636,3646,C
4-HA,1160,3641,3,1,0,3645,A
4-HA,1161,3708,0,2,0,3710,A
4-HA,1162,1,1,3708,0,3710,G
4-HA,1163,1,1,0,3701,3703,C
4-HA,1164,3675,1,3,0,3679,A
4-HA,1165,2,1,3706,0,3709,G
4-HA,1166,0,3,0,3645,3648,C
4-HA,1167,3633,0,0,0,3633,A
4-HA,1168,3631,0,1,0,3632,A
4-HA,1169,0,3608,0,9,3617,T
4-HA,1170,3,1,0,3536,3540,C
4-HA,1171,2,3,3558,0,3563,G
4-HA,1172,3558,2,0,0,3560,A
4-HA,1173,0,3538,0,1,3539,T
4-HA,1174,9,0,0,3528,3537,C
4-HA,1175,3521,0,2,0,3523,A
4-HA,1176,3600,1,2,0,3603,A
4-HA,1177,3607,3,1,0,3611,A
4-HA,1178,0,3599,1,0,3600,T
4-HA,1179,8,0,1,3598,3607,C
4-HA,1180,3563,1,1,0,3565,A
4-HA,1181,3590,1,3,1,3595,A
4-HA,1182,0,3594,0,1,3595,T
4-HA,1183,1,17,3578,2,3598,G
4-HA,1184,3,5,3582,0,3590,G
4-HA,1185,0,2,3547,0,3549,G
4-HA,1186,3551,1,3,1,3556,A
4-HA,1187,3547,1,1,0,3549,A
4-HA,1188,0,1,3604,0,3605,G
4-HA,1189,0,1,0,3602,3603,C
4-HA,1190,0,3588,0,4,3592,T
4-HA,1191,1,5,3729,0,3735,G
4-HA,1192,3728,0,5,0,3733,A
4-HA,1193,3723,1,5,0,3729,A
4-HA,1194,0,3733,0,0,3733,T
4-HA,1195,3643,0,0,2,3645,A
4-HA,1196,1,4,3634,1,3640,G
4-HA,1197,3359,0,0,0,3359,A
4-HA,1198,4,3372,0,2,3378,T
4-HA,1199,0,3380,0,3,3383,T
4-HA,1200,0,5,3407,0,3412,G
4-HA,1201,3400,0,0,1,3401,A
4-HA,1202,0,3382,0,1,3383,T
4-HA,1203,4,0,0,3394,3398,C
4-HA,1204,1,0,3398,0,3399,G
4-HA,1205,1,2,3396,0,3399,G
4-HA,1206,3,2,3401,1,3407,G
4-HA,1207,3399,1,1,0,3401,A
4-HA,1208,3402,0,1,0,3403,A
4-HA,1209,3378,0,5,0,3383,A
4-HA,1210,3399,0,2,0,3401,A
4-HA,1211,2,1,0,3400,3403,C
4-HA,1212,5,2,1,3395,3403,C
4-HA,1213,3366,0,3,0,3369,A
4-HA,1214,3364,0,0,0,3364,A
4-HA,1215,1,1,1,3370,3373,C
4-HA,1216,2,6,3377,1,3386,G
4-HA,1217,3381,0,0,0,3381,A
4-HA,1218,1,5,3374,0,3380,G
4-HA,1219,3368,1,0,1,3370,A
4-HA,1220,3373,0,0,0,3373,A
4-HA,1221,3361,1,0,0,3362,A
4-HA,1222,0,3379,0,8,3387,T
4-HA,1223,0,3386,0,4,3390,T
4-HA,1224,7,1,1,3371,3380,C
4-HA,1225,3,1,1,3369,3374,C
4-HA,1226,3377,0,3,1,3381,A
4-HA,1227,0,3372,0,1,3373,T
4-HA,1228,5,0,1,3375,3381,C
4-HA,1229,3360,1,1,1,3363,A
4-HA,1230,0,1,3387,0,3388,G
4-HA,1231,3370,0,0,1,3371,A
4-HA,1232,1,3363,0,0,3364,T
4-HA,1233,1,3345,0,2,3348,T
4-HA,1234,1,3,3379,0,3383,G
4-HA,1235,3381,0,0,0,3381,A
4-HA,1236,3382,1,0,0,3383,A
4-HA,1237,3378,0,9,0,3387,A
4-HA,1238,3385,0,0,0,3385,A
4-HA,1239,3330,1,1,0,3332,A
4-HA,1240,0,2,3331,1,3334,G
4-HA,1241,3327,0,1,0,3328,A
4-HA,1242,3337,0,0,0,3337,A
4-HA,1243,2,3292,0,0,3294,T
4-HA,1244,0,3311,0,1,3312,T
4-HA,1245,6,2,0,3313,3321,C
4-HA,1246,1,3308,0,3,3312,T
4-HA,1247,5,1,0,3307,3313,C
4-HA,1248,3307,0,3,0,3310,A
4-HA,1249,3,3,3309,0,3315,G
4-HA,1250,3306,0,0,0,3306,A
4-HA,1251,3288,0,2,0,3290,A
4-HA,1252,1,1,3332,0,3334,G
4-HA,1253,0,3310,0,2,3312,T
4-HA,1254,8,0,0,3308,3316,C
4-HA,1255,0,2,3315,0,3317,G
4-HA,1256,3312,1,1,2,3316,A
4-HA,1257,3309,0,5,0,3314,A
4-HA,1258,2,10,3313,0,3325,G
4-HA,1259,0,3,3349,0,3352,G
4-HA,1260,1,3,3351,0,3355,G
4-HA,1261,3281,0,1,0,3282,A
4-HA,1262,0,3,3296,1,3300,G
4-HA,1263,3286,1,4,0,3291,A
4-HA,1264,3492,1,0,0,3493,A
4-HA,1265,1,3492,0,1,3494,T
4-HA,1266,0,3488,0,0,3488,T
4-HA,1267,5,0,0,3494,3499,C
4-HA,1268,3414,3,1,0,3418,A
4-HA,1269,1,4,3415,0,3420,G
4-HA,1270,1,4,3418,0,3423,G
4-HA,1271,3413,0,2,0,3415,A
4-HA,1272,0,0,0,3428,3428,C
4-HA,1273,6,0,0,3209,3215,C
4-HA,1274,0,3202,0,1,3203,T
4-HA,1275,1,3139,0,71,3211,T
4-HA,1276,4,6,3233,1,3244,G
4-HA,1277,3236,1,2,0,3239,A
4-HA,1278,0,6,3318,0,3324,G
4-HA,1279,3307,0,0,0,3307,A
4-HA,1280,3182,1,3,0,3186,A
4-HA,1281,3175,2,2,0,3179,A
4-HA,1282,0,3158,0,1,3159,T
4-HA,1283,3295,1,1,0,3297,A
4-HA,1284,0,3282,1,2,3285,T
4-HA,1285,3,3,3324,0,3330,G
4-HA,1286,0,3324,0,3,3327,T
4-HA,1287,1,3224,0,0,3225,T
4-HA,1288,1,0,3240,0,3241,G
4-HA,1289,3209,0,2,1,3212,A
4-HA,1290,1,4,3245,0,3250,G
4-HA,1291,0,5,3238,1,3244,G
4-HA,1292,3192,0,0,0,3192,A
4-HA,1293,0,0,0,3308,3308,C
4-HA,1294,3245,0,5,0,3250,A
4-HA,1295,0,0,0,3242,3242,C
4-HA,1296,0,3215,0,1,3216,T
4-HA,1297,3366,0,0,0,3366,A
4-HA,1298,3414,0,1,0,3415,A
4-HA,1299,3408,0,1,1,3410,A
4-HA,1300,3453,0,2,0,3455,A
4-HA,1301,1,3451,0,0,3452,T
4-HA,1302,3301,0,2,0,3303,A
4-HA,1303,1,7,3314,0,3322,G
4-HA,1304,3247,0,0,0,3247,A
4-HA,1305,0,3272,0,2,3274,T
4-HA,1306,3,1,0,3250,3254,C
4-HA,1307,0,3212,0,1,3213,T
4-HA,1308,8,0,0,3266,3274,C
4-HA,1309,0,3275,0,1,3276,T
4-HA,1310,0,1,3331,0,3332,G
4-HA,1311,0,0,3417,0,3417,G
4-HA,1312,1,3394,0,3,3398,T
4-HA,1313,9,3,0,3391,3403,C
4-HA,1314,3430,2,1,0,3433,A
4-HA,1315,1,3440,0,2,3443,T
4-HA,1316,3440,0,2,0,3442,A
4-HA,1317,0,0,0,3440,3440,C
4-HA,1318,3326,0,1,1,3328,A
4-HA,1319,3355,0,1,0,3356,A
4-HA,1320,0,2,0,3279,3281,C
4-HA,1321,0,0,3277,0,3277,G
4-HA,1322,3,1,0,3267,3271,C
4-HA,1323,0,5,3246,0,3251,G
4-HA,1324,1,4,3255,1,3261,G
4-HA,1325,3253,0,1,0,3254,A
4-HA,1326,2,3,3290,0,3295,G
4-HA,1327,1,0,0,3290,3291,C
4-HA,1328,0,3280,0,2,3282,T
4-HA,1329,0,3287,0,6,3293,T
4-HA,1330,0,0,0,3301,3301,C
4-HA,1331,1,3319,0,1,3321,T
4-HA,1332,0,3329,0,0,3329,T
4-HA,1333,2,2,3321,0,3325,G
4-HA,1334,1,3312,1,1,3315,T
4-HA,1335,0,3250,0,0,3250,T
4-HA,1336,0,0,3315,0,3315,G
4-HA,1337,1,0,0,3298,3299,C
4-HA,1338,4,2,1,3289,3296,C
4-HA,1339,9,2,0,3310,3321,C
4-HA,1340,1,3309,0,2,3312,T
4-HA,1341,1,3,3358,0,3362,G
4-HA,1342,0,1,3365,0,3366,G
4-HA,1343,3364,1,6,0,3371,A
4-HA,1344,1,4,3365,0,3370,G
4-HA,1345,3318,2,3,0,3323,A
4-HA,1346,3338,1,1,1,3341,A
4-HA,1347,1,2,0,3377,3380,C
4-HA,1348,6,0,1,3363,3370,C
4-HA,1349,3367,1,0,0,3368,A
4-HA,1350,3503,0,0,0,3503,A
4-HA,1351,1,1,0,3516,3518,C
4-HA,1352,3523,0,1,0,3524,A
4-HA,1353,1,3521,0,3,3525,T
4-HA,1354,3512,0,0,0,3512,A
4-HA,1355,2,0,0,3579,3581,C
4-HA,1356,3496,0,0,0,3496,A
4-HA,1357,3497,1,0,0,3498,A
4-HA,1358,0,3495,0,1,3496,T
4-HA,1359,0,3377,0,1,3378,T
4-HA,1360,1,12,3430,0,3443,G
4-HA,1361,3458,0,1,0,3459,A
4-HA,1362,0,3458,0,1,3459,T
4-HA,1363,7,0,1,3452,3460,C
4-HA,1364,0,3392,3,4,3399,T
4-HA,1365,3410,0,0,0,3410,A
4-HA,1366,3404,1,1,0,3406,A
4-HA,1367,1,1,0,3410,3412,C
4-HA,1368,0,3384,0,0,3384,T
4-HA,1369,0,4,3366,0,3370,G
4-HA,1370,3363,1,4,1,3369,A
4-HA,1371,2,1,1,3376,3380,C
4-HA,1372,0,3369,1,5,3375,T
4-HA,1373,10,0,1,3370,3381,C
4-HA,1374,3368,1,1,1,3371,A
4-HA,1375,0,2,3421,0,3423,G
4-HA,1376,3419,0,1,0,3420,A
4-HA,1377,3419,0,1,0,3420,A
4-HA,1378,3417,0,2,0,3419,A
4-HA,1379,0,3389,1,0,3390,T
4-HA,1380,0,18,3412,0,3430,G
4-HA,1381,3426,2,3,0,3431,A
4-HA,1382,3434,1,4,0,3439,A
4-HA,1383,1,1,0,3433,3435,C
4-HA,1384,3387,0,0,2,3389,A
4-HA,1385,3382,0,2,1,3385,A
4-HA,1386,3383,0,2,2,3387,A
4-HA,1387,0,0,0,3400,3400,C
4-HA,1388,1,3375,0,0,3376,T
4-HA,1389,1,2,3380,0,3383,G
4-HA,1390,0,3352,0,2,3354,T
4-HA,1391,1,3338,0,1,3340,T
4-HA,1392,1,3340,1,0,3342,T
4-HA,1393,0,10,3340,0,3350,G
4-HA,1394,3350,0,0,0,3350,A
4-HA,1395,3345,0,0,0,3345,A
4-HA,1396,3332,0,0,0,3332,A
4-HA,1397,3334,0,0,1,3335,A
4-HA,1398,3313,0,0,1,3314,A
4-HA,1399,3322,2,2,2,3328,A
4-HA,1400,1,2,0,3334,3337,C
4-HA,1401,3339,0,1,0,3340,A
4-HA,1402,3337,0,1,0,3338,A
4-HA,1403,3332,0,2,0,3334,A
4-HA,1404,0,3,3350,0,3353,G
4-HA,1405,3358,0,0,0,3358,A
4-HA,1406,3355,1,2,0,3358,A
4-HA,1407,1,0,3355,0,3356,G
4-HA,1408,1,0,0,3358,3359,C
4-HA,1409,3352,0,4,0,3356,A
4-HA,1410,3380,0,0,0,3380,A
4-HA,1411,0,0,0,3375,3375,C
4-HA,1412,2,3355,1,1,3359,T
4-HA,1413,0,2,3384,0,3386,G
4-HA,1414,3354,2,1,6,3363,A
4-HA,1415,1,10,3387,0,3398,G
4-HA,1416,1,2,3411,0,3414,G
4-HA,1417,3,5,3403,0,3411,G
4-HA,1418,3409,0,0,0,3409,A
4-HA,1419,3393,0,0,0,3393,A
4-HA,1420,3369,2,5,0,3376,A
4-HA,1421,3417,0,1,0,3418,A
4-HA,1422,2,3407,0,1,3410,T
4-HA,1423,1,0,3426,0,3427,G
4-HA,1424,1,1,0,3419,3421,C
4-HA,1425,0,3394,0,1,3395,T
4-HA,1426,0,2,3407,0,3409,G
4-HA,1427,3400,2,1,0,3403,A
4-HA,1428,1,5,3560,0,3566,G
4-HA,1429,0,1,3616,0,3617,G
4-HA,1430,3572,0,4,0,3576,A
4-HA,1431,0,3570,0,0,3570,T
4-HA,1432,3545,1,2,0,3548,A
4-HA,1433,2,3530,0,1,3533,T
4-HA,1434,2,10,3557,0,3569,G
4-HA,1435,0,6,3591,1,3598,G
4-HA,1436,1,2,3598,0,3601,G
4-HA,1437,1,0,1,3463,3465,C
4-HA,1438,3376,0,0,1,3377,A
4-HA,1439,3373,1,1,0,3375,A
4-HA,1440,0,3373,0,1,3374,T
4-HA,1441,1,5,3381,1,3388,G
4-HA,1442,2,2,3391,0,3395,G
4-HA,1443,4,3345,0,0,3349,T
4-HA,1444,0,3274,0,2,3276,T
4-HA,1445,0,0,3287,0,3287,G
4-HA,1446,1,3321,0,4,3326,T
4-HA,1447,0,3290,17,1,3308,T
4-HA,1448,0,3323,0,0,3323,T
4-HA,1449,7,0,0,3337,3344,C
4-HA,1450,3333,0,0,0,3333,A
4-HA,1451,3341,0,1,1,3343,A
4-HA,1452,3339,0,0,0,3339,A
4-HA,1453,3385,1,2,0,3388,A
4-HA,1454,1,3369,0,0,3370,T
4-HA,1455,3342,0,0,0,3342,A
4-HA,1456,0,3349,0,2,3351,T
4-HA,1457,3346,1,2,1,3350,A
4-HA,1458,1,1,0,3394,3396,C
4-HA,1459,3,0,1,3369,3373,C
4-HA,1460,3368,1,1,1,3371,A
4-HA,1461,0,2,0,3386,3388,C
4-HA,1462,3377,1,3,0,3381,A
4-HA,1463,3382,1,1,1,3385,A
4-HA,1464,3393,0,0,0,3393,A
4-HA,1465,1,3386,0,0,3387,T
4-HA,1466,0,2,3396,0,3398,G
4-HA,1467,3,3357,0,2,3362,T
4-HA,1468,1,7,3379,1,3388,G
4-HA,1469,3393,1,4,0,3398,A
4-HA,1470,0,1,0,3393,3394,C
4-HA,1471,3348,0,0,0,3348,A
4-HA,1472,3339,0,0,0,3339,A
4-HA,1473,1,3369,1,1,3372,T
4-HA,1474,2,1,3395,0,3398,G
4-HA,1475,0,2,0,3382,3384,C
4-HA,1476,3,0,0,3385,3388,C
4-HA,1477,2,3360,0,1,3363,T
4-HA,1478,2,1,3470,1,3474,G
4-HA,1479,0,1,0,3473,3474,C
4-HA,1480,3476,0,0,1,3477,A
4-HA,1481,1,3473,0,0,3474,T
4-HA,1482,3381,0,0,0,3381,A
4-HA,1483,1,4,3397,0,3402,G
4-HA,1484,0,3,3383,0,3386,G
4-HA,1485,3371,0,1,0,3372,A
4-HA,1486,0,3357,0,0,3357,T
4-HA,1487,4,1,0,3215,3220,C
4-HA,1488,3207,1,1,1,3210,A
4-HA,1489,3217,0,0,1,3218,A
4-HA,1490,0,3213,0,1,3214,T
4-HA,1491,6,0,0,3217,3223,C
4-HA,1492,3163,1,1,1,3166,A
4-HA,1493,0,1,3184,0,3185,G
4-HA,1494,3197,0,0,0,3197,A
4-HA,1495,3195,0,2,0,3197,A
4-HA,1496,3190,0,0,0,3190,A
4-HA,1497,2,3171,0,0,3173,T
4-HA,1498,0,2,3155,0,3157,G
4-HA,1499,2,5,3154,0,3161,G
4-HA,1500,3159,1,0,0,3160,A
4-HA,1501,3177,0,1,0,3178,A
4-HA,1502,1,3,0,3165,3169,C
4-HA,1503,1,3144,1,2,3148,T
4-HA,1504,0,3154,0,1,3155,T
4-HA,1505,3160,0,1,0,3161,A
4-HA,1506,0,3152,0,0,3152,T
4-HA,1507,1,10,3142,0,3153,G
4-HA,1508,3137,0,5,2,3144,A
4-HA,1509,0,0,1,3135,3136,C
4-HA,1510,7,2,0,3082,3091,C
4-HA,1511,3090,0,0,0,3090,A
4-HA,1512,1,0,0,3146,3147,C
4-HA,1513,0,2,3207,0,3209,G
4-HA,1514,3283,2,2,0,3287,A
4-HA,1515,1,3282,0,37,3320,T
4-HA,1516,2,1,3439,0,3442,G
4-HA,1517,0,3412,1,0,3413,T
4-HA,1518,3527,0,0,0,3527,A
4-HA,1519,1,3523,0,0,3524,T
4-HA,1520,3513,0,2,0,3515,A
4-HA,1521,3,1,0,3512,3516,C
4-HA,1522,3142,2,2,0,3146,A
4-HA,1523,0,3,3166,0,3169,G
4-HA,1524,2999,0,0,0,2999,A
4-HA,1525,0,1,2918,0,2919,G
4-HA,1526,2896,0,1,0,2897,A
4-HA,1527,2,2689,0,0,2691,T
4-HA,1528,0,1,2677,0,2678,G
4-HA,1529,2684,1,0,0,2685,A
4-HA,1530,2662,0,6,0,2668,A
4-HA,1531,0,0,2717,0,2717,G
4-HA,1532,0,0,0,2670,2670,C
4-HA,1533,2661,1,0,0,2662,A
4-HA,1534,0,2624,0,1,2625,T
4-HA,1535,1,2626,0,0,2627,T
4-HA,1536,2639,0,1,0,2640,A
4-HA,1537,2635,0,2,0,2637,A
4-HA,1538,2636,2,2,1,2641,A
4-HA,1539,0,0,1,2640,2641,C
4-HA,1540,2491,0,1,0,2492,A
4-HA,1541,2487,0,0,0,2487,A
4-HA,1542,0,2471,0,1,2472,T
4-HA,1543,1,1,0,2487,2489,C
4-HA,1544,0,3,2483,0,2486,G
4-HA,1545,0,1,2528,1,2530,G
4-HA,1546,1,2525,1,7,2534,T
4-HA,1547,1,2525,0,1,2527,T
4-HA,1548,1,2490,0,2,2493,T
4-HA,1549,3,0,0,2503,2506,C
4-HA,1550,2514,0,2,0,2516,A
4-HA,1551,0,6,2540,0,2546,G
4-HA,1552,2545,1,0,0,2546,A
4-HA,1553,1,2542,0,1,2544,T
4-HA,1554,5,0,0,2466,2471,C
4-HA,1555,2444,0,3,1,2448,A
4-HA,1556,2450,0,0,0,2450,A
4-HA,1557,0,7,2447,0,2454,G
4-HA,1558,0,4,2440,0,2444,G
4-HA,1559,0,3,2440,0,2443,G
4-HA,1560,2345,0,1,1,2347,A
4-HA,1561,0,0,2367,0,2367,G
4-HA,1562,1,2372,0,0,2373,T
4-HA,1563,1,2368,0,0,2369,T
4-HA,1564,0,5,2385,0,2390,G
4-HA,1565,2368,2,4,0,2374,A
4-HA,1566,0,1,2382,0,2383,G
4-HA,1567,0,0,0,2370,2370,C
4-HA,1568,2,2346,0,3,2351,T
4-HA,1569,0,0,2355,0,2355,G
4-HA,1570,2335,0,4,1,2340,A
4-HA,1571,2348,0,2,0,2350,A
4-HA,1572,0,0,2348,0,2348,G
4-HA,1573,0,2299,0,0,2299,T
4-HA,1574,3,1,0,2288,2292,C
4-HA,1575,2262,0,2,0,2264,A
4-HA,1576,2,6,2251,1,2260,G
4-HA,1577,1,3,2253,0,2257,G
4-HA,1578,1,1,2213,0,2215,G
4-HA,1579,0,2278,0,0,2278,T
4-HA,1580,2280,0,0,0,2280,A
4-HA,1581,1,1,0,2268,2270,C
4-HA,1582,2267,0,0,0,2267,A
4-HA,1583,2263,0,0,0,2263,A
4-HA,1584,2257,0,1,0,2258,A
4-HA,1585,0,2,2273,0,2275,G
4-HA,1586,2204,0,0,0,2204,A
4-HA,1587,1,2118,0,1,2120,T
4-HA,1588,0,2088,0,0,2088,T
4-HA,1589,0,5,2085,0,2090,G
4-HA,1590,1,1,2090,0,2092,G
4-HA,1591,2109,1,1,0,2111,A
4-HA,1592,0,2108,0,1,2109,T
4-HA,1593,4,0,0,2089,2093,C
4-HA,1594,4,0,0,2058,2062,C
4-HA,1595,0,2037,0,0,2037,T
4-HA,1596,2046,0,0,0,2046,A
4-HA,1597,0,2046,0,3,2049,T
4-HA,1598,1,1,2046,0,2048,G
4-HA,1599,0,3,2041,0,2044,G
4-HA,1600,1989,0,0,1,1990,A
4-HA,1601,0,1980,0,2,1982,T
4-HA,1602,0,1951,0,0,1951,T
4-HA,1603,0,1948,0,1,1949,T
4-HA,1604,2,0,0,1937,1939,C
4-HA,1605,2,0,0,1937,1939,C
4-HA,1606,0,1913,0,1,1914,T
4-HA,1607,0,1908,0,0,1908,T
4-HA,1608,3,1893,0,0,1896,T
4-HA,1609,0,0,1909,0,1909,G
4-HA,1610,0,0,0,1906,1906,C
4-HA,1611,3,3,0,1904,1910,C
4-HA,1612,1880,0,1,0,1881,A
4-HA,1613,0,1855,0,0,1855,T
4-HA,1614,1881,0,0,0,1881,A
4-HA,1615,0,1877,0,2,1879,T
4-HA,1616,2,0,0,1872,1874,C
4-HA,1617,1872,0,1,0,1873,A
4-HA,1618,0,1817,0,5,1822,T
4-HA,1619,0,1,1832,0,1833,G
4-HA,1620,0,1824,0,0,1824,T
4-HA,1621,0,1810,0,0,1810,T
4-HA,1622,0,1809,0,0,1809,T
4-HA,1623,0,1767,0,0,1767,T
4-HA,1624,1,1766,0,0,1767,T
4-HA,1625,0,1763,0,0,1763,T
4-HA,1626,0,1,1763,0,1764,G
4-HA,1627,0,1,0,1766,1767,C
4-HA,1628,0,1712,0,1,1713,T
4-HA,1629,0,1715,0,0,1715,T
4-HA,1630,1,1708,1,0,1710,T
4-HA,1631,0,0,1736,0,1736,G
4-HA,1632,0,1735,0,2,1737,T
4-HA,1633,0,0,1736,0,1736,G
4-HA,1634,0,1735,0,1,1736,T
4-HA,1635,1,1698,0,0,1699,T
4-HA,1636,1,0,1709,0,1710,G
4-HA,1637,0,0,0,1708,1708,C
4-HA,1638,0,1692,0,5,1697,T
4-HA,1639,1,1699,0,0,1700,T
4-HA,1640,1,1611,0,1,1613,T
4-HA,1641,0,2,1623,0,1625,G
4-HA,1642,0,1619,0,0,1619,T
4-HA,1643,0,1613,0,1,1614,T
4-HA,1644,0,5,1606,0,1611,G
4-HA,1645,0,4,1559,0,1563,G
4-HA,1646,0,4,1550,0,1554,G
4-HA,1647,0,1,1561,0,1562,G
4-HA,1648,1,1520,0,0,1521,T
4-HA,1649,0,1512,1,2,1515,T
4-HA,1650,5,2,0,1483,1490,C
4-HA,1651,1472,0,1,0,1473,A
4-HA,1652,1,1475,0,2,1478,T
4-HA,1653,0,1,0,1469,1470,C
4-HA,1654,1460,0,0,0,1460,A
4-HA,1655,0,1414,0,1,1415,T
4-HA,1656,1,0,1405,0,1406,G
4-HA,1657,0,1384,0,2,1386,T
4-HA,1658,1,4,1372,0,1377,G
4-HA,1659,1,3,1344,0,1348,G
4-HA,1660,1,0,1337,1,1339,G
4-HA,1661,0,1,0,1314,1315,C
4-HA,1662,0,0,0,1275,1275,C
4-HA,1663,0,1206,0,2,1208,T
4-HA,1664,1,0,1212,0,1213,G
4-HA,1665,0,0,1,1207,1208,C
4-HA,1666,0,1,0,1209,1210,C
4-HA,1667,1205,0,0,0,1205,A
4-HA,1668,1196,0,0,0,1196,A
4-HA,1669,1197,0,0,0,1197,A
4-HA,1670,1191,0,0,0,1191,A
4-HA,1671,1191,0,2,0,1193,A
4-HA,1672,0,3,1190,0,1193,G
4-HA,1673,0,1,1152,0,1153,G
4-HA,1674,0,0,0,1136,1136,C
4-HA,1675,1137,0,1,0,1138,A
4-HA,1676,1137,1,1,0,1139,A
4-HA,1677,0,0,0,1136,1136,C
4-HA,1678,1135,0,0,0,1135,A
4-HA,1679,0,1133,0,0,1133,T
4-HA,1680,0,1114,0,1,1115,T
4-HA,1681,1090,0,1,0,1091,A
4-HA,1682,0,0,1090,0,1090,G
4-HA,1683,0,0,1087,0,1087,G
4-HA,1684,0,1052,0,4,1056,T
4-HA,1685,0,0,998,0,998,G
4-HA,1686,0,0,0,970,970,C
4-HA,1687,953,0,0,0,953,A
4-HA,1688,951,0,0,0,951,A
4-HA,1689,1,0,0,949,950,C
4-HA,1690,940,0,0,0,940,A
4-HA,1691,0,914,0,0,914,T
4-HA,1692,0,857,1,4,862,T
4-HA,1693,0,856,0,0,856,T
4-HA,1694,0,0,857,0,857,G
4-HA,1695,0,0,0,850,850,C
4-HA,1696,848,0,0,0,848,A
4-HA,1697,0,786,0,0,786,T
4-HA,1698,0,754,1,0,755,T
4-HA,1699,0,727,0,0,727,T
4-HA,1700,0,0,727,0,727,G
4-HA,1701,692,0,0,0,692,A
5-NP,1,808,0,0,0,808,A
5-NP,2,0,811,0,0,811,T
5-NP,3,0,0,808,0,808,G
5-NP,4,1,0,811,0,812,G
5-NP,5,1,2,0,813,816,C
5-NP,6,1,1,826,0,828,G
5-NP,7,0,863,0,1,864,T
5-NP,8,2,1,0,875,878,C
5-NP,9,3,0,0,879,882,C
5-NP,10,2,0,0,883,885,C
5-NP,11,889,0,0,0,889,A
5-NP,12,888,0,0,0,888,A
5-NP,13,0,2,895,0,897,G
5-NP,14,0,0,924,0,924,G
5-NP,15,0,0,0,931,931,C
5-NP,16,937,0,0,0,937,A
5-NP,17,0,1,0,939,940,C
5-NP,18,1,0,0,938,939,C
5-NP,19,949,0,0,0,949,A
5-NP,20,946,0,0,0,946,A
5-NP,21,946,0,0,0,946,A
5-NP,22,0,0,0,951,951,C
5-NP,23,0,3,948,0,951,G
5-NP,24,0,0,1050,0,1050,G
5-NP,25,0,1048,0,1,1049,T
5-NP,26,2,0,0,1117,1119,C
5-NP,27,0,1116,0,0,1116,T
5-NP,28,0,1129,0,1,1130,T
5-NP,29,1134,0,0,0,1134,A
5-NP,30,0,1134,0,0,1134,T
5-NP,31,0,6,1138,0,1144,G
5-NP,32,1141,0,0,0,1141,A
5-NP,33,1117,0,0,0,1117,A
5-NP,34,0,0,0,1122,1122,C
5-NP,35,1104,0,0,0,1104,A
5-NP,36,0,1,1179,0,1180,G
5-NP,37,1179,0,0,0,1179,A
5-NP,38,0,1182,0,1,1183,T
5-NP,39,0,1,1182,0,1183,G
5-NP,40,0,0,1185,0,1185,G
5-NP,41,1182,1,0,0,1183,A
5-NP,42,1187,0,0,0,1187,A
5-NP,43,1192,0,0,0,1192,A
5-NP,44,0,0,0,1227,1227,C
5-NP,45,0,1212,0,1,1213,T
5-NP,46,0,5,1224,0,1229,G
5-NP,47,1219,0,2,0,1221,A
5-NP,48,0,1224,1,0,1225,T
5-NP,49,0,4,1221,0,1225,G
5-NP,50,1,5,1222,0,1228,G
5-NP,51,0,1,1228,0,1229,G
5-NP,52,1,2,1230,0,1233,G
5-NP,53,1222,0,0,0,1222,A
5-NP,54,1,1222,0,1,1224,T
5-NP,55,0,0,0,1232,1232,C
5-NP,56,0,1,1237,0,1238,G
5-NP,57,0,0,0,1250,1250,C
5-NP,58,1,1,1,1248,1251,C
5-NP,59,1249,0,1,0,1250,A
5-NP,60,0,0,1261,0,1261,G
5-NP,61,1254,0,0,0,1254,A
5-NP,62,1268,0,0,0,1268,A
5-NP,63,0,1270,0,0,1270,T
5-NP,64,0,0,1267,0,1267,G
5-NP,65,0,0,0,1272,1272,C
5-NP,66,1272,0,1,0,1273,A
5-NP,67,1295,0,0,0,1295,A
5-NP,68,1,1,0,1292,1294,C
5-NP,69,0,1284,0,0,1284,T
5-NP,70,0,4,1301,0,1305,G
5-NP,71,1323,0,1,0,1324,A
5-NP,72,0,1,1408,0,1409,G
5-NP,73,1412,0,0,0,1412,A
5-NP,74,0,1395,0,1,1396,T
5-NP,75,0,1403,0,0,1403,T
5-NP,76,1400,0,0,0,1400,A
5-NP,77,0,6,1396,0,1402,G
5-NP,78,0,1,1404,0,1405,G
5-NP,79,1,0,1403,0,1404,G
5-NP,80,0,0,0,1394,1394,C
5-NP,81,1373,1,1,0,1375,A
5-NP,82,0,1382,0,0,1382,T
5-NP,83,1,0,0,1386,1387,C
5-NP,84,1,0,0,1385,1386,C
5-NP,85,1,1,1400,0,1402,G
5-NP,86,0,1400,0,2,1402,T
5-NP,87,5,0,0,1395,1400,C
5-NP,88,1,2,1400,1,1404,G
5-NP,89,0,3,1402,0,1405,G
5-NP,90,1,1,1411,0,1413,G
5-NP,91,1405,0,0,0,1405,A
5-NP,92,1410,0,0,0,1410,A
5-NP,93,0,2,1420,0,1422,G
5-NP,94,1404,0,3,0,1407,A
5-NP,95,0,1419,0,0,1419,T
5-NP,96,1,1,1423,0,1425,G
5-NP,97,1438,0,1,0,1439,A
5-NP,98,0,1443,0,0,1443,T
5-NP,99,1,1433,0,0,1434,T
5-NP,100,0,0,1439,0,1439,G
5-NP,101,1433,0,1,0,1434,A
5-NP,102,0,1431,0,0,1431,T
5-NP,103,0,4,1419,0,1423,G
5-NP,104,0,0,1416,0,1416,G
5-NP,105,0,2,1406,0,1408,G
5-NP,106,1489,0,0,0,1489,A
5-NP,107,0,1492,0,1,1493,T
5-NP,108,0,1495,0,0,1495,T
5-NP,109,0,4,1494,0,1498,G
5-NP,110,0,0,1502,1,1503,G
5-NP,111,1,5,1497,0,1503,G
5-NP,112,1501,1,2,0,1504,A
5-NP,113,0,1,1498,0,1499,G
5-NP,114,1491,0,1,0,1492,A
5-NP,115,0,1526,0,1,1527,T
5-NP,116,0,1533,0,0,1533,T
5-NP,117,5,0,0,1531,1536,C
5-NP,118,0,1524,0,2,1526,T
5-NP,119,1498,0,44,0,1542,A
5-NP,120,0,0,0,1541,1541,C
5-NP,121,1582,0,0,0,1582,A
5-NP,122,0,1592,0,0,1592,T
5-NP,123,1,0,0,1586,1587,C
5-NP,124,3,0,0,1584,1587,C
5-NP,125,1592,0,0,0,1592,A
5-NP,126,1617,0,0,0,1617,A
5-NP,127,1617,0,1,0,1618,A
5-NP,128,0,1609,0,0,1609,T
5-NP,129,0,0,1615,0,1615,G
5-NP,130,1,1589,0,1,1591,T
5-NP,131,0,2,1610,0,1612,G
5-NP,132,0,1,0,1603,1604,C
5-NP,133,1600,0,2,0,1602,A
5-NP,134,0,0,0,1602,1602,C
5-NP,135,0,1590,0,0,1590,T
5-NP,136,0,4,1661,1,1666,G
5-NP,137,1685,0,0,1,1686,A
5-NP,138,1709,1,0,0,1710,A
5-NP,139,0,0,1,1733,1734,C
5-NP,140,0,1715,0,0,1715,T
5-NP,141,0,1726,0,0,1726,T
5-NP,142,1726,0,0,0,1726,A
5-NP,143,1725,0,1,0,1726,A
5-NP,144,1737,0,0,1,1738,A
5-NP,145,1,0,0,1739,1740,C
5-NP,146,0,1675,0,1,1676,T
5-NP,147,4,0,0,1676,1680,C
5-NP,148,1658,0,1,0,1659,A
5-NP,149,0,0,1685,0,1685,G
5-NP,150,2,1681,0,1,1684,T
5-NP,151,0,3,1688,0,1691,G
5-NP,152,1715,1,0,0,1716,A
5-NP,153,0,1716,0,0,1716,T
5-NP,154,5,0,0,1740,1745,C
5-NP,155,1749,0,1,0,1750,A
5-NP,156,0,1741,0,0,1741,T
5-NP,157,0,1,1741,0,1742,G
5-NP,158,1735,0,0,0,1735,A
5-NP,159,1730,0,2,0,1732,A
5-NP,160,0,5,1726,0,1731,G
5-NP,161,0,1,1710,0,1711,G
5-NP,162,1,0,1713,0,1714,G
5-NP,163,0,0,0,1700,1700,C
5-NP,164,1,2,1704,0,1707,G
5-NP,165,0,0,1711,0,1711,G
5-NP,166,0,1706,0,0,1706,T
5-NP,167,0,1704,0,1,1705,T
5-NP,168,0,1,1712,0,1713,G
5-NP,169,1876,0,0,0,1876,A
5-NP,170,0,1871,0,0,1871,T
5-NP,171,1,1,0,1870,1872,C
5-NP,172,5,0,1,1870,1876,C
5-NP,173,1874,0,0,0,1874,A
5-NP,174,0,1,1875,1,1877,G
5-NP,175,1873,0,0,0,1873,A
5-NP,176,1877,0,0,0,1877,A
5-NP,177,0,0,0,1886,1886,C
5-NP,178,1800,0,1,0,1801,A
5-NP,179,0,0,1816,0,1816,G
5-NP,180,1,0,0,1811,1812,C
5-NP,181,0,1812,0,3,1815,T
5-NP,182,1,1824,0,0,1825,T
5-NP,183,0,5,1823,0,1828,G
5-NP,184,1835,0,1,0,1836,A
5-NP,185,0,1,0,1842,1843,C
5-NP,186,1836,0,0,0,1836,A
5-NP,187,1845,1,1,0,1847,A
5-NP,188,0,1835,0,0,1835,T
5-NP,189,1846,0,0,0,1846,A
5-NP,190,0,3,1849,0,1852,G
5-NP,191,1840,0,1,0,1841,A
5-NP,192,1,4,1847,0,1852,G
5-NP,193,1834,0,0,0,1834,A
5-NP,194,1867,0,1,0,1868,A
5-NP,195,1869,0,1,0,1870,A
5-NP,196,1875,0,0,0,1875,A
5-NP,197,0,1878,0,0,1878,T
5-NP,198,0,3,1876,0,1879,G
5-NP,199,0,1,1878,0,1879,G
5-NP,200,0,1871,0,0,1871,T
5-NP,201,1847,0,0,0,1847,A
5-NP,202,0,1,0,1861,1862,C
5-NP,203,0,1860,1,0,1861,T
5-NP,204,1,0,0,1865,1866,C
5-NP,205,0,1852,0,2,1854,T
5-NP,206,3,1,0,1853,1857,C
5-NP,207,3,3,1840,0,1846,G
5-NP,208,1,1,1848,0,1850,G
5-NP,209,0,0,0,1849,1849,C
5-NP,210,0,1847,1,2,1850,T
5-NP,211,1,1839,0,0,1840,T
5-NP,212,0,1836,0,1,1837,T
5-NP,213,0,1847,0,1,1848,T
5-NP,214,0,2,1846,0,1848,G
5-NP,215,1846,0,3,0,1849,A
5-NP,216,1,1851,0,0,1852,T
5-NP,217,0,1,1853,0,1854,G
5-NP,218,1851,0,0,0,1851,A
5-NP,219,1852,0,0,0,1852,A
5-NP,220,1849,0,0,0,1849,A
5-NP,221,0,2,1849,1,1852,G
5-NP,222,1856,0,1,0,1857,A
5-NP,223,1845,2,1,0,1848,A
5-NP,224,0,1,1864,0,1865,G
5-NP,225,0,2,1911,0,1913,G
5-NP,226,1914,1,1,0,1916,A
5-NP,227,1937,0,0,0,1937,A
5-NP,228,0,1939,0,0,1939,T
5-NP,229,1932,0,0,0,1932,A
5-NP,230,1929,0,1,0,1930,A
5-NP,231,1935,0,1,0,1936,A
5-NP,232,0,1933,1,1,1935,T
5-NP,233,1949,1,0,0,1950,A
5-NP,234,1,0,0,1939,1940,C
5-NP,235,2,0,0,1905,1907,C
5-NP,236,0,1907,0,0,1907,T
5-NP,237,0,0,1911,0,1911,G
5-NP,238,1,0,1936,0,1937,G
5-NP,239,1939,0,1,0,1940,A
5-NP,240,1934,0,1,0,1935,A
5-NP,241,0,3,1958,0,1961,G
5-NP,242,1935,0,1,1,1937,A
5-NP,243,1933,0,2,0,1935,A
5-NP,244,0,0,0,1929,1929,C
5-NP,245,1926,0,1,0,1927,A
5-NP,246,0,0,0,1974,1974,C
5-NP,247,6,1,0,1942,1949,C
5-NP,248,6,0,1,1938,1945,C
5-NP,249,5,1,0,1936,1942,C
5-NP,250,1917,0,0,1,1918,A
5-NP,251,0,1,1918,0,1919,G
5-NP,252,0,2,0,1916,1918,C
5-NP,253,0,0,1915,0,1915,G
5-NP,254,1,2,0,1918,1921,C
5-NP,255,2,4,1893,0,1899,G
5-NP,256,0,2,1922,0,1924,G
5-NP,257,1,3,1914,1,1919,G
5-NP,258,1,1,1929,0,1931,G
5-NP,259,1929,0,1,0,1930,A
5-NP,260,1921,0,2,0,1923,A
5-NP,261,1912,0,3,1,1916,A
5-NP,262,0,0,1928,0,1928,G
5-NP,263,1906,0,2,0,1908,A
5-NP,264,0,1908,1,0,1909,T
5-NP,265,1,0,1,1897,1899,C
5-NP,266,5,1,0,1891,1897,C
5-NP,267,7,1,0,1892,1900,C
5-NP,268,1902,0,0,0,1902,A
5-NP,269,1907,0,0,1,1908,A
5-NP,270,0,4,1908,0,1912,G
5-NP,271,1899,1,1,0,1901,A
5-NP,272,1897,0,1,1,1899,A
5-NP,273,1901,0,0,0,1901,A
5-NP,274,1906,0,0,0,1906,A
5-NP,275,2,0,0,1904,1906,C
5-NP,276,0,1901,0,0,1901,T
5-NP,277,1,5,1895,0,1901,G
5-NP,278,0,5,1897,0,1902,G
5-NP,279,0,2,1897,0,1899,G
5-NP,280,0,3,1894,0,1897,G
5-NP,281,1,1,1898,0,1900,G
5-NP,282,0,0,1928,0,1928,G
5-NP,283,0,0,0,2052,2052,C
5-NP,284,4,0,0,2047,2051,C
5-NP,285,6,2,1,2059,2068,C
5-NP,286,2363,0,0,0,2363,A
5-NP,287,0,2373,1,1,2375,T
5-NP,288,2503,0,1,0,2504,A
5-NP,289,0,2503,0,1,2504,T
5-NP,290,2482,1,0,0,2483,A
5-NP,291,0,0,1,2498,2499,C
5-NP,292,2307,0,0,0,2307,A
5-NP,293,0,1,2331,0,2332,G
5-NP,294,0,3,2327,0,2330,G
5-NP,295,2099,0,1,0,2100,A
5-NP,296,0,7,2130,2,2139,G
5-NP,297,2037,0,1,0,2038,A
5-NP,298,0,0,2059,0,2059,G
5-NP,299,0,2047,0,0,2047,T
5-NP,300,2020,1,2,0,2023,A
5-NP,301,0,0,2038,0,2038,G
5-NP,302,2012,0,0,1,2013,A
5-NP,303,0,2014,0,1,2015,T
5-NP,304,0,3,2001,0,2004,G
5-NP,305,0,1,2015,0,2016,G
5-NP,306,2011,1,0,0,2012,A
5-NP,307,1986,0,1,1,1988,A
5-NP,308,1993,0,0,0,1993,A
5-NP,309,2004,0,0,0,2004,A
5-NP,310,0,2002,0,1,2003,T
5-NP,311,0,4,2005,0,2009,G
5-NP,312,0,1,2014,0,2015,G
5-NP,313,2015,0,0,0,2015,A
5-NP,314,0,2006,0,1,2007,T
5-NP,315,0,0,2012,0,2012,G
5-NP,316,2002,0,2,0,2004,A
5-NP,317,0,11,2002,0,2013,G
5-NP,318,0,6,2007,0,2013,G
5-NP,319,1,1,2030,0,2032,G
5-NP,320,2118,0,2,0,2120,A
5-NP,321,2137,0,0,0,2137,A
5-NP,322,0,0,0,2228,2228,C
5-NP,323,1,2220,0,0,2221,T
5-NP,324,3,1,0,2303,2307,C
5-NP,325,2,0,2374,1,2377,G
5-NP,326,0,2429,0,1,2430,T
5-NP,327,0,0,0,2477,2477,C
5-NP,328,4,0,0,3037,3041,C
5-NP,329,0,3027,0,1,3028,T
5-NP,330,1,3063,1,1,3066,T
5-NP,331,0,3065,0,1,3066,T
5-NP,332,3082,0,0,0,3082,A
5-NP,333,0,3086,0,0,3086,T
5-NP,334,0,10,3078,0,3088,G
5-NP,335,3152,0,2,1,3155,A
5-NP,336,0,3,0,3157,3160,C
5-NP,337,3109,0,5,0,3114,A
5-NP,338,3126,0,1,1,3128,A
5-NP,339,3172,0,0,1,3173,A
5-NP,340,0,2,3431,0,3433,G
5-NP,341,3429,0,0,0,3429,A
5-NP,342,3428,1,2,0,3431,A
5-NP,343,1,5,3744,0,3750,G
5-NP,344,3793,0,0,0,3793,A
5-NP,345,3819,0,1,1,3821,A
5-NP,346,3819,0,0,0,3819,A
5-NP,347,0,3822,0,4,3826,T
5-NP,348,3819,0,2,0,3821,A
5-NP,349,3806,0,1,0,3807,A
5-NP,350,0,8,3877,0,3885,G
5-NP,351,0,1,3872,0,3873,G
5-NP,352,2,1,0,3862,3865,C
5-NP,353,1,8,3858,0,3867,G
5-NP,354,3901,0,0,1,3902,A
5-NP,355,3987,0,2,0,3989,A
5-NP,356,0,4007,0,0,4007,T
5-NP,357,3,0,0,4006,4009,C
5-NP,358,0,4001,2,0,4003,T
5-NP,359,2,5,4007,0,4014,G
5-NP,360,1,2,4019,0,4022,G
5-NP,361,1,2,0,4021,4024,C
5-NP,362,0,2,4023,2,4027,G
5-NP,363,0,1,0,4037,4038,C
5-NP,364,2,2,1,4033,4038,C
5-NP,365,4059,0,0,2,4061,A
5-NP,366,4147,0,2,1,4150,A
5-NP,367,1,0,4319,0,4320,G
5-NP,368,1,3,0,4326,4330,C
5-NP,369,4,1,0,4407,4412,C
5-NP,370,4421,1,2,1,4425,A
5-NP,371,4540,1,2,2,4545,A
5-NP,372,1,0,0,4629,4630,C
5-NP,373,4625,0,2,0,4627,A
5-NP,374,4771,1,3,0,4775,A
5-NP,375,0,4771,0,0,4771,T
5-NP,376,0,12,4929,1,4942,G
5-NP,377,0,0,4951,0,4951,G
5-NP,378,2,4909,0,0,4911,T
5-NP,379,0,9,4917,1,4927,G
5-NP,380,4897,1,4,0,4902,A
5-NP,381,0,8,5070,0,5078,G
5-NP,382,0,6,5088,0,5094,G
5-NP,383,5172,1,0,1,5174,A
5-NP,384,1,5740,0,1,5742,T
5-NP,385,1,4,5831,0,5836,G
5-NP,386,0,4,0,5880,5884,C
5-NP,387,0,5878,0,2,5880,T
5-NP,388,5941,0,1,0,5942,A
5-NP,389,0,1,0,6078,6079,C
5-NP,390,6075,2,2,0,6079,A
5-NP,391,2,6067,1,2,6072,T
5-NP,392,1,0,0,6052,6053,C
5-NP,393,0,5855,1,1,5857,T
5-NP,394,1,8,6185,3,6197,G
5-NP,395,1,2,6386,1,6390,G
5-NP,396,0,6385,2,4,6391,T
5-NP,397,15,0,1,6394,6410,C
5-NP,398,1,6366,0,4,6371,T
5-NP,399,6510,0,2,0,6512,A
5-NP,400,6527,1,0,0,6528,A
5-NP,401,1,0,0,6613,6614,C
5-NP,402,1,6606,0,3,6610,T
5-NP,403,7,1,0,6719,6727,C
5-NP,404,6724,2,5,3,6734,A
5-NP,405,0,1,0,7116,7117,C
5-NP,406,7111,1,4,0,7116,A
5-NP,407,0,7151,0,1,7152,T
5-NP,408,7109,0,0,0,7109,A
5-NP,409,7148,0,3,0,7151,A
5-NP,410,1,7210,0,4,7215,T
5-NP,411,0,17,7309,0,7326,G
5-NP,412,7296,1,0,1,7298,A
5-NP,413,0,7255,1,2,7258,T
5-NP,414,3,7142,2,1,7148,T
5-NP,415,2,7154,0,3,7159,T
5-NP,416,2,21,7116,3,7142,G
5-NP,417,2,3,7165,0,7170,G
5-NP,418,1,3,1,7170,7175,C
5-NP,419,7166,1,5,1,7173,A
5-NP,420,0,7184,0,5,7189,T
5-NP,421,1,7185,1,3,7190,T
5-NP,422,6,0,0,7193,7199,C
5-NP,423,9,0,0,7220,7229,C
5-NP,424,7378,1,3,0,7382,A
5-NP,425,7396,2,3,0,7401,A
5-NP,426,0,7390,0,1,7391,T
5-NP,427,0,7398,0,1,7399,T
5-NP,428,0,7395,0,1,7396,T
5-NP,429,4,7,7457,0,7468,G
5-NP,430,7455,0,9,0,7464,A
5-NP,431,7480,0,1,0,7481,A
5-NP,432,2,7528,0,2,7532,T
5-NP,433,1,15,7450,0,7466,G
5-NP,434,7811,5,3,0,7819,A
5-NP,435,1,7817,1,4,7823,T
5-NP,436,3,2,7864,0,7869,G
5-NP,437,1,2,1,8074,8078,C
5-NP,438,8044,0,8,0,8052,A
5-NP,439,8442,0,5,0,8447,A
5-NP,440,4,0,0,8456,8460,C
5-NP,441,8632,2,1,0,8635,A
5-NP,442,0,8887,3,4,8894,T
5-NP,443,8785,2,3,1,8791,A
5-NP,444,4,2,0,8989,8995,C
5-NP,445,13,1,0,8967,8981,C
5-NP,446,8800,1,2,0,8803,A
5-NP,447,1,12,8936,0,8949,G
5-NP,448,8761,1,6,1,8769,A
5-NP,449,2,13,8970,1,8986,G
5-NP,450,1,15,8966,2,8984,G
5-NP,451,8927,0,13,0,8940,A
5-NP,452,2,0,0,8990,8992,C
5-NP,453,8910,1,7,1,8919,A
5-NP,454,8907,3,9,1,8920,A
5-NP,455,0,15,8956,0,8971,G
5-NP,456,8885,3,9,2,8899,A
5-NP,457,1,3,8943,0,8947,G
5-NP,458,2,0,0,8932,8934,C
5-NP,459,3,8877,0,14,8894,T
5-NP,460,17,1,0,8923,8941,C
5-NP,461,0,8901,1,1,8903,T
5-NP,462,0,8936,0,1,8937,T
5-NP,463,2,4,8978,0,8984,G
5-NP,464,2,8959,0,0,8961,T
5-NP,465,1,8948,0,6,8955,T
5-NP,466,18,2,1,8923,8944,C
5-NP,467,0,20,8942,2,8964,G
5-NP,468,9157,2,2,2,9163,A
5-NP,469,9154,5,3,1,9163,A
5-NP,470,0,1,1,9233,9235,C
5-NP,471,1,9202,0,1,9204,T
5-NP,472,2,11,9335,0,9348,G
5-NP,473,1,13,9376,2,9392,G
5-NP,474,9371,5,4,2,9382,A
5-NP,475,9402,3,11,0,9416,A
5-NP,476,0,9392,0,2,9394,T
5-NP,477,1,27,9389,0,9417,G
5-NP,478,3,8,9442,1,9454,G
5-NP,479,9522,1,7,0,9530,A
5-NP,480,2,9603,0,2,9607,T
5-NP,481,9,1,0,9638,9648,C
5-NP,482,17,2,0,9606,9625,C
5-NP,483,24,1,0,9637,9662,C
5-NP,484,9741,1,6,1,9749,A
5-NP,485,0,6,9843,0,9849,G
5-NP,486,9858,1,1,0,9860,A
5-NP,487,9850,0,2,2,9854,A
5-NP,488,2,9778,0,2,9782,T
5-NP,489,1,4,9868,0,9873,G
5-NP,490,1,9804,0,3,9808,T
5-NP,491,3,2,9853,0,9858,G
5-NP,492,1,2,1,9868,9872,C
5-NP,493,4,9807,1,8,9820,T
5-NP,494,23,0,0,10318,10341,C
5-NP,495,0,10278,1,11,10290,T
5-NP,496,10,0,2,10640,10652,C
5-NP,497,2,10642,1,1,10646,T
5-NP,498,2,17,10652,1,10672,G
5-NP,499,10736,3,6,0,10745,A
5-NP,500,4,10709,1,4,10718,T
5-NP,501,7,3,10695,0,10705,G
5-NP,502,3,1,0,10694,10698,C
5-NP,503,10392,3,3,0,10398,A
5-NP,504,4,31,10624,2,10661,G
5-NP,505,2,15,10490,0,10507,G
5-NP,506,1,3,10584,0,10588,G
5-NP,507,4,1,0,10588,10593,C
5-NP,508,2,10547,0,4,10553,T
5-NP,509,12,8,0,10576,10596,C
5-NP,510,2,34,10575,0,10611,G
5-NP,511,10743,3,3,0,10749,A
5-NP,512,2,0,1,10731,10734,C
5-NP,513,4,10605,0,9,10618,T
5-NP,514,15,0,0,11098,11113,C
5-NP,515,2,11061,0,4,11067,T
5-NP,516,17,3,0,12506,12526,C
5-NP,517,14,2,0,12528,12544,C
5-NP,518,41,0,1,12528,12570,C
5-NP,519,0,12568,0,3,12571,T
5-NP,520,12496,4,1,0,12501,A
5-NP,521,0,8,12487,0,12495,G
5-NP,522,12474,2,5,1,12482,A
5-NP,523,12129,0,4,0,12133,A
5-NP,524,2,27,12116,0,12145,G
5-NP,525,2,5,11976,1,11984,G
5-NP,526,4,11811,1,7,11823,T
5-NP,527,12,0,1,11801,11814,C
5-NP,528,9,6,0,11802,11817,C
5-NP,529,7,27,11798,0,11832,G
5-NP,530,1,15,11899,1,11916,G
5-NP,531,11875,0,26,0,11901,A
5-NP,532,0,1,12013,0,12014,G
5-NP,533,3,1,0,12023,12027,C
5-NP,534,2,11926,0,13,11941,T
5-NP,535,5,3,11966,0,11974,G
5-NP,536,5,3,2,11977,11987,C
5-NP,537,11944,3,19,1,11967,A
5-NP,538,4,15,11999,1,12019,G
5-NP,539,2,4,12077,0,12083,G
5-NP,540,0,12071,0,3,12074,T
5-NP,541,1,1,11975,0,11977,G
5-NP,542,2,4,0,12026,12032,C
5-NP,543,2,11999,1,10,12012,T
5-NP,544,4,5,12029,0,12038,G
5-NP,545,2,1,0,12010,12013,C
5-NP,546,12156,1,6,1,12164,A
5-NP,547,0,3,12359,1,12363,G
5-NP,548,4,12273,2,5,12284,T
5-NP,549,31,2,1,12273,12307,C
5-NP,550,12285,2,7,0,12294,A
5-NP,551,12303,3,3,0,12309,A
5-NP,552,12276,1,18,4,12299,A
5-NP,553,2,19,12341,0,12362,G
5-NP,554,2,22,12407,0,12431,G
5-NP,555,12372,3,1,1,12377,A
5-NP,556,12251,1,2,0,12254,A
5-NP,557,1,12262,0,1,12264,T
5-NP,558,9,8,0,12237,12254,C
5-NP,559,4,33,12206,1,12244,G
5-NP,560,10,19,12540,0,12569,G
5-NP,561,3,17,12572,3,12595,G
5-NP,562,12533,0,23,0,12556,A
5-NP,563,3,5,0,12567,12575,C
5-NP,564,12430,3,1,0,12434,A
5-NP,565,12699,1,9,1,12710,A
5-NP,566,2,12742,0,2,12746,T
5-NP,567,3,28,12788,0,12819,G
5-NP,568,1,2,12947,0,12950,G
5-NP,569,3,12757,0,1,12761,T
5-NP,570,1,11,12767,0,12779,G
5-NP,571,12768,4,4,0,12776,A
5-NP,572,1,12722,0,6,12729,T
5-NP,573,5,24,12717,2,12748,G
5-NP,574,2,23,12957,2,12984,G
5-NP,575,12955,3,12,0,12970,A
5-NP,576,12967,0,0,0,12967,A
5-NP,577,3,3,1,12917,12924,C
5-NP,578,1,12777,0,3,12781,T
5-NP,579,12738,0,6,1,12745,A
5-NP,580,13337,1,3,1,13342,A
5-NP,581,2,13346,0,1,13349,T
5-NP,582,21,3,1,13349,13374,C
5-NP,583,13014,0,4,0,13018,A
5-NP,584,0,18,13229,1,13248,G
5-NP,585,13193,2,4,0,13199,A
5-NP,586,13215,2,8,1,13226,A
5-NP,587,0,13223,1,2,13226,T
5-NP,588,1,25,13088,1,13115,G
5-NP,589,7,5,13250,0,13262,G
5-NP,590,1,13271,0,16,13288,T
5-NP,591,35,5,1,13254,13295,C
5-NP,592,13275,9,3,0,13287,A
5-NP,593,13269,1,2,6,13278,A
5-NP,594,13279,1,9,1,13290,A
5-NP,595,3,10,0,13276,13289,C
5-NP,596,6,37,13189,4,13236,G
5-NP,597,3,36,13263,1,13303,G
5-NP,598,3,52,13143,2,13200,G
5-NP,599,4,17,13213,0,13234,G
5-NP,600,6,23,13217,1,13247,G
5-NP,601,13240,4,12,1,13257,A
5-NP,602,4,13135,0,10,13149,T
5-NP,603,16,2,1,13150,13169,C
5-NP,604,13188,1,12,0,13201,A
5-NP,605,13141,1,56,0,13198,A
5-NP,606,0,6,2,13087,13095,C
5-NP,607,2,25,13008,1,13036,G
5-NP,608,12980,2,6,1,12989,A
5-NP,609,1,12971,0,1,12973,T
5-NP,610,13,1,1,12957,12972,C
5-NP,611,3,20,12969,1,12993,G
5-NP,612,12990,1,2,0,12993,A
5-NP,613,12971,1,6,2,12980,A
5-NP,614,12989,1,2,3,12995,A
5-NP,615,1,13158,0,1,13160,T
5-NP,616,2,13130,1,0,13133,T
5-NP,617,3,13126,3,0,13132,T
5-NP,618,2,13185,1,4,13192,T
5-NP,619,0,13209,2,8,13219,T
5-NP,620,4,25,13191,1,13221,G
5-NP,621,0,20,13209,0,13229,G
5-NP,622,13153,3,12,1,13169,A
5-NP,623,1,12,13245,0,13258,G
5-NP,624,13047,2,1,0,13050,A
5-NP,625,1,16,13596,1,13614,G
5-NP,626,144,2,13514,0,13660,G
5-NP,627,0,13651,0,6,13657,T
5-NP,628,1,28,13652,2,13683,G
5-NP,629,13679,0,14,1,13694,A
5-NP,630,1,16,13763,1,13781,G
5-NP,631,13754,1,28,0,13783,A
5-NP,632,13734,1,6,1,13742,A
5-NP,633,1,13707,0,3,13711,T
5-NP,634,3,24,13289,0,13316,G
5-NP,635,2,12,13221,0,13235,G
5-NP,636,13074,4,27,1,13106,A
5-NP,637,3,9,0,13146,13158,C
5-NP,638,4,16,13152,0,13172,G
5-NP,639,2,12,13364,2,13380,G
5-NP,640,13353,2,0,2,13357,A
5-NP,641,13386,4,3,0,13393,A
5-NP,642,13543,0,6,1,13550,A
5-NP,643,13555,3,14,1,13573,A
5-NP,644,1,2,1,13662,13666,C
5-NP,645,13626,0,8,0,13634,A
5-NP,646,13612,4,4,1,13621,A
5-NP,647,2,5,13612,1,13620,G
5-NP,648,13255,0,2,1,13258,A
5-NP,649,13302,3,6,0,13311,A
5-NP,650,3,5,13619,0,13627,G
5-NP,651,8,13590,1,1,13600,T
5-NP,652,2,4,14231,0,14237,G
5-NP,653,2,3,2,14154,14161,C
5-NP,654,2,14180,0,12,14194,T
5-NP,655,0,14254,1,5,14260,T
5-NP,656,14424,0,1,1,14426,A
5-NP,657,2,14431,0,3,14436,T
5-NP,658,4,24,14471,0,14499,G
5-NP,659,14164,4,18,0,14186,A
5-NP,660,1,35,14174,0,14210,G
5-NP,661,13477,1,10,1,13489,A
5-NP,662,2,15,13555,0,13572,G
5-NP,663,13509,1,4,1,13515,A
5-NP,664,13652,0,5,0,13657,A
5-NP,665,4,13522,1,2,13529,T
5-NP,666,7,5,13655,1,13668,G
5-NP,667,6,13613,2,10,13631,T
5-NP,668,3,1,13656,0,13660,G
5-NP,669,3,4,1,13614,13622,C
5-NP,670,13580,2,6,0,13588,A
5-NP,671,13614,2,11,1,13628,A
5-NP,672,2,0,0,13600,13602,C
5-NP,673,13483,2,0,0,13485,A
5-NP,674,1,13515,0,4,13520,T
5-NP,675,2,13348,0,10,13360,T
5-NP,676,14,0,0,13405,13419,C
5-NP,677,6,13359,1,3,13369,T
5-NP,678,4,13358,1,2,13365,T
5-NP,679,13379,0,3,3,13385,A
5-NP,680,13320,1,3,1,13325,A
5-NP,681,13316,5,5,0,13326,A
5-NP,682,1,13,13312,0,13326,G
5-NP,683,0,11,13297,0,13308,G
5-NP,684,13262,3,1,1,13267,A
5-NP,685,13220,0,4,1,13225,A
5-NP,686,13226,0,1,0,13227,A
5-NP,687,13437,2,1,1,13441,A
5-NP,688,3,13388,3,2,13396,T
5-NP,689,0,13389,1,1,13391,T
5-NP,690,5,13437,0,4,13446,T
5-NP,691,27,3,2,13430,13462,C
5-NP,692,13467,1,6,0,13474,A
5-NP,693,13448,4,5,0,13457,A
5-NP,694,13454,1,2,0,13457,A
5-NP,695,1,2,1,13615,13619,C
5-NP,696,13408,4,5,1,13418,A
5-NP,697,2,3,13641,0,13646,G
5-NP,698,3,0,1,13641,13645,C
5-NP,699,2,13634,1,15,13652,T
5-NP,700,2,5,13875,1,13883,G
5-NP,701,3,4,2,13843,13852,C
5-NP,702,13942,5,2,2,13951,A
5-NP,703,1,6,2,13960,13969,C
5-NP,704,13852,2,3,0,13857,A
5-NP,705,13890,3,9,1,13903,A
5-NP,706,13565,1,6,0,13572,A
5-NP,707,2,26,14054,1,14083,G
5-NP,708,14050,4,18,0,14072,A
5-NP,709,12,5,14087,0,14104,G
5-NP,710,6,2,0,13999,14007,C
5-NP,711,13977,1,4,0,13982,A
5-NP,712,14283,2,51,7,14343,A
5-NP,713,0,14344,0,2,14346,T
5-NP,714,2,16,14347,2,14367,G
5-NP,715,1,7,14428,0,14436,G
5-NP,716,4,14023,0,10,14037,T
5-NP,717,9,28,14001,1,14039,G
5-NP,718,5,17,14117,0,14139,G
5-NP,719,14155,0,6,1,14162,A
5-NP,720,1,14124,1,3,14129,T
5-NP,721,24,3,0,13743,13770,C
5-NP,722,13798,0,9,2,13809,A
5-NP,723,13907,3,6,0,13916,A
5-NP,724,12,4,13964,0,13980,G
5-NP,725,0,13865,0,9,13874,T
5-NP,726,2,23,13856,0,13881,G
5-NP,727,13730,1,16,1,13748,A
5-NP,728,1,26,13780,1,13808,G
5-NP,729,13759,4,15,3,13781,A
5-NP,730,2,8,13789,0,13799,G
5-NP,731,13689,1,7,0,13697,A
5-NP,732,13462,1,4,0,13467,A
5-NP,733,13478,1,13,3,13495,A
5-NP,734,0,4,13566,1,13571,G
5-NP,735,1,13501,3,4,13509,T
5-NP,736,25,6,0,13454,13485,C
5-NP,737,5,19,13417,0,13441,G
5-NP,738,4,24,13447,2,13477,G
5-NP,739,13469,4,10,1,13484,A
5-NP,740,13543,2,3,0,13548,A
5-NP,741,3,3,0,13569,13575,C
5-NP,742,14,2,1,13487,13504,C
5-NP,743,50,1,1,13501,13553,C
5-NP,744,13555,1,7,0,13563,A
5-NP,745,0,14,13598,1,13613,G
5-NP,746,2,12,13614,0,13628,G
5-NP,747,13588,1,7,0,13596,A
5-NP,748,13579,2,5,2,13588,A
5-NP,749,13542,2,15,1,13560,A
5-NP,750,2,3,3,13558,13566,C
5-NP,751,5,3,13545,0,13553,G
5-NP,752,2,1,0,13523,13526,C
5-NP,753,4,13496,1,11,13512,T
5-NP,754,5,19,13520,0,13544,G
5-NP,755,13504,2,10,0,13516,A
5-NP,756,0,14,13716,0,13730,G
5-NP,757,13860,1,5,0,13866,A
5-NP,758,0,13869,2,0,13871,T
5-NP,759,18,5,0,13662,13685,C
5-NP,760,4,7,13696,1,13708,G
5-NP,761,13682,1,4,1,13688,A
5-NP,762,13669,2,7,0,13678,A
5-NP,763,2,17,13657,0,13676,G
5-NP,764,13646,3,9,0,13658,A
5-NP,765,1,3,0,13222,13226,C
5-NP,766,20,2,1,13714,13737,C
5-NP,767,3,13725,3,21,13752,T
5-NP,768,23,6,1,13789,13819,C
5-NP,769,13831,1,6,0,13838,A
5-NP,770,1,13837,1,2,13841,T
5-NP,771,13883,0,0,4,13887,A
5-NP,772,2,13878,1,2,13883,T
5-NP,773,3,13776,2,2,13783,T
5-NP,774,1,13506,6,3,13516,T
5-NP,775,1,13398,2,6,13407,T
5-NP,776,1,13404,0,2,13407,T
5-NP,777,13435,2,6,0,13443,A
5-NP,778,3,5,13431,1,13440,G
5-NP,779,3,6,0,13431,13440,C
5-NP,780,13385,7,5,1,13398,A
5-NP,781,13334,4,5,2,13345,A
5-NP,782,1,15,13787,2,13805,G
5-NP,783,13791,3,3,1,13798,A
5-NP,784,5,13798,0,2,13805,T
5-NP,785,10,2,0,13871,13883,C
5-NP,786,4,13810,1,14,13829,T
5-NP,787,2,2,14227,0,14231,G
5-NP,788,3,8,0,14251,14262,C
5-NP,789,14277,2,12,1,14292,A
5-NP,790,1,14437,0,3,14441,T
5-NP,791,3,13970,2,2,13977,T
5-NP,792,0,10,14878,1,14889,G
5-NP,793,15172,0,4,2,15178,A
5-NP,794,0,15159,0,2,15161,T
5-NP,795,15188,5,2,1,15196,A
5-NP,796,1,14840,2,6,14849,T
5-NP,797,1,14729,0,6,14736,T
5-NP,798,3,27,14815,0,14845,G
5-NP,799,14678,3,7,0,14688,A
5-NP,800,1,15,14786,1,14803,G
5-NP,801,14009,5,18,1,14033,A
5-NP,802,0,18,13834,1,13853,G
5-NP,803,4,23,14012,0,14039,G
5-NP,804,14006,2,9,0,14017,A
5-NP,805,5,13996,1,6,14008,T
5-NP,806,33,4,0,14009,14046,C
5-NP,807,13959,4,5,0,13968,A
5-NP,808,1,8,14012,0,14021,G
5-NP,809,7,13949,1,6,13963,T
5-NP,810,2,13858,0,3,13863,T
5-NP,811,3,5,13854,2,13864,G
5-NP,812,2,3,2,13756,13763,C
5-NP,813,0,13730,1,22,13753,T
5-NP,814,51,4,0,13810,13865,C
5-NP,815,13875,6,5,3,13889,A
5-NP,816,6,3,1,13886,13896,C
5-NP,817,13874,1,5,0,13880,A
5-NP,818,13942,1,1,3,13947,A
5-NP,819,13972,2,2,3,13979,A
5-NP,820,1,13916,2,3,13922,T
5-NP,821,9,1,1,13928,13939,C
5-NP,822,1,13921,2,12,13936,T
5-NP,823,1,13898,1,6,13906,T
5-NP,824,4,4,13961,0,13969,G
5-NP,825,7,9,2,13949,13967,C
5-NP,826,17,0,2,14140,14159,C
5-NP,827,3,14097,1,9,14110,T
5-NP,828,14172,1,6,0,14179,A
5-NP,829,4,4,1,14144,14153,C
5-NP,830,11,1,0,14135,14147,C
5-NP,831,3,14099,3,18,14123,T
5-NP,832,2,4,14306,0,14312,G
5-NP,833,4,3,1,14261,14269,C
5-NP,834,12,3,5,14273,14293,C
5-NP,835,1,14038,2,14,14055,T
5-NP,836,5,4,14215,1,14225,G
5-NP,837,2,14150,1,6,14159,T
5-NP,838,1,5,14305,0,14311,G
5-NP,839,14,6,0,14348,14368,C
5-NP,840,6,3,14573,1,14583,G
5-NP,841,3,14359,0,4,14366,T
5-NP,842,14335,1,2,0,14338,A
5-NP,843,0,14346,0,6,14352,T
5-NP,844,4,29,14315,0,14348,G
5-NP,845,1,32,14765,0,14798,G
5-NP,846,14740,2,9,0,14751,A
5-NP,847,2,4,1,14537,14544,C
5-NP,848,19,0,1,14490,14510,C
5-NP,849,5,14297,1,13,14316,T
5-NP,850,1,2,14986,0,14989,G
5-NP,851,3,2,1,14998,15004,C
5-NP,852,15009,0,12,0,15021,A
5-NP,853,3,2,15293,0,15298,G
5-NP,854,0,14619,0,3,14622,T
5-NP,855,15196,0,6,0,15202,A
5-NP,856,3,15147,1,14,15165,T
5-NP,857,15,2,0,15072,15089,C
5-NP,858,16,3,1,15094,15114,C
5-NP,859,14439,3,8,1,14451,A
5-NP,860,1,1,14523,0,14525,G
5-NP,861,4,14443,0,2,14449,T
5-NP,862,2,42,14528,1,14573,G
5-NP,863,1,18,14477,1,14497,G
5-NP,864,2,6,14266,0,14274,G
5-NP,865,2,14239,0,10,14251,T
5-NP,866,14208,3,3,1,14215,A
5-NP,867,2,8,2,14273,14285,C
5-NP,868,4,34,14179,0,14217,G
5-NP,869,14166,3,4,2,14175,A
5-NP,870,3,0,0,14169,14172,C
5-NP,871,1,13835,0,3,13839,T
5-NP,872,0,13861,1,7,13869,T
5-NP,873,13,4,0,13820,13837,C
5-NP,874,4,16,13835,0,13855,G
5-NP,875,13872,1,1,0,13874,A
5-NP,876,13865,1,4,1,13871,A
5-NP,877,13889,0,1,0,13890,A
5-NP,878,13873,1,3,1,13878,A
5-NP,879,13833,1,14,0,13848,A
5-NP,880,2,16,13897,1,13916,G
5-NP,881,13833,1,37,0,13871,A
5-NP,882,1,43,13930,0,13974,G
5-NP,883,3,27,14013,0,14043,G
5-NP,884,3,14,14067,1,14085,G
5-NP,885,14113,4,13,1,14131,A
5-NP,886,1,14104,0,7,14112,T
5-NP,887,14209,2,4,1,14216,A
5-NP,888,3,14186,2,8,14199,T
5-NP,889,1,14279,2,4,14286,T
5-NP,890,21,0,0,14345,14366,C
5-NP,891,15,3,0,14223,14241,C
5-NP,892,1,14049,2,3,14055,T
5-NP,893,0,14048,0,1,14049,T
5-NP,894,0,25,14175,1,14201,G
5-NP,895,1,1,14260,1,14263,G
5-NP,896,4,14140,0,9,14153,T
5-NP,897,3,41,14039,3,14086,G
5-NP,898,5,17,14010,1,14033,G
5-NP,899,4,16,14630,1,14651,G
5-NP,900,14642,2,6,1,14651,A
5-NP,901,14661,1,1,0,14663,A
5-NP,902,0,14670,0,3,14673,T
5-NP,903,14425,1,7,1,14434,A
5-NP,904,1,20,14414,3,14438,G
5-NP,905,14291,5,14,0,14310,A
5-NP,906,6,3,1,14277,14287,C
5-NP,907,22,3,1,14129,14155,C
5-NP,908,55,0,0,13718,13773,C
5-NP,909,2,13890,2,26,13920,T
5-NP,910,2,13944,1,8,13955,T
5-NP,911,1,13957,0,10,13968,T
5-NP,912,21,1,1,13954,13977,C
5-NP,913,13935,1,3,0,13939,A
5-NP,914,13948,3,3,0,13954,A
5-NP,915,13747,1,146,0,13894,A
5-NP,916,3,1,0,13913,13917,C
5-NP,917,0,13534,2,4,13540,T
5-NP,918,13469,2,2,1,13474,A
5-NP,919,3,1,0,13597,13601,C
5-NP,920,2,13512,0,8,13522,T
5-NP,921,3,13519,2,1,13525,T
5-NP,922,11,3,0,13566,13580,C
5-NP,923,13533,0,2,0,13535,A
5-NP,924,13546,2,3,0,13551,A
5-NP,925,13482,1,3,0,13486,A
5-NP,926,13490,5,3,1,13499,A
5-NP,927,1,13401,2,0,13404,T
5-NP,928,13152,1,8,0,13161,A
5-NP,929,1,3,13337,0,13341,G
5-NP,930,3,6,0,13374,13383,C
5-NP,931,21,5,0,13505,13531,C
5-NP,932,13543,1,0,1,13545,A
5-NP,933,13570,2,1,1,13574,A
5-NP,934,13990,0,2,0,13992,A
5-NP,935,1,14010,1,5,14017,T
5-NP,936,14080,0,6,1,14087,A
5-NP,937,1,14065,2,3,14071,T
5-NP,938,13841,3,4,0,13848,A
5-NP,939,2,3,3,13865,13873,C
5-NP,940,13463,1,4,3,13471,A
5-NP,941,3,4,13784,0,13791,G
5-NP,942,4,0,0,13739,13743,C
5-NP,943,1,13292,0,8,13301,T
5-NP,944,2,13404,0,3,13409,T
5-NP,945,13467,3,0,0,13470,A
5-NP,946,13476,3,3,0,13482,A
5-NP,947,0,13480,1,3,13484,T
5-NP,948,17,1,0,13439,13457,C
5-NP,949,12997,1,6,0,13004,A
5-NP,950,1,23,13112,2,13138,G
5-NP,951,13131,2,5,0,13138,A
5-NP,952,4,1,1,13233,13239,C
5-NP,953,13,2,1,13105,13121,C
5-NP,954,1,12966,0,4,12971,T
5-NP,955,13074,1,8,2,13085,A
5-NP,956,13073,1,3,0,13077,A
5-NP,957,3,25,0,13094,13122,C
5-NP,958,5,25,13095,0,13125,G
5-NP,959,12856,1,7,1,12865,A
5-NP,960,0,19,12871,0,12890,G
5-NP,961,12727,2,7,0,12736,A
5-NP,962,12826,3,3,2,12834,A
5-NP,963,4,12786,0,5,12795,T
5-NP,964,8,1,12,12659,12680,C
5-NP,965,14,2,1,12665,12682,C
5-NP,966,12511,1,20,0,12532,A
5-NP,967,2,4,12613,0,12619,G
5-NP,968,6,2,0,12595,12603,C
5-NP,969,12727,3,6,1,12737,A
5-NP,970,6,2,1,12780,12789,C
5-NP,971,12611,3,4,2,12620,A
5-NP,972,3,4,0,12644,12651,C
5-NP,973,12595,0,2,1,12598,A
5-NP,974,12647,2,13,0,12662,A
5-NP,975,0,23,12672,1,12696,G
5-NP,976,12570,2,12,1,12585,A
5-NP,977,3,3,12619,0,12625,G
5-NP,978,3,12349,0,9,12361,T
5-NP,979,22,1,0,12312,12335,C
5-NP,980,12303,3,8,0,12314,A
5-NP,981,1,5,12305,0,12311,G
5-NP,982,2,0,1,12285,12288,C
5-NP,983,0,12192,1,5,12198,T
5-NP,984,1,15,12331,3,12350,G
5-NP,985,4,4,12423,0,12431,G
5-NP,986,4,12333,0,4,12341,T
5-NP,987,1,1,12411,1,12414,G
5-NP,988,1,12279,0,5,12285,T
5-NP,989,2,24,12241,0,12267,G
5-NP,990,3,5,12218,2,12228,G
5-NP,991,12137,2,12,0,12151,A
5-NP,992,1,12170,0,7,12178,T
5-NP,993,4,20,11707,2,11733,G
5-NP,994,5,3,11685,0,11693,G
5-NP,995,3,5,1,11629,11638,C
5-NP,996,11538,2,7,0,11547,A
5-NP,997,1,11531,4,8,11544,T
5-NP,998,7,3,11472,1,11483,G
5-NP,999,4,5,0,11540,11549,C
5-NP,1000,24,7,1,11551,11583,C
5-NP,1001,11592,3,5,1,11601,A
5-NP,1002,4,11555,0,4,11563,T
5-NP,1003,4,11360,2,6,11372,T
5-NP,1004,14,3,1,11385,11403,C
5-NP,1005,0,11264,0,1,11265,T
5-NP,1006,5,1,11250,0,11256,G
5-NP,1007,2,1,0,11218,11221,C
5-NP,1008,2,10887,0,14,10903,T
5-NP,1009,8,3,10937,0,10948,G
5-NP,1010,4,1,0,10776,10781,C
5-NP,1011,10798,0,1,1,10800,A
5-NP,1012,0,10808,0,2,10810,T
5-NP,1013,2,10697,1,3,10703,T
5-NP,1014,2,10690,1,4,10697,T
5-NP,1015,1,8,10681,0,10690,G
5-NP,1016,10679,3,4,0,10686,A
5-NP,1017,10688,2,4,0,10694,A
5-NP,1018,0,11,10730,0,10741,G
5-NP,1019,10669,1,1,0,10671,A
5-NP,1020,0,10611,0,1,10612,T
5-NP,1021,0,10588,0,2,10590,T
5-NP,1022,2,10601,1,2,10606,T
5-NP,1023,10593,5,9,1,10608,A
5-NP,1024,10603,1,2,0,10606,A
5-NP,1025,1,7,10616,0,10624,G
5-NP,1026,10583,1,7,1,10592,A
5-NP,1027,3,10545,3,1,10552,T
5-NP,1028,1,10256,3,2,10262,T
5-NP,1029,2,2,10311,0,10315,G
5-NP,1030,3,10294,1,7,10305,T
5-NP,1031,2,10298,0,0,10300,T
5-NP,1032,10291,4,2,0,10297,A
5-NP,1033,10300,0,4,0,10304,A
5-NP,1034,2,1,10322,0,10325,G
5-NP,1035,3,3,1,10322,10329,C
5-NP,1036,2,10107,1,16,10126,T
5-NP,1037,3,10119,2,3,10127,T
5-NP,1038,12,2,0,10137,10151,C
5-NP,1039,10147,5,7,0,10159,A
5-NP,1040,1,10128,1,6,10136,T
5-NP,1041,3,1,1,10151,10156,C
5-NP,1042,10015,1,5,0,10021,A
5-NP,1043,1,5,10014,0,10020,G
5-NP,1044,9865,3,10,1,9879,A
5-NP,1045,1,29,9864,0,9894,G
5-NP,1046,4,12,9840,0,9856,G
5-NP,1047,5,13,9799,0,9817,G
5-NP,1048,9808,2,7,0,9817,A
5-NP,1049,3,4,2,9802,9811,C
5-NP,1050,9816,1,2,0,9819,A
5-NP,1051,9829,1,4,0,9834,A
5-NP,1052,9845,0,3,1,9849,A
5-NP,1053,9851,1,5,0,9857,A
5-NP,1054,0,7,9895,0,9902,G
5-NP,1055,2,9614,0,4,9620,T
5-NP,1056,9559,1,6,0,9566,A
5-NP,1057,2,9521,0,3,9526,T
5-NP,1058,10,0,0,9488,9498,C
5-NP,1059,1,9442,0,6,9449,T
5-NP,1060,10,0,0,9457,9467,C
5-NP,1061,9,1,2,9376,9388,C
5-NP,1062,1,9323,0,1,9325,T
5-NP,1063,9,2,0,9280,9291,C
5-NP,1064,1,19,9247,0,9267,G
5-NP,1065,3,14,9274,0,9291,G
5-NP,1066,2,15,9276,1,9294,G
5-NP,1067,1,4,9264,1,9270,G
5-NP,1068,3,9,9237,1,9250,G
5-NP,1069,9086,0,4,0,9090,A
5-NP,1070,9089,1,5,1,9096,A
5-NP,1071,9096,0,5,0,9101,A
5-NP,1072,4,1,0,9138,9143,C
5-NP,1073,2,9057,1,1,9061,T
5-NP,1074,2,2,9102,0,9106,G
5-NP,1075,3,9022,0,14,9039,T
5-NP,1076,19,1,0,9016,9036,C
5-NP,1077,9139,1,9,0,9149,A
5-NP,1078,9180,0,4,0,9184,A
5-NP,1079,3,10,0,9194,9207,C
5-NP,1080,1,9171,1,4,9177,T
5-NP,1081,8965,2,3,0,8970,A
5-NP,1082,0,9,8974,0,8983,G
5-NP,1083,8776,1,5,0,8782,A
5-NP,1084,1,6,8777,0,8784,G
5-NP,1085,2,11,8745,0,8758,G
5-NP,1086,8270,0,8,0,8278,A
5-NP,1087,1,2,8362,0,8365,G
5-NP,1088,2,8242,0,2,8246,T
5-NP,1089,8231,2,13,0,8246,A
5-NP,1090,2,1,1,8235,8239,C
5-NP,1091,8112,1,3,0,8116,A
5-NP,1092,8114,1,5,0,8120,A
5-NP,1093,8021,1,0,3,8025,A
5-NP,1094,2,7933,0,1,7936,T
5-NP,1095,1,7877,0,2,7880,T
5-NP,1096,0,3,7598,0,7601,G
5-NP,1097,2,1,0,7497,7500,C
5-NP,1098,0,7458,1,12,7471,T
5-NP,1099,3,7438,1,5,7447,T
5-NP,1100,6,1,1,7446,7454,C
5-NP,1101,7447,2,2,2,7453,A
5-NP,1102,7460,1,0,0,7461,A
5-NP,1103,7461,3,3,0,7467,A
5-NP,1104,0,7470,1,1,7472,T
5-NP,1105,4,10,7447,0,7461,G
5-NP,1106,7277,1,9,1,7288,A
5-NP,1107,0,10,7275,1,7286,G
5-NP,1108,7287,0,13,0,7300,A
5-NP,1109,7282,1,4,0,7287,A
5-NP,1110,1,5,1,7273,7280,C
5-NP,1111,7157,0,1,1,7159,A
5-NP,1112,1,7145,0,2,7148,T
5-NP,1113,1,10,7124,0,7135,G
5-NP,1114,0,9,7134,0,7143,G
5-NP,1115,7128,1,7,0,7136,A
5-NP,1116,0,6950,1,1,6952,T
5-NP,1117,6827,1,0,1,6829,A
5-NP,1118,6977,0,4,0,6981,A
5-NP,1119,0,6790,0,0,6790,T
5-NP,1120,6709,1,2,0,6712,A
5-NP,1121,1,6670,0,2,6673,T
5-NP,1122,0,18,5992,1,6011,G
5-NP,1123,0,5,5855,0,5860,G
5-NP,1124,0,6,5805,0,5811,G
5-NP,1125,5779,0,2,0,5781,A
5-NP,1126,1,5757,0,0,5758,T
5-NP,1127,4,18,1,4174,4197,C
5-NP,1128,3,6,4176,0,4185,G
5-NP,1129,4172,1,2,1,4176,A
5-NP,1130,2,1,4167,0,4170,G
5-NP,1131,2,0,0,4160,4162,C
5-NP,1132,4083,2,1,1,4087,A
5-NP,1133,1,0,1,4130,4132,C
5-NP,1134,0,4034,0,2,4036,T
5-NP,1135,8,2,0,4048,4058,C
5-NP,1136,3,4015,2,11,4031,T
5-NP,1137,0,3964,1,0,3965,T
5-NP,1138,0,9,3944,0,3953,G
5-NP,1139,3936,0,3,0,3939,A
5-NP,1140,3937,0,2,0,3939,A
5-NP,1141,1,0,0,3926,3927,C
5-NP,1142,0,2673,1,0,2674,T
5-NP,1143,0,7,2668,0,2675,G
5-NP,1144,2511,0,4,0,2515,A
5-NP,1145,1,1,2518,0,2520,G
5-NP,1146,2516,1,0,0,2517,A
5-NP,1147,2445,0,0,0,2445,A
5-NP,1148,1,0,2442,1,2444,G
5-NP,1149,0,0,0,2323,2323,C
5-NP,1150,1,6,2299,0,2306,G
5-NP,1151,1,2,2296,0,2299,G
5-NP,1152,1,2,2135,0,2138,G
5-NP,1153,1,2089,0,0,2090,T
5-NP,1154,1960,0,0,0,1960,A
5-NP,1155,0,0,0,1952,1952,C
5-NP,1156,1,1106,0,0,1107,T
5-NP,1157,1,1,1027,0,1029,G
5-NP,1158,0,0,937,0,937,G
5-NP,1159,0,0,868,0,868,G
5-NP,1160,0,0,0,822,822,C
5-NP,1161,1,0,0,589,590,C
5-NP,1162,592,0,0,0,592,A
5-NP,1163,0,591,0,0,591,T
5-NP,1164,593,0,0,0,593,A
5-NP,1165,594,0,0,0,594,A
5-NP,1166,0,1,594,0,595,G
5-NP,1167,0,0,606,0,606,G
5-NP,1168,597,0,0,0,597,A
5-NP,1169,0,0,0,593,593,C
5-NP,1170,1,0,0,592,593,C
5-NP,1171,588,0,1,0,589,A
5-NP,1172,0,2,600,0,602,G
5-NP,1173,0,0,602,0,602,G
5-NP,1174,597,0,0,0,597,A
5-NP,1175,0,0,600,0,600,G
5-NP,1176,0,578,0,0,578,T
5-NP,1177,0,1,577,0,578,G
5-NP,1178,0,1,581,0,582,G
5-NP,1179,579,0,1,1,581,A
5-NP,1180,1,0,586,0,587,G
5-NP,1181,0,1,579,0,580,G
5-NP,1182,576,0,1,0,577,A
5-NP,1183,577,0,0,0,577,A
5-NP,1184,572,0,0,0,572,A
5-NP,1185,0,0,0,577,577,C
5-NP,1186,573,0,2,0,575,A
5-NP,1187,0,0,0,586,586,C
5-NP,1188,1,576,0,0,577,T
5-NP,1189,594,0,0,0,594,A
5-NP,1190,591,0,0,0,591,A
5-NP,1191,0,594,0,1,595,T
5-NP,1192,2,1,0,593,596,C
5-NP,1193,590,0,0,0,590,A
5-NP,1194,593,0,1,0,594,A
5-NP,1195,0,0,0,595,595,C
5-NP,1196,579,0,0,0,579,A
5-NP,1197,0,0,579,0,579,G
5-NP,1198,560,0,1,0,561,A
5-NP,1199,0,1,566,0,567,G
5-NP,1200,0,1,563,0,564,G
5-NP,1201,0,0,563,0,563,G
5-NP,1202,0,1,0,567,568,C
5-NP,1203,0,0,0,565,565,C
5-NP,1204,0,555,0,2,557,T
5-NP,1205,0,0,0,566,566,C
5-NP,1206,0,0,0,560,560,C
5-NP,1207,2,0,559,0,561,G
5-NP,1208,0,0,0,562,562,C
5-NP,1209,557,0,0,0,557,A
5-NP,1210,0,0,585,0,585,G
5-NP,1211,0,0,589,0,589,G
5-NP,1212,0,0,0,589,589,C
5-NP,1213,1,0,0,587,588,C
5-NP,1214,585,0,0,0,585,A
5-NP,1215,591,0,0,0,591,A
5-NP,1216,589,2,0,0,591,A
5-NP,1217,0,0,0,594,594,C
5-NP,1218,1,0,0,593,594,C
5-NP,1219,563,0,0,0,563,A
5-NP,1220,0,1,570,0,571,G
5-NP,1221,0,569,0,0,569,T
5-NP,1222,0,0,573,0,573,G
5-NP,1223,0,571,0,0,571,T
5-NP,1224,0,0,572,0,572,G
5-NP,1225,0,0,0,574,574,C
5-NP,1226,569,0,0,0,569,A
5-NP,1227,572,1,1,0,574,A
5-NP,1228,0,0,0,573,573,C
5-NP,1229,1,0,0,568,569,C
5-NP,1230,0,561,0,0,561,T
5-NP,1231,556,0,0,0,556,A
5-NP,1232,0,0,0,559,559,C
5-NP,1233,0,0,558,0,558,G
5-NP,1234,0,557,0,0,557,T
5-NP,1235,0,561,0,0,561,T
5-NP,1236,0,552,0,0,552,T
5-NP,1237,0,548,0,1,549,T
5-NP,1238,1,0,0,549,550,C
5-NP,1239,0,544,0,0,544,T
5-NP,1240,0,0,562,0,562,G
5-NP,1241,0,560,0,0,560,T
5-NP,1242,564,0,0,0,564,A
5-NP,1243,1,1,0,563,565,C
5-NP,1244,558,0,0,0,558,A
5-NP,1245,558,0,0,0,558,A
5-NP,1246,554,0,0,1,555,A
5-NP,1247,0,0,563,0,563,G
5-NP,1248,560,0,1,0,561,A
5-NP,1249,542,0,0,0,542,A
5-NP,1250,542,0,0,0,542,A
5-NP,1251,0,0,0,543,543,C
5-NP,1252,3,0,0,535,538,C
5-NP,1253,0,533,0,0,533,T
5-NP,1254,0,0,0,535,535,C
5-NP,1255,3,0,0,531,534,C
5-NP,1256,1,0,0,533,534,C
5-NP,1257,534,0,0,0,534,A
5-NP,1258,0,530,0,0,530,T
5-NP,1259,0,534,0,0,534,T
5-NP,1260,0,528,0,0,528,T
5-NP,1261,0,0,529,0,529,G
5-NP,1262,528,0,0,0,528,A
5-NP,1263,528,0,1,0,529,A
5-NP,1264,529,0,0,0,529,A
5-NP,1265,525,0,0,0,525,A
5-NP,1266,0,0,531,0,531,G
5-NP,1267,0,526,0,1,527,T
5-NP,1268,1,0,1,521,523,C
5-NP,1269,526,0,1,0,527,A
5-NP,1270,530,0,0,0,530,A
5-NP,1271,1,0,0,532,533,C
5-NP,1272,2,0,0,536,538,C
5-NP,1273,539,0,0,0,539,A
5-NP,1274,0,539,0,1,540,T
5-NP,1275,0,1,0,532,533,C
5-NP,1276,533,1,0,0,534,A
5-NP,1277,1,531,0,1,533,T
5-NP,1278,0,0,531,0,531,G
5-NP,1279,0,0,532,0,532,G
5-NP,1280,1,0,0,531,532,C
5-NP,1281,518,0,0,0,518,A
5-NP,1282,0,0,521,0,521,G
5-NP,1283,0,1,0,514,515,C
5-NP,1284,515,0,0,0,515,A
5-NP,1285,0,516,0,0,516,T
5-NP,1286,0,508,0,0,508,T
5-NP,1287,0,0,0,513,513,C
5-NP,1288,509,0,0,0,509,A
5-NP,1289,0,1,0,514,515,C
5-NP,1290,0,515,0,0,515,T
5-NP,1291,1,2,514,0,517,G
5-NP,1292,0,0,520,0,520,G
5-NP,1293,508,1,1,0,510,A
5-NP,1294,511,0,0,0,511,A
5-NP,1295,515,0,0,0,515,A
5-NP,1296,0,509,0,0,509,T
5-NP,1297,511,0,0,0,511,A
5-NP,1298,0,0,0,508,508,C
5-NP,1299,0,0,499,0,499,G
5-NP,1300,0,1,498,0,499,G
5-NP,1301,490,0,1,0,491,A
5-NP,1302,0,3,487,0,490,G
5-NP,1303,0,1,488,0,489,G
5-NP,1304,1,0,491,0,492,G
5-NP,1305,489,0,1,0,490,A
5-NP,1306,489,0,0,0,489,A
5-NP,1307,0,2,490,0,492,G
5-NP,1308,492,0,0,0,492,A
5-NP,1309,500,0,0,0,500,A
5-NP,1310,0,0,0,506,506,C
5-NP,1311,0,492,0,0,492,T
5-NP,1312,0,497,0,0,497,T
5-NP,1313,0,0,0,498,498,C
5-NP,1314,495,0,2,0,497,A
5-NP,1315,0,0,499,0,499,G
5-NP,1316,496,0,0,0,496,A
5-NP,1317,0,0,0,498,498,C
5-NP,1318,499,0,0,0,499,A
5-NP,1319,0,488,0,1,489,T
5-NP,1320,0,2,487,0,489,G
5-NP,1321,477,0,0,0,477,A
5-NP,1322,0,0,484,0,484,G
5-NP,1323,0,0,483,0,483,G
5-NP,1324,0,1,478,0,479,G
5-NP,1325,0,0,0,480,480,C
5-NP,1326,478,0,0,0,478,A
5-NP,1327,0,1,477,0,478,G
5-NP,1328,474,1,1,0,476,A
5-NP,1329,481,0,0,0,481,A
5-NP,1330,481,0,0,0,481,A
5-NP,1331,0,477,1,1,479,T
5-NP,1332,0,0,0,485,485,C
5-NP,1333,483,0,0,0,483,A
5-NP,1334,1,480,0,0,481,T
5-NP,1335,481,0,0,0,481,A
5-NP,1336,479,0,0,0,479,A
5-NP,1337,0,0,486,0,486,G
5-NP,1338,478,0,0,0,478,A
5-NP,1339,484,0,0,0,484,A
5-NP,1340,0,476,0,0,476,T
5-NP,1341,0,0,471,0,471,G
5-NP,1342,469,1,1,0,471,A
5-NP,1343,0,471,0,0,471,T
5-NP,1344,0,2,470,0,472,G
5-NP,1345,0,1,470,0,471,G
5-NP,1346,460,1,1,0,462,A
5-NP,1347,461,0,0,0,461,A
5-NP,1348,450,0,0,0,450,A
5-NP,1349,0,0,456,0,456,G
5-NP,1350,0,455,0,1,456,T
5-NP,1351,7,0,449,0,456,G
5-NP,1352,0,0,0,456,456,C
5-NP,1353,455,0,0,0,455,A
5-NP,1354,456,0,0,0,456,A
5-NP,1355,455,1,0,0,456,A
5-NP,1356,462,0,0,0,462,A
5-NP,1357,0,0,0,464,464,C
5-NP,1358,0,1,0,460,461,C
5-NP,1359,458,0,0,0,458,A
5-NP,1360,0,0,458,0,458,G
5-NP,1361,456,1,0,0,457,A
5-NP,1362,457,0,0,0,457,A
5-NP,1363,0,0,457,0,457,G
5-NP,1364,458,0,0,0,458,A
5-NP,1365,440,0,1,0,441,A
5-NP,1366,0,0,442,0,442,G
5-NP,1367,0,436,0,0,436,T
5-NP,1368,0,0,439,0,439,G
5-NP,1369,0,436,0,1,437,T
5-NP,1370,0,0,0,438,438,C
5-NP,1371,439,0,0,0,439,A
5-NP,1372,0,441,0,0,441,T
5-NP,1373,0,438,0,0,438,T
5-NP,1374,2,0,0,439,441,C
5-NP,1375,1,0,0,429,430,C
5-NP,1376,0,0,430,0,430,G
5-NP,1377,0,0,435,0,435,G
5-NP,1378,0,1,434,0,435,G
5-NP,1379,0,0,436,0,436,G
5-NP,1380,427,0,1,0,428,A
5-NP,1381,433,0,0,0,433,A
5-NP,1382,0,3,429,0,432,G
5-NP,1383,0,2,432,0,434,G
5-NP,1384,0,1,434,0,435,G
5-NP,1385,0,0,432,0,432,G
5-NP,1386,428,1,0,0,429,A
5-NP,1387,0,0,429,0,429,G
5-NP,1388,0,423,0,0,423,T
5-NP,1389,2,0,0,415,417,C
5-NP,1390,0,421,0,0,421,T
5-NP,1391,0,420,0,0,420,T
5-NP,1392,0,0,0,423,423,C
5-NP,1393,3,1,418,0,422,G
5-NP,1394,420,0,1,0,421,A
5-NP,1395,0,0,421,0,421,G
5-NP,1396,0,0,0,407,407,C
5-NP,1397,0,402,0,0,402,T
5-NP,1398,0,0,0,397,397,C
5-NP,1399,0,399,0,0,399,T
5-NP,1400,1,1,0,398,400,C
5-NP,1401,398,1,0,0,399,A
5-NP,1402,1,0,398,0,399,G
5-NP,1403,399,1,1,0,401,A
5-NP,1404,0,0,0,396,396,C
5-NP,1405,1,0,393,0,394,G
5-NP,1406,389,0,0,0,389,A
5-NP,1407,0,0,391,0,391,G
5-NP,1408,386,0,0,0,386,A
5-NP,1409,383,0,1,0,384,A
5-NP,1410,0,1,384,0,385,G
5-NP,1411,0,0,382,0,382,G
5-NP,1412,0,0,0,380,380,C
5-NP,1413,379,0,0,0,379,A
5-NP,1414,378,0,0,0,378,A
5-NP,1415,0,0,0,378,378,C
5-NP,1416,0,0,378,0,378,G
5-NP,1417,376,2,0,0,378,A
5-NP,1418,380,0,0,0,380,A
5-NP,1419,0,0,1,379,380,C
5-NP,1420,0,0,0,379,379,C
5-NP,1421,3,0,0,373,376,C
5-NP,1422,2,0,374,0,376,G
5-NP,1423,376,0,0,0,376,A
5-NP,1424,0,376,0,0,376,T
5-NP,1425,0,0,0,368,368,C
5-NP,1426,0,0,367,0,367,G
5-NP,1427,0,363,0,2,365,T
5-NP,1428,0,0,365,0,365,G
5-NP,1429,0,0,0,364,364,C
5-NP,1430,0,0,0,362,362,C
5-NP,1431,0,0,0,361,361,C
5-NP,1432,0,358,0,0,358,T
5-NP,1433,0,0,0,372,372,C
5-NP,1434,0,372,0,0,372,T
5-NP,1435,0,369,0,0,369,T
5-NP,1436,0,368,0,0,368,T
5-NP,1437,0,365,0,0,365,T
5-NP,1438,0,0,367,0,367,G
5-NP,1439,363,0,0,0,363,A
5-NP,1440,0,356,0,0,356,T
5-NP,1441,352,0,0,0,352,A
5-NP,1442,0,298,0,0,298,T
5-NP,1443,0,1,303,0,304,G
5-NP,1444,303,0,0,0,303,A
5-NP,1445,1,0,304,0,305,G
5-NP,1446,0,304,0,0,304,T
5-NP,1447,295,0,0,0,295,A
5-NP,1448,295,0,0,0,295,A
5-NP,1449,0,296,0,0,296,T
5-NP,1450,0,0,296,0,296,G
5-NP,1451,296,0,0,0,296,A
5-NP,1452,266,0,0,0,266,A
5-NP,1453,0,1,263,0,264,G
5-NP,1454,0,0,247,0,247,G
5-NP,1455,245,0,0,0,245,A
5-NP,1456,0,244,0,0,244,T
5-NP,1457,0,0,0,243,243,C
5-NP,1458,0,239,0,1,240,T
5-NP,1459,0,239,0,1,240,T
5-NP,1460,239,0,0,0,239,A
5-NP,1461,0,239,0,0,239,T
5-NP,1462,1,236,0,0,237,T
5-NP,1463,0,235,0,0,235,T
5-NP,1464,0,0,0,225,225,C
5-NP,1465,0,222,0,0,222,T
5-NP,1466,0,220,0,0,220,T
5-NP,1467,0,0,0,219,219,C
5-NP,1468,0,1,218,0,219,G
5-NP,1469,0,0,220,0,220,G
5-NP,1470,219,0,0,0,219,A
5-NP,1471,0,0,219,0,219,G
5-NP,1472,214,0,0,0,214,A
5-NP,1473,0,0,0,211,211,C
5-NP,1474,198,0,0,0,198,A
5-NP,1475,198,0,0,0,198,A
5-NP,1476,0,198,0,0,198,T
5-NP,1477,0,0,198,0,198,G
5-NP,1478,0,0,0,196,196,C
5-NP,1479,193,0,0,0,193,A
5-NP,1480,0,0,192,0,192,G
5-NP,1481,192,0,0,0,192,A
5-NP,1482,180,0,0,0,180,A
5-NP,1483,0,0,181,0,181,G
5-NP,1484,137,0,0,0,137,A
5-NP,1485,0,0,137,0,137,G
5-NP,1486,0,120,0,0,120,T
5-NP,1487,117,0,0,0,117,A
5-NP,1488,0,112,0,0,112,T
5-NP,1489,0,0,112,0,112,G
5-NP,1490,112,0,0,0,112,A
5-NP,1491,0,0,0,112,112,C
5-NP,1492,74,0,0,0,74,A
5-NP,1493,74,0,0,0,74,A
5-NP,1494,0,49,0,0,49,T
5-NP,1495,0,47,0,0,47,T
5-NP,1496,47,0,0,0,47,A
5-NP,1497,47,0,0,0,47,A
6-NA,1,90,0,0,0,90,A
6-NA,2,0,90,0,0,90,T
6-NA,3,0,0,91,0,91,G
6-NA,4,91,0,0,0,91,A
6-NA,5,95,0,0,0,95,A
6-NA,6,0,95,0,0,95,T
6-NA,7,0,0,0,95,95,C
6-NA,8,0,0,0,95,95,C
6-NA,9,94,0,1,0,95,A
6-NA,10,98,0,0,0,98,A
6-NA,11,97,0,0,0,97,A
6-NA,12,0,102,0,0,102,T
6-NA,13,0,0,0,102,102,C
6-NA,14,102,0,0,0,102,A
6-NA,15,104,0,0,0,104,A
6-NA,16,104,0,0,0,104,A
6-NA,17,108,0,0,0,108,A
6-NA,18,0,0,126,0,126,G
6-NA,19,129,1,0,0,130,A
6-NA,20,0,130,0,0,130,T
6-NA,21,132,0,0,0,132,A
6-NA,22,134,0,0,0,134,A
6-NA,23,0,134,0,0,134,T
6-NA,24,134,0,0,0,134,A
6-NA,25,136,0,0,0,136,A
6-NA,26,0,0,0,142,142,C
6-NA,27,0,0,150,0,150,G
6-NA,28,150,0,0,0,150,A
6-NA,29,0,150,0,0,150,T
6-NA,30,0,150,0,0,150,T
6-NA,31,0,0,154,0,154,G
6-NA,32,0,1,163,0,164,G
6-NA,33,0,0,0,165,165,C
6-NA,34,0,164,0,0,164,T
6-NA,35,0,0,0,177,177,C
6-NA,36,0,177,0,0,177,T
6-NA,37,0,0,187,0,187,G
6-NA,38,0,189,0,0,189,T
6-NA,39,0,189,0,0,189,T
6-NA,40,0,196,0,1,197,T
6-NA,41,0,0,0,201,201,C
6-NA,42,0,202,0,0,202,T
6-NA,43,0,0,0,206,206,C
6-NA,44,0,205,0,0,205,T
6-NA,45,0,0,0,212,212,C
6-NA,46,212,0,0,0,212,A
6-NA,47,0,0,0,223,223,C
6-NA,48,1,0,0,222,223,C
6-NA,49,225,0,0,0,225,A
6-NA,50,0,227,0,0,227,T
6-NA,51,0,230,0,0,230,T
6-NA,52,0,232,0,1,233,T
6-NA,53,0,0,0,237,237,C
6-NA,54,0,0,0,238,238,C
6-NA,55,241,0,1,0,242,A
6-NA,56,0,0,0,254,254,C
6-NA,57,254,0,0,0,254,A
6-NA,58,267,0,0,0,267,A
6-NA,59,0,266,0,0,266,T
6-NA,60,281,0,0,0,281,A
6-NA,61,0,283,0,0,283,T
6-NA,62,0,0,284,0,284,G
6-NA,63,0,0,0,284,284,C
6-NA,64,0,284,0,0,284,T
6-NA,65,0,294,0,0,294,T
6-NA,66,1,0,0,295,296,C
6-NA,67,0,293,0,0,293,T
6-NA,68,0,294,0,0,294,T
6-NA,69,1,0,0,292,293,C
6-NA,70,292,0,0,0,292,A
6-NA,71,0,293,0,0,293,T
6-NA,72,0,1,291,0,292,G
6-NA,73,0,0,0,296,296,C
6-NA,74,294,0,0,0,294,A
6-NA,75,296,1,0,0,297,A
6-NA,76,299,0,0,0,299,A
6-NA,77,0,306,0,0,306,T
6-NA,78,0,306,0,0,306,T
6-NA,79,0,0,308,0,308,G
6-NA,80,0,0,0,309,309,C
6-NA,81,0,0,0,310,310,C
6-NA,82,309,0,0,0,309,A
6-NA,83,0,309,0,0,309,T
6-NA,84,1,0,0,335,336,C
6-NA,85,0,338,0,0,338,T
6-NA,86,0,337,0,0,337,T
6-NA,87,0,0,348,0,348,G
6-NA,88,347,0,0,0,347,A
6-NA,89,0,349,0,1,350,T
6-NA,90,348,0,0,0,348,A
6-NA,91,350,0,0,0,350,A
6-NA,92,0,0,0,385,385,C
6-NA,93,0,386,0,0,386,T
6-NA,94,399,0,0,0,399,A
6-NA,95,0,0,0,421,421,C
6-NA,96,1,418,0,0,419,T
6-NA,97,0,0,428,0,428,G
6-NA,98,0,428,0,3,431,T
6-NA,99,431,0,0,0,431,A
6-NA,100,432,0,0,0,432,A
6-NA,101,0,0,0,423,423,C
6-NA,102,419,0,0,0,419,A
6-NA,103,0,418,0,0,418,T
6-NA,104,0,412,0,0,412,T
6-NA,105,1,0,413,1,415,G
6-NA,106,0,1,0,416,417,C
6-NA,107,421,0,0,0,421,A
6-NA,108,0,422,0,1,423,T
6-NA,109,0,421,0,0,421,T
6-NA,110,0,421,0,0,421,T
6-NA,111,1,0,0,420,421,C
6-NA,112,422,0,0,0,422,A
6-NA,113,421,0,1,0,422,A
6-NA,114,420,0,0,0,420,A
6-NA,115,0,0,0,436,436,C
6-NA,116,439,0,0,0,439,A
6-NA,117,457,0,0,0,457,A
6-NA,118,0,464,0,0,464,T
6-NA,119,464,0,0,0,464,A
6-NA,120,0,462,0,0,462,T
6-NA,121,0,1,469,0,470,G
6-NA,122,471,0,0,0,471,A
6-NA,123,484,0,0,0,484,A
6-NA,124,0,477,0,1,478,T
6-NA,125,0,481,0,0,481,T
6-NA,126,2,0,0,481,483,C
6-NA,127,481,0,0,0,481,A
6-NA,128,481,0,1,0,482,A
6-NA,129,0,0,0,482,482,C
6-NA,130,0,481,0,1,482,T
6-NA,131,1,0,0,482,483,C
6-NA,132,1,0,0,484,485,C
6-NA,133,0,0,0,495,495,C
6-NA,134,2,0,0,495,497,C
6-NA,135,4,0,0,494,498,C
6-NA,136,3,0,0,499,502,C
6-NA,137,0,0,0,503,503,C
6-NA,138,503,0,0,0,503,A
6-NA,139,502,0,0,0,502,A
6-NA,140,502,0,0,0,502,A
6-NA,141,0,0,0,510,510,C
6-NA,142,500,0,0,0,500,A
6-NA,143,505,0,0,1,506,A
6-NA,144,0,0,0,508,508,C
6-NA,145,0,0,0,504,504,C
6-NA,146,516,0,0,0,516,A
6-NA,147,520,0,1,0,521,A
6-NA,148,0,0,531,0,531,G
6-NA,149,1,528,0,1,530,T
6-NA,150,0,2,527,0,529,G
6-NA,151,538,0,0,0,538,A
6-NA,152,0,534,0,0,534,T
6-NA,153,0,0,539,0,539,G
6-NA,154,0,0,0,538,538,C
6-NA,155,0,529,0,0,529,T
6-NA,156,0,1,562,0,563,G
6-NA,157,0,559,0,0,559,T
6-NA,158,0,0,563,0,563,G
6-NA,159,1,560,0,1,562,T
6-NA,160,0,3,552,0,555,G
6-NA,161,564,0,0,0,564,A
6-NA,162,564,0,2,0,566,A
6-NA,163,0,0,0,567,567,C
6-NA,164,1,0,0,562,563,C
6-NA,165,553,0,0,0,553,A
6-NA,166,552,1,0,0,553,A
6-NA,167,0,0,0,584,584,C
6-NA,168,584,0,0,0,584,A
6-NA,169,589,0,0,0,589,A
6-NA,170,0,588,0,0,588,T
6-NA,171,588,0,0,0,588,A
6-NA,172,590,0,0,0,590,A
6-NA,173,0,592,0,0,592,T
6-NA,174,588,1,0,0,589,A
6-NA,175,0,3,588,0,591,G
6-NA,176,575,0,0,0,575,A
6-NA,177,575,0,1,1,577,A
6-NA,178,574,0,0,0,574,A
6-NA,179,0,1,573,0,574,G
6-NA,180,589,0,0,0,589,A
6-NA,181,590,0,0,0,590,A
6-NA,182,617,0,0,0,617,A
6-NA,183,0,0,0,618,618,C
6-NA,184,616,0,0,0,616,A
6-NA,185,0,633,0,1,634,T
6-NA,186,638,0,1,0,639,A
6-NA,187,644,0,0,0,644,A
6-NA,188,0,0,0,649,649,C
6-NA,189,637,0,0,0,637,A
6-NA,190,0,0,666,0,666,G
6-NA,191,664,0,0,0,664,A
6-NA,192,0,0,662,0,662,G
6-NA,193,667,0,0,0,667,A
6-NA,194,0,694,0,0,694,T
6-NA,195,696,1,1,0,698,A
6-NA,196,0,0,711,0,711,G
6-NA,197,0,701,0,1,702,T
6-NA,198,0,1,711,0,712,G
6-NA,199,0,696,0,10,706,T
6-NA,200,708,0,1,0,709,A
6-NA,201,0,705,0,0,705,T
6-NA,202,1,0,0,702,703,C
6-NA,203,0,683,0,10,693,T
6-NA,204,0,1,724,0,725,G
6-NA,205,725,0,0,0,725,A
6-NA,206,1,0,0,726,727,C
6-NA,207,2,0,0,731,733,C
6-NA,208,722,0,1,0,723,A
6-NA,209,732,0,1,1,734,A
6-NA,210,0,0,0,746,746,C
6-NA,211,745,0,0,0,745,A
6-NA,212,0,0,0,767,767,C
6-NA,213,0,0,0,757,757,C
6-NA,214,781,0,0,0,781,A
6-NA,215,0,0,0,805,805,C
6-NA,216,0,0,0,808,808,C
6-NA,217,810,0,0,0,810,A
6-NA,218,0,809,0,0,809,T
6-NA,219,801,0,0,0,801,A
6-NA,220,0,0,809,0,809,G
6-NA,221,799,0,0,0,799,A
6-NA,222,0,1,815,0,816,G
6-NA,223,807,0,0,0,807,A
6-NA,224,795,0,0,0,795,A
6-NA,225,0,3,804,0,807,G
6-NA,226,0,1,812,0,813,G
6-NA,227,812,0,0,0,812,A
6-NA,228,819,0,0,0,819,A
6-NA,229,819,0,0,0,819,A
6-NA,230,0,817,0,0,817,T
6-NA,231,810,0,0,0,810,A
6-NA,232,0,803,0,0,803,T
6-NA,233,10,0,804,0,814,G
6-NA,234,0,2,0,818,820,C
6-NA,235,2,1,0,813,816,C
6-NA,236,0,0,0,816,816,C
6-NA,237,3,0,0,812,815,C
6-NA,238,819,0,0,0,819,A
6-NA,239,836,0,1,0,837,A
6-NA,240,834,0,0,0,834,A
6-NA,241,0,0,0,839,839,C
6-NA,242,0,839,0,1,840,T
6-NA,243,831,0,0,0,831,A
6-NA,244,0,0,832,0,832,G
6-NA,245,0,0,0,833,833,C
6-NA,246,832,0,1,0,833,A
6-NA,247,0,2,847,0,849,G
6-NA,248,838,0,0,0,838,A
6-NA,249,866,0,0,0,866,A
6-NA,250,0,863,0,0,863,T
6-NA,251,863,0,3,0,866,A
6-NA,252,0,0,0,867,867,C
6-NA,253,857,0,4,0,861,A
6-NA,254,0,0,863,0,863,G
6-NA,255,861,0,0,0,861,A
6-NA,256,852,0,1,0,853,A
6-NA,257,854,0,0,0,854,A
6-NA,258,0,842,0,0,842,T
6-NA,259,0,837,0,1,838,T
6-NA,260,0,1,843,0,844,G
6-NA,261,0,0,843,0,843,G
6-NA,262,0,842,0,2,844,T
6-NA,263,0,0,0,845,845,C
6-NA,264,843,0,1,0,844,A
6-NA,265,849,0,0,0,849,A
6-NA,266,842,0,1,0,843,A
6-NA,267,0,0,847,0,847,G
6-NA,268,0,0,0,846,846,C
6-NA,269,1,0,0,841,842,C
6-NA,270,1,1,846,0,848,G
6-NA,271,0,0,0,853,853,C
6-NA,272,854,0,1,0,855,A
6-NA,273,869,0,1,0,870,A
6-NA,274,0,866,0,1,867,T
6-NA,275,0,1,871,0,872,G
6-NA,276,0,866,0,0,866,T
6-NA,277,0,3,860,0,863,G
6-NA,278,880,0,0,0,880,A
6-NA,279,0,1,0,895,896,C
6-NA,280,920,0,0,0,920,A
6-NA,281,0,925,0,0,925,T
6-NA,282,0,924,0,0,924,T
6-NA,283,926,0,1,0,927,A
6-NA,284,2,1,0,922,925,C
6-NA,285,913,0,1,0,914,A
6-NA,286,0,2,908,0,910,G
6-NA,287,0,1,904,0,905,G
6-NA,288,1,0,853,1,855,G
6-NA,289,0,885,0,0,885,T
6-NA,290,0,879,0,0,879,T
6-NA,291,0,884,0,0,884,T
6-NA,292,0,0,885,0,885,G
6-NA,293,0,1,0,881,882,C
6-NA,294,884,0,1,0,885,A
6-NA,295,0,0,0,889,889,C
6-NA,296,2,0,0,879,881,C
6-NA,297,0,878,0,0,878,T
6-NA,298,0,876,0,0,876,T
6-NA,299,0,885,0,0,885,T
6-NA,300,0,870,0,15,885,T
6-NA,301,0,902,0,0,902,T
6-NA,302,0,1,0,899,900,C
6-NA,303,0,899,0,0,899,T
6-NA,304,897,0,0,0,897,A
6-NA,305,894,0,0,0,894,A
6-NA,306,0,0,905,0,905,G
6-NA,307,0,0,905,0,905,G
6-NA,308,900,0,1,0,901,A
6-NA,309,0,0,0,911,911,C
6-NA,310,897,0,0,0,897,A
6-NA,311,904,0,0,0,904,A
6-NA,312,0,901,0,0,901,T
6-NA,313,0,905,0,1,906,T
6-NA,314,2,1,0,924,927,C
6-NA,315,0,2,918,0,920,G
6-NA,316,918,0,1,0,919,A
6-NA,317,0,920,0,0,920,T
6-NA,318,0,916,0,0,916,T
6-NA,319,915,0,0,0,915,A
6-NA,320,0,0,920,0,920,G
6-NA,321,0,0,927,0,927,G
6-NA,322,2,0,0,928,930,C
6-NA,323,0,918,0,1,919,T
6-NA,324,0,922,0,0,922,T
6-NA,325,0,922,0,1,923,T
6-NA,326,1,0,0,929,930,C
6-NA,327,1,0,0,929,930,C
6-NA,328,0,0,930,0,930,G
6-NA,329,0,0,0,933,933,C
6-NA,330,0,926,0,0,926,T
6-NA,331,0,2,944,0,946,G
6-NA,332,0,0,943,0,943,G
6-NA,333,0,946,0,0,946,T
6-NA,334,1,2,945,0,948,G
6-NA,335,0,3,946,0,949,G
6-NA,336,0,1,950,0,951,G
6-NA,337,1,1,954,1,957,G
6-NA,338,946,0,3,0,949,A
6-NA,339,0,0,0,963,963,C
6-NA,340,947,0,0,0,947,A
6-NA,341,0,942,0,0,942,T
6-NA,342,1,0,0,942,943,C
6-NA,343,1,939,0,0,940,T
6-NA,344,1,5,939,0,945,G
6-NA,345,1,0,947,0,948,G
6-NA,346,0,0,943,0,943,G
6-NA,347,0,947,0,1,948,T
6-NA,348,0,3,929,0,932,G
6-NA,349,927,1,0,0,928,A
6-NA,350,1,0,0,947,948,C
6-NA,351,943,0,1,0,944,A
6-NA,352,954,0,1,0,955,A
6-NA,353,1,3,958,0,962,G
6-NA,354,945,1,1,0,947,A
6-NA,355,1,1,953,0,955,G
6-NA,356,960,1,0,0,961,A
6-NA,357,985,1,1,0,987,A
6-NA,358,0,0,0,1058,1058,C
6-NA,359,1,0,0,1063,1064,C
6-NA,360,0,1052,0,0,1052,T
6-NA,361,0,1053,0,1,1054,T
6-NA,362,1056,0,0,0,1056,A
6-NA,363,0,1060,0,0,1060,T
6-NA,364,0,0,1098,0,1098,G
6-NA,365,0,1082,0,5,1087,T
6-NA,366,0,0,1106,0,1106,G
6-NA,367,0,1080,0,0,1080,T
6-NA,368,0,0,0,1068,1068,C
6-NA,369,1073,0,1,2,1076,A
6-NA,370,1,1074,0,0,1075,T
6-NA,371,0,1,1072,0,1073,G
6-NA,372,0,0,0,1073,1073,C
6-NA,373,0,0,1068,0,1068,G
6-NA,374,1121,1,0,0,1122,A
6-NA,375,0,1122,0,1,1123,T
6-NA,376,1,0,0,1129,1130,C
6-NA,377,2,0,0,1139,1141,C
6-NA,378,0,1147,0,1,1148,T
6-NA,379,0,1,1160,0,1161,G
6-NA,380,1156,0,2,0,1158,A
6-NA,381,0,1,0,1160,1161,C
6-NA,382,1156,0,0,0,1156,A
6-NA,383,1120,0,0,0,1120,A
6-NA,384,0,1,1159,0,1160,G
6-NA,385,0,1155,0,0,1155,T
6-NA,386,0,0,1168,0,1168,G
6-NA,387,0,1159,0,0,1159,T
6-NA,388,0,1157,0,0,1157,T
6-NA,389,1161,0,0,0,1161,A
6-NA,390,0,1157,0,2,1159,T
6-NA,391,2,0,0,1166,1168,C
6-NA,392,1166,0,1,0,1167,A
6-NA,393,1154,0,0,0,1154,A
6-NA,394,0,1148,0,0,1148,T
6-NA,395,0,1140,0,0,1140,T
6-NA,396,0,1139,0,0,1139,T
6-NA,397,0,1,1141,0,1142,G
6-NA,398,2,0,0,1182,1184,C
6-NA,399,1,0,0,1182,1183,C
6-NA,400,5,0,0,1185,1190,C
6-NA,401,0,1179,0,1,1180,T
6-NA,402,0,1185,0,0,1185,T
6-NA,403,0,2,1197,0,1199,G
6-NA,404,0,0,1199,0,1199,G
6-NA,405,1202,1,5,1,1209,A
6-NA,406,0,0,0,1210,1210,C
6-NA,407,1161,0,0,0,1161,A
6-NA,408,0,4,1184,0,1188,G
6-NA,409,1,1,1187,0,1189,G
6-NA,410,0,2,1221,0,1223,G
6-NA,411,1217,0,2,0,1219,A
6-NA,412,1206,0,2,0,1208,A
6-NA,413,0,1,0,1211,1212,C
6-NA,414,1213,0,1,0,1214,A
6-NA,415,1288,1,1,0,1290,A
6-NA,416,0,0,0,1296,1296,C
6-NA,417,1284,0,0,1,1285,A
6-NA,418,0,0,1,1298,1299,C
6-NA,419,0,1275,0,0,1275,T
6-NA,420,1288,0,0,0,1288,A
6-NA,421,1284,0,0,0,1284,A
6-NA,422,1289,0,1,0,1290,A
6-NA,423,0,0,0,1288,1288,C
6-NA,424,1206,0,0,0,1206,A
6-NA,425,1220,0,1,0,1221,A
6-NA,426,0,0,0,1227,1227,C
6-NA,427,1,0,1222,0,1223,G
6-NA,428,0,1222,0,0,1222,T
6-NA,429,1198,0,1,0,1199,A
6-NA,430,0,0,0,1218,1218,C
6-NA,431,1218,1,0,0,1219,A
6-NA,432,0,1223,0,1,1224,T
6-NA,433,0,1221,0,2,1223,T
6-NA,434,4,0,0,1273,1277,C
6-NA,435,1300,0,0,0,1300,A
6-NA,436,1306,0,0,0,1306,A
6-NA,437,1305,0,0,0,1305,A
6-NA,438,0,1306,0,0,1306,T
6-NA,439,1295,0,0,0,1295,A
6-NA,440,1329,1,0,0,1330,A
6-NA,441,1,0,0,1332,1333,C
6-NA,442,1332,0,1,0,1333,A
6-NA,443,0,0,0,1348,1348,C
6-NA,444,1307,0,0,0,1307,A
6-NA,445,0,0,1533,0,1533,G
6-NA,446,0,1528,0,1,1529,T
6-NA,447,1558,1,0,0,1559,A
6-NA,448,1,0,0,1562,1563,C
6-NA,449,0,0,1557,0,1557,G
6-NA,450,0,1617,0,0,1617,T
6-NA,451,4,1,1617,0,1622,G
6-NA,452,1622,0,0,0,1622,A
6-NA,453,0,1625,1,1,1627,T
6-NA,454,1511,0,1,0,1512,A
6-NA,455,0,3,1507,0,1510,G
6-NA,456,1,4,1494,0,1499,G
6-NA,457,1506,1,1,0,1508,A
6-NA,458,0,1,0,1523,1524,C
6-NA,459,2,2,0,1491,1495,C
6-NA,460,4,0,0,1512,1516,C
6-NA,461,5,0,0,1506,1511,C
6-NA,462,0,1519,0,1,1520,T
6-NA,463,1,1545,0,3,1549,T
6-NA,464,1552,0,0,0,1552,A
6-NA,465,0,1552,0,0,1552,T
6-NA,466,2,0,0,1552,1554,C
6-NA,467,0,1,1536,0,1537,G
6-NA,468,0,4,1529,0,1533,G
6-NA,469,1528,0,0,0,1528,A
6-NA,470,0,0,0,1542,1542,C
6-NA,471,3,1,0,1530,1534,C
6-NA,472,7,0,0,1602,1609,C
6-NA,473,1,1601,0,0,1602,T
6-NA,474,1625,1,0,0,1626,A
6-NA,475,0,1627,0,0,1627,T
6-NA,476,0,1626,1,0,1627,T
6-NA,477,0,1,1628,0,1629,G
6-NA,478,1626,0,0,0,1626,A
6-NA,479,0,1616,0,0,1616,T
6-NA,480,1,3,1618,0,1622,G
6-NA,481,1559,0,2,0,1561,A
6-NA,482,1562,0,0,0,1562,A
6-NA,483,0,1553,0,0,1553,T
6-NA,484,1,3,1577,0,1581,G
6-NA,485,1596,0,2,0,1598,A
6-NA,486,0,0,1608,0,1608,G
6-NA,487,0,1594,0,1,1595,T
6-NA,488,0,1602,0,2,1604,T
6-NA,489,1608,0,0,0,1608,A
6-NA,490,1,2,1605,0,1608,G
6-NA,491,0,0,1606,0,1606,G
6-NA,492,0,1597,0,0,1597,T
6-NA,493,1,1,1595,0,1597,G
6-NA,494,0,1585,0,1,1586,T
6-NA,495,1,1580,0,0,1581,T
6-NA,496,0,0,0,1599,1599,C
6-NA,497,7,1,0,1597,1605,C
6-NA,498,0,1601,0,1,1602,T
6-NA,499,0,1603,0,0,1603,T
6-NA,500,0,1601,0,0,1601,T
6-NA,501,1,1599,0,1,1601,T
6-NA,502,1,0,0,1601,1602,C
6-NA,503,1596,0,0,0,1596,A
6-NA,504,0,1617,0,1,1618,T
6-NA,505,0,0,0,1621,1621,C
6-NA,506,0,1605,0,1,1606,T
6-NA,507,1,5,1598,0,1604,G
6-NA,508,1,4,1594,0,1599,G
6-NA,509,0,5,1594,0,1599,G
6-NA,510,0,0,1616,0,1616,G
6-NA,511,1611,0,0,0,1611,A
6-NA,512,0,0,0,1639,1639,C
6-NA,513,3,1,0,1617,1621,C
6-NA,514,1632,0,3,0,1635,A
6-NA,515,1634,0,4,0,1638,A
6-NA,516,0,2,1635,0,1637,G
6-NA,517,0,1,0,1637,1638,C
6-NA,518,1631,0,1,0,1632,A
6-NA,519,1649,0,1,0,1650,A
6-NA,520,0,1,1665,0,1666,G
6-NA,521,0,1657,0,1,1658,T
6-NA,522,1,0,1697,0,1698,G
6-NA,523,1,1695,0,0,1696,T
6-NA,524,1,0,1748,1,1750,G
6-NA,525,1,2,0,1748,1751,C
6-NA,526,1742,1,1,0,1744,A
6-NA,527,0,1761,0,1,1762,T
6-NA,528,1731,0,0,0,1731,A
6-NA,529,0,0,1776,0,1776,G
6-NA,530,0,0,0,1777,1777,C
6-NA,531,1730,0,0,0,1730,A
6-NA,532,1,1734,0,0,1735,T
6-NA,533,1,3,1688,1,1693,G
6-NA,534,1,1,1904,0,1906,G
6-NA,535,0,1903,0,7,1910,T
6-NA,536,4,0,0,1899,1903,C
6-NA,537,2,0,0,1939,1941,C
6-NA,538,1977,0,2,0,1979,A
6-NA,539,0,0,2152,0,2152,G
6-NA,540,0,1,0,2175,2176,C
6-NA,541,0,2164,1,4,2169,T
6-NA,542,2,0,0,2185,2187,C
6-NA,543,2116,0,0,0,2116,A
6-NA,544,2177,0,0,0,2177,A
6-NA,545,1,0,2192,0,2193,G
6-NA,546,1,2193,0,0,2194,T
6-NA,547,0,2194,0,1,2195,T
6-NA,548,0,1,2197,0,2198,G
6-NA,549,0,2199,0,0,2199,T
6-NA,550,5,0,0,2194,2199,C
6-NA,551,2200,0,2,0,2202,A
6-NA,552,0,1,0,2237,2238,C
6-NA,553,1,5,2223,0,2229,G
6-NA,554,2311,0,1,0,2312,A
6-NA,555,0,2319,0,2,2321,T
6-NA,556,1,2,2410,0,2413,G
6-NA,557,0,2,2450,0,2452,G
6-NA,558,2446,0,1,1,2448,A
6-NA,559,2462,0,0,0,2462,A
6-NA,560,2503,0,1,0,2504,A
6-NA,561,2512,0,4,0,2516,A
6-NA,562,0,2,2581,0,2583,G
6-NA,563,0,0,0,2577,2577,C
6-NA,564,2561,1,3,0,2565,A
6-NA,565,0,2575,0,1,2576,T
6-NA,566,0,4,2621,1,2626,G
6-NA,567,1,2,2660,0,2663,G
6-NA,568,0,0,0,2708,2708,C
6-NA,569,0,2705,0,0,2705,T
6-NA,570,0,1,2730,0,2731,G
6-NA,571,0,0,0,2720,2720,C
6-NA,572,2731,3,2,0,2736,A
6-NA,573,0,2906,0,1,2907,T
6-NA,574,0,0,2925,0,2925,G
6-NA,575,1,2948,0,0,2949,T
6-NA,576,0,3062,0,1,3063,T
6-NA,577,0,3052,0,1,3053,T
6-NA,578,2,1,3393,0,3396,G
6-NA,579,0,3396,0,0,3396,T
6-NA,580,3414,0,0,0,3414,A
6-NA,581,1,3430,0,0,3431,T
6-NA,582,3395,0,2,0,3397,A
6-NA,583,3427,0,1,1,3429,A
6-NA,584,1,4,0,3412,3417,C
6-NA,585,2,16,3363,1,3382,G
6-NA,586,1,13,3400,0,3414,G
6-NA,587,0,11,3360,1,3372,G
6-NA,588,0,11,3402,0,3413,G
6-NA,589,1,7,3407,0,3415,G
6-NA,590,3418,2,1,0,3421,A
6-NA,591,3,3437,1,0,3441,T
6-NA,592,0,3,3466,0,3469,G
6-NA,593,3496,3,5,0,3504,A
6-NA,594,0,3528,0,2,3530,T
6-NA,595,3523,1,1,0,3525,A
6-NA,596,3602,0,0,2,3604,A
6-NA,597,3623,2,1,0,3626,A
6-NA,598,3635,0,2,0,3637,A
6-NA,599,3654,1,0,0,3655,A
6-NA,600,0,3650,0,2,3652,T
6-NA,601,1,1,3660,0,3662,G
6-NA,602,2,1,0,3649,3652,C
6-NA,603,3647,1,2,0,3650,A
6-NA,604,3673,1,1,0,3675,A
6-NA,605,0,0,0,3727,3727,C
6-NA,606,0,3732,0,1,3733,T
6-NA,607,13,1,3738,0,3752,G
6-NA,608,0,0,0,3748,3748,C
6-NA,609,0,3751,0,2,3753,T
6-NA,610,3757,0,5,0,3762,A
6-NA,611,0,2,3780,0,3782,G
6-NA,612,0,2,0,3842,3844,C
6-NA,613,3,3837,0,4,3844,T
6-NA,614,2,3834,1,1,3838,T
6-NA,615,4,2,1,3923,3930,C
6-NA,616,3957,1,1,0,3959,A
6-NA,617,0,3968,0,0,3968,T
6-NA,618,1,3977,0,1,3979,T
6-NA,619,0,4005,0,1,4006,T
6-NA,620,4035,1,0,0,4036,A
6-NA,621,1,0,0,4097,4098,C
6-NA,622,4087,0,1,0,4088,A
6-NA,623,4140,2,4,0,4146,A
6-NA,624,0,4136,0,1,4137,T
6-NA,625,1,18,4112,0,4131,G
6-NA,626,2,5,4120,0,4127,G
6-NA,627,0,1,4131,0,4132,G
6-NA,628,4108,1,6,0,4115,A
6-NA,629,0,4,4225,0,4229,G
6-NA,630,1,2,4290,0,4293,G
6-NA,631,1,1,0,4692,4694,C
6-NA,632,1,4685,0,3,4689,T
6-NA,633,0,4753,0,4,4757,T
6-NA,634,1,1,4817,0,4819,G
6-NA,635,1,4833,0,1,4835,T
6-NA,636,4932,3,4,1,4940,A
6-NA,637,0,4,4975,0,4979,G
6-NA,638,4921,2,0,0,4923,A
6-NA,639,1,4931,0,0,4932,T
6-NA,640,4674,1,0,0,4675,A
6-NA,641,0,3,4679,0,4682,G
6-NA,642,4,4649,0,1,4654,T
6-NA,643,0,0,4593,0,4593,G
6-NA,644,0,4851,0,0,4851,T
6-NA,645,0,4849,0,1,4850,T
6-NA,646,1,1,4984,0,4986,G
6-NA,647,1,4973,1,2,4977,T
6-NA,648,0,4991,0,2,4993,T
6-NA,649,1,5005,0,2,5008,T
6-NA,650,6,1,0,4955,4962,C
6-NA,651,4961,2,2,1,4966,A
6-NA,652,0,4950,0,4,4954,T
6-NA,653,1,8,4958,0,4967,G
6-NA,654,2,0,5330,0,5332,G
6-NA,655,0,5302,0,3,5305,T
6-NA,656,6,1,0,5293,5300,C
6-NA,657,14,2,1,5283,5300,C
6-NA,658,5331,1,1,1,5334,A
6-NA,659,5367,0,0,2,5369,A
6-NA,660,5364,0,0,0,5364,A
6-NA,661,1,9,5390,0,5400,G
6-NA,662,5377,0,1,0,5378,A
6-NA,663,5248,1,3,0,5252,A
6-NA,664,5263,0,1,0,5264,A
6-NA,665,0,5258,2,0,5260,T
6-NA,666,4,2,1,5432,5439,C
6-NA,667,8,0,0,5442,5450,C
6-NA,668,0,5429,0,3,5432,T
6-NA,669,7,0,0,5437,5444,C
6-NA,670,5418,2,4,1,5425,A
6-NA,671,1,8,5470,0,5479,G
6-NA,672,0,11,5460,0,5471,G
6-NA,673,5590,1,15,0,5606,A
6-NA,674,1,1,1,5606,5609,C
6-NA,675,4,3,1,5545,5553,C
6-NA,676,11,1,0,5546,5558,C
6-NA,677,5549,2,3,0,5554,A
6-NA,678,3,4,5579,0,5586,G
6-NA,679,1,13,5575,1,5590,G
6-NA,680,5562,2,2,0,5566,A
6-NA,681,3,1,5644,0,5648,G
6-NA,682,0,5585,0,7,5592,T
6-NA,683,9,0,0,5597,5606,C
6-NA,684,5583,2,17,0,5602,A
6-NA,685,1,15,5621,0,5637,G
6-NA,686,5619,1,4,0,5624,A
6-NA,687,5638,1,4,1,5644,A
6-NA,688,0,5619,0,1,5620,T
6-NA,689,0,4,5660,0,5664,G
6-NA,690,1,0,0,5655,5656,C
6-NA,691,3,1,5679,0,5683,G
6-NA,692,0,5664,0,2,5666,T
6-NA,693,1,5664,0,2,5667,T
6-NA,694,1,5628,0,2,5631,T
6-NA,695,2,1,5705,0,5708,G
6-NA,696,2,5724,0,2,5728,T
6-NA,697,5729,0,1,1,5731,A
6-NA,698,0,5710,0,1,5711,T
6-NA,699,9,3,0,5730,5742,C
6-NA,700,5717,1,1,0,5719,A
6-NA,701,5728,0,1,1,5730,A
6-NA,702,1,5733,0,1,5735,T
6-NA,703,1,12,5729,1,5743,G
6-NA,704,1,9,5754,0,5764,G
6-NA,705,5855,2,5,0,5862,A
6-NA,706,5854,3,6,1,5864,A
6-NA,707,1,1,0,5936,5938,C
6-NA,708,0,5976,0,1,5977,T
6-NA,709,1,5962,1,0,5964,T
6-NA,710,0,1,6171,0,6172,G
6-NA,711,1,6174,0,2,6177,T
6-NA,712,6166,3,6,0,6175,A
6-NA,713,2,0,0,6224,6226,C
6-NA,714,6066,1,7,0,6074,A
6-NA,715,0,2,6560,0,6562,G
6-NA,716,0,6520,1,1,6522,T
6-NA,717,6924,0,1,0,6925,A
6-NA,718,1,1,7011,0,7013,G
6-NA,719,0,6951,0,3,6954,T
6-NA,720,6969,0,2,0,6971,A
6-NA,721,6958,1,1,0,6960,A
6-NA,722,1,6913,0,3,6917,T
6-NA,723,6331,0,3,0,6334,A
6-NA,724,6630,0,2,0,6632,A
6-NA,725,1,0,1,6749,6751,C
6-NA,726,1,6758,0,3,6762,T
6-NA,727,1,7,6784,1,6793,G
6-NA,728,6743,3,3,0,6749,A
6-NA,729,2,6769,0,3,6774,T
6-NA,730,4,20,6756,1,6781,G
6-NA,731,1,11,6725,1,6738,G
6-NA,732,0,14,6752,1,6767,G
6-NA,733,6681,3,11,0,6695,A
6-NA,734,1,2,6701,0,6704,G
6-NA,735,1,6647,1,1,6650,T
6-NA,736,2,1,6693,0,6696,G
6-NA,737,2,1,0,6748,6751,C
6-NA,738,1,6740,0,2,6743,T
6-NA,739,3,6736,0,4,6743,T
6-NA,740,4,0,0,6742,6746,C
6-NA,741,6733,2,7,1,6743,A
6-NA,742,0,4,6779,0,6783,G
6-NA,743,0,5,6782,0,6787,G
6-NA,744,6775,0,3,1,6779,A
6-NA,745,6717,0,1,0,6718,A
6-NA,746,6671,0,2,0,6673,A
6-NA,747,6695,0,3,4,6702,A
6-NA,748,0,3,6743,0,6746,G
6-NA,749,2,1,0,6739,6742,C
6-NA,750,0,6725,0,0,6725,T
6-NA,751,1,7,6712,0,6720,G
6-NA,752,6688,2,31,0,6721,A
6-NA,753,1,6793,0,0,6794,T
6-NA,754,6833,3,3,1,6840,A
6-NA,755,0,2,0,7203,7205,C
6-NA,756,1,7154,0,7,7162,T
6-NA,757,7157,0,1,1,7159,A
6-NA,758,7169,1,1,0,7171,A
6-NA,759,7177,1,1,1,7180,A
6-NA,760,7419,0,1,0,7420,A
6-NA,761,0,7414,0,1,7415,T
6-NA,762,7417,2,0,1,7420,A
6-NA,763,1,1,0,7451,7453,C
6-NA,764,2,7187,0,0,7189,T
6-NA,765,7308,1,0,2,7311,A
6-NA,766,3,7256,1,11,7271,T
6-NA,767,0,7608,0,5,7613,T
6-NA,768,8,2,1,7659,7670,C
6-NA,769,7526,1,1,0,7528,A
6-NA,770,0,7520,0,2,7522,T
6-NA,771,0,7495,0,2,7497,T
6-NA,772,0,5,7524,0,7529,G
6-NA,773,7482,0,10,0,7492,A
6-NA,774,0,17,7441,0,7458,G
6-NA,775,0,15,7441,0,7456,G
6-NA,776,7189,1,8,1,7199,A
6-NA,777,0,14,7318,1,7333,G
6-NA,778,4,23,7302,0,7329,G
6-NA,779,0,7,7334,0,7341,G
6-NA,780,2,5,7346,2,7355,G
6-NA,781,7311,0,6,0,7317,A
6-NA,782,7329,0,5,0,7334,A
6-NA,783,7299,0,6,1,7306,A
6-NA,784,7304,1,3,0,7308,A
6-NA,785,0,7304,0,1,7305,T
6-NA,786,14,4,0,7249,7267,C
6-NA,787,3,0,7338,0,7341,G
6-NA,788,1,7337,0,3,7341,T
6-NA,789,4,7329,0,0,7333,T
6-NA,790,16,2,1,7335,7354,C
6-NA,791,7335,1,1,0,7337,A
6-NA,792,2,7905,1,3,7911,T
6-NA,793,7901,2,1,0,7904,A
6-NA,794,3,1,2,7947,7953,C
6-NA,795,1,7919,0,3,7923,T
6-NA,796,7919,0,5,0,7924,A
6-NA,797,2,1,7930,0,7933,G
6-NA,798,3,2,1,7919,7925,C
6-NA,799,7939,1,5,1,7946,A
6-NA,800,0,3,0,7963,7966,C
6-NA,801,7653,0,1,1,7655,A
6-NA,802,0,7774,0,1,7775,T
6-NA,803,2,7717,0,2,7721,T
6-NA,804,0,5,8232,0,8237,G
6-NA,805,4,8199,0,9,8212,T
6-NA,806,15,5,1,8182,8203,C
6-NA,807,8200,0,4,0,8204,A
6-NA,808,3,8,8212,0,8223,G
6-NA,809,0,4,8206,0,8210,G
6-NA,810,8202,0,0,0,8202,A
6-NA,811,8059,0,3,0,8062,A
6-NA,812,3,3,8136,0,8142,G
6-NA,813,1,7759,0,4,7764,T
6-NA,814,0,4,7810,0,7814,G
6-NA,815,2,3,1,7805,7811,C
6-NA,816,0,7798,0,4,7802,T
6-NA,817,14,0,0,7829,7843,C
6-NA,818,7820,0,2,0,7822,A
6-NA,819,1,2,7886,0,7889,G
6-NA,820,3,0,2,7891,7896,C
6-NA,821,7873,0,3,0,7876,A
6-NA,822,1,7877,0,2,7880,T
6-NA,823,4,2,8112,1,8119,G
6-NA,824,0,8124,0,10,8134,T
6-NA,825,13,3,0,8111,8127,C
6-NA,826,4,11,8111,2,8128,G
6-NA,827,8094,5,4,1,8104,A
6-NA,828,2,16,8045,1,8064,G
6-NA,829,1,15,8054,0,8070,G
6-NA,830,7995,0,5,0,8000,A
6-NA,831,0,0,8104,0,8104,G
6-NA,832,1,7888,0,4,7893,T
6-NA,833,3,3,7909,0,7915,G
6-NA,834,1,0,0,8047,8048,C
6-NA,835,2,8024,0,6,8032,T
6-NA,836,19,0,0,8069,8088,C
6-NA,837,11,1,0,8101,8113,C
6-NA,838,1,8111,0,4,8116,T
6-NA,839,2,3,8134,1,8140,G
6-NA,840,1,0,0,8077,8078,C
6-NA,841,0,8017,0,4,8021,T
6-NA,842,8083,1,3,0,8087,A
6-NA,843,0,7971,2,3,7976,T
6-NA,844,5,0,0,8050,8055,C
6-NA,845,20,6,1,7999,8026,C
6-NA,846,1,8022,1,8,8032,T
6-NA,847,4,3,1,8075,8083,C
6-NA,848,7,10,8064,0,8081,G
6-NA,849,8167,0,7,0,8174,A
6-NA,850,1,8173,0,4,8178,T
6-NA,851,8189,0,2,0,8191,A
6-NA,852,1,8183,0,1,8185,T
6-NA,853,8,0,1,8141,8150,C
6-NA,854,11,0,0,8127,8138,C
6-NA,855,0,8097,0,0,8097,T
6-NA,856,1,12,8128,2,8143,G
6-NA,857,1,3,8177,0,8181,G
6-NA,858,1,8268,1,8,8278,T
6-NA,859,2,2,8284,0,8288,G
6-NA,860,0,8238,1,13,8252,T
6-NA,861,19,3,0,8230,8252,C
6-NA,862,8236,2,5,1,8244,A
6-NA,863,2,9,8250,0,8261,G
6-NA,864,8261,1,1,0,8263,A
6-NA,865,0,8174,0,2,8176,T
6-NA,866,1,3,8167,0,8171,G
6-NA,867,1,7962,0,4,7967,T
6-NA,868,2,2,7993,0,7997,G
6-NA,869,2,7975,0,4,7981,T
6-NA,870,13,0,0,8024,8037,C
6-NA,871,3,8056,1,8,8068,T
6-NA,872,1,2,8098,0,8101,G
6-NA,873,1,1,0,8090,8092,C
6-NA,874,8083,0,5,2,8090,A
6-NA,875,7538,1,470,1,8010,A
6-NA,876,8007,0,12,0,8019,A
6-NA,877,3,7,8065,0,8075,G
6-NA,878,8067,3,3,0,8073,A
6-NA,879,0,2,0,8094,8096,C
6-NA,880,7961,0,4,0,7965,A
6-NA,881,8010,1,5,0,8016,A
6-NA,882,2,2,1,8034,8039,C
6-NA,883,3,8030,0,2,8035,T
6-NA,884,6,10,8049,1,8066,G
6-NA,885,1,3,8062,1,8067,G
6-NA,886,8019,1,3,0,8023,A
6-NA,887,8010,1,2,1,8014,A
6-NA,888,7916,1,5,0,7922,A
6-NA,889,5,13,7898,0,7916,G
6-NA,890,1,10,7834,0,7845,G
6-NA,891,7749,1,1,0,7751,A
6-NA,892,3,7980,1,2,7986,T
6-NA,893,8,2,0,8022,8032,C
6-NA,894,9,1,0,8211,8221,C
6-NA,895,8228,3,2,1,8234,A
6-NA,896,8227,2,4,0,8233,A
6-NA,897,0,8239,1,2,8242,T
6-NA,898,8037,3,3,0,8043,A
6-NA,899,2,10,7984,1,7997,G
6-NA,900,2,1,8014,0,8017,G
6-NA,901,1,4,0,8022,8027,C
6-NA,902,10,2,0,7956,7968,C
6-NA,903,24,2,0,7766,7792,C
6-NA,904,7878,1,2,0,7881,A
6-NA,905,4,7938,0,4,7946,T
6-NA,906,6,5,0,7934,7945,C
6-NA,907,2,3,7954,0,7959,G
6-NA,908,0,7929,1,1,7931,T
6-NA,909,7818,2,3,1,7824,A
6-NA,910,1,6,7985,0,7992,G
6-NA,911,8007,4,7,0,8018,A
6-NA,912,2,8057,0,0,8059,T
6-NA,913,7897,0,0,0,7897,A
6-NA,914,0,7800,0,1,7801,T
6-NA,915,7799,0,0,0,7799,A
6-NA,916,7797,0,0,0,7797,A
6-NA,917,7974,4,5,0,7983,A
6-NA,918,1,5,0,8127,8133,C
6-NA,919,7889,2,1,0,7892,A
6-NA,920,2,7874,1,2,7879,T
6-NA,921,7805,0,1,0,7806,A
6-NA,922,7812,1,3,0,7816,A
6-NA,923,7810,0,6,3,7819,A
6-NA,924,3,12,7905,0,7920,G
6-NA,925,0,9,8006,0,8015,G
6-NA,926,7811,3,2,0,7816,A
6-NA,927,2,7844,0,6,7852,T
6-NA,928,7,1,0,7863,7871,C
6-NA,929,7898,1,5,1,7905,A
6-NA,930,0,7916,0,4,7920,T
6-NA,931,7890,0,6,0,7896,A
6-NA,932,4,2,7952,0,7958,G
6-NA,933,3,0,0,7871,7874,C
6-NA,934,7720,0,0,0,7720,A
6-NA,935,0,7457,0,0,7457,T
6-NA,936,2,7493,0,0,7495,T
6-NA,937,3,0,7479,0,7482,G
6-NA,938,0,7484,0,12,7496,T
6-NA,939,13,1,0,7385,7399,C
6-NA,940,0,7996,0,10,8006,T
6-NA,941,13,4,0,8073,8090,C
6-NA,942,9,2,0,8130,8141,C
6-NA,943,8218,2,9,1,8230,A
6-NA,944,1,3,8356,1,8361,G
6-NA,945,1,8339,1,4,8345,T
6-NA,946,0,7985,0,2,7987,T
6-NA,947,7982,1,3,1,7987,A
6-NA,948,1,7787,0,2,7790,T
6-NA,949,1,2,7790,0,7793,G
6-NA,950,1,7668,1,7,7677,T
6-NA,951,0,3,7705,0,7708,G
6-NA,952,0,7483,0,4,7487,T
6-NA,953,1,0,7659,0,7660,G
6-NA,954,1,7654,0,5,7660,T
6-NA,955,3,7622,1,1,7627,T
6-NA,956,11,1,1,7604,7617,C
6-NA,957,7562,3,4,1,7570,A
6-NA,958,7,11,7614,0,7632,G
6-NA,959,1,9,7614,1,7625,G
6-NA,960,7579,1,5,0,7585,A
6-NA,961,0,0,0,7604,7604,C
6-NA,962,1,7384,0,2,7387,T
6-NA,963,0,7418,0,3,7421,T
6-NA,964,2,4,7660,0,7666,G
6-NA,965,2,7656,0,8,7666,T
6-NA,966,2,7659,1,9,7671,T
6-NA,967,2,5,7627,0,7634,G
6-NA,968,3,18,7605,5,7631,G
6-NA,969,7621,0,15,1,7637,A
6-NA,970,1,8,7646,0,7655,G
6-NA,971,7633,2,11,0,7646,A
6-NA,972,1,3,0,7651,7655,C
6-NA,973,7450,0,8,0,7458,A
6-NA,974,4,3,0,7475,7482,C
6-NA,975,7492,0,8,0,7500,A
6-NA,976,3,2,0,7516,7521,C
6-NA,977,10,2,0,7469,7481,C
6-NA,978,15,3,0,7474,7492,C
6-NA,979,7458,1,4,0,7463,A
6-NA,980,2,3,7508,2,7515,G
6-NA,981,7489,0,2,0,7491,A
6-NA,982,7531,0,1,0,7532,A
6-NA,983,7481,0,2,1,7484,A
6-NA,984,7493,0,1,0,7494,A
6-NA,985,7434,1,3,0,7438,A
6-NA,986,7447,1,6,2,7456,A
6-NA,987,1,2,0,7464,7467,C
6-NA,988,2,14,7445,1,7462,G
6-NA,989,7427,2,22,0,7451,A
6-NA,990,0,0,0,7447,7447,C
6-NA,991,7408,0,3,0,7411,A
6-NA,992,1,5,7475,0,7481,G
6-NA,993,1,0,1,7721,7723,C
6-NA,994,2,7691,1,4,7698,T
6-NA,995,12,4,1,7691,7708,C
6-NA,996,10,1,0,7721,7732,C
6-NA,997,7735,1,6,1,7743,A
6-NA,998,0,0,7825,1,7826,G
6-NA,999,1,3,1,7822,7827,C
6-NA,1000,7797,1,0,0,7798,A
6-NA,1001,0,3,7792,0,7795,G
6-NA,1002,0,7536,0,3,7539,T
6-NA,1003,7538,0,2,1,7541,A
6-NA,1004,2,1,7556,2,7561,G
6-NA,1005,3,1,0,7571,7575,C
6-NA,1006,16,1,0,7582,7599,C
6-NA,1007,7513,1,3,0,7517,A
6-NA,1008,2,7513,0,1,7516,T
6-NA,1009,0,7513,0,0,7513,T
6-NA,1010,2,1,7667,0,7670,G
6-NA,1011,0,7644,3,1,7648,T
6-NA,1012,0,7627,0,3,7630,T
6-NA,1013,7,7621,0,3,7631,T
6-NA,1014,3,13,7567,0,7583,G
6-NA,1015,1,3,7648,0,7652,G
6-NA,1016,7611,2,6,0,7619,A
6-NA,1017,0,7704,0,1,7705,T
6-NA,1018,9,2,1,7690,7702,C
6-NA,1019,9,1,0,7618,7628,C
6-NA,1020,13,7589,0,3,7605,T
6-NA,1021,7611,0,16,0,7627,A
6-NA,1022,7644,2,3,0,7649,A
6-NA,1023,4,1,0,7784,7789,C
6-NA,1024,7636,1,1,0,7638,A
6-NA,1025,7672,1,4,0,7677,A
6-NA,1026,1,7607,0,1,7609,T
6-NA,1027,1,6,7600,0,7607,G
6-NA,1028,7534,1,7,0,7542,A
6-NA,1029,2,12,7245,0,7259,G
6-NA,1030,1,3,7410,0,7414,G
6-NA,1031,7392,1,8,0,7401,A
6-NA,1032,7420,0,3,1,7424,A
6-NA,1033,0,11,7421,0,7432,G
6-NA,1034,2,2,7459,0,7463,G
6-NA,1035,0,7395,1,3,7399,T
6-NA,1036,2,9,7384,0,7395,G
6-NA,1037,0,1,7531,0,7532,G
6-NA,1038,2,7460,0,4,7466,T
6-NA,1039,30,1,2,7406,7439,C
6-NA,1040,7421,2,1,0,7424,A
6-NA,1041,1,7395,0,5,7401,T
6-NA,1042,2,34,7341,0,7377,G
6-NA,1043,1,26,7296,1,7324,G
6-NA,1044,1,10,7089,0,7100,G
6-NA,1045,2,2,7433,0,7437,G
6-NA,1046,1,7432,1,4,7438,T
6-NA,1047,1,10,7444,2,7457,G
6-NA,1048,7427,0,3,0,7430,A
6-NA,1049,7438,0,4,0,7442,A
6-NA,1050,7458,1,6,0,7465,A
6-NA,1051,2,8,7473,1,7484,G
6-NA,1052,2,4,7408,0,7414,G
6-NA,1053,0,2,0,7404,7406,C
6-NA,1054,0,7194,0,7,7201,T
6-NA,1055,0,13,7200,0,7213,G
6-NA,1056,3,6,7202,1,7212,G
6-NA,1057,3,0,7270,1,7274,G
6-NA,1058,1,3,0,7279,7283,C
6-NA,1059,4,2,0,7283,7289,C
6-NA,1060,1,7191,1,17,7210,T
6-NA,1061,2,7212,1,1,7216,T
6-NA,1062,2,7212,1,0,7215,T
6-NA,1063,1,8,7246,1,7256,G
6-NA,1064,7228,3,8,2,7241,A
6-NA,1065,2,7210,0,1,7213,T
6-NA,1066,0,6,7087,1,7094,G
6-NA,1067,7000,2,16,0,7018,A
6-NA,1068,0,7039,1,4,7044,T
6-NA,1069,2,10,7034,1,7047,G
6-NA,1070,0,3,7113,2,7118,G
6-NA,1071,7107,1,5,2,7115,A
6-NA,1072,7098,1,4,1,7104,A
6-NA,1073,7108,0,6,0,7114,A
6-NA,1074,0,7126,0,0,7126,T
6-NA,1075,2,9,7128,1,7140,G
6-NA,1076,7125,1,5,1,7132,A
6-NA,1077,2,3,1,7099,7105,C
6-NA,1078,4,0,7127,0,7131,G
6-NA,1079,0,6962,1,2,6965,T
6-NA,1080,3,2,7022,0,7027,G
6-NA,1081,2,7012,1,4,7019,T
6-NA,1082,4,16,7015,0,7035,G
6-NA,1083,1,4,7060,0,7065,G
6-NA,1084,7019,0,3,0,7022,A
6-NA,1085,0,7047,1,1,7049,T
6-NA,1086,5,19,7003,1,7028,G
6-NA,1087,3,8,6989,0,7000,G
6-NA,1088,3,4,7056,0,7063,G
6-NA,1089,7002,1,5,0,7008,A
6-NA,1090,6980,1,6,0,6987,A
6-NA,1091,1,19,6978,0,6998,G
6-NA,1092,6884,2,18,1,6905,A
6-NA,1093,6911,2,8,0,6921,A
6-NA,1094,3,7,0,6872,6882,C
6-NA,1095,0,13,6834,0,6847,G
6-NA,1096,6852,1,3,0,6856,A
6-NA,1097,0,6745,0,1,6746,T
6-NA,1098,9,1,0,6762,6772,C
6-NA,1099,6771,0,4,0,6775,A
6-NA,1100,1,2,6796,0,6799,G
6-NA,1101,2,0,1,6784,6787,C
6-NA,1102,2,10,6778,0,6790,G
6-NA,1103,6770,0,4,0,6774,A
6-NA,1104,1,8,6765,1,6775,G
6-NA,1105,6786,0,3,0,6789,A
6-NA,1106,6790,1,5,2,6798,A
6-NA,1107,3,0,6851,1,6855,G
6-NA,1108,2,6791,0,8,6801,T
6-NA,1109,14,1,0,6741,6756,C
6-NA,1110,6751,1,3,0,6755,A
6-NA,1111,2,4,0,6915,6921,C
6-NA,1112,1,1,6938,0,6940,G
6-NA,1113,0,1,0,6939,6940,C
6-NA,1114,0,6889,0,3,6892,T
6-NA,1115,0,6918,0,1,6919,T
6-NA,1116,6829,0,2,1,6832,A
6-NA,1117,2,18,7053,0,7073,G
6-NA,1118,2,11,7056,0,7069,G
6-NA,1119,0,6,7208,0,7214,G
6-NA,1120,1,6808,0,6,6815,T
6-NA,1121,6773,1,1,0,6775,A
6-NA,1122,1,6753,2,5,6761,T
6-NA,1123,1,11,6750,1,6763,G
6-NA,1124,6751,1,4,0,6756,A
6-NA,1125,6731,1,4,0,6736,A
6-NA,1126,6466,0,8,0,6474,A
6-NA,1127,0,1,0,6463,6464,C
6-NA,1128,5,0,0,6386,6391,C
6-NA,1129,0,6315,0,5,6320,T
6-NA,1130,0,6320,0,2,6322,T
6-NA,1131,4,2,0,6321,6327,C
6-NA,1132,6320,0,4,0,6324,A
6-NA,1133,6326,0,2,1,6329,A
6-NA,1134,6310,1,2,1,6314,A
6-NA,1135,1,2,6366,0,6369,G
6-NA,1136,1,6275,0,4,6280,T
6-NA,1137,17,1,0,6309,6327,C
6-NA,1138,6433,1,1,0,6435,A
6-NA,1139,2,6453,0,1,6456,T
6-NA,1140,0,6449,1,2,6452,T
6-NA,1141,0,2,6456,1,6459,G
6-NA,1142,6443,0,4,0,6447,A
6-NA,1143,6482,1,1,0,6484,A
6-NA,1144,0,5,6577,0,6582,G
6-NA,1145,3,2,6589,0,6594,G
6-NA,1146,1,0,0,6571,6572,C
6-NA,1147,0,6372,1,8,6381,T
6-NA,1148,3,5,6422,0,6430,G
6-NA,1149,1,3,6558,1,6563,G
6-NA,1150,0,6557,0,7,6564,T
6-NA,1151,12,2,1,6512,6527,C
6-NA,1152,8,1,0,6526,6535,C
6-NA,1153,6510,1,5,0,6516,A
6-NA,1154,6561,1,4,0,6566,A
6-NA,1155,4,0,0,6614,6618,C
6-NA,1156,14,2,0,6609,6625,C
6-NA,1157,19,0,0,6593,6612,C
6-NA,1158,1,6354,0,4,6359,T
6-NA,1159,6368,1,2,0,6371,A
6-NA,1160,6367,0,4,0,6371,A
6-NA,1161,2,1,6428,0,6431,G
6-NA,1162,0,6393,0,7,6400,T
6-NA,1163,13,1,0,6362,6376,C
6-NA,1164,21,1,0,6284,6306,C
6-NA,1165,6273,0,1,0,6274,A
6-NA,1166,6273,0,1,2,6276,A
6-NA,1167,6282,1,2,0,6285,A
6-NA,1168,0,6288,0,0,6288,T
6-NA,1169,0,6290,1,3,6294,T
6-NA,1170,1,108,6156,0,6265,G
6-NA,1171,1,3,1,6233,6238,C
6-NA,1172,6222,0,5,0,6227,A
6-NA,1173,0,5,6258,0,6263,G
6-NA,1174,6256,2,1,1,6260,A
6-NA,1175,1,6354,0,0,6355,T
6-NA,1176,6363,0,1,1,6365,A
6-NA,1177,6354,0,2,1,6357,A
6-NA,1178,6364,3,1,0,6368,A
6-NA,1179,3,6336,0,2,6341,T
6-NA,1180,6320,1,1,1,6323,A
6-NA,1181,0,5,6326,1,6332,G
6-NA,1182,3,0,6288,0,6291,G
6-NA,1183,1,2,0,6273,6276,C
6-NA,1184,6114,1,0,0,6115,A
6-NA,1185,6172,1,3,0,6176,A
6-NA,1186,0,1,6229,0,6230,G
6-NA,1187,2,6214,0,5,6221,T
6-NA,1188,20,0,2,6191,6213,C
6-NA,1189,6238,2,3,0,6243,A
6-NA,1190,1,6246,2,6,6255,T
6-NA,1191,6335,0,3,0,6338,A
6-NA,1192,2,1,6367,0,6370,G
6-NA,1193,1,6358,0,2,6361,T
6-NA,1194,1,6199,1,2,6203,T
6-NA,1195,2,14,6102,0,6118,G
6-NA,1196,6079,2,5,0,6086,A
6-NA,1197,0,2,0,6087,6089,C
6-NA,1198,6021,0,1,0,6022,A
6-NA,1199,0,6,6127,1,6134,G
6-NA,1200,6077,1,8,0,6086,A
6-NA,1201,0,5,6373,0,6378,G
6-NA,1202,1,1,6389,0,6391,G
6-NA,1203,1,6180,0,184,6365,T
6-NA,1204,6369,0,2,0,6371,A
6-NA,1205,6350,0,8,1,6359,A
6-NA,1206,1,6359,0,0,6360,T
6-NA,1207,6331,0,2,0,6333,A
6-NA,1208,2,12,6174,0,6188,G
6-NA,1209,4,3,6050,0,6057,G
6-NA,1210,2,5728,0,1,5731,T
6-NA,1211,15,0,0,5668,5683,C
6-NA,1212,15,4,0,5647,5666,C
6-NA,1213,4,7,5668,0,5679,G
6-NA,1214,2,2,5704,0,5708,G
6-NA,1215,0,5687,0,1,5688,T
6-NA,1216,0,5690,0,1,5691,T
6-NA,1217,5670,0,1,0,5671,A
6-NA,1218,0,5603,0,0,5603,T
6-NA,1219,0,5604,0,2,5606,T
6-NA,1220,9,1,0,5616,5626,C
6-NA,1221,1,5479,0,2,5482,T
6-NA,1222,3,4,5524,0,5531,G
6-NA,1223,1,1,5544,0,5546,G
6-NA,1224,0,5539,1,2,5542,T
6-NA,1225,5545,0,1,1,5547,A
6-NA,1226,0,5470,0,3,5473,T
6-NA,1227,0,5471,1,3,5475,T
6-NA,1228,0,5473,0,5,5478,T
6-NA,1229,1,5511,1,3,5516,T
6-NA,1230,7,2,1,5517,5527,C
6-NA,1231,1,5442,1,8,5452,T
6-NA,1232,11,0,0,5461,5472,C
6-NA,1233,3,5440,0,1,5444,T
6-NA,1234,1,2,5522,0,5525,G
6-NA,1235,2,5519,1,3,5525,T
6-NA,1236,2,5470,0,10,5482,T
6-NA,1237,2,5,5485,0,5492,G
6-NA,1238,5427,0,3,0,5430,A
6-NA,1239,5424,0,7,0,5431,A
6-NA,1240,1,11,5457,0,5469,G
6-NA,1241,3,1,5451,0,5455,G
6-NA,1242,1,2,0,5470,5473,C
6-NA,1243,5377,2,0,0,5379,A
6-NA,1244,5374,0,7,0,5381,A
6-NA,1245,5386,0,4,0,5390,A
6-NA,1246,5275,0,100,0,5375,A
6-NA,1247,1,0,5379,1,5381,G
6-NA,1248,1,0,0,5377,5378,C
6-NA,1249,0,5298,1,7,5306,T
6-NA,1250,1,1,5367,1,5370,G
6-NA,1251,2,2,0,5351,5355,C
6-NA,1252,5367,0,3,1,5371,A
6-NA,1253,1,5357,0,7,5365,T
6-NA,1254,6,1,0,5318,5325,C
6-NA,1255,5306,1,1,0,5308,A
6-NA,1256,5306,2,2,0,5310,A
6-NA,1257,1,5305,0,1,5307,T
6-NA,1258,8,2,0,5303,5313,C
6-NA,1259,4,5,5232,1,5242,G
6-NA,1260,1,0,5318,0,5319,G
6-NA,1261,3,5302,0,9,5314,T
6-NA,1262,0,2,5345,0,5347,G
6-NA,1263,1,0,0,5375,5376,C
6-NA,1264,0,5347,0,3,5350,T
6-NA,1265,0,5408,1,1,5410,T
6-NA,1266,1,5406,1,2,5410,T
6-NA,1267,0,5428,0,0,5428,T
6-NA,1268,5449,0,3,0,5452,A
6-NA,1269,1,5231,0,2,5234,T
6-NA,1270,0,0,5243,0,5243,G
6-NA,1271,0,5171,0,1,5172,T
6-NA,1272,0,4,5108,0,5112,G
6-NA,1273,0,7,5188,0,5195,G
6-NA,1274,5082,0,4,0,5086,A
6-NA,1275,0,0,5147,0,5147,G
6-NA,1276,1,5115,0,2,5118,T
6-NA,1277,0,5090,0,1,5091,T
6-NA,1278,0,6,5119,0,5125,G
6-NA,1279,5103,3,4,0,5110,A
6-NA,1280,1,5110,0,2,5113,T
6-NA,1281,5084,1,2,1,5088,A
6-NA,1282,4920,1,4,0,4925,A
6-NA,1283,0,21,4938,0,4959,G
6-NA,1284,0,9,4855,0,4864,G
6-NA,1285,0,5,4810,1,4816,G
6-NA,1286,0,4,4807,0,4811,G
6-NA,1287,4728,0,3,0,4731,A
6-NA,1288,4716,1,4,2,4723,A
6-NA,1289,1,2,4760,0,4763,G
6-NA,1290,4751,2,1,0,4754,A
6-NA,1291,4748,1,1,1,4751,A
6-NA,1292,4683,0,1,1,4685,A
6-NA,1293,4595,1,4,0,4600,A
6-NA,1294,1,5,4604,0,4610,G
6-NA,1295,4551,0,5,0,4556,A
6-NA,1296,0,1,4560,0,4561,G
6-NA,1297,0,3,4547,0,4550,G
6-NA,1298,4483,1,4,0,4488,A
6-NA,1299,4486,0,1,0,4487,A
6-NA,1300,4492,1,0,1,4494,A
6-NA,1301,0,1,0,4510,4511,C
6-NA,1302,0,4493,0,1,4494,T
6-NA,1303,0,7,4495,0,4502,G
6-NA,1304,4481,0,2,0,4483,A
6-NA,1305,4470,0,6,0,4476,A
6-NA,1306,2,0,4500,0,4502,G
6-NA,1307,1,4466,0,4,4471,T
6-NA,1308,13,1,0,4487,4501,C
6-NA,1309,1,4478,0,4,4483,T
6-NA,1310,1,4435,0,2,4438,T
6-NA,1311,1,0,4441,0,4442,G
6-NA,1312,0,4415,0,6,4421,T
6-NA,1313,0,7,4413,0,4420,G
6-NA,1314,0,6,4408,0,4414,G
6-NA,1315,4378,0,1,0,4379,A
6-NA,1316,1,1,2,4394,4398,C
6-NA,1317,10,0,0,4285,4295,C
6-NA,1318,1,4284,1,8,4294,T
6-NA,1319,5,1,0,4296,4302,C
6-NA,1320,4313,0,2,0,4315,A
6-NA,1321,4319,0,3,0,4322,A
6-NA,1322,4318,0,1,0,4319,A
6-NA,1323,0,0,0,4363,4363,C
6-NA,1324,4235,1,0,0,4236,A
6-NA,1325,1,0,4304,0,4305,G
6-NA,1326,1,4232,0,1,4234,T
6-NA,1327,4236,1,1,0,4238,A
6-NA,1328,0,4236,0,0,4236,T
6-NA,1329,1,4155,1,1,4158,T
6-NA,1330,0,1,4180,1,4182,G
6-NA,1331,1,4163,0,5,4169,T
6-NA,1332,0,3968,0,0,3968,T
6-NA,1333,1,1,3972,0,3974,G
6-NA,1334,1,3719,0,3,3723,T
6-NA,1335,2,1,3739,0,3742,G
6-NA,1336,0,3720,2,5,3727,T
6-NA,1337,0,3668,0,1,3669,T
6-NA,1338,0,3672,0,1,3673,T
6-NA,1339,1,3580,0,1,3582,T
6-NA,1340,0,0,3575,0,3575,G
6-NA,1341,1,3580,0,1,3582,T
6-NA,1342,1,3,3548,1,3553,G
6-NA,1343,0,0,3546,0,3546,G
6-NA,1344,0,2,0,3504,3506,C
6-NA,1345,3493,1,3,0,3497,A
6-NA,1346,1,2,0,3519,3522,C
6-NA,1347,3,0,0,3506,3509,C
6-NA,1348,1,3500,0,5,3506,T
6-NA,1349,2,1,1,3515,3519,C
6-NA,1350,3520,0,4,0,3524,A
6-NA,1351,1,2,3559,0,3562,G
6-NA,1352,0,1,3561,0,3562,G
6-NA,1353,1,3539,1,1,3542,T
6-NA,1354,3528,0,1,0,3529,A
6-NA,1355,1,1,0,3362,3364,C
6-NA,1356,3332,0,0,0,3332,A
6-NA,1357,1,3318,0,1,3320,T
6-NA,1358,3210,0,28,0,3238,A
6-NA,1359,1,3230,0,0,3231,T
6-NA,1360,2,5,3002,0,3009,G
6-NA,1361,2,2,3001,0,3005,G
6-NA,1362,2974,1,0,0,2975,A
6-NA,1363,2951,0,1,0,2952,A
6-NA,1364,1,0,1,2920,2922,C
6-NA,1365,2424,0,0,0,2424,A
6-NA,1366,0,2,2434,0,2436,G
6-NA,1367,1,0,2429,0,2430,G
6-NA,1368,2,1,0,2432,2435,C
6-NA,1369,0,2413,0,6,2419,T
6-NA,1370,6,1,0,2305,2312,C
6-NA,1371,2292,1,3,0,2296,A
6-NA,1372,0,2290,0,4,2294,T
6-NA,1373,0,1,2296,0,2297,G
6-NA,1374,1,0,2302,0,2303,G
6-NA,1375,1,0,0,2237,2238,C
6-NA,1376,0,0,0,2228,2228,C
6-NA,1377,0,2101,0,1,2102,T
6-NA,1378,0,2,2094,0,2096,G
6-NA,1379,2095,0,1,0,2096,A
6-NA,1380,0,2092,0,0,2092,T
6-NA,1381,0,3,2056,0,2059,G
6-NA,1382,0,6,2011,0,2017,G
6-NA,1383,0,1,1919,1,1921,G
6-NA,1384,1,1,1911,1,1914,G
6-NA,1385,1,0,0,1871,1872,C
6-NA,1386,1,1,1862,0,1864,G
6-NA,1387,0,1,1851,0,1852,G
6-NA,1388,1831,0,4,0,1835,A
6-NA,1389,0,2,0,1828,1830,C
6-NA,1390,1825,0,0,0,1825,A
6-NA,1391,0,1790,0,3,1793,T
6-NA,1392,5,0,0,1753,1758,C
6-NA,1393,1751,0,2,0,1753,A
6-NA,1394,1750,2,0,0,1752,A
6-NA,1395,0,1744,0,2,1746,T
6-NA,1396,1,0,0,1706,1707,C
6-NA,1397,0,1649,0,0,1649,T
6-NA,1398,7,1,0,1443,1451,C
6-NA,1399,1442,0,1,0,1443,A
6-NA,1400,0,1434,0,2,1436,T
6-NA,1401,0,0,1431,0,1431,G
6-NA,1402,2,0,0,1425,1427,C
6-NA,1403,2,0,0,1380,1382,C
6-NA,1404,0,1247,0,0,1247,T
6-NA,1405,1232,1,0,0,1233,A
6-NA,1406,0,1232,1,1,1234,T
6-NA,1407,1207,0,0,0,1207,A
6-NA,1408,0,1204,0,0,1204,T
6-NA,1409,1099,0,0,0,1099,A
6-NA,1410,1056,0,0,0,1056,A
7-M,1,64,0,0,0,64,A
7-M,2,0,65,0,0,65,T
7-M,3,0,0,65,0,65,G
7-M,4,65,0,0,0,65,A
7-M,5,0,0,71,0,71,G
7-M,6,0,0,0,78,78,C
7-M,7,0,0,0,82,82,C
7-M,8,0,96,0,0,96,T
7-M,9,0,96,0,0,96,T
7-M,10,0,0,0,95,95,C
7-M,11,0,96,0,0,96,T
7-M,12,98,0,0,0,98,A
7-M,13,98,0,0,0,98,A
7-M,14,0,0,0,98,98,C
7-M,15,0,0,0,97,97,C
7-M,16,0,0,98,0,98,G
7-M,17,98,1,0,0,99,A
7-M,18,0,0,100,0,100,G
7-M,19,0,0,100,0,100,G
7-M,20,0,102,0,0,102,T
7-M,21,0,0,0,102,102,C
7-M,22,0,0,103,0,103,G
7-M,23,106,0,0,0,106,A
7-M,24,108,0,0,0,108,A
7-M,25,111,0,0,0,111,A
7-M,26,0,0,0,117,117,C
7-M,27,0,0,121,0,121,G
7-M,28,0,120,0,1,121,T
7-M,29,119,0,1,0,120,A
7-M,30,0,123,0,0,123,T
7-M,31,0,1,125,0,126,G
7-M,32,0,125,0,0,125,T
7-M,33,0,141,0,0,141,T
7-M,34,0,0,0,147,147,C
7-M,35,0,148,0,0,148,T
7-M,36,0,0,0,154,154,C
7-M,37,0,154,0,0,154,T
7-M,38,0,0,0,156,156,C
7-M,39,0,155,0,0,155,T
7-M,40,155,0,0,0,155,A
7-M,41,0,155,0,0,155,T
7-M,42,0,0,0,154,154,C
7-M,43,0,0,155,0,155,G
7-M,44,0,155,0,0,155,T
7-M,45,0,155,0,0,155,T
7-M,46,0,0,0,155,155,C
7-M,47,0,0,0,156,156,C
7-M,48,156,0,1,0,157,A
7-M,49,0,157,0,0,157,T
7-M,50,0,0,0,157,157,C
7-M,51,157,0,0,0,157,A
7-M,52,0,0,159,1,160,G
7-M,53,0,0,162,0,162,G
7-M,54,0,0,0,162,162,C
7-M,55,1,0,1,161,163,C
7-M,56,1,0,0,162,163,C
7-M,57,0,0,0,165,165,C
7-M,58,1,0,0,165,166,C
7-M,59,0,166,0,0,166,T
7-M,60,0,0,0,166,166,C
7-M,61,164,0,0,0,164,A
7-M,62,164,0,0,0,164,A
7-M,63,166,0,1,0,167,A
7-M,64,0,0,170,0,170,G
7-M,65,0,0,0,170,170,C
7-M,66,0,0,0,169,169,C
7-M,67,0,0,169,0,169,G
7-M,68,170,0,0,0,170,A
7-M,69,0,0,171,0,171,G
7-M,70,171,0,0,0,171,A
7-M,71,0,173,0,0,173,T
7-M,72,0,0,0,172,172,C
7-M,73,0,0,173,0,173,G
7-M,74,0,0,0,173,173,C
7-M,75,0,0,173,0,173,G
7-M,76,0,0,0,172,172,C
7-M,77,174,0,0,0,174,A
7-M,78,0,0,177,0,177,G
7-M,79,176,0,0,0,176,A
7-M,80,0,0,186,0,186,G
7-M,81,185,0,0,0,185,A
7-M,82,0,0,0,188,188,C
7-M,83,0,187,0,0,187,T
7-M,84,0,187,0,0,187,T
7-M,85,0,0,190,0,190,G
7-M,86,191,0,0,0,191,A
7-M,87,191,0,0,0,191,A
7-M,88,0,1,191,0,192,G
7-M,89,191,0,0,0,191,A
7-M,90,0,192,0,0,192,T
7-M,91,0,0,194,0,194,G
7-M,92,0,194,0,0,194,T
7-M,93,0,0,0,192,192,C
7-M,94,0,194,0,0,194,T
7-M,95,1,193,0,0,194,T
7-M,96,0,193,0,0,193,T
7-M,97,1,0,192,0,193,G
7-M,98,0,0,0,194,194,C
7-M,99,0,191,0,0,191,T
7-M,100,0,2,189,0,191,G
7-M,101,0,1,191,0,192,G
7-M,102,0,0,194,0,194,G
7-M,103,191,0,0,0,191,A
7-M,104,194,0,0,0,194,A
7-M,105,194,0,0,0,194,A
7-M,106,194,0,0,0,194,A
7-M,107,193,0,0,1,194,A
7-M,108,0,0,0,197,197,C
7-M,109,197,0,0,0,197,A
7-M,110,0,0,0,197,197,C
7-M,111,196,0,0,0,196,A
7-M,112,0,0,202,0,202,G
7-M,113,208,0,0,0,208,A
7-M,114,0,210,0,0,210,T
7-M,115,0,0,0,212,212,C
7-M,116,0,211,0,0,211,T
7-M,117,0,208,0,0,208,T
7-M,118,0,1,208,0,209,G
7-M,119,210,0,0,0,210,A
7-M,120,0,1,210,0,211,G
7-M,121,0,0,208,0,208,G
7-M,122,0,0,0,208,208,C
7-M,123,0,208,0,0,208,T
7-M,124,0,0,0,235,235,C
7-M,125,0,234,0,0,234,T
7-M,126,2,0,0,233,235,C
7-M,127,234,0,1,0,235,A
7-M,128,0,237,0,1,238,T
7-M,129,0,0,236,0,236,G
7-M,130,0,3,233,0,236,G
7-M,131,236,0,0,0,236,A
7-M,132,237,0,0,0,237,A
7-M,133,0,226,0,0,226,T
7-M,134,0,0,233,0,233,G
7-M,135,0,0,248,0,248,G
7-M,136,0,0,0,249,249,C
7-M,137,0,250,0,0,250,T
7-M,138,249,0,0,0,249,A
7-M,139,250,0,0,0,250,A
7-M,140,251,0,0,0,251,A
7-M,141,0,0,256,0,256,G
7-M,142,255,0,0,0,255,A
7-M,143,1,0,0,252,253,C
7-M,144,246,0,0,0,246,A
7-M,145,244,0,1,1,246,A
7-M,146,0,3,245,0,248,G
7-M,147,249,0,0,0,249,A
7-M,148,1,0,0,247,248,C
7-M,149,0,0,0,249,249,C
7-M,150,246,0,1,0,247,A
7-M,151,253,0,0,0,253,A
7-M,152,3,250,0,0,253,T
7-M,153,0,251,0,1,252,T
7-M,154,0,0,0,255,255,C
7-M,155,0,252,0,0,252,T
7-M,156,0,0,253,0,253,G
7-M,157,0,253,0,0,253,T
7-M,158,2,0,0,251,253,C
7-M,159,253,0,0,0,253,A
7-M,160,0,0,0,266,266,C
7-M,161,1,0,0,267,268,C
7-M,162,0,266,0,1,267,T
7-M,163,0,0,0,268,268,C
7-M,164,0,267,0,0,267,T
7-M,165,0,0,276,0,276,G
7-M,166,275,0,0,0,275,A
7-M,167,0,0,0,278,278,C
7-M,168,0,277,0,0,277,T
7-M,169,274,0,2,0,276,A
7-M,170,275,0,0,0,275,A
7-M,171,0,1,274,0,275,G
7-M,172,0,1,275,0,276,G
7-M,173,0,1,273,0,274,G
7-M,174,0,1,270,0,271,G
7-M,175,274,0,0,0,274,A
7-M,176,0,274,0,0,274,T
7-M,177,0,273,0,0,273,T
7-M,178,0,273,0,0,273,T
7-M,179,0,273,2,0,275,T
7-M,180,0,0,274,0,274,G
7-M,181,0,1,276,0,277,G
7-M,182,0,1,274,0,275,G
7-M,183,0,0,277,0,277,G
7-M,184,0,273,0,0,273,T
7-M,185,0,274,0,0,274,T
7-M,186,0,274,0,0,274,T
7-M,187,0,0,284,0,284,G
7-M,188,1,283,0,0,284,T
7-M,189,0,0,286,0,286,G
7-M,190,0,286,0,0,286,T
7-M,191,0,286,0,0,286,T
7-M,192,0,0,0,285,285,C
7-M,193,285,0,0,0,285,A
7-M,194,1,0,0,293,294,C
7-M,195,0,0,295,0,295,G
7-M,196,0,0,0,298,298,C
7-M,197,0,297,0,0,297,T
7-M,198,0,0,0,306,306,C
7-M,199,310,0,0,0,310,A
7-M,200,0,1,0,313,314,C
7-M,201,0,0,0,312,312,C
7-M,202,0,0,311,0,311,G
7-M,203,0,312,0,0,312,T
7-M,204,0,0,313,0,313,G
7-M,205,0,0,0,317,317,C
7-M,206,0,0,0,317,317,C
7-M,207,1,0,0,313,314,C
7-M,208,309,0,0,0,309,A
7-M,209,0,0,316,0,316,G
7-M,210,0,314,0,0,314,T
7-M,211,0,1,315,0,316,G
7-M,212,319,0,0,0,319,A
7-M,213,1,0,317,0,318,G
7-M,214,0,0,0,315,315,C
7-M,215,0,0,315,0,315,G
7-M,216,314,0,0,0,314,A
7-M,217,1,2,314,0,317,G
7-M,218,0,0,318,0,318,G
7-M,219,317,0,0,0,317,A
7-M,220,0,0,0,322,322,C
7-M,221,0,321,0,0,321,T
7-M,222,0,0,322,0,322,G
7-M,223,0,0,0,323,323,C
7-M,224,324,0,0,0,324,A
7-M,225,0,0,335,0,335,G
7-M,226,0,1,0,328,329,C
7-M,227,0,0,333,0,333,G
7-M,228,0,335,0,0,335,T
7-M,229,333,0,0,0,333,A
7-M,230,0,1,332,0,333,G
7-M,231,333,0,0,0,333,A
7-M,232,0,0,0,333,333,C
7-M,233,0,1,333,0,334,G
7-M,234,0,0,0,327,327,C
7-M,235,0,324,0,0,324,T
7-M,236,2,326,0,0,328,T
7-M,237,0,328,0,0,328,T
7-M,238,0,0,338,0,338,G
7-M,239,0,336,0,1,337,T
7-M,240,1,0,0,336,337,C
7-M,241,0,0,0,338,338,C
7-M,242,338,0,0,0,338,A
7-M,243,338,0,0,0,338,A
7-M,244,338,0,0,0,338,A
7-M,245,339,0,0,0,339,A
7-M,246,0,337,0,0,337,T
7-M,247,0,0,336,0,336,G
7-M,248,0,0,0,337,337,C
7-M,249,1,0,0,339,340,C
7-M,250,2,0,0,340,342,C
7-M,251,0,343,0,0,343,T
7-M,252,0,0,0,354,354,C
7-M,253,354,0,0,0,354,A
7-M,254,360,0,0,0,360,A
7-M,255,0,362,0,0,362,T
7-M,256,0,0,363,0,363,G
7-M,257,0,0,364,0,364,G
7-M,258,0,0,366,0,366,G
7-M,259,364,0,0,0,364,A
7-M,260,366,0,1,0,367,A
7-M,261,0,357,0,0,357,T
7-M,262,1,0,355,0,356,G
7-M,263,0,1,354,0,355,G
7-M,264,354,0,1,0,355,A
7-M,265,0,0,354,0,354,G
7-M,266,352,0,0,0,352,A
7-M,267,0,0,0,351,351,C
7-M,268,1,0,0,368,369,C
7-M,269,0,0,0,370,370,C
7-M,270,375,0,0,0,375,A
7-M,271,373,0,0,0,373,A
7-M,272,373,0,0,0,373,A
7-M,273,0,373,0,0,373,T
7-M,274,383,0,0,0,383,A
7-M,275,382,0,0,0,382,A
7-M,276,0,0,0,372,372,C
7-M,277,370,0,0,0,370,A
7-M,278,0,367,0,0,367,T
7-M,279,0,0,371,0,371,G
7-M,280,0,0,371,0,371,G
7-M,281,372,0,0,0,372,A
7-M,282,0,0,0,372,372,C
7-M,283,362,0,0,0,362,A
7-M,284,358,1,0,0,359,A
7-M,285,358,0,1,0,359,A
7-M,286,0,0,365,0,365,G
7-M,287,1,1,0,365,367,C
7-M,288,362,0,0,0,362,A
7-M,289,0,0,373,0,373,G
7-M,290,0,373,0,0,373,T
7-M,291,0,373,0,0,373,T
7-M,292,376,0,0,0,376,A
7-M,293,372,0,0,0,372,A
7-M,294,373,0,0,0,373,A
7-M,295,0,0,0,374,374,C
7-M,296,0,368,0,0,368,T
7-M,297,0,0,415,0,415,G
7-M,298,1,408,0,1,410,T
7-M,299,413,0,0,0,413,A
7-M,300,0,412,0,1,413,T
7-M,301,409,0,1,0,410,A
7-M,302,0,1,409,0,410,G
7-M,303,0,0,410,0,410,G
7-M,304,406,0,0,0,406,A
7-M,305,408,0,0,0,408,A
7-M,306,380,0,0,0,380,A
7-M,307,1,0,0,385,386,C
7-M,308,0,384,0,0,384,T
7-M,309,0,385,0,0,385,T
7-M,310,385,0,0,0,385,A
7-M,311,384,0,1,0,385,A
7-M,312,0,0,385,0,385,G
7-M,313,383,0,0,0,383,A
7-M,314,0,1,383,0,384,G
7-M,315,365,0,0,0,365,A
7-M,316,0,0,376,0,376,G
7-M,317,378,0,0,0,378,A
7-M,318,0,0,380,0,380,G
7-M,319,381,0,1,0,382,A
7-M,320,0,382,0,0,382,T
7-M,321,382,0,0,0,382,A
7-M,322,386,0,0,0,386,A
7-M,323,0,0,0,386,386,C
7-M,324,0,0,390,0,390,G
7-M,325,0,386,0,1,387,T
7-M,326,1,381,0,1,383,T
7-M,327,0,0,0,389,389,C
7-M,328,1,0,0,387,388,C
7-M,329,387,0,0,0,387,A
7-M,330,1,386,1,0,388,T
7-M,331,0,2,383,0,385,G
7-M,332,5,1,384,0,390,G
7-M,333,0,0,385,0,385,G
7-M,334,1,0,384,0,385,G
7-M,335,0,0,0,384,384,C
7-M,336,1,0,0,383,384,C
7-M,337,385,0,0,0,385,A
7-M,338,389,0,0,0,389,A
7-M,339,390,0,2,0,392,A
7-M,340,0,0,396,1,397,G
7-M,341,399,0,0,0,399,A
7-M,342,396,0,1,0,397,A
7-M,343,397,0,0,0,397,A
7-M,344,0,396,0,0,396,T
7-M,345,395,0,0,0,395,A
7-M,346,0,1,401,0,402,G
7-M,347,0,0,0,400,400,C
7-M,348,0,398,1,0,399,T
7-M,349,0,0,1,401,402,C
7-M,350,0,398,0,0,398,T
7-M,351,0,0,0,412,412,C
7-M,352,412,0,0,0,412,A
7-M,353,1,0,411,0,412,G
7-M,354,0,407,0,1,408,T
7-M,355,0,416,0,0,416,T
7-M,356,418,0,0,0,418,A
7-M,357,0,420,0,0,420,T
7-M,358,0,420,0,0,420,T
7-M,359,1,0,0,421,422,C
7-M,360,1,402,0,1,404,T
7-M,361,0,0,409,0,409,G
7-M,362,0,0,0,410,410,C
7-M,363,0,405,0,0,405,T
7-M,364,0,1,404,0,405,G
7-M,365,1,0,402,0,403,G
7-M,366,0,401,0,0,401,T
7-M,367,0,0,402,0,402,G
7-M,368,0,0,0,401,401,C
7-M,369,400,0,1,0,401,A
7-M,370,0,0,0,402,402,C
7-M,371,0,395,0,0,395,T
7-M,372,0,406,0,0,406,T
7-M,373,0,0,405,0,405,G
7-M,374,0,0,0,405,405,C
7-M,375,0,0,0,406,406,C
7-M,376,405,0,0,0,405,A
7-M,377,0,0,412,0,412,G
7-M,378,0,414,0,0,414,T
7-M,379,0,409,0,0,409,T
7-M,380,0,0,408,0,408,G
7-M,381,0,403,0,0,403,T
7-M,382,412,0,0,0,412,A
7-M,383,0,413,0,0,413,T
7-M,384,0,2,410,0,412,G
7-M,385,0,1,415,0,416,G
7-M,386,0,0,411,0,411,G
7-M,387,0,0,0,415,415,C
7-M,388,0,0,0,426,426,C
7-M,389,0,420,0,0,420,T
7-M,390,0,0,0,428,428,C
7-M,391,432,1,7,0,440,A
7-M,392,0,441,0,0,441,T
7-M,393,457,0,0,0,457,A
7-M,394,0,451,0,0,451,T
7-M,395,442,0,1,0,443,A
7-M,396,0,0,0,474,474,C
7-M,397,457,0,0,0,457,A
7-M,398,462,0,1,0,463,A
7-M,399,0,460,0,0,460,T
7-M,400,441,0,0,0,441,A
7-M,401,0,0,444,0,444,G
7-M,402,0,0,438,0,438,G
7-M,403,436,1,0,0,437,A
7-M,404,0,436,0,0,436,T
7-M,405,0,2,407,0,409,G
7-M,406,0,0,409,0,409,G
7-M,407,0,1,408,0,409,G
7-M,408,0,0,410,0,410,G
7-M,409,0,0,408,0,408,G
7-M,410,0,0,0,405,405,C
7-M,411,0,402,0,0,402,T
7-M,412,0,1,404,0,405,G
7-M,413,0,405,0,0,405,T
7-M,414,407,0,0,0,407,A
7-M,415,407,0,0,0,407,A
7-M,416,0,0,0,410,410,C
7-M,417,0,0,0,406,406,C
7-M,418,399,0,0,1,400,A
7-M,419,1,0,0,402,403,C
7-M,420,0,400,0,1,401,T
7-M,421,0,0,404,0,404,G
7-M,422,401,0,0,1,402,A
7-M,423,398,0,0,1,399,A
7-M,424,0,0,397,0,397,G
7-M,425,0,395,0,0,395,T
7-M,426,1,1,393,0,395,G
7-M,427,0,0,396,0,396,G
7-M,428,0,0,0,397,397,C
7-M,429,397,0,0,0,397,A
7-M,430,1,395,0,0,396,T
7-M,431,0,396,0,0,396,T
7-M,432,0,396,0,0,396,T
7-M,433,0,0,408,0,408,G
7-M,434,0,0,408,0,408,G
7-M,435,0,0,0,409,409,C
7-M,436,1,0,0,408,409,C
7-M,437,0,407,0,0,407,T
7-M,438,0,0,426,0,426,G
7-M,439,0,0,429,0,429,G
7-M,440,0,428,0,0,428,T
7-M,441,429,0,1,0,430,A
7-M,442,0,408,0,0,408,T
7-M,443,0,0,419,0,419,G
7-M,444,1,416,0,0,417,T
7-M,445,0,0,417,0,417,G
7-M,446,0,0,0,417,417,C
7-M,447,404,0,0,0,404,A
7-M,448,400,0,0,0,400,A
7-M,449,0,0,0,404,404,C
7-M,450,401,0,0,0,401,A
7-M,451,0,401,0,0,401,T
7-M,452,0,0,394,0,394,G
7-M,453,0,383,0,1,384,T
7-M,454,0,2,382,0,384,G
7-M,455,383,0,0,0,383,A
7-M,456,0,0,384,0,384,G
7-M,457,0,0,0,383,383,C
7-M,458,376,0,1,0,377,A
7-M,459,0,0,380,0,380,G
7-M,460,380,0,0,0,380,A
7-M,461,0,381,1,0,382,T
7-M,462,0,382,0,0,382,T
7-M,463,0,0,379,0,379,G
7-M,464,0,0,0,378,378,C
7-M,465,0,375,0,1,376,T
7-M,466,0,2,375,0,377,G
7-M,467,376,0,0,0,376,A
7-M,468,0,0,0,394,394,C
7-M,469,0,394,0,0,394,T
7-M,470,0,0,0,396,396,C
7-M,471,0,0,0,396,396,C
7-M,472,2,0,0,395,397,C
7-M,473,393,1,1,0,395,A
7-M,474,0,0,396,0,396,G
7-M,475,0,0,0,394,394,C
7-M,476,395,0,0,0,395,A
7-M,477,0,0,0,396,396,C
7-M,478,370,1,0,0,371,A
7-M,479,0,2,383,0,385,G
7-M,480,0,0,384,0,384,G
7-M,481,1,383,0,0,384,T
7-M,482,1,0,0,398,399,C
7-M,483,0,393,0,0,393,T
7-M,484,1,0,0,396,397,C
7-M,485,395,0,0,0,395,A
7-M,486,0,397,0,0,397,T
7-M,487,398,0,0,0,398,A
7-M,488,0,1,392,0,393,G
7-M,489,0,0,392,0,392,G
7-M,490,0,0,0,391,391,C
7-M,491,384,0,1,0,385,A
7-M,492,0,0,382,0,382,G
7-M,493,385,0,0,0,385,A
7-M,494,0,385,0,0,385,T
7-M,495,0,0,385,0,385,G
7-M,496,0,0,385,0,385,G
7-M,497,0,379,0,0,379,T
7-M,498,0,0,383,0,383,G
7-M,499,0,0,384,0,384,G
7-M,500,0,0,0,381,381,C
7-M,501,382,0,1,0,383,A
7-M,502,383,0,0,0,383,A
7-M,503,0,0,0,390,390,C
7-M,504,389,0,0,0,389,A
7-M,505,388,0,0,0,388,A
7-M,506,0,0,0,388,388,C
7-M,507,0,0,0,386,386,C
7-M,508,383,0,0,0,383,A
7-M,509,384,0,0,0,384,A
7-M,510,0,384,0,0,384,T
7-M,511,2,0,0,381,383,C
7-M,512,0,0,0,378,378,C
7-M,513,376,0,0,0,376,A
7-M,514,0,375,0,0,375,T
7-M,515,0,373,0,0,373,T
7-M,516,373,0,0,0,373,A
7-M,517,374,0,0,0,374,A
7-M,518,0,375,0,0,375,T
7-M,519,372,0,0,0,372,A
7-M,520,371,0,0,0,371,A
7-M,521,369,0,0,0,369,A
7-M,522,374,0,0,0,374,A
7-M,523,0,0,0,379,379,C
7-M,524,379,0,0,0,379,A
7-M,525,0,378,0,0,378,T
7-M,526,0,0,378,0,378,G
7-M,527,374,0,1,0,375,A
7-M,528,0,0,377,0,377,G
7-M,529,379,0,0,0,379,A
7-M,530,378,0,0,0,378,A
7-M,531,0,0,0,382,382,C
7-M,532,370,0,0,0,370,A
7-M,533,0,0,372,0,372,G
7-M,534,369,0,0,0,369,A
7-M,535,370,0,0,0,370,A
7-M,536,1,369,0,0,370,T
7-M,537,0,1,363,0,364,G
7-M,538,0,0,363,0,363,G
7-M,539,0,359,0,0,359,T
7-M,540,0,345,0,1,346,T
7-M,541,0,359,0,0,359,T
7-M,542,0,359,0,0,359,T
7-M,543,0,0,363,0,363,G
7-M,544,1,0,360,0,361,G
7-M,545,0,1,0,359,360,C
7-M,546,0,0,0,360,360,C
7-M,547,352,0,0,0,352,A
7-M,548,0,0,375,0,375,G
7-M,549,0,0,0,376,376,C
7-M,550,379,0,0,0,379,A
7-M,551,0,0,0,387,387,C
7-M,552,0,380,0,0,380,T
7-M,553,381,0,0,0,381,A
7-M,554,1,1,0,379,381,C
7-M,555,381,0,0,0,381,A
7-M,556,0,1,388,0,389,G
7-M,557,0,0,0,387,387,C
7-M,558,0,377,0,0,377,T
7-M,559,377,0,1,0,378,A
7-M,560,376,0,0,0,376,A
7-M,561,0,0,378,0,378,G
7-M,562,0,0,378,0,378,G
7-M,563,0,0,0,381,381,C
7-M,564,0,358,0,0,358,T
7-M,565,355,0,0,0,355,A
7-M,566,0,354,0,0,354,T
7-M,567,0,0,352,0,352,G
7-M,568,0,1,354,0,355,G
7-M,569,352,0,0,0,352,A
7-M,570,0,0,354,0,354,G
7-M,571,0,0,0,341,341,C
7-M,572,341,0,0,0,341,A
7-M,573,340,0,0,0,340,A
7-M,574,334,0,1,0,335,A
7-M,575,0,342,0,0,342,T
7-M,576,1,0,342,0,343,G
7-M,577,0,0,341,0,341,G
7-M,578,2,0,0,338,340,C
7-M,579,0,339,0,0,339,T
7-M,580,0,0,341,0,341,G
7-M,581,0,0,344,0,344,G
7-M,582,344,0,0,0,344,A
7-M,583,0,343,0,0,343,T
7-M,584,0,0,0,334,334,C
7-M,585,335,0,0,0,335,A
7-M,586,336,0,0,0,336,A
7-M,587,0,0,337,0,337,G
7-M,588,0,340,0,0,340,T
7-M,589,1,0,338,0,339,G
7-M,590,332,0,0,0,332,A
7-M,591,328,0,1,0,329,A
7-M,592,0,0,0,336,336,C
7-M,593,337,0,0,0,337,A
7-M,594,0,0,338,0,338,G
7-M,595,2,0,330,0,332,G
7-M,596,0,0,0,336,336,C
7-M,597,329,0,0,0,329,A
7-M,598,0,0,330,0,330,G
7-M,599,0,0,0,330,330,C
7-M,600,0,1,329,0,330,G
7-M,601,0,0,330,0,330,G
7-M,602,328,0,0,0,328,A
7-M,603,0,1,336,0,337,G
7-M,604,0,0,339,0,339,G
7-M,605,0,1,0,335,336,C
7-M,606,0,0,0,336,336,C
7-M,607,333,0,0,0,333,A
7-M,608,0,334,0,0,334,T
7-M,609,0,0,335,0,335,G
7-M,610,0,3,331,0,334,G
7-M,611,332,0,0,0,332,A
7-M,612,0,0,330,0,330,G
7-M,613,326,0,0,0,326,A
7-M,614,0,342,0,0,342,T
7-M,615,0,340,1,0,341,T
7-M,616,0,0,342,0,342,G
7-M,617,0,0,0,340,340,C
7-M,618,0,341,0,0,341,T
7-M,619,343,0,0,0,343,A
7-M,620,0,0,343,0,343,G
7-M,621,1,342,0,0,343,T
7-M,622,1,0,0,342,343,C
7-M,623,330,1,2,0,333,A
7-M,624,0,0,335,1,336,G
7-M,625,0,0,336,0,336,G
7-M,626,0,0,0,335,335,C
7-M,627,0,0,0,332,332,C
7-M,628,328,0,1,0,329,A
7-M,629,0,0,334,0,334,G
7-M,630,0,0,336,0,336,G
7-M,631,0,0,0,336,336,C
7-M,632,335,0,0,0,335,A
7-M,633,0,0,329,0,329,G
7-M,634,325,0,0,0,325,A
7-M,635,1,327,0,0,328,T
7-M,636,1,0,330,0,331,G
7-M,637,0,0,337,0,337,G
7-M,638,0,332,0,0,332,T
7-M,639,1,0,329,0,330,G
7-M,640,0,0,0,331,331,C
7-M,641,329,1,1,0,331,A
7-M,642,0,0,334,0,334,G
7-M,643,0,0,335,0,335,G
7-M,644,0,0,0,330,330,C
7-M,645,333,0,1,0,334,A
7-M,646,327,0,0,0,327,A
7-M,647,0,322,0,0,322,T
7-M,648,0,1,322,0,323,G
7-M,649,324,0,0,0,324,A
7-M,650,0,0,321,0,321,G
7-M,651,318,0,1,0,319,A
7-M,652,0,0,319,0,319,G
7-M,653,0,0,0,323,323,C
7-M,654,0,0,0,330,330,C
7-M,655,334,0,0,0,334,A
7-M,656,0,333,0,0,333,T
7-M,657,0,333,0,0,333,T
7-M,658,0,0,335,0,335,G
7-M,659,0,2,332,0,334,G
7-M,660,1,1,332,0,334,G
7-M,661,334,0,0,0,334,A
7-M,662,0,0,0,334,334,C
7-M,663,0,323,0,0,323,T
7-M,664,2,0,0,322,324,C
7-M,665,322,0,0,0,322,A
7-M,666,0,342,0,0,342,T
7-M,667,1,0,0,342,343,C
7-M,668,1,0,0,338,339,C
7-M,669,0,337,0,1,338,T
7-M,670,335,0,0,0,335,A
7-M,671,0,0,338,0,338,G
7-M,672,0,352,0,0,352,T
7-M,673,0,347,0,0,347,T
7-M,674,0,0,0,344,344,C
7-M,675,0,0,0,332,332,C
7-M,676,329,0,1,0,330,A
7-M,677,0,0,336,0,336,G
7-M,678,0,336,0,0,336,T
7-M,679,335,0,0,0,335,A
7-M,680,1,0,0,331,332,C
7-M,681,1,311,0,0,312,T
7-M,682,0,2,327,0,329,G
7-M,683,0,0,327,0,327,G
7-M,684,0,327,0,0,327,T
7-M,685,0,321,0,0,321,T
7-M,686,0,326,0,0,326,T
7-M,687,327,0,0,0,327,A
7-M,688,325,0,1,0,326,A
7-M,689,0,1,327,0,328,G
7-M,690,323,0,0,0,323,A
7-M,691,0,0,316,0,316,G
7-M,692,305,0,0,0,305,A
7-M,693,0,304,0,0,304,T
7-M,694,0,3,302,0,305,G
7-M,695,305,1,0,0,306,A
7-M,696,1,301,0,0,302,T
7-M,697,3,0,0,303,306,C
7-M,698,0,305,0,0,305,T
7-M,699,0,305,0,0,305,T
7-M,700,0,1,0,307,308,C
7-M,701,0,305,0,0,305,T
7-M,702,0,308,0,0,308,T
7-M,703,0,0,305,0,305,G
7-M,704,304,0,0,1,305,A
7-M,705,306,1,0,0,307,A
7-M,706,303,0,0,1,304,A
7-M,707,306,0,0,0,306,A
7-M,708,0,303,0,0,303,T
7-M,709,0,306,0,0,306,T
7-M,710,0,306,0,0,306,T
7-M,711,0,0,307,0,307,G
7-M,712,0,0,0,307,307,C
7-M,713,306,0,0,0,306,A
7-M,714,0,1,308,0,309,G
7-M,715,308,0,0,0,308,A
7-M,716,0,0,0,314,314,C
7-M,717,0,0,0,313,313,C
7-M,718,0,313,0,0,313,T
7-M,719,319,0,0,0,319,A
7-M,720,0,319,0,0,319,T
7-M,721,2,0,0,318,320,C
7-M,722,320,0,0,0,320,A
7-M,723,0,0,318,0,318,G
7-M,724,318,0,0,0,318,A
7-M,725,307,0,1,0,308,A
7-M,726,307,0,0,0,307,A
7-M,727,0,1,0,308,309,C
7-M,728,0,0,308,0,308,G
7-M,729,306,0,0,0,306,A
7-M,730,307,0,0,0,307,A
7-M,731,0,305,0,0,305,T
7-M,732,0,1,305,0,306,G
7-M,733,0,0,308,0,308,G
7-M,734,0,1,307,0,308,G
7-M,735,1,1,306,0,308,G
7-M,736,0,1,311,0,312,G
7-M,737,0,299,0,0,299,T
7-M,738,0,0,299,0,299,G
7-M,739,0,0,0,299,299,C
7-M,740,298,0,0,0,298,A
7-M,741,0,0,299,0,299,G
7-M,742,293,0,1,0,294,A
7-M,743,0,294,0,0,294,T
7-M,744,0,1,295,0,296,G
7-M,745,0,0,0,292,292,C
7-M,746,291,0,0,0,291,A
7-M,747,292,0,0,0,292,A
7-M,748,0,0,0,293,293,C
7-M,749,0,1,292,0,293,G
7-M,750,292,0,0,0,292,A
7-M,751,0,286,0,2,288,T
7-M,752,0,291,0,0,291,T
7-M,753,1,0,0,291,292,C
7-M,754,292,0,0,0,292,A
7-M,755,294,0,0,0,294,A
7-M,756,0,0,293,0,293,G
7-M,757,0,287,0,0,287,T
7-M,758,0,0,287,0,287,G
7-M,759,283,1,0,0,284,A
7-M,760,0,0,0,284,284,C
7-M,761,0,0,0,287,287,C
7-M,762,1,0,0,284,285,C
7-M,763,1,0,284,0,285,G
7-M,764,0,0,0,282,282,C
7-M,765,0,286,0,0,286,T
7-M,766,0,286,0,0,286,T
7-M,767,0,0,285,0,285,G
7-M,768,0,286,0,0,286,T
7-M,769,0,283,0,0,283,T
7-M,770,0,0,284,0,284,G
7-M,771,0,280,0,0,280,T
7-M,772,1,274,0,0,275,T
7-M,773,0,0,277,0,277,G
7-M,774,1,0,0,274,275,C
7-M,775,0,0,1,276,277,C
7-M,776,0,0,277,0,277,G
7-M,777,0,0,0,274,274,C
7-M,778,0,0,279,0,279,G
7-M,779,279,0,0,0,279,A
7-M,780,277,0,0,0,277,A
7-M,781,0,279,0,1,280,T
7-M,782,282,0,0,0,282,A
7-M,783,0,283,0,0,283,T
7-M,784,1,0,0,283,284,C
7-M,785,279,2,0,0,281,A
7-M,786,0,283,0,0,283,T
7-M,787,0,279,0,0,279,T
7-M,788,0,2,274,0,276,G
7-M,789,0,1,270,1,272,G
7-M,790,0,0,272,0,272,G
7-M,791,274,0,0,0,274,A
7-M,792,1,269,0,0,270,T
7-M,793,0,0,0,263,263,C
7-M,794,0,264,0,0,264,T
7-M,795,0,262,0,0,262,T
7-M,796,0,0,265,0,265,G
7-M,797,1,0,0,265,266,C
7-M,798,270,0,0,0,270,A
7-M,799,0,0,0,271,271,C
7-M,800,0,262,0,1,263,T
7-M,801,0,265,0,0,265,T
7-M,802,0,0,266,0,266,G
7-M,803,273,0,0,0,273,A
7-M,804,0,271,0,0,271,T
7-M,805,268,0,0,0,268,A
7-M,806,0,267,0,0,267,T
7-M,807,1,264,0,0,265,T
7-M,808,0,0,264,0,264,G
7-M,809,0,263,0,0,263,T
7-M,810,0,0,263,0,263,G
7-M,811,0,0,263,0,263,G
7-M,812,259,0,0,0,259,A
7-M,813,0,258,0,0,258,T
7-M,814,0,260,0,0,260,T
7-M,815,0,0,0,262,262,C
7-M,816,0,259,0,0,259,T
7-M,817,0,259,0,0,259,T
7-M,818,0,0,258,0,258,G
7-M,819,257,0,0,0,257,A
7-M,820,0,258,0,0,258,T
7-M,821,2,0,0,254,256,C
7-M,822,0,0,255,0,255,G
7-M,823,0,256,0,0,256,T
7-M,824,0,0,0,257,257,C
7-M,825,0,251,0,1,252,T
7-M,826,0,256,1,0,257,T
7-M,827,0,256,1,0,257,T
7-M,828,0,253,1,0,254,T
7-M,829,0,256,0,0,256,T
7-M,830,0,254,1,0,255,T
7-M,831,0,255,1,0,256,T
7-M,832,0,0,0,256,256,C
7-M,833,253,0,0,0,253,A
7-M,834,256,0,0,0,256,A
7-M,835,256,0,0,0,256,A
7-M,836,0,255,1,0,256,T
7-M,837,0,0,256,0,256,G
7-M,838,0,0,0,256,256,C
7-M,839,254,0,0,0,254,A
7-M,840,0,259,0,1,260,T
7-M,841,0,0,0,262,262,C
7-M,842,0,261,1,0,262,T
7-M,843,262,0,0,0,262,A
7-M,844,0,261,0,0,261,T
7-M,845,1,0,0,258,259,C
7-M,846,0,0,258,0,258,G
7-M,847,258,0,0,0,258,A
7-M,848,0,0,0,259,259,C
7-M,849,0,248,0,1,249,T
7-M,850,2,0,0,250,252,C
7-M,851,0,252,0,0,252,T
7-M,852,0,250,0,0,250,T
7-M,853,0,0,0,251,251,C
7-M,854,251,0,0,0,251,A
7-M,855,252,0,0,0,252,A
7-M,856,251,0,0,0,251,A
7-M,857,0,0,0,252,252,C
7-M,858,250,0,0,0,250,A
7-M,859,0,0,0,238,238,C
7-M,860,0,0,230,0,230,G
7-M,861,0,0,236,0,236,G
7-M,862,0,0,0,240,240,C
7-M,863,0,0,0,240,240,C
7-M,864,0,240,0,0,240,T
7-M,865,0,240,0,0,240,T
7-M,866,240,0,0,0,240,A
7-M,867,242,0,0,0,242,A
7-M,868,240,0,0,0,240,A
7-M,869,242,0,0,0,242,A
7-M,870,0,0,238,0,238,G
7-M,871,206,0,0,0,206,A
7-M,872,1,1,203,0,205,G
7-M,873,0,0,206,0,206,G
7-M,874,0,0,0,203,203,C
7-M,875,1,0,0,204,205,C
7-M,876,1,0,0,206,207,C
7-M,877,0,207,0,2,209,T
7-M,878,0,210,0,0,210,T
7-M,879,0,0,0,208,208,C
7-M,880,0,209,0,0,209,T
7-M,881,210,0,0,0,210,A
7-M,882,0,0,0,211,211,C
7-M,883,1,0,209,0,210,G
7-M,884,0,0,209,0,209,G
7-M,885,200,0,0,0,200,A
7-M,886,200,0,0,0,200,A
7-M,887,0,0,201,0,201,G
7-M,888,0,0,202,0,202,G
7-M,889,198,0,0,0,198,A
7-M,890,0,0,198,0,198,G
7-M,891,0,197,0,0,197,T
7-M,892,198,0,0,0,198,A
7-M,893,0,0,0,197,197,C
7-M,894,0,0,0,193,193,C
7-M,895,0,193,0,1,194,T
7-M,896,0,0,190,0,190,G
7-M,897,178,0,0,0,178,A
7-M,898,0,0,179,0,179,G
7-M,899,0,174,0,0,174,T
7-M,900,0,0,0,171,171,C
7-M,901,0,164,0,0,164,T
7-M,902,164,0,0,0,164,A
7-M,903,0,163,0,0,163,T
7-M,904,0,0,163,0,163,G
7-M,905,162,0,0,0,162,A
7-M,906,0,0,164,0,164,G
7-M,907,0,2,148,0,150,G
7-M,908,0,0,149,0,149,G
7-M,909,147,0,0,0,147,A
7-M,910,147,0,0,0,147,A
7-M,911,0,0,147,0,147,G
7-M,912,145,0,0,0,145,A
7-M,913,147,0,0,0,147,A
7-M,914,0,145,0,0,145,T
7-M,915,142,0,0,0,142,A
7-M,916,0,142,0,0,142,T
7-M,917,0,2,0,138,140,C
7-M,918,0,0,141,0,141,G
7-M,919,139,0,0,0,139,A
7-M,920,137,0,0,0,137,A
7-M,921,135,0,2,0,137,A
7-M,922,0,0,137,0,137,G
7-M,923,0,0,138,0,138,G
7-M,924,137,0,0,0,137,A
7-M,925,137,0,0,0,137,A
7-M,926,0,0,0,137,137,C
7-M,927,137,0,0,0,137,A
7-M,928,0,0,139,0,139,G
7-M,929,0,0,0,139,139,C
7-M,930,139,0,0,0,139,A
7-M,931,0,0,139,0,139,G
7-M,932,132,0,0,0,132,A
7-M,933,133,0,0,0,133,A
7-M,934,0,132,0,0,132,T
7-M,935,0,0,129,0,129,G
7-M,936,0,0,0,130,130,C
7-M,937,0,121,0,0,121,T
7-M,938,0,0,121,0,121,G
7-M,939,0,119,0,1,120,T
7-M,940,0,0,119,0,119,G
7-M,941,0,0,119,0,119,G
7-M,942,116,0,0,0,116,A
7-M,943,0,116,0,0,116,T
7-M,944,0,0,111,0,111,G
7-M,945,0,0,0,108,108,C
7-M,946,0,102,0,0,102,T
7-M,947,0,2,98,0,100,G
7-M,948,101,0,0,0,101,A
7-M,949,0,0,0,99,99,C
7-M,950,0,0,97,0,97,G
7-M,951,95,0,0,0,95,A
7-M,952,0,0,0,96,96,C
7-M,953,94,0,0,0,94,A
7-M,954,0,0,94,0,94,G
7-M,955,0,94,0,0,94,T
7-M,956,0,0,0,91,91,C
7-M,957,92,0,0,0,92,A
7-M,958,0,92,0,0,92,T
7-M,959,0,92,0,0,92,T
7-M,960,0,91,0,0,91,T
7-M,961,0,89,0,0,89,T
7-M,962,0,0,89,0,89,G
7-M,963,0,87,0,0,87,T
7-M,964,0,0,0,87,87,C
7-M,965,83,0,0,0,83,A
7-M,966,0,0,83,0,83,G
7-M,967,0,0,0,83,83,C
7-M,968,83,0,0,0,83,A
7-M,969,0,83,0,0,83,T
7-M,970,82,0,0,0,82,A
7-M,971,0,0,82,0,82,G
7-M,972,80,0,0,0,80,A
7-M,973,0,0,80,0,80,G
7-M,974,0,79,0,0,79,T
7-M,975,0,45,0,0,45,T
7-M,976,0,0,44,0,44,G
7-M,977,0,0,44,0,44,G
7-M,978,44,0,0,0,44,A
7-M,979,0,0,44,0,44,G
7-M,980,0,32,0,0,32,T
7-M,981,31,0,0,0,31,A
7-M,982,30,0,0,0,30,A
8-NS,1,582,0,0,0,582,A
8-NS,2,0,584,0,0,584,T
8-NS,3,0,0,623,0,623,G
8-NS,4,0,0,669,0,669,G
8-NS,5,722,0,1,0,723,A
8-NS,6,0,1494,0,0,1494,T
8-NS,7,1,1494,0,1,1496,T
8-NS,8,1,0,0,1551,1552,C
8-NS,9,1,1,0,1552,1554,C
8-NS,10,1557,0,0,0,1557,A
8-NS,11,1567,0,0,0,1567,A
8-NS,12,0,1,0,1573,1574,C
8-NS,13,1573,0,2,0,1575,A
8-NS,14,0,0,0,1591,1591,C
8-NS,15,0,1596,0,2,1598,T
8-NS,16,0,0,1761,0,1761,G
8-NS,17,0,1761,0,2,1763,T
8-NS,18,2,1,1773,0,1776,G
8-NS,19,1,1774,0,1,1776,T
8-NS,20,7,0,0,1771,1778,C
8-NS,21,1781,0,1,0,1782,A
8-NS,22,1779,1,0,0,1780,A
8-NS,23,1,0,1803,0,1804,G
8-NS,24,0,1836,1,1,1838,T
8-NS,25,2,1833,1,2,1838,T
8-NS,26,0,1857,0,1,1858,T
8-NS,27,0,0,0,1854,1854,C
8-NS,28,0,1,0,1865,1866,C
8-NS,29,1868,2,0,0,1870,A
8-NS,30,0,5,1882,0,1887,G
8-NS,31,0,4,1894,0,1898,G
8-NS,32,0,1897,0,0,1897,T
8-NS,33,1901,0,0,0,1901,A
8-NS,34,0,2,1913,0,1915,G
8-NS,35,1909,0,1,0,1910,A
8-NS,36,0,1925,0,0,1925,T
8-NS,37,0,1920,0,0,1920,T
8-NS,38,0,0,1948,0,1948,G
8-NS,39,0,0,1,1946,1947,C
8-NS,40,0,1945,0,4,1949,T
8-NS,41,0,1968,0,1,1969,T
8-NS,42,0,1981,0,2,1983,T
8-NS,43,1,1,0,2024,2026,C
8-NS,44,0,2026,0,0,2026,T
8-NS,45,0,2027,0,0,2027,T
8-NS,46,0,2028,0,0,2028,T
8-NS,47,0,4,2041,0,2045,G
8-NS,48,0,1,2051,0,2052,G
8-NS,49,0,0,0,2052,2052,C
8-NS,50,2048,0,0,0,2048,A
8-NS,51,0,2050,0,0,2050,T
8-NS,52,2059,1,0,0,2060,A
8-NS,53,0,2245,0,1,2246,T
8-NS,54,0,0,0,2261,2261,C
8-NS,55,4,2,1,2251,2258,C
8-NS,56,0,1,2258,0,2259,G
8-NS,57,0,2252,0,0,2252,T
8-NS,58,2287,0,0,1,2288,A
8-NS,59,2290,1,0,1,2292,A
8-NS,60,2298,0,0,0,2298,A
8-NS,61,0,0,0,2310,2310,C
8-NS,62,2256,0,0,0,2256,A
8-NS,63,2252,1,2,1,2256,A
8-NS,64,1,2,2356,0,2359,G
8-NS,65,0,2367,0,1,2368,T
8-NS,66,0,2361,0,2,2363,T
8-NS,67,2,1,2371,0,2374,G
8-NS,68,0,2373,0,1,2374,T
8-NS,69,2381,1,3,0,2385,A
8-NS,70,0,2,2403,0,2405,G
8-NS,71,2522,1,7,2,2532,A
8-NS,72,1,2,0,2545,2548,C
8-NS,73,3,0,0,2528,2531,C
8-NS,74,2539,1,2,1,2543,A
8-NS,75,2558,2,0,0,2560,A
8-NS,76,1,2,2697,0,2700,G
8-NS,77,2697,1,2,0,2700,A
8-NS,78,2722,0,2,0,2724,A
8-NS,79,0,0,0,2730,2730,C
8-NS,80,0,2676,0,1,2677,T
8-NS,81,1,5,2700,0,2706,G
8-NS,82,2701,1,7,0,2709,A
8-NS,83,0,1,2759,1,2761,G
8-NS,84,1,2759,0,1,2761,T
8-NS,85,0,3,2734,0,2737,G
8-NS,86,2748,0,1,0,2749,A
8-NS,87,0,2741,0,1,2742,T
8-NS,88,2,0,2770,0,2772,G
8-NS,89,0,2,0,2805,2807,C
8-NS,90,3,1,2,2804,2810,C
8-NS,91,7,0,0,2814,2821,C
8-NS,92,5,0,0,2798,2803,C
8-NS,93,2813,0,0,0,2813,A
8-NS,94,0,2874,0,1,2875,T
8-NS,95,0,2909,0,1,2910,T
8-NS,96,0,0,0,2929,2929,C
8-NS,97,4,0,1,2908,2913,C
8-NS,98,2,2903,0,4,2909,T
8-NS,99,1,2898,0,0,2899,T
8-NS,100,0,8,2899,0,2907,G
8-NS,101,2900,0,1,0,2901,A
8-NS,102,0,2903,0,2,2905,T
8-NS,103,5,0,1,2888,2894,C
8-NS,104,2,3,2876,0,2881,G
8-NS,105,0,0,2901,0,2901,G
8-NS,106,0,0,0,2909,2909,C
8-NS,107,0,2895,0,10,2905,T
8-NS,108,0,2911,0,0,2911,T
8-NS,109,4,0,0,2910,2914,C
8-NS,110,2,0,2924,0,2926,G
8-NS,111,1,2,0,2925,2928,C
8-NS,112,3,1,0,2924,2928,C
8-NS,113,1,2,2933,0,2936,G
8-NS,114,2909,0,0,0,2909,A
8-NS,115,1,4,3003,0,3008,G
8-NS,116,3007,0,2,0,3009,A
8-NS,117,1,3007,0,1,3009,T
8-NS,118,5,0,0,3009,3014,C
8-NS,119,3004,3,0,0,3007,A
8-NS,120,0,3,3010,0,3013,G
8-NS,121,2992,1,2,0,2995,A
8-NS,122,0,7,3007,0,3014,G
8-NS,123,0,1,3049,0,3050,G
8-NS,124,0,3072,0,1,3073,T
8-NS,125,4,1,0,3250,3255,C
8-NS,126,9,1,1,3248,3259,C
8-NS,127,9,0,0,3257,3266,C
8-NS,128,1,3268,0,1,3270,T
8-NS,129,3277,0,0,0,3277,A
8-NS,130,3268,0,2,1,3271,A
8-NS,131,1,13,3300,0,3314,G
8-NS,132,1,10,3304,1,3316,G
8-NS,133,1,3,3274,0,3278,G
8-NS,134,0,4,3207,0,3211,G
8-NS,135,3202,2,0,0,3204,A
8-NS,136,3201,0,1,0,3202,A
8-NS,137,1,4,3210,0,3215,G
8-NS,138,3279,3,1,0,3283,A
8-NS,139,2,4,3328,0,3334,G
8-NS,140,0,1,3341,0,3342,G
8-NS,141,2,0,0,3344,3346,C
8-NS,142,3345,0,2,1,3348,A
8-NS,143,3354,1,1,1,3357,A
8-NS,144,1,3354,0,0,3355,T
8-NS,145,3378,0,0,0,3378,A
8-NS,146,3,0,0,3441,3444,C
8-NS,147,0,3364,0,4,3368,T
8-NS,148,4,0,0,3366,3370,C
8-NS,149,1,3341,0,2,3344,T
8-NS,150,4,1,0,3356,3361,C
8-NS,151,2,12,3387,0,3401,G
8-NS,152,1,1,3587,0,3589,G
8-NS,153,2,3587,0,3,3592,T
8-NS,154,5,1,0,3603,3609,C
8-NS,155,0,3591,0,1,3592,T
8-NS,156,3620,1,3,0,3624,A
8-NS,157,0,6,3617,0,3623,G
8-NS,158,3623,0,4,0,3627,A
8-NS,159,0,2,0,3725,3727,C
8-NS,160,3679,1,0,0,3680,A
8-NS,161,0,3616,0,3,3619,T
8-NS,162,3,0,0,3614,3617,C
8-NS,163,3609,1,0,0,3610,A
8-NS,164,3621,0,0,0,3621,A
8-NS,165,3597,0,1,0,3598,A
8-NS,166,1,1,3612,0,3614,G
8-NS,167,0,2,0,3625,3627,C
8-NS,168,3577,1,1,0,3579,A
8-NS,169,1,0,3608,0,3609,G
8-NS,170,1,0,0,3605,3606,C
8-NS,171,8,0,0,3612,3620,C
8-NS,172,3647,1,1,0,3649,A
8-NS,173,3,1,0,3681,3685,C
8-NS,174,3,0,0,3685,3688,C
8-NS,175,15,0,0,3674,3689,C
8-NS,176,3715,0,1,0,3716,A
8-NS,177,0,3720,0,0,3720,T
8-NS,178,0,2,3714,0,3716,G
8-NS,179,0,3708,0,1,3709,T
8-NS,180,2,3695,0,4,3701,T
8-NS,181,0,3,3704,0,3707,G
8-NS,182,1,1,3688,0,3690,G
8-NS,183,3689,0,2,0,3691,A
8-NS,184,3691,0,1,0,3692,A
8-NS,185,3657,0,2,0,3659,A
8-NS,186,3649,2,1,1,3653,A
8-NS,187,3,0,0,3669,3672,C
8-NS,188,3673,0,1,0,3674,A
8-NS,189,3662,1,0,0,3663,A
8-NS,190,3657,0,0,1,3658,A
8-NS,191,0,3689,0,0,3689,T
8-NS,192,0,3688,0,2,3690,T
8-NS,193,2,0,3756,0,3758,G
8-NS,194,0,3759,0,4,3763,T
8-NS,195,3741,0,2,0,3743,A
8-NS,196,1,2,3742,1,3746,G
8-NS,197,3734,1,1,0,3736,A
8-NS,198,3727,0,2,0,3729,A
8-NS,199,3727,0,2,0,3729,A
8-NS,200,3726,1,1,0,3728,A
8-NS,201,1,4,3741,0,3746,G
8-NS,202,3724,0,0,0,3724,A
8-NS,203,0,3717,0,0,3717,T
8-NS,204,2,3710,0,0,3712,T
8-NS,205,3,0,0,3726,3729,C
8-NS,206,2,3718,0,1,3721,T
8-NS,207,0,0,3736,1,3737,G
8-NS,208,3729,0,3,1,3733,A
8-NS,209,3732,0,0,0,3732,A
8-NS,210,3722,2,3,0,3727,A
8-NS,211,1,2,3736,0,3739,G
8-NS,212,3728,0,0,1,3729,A
8-NS,213,3735,0,1,0,3736,A
8-NS,214,0,4,3763,0,3767,G
8-NS,215,3785,0,5,0,3790,A
8-NS,216,3802,1,2,0,3805,A
8-NS,217,0,3805,0,1,3806,T
8-NS,218,2,0,0,3835,3837,C
8-NS,219,2,3823,0,4,3829,T
8-NS,220,0,4,3849,0,3853,G
8-NS,221,3850,0,2,0,3852,A
8-NS,222,0,3847,0,0,3847,T
8-NS,223,1,4,3822,0,3827,G
8-NS,224,3780,2,7,0,3789,A
8-NS,225,1,6,3774,0,3781,G
8-NS,226,2,2,3786,0,3790,G
8-NS,227,3,0,0,3777,3780,C
8-NS,228,3794,0,2,0,3796,A
8-NS,229,1,0,0,3898,3899,C
8-NS,230,2,3886,2,0,3890,T
8-NS,231,1,3916,0,1,3918,T
8-NS,232,3932,0,1,0,3933,A
8-NS,233,3948,0,0,0,3948,A
8-NS,234,3940,0,1,1,3942,A
8-NS,235,3931,0,2,0,3933,A
8-NS,236,0,3932,0,1,3933,T
8-NS,237,2,20,3915,0,3937,G
8-NS,238,3929,1,4,1,3935,A
8-NS,239,0,0,0,3936,3936,C
8-NS,240,6,3,0,3917,3926,C
8-NS,241,3925,3,2,0,3930,A
8-NS,242,0,3920,0,3,3923,T
8-NS,243,2,4,4001,0,4007,G
8-NS,244,0,2,4056,0,4058,G
8-NS,245,0,4072,0,6,4078,T
8-NS,246,4,0,1,4250,4255,C
8-NS,247,0,4224,0,10,4234,T
8-NS,248,4,2,0,4270,4276,C
8-NS,249,1,2,0,4279,4282,C
8-NS,250,4280,2,4,0,4286,A
8-NS,251,2,0,0,4315,4317,C
8-NS,252,4264,2,1,0,4267,A
8-NS,253,1,0,0,4274,4275,C
8-NS,254,9,0,1,4242,4252,C
8-NS,255,0,4112,0,7,4119,T
8-NS,256,1,1,4141,0,4143,G
8-NS,257,1,1,0,4134,4136,C
8-NS,258,1,4096,1,4,4102,T
8-NS,259,1,4132,1,2,4136,T
8-NS,260,3,2,1,4106,4112,C
8-NS,261,3,0,4122,0,4125,G
8-NS,262,1,4,0,4106,4111,C
8-NS,263,3,8,4104,0,4115,G
8-NS,264,4285,0,0,0,4285,A
8-NS,265,1,4270,0,2,4273,T
8-NS,266,4413,1,1,0,4415,A
8-NS,267,0,1,0,4438,4439,C
8-NS,268,4422,0,3,0,4425,A
8-NS,269,0,4546,0,0,4546,T
8-NS,270,4511,0,0,0,4511,A
8-NS,271,4527,0,2,0,4529,A
8-NS,272,1,0,0,4537,4538,C
8-NS,273,1,4416,0,0,4417,T
8-NS,274,3,5,4463,0,4471,G
8-NS,275,4393,0,4,1,4398,A
8-NS,276,0,2,1,4425,4428,C
8-NS,277,4418,0,1,0,4419,A
8-NS,278,0,4373,0,2,4375,T
8-NS,279,1,6,4378,0,4385,G
8-NS,280,4374,0,6,0,4380,A
8-NS,281,1,2,1,4519,4523,C
8-NS,282,1,4493,0,5,4499,T
8-NS,283,4541,1,0,0,4542,A
8-NS,284,1,4542,1,0,4544,T
8-NS,285,0,4500,0,1,4501,T
8-NS,286,1,9,4502,2,4514,G
8-NS,287,4483,1,4,0,4488,A
8-NS,288,0,9,4470,0,4479,G
8-NS,289,0,9,4462,0,4471,G
8-NS,290,4380,0,0,0,4380,A
8-NS,291,4388,0,1,1,4390,A
8-NS,292,0,4316,0,0,4316,T
8-NS,293,0,4316,0,0,4316,T
8-NS,294,3,1,4391,0,4395,G
8-NS,295,0,4401,1,1,4403,T
8-NS,296,10,0,1,4385,4396,C
8-NS,297,4391,2,1,1,4395,A
8-NS,298,4395,1,1,0,4397,A
8-NS,299,1,5,4397,0,4403,G
8-NS,300,4415,2,2,2,4421,A
8-NS,301,4423,1,0,0,4424,A
8-NS,302,4417,0,1,0,4418,A
8-NS,303,1,1,0,4417,4419,C
8-NS,304,1,4358,0,1,4360,T
8-NS,305,4,6,4438,0,4448,G
8-NS,306,0,0,4500,0,4500,G
8-NS,307,0,4496,0,2,4498,T
8-NS,308,1,4491,0,2,4494,T
8-NS,309,9,0,1,4458,4468,C
8-NS,310,4478,2,1,0,4481,A
8-NS,311,0,4527,0,3,4530,T
8-NS,312,3,3,4572,0,4578,G
8-NS,313,0,2,0,4611,4613,C
8-NS,314,1,4566,0,6,4573,T
8-NS,315,4511,1,2,0,4514,A
8-NS,316,4646,0,1,1,4648,A
8-NS,317,0,4660,0,2,4662,T
8-NS,318,1,2,4652,0,4655,G
8-NS,319,0,4,2,4645,4651,C
8-NS,320,2,1,0,4603,4606,C
8-NS,321,12,1,0,4584,4597,C
8-NS,322,4577,0,1,0,4578,A
8-NS,323,4580,0,2,1,4583,A
8-NS,324,1,0,4618,0,4619,G
8-NS,325,0,0,0,4614,4614,C
8-NS,326,4600,1,0,0,4601,A
8-NS,327,0,2,4641,1,4644,G
8-NS,328,4636,1,2,0,4639,A
8-NS,329,4635,0,3,1,4639,A
8-NS,330,4626,0,2,1,4629,A
8-NS,331,4586,0,3,2,4591,A
8-NS,332,0,4640,0,1,4641,T
8-NS,333,4,13,4637,0,4654,G
8-NS,334,1,4,4654,0,4659,G
8-NS,335,4650,0,4,0,4654,A
8-NS,336,4593,1,5,1,4600,A
8-NS,337,1,4,4584,0,4589,G
8-NS,338,0,5,4605,0,4610,G
8-NS,339,4617,2,3,0,4622,A
8-NS,340,2,1,0,4616,4619,C
8-NS,341,6,0,0,4613,4619,C
8-NS,342,2,4608,0,2,4612,T
8-NS,343,8,2,0,4675,4685,C
8-NS,344,1,4683,0,0,4684,T
8-NS,345,0,4708,0,1,4709,T
8-NS,346,2,4701,0,1,4704,T
8-NS,347,1,1,4678,0,4680,G
8-NS,348,2,2,0,4722,4726,C
8-NS,349,4685,3,2,0,4690,A
8-NS,350,1,4685,1,4,4691,T
8-NS,351,9,2,1,4672,4684,C
8-NS,352,4748,2,0,0,4750,A
8-NS,353,1,5,4869,0,4875,G
8-NS,354,4851,2,4,2,4859,A
8-NS,355,4852,3,2,0,4857,A
8-NS,356,1,4834,0,3,4838,T
8-NS,357,3,13,4776,1,4793,G
8-NS,358,7,5,4818,0,4830,G
8-NS,359,4821,0,7,0,4828,A
8-NS,360,3,0,0,4824,4827,C
8-NS,361,4,2,1,4716,4723,C
8-NS,362,4621,2,4,1,4628,A
8-NS,363,3,4,4668,0,4675,G
8-NS,364,21,1,4646,0,4668,G
8-NS,365,0,0,0,4674,4674,C
8-NS,366,4655,1,1,0,4657,A
8-NS,367,4671,1,0,1,4673,A
8-NS,368,3,4662,0,1,4666,T
8-NS,369,6,0,1,4665,4672,C
8-NS,370,4673,1,0,0,4674,A
8-NS,371,0,4652,0,2,4654,T
8-NS,372,2,8,4594,0,4604,G
8-NS,373,1,13,4623,0,4637,G
8-NS,374,4620,0,6,1,4627,A
8-NS,375,0,4,4665,0,4669,G
8-NS,376,4607,0,3,0,4610,A
8-NS,377,4616,1,2,0,4619,A
8-NS,378,4610,1,0,0,4611,A
8-NS,379,4608,0,4,0,4612,A
8-NS,380,4636,0,1,0,4637,A
8-NS,381,1,0,0,4648,4649,C
8-NS,382,4629,0,0,0,4629,A
8-NS,383,0,4664,0,0,4664,T
8-NS,384,5,1,1,4619,4626,C
8-NS,385,4618,0,1,0,4619,A
8-NS,386,1,4639,0,1,4641,T
8-NS,387,1,1,4413,235,4650,G
8-NS,388,1,4653,1,3,4658,T
8-NS,389,0,4614,1,1,4616,T
8-NS,390,1,10,4598,0,4609,G
8-NS,391,4578,2,0,0,4580,A
8-NS,392,4553,1,2,0,4556,A
8-NS,393,4552,0,2,0,4554,A
8-NS,394,0,1,4558,0,4559,G
8-NS,395,1,2,0,4534,4537,C
8-NS,396,3,9,4528,1,4541,G
8-NS,397,4542,1,0,1,4544,A
8-NS,398,4551,0,1,0,4552,A
8-NS,399,1,4541,1,1,4544,T
8-NS,400,1,4541,0,8,4550,T
8-NS,401,1,4554,0,0,4555,T
8-NS,402,5,2,0,4552,4559,C
8-NS,403,4516,0,5,0,4521,A
8-NS,404,0,2,4529,0,4531,G
8-NS,405,1,4515,0,1,4517,T
8-NS,406,0,0,4513,1,4514,G
8-NS,407,0,4498,1,5,4504,T
8-NS,408,0,7,4512,0,4519,G
8-NS,409,4546,0,1,0,4547,A
8-NS,410,1,4461,0,3,4465,T
8-NS,411,2,4537,0,1,4540,T
8-NS,412,0,4547,0,2,4549,T
8-NS,413,1,4526,0,3,4530,T
8-NS,414,2,4522,0,1,4525,T
8-NS,415,1,13,4502,0,4516,G
8-NS,416,4527,0,3,0,4530,A
8-NS,417,1,2,0,4517,4520,C
8-NS,418,3,0,0,4454,4457,C
8-NS,419,2,9,4471,0,4482,G
8-NS,420,4727,0,1,0,4728,A
8-NS,421,1,0,0,4822,4823,C
8-NS,422,1,4820,1,1,4823,T
8-NS,423,4852,1,3,0,4856,A
8-NS,424,1,2,4855,0,4858,G
8-NS,425,4859,0,8,0,4867,A
8-NS,426,1,15,4887,0,4903,G
8-NS,427,4896,1,2,2,4901,A
8-NS,428,0,0,1,5031,5032,C
8-NS,429,9,2,0,4807,4818,C
8-NS,430,4697,0,2,0,4699,A
8-NS,431,1,4936,0,0,4937,T
8-NS,432,4908,0,2,0,4910,A
8-NS,433,2,2,5297,0,5301,G
8-NS,434,1,5272,0,1,5274,T
8-NS,435,5252,0,1,0,5253,A
8-NS,436,0,5233,0,0,5233,T
8-NS,437,0,5089,1,0,5090,T
8-NS,438,5251,3,2,0,5256,A
8-NS,439,2,0,1,5247,5250,C
8-NS,440,0,5012,1,3,5016,T
8-NS,441,5001,0,3,0,5004,A
8-NS,442,4582,1,2,0,4585,A
8-NS,443,1,10,4606,0,4617,G
8-NS,444,0,12,4593,0,4605,G
8-NS,445,1,2,4604,1,4608,G
8-NS,446,0,0,0,4542,4542,C
8-NS,447,0,4453,1,9,4463,T
8-NS,448,1,4454,1,1,4457,T
8-NS,449,1,4513,0,3,4517,T
8-NS,450,1,1,3,4529,4534,C
8-NS,451,4601,0,1,0,4602,A
8-NS,452,1,3,0,4607,4611,C
8-NS,453,5,0,0,4551,4556,C
8-NS,454,1,6,4563,0,4570,G
8-NS,455,4565,0,0,1,4566,A
8-NS,456,4565,2,2,0,4569,A
8-NS,457,0,5,4581,0,4586,G
8-NS,458,4535,0,2,0,4537,A
8-NS,459,1,14,4550,0,4565,G
8-NS,460,1,10,4477,1,4489,G
8-NS,461,2,12,4511,0,4525,G
8-NS,462,4517,0,9,0,4526,A
8-NS,463,0,0,4530,0,4530,G
8-NS,464,0,1,0,4515,4516,C
8-NS,465,4514,2,5,0,4521,A
8-NS,466,4526,1,2,0,4529,A
8-NS,467,2,4420,89,0,4511,T
8-NS,468,2,4497,1,0,4500,T
8-NS,469,1,0,4499,0,4500,G
8-NS,470,0,4435,0,2,4437,T
8-NS,471,0,4428,0,1,4429,T
8-NS,472,2,4,4412,0,4418,G
8-NS,473,2,1,4422,1,4426,G
8-NS,474,3,3,1,4425,4432,C
8-NS,475,1,5,4423,0,4429,G
8-NS,476,4432,1,0,0,4433,A
8-NS,477,4449,1,1,0,4451,A
8-NS,478,4460,1,1,1,4463,A
8-NS,479,0,4470,0,0,4470,T
8-NS,480,3,2,0,4468,4473,C
8-NS,481,2,4445,1,4,4452,T
8-NS,482,9,0,0,4450,4459,C
8-NS,483,4477,1,3,0,4481,A
8-NS,484,0,4,0,4496,4500,C
8-NS,485,13,0,1,4482,4496,C
8-NS,486,4464,2,0,0,4466,A
8-NS,487,2,4451,1,3,4457,T
8-NS,488,1,4437,0,1,4439,T
8-NS,489,107,1,4332,1,4441,G
8-NS,490,1,1,1,4421,4424,C
8-NS,491,4,1,1,4421,4427,C
8-NS,492,0,4419,1,6,4426,T
8-NS,493,2,4410,0,1,4413,T
8-NS,494,1,0,0,4443,4444,C
8-NS,495,0,4425,1,0,4426,T
8-NS,496,0,4436,1,1,4438,T
8-NS,497,0,4513,1,1,4515,T
8-NS,498,2,4471,1,3,4477,T
8-NS,499,1,0,0,4485,4486,C
8-NS,500,3,4,0,4465,4472,C
8-NS,501,4459,0,3,0,4462,A
8-NS,502,0,8,4502,0,4510,G
8-NS,503,0,5,4498,0,4503,G
8-NS,504,4596,2,4,0,4602,A
8-NS,505,1,0,0,4613,4614,C
8-NS,506,4615,1,2,0,4618,A
8-NS,507,0,4624,0,2,4626,T
8-NS,508,4642,1,3,1,4647,A
8-NS,509,2,0,0,4935,4937,C
8-NS,510,0,4920,0,2,4922,T
8-NS,511,4909,0,6,0,4915,A
8-NS,512,1,4897,0,3,4901,T
8-NS,513,0,4712,0,2,4714,T
8-NS,514,1,7,4703,0,4711,G
8-NS,515,4537,0,3,0,4540,A
8-NS,516,0,6,4537,0,4543,G
8-NS,517,0,4,4534,0,4538,G
8-NS,518,4129,1,1,1,4132,A
8-NS,519,0,4121,0,4,4125,T
8-NS,520,2,1,4088,0,4091,G
8-NS,521,0,4078,1,3,4082,T
8-NS,522,10,1,0,4072,4083,C
8-NS,523,4084,0,2,0,4086,A
8-NS,524,4093,0,1,1,4095,A
8-NS,525,4080,0,1,0,4081,A
8-NS,526,4067,0,1,0,4068,A
8-NS,527,4084,3,1,0,4088,A
8-NS,528,1,4080,0,2,4083,T
8-NS,529,1,1,4073,0,4075,G
8-NS,530,1,0,0,4106,4107,C
8-NS,531,4099,0,2,1,4102,A
8-NS,532,4130,0,0,0,4130,A
8-NS,533,0,4131,0,0,4131,T
8-NS,534,2,4127,0,2,4131,T
8-NS,535,1,9,4126,0,4136,G
8-NS,536,0,16,4079,0,4095,G
8-NS,537,0,6,4096,0,4102,G
8-NS,538,0,1,4134,0,4135,G
8-NS,539,1,4061,0,2,4064,T
8-NS,540,1,2,0,4094,4097,C
8-NS,541,12,1,0,4069,4082,C
8-NS,542,1,4080,0,4,4085,T
8-NS,543,7,0,0,4126,4133,C
8-NS,544,4130,1,0,0,4131,A
8-NS,545,0,4142,0,1,4143,T
8-NS,546,6,0,0,4138,4144,C
8-NS,547,3,3,4084,0,4090,G
8-NS,548,2,4,4097,0,4103,G
8-NS,549,4025,0,2,0,4027,A
8-NS,550,0,7,4024,0,4031,G
8-NS,551,0,7,4044,0,4051,G
8-NS,552,3984,0,2,0,3986,A
8-NS,553,1,0,0,4019,4020,C
8-NS,554,0,4007,0,1,4008,T
8-NS,555,2,4007,0,0,4009,T
8-NS,556,2,6,4024,0,4032,G
8-NS,557,4016,0,2,0,4018,A
8-NS,558,4015,0,2,0,4017,A
8-NS,559,0,4002,0,0,4002,T
8-NS,560,1,10,3930,1,3942,G
8-NS,561,1,5,3965,1,3972,G
8-NS,562,3915,0,3,0,3918,A
8-NS,563,3955,0,3,1,3959,A
8-NS,564,1,4109,1,0,4111,T
8-NS,565,1,2,4160,0,4163,G
8-NS,566,4170,1,1,0,4172,A
8-NS,567,0,4175,0,0,4175,T
8-NS,568,4157,0,3,0,4160,A
8-NS,569,4180,1,5,0,4186,A
8-NS,570,0,2,0,4138,4140,C
8-NS,571,4065,0,2,0,4067,A
8-NS,572,0,1,0,4119,4120,C
8-NS,573,3770,0,0,0,3770,A
8-NS,574,0,1,3832,0,3833,G
8-NS,575,1,3790,0,8,3799,T
8-NS,576,0,3801,0,0,3801,T
8-NS,577,13,1,0,3788,3802,C
8-NS,578,3,4,3775,0,3782,G
8-NS,579,3772,2,1,0,3775,A
8-NS,580,2,0,3779,0,3781,G
8-NS,581,0,3739,0,1,3740,T
8-NS,582,3,1,0,3759,3763,C
8-NS,583,0,3683,0,5,3688,T
8-NS,584,1,0,0,3722,3723,C
8-NS,585,0,3722,2,2,3726,T
8-NS,586,3721,0,2,0,3723,A
8-NS,587,3720,0,0,0,3720,A
8-NS,588,3713,0,0,0,3713,A
8-NS,589,3739,0,1,0,3740,A
8-NS,590,3753,0,0,0,3753,A
8-NS,591,0,3708,0,0,3708,T
8-NS,592,4,0,0,3738,3742,C
8-NS,593,0,3715,0,0,3715,T
8-NS,594,3729,2,2,0,3733,A
8-NS,595,0,2,1,3730,3733,C
8-NS,596,3725,1,3,0,3729,A
8-NS,597,2,7,3725,0,3734,G
8-NS,598,3653,1,1,0,3655,A
8-NS,599,0,2,3669,0,3671,G
8-NS,600,3659,1,3,0,3663,A
8-NS,601,0,3613,1,1,3615,T
8-NS,602,1,3616,0,3,3620,T
8-NS,603,6,0,0,3608,3614,C
8-NS,604,3,1,3617,0,3621,G
8-NS,605,2,0,0,3622,3624,C
8-NS,606,0,3604,0,2,3606,T
8-NS,607,0,3624,1,1,3626,T
8-NS,608,0,4,3607,0,3611,G
8-NS,609,1,4,3616,0,3621,G
8-NS,610,3616,2,2,0,3620,A
8-NS,611,0,1,3612,0,3613,G
8-NS,612,3584,0,0,0,3584,A
8-NS,613,3568,0,3,0,3571,A
8-NS,614,1,0,3630,0,3631,G
8-NS,615,0,1,0,3634,3635,C
8-NS,616,3629,1,3,0,3633,A
8-NS,617,0,2,3686,0,3688,G
8-NS,618,0,3660,0,2,3662,T
8-NS,619,3671,0,1,0,3672,A
8-NS,620,3648,0,2,0,3650,A
8-NS,621,0,3629,0,1,3630,T
8-NS,622,0,5,3646,0,3651,G
8-NS,623,3476,0,1,0,3477,A
8-NS,624,1,1,3534,0,3536,G
8-NS,625,3506,0,1,0,3507,A
8-NS,626,3344,0,1,2,3347,A
8-NS,627,1,3327,0,2,3330,T
8-NS,628,1,10,3289,0,3300,G
8-NS,629,0,12,3289,0,3301,G
8-NS,630,1,11,3276,0,3288,G
8-NS,631,0,4,3260,0,3264,G
8-NS,632,1,4,3251,0,3256,G
8-NS,633,3155,0,5,0,3160,A
8-NS,634,2,3086,0,3,3091,T
8-NS,635,2,0,0,3185,3187,C
8-NS,636,0,3176,0,4,3180,T
8-NS,637,5,0,0,3191,3196,C
8-NS,638,10,0,0,3195,3205,C
8-NS,639,3224,0,1,0,3225,A
8-NS,640,2,1,1,3223,3227,C
8-NS,641,0,3163,1,1,3165,T
8-NS,642,0,3148,0,0,3148,T
8-NS,643,3101,1,0,0,3102,A
8-NS,644,0,0,0,3120,3120,C
8-NS,645,0,3076,1,18,3095,T
8-NS,646,1,2,0,3080,3083,C
8-NS,647,2,1,0,3036,3039,C
8-NS,648,3048,1,0,0,3049,A
8-NS,649,3060,0,0,1,3061,A
8-NS,650,3057,0,1,0,3058,A
8-NS,651,3055,0,2,1,3058,A
8-NS,652,1,2,0,3061,3064,C
8-NS,653,2966,0,0,0,2966,A
8-NS,654,0,4,2970,0,2974,G
8-NS,655,2963,0,1,0,2964,A
8-NS,656,2965,0,0,0,2965,A
8-NS,657,2961,0,0,0,2961,A
8-NS,658,1,0,0,2963,2964,C
8-NS,659,0,4,2959,0,2963,G
8-NS,660,3,4,2961,0,2968,G
8-NS,661,0,2,2967,0,2969,G
8-NS,662,2968,0,1,0,2969,A
8-NS,663,2955,1,1,0,2957,A
8-NS,664,2944,1,2,0,2947,A
8-NS,665,0,2951,0,2,2953,T
8-NS,666,1,3,2969,0,2973,G
8-NS,667,2,1,2968,0,2971,G
8-NS,668,3,4,0,2944,2951,C
8-NS,669,1,7,2943,0,2951,G
8-NS,670,2940,0,1,0,2941,A
8-NS,671,0,2,2950,0,2952,G
8-NS,672,2950,0,1,0,2951,A
8-NS,673,2948,2,2,0,2952,A
8-NS,674,0,2,0,2956,2958,C
8-NS,675,2895,0,2,1,2898,A
8-NS,676,0,1,2899,0,2900,G
8-NS,677,2,0,0,2880,2882,C
8-NS,678,1,2901,0,1,2903,T
8-NS,679,2892,0,1,1,2894,A
8-NS,680,0,3,2867,0,2870,G
8-NS,681,1,0,2875,0,2876,G
8-NS,682,2,2857,0,3,2862,T
8-NS,683,10,1,0,2805,2816,C
8-NS,684,2810,1,2,0,2813,A
8-NS,685,2805,0,2,1,2808,A
8-NS,686,2803,0,1,0,2804,A
8-NS,687,2829,1,1,0,2831,A
8-NS,688,1,0,2838,0,2839,G
8-NS,689,0,2772,0,1,2773,T
8-NS,690,0,2761,1,1,2763,T
8-NS,691,0,2771,0,0,2771,T
8-NS,692,0,4,2759,0,2763,G
8-NS,693,2766,2,3,1,2772,A
8-NS,694,2766,0,1,1,2768,A
8-NS,695,0,5,2778,0,2783,G
8-NS,696,2722,2,2,1,2727,A
8-NS,697,0,3,2742,0,2745,G
8-NS,698,2743,1,0,1,2745,A
8-NS,699,0,2747,0,1,2748,T
8-NS,700,2743,0,3,1,2747,A
8-NS,701,2735,0,2,0,2737,A
8-NS,702,0,3,2734,0,2737,G
8-NS,703,2560,0,1,1,2562,A
8-NS,704,0,2559,1,1,2561,T
8-NS,705,1,3,2566,0,2570,G
8-NS,706,0,0,2572,0,2572,G
8-NS,707,1,1,0,2559,2561,C
8-NS,708,0,2546,0,1,2547,T
8-NS,709,2546,0,1,1,2548,A
8-NS,710,2543,0,0,0,2543,A
8-NS,711,0,2551,0,0,2551,T
8-NS,712,1,2529,0,2,2532,T
8-NS,713,1,1,2542,0,2544,G
8-NS,714,2512,0,0,0,2512,A
8-NS,715,2504,0,1,0,2505,A
8-NS,716,0,4,2500,0,2504,G
8-NS,717,2500,0,1,0,2501,A
8-NS,718,2481,0,0,0,2481,A
8-NS,719,0,0,2517,0,2517,G
8-NS,720,1,2457,0,1,2459,T
8-NS,721,0,6,2460,0,2466,G
8-NS,722,2434,0,5,0,2439,A
8-NS,723,2,4,2443,1,2450,G
8-NS,724,2445,0,4,0,2449,A
8-NS,725,1,1,0,2433,2435,C
8-NS,726,2416,0,1,0,2417,A
8-NS,727,1,0,0,2404,2405,C
8-NS,728,2252,0,0,0,2252,A
8-NS,729,0,1,2298,0,2299,G
8-NS,730,2284,0,1,0,2285,A
8-NS,731,0,2265,0,1,2266,T
8-NS,732,0,2259,0,0,2259,T
8-NS,733,2263,0,1,0,2264,A
8-NS,734,2262,0,1,0,2263,A
8-NS,735,2263,0,0,0,2263,A
8-NS,736,2254,1,1,0,2256,A
8-NS,737,2261,2,1,0,2264,A
8-NS,738,0,0,0,2191,2191,C
8-NS,739,2067,2,0,0,2069,A
8-NS,740,2075,0,5,0,2080,A
8-NS,741,1,1,0,2075,2077,C
8-NS,742,1,2067,0,0,2068,T
8-NS,743,0,3,2073,0,2076,G
8-NS,744,2060,0,0,0,2060,A
8-NS,745,2072,1,0,0,2073,A
8-NS,746,2068,0,0,0,2068,A
8-NS,747,2040,1,0,0,2041,A
8-NS,748,1,2032,0,1,2034,T
8-NS,749,2009,0,1,0,2010,A
8-NS,750,0,0,2023,0,2023,G
8-NS,751,0,0,0,2015,2015,C
8-NS,752,0,1976,0,2,1978,T
8-NS,753,0,1976,0,1,1977,T
8-NS,754,1,1958,0,0,1959,T
8-NS,755,0,3,1963,0,1966,G
8-NS,756,1965,0,4,0,1969,A
8-NS,757,1967,0,0,0,1967,A
8-NS,758,0,1,0,1971,1972,C
8-NS,759,1918,1,0,0,1919,A
8-NS,760,1921,0,1,0,1922,A
8-NS,761,1925,1,0,0,1926,A
8-NS,762,0,1923,0,1,1924,T
8-NS,763,1922,0,1,0,1923,A
8-NS,764,1901,0,1,0,1902,A
8-NS,765,3,0,0,1892,1895,C
8-NS,766,1890,0,0,0,1890,A
8-NS,767,2,1864,0,0,1866,T
8-NS,768,1,1828,0,2,1831,T
8-NS,769,3,1,0,1797,1801,C
8-NS,770,1789,0,0,0,1789,A
8-NS,771,0,1783,0,1,1784,T
8-NS,772,0,0,1786,1,1787,G
8-NS,773,1,2,0,1747,1750,C
8-NS,774,1725,0,2,0,1727,A
8-NS,775,1718,1,1,0,1720,A
8-NS,776,0,1,1713,0,1714,G
8-NS,777,2,0,0,1754,1756,C
8-NS,778,1729,0,0,0,1729,A
8-NS,779,0,1735,0,0,1735,T
8-NS,780,0,1732,0,0,1732,T
8-NS,781,1730,0,1,0,1731,A
8-NS,782,1,0,0,1733,1734,C
8-NS,783,1718,0,1,0,1719,A
8-NS,784,1698,0,1,0,1699,A
8-NS,785,0,1,0,1681,1682,C
8-NS,786,0,1453,0,0,1453,T
8-NS,787,0,0,1448,0,1448,G
8-NS,788,0,0,0,1416,1416,C
8-NS,789,1,1385,0,2,1388,T
8-NS,790,1,3,1390,0,1394,G
8-NS,791,0,1377,0,2,1379,T
8-NS,792,0,1380,0,0,1380,T
8-NS,793,0,1377,0,0,1377,T
8-NS,794,1,1,1364,0,1366,G
8-NS,795,1365,0,2,0,1367,A
8-NS,796,1339,0,0,0,1339,A
8-NS,797,0,0,1334,1,1335,G
8-NS,798,0,1323,0,0,1323,T
8-NS,799,0,2,1274,0,1276,G
8-NS,800,0,4,1279,0,1283,G
8-NS,801,1285,0,0,0,1285,A
8-NS,802,1286,0,1,0,1287,A
8-NS,803,3,0,0,1282,1285,C
8-NS,804,1251,0,2,0,1253,A
8-NS,805,0,0,1256,1,1257,G
8-NS,806,1,0,1244,0,1245,G
8-NS,807,1225,1,2,0,1228,A
8-NS,808,0,1,1233,0,1234,G
8-NS,809,1049,0,3,1,1053,A
8-NS,810,0,1048,0,1,1049,T
8-NS,811,1046,0,0,0,1046,A
8-NS,812,1035,0,1,1,1037,A
8-NS,813,1,1,1036,0,1038,G
8-NS,814,942,0,0,0,942,A
8-NS,815,938,0,0,0,938,A
8-NS,816,0,0,0,932,932,C
8-NS,817,0,818,0,1,819,T
8-NS,818,0,813,0,0,813,T
8-NS,819,1,812,0,0,813,T
8-NS,820,1,0,0,812,813,C
8-NS,821,0,794,0,9,803,T
8-NS,822,2,0,0,787,789,C
8-NS,823,767,0,0,0,767,A
8-NS,824,0,763,0,0,763,T
8-NS,825,0,745,0,1,746,T
8-NS,826,0,742,0,0,742,T
8-NS,827,1,0,0,735,736,C
8-NS,828,705,0,0,0,705,A
8-NS,829,0,0,706,0,706,G
8-NS,830,0,0,0,702,702,C
8-NS,831,0,648,0,1,649,T
8-NS,832,0,645,0,0,645,T
8-NS,833,626,0,0,0,626,A
8-NS,834,0,620,0,0,620,T
8-NS,835,0,626,0,0,626,T
8-NS,836,0,619,0,0,619,T
8-NS,837,593,0,0,0,593,A
8-NS,838,575,0,0,0,575,A
8-NS,839,0,564,0,0,564,T
8-NS,840,0,0,557,0,557,G
8-NS,841,541,0,0,0,541,A
8-NS,842,0,487,0,0,487,T
8-NS,843,483,0,0,0,483,A
8-NS,844,481,0,0,0,481,A
8-NS,845,482,0,1,0,483,A
8-NS,846,483,0,0,0,483,A
8-NS,847,476,0,0,0,476,A
8-NS,848,470,0,1,2,473,A
8-NS,849,0,1,0,468,469,C
8-NS,850,391,0,0,0,391,A
8-NS,851,0,0,0,390,390,C
8-NS,852,1,0,0,372,373,C
8-NS,853,1,0,0,351,352,C
8-NS,854,0,330,0,0,330,T
8-NS,855,0,320,0,0,320,T
8-NS,856,0,0,320,0,320,G
8-NS,857,0,302,0,0,302,T
8-NS,858,0,301,0,0,301,T
8-NS,859,0,295,0,0,295,T
8-NS,860,0,0,0,100,100,C
8-NS,861,0,71,0,0,71,T
8-NS,862,56,0,0,0,56,A
8-NS,863,0,0,0,56,56,C
