Gene,Position,A,T,G,C,Coverage,Consensus
1-PB2,1,503,0,0,0,503,A
1-PB2,2,0,504,0,0,504,T
1-PB2,3,0,0,515,0,515,G
1-PB2,4,0,0,513,0,513,G
1-PB2,5,509,1,1,0,511,A
1-PB2,6,510,0,0,0,510,A
1-PB2,7,511,0,0,0,511,A
1-PB2,8,1,0,572,0,573,G
1-PB2,9,566,0,0,0,566,A
1-PB2,10,573,0,0,0,573,A
1-PB2,11,0,588,0,0,588,T
1-PB2,12,589,0,0,0,589,A
1-PB2,13,587,0,1,0,588,A
1-PB2,14,591,0,0,0,591,A
1-PB2,15,586,0,0,0,586,A
1-PB2,16,0,0,614,0,614,G
1-PB2,17,608,0,0,0,608,A
1-PB2,18,613,0,0,0,613,A
1-PB2,19,0,1,0,619,620,C
1-PB2,20,0,623,0,1,624,T
1-PB2,21,642,0,0,0,642,A
1-PB2,22,0,2,0,637,639,C
1-PB2,23,0,0,645,0,645,G
1-PB2,24,0,0,653,0,653,G
1-PB2,25,658,0,0,0,658,A
1-PB2,26,679,0,0,0,679,A
1-PB2,27,0,683,0,0,683,T
1-PB2,28,0,0,0,685,685,C
1-PB2,29,0,689,0,0,689,T
1-PB2,30,0,0,689,0,689,G
1-PB2,31,693,0,1,0,694,A
1-PB2,32,0,698,0,0,698,T
1-PB2,33,0,0,703,0,703,G
1-PB2,34,0,709,0,0,709,T
1-PB2,35,0,0,0,710,710,C
1-PB2,36,1,0,707,0,708,G
1-PB2,37,0,0,0,707,707,C
1-PB2,38,706,0,1,0,707,A
1-PB2,39,0,0,739,0,739,G
1-PB2,40,0,739,0,1,740,T
1-PB2,41,5,0,0,742,747,C
1-PB2,42,0,742,0,2,744,T
1-PB2,43,0,0,0,751,751,C
1-PB2,44,1,0,740,0,741,G
1-PB2,45,0,0,0,749,749,C
1-PB2,46,747,0,0,0,747,A
1-PB2,47,0,0,0,760,760,C
1-PB2,48,0,756,0,0,756,T
1-PB2,49,0,0,0,772,772,C
1-PB2,50,1,0,771,0,772,G
1-PB2,51,0,1,0,771,772,C
1-PB2,52,0,0,776,0,776,G
1-PB2,53,772,0,1,0,773,A
1-PB2,54,0,0,781,0,781,G
1-PB2,55,796,0,0,0,796,A
1-PB2,56,0,795,0,0,795,T
1-PB2,57,797,0,0,0,797,A
1-PB2,58,0,0,0,797,797,C
1-PB2,59,0,795,0,1,796,T
1-PB2,60,1,2,813,0,816,G
1-PB2,61,818,0,1,0,819,A
1-PB2,62,0,0,0,824,824,C
1-PB2,63,821,0,2,0,823,A
1-PB2,64,821,0,0,0,821,A
1-PB2,65,834,0,1,0,835,A
1-PB2,66,846,0,0,0,846,A
1-PB2,67,847,0,0,0,847,A
1-PB2,68,0,0,0,856,856,C
1-PB2,69,1,0,0,861,862,C
1-PB2,70,891,0,0,0,891,A
1-PB2,71,0,0,0,903,903,C
1-PB2,72,902,0,0,0,902,A
1-PB2,73,0,0,932,0,932,G
1-PB2,74,0,921,0,0,921,T
1-PB2,75,0,0,962,0,962,G
1-PB2,76,0,2,962,0,964,G
1-PB2,77,970,0,1,0,971,A
1-PB2,78,1,1,0,1017,1019,C
1-PB2,79,0,0,0,1019,1019,C
1-PB2,80,1038,0,0,0,1038,A
1-PB2,81,0,1039,0,0,1039,T
1-PB2,82,1028,0,0,0,1028,A
1-PB2,83,0,1026,0,1,1027,T
1-PB2,84,0,0,1038,0,1038,G
1-PB2,85,2,0,1039,0,1041,G
1-PB2,86,0,0,0,1039,1039,C
1-PB2,87,0,0,1,1030,1031,C
1-PB2,88,1030,0,0,0,1030,A
1-PB2,89,0,1106,0,0,1106,T
1-PB2,90,1104,0,2,0,1106,A
1-PB2,91,1134,0,0,0,1134,A
1-PB2,92,0,1140,0,0,1140,T
1-PB2,93,0,1135,0,0,1135,T
1-PB2,94,1144,0,0,0,1144,A
1-PB2,95,1143,0,0,0,1143,A
1-PB2,96,0,1,1159,0,1160,G
1-PB2,97,1162,0,1,0,1163,A
1-PB2,98,1144,1,0,0,1145,A
1-PB2,99,1,0,1193,1,1195,G
1-PB2,100,0,1171,0,1,1172,T
1-PB2,101,1182,0,0,0,1182,A
1-PB2,102,0,2,0,1186,1188,C
1-PB2,103,1185,0,2,0,1187,A
1-PB2,104,0,0,0,1222,1222,C
1-PB2,105,1218,0,0,0,1218,A
1-PB2,106,0,1218,0,0,1218,T
1-PB2,107,0,1,0,1226,1227,C
1-PB2,108,0,3,1209,0,1212,G
1-PB2,109,0,2,1205,0,1207,G
1-PB2,110,1,0,1208,0,1209,G
1-PB2,111,0,0,1208,0,1208,G
1-PB2,112,1214,0,0,0,1214,A
1-PB2,113,0,0,1228,0,1228,G
1-PB2,114,1226,0,0,0,1226,A
1-PB2,115,0,0,0,1239,1239,C
1-PB2,116,1234,0,3,0,1237,A
1-PB2,117,0,0,1255,0,1255,G
1-PB2,118,0,1,1269,0,1270,G
1-PB2,119,1261,0,1,0,1262,A
1-PB2,120,1268,0,0,0,1268,A
1-PB2,121,1271,0,0,0,1271,A
1-PB2,122,1268,0,1,0,1269,A
1-PB2,123,0,1,1273,0,1274,G
1-PB2,124,1260,1,2,0,1263,A
1-PB2,125,1268,0,2,0,1270,A
1-PB2,126,0,0,0,1270,1270,C
1-PB2,127,0,0,0,1262,1262,C
1-PB2,128,1,1,0,1261,1263,C
1-PB2,129,1,0,1260,0,1261,G
1-PB2,130,0,1249,0,1,1250,T
1-PB2,131,1,0,0,1265,1266,C
1-PB2,132,1273,0,0,0,1273,A
1-PB2,133,0,0,0,1286,1286,C
1-PB2,134,0,1290,0,0,1290,T
1-PB2,135,0,1289,0,0,1289,T
1-PB2,136,1287,0,0,0,1287,A
1-PB2,137,0,0,1316,0,1316,G
1-PB2,138,1,0,1315,0,1316,G
1-PB2,139,1311,0,2,0,1313,A
1-PB2,140,0,1314,0,1,1315,T
1-PB2,141,0,1,1348,0,1349,G
1-PB2,142,1355,0,0,0,1355,A
1-PB2,143,1357,0,0,0,1357,A
1-PB2,144,1368,0,1,0,1369,A
1-PB2,145,0,1368,0,0,1368,T
1-PB2,146,0,1,1373,0,1374,G
1-PB2,147,0,0,1374,0,1374,G
1-PB2,148,1368,0,2,0,1370,A
1-PB2,149,0,1377,0,2,1379,T
1-PB2,150,0,1,1369,0,1370,G
1-PB2,151,1356,0,2,0,1358,A
1-PB2,152,0,1363,0,1,1364,T
1-PB2,153,0,2,1359,0,1361,G
1-PB2,154,0,0,1376,0,1376,G
1-PB2,155,1,0,0,1368,1369,C
1-PB2,156,1370,0,0,1,1371,A
1-PB2,157,1382,0,0,0,1382,A
1-PB2,158,0,1383,0,1,1384,T
1-PB2,159,0,3,1430,0,1433,G
1-PB2,160,1436,0,0,0,1436,A
1-PB2,161,1429,0,0,0,1429,A
1-PB2,162,1429,0,2,0,1431,A
1-PB2,163,0,1423,0,0,1423,T
1-PB2,164,1432,0,1,0,1433,A
1-PB2,165,0,0,0,1450,1450,C
1-PB2,166,3,0,0,1439,1442,C
1-PB2,167,1,0,0,1447,1448,C
1-PB2,168,1439,0,0,0,1439,A
1-PB2,169,1438,0,0,0,1438,A
1-PB2,170,0,1428,0,0,1428,T
1-PB2,171,1,0,0,1438,1439,C
1-PB2,172,1427,0,0,0,1427,A
1-PB2,173,1,0,0,1450,1451,C
1-PB2,174,0,1426,0,1,1427,T
1-PB2,175,0,1,1436,0,1437,G
1-PB2,176,0,1,0,1439,1440,C
1-PB2,177,0,1435,0,1,1436,T
1-PB2,178,1,0,1443,0,1444,G
1-PB2,179,1445,0,1,0,1446,A
1-PB2,180,0,1,0,1467,1468,C
1-PB2,181,1465,1,0,0,1466,A
1-PB2,182,1439,0,0,0,1439,A
1-PB2,183,1439,0,5,0,1444,A
1-PB2,184,1436,0,2,0,1438,A
1-PB2,185,0,1,1469,0,1470,G
1-PB2,186,0,1,1466,0,1467,G
1-PB2,187,1464,0,0,0,1464,A
1-PB2,188,0,1463,0,0,1463,T
1-PB2,189,1454,0,0,0,1454,A
1-PB2,190,1462,0,1,0,1463,A
1-PB2,191,0,1,0,1473,1474,C
1-PB2,192,1475,0,0,0,1475,A
1-PB2,193,1,1,1474,0,1476,G
1-PB2,194,1466,0,0,1,1467,A
1-PB2,195,1465,0,0,0,1465,A
1-PB2,196,1459,0,0,0,1459,A
1-PB2,197,0,1458,0,0,1458,T
1-PB2,198,0,4,1458,0,1462,G
1-PB2,199,0,0,1492,0,1492,G
1-PB2,200,1,1473,0,0,1474,T
1-PB2,201,0,1477,0,0,1477,T
1-PB2,202,0,0,0,1483,1483,C
1-PB2,203,0,1,0,1480,1481,C
1-PB2,204,0,0,1492,0,1492,G
1-PB2,205,0,1,1486,0,1487,G
1-PB2,206,1482,0,1,0,1483,A
1-PB2,207,0,4,1486,0,1490,G
1-PB2,208,1462,0,1,0,1463,A
1-PB2,209,0,1,1505,0,1506,G
1-PB2,210,1497,0,0,0,1497,A
1-PB2,211,1509,0,0,0,1509,A
1-PB2,212,1502,0,3,0,1505,A
1-PB2,213,0,1503,0,0,1503,T
1-PB2,214,0,3,1509,0,1512,G
1-PB2,215,1515,0,2,0,1517,A
1-PB2,216,1513,0,1,0,1514,A
1-PB2,217,0,1,1,1509,1511,C
1-PB2,218,1497,0,0,0,1497,A
1-PB2,219,1502,0,2,0,1504,A
1-PB2,220,0,0,1530,0,1530,G
1-PB2,221,0,2,1549,0,1551,G
1-PB2,222,1549,0,1,0,1550,A
1-PB2,223,1,0,0,1548,1549,C
1-PB2,224,1543,0,1,0,1544,A
1-PB2,225,1548,0,1,0,1549,A
1-PB2,226,1538,0,1,0,1539,A
1-PB2,227,0,0,0,1544,1544,C
1-PB2,228,2,0,0,1482,1484,C
1-PB2,229,4,0,0,1594,1598,C
1-PB2,230,0,1601,0,1,1602,T
1-PB2,231,1611,0,0,0,1611,A
1-PB2,232,0,1611,0,0,1611,T
1-PB2,233,0,1,1619,0,1620,G
1-PB2,234,0,3,1640,0,1643,G
1-PB2,235,1573,0,2,0,1575,A
1-PB2,236,1,0,1585,0,1586,G
1-PB2,237,0,1577,0,0,1577,T
1-PB2,238,1566,0,1,0,1567,A
1-PB2,239,1573,0,0,0,1573,A
1-PB2,240,1574,0,0,0,1574,A
1-PB2,241,1574,0,0,0,1574,A
1-PB2,242,0,1560,0,0,1560,T
1-PB2,243,1,3,1546,0,1550,G
1-PB2,244,1526,0,0,0,1526,A
1-PB2,245,0,2,1530,0,1532,G
1-PB2,246,0,1519,0,1,1520,T
1-PB2,247,1,1,1517,0,1519,G
1-PB2,248,1545,0,1,0,1546,A
1-PB2,249,0,1551,0,0,1551,T
1-PB2,250,0,0,1566,0,1566,G
1-PB2,251,0,0,0,1554,1554,C
1-PB2,252,0,1550,0,1,1551,T
1-PB2,253,0,0,1604,0,1604,G
1-PB2,254,0,0,1600,1,1601,G
1-PB2,255,1616,0,0,0,1616,A
1-PB2,256,0,1610,0,1,1611,T
1-PB2,257,1,0,0,1621,1622,C
1-PB2,258,1624,0,0,0,1624,A
1-PB2,259,1,1,1672,0,1674,G
1-PB2,260,1670,0,0,0,1670,A
1-PB2,261,0,1674,0,0,1674,T
1-PB2,262,1641,0,0,0,1641,A
1-PB2,263,0,3,1675,0,1678,G
1-PB2,264,1669,0,1,0,1670,A
1-PB2,265,1,0,1689,0,1690,G
1-PB2,266,0,1654,0,0,1654,T
1-PB2,267,0,1,1653,0,1654,G
1-PB2,268,1637,0,0,0,1637,A
1-PB2,269,0,1638,0,0,1638,T
1-PB2,270,0,2,1670,0,1672,G
1-PB2,271,1,0,1698,0,1699,G
1-PB2,272,0,1682,0,1,1683,T
1-PB2,273,1682,0,0,0,1682,A
1-PB2,274,0,1656,0,1,1657,T
1-PB2,275,1,0,0,1665,1666,C
1-PB2,276,1680,0,0,0,1680,A
1-PB2,277,0,0,0,1740,1740,C
1-PB2,278,1,0,0,1735,1736,C
1-PB2,279,0,1700,1,0,1701,T
1-PB2,280,0,1691,0,0,1691,T
1-PB2,281,0,1703,0,0,1703,T
1-PB2,282,2,1,1720,0,1723,G
1-PB2,283,0,0,1726,0,1726,G
1-PB2,284,0,0,0,1743,1743,C
1-PB2,285,1,1720,0,1,1722,T
1-PB2,286,0,0,1716,0,1716,G
1-PB2,287,0,1722,0,0,1722,T
1-PB2,288,1734,0,0,0,1734,A
1-PB2,289,1736,0,1,0,1737,A
1-PB2,290,0,1,0,1735,1736,C
1-PB2,291,1703,0,1,0,1704,A
1-PB2,292,0,1699,0,1,1700,T
1-PB2,293,0,0,1681,0,1681,G
1-PB2,294,0,0,1722,0,1722,G
1-PB2,295,0,1710,0,1,1711,T
1-PB2,296,0,1,1710,0,1711,G
1-PB2,297,0,2,1733,0,1735,G
1-PB2,298,1724,1,0,0,1725,A
1-PB2,299,1737,0,2,0,1739,A
1-PB2,300,0,1740,0,0,1740,T
1-PB2,301,1741,0,0,0,1741,A
1-PB2,302,0,1,1765,0,1766,G
1-PB2,303,1746,0,1,0,1747,A
1-PB2,304,1749,0,0,0,1749,A
1-PB2,305,1750,0,0,0,1750,A
1-PB2,306,0,1719,0,0,1719,T
1-PB2,307,0,1,1706,0,1707,G
1-PB2,308,0,0,1706,0,1706,G
1-PB2,309,1713,1,0,0,1714,A
1-PB2,310,0,0,0,1721,1721,C
1-PB2,311,0,0,1,1700,1701,C
1-PB2,312,2,0,0,1702,1704,C
1-PB2,313,2,0,1717,0,1719,G
1-PB2,314,0,1716,1,1,1718,T
1-PB2,315,0,1,1756,0,1757,G
1-PB2,316,1755,0,2,0,1757,A
1-PB2,317,0,0,0,1779,1779,C
1-PB2,318,1778,0,1,0,1779,A
1-PB2,319,1777,0,0,0,1777,A
1-PB2,320,1,0,1805,19,1825,G
1-PB2,321,1,1826,0,1,1828,T
1-PB2,322,1812,0,3,0,1815,A
1-PB2,323,0,1,0,1810,1811,C
1-PB2,324,1,1,1778,0,1780,G
1-PB2,325,1,0,1819,0,1820,G
1-PB2,326,1,1811,0,1,1813,T
1-PB2,327,1,0,0,1828,1829,C
1-PB2,328,2,0,0,1824,1826,C
1-PB2,329,1807,0,0,0,1807,A
1-PB2,330,0,1803,0,1,1804,T
1-PB2,331,1,1804,0,0,1805,T
1-PB2,332,1892,0,0,0,1892,A
1-PB2,333,0,0,0,1889,1889,C
1-PB2,334,3,0,1,1845,1849,C
1-PB2,335,0,0,0,1859,1859,C
1-PB2,336,1846,0,1,0,1847,A
1-PB2,337,1855,0,0,0,1855,A
1-PB2,338,1849,0,0,0,1849,A
1-PB2,339,1848,0,1,0,1849,A
1-PB2,340,1,0,1866,0,1867,G
1-PB2,341,0,1791,0,0,1791,T
1-PB2,342,0,0,1856,0,1856,G
1-PB2,343,1,1847,0,2,1850,T
1-PB2,344,1852,0,1,0,1853,A
1-PB2,345,0,0,0,1850,1850,C
1-PB2,346,1850,0,0,0,1850,A
1-PB2,347,1850,0,0,0,1850,A
1-PB2,348,1,2,1868,0,1871,G
1-PB2,349,1847,0,0,0,1847,A
1-PB2,350,1,0,0,1866,1867,C
1-PB2,351,0,1835,0,1,1836,T
1-PB2,352,0,1862,0,0,1862,T
1-PB2,353,1863,0,0,0,1863,A
1-PB2,354,0,1859,0,2,1861,T
1-PB2,355,0,1862,0,0,1862,T
1-PB2,356,0,1854,0,0,1854,T
1-PB2,357,0,2,0,1837,1839,C
1-PB2,358,0,1,1834,0,1835,G
1-PB2,359,1819,0,1,0,1820,A
1-PB2,360,0,1,0,1832,1833,C
1-PB2,361,1832,1,0,0,1833,A
1-PB2,362,1829,0,0,0,1829,A
1-PB2,363,1829,0,0,0,1829,A
1-PB2,364,0,0,1845,0,1845,G
1-PB2,365,0,1843,0,0,1843,T
1-PB2,366,2,3,0,1855,1860,C
1-PB2,367,0,1,1858,0,1859,G
1-PB2,368,1838,0,1,0,1839,A
1-PB2,369,1847,0,6,0,1853,A
1-PB2,370,1854,0,2,0,1856,A
1-PB2,371,0,1,1916,0,1917,G
1-PB2,372,0,0,1921,0,1921,G
1-PB2,373,0,1898,0,1,1899,T
1-PB2,374,0,1912,0,2,1914,T
1-PB2,375,1911,0,0,0,1911,A
1-PB2,376,1905,0,1,0,1906,A
1-PB2,377,1907,0,2,0,1909,A
1-PB2,378,1916,0,2,0,1918,A
1-PB2,379,0,1,0,1931,1932,C
1-PB2,380,1888,0,0,0,1888,A
1-PB2,381,0,1872,0,0,1872,T
1-PB2,382,2,2,1862,0,1866,G
1-PB2,383,1,2,1868,0,1871,G
1-PB2,384,1864,0,0,1,1865,A
1-PB2,385,1873,0,1,0,1874,A
1-PB2,386,0,0,0,1930,1930,C
1-PB2,387,0,1,0,1950,1951,C
1-PB2,388,0,1934,0,4,1938,T
1-PB2,389,0,1931,0,1,1932,T
1-PB2,390,0,1937,0,2,1939,T
1-PB2,391,0,0,1933,0,1933,G
1-PB2,392,2,1,1937,0,1940,G
1-PB2,393,0,1,0,1927,1928,C
1-PB2,394,1,0,0,1924,1925,C
1-PB2,395,1,0,0,1924,1925,C
1-PB2,396,0,1855,0,2,1857,T
1-PB2,397,1,0,1877,0,1878,G
1-PB2,398,0,1870,0,0,1870,T
1-PB2,399,0,1868,0,1,1869,T
1-PB2,400,6,0,0,1870,1876,C
1-PB2,401,1863,0,1,0,1864,A
1-PB2,402,0,1859,0,1,1860,T
1-PB2,403,0,1865,0,0,1865,T
1-PB2,404,0,1866,0,2,1868,T
1-PB2,405,0,1867,0,1,1868,T
1-PB2,406,1842,0,0,0,1842,A
1-PB2,407,0,0,1839,0,1839,G
1-PB2,408,1830,0,2,0,1832,A
1-PB2,409,1848,0,0,0,1848,A
1-PB2,410,1845,0,0,0,1845,A
1-PB2,411,0,1828,0,0,1828,T
1-PB2,412,2,0,1,1838,1841,C
1-PB2,413,1845,0,1,0,1846,A
1-PB2,414,1851,0,0,0,1851,A
1-PB2,415,0,0,1863,0,1863,G
1-PB2,416,0,1854,0,1,1855,T
1-PB2,417,3,0,0,1861,1864,C
1-PB2,418,1867,0,3,0,1870,A
1-PB2,419,1871,0,0,0,1871,A
1-PB2,420,0,0,1877,0,1877,G
1-PB2,421,1880,0,1,0,1881,A
1-PB2,422,0,1883,0,0,1883,T
1-PB2,423,1890,0,1,0,1891,A
1-PB2,424,1,1,0,1893,1895,C
1-PB2,425,0,0,1893,0,1893,G
1-PB2,426,1,0,0,1895,1896,C
1-PB2,427,1885,0,1,0,1886,A
1-PB2,428,0,0,1908,0,1908,G
1-PB2,429,1889,0,1,0,1890,A
1-PB2,430,1897,0,0,0,1897,A
1-PB2,431,0,1,1949,0,1950,G
1-PB2,432,1905,0,0,0,1905,A
1-PB2,433,0,0,1929,0,1929,G
1-PB2,434,0,1915,0,1,1916,T
1-PB2,435,1906,1,2,0,1909,A
1-PB2,436,0,0,1927,0,1927,G
1-PB2,437,1925,0,2,0,1927,A
1-PB2,438,0,0,0,1988,1988,C
1-PB2,439,1968,1,0,0,1969,A
1-PB2,440,0,1939,0,1,1940,T
1-PB2,441,1942,0,1,0,1943,A
1-PB2,442,1946,0,1,0,1947,A
1-PB2,443,1948,0,0,0,1948,A
1-PB2,444,0,0,0,1967,1967,C
1-PB2,445,1,0,0,1930,1931,C
1-PB2,446,4,0,0,1919,1923,C
1-PB2,447,0,1823,0,2,1825,T
1-PB2,448,2,1,1834,0,1837,G
1-PB2,449,1,0,1855,0,1856,G
1-PB2,450,0,1849,0,1,1850,T
1-PB2,451,3,0,0,1842,1845,C
1-PB2,452,1868,0,1,0,1869,A
1-PB2,453,0,1856,0,1,1857,T
1-PB2,454,0,0,1877,0,1877,G
1-PB2,455,0,0,0,1869,1869,C
1-PB2,456,1872,0,1,0,1873,A
1-PB2,457,0,1,1886,0,1887,G
1-PB2,458,1858,0,0,0,1858,A
1-PB2,459,0,0,0,1883,1883,C
1-PB2,460,1,0,0,1886,1887,C
1-PB2,461,0,1838,0,7,1845,T
1-PB2,462,0,0,0,1856,1856,C
1-PB2,463,1849,0,0,0,1849,A
1-PB2,464,1,0,1879,0,1880,G
1-PB2,465,0,1874,0,0,1874,T
1-PB2,466,0,0,1884,0,1884,G
1-PB2,467,2,0,0,1874,1876,C
1-PB2,468,1,0,0,1865,1866,C
1-PB2,469,1873,0,1,0,1874,A
1-PB2,470,1868,0,0,0,1868,A
1-PB2,471,1862,0,0,0,1862,A
1-PB2,472,0,0,1867,0,1867,G
1-PB2,473,1820,0,2,0,1822,A
1-PB2,474,2,0,1830,0,1832,G
1-PB2,475,3,0,1832,0,1835,G
1-PB2,476,0,0,0,1831,1831,C
1-PB2,477,1828,0,1,0,1829,A
1-PB2,478,0,1,0,1839,1840,C
1-PB2,479,1844,0,0,0,1844,A
1-PB2,480,1880,0,0,0,1880,A
1-PB2,481,1,1,1893,0,1895,G
1-PB2,482,1905,1,1,0,1907,A
1-PB2,483,0,1903,0,1,1904,T
1-PB2,484,0,0,1910,0,1910,G
1-PB2,485,0,1904,0,0,1904,T
1-PB2,486,1923,0,0,0,1923,A
1-PB2,487,1916,0,0,0,1916,A
1-PB2,488,0,1925,0,0,1925,T
1-PB2,489,0,1852,0,0,1852,T
1-PB2,490,1831,1,1,0,1833,A
1-PB2,491,0,1780,0,0,1780,T
1-PB2,492,0,0,1781,0,1781,G
1-PB2,493,0,2,1771,0,1773,G
1-PB2,494,1761,0,0,0,1761,A
1-PB2,495,1748,0,4,0,1752,A
1-PB2,496,0,0,1761,0,1761,G
1-PB2,497,0,1738,0,1,1739,T
1-PB2,498,0,1741,0,3,1744,T
1-PB2,499,0,0,1760,0,1760,G
1-PB2,500,0,1743,1,1,1745,T
1-PB2,501,0,1741,1,1,1743,T
1-PB2,502,0,1747,0,1,1748,T
1-PB2,503,0,1743,0,2,1745,T
1-PB2,504,1,1737,0,1,1739,T
1-PB2,505,1,1,0,1753,1755,C
1-PB2,506,0,0,0,1740,1740,C
1-PB2,507,0,0,0,1757,1757,C
1-PB2,508,1739,1,3,0,1743,A
1-PB2,509,1748,0,0,0,1748,A
1-PB2,510,0,1750,0,1,1751,T
1-PB2,511,0,0,1768,0,1768,G
1-PB2,512,1762,0,0,0,1762,A
1-PB2,513,1769,0,0,0,1769,A
1-PB2,514,2,0,1784,0,1786,G
1-PB2,515,1,1764,0,2,1767,T
1-PB2,516,0,2,1755,1,1758,G
1-PB2,517,0,1,1761,0,1762,G
1-PB2,518,0,0,1762,0,1762,G
1-PB2,519,1768,0,3,0,1771,A
1-PB2,520,0,0,1767,1,1768,G
1-PB2,521,1,0,0,1746,1747,C
1-PB2,522,0,1,0,1768,1769,C
1-PB2,523,1765,0,0,0,1765,A
1-PB2,524,0,1,1806,0,1807,G
1-PB2,525,0,0,1811,0,1811,G
1-PB2,526,1821,0,0,0,1821,A
1-PB2,527,0,1815,0,1,1816,T
1-PB2,528,1817,0,0,0,1817,A
1-PB2,529,0,0,0,1809,1809,C
1-PB2,530,0,1806,0,2,1808,T
1-PB2,531,1809,0,1,0,1810,A
1-PB2,532,1799,0,1,0,1800,A
1-PB2,533,1,1,0,1785,1787,C
1-PB2,534,1749,0,0,0,1749,A
1-PB2,535,0,1724,0,1,1725,T
1-PB2,536,2,0,0,1740,1742,C
1-PB2,537,1719,0,1,0,1720,A
1-PB2,538,0,1,1744,0,1745,G
1-PB2,539,1734,0,0,0,1734,A
1-PB2,540,1736,0,0,0,1736,A
1-PB2,541,0,1718,0,0,1718,T
1-PB2,542,3,0,0,1700,1703,C
1-PB2,543,1705,0,1,0,1706,A
1-PB2,544,0,0,0,1724,1724,C
1-PB2,545,1727,0,0,0,1727,A
1-PB2,546,1736,0,0,0,1736,A
1-PB2,547,0,1712,0,0,1712,T
1-PB2,548,0,1722,0,0,1722,T
1-PB2,549,1733,0,1,0,1734,A
1-PB2,550,1733,0,1,0,1734,A
1-PB2,551,0,0,0,1744,1744,C
1-PB2,552,1739,0,0,0,1739,A
1-PB2,553,1711,0,0,0,1711,A
1-PB2,554,0,1728,1,1,1730,T
1-PB2,555,1725,0,0,0,1725,A
1-PB2,556,1723,0,1,0,1724,A
1-PB2,557,0,2,0,1730,1732,C
1-PB2,558,0,1717,0,2,1719,T
1-PB2,559,1720,0,0,0,1720,A
1-PB2,560,1710,0,0,0,1710,A
1-PB2,561,1716,0,2,0,1718,A
1-PB2,562,0,2,1715,0,1717,G
1-PB2,563,1687,0,0,0,1687,A
1-PB2,564,1,1,1683,0,1685,G
1-PB2,565,1675,0,0,0,1675,A
1-PB2,566,1678,0,0,0,1678,A
1-PB2,567,1683,0,0,0,1683,A
1-PB2,568,1677,0,0,0,1677,A
1-PB2,569,1681,0,0,0,1681,A
1-PB2,570,1686,0,1,0,1687,A
1-PB2,571,0,2,1686,0,1688,G
1-PB2,572,1690,0,1,0,1691,A
1-PB2,573,1676,0,1,0,1677,A
1-PB2,574,0,3,1675,0,1678,G
1-PB2,575,1672,0,0,0,1672,A
1-PB2,576,1672,0,0,0,1672,A
1-PB2,577,0,0,0,1680,1680,C
1-PB2,578,0,1637,0,0,1637,T
1-PB2,579,1,0,0,1663,1664,C
1-PB2,580,0,1,0,1675,1676,C
1-PB2,581,1,3,1683,0,1687,G
1-PB2,582,1687,0,0,0,1687,A
1-PB2,583,0,0,1682,0,1682,G
1-PB2,584,1672,0,0,0,1672,A
1-PB2,585,1,1662,0,0,1663,T
1-PB2,586,0,1654,1,0,1655,T
1-PB2,587,5,0,1646,0,1651,G
1-PB2,588,0,0,1,1653,1654,C
1-PB2,589,1665,0,0,0,1665,A
1-PB2,590,1662,0,0,0,1662,A
1-PB2,591,1666,0,0,0,1666,A
1-PB2,592,1676,0,0,1,1677,A
1-PB2,593,0,1662,0,1,1663,T
1-PB2,594,0,1653,0,0,1653,T
1-PB2,595,0,1651,0,0,1651,T
1-PB2,596,1,0,0,1664,1665,C
1-PB2,597,0,1650,0,1,1651,T
1-PB2,598,1,0,0,1742,1743,C
1-PB2,599,0,0,0,1745,1745,C
1-PB2,600,3,0,0,1907,1910,C
1-PB2,601,0,1894,0,3,1897,T
1-PB2,602,1,1938,0,0,1939,T
1-PB2,603,0,0,1957,0,1957,G
1-PB2,604,1950,1,0,0,1951,A
1-PB2,605,0,2009,0,0,2009,T
1-PB2,606,0,2,2043,0,2045,G
1-PB2,607,0,0,2268,0,2268,G
1-PB2,608,0,2305,0,5,2310,T
1-PB2,609,0,2292,1,1,2294,T
1-PB2,610,0,1,2465,1,2467,G
1-PB2,611,0,1,0,2475,2476,C
1-PB2,612,2549,0,1,0,2550,A
1-PB2,613,0,2550,1,1,2552,T
1-PB2,614,2574,0,0,1,2575,A
1-PB2,615,0,1,0,2694,2695,C
1-PB2,616,3008,1,1,6,3016,A
1-PB2,617,1,3088,0,1,3090,T
1-PB2,618,0,0,3240,0,3240,G
1-PB2,619,0,3208,0,6,3214,T
1-PB2,620,0,3216,0,2,3218,T
1-PB2,621,3211,0,1,0,3212,A
1-PB2,622,0,5,3217,0,3222,G
1-PB2,623,3270,0,0,0,3270,A
1-PB2,624,0,1,3284,0,3285,G
1-PB2,625,3151,0,2,0,3153,A
1-PB2,626,2,2,3162,0,3166,G
1-PB2,627,3096,0,1,0,3097,A
1-PB2,628,1,5,3123,0,3129,G
1-PB2,629,3110,0,4,0,3114,A
1-PB2,630,3129,0,0,0,3129,A
1-PB2,631,0,1,0,3132,3133,C
1-PB2,632,0,3133,0,1,3134,T
1-PB2,633,0,3130,0,2,3132,T
1-PB2,634,0,0,3133,2,3135,G
1-PB2,635,1,3138,0,0,3139,T
1-PB2,636,3143,0,5,0,3148,A
1-PB2,637,1,0,0,3129,3130,C
1-PB2,638,2,6,3120,0,3128,G
1-PB2,639,3124,0,0,0,3124,A
1-PB2,640,3117,0,1,0,3118,A
1-PB2,641,3159,1,0,0,3160,A
1-PB2,642,3163,0,1,0,3164,A
1-PB2,643,3147,1,4,0,3152,A
1-PB2,644,0,3,0,3168,3171,C
1-PB2,645,3164,0,2,0,3166,A
1-PB2,646,3168,0,0,0,3168,A
1-PB2,647,1,4,3188,0,3193,G
1-PB2,648,3194,0,3,0,3197,A
1-PB2,649,0,3187,0,1,3188,T
1-PB2,650,0,3171,0,1,3172,T
1-PB2,651,0,3199,0,3,3202,T
1-PB2,652,0,0,0,3210,3210,C
1-PB2,653,0,3225,0,4,3229,T
1-PB2,654,4,1,0,3220,3225,C
1-PB2,655,1,0,0,3218,3219,C
1-PB2,656,3,1,0,3217,3221,C
1-PB2,657,3220,0,2,0,3222,A
1-PB2,658,1,0,3254,0,3255,G
1-PB2,659,1,3257,0,1,3259,T
1-PB2,660,0,3246,0,0,3246,T
1-PB2,661,0,1,3249,0,3250,G
1-PB2,662,0,0,0,3239,3239,C
1-PB2,663,0,3244,0,2,3246,T
1-PB2,664,0,2,3250,0,3252,G
1-PB2,665,1,0,3225,0,3226,G
1-PB2,666,1,1,1,3232,3235,C
1-PB2,667,0,0,3259,1,3260,G
1-PB2,668,0,2,3299,0,3301,G
1-PB2,669,3307,0,1,0,3308,A
1-PB2,670,3311,0,0,0,3311,A
1-PB2,671,0,2,0,3313,3315,C
1-PB2,672,3342,0,1,0,3343,A
1-PB2,673,3338,0,3,0,3341,A
1-PB2,674,2,10,3499,0,3511,G
1-PB2,675,1,0,1,3569,3571,C
1-PB2,676,3594,0,0,0,3594,A
1-PB2,677,0,2,4490,0,4492,G
1-PB2,678,0,4461,0,3,4464,T
1-PB2,679,4500,0,1,0,4501,A
1-PB2,680,0,4508,0,2,4510,T
1-PB2,681,4531,0,0,0,4531,A
1-PB2,682,0,4526,0,3,4529,T
1-PB2,683,4483,1,2,0,4486,A
1-PB2,684,1,2,0,4537,4540,C
1-PB2,685,4376,0,0,0,4376,A
1-PB2,686,0,4143,0,1,4144,T
1-PB2,687,0,4026,0,4,4030,T
1-PB2,688,1,1,4022,2,4026,G
1-PB2,689,4018,0,1,0,4019,A
1-PB2,690,4019,0,2,0,4021,A
1-PB2,691,3,0,4077,0,4080,G
1-PB2,692,0,4046,1,0,4047,T
1-PB2,693,0,4023,1,2,4026,T
1-PB2,694,0,4031,0,5,4036,T
1-PB2,695,0,4034,0,2,4036,T
1-PB2,696,4071,0,1,0,4072,A
1-PB2,697,1,0,0,4100,4101,C
1-PB2,698,4095,0,1,0,4096,A
1-PB2,699,0,4103,0,1,4104,T
1-PB2,700,0,4064,0,3,4067,T
1-PB2,701,1,4074,0,1,4076,T
1-PB2,702,1,2,4121,1,4125,G
1-PB2,703,4130,0,3,0,4133,A
1-PB2,704,0,1,0,4153,4154,C
1-PB2,705,0,4118,0,2,4120,T
1-PB2,706,1,0,0,4138,4139,C
1-PB2,707,4133,0,4,0,4137,A
1-PB2,708,0,4,4116,0,4120,G
1-PB2,709,0,0,4214,0,4214,G
1-PB2,710,0,4,4219,0,4223,G
1-PB2,711,4203,0,2,0,4205,A
1-PB2,712,4227,0,5,0,4232,A
1-PB2,713,0,4,0,4227,4231,C
1-PB2,714,1,0,4271,1,4273,G
1-PB2,715,1,4250,0,4,4255,T
1-PB2,716,1,0,4311,0,4312,G
1-PB2,717,0,4266,0,4,4270,T
1-PB2,718,0,4278,0,1,4279,T
1-PB2,719,3,4,4283,0,4290,G
1-PB2,720,2,3,4284,0,4289,G
1-PB2,721,1,4,4318,0,4323,G
1-PB2,722,4280,0,10,0,4290,A
1-PB2,723,4286,0,7,0,4293,A
1-PB2,724,0,2,0,4385,4387,C
1-PB2,725,4370,0,0,0,4370,A
1-PB2,726,4497,0,0,0,4497,A
1-PB2,727,4503,0,1,0,4504,A
1-PB2,728,0,4538,0,0,4538,T
1-PB2,729,2,1,4606,1,4610,G
1-PB2,730,3,4555,0,5,4563,T
1-PB2,731,4570,0,3,0,4573,A
1-PB2,732,0,0,0,4578,4578,C
1-PB2,733,4503,0,2,1,4506,A
1-PB2,734,0,0,0,4518,4518,C
1-PB2,735,0,4387,0,6,4393,T
1-PB2,736,1,0,0,4764,4765,C
1-PB2,737,0,1,0,4770,4771,C
1-PB2,738,4851,0,4,0,4855,A
1-PB2,739,4,0,4901,0,4905,G
1-PB2,740,1,2,4995,0,4998,G
1-PB2,741,0,4932,0,1,4933,T
1-PB2,742,1,1,4993,0,4995,G
1-PB2,743,3,1,4852,0,4856,G
1-PB2,744,4768,1,1,0,4770,A
1-PB2,745,1,2,4870,0,4873,G
1-PB2,746,2,4,4863,0,4869,G
1-PB2,747,4744,0,7,0,4751,A
1-PB2,748,2,0,4846,0,4848,G
1-PB2,749,1,4714,0,3,4718,T
1-PB2,750,2,3,4787,0,4792,G
1-PB2,751,4781,0,6,0,4787,A
1-PB2,752,0,0,4799,0,4799,G
1-PB2,753,0,4,4821,0,4825,G
1-PB2,754,4804,0,2,0,4806,A
1-PB2,755,4792,0,5,0,4797,A
1-PB2,756,1,4804,0,1,4806,T
1-PB2,757,0,8,4804,0,4812,G
1-PB2,758,4783,1,3,0,4787,A
1-PB2,759,1,3,0,4785,4789,C
1-PB2,760,2,2,4792,0,4796,G
1-PB2,761,4845,0,1,0,4846,A
1-PB2,762,0,4820,0,2,4822,T
1-PB2,763,1,1,4835,0,4837,G
1-PB2,764,0,4825,0,2,4827,T
1-PB2,765,1,4812,0,0,4813,T
1-PB2,766,1,6,4835,0,4842,G
1-PB2,767,4844,0,3,0,4847,A
1-PB2,768,0,0,1,4841,4842,C
1-PB2,769,7,1,0,4833,4841,C
1-PB2,770,4798,0,3,0,4801,A
1-PB2,771,4807,0,1,0,4808,A
1-PB2,772,4817,0,2,0,4819,A
1-PB2,773,0,2,4937,0,4939,G
1-PB2,774,0,4,0,4940,4944,C
1-PB2,775,3,1,0,4937,4941,C
1-PB2,776,0,4987,0,3,4990,T
1-PB2,777,4994,0,2,0,4996,A
1-PB2,778,4991,0,3,0,4994,A
1-PB2,779,1,4999,0,1,5001,T
1-PB2,780,0,4994,0,0,4994,T
1-PB2,781,4943,0,0,0,4943,A
1-PB2,782,0,4824,0,5,4829,T
1-PB2,783,0,4818,1,2,4821,T
1-PB2,784,1,0,4819,0,4820,G
1-PB2,785,1,3,0,4769,4773,C
1-PB2,786,0,6,4766,0,4772,G
1-PB2,787,1,2,4836,0,4839,G
1-PB2,788,1,1,1,4819,4822,C
1-PB2,789,1,3,0,4849,4853,C
1-PB2,790,4849,0,0,0,4849,A
1-PB2,791,0,3,4944,0,4947,G
1-PB2,792,0,5,4965,0,4970,G
1-PB2,793,4963,0,1,0,4964,A
1-PB2,794,4994,1,11,0,5006,A
1-PB2,795,0,1,0,5037,5038,C
1-PB2,796,4979,0,2,0,4981,A
1-PB2,797,0,5045,0,1,5046,T
1-PB2,798,5088,0,2,1,5091,A
1-PB2,799,2,0,5139,0,5141,G
1-PB2,800,0,5070,0,4,5074,T
1-PB2,801,5067,0,1,0,5068,A
1-PB2,802,5026,0,5,0,5031,A
1-PB2,803,0,4,5062,0,5066,G
1-PB2,804,5031,0,2,0,5033,A
1-PB2,805,4958,0,2,0,4960,A
1-PB2,806,0,4,4943,1,4948,G
1-PB2,807,4803,0,8,0,4811,A
1-PB2,808,2,1,4814,0,4817,G
1-PB2,809,1,2,1,4811,4815,C
1-PB2,810,5,2,0,4817,4824,C
1-PB2,811,2,1,4821,0,4824,G
1-PB2,812,1,0,0,4856,4857,C
1-PB2,813,4870,3,1,1,4875,A
1-PB2,814,3,2,5207,0,5212,G
1-PB2,815,0,5158,0,1,5159,T
1-PB2,816,5196,1,2,1,5200,A
1-PB2,817,0,5174,0,4,5178,T
1-PB2,818,3,0,0,5212,5215,C
1-PB2,819,5207,0,7,0,5214,A
1-PB2,820,3,2,5209,0,5214,G
1-PB2,821,0,1,0,5220,5221,C
1-PB2,822,5050,2,2,1,5055,A
1-PB2,823,0,4,4994,0,4998,G
1-PB2,824,5013,0,6,0,5019,A
1-PB2,825,0,5024,0,1,5025,T
1-PB2,826,6,0,0,5044,5050,C
1-PB2,827,4,1,0,5039,5044,C
1-PB2,828,5033,1,1,1,5036,A
1-PB2,829,1,0,0,5064,5065,C
1-PB2,830,0,5067,1,1,5069,T
1-PB2,831,5067,0,4,1,5072,A
1-PB2,832,0,1,5056,0,5057,G
1-PB2,833,0,0,0,5030,5030,C
1-PB2,834,5015,0,1,0,5016,A
1-PB2,835,0,5030,1,2,5033,T
1-PB2,836,2,1,1,5083,5087,C
1-PB2,837,0,5067,0,0,5067,T
1-PB2,838,0,5187,1,2,5190,T
1-PB2,839,0,5212,0,1,5213,T
1-PB2,840,5209,0,2,0,5211,A
1-PB2,841,0,5195,0,2,5197,T
1-PB2,842,1,5184,0,2,5187,T
1-PB2,843,0,3,5173,0,5176,G
1-PB2,844,0,3,5154,0,5157,G
1-PB2,845,5069,1,6,0,5076,A
1-PB2,846,3,3,5078,0,5084,G
1-PB2,847,5011,0,0,0,5011,A
1-PB2,848,0,4979,0,2,4981,T
1-PB2,849,1,0,5082,0,5083,G
1-PB2,850,0,5051,0,2,5053,T
1-PB2,851,1,1,5059,0,5061,G
1-PB2,852,2,1,0,5052,5055,C
1-PB2,853,2,3,0,5070,5075,C
1-PB2,854,5049,0,2,2,5053,A
1-PB2,855,1,2,0,5052,5055,C
1-PB2,856,4975,0,3,0,4978,A
1-PB2,857,1,0,5035,0,5036,G
1-PB2,858,4,0,0,4903,4907,C
1-PB2,859,4909,1,4,0,4914,A
1-PB2,860,1,4,0,4907,4912,C
1-PB2,861,4887,0,9,0,4896,A
1-PB2,862,0,1,0,4947,4948,C
1-PB2,863,4932,0,0,0,4932,A
1-PB2,864,4932,0,3,0,4935,A
1-PB2,865,4904,1,5,0,4910,A
1-PB2,866,0,4765,0,1,4766,T
1-PB2,867,0,4773,0,3,4776,T
1-PB2,868,2,2,4753,0,4757,G
1-PB2,869,2,0,4697,0,4699,G
1-PB2,870,0,3,0,4731,4734,C
1-PB2,871,1,1,4715,0,4717,G
1-PB2,872,2,4,4699,0,4705,G
1-PB2,873,4700,0,2,0,4702,A
1-PB2,874,4821,0,1,0,4822,A
1-PB2,875,2,0,0,4838,4840,C
1-PB2,876,4849,0,3,0,4852,A
1-PB2,877,4832,0,5,0,4837,A
1-PB2,878,0,1,4860,0,4861,G
1-PB2,879,13,1,4867,0,4881,G
1-PB2,880,4867,0,1,0,4868,A
1-PB2,881,0,4654,0,4,4658,T
1-PB2,882,0,4,4647,1,4652,G
1-PB2,883,0,0,4689,0,4689,G
1-PB2,884,0,4602,0,4,4606,T
1-PB2,885,1,3,4653,1,4658,G
1-PB2,886,1,2,4625,0,4628,G
1-PB2,887,4572,0,11,0,4583,A
1-PB2,888,0,2,0,4584,4586,C
1-PB2,889,4553,0,1,0,4554,A
1-PB2,890,0,4868,0,2,4870,T
1-PB2,891,0,4847,0,2,4849,T
1-PB2,892,5,1,1,4829,4836,C
1-PB2,893,0,4793,0,4,4797,T
1-PB2,894,0,4788,0,2,4790,T
1-PB2,895,4786,0,5,0,4791,A
1-PB2,896,0,5,4800,0,4805,G
1-PB2,897,4787,1,7,0,4795,A
1-PB2,898,0,2,0,4806,4808,C
1-PB2,899,4254,0,1,0,4255,A
1-PB2,900,4216,0,7,0,4223,A
1-PB2,901,4267,0,2,1,4270,A
1-PB2,902,4236,0,5,0,4241,A
1-PB2,903,0,1,0,4265,4266,C
1-PB2,904,1,1,0,4272,4274,C
1-PB2,905,6,2,0,4256,4264,C
1-PB2,906,1,4,4252,1,4258,G
1-PB2,907,4229,0,5,1,4235,A
1-PB2,908,1,1,0,4280,4282,C
1-PB2,909,0,4261,0,1,4262,T
1-PB2,910,0,0,4298,0,4298,G
1-PB2,911,4270,2,3,0,4275,A
1-PB2,912,4302,0,10,2,4314,A
1-PB2,913,2,7,4328,0,4337,G
1-PB2,914,4329,0,6,0,4335,A
1-PB2,915,4325,0,7,0,4332,A
1-PB2,916,0,0,1,4338,4339,C
1-PB2,917,4318,0,0,0,4318,A
1-PB2,918,4332,1,9,0,4342,A
1-PB2,919,0,0,4386,0,4386,G
1-PB2,920,0,0,0,4428,4428,C
1-PB2,921,0,4397,0,0,4397,T
1-PB2,922,1,2,4481,0,4484,G
1-PB2,923,0,4461,0,0,4461,T
1-PB2,924,1,3,4542,0,4546,G
1-PB2,925,0,2,4719,0,4721,G
1-PB2,926,4683,1,11,0,4695,A
1-PB2,927,0,4699,0,2,4701,T
1-PB2,928,4682,0,1,0,4683,A
1-PB2,929,0,4635,0,1,4636,T
1-PB2,930,4761,0,3,0,4764,A
1-PB2,931,0,4678,0,1,4679,T
1-PB2,932,1,1,4669,1,4672,G
1-PB2,933,0,3,0,4618,4621,C
1-PB2,934,4416,0,4,0,4420,A
1-PB2,935,4405,1,4,0,4410,A
1-PB2,936,1,2,4409,0,4412,G
1-PB2,937,1,0,4429,0,4430,G
1-PB2,938,0,2,0,4436,4438,C
1-PB2,939,0,4357,2,3,4362,T
1-PB2,940,2,1,4383,0,4386,G
1-PB2,941,0,1,0,4393,4394,C
1-PB2,942,4413,0,2,0,4415,A
1-PB2,943,4424,0,2,0,4426,A
1-PB2,944,0,4375,1,3,4379,T
1-PB2,945,0,3,4407,0,4410,G
1-PB2,946,1,4,4379,0,4384,G
1-PB2,947,0,2,4399,0,4401,G
1-PB2,948,4388,0,3,0,4391,A
1-PB2,949,0,4377,0,2,4379,T
1-PB2,950,0,4354,0,0,4354,T
1-PB2,951,2,3,4372,0,4377,G
1-PB2,952,4345,0,7,0,4352,A
1-PB2,953,1,3,4398,0,4402,G
1-PB2,954,4369,0,4,0,4373,A
1-PB2,955,4351,0,1,0,4352,A
1-PB2,956,0,4284,1,2,4287,T
1-PB2,957,1,0,0,4335,4336,C
1-PB2,958,4331,0,5,3,4339,A
1-PB2,959,0,0,4358,0,4358,G
1-PB2,960,0,1,0,4338,4339,C
1-PB2,961,1,4303,1,8,4313,T
1-PB2,962,2,0,0,4336,4338,C
1-PB2,963,4336,0,1,1,4338,A
1-PB2,964,1,4388,0,3,4392,T
1-PB2,965,1,1,0,4411,4413,C
1-PB2,966,2,2,2,4431,4437,C
1-PB2,967,1,4402,0,3,4406,T
1-PB2,968,0,4384,0,6,4390,T
1-PB2,969,2,1,0,4399,4402,C
1-PB2,970,4411,0,2,1,4414,A
1-PB2,971,1,0,4470,0,4471,G
1-PB2,972,2,1,0,4450,4453,C
1-PB2,973,1,4373,0,4,4378,T
1-PB2,974,0,4375,1,2,4378,T
1-PB2,975,0,4364,1,1,4366,T
1-PB2,976,0,2,4379,0,4381,G
1-PB2,977,1,0,4365,0,4366,G
1-PB2,978,0,4320,0,4,4324,T
1-PB2,979,3,6,4385,0,4394,G
1-PB2,980,0,4,4374,0,4378,G
1-PB2,981,0,1,4410,0,4411,G
1-PB2,982,0,4368,0,1,4369,T
1-PB2,983,0,4377,2,4,4383,T
1-PB2,984,0,4397,0,0,4397,T
1-PB2,985,4419,0,2,0,4421,A
1-PB2,986,0,0,0,4429,4429,C
1-PB2,987,4434,0,0,0,4434,A
1-PB2,988,0,4409,0,3,4412,T
1-PB2,989,0,4343,0,3,4346,T
1-PB2,990,1,4353,0,1,4355,T
1-PB2,991,4352,1,2,0,4355,A
1-PB2,992,4339,1,5,0,4345,A
1-PB2,993,4355,0,1,1,4357,A
1-PB2,994,4331,0,6,0,4337,A
1-PB2,995,0,3,4353,0,4356,G
1-PB2,996,4336,0,4,0,4340,A
1-PB2,997,4329,0,1,1,4331,A
1-PB2,998,0,0,0,4344,4344,C
1-PB2,999,4331,1,0,0,4332,A
1-PB2,1000,4347,0,6,0,4353,A
1-PB2,1001,0,0,4334,0,4334,G
1-PB2,1002,2,4,0,4325,4331,C
1-PB2,1003,5,3,4329,0,4337,G
1-PB2,1004,1,2,4324,0,4327,G
1-PB2,1005,0,3,4333,0,4336,G
1-PB2,1006,0,4325,1,8,4334,T
1-PB2,1007,4,2,0,4318,4324,C
1-PB2,1008,4330,1,2,0,4333,A
1-PB2,1009,0,4292,0,2,4294,T
1-PB2,1010,8,0,0,4323,4331,C
1-PB2,1011,4321,0,2,0,4323,A
1-PB2,1012,1,0,4370,0,4371,G
1-PB2,1013,0,4278,0,3,4281,T
1-PB2,1014,3,1,0,4318,4322,C
1-PB2,1015,4320,0,2,1,4323,A
1-PB2,1016,4336,0,3,1,4340,A
1-PB2,1017,4336,0,2,0,4338,A
1-PB2,1018,4336,0,1,1,4338,A
1-PB2,1019,4366,0,0,0,4366,A
1-PB2,1020,4363,0,5,0,4368,A
1-PB2,1021,2,1,4390,0,4393,G
1-PB2,1022,4377,0,2,0,4379,A
1-PB2,1023,4377,0,2,1,4380,A
1-PB2,1024,0,1,4387,0,4388,G
1-PB2,1025,4373,0,3,1,4377,A
1-PB2,1026,4245,0,16,0,4261,A
1-PB2,1027,0,3,4256,0,4259,G
1-PB2,1028,4248,1,3,0,4252,A
1-PB2,1029,2,3,4243,0,4248,G
1-PB2,1030,1,0,4328,0,4329,G
1-PB2,1031,0,4299,2,2,4303,T
1-PB2,1032,0,0,4396,0,4396,G
1-PB2,1033,2,2,0,4414,4418,C
1-PB2,1034,0,4402,0,7,4409,T
1-PB2,1035,0,4442,0,2,4444,T
1-PB2,1036,4429,0,0,0,4429,A
1-PB2,1037,0,3,0,4436,4439,C
1-PB2,1038,4397,1,2,0,4400,A
1-PB2,1039,0,1,4406,0,4407,G
1-PB2,1040,1,0,4385,0,4386,G
1-PB2,1041,2,0,0,4305,4307,C
1-PB2,1042,4301,1,1,0,4303,A
1-PB2,1043,4300,1,4,0,4305,A
1-PB2,1044,1,4386,0,3,4390,T
1-PB2,1045,3,1,0,4429,4433,C
1-PB2,1046,0,4400,1,8,4409,T
1-PB2,1047,6,0,0,4431,4437,C
1-PB2,1048,3,2,0,4420,4425,C
1-PB2,1049,4440,0,3,0,4443,A
1-PB2,1050,4450,0,2,0,4452,A
1-PB2,1051,4457,0,2,1,4460,A
1-PB2,1052,0,1,0,4482,4483,C
1-PB2,1053,4386,0,1,0,4387,A
1-PB2,1054,0,4333,1,2,4336,T
1-PB2,1055,0,4259,1,2,4262,T
1-PB2,1056,1,5,4268,0,4274,G
1-PB2,1057,4253,0,6,0,4259,A
1-PB2,1058,6,5,4216,0,4227,G
1-PB2,1059,4422,0,4,0,4426,A
1-PB2,1060,4422,0,1,0,4423,A
1-PB2,1061,1,4467,0,0,4468,T
1-PB2,1062,4471,0,1,0,4472,A
1-PB2,1063,4485,0,2,1,4488,A
1-PB2,1064,2,2,4599,0,4603,G
1-PB2,1065,4516,0,6,0,4522,A
1-PB2,1066,2,2,4665,0,4669,G
1-PB2,1067,1,4515,0,0,4516,T
1-PB2,1068,4558,0,2,0,4560,A
1-PB2,1069,0,1,0,4654,4655,C
1-PB2,1070,4617,0,5,1,4623,A
1-PB2,1071,0,4601,0,1,4602,T
1-PB2,1072,0,3,4614,0,4617,G
1-PB2,1073,4442,1,9,0,4452,A
1-PB2,1074,0,3,4506,0,4509,G
1-PB2,1075,0,9,4510,1,4520,G
1-PB2,1076,2,5,4698,0,4705,G
1-PB2,1077,1,2,4735,0,4738,G
1-PB2,1078,0,4593,1,3,4597,T
1-PB2,1079,4664,0,3,0,4667,A
1-PB2,1080,0,4634,1,5,4640,T
1-PB2,1081,0,3,4673,0,4676,G
1-PB2,1082,4660,0,3,0,4663,A
1-PB2,1083,2,2,4649,0,4653,G
1-PB2,1084,0,6,4623,0,4629,G
1-PB2,1085,4367,0,2,0,4369,A
1-PB2,1086,3,1,4477,0,4481,G
1-PB2,1087,0,4489,1,10,4500,T
1-PB2,1088,0,4575,1,6,4582,T
1-PB2,1089,5,0,0,4604,4609,C
1-PB2,1090,4609,3,4,0,4616,A
1-PB2,1091,0,3,0,4650,4653,C
1-PB2,1092,4623,0,2,0,4625,A
1-PB2,1093,4636,1,6,0,4643,A
1-PB2,1094,0,4635,0,1,4636,T
1-PB2,1095,1,4,4567,0,4572,G
1-PB2,1096,2,1,4604,0,4607,G
1-PB2,1097,0,4438,1,3,4442,T
1-PB2,1098,2,1,4499,0,4502,G
1-PB2,1099,3,5,4481,0,4489,G
1-PB2,1100,0,3,4466,0,4469,G
1-PB2,1101,1,3,4520,0,4524,G
1-PB2,1102,4484,0,5,0,4489,A
1-PB2,1103,4483,0,8,0,4491,A
1-PB2,1104,4479,1,0,0,4480,A
1-PB2,1105,4377,0,17,2,4396,A
1-PB2,1106,1,1,4453,0,4455,G
1-PB2,1107,4410,0,5,0,4415,A
1-PB2,1108,1,1,4430,0,4432,G
1-PB2,1109,1,0,0,4415,4416,C
1-PB2,1110,4403,0,4,0,4407,A
1-PB2,1111,4407,1,3,0,4411,A
1-PB2,1112,1,1,1,4515,4518,C
1-PB2,1113,4528,0,2,0,4530,A
1-PB2,1114,0,0,4587,0,4587,G
1-PB2,1115,0,0,0,4535,4535,C
1-PB2,1116,0,4529,0,4,4533,T
1-PB2,1117,4681,0,2,0,4683,A
1-PB2,1118,0,4681,0,0,4681,T
1-PB2,1119,4701,0,0,0,4701,A
1-PB2,1120,1,1,0,4712,4714,C
1-PB2,1121,0,4467,1,6,4474,T
1-PB2,1122,4501,1,2,1,4505,A
1-PB2,1123,4418,0,3,0,4421,A
1-PB2,1124,0,1,4429,0,4430,G
1-PB2,1125,4411,0,0,1,4412,A
1-PB2,1126,4272,0,0,0,4272,A
1-PB2,1127,4275,0,4,0,4279,A
1-PB2,1128,4224,1,6,1,4232,A
1-PB2,1129,1,1,4260,0,4262,G
1-PB2,1130,0,4,0,4231,4235,C
1-PB2,1131,4260,2,2,1,4265,A
1-PB2,1132,4271,0,1,0,4272,A
1-PB2,1133,1,0,0,4296,4297,C
1-PB2,1134,2,1,0,4296,4299,C
1-PB2,1135,4304,0,3,1,4308,A
1-PB2,1136,0,2,4313,0,4315,G
1-PB2,1137,4312,0,2,0,4314,A
1-PB2,1138,4305,1,2,2,4310,A
1-PB2,1139,1,0,4335,1,4337,G
1-PB2,1140,4326,0,4,1,4331,A
1-PB2,1141,0,4306,1,1,4308,T
1-PB2,1142,1,4289,0,3,4293,T
1-PB2,1143,1,1,4311,0,4313,G
1-PB2,1144,0,0,4383,0,4383,G
1-PB2,1145,1,4337,0,9,4347,T
1-PB2,1146,0,4343,1,3,4347,T
1-PB2,1147,4,3,1,4348,4356,C
1-PB2,1148,4333,0,3,0,4336,A
1-PB2,1149,4320,1,6,1,4328,A
1-PB2,1150,2,2,0,4615,4619,C
1-PB2,1151,0,4602,1,6,4609,T
1-PB2,1152,6,1,0,4633,4640,C
1-PB2,1153,4584,0,4,1,4589,A
1-PB2,1154,0,4601,1,5,4607,T
1-PB2,1155,4610,0,1,1,4612,A
1-PB2,1156,1,1,4618,0,4620,G
1-PB2,1157,1,4421,0,2,4424,T
1-PB2,1158,0,1,4488,1,4490,G
1-PB2,1159,4253,0,4,0,4257,A
1-PB2,1160,0,0,4337,0,4337,G
1-PB2,1161,2,4287,0,3,4292,T
1-PB2,1162,1,4,4287,0,4292,G
1-PB2,1163,1,1,4320,0,4322,G
1-PB2,1164,4326,0,2,1,4329,A
1-PB2,1165,4307,0,5,1,4313,A
1-PB2,1166,0,5,4343,0,4348,G
1-PB2,1167,4298,0,3,0,4301,A
1-PB2,1168,2,4,4329,0,4335,G
1-PB2,1169,4256,0,8,0,4264,A
1-PB2,1170,0,6,0,4259,4265,C
1-PB2,1171,3,7,4282,0,4292,G
1-PB2,1172,4235,1,0,0,4236,A
1-PB2,1173,4242,2,8,1,4253,A
1-PB2,1174,0,0,1,4257,4258,C
1-PB2,1175,4224,1,8,0,4233,A
1-PB2,1176,0,0,4435,0,4435,G
1-PB2,1177,1,4398,0,8,4407,T
1-PB2,1178,9,1,1,4408,4419,C
1-PB2,1179,4441,0,2,1,4444,A
1-PB2,1180,4419,0,6,0,4425,A
1-PB2,1181,1,4430,0,1,4432,T
1-PB2,1182,4434,0,1,0,4435,A
1-PB2,1183,1,0,4412,0,4413,G
1-PB2,1184,2,1,0,4391,4394,C
1-PB2,1185,3,3,0,4249,4255,C
1-PB2,1186,1,3,4226,0,4230,G
1-PB2,1187,4219,0,1,0,4220,A
1-PB2,1188,4228,0,3,0,4231,A
1-PB2,1189,1,0,4269,0,4270,G
1-PB2,1190,0,3,0,4366,4369,C
1-PB2,1191,4388,1,5,0,4394,A
1-PB2,1192,4382,0,5,0,4387,A
1-PB2,1193,0,4391,0,1,4392,T
1-PB2,1194,4412,0,2,1,4415,A
1-PB2,1195,4442,0,4,1,4447,A
1-PB2,1196,0,4430,0,2,4432,T
1-PB2,1197,3,2,0,4435,4440,C
1-PB2,1198,3,1,4413,0,4417,G
1-PB2,1199,0,4276,0,1,4277,T
1-PB2,1200,4,2,4293,0,4299,G
1-PB2,1201,1,1,4316,0,4318,G
1-PB2,1202,1,1,0,4306,4308,C
1-PB2,1203,3,2,0,4313,4318,C
1-PB2,1204,4287,0,2,0,4289,A
1-PB2,1205,0,4294,0,3,4297,T
1-PB2,1206,1,4,4312,0,4317,G
1-PB2,1207,1,2,4375,0,4378,G
1-PB2,1208,0,4223,0,3,4226,T
1-PB2,1209,1,1,4370,0,4372,G
1-PB2,1210,0,4231,1,5,4237,T
1-PB2,1211,0,4232,1,11,4244,T
1-PB2,1212,0,4265,0,8,4273,T
1-PB2,1213,1,4262,0,5,4268,T
1-PB2,1214,0,1,0,4355,4356,C
1-PB2,1215,4365,0,2,0,4367,A
1-PB2,1216,1,2,1,4664,4668,C
1-PB2,1217,4620,0,0,2,4622,A
1-PB2,1218,4669,0,2,0,4671,A
1-PB2,1219,1,0,4694,0,4695,G
1-PB2,1220,4653,0,0,0,4653,A
1-PB2,1221,4404,0,226,1,4631,A
1-PB2,1222,0,2,4723,0,4725,G
1-PB2,1223,4718,0,3,0,4721,A
1-PB2,1224,2,4726,0,2,4730,T
1-PB2,1225,0,4698,0,0,4698,T
1-PB2,1226,0,0,4687,0,4687,G
1-PB2,1227,0,0,2,4642,4644,C
1-PB2,1228,4672,0,6,4,4682,A
1-PB2,1229,1,4728,0,3,4732,T
1-PB2,1230,1,1,4959,0,4961,G
1-PB2,1231,4979,1,9,0,4989,A
1-PB2,1232,0,5032,0,0,5032,T
1-PB2,1233,5022,0,2,0,5024,A
1-PB2,1234,5013,0,1,0,5014,A
1-PB2,1235,5026,0,2,1,5029,A
1-PB2,1236,5026,0,8,0,5034,A
1-PB2,1237,1,0,5046,0,5047,G
1-PB2,1238,0,0,0,5166,5166,C
1-PB2,1239,5234,0,2,0,5236,A
1-PB2,1240,1,1,5404,0,5406,G
1-PB2,1241,0,5405,0,3,5408,T
1-PB2,1242,0,5414,0,2,5416,T
1-PB2,1243,5398,0,5,0,5403,A
1-PB2,1244,0,1,5437,0,5438,G
1-PB2,1245,5387,1,14,0,5402,A
1-PB2,1246,1,1,5408,0,5410,G
1-PB2,1247,1,2,5362,0,5365,G
1-PB2,1248,0,5088,0,2,5090,T
1-PB2,1249,1,4,5193,0,5198,G
1-PB2,1250,5202,0,11,1,5214,A
1-PB2,1251,0,1,0,5262,5263,C
1-PB2,1252,1,1,2,5297,5301,C
1-PB2,1253,0,5249,0,15,5264,T
1-PB2,1254,2,4,5293,0,5299,G
1-PB2,1255,5272,0,2,0,5274,A
1-PB2,1256,5273,0,1,0,5274,A
1-PB2,1257,0,5302,0,0,5302,T
1-PB2,1258,0,5381,0,6,5387,T
1-PB2,1259,0,5384,0,0,5384,T
1-PB2,1260,7,1,0,5406,5414,C
1-PB2,1261,0,0,5412,0,5412,G
1-PB2,1262,1,5382,0,9,5392,T
1-PB2,1263,5,2,0,5416,5423,C
1-PB2,1264,5413,0,0,1,5414,A
1-PB2,1265,5409,0,1,1,5411,A
1-PB2,1266,0,1,0,5430,5431,C
1-PB2,1267,5364,0,2,1,5367,A
1-PB2,1268,1,5,5440,1,5447,G
1-PB2,1269,5413,1,6,2,5422,A
1-PB2,1270,0,1,5438,0,5439,G
1-PB2,1271,0,4,1,5435,5440,C
1-PB2,1272,5456,0,2,0,5458,A
1-PB2,1273,5505,0,3,0,5508,A
1-PB2,1274,5507,0,3,0,5510,A
1-PB2,1275,0,5491,0,0,5491,T
1-PB2,1276,4,0,0,5528,5532,C
1-PB2,1277,5495,0,4,0,5499,A
1-PB2,1278,1,4,5472,0,5477,G
1-PB2,1279,0,6,0,5481,5487,C
1-PB2,1280,0,6,5497,0,5503,G
1-PB2,1281,2,1,5784,0,5787,G
1-PB2,1282,1,5744,0,4,5749,T
1-PB2,1283,0,5766,0,1,5767,T
1-PB2,1284,2,11,5754,0,5767,G
1-PB2,1285,5761,0,7,1,5769,A
1-PB2,1286,5821,0,9,0,5830,A
1-PB2,1287,1,5,1,5865,5872,C
1-PB2,1288,3,2,0,5834,5839,C
1-PB2,1289,7,1,0,5885,5893,C
1-PB2,1290,8,1,1,5753,5763,C
1-PB2,1291,5781,0,3,0,5784,A
1-PB2,1292,0,5781,0,3,5784,T
1-PB2,1293,2,5,5772,0,5779,G
1-PB2,1294,1,1,0,5824,5826,C
1-PB2,1295,5794,0,2,0,5796,A
1-PB2,1296,0,5763,0,6,5769,T
1-PB2,1297,2,2,0,5771,5775,C
1-PB2,1298,5728,0,6,0,5734,A
1-PB2,1299,1,1,5821,0,5823,G
1-PB2,1300,2,1,0,5819,5822,C
1-PB2,1301,1,5815,0,8,5824,T
1-PB2,1302,0,5836,1,1,5838,T
1-PB2,1303,0,5827,0,3,5830,T
1-PB2,1304,0,5830,1,0,5831,T
1-PB2,1305,5826,0,1,0,5827,A
1-PB2,1306,5824,0,2,0,5826,A
1-PB2,1307,1,5,5820,0,5826,G
1-PB2,1308,4,1,5760,0,5765,G
1-PB2,1309,2,2,0,5728,5732,C
1-PB2,1310,5738,0,2,1,5741,A
1-PB2,1311,1,5761,0,2,5764,T
1-PB2,1312,0,5780,0,4,5784,T
1-PB2,1313,0,5791,0,4,5795,T
1-PB2,1314,0,5785,0,8,5793,T
1-PB2,1315,3,2,1,5807,5813,C
1-PB2,1316,5802,0,5,2,5809,A
1-PB2,1317,1,2,5823,0,5826,G
1-PB2,1318,5796,0,1,3,5800,A
1-PB2,1319,5814,0,2,1,5817,A
1-PB2,1320,5798,0,6,0,5804,A
1-PB2,1321,3,4,5817,0,5824,G
1-PB2,1322,5852,0,5,0,5857,A
1-PB2,1323,0,5849,0,3,5852,T
1-PB2,1324,1,1,5868,0,5870,G
1-PB2,1325,0,4,0,5849,5853,C
1-PB2,1326,4,4,5879,0,5887,G
1-PB2,1327,5842,1,3,0,5846,A
1-PB2,1328,5873,1,1,0,5875,A
1-PB2,1329,5881,0,6,0,5887,A
1-PB2,1330,2,0,5874,0,5876,G
1-PB2,1331,0,5795,0,7,5802,T
1-PB2,1332,2,1,5818,0,5821,G
1-PB2,1333,0,0,0,5788,5788,C
1-PB2,1334,1,5822,0,8,5831,T
1-PB2,1335,1,5831,0,1,5833,T
1-PB2,1336,1,5838,0,5,5844,T
1-PB2,1337,1,5847,0,0,5848,T
1-PB2,1338,1,5809,0,7,5817,T
1-PB2,1339,0,1,0,5848,5849,C
1-PB2,1340,5839,0,3,0,5842,A
1-PB2,1341,5858,0,2,0,5860,A
1-PB2,1342,5854,0,1,1,5856,A
1-PB2,1343,5885,0,0,0,5885,A
1-PB2,1344,0,5879,2,0,5881,T
1-PB2,1345,0,5896,0,1,5897,T
1-PB2,1346,3,5,5902,0,5910,G
1-PB2,1347,3,8,5856,1,5868,G
1-PB2,1348,2,5,5870,0,5877,G
1-PB2,1349,1,2,5969,0,5972,G
1-PB2,1350,5947,0,4,0,5951,A
1-PB2,1351,0,2,6051,0,6053,G
1-PB2,1352,2,6033,0,3,6038,T
1-PB2,1353,0,6040,1,2,6043,T
1-PB2,1354,1,5,6071,0,6077,G
1-PB2,1355,6059,1,7,0,6067,A
1-PB2,1356,6056,3,17,0,6076,A
1-PB2,1357,0,2,0,6241,6243,C
1-PB2,1358,6154,1,2,0,6157,A
1-PB2,1359,2,6,0,6307,6315,C
1-PB2,1360,6190,0,6,0,6196,A
1-PB2,1361,0,6180,0,2,6182,T
1-PB2,1362,5,1,0,6241,6247,C
1-PB2,1363,2,4,6247,0,6253,G
1-PB2,1364,6257,0,6,0,6263,A
1-PB2,1365,0,1,0,6288,6289,C
1-PB2,1366,6113,0,3,0,6116,A
1-PB2,1367,1,1,6331,0,6333,G
1-PB2,1368,0,6179,1,5,6185,T
1-PB2,1369,0,0,6341,0,6341,G
1-PB2,1370,0,6284,1,3,6288,T
1-PB2,1371,2,3,6303,0,6308,G
1-PB2,1372,6288,1,10,0,6299,A
1-PB2,1373,0,6271,1,2,6274,T
1-PB2,1374,0,6,6305,0,6311,G
1-PB2,1375,1,2,6308,0,6311,G
1-PB2,1376,2,4,6254,0,6260,G
1-PB2,1377,6204,1,9,0,6214,A
1-PB2,1378,6160,0,6,1,6167,A
1-PB2,1379,1,6209,0,3,6213,T
1-PB2,1380,0,4,6259,0,6263,G
1-PB2,1381,6271,0,3,0,6274,A
1-PB2,1382,0,6270,0,1,6271,T
1-PB2,1383,0,6250,0,6,6256,T
1-PB2,1384,3,4,6221,1,6229,G
1-PB2,1385,2,6,6415,0,6423,G
1-PB2,1386,6398,0,9,0,6407,A
1-PB2,1387,0,0,6505,0,6505,G
1-PB2,1388,0,6421,0,2,6423,T
1-PB2,1389,6423,0,0,0,6423,A
1-PB2,1390,0,6453,0,5,6458,T
1-PB2,1391,0,6527,0,1,6528,T
1-PB2,1392,6575,1,6,1,6583,A
1-PB2,1393,1,0,0,6612,6613,C
1-PB2,1394,3,4,0,6512,6519,C
1-PB2,1395,6504,0,3,0,6507,A
1-PB2,1396,0,2,6535,0,6537,G
1-PB2,1397,6672,1,2,0,6675,A
1-PB2,1398,0,6635,0,8,6643,T
1-PB2,1399,6604,0,2,1,6607,A
1-PB2,1400,1,6529,0,8,6538,T
1-PB2,1401,0,9,6505,0,6514,G
1-PB2,1402,6506,1,4,0,6511,A
1-PB2,1403,2,3,0,6547,6552,C
1-PB2,1404,0,6525,0,4,6529,T
1-PB2,1405,9,2,1,6470,6482,C
1-PB2,1406,5,1,2,6432,6440,C
1-PB2,1407,6495,1,3,0,6499,A
1-PB2,1408,6494,2,13,5,6514,A
1-PB2,1409,7,1,6667,0,6675,G
1-PB2,1410,1,0,0,6649,6650,C
1-PB2,1411,6627,1,3,0,6631,A
1-PB2,1412,1,0,0,6638,6639,C
1-PB2,1413,6609,0,5,2,6616,A
1-PB2,1414,0,3,6623,0,6626,G
1-PB2,1415,6587,1,4,0,6592,A
1-PB2,1416,4,1,6663,0,6668,G
1-PB2,1417,6659,1,9,1,6670,A
1-PB2,1418,0,6520,1,7,6528,T
1-PB2,1419,1,3,6595,0,6599,G
1-PB2,1420,0,6536,1,7,6544,T
1-PB2,1421,8,0,1,6573,6582,C
1-PB2,1422,6604,1,8,0,6613,A
1-PB2,1423,6594,0,2,0,6596,A
1-PB2,1424,0,6581,1,0,6582,T
1-PB2,1425,0,5,6580,0,6585,G
1-PB2,1426,6506,1,5,0,6512,A
1-PB2,1427,1,1,6538,0,6540,G
1-PB2,1428,6453,1,16,0,6470,A
1-PB2,1429,0,1,6490,0,6491,G
1-PB2,1430,2,5,6770,0,6777,G
1-PB2,1431,6745,0,1,0,6746,A
1-PB2,1432,6766,1,3,0,6770,A
1-PB2,1433,0,6757,2,1,6760,T
1-PB2,1434,6756,0,0,0,6756,A
1-PB2,1435,6761,0,6,0,6767,A
1-PB2,1436,1,6,6758,0,6765,G
1-PB2,1437,6733,0,11,1,6745,A
1-PB2,1438,0,0,6744,0,6744,G
1-PB2,1439,2,6395,1,3,6401,T
1-PB2,1440,7,2,1,6409,6419,C
1-PB2,1441,6435,1,7,0,6443,A
1-PB2,1442,6,0,6461,0,6467,G
1-PB2,1443,1,1,0,6474,6476,C
1-PB2,1444,6508,0,0,0,6508,A
1-PB2,1445,6519,0,1,1,6521,A
1-PB2,1446,6494,0,5,0,6499,A
1-PB2,1447,6484,0,2,0,6486,A
1-PB2,1448,0,6481,1,2,6484,T
1-PB2,1449,0,7,6485,0,6492,G
1-PB2,1450,4,2,6487,0,6493,G
1-PB2,1451,1,0,6523,0,6524,G
1-PB2,1452,0,6440,0,4,6444,T
1-PB2,1453,1,0,6487,0,6488,G
1-PB2,1454,0,6444,0,1,6445,T
1-PB2,1455,0,7,6451,0,6458,G
1-PB2,1456,0,1,6557,1,6559,G
1-PB2,1457,6549,0,2,0,6551,A
1-PB2,1458,0,6518,0,1,6519,T
1-PB2,1459,3,5,6569,0,6577,G
1-PB2,1460,6550,0,7,0,6557,A
1-PB2,1461,6566,1,5,0,6572,A
1-PB2,1462,0,6566,1,0,6567,T
1-PB2,1463,6475,0,7,0,6482,A
1-PB2,1464,1,3,1,6847,6852,C
1-PB2,1465,1,6693,1,6,6701,T
1-PB2,1466,4,1,0,6776,6781,C
1-PB2,1467,3,4,0,6824,6831,C
1-PB2,1468,6777,0,9,0,6786,A
1-PB2,1469,7,0,7017,0,7024,G
1-PB2,1470,0,6990,0,3,6993,T
1-PB2,1471,7013,1,2,0,7016,A
1-PB2,1472,0,4,1,7039,7044,C
1-PB2,1473,6491,0,1,1,6493,A
1-PB2,1474,0,6,6529,0,6535,G
1-PB2,1475,6372,0,6,1,6379,A
1-PB2,1476,1,1,6437,0,6439,G
1-PB2,1477,6219,0,11,0,6230,A
1-PB2,1478,0,5,6060,0,6065,G
1-PB2,1479,0,4,6041,0,6045,G
1-PB2,1480,1,0,6057,0,6058,G
1-PB2,1481,0,5906,1,7,5914,T
1-PB2,1482,1,5,5951,0,5957,G
1-PB2,1483,0,3,5957,0,5960,G
1-PB2,1484,0,5888,1,2,5891,T
1-PB2,1485,9,4,6039,0,6052,G
1-PB2,1486,1,0,6033,0,6034,G
1-PB2,1487,0,5924,0,3,5927,T
1-PB2,1488,0,5942,0,6,5948,T
1-PB2,1489,5863,0,4,0,5867,A
1-PB2,1490,2,0,5883,0,5885,G
1-PB2,1491,0,1,0,5880,5881,C
1-PB2,1492,5870,0,3,0,5873,A
1-PB2,1493,1,5835,0,3,5839,T
1-PB2,1494,0,5578,0,0,5578,T
1-PB2,1495,0,5,5573,0,5578,G
1-PB2,1496,5562,0,1,0,5563,A
1-PB2,1497,0,5538,0,3,5541,T
1-PB2,1498,5,2,0,5576,5583,C
1-PB2,1499,1,4,5535,1,5541,G
1-PB2,1500,2,0,5629,0,5631,G
1-PB2,1501,0,5582,0,5,5587,T
1-PB2,1502,1,5596,0,2,5599,T
1-PB2,1503,0,5620,0,1,5621,T
1-PB2,1504,0,5607,0,1,5608,T
1-PB2,1505,0,5611,0,4,5615,T
1-PB2,1506,7,4,5609,0,5620,G
1-PB2,1507,5598,0,9,0,5607,A
1-PB2,1508,1,5,5615,0,5621,G
1-PB2,1509,5422,0,5,0,5427,A
1-PB2,1510,0,0,5454,0,5454,G
1-PB2,1511,0,5450,0,4,5454,T
1-PB2,1512,1,5426,0,1,5428,T
1-PB2,1513,2,3,0,5447,5452,C
1-PB2,1514,1,4,5474,0,5479,G
1-PB2,1515,5482,0,10,0,5492,A
1-PB2,1516,0,7,5479,0,5486,G
1-PB2,1517,5459,0,3,0,5462,A
1-PB2,1518,0,1,1,5468,5470,C
1-PB2,1519,3,2,0,5437,5442,C
1-PB2,1520,5401,0,1,0,5402,A
1-PB2,1521,5444,0,6,0,5450,A
1-PB2,1522,1,0,0,5476,5477,C
1-PB2,1523,3,1,5500,0,5504,G
1-PB2,1524,0,5451,0,1,5452,T
1-PB2,1525,1,2,5435,0,5438,G
1-PB2,1526,0,2,5457,1,5460,G
1-PB2,1527,3,4,5458,0,5465,G
1-PB2,1528,5410,0,5,0,5415,A
1-PB2,1529,5444,0,0,0,5444,A
1-PB2,1530,2,5270,0,2,5274,T
1-PB2,1531,1,2,5486,0,5489,G
1-PB2,1532,1,5456,2,0,5459,T
1-PB2,1533,5443,0,36,0,5479,A
1-PB2,1534,0,5465,1,5,5471,T
1-PB2,1535,0,5419,0,0,5419,T
1-PB2,1536,5507,0,1,1,5509,A
1-PB2,1537,0,5475,1,2,5478,T
1-PB2,1538,0,5437,0,2,5439,T
1-PB2,1539,5420,0,0,0,5420,A
1-PB2,1540,0,4841,0,2,4843,T
1-PB2,1541,2,2,0,4996,5000,C
1-PB2,1542,3,4895,1,7,4906,T
1-PB2,1543,3,2,0,4946,4951,C
1-PB2,1544,0,1,0,4963,4964,C
1-PB2,1545,0,4819,0,3,4822,T
1-PB2,1546,0,1,4837,0,4838,G
1-PB2,1547,4811,0,0,1,4812,A
1-PB2,1548,0,2,4799,0,4801,G
1-PB2,1549,1,2,4777,0,4780,G
1-PB2,1550,4359,1,6,0,4366,A
1-PB2,1551,0,2,4390,0,4392,G
1-PB2,1552,1,0,4352,0,4353,G
1-PB2,1553,0,4230,0,1,4231,T
1-PB2,1554,5,1,0,4266,4272,C
1-PB2,1555,4227,0,3,1,4231,A
1-PB2,1556,0,0,4270,0,4270,G
1-PB2,1557,0,4264,0,1,4265,T
1-PB2,1558,0,2,4265,0,4267,G
1-PB2,1559,4237,0,4,0,4241,A
1-PB2,1560,4105,1,3,0,4109,A
1-PB2,1561,4120,0,8,0,4128,A
1-PB2,1562,0,0,0,4128,4128,C
1-PB2,1563,4086,0,3,0,4089,A
1-PB2,1564,1,2,0,4101,4104,C
1-PB2,1565,3948,2,8,0,3958,A
1-PB2,1566,7,2,3968,0,3977,G
1-PB2,1567,0,5,3952,0,3957,G
1-PB2,1568,1,2,3983,0,3986,G
1-PB2,1569,3961,0,1,0,3962,A
1-PB2,1570,3944,0,3,0,3947,A
1-PB2,1571,1,1,0,3969,3971,C
1-PB2,1572,1,3922,0,2,3925,T
1-PB2,1573,1,0,3930,0,3931,G
1-PB2,1574,3880,0,7,0,3887,A
1-PB2,1575,1,0,3902,0,3903,G
1-PB2,1576,3842,0,5,0,3847,A
1-PB2,1577,1,2,3678,0,3681,G
1-PB2,1578,3648,0,7,0,3655,A
1-PB2,1579,2,1,0,3642,3645,C
1-PB2,1580,0,3563,0,1,3564,T
1-PB2,1581,2,2,3613,0,3617,G
1-PB2,1582,3588,0,3,0,3591,A
1-PB2,1583,0,0,0,3621,3621,C
1-PB2,1584,3599,0,5,1,3605,A
1-PB2,1585,3591,0,1,0,3592,A
1-PB2,1586,0,3605,0,1,3606,T
1-PB2,1587,3622,0,0,0,3622,A
1-PB2,1588,3610,0,1,0,3611,A
1-PB2,1589,0,1,0,3647,3648,C
1-PB2,1590,1,3454,0,2,3457,T
1-PB2,1591,0,3427,0,1,3428,T
1-PB2,1592,3393,0,0,0,3393,A
1-PB2,1593,0,3401,0,2,3403,T
1-PB2,1594,0,3384,0,5,3389,T
1-PB2,1595,0,0,0,3386,3386,C
1-PB2,1596,3229,0,0,0,3229,A
1-PB2,1597,0,3212,0,2,3214,T
1-PB2,1598,0,0,0,3142,3142,C
1-PB2,1599,2,0,3138,0,3140,G
1-PB2,1600,0,3157,0,5,3162,T
1-PB2,1601,1,0,0,3143,3144,C
1-PB2,1602,1,1,3138,0,3140,G
1-PB2,1603,3130,0,1,0,3131,A
1-PB2,1604,0,3141,0,0,3141,T
1-PB2,1605,0,2,3132,0,3134,G
1-PB2,1606,3143,0,6,1,3150,A
1-PB2,1607,0,3149,0,0,3149,T
1-PB2,1608,2,0,3146,0,3148,G
1-PB2,1609,0,3061,0,1,3062,T
1-PB2,1610,1,6,3036,1,3044,G
1-PB2,1611,0,2,3036,0,3038,G
1-PB2,1612,2,2,3036,0,3040,G
1-PB2,1613,2965,0,1,0,2966,A
1-PB2,1614,1,1,2972,0,2974,G
1-PB2,1615,2817,0,0,0,2817,A
1-PB2,1616,0,2764,0,0,2764,T
1-PB2,1617,0,2731,0,0,2731,T
1-PB2,1618,2712,0,2,0,2714,A
1-PB2,1619,2701,0,1,0,2702,A
1-PB2,1620,1,2,0,2689,2692,C
1-PB2,1621,0,3,2580,0,2583,G
1-PB2,1622,1,0,2636,0,2637,G
1-PB2,1623,0,2427,0,1,2428,T
1-PB2,1624,2,0,0,2409,2411,C
1-PB2,1625,2,1,0,2419,2422,C
1-PB2,1626,1,2353,0,4,2358,T
1-PB2,1627,0,2,2378,0,2380,G
1-PB2,1628,2368,0,1,0,2369,A
1-PB2,1629,0,0,2382,0,2382,G
1-PB2,1630,0,2353,0,2,2355,T
1-PB2,1631,2,2,0,2286,2290,C
1-PB2,1632,1,1,2283,0,2285,G
1-PB2,1633,0,2,2310,0,2312,G
1-PB2,1634,0,2317,0,0,2317,T
1-PB2,1635,0,2326,0,0,2326,T
1-PB2,1636,0,2314,0,1,2315,T
1-PB2,1637,0,2330,2,1,2333,T
1-PB2,1638,0,4,2369,0,2373,G
1-PB2,1639,0,0,2395,0,2395,G
1-PB2,1640,0,2383,0,0,2383,T
1-PB2,1641,7,0,1,2394,2402,C
1-PB2,1642,2359,1,0,0,2360,A
1-PB2,1643,2434,0,0,0,2434,A
1-PB2,1644,0,2428,0,0,2428,T
1-PB2,1645,2421,0,0,0,2421,A
1-PB2,1646,0,0,0,2489,2489,C
1-PB2,1647,5,2,0,2412,2419,C
1-PB2,1648,0,2408,0,2,2410,T
1-PB2,1649,2433,0,0,0,2433,A
1-PB2,1650,0,2439,0,0,2439,T
1-PB2,1651,0,0,0,2450,2450,C
1-PB2,1652,2366,0,2,0,2368,A
1-PB2,1653,2368,0,0,0,2368,A
1-PB2,1654,0,2365,0,0,2365,T
1-PB2,1655,0,4,2293,0,2297,G
1-PB2,1656,0,0,2299,0,2299,G
1-PB2,1657,2269,0,1,0,2270,A
1-PB2,1658,0,2233,0,2,2235,T
1-PB2,1659,1,0,0,2235,2236,C
1-PB2,1660,2247,0,0,0,2247,A
1-PB2,1661,0,2239,0,1,2240,T
1-PB2,1662,1,0,0,2257,2258,C
1-PB2,1663,2260,0,2,0,2262,A
1-PB2,1664,0,2,2255,0,2257,G
1-PB2,1665,2244,0,2,0,2246,A
1-PB2,1666,2257,0,0,0,2257,A
1-PB2,1667,2255,0,0,0,2255,A
1-PB2,1668,0,2249,0,0,2249,T
1-PB2,1669,0,2244,0,0,2244,T
1-PB2,1670,0,3,2233,0,2236,G
1-PB2,1671,1,0,2232,0,2233,G
1-PB2,1672,0,0,2217,0,2217,G
1-PB2,1673,2224,1,0,0,2225,A
1-PB2,1674,2205,0,0,0,2205,A
1-PB2,1675,0,1,2182,0,2183,G
1-PB2,1676,0,1,0,2188,2189,C
1-PB2,1677,0,2197,0,1,2198,T
1-PB2,1678,2,0,2215,0,2217,G
1-PB2,1679,0,2197,0,1,2198,T
1-PB2,1680,4,0,0,2207,2211,C
1-PB2,1681,2225,0,0,0,2225,A
1-PB2,1682,2224,0,0,0,2224,A
1-PB2,1683,2223,0,0,0,2223,A
1-PB2,1684,2229,1,1,0,2231,A
1-PB2,1685,0,2236,0,1,2237,T
1-PB2,1686,0,2234,0,0,2234,T
1-PB2,1687,1,0,0,2219,2220,C
1-PB2,1688,2216,0,1,0,2217,A
1-PB2,1689,2216,2,1,0,2219,A
1-PB2,1690,0,2220,0,0,2220,T
1-PB2,1691,0,2,2224,0,2226,G
1-PB2,1692,0,0,2244,0,2244,G
1-PB2,1693,0,2263,0,2,2265,T
1-PB2,1694,1,1,0,2280,2282,C
1-PB2,1695,0,2282,0,1,2283,T
1-PB2,1696,1,0,0,2285,2286,C
1-PB2,1697,2290,0,1,0,2291,A
1-PB2,1698,0,1,2290,0,2291,G
1-PB2,1699,2311,0,0,0,2311,A
1-PB2,1700,2316,0,0,0,2316,A
1-PB2,1701,0,2276,0,0,2276,T
1-PB2,1702,2,0,0,2217,2219,C
1-PB2,1703,2,0,0,2265,2267,C
1-PB2,1704,1,2265,0,3,2269,T
1-PB2,1705,0,0,2270,0,2270,G
1-PB2,1706,0,1,0,2273,2274,C
1-PB2,1707,2274,0,0,0,2274,A
1-PB2,1708,2313,0,0,0,2313,A
1-PB2,1709,0,2270,0,0,2270,T
1-PB2,1710,0,0,2302,0,2302,G
1-PB2,1711,0,2320,0,2,2322,T
1-PB2,1712,0,2264,0,1,2265,T
1-PB2,1713,0,0,2283,0,2283,G
1-PB2,1714,0,2262,0,0,2262,T
1-PB2,1715,2274,0,2,1,2277,A
1-PB2,1716,0,1,0,2278,2279,C
1-PB2,1717,2240,0,0,1,2241,A
1-PB2,1718,2255,0,1,1,2257,A
1-PB2,1719,0,0,0,2234,2234,C
1-PB2,1720,2193,0,0,0,2193,A
1-PB2,1721,2193,0,0,1,2194,A
1-PB2,1722,2154,0,6,0,2160,A
1-PB2,1723,2163,0,0,1,2164,A
1-PB2,1724,0,2148,0,0,2148,T
1-PB2,1725,0,2,2146,0,2148,G
1-PB2,1726,0,3,2155,0,2158,G
1-PB2,1727,2155,0,1,1,2157,A
1-PB2,1728,2179,0,0,0,2179,A
1-PB2,1729,0,2174,0,0,2174,T
1-PB2,1730,0,2172,0,0,2172,T
1-PB2,1731,0,2173,0,0,2173,T
1-PB2,1732,0,2,2160,0,2162,G
1-PB2,1733,2170,1,1,0,2172,A
1-PB2,1734,2165,0,0,0,2165,A
1-PB2,1735,0,2,0,2155,2157,C
1-PB2,1736,2,1,0,2135,2138,C
1-PB2,1737,2172,0,0,0,2172,A
1-PB2,1738,0,2190,0,0,2190,T
1-PB2,1739,0,2195,0,0,2195,T
1-PB2,1740,0,2191,0,1,2192,T
1-PB2,1741,0,0,0,2197,2197,C
1-PB2,1742,2198,0,1,0,2199,A
1-PB2,1743,2211,0,0,0,2211,A
1-PB2,1744,0,2200,0,0,2200,T
1-PB2,1745,1,0,0,2232,2233,C
1-PB2,1746,0,2203,0,0,2203,T
1-PB2,1747,0,2214,0,0,2214,T
1-PB2,1748,0,2208,0,0,2208,T
1-PB2,1749,2211,0,1,0,2212,A
1-PB2,1750,0,0,2211,0,2211,G
1-PB2,1751,0,2196,0,1,2197,T
1-PB2,1752,1,0,0,2229,2230,C
1-PB2,1753,2,0,1,2238,2241,C
1-PB2,1754,1,1,0,2218,2220,C
1-PB2,1755,1,1,0,2219,2221,C
1-PB2,1756,2215,0,1,0,2216,A
1-PB2,1757,2221,0,2,0,2223,A
1-PB2,1758,0,2,2262,0,2264,G
1-PB2,1759,0,0,2243,0,2243,G
1-PB2,1760,0,0,0,2251,2251,C
1-PB2,1761,0,3,0,2230,2233,C
1-PB2,1762,2243,0,0,0,2243,A
1-PB2,1763,0,2269,0,0,2269,T
1-PB2,1764,0,2265,0,1,2266,T
1-PB2,1765,2278,0,0,0,2278,A
1-PB2,1766,0,1,2266,0,2267,G
1-PB2,1767,2226,0,2,0,2228,A
1-PB2,1768,2284,0,4,0,2288,A
1-PB2,1769,0,0,2312,0,2312,G
1-PB2,1770,0,0,0,2312,2312,C
1-PB2,1771,1,0,0,2336,2337,C
1-PB2,1772,2301,0,0,0,2301,A
1-PB2,1773,2323,0,1,0,2324,A
1-PB2,1774,0,2337,0,0,2337,T
1-PB2,1775,2341,0,0,0,2341,A
1-PB2,1776,0,0,0,2354,2354,C
1-PB2,1777,2217,0,0,0,2217,A
1-PB2,1778,0,2,2228,0,2230,G
1-PB2,1779,0,2192,0,0,2192,T
1-PB2,1780,0,4,2222,0,2226,G
1-PB2,1781,0,0,2219,0,2219,G
1-PB2,1782,1,1,2227,0,2229,G
1-PB2,1783,0,2186,0,0,2186,T
1-PB2,1784,0,2173,0,0,2173,T
1-PB2,1785,1,2199,0,1,2201,T
1-PB2,1786,1,0,2215,0,2216,G
1-PB2,1787,0,2202,0,1,2203,T
1-PB2,1788,2,0,0,2211,2213,C
1-PB2,1789,2196,0,0,0,2196,A
1-PB2,1790,0,2,2190,0,2192,G
1-PB2,1791,2186,0,0,0,2186,A
1-PB2,1792,2187,0,1,0,2188,A
1-PB2,1793,0,0,0,2178,2178,C
1-PB2,1794,0,2135,0,0,2135,T
1-PB2,1795,0,1,0,2193,2194,C
1-PB2,1796,0,2197,0,1,2198,T
1-PB2,1797,2209,0,0,0,2209,A
1-PB2,1798,0,2211,0,1,2212,T
1-PB2,1799,1,2196,0,0,2197,T
1-PB2,1800,0,1,0,2189,2190,C
1-PB2,1801,2,1,0,2188,2191,C
1-PB2,1802,2178,0,2,0,2180,A
1-PB2,1803,2193,0,1,1,2195,A
1-PB2,1804,0,0,0,2200,2200,C
1-PB2,1805,2192,0,0,0,2192,A
1-PB2,1806,2179,0,0,0,2179,A
1-PB2,1807,2186,0,0,0,2186,A
1-PB2,1808,0,2193,0,1,2194,T
1-PB2,1809,0,0,2199,1,2200,G
1-PB2,1810,2190,0,1,0,2191,A
1-PB2,1811,0,2,2203,0,2205,G
1-PB2,1812,2185,0,3,0,2188,A
1-PB2,1813,0,1,2189,0,2190,G
1-PB2,1814,2193,0,3,0,2196,A
1-PB2,1815,0,1,0,2187,2188,C
1-PB2,1816,0,0,2205,0,2205,G
1-PB2,1817,0,2200,0,1,2201,T
1-PB2,1818,2218,0,0,0,2218,A
1-PB2,1819,0,2,0,2236,2238,C
1-PB2,1820,1,2205,0,1,2207,T
1-PB2,1821,0,2212,0,2,2214,T
1-PB2,1822,1,1,2199,0,2201,G
1-PB2,1823,0,1,2198,1,2200,G
1-PB2,1824,0,2,2205,0,2207,G
1-PB2,1825,2185,0,2,0,2187,A
1-PB2,1826,1,0,0,2201,2202,C
1-PB2,1827,2199,0,0,0,2199,A
1-PB2,1828,0,2215,1,0,2216,T
1-PB2,1829,0,2212,0,0,2212,T
1-PB2,1830,0,2222,0,0,2222,T
1-PB2,1831,1,3,2217,0,2221,G
1-PB2,1832,2222,0,1,0,2223,A
1-PB2,1833,0,2,0,2225,2227,C
1-PB2,1834,2203,1,1,0,2205,A
1-PB2,1835,0,0,0,2223,2223,C
1-PB2,1836,1,2,1,2209,2213,C
1-PB2,1837,2220,0,2,0,2222,A
1-PB2,1838,0,0,0,2285,2285,C
1-PB2,1839,2,1,0,2297,2300,C
1-PB2,1840,3,1,0,2315,2319,C
1-PB2,1841,2304,0,3,0,2307,A
1-PB2,1842,0,0,2338,0,2338,G
1-PB2,1843,1760,0,568,0,2328,A
1-PB2,1844,0,2421,0,0,2421,T
1-PB2,1845,2419,0,1,0,2420,A
1-PB2,1846,2397,0,0,0,2397,A
1-PB2,1847,0,2375,0,0,2375,T
1-PB2,1848,2288,0,1,0,2289,A
1-PB2,1849,2282,0,0,0,2282,A
1-PB2,1850,2254,0,1,0,2255,A
1-PB2,1851,0,0,2247,0,2247,G
1-PB2,1852,0,0,0,2231,2231,C
1-PB2,1853,1,2129,1,0,2131,T
1-PB2,1854,0,2135,0,0,2135,T
1-PB2,1855,0,0,0,2141,2141,C
1-PB2,1856,0,2119,0,1,2120,T
1-PB2,1857,3,0,0,2174,2177,C
1-PB2,1858,2,0,0,2169,2171,C
1-PB2,1859,3,0,0,2183,2186,C
1-PB2,1860,1,2184,0,3,2188,T
1-PB2,1861,0,2199,0,0,2199,T
1-PB2,1862,0,2190,0,0,2190,T
1-PB2,1863,0,2204,0,1,2205,T
1-PB2,1864,0,0,2202,0,2202,G
1-PB2,1865,1,0,0,2208,2209,C
1-PB2,1866,2184,0,4,0,2188,A
1-PB2,1867,0,0,2185,0,2185,G
1-PB2,1868,0,0,0,2172,2172,C
1-PB2,1869,0,2165,0,1,2166,T
1-PB2,1870,0,0,2174,0,2174,G
1-PB2,1871,1,0,0,2157,2158,C
1-PB2,1872,0,2150,0,1,2151,T
1-PB2,1873,2,0,1,2176,2179,C
1-PB2,1874,0,0,0,2201,2201,C
1-PB2,1875,2204,0,1,0,2205,A
1-PB2,1876,0,1,0,2218,2219,C
1-PB2,1877,2,0,0,2227,2229,C
1-PB2,1878,2216,0,1,1,2218,A
1-PB2,1879,2215,0,0,0,2215,A
1-PB2,1880,2219,0,2,0,2221,A
1-PB2,1881,0,0,2233,0,2233,G
1-PB2,1882,0,0,0,2230,2230,C
1-PB2,1883,2189,0,2,0,2191,A
1-PB2,1884,2201,0,1,0,2202,A
1-PB2,1885,2186,0,0,0,2186,A
1-PB2,1886,1,0,2229,0,2230,G
1-PB2,1887,0,0,0,2229,2229,C
1-PB2,1888,2217,0,2,0,2219,A
1-PB2,1889,0,0,2222,0,2222,G
1-PB2,1890,2215,0,3,0,2218,A
1-PB2,1891,2249,0,0,0,2249,A
1-PB2,1892,0,2242,0,1,2243,T
1-PB2,1893,0,0,2234,0,2234,G
1-PB2,1894,0,0,0,2247,2247,C
1-PB2,1895,2212,0,0,0,2212,A
1-PB2,1896,1,1,2240,0,2242,G
1-PB2,1897,1,2238,0,0,2239,T
1-PB2,1898,0,2297,0,0,2297,T
1-PB2,1899,1,0,0,2304,2305,C
1-PB2,1900,0,2278,0,3,2281,T
1-PB2,1901,4,1,0,2305,2310,C
1-PB2,1902,0,2297,0,4,2301,T
1-PB2,1903,1,2299,0,0,2300,T
1-PB2,1904,1,0,2,2304,2307,C
1-PB2,1905,2277,2,0,0,2279,A
1-PB2,1906,0,0,0,2286,2286,C
1-PB2,1907,0,2199,0,0,2199,T
1-PB2,1908,0,4,2230,0,2234,G
1-PB2,1909,2200,0,0,0,2200,A
1-PB2,1910,0,0,0,2252,2252,C
1-PB2,1911,0,2234,0,0,2234,T
1-PB2,1912,0,0,2255,0,2255,G
1-PB2,1913,0,2229,0,0,2229,T
1-PB2,1914,1,2,2262,0,2265,G
1-PB2,1915,2251,0,2,0,2253,A
1-PB2,1916,2307,0,0,0,2307,A
1-PB2,1917,0,2278,0,0,2278,T
1-PB2,1918,0,0,2274,0,2274,G
1-PB2,1919,1,2210,0,0,2211,T
1-PB2,1920,2175,0,0,0,2175,A
1-PB2,1921,2182,0,2,0,2184,A
1-PB2,1922,0,3,2183,0,2186,G
1-PB2,1923,0,0,2191,0,2191,G
1-PB2,1924,1,4,2173,0,2178,G
1-PB2,1925,1,1,2201,1,2204,G
1-PB2,1926,2200,0,3,0,2203,A
1-PB2,1927,0,2183,0,1,2184,T
1-PB2,1928,3,1,0,2190,2194,C
1-PB2,1929,2197,1,3,0,2201,A
1-PB2,1930,1,1,2241,0,2243,G
1-PB2,1931,1,0,2233,0,2234,G
1-PB2,1932,0,0,2236,0,2236,G
1-PB2,1933,2229,2,0,0,2231,A
1-PB2,1934,0,2169,0,0,2169,T
1-PB2,1935,1,0,2187,0,2188,G
1-PB2,1936,2155,0,0,0,2155,A
1-PB2,1937,0,0,2239,0,2239,G
1-PB2,1938,2242,0,2,0,2244,A
1-PB2,1939,2198,0,1,0,2199,A
1-PB2,1940,0,2227,0,0,2227,T
1-PB2,1941,2218,0,0,0,2218,A
1-PB2,1942,2,0,0,2249,2251,C
1-PB2,1943,0,2226,0,3,2229,T
1-PB2,1944,0,2234,0,1,2235,T
1-PB2,1945,0,1,2232,0,2233,G
1-PB2,1946,1,2180,0,0,2181,T
1-PB2,1947,2181,0,0,0,2181,A
1-PB2,1948,2169,1,0,0,2170,A
1-PB2,1949,0,3,2117,0,2120,G
1-PB2,1950,1,1,2131,0,2133,G
1-PB2,1951,1,1,2093,0,2095,G
1-PB2,1952,0,0,2089,0,2089,G
1-PB2,1953,1,0,0,2119,2120,C
1-PB2,1954,2108,0,1,0,2109,A
1-PB2,1955,2158,0,0,0,2158,A
1-PB2,1956,0,2160,0,1,2161,T
1-PB2,1957,0,2154,0,0,2154,T
1-PB2,1958,2,0,0,2188,2190,C
1-PB2,1959,0,2160,0,0,2160,T
1-PB2,1960,2,0,0,2204,2206,C
1-PB2,1961,2,0,0,2209,2211,C
1-PB2,1962,0,2194,0,2,2196,T
1-PB2,1963,0,0,2241,0,2241,G
1-PB2,1964,0,2199,0,0,2199,T
1-PB2,1965,2196,1,1,1,2199,A
1-PB2,1966,0,2208,0,1,2209,T
1-PB2,1967,0,2158,0,3,2161,T
1-PB2,1968,0,0,0,2183,2183,C
1-PB2,1969,2165,0,0,0,2165,A
1-PB2,1970,2186,0,0,0,2186,A
1-PB2,1971,0,2,0,2188,2190,C
1-PB2,1972,0,2155,0,2,2157,T
1-PB2,1973,2145,0,0,0,2145,A
1-PB2,1974,0,0,0,2217,2217,C
1-PB2,1975,2214,0,0,0,2214,A
1-PB2,1976,2211,0,2,0,2213,A
1-PB2,1977,1,0,0,2208,2209,C
1-PB2,1978,2191,0,0,0,2191,A
1-PB2,1979,2168,0,1,0,2169,A
1-PB2,1980,0,2,2173,0,2175,G
1-PB2,1981,2172,0,2,0,2174,A
1-PB2,1982,1,2,0,2172,2175,C
1-PB2,1983,4,0,0,2113,2117,C
1-PB2,1984,2123,0,1,0,2124,A
1-PB2,1985,0,0,0,2203,2203,C
1-PB2,1986,0,2208,0,0,2208,T
1-PB2,1987,2205,0,2,0,2207,A
1-PB2,1988,2199,0,1,1,2201,A
1-PB2,1989,2203,0,0,0,2203,A
1-PB2,1990,2194,0,3,0,2197,A
1-PB2,1991,0,0,2215,0,2215,G
1-PB2,1992,2190,0,1,0,2191,A
1-PB2,1993,0,0,0,2196,2196,C
1-PB2,1994,0,2142,0,2,2144,T
1-PB2,1995,2150,0,0,0,2150,A
1-PB2,1996,2141,0,0,0,2141,A
1-PB2,1997,0,0,0,2148,2148,C
1-PB2,1998,2151,0,1,0,2152,A
1-PB2,1999,2147,1,0,0,2148,A
1-PB2,2000,0,2114,0,0,2114,T
1-PB2,2001,0,2112,0,0,2112,T
1-PB2,2002,1,1,0,2121,2123,C
1-PB2,2003,0,2097,0,0,2097,T
1-PB2,2004,3,0,0,2132,2135,C
1-PB2,2005,1,2,2133,0,2136,G
1-PB2,2006,0,4,2124,0,2128,G
1-PB2,2007,2130,1,1,0,2132,A
1-PB2,2008,2127,0,1,0,2128,A
1-PB2,2009,2135,1,0,0,2136,A
1-PB2,2010,2133,1,2,0,2136,A
1-PB2,2011,0,0,2141,0,2141,G
1-PB2,2012,2131,0,1,0,2132,A
1-PB2,2013,0,2137,0,0,2137,T
1-PB2,2014,0,0,2140,0,2140,G
1-PB2,2015,0,0,0,2124,2124,C
1-PB2,2016,5,0,0,2128,2133,C
1-PB2,2017,1,1,2134,0,2136,G
1-PB2,2018,1,3,2116,0,2120,G
1-PB2,2019,0,0,0,2132,2132,C
1-PB2,2020,2128,0,1,0,2129,A
1-PB2,2021,1,0,0,2165,2166,C
1-PB2,2022,0,2159,0,0,2159,T
1-PB2,2023,0,2149,0,1,2150,T
1-PB2,2024,0,2164,0,0,2164,T
1-PB2,2025,2167,0,0,0,2167,A
1-PB2,2026,2175,0,0,0,2175,A
1-PB2,2027,0,2169,0,0,2169,T
1-PB2,2028,0,2171,0,0,2171,T
1-PB2,2029,1,3,2162,0,2166,G
1-PB2,2030,2121,0,0,0,2121,A
1-PB2,2031,2123,0,1,0,2124,A
1-PB2,2032,0,2,2118,0,2120,G
1-PB2,2033,2129,0,0,0,2129,A
1-PB2,2034,1,0,1,2146,2148,C
1-PB2,2035,0,0,0,2128,2128,C
1-PB2,2036,1,0,0,2132,2133,C
1-PB2,2037,2129,0,1,0,2130,A
1-PB2,2038,0,1,2167,0,2168,G
1-PB2,2039,2164,0,0,0,2164,A
1-PB2,2040,0,2164,0,1,2165,T
1-PB2,2041,0,0,2152,0,2152,G
1-PB2,2042,2117,0,1,0,2118,A
1-PB2,2043,2113,0,0,0,2113,A
1-PB2,2044,2115,0,1,0,2116,A
1-PB2,2045,0,1,2106,0,2107,G
1-PB2,2046,1,0,0,2116,2117,C
1-PB2,2047,2056,0,0,0,2056,A
1-PB2,2048,1,1,0,2082,2084,C
1-PB2,2049,2098,0,0,0,2098,A
1-PB2,2050,0,2048,0,0,2048,T
1-PB2,2051,2,0,0,2086,2088,C
1-PB2,2052,1,0,0,2079,2080,C
1-PB2,2053,1,0,2094,0,2095,G
1-PB2,2054,0,0,2096,0,2096,G
1-PB2,2055,2083,0,0,0,2083,A
1-PB2,2056,0,0,2099,0,2099,G
1-PB2,2057,0,2047,0,4,2051,T
1-PB2,2058,1,0,2059,0,2060,G
1-PB2,2059,2,4,2051,0,2057,G
1-PB2,2060,2029,0,2,0,2031,A
1-PB2,2061,0,0,2023,0,2023,G
1-PB2,2062,0,1988,0,1,1989,T
1-PB2,2063,1,0,1,1977,1979,C
1-PB2,2064,1,0,0,1992,1993,C
1-PB2,2065,0,0,1990,0,1990,G
1-PB2,2066,0,1,0,1984,1985,C
1-PB2,2067,5,0,0,1976,1981,C
1-PB2,2068,1,0,2026,0,2027,G
1-PB2,2069,0,2001,0,1,2002,T
1-PB2,2070,1,1,0,2026,2028,C
1-PB2,2071,1,2024,0,1,2026,T
1-PB2,2072,0,2030,0,1,2031,T
1-PB2,2073,2,0,2022,0,2024,G
1-PB2,2074,2023,0,0,0,2023,A
1-PB2,2075,0,0,2018,0,2018,G
1-PB2,2076,2013,0,2,0,2015,A
1-PB2,2077,0,1,1957,0,1958,G
1-PB2,2078,1,2,1957,0,1960,G
1-PB2,2079,2,2,1941,0,1945,G
1-PB2,2080,0,1934,0,1,1935,T
1-PB2,2081,0,1926,0,0,1926,T
1-PB2,2082,0,1933,0,1,1934,T
1-PB2,2083,1,0,0,1938,1939,C
1-PB2,2084,0,1938,0,1,1939,T
1-PB2,2085,0,0,0,2002,2002,C
1-PB2,2086,1982,0,1,0,1983,A
1-PB2,2087,0,1967,0,2,1969,T
1-PB2,2088,0,1967,0,0,1967,T
1-PB2,2089,1963,0,0,0,1963,A
1-PB2,2090,0,1971,0,1,1972,T
1-PB2,2091,1944,0,0,0,1944,A
1-PB2,2092,0,3,1954,0,1957,G
1-PB2,2093,0,0,1958,0,1958,G
1-PB2,2094,0,1864,0,1,1865,T
1-PB2,2095,1856,0,0,0,1856,A
1-PB2,2096,1844,0,3,0,1847,A
1-PB2,2097,0,1,1864,0,1865,G
1-PB2,2098,0,1,1862,0,1863,G
1-PB2,2099,1857,0,0,0,1857,A
1-PB2,2100,1829,0,1,0,1830,A
1-PB2,2101,1,1,1834,0,1836,G
1-PB2,2102,1825,1,1,0,1827,A
1-PB2,2103,0,1,0,1831,1832,C
1-PB2,2104,1830,0,0,0,1830,A
1-PB2,2105,0,0,1833,0,1833,G
1-PB2,2106,1812,0,4,0,1816,A
1-PB2,2107,1797,0,2,0,1799,A
1-PB2,2108,0,2,1795,0,1797,G
1-PB2,2109,0,0,1751,0,1751,G
1-PB2,2110,0,1775,0,0,1775,T
1-PB2,2111,1782,0,0,0,1782,A
1-PB2,2112,0,1,0,1793,1794,C
1-PB2,2113,2,2,1772,0,1776,G
1-PB2,2114,1,2,1808,0,1811,G
1-PB2,2115,1802,0,0,0,1802,A
1-PB2,2116,0,0,0,1777,1777,C
1-PB2,2117,0,0,0,1781,1781,C
1-PB2,2118,1725,0,1,0,1726,A
1-PB2,2119,0,1,1780,0,1781,G
1-PB2,2120,0,0,0,1775,1775,C
1-PB2,2121,1776,0,1,0,1777,A
1-PB2,2122,0,1772,0,0,1772,T
1-PB2,2123,0,1668,0,0,1668,T
1-PB2,2124,1670,0,0,0,1670,A
1-PB2,2125,1662,0,1,0,1663,A
1-PB2,2126,0,0,1672,0,1672,G
1-PB2,2127,0,0,0,1659,1659,C
1-PB2,2128,1580,0,0,0,1580,A
1-PB2,2129,0,1626,0,0,1626,T
1-PB2,2130,1,0,0,1630,1631,C
1-PB2,2131,1631,0,0,0,1631,A
1-PB2,2132,1631,0,0,0,1631,A
1-PB2,2133,0,1623,0,2,1625,T
1-PB2,2134,0,2,1628,0,1630,G
1-PB2,2135,1611,0,0,0,1611,A
1-PB2,2136,1598,0,0,0,1598,A
1-PB2,2137,1,1,0,1603,1605,C
1-PB2,2138,0,1517,0,1,1518,T
1-PB2,2139,0,0,1562,1,1563,G
1-PB2,2140,1547,0,0,0,1547,A
1-PB2,2141,0,1,1544,0,1545,G
1-PB2,2142,0,1549,0,0,1549,T
1-PB2,2143,1528,0,0,0,1528,A
1-PB2,2144,1516,0,1,0,1517,A
1-PB2,2145,0,0,0,1523,1523,C
1-PB2,2146,2,0,0,1470,1472,C
1-PB2,2147,0,1464,0,2,1466,T
1-PB2,2148,0,1416,0,3,1419,T
1-PB2,2149,0,0,1423,0,1423,G
1-PB2,2150,0,1,1,1413,1415,C
1-PB2,2151,1418,0,0,0,1418,A
1-PB2,2152,1414,0,0,0,1414,A
1-PB2,2153,1395,0,1,0,1396,A
1-PB2,2154,1392,0,1,0,1393,A
1-PB2,2155,0,2,1382,0,1384,G
1-PB2,2156,0,2,1380,0,1382,G
1-PB2,2157,0,0,1382,0,1382,G
1-PB2,2158,0,0,1380,0,1380,G
1-PB2,2159,1380,0,0,0,1380,A
1-PB2,2160,1380,0,1,0,1381,A
1-PB2,2161,1384,0,1,0,1385,A
1-PB2,2162,1394,0,1,0,1395,A
1-PB2,2163,0,0,1393,0,1393,G
1-PB2,2164,0,0,1383,0,1383,G
1-PB2,2165,0,0,0,1387,1387,C
1-PB2,2166,0,1391,0,1,1392,T
1-PB2,2167,1385,0,0,0,1385,A
1-PB2,2168,1390,0,0,0,1390,A
1-PB2,2169,0,1382,0,0,1382,T
1-PB2,2170,0,0,1408,0,1408,G
1-PB2,2171,0,1365,0,1,1366,T
1-PB2,2172,0,0,1360,0,1360,G
1-PB2,2173,0,0,0,1351,1351,C
1-PB2,2174,0,1348,0,2,1350,T
1-PB2,2175,1357,0,0,0,1357,A
1-PB2,2176,1348,0,0,0,1348,A
1-PB2,2177,0,1334,0,0,1334,T
1-PB2,2178,0,0,0,1338,1338,C
1-PB2,2179,0,0,1287,0,1287,G
1-PB2,2180,1,0,1291,0,1292,G
1-PB2,2181,1,1,1286,0,1288,G
1-PB2,2182,0,0,0,1289,1289,C
1-PB2,2183,1297,0,0,0,1297,A
1-PB2,2184,1297,1,1,0,1299,A
1-PB2,2185,0,0,1299,0,1299,G
1-PB2,2186,0,1,1297,0,1298,G
1-PB2,2187,1294,0,0,0,1294,A
1-PB2,2188,0,1,1298,0,1299,G
1-PB2,2189,1233,0,0,0,1233,A
1-PB2,2190,0,0,0,1246,1246,C
1-PB2,2191,0,0,1254,0,1254,G
1-PB2,2192,1,1239,0,1,1241,T
1-PB2,2193,0,0,1248,0,1248,G
1-PB2,2194,0,0,1249,0,1249,G
1-PB2,2195,1,1216,0,0,1217,T
1-PB2,2196,1,0,1224,0,1225,G
1-PB2,2197,0,1202,1,0,1203,T
1-PB2,2198,0,1196,0,0,1196,T
1-PB2,2199,1,1,1198,0,1200,G
1-PB2,2200,0,0,1191,0,1191,G
1-PB2,2201,0,1189,0,0,1189,T
1-PB2,2202,1165,0,0,0,1165,A
1-PB2,2203,1126,0,0,0,1126,A
1-PB2,2204,0,1098,0,0,1098,T
1-PB2,2205,0,0,1091,0,1091,G
1-PB2,2206,1087,0,0,0,1087,A
1-PB2,2207,1077,0,0,0,1077,A
1-PB2,2208,1069,0,0,0,1069,A
1-PB2,2209,0,0,0,1077,1077,C
1-PB2,2210,0,0,1074,0,1074,G
1-PB2,2211,1075,0,1,0,1076,A
1-PB2,2212,1078,0,0,0,1078,A
1-PB2,2213,1072,0,3,0,1075,A
1-PB2,2214,1068,0,0,0,1068,A
1-PB2,2215,0,0,0,1077,1077,C
1-PB2,2216,0,3,1063,0,1066,G
1-PB2,2217,0,0,1050,0,1050,G
1-PB2,2218,0,0,1057,0,1057,G
1-PB2,2219,1053,0,0,0,1053,A
1-PB2,2220,0,1,0,1054,1055,C
1-PB2,2221,0,1035,0,1,1036,T
1-PB2,2222,2,0,1,1043,1046,C
1-PB2,2223,0,1056,0,0,1056,T
1-PB2,2224,1048,0,1,0,1049,A
1-PB2,2225,0,0,1050,0,1050,G
1-PB2,2226,0,0,0,1023,1023,C
1-PB2,2227,1025,0,0,0,1025,A
1-PB2,2228,0,1015,0,0,1015,T
1-PB2,2229,972,0,0,0,972,A
1-PB2,2230,0,0,0,983,983,C
1-PB2,2231,0,850,0,0,850,T
1-PB2,2232,0,850,0,0,850,T
1-PB2,2233,830,0,0,0,830,A
1-PB2,2234,0,2,0,827,829,C
1-PB2,2235,0,817,0,0,817,T
1-PB2,2236,0,0,813,0,813,G
1-PB2,2237,796,0,0,0,796,A
1-PB2,2238,0,0,0,793,793,C
1-PB2,2239,726,0,0,0,726,A
1-PB2,2240,0,0,727,0,727,G
1-PB2,2241,0,0,0,719,719,C
1-PB2,2242,1,1,0,715,717,C
1-PB2,2243,715,0,0,0,715,A
1-PB2,2244,0,1,712,0,713,G
1-PB2,2245,710,0,0,0,710,A
1-PB2,2246,0,1,0,712,713,C
1-PB2,2247,657,0,0,0,657,A
1-PB2,2248,0,0,655,0,655,G
1-PB2,2249,0,1,0,607,608,C
1-PB2,2250,0,2,610,0,612,G
1-PB2,2251,605,0,0,0,605,A
1-PB2,2252,0,0,0,605,605,C
1-PB2,2253,1,1,0,608,610,C
1-PB2,2254,607,0,0,0,607,A
1-PB2,2255,610,0,0,0,610,A
1-PB2,2256,608,0,1,0,609,A
1-PB2,2257,609,0,1,0,610,A
1-PB2,2258,0,1,609,0,610,G
1-PB2,2259,583,0,0,0,583,A
1-PB2,2260,583,0,1,1,585,A
1-PB2,2261,0,570,0,0,570,T
1-PB2,2262,0,573,0,0,573,T
1-PB2,2263,2,0,0,575,577,C
1-PB2,2264,0,1,565,0,566,G
1-PB2,2265,0,1,563,0,564,G
1-PB2,2266,559,0,0,0,559,A
1-PB2,2267,0,532,1,0,533,T
1-PB2,2268,0,0,538,0,538,G
1-PB2,2269,1,0,525,0,526,G
1-PB2,2270,0,0,0,514,514,C
1-PB2,2271,1,0,0,522,523,C
1-PB2,2272,525,0,0,0,525,A
1-PB2,2273,0,525,0,0,525,T
1-PB2,2274,0,0,0,523,523,C
1-PB2,2275,524,0,0,0,524,A
1-PB2,2276,530,0,0,0,530,A
1-PB2,2277,0,524,0,0,524,T
1-PB2,2278,0,469,0,0,469,T
1-PB2,2279,439,0,0,0,439,A
1-PB2,2280,440,0,0,0,440,A
2-PB1,1,198,0,0,0,198,A
2-PB1,2,0,198,0,0,198,T
2-PB1,3,0,0,202,0,202,G
2-PB1,4,0,0,217,0,217,G
2-PB1,5,263,0,0,0,263,A
2-PB1,6,0,280,0,0,280,T
2-PB1,7,0,0,282,0,282,G
2-PB1,8,0,282,0,0,282,T
2-PB1,9,1,0,0,308,309,C
2-PB1,10,310,0,0,0,310,A
2-PB1,11,321,0,0,0,321,A
2-PB1,12,0,327,0,0,327,T
2-PB1,13,0,0,0,329,329,C
2-PB1,14,0,0,0,349,349,C
2-PB1,15,0,0,353,0,353,G
2-PB1,16,388,0,0,0,388,A
2-PB1,17,0,0,0,399,399,C
2-PB1,18,0,396,0,1,397,T
2-PB1,19,0,0,0,463,463,C
2-PB1,20,0,464,0,0,464,T
2-PB1,21,471,0,0,0,471,A
2-PB1,22,0,0,0,474,474,C
2-PB1,23,1,473,0,0,474,T
2-PB1,24,0,0,539,0,539,G
2-PB1,25,0,548,0,0,548,T
2-PB1,26,1,543,0,0,544,T
2-PB1,27,2,0,1,540,543,C
2-PB1,28,0,1,0,543,544,C
2-PB1,29,0,622,0,0,622,T
2-PB1,30,656,0,0,0,656,A
2-PB1,31,655,0,0,0,655,A
2-PB1,32,697,0,1,0,698,A
2-PB1,33,0,1,714,0,715,G
2-PB1,34,0,0,713,0,713,G
2-PB1,35,0,710,0,2,712,T
2-PB1,36,0,260,0,456,716,C
2-PB1,37,0,0,0,737,737,C
2-PB1,38,0,0,0,744,744,C
2-PB1,39,745,0,1,0,746,A
2-PB1,40,0,0,753,0,753,G
2-PB1,41,0,0,0,759,759,C
2-PB1,42,0,0,758,0,758,G
2-PB1,43,0,0,0,762,762,C
2-PB1,44,767,0,0,0,767,A
2-PB1,45,769,0,0,0,769,A
2-PB1,46,766,0,0,0,766,A
2-PB1,47,769,0,1,0,770,A
2-PB1,48,0,777,0,0,777,T
2-PB1,49,0,0,817,0,817,G
2-PB1,50,0,1,0,824,825,C
2-PB1,51,0,0,0,827,827,C
2-PB1,52,825,1,0,0,826,A
2-PB1,53,0,831,0,0,831,T
2-PB1,54,890,0,0,0,890,A
2-PB1,55,885,0,0,0,885,A
2-PB1,56,0,1,918,0,919,G
2-PB1,57,0,1,0,923,924,C
2-PB1,58,919,0,1,0,920,A
2-PB1,59,0,0,0,952,952,C
2-PB1,60,955,0,0,0,955,A
2-PB1,61,1000,0,0,0,1000,A
2-PB1,62,0,0,0,1010,1010,C
2-PB1,63,1010,0,0,0,1010,A
2-PB1,64,0,1018,0,0,1018,T
2-PB1,65,0,1021,0,0,1021,T
2-PB1,66,0,0,0,1238,1238,C
2-PB1,67,1,0,0,1236,1237,C
2-PB1,68,1,0,0,1260,1261,C
2-PB1,69,0,1270,0,3,1273,T
2-PB1,70,0,1271,0,1,1272,T
2-PB1,71,1369,0,0,0,1369,A
2-PB1,72,0,1363,0,7,1370,T
2-PB1,73,1387,0,1,0,1388,A
2-PB1,74,0,0,0,1399,1399,C
2-PB1,75,0,1376,0,2,1378,T
2-PB1,76,1,0,1389,0,1390,G
2-PB1,77,0,3,1382,0,1385,G
2-PB1,78,1391,0,1,0,1392,A
2-PB1,79,0,0,1396,0,1396,G
2-PB1,80,1383,1,1,0,1385,A
2-PB1,81,0,1385,0,1,1386,T
2-PB1,82,0,1,0,1463,1464,C
2-PB1,83,0,0,0,1471,1471,C
2-PB1,84,0,1472,0,3,1475,T
2-PB1,85,0,0,0,1569,1569,C
2-PB1,86,0,0,0,1570,1570,C
2-PB1,87,1579,0,0,0,1579,A
2-PB1,88,0,1578,0,1,1579,T
2-PB1,89,1579,0,0,0,1579,A
2-PB1,90,0,0,0,1588,1588,C
2-PB1,91,1579,0,0,0,1579,A
2-PB1,92,0,0,1661,0,1661,G
2-PB1,93,0,0,0,1674,1674,C
2-PB1,94,2,0,0,1665,1667,C
2-PB1,95,1677,0,0,0,1677,A
2-PB1,96,1,1670,0,4,1675,T
2-PB1,97,1,2,1676,0,1679,G
2-PB1,98,0,2,1774,0,1776,G
2-PB1,99,1778,0,0,0,1778,A
2-PB1,100,1789,0,1,0,1790,A
2-PB1,101,0,0,0,1792,1792,C
2-PB1,102,1773,0,2,0,1775,A
2-PB1,103,3,2,1808,0,1813,G
2-PB1,104,0,1,1848,0,1849,G
2-PB1,105,1839,0,3,0,1842,A
2-PB1,106,1861,0,2,0,1863,A
2-PB1,107,0,0,0,1868,1868,C
2-PB1,108,1855,0,1,0,1856,A
2-PB1,109,0,2,2082,0,2084,G
2-PB1,110,0,1,2071,0,2072,G
2-PB1,111,0,1,2112,0,2113,G
2-PB1,112,0,2101,0,0,2101,T
2-PB1,113,2112,0,0,0,2112,A
2-PB1,114,0,0,0,2141,2141,C
2-PB1,115,2208,0,2,0,2210,A
2-PB1,116,0,0,0,2300,2300,C
2-PB1,117,1,0,0,2282,2283,C
2-PB1,118,2233,0,1,0,2234,A
2-PB1,119,0,2219,0,0,2219,T
2-PB1,120,1,2,2229,0,2232,G
2-PB1,121,0,0,2237,0,2237,G
2-PB1,122,2237,0,1,0,2238,A
2-PB1,123,1,0,0,2255,2256,C
2-PB1,124,2230,1,5,0,2236,A
2-PB1,125,1,1,0,2282,2284,C
2-PB1,126,2280,0,2,0,2282,A
2-PB1,127,0,0,2341,0,2341,G
2-PB1,128,0,2330,0,3,2333,T
2-PB1,129,2,0,0,2406,2408,C
2-PB1,130,2406,1,0,0,2407,A
2-PB1,131,2433,0,1,0,2434,A
2-PB1,132,0,0,0,2435,2435,C
2-PB1,133,2433,0,1,0,2434,A
2-PB1,134,0,3,2449,0,2452,G
2-PB1,135,2422,0,2,1,2425,A
2-PB1,136,2420,0,4,0,2424,A
2-PB1,137,0,0,0,2430,2430,C
2-PB1,138,2396,1,0,1,2398,A
2-PB1,139,0,0,0,2408,2408,C
2-PB1,140,2398,0,0,0,2398,A
2-PB1,141,0,2376,0,1,2377,T
2-PB1,142,0,0,0,2543,2543,C
2-PB1,143,2546,0,0,0,2546,A
2-PB1,144,2578,0,0,0,2578,A
2-PB1,145,0,2618,0,0,2618,T
2-PB1,146,2692,0,1,0,2693,A
2-PB1,147,0,2692,0,0,2692,T
2-PB1,148,0,2667,0,1,2668,T
2-PB1,149,3,2,0,2660,2665,C
2-PB1,150,2634,0,3,1,2638,A
2-PB1,151,0,2,2645,0,2647,G
2-PB1,152,2624,0,0,0,2624,A
2-PB1,153,0,0,2643,0,2643,G
2-PB1,154,2580,0,1,0,2581,A
2-PB1,155,1,1,2560,0,2562,G
2-PB1,156,0,4,2537,0,2541,G
2-PB1,157,0,4,2619,0,2623,G
2-PB1,158,0,1,2614,0,2615,G
2-PB1,159,1,1,2642,0,2644,G
2-PB1,160,2633,1,3,0,2637,A
2-PB1,161,2650,0,2,0,2652,A
2-PB1,162,0,1,2662,0,2663,G
2-PB1,163,0,2616,0,1,2617,T
2-PB1,164,0,5,2623,0,2628,G
2-PB1,165,0,0,2617,0,2617,G
2-PB1,166,2627,0,5,0,2632,A
2-PB1,167,0,1,0,2652,2653,C
2-PB1,168,0,3,2661,0,2664,G
2-PB1,169,2665,0,4,0,2669,A
2-PB1,170,0,0,1,2698,2699,C
2-PB1,171,2685,0,0,0,2685,A
2-PB1,172,2683,0,1,0,2684,A
2-PB1,173,2697,0,2,0,2699,A
2-PB1,174,0,2730,0,0,2730,T
2-PB1,175,2736,0,0,0,2736,A
2-PB1,176,1,0,0,2737,2738,C
2-PB1,177,2716,0,2,0,2718,A
2-PB1,178,0,1,2723,0,2724,G
2-PB1,179,2704,0,1,0,2705,A
2-PB1,180,2730,0,0,0,2730,A
2-PB1,181,2727,0,0,0,2727,A
2-PB1,182,0,0,0,2734,2734,C
2-PB1,183,0,2698,0,0,2698,T
2-PB1,184,0,1,2679,0,2680,G
2-PB1,185,0,2,2640,1,2643,G
2-PB1,186,0,2,2632,0,2634,G
2-PB1,187,3,0,2634,0,2637,G
2-PB1,188,2,0,0,2672,2674,C
2-PB1,189,2676,0,1,0,2677,A
2-PB1,190,0,3,0,2751,2754,C
2-PB1,191,1,0,0,2754,2755,C
2-PB1,192,6,0,0,2748,2754,C
2-PB1,193,0,0,0,2765,2765,C
2-PB1,194,2768,1,1,0,2770,A
2-PB1,195,2798,0,2,0,2800,A
2-PB1,196,1,0,0,2799,2800,C
2-PB1,197,0,2781,0,1,2782,T
2-PB1,198,2,0,0,2798,2800,C
2-PB1,199,2738,0,1,0,2739,A
2-PB1,200,2751,0,3,0,2754,A
2-PB1,201,0,0,1,2748,2749,C
2-PB1,202,4,0,0,2735,2739,C
2-PB1,203,1,0,0,2749,2750,C
2-PB1,204,2742,0,1,0,2743,A
2-PB1,205,2749,0,0,0,2749,A
2-PB1,206,0,2762,0,0,2762,T
2-PB1,207,0,2750,0,2,2752,T
2-PB1,208,1,2,2760,0,2763,G
2-PB1,209,2732,0,0,0,2732,A
2-PB1,210,0,2732,2,0,2734,T
2-PB1,211,1,3,2733,0,2737,G
2-PB1,212,1,5,2729,0,2735,G
2-PB1,213,2772,1,5,0,2778,A
2-PB1,214,2,0,0,2793,2795,C
2-PB1,215,3,0,0,2785,2788,C
2-PB1,216,2780,0,2,0,2782,A
2-PB1,217,0,1,0,2842,2843,C
2-PB1,218,0,2840,0,1,2841,T
2-PB1,219,2873,2,1,0,2876,A
2-PB1,220,0,0,0,2916,2916,C
2-PB1,221,4,0,0,2886,2890,C
2-PB1,222,0,2868,0,4,2872,T
2-PB1,223,0,0,2879,0,2879,G
2-PB1,224,2856,1,2,0,2859,A
2-PB1,225,6,1,2873,0,2880,G
2-PB1,226,2,0,2859,0,2861,G
2-PB1,227,2841,0,0,0,2841,A
2-PB1,228,0,2816,0,0,2816,T
2-PB1,229,2804,0,0,0,2804,A
2-PB1,230,2789,0,1,0,2790,A
2-PB1,231,1,2800,0,0,2801,T
2-PB1,232,0,4,2807,0,2811,G
2-PB1,233,2794,0,1,0,2795,A
2-PB1,234,2784,0,2,0,2786,A
2-PB1,235,1,2,1,2790,2794,C
2-PB1,236,1,1,0,2758,2760,C
2-PB1,237,2784,0,0,0,2784,A
2-PB1,238,2774,0,1,0,2775,A
2-PB1,239,0,1,2800,0,2801,G
2-PB1,240,0,2771,0,0,2771,T
2-PB1,241,0,2,2782,0,2784,G
2-PB1,242,0,1,2827,0,2828,G
2-PB1,243,2828,0,3,0,2831,A
2-PB1,244,0,2832,0,0,2832,T
2-PB1,245,2833,0,1,0,2834,A
2-PB1,246,0,2882,0,1,2883,T
2-PB1,247,1,0,2893,0,2894,G
2-PB1,248,0,1,0,2901,2902,C
2-PB1,249,2905,1,1,0,2907,A
2-PB1,250,0,0,0,2958,2958,C
2-PB1,251,2921,1,0,0,2922,A
2-PB1,252,2966,0,0,0,2966,A
2-PB1,253,2959,0,1,0,2960,A
2-PB1,254,1,0,0,2969,2970,C
2-PB1,255,2878,0,0,0,2878,A
2-PB1,256,1,2,2908,0,2911,G
2-PB1,257,2890,0,2,0,2892,A
2-PB1,258,0,0,0,2902,2902,C
2-PB1,259,0,2824,0,2,2826,T
2-PB1,260,0,0,2861,0,2861,G
2-PB1,261,0,2819,0,0,2819,T
2-PB1,262,0,1,2957,0,2958,G
2-PB1,263,1,2947,0,1,2949,T
2-PB1,264,2,2,0,2954,2958,C
2-PB1,265,1,1,0,2951,2953,C
2-PB1,266,1,2946,0,4,2951,T
2-PB1,267,0,1,2952,0,2953,G
2-PB1,268,0,1,2932,0,2933,G
2-PB1,269,2895,0,1,0,2896,A
2-PB1,270,1,3,2954,0,2958,G
2-PB1,271,0,0,2862,0,2862,G
2-PB1,272,0,0,0,2868,2868,C
2-PB1,273,0,2862,0,3,2865,T
2-PB1,274,2861,0,2,0,2863,A
2-PB1,275,0,2860,0,2,2862,T
2-PB1,276,4,2,2860,0,2866,G
2-PB1,277,0,0,2843,0,2843,G
2-PB1,278,1,0,0,2839,2840,C
2-PB1,279,5,0,0,2806,2811,C
2-PB1,280,2,2775,0,6,2783,T
2-PB1,281,0,2938,1,0,2939,T
2-PB1,282,2,0,0,2939,2941,C
2-PB1,283,6,0,1,2948,2955,C
2-PB1,284,0,2957,1,0,2958,T
2-PB1,285,0,2951,0,1,2952,T
2-PB1,286,5,0,2952,0,2957,G
2-PB1,287,2941,0,1,0,2942,A
2-PB1,288,2951,1,1,1,2954,A
2-PB1,289,0,1,2957,0,2958,G
2-PB1,290,2835,0,0,1,2836,A
2-PB1,291,2862,0,0,0,2862,A
2-PB1,292,0,2841,0,1,2842,T
2-PB1,293,1,2,0,2849,2852,C
2-PB1,294,1,2,0,2851,2854,C
2-PB1,295,3,0,0,2842,2845,C
2-PB1,296,2829,0,1,1,2831,A
2-PB1,297,1,1,0,2857,2859,C
2-PB1,298,3,0,0,2862,2865,C
2-PB1,299,3,0,0,2868,2871,C
2-PB1,300,2847,0,0,0,2847,A
2-PB1,301,4,1,2856,0,2861,G
2-PB1,302,2,0,2851,0,2853,G
2-PB1,303,0,2807,0,1,2808,T
2-PB1,304,2874,0,0,0,2874,A
2-PB1,305,0,2854,0,1,2855,T
2-PB1,306,0,0,0,2866,2866,C
2-PB1,307,0,2859,0,0,2859,T
2-PB1,308,0,2863,0,0,2863,T
2-PB1,309,0,2855,0,0,2855,T
2-PB1,310,0,1,2841,0,2842,G
2-PB1,311,2811,1,3,0,2815,A
2-PB1,312,0,2,2820,0,2822,G
2-PB1,313,2791,0,0,0,2791,A
2-PB1,314,2803,0,0,0,2803,A
2-PB1,315,1,0,0,2817,2818,C
2-PB1,316,0,2800,0,0,2800,T
2-PB1,317,2,0,0,2803,2805,C
2-PB1,318,2802,0,1,0,2803,A
2-PB1,319,1,2800,0,1,2802,T
2-PB1,320,2,2,2809,0,2813,G
2-PB1,321,1,0,0,2839,2840,C
2-PB1,322,3,0,0,2841,2844,C
2-PB1,323,0,2829,1,2,2832,T
2-PB1,324,0,2824,0,2,2826,T
2-PB1,325,0,2,2817,0,2819,G
2-PB1,326,2842,0,2,0,2844,A
2-PB1,327,2834,0,1,0,2835,A
2-PB1,328,2841,1,1,0,2843,A
2-PB1,329,1,2,0,2882,2885,C
2-PB1,330,2809,1,0,0,2810,A
2-PB1,331,2826,0,1,0,2827,A
2-PB1,332,0,2828,0,2,2830,T
2-PB1,333,0,3,2829,0,2832,G
2-PB1,334,0,1,2828,0,2829,G
2-PB1,335,2781,0,3,0,2784,A
2-PB1,336,2793,0,2,0,2795,A
2-PB1,337,1,2,2781,0,2784,G
2-PB1,338,0,1,0,2780,2781,C
2-PB1,339,1,2,0,2782,2785,C
2-PB1,340,2,0,2808,0,2810,G
2-PB1,341,0,2792,0,0,2792,T
2-PB1,342,0,2788,1,1,2790,T
2-PB1,343,3,0,0,2825,2828,C
2-PB1,344,2830,1,0,0,2831,A
2-PB1,345,2849,0,2,2,2853,A
2-PB1,346,2,1,0,2874,2877,C
2-PB1,347,2877,0,0,0,2877,A
2-PB1,348,0,4,2876,0,2880,G
2-PB1,349,2837,0,5,0,2842,A
2-PB1,350,0,0,0,2853,2853,C
2-PB1,351,2853,0,2,0,2855,A
2-PB1,352,2866,1,1,0,2868,A
2-PB1,353,0,2,2894,0,2896,G
2-PB1,354,0,3,2836,0,2839,G
2-PB1,355,0,1,2843,0,2844,G
2-PB1,356,0,2720,0,4,2724,T
2-PB1,357,3,2,2792,0,2797,G
2-PB1,358,1,5,2800,0,2806,G
2-PB1,359,2803,0,1,0,2804,A
2-PB1,360,0,0,0,2819,2819,C
2-PB1,361,2765,0,0,0,2765,A
2-PB1,362,2793,0,0,0,2793,A
2-PB1,363,2807,1,0,0,2808,A
2-PB1,364,1,0,0,2806,2807,C
2-PB1,365,0,2779,0,3,2782,T
2-PB1,366,2797,0,1,0,2798,A
2-PB1,367,2793,0,1,0,2794,A
2-PB1,368,1,0,0,2801,2802,C
2-PB1,369,0,0,0,2806,2806,C
2-PB1,370,1,0,0,2820,2821,C
2-PB1,371,2728,0,3,0,2731,A
2-PB1,372,2721,0,1,0,2722,A
2-PB1,373,0,0,2727,0,2727,G
2-PB1,374,1,0,2738,0,2739,G
2-PB1,375,0,2680,0,1,2681,T
2-PB1,376,2,0,0,2724,2726,C
2-PB1,377,0,0,2708,0,2708,G
2-PB1,378,0,3,0,2697,2700,C
2-PB1,379,1,2,0,2719,2722,C
2-PB1,380,2720,0,0,0,2720,A
2-PB1,381,0,3,2799,1,2803,G
2-PB1,382,2825,0,0,0,2825,A
2-PB1,383,1,0,0,2837,2838,C
2-PB1,384,0,2821,0,2,2823,T
2-PB1,385,0,2806,0,0,2806,T
2-PB1,386,2816,0,2,0,2818,A
2-PB1,387,0,2823,0,1,2824,T
2-PB1,388,0,2,2826,0,2828,G
2-PB1,389,2812,0,1,0,2813,A
2-PB1,390,0,2766,0,1,2767,T
2-PB1,391,0,2699,0,0,2699,T
2-PB1,392,0,2,2701,0,2703,G
2-PB1,393,0,2,2685,1,2688,G
2-PB1,394,2717,0,4,0,2721,A
2-PB1,395,0,1,0,2738,2739,C
2-PB1,396,2706,0,0,0,2706,A
2-PB1,397,0,2686,1,0,2687,T
2-PB1,398,0,2716,0,0,2716,T
2-PB1,399,2731,0,1,0,2732,A
2-PB1,400,2724,0,0,0,2724,A
2-PB1,401,2716,0,0,0,2716,A
2-PB1,402,1,0,0,2725,2726,C
2-PB1,403,2682,0,0,0,2682,A
2-PB1,404,0,1,2696,0,2697,G
2-PB1,405,2682,0,0,1,2683,A
2-PB1,406,2696,0,0,1,2697,A
2-PB1,407,2684,0,0,0,2684,A
2-PB1,408,0,2640,0,2,2642,T
2-PB1,409,5,2,0,2669,2676,C
2-PB1,410,2678,0,2,0,2680,A
2-PB1,411,2668,0,0,0,2668,A
2-PB1,412,0,1,0,2668,2669,C
2-PB1,413,0,3,0,2670,2673,C
2-PB1,414,2,2,2660,1,2665,G
2-PB1,415,2,0,2653,0,2655,G
2-PB1,416,3,2,0,2669,2674,C
2-PB1,417,2677,0,2,1,2680,A
2-PB1,418,0,0,2677,0,2677,G
2-PB1,419,0,0,0,2714,2714,C
2-PB1,420,2719,0,0,0,2719,A
2-PB1,421,2722,0,1,0,2723,A
2-PB1,422,0,0,0,2720,2720,C
2-PB1,423,0,2710,0,0,2710,T
2-PB1,424,1,1,2808,0,2810,G
2-PB1,425,1,1,0,2802,2804,C
2-PB1,426,2805,3,0,0,2808,A
2-PB1,427,1,2813,0,3,2817,T
2-PB1,428,0,2781,0,0,2781,T
2-PB1,429,2910,3,0,0,2913,A
2-PB1,430,0,0,2896,0,2896,G
2-PB1,431,0,0,0,2875,2875,C
2-PB1,432,3,1,0,2897,2901,C
2-PB1,433,2827,0,0,0,2827,A
2-PB1,434,2845,0,0,0,2845,A
2-PB1,435,0,1,0,2862,2863,C
2-PB1,436,2845,0,0,0,2845,A
2-PB1,437,1,0,0,2942,2943,C
2-PB1,438,2,1,0,2758,2761,C
2-PB1,439,2747,0,1,0,2748,A
2-PB1,440,0,2747,0,0,2747,T
2-PB1,441,2771,0,1,0,2772,A
2-PB1,442,1,1,2764,0,2766,G
2-PB1,443,2751,0,0,0,2751,A
2-PB1,444,2721,0,0,0,2721,A
2-PB1,445,0,1,2732,1,2734,G
2-PB1,446,0,2642,0,0,2642,T
2-PB1,447,0,2638,0,3,2641,T
2-PB1,448,0,2670,0,2,2672,T
2-PB1,449,0,2666,0,0,2666,T
2-PB1,450,0,2674,0,1,2675,T
2-PB1,451,2666,0,1,0,2667,A
2-PB1,452,0,2,2665,0,2667,G
2-PB1,453,2658,0,0,0,2658,A
2-PB1,454,1,2634,0,0,2635,T
2-PB1,455,1,0,0,2602,2603,C
2-PB1,456,0,3,2617,0,2620,G
2-PB1,457,2609,0,1,0,2610,A
2-PB1,458,2612,0,1,0,2613,A
2-PB1,459,1,2,0,2618,2621,C
2-PB1,460,1,1,2620,0,2622,G
2-PB1,461,0,1,2746,0,2747,G
2-PB1,462,2735,0,4,1,2740,A
2-PB1,463,0,2740,0,0,2740,T
2-PB1,464,1,2746,0,1,2748,T
2-PB1,465,2740,0,2,0,2742,A
2-PB1,466,2748,0,1,0,2749,A
2-PB1,467,0,0,0,2751,2751,C
2-PB1,468,2735,0,1,0,2736,A
2-PB1,469,0,1,2755,0,2756,G
2-PB1,470,0,0,0,2645,2645,C
2-PB1,471,1,2650,0,0,2651,T
2-PB1,472,2652,0,3,0,2655,A
2-PB1,473,2650,0,1,0,2651,A
2-PB1,474,0,2652,0,0,2652,T
2-PB1,475,0,2,2673,0,2675,G
2-PB1,476,2666,0,0,0,2666,A
2-PB1,477,2675,0,0,0,2675,A
2-PB1,478,0,2614,0,0,2614,T
2-PB1,479,1,0,0,2630,2631,C
2-PB1,480,2625,0,2,1,2628,A
2-PB1,481,0,0,2619,0,2619,G
2-PB1,482,1,0,2613,0,2614,G
2-PB1,483,2604,0,2,0,2606,A
2-PB1,484,2554,1,2,0,2557,A
2-PB1,485,1,5,2630,0,2636,G
2-PB1,486,1,0,2611,0,2612,G
2-PB1,487,0,1,0,2631,2632,C
2-PB1,488,0,2646,1,2,2649,T
2-PB1,489,2648,0,3,0,2651,A
2-PB1,490,2657,0,0,0,2657,A
2-PB1,491,0,2659,0,0,2659,T
2-PB1,492,2663,0,0,0,2663,A
2-PB1,493,2,1,2666,0,2669,G
2-PB1,494,2543,0,0,0,2543,A
2-PB1,495,0,2509,0,0,2509,T
2-PB1,496,0,2516,0,1,2517,T
2-PB1,497,0,2491,0,0,2491,T
2-PB1,498,1,1,0,2579,2581,C
2-PB1,499,1,0,0,2574,2575,C
2-PB1,500,0,2569,1,2,2572,T
2-PB1,501,3,0,0,2612,2615,C
2-PB1,502,2613,0,2,2,2617,A
2-PB1,503,2616,0,0,0,2616,A
2-PB1,504,2,1,2624,0,2627,G
2-PB1,505,0,0,2651,0,2651,G
2-PB1,506,2647,0,1,0,2648,A
2-PB1,507,0,2543,0,1,2544,T
2-PB1,508,0,0,2582,0,2582,G
2-PB1,509,0,2569,0,1,2570,T
2-PB1,510,0,2,2602,0,2604,G
2-PB1,511,2603,0,4,0,2607,A
2-PB1,512,0,2589,1,0,2590,T
2-PB1,513,0,2,2588,0,2590,G
2-PB1,514,1,3,2564,0,2568,G
2-PB1,515,2561,0,1,1,2563,A
2-PB1,516,2560,0,1,0,2561,A
2-PB1,517,1,2512,0,1,2514,T
2-PB1,518,0,0,0,2533,2533,C
2-PB1,519,2525,0,0,0,2525,A
2-PB1,520,2531,0,0,0,2531,A
2-PB1,521,1,2531,1,0,2533,T
2-PB1,522,2,2,2561,0,2565,G
2-PB1,523,0,2,2587,0,2589,G
2-PB1,524,2575,1,5,1,2582,A
2-PB1,525,0,2526,0,54,2580,T
2-PB1,526,2584,0,0,0,2584,A
2-PB1,527,2573,0,1,0,2574,A
2-PB1,528,2566,0,0,0,2566,A
2-PB1,529,0,0,2592,0,2592,G
2-PB1,530,2566,0,1,0,2567,A
2-PB1,531,2,0,2540,0,2542,G
2-PB1,532,0,1,2543,0,2544,G
2-PB1,533,2532,2,2,0,2536,A
2-PB1,534,2534,0,1,0,2535,A
2-PB1,535,2531,0,0,0,2531,A
2-PB1,536,0,2535,0,0,2535,T
2-PB1,537,0,1,2563,0,2564,G
2-PB1,538,0,1,2564,0,2565,G
2-PB1,539,2540,0,4,0,2544,A
2-PB1,540,0,2,2560,0,2562,G
2-PB1,541,2525,0,4,0,2529,A
2-PB1,542,0,2569,0,1,2570,T
2-PB1,543,2567,0,0,0,2567,A
2-PB1,544,2586,0,1,0,2587,A
2-PB1,545,0,0,0,2587,2587,C
2-PB1,546,2545,0,0,0,2545,A
2-PB1,547,2537,1,0,0,2538,A
2-PB1,548,1,0,0,2531,2532,C
2-PB1,549,2500,0,1,0,2501,A
2-PB1,550,0,0,0,2513,2513,C
2-PB1,551,2465,0,1,0,2466,A
2-PB1,552,0,0,0,2490,2490,C
2-PB1,553,1,2468,0,0,2469,T
2-PB1,554,0,2470,0,0,2470,T
2-PB1,555,0,2462,0,1,2463,T
2-PB1,556,1,0,0,2476,2477,C
2-PB1,557,2475,0,1,0,2476,A
2-PB1,558,2477,0,0,0,2477,A
2-PB1,559,2485,0,1,0,2486,A
2-PB1,560,0,1,2508,0,2509,G
2-PB1,561,2485,0,1,0,2486,A
2-PB1,562,2483,0,1,0,2484,A
2-PB1,563,2494,0,2,0,2496,A
2-PB1,564,2496,0,0,0,2496,A
2-PB1,565,2489,0,3,0,2492,A
2-PB1,566,0,0,2500,0,2500,G
2-PB1,567,4,2,2499,0,2505,G
2-PB1,568,2467,0,1,0,2468,A
2-PB1,569,1,2,2509,0,2512,G
2-PB1,570,2485,0,5,0,2490,A
2-PB1,571,0,0,2563,0,2563,G
2-PB1,572,0,2534,0,0,2534,T
2-PB1,573,2557,0,0,0,2557,A
2-PB1,574,2547,1,5,0,2553,A
2-PB1,575,0,8,2547,0,2555,G
2-PB1,576,2,1,2566,0,2569,G
2-PB1,577,1,2,2562,0,2565,G
2-PB1,578,2534,0,1,0,2535,A
2-PB1,579,0,0,0,2553,2553,C
2-PB1,580,2491,0,2,2,2495,A
2-PB1,581,2493,0,3,0,2496,A
2-PB1,582,3,0,0,2487,2490,C
2-PB1,583,2480,0,0,0,2480,A
2-PB1,584,1,2454,0,0,2455,T
2-PB1,585,0,10,2436,0,2446,G
2-PB1,586,2438,1,2,1,2442,A
2-PB1,587,0,0,0,2425,2425,C
2-PB1,588,1,0,0,2410,2411,C
2-PB1,589,2414,1,0,0,2415,A
2-PB1,590,2411,0,0,0,2411,A
2-PB1,591,0,2,2424,0,2426,G
2-PB1,592,2428,0,0,0,2428,A
2-PB1,593,2426,0,1,0,2427,A
2-PB1,594,2417,0,0,1,2418,A
2-PB1,595,2412,0,2,0,2414,A
2-PB1,596,0,2400,0,1,2401,T
2-PB1,597,1,0,2418,0,2419,G
2-PB1,598,0,1,2425,0,2426,G
2-PB1,599,0,2395,0,4,2399,T
2-PB1,600,3,0,0,2390,2393,C
2-PB1,601,2415,0,1,0,2416,A
2-PB1,602,1,0,0,2561,2562,C
2-PB1,603,2603,0,1,0,2604,A
2-PB1,604,0,0,0,2616,2616,C
2-PB1,605,2610,0,0,0,2610,A
2-PB1,606,2686,0,2,0,2688,A
2-PB1,607,2668,0,2,0,2670,A
2-PB1,608,0,4,2848,0,2852,G
2-PB1,609,2843,0,1,0,2844,A
2-PB1,610,2863,0,1,0,2864,A
2-PB1,611,0,2,0,2935,2937,C
2-PB1,612,2879,0,0,0,2879,A
2-PB1,613,2845,0,57,0,2902,A
2-PB1,614,0,2904,0,1,2905,T
2-PB1,615,2888,0,0,0,2888,A
2-PB1,616,0,3,2876,0,2879,G
2-PB1,617,0,0,2815,0,2815,G
2-PB1,618,2,1,2814,0,2817,G
2-PB1,619,2806,0,2,0,2808,A
2-PB1,620,2788,0,1,0,2789,A
2-PB1,621,0,0,2807,0,2807,G
2-PB1,622,2797,0,0,0,2797,A
2-PB1,623,2808,1,0,0,2809,A
2-PB1,624,2820,0,0,0,2820,A
2-PB1,625,2840,0,0,0,2840,A
2-PB1,626,2879,0,0,0,2879,A
2-PB1,627,2899,0,2,0,2901,A
2-PB1,628,0,0,0,2914,2914,C
2-PB1,629,2902,0,0,0,2902,A
2-PB1,630,2898,0,1,1,2900,A
2-PB1,631,2889,0,1,0,2890,A
2-PB1,632,2,1,2934,0,2937,G
2-PB1,633,2927,0,1,1,2929,A
2-PB1,634,1,0,3041,1,3043,G
2-PB1,635,0,2979,0,1,2980,T
2-PB1,636,0,3,3410,0,3413,G
2-PB1,637,3422,1,6,0,3429,A
2-PB1,638,3430,0,2,0,3432,A
2-PB1,639,1,3472,0,0,3473,T
2-PB1,640,3492,0,0,1,3493,A
2-PB1,641,3489,0,3,0,3492,A
2-PB1,642,0,4,3490,0,3494,G
2-PB1,643,3429,1,3,0,3433,A
2-PB1,644,0,0,3438,0,3438,G
2-PB1,645,3262,0,4,0,3266,A
2-PB1,646,1,3,3268,0,3272,G
2-PB1,647,2,2,3240,0,3244,G
2-PB1,648,0,0,0,3249,3249,C
2-PB1,649,0,3244,1,1,3246,T
2-PB1,650,3345,0,0,0,3345,A
2-PB1,651,0,0,0,3532,3532,C
2-PB1,652,1,0,0,3545,3546,C
2-PB1,653,0,3572,0,1,3573,T
2-PB1,654,3724,0,0,0,3724,A
2-PB1,655,3704,0,2,0,3706,A
2-PB1,656,0,3711,1,0,3712,T
2-PB1,657,3706,0,0,1,3707,A
2-PB1,658,3701,1,0,0,3702,A
2-PB1,659,0,4,3702,0,3706,G
2-PB1,660,3602,0,0,0,3602,A
2-PB1,661,1,1,3607,0,3609,G
2-PB1,662,1,1,0,3614,3616,C
2-PB1,663,0,3564,0,2,3566,T
2-PB1,664,0,3585,0,0,3585,T
2-PB1,665,0,3594,0,1,3595,T
2-PB1,666,1,3,3583,0,3587,G
2-PB1,667,3656,1,2,0,3659,A
2-PB1,668,0,1,0,3670,3671,C
2-PB1,669,3670,0,1,0,3671,A
2-PB1,670,1,3651,0,1,3653,T
2-PB1,671,0,3660,0,0,3660,T
2-PB1,672,0,4,3707,0,3711,G
2-PB1,673,3710,1,0,0,3711,A
2-PB1,674,3705,0,4,0,3709,A
2-PB1,675,0,1,0,3707,3708,C
2-PB1,676,3708,0,2,0,3710,A
2-PB1,677,0,0,0,3699,3699,C
2-PB1,678,0,1,3697,0,3698,G
2-PB1,679,3685,0,8,0,3693,A
2-PB1,680,2,3711,0,1,3714,T
2-PB1,681,0,6,3764,0,3770,G
2-PB1,682,3776,0,3,0,3779,A
2-PB1,683,1,2,0,3791,3794,C
2-PB1,684,3,1,0,3799,3803,C
2-PB1,685,3811,0,0,0,3811,A
2-PB1,686,3838,4,0,1,3843,A
2-PB1,687,3829,1,10,0,3840,A
2-PB1,688,0,0,3947,0,3947,G
2-PB1,689,3994,0,1,0,3995,A
2-PB1,690,0,3953,0,0,3953,T
2-PB1,691,1,0,3965,0,3966,G
2-PB1,692,0,2,0,3942,3944,C
2-PB1,693,3948,0,4,0,3952,A
2-PB1,694,0,4,3993,0,3997,G
2-PB1,695,3943,0,1,0,3944,A
2-PB1,696,0,0,3955,0,3955,G
2-PB1,697,3862,0,3,0,3865,A
2-PB1,698,0,3,3865,0,3868,G
2-PB1,699,3828,0,11,1,3840,A
2-PB1,700,1,3,3830,0,3834,G
2-PB1,701,1,0,3826,0,3827,G
2-PB1,702,0,0,0,3819,3819,C
2-PB1,703,3809,1,5,1,3816,A
2-PB1,704,3827,0,0,0,3827,A
2-PB1,705,3849,2,0,0,3851,A
2-PB1,706,0,3862,0,0,3862,T
2-PB1,707,0,3870,0,2,3872,T
2-PB1,708,3879,1,2,0,3882,A
2-PB1,709,3861,1,0,0,3862,A
2-PB1,710,3872,0,1,0,3873,A
2-PB1,711,3886,0,0,1,3887,A
2-PB1,712,3878,0,3,0,3881,A
2-PB1,713,0,1,3884,0,3885,G
2-PB1,714,3842,1,0,0,3843,A
2-PB1,715,3839,0,3,1,3843,A
2-PB1,716,0,6,3892,0,3898,G
2-PB1,717,2,2,3934,0,3938,G
2-PB1,718,3,0,3944,0,3947,G
2-PB1,719,0,0,0,3976,3976,C
2-PB1,720,0,3976,0,1,3977,T
2-PB1,721,4019,0,0,2,4021,A
2-PB1,722,0,4079,0,1,4080,T
2-PB1,723,0,4080,0,2,4082,T
2-PB1,724,0,1,4111,1,4113,G
2-PB1,725,0,2,1,4065,4068,C
2-PB1,726,3981,1,7,0,3989,A
2-PB1,727,3987,0,6,1,3994,A
2-PB1,728,0,1,0,3990,3991,C
2-PB1,729,3970,0,0,0,3970,A
2-PB1,730,0,0,0,3992,3992,C
2-PB1,731,2,2,0,3906,3910,C
2-PB1,732,4,0,0,3896,3900,C
2-PB1,733,1,3,3882,0,3886,G
2-PB1,734,0,2,3879,1,3882,G
2-PB1,735,0,3,3892,0,3895,G
2-PB1,736,3900,1,2,1,3904,A
2-PB1,737,0,3908,0,1,3909,T
2-PB1,738,0,0,3913,0,3913,G
2-PB1,739,1,1,1,3890,3893,C
2-PB1,740,3933,0,1,1,3935,A
2-PB1,741,3996,0,1,1,3998,A
2-PB1,742,4043,0,1,1,4045,A
2-PB1,743,0,4034,1,0,4035,T
2-PB1,744,0,4034,2,0,4036,T
2-PB1,745,4013,0,0,0,4013,A
2-PB1,746,1,1,4014,0,4016,G
2-PB1,747,3976,0,5,1,3982,A
2-PB1,748,1,7,3989,0,3997,G
2-PB1,749,0,3,3911,0,3914,G
2-PB1,750,2,0,3992,0,3994,G
2-PB1,751,0,3932,1,2,3935,T
2-PB1,752,2,3974,0,1,3977,T
2-PB1,753,3,0,0,4008,4011,C
2-PB1,754,0,0,4054,0,4054,G
2-PB1,755,0,4027,0,9,4036,T
2-PB1,756,4,1,4042,0,4047,G
2-PB1,757,0,4013,0,10,4023,T
2-PB1,758,3999,0,2,1,4002,A
2-PB1,759,0,2,0,3989,3991,C
2-PB1,760,0,3816,0,1,3817,T
2-PB1,761,0,3821,0,1,3822,T
2-PB1,762,2,1,0,3814,3817,C
2-PB1,763,1,0,3797,0,3798,G
2-PB1,764,1,3797,0,0,3798,T
2-PB1,765,0,3794,0,2,3796,T
2-PB1,766,0,4,3790,0,3794,G
2-PB1,767,3769,0,1,0,3770,A
2-PB1,768,3778,0,1,0,3779,A
2-PB1,769,3808,1,0,0,3809,A
2-PB1,770,0,0,0,3838,3838,C
2-PB1,771,0,3804,0,1,3805,T
2-PB1,772,0,3787,0,1,3788,T
2-PB1,773,0,3783,0,2,3785,T
2-PB1,774,3844,0,3,0,3847,A
2-PB1,775,1,1,3850,0,3852,G
2-PB1,776,1,0,0,3865,3866,C
2-PB1,777,0,3863,0,0,3863,T
2-PB1,778,3814,0,2,0,3816,A
2-PB1,779,2,0,3822,0,3824,G
2-PB1,780,3816,1,2,1,3820,A
2-PB1,781,3817,0,2,0,3819,A
2-PB1,782,1,2,3818,0,3821,G
2-PB1,783,1,1,0,3751,3753,C
2-PB1,784,3760,0,0,0,3760,A
2-PB1,785,0,3749,0,0,3749,T
2-PB1,786,1,3742,1,0,3744,T
2-PB1,787,1,3747,0,0,3748,T
2-PB1,788,0,0,3741,0,3741,G
2-PB1,789,1,1,0,3735,3737,C
2-PB1,790,1,3,3743,0,3747,G
2-PB1,791,3734,0,1,0,3735,A
2-PB1,792,3729,0,0,0,3729,A
2-PB1,793,3735,0,3,0,3738,A
2-PB1,794,3798,0,3,0,3801,A
2-PB1,795,1,1,3830,0,3832,G
2-PB1,796,0,2,0,3820,3822,C
2-PB1,797,0,3829,0,3,3832,T
2-PB1,798,0,3835,0,2,3837,T
2-PB1,799,1,1,3837,0,3839,G
2-PB1,800,3827,0,6,0,3833,A
2-PB1,801,3827,0,2,0,3829,A
2-PB1,802,1,0,0,3851,3852,C
2-PB1,803,3768,0,2,0,3770,A
2-PB1,804,1,0,4055,0,4056,G
2-PB1,805,0,4014,0,0,4014,T
2-PB1,806,2,0,0,4019,4021,C
2-PB1,807,1,4027,0,2,4030,T
2-PB1,808,1,4,4013,0,4018,G
2-PB1,809,0,4,4020,0,4024,G
2-PB1,810,4016,0,3,0,4019,A
2-PB1,811,1,0,0,4050,4051,C
2-PB1,812,0,3896,0,1,3897,T
2-PB1,813,0,3619,0,2,3621,T
2-PB1,814,3,1,0,3613,3617,C
2-PB1,815,2,1,0,3613,3616,C
2-PB1,816,4,2,3652,0,3658,G
2-PB1,817,0,2,3648,0,3650,G
2-PB1,818,0,3625,0,1,3626,T
2-PB1,819,0,3652,0,1,3653,T
2-PB1,820,0,3,3620,0,3623,G
2-PB1,821,0,3,3637,0,3640,G
2-PB1,822,2,3,3665,0,3670,G
2-PB1,823,1,1,3678,0,3680,G
2-PB1,824,2,1,3688,0,3691,G
2-PB1,825,0,3634,2,1,3637,T
2-PB1,826,3647,0,0,0,3647,A
2-PB1,827,3654,0,1,0,3655,A
2-PB1,828,0,3663,0,0,3663,T
2-PB1,829,1,3,3674,0,3678,G
2-PB1,830,3635,0,0,1,3636,A
2-PB1,831,3594,2,0,2,3598,A
2-PB1,832,3607,1,0,0,3608,A
2-PB1,833,3599,0,1,0,3600,A
2-PB1,834,2,1,3594,0,3597,G
2-PB1,835,3556,0,1,0,3557,A
2-PB1,836,3535,0,12,0,3547,A
2-PB1,837,1,0,3546,0,3547,G
2-PB1,838,1,2,3512,0,3515,G
2-PB1,839,1,0,0,3514,3515,C
2-PB1,840,3,1,0,3530,3534,C
2-PB1,841,3542,0,1,1,3544,A
2-PB1,842,3547,0,3,0,3550,A
2-PB1,843,3538,1,1,0,3540,A
2-PB1,844,0,1,0,3550,3551,C
2-PB1,845,1,3548,0,2,3551,T
2-PB1,846,3,2,3577,0,3582,G
2-PB1,847,1,0,3573,0,3574,G
2-PB1,848,1,1,0,3576,3578,C
2-PB1,849,3591,0,2,1,3594,A
2-PB1,850,3582,0,1,1,3584,A
2-PB1,851,3588,0,0,0,3588,A
2-PB1,852,0,3599,0,0,3599,T
2-PB1,853,0,0,3617,0,3617,G
2-PB1,854,0,3575,0,0,3575,T
2-PB1,855,0,3523,0,0,3523,T
2-PB1,856,0,0,3522,0,3522,G
2-PB1,857,0,3486,0,2,3488,T
2-PB1,858,0,2,3514,0,3516,G
2-PB1,859,3516,0,1,0,3517,A
2-PB1,860,1,2,3519,1,3523,G
2-PB1,861,3512,0,2,0,3514,A
2-PB1,862,3497,1,0,0,3498,A
2-PB1,863,3496,0,2,0,3498,A
2-PB1,864,3510,0,0,0,3510,A
2-PB1,865,3525,0,0,0,3525,A
2-PB1,866,1,3493,0,0,3494,T
2-PB1,867,0,4,3501,0,3505,G
2-PB1,868,3494,0,2,0,3496,A
2-PB1,869,0,3454,0,0,3454,T
2-PB1,870,0,2,3493,0,3495,G
2-PB1,871,3473,0,3,0,3476,A
2-PB1,872,0,0,0,3509,3509,C
2-PB1,873,1,3504,0,3,3508,T
2-PB1,874,3511,0,0,0,3511,A
2-PB1,875,3543,1,2,0,3546,A
2-PB1,876,0,3523,0,1,3524,T
2-PB1,877,0,3542,1,2,3545,T
2-PB1,878,4,2,0,3579,3585,C
2-PB1,879,3556,1,3,0,3560,A
2-PB1,880,0,0,0,3582,3582,C
2-PB1,881,3534,0,0,0,3534,A
2-PB1,882,3530,1,0,0,3531,A
2-PB1,883,1,5,3531,0,3537,G
2-PB1,884,3551,0,5,0,3556,A
2-PB1,885,0,1,0,3554,3555,C
2-PB1,886,3538,0,0,0,3538,A
2-PB1,887,0,1,0,3522,3523,C
2-PB1,888,3497,0,2,0,3499,A
2-PB1,889,1,1,3517,0,3519,G
2-PB1,890,3492,1,5,0,3498,A
2-PB1,891,1,0,3506,0,3507,G
2-PB1,892,1,0,0,3482,3483,C
2-PB1,893,0,3422,0,4,3426,T
2-PB1,894,0,3472,0,1,3473,T
2-PB1,895,0,3445,0,2,3447,T
2-PB1,896,2,0,0,3476,3478,C
2-PB1,897,0,3464,0,5,3469,T
2-PB1,898,0,3465,0,1,3466,T
2-PB1,899,0,3469,0,4,3473,T
2-PB1,900,1,2,0,3466,3469,C
2-PB1,901,3438,0,4,1,3443,A
2-PB1,902,0,0,2,3478,3480,C
2-PB1,903,3441,0,1,0,3442,A
2-PB1,904,3435,0,1,0,3436,A
2-PB1,905,0,3458,0,1,3459,T
2-PB1,906,9,0,0,3497,3506,C
2-PB1,907,3482,0,0,0,3482,A
2-PB1,908,0,1,0,3531,3532,C
2-PB1,909,1,3506,0,4,3511,T
2-PB1,910,1,1,3535,0,3537,G
2-PB1,911,0,3,3499,0,3502,G
2-PB1,912,1,5,3600,0,3606,G
2-PB1,913,0,3,3577,0,3580,G
2-PB1,914,3512,0,4,0,3516,A
2-PB1,915,0,2,0,3401,3403,C
2-PB1,916,3450,0,3,0,3453,A
2-PB1,917,3629,0,3,0,3632,A
2-PB1,918,1,1,1,3658,3661,C
2-PB1,919,3648,0,0,2,3650,A
2-PB1,920,0,0,0,3658,3658,C
2-PB1,921,0,3515,0,3,3518,T
2-PB1,922,3529,1,1,0,3531,A
2-PB1,923,3521,0,2,0,3523,A
2-PB1,924,1,1,3528,0,3530,G
2-PB1,925,0,3483,0,2,3485,T
2-PB1,926,3,3,3278,0,3284,G
2-PB1,927,1,0,3255,0,3256,G
2-PB1,928,3238,0,0,0,3238,A
2-PB1,929,3233,1,2,2,3238,A
2-PB1,930,0,3247,0,0,3247,T
2-PB1,931,1,2,3243,0,3246,G
2-PB1,932,3246,0,0,0,3246,A
2-PB1,933,3200,0,1,0,3201,A
2-PB1,934,3226,0,1,0,3227,A
2-PB1,935,3233,0,1,0,3234,A
2-PB1,936,0,3206,0,0,3206,T
2-PB1,937,1,0,0,3228,3229,C
2-PB1,938,3230,0,0,0,3230,A
2-PB1,939,3211,0,1,0,3212,A
2-PB1,940,3205,0,2,1,3208,A
2-PB1,941,3180,0,1,0,3181,A
2-PB1,942,0,0,0,3219,3219,C
2-PB1,943,2,1,0,3192,3195,C
2-PB1,944,5,0,0,3181,3186,C
2-PB1,945,0,3166,1,6,3173,T
2-PB1,946,2,1,0,3185,3188,C
2-PB1,947,2,2,3177,0,3181,G
2-PB1,948,3167,0,1,0,3168,A
2-PB1,949,3176,0,1,0,3177,A
2-PB1,950,0,3179,1,0,3180,T
2-PB1,951,0,0,3196,0,3196,G
2-PB1,952,0,3141,3,4,3148,T
2-PB1,953,0,3156,1,1,3158,T
2-PB1,954,0,3170,1,1,3172,T
2-PB1,955,0,3150,1,0,3151,T
2-PB1,956,1,3151,1,1,3154,T
2-PB1,957,0,3,3145,1,3149,G
2-PB1,958,2,0,3123,0,3125,G
2-PB1,959,0,2,0,3121,3123,C
2-PB1,960,0,0,3103,0,3103,G
2-PB1,961,3104,0,1,0,3105,A
2-PB1,962,0,3159,0,0,3159,T
2-PB1,963,0,0,3263,0,3263,G
2-PB1,964,3414,0,2,0,3416,A
2-PB1,965,0,3427,0,4,3431,T
2-PB1,966,1,3407,1,2,3411,T
2-PB1,967,3430,1,2,0,3433,A
2-PB1,968,0,1,0,3437,3438,C
2-PB1,969,3456,0,3,0,3459,A
2-PB1,970,0,3437,0,3,3440,T
2-PB1,971,3254,1,1,0,3256,A
2-PB1,972,0,0,0,3262,3262,C
2-PB1,973,2968,0,0,0,2968,A
2-PB1,974,1,2943,0,3,2947,T
2-PB1,975,1,0,0,2943,2944,C
2-PB1,976,2907,0,1,0,2908,A
2-PB1,977,0,0,0,2919,2919,C
2-PB1,978,2910,0,0,0,2910,A
2-PB1,979,2907,0,1,0,2908,A
2-PB1,980,2893,0,1,0,2894,A
2-PB1,981,1,4,2788,0,2793,G
2-PB1,982,2909,1,2,1,2913,A
2-PB1,983,2929,0,2,0,2931,A
2-PB1,984,1,2902,0,0,2903,T
2-PB1,985,4,1,0,2917,2922,C
2-PB1,986,2925,0,3,0,2928,A
2-PB1,987,2914,0,5,0,2919,A
2-PB1,988,0,0,0,2926,2926,C
2-PB1,989,0,1,0,2924,2925,C
2-PB1,990,0,2792,0,0,2792,T
2-PB1,991,0,3,2812,0,2815,G
2-PB1,992,2805,0,1,0,2806,A
2-PB1,993,0,2,2814,0,2816,G
2-PB1,994,1,2782,0,1,2784,T
2-PB1,995,1,3,2710,0,2714,G
2-PB1,996,0,0,2857,0,2857,G
2-PB1,997,0,2854,0,0,2854,T
2-PB1,998,0,2849,0,1,2850,T
2-PB1,999,5,1,0,2866,2872,C
2-PB1,1000,2831,0,1,0,2832,A
2-PB1,1001,0,1,2872,0,2873,G
2-PB1,1002,2879,0,1,0,2880,A
2-PB1,1003,2881,0,0,0,2881,A
2-PB1,1004,2836,1,0,0,2837,A
2-PB1,1005,0,2,0,2592,2594,C
2-PB1,1006,2614,1,0,0,2615,A
2-PB1,1007,1,2580,0,1,2582,T
2-PB1,1008,2,1,0,2633,2636,C
2-PB1,1009,1,2,0,2635,2638,C
2-PB1,1010,1,2544,0,1,2546,T
2-PB1,1011,0,2,2540,0,2542,G
2-PB1,1012,2525,0,3,0,2528,A
2-PB1,1013,1,0,2533,0,2534,G
2-PB1,1014,0,0,0,2525,2525,C
2-PB1,1015,2454,0,1,1,2456,A
2-PB1,1016,0,2437,0,1,2438,T
2-PB1,1017,1,0,0,2425,2426,C
2-PB1,1018,2,0,2421,1,2424,G
2-PB1,1019,1,0,0,2507,2508,C
2-PB1,1020,2512,0,1,0,2513,A
2-PB1,1021,0,1,0,2593,2594,C
2-PB1,1022,1,0,0,2605,2606,C
2-PB1,1023,2613,0,0,1,2614,A
2-PB1,1024,2640,0,3,0,2643,A
2-PB1,1025,0,2644,0,0,2644,T
2-PB1,1026,2640,0,0,0,2640,A
2-PB1,1027,2632,0,0,0,2632,A
2-PB1,1028,0,2539,0,2,2541,T
2-PB1,1029,1,1,2556,0,2558,G
2-PB1,1030,0,2479,0,1,2480,T
2-PB1,1031,0,2452,0,5,2457,T
2-PB1,1032,3,0,1,2479,2483,C
2-PB1,1033,0,2460,0,0,2460,T
2-PB1,1034,1,0,0,2458,2459,C
2-PB1,1035,2471,0,1,0,2472,A
2-PB1,1036,2465,1,1,0,2467,A
2-PB1,1037,2472,0,1,2,2475,A
2-PB1,1038,0,1,0,2477,2478,C
2-PB1,1039,2463,0,0,0,2463,A
2-PB1,1040,2463,0,0,0,2463,A
2-PB1,1041,2453,1,0,0,2454,A
2-PB1,1042,2449,0,1,1,2451,A
2-PB1,1043,0,2453,0,0,2453,T
2-PB1,1044,0,3,2459,0,2462,G
2-PB1,1045,2,0,2447,0,2449,G
2-PB1,1046,0,1,0,2448,2449,C
2-PB1,1047,2457,0,3,0,2460,A
2-PB1,1048,2463,0,1,0,2464,A
2-PB1,1049,1,0,2463,0,2464,G
2-PB1,1050,2443,0,0,0,2443,A
2-PB1,1051,0,2438,0,1,2439,T
2-PB1,1052,0,2495,0,1,2496,T
2-PB1,1053,0,4,2496,0,2500,G
2-PB1,1054,0,0,2503,0,2503,G
2-PB1,1055,0,0,2517,1,2518,G
2-PB1,1056,2521,0,2,0,2523,A
2-PB1,1057,2524,0,2,0,2526,A
2-PB1,1058,2520,0,1,0,2521,A
2-PB1,1059,2497,0,2,0,2499,A
2-PB1,1060,2,2,2589,0,2593,G
2-PB1,1061,0,5,2579,0,2584,G
2-PB1,1062,2592,0,2,0,2594,A
2-PB1,1063,0,2583,0,0,2583,T
2-PB1,1064,2595,1,3,0,2599,A
2-PB1,1065,0,0,0,2593,2593,C
2-PB1,1066,2628,0,1,0,2629,A
2-PB1,1067,0,2613,0,0,2613,T
2-PB1,1068,0,0,2648,0,2648,G
2-PB1,1069,3,2588,0,3,2594,T
2-PB1,1070,0,2586,0,3,2589,T
2-PB1,1071,3,2,0,2577,2582,C
2-PB1,1072,2,1,2579,0,2582,G
2-PB1,1073,2582,0,2,0,2584,A
2-PB1,1074,0,0,2638,0,2638,G
2-PB1,1075,2612,1,0,1,2614,A
2-PB1,1076,0,1,2640,1,2642,G
2-PB1,1077,1,2611,0,0,2612,T
2-PB1,1078,2622,0,2,0,2624,A
2-PB1,1079,2623,1,0,0,2624,A
2-PB1,1080,0,2,2628,1,2631,G
2-PB1,1081,2624,0,2,0,2626,A
2-PB1,1082,0,1,2672,0,2673,G
2-PB1,1083,2615,1,2,0,2618,A
2-PB1,1084,2636,0,1,0,2637,A
2-PB1,1085,0,2621,0,1,2622,T
2-PB1,1086,0,2,2621,0,2623,G
2-PB1,1087,2615,0,3,0,2618,A
2-PB1,1088,2612,0,7,0,2619,A
2-PB1,1089,0,1,2608,0,2609,G
2-PB1,1090,0,1,0,2597,2598,C
2-PB1,1091,0,2561,0,2,2563,T
2-PB1,1092,3,0,0,2581,2584,C
2-PB1,1093,0,0,0,2588,2588,C
2-PB1,1094,2,2,2592,0,2596,G
2-PB1,1095,0,2,2602,0,2604,G
2-PB1,1096,2618,0,1,0,2619,A
2-PB1,1097,0,0,0,2648,2648,C
2-PB1,1098,2639,1,2,0,2642,A
2-PB1,1099,0,1,0,2671,2672,C
2-PB1,1100,2663,0,0,0,2663,A
2-PB1,1101,2664,0,2,0,2666,A
2-PB1,1102,2668,0,1,0,2669,A
2-PB1,1103,0,2674,0,0,2674,T
2-PB1,1104,2655,0,0,0,2655,A
2-PB1,1105,0,0,0,2669,2669,C
2-PB1,1106,2,0,0,2637,2639,C
2-PB1,1107,2,2605,0,3,2610,T
2-PB1,1108,0,0,2638,1,2639,G
2-PB1,1109,1,0,0,2638,2639,C
2-PB1,1110,2647,0,0,0,2647,A
2-PB1,1111,1,1,2628,0,2630,G
2-PB1,1112,2637,0,0,0,2637,A
2-PB1,1113,2627,0,1,0,2628,A
2-PB1,1114,2629,1,1,0,2631,A
2-PB1,1115,0,2615,0,2,2617,T
2-PB1,1116,0,0,2631,0,2631,G
2-PB1,1117,1,1,0,2601,2603,C
2-PB1,1118,0,2613,0,0,2613,T
2-PB1,1119,2640,0,2,0,2642,A
2-PB1,1120,1,1,2639,0,2641,G
2-PB1,1121,1,0,0,2634,2635,C
2-PB1,1122,2645,1,0,0,2646,A
2-PB1,1123,2626,0,3,0,2629,A
2-PB1,1124,1,0,2607,0,2608,G
2-PB1,1125,0,0,0,2605,2605,C
2-PB1,1126,2581,0,1,0,2582,A
2-PB1,1127,1,2605,1,1,2608,T
2-PB1,1128,0,2604,0,0,2604,T
2-PB1,1129,0,3,2673,0,2676,G
2-PB1,1130,2695,0,1,0,2696,A
2-PB1,1131,0,1,0,2688,2689,C
2-PB1,1132,2,0,0,2707,2709,C
2-PB1,1133,1,2641,0,4,2646,T
2-PB1,1134,0,1,2707,0,2708,G
2-PB1,1135,2712,2,0,0,2714,A
2-PB1,1136,2717,0,1,0,2718,A
2-PB1,1137,1,2,2754,0,2757,G
2-PB1,1138,0,2653,0,0,2653,T
2-PB1,1139,2677,0,1,0,2678,A
2-PB1,1140,0,2668,0,1,2669,T
2-PB1,1141,0,2671,0,1,2672,T
2-PB1,1142,0,2661,0,1,2662,T
2-PB1,1143,3,0,0,2641,2644,C
2-PB1,1144,2642,0,2,0,2644,A
2-PB1,1145,2641,0,1,0,2642,A
2-PB1,1146,0,2603,0,0,2603,T
2-PB1,1147,1,5,2611,0,2617,G
2-PB1,1148,2605,1,3,0,2609,A
2-PB1,1149,2623,0,1,0,2624,A
2-PB1,1150,0,2595,1,1,2597,T
2-PB1,1151,3,0,0,2626,2629,C
2-PB1,1152,2621,0,3,0,2624,A
2-PB1,1153,2619,0,0,0,2619,A
2-PB1,1154,1,1,0,2620,2622,C
2-PB1,1155,2624,0,0,0,2624,A
2-PB1,1156,2606,0,0,0,2606,A
2-PB1,1157,0,1,2608,0,2609,G
2-PB1,1158,3,0,2608,0,2611,G
2-PB1,1159,2613,2,3,0,2618,A
2-PB1,1160,2612,0,1,0,2613,A
2-PB1,1161,0,1,2601,0,2602,G
2-PB1,1162,2602,1,2,0,2605,A
2-PB1,1163,2597,0,1,0,2598,A
2-PB1,1164,2607,0,1,0,2608,A
2-PB1,1165,2608,1,2,1,2612,A
2-PB1,1166,0,2590,0,0,2590,T
2-PB1,1167,0,2577,0,0,2577,T
2-PB1,1168,3,0,2586,0,2589,G
2-PB1,1169,2583,0,0,0,2583,A
2-PB1,1170,2594,0,3,0,2597,A
2-PB1,1171,2598,0,0,0,2598,A
2-PB1,1172,2608,0,0,1,2609,A
2-PB1,1173,2658,0,0,0,2658,A
2-PB1,1174,2665,0,0,0,2665,A
2-PB1,1175,0,2643,0,0,2643,T
2-PB1,1176,2663,0,1,0,2664,A
2-PB1,1177,2659,1,2,0,2662,A
2-PB1,1178,1,2,2661,0,2664,G
2-PB1,1179,1,0,2657,1,2659,G
2-PB1,1180,0,1,0,2622,2623,C
2-PB1,1181,2,2,0,2623,2627,C
2-PB1,1182,0,2617,0,6,2623,T
2-PB1,1183,0,0,1,2945,2946,C
2-PB1,1184,2,2985,0,0,2987,T
2-PB1,1185,1,2998,0,0,2999,T
2-PB1,1186,1,2,0,3071,3074,C
2-PB1,1187,0,3057,0,1,3058,T
2-PB1,1188,3068,0,0,0,3068,A
2-PB1,1189,3065,1,0,0,3066,A
2-PB1,1190,0,3055,0,5,3060,T
2-PB1,1191,3070,0,0,0,3070,A
2-PB1,1192,0,1,2992,0,2993,G
2-PB1,1193,2758,0,2,0,2760,A
2-PB1,1194,0,2747,0,0,2747,T
2-PB1,1195,1,3,2679,0,2683,G
2-PB1,1196,0,0,2709,0,2709,G
2-PB1,1197,0,0,0,2717,2717,C
2-PB1,1198,2731,0,0,0,2731,A
2-PB1,1199,1,0,0,2726,2727,C
2-PB1,1200,2699,0,1,0,2700,A
2-PB1,1201,0,2,2767,0,2769,G
2-PB1,1202,0,0,0,2769,2769,C
2-PB1,1203,2782,0,1,0,2783,A
2-PB1,1204,0,2831,0,1,2832,T
2-PB1,1205,3,0,0,2798,2801,C
2-PB1,1206,2829,0,1,0,2830,A
2-PB1,1207,1,2815,0,0,2816,T
2-PB1,1208,0,2802,0,1,2803,T
2-PB1,1209,2,0,2806,3,2811,G
2-PB1,1210,2710,0,6,0,2716,A
2-PB1,1211,2,1,2797,1,2801,G
2-PB1,1212,1,1,1,2764,2767,C
2-PB1,1213,0,0,0,2720,2720,C
2-PB1,1214,4,1,0,2782,2787,C
2-PB1,1215,2,2781,0,3,2786,T
2-PB1,1216,1,3,3186,0,3190,G
2-PB1,1217,0,0,3269,0,3269,G
2-PB1,1218,3259,0,5,0,3264,A
2-PB1,1219,3477,0,1,0,3478,A
2-PB1,1220,0,3431,0,1,3432,T
2-PB1,1221,0,2,3582,0,3584,G
2-PB1,1222,3657,1,1,1,3660,A
2-PB1,1223,0,3720,0,0,3720,T
2-PB1,1224,0,3,3747,0,3750,G
2-PB1,1225,3709,1,2,0,3712,A
2-PB1,1226,0,3670,0,2,3672,T
2-PB1,1227,0,0,3684,0,3684,G
2-PB1,1228,0,1,3755,0,3756,G
2-PB1,1229,0,1,3743,0,3744,G
2-PB1,1230,1,0,0,3721,3722,C
2-PB1,1231,3769,0,0,0,3769,A
2-PB1,1232,0,3813,0,1,3814,T
2-PB1,1233,1,0,3992,0,3993,G
2-PB1,1234,0,3989,0,7,3996,T
2-PB1,1235,0,4014,1,2,4017,T
2-PB1,1236,2,0,1,4030,4033,C
2-PB1,1237,3998,0,3,0,4001,A
2-PB1,1238,4016,1,3,0,4020,A
2-PB1,1239,1,0,0,4024,4025,C
2-PB1,1240,4046,0,0,0,4046,A
2-PB1,1241,0,4056,0,1,4057,T
2-PB1,1242,0,0,4161,0,4161,G
2-PB1,1243,0,2,0,4148,4150,C
2-PB1,1244,0,4182,0,0,4182,T
2-PB1,1245,4246,0,1,0,4247,A
2-PB1,1246,4227,0,0,0,4227,A
2-PB1,1247,0,0,4363,0,4363,G
2-PB1,1248,0,4343,0,0,4343,T
2-PB1,1249,4350,0,1,0,4351,A
2-PB1,1250,1,3,0,4373,4377,C
2-PB1,1251,3,2,4411,0,4416,G
2-PB1,1252,0,1,4736,0,4737,G
2-PB1,1253,0,4715,0,1,4716,T
2-PB1,1254,0,4716,0,0,4716,T
2-PB1,1255,0,4722,0,0,4722,T
2-PB1,1256,0,4695,0,0,4695,T
2-PB1,1257,4743,0,3,0,4746,A
2-PB1,1258,3,1,4693,1,4698,G
2-PB1,1259,0,4,4696,0,4700,G
2-PB1,1260,4642,1,4,0,4647,A
2-PB1,1261,2,0,4642,0,4644,G
2-PB1,1262,0,4622,0,6,4628,T
2-PB1,1263,3,1,1,4630,4635,C
2-PB1,1264,0,4635,0,1,4636,T
2-PB1,1265,4,0,0,4638,4642,C
2-PB1,1266,2,4,4646,0,4652,G
2-PB1,1267,4607,0,0,0,4607,A
2-PB1,1268,0,4620,0,0,4620,T
2-PB1,1269,11,0,0,4591,4602,C
2-PB1,1270,1,2,0,4828,4831,C
2-PB1,1271,0,4832,0,10,4842,T
2-PB1,1272,1,6,4837,1,4845,G
2-PB1,1273,4849,1,0,0,4850,A
2-PB1,1274,4888,0,0,0,4888,A
2-PB1,1275,1,4902,0,3,4906,T
2-PB1,1276,6,0,0,4823,4829,C
2-PB1,1277,0,4826,0,4,4830,T
2-PB1,1278,0,4807,0,0,4807,T
2-PB1,1279,1,5,4800,0,4806,G
2-PB1,1280,1,2,4805,0,4808,G
2-PB1,1281,4781,0,5,0,4786,A
2-PB1,1282,0,0,0,4816,4816,C
2-PB1,1283,4787,0,1,0,4788,A
2-PB1,1284,4825,0,1,0,4826,A
2-PB1,1285,4854,0,2,1,4857,A
2-PB1,1286,4865,0,6,0,4871,A
2-PB1,1287,3,2,4984,0,4989,G
2-PB1,1288,5005,0,1,0,5006,A
2-PB1,1289,5014,0,1,1,5016,A
2-PB1,1290,5025,0,7,1,5033,A
2-PB1,1291,1,5022,0,1,5024,T
2-PB1,1292,5020,1,3,0,5024,A
2-PB1,1293,1,0,0,5196,5197,C
2-PB1,1294,5150,0,3,0,5153,A
2-PB1,1295,0,2,0,5191,5193,C
2-PB1,1296,5,1,0,5143,5149,C
2-PB1,1297,5135,1,0,0,5136,A
2-PB1,1298,5203,0,0,0,5203,A
2-PB1,1299,3,3,5402,0,5408,G
2-PB1,1300,5460,0,3,0,5463,A
2-PB1,1301,0,1,1,5553,5555,C
2-PB1,1302,5455,0,2,0,5457,A
2-PB1,1303,5604,0,4,0,5608,A
2-PB1,1304,0,0,0,5625,5625,C
2-PB1,1305,5720,2,2,0,5724,A
2-PB1,1306,0,5754,0,0,5754,T
2-PB1,1307,5712,0,2,0,5714,A
2-PB1,1308,0,4,0,5780,5784,C
2-PB1,1309,0,5659,0,1,5660,T
2-PB1,1310,0,1,5777,0,5778,G
2-PB1,1311,0,0,5765,0,5765,G
2-PB1,1312,0,5619,0,4,5623,T
2-PB1,1313,2,5,5682,0,5689,G
2-PB1,1314,0,5,5630,0,5635,G
2-PB1,1315,1,1,5674,0,5676,G
2-PB1,1316,5651,1,6,0,5658,A
2-PB1,1317,0,5614,0,1,5615,T
2-PB1,1318,1,2,5594,0,5597,G
2-PB1,1319,0,3,5544,0,5547,G
2-PB1,1320,5490,0,14,0,5504,A
2-PB1,1321,0,0,0,5734,5734,C
2-PB1,1322,0,5730,0,4,5734,T
2-PB1,1323,5,2,0,5807,5814,C
2-PB1,1324,2,0,0,5809,5811,C
2-PB1,1325,5808,0,2,0,5810,A
2-PB1,1326,5799,0,3,0,5802,A
2-PB1,1327,0,5786,0,2,5788,T
2-PB1,1328,1,0,2,5757,5760,C
2-PB1,1329,6,1,0,5754,5761,C
2-PB1,1330,0,5713,0,5,5718,T
2-PB1,1331,1,2,0,5715,5718,C
2-PB1,1332,0,1,0,5700,5701,C
2-PB1,1333,3,0,5732,0,5735,G
2-PB1,1334,5698,0,0,0,5698,A
2-PB1,1335,0,5676,0,13,5689,T
2-PB1,1336,0,9,5724,0,5733,G
2-PB1,1337,5766,0,0,0,5766,A
2-PB1,1338,0,5767,0,0,5767,T
2-PB1,1339,0,5756,0,0,5756,T
2-PB1,1340,0,5745,0,2,5747,T
2-PB1,1341,0,5747,0,1,5748,T
2-PB1,1342,3,0,5760,1,5764,G
2-PB1,1343,0,7,0,5781,5788,C
2-PB1,1344,3,1,0,5795,5799,C
2-PB1,1345,6,1,0,6007,6014,C
2-PB1,1346,0,5966,1,7,5974,T
2-PB1,1347,4,0,0,6228,6232,C
2-PB1,1348,6255,0,0,0,6255,A
2-PB1,1349,0,6286,0,3,6289,T
2-PB1,1350,6300,0,3,0,6303,A
2-PB1,1351,2,0,6364,0,6366,G
2-PB1,1352,1,6279,0,1,6281,T
2-PB1,1353,2,10,6342,0,6354,G
2-PB1,1354,6195,0,2,0,6197,A
2-PB1,1355,6200,0,1,0,6201,A
2-PB1,1356,0,6001,0,2,6003,T
2-PB1,1357,1,0,6016,0,6017,G
2-PB1,1358,1,7,0,6056,6064,C
2-PB1,1359,6051,0,6,0,6057,A
2-PB1,1360,1,3,0,6078,6082,C
2-PB1,1361,5,0,1,6038,6044,C
2-PB1,1362,6038,0,2,0,6040,A
2-PB1,1363,6028,0,2,0,6030,A
2-PB1,1364,6001,0,1,2,6004,A
2-PB1,1365,0,5888,0,2,5890,T
2-PB1,1366,5,0,0,6108,6113,C
2-PB1,1367,6092,0,0,0,6092,A
2-PB1,1368,0,6117,0,0,6117,T
2-PB1,1369,3,4,6122,0,6129,G
2-PB1,1370,6122,2,9,0,6133,A
2-PB1,1371,0,7,6180,0,6187,G
2-PB1,1372,0,3,6139,0,6142,G
2-PB1,1373,1,3,6181,0,6185,G
2-PB1,1374,6138,0,6,1,6145,A
2-PB1,1375,6259,0,4,0,6263,A
2-PB1,1376,0,6274,1,1,6276,T
2-PB1,1377,6275,0,3,0,6278,A
2-PB1,1378,1,1,0,6302,6304,C
2-PB1,1379,6342,0,7,1,6350,A
2-PB1,1380,6318,0,15,0,6333,A
2-PB1,1381,1,0,6306,0,6307,G
2-PB1,1382,1,1,0,6275,6277,C
2-PB1,1383,6233,0,4,0,6237,A
2-PB1,1384,1,3,6292,0,6296,G
2-PB1,1385,0,7,6286,0,6293,G
2-PB1,1386,6231,0,5,1,6237,A
2-PB1,1387,0,2,6311,0,6313,G
2-PB1,1388,0,6215,0,2,6217,T
2-PB1,1389,4,4,6331,0,6339,G
2-PB1,1390,3,2,6329,0,6334,G
2-PB1,1391,6330,0,9,0,6339,A
2-PB1,1392,0,6344,0,1,6345,T
2-PB1,1393,6310,0,0,0,6310,A
2-PB1,1394,1,1,6351,0,6353,G
2-PB1,1395,6428,0,0,1,6429,A
2-PB1,1396,0,6423,0,0,6423,T
2-PB1,1397,0,6425,0,1,6426,T
2-PB1,1398,1,0,0,6639,6640,C
2-PB1,1399,0,6613,0,2,6615,T
2-PB1,1400,6621,0,0,1,6622,A
2-PB1,1401,2,1,0,6616,6619,C
2-PB1,1402,6506,0,10,0,6516,A
2-PB1,1403,5,2,6493,0,6500,G
2-PB1,1404,6,6,6378,0,6390,G
2-PB1,1405,6461,1,5,0,6467,A
2-PB1,1406,2,1,0,6471,6474,C
2-PB1,1407,6,2,0,6364,6372,C
2-PB1,1408,1,6313,0,11,6325,T
2-PB1,1409,1,1,6349,0,6351,G
2-PB1,1410,0,2,0,6355,6357,C
2-PB1,1411,6362,1,1,0,6364,A
2-PB1,1412,6432,0,3,1,6436,A
2-PB1,1413,0,0,6469,0,6469,G
2-PB1,1414,0,6353,0,1,6354,T
2-PB1,1415,0,6376,0,1,6377,T
2-PB1,1416,6280,1,1,0,6282,A
2-PB1,1417,1,1,6278,0,6280,G
2-PB1,1418,0,6219,0,3,6222,T
2-PB1,1419,0,3,6236,1,6240,G
2-PB1,1420,0,7,6201,0,6208,G
2-PB1,1421,1,4,6271,1,6277,G
2-PB1,1422,6250,0,4,0,6254,A
2-PB1,1423,6284,0,0,0,6284,A
2-PB1,1424,0,6274,0,2,6276,T
2-PB1,1425,6,0,0,6290,6296,C
2-PB1,1426,6302,0,6,0,6308,A
2-PB1,1427,6324,0,6,0,6330,A
2-PB1,1428,1,2,0,6304,6307,C
2-PB1,1429,6298,0,4,0,6302,A
2-PB1,1430,0,6193,0,1,6194,T
2-PB1,1431,2,7,6211,0,6220,G
2-PB1,1432,6204,0,10,0,6214,A
2-PB1,1433,6,1,6252,1,6260,G
2-PB1,1434,1,0,0,6221,6222,C
2-PB1,1435,6248,1,0,0,6249,A
2-PB1,1436,6242,0,4,0,6246,A
2-PB1,1437,6243,0,0,0,6243,A
2-PB1,1438,6291,0,0,0,6291,A
2-PB1,1439,6300,0,8,0,6308,A
2-PB1,1440,0,1,6290,0,6291,G
2-PB1,1441,6224,0,3,0,6227,A
2-PB1,1442,6169,0,5,0,6174,A
2-PB1,1443,0,0,6409,0,6409,G
2-PB1,1444,0,6376,0,0,6376,T
2-PB1,1445,3,4,0,6403,6410,C
2-PB1,1446,4,0,0,6433,6437,C
2-PB1,1447,0,6416,0,6,6422,T
2-PB1,1448,6513,0,0,0,6513,A
2-PB1,1449,1,6498,0,1,6500,T
2-PB1,1450,6505,0,0,0,6505,A
2-PB1,1451,1,6505,0,2,6508,T
2-PB1,1452,6448,0,2,0,6450,A
2-PB1,1453,6453,1,4,0,6458,A
2-PB1,1454,6440,0,0,1,6441,A
2-PB1,1455,0,6439,0,1,6440,T
2-PB1,1456,6374,0,1,0,6375,A
2-PB1,1457,6332,0,3,0,6335,A
2-PB1,1458,6360,0,1,0,6361,A
2-PB1,1459,6358,0,0,0,6358,A
2-PB1,1460,1,2,0,6364,6367,C
2-PB1,1461,6115,0,1,0,6116,A
2-PB1,1462,1,12,6101,0,6114,G
2-PB1,1463,4,4,6100,0,6108,G
2-PB1,1464,0,6,6096,0,6102,G
2-PB1,1465,6095,1,7,0,6103,A
2-PB1,1466,0,3,0,6144,6147,C
2-PB1,1467,6106,1,1,0,6108,A
2-PB1,1468,0,6169,0,0,6169,T
2-PB1,1469,0,6167,1,4,6172,T
2-PB1,1470,0,6186,0,0,6186,T
2-PB1,1471,0,11,6166,1,6178,G
2-PB1,1472,6115,0,1,0,6116,A
2-PB1,1473,6144,0,0,0,6144,A
2-PB1,1474,1,6139,0,0,6140,T
2-PB1,1475,0,6045,0,2,6047,T
2-PB1,1476,9,1,0,6059,6069,C
2-PB1,1477,6018,0,1,0,6019,A
2-PB1,1478,3,1,0,6043,6047,C
2-PB1,1479,2,6046,0,2,6050,T
2-PB1,1480,6064,0,1,0,6065,A
2-PB1,1481,0,2,6036,0,6038,G
2-PB1,1482,3,0,0,6035,6038,C
2-PB1,1483,0,5979,0,11,5990,T
2-PB1,1484,0,6058,0,0,6058,T
2-PB1,1485,0,6050,1,2,6053,T
2-PB1,1486,2,6045,0,1,6048,T
2-PB1,1487,0,6057,0,2,6059,T
2-PB1,1488,0,6054,0,0,6054,T
2-PB1,1489,0,6045,0,0,6045,T
2-PB1,1490,6026,1,2,0,6029,A
2-PB1,1491,0,5973,0,1,5974,T
2-PB1,1492,0,1,0,6043,6044,C
2-PB1,1493,2,3,6070,1,6076,G
2-PB1,1494,6281,0,2,0,6283,A
2-PB1,1495,2,6290,1,1,6294,T
2-PB1,1496,6301,0,1,0,6302,A
2-PB1,1497,0,6344,0,2,6346,T
2-PB1,1498,0,3,6314,0,6317,G
2-PB1,1499,0,7,6347,0,6354,G
2-PB1,1500,6347,0,2,0,6349,A
2-PB1,1501,1,6280,0,1,6282,T
2-PB1,1502,0,6277,0,1,6278,T
2-PB1,1503,0,6114,0,1,6115,T
2-PB1,1504,0,0,6130,0,6130,G
2-PB1,1505,0,6083,0,1,6084,T
2-PB1,1506,0,2,6085,0,6087,G
2-PB1,1507,1,1,6067,1,6070,G
2-PB1,1508,3,2,0,5989,5994,C
2-PB1,1509,0,6063,0,1,6064,T
2-PB1,1510,6108,0,0,0,6108,A
2-PB1,1511,6134,0,1,0,6135,A
2-PB1,1512,0,6156,0,1,6157,T
2-PB1,1513,0,6177,0,1,6178,T
2-PB1,1514,1,6164,0,4,6169,T
2-PB1,1515,0,6174,0,2,6176,T
2-PB1,1516,6193,0,5,0,6198,A
2-PB1,1517,0,0,6236,0,6236,G
2-PB1,1518,1,4,0,6249,6254,C
2-PB1,1519,6218,0,1,0,6219,A
2-PB1,1520,0,6197,0,2,6199,T
2-PB1,1521,0,5,6120,0,6125,G
2-PB1,1522,0,8,6206,1,6215,G
2-PB1,1523,6188,0,8,0,6196,A
2-PB1,1524,1,1,6197,0,6199,G
2-PB1,1525,0,1,0,6177,6178,C
2-PB1,1526,0,6145,0,0,6145,T
2-PB1,1527,1,2,6163,0,6166,G
2-PB1,1528,0,4,0,6118,6122,C
2-PB1,1529,7,0,1,6125,6133,C
2-PB1,1530,5,1,0,6192,6198,C
2-PB1,1531,6086,0,3,0,6089,A
2-PB1,1532,1,1,6467,0,6469,G
2-PB1,1533,0,6439,0,1,6440,T
2-PB1,1534,0,6452,0,0,6452,T
2-PB1,1535,0,6447,1,3,6451,T
2-PB1,1536,0,6385,1,2,6388,T
2-PB1,1537,1,2,6371,0,6374,G
2-PB1,1538,1,7,6344,0,6352,G
2-PB1,1539,6304,1,5,0,6310,A
2-PB1,1540,0,1,6346,0,6347,G
2-PB1,1541,0,5892,0,0,5892,T
2-PB1,1542,0,0,6159,0,6159,G
2-PB1,1543,1,6123,0,1,6125,T
2-PB1,1544,9,1,0,6138,6148,C
2-PB1,1545,0,6166,0,7,6173,T
2-PB1,1546,0,3,6191,0,6194,G
2-PB1,1547,2,2,6300,0,6304,G
2-PB1,1548,6306,0,2,0,6308,A
2-PB1,1549,6323,0,1,0,6324,A
2-PB1,1550,0,6300,2,0,6302,T
2-PB1,1551,5959,0,0,0,5959,A
2-PB1,1552,5953,0,1,0,5954,A
2-PB1,1553,5957,0,3,0,5960,A
2-PB1,1554,0,0,0,5966,5966,C
2-PB1,1555,0,9,5884,0,5893,G
2-PB1,1556,5833,0,5,0,5838,A
2-PB1,1557,1,0,5831,0,5832,G
2-PB1,1558,1,5801,0,3,5805,T
2-PB1,1559,4,1,0,5851,5856,C
2-PB1,1560,5875,1,6,0,5882,A
2-PB1,1561,0,0,5940,0,5940,G
2-PB1,1562,1,3,1,5921,5926,C
2-PB1,1563,0,5948,0,3,5951,T
2-PB1,1564,3,1,6175,0,6179,G
2-PB1,1565,6146,0,1,0,6147,A
2-PB1,1566,0,6163,0,0,6163,T
2-PB1,1567,6157,0,5,0,6162,A
2-PB1,1568,1,6091,1,1,6094,T
2-PB1,1569,1,11,6123,1,6136,G
2-PB1,1570,5938,2,4,0,5944,A
2-PB1,1571,0,4,6050,0,6054,G
2-PB1,1572,1,1,0,6068,6070,C
2-PB1,1573,5842,0,1,0,5843,A
2-PB1,1574,2,5823,0,1,5826,T
2-PB1,1575,0,5836,0,1,5837,T
2-PB1,1576,2,2,5913,0,5917,G
2-PB1,1577,1,4,6113,0,6118,G
2-PB1,1578,6049,0,9,1,6059,A
2-PB1,1579,2,1,6070,0,6073,G
2-PB1,1580,0,5923,0,3,5926,T
2-PB1,1581,5948,0,3,0,5951,A
2-PB1,1582,5953,0,2,0,5955,A
2-PB1,1583,0,2,1,5993,5996,C
2-PB1,1584,5954,1,1,0,5956,A
2-PB1,1585,1,1,6054,0,6056,G
2-PB1,1586,0,5633,0,3,5636,T
2-PB1,1587,1,2,5727,0,5730,G
2-PB1,1588,5792,0,3,0,5795,A
2-PB1,1589,0,5800,0,0,5800,T
2-PB1,1590,5784,0,3,0,5787,A
2-PB1,1591,5788,0,1,0,5789,A
2-PB1,1592,5702,0,6,1,5709,A
2-PB1,1593,1,5,5749,0,5755,G
2-PB1,1594,5542,0,4,0,5546,A
2-PB1,1595,5548,0,2,1,5551,A
2-PB1,1596,0,2,0,5583,5585,C
2-PB1,1597,5469,1,2,0,5472,A
2-PB1,1598,5503,0,10,0,5513,A
2-PB1,1599,0,1,0,5552,5553,C
2-PB1,1600,5597,0,4,0,5601,A
2-PB1,1601,0,5591,2,6,5599,T
2-PB1,1602,0,4,5572,0,5576,G
2-PB1,1603,5574,0,1,0,5575,A
2-PB1,1604,0,5584,0,1,5585,T
2-PB1,1605,5539,0,3,0,5542,A
2-PB1,1606,5587,0,3,0,5590,A
2-PB1,1607,5590,0,4,1,5595,A
2-PB1,1608,0,2,0,5637,5639,C
2-PB1,1609,5484,0,0,0,5484,A
2-PB1,1610,5473,0,0,0,5473,A
2-PB1,1611,0,5382,0,2,5384,T
2-PB1,1612,0,9,5392,1,5402,G
2-PB1,1613,5481,0,4,0,5485,A
2-PB1,1614,0,3,0,5560,5563,C
2-PB1,1615,2,0,0,5529,5531,C
2-PB1,1616,0,5416,0,2,5418,T
2-PB1,1617,0,5360,0,4,5364,T
2-PB1,1618,1,3,5377,0,5381,G
2-PB1,1619,0,7,5407,0,5414,G
2-PB1,1620,5442,0,8,2,5452,A
2-PB1,1621,1,1,0,5424,5426,C
2-PB1,1622,2,0,0,5379,5381,C
2-PB1,1623,5334,0,10,0,5344,A
2-PB1,1624,0,1,5394,0,5395,G
2-PB1,1625,0,2,0,5401,5403,C
2-PB1,1626,5417,0,2,0,5419,A
2-PB1,1627,5387,0,1,0,5388,A
2-PB1,1628,0,0,0,5367,5367,C
2-PB1,1629,5338,0,2,0,5340,A
2-PB1,1630,0,0,5419,0,5419,G
2-PB1,1631,0,2,0,5401,5403,C
2-PB1,1632,2,0,0,5420,5422,C
2-PB1,1633,6,2,0,5413,5421,C
2-PB1,1634,5448,0,1,0,5449,A
2-PB1,1635,5442,0,0,0,5442,A
2-PB1,1636,5441,0,4,0,5445,A
2-PB1,1637,0,5418,0,5,5423,T
2-PB1,1638,0,6,5416,0,5422,G
2-PB1,1639,2,1,5329,0,5332,G
2-PB1,1640,1,0,0,5377,5378,C
2-PB1,1641,0,5307,0,3,5310,T
2-PB1,1642,1,3,0,5436,5440,C
2-PB1,1643,0,5419,0,9,5428,T
2-PB1,1644,3,1,0,5475,5479,C
2-PB1,1645,4,2,0,5520,5526,C
2-PB1,1646,5551,0,3,0,5554,A
2-PB1,1647,5552,0,0,0,5552,A
2-PB1,1648,0,5509,1,3,5513,T
2-PB1,1649,0,5499,0,0,5499,T
2-PB1,1650,1,1,5533,0,5535,G
2-PB1,1651,1,5417,0,6,5424,T
2-PB1,1652,0,5423,0,1,5424,T
2-PB1,1653,10,10,0,5448,5468,C
2-PB1,1654,5450,0,1,0,5451,A
2-PB1,1655,0,5423,0,4,5427,T
2-PB1,1656,4,2,0,5449,5455,C
2-PB1,1657,5472,1,1,0,5474,A
2-PB1,1658,5462,0,0,0,5462,A
2-PB1,1659,5441,1,10,0,5452,A
2-PB1,1660,1,3,5598,1,5603,G
2-PB1,1661,5563,0,0,0,5563,A
2-PB1,1662,0,5586,0,0,5586,T
2-PB1,1663,0,5605,0,2,5607,T
2-PB1,1664,5619,1,5,0,5625,A
2-PB1,1665,0,2,0,5746,5748,C
2-PB1,1666,5754,1,2,0,5757,A
2-PB1,1667,0,4,5812,0,5816,G
2-PB1,1668,5786,0,2,2,5790,A
2-PB1,1669,0,5918,0,1,5919,T
2-PB1,1670,5932,0,2,0,5934,A
2-PB1,1671,0,2,0,6271,6273,C
2-PB1,1672,6345,1,4,0,6350,A
2-PB1,1673,0,1,0,6701,6702,C
2-PB1,1674,6621,0,4,0,6625,A
2-PB1,1675,0,6655,0,2,6657,T
2-PB1,1676,6640,0,0,0,6640,A
2-PB1,1677,0,6596,1,3,6600,T
2-PB1,1678,6480,0,2,0,6482,A
2-PB1,1679,2,2,6457,0,6461,G
2-PB1,1680,0,2,6384,0,6386,G
2-PB1,1681,0,6055,0,6,6061,T
2-PB1,1682,2,1,6003,1,6007,G
2-PB1,1683,2,4,1,6142,6149,C
2-PB1,1684,5,2,0,6174,6181,C
2-PB1,1685,6287,0,0,0,6287,A
2-PB1,1686,1,6298,0,0,6299,T
2-PB1,1687,6302,1,2,0,6305,A
2-PB1,1688,1,2,6321,0,6324,G
2-PB1,1689,6176,0,6,0,6182,A
2-PB1,1690,2,2,6216,0,6220,G
2-PB1,1691,1,3,6185,0,6189,G
2-PB1,1692,5964,1,7,0,5972,A
2-PB1,1693,0,2,6002,0,6004,G
2-PB1,1694,5956,4,5,0,5965,A
2-PB1,1695,0,2,0,5987,5989,C
2-PB1,1696,5975,2,2,0,5979,A
2-PB1,1697,1,2,1,6005,6009,C
2-PB1,1698,6001,1,6,0,6008,A
2-PB1,1699,0,1,0,6021,6022,C
2-PB1,1700,6010,0,1,0,6011,A
2-PB1,1701,6034,0,1,0,6035,A
2-PB1,1702,6046,0,2,1,6049,A
2-PB1,1703,1,6023,0,1,6025,T
2-PB1,1704,3,0,0,6043,6046,C
2-PB1,1705,3,2,0,6042,6047,C
2-PB1,1706,5988,0,6,0,5994,A
2-PB1,1707,0,3,6011,0,6014,G
2-PB1,1708,5995,0,2,1,5998,A
2-PB1,1709,0,1,0,6049,6050,C
2-PB1,1710,0,10,6042,0,6052,G
2-PB1,1711,5993,0,3,2,5998,A
2-PB1,1712,1,4,6022,0,6027,G
2-PB1,1713,6011,0,5,0,6016,A
2-PB1,1714,6029,0,3,1,6033,A
2-PB1,1715,0,4,6045,0,6049,G
2-PB1,1716,6026,0,4,1,6031,A
2-PB1,1717,1,6029,1,3,6034,T
2-PB1,1718,4,1,0,6004,6009,C
2-PB1,1719,6037,0,1,0,6038,A
2-PB1,1720,1,6003,0,0,6004,T
2-PB1,1721,0,5985,0,0,5985,T
2-PB1,1722,2,2,0,6013,6017,C
2-PB1,1723,1,4,6016,0,6021,G
2-PB1,1724,5941,0,8,0,5949,A
2-PB1,1725,0,0,5975,0,5975,G
2-PB1,1726,5941,0,0,1,5942,A
2-PB1,1727,0,6147,0,1,6148,T
2-PB1,1728,6160,0,0,0,6160,A
2-PB1,1729,6162,1,8,1,6172,A
2-PB1,1730,6166,1,5,0,6172,A
2-PB1,1731,1,0,6171,0,6172,G
2-PB1,1732,6168,0,2,0,6170,A
2-PB1,1733,5997,0,7,1,6005,A
2-PB1,1734,0,0,6030,0,6030,G
2-PB1,1735,1,5,0,6004,6010,C
2-PB1,1736,2,5976,0,2,5980,T
2-PB1,1737,2,0,6001,0,6003,G
2-PB1,1738,0,5950,0,4,5954,T
2-PB1,1739,0,6,5980,0,5986,G
2-PB1,1740,4,2,5960,1,5967,G
2-PB1,1741,0,5,6022,0,6027,G
2-PB1,1742,6032,0,7,0,6039,A
2-PB1,1743,0,5976,0,3,5979,T
2-PB1,1744,4,0,0,5957,5961,C
2-PB1,1745,5981,0,4,0,5985,A
2-PB1,1746,5991,0,3,0,5994,A
2-PB1,1747,6000,0,3,0,6003,A
2-PB1,1748,1,0,0,6008,6009,C
2-PB1,1749,6,2,0,5984,5992,C
2-PB1,1750,8,0,0,5974,5982,C
2-PB1,1751,5983,0,1,0,5984,A
2-PB1,1752,6068,0,0,2,6070,A
2-PB1,1753,1,6034,0,1,6036,T
2-PB1,1754,3,0,0,6080,6083,C
2-PB1,1755,6036,0,3,0,6039,A
2-PB1,1756,5996,1,12,0,6009,A
2-PB1,1757,9,8,6040,0,6057,G
2-PB1,1758,0,2,6003,0,6005,G
2-PB1,1759,3,1,6011,0,6015,G
2-PB1,1760,1,0,0,6035,6036,C
2-PB1,1761,5927,0,13,0,5940,A
2-PB1,1762,0,2,6093,0,6095,G
2-PB1,1763,1,7,6145,0,6153,G
2-PB1,1764,6158,1,3,0,6162,A
2-PB1,1765,1,0,0,6265,6266,C
2-PB1,1766,0,6145,0,1,6146,T
2-PB1,1767,6334,2,3,0,6339,A
2-PB1,1768,2,6304,1,4,6311,T
2-PB1,1769,2,6306,0,1,6309,T
2-PB1,1770,1,7,6344,0,6352,G
2-PB1,1771,1,0,6350,0,6351,G
2-PB1,1772,0,6261,0,4,6265,T
2-PB1,1773,6339,0,1,0,6340,A
2-PB1,1774,0,6220,1,5,6226,T
2-PB1,1775,1,1,1,6253,6256,C
2-PB1,1776,6140,0,2,0,6142,A
2-PB1,1777,1,4,6218,0,6223,G
2-PB1,1778,6202,0,3,0,6205,A
2-PB1,1779,3,6164,0,2,6169,T
2-PB1,1780,0,5,5944,0,5949,G
2-PB1,1781,2,6,5923,0,5931,G
2-PB1,1782,4,4,5931,0,5939,G
2-PB1,1783,1,7,5938,0,5946,G
2-PB1,1784,0,3,5952,0,5955,G
2-PB1,1785,5925,1,5,0,5931,A
2-PB1,1786,1,0,0,5904,5905,C
2-PB1,1787,3,0,0,5879,5882,C
2-PB1,1788,5904,1,0,0,5905,A
2-PB1,1789,6309,0,0,3,6312,A
2-PB1,1790,6323,0,2,0,6325,A
2-PB1,1791,0,1,0,6487,6488,C
2-PB1,1792,0,6407,0,3,6410,T
2-PB1,1793,0,6396,0,0,6396,T
2-PB1,1794,6429,0,1,0,6430,A
2-PB1,1795,0,6425,0,1,6426,T
2-PB1,1796,6415,1,4,0,6420,A
2-PB1,1797,2,0,1,6440,6443,C
2-PB1,1798,5958,0,1,0,5959,A
2-PB1,1799,5975,0,1,0,5976,A
2-PB1,1800,0,5861,0,0,5861,T
2-PB1,1801,5944,0,0,1,5945,A
2-PB1,1802,0,5927,0,1,5928,T
2-PB1,1803,3,2,0,5922,5927,C
2-PB1,1804,3,3,0,5921,5927,C
2-PB1,1805,4,3,5919,0,5926,G
2-PB1,1806,3,6,5928,0,5937,G
2-PB1,1807,5926,0,5,0,5931,A
2-PB1,1808,5929,0,0,0,5929,A
2-PB1,1809,2,5935,0,0,5937,T
2-PB1,1810,3,2,0,5928,5933,C
2-PB1,1811,0,5909,0,4,5913,T
2-PB1,1812,0,5918,0,7,5925,T
2-PB1,1813,2,2,0,5920,5924,C
2-PB1,1814,5915,3,6,0,5924,A
2-PB1,1815,0,1,0,5931,5932,C
2-PB1,1816,5930,0,1,0,5931,A
2-PB1,1817,0,6277,0,6,6283,T
2-PB1,1818,4,4,0,6298,6306,C
2-PB1,1819,5,0,0,6278,6283,C
2-PB1,1820,4,1,2,6328,6335,C
2-PB1,1821,0,6327,0,11,6338,T
2-PB1,1822,1,3,6342,0,6346,G
2-PB1,1823,6290,0,0,0,6290,A
2-PB1,1824,6290,0,2,0,6292,A
2-PB1,1825,0,1,6319,0,6320,G
2-PB1,1826,1,5945,0,7,5953,T
2-PB1,1827,4,0,0,5989,5993,C
2-PB1,1828,0,5892,0,4,5896,T
2-PB1,1829,1,2,5983,0,5986,G
2-PB1,1830,0,0,0,5991,5991,C
2-PB1,1831,1,6007,0,1,6009,T
2-PB1,1832,2,6010,0,3,6015,T
2-PB1,1833,6010,1,0,1,6012,A
2-PB1,1834,6000,0,1,0,6001,A
2-PB1,1835,6009,0,0,1,6010,A
2-PB1,1836,5836,1,8,1,5846,A
2-PB1,1837,0,5868,0,0,5868,T
2-PB1,1838,0,3,5867,0,5870,G
2-PB1,1839,5,4,5830,0,5839,G
2-PB1,1840,0,6,5857,0,5863,G
2-PB1,1841,5856,0,8,0,5864,A
2-PB1,1842,0,0,5882,0,5882,G
2-PB1,1843,2,0,0,5852,5854,C
2-PB1,1844,0,5875,0,6,5881,T
2-PB1,1845,0,1,5904,0,5905,G
2-PB1,1846,5874,0,0,0,5874,A
2-PB1,1847,0,5888,0,3,5891,T
2-PB1,1848,3,4,5922,0,5929,G
2-PB1,1849,3,1,5924,0,5928,G
2-PB1,1850,5914,2,1,1,5918,A
2-PB1,1851,0,5921,0,1,5922,T
2-PB1,1852,1,4,5909,1,5915,G
2-PB1,1853,5874,0,4,1,5879,A
2-PB1,1854,0,5,5981,0,5986,G
2-PB1,1855,5979,0,3,1,5983,A
2-PB1,1856,5978,0,1,0,5979,A
2-PB1,1857,0,5941,0,0,5941,T
2-PB1,1858,0,5924,0,1,5925,T
2-PB1,1859,5936,0,0,0,5936,A
2-PB1,1860,0,5903,0,0,5903,T
2-PB1,1861,3,1,0,5930,5934,C
2-PB1,1862,3,5,5930,0,5938,G
2-PB1,1863,1,1,5878,1,5881,G
2-PB1,1864,2,5,5858,0,5865,G
2-PB1,1865,2,3,5845,0,5850,G
2-PB1,1866,5846,0,1,1,5848,A
2-PB1,1867,5859,1,7,1,5868,A
2-PB1,1868,1,3,5905,0,5909,G
2-PB1,1869,5937,1,1,2,5941,A
2-PB1,1870,0,0,0,5981,5981,C
2-PB1,1871,1,5927,1,5,5934,T
2-PB1,1872,0,6034,0,1,6035,T
2-PB1,1873,0,6050,0,0,6050,T
2-PB1,1874,1,0,6066,0,6067,G
2-PB1,1875,0,6055,0,3,6058,T
2-PB1,1876,6040,0,0,1,6041,A
2-PB1,1877,6010,0,1,0,6011,A
2-PB1,1878,1,5905,0,1,5907,T
2-PB1,1879,5,2,0,5949,5956,C
2-PB1,1880,3,1,0,5925,5929,C
2-PB1,1881,9,0,0,5885,5894,C
2-PB1,1882,2,0,0,5921,5923,C
2-PB1,1883,0,5920,1,7,5928,T
2-PB1,1884,1,7,5915,0,5923,G
2-PB1,1885,5910,0,1,0,5911,A
2-PB1,1886,5913,0,3,0,5916,A
2-PB1,1887,0,5921,0,5,5926,T
2-PB1,1888,2,0,0,5876,5878,C
2-PB1,1889,1,0,0,5864,5865,C
2-PB1,1890,6,3,0,5830,5839,C
2-PB1,1891,0,5835,0,4,5839,T
2-PB1,1892,0,5861,0,0,5861,T
2-PB1,1893,0,5834,1,3,5838,T
2-PB1,1894,2,1,5842,0,5845,G
2-PB1,1895,0,5800,0,6,5806,T
2-PB1,1896,6,3,1,5790,5800,C
2-PB1,1897,5765,1,3,1,5770,A
2-PB1,1898,2,0,5807,1,5810,G
2-PB1,1899,1,0,0,5765,5766,C
2-PB1,1900,2,0,0,5798,5800,C
2-PB1,1901,5809,0,2,0,5811,A
2-PB1,1902,0,5839,0,0,5839,T
2-PB1,1903,5827,0,3,1,5831,A
2-PB1,1904,5843,1,1,0,5845,A
2-PB1,1905,5841,0,2,1,5844,A
2-PB1,1906,5,4,5910,0,5919,G
2-PB1,1907,5785,0,0,0,5785,A
2-PB1,1908,5811,0,0,0,5811,A
2-PB1,1909,5799,0,4,0,5803,A
2-PB1,1910,1,5758,0,3,5762,T
2-PB1,1911,0,5766,1,0,5767,T
2-PB1,1912,0,4,5775,0,5779,G
2-PB1,1913,5743,1,4,0,5748,A
2-PB1,1914,1,0,5815,0,5816,G
2-PB1,1915,0,5781,6,2,5789,T
2-PB1,1916,5,0,0,5847,5852,C
2-PB1,1917,1,5820,0,6,5827,T
2-PB1,1918,1,2,5928,0,5931,G
2-PB1,1919,0,5914,2,2,5918,T
2-PB1,1920,5991,0,2,0,5993,A
2-PB1,1921,5972,0,4,0,5976,A
2-PB1,1922,5967,2,5,0,5974,A
2-PB1,1923,0,5,0,5992,5997,C
2-PB1,1924,5824,0,1,0,5825,A
2-PB1,1925,5929,0,0,0,5929,A
2-PB1,1926,0,5908,1,1,5910,T
2-PB1,1927,2,1,5888,0,5891,G
2-PB1,1928,1,3,0,5899,5903,C
2-PB1,1929,0,5865,0,3,5868,T
2-PB1,1930,5,0,6036,0,6041,G
2-PB1,1931,1,6033,0,3,6037,T
2-PB1,1932,6116,0,4,0,6120,A
2-PB1,1933,10,4,6106,0,6120,G
2-PB1,1934,1,5981,1,0,5983,T
2-PB1,1935,5965,0,0,1,5966,A
2-PB1,1936,5896,0,0,1,5897,A
2-PB1,1937,0,5853,1,0,5854,T
2-PB1,1938,2,0,5841,0,5843,G
2-PB1,1939,0,3,0,5727,5730,C
2-PB1,1940,8,2,0,5662,5672,C
2-PB1,1941,5596,0,3,0,5599,A
2-PB1,1942,0,5,5710,0,5715,G
2-PB1,1943,1,2,0,5771,5774,C
2-PB1,1944,2,2,0,5778,5782,C
2-PB1,1945,4,1,1,5793,5799,C
2-PB1,1946,5782,0,2,0,5784,A
2-PB1,1947,0,5774,0,5,5779,T
2-PB1,1948,2,4,5792,0,5798,G
2-PB1,1949,1,0,5865,0,5866,G
2-PB1,1950,0,5793,1,6,5800,T
2-PB1,1951,7,0,1,5666,5674,C
2-PB1,1952,5,1,1,5581,5588,C
2-PB1,1953,3,5563,4,6,5576,T
2-PB1,1954,3,2,5663,0,5668,G
2-PB1,1955,1,1,0,5606,5608,C
2-PB1,1956,4,1,0,5653,5658,C
2-PB1,1957,5672,0,1,1,5674,A
2-PB1,1958,5589,0,0,0,5589,A
2-PB1,1959,5590,2,1,0,5593,A
2-PB1,1960,5617,0,3,1,5621,A
2-PB1,1961,1,3,5701,0,5705,G
2-PB1,1962,0,5561,0,7,5568,T
2-PB1,1963,5623,0,1,0,5624,A
2-PB1,1964,0,5614,0,0,5614,T
2-PB1,1965,1,4,5611,0,5616,G
2-PB1,1966,0,6,5704,0,5710,G
2-PB1,1967,5693,0,2,0,5695,A
2-PB1,1968,5763,0,0,0,5763,A
2-PB1,1969,0,5742,1,0,5743,T
2-PB1,1970,5668,0,1,0,5669,A
2-PB1,1971,0,5635,0,4,5639,T
2-PB1,1972,1,2,5598,0,5601,G
2-PB1,1973,5608,0,8,0,5616,A
2-PB1,1974,0,5577,0,3,5580,T
2-PB1,1975,1,1,5445,0,5447,G
2-PB1,1976,1,3,0,5429,5433,C
2-PB1,1977,1,4,0,5380,5385,C
2-PB1,1978,3,0,5422,0,5425,G
2-PB1,1979,0,5414,0,1,5415,T
2-PB1,1980,1,5424,0,5,5430,T
2-PB1,1981,0,0,5429,0,5429,G
2-PB1,1982,0,1,0,5524,5525,C
2-PB1,1983,5537,1,0,0,5538,A
2-PB1,1984,5593,0,1,0,5594,A
2-PB1,1985,1,2,1,5614,5618,C
2-PB1,1986,0,5576,0,2,5578,T
2-PB1,1987,5580,0,2,0,5582,A
2-PB1,1988,0,8,0,5573,5581,C
2-PB1,1989,5542,2,2,0,5546,A
2-PB1,1990,2,0,0,5594,5596,C
2-PB1,1991,5369,0,0,1,5370,A
2-PB1,1992,0,0,0,5860,5860,C
2-PB1,1993,1,5698,0,1,5700,T
2-PB1,1994,9,0,0,5762,5771,C
2-PB1,1995,3,1,0,5757,5761,C
2-PB1,1996,0,5703,0,13,5716,T
2-PB1,1997,1,5,5728,1,5735,G
2-PB1,1998,0,2,5723,0,5725,G
2-PB1,1999,5712,0,0,0,5712,A
2-PB1,2000,0,5724,0,2,5726,T
2-PB1,2001,0,5172,0,1,5173,T
2-PB1,2002,4,2,1,5252,5259,C
2-PB1,2003,4,0,0,5222,5226,C
2-PB1,2004,3,0,0,5267,5270,C
2-PB1,2005,5292,0,0,0,5292,A
2-PB1,2006,5280,0,2,0,5282,A
2-PB1,2007,1,3,5292,0,5296,G
2-PB1,2008,5277,0,4,1,5282,A
2-PB1,2009,1,0,5261,0,5262,G
2-PB1,2010,1,6,5249,0,5256,G
2-PB1,2011,5180,0,3,0,5183,A
2-PB1,2012,5173,0,3,0,5176,A
2-PB1,2013,1,1,0,5179,5181,C
2-PB1,2014,2,2,0,5130,5134,C
2-PB1,2015,0,1,5203,0,5204,G
2-PB1,2016,0,0,0,5191,5191,C
2-PB1,2017,0,5197,2,7,5206,T
2-PB1,2018,4,1,0,5216,5221,C
2-PB1,2019,0,5201,0,2,5203,T
2-PB1,2020,5502,0,1,0,5503,A
2-PB1,2021,1,5499,0,6,5506,T
2-PB1,2022,0,5493,0,0,5493,T
2-PB1,2023,3,0,0,5510,5513,C
2-PB1,2024,0,5326,0,1,5327,T
2-PB1,2025,5324,0,3,0,5327,A
2-PB1,2026,5321,0,1,0,5322,A
2-PB1,2027,5311,0,0,1,5312,A
2-PB1,2028,1,0,0,5326,5327,C
2-PB1,2029,4956,0,1,0,4957,A
2-PB1,2030,3,1,1,4965,4970,C
2-PB1,2031,4901,0,3,0,4904,A
2-PB1,2032,4927,1,6,0,4934,A
2-PB1,2033,0,0,4965,0,4965,G
2-PB1,2034,0,1,0,4926,4927,C
2-PB1,2035,6,3,0,4949,4958,C
2-PB1,2036,4899,0,2,1,4902,A
2-PB1,2037,4898,0,2,0,4900,A
2-PB1,2038,4902,0,6,0,4908,A
2-PB1,2039,0,3,4930,0,4933,G
2-PB1,2040,0,5,4921,0,4926,G
2-PB1,2041,3,4,4834,0,4841,G
2-PB1,2042,1,6,4858,1,4866,G
2-PB1,2043,4829,0,0,0,4829,A
2-PB1,2044,4848,0,0,0,4848,A
2-PB1,2045,0,4849,0,0,4849,T
2-PB1,2046,0,4855,0,0,4855,T
2-PB1,2047,1,0,0,4875,4876,C
2-PB1,2048,0,4838,0,3,4841,T
2-PB1,2049,0,4831,1,1,4833,T
2-PB1,2050,0,0,4839,0,4839,G
2-PB1,2051,4828,0,7,0,4835,A
2-PB1,2052,0,4,4857,0,4861,G
2-PB1,2053,0,1,4845,0,4846,G
2-PB1,2054,4849,1,2,0,4852,A
2-PB1,2055,0,4817,1,1,4819,T
2-PB1,2056,2,7,4822,0,4831,G
2-PB1,2057,4830,0,7,0,4837,A
2-PB1,2058,4817,1,6,0,4824,A
2-PB1,2059,0,2,0,4859,4861,C
2-PB1,2060,4802,0,0,0,4802,A
2-PB1,2061,0,1,4859,0,4860,G
2-PB1,2062,4823,0,4,0,4827,A
2-PB1,2063,1,4817,0,0,4818,T
2-PB1,2064,0,0,4823,1,4824,G
2-PB1,2065,0,4861,0,2,4863,T
2-PB1,2066,4864,0,3,0,4867,A
2-PB1,2067,2,2,0,4857,4861,C
2-PB1,2068,5,0,0,4862,4867,C
2-PB1,2069,4819,0,2,0,4821,A
2-PB1,2070,0,1,4753,0,4754,G
2-PB1,2071,4703,1,0,0,4704,A
2-PB1,2072,4680,0,1,0,4681,A
2-PB1,2073,0,0,4695,0,4695,G
2-PB1,2074,0,4432,1,1,4434,T
2-PB1,2075,1,0,4463,0,4464,G
2-PB1,2076,0,1,0,4446,4447,C
2-PB1,2077,0,4438,0,9,4447,T
2-PB1,2078,2,0,4450,0,4452,G
2-PB1,2079,3,0,0,4435,4438,C
2-PB1,2080,4450,0,3,0,4453,A
2-PB1,2081,4445,1,2,0,4448,A
2-PB1,2082,0,0,0,4389,4389,C
2-PB1,2083,1,4361,0,5,4367,T
2-PB1,2084,0,4323,1,0,4324,T
2-PB1,2085,1,0,4326,0,4327,G
2-PB1,2086,0,4316,0,0,4316,T
2-PB1,2087,0,4300,1,1,4302,T
2-PB1,2088,3,2,0,4312,4317,C
2-PB1,2089,1,3,4309,1,4314,G
2-PB1,2090,4309,0,2,0,4311,A
2-PB1,2091,0,1,4308,0,4309,G
2-PB1,2092,4314,1,3,0,4318,A
2-PB1,2093,4308,0,0,0,4308,A
2-PB1,2094,4304,0,0,0,4304,A
2-PB1,2095,0,4293,0,1,4294,T
2-PB1,2096,0,4289,0,0,4289,T
2-PB1,2097,0,4306,1,1,4308,T
2-PB1,2098,0,4305,0,0,4305,T
2-PB1,2099,0,4280,1,0,4281,T
2-PB1,2100,0,1,1,4272,4274,C
2-PB1,2101,3,0,0,4270,4273,C
2-PB1,2102,3,0,0,4291,4294,C
2-PB1,2103,0,4307,0,5,4312,T
2-PB1,2104,4310,0,0,0,4310,A
2-PB1,2105,1,0,4334,0,4335,G
2-PB1,2106,1,4305,0,2,4308,T
2-PB1,2107,4331,0,2,0,4333,A
2-PB1,2108,0,0,4356,0,4356,G
2-PB1,2109,0,4297,0,2,4299,T
2-PB1,2110,0,4382,1,4,4387,T
2-PB1,2111,5,0,0,4412,4417,C
2-PB1,2112,4483,0,1,0,4484,A
2-PB1,2113,0,4482,0,0,4482,T
2-PB1,2114,4509,0,2,0,4511,A
2-PB1,2115,1,4515,1,1,4518,T
2-PB1,2116,4344,0,4,0,4348,A
2-PB1,2117,3,2,4306,0,4311,G
2-PB1,2118,0,2,4296,0,4298,G
2-PB1,2119,3900,0,4,0,3904,A
2-PB1,2120,1,3,3911,0,3915,G
2-PB1,2121,3663,0,6,2,3671,A
2-PB1,2122,1,0,0,3653,3654,C
2-PB1,2123,2,1,0,3431,3434,C
2-PB1,2124,1,0,3438,0,3439,G
2-PB1,2125,3406,0,1,0,3407,A
2-PB1,2126,0,3400,0,0,3400,T
2-PB1,2127,2,3,0,3403,3408,C
2-PB1,2128,2,2,3404,2,3410,G
2-PB1,2129,0,4,3422,0,3426,G
2-PB1,2130,3424,0,1,0,3425,A
2-PB1,2131,3426,0,1,0,3427,A
2-PB1,2132,0,3424,0,1,3425,T
2-PB1,2133,0,3424,1,1,3426,T
2-PB1,2134,0,3400,0,0,3400,T
2-PB1,2135,2,0,0,3424,3426,C
2-PB1,2136,0,3426,0,0,3426,T
2-PB1,2137,3422,0,3,0,3425,A
2-PB1,2138,0,0,3421,0,3421,G
2-PB1,2139,0,1,0,3377,3378,C
2-PB1,2140,3361,0,0,0,3361,A
2-PB1,2141,0,3354,0,2,3356,T
2-PB1,2142,0,2,3297,0,3299,G
2-PB1,2143,0,6,3347,0,3353,G
2-PB1,2144,0,3331,0,3,3334,T
2-PB1,2145,3,1,3330,0,3334,G
2-PB1,2146,0,2,3321,0,3323,G
2-PB1,2147,3287,0,4,0,3291,A
2-PB1,2148,1,2,3289,0,3292,G
2-PB1,2149,0,1,3258,0,3259,G
2-PB1,2150,2,1,0,3171,3174,C
2-PB1,2151,3,1,0,3211,3215,C
2-PB1,2152,3014,1,0,0,3015,A
2-PB1,2153,1,2997,0,1,2999,T
2-PB1,2154,0,2,3017,0,3019,G
2-PB1,2155,4,1,3022,0,3027,G
2-PB1,2156,0,2960,1,1,2962,T
2-PB1,2157,1,0,2987,0,2988,G
2-PB1,2158,0,2911,0,1,2912,T
2-PB1,2159,1,0,0,2876,2877,C
2-PB1,2160,1,2890,0,2,2893,T
2-PB1,2161,2870,0,0,0,2870,A
2-PB1,2162,1,1,2852,0,2854,G
2-PB1,2163,2,1,2795,0,2798,G
2-PB1,2164,0,0,2730,0,2730,G
2-PB1,2165,0,1,0,2651,2652,C
2-PB1,2166,0,0,0,2542,2542,C
2-PB1,2167,4,2,1,2499,2506,C
2-PB1,2168,0,0,2504,0,2504,G
2-PB1,2169,0,1,2518,0,2519,G
2-PB1,2170,2509,0,0,0,2509,A
2-PB1,2171,0,2510,0,1,2511,T
2-PB1,2172,0,2411,0,0,2411,T
2-PB1,2173,0,2,2406,0,2408,G
2-PB1,2174,2398,0,2,0,2400,A
2-PB1,2175,0,2390,0,2,2392,T
2-PB1,2176,3,1,2398,0,2402,G
2-PB1,2177,2,1,0,2362,2365,C
2-PB1,2178,1,0,0,2370,2371,C
2-PB1,2179,2350,0,0,0,2350,A
2-PB1,2180,0,0,2360,0,2360,G
2-PB1,2181,2357,0,1,0,2358,A
2-PB1,2182,2351,0,1,0,2352,A
2-PB1,2183,0,2351,0,0,2351,T
2-PB1,2184,0,2293,0,3,2296,T
2-PB1,2185,0,2,2297,0,2299,G
2-PB1,2186,2259,0,0,0,2259,A
2-PB1,2187,0,0,0,2275,2275,C
2-PB1,2188,0,2256,0,3,2259,T
2-PB1,2189,0,2215,0,0,2215,T
2-PB1,2190,0,0,0,2232,2232,C
2-PB1,2191,0,5,2231,0,2236,G
2-PB1,2192,2225,0,0,0,2225,A
2-PB1,2193,1,0,2202,0,2203,G
2-PB1,2194,0,2209,0,3,2212,T
2-PB1,2195,2,1,0,2219,2222,C
2-PB1,2196,0,2222,0,2,2224,T
2-PB1,2197,0,1,2217,0,2218,G
2-PB1,2198,0,1,2217,0,2218,G
2-PB1,2199,2219,0,1,0,2220,A
2-PB1,2200,2032,0,1,0,2033,A
2-PB1,2201,1,2,2029,0,2032,G
2-PB1,2202,0,0,2054,0,2054,G
2-PB1,2203,2062,0,2,0,2064,A
2-PB1,2204,0,2039,0,0,2039,T
2-PB1,2205,0,2046,0,0,2046,T
2-PB1,2206,2033,0,0,0,2033,A
2-PB1,2207,2033,0,7,0,2040,A
2-PB1,2208,0,2,2032,0,2034,G
2-PB1,2209,2038,0,1,0,2039,A
2-PB1,2210,2005,0,1,0,2006,A
2-PB1,2211,1754,0,2,0,1756,A
2-PB1,2212,0,1,1754,0,1755,G
2-PB1,2213,1761,0,0,0,1761,A
2-PB1,2214,1763,0,1,0,1764,A
2-PB1,2215,1,2,1754,0,1757,G
2-PB1,2216,1631,0,0,0,1631,A
2-PB1,2217,3,0,1628,0,1631,G
2-PB1,2218,0,1546,0,0,1546,T
2-PB1,2219,0,1526,0,1,1527,T
2-PB1,2220,0,1,0,1551,1552,C
2-PB1,2221,1,1505,0,1,1507,T
2-PB1,2222,4,0,0,1524,1528,C
2-PB1,2223,0,1518,0,0,1518,T
2-PB1,2224,0,0,1514,0,1514,G
2-PB1,2225,1491,0,1,0,1492,A
2-PB1,2226,1,0,1474,0,1475,G
2-PB1,2227,1456,0,0,0,1456,A
2-PB1,2228,0,1409,0,0,1409,T
2-PB1,2229,0,1,0,1316,1317,C
2-PB1,2230,1319,0,0,0,1319,A
2-PB1,2231,0,1315,0,0,1315,T
2-PB1,2232,1,0,1311,0,1312,G
2-PB1,2233,1308,0,1,0,1309,A
2-PB1,2234,1304,0,0,0,1304,A
2-PB1,2235,3,0,1275,0,1278,G
2-PB1,2236,1256,0,0,0,1256,A
2-PB1,2237,0,1233,0,0,1233,T
2-PB1,2238,2,2,0,1228,1232,C
2-PB1,2239,0,1163,0,0,1163,T
2-PB1,2240,0,0,1159,0,1159,G
2-PB1,2241,0,1157,0,2,1159,T
2-PB1,2242,0,1145,0,1,1146,T
2-PB1,2243,0,0,0,1141,1141,C
2-PB1,2244,1,0,0,1099,1100,C
2-PB1,2245,1080,0,1,0,1081,A
2-PB1,2246,0,0,0,1087,1087,C
2-PB1,2247,4,1,0,1020,1025,C
2-PB1,2248,998,0,0,0,998,A
2-PB1,2249,0,938,0,1,939,T
2-PB1,2250,0,903,0,0,903,T
2-PB1,2251,0,1,899,0,900,G
2-PB1,2252,896,0,0,0,896,A
2-PB1,2253,890,0,1,0,891,A
2-PB1,2254,0,1,885,0,886,G
2-PB1,2255,764,0,0,0,764,A
2-PB1,2256,764,0,0,0,764,A
2-PB1,2257,0,0,0,749,749,C
2-PB1,2258,0,715,0,0,715,T
2-PB1,2259,0,0,0,716,716,C
2-PB1,2260,678,0,0,0,678,A
2-PB1,2261,0,0,685,0,685,G
2-PB1,2262,681,0,0,0,681,A
2-PB1,2263,0,1,0,647,648,C
2-PB1,2264,0,1,636,0,637,G
2-PB1,2265,0,0,617,0,617,G
2-PB1,2266,0,0,0,614,614,C
2-PB1,2267,618,0,1,0,619,A
2-PB1,2268,616,0,0,0,616,A
2-PB1,2269,613,0,0,0,613,A
2-PB1,2270,609,0,0,0,609,A
2-PB1,2271,608,0,0,0,608,A
2-PB1,2272,0,593,0,0,593,T
2-PB1,2273,579,0,0,0,579,A
2-PB1,2274,571,0,0,0,571,A
3-PA,1,111,0,0,0,111,A
3-PA,2,0,113,0,0,113,T
3-PA,3,0,0,120,0,120,G
3-PA,4,0,0,121,0,121,G
3-PA,5,121,0,0,0,121,A
3-PA,6,119,0,0,0,119,A
3-PA,7,0,0,124,0,124,G
3-PA,8,127,0,0,0,127,A
3-PA,9,0,128,0,0,128,T
3-PA,10,0,127,0,0,127,T
3-PA,11,0,132,0,0,132,T
3-PA,12,0,132,0,0,132,T
3-PA,13,0,0,137,0,137,G
3-PA,14,0,132,0,0,132,T
3-PA,15,0,0,137,0,137,G
3-PA,16,0,0,0,147,147,C
3-PA,17,0,1,149,0,150,G
3-PA,18,165,0,1,0,166,A
3-PA,19,0,0,0,169,169,C
3-PA,20,168,0,0,0,168,A
3-PA,21,171,0,0,0,171,A
3-PA,22,0,180,0,0,180,T
3-PA,23,0,0,195,0,195,G
3-PA,24,0,0,0,203,203,C
3-PA,25,0,202,0,0,202,T
3-PA,26,0,202,0,1,203,T
3-PA,27,1,0,0,200,201,C
3-PA,28,209,0,0,0,209,A
3-PA,29,216,0,0,0,216,A
3-PA,30,0,0,0,228,228,C
3-PA,31,0,0,0,226,226,C
3-PA,32,0,0,0,226,226,C
3-PA,33,0,0,227,0,227,G
3-PA,34,227,0,0,0,227,A
3-PA,35,0,230,0,0,230,T
3-PA,36,0,0,230,0,230,G
3-PA,37,231,0,0,0,231,A
3-PA,38,0,240,0,0,240,T
3-PA,39,0,238,0,0,238,T
3-PA,40,0,0,243,0,243,G
3-PA,41,0,240,0,0,240,T
3-PA,42,0,0,0,242,242,C
3-PA,43,0,0,242,0,242,G
3-PA,44,241,0,0,0,241,A
3-PA,45,244,0,0,0,244,A
3-PA,46,0,0,0,243,243,C
3-PA,47,0,246,0,0,246,T
3-PA,48,0,246,0,0,246,T
3-PA,49,0,0,246,0,246,G
3-PA,50,0,0,0,249,249,C
3-PA,51,248,0,0,0,248,A
3-PA,52,0,0,249,0,249,G
3-PA,53,249,0,0,0,249,A
3-PA,54,249,0,0,0,249,A
3-PA,55,252,0,0,0,252,A
3-PA,56,253,0,0,0,253,A
3-PA,57,252,0,0,0,252,A
3-PA,58,0,0,254,0,254,G
3-PA,59,0,0,0,267,267,C
3-PA,60,269,0,0,0,269,A
3-PA,61,284,0,0,0,284,A
3-PA,62,0,288,0,0,288,T
3-PA,63,0,0,290,0,290,G
3-PA,64,299,0,0,0,299,A
3-PA,65,299,0,0,0,299,A
3-PA,66,298,0,0,0,298,A
3-PA,67,0,0,321,0,321,G
3-PA,68,329,0,1,0,330,A
3-PA,69,0,0,393,0,393,G
3-PA,70,0,390,0,0,390,T
3-PA,71,396,0,0,0,396,A
3-PA,72,0,393,0,0,393,T
3-PA,73,0,0,394,0,394,G
3-PA,74,0,0,396,0,396,G
3-PA,75,0,0,393,0,393,G
3-PA,76,0,0,395,0,395,G
3-PA,77,391,0,0,0,391,A
3-PA,78,0,0,391,0,391,G
3-PA,79,0,0,402,0,402,G
3-PA,80,398,0,0,0,398,A
3-PA,81,0,405,0,0,405,T
3-PA,82,0,0,0,410,410,C
3-PA,83,0,411,0,0,411,T
3-PA,84,0,0,412,0,412,G
3-PA,85,414,0,0,0,414,A
3-PA,86,415,0,0,0,415,A
3-PA,87,419,0,0,0,419,A
3-PA,88,414,0,0,0,414,A
3-PA,89,0,413,0,0,413,T
3-PA,90,0,417,0,0,417,T
3-PA,91,0,0,413,0,413,G
3-PA,92,415,0,0,0,415,A
3-PA,93,411,0,2,0,413,A
3-PA,94,418,0,0,0,418,A
3-PA,95,0,0,0,418,418,C
3-PA,96,421,0,0,0,421,A
3-PA,97,419,0,0,0,419,A
3-PA,98,418,0,0,0,418,A
3-PA,99,0,0,0,420,420,C
3-PA,100,422,0,0,0,422,A
3-PA,101,424,0,0,0,424,A
3-PA,102,424,0,0,0,424,A
3-PA,103,0,424,0,0,424,T
3-PA,104,0,426,0,0,426,T
3-PA,105,0,427,0,0,427,T
3-PA,106,0,0,426,0,426,G
3-PA,107,0,1,0,427,428,C
3-PA,108,428,0,3,0,431,A
3-PA,109,0,0,457,0,457,G
3-PA,110,0,0,0,457,457,C
3-PA,111,479,0,0,0,479,A
3-PA,112,485,0,0,0,485,A
3-PA,113,0,487,0,1,488,T
3-PA,114,492,0,2,0,494,A
3-PA,115,0,495,0,0,495,T
3-PA,116,0,0,500,0,500,G
3-PA,117,0,0,0,502,502,C
3-PA,118,498,0,0,0,498,A
3-PA,119,0,0,0,503,503,C
3-PA,120,0,501,0,0,501,T
3-PA,121,0,0,0,593,593,C
3-PA,122,614,0,0,0,614,A
3-PA,123,0,1,0,632,633,C
3-PA,124,0,633,0,0,633,T
3-PA,125,0,631,0,0,631,T
3-PA,126,0,0,631,0,631,G
3-PA,127,0,0,642,0,642,G
3-PA,128,633,1,2,0,636,A
3-PA,129,0,2,645,0,647,G
3-PA,130,0,0,649,0,649,G
3-PA,131,0,604,0,0,604,T
3-PA,132,0,0,643,0,643,G
3-PA,133,0,637,0,1,638,T
3-PA,134,0,0,657,0,657,G
3-PA,135,0,660,0,1,661,T
3-PA,136,0,658,0,0,658,T
3-PA,137,0,658,0,1,659,T
3-PA,138,0,0,0,665,665,C
3-PA,139,667,0,1,0,668,A
3-PA,140,0,669,0,0,669,T
3-PA,141,0,0,681,0,681,G
3-PA,142,0,677,0,0,677,T
3-PA,143,683,1,0,0,684,A
3-PA,144,0,678,0,0,678,T
3-PA,145,0,683,0,0,683,T
3-PA,146,0,1,0,679,680,C
3-PA,147,679,0,1,0,680,A
3-PA,148,0,1,688,0,689,G
3-PA,149,684,0,0,0,684,A
3-PA,150,0,691,0,0,691,T
3-PA,151,0,690,0,2,692,T
3-PA,152,0,689,0,0,689,T
3-PA,153,0,1,1,680,682,C
3-PA,154,0,0,0,703,703,C
3-PA,155,707,0,0,0,707,A
3-PA,156,0,704,0,0,704,T
3-PA,157,0,702,0,0,702,T
3-PA,158,0,700,0,1,701,T
3-PA,159,1,0,0,704,705,C
3-PA,160,701,0,2,0,703,A
3-PA,161,0,709,0,0,709,T
3-PA,162,0,0,0,714,714,C
3-PA,163,711,0,0,0,711,A
3-PA,164,710,0,0,0,710,A
3-PA,165,0,713,0,1,714,T
3-PA,166,0,5,736,0,741,G
3-PA,167,750,0,0,0,750,A
3-PA,168,748,0,0,0,748,A
3-PA,169,0,0,0,755,755,C
3-PA,170,751,0,0,0,751,A
3-PA,171,752,0,1,0,753,A
3-PA,172,0,1,753,0,754,G
3-PA,173,0,0,748,0,748,G
3-PA,174,738,0,2,1,741,A
3-PA,175,0,0,777,0,777,G
3-PA,176,804,0,1,0,805,A
3-PA,177,808,0,0,0,808,A
3-PA,178,0,809,0,0,809,T
3-PA,179,0,0,0,820,820,C
3-PA,180,821,0,0,0,821,A
3-PA,181,817,0,1,0,818,A
3-PA,182,0,824,0,0,824,T
3-PA,183,818,0,0,0,818,A
3-PA,184,0,0,844,0,844,G
3-PA,185,0,841,0,0,841,T
3-PA,186,0,0,845,0,845,G
3-PA,187,1,0,848,0,849,G
3-PA,188,0,838,0,0,838,T
3-PA,189,846,0,0,0,846,A
3-PA,190,0,1,863,0,864,G
3-PA,191,855,0,3,0,858,A
3-PA,192,853,0,0,0,853,A
3-PA,193,0,0,0,855,855,C
3-PA,194,0,843,0,0,843,T
3-PA,195,0,846,0,0,846,T
3-PA,196,0,2,844,0,846,G
3-PA,197,838,0,0,0,838,A
3-PA,198,0,1,0,840,841,C
3-PA,199,0,1,838,0,839,G
3-PA,200,851,0,0,0,851,A
3-PA,201,0,872,0,0,872,T
3-PA,202,1,0,0,879,880,C
3-PA,203,3,0,0,886,889,C
3-PA,204,894,0,1,0,895,A
3-PA,205,891,0,1,0,892,A
3-PA,206,899,0,0,0,899,A
3-PA,207,0,898,0,0,898,T
3-PA,208,1,1,899,0,901,G
3-PA,209,1,0,0,891,892,C
3-PA,210,882,0,0,0,882,A
3-PA,211,0,0,0,910,910,C
3-PA,212,0,905,0,0,905,T
3-PA,213,1,0,1055,0,1056,G
3-PA,214,0,1055,0,0,1055,T
3-PA,215,1,1055,0,0,1056,T
3-PA,216,1054,0,0,0,1054,A
3-PA,217,1057,0,1,0,1058,A
3-PA,218,1055,0,1,0,1056,A
3-PA,219,0,0,1059,0,1059,G
3-PA,220,0,0,0,1044,1044,C
3-PA,221,1032,0,1,0,1033,A
3-PA,222,0,0,0,1035,1035,C
3-PA,223,991,0,0,1,992,A
3-PA,224,0,0,1020,0,1020,G
3-PA,225,1017,0,0,0,1017,A
3-PA,226,0,1019,0,0,1019,T
3-PA,227,0,1021,0,2,1023,T
3-PA,228,0,1023,0,0,1023,T
3-PA,229,0,4,1024,0,1028,G
3-PA,230,1029,0,0,0,1029,A
3-PA,231,1031,0,0,0,1031,A
3-PA,232,1026,0,1,0,1027,A
3-PA,233,0,1021,0,0,1021,T
3-PA,234,1020,0,0,0,1020,A
3-PA,235,1015,0,0,0,1015,A
3-PA,236,0,1019,0,0,1019,T
3-PA,237,0,1012,0,2,1014,T
3-PA,238,0,0,1031,0,1031,G
3-PA,239,1023,0,0,0,1023,A
3-PA,240,1,1,1035,0,1037,G
3-PA,241,0,1,1049,0,1050,G
3-PA,242,0,0,1046,0,1046,G
3-PA,243,1,1,1043,0,1045,G
3-PA,244,1031,0,1,0,1032,A
3-PA,245,0,1,1049,0,1050,G
3-PA,246,1066,0,1,0,1067,A
3-PA,247,1,0,1057,0,1058,G
3-PA,248,1071,0,0,0,1071,A
3-PA,249,0,0,0,1071,1071,C
3-PA,250,1066,0,0,1,1067,A
3-PA,251,0,0,1076,0,1076,G
3-PA,252,1076,0,1,0,1077,A
3-PA,253,1093,0,1,0,1094,A
3-PA,254,0,1,0,1101,1102,C
3-PA,255,1072,0,0,0,1072,A
3-PA,256,1073,0,0,0,1073,A
3-PA,257,0,1071,0,0,1071,T
3-PA,258,0,0,1116,0,1116,G
3-PA,259,0,0,1118,0,1118,G
3-PA,260,0,0,0,1113,1113,C
3-PA,261,0,0,0,1120,1120,C
3-PA,262,0,1124,0,0,1124,T
3-PA,263,0,2,1143,0,1145,G
3-PA,264,0,2,1139,0,1141,G
3-PA,265,1148,0,0,1,1149,A
3-PA,266,0,0,0,1156,1156,C
3-PA,267,1128,0,0,0,1128,A
3-PA,268,0,0,1264,0,1264,G
3-PA,269,0,1263,0,0,1263,T
3-PA,270,1282,0,1,0,1283,A
3-PA,271,0,0,1281,0,1281,G
3-PA,272,0,1251,0,0,1251,T
3-PA,273,1264,0,0,0,1264,A
3-PA,274,1257,0,0,0,1257,A
3-PA,275,1260,0,0,0,1260,A
3-PA,276,0,0,0,1277,1277,C
3-PA,277,1194,0,0,0,1194,A
3-PA,278,0,1,1214,0,1215,G
3-PA,279,0,1204,0,0,1204,T
3-PA,280,1221,0,0,0,1221,A
3-PA,281,0,1219,0,0,1219,T
3-PA,282,0,1,0,1235,1236,C
3-PA,283,0,1227,0,1,1228,T
3-PA,284,0,0,1225,0,1225,G
3-PA,285,0,1,1,1223,1225,C
3-PA,286,1216,0,0,0,1216,A
3-PA,287,1216,0,0,1,1217,A
3-PA,288,0,0,0,1222,1222,C
3-PA,289,1212,0,0,0,1212,A
3-PA,290,0,0,0,1264,1264,C
3-PA,291,0,1247,0,0,1247,T
3-PA,292,1250,0,1,0,1251,A
3-PA,293,0,1,0,1255,1256,C
3-PA,294,0,1253,0,0,1253,T
3-PA,295,0,1,1253,0,1254,G
3-PA,296,1,1,1242,0,1244,G
3-PA,297,1230,0,0,0,1230,A
3-PA,298,2,0,1239,0,1241,G
3-PA,299,0,1,0,1195,1196,C
3-PA,300,0,1220,0,0,1220,T
3-PA,301,0,0,1203,0,1203,G
3-PA,302,1,0,1199,0,1200,G
3-PA,303,0,1,1207,0,1208,G
3-PA,304,1208,0,0,0,1208,A
3-PA,305,1212,0,0,0,1212,A
3-PA,306,1214,0,1,0,1215,A
3-PA,307,0,0,0,1211,1211,C
3-PA,308,1,2,0,1214,1217,C
3-PA,309,0,1,1216,0,1217,G
3-PA,310,1210,1,0,0,1211,A
3-PA,311,1217,0,0,0,1217,A
3-PA,312,0,0,1229,0,1229,G
3-PA,313,0,1210,0,1,1211,T
3-PA,314,0,1226,0,0,1226,T
3-PA,315,0,1220,0,0,1220,T
3-PA,316,2,0,0,1219,1221,C
3-PA,317,0,1229,0,0,1229,T
3-PA,318,1225,0,0,0,1225,A
3-PA,319,0,1,0,1223,1224,C
3-PA,320,0,0,0,1221,1221,C
3-PA,321,1216,0,0,0,1216,A
3-PA,322,0,2,1227,0,1229,G
3-PA,323,1236,0,0,0,1236,A
3-PA,324,0,1240,0,0,1240,T
3-PA,325,1,1240,0,0,1241,T
3-PA,326,0,1241,0,0,1241,T
3-PA,327,0,0,1247,0,1247,G
3-PA,328,0,1251,0,0,1251,T
3-PA,329,1251,0,2,0,1253,A
3-PA,330,1,1253,0,1,1255,T
3-PA,331,1,1,1237,0,1239,G
3-PA,332,1277,0,2,0,1279,A
3-PA,333,0,1276,0,0,1276,T
3-PA,334,0,1273,0,0,1273,T
3-PA,335,1280,0,0,0,1280,A
3-PA,336,0,0,0,1278,1278,C
3-PA,337,1280,0,1,0,1281,A
3-PA,338,1279,0,0,0,1279,A
3-PA,339,0,0,1286,0,1286,G
3-PA,340,0,0,1290,0,1290,G
3-PA,341,1245,0,1,0,1246,A
3-PA,342,0,1,1252,0,1253,G
3-PA,343,1254,0,0,0,1254,A
3-PA,344,1256,0,0,0,1256,A
3-PA,345,4,0,0,1253,1257,C
3-PA,346,1237,0,0,0,1237,A
3-PA,347,1,0,1243,0,1244,G
3-PA,348,1237,0,0,0,1237,A
3-PA,349,0,1233,0,1,1234,T
3-PA,350,0,1228,0,0,1228,T
3-PA,351,2,2,0,1209,1213,C
3-PA,352,1215,0,1,0,1216,A
3-PA,353,0,1205,0,0,1205,T
3-PA,354,0,0,0,1210,1210,C
3-PA,355,1,0,1219,0,1220,G
3-PA,356,1219,0,0,0,1219,A
3-PA,357,1222,0,0,0,1222,A
3-PA,358,1218,0,0,0,1218,A
3-PA,359,0,1222,0,0,1222,T
3-PA,360,0,1215,0,1,1216,T
3-PA,361,0,2,1220,0,1222,G
3-PA,362,0,2,1217,0,1219,G
3-PA,363,0,0,1211,0,1211,G
3-PA,364,0,1,1221,0,1222,G
3-PA,365,0,1210,0,0,1210,T
3-PA,366,0,1,1231,0,1232,G
3-PA,367,1229,0,1,1,1231,A
3-PA,368,0,0,0,1247,1247,C
3-PA,369,1253,0,0,0,1253,A
3-PA,370,1243,0,0,0,1243,A
3-PA,371,0,0,1266,0,1266,G
3-PA,372,0,1,1263,0,1264,G
3-PA,373,1263,0,1,0,1264,A
3-PA,374,0,1,1265,0,1266,G
3-PA,375,1244,0,2,0,1246,A
3-PA,376,0,1,1255,0,1256,G
3-PA,377,1239,0,1,0,1240,A
3-PA,378,1234,0,0,0,1234,A
3-PA,379,0,0,1280,0,1280,G
3-PA,380,0,1249,0,1,1250,T
3-PA,381,0,0,0,1259,1259,C
3-PA,382,1,1,0,1271,1273,C
3-PA,383,1275,1,1,0,1277,A
3-PA,384,1,0,0,1304,1305,C
3-PA,385,1326,0,0,0,1326,A
3-PA,386,0,1352,0,2,1354,T
3-PA,387,1374,0,1,0,1375,A
3-PA,388,1,1328,0,0,1329,T
3-PA,389,1318,0,0,0,1318,A
3-PA,390,0,1300,0,0,1300,T
3-PA,391,0,1291,0,0,1291,T
3-PA,392,1313,0,0,0,1313,A
3-PA,393,0,2,0,1318,1320,C
3-PA,394,1,0,0,1265,1266,C
3-PA,395,0,1245,1,2,1248,T
3-PA,396,0,1230,0,0,1230,T
3-PA,397,0,1,1241,0,1242,G
3-PA,398,1241,0,1,0,1242,A
3-PA,399,1241,0,0,0,1241,A
3-PA,400,1237,0,0,0,1237,A
3-PA,401,1195,0,1,0,1196,A
3-PA,402,0,1,1204,0,1205,G
3-PA,403,0,0,1196,0,1196,G
3-PA,404,0,0,0,1204,1204,C
3-PA,405,1,0,0,1205,1206,C
3-PA,406,1202,0,1,0,1203,A
3-PA,407,1202,0,0,0,1202,A
3-PA,408,0,1209,0,0,1209,T
3-PA,409,1206,0,0,0,1206,A
3-PA,410,1203,0,1,0,1204,A
3-PA,411,0,0,1220,0,1220,G
3-PA,412,1216,0,0,1,1217,A
3-PA,413,0,1213,0,0,1213,T
3-PA,414,0,1215,0,0,1215,T
3-PA,415,1216,0,0,0,1216,A
3-PA,416,1216,0,0,0,1216,A
3-PA,417,1216,0,0,0,1216,A
3-PA,418,0,1217,0,0,1217,T
3-PA,419,0,0,0,1226,1226,C
3-PA,420,1,1193,0,0,1194,T
3-PA,421,0,0,1211,0,1211,G
3-PA,422,1204,0,1,0,1205,A
3-PA,423,0,0,1221,0,1221,G
3-PA,424,1206,0,3,0,1209,A
3-PA,425,1215,0,0,0,1215,A
3-PA,426,0,0,0,1223,1223,C
3-PA,427,1213,0,2,0,1215,A
3-PA,428,0,0,0,1220,1220,C
3-PA,429,1222,0,0,0,1222,A
3-PA,430,0,0,0,1229,1229,C
3-PA,431,1216,0,0,1,1217,A
3-PA,432,0,0,0,1239,1239,C
3-PA,433,1223,0,0,0,1223,A
3-PA,434,0,1217,0,1,1218,T
3-PA,435,0,1214,1,0,1215,T
3-PA,436,0,1,0,1222,1223,C
3-PA,437,1204,1,0,0,1205,A
3-PA,438,1,0,0,1224,1225,C
3-PA,439,1205,0,0,0,1205,A
3-PA,440,0,1204,0,0,1204,T
3-PA,441,0,1176,0,1,1177,T
3-PA,442,0,1192,0,1,1193,T
3-PA,443,0,1193,0,1,1194,T
3-PA,444,1,0,0,1200,1201,C
3-PA,445,0,1197,0,3,1200,T
3-PA,446,0,0,0,1212,1212,C
3-PA,447,1208,0,0,1,1209,A
3-PA,448,0,1201,1,1,1203,T
3-PA,449,0,1205,1,2,1208,T
3-PA,450,2,0,0,1209,1211,C
3-PA,451,1200,0,0,0,1200,A
3-PA,452,0,0,0,1208,1208,C
3-PA,453,0,1197,0,0,1197,T
3-PA,454,0,1,1197,0,1198,G
3-PA,455,0,0,1189,0,1189,G
3-PA,456,1166,0,0,0,1166,A
3-PA,457,0,1,1201,0,1202,G
3-PA,458,1202,0,1,0,1203,A
3-PA,459,0,0,1218,0,1218,G
3-PA,460,1,0,1212,0,1213,G
3-PA,461,1206,0,0,0,1206,A
3-PA,462,1201,0,2,0,1203,A
3-PA,463,1182,0,0,0,1182,A
3-PA,464,0,1167,0,0,1167,T
3-PA,465,0,0,1177,0,1177,G
3-PA,466,1,0,1169,1,1171,G
3-PA,467,0,1,1,1161,1163,C
3-PA,468,0,0,0,1170,1170,C
3-PA,469,1165,0,1,0,1166,A
3-PA,470,0,1,0,1174,1175,C
3-PA,471,1181,0,0,0,1181,A
3-PA,472,1190,0,0,0,1190,A
3-PA,473,1187,0,2,0,1189,A
3-PA,474,0,1,1184,0,1185,G
3-PA,475,0,0,1181,0,1181,G
3-PA,476,0,0,0,1187,1187,C
3-PA,477,1180,0,1,0,1181,A
3-PA,478,0,0,1204,0,1204,G
3-PA,479,1202,0,4,0,1206,A
3-PA,480,2,0,0,1219,1221,C
3-PA,481,1,1206,0,1,1208,T
3-PA,482,1207,0,0,0,1207,A
3-PA,483,0,1,0,1199,1200,C
3-PA,484,1183,0,0,0,1183,A
3-PA,485,0,0,0,1203,1203,C
3-PA,486,0,1168,1,0,1169,T
3-PA,487,0,0,0,1181,1181,C
3-PA,488,0,1164,0,0,1164,T
3-PA,489,0,0,0,1158,1158,C
3-PA,490,0,1,1156,0,1157,G
3-PA,491,1148,1,0,0,1149,A
3-PA,492,0,0,0,1152,1152,C
3-PA,493,0,1,1167,0,1168,G
3-PA,494,1155,0,0,0,1155,A
3-PA,495,0,0,1163,0,1163,G
3-PA,496,0,1,1159,0,1160,G
3-PA,497,1160,0,0,0,1160,A
3-PA,498,1162,0,0,0,1162,A
3-PA,499,1162,0,1,0,1163,A
3-PA,500,0,0,1161,0,1161,G
3-PA,501,1,0,0,1158,1159,C
3-PA,502,1150,0,1,1,1152,A
3-PA,503,0,2,1176,0,1178,G
3-PA,504,1,1,1173,0,1175,G
3-PA,505,1,0,1176,0,1177,G
3-PA,506,0,1,0,1175,1176,C
3-PA,507,0,1178,0,0,1178,T
3-PA,508,1173,0,0,0,1173,A
3-PA,509,0,0,1188,0,1188,G
3-PA,510,0,0,1253,0,1253,G
3-PA,511,1252,0,0,0,1252,A
3-PA,512,0,1231,0,0,1231,T
3-PA,513,0,1206,0,1,1207,T
3-PA,514,1206,0,0,0,1206,A
3-PA,515,1212,0,1,0,1213,A
3-PA,516,1,2,1213,0,1216,G
3-PA,517,1203,0,1,0,1204,A
3-PA,518,0,0,0,1212,1212,C
3-PA,519,0,0,0,1136,1136,C
3-PA,520,1128,0,1,0,1129,A
3-PA,521,0,2,1130,0,1132,G
3-PA,522,0,0,1133,0,1133,G
3-PA,523,0,0,0,1133,1133,C
3-PA,524,0,1096,0,0,1096,T
3-PA,525,0,0,1121,0,1121,G
3-PA,526,0,1112,0,0,1112,T
3-PA,527,0,1113,0,1,1114,T
3-PA,528,0,1114,0,3,1117,T
3-PA,529,1109,0,0,0,1109,A
3-PA,530,1,0,0,1129,1130,C
3-PA,531,1,1,0,1122,1124,C
3-PA,532,1117,0,2,0,1119,A
3-PA,533,0,1117,0,0,1117,T
3-PA,534,1082,0,0,0,1082,A
3-PA,535,1082,0,0,0,1082,A
3-PA,536,0,1,1102,0,1103,G
3-PA,537,1090,0,0,0,1090,A
3-PA,538,0,0,0,1100,1100,C
3-PA,539,1063,0,1,0,1064,A
3-PA,540,1064,0,1,0,1065,A
3-PA,541,0,0,1071,0,1071,G
3-PA,542,1073,0,0,0,1073,A
3-PA,543,1074,0,0,1,1075,A
3-PA,544,1065,0,0,0,1065,A
3-PA,545,0,1034,0,0,1034,T
3-PA,546,0,0,1042,0,1042,G
3-PA,547,0,0,1039,0,1039,G
3-PA,548,0,3,0,1033,1036,C
3-PA,549,0,1,1,1035,1037,C
3-PA,550,1037,0,0,0,1037,A
3-PA,551,1059,0,0,0,1059,A
3-PA,552,0,0,0,1061,1061,C
3-PA,553,1057,0,0,0,1057,A
3-PA,554,0,0,1059,0,1059,G
3-PA,555,1030,0,3,0,1033,A
3-PA,556,0,0,1049,0,1049,G
3-PA,557,1,0,1060,0,1061,G
3-PA,558,0,0,0,1044,1044,C
3-PA,559,2,0,0,1052,1054,C
3-PA,560,0,1025,0,0,1025,T
3-PA,561,1016,0,1,0,1017,A
3-PA,562,0,1039,0,2,1041,T
3-PA,563,0,0,1040,0,1040,G
3-PA,564,0,3,1035,0,1038,G
3-PA,565,0,0,995,0,995,G
3-PA,566,946,0,0,0,946,A
3-PA,567,0,931,0,1,932,T
3-PA,568,0,891,0,0,891,T
3-PA,569,0,0,0,1033,1033,C
3-PA,570,0,0,0,1009,1009,C
3-PA,571,0,973,0,1,974,T
3-PA,572,0,979,0,2,981,T
3-PA,573,1,983,0,0,984,T
3-PA,574,0,0,0,1001,1001,C
3-PA,575,0,0,1012,0,1012,G
3-PA,576,1,996,0,4,1001,T
3-PA,577,0,0,0,1006,1006,C
3-PA,578,982,0,0,1,983,A
3-PA,579,0,0,1193,0,1193,G
3-PA,580,0,1198,0,0,1198,T
3-PA,581,0,0,0,1194,1194,C
3-PA,582,3,2,0,1200,1205,C
3-PA,583,3,1,1212,2,1218,G
3-PA,584,1206,0,0,7,1213,A
3-PA,585,1223,0,0,0,1223,A
3-PA,586,1216,0,4,0,1220,A
3-PA,587,0,2,1245,0,1247,G
3-PA,588,1204,0,2,0,1206,A
3-PA,589,1,1,1229,0,1231,G
3-PA,590,0,0,1242,0,1242,G
3-PA,591,2,0,0,1236,1238,C
3-PA,592,0,0,1252,0,1252,G
3-PA,593,1247,0,1,0,1248,A
3-PA,594,1253,0,3,0,1256,A
3-PA,595,0,1,1261,0,1262,G
3-PA,596,1275,0,0,0,1275,A
3-PA,597,1269,0,2,0,1271,A
3-PA,598,1270,0,1,0,1271,A
3-PA,599,0,0,0,1297,1297,C
3-PA,600,1288,0,0,0,1288,A
3-PA,601,1287,0,0,0,1287,A
3-PA,602,0,1287,0,1,1288,T
3-PA,603,0,1291,0,0,1291,T
3-PA,604,0,0,1298,0,1298,G
3-PA,605,1290,0,1,0,1291,A
3-PA,606,1290,0,1,0,1291,A
3-PA,607,0,1,1290,0,1291,G
3-PA,608,1286,0,0,0,1286,A
3-PA,609,1287,0,0,0,1287,A
3-PA,610,1292,0,2,0,1294,A
3-PA,611,1294,0,0,1,1295,A
3-PA,612,1298,0,0,0,1298,A
3-PA,613,0,1300,0,1,1301,T
3-PA,614,0,1311,0,0,1311,T
3-PA,615,1,1309,0,0,1310,T
3-PA,616,0,1,1298,0,1299,G
3-PA,617,1311,0,0,0,1311,A
3-PA,618,1320,0,1,0,1321,A
3-PA,619,1319,0,0,0,1319,A
3-PA,620,0,1338,0,0,1338,T
3-PA,621,0,0,0,1532,1532,C
3-PA,622,1519,0,0,0,1519,A
3-PA,623,0,0,0,1567,1567,C
3-PA,624,1559,0,3,0,1562,A
3-PA,625,0,3,1596,0,1599,G
3-PA,626,0,4,1676,0,1680,G
3-PA,627,1711,1,2,0,1714,A
3-PA,628,1754,0,2,0,1756,A
3-PA,629,0,0,0,1777,1777,C
3-PA,630,0,1743,0,0,1743,T
3-PA,631,1917,0,0,0,1917,A
3-PA,632,0,1964,0,0,1964,T
3-PA,633,1,1,2036,1,2039,G
3-PA,634,2,1,0,2030,2033,C
3-PA,635,1,0,2020,1,2022,G
3-PA,636,0,2005,0,0,2005,T
3-PA,637,2016,0,0,0,2016,A
3-PA,638,0,0,2018,0,2018,G
3-PA,639,0,0,1989,0,1989,G
3-PA,640,0,0,0,2001,2001,C
3-PA,641,0,1974,0,0,1974,T
3-PA,642,0,1961,1,1,1963,T
3-PA,643,0,1,1951,0,1952,G
3-PA,644,0,2,0,1959,1961,C
3-PA,645,1,1,0,1949,1951,C
3-PA,646,1,6,1982,0,1989,G
3-PA,647,1997,0,0,0,1997,A
3-PA,648,0,0,1,2001,2002,C
3-PA,649,4,0,0,2012,2016,C
3-PA,650,2028,0,1,0,2029,A
3-PA,651,2036,0,0,0,2036,A
3-PA,652,2022,0,3,0,2025,A
3-PA,653,0,0,2061,0,2061,G
3-PA,654,0,2055,0,1,2056,T
3-PA,655,2,0,0,2081,2083,C
3-PA,656,0,2073,0,2,2075,T
3-PA,657,0,0,0,2106,2106,C
3-PA,658,0,1,0,2114,2115,C
3-PA,659,6,0,0,2114,2120,C
3-PA,660,2114,0,0,0,2114,A
3-PA,661,0,0,0,2141,2141,C
3-PA,662,0,2,0,2126,2128,C
3-PA,663,0,2,2131,0,2133,G
3-PA,664,2150,0,0,0,2150,A
3-PA,665,2159,0,2,0,2161,A
3-PA,666,1,1,0,2182,2184,C
3-PA,667,2,2166,0,1,2169,T
3-PA,668,0,2193,0,2,2195,T
3-PA,669,3,0,1,2238,2242,C
3-PA,670,0,2216,1,3,2220,T
3-PA,671,1,0,0,2235,2236,C
3-PA,672,1,2,0,2229,2232,C
3-PA,673,0,2221,0,0,2221,T
3-PA,674,0,1,2237,0,2238,G
3-PA,675,0,0,0,2241,2241,C
3-PA,676,1,0,0,2253,2254,C
3-PA,677,1,2235,0,1,2237,T
3-PA,678,0,2237,0,0,2237,T
3-PA,679,0,2,2243,0,2245,G
3-PA,680,2233,0,3,0,2236,A
3-PA,681,0,1,2265,0,2266,G
3-PA,682,2255,0,0,0,2255,A
3-PA,683,2294,0,0,0,2294,A
3-PA,684,0,2342,0,0,2342,T
3-PA,685,0,2358,0,0,2358,T
3-PA,686,0,2358,0,0,2358,T
3-PA,687,0,2361,0,1,2362,T
3-PA,688,2360,0,1,0,2361,A
3-PA,689,1,3,2353,0,2357,G
3-PA,690,2347,0,0,0,2347,A
3-PA,691,0,0,2433,0,2433,G
3-PA,692,0,0,0,2430,2430,C
3-PA,693,1,0,0,2457,2458,C
3-PA,694,0,2521,0,0,2521,T
3-PA,695,2660,0,0,0,2660,A
3-PA,696,0,2672,0,0,2672,T
3-PA,697,0,0,2695,0,2695,G
3-PA,698,0,2669,0,0,2669,T
3-PA,699,1,3,2705,0,2709,G
3-PA,700,1,2,2671,0,2674,G
3-PA,701,2664,0,2,0,2666,A
3-PA,702,1,2629,0,1,2631,T
3-PA,703,1,1,2605,0,2607,G
3-PA,704,0,4,2680,1,2685,G
3-PA,705,2680,0,0,0,2680,A
3-PA,706,1,2683,0,0,2684,T
3-PA,707,0,2681,0,0,2681,T
3-PA,708,1,0,0,2664,2665,C
3-PA,709,0,0,2667,1,2668,G
3-PA,710,2679,0,1,0,2680,A
3-PA,711,2690,0,1,0,2691,A
3-PA,712,1,1,0,2693,2695,C
3-PA,713,0,1,0,2644,2645,C
3-PA,714,2,5,2644,0,2651,G
3-PA,715,2645,0,1,0,2646,A
3-PA,716,2648,0,2,0,2650,A
3-PA,717,0,1,0,2698,2699,C
3-PA,718,0,2,2675,0,2677,G
3-PA,719,2,0,2752,0,2754,G
3-PA,720,0,0,0,2766,2766,C
3-PA,721,0,2752,0,2,2754,T
3-PA,722,4,0,2855,0,2859,G
3-PA,723,0,0,0,2867,2867,C
3-PA,724,2892,0,0,0,2892,A
3-PA,725,0,2885,1,3,2889,T
3-PA,726,0,2865,0,1,2866,T
3-PA,727,0,1,2856,0,2857,G
3-PA,728,2779,1,3,0,2783,A
3-PA,729,1,4,2827,0,2832,G
3-PA,730,0,2,2832,0,2834,G
3-PA,731,0,0,2814,0,2814,G
3-PA,732,0,1,0,2814,2815,C
3-PA,733,2807,0,0,0,2807,A
3-PA,734,2802,0,4,0,2806,A
3-PA,735,1,0,2830,0,2831,G
3-PA,736,0,0,1,2835,2836,C
3-PA,737,0,2847,0,2,2849,T
3-PA,738,0,2864,0,0,2864,T
3-PA,739,0,2873,0,0,2873,T
3-PA,740,1,0,0,2863,2864,C
3-PA,741,0,2873,0,3,2876,T
3-PA,742,2,1,0,2897,2900,C
3-PA,743,2896,0,1,0,2897,A
3-PA,744,2882,0,2,0,2884,A
3-PA,745,2878,0,0,0,2878,A
3-PA,746,0,2868,0,0,2868,T
3-PA,747,0,0,2971,0,2971,G
3-PA,748,3,2940,0,3,2946,T
3-PA,749,4,0,0,2984,2988,C
3-PA,750,3,1,0,2998,3002,C
3-PA,751,3001,1,1,0,3003,A
3-PA,752,3012,0,1,0,3013,A
3-PA,753,3006,0,0,0,3006,A
3-PA,754,1,3,3041,0,3045,G
3-PA,755,3026,0,1,0,3027,A
3-PA,756,2976,0,2,0,2978,A
3-PA,757,0,0,3006,0,3006,G
3-PA,758,0,2975,0,1,2976,T
3-PA,759,3,5,2965,0,2973,G
3-PA,760,2960,0,1,0,2961,A
3-PA,761,2968,0,4,0,2972,A
3-PA,762,1,2966,0,2,2969,T
3-PA,763,1,0,2962,0,2963,G
3-PA,764,0,1,0,2974,2975,C
3-PA,765,1,0,0,2979,2980,C
3-PA,766,3,1,0,2986,2990,C
3-PA,767,3004,0,0,0,3004,A
3-PA,768,3047,0,0,1,3048,A
3-PA,769,3054,0,0,0,3054,A
3-PA,770,0,3057,0,0,3057,T
3-PA,771,0,3056,0,0,3056,T
3-PA,772,0,1,3050,0,3051,G
3-PA,773,3023,1,0,0,3024,A
3-PA,774,3011,0,1,0,3012,A
3-PA,775,1,0,0,3036,3037,C
3-PA,776,2,1,0,3028,3031,C
3-PA,777,0,2999,0,0,2999,T
3-PA,778,0,3078,0,1,3079,T
3-PA,779,0,3093,0,0,3093,T
3-PA,780,1,3143,0,3,3147,T
3-PA,781,0,0,0,3159,3159,C
3-PA,782,0,3153,0,3,3156,T
3-PA,783,0,0,3167,0,3167,G
3-PA,784,3156,0,0,0,3156,A
3-PA,785,3194,0,0,0,3194,A
3-PA,786,1,1,3206,0,3208,G
3-PA,787,3165,0,4,0,3169,A
3-PA,788,0,0,0,3176,3176,C
3-PA,789,3142,0,0,0,3142,A
3-PA,790,3157,0,3,0,3160,A
3-PA,791,0,0,0,3490,3490,C
3-PA,792,3473,0,2,0,3475,A
3-PA,793,0,1,0,3487,3488,C
3-PA,794,4,2,0,3456,3462,C
3-PA,795,3458,0,4,0,3462,A
3-PA,796,3450,1,4,0,3455,A
3-PA,797,1,3,3457,0,3461,G
3-PA,798,3449,0,3,0,3452,A
3-PA,799,1,0,2,3458,3461,C
3-PA,800,0,0,0,3267,3267,C
3-PA,801,3264,0,0,0,3264,A
3-PA,802,3256,1,1,0,3258,A
3-PA,803,0,3270,0,2,3272,T
3-PA,804,3,1,0,3264,3268,C
3-PA,805,3258,0,0,0,3258,A
3-PA,806,3247,0,0,0,3247,A
3-PA,807,3241,0,0,0,3241,A
3-PA,808,5,1,0,3278,3284,C
3-PA,809,0,3253,0,0,3253,T
3-PA,810,0,3261,0,1,3262,T
3-PA,811,4,0,0,3289,3293,C
3-PA,812,2,4,0,3280,3286,C
3-PA,813,3,3,3310,0,3316,G
3-PA,814,3314,0,1,0,3315,A
3-PA,815,3320,0,1,0,3321,A
3-PA,816,0,3319,0,0,3319,T
3-PA,817,1,2,3277,0,3280,G
3-PA,818,1,2,3278,0,3281,G
3-PA,819,3274,0,4,0,3278,A
3-PA,820,1,1,0,3304,3306,C
3-PA,821,2,1,1,3299,3303,C
3-PA,822,0,3391,0,4,3395,T
3-PA,823,3,0,0,3472,3475,C
3-PA,824,2,0,0,3485,3487,C
3-PA,825,0,3484,0,1,3485,T
3-PA,826,0,3494,0,1,3495,T
3-PA,827,1,0,3652,0,3653,G
3-PA,828,0,3620,0,3,3623,T
3-PA,829,0,3623,0,1,3624,T
3-PA,830,3607,0,11,0,3618,A
3-PA,831,0,3503,0,0,3503,T
3-PA,832,1,0,0,3486,3487,C
3-PA,833,3428,0,0,0,3428,A
3-PA,834,1,0,3411,0,3412,G
3-PA,835,1,1,0,3400,3402,C
3-PA,836,0,3,3306,0,3309,G
3-PA,837,0,1,3422,0,3423,G
3-PA,838,0,3386,0,2,3388,T
3-PA,839,6,1,0,3412,3419,C
3-PA,840,4,1,0,3425,3430,C
3-PA,841,3459,0,1,0,3460,A
3-PA,842,3476,0,1,0,3477,A
3-PA,843,3471,0,0,1,3472,A
3-PA,844,0,3461,0,0,3461,T
3-PA,845,1,3464,0,0,3465,T
3-PA,846,1,0,0,3443,3444,C
3-PA,847,2,1,0,3404,3407,C
3-PA,848,0,3410,0,1,3411,T
3-PA,849,2,1,0,3428,3431,C
3-PA,850,3,0,1,3441,3445,C
3-PA,851,0,3435,0,0,3435,T
3-PA,852,0,1,3465,1,3467,G
3-PA,853,3444,1,1,0,3446,A
3-PA,854,0,3454,0,0,3454,T
3-PA,855,1,1,3429,0,3431,G
3-PA,856,1,3,3387,0,3391,G
3-PA,857,3358,0,5,0,3363,A
3-PA,858,0,3348,0,1,3349,T
3-PA,859,0,2,3359,0,3361,G
3-PA,860,1,0,0,3563,3564,C
3-PA,861,0,3556,0,2,3558,T
3-PA,862,0,3571,0,2,3573,T
3-PA,863,0,3572,0,2,3574,T
3-PA,864,3576,0,0,1,3577,A
3-PA,865,3588,0,1,1,3590,A
3-PA,866,3597,0,0,0,3597,A
3-PA,867,3603,0,0,0,3603,A
3-PA,868,0,3601,0,0,3601,T
3-PA,869,0,3405,0,0,3405,T
3-PA,870,1,5,3390,0,3396,G
3-PA,871,3374,1,5,0,3380,A
3-PA,872,0,0,3386,0,3386,G
3-PA,873,0,0,0,3410,3410,C
3-PA,874,3409,0,1,0,3410,A
3-PA,875,1,3489,0,0,3490,T
3-PA,876,0,3498,0,1,3499,T
3-PA,877,2,1,3494,0,3497,G
3-PA,878,3493,0,1,0,3494,A
3-PA,879,3488,1,4,1,3494,A
3-PA,880,1,4,3484,0,3489,G
3-PA,881,3443,0,2,0,3445,A
3-PA,882,0,1,0,3474,3475,C
3-PA,883,1,0,0,3447,3448,C
3-PA,884,4,0,1,3446,3451,C
3-PA,885,3442,0,1,0,3443,A
3-PA,886,3449,0,1,0,3450,A
3-PA,887,0,1,3469,0,3470,G
3-PA,888,0,3449,0,2,3451,T
3-PA,889,10,0,0,3468,3478,C
3-PA,890,3453,0,1,0,3454,A
3-PA,891,1,1,0,3465,3467,C
3-PA,892,0,0,3465,0,3465,G
3-PA,893,3492,0,3,0,3495,A
3-PA,894,3513,1,2,0,3516,A
3-PA,895,0,1,3627,0,3628,G
3-PA,896,0,2,3611,0,3613,G
3-PA,897,3587,2,2,0,3591,A
3-PA,898,0,1,3626,0,3627,G
3-PA,899,3616,0,6,0,3622,A
3-PA,900,3607,1,5,2,3615,A
3-PA,901,0,7,3610,0,3617,G
3-PA,902,0,7,3572,0,3579,G
3-PA,903,0,3,3601,0,3604,G
3-PA,904,3489,1,1,0,3491,A
3-PA,905,0,3509,0,3,3512,T
3-PA,906,2,1,0,3543,3546,C
3-PA,907,2,0,1,3870,3873,C
3-PA,908,3,1,1,3934,3939,C
3-PA,909,4000,0,2,0,4002,A
3-PA,910,0,4027,0,1,4028,T
3-PA,911,0,4041,0,0,4041,T
3-PA,912,4151,0,0,0,4151,A
3-PA,913,0,4146,0,1,4147,T
3-PA,914,4141,0,2,0,4143,A
3-PA,915,0,4112,0,2,4114,T
3-PA,916,2,3,3740,0,3745,G
3-PA,917,3738,0,2,0,3740,A
3-PA,918,0,3698,0,0,3698,T
3-PA,919,1,0,3726,0,3727,G
3-PA,920,0,1,0,3687,3688,C
3-PA,921,0,2,3679,0,3681,G
3-PA,922,3708,0,2,0,3710,A
3-PA,923,0,3700,0,0,3700,T
3-PA,924,4,0,0,3702,3706,C
3-PA,925,3704,1,3,0,3708,A
3-PA,926,3694,0,2,0,3696,A
3-PA,927,1,1,3712,0,3714,G
3-PA,928,0,3659,0,0,3659,T
3-PA,929,0,1,3701,0,3702,G
3-PA,930,0,2,0,3704,3706,C
3-PA,931,3710,1,3,0,3714,A
3-PA,932,0,3724,0,0,3724,T
3-PA,933,3726,0,0,0,3726,A
3-PA,934,3776,0,0,0,3776,A
3-PA,935,3779,0,0,0,3779,A
3-PA,936,3749,0,3,0,3752,A
3-PA,937,3754,0,0,0,3754,A
3-PA,938,0,0,0,3766,3766,C
3-PA,939,3716,0,1,0,3717,A
3-PA,940,0,3718,0,0,3718,T
3-PA,941,0,3715,0,0,3715,T
3-PA,942,2,0,0,3731,3733,C
3-PA,943,0,3717,0,1,3718,T
3-PA,944,0,3707,0,0,3707,T
3-PA,945,0,3699,0,7,3706,T
3-PA,946,1,4,3713,0,3718,G
3-PA,947,0,0,3708,0,3708,G
3-PA,948,3686,0,5,0,3691,A
3-PA,949,2,3709,0,0,3711,T
3-PA,950,2,0,3743,0,3745,G
3-PA,951,0,1,3774,0,3775,G
3-PA,952,3773,0,4,0,3777,A
3-PA,953,3794,2,1,0,3797,A
3-PA,954,3801,0,5,0,3806,A
3-PA,955,1,3,3824,0,3828,G
3-PA,956,3821,0,2,1,3824,A
3-PA,957,4207,0,7,0,4214,A
3-PA,958,1,1,0,4305,4307,C
3-PA,959,3,0,0,4306,4309,C
3-PA,960,0,4277,0,2,4279,T
3-PA,961,0,4368,0,1,4369,T
3-PA,962,4392,0,0,0,4392,A
3-PA,963,1,4383,0,0,4384,T
3-PA,964,4359,0,9,0,4368,A
3-PA,965,0,4406,0,0,4406,T
3-PA,966,4099,0,2,0,4101,A
3-PA,967,2,2,4157,0,4161,G
3-PA,968,1,4096,0,2,4099,T
3-PA,969,3,2,0,4097,4102,C
3-PA,970,4061,0,0,0,4061,A
3-PA,971,4054,0,5,0,4059,A
3-PA,972,4051,0,4,1,4056,A
3-PA,973,0,1,0,4071,4072,C
3-PA,974,3,1,0,4019,4023,C
3-PA,975,3986,0,0,1,3987,A
3-PA,976,0,0,0,4040,4040,C
3-PA,977,4025,0,4,1,4030,A
3-PA,978,0,5,0,4044,4049,C
3-PA,979,0,2,4062,0,4064,G
3-PA,980,4003,1,0,0,4004,A
3-PA,981,4022,0,0,0,4022,A
3-PA,982,4017,1,1,0,4019,A
3-PA,983,4014,1,9,0,4024,A
3-PA,984,1,4,4048,0,4053,G
3-PA,985,1,3,4022,0,4026,G
3-PA,986,1,3,4073,0,4077,G
3-PA,987,4070,0,4,0,4074,A
3-PA,988,4085,0,2,0,4087,A
3-PA,989,0,4084,0,0,4084,T
3-PA,990,4091,0,0,0,4091,A
3-PA,991,4096,0,1,0,4097,A
3-PA,992,4109,1,1,0,4111,A
3-PA,993,0,4099,0,0,4099,T
3-PA,994,1,4089,0,0,4090,T
3-PA,995,3,0,0,4110,4113,C
3-PA,996,4118,1,1,1,4121,A
3-PA,997,4134,0,1,0,4135,A
3-PA,998,4126,0,0,0,4126,A
3-PA,999,1,4118,0,1,4120,T
3-PA,1000,0,4132,0,2,4134,T
3-PA,1001,4128,0,0,0,4128,A
3-PA,1002,0,0,0,4137,4137,C
3-PA,1003,3,0,0,4138,4141,C
3-PA,1004,0,4106,0,4,4110,T
3-PA,1005,1,0,4145,0,4146,G
3-PA,1006,0,1,0,4137,4138,C
3-PA,1007,0,4161,0,0,4161,T
3-PA,1008,4,1,4233,0,4238,G
3-PA,1009,0,4210,0,2,4212,T
3-PA,1010,4,0,0,4215,4219,C
3-PA,1011,4230,2,2,0,4234,A
3-PA,1012,1,4237,1,1,4240,T
3-PA,1013,3,3,4227,1,4234,G
3-PA,1014,1,2,4199,0,4202,G
3-PA,1015,4193,0,0,0,4193,A
3-PA,1016,4267,0,4,0,4271,A
3-PA,1017,1,0,4244,0,4245,G
3-PA,1018,0,1,0,4254,4255,C
3-PA,1019,4256,1,1,0,4258,A
3-PA,1020,4265,0,3,0,4268,A
3-PA,1021,1,2,4297,0,4300,G
3-PA,1022,0,4272,0,0,4272,T
3-PA,1023,4278,0,1,0,4279,A
3-PA,1024,0,1,0,4292,4293,C
3-PA,1025,0,4215,0,2,4217,T
3-PA,1026,0,0,4254,0,4254,G
3-PA,1027,1,4218,0,1,4220,T
3-PA,1028,3,1,1,4235,4240,C
3-PA,1029,4241,0,8,0,4249,A
3-PA,1030,1,4,4298,1,4304,G
3-PA,1031,4307,0,1,0,4308,A
3-PA,1032,4308,0,0,0,4308,A
3-PA,1033,0,4359,0,0,4359,T
3-PA,1034,0,4340,0,4,4344,T
3-PA,1035,1,0,4314,0,4315,G
3-PA,1036,0,0,1,4310,4311,C
3-PA,1037,4302,2,7,0,4311,A
3-PA,1038,1,5,4317,0,4323,G
3-PA,1039,2,2,4243,0,4247,G
3-PA,1040,4269,1,2,0,4272,A
3-PA,1041,1,1,0,4258,4260,C
3-PA,1042,5,2,4208,0,4215,G
3-PA,1043,0,4272,0,2,4274,T
3-PA,1044,0,4306,0,2,4308,T
3-PA,1045,1,1,4319,0,4321,G
3-PA,1046,4314,0,1,0,4315,A
3-PA,1047,4324,0,1,0,4325,A
3-PA,1048,4319,0,0,0,4319,A
3-PA,1049,4299,0,3,1,4303,A
3-PA,1050,0,4310,0,0,4310,T
3-PA,1051,1,0,4328,0,4329,G
3-PA,1052,4267,1,4,1,4273,A
3-PA,1053,0,3,4326,0,4329,G
3-PA,1054,1,7,4310,0,4318,G
3-PA,1055,4294,0,0,0,4294,A
3-PA,1056,0,1,4336,1,4338,G
3-PA,1057,4329,0,0,0,4329,A
3-PA,1058,4319,0,4,0,4323,A
3-PA,1059,2,1,4324,0,4327,G
3-PA,1060,4,1,4259,0,4264,G
3-PA,1061,0,4362,0,3,4365,T
3-PA,1062,1,4379,0,3,4383,T
3-PA,1063,5,2,0,4392,4399,C
3-PA,1064,4,1,0,4414,4419,C
3-PA,1065,4414,0,3,0,4417,A
3-PA,1066,4397,0,0,0,4397,A
3-PA,1067,0,1,4423,0,4424,G
3-PA,1068,0,4,4477,0,4481,G
3-PA,1069,4388,0,1,0,4389,A
3-PA,1070,0,0,0,4423,4423,C
3-PA,1071,0,4433,0,1,4434,T
3-PA,1072,4442,0,0,0,4442,A
3-PA,1073,4447,0,1,0,4448,A
3-PA,1074,4433,0,2,1,4436,A
3-PA,1075,4437,0,3,0,4440,A
3-PA,1076,4414,0,2,0,4416,A
3-PA,1077,0,2,0,4375,4377,C
3-PA,1078,4355,0,1,0,4356,A
3-PA,1079,0,4335,1,1,4337,T
3-PA,1080,15,2,4356,0,4373,G
3-PA,1081,4342,1,1,0,4344,A
3-PA,1082,4362,0,0,0,4362,A
3-PA,1083,3,1,4374,0,4378,G
3-PA,1084,4382,1,0,0,4383,A
3-PA,1085,4388,0,0,0,4388,A
3-PA,1086,4345,0,1,0,4346,A
3-PA,1087,4332,0,3,1,4336,A
3-PA,1088,1,0,0,4355,4356,C
3-PA,1089,0,4,4342,0,4346,G
3-PA,1090,4361,0,0,0,4361,A
3-PA,1091,0,1,4346,0,4347,G
3-PA,1092,0,4307,1,0,4308,T
3-PA,1093,6,0,0,4388,4394,C
3-PA,1094,4428,0,1,0,4429,A
3-PA,1095,4475,0,2,0,4477,A
3-PA,1096,1,2,0,4481,4484,C
3-PA,1097,1,4474,1,1,4477,T
3-PA,1098,4,1,4559,1,4565,G
3-PA,1099,4525,0,0,0,4525,A
3-PA,1100,4529,0,5,0,4534,A
3-PA,1101,1,2,4548,0,4551,G
3-PA,1102,0,4427,1,2,4430,T
3-PA,1103,0,2,4454,0,4456,G
3-PA,1104,0,3,4418,0,4421,G
3-PA,1105,1,1,4455,0,4457,G
3-PA,1106,0,0,0,4452,4452,C
3-PA,1107,2,4408,0,0,4410,T
3-PA,1108,2,0,0,4444,4446,C
3-PA,1109,0,4438,0,0,4438,T
3-PA,1110,0,4456,0,1,4457,T
3-PA,1111,1,2,4533,0,4536,G
3-PA,1112,0,0,4537,0,4537,G
3-PA,1113,0,4487,2,3,4492,T
3-PA,1114,4,3,4530,0,4537,G
3-PA,1115,4498,2,3,0,4503,A
3-PA,1116,4531,0,1,5,4537,A
3-PA,1117,4538,0,1,0,4539,A
3-PA,1118,4543,0,0,0,4543,A
3-PA,1119,0,1,0,4574,4575,C
3-PA,1120,4482,0,1,0,4483,A
3-PA,1121,0,4459,0,3,4462,T
3-PA,1122,0,2,4450,0,4452,G
3-PA,1123,1,0,4483,0,4484,G
3-PA,1124,1,1,1,4508,4511,C
3-PA,1125,4506,0,3,3,4512,A
3-PA,1126,0,4,1,4525,4530,C
3-PA,1127,1,1,1,4552,4555,C
3-PA,1128,4622,0,3,0,4625,A
3-PA,1129,1,2,4671,0,4674,G
3-PA,1130,4634,4,4,0,4642,A
3-PA,1131,4,1,4702,0,4707,G
3-PA,1132,4675,0,0,0,4675,A
3-PA,1133,4666,1,4,0,4671,A
3-PA,1134,0,5,4690,0,4695,G
3-PA,1135,5,0,4652,0,4657,G
3-PA,1136,1,4551,1,5,4558,T
3-PA,1137,4605,1,3,0,4609,A
3-PA,1138,0,4,4589,0,4593,G
3-PA,1139,4590,1,2,0,4593,A
3-PA,1140,1,0,0,4625,4626,C
3-PA,1141,1,4558,1,2,4562,T
3-PA,1142,0,4562,0,0,4562,T
3-PA,1143,1,4568,0,4,4573,T
3-PA,1144,0,1,4577,0,4578,G
3-PA,1145,4570,1,5,0,4576,A
3-PA,1146,4583,1,1,1,4586,A
3-PA,1147,4595,0,0,0,4595,A
3-PA,1148,4559,0,1,0,4560,A
3-PA,1149,0,2,0,4645,4647,C
3-PA,1150,0,4631,1,1,4633,T
3-PA,1151,1,0,4680,1,4682,G
3-PA,1152,0,3,0,4675,4678,C
3-PA,1153,4688,0,5,0,4693,A
3-PA,1154,0,2,4684,0,4686,G
3-PA,1155,4675,0,2,0,4677,A
3-PA,1156,2,2,4839,0,4843,G
3-PA,1157,4864,1,2,1,4868,A
3-PA,1158,1,0,0,4824,4825,C
3-PA,1159,4822,1,4,0,4827,A
3-PA,1160,0,4767,1,2,4770,T
3-PA,1161,4796,0,1,0,4797,A
3-PA,1162,4785,1,2,0,4788,A
3-PA,1163,0,0,4773,0,4773,G
3-PA,1164,0,1,0,4774,4775,C
3-PA,1165,1,1,4678,0,4680,G
3-PA,1166,4765,0,0,0,4765,A
3-PA,1167,1,4726,0,1,4728,T
3-PA,1168,0,4729,1,0,4730,T
3-PA,1169,0,4736,0,2,4738,T
3-PA,1170,3,3,4757,0,4763,G
3-PA,1171,4780,1,1,0,4782,A
3-PA,1172,4774,0,7,0,4781,A
3-PA,1173,0,2,4800,0,4802,G
3-PA,1174,2,0,0,4919,4921,C
3-PA,1175,4865,0,0,0,4865,A
3-PA,1176,5165,0,5,0,5170,A
3-PA,1177,0,5170,1,1,5172,T
3-PA,1178,5188,0,2,1,5191,A
3-PA,1179,1,5198,0,1,5200,T
3-PA,1180,1,6,5226,0,5233,G
3-PA,1181,5274,2,5,1,5282,A
3-PA,1182,0,5268,1,0,5269,T
3-PA,1183,5123,0,2,1,5126,A
3-PA,1184,1,0,5129,0,5130,G
3-PA,1185,1,4900,0,2,4903,T
3-PA,1186,1,3,4912,0,4916,G
3-PA,1187,4905,0,4,0,4909,A
3-PA,1188,0,1,0,4887,4888,C
3-PA,1189,0,6,4862,0,4868,G
3-PA,1190,4869,0,1,0,4870,A
3-PA,1191,4873,1,5,0,4879,A
3-PA,1192,1,1,0,4916,4918,C
3-PA,1193,1,0,0,4935,4936,C
3-PA,1194,1,4924,1,5,4931,T
3-PA,1195,2,1,5069,0,5072,G
3-PA,1196,5043,0,2,0,5045,A
3-PA,1197,5067,0,0,0,5067,A
3-PA,1198,1,5061,0,0,5062,T
3-PA,1199,0,5037,0,1,5038,T
3-PA,1200,5023,0,0,0,5023,A
3-PA,1201,4981,1,3,0,4985,A
3-PA,1202,1,6,4997,0,5004,G
3-PA,1203,9,0,4978,0,4987,G
3-PA,1204,1,4869,0,10,4880,T
3-PA,1205,4,0,0,4904,4908,C
3-PA,1206,4869,0,2,0,4871,A
3-PA,1207,0,8,1,5048,5057,C
3-PA,1208,1,5063,0,5,5069,T
3-PA,1209,2,5071,0,3,5076,T
3-PA,1210,0,5075,0,3,5078,T
3-PA,1211,2,0,0,5068,5070,C
3-PA,1212,5051,0,11,0,5062,A
3-PA,1213,5065,0,0,0,5065,A
3-PA,1214,0,0,5144,0,5144,G
3-PA,1215,0,2,0,5117,5119,C
3-PA,1216,1,5059,0,0,5060,T
3-PA,1217,13,7,5177,0,5197,G
3-PA,1218,1,0,5201,0,5202,G
3-PA,1219,5259,0,6,0,5265,A
3-PA,1220,0,5317,0,0,5317,T
3-PA,1221,5301,1,3,0,5305,A
3-PA,1222,0,3,0,5337,5340,C
3-PA,1223,5287,2,0,0,5289,A
3-PA,1224,3,1,5342,0,5346,G
3-PA,1225,5315,0,2,0,5317,A
3-PA,1226,5239,0,1,1,5241,A
3-PA,1227,1,5177,0,0,5178,T
3-PA,1228,2,5,5212,1,5220,G
3-PA,1229,5176,1,3,1,5181,A
3-PA,1230,0,0,5250,0,5250,G
3-PA,1231,0,5182,0,3,5185,T
3-PA,1232,0,5170,2,1,5173,T
3-PA,1233,3,2,0,5255,5260,C
3-PA,1234,5294,0,2,0,5296,A
3-PA,1235,5286,0,1,0,5287,A
3-PA,1236,0,0,0,5277,5277,C
3-PA,1237,5231,0,0,0,5231,A
3-PA,1238,5220,0,1,0,5221,A
3-PA,1239,0,2,5194,0,5196,G
3-PA,1240,0,0,5204,1,5205,G
3-PA,1241,0,0,0,5208,5208,C
3-PA,1242,3,0,0,5225,5228,C
3-PA,1243,0,5199,0,3,5202,T
3-PA,1244,0,0,5279,0,5279,G
3-PA,1245,0,5241,0,1,5242,T
3-PA,1246,1,2,5299,0,5302,G
3-PA,1247,5295,1,7,1,5304,A
3-PA,1248,0,1,5290,0,5291,G
3-PA,1249,2,0,0,5237,5239,C
3-PA,1250,0,5220,0,2,5222,T
3-PA,1251,5330,0,0,0,5330,A
3-PA,1252,5329,0,1,0,5330,A
3-PA,1253,0,0,0,5339,5339,C
3-PA,1254,1,5306,0,0,5307,T
3-PA,1255,2,2,5298,3,5305,G
3-PA,1256,5274,2,1,0,5277,A
3-PA,1257,0,5240,0,3,5243,T
3-PA,1258,0,5273,1,0,5274,T
3-PA,1259,3,2,1,5293,5299,C
3-PA,1260,5424,1,1,0,5426,A
3-PA,1261,0,1,5532,0,5533,G
3-PA,1262,0,5486,0,4,5490,T
3-PA,1263,5,0,0,5506,5511,C
3-PA,1264,0,5503,0,4,5507,T
3-PA,1265,0,2,5693,0,5695,G
3-PA,1266,0,3,5685,0,5688,G
3-PA,1267,5697,0,1,0,5698,A
3-PA,1268,0,5704,0,2,5706,T
3-PA,1269,5465,0,0,0,5465,A
3-PA,1270,0,3,5449,0,5452,G
3-PA,1271,5370,0,12,0,5382,A
3-PA,1272,0,2,5384,0,5386,G
3-PA,1273,3,3,0,5333,5339,C
3-PA,1274,1,5243,0,0,5244,T
3-PA,1275,5,1,0,5283,5289,C
3-PA,1276,3,6,5293,0,5302,G
3-PA,1277,5303,0,4,0,5307,A
3-PA,1278,1,5309,0,2,5312,T
3-PA,1279,0,2,5316,0,5318,G
3-PA,1280,5371,1,0,0,5372,A
3-PA,1281,5360,1,1,0,5362,A
3-PA,1282,5388,0,1,0,5389,A
3-PA,1283,0,5344,0,0,5344,T
3-PA,1284,0,5364,0,0,5364,T
3-PA,1285,2,2,5404,0,5408,G
3-PA,1286,4,5,5386,0,5395,G
3-PA,1287,5415,0,7,0,5422,A
3-PA,1288,0,2,5408,0,5410,G
3-PA,1289,5345,0,1,0,5346,A
3-PA,1290,0,4,5380,0,5384,G
3-PA,1291,0,7,5401,0,5408,G
3-PA,1292,5468,0,0,0,5468,A
3-PA,1293,1,1,0,5464,5466,C
3-PA,1294,1,1,5442,0,5444,G
3-PA,1295,0,5438,1,1,5440,T
3-PA,1296,5467,0,0,0,5467,A
3-PA,1297,0,1,5494,0,5495,G
3-PA,1298,0,1,0,5500,5501,C
3-PA,1299,1,2,1,5435,5439,C
3-PA,1300,7,2,2,5394,5405,C
3-PA,1301,8,1,0,5428,5437,C
3-PA,1302,5455,0,2,0,5457,A
3-PA,1303,5621,0,0,0,5621,A
3-PA,1304,0,5588,0,0,5588,T
3-PA,1305,0,5578,1,0,5579,T
3-PA,1306,3,5,5575,1,5584,G
3-PA,1307,5456,0,10,0,5466,A
3-PA,1308,2,1,5478,0,5481,G
3-PA,1309,2,4,0,5459,5465,C
3-PA,1310,5429,3,1,0,5433,A
3-PA,1311,0,1,0,5542,5543,C
3-PA,1312,5397,0,0,0,5397,A
3-PA,1313,0,5519,1,3,5523,T
3-PA,1314,0,5528,0,2,5530,T
3-PA,1315,0,0,5542,2,5544,G
3-PA,1316,0,0,0,5515,5515,C
3-PA,1317,5528,0,3,0,5531,A
3-PA,1318,5530,0,4,0,5534,A
3-PA,1319,0,0,5522,1,5523,G
3-PA,1320,0,0,0,5474,5474,C
3-PA,1321,5460,1,0,0,5461,A
3-PA,1322,0,5348,1,3,5352,T
3-PA,1323,1,7,5360,0,5368,G
3-PA,1324,5346,0,3,0,5349,A
3-PA,1325,3,3,5352,0,5358,G
3-PA,1326,5365,0,6,0,5371,A
3-PA,1327,5376,0,5,0,5381,A
3-PA,1328,0,6,5344,0,5350,G
3-PA,1329,0,2,5338,0,5340,G
3-PA,1330,5358,0,3,0,5361,A
3-PA,1331,5350,0,3,0,5353,A
3-PA,1332,0,5342,0,1,5343,T
3-PA,1333,0,5356,1,0,5357,T
3-PA,1334,5367,0,0,0,5367,A
3-PA,1335,0,5384,0,1,5385,T
3-PA,1336,0,5362,1,2,5365,T
3-PA,1337,0,5357,0,2,5359,T
3-PA,1338,3,1,1,5323,5328,C
3-PA,1339,5322,1,2,0,5325,A
3-PA,1340,0,0,0,5415,5415,C
3-PA,1341,5399,0,5,0,5404,A
3-PA,1342,0,0,5450,0,5450,G
3-PA,1343,2,1,0,5411,5414,C
3-PA,1344,5392,2,0,0,5394,A
3-PA,1345,0,2,5433,0,5435,G
3-PA,1346,5410,0,3,0,5413,A
3-PA,1347,0,1,5403,0,5404,G
3-PA,1348,0,0,5431,0,5431,G
3-PA,1349,0,5251,0,2,5253,T
3-PA,1350,3,0,5348,1,5352,G
3-PA,1351,0,5302,0,3,5305,T
3-PA,1352,9,4,0,5282,5295,C
3-PA,1353,5,2,0,5368,5375,C
3-PA,1354,5,0,0,5366,5371,C
3-PA,1355,5404,0,1,0,5405,A
3-PA,1356,0,5438,0,4,5442,T
3-PA,1357,1,5409,0,0,5410,T
3-PA,1358,0,0,5424,0,5424,G
3-PA,1359,1,5326,1,5,5333,T
3-PA,1360,5269,0,2,0,5271,A
3-PA,1361,0,2,5240,0,5242,G
3-PA,1362,5136,1,1,0,5138,A
3-PA,1363,1,1,5110,0,5112,G
3-PA,1364,0,0,0,5073,5073,C
3-PA,1365,3,0,0,4993,4996,C
3-PA,1366,5073,2,1,0,5076,A
3-PA,1367,2,0,0,5086,5088,C
3-PA,1368,1,5068,0,0,5069,T
3-PA,1369,1,6,5066,1,5074,G
3-PA,1370,5055,0,1,0,5056,A
3-PA,1371,4985,0,1,0,4986,A
3-PA,1372,0,5094,0,1,5095,T
3-PA,1373,5138,2,3,0,5143,A
3-PA,1374,0,3,0,5196,5199,C
3-PA,1375,5052,0,3,0,5055,A
3-PA,1376,0,5074,0,0,5074,T
3-PA,1377,5040,0,1,0,5041,A
3-PA,1378,5045,0,1,0,5046,A
3-PA,1379,0,5021,0,0,5021,T
3-PA,1380,2,3,4960,0,4965,G
3-PA,1381,4916,1,2,0,4919,A
3-PA,1382,4834,0,2,3,4839,A
3-PA,1383,0,4,4824,0,4828,G
3-PA,1384,0,9,4807,0,4816,G
3-PA,1385,0,5,4846,0,4851,G
3-PA,1386,4,0,4857,0,4861,G
3-PA,1387,0,3,4904,0,4907,G
3-PA,1388,1,4834,0,0,4835,T
3-PA,1389,4858,1,1,1,4861,A
3-PA,1390,0,4877,0,1,4878,T
3-PA,1391,4907,0,2,0,4909,A
3-PA,1392,0,1,0,5320,5321,C
3-PA,1393,5188,0,0,0,5188,A
3-PA,1394,0,5059,1,1,5061,T
3-PA,1395,0,5018,0,0,5018,T
3-PA,1396,4950,0,1,0,4951,A
3-PA,1397,5042,1,0,0,5043,A
3-PA,1398,2,0,0,5028,5030,C
3-PA,1399,4933,1,0,0,4934,A
3-PA,1400,0,2,0,4960,4962,C
3-PA,1401,0,4423,0,0,4423,T
3-PA,1402,6,1,4536,0,4543,G
3-PA,1403,0,1,0,4513,4514,C
3-PA,1404,9,1,0,4475,4485,C
3-PA,1405,4,0,0,4539,4543,C
3-PA,1406,1,4403,0,4,4408,T
3-PA,1407,3,2,4532,0,4537,G
3-PA,1408,0,0,0,4529,4529,C
3-PA,1409,0,4508,0,5,4513,T
3-PA,1410,5,0,0,4651,4656,C
3-PA,1411,4494,0,1,0,4495,A
3-PA,1412,4534,0,1,0,4535,A
3-PA,1413,0,4536,0,0,4536,T
3-PA,1414,0,0,4530,0,4530,G
3-PA,1415,1,2,0,4501,4504,C
3-PA,1416,4409,0,3,0,4412,A
3-PA,1417,0,4375,1,2,4378,T
3-PA,1418,2,1,0,4378,4381,C
3-PA,1419,2,1,0,4420,4423,C
3-PA,1420,0,4229,0,4,4233,T
3-PA,1421,0,0,4331,1,4332,G
3-PA,1422,0,4316,0,0,4316,T
3-PA,1423,1,0,4303,0,4304,G
3-PA,1424,0,2,0,4312,4314,C
3-PA,1425,4261,0,1,0,4262,A
3-PA,1426,0,0,4271,0,4271,G
3-PA,1427,0,1,0,4257,4258,C
3-PA,1428,4216,0,1,0,4217,A
3-PA,1429,4213,1,0,0,4214,A
3-PA,1430,0,4046,0,0,4046,T
3-PA,1431,0,0,4044,0,4044,G
3-PA,1432,0,1,4027,0,4028,G
3-PA,1433,4025,0,5,0,4030,A
3-PA,1434,0,4,0,4013,4017,C
3-PA,1435,0,5,3966,1,3972,G
3-PA,1436,4024,0,1,0,4025,A
3-PA,1437,1,4027,0,0,4028,T
3-PA,1438,0,4020,0,0,4020,T
3-PA,1439,0,4003,0,3,4006,T
3-PA,1440,0,3965,0,27,3992,T
3-PA,1441,2,1,0,4013,4016,C
3-PA,1442,4027,0,1,0,4028,A
3-PA,1443,4021,0,2,0,4023,A
3-PA,1444,0,0,0,4028,4028,C
3-PA,1445,0,3943,1,0,3944,T
3-PA,1446,3947,0,0,0,3947,A
3-PA,1447,3939,0,1,0,3940,A
3-PA,1448,0,3937,0,0,3937,T
3-PA,1449,0,3893,0,2,3895,T
3-PA,1450,3,0,0,3944,3947,C
3-PA,1451,3,0,0,3925,3928,C
3-PA,1452,4,7,0,3918,3929,C
3-PA,1453,3914,1,1,0,3916,A
3-PA,1454,0,3974,0,0,3974,T
3-PA,1455,0,4,3973,0,3977,G
3-PA,1456,3970,0,1,0,3971,A
3-PA,1457,0,3940,0,0,3940,T
3-PA,1458,3934,0,1,0,3935,A
3-PA,1459,3934,0,2,1,3937,A
3-PA,1460,0,0,3926,0,3926,G
3-PA,1461,1,1,0,3912,3914,C
3-PA,1462,3904,0,1,0,3905,A
3-PA,1463,3794,0,4,0,3798,A
3-PA,1464,0,0,3829,0,3829,G
3-PA,1465,0,3808,0,4,3812,T
3-PA,1466,1,1,3808,0,3810,G
3-PA,1467,0,5,0,3799,3804,C
3-PA,1468,3772,0,4,0,3776,A
3-PA,1469,0,2,3818,0,3820,G
3-PA,1470,3809,0,0,1,3810,A
3-PA,1471,3839,2,2,0,3843,A
3-PA,1472,1,1,0,3833,3835,C
3-PA,1473,0,3748,0,8,3756,T
3-PA,1474,3787,0,0,0,3787,A
3-PA,1475,3783,0,1,0,3784,A
3-PA,1476,3768,0,6,0,3774,A
3-PA,1477,0,1,3785,0,3786,G
3-PA,1478,3615,0,2,0,3617,A
3-PA,1479,0,1,3612,0,3613,G
3-PA,1480,0,2,3512,0,3514,G
3-PA,1481,0,1,3508,0,3509,G
3-PA,1482,3477,0,2,0,3479,A
3-PA,1483,3403,0,3,0,3406,A
3-PA,1484,1,2,3392,0,3395,G
3-PA,1485,2,1,3381,0,3384,G
3-PA,1486,1,1,0,3384,3386,C
3-PA,1487,0,1,3387,0,3388,G
3-PA,1488,3373,1,2,0,3376,A
3-PA,1489,3383,0,0,0,3383,A
3-PA,1490,3380,0,1,0,3381,A
3-PA,1491,3390,0,1,0,3391,A
3-PA,1492,3381,2,4,1,3388,A
3-PA,1493,0,0,0,3382,3382,C
3-PA,1494,1,2,0,3369,3372,C
3-PA,1495,3360,0,0,0,3360,A
3-PA,1496,3397,0,1,0,3398,A
3-PA,1497,0,3388,1,0,3389,T
3-PA,1498,0,3394,0,0,3394,T
3-PA,1499,0,3397,0,0,3397,T
3-PA,1500,3408,1,0,0,3409,A
3-PA,1501,0,3410,0,1,3411,T
3-PA,1502,3403,0,6,0,3409,A
3-PA,1503,0,3385,0,1,3386,T
3-PA,1504,0,1,3351,0,3352,G
3-PA,1505,0,2,3290,0,3292,G
3-PA,1506,3293,0,0,0,3293,A
3-PA,1507,0,3269,0,0,3269,T
3-PA,1508,0,3238,1,0,3239,T
3-PA,1509,4,0,0,3207,3211,C
3-PA,1510,3223,1,0,0,3224,A
3-PA,1511,0,3230,0,4,3234,T
3-PA,1512,4,1,0,3237,3242,C
3-PA,1513,3209,0,2,0,3211,A
3-PA,1514,0,3197,1,0,3198,T
3-PA,1515,3175,2,0,0,3177,A
3-PA,1516,3176,1,1,0,3178,A
3-PA,1517,3167,0,1,0,3168,A
3-PA,1518,0,2,3153,0,3155,G
3-PA,1519,0,1,3088,0,3089,G
3-PA,1520,1,3,3059,0,3063,G
3-PA,1521,3039,0,1,0,3040,A
3-PA,1522,2994,0,4,0,2998,A
3-PA,1523,1,2,2998,0,3001,G
3-PA,1524,2975,0,0,0,2975,A
3-PA,1525,0,2956,0,0,2956,T
3-PA,1526,1,2,0,2952,2955,C
3-PA,1527,0,2910,0,2,2912,T
3-PA,1528,2,0,0,2948,2950,C
3-PA,1529,2946,0,0,0,2946,A
3-PA,1530,1,2944,0,0,2945,T
3-PA,1531,0,2954,0,0,2954,T
3-PA,1532,0,2907,0,0,2907,T
3-PA,1533,2883,0,0,0,2883,A
3-PA,1534,2879,0,0,0,2879,A
3-PA,1535,0,2,2874,0,2876,G
3-PA,1536,0,1,2876,0,2877,G
3-PA,1537,2718,1,0,0,2719,A
3-PA,1538,2718,0,0,0,2718,A
3-PA,1539,1,2704,0,0,2705,T
3-PA,1540,0,4,2711,0,2715,G
3-PA,1541,2756,0,3,0,2759,A
3-PA,1542,0,1,0,2757,2758,C
3-PA,1543,2740,0,5,1,2746,A
3-PA,1544,0,0,0,2737,2737,C
3-PA,1545,2647,0,0,0,2647,A
3-PA,1546,0,0,2655,0,2655,G
3-PA,1547,2641,0,3,0,2644,A
3-PA,1548,0,2,0,2595,2597,C
3-PA,1549,1,0,2566,0,2567,G
3-PA,1550,0,2357,0,1,2358,T
3-PA,1551,0,1,2362,0,2363,G
3-PA,1552,1,1,2361,0,2363,G
3-PA,1553,0,2375,0,1,2376,T
3-PA,1554,2379,0,0,0,2379,A
3-PA,1555,2305,0,0,0,2305,A
3-PA,1556,2293,1,0,0,2294,A
3-PA,1557,0,2277,1,0,2278,T
3-PA,1558,0,2234,1,0,2235,T
3-PA,1559,0,2237,1,0,2238,T
3-PA,1560,1,2199,1,0,2201,T
3-PA,1561,0,1,2198,0,2199,G
3-PA,1562,0,2159,0,1,2160,T
3-PA,1563,0,5,2157,0,2162,G
3-PA,1564,2144,0,0,0,2144,A
3-PA,1565,0,0,2145,0,2145,G
3-PA,1566,3,0,0,2130,2133,C
3-PA,1567,2146,0,0,0,2146,A
3-PA,1568,0,2138,1,4,2143,T
3-PA,1569,0,0,2143,0,2143,G
3-PA,1570,0,2,2141,0,2143,G
3-PA,1571,2145,0,2,0,2147,A
3-PA,1572,1,0,2149,0,2150,G
3-PA,1573,0,2102,0,1,2103,T
3-PA,1574,0,2083,0,4,2087,T
3-PA,1575,0,2083,0,2,2085,T
3-PA,1576,0,2089,0,3,2092,T
3-PA,1577,1,2,0,2088,2091,C
3-PA,1578,0,2079,0,2,2081,T
3-PA,1579,2,0,0,2069,2071,C
3-PA,1580,0,2001,0,1,2002,T
3-PA,1581,1,0,0,1995,1996,C
3-PA,1582,1980,0,2,0,1982,A
3-PA,1583,1,0,0,1980,1981,C
3-PA,1584,0,1915,1,0,1916,T
3-PA,1585,1,5,1911,0,1917,G
3-PA,1586,1900,0,0,0,1900,A
3-PA,1587,1,0,0,1905,1906,C
3-PA,1588,2,1,0,1884,1887,C
3-PA,1589,5,1,0,1869,1875,C
3-PA,1590,1,0,1873,0,1874,G
3-PA,1591,1873,0,0,0,1873,A
3-PA,1592,0,2,1862,0,1864,G
3-PA,1593,1860,0,1,0,1861,A
3-PA,1594,1,0,0,1813,1814,C
3-PA,1595,0,1757,0,0,1757,T
3-PA,1596,0,1679,0,0,1679,T
3-PA,1597,0,1,1676,0,1677,G
3-PA,1598,1659,0,0,0,1659,A
3-PA,1599,0,1,1663,0,1664,G
3-PA,1600,2,0,0,1655,1657,C
3-PA,1601,5,0,1,1584,1590,C
3-PA,1602,1576,1,1,0,1578,A
3-PA,1603,1,0,0,1578,1579,C
3-PA,1604,1584,0,0,0,1584,A
3-PA,1605,0,1586,0,0,1586,T
3-PA,1606,1567,0,0,0,1567,A
3-PA,1607,1553,0,0,0,1553,A
3-PA,1608,1539,0,1,0,1540,A
3-PA,1609,0,1507,0,0,1507,T
3-PA,1610,4,3,1504,0,1511,G
3-PA,1611,0,0,1319,0,1319,G
3-PA,1612,0,0,1299,0,1299,G
3-PA,1613,1260,0,1,0,1261,A
3-PA,1614,0,2,1246,0,1248,G
3-PA,1615,1221,0,0,0,1221,A
3-PA,1616,1189,0,0,0,1189,A
3-PA,1617,1188,0,0,0,1188,A
3-PA,1618,0,1170,0,0,1170,T
3-PA,1619,1147,0,0,0,1147,A
3-PA,1620,1,0,1,1149,1151,C
3-PA,1621,0,601,0,0,601,T
3-PA,1622,0,0,598,0,598,G
3-PA,1623,0,344,0,0,344,T
3-PA,1624,0,0,346,0,346,G
3-PA,1625,0,323,0,0,323,T
3-PA,1626,1,0,0,192,193,C
3-PA,1627,0,0,0,178,178,C
3-PA,1628,0,162,0,0,162,T
3-PA,1629,0,161,0,0,161,T
3-PA,1630,0,0,161,0,161,G
3-PA,1631,160,0,0,0,160,A
3-PA,1632,0,0,164,0,164,G
3-PA,1633,160,0,0,0,160,A
3-PA,1634,0,159,0,0,159,T
3-PA,1635,156,0,1,0,157,A
3-PA,1636,0,0,161,0,161,G
3-PA,1637,0,0,162,0,162,G
3-PA,1638,162,0,0,0,162,A
3-PA,1639,0,0,163,0,163,G
3-PA,1640,164,0,0,0,164,A
3-PA,1641,0,164,0,0,164,T
3-PA,1642,166,0,0,0,166,A
3-PA,1643,0,168,0,0,168,T
3-PA,1644,0,0,166,0,166,G
3-PA,1645,0,165,0,0,165,T
3-PA,1646,1,162,0,0,163,T
3-PA,1647,167,0,0,0,167,A
3-PA,1648,0,0,0,167,167,C
3-PA,1649,0,166,0,0,166,T
3-PA,1650,164,0,0,0,164,A
3-PA,1651,163,0,0,0,163,A
3-PA,1652,0,0,163,0,163,G
3-PA,1653,161,0,0,0,161,A
3-PA,1654,159,0,0,0,159,A
3-PA,1655,0,0,157,0,157,G
3-PA,1656,0,155,0,0,155,T
3-PA,1657,0,0,162,0,162,G
3-PA,1658,0,0,0,159,159,C
3-PA,1659,0,0,0,159,159,C
3-PA,1660,159,0,0,0,159,A
3-PA,1661,0,159,0,0,159,T
3-PA,1662,161,0,0,0,161,A
3-PA,1663,0,0,160,0,160,G
3-PA,1664,0,0,154,0,154,G
3-PA,1665,0,0,0,158,158,C
3-PA,1666,0,0,0,157,157,C
3-PA,1667,155,0,1,0,156,A
3-PA,1668,158,0,0,0,158,A
3-PA,1669,156,0,0,0,156,A
3-PA,1670,0,158,0,0,158,T
3-PA,1671,0,157,0,0,157,T
3-PA,1672,0,155,0,0,155,T
3-PA,1673,0,0,0,157,157,C
3-PA,1674,152,0,0,0,152,A
3-PA,1675,151,0,0,0,151,A
3-PA,1676,0,0,151,0,151,G
3-PA,1677,0,0,148,0,148,G
3-PA,1678,0,0,0,150,150,C
3-PA,1679,0,1,0,149,150,C
3-PA,1680,153,0,0,0,153,A
3-PA,1681,161,0,0,0,161,A
3-PA,1682,0,159,0,0,159,T
3-PA,1683,0,0,174,0,174,G
3-PA,1684,0,174,0,0,174,T
3-PA,1685,0,183,0,0,183,T
3-PA,1686,0,0,0,186,186,C
3-PA,1687,0,185,0,0,185,T
3-PA,1688,0,184,0,0,184,T
3-PA,1689,177,0,0,0,177,A
3-PA,1690,0,177,0,0,177,T
3-PA,1691,177,0,0,0,177,A
3-PA,1692,0,178,0,0,178,T
3-PA,1693,0,0,178,0,178,G
3-PA,1694,0,168,0,0,168,T
3-PA,1695,1,0,167,0,168,G
3-PA,1696,165,0,0,0,165,A
3-PA,1697,0,0,166,0,166,G
3-PA,1698,0,0,166,0,166,G
3-PA,1699,162,0,0,0,162,A
3-PA,1700,0,0,0,166,166,C
3-PA,1701,166,0,0,0,166,A
3-PA,1702,166,0,0,0,166,A
3-PA,1703,166,0,0,0,166,A
3-PA,1704,0,0,0,167,167,C
3-PA,1705,0,1,165,0,166,G
3-PA,1706,0,0,171,0,171,G
3-PA,1707,166,0,1,0,167,A
3-PA,1708,168,0,0,0,168,A
3-PA,1709,0,0,0,169,169,C
3-PA,1710,168,0,0,0,168,A
3-PA,1711,0,165,0,0,165,T
3-PA,1712,0,0,0,166,166,C
3-PA,1713,164,0,0,0,164,A
3-PA,1714,167,0,0,0,167,A
3-PA,1715,162,0,0,0,162,A
3-PA,1716,0,0,163,0,163,G
3-PA,1717,0,0,165,0,165,G
3-PA,1718,0,163,0,0,163,T
3-PA,1719,1,0,0,164,165,C
3-PA,1720,165,0,0,0,165,A
3-PA,1721,166,0,0,0,166,A
3-PA,1722,167,0,0,0,167,A
3-PA,1723,166,0,0,0,166,A
3-PA,1724,0,167,0,0,167,T
3-PA,1725,0,0,167,0,167,G
3-PA,1726,165,0,0,0,165,A
3-PA,1727,166,0,0,0,166,A
3-PA,1728,165,0,0,0,165,A
3-PA,1729,0,165,0,0,165,T
3-PA,1730,0,0,167,0,167,G
3-PA,1731,0,0,165,0,165,G
3-PA,1732,0,0,165,0,165,G
3-PA,1733,0,0,169,0,169,G
3-PA,1734,163,0,0,0,163,A
3-PA,1735,167,0,0,0,167,A
3-PA,1736,0,168,0,0,168,T
3-PA,1737,0,0,168,0,168,G
3-PA,1738,0,0,168,0,168,G
3-PA,1739,167,0,0,0,167,A
3-PA,1740,0,0,168,0,168,G
3-PA,1741,169,0,0,0,169,A
3-PA,1742,0,162,0,0,162,T
3-PA,1743,1,0,166,0,167,G
3-PA,1744,165,0,0,0,165,A
3-PA,1745,0,0,170,0,170,G
3-PA,1746,168,0,0,0,168,A
3-PA,1747,0,0,0,164,164,C
3-PA,1748,0,0,163,0,163,G
3-PA,1749,0,164,0,0,164,T
3-PA,1750,0,162,0,0,162,T
3-PA,1751,0,0,164,0,164,G
3-PA,1752,0,0,0,164,164,C
3-PA,1753,0,0,0,163,163,C
3-PA,1754,0,164,0,0,164,T
3-PA,1755,0,0,0,164,164,C
3-PA,1756,0,0,0,163,163,C
3-PA,1757,0,164,0,0,164,T
3-PA,1758,0,165,0,0,165,T
3-PA,1759,0,0,0,166,166,C
3-PA,1760,164,0,0,0,164,A
3-PA,1761,0,0,166,0,166,G
3-PA,1762,0,166,0,1,167,T
3-PA,1763,0,0,0,169,169,C
3-PA,1764,164,0,0,0,164,A
3-PA,1765,0,0,0,168,168,C
3-PA,1766,0,168,0,0,168,T
3-PA,1767,0,0,0,170,170,C
3-PA,1768,0,0,0,169,169,C
3-PA,1769,170,0,0,0,170,A
3-PA,1770,0,0,170,0,170,G
3-PA,1771,0,0,0,168,168,C
3-PA,1772,167,0,0,0,167,A
3-PA,1773,0,0,170,0,170,G
3-PA,1774,164,0,1,0,165,A
3-PA,1775,0,164,0,0,164,T
3-PA,1776,0,0,0,167,167,C
3-PA,1777,0,0,166,0,166,G
3-PA,1778,166,0,0,0,166,A
3-PA,1779,0,0,166,0,166,G
3-PA,1780,167,0,0,0,167,A
3-PA,1781,0,0,166,0,166,G
3-PA,1782,1,0,0,163,164,C
3-PA,1783,164,0,0,0,164,A
3-PA,1784,0,163,0,0,163,T
3-PA,1785,0,0,167,0,167,G
3-PA,1786,169,0,0,0,169,A
3-PA,1787,0,169,0,0,169,T
3-PA,1788,0,168,0,0,168,T
3-PA,1789,0,0,168,0,168,G
3-PA,1790,168,0,0,0,168,A
3-PA,1791,167,0,0,0,167,A
3-PA,1792,0,0,165,0,165,G
3-PA,1793,0,0,0,168,168,C
3-PA,1794,2,0,0,160,162,C
3-PA,1795,0,0,159,0,159,G
3-PA,1796,160,0,0,0,160,A
3-PA,1797,0,0,162,0,162,G
3-PA,1798,0,161,0,0,161,T
3-PA,1799,0,0,0,160,160,C
3-PA,1800,0,0,0,157,157,C
3-PA,1801,0,157,0,0,157,T
3-PA,1802,0,0,0,159,159,C
3-PA,1803,0,0,162,0,162,G
3-PA,1804,0,0,166,0,166,G
3-PA,1805,0,163,0,0,163,T
3-PA,1806,0,165,0,0,165,T
3-PA,1807,165,0,0,0,165,A
3-PA,1808,165,0,0,0,165,A
3-PA,1809,163,0,0,0,163,A
3-PA,1810,0,0,167,0,167,G
3-PA,1811,168,0,0,0,168,A
3-PA,1812,0,0,168,0,168,G
3-PA,1813,160,0,0,0,160,A
3-PA,1814,163,0,0,0,163,A
3-PA,1815,162,0,0,0,162,A
3-PA,1816,0,0,161,0,161,G
3-PA,1817,164,0,0,0,164,A
3-PA,1818,0,0,0,164,164,C
3-PA,1819,160,0,0,0,160,A
3-PA,1820,0,161,0,0,161,T
3-PA,1821,0,0,160,0,160,G
3-PA,1822,156,0,0,0,156,A
3-PA,1823,0,0,0,161,161,C
3-PA,1824,0,0,0,159,159,C
3-PA,1825,159,0,0,0,159,A
3-PA,1826,159,0,0,0,159,A
3-PA,1827,159,0,0,0,159,A
3-PA,1828,0,0,163,0,163,G
3-PA,1829,157,0,0,0,157,A
3-PA,1830,0,0,160,0,160,G
3-PA,1831,0,156,0,1,157,T
3-PA,1832,0,157,0,0,157,T
3-PA,1833,0,156,0,0,156,T
3-PA,1834,0,156,0,0,156,T
3-PA,1835,0,157,0,0,157,T
3-PA,1836,0,157,0,0,157,T
3-PA,1837,0,0,156,0,156,G
3-PA,1838,156,0,0,0,156,A
3-PA,1839,0,0,158,0,158,G
3-PA,1840,159,0,0,0,159,A
3-PA,1841,157,0,0,0,157,A
3-PA,1842,0,158,0,0,158,T
3-PA,1843,157,1,0,0,158,A
3-PA,1844,163,0,0,0,163,A
3-PA,1845,164,0,0,0,164,A
3-PA,1846,0,165,0,0,165,T
3-PA,1847,0,0,0,163,163,C
3-PA,1848,162,0,1,0,163,A
3-PA,1849,0,0,161,0,161,G
3-PA,1850,163,0,0,0,163,A
3-PA,1851,164,0,0,0,164,A
3-PA,1852,0,0,164,0,164,G
3-PA,1853,1,0,0,160,161,C
3-PA,1854,162,0,0,0,162,A
3-PA,1855,0,161,0,0,161,T
3-PA,1856,0,0,161,0,161,G
3-PA,1857,0,0,165,0,165,G
3-PA,1858,0,0,0,164,164,C
3-PA,1859,0,0,0,167,167,C
3-PA,1860,0,0,0,169,169,C
3-PA,1861,169,0,0,1,170,A
3-PA,1862,0,172,0,0,172,T
3-PA,1863,0,171,0,0,171,T
3-PA,1864,0,0,174,0,174,G
3-PA,1865,0,1,173,0,174,G
3-PA,1866,0,0,173,0,173,G
3-PA,1867,0,0,173,0,173,G
3-PA,1868,166,0,1,0,167,A
3-PA,1869,0,0,172,0,172,G
3-PA,1870,0,167,0,0,167,T
3-PA,1871,0,0,0,169,169,C
3-PA,1872,0,0,0,178,178,C
3-PA,1873,0,0,0,177,177,C
3-PA,1874,0,0,0,178,178,C
3-PA,1875,0,0,0,176,176,C
3-PA,1876,179,0,0,0,179,A
3-PA,1877,179,0,0,0,179,A
3-PA,1878,0,0,180,0,180,G
3-PA,1879,0,0,177,0,177,G
3-PA,1880,0,0,178,0,178,G
3-PA,1881,157,0,0,0,157,A
3-PA,1882,0,0,158,0,158,G
3-PA,1883,0,158,0,0,158,T
3-PA,1884,0,0,159,0,159,G
3-PA,1885,0,0,159,0,159,G
3-PA,1886,160,0,0,0,160,A
3-PA,1887,157,0,0,0,157,A
3-PA,1888,0,0,158,0,158,G
3-PA,1889,157,0,0,0,157,A
3-PA,1890,156,0,0,0,156,A
3-PA,1891,0,0,154,0,154,G
3-PA,1892,0,0,154,0,154,G
3-PA,1893,0,153,0,0,153,T
3-PA,1894,0,153,0,0,153,T
3-PA,1895,0,0,0,154,154,C
3-PA,1896,0,0,0,153,153,C
3-PA,1897,154,0,0,0,154,A
3-PA,1898,0,154,0,0,154,T
3-PA,1899,0,155,0,0,155,T
3-PA,1900,0,1,154,0,155,G
3-PA,1901,0,0,153,0,153,G
3-PA,1902,0,0,155,0,155,G
3-PA,1903,153,0,0,0,153,A
3-PA,1904,153,0,0,0,153,A
3-PA,1905,152,0,0,0,152,A
3-PA,1906,0,0,157,0,157,G
3-PA,1907,0,157,0,0,157,T
3-PA,1908,0,0,0,159,159,C
3-PA,1909,0,158,0,0,158,T
3-PA,1910,0,0,161,0,161,G
3-PA,1911,0,158,0,0,158,T
3-PA,1912,160,0,0,0,160,A
3-PA,1913,0,0,159,0,159,G
3-PA,1914,0,0,160,0,160,G
3-PA,1915,151,0,0,0,151,A
3-PA,1916,0,0,0,155,155,C
3-PA,1917,0,152,0,0,152,T
3-PA,1918,0,0,0,153,153,C
3-PA,1919,0,154,0,0,154,T
3-PA,1920,154,0,0,0,154,A
3-PA,1921,0,153,0,0,153,T
3-PA,1922,0,154,0,0,154,T
3-PA,1923,0,0,157,0,157,G
3-PA,1924,0,0,154,0,154,G
3-PA,1925,0,0,0,154,154,C
3-PA,1926,0,154,0,0,154,T
3-PA,1927,144,0,0,0,144,A
3-PA,1928,145,0,0,0,145,A
3-PA,1929,0,0,146,0,146,G
3-PA,1930,0,146,0,0,146,T
3-PA,1931,0,0,0,146,146,C
3-PA,1932,141,0,0,0,141,A
3-PA,1933,0,0,144,0,144,G
3-PA,1934,0,144,0,0,144,T
3-PA,1935,149,0,0,0,149,A
3-PA,1936,0,147,0,0,147,T
3-PA,1937,0,148,0,0,148,T
3-PA,1938,0,0,0,147,147,C
3-PA,1939,147,0,0,0,147,A
3-PA,1940,145,0,1,0,146,A
3-PA,1941,0,147,0,0,147,T
3-PA,1942,145,0,0,0,145,A
3-PA,1943,0,0,146,0,146,G
3-PA,1944,0,0,0,144,144,C
3-PA,1945,0,0,0,143,143,C
3-PA,1946,0,140,0,0,140,T
3-PA,1947,0,0,150,0,150,G
3-PA,1948,0,149,0,0,149,T
3-PA,1949,150,0,0,0,150,A
3-PA,1950,0,150,0,0,150,T
3-PA,1951,0,0,147,0,147,G
3-PA,1952,0,0,0,148,148,C
3-PA,1953,142,0,0,0,142,A
3-PA,1954,0,142,0,0,142,T
3-PA,1955,0,0,0,141,141,C
3-PA,1956,142,0,0,0,142,A
3-PA,1957,0,0,0,143,143,C
3-PA,1958,0,0,0,142,142,C
3-PA,1959,140,0,0,0,140,A
3-PA,1960,0,0,0,142,142,C
3-PA,1961,142,0,0,0,142,A
3-PA,1962,140,0,0,0,140,A
3-PA,1963,0,142,0,0,142,T
3-PA,1964,0,142,0,0,142,T
3-PA,1965,0,0,142,0,142,G
3-PA,1966,0,0,141,0,141,G
3-PA,1967,141,0,0,0,141,A
3-PA,1968,141,0,0,0,141,A
3-PA,1969,0,0,142,0,142,G
3-PA,1970,0,0,142,0,142,G
3-PA,1971,141,0,1,0,142,A
3-PA,1972,0,141,0,2,143,T
3-PA,1973,0,145,0,0,145,T
3-PA,1974,0,143,0,0,143,T
3-PA,1975,0,143,0,0,143,T
3-PA,1976,0,0,0,144,144,C
3-PA,1977,145,0,0,0,145,A
3-PA,1978,0,0,143,0,143,G
3-PA,1979,0,0,0,144,144,C
3-PA,1980,0,0,144,0,144,G
3-PA,1981,0,0,143,0,143,G
3-PA,1982,144,0,0,0,144,A
3-PA,1983,0,0,145,0,145,G
3-PA,1984,0,144,0,0,144,T
3-PA,1985,0,0,0,143,143,C
3-PA,1986,143,0,0,0,143,A
3-PA,1987,143,0,0,0,143,A
3-PA,1988,0,1,142,0,143,G
3-PA,1989,144,0,0,0,144,A
3-PA,1990,143,0,0,0,143,A
3-PA,1991,140,0,0,0,140,A
3-PA,1992,140,0,0,0,140,A
3-PA,1993,0,0,0,142,142,C
3-PA,1994,0,141,0,0,141,T
3-PA,1995,0,0,140,0,140,G
3-PA,1996,1,0,0,136,137,C
3-PA,1997,0,138,0,0,138,T
3-PA,1998,0,0,0,139,139,C
3-PA,1999,0,0,0,137,137,C
3-PA,2000,0,138,0,0,138,T
3-PA,2001,0,138,0,0,138,T
3-PA,2002,0,0,138,0,138,G
3-PA,2003,0,138,0,0,138,T
3-PA,2004,0,137,0,0,137,T
3-PA,2005,0,0,138,0,138,G
3-PA,2006,0,137,0,0,137,T
3-PA,2007,0,138,0,0,138,T
3-PA,2008,0,0,0,137,137,C
3-PA,2009,131,0,0,0,131,A
3-PA,2010,0,0,136,0,136,G
3-PA,2011,0,0,134,0,134,G
3-PA,2012,0,0,0,133,133,C
3-PA,2013,0,134,0,0,134,T
3-PA,2014,0,0,0,139,139,C
3-PA,2015,0,140,0,0,140,T
3-PA,2016,0,140,0,0,140,T
3-PA,2017,141,0,0,0,141,A
3-PA,2018,0,0,141,0,141,G
3-PA,2019,0,0,139,0,139,G
3-PA,2020,0,1,138,0,139,G
3-PA,2021,134,0,0,0,134,A
3-PA,2022,0,0,0,133,133,C
3-PA,2023,127,0,0,0,127,A
3-PA,2024,128,0,0,0,128,A
3-PA,2025,0,0,0,126,126,C
3-PA,2026,0,0,0,128,128,C
3-PA,2027,0,128,0,0,128,T
3-PA,2028,0,0,0,127,127,C
3-PA,2029,0,0,128,0,128,G
3-PA,2030,127,0,0,0,127,A
3-PA,2031,125,0,0,0,125,A
3-PA,2032,0,0,0,127,127,C
3-PA,2033,0,0,0,121,121,C
3-PA,2034,0,121,0,0,121,T
3-PA,2035,0,0,120,0,120,G
3-PA,2036,0,0,120,0,120,G
3-PA,2037,0,0,119,0,119,G
3-PA,2038,119,0,0,0,119,A
3-PA,2039,0,0,0,117,117,C
3-PA,2040,0,0,0,117,117,C
3-PA,2041,0,115,0,1,116,T
3-PA,2042,0,116,0,0,116,T
3-PA,2043,0,117,0,0,117,T
3-PA,2044,0,0,117,0,117,G
3-PA,2045,116,0,0,0,116,A
3-PA,2046,0,116,0,0,116,T
3-PA,2047,0,0,0,116,116,C
3-PA,2048,0,114,0,0,114,T
3-PA,2049,0,113,0,0,113,T
3-PA,2050,0,0,111,0,111,G
3-PA,2051,0,1,110,0,111,G
3-PA,2052,0,1,109,0,110,G
3-PA,2053,1,1,109,0,111,G
3-PA,2054,0,0,109,0,109,G
3-PA,2055,0,0,111,0,111,G
3-PA,2056,0,0,0,110,110,C
3-PA,2057,0,110,0,0,110,T
3-PA,2058,112,0,0,0,112,A
3-PA,2059,0,114,0,0,114,T
3-PA,2060,112,0,0,0,112,A
3-PA,2061,0,112,0,0,112,T
3-PA,2062,0,0,108,0,108,G
3-PA,2063,107,0,0,0,107,A
3-PA,2064,105,0,0,0,105,A
3-PA,2065,0,0,101,0,101,G
3-PA,2066,0,0,0,106,106,C
3-PA,2067,94,0,0,0,94,A
3-PA,2068,99,0,0,0,99,A
3-PA,2069,0,99,0,0,99,T
3-PA,2070,0,99,0,0,99,T
3-PA,2071,0,0,98,0,98,G
3-PA,2072,99,0,0,0,99,A
3-PA,2073,0,0,99,0,99,G
3-PA,2074,0,0,99,0,99,G
3-PA,2075,93,0,0,0,93,A
3-PA,2076,0,0,94,0,94,G
3-PA,2077,0,84,0,0,84,T
3-PA,2078,0,0,83,0,83,G
3-PA,2079,0,0,0,83,83,C
3-PA,2080,0,0,0,84,84,C
3-PA,2081,0,84,0,0,84,T
3-PA,2082,0,0,84,0,84,G
3-PA,2083,84,0,0,0,84,A
3-PA,2084,0,82,0,0,82,T
3-PA,2085,0,81,0,0,81,T
3-PA,2086,80,0,0,0,80,A
3-PA,2087,79,0,1,0,80,A
3-PA,2088,0,78,0,0,78,T
3-PA,2089,0,0,78,0,78,G
3-PA,2090,79,0,0,0,79,A
3-PA,2091,0,75,0,1,76,T
3-PA,2092,0,0,0,77,77,C
3-PA,2093,0,0,0,76,76,C
3-PA,2094,1,0,0,76,77,C
3-PA,2095,0,77,0,0,77,T
3-PA,2096,0,0,77,0,77,G
3-PA,2097,0,0,77,0,77,G
3-PA,2098,0,0,76,0,76,G
3-PA,2099,0,77,0,0,77,T
3-PA,2100,0,75,0,1,76,T
3-PA,2101,0,76,0,0,76,T
3-PA,2102,0,76,0,0,76,T
3-PA,2103,0,0,75,0,75,G
3-PA,2104,0,0,0,77,77,C
3-PA,2105,0,75,0,0,75,T
3-PA,2106,0,0,0,75,75,C
3-PA,2107,73,0,0,0,73,A
3-PA,2108,72,0,0,0,72,A
3-PA,2109,0,73,0,0,73,T
3-PA,2110,0,0,73,0,73,G
3-PA,2111,0,0,0,70,70,C
3-PA,2112,0,0,66,0,66,G
3-PA,2113,0,66,0,0,66,T
3-PA,2114,0,0,0,66,66,C
3-PA,2115,0,66,0,0,66,T
3-PA,2116,0,66,0,0,66,T
3-PA,2117,0,0,65,0,65,G
3-PA,2118,0,0,66,0,66,G
3-PA,2119,0,66,0,0,66,T
3-PA,2120,0,66,0,0,66,T
3-PA,2121,0,0,0,64,64,C
3-PA,2122,62,0,0,0,62,A
3-PA,2123,61,0,0,0,61,A
3-PA,2124,0,0,0,63,63,C
3-PA,2125,0,62,0,0,62,T
3-PA,2126,0,0,0,59,59,C
3-PA,2127,0,0,0,56,56,C
3-PA,2128,0,55,0,0,55,T
3-PA,2129,0,55,0,0,55,T
3-PA,2130,0,0,0,54,54,C
3-PA,2131,0,0,0,54,54,C
3-PA,2132,0,53,0,0,53,T
3-PA,2133,0,0,52,0,52,G
3-PA,2134,52,0,0,0,52,A
3-PA,2135,0,0,0,51,51,C
3-PA,2136,46,0,0,0,46,A
3-PA,2137,0,0,0,45,45,C
3-PA,2138,45,0,0,0,45,A
3-PA,2139,0,45,0,0,45,T
3-PA,2140,0,0,45,0,45,G
3-PA,2141,0,0,0,43,43,C
3-PA,2142,42,0,0,0,42,A
3-PA,2143,0,42,0,0,42,T
3-PA,2144,0,42,0,0,42,T
3-PA,2145,42,0,0,0,42,A
3-PA,2146,42,0,0,0,42,A
3-PA,2147,42,0,0,0,42,A
3-PA,2148,42,0,0,0,42,A
3-PA,2149,0,42,0,0,42,T
3-PA,2150,28,0,0,0,28,A
3-PA,2151,0,0,28,0,28,G
4-HA,1,228,0,0,0,228,A
4-HA,2,0,228,0,0,228,T
4-HA,3,0,0,232,0,232,G
4-HA,4,231,0,0,0,231,A
4-HA,5,237,0,0,0,237,A
4-HA,6,0,0,263,0,263,G
4-HA,7,262,0,0,0,262,A
4-HA,8,0,0,0,279,279,C
4-HA,9,0,283,0,0,283,T
4-HA,10,289,0,2,0,291,A
4-HA,11,0,306,0,1,307,T
4-HA,12,0,0,0,310,310,C
4-HA,13,310,0,1,0,311,A
4-HA,14,0,310,0,1,311,T
4-HA,15,0,312,0,0,312,T
4-HA,16,0,0,349,0,349,G
4-HA,17,0,0,0,351,351,C
4-HA,18,0,352,0,0,352,T
4-HA,19,0,351,0,1,352,T
4-HA,20,0,353,0,0,353,T
4-HA,21,0,0,372,0,372,G
4-HA,22,371,0,1,0,372,A
4-HA,23,0,0,390,0,390,G
4-HA,24,0,0,0,391,391,C
4-HA,25,0,390,0,0,390,T
4-HA,26,430,0,0,0,430,A
4-HA,27,0,0,0,436,436,C
4-HA,28,442,0,0,0,442,A
4-HA,29,0,475,0,0,475,T
4-HA,30,0,476,0,0,476,T
4-HA,31,0,1,0,480,481,C
4-HA,32,0,483,0,0,483,T
4-HA,33,492,0,0,0,492,A
4-HA,34,0,496,0,1,497,T
4-HA,35,1,0,496,0,497,G
4-HA,36,0,499,0,0,499,T
4-HA,37,0,0,0,493,493,C
4-HA,38,0,490,0,1,491,T
4-HA,39,0,0,492,0,492,G
4-HA,40,0,0,491,0,491,G
4-HA,41,0,496,0,0,496,T
4-HA,42,0,494,0,0,494,T
4-HA,43,0,492,0,0,492,T
4-HA,44,0,496,0,0,496,T
4-HA,45,1,0,1,489,491,C
4-HA,46,0,0,498,0,498,G
4-HA,47,0,0,0,501,501,C
4-HA,48,0,496,0,0,496,T
4-HA,49,1,0,0,502,503,C
4-HA,50,501,0,0,0,501,A
4-HA,51,502,0,0,0,502,A
4-HA,52,506,0,0,0,506,A
4-HA,53,500,0,0,0,500,A
4-HA,54,499,0,0,0,499,A
4-HA,55,0,0,0,505,505,C
4-HA,56,0,502,0,0,502,T
4-HA,57,0,514,0,0,514,T
4-HA,58,1,0,0,510,511,C
4-HA,59,1,0,0,510,511,C
4-HA,60,0,516,0,0,516,T
4-HA,61,0,0,517,0,517,G
4-HA,62,0,0,516,0,516,G
4-HA,63,516,0,0,0,516,A
4-HA,64,532,0,0,0,532,A
4-HA,65,533,0,0,0,533,A
4-HA,66,0,537,0,0,537,T
4-HA,67,1,0,536,0,537,G
4-HA,68,542,0,1,0,543,A
4-HA,69,0,0,0,545,545,C
4-HA,70,540,0,1,0,541,A
4-HA,71,542,1,0,0,543,A
4-HA,72,0,0,0,554,554,C
4-HA,73,550,0,1,0,551,A
4-HA,74,0,0,548,0,548,G
4-HA,75,0,0,0,552,552,C
4-HA,76,551,0,0,0,551,A
4-HA,77,0,1,0,561,562,C
4-HA,78,0,0,555,0,555,G
4-HA,79,0,0,555,1,556,G
4-HA,80,0,0,0,571,571,C
4-HA,81,566,0,0,0,566,A
4-HA,82,574,0,0,0,574,A
4-HA,83,0,0,0,578,578,C
4-HA,84,0,0,582,0,582,G
4-HA,85,0,1,0,585,586,C
4-HA,86,0,584,0,1,585,T
4-HA,87,0,0,590,0,590,G
4-HA,88,0,590,0,0,590,T
4-HA,89,0,0,622,1,623,G
4-HA,90,0,1,0,632,633,C
4-HA,91,1,0,0,638,639,C
4-HA,92,0,643,0,0,643,T
4-HA,93,0,638,0,0,638,T
4-HA,94,0,0,642,0,642,G
4-HA,95,0,0,643,0,643,G
4-HA,96,0,0,654,0,654,G
4-HA,97,0,0,0,656,656,C
4-HA,98,652,0,0,0,652,A
4-HA,99,0,1,0,661,662,C
4-HA,100,0,0,0,658,658,C
4-HA,101,732,0,0,0,732,A
4-HA,102,0,735,0,1,736,T
4-HA,103,0,0,731,0,731,G
4-HA,104,0,0,0,735,735,C
4-HA,105,734,0,0,0,734,A
4-HA,106,0,0,785,0,785,G
4-HA,107,0,784,0,0,784,T
4-HA,108,791,0,1,0,792,A
4-HA,109,0,0,0,786,786,C
4-HA,110,1,1,0,781,783,C
4-HA,111,786,0,0,0,786,A
4-HA,112,778,0,0,0,778,A
4-HA,113,782,0,0,0,782,A
4-HA,114,0,0,0,788,788,C
4-HA,115,0,2,765,0,767,G
4-HA,116,1,1,780,0,782,G
4-HA,117,781,1,1,0,783,A
4-HA,118,786,0,0,0,786,A
4-HA,119,0,0,0,782,782,C
4-HA,120,1,0,788,0,789,G
4-HA,121,797,0,0,0,797,A
4-HA,122,0,799,0,0,799,T
4-HA,123,808,0,0,0,808,A
4-HA,124,0,0,802,0,802,G
4-HA,125,1,794,0,0,795,T
4-HA,126,0,0,803,0,803,G
4-HA,127,800,0,1,0,801,A
4-HA,128,800,0,0,0,800,A
4-HA,129,801,0,0,0,801,A
4-HA,130,794,0,1,1,796,A
4-HA,131,0,1,0,803,804,C
4-HA,132,807,0,0,0,807,A
4-HA,133,805,0,0,0,805,A
4-HA,134,0,809,0,0,809,T
4-HA,135,1,0,0,811,812,C
4-HA,136,810,0,0,0,810,A
4-HA,137,0,0,0,817,817,C
4-HA,138,0,0,818,0,818,G
4-HA,139,815,0,0,0,815,A
4-HA,140,814,0,0,0,814,A
4-HA,141,0,810,0,0,810,T
4-HA,142,2,0,810,0,812,G
4-HA,143,808,0,0,0,808,A
4-HA,144,1,0,0,818,819,C
4-HA,145,1,0,0,815,816,C
4-HA,146,824,0,0,0,824,A
4-HA,147,825,0,0,0,825,A
4-HA,148,825,0,0,0,825,A
4-HA,149,0,827,0,0,827,T
4-HA,150,0,825,0,0,825,T
4-HA,151,0,0,829,0,829,G
4-HA,152,826,0,1,0,827,A
4-HA,153,827,0,1,0,828,A
4-HA,154,0,0,833,0,833,G
4-HA,155,0,827,0,0,827,T
4-HA,156,0,861,0,0,861,T
4-HA,157,863,0,0,0,863,A
4-HA,158,0,0,0,868,868,C
4-HA,159,0,872,0,0,872,T
4-HA,160,867,0,0,0,867,A
4-HA,161,892,0,0,0,892,A
4-HA,162,0,892,0,0,892,T
4-HA,163,1,0,890,0,891,G
4-HA,164,1,0,0,918,919,C
4-HA,165,0,909,0,2,911,T
4-HA,166,915,0,1,0,916,A
4-HA,167,0,0,0,913,913,C
4-HA,168,0,909,0,0,909,T
4-HA,169,0,0,918,0,918,G
4-HA,170,908,0,0,0,908,A
4-HA,171,0,0,912,0,912,G
4-HA,172,0,0,0,911,911,C
4-HA,173,0,896,0,0,896,T
4-HA,174,0,0,921,0,921,G
4-HA,175,0,0,939,0,939,G
4-HA,176,1,939,0,0,940,T
4-HA,177,0,937,0,0,937,T
4-HA,178,1,0,0,943,944,C
4-HA,179,940,0,0,0,940,A
4-HA,180,0,1,938,0,939,G
4-HA,181,943,0,0,0,943,A
4-HA,182,0,0,965,0,965,G
4-HA,183,0,963,0,0,963,T
4-HA,184,0,950,0,0,950,T
4-HA,185,1,0,0,955,956,C
4-HA,186,1,0,0,962,963,C
4-HA,187,0,957,0,0,957,T
4-HA,188,0,0,0,960,960,C
4-HA,189,960,0,0,0,960,A
4-HA,190,961,0,0,0,961,A
4-HA,191,0,0,0,962,962,C
4-HA,192,939,1,1,0,941,A
4-HA,193,0,1,956,0,957,G
4-HA,194,1,0,953,0,954,G
4-HA,195,0,947,0,0,947,T
4-HA,196,0,0,954,0,954,G
4-HA,197,955,0,0,0,955,A
4-HA,198,957,0,0,0,957,A
4-HA,199,978,1,0,0,979,A
4-HA,200,0,976,0,0,976,T
4-HA,201,975,0,8,0,983,A
4-HA,202,0,973,0,0,973,T
4-HA,203,0,0,966,0,966,G
4-HA,204,0,1,0,971,972,C
4-HA,205,1,1,969,0,971,G
4-HA,206,966,0,0,0,966,A
4-HA,207,1,0,0,968,969,C
4-HA,208,953,0,0,0,953,A
4-HA,209,0,0,1004,0,1004,G
4-HA,210,0,996,0,0,996,T
4-HA,211,0,0,0,1006,1006,C
4-HA,212,3,0,0,1008,1011,C
4-HA,213,0,1002,0,0,1002,T
4-HA,214,0,1,0,1013,1014,C
4-HA,215,1013,0,0,0,1013,A
4-HA,216,0,1012,0,0,1012,T
4-HA,217,0,1,0,1017,1018,C
4-HA,218,969,0,0,0,969,A
4-HA,219,0,2,970,0,972,G
4-HA,220,956,0,1,0,957,A
4-HA,221,0,961,0,0,961,T
4-HA,222,1,3,0,961,965,C
4-HA,223,2,1,0,941,944,C
4-HA,224,0,944,0,0,944,T
4-HA,225,0,943,0,0,943,T
4-HA,226,1,2,938,0,941,G
4-HA,227,936,0,0,0,936,A
4-HA,228,0,942,0,0,942,T
4-HA,229,0,0,950,0,950,G
4-HA,230,1,0,940,0,941,G
4-HA,231,939,0,0,1,940,A
4-HA,232,945,0,0,0,945,A
4-HA,233,950,0,0,0,950,A
4-HA,234,951,0,0,0,951,A
4-HA,235,956,0,0,0,956,A
4-HA,236,959,0,0,0,959,A
4-HA,237,0,0,0,963,963,C
4-HA,238,0,951,0,0,951,T
4-HA,239,0,1,955,0,956,G
4-HA,240,1,0,0,953,954,C
4-HA,241,955,0,1,0,956,A
4-HA,242,0,1,0,989,990,C
4-HA,243,990,0,0,0,990,A
4-HA,244,0,0,0,1112,1112,C
4-HA,245,0,1115,0,0,1115,T
4-HA,246,1136,0,0,0,1136,A
4-HA,247,1128,1,0,0,1129,A
4-HA,248,0,1132,0,0,1132,T
4-HA,249,1131,0,0,0,1131,A
4-HA,250,0,0,1126,0,1126,G
4-HA,251,1110,0,0,0,1110,A
4-HA,252,1,1094,0,0,1095,T
4-HA,253,0,0,1037,0,1037,G
4-HA,254,0,1,0,1029,1030,C
4-HA,255,0,1021,0,0,1021,T
4-HA,256,0,0,0,1093,1093,C
4-HA,257,0,1095,0,0,1095,T
4-HA,258,1129,0,0,0,1129,A
4-HA,259,0,1134,0,0,1134,T
4-HA,260,0,1125,0,0,1125,T
4-HA,261,0,1,1161,0,1162,G
4-HA,262,0,1,1161,0,1162,G
4-HA,263,1,4,1164,0,1169,G
4-HA,264,1165,0,3,0,1168,A
4-HA,265,1,0,1161,0,1162,G
4-HA,266,1145,0,0,0,1145,A
4-HA,267,0,0,1,1351,1352,C
4-HA,268,0,0,0,1400,1400,C
4-HA,269,0,1,0,1419,1420,C
4-HA,270,0,1423,0,0,1423,T
4-HA,271,0,0,0,1471,1471,C
4-HA,272,1460,0,0,0,1460,A
4-HA,273,0,0,1643,0,1643,G
4-HA,274,0,1635,0,1,1636,T
4-HA,275,0,1,1656,0,1657,G
4-HA,276,0,1625,0,2,1627,T
4-HA,277,1,0,1629,0,1630,G
4-HA,278,1622,1,3,0,1626,A
4-HA,279,0,1625,0,1,1626,T
4-HA,280,0,0,1620,0,1620,G
4-HA,281,6,0,1605,0,1611,G
4-HA,282,0,0,0,1621,1621,C
4-HA,283,0,1613,0,0,1613,T
4-HA,284,0,1618,0,2,1620,T
4-HA,285,0,1,0,1613,1614,C
4-HA,286,2,1,0,1617,1620,C
4-HA,287,1626,0,0,0,1626,A
4-HA,288,1629,0,0,0,1629,A
4-HA,289,1630,0,0,0,1630,A
4-HA,290,1635,0,1,0,1636,A
4-HA,291,0,1653,0,0,1653,T
4-HA,292,1647,0,0,0,1647,A
4-HA,293,1652,0,0,1,1653,A
4-HA,294,0,1,1670,0,1671,G
4-HA,295,1685,0,0,0,1685,A
4-HA,296,1692,0,0,0,1692,A
4-HA,297,1687,0,0,0,1687,A
4-HA,298,1,1686,0,0,1687,T
4-HA,299,0,1,1683,0,1684,G
4-HA,300,0,1,1676,0,1677,G
4-HA,301,0,1,1672,0,1673,G
4-HA,302,1658,0,0,0,1658,A
4-HA,303,0,0,0,1700,1700,C
4-HA,304,0,0,0,1700,1700,C
4-HA,305,1,1749,0,1,1751,T
4-HA,306,0,1747,0,1,1748,T
4-HA,307,0,1747,0,1,1748,T
4-HA,308,0,1761,0,2,1763,T
4-HA,309,0,1768,0,0,1768,T
4-HA,310,1,0,1772,0,1773,G
4-HA,311,0,1771,0,0,1771,T
4-HA,312,0,1772,0,1,1773,T
4-HA,313,1,1,1770,0,1772,G
4-HA,314,1765,0,0,0,1765,A
4-HA,315,1783,0,0,0,1783,A
4-HA,316,0,2,0,1776,1778,C
4-HA,317,0,0,1781,0,1781,G
4-HA,318,0,1,0,1807,1808,C
4-HA,319,1803,0,1,0,1804,A
4-HA,320,0,0,1822,0,1822,G
4-HA,321,0,0,0,1824,1824,C
4-HA,322,1832,0,0,0,1832,A
4-HA,323,1822,0,0,0,1822,A
4-HA,324,1805,0,1,0,1806,A
4-HA,325,0,1,1848,0,1849,G
4-HA,326,0,1,0,1852,1853,C
4-HA,327,0,1,0,1848,1849,C
4-HA,328,2,1,0,1829,1832,C
4-HA,329,1847,0,0,0,1847,A
4-HA,330,1,1,0,1902,1904,C
4-HA,331,1905,0,0,0,1905,A
4-HA,332,0,1,1907,0,1908,G
4-HA,333,1,2,0,1906,1909,C
4-HA,334,1898,0,1,0,1899,A
4-HA,335,1914,1,1,0,1916,A
4-HA,336,0,1,0,2025,2026,C
4-HA,337,0,2029,0,0,2029,T
4-HA,338,2,1,2032,0,2035,G
4-HA,339,0,2016,0,2,2018,T
4-HA,340,0,2021,0,1,2022,T
4-HA,341,2009,0,1,0,2010,A
4-HA,342,0,0,0,2234,2234,C
4-HA,343,1,0,0,2243,2244,C
4-HA,344,4,0,0,2289,2293,C
4-HA,345,0,2224,0,0,2224,T
4-HA,346,0,2224,0,0,2224,T
4-HA,347,2233,0,0,0,2233,A
4-HA,348,0,2236,0,0,2236,T
4-HA,349,1,1,2233,0,2235,G
4-HA,350,2229,1,0,1,2231,A
4-HA,351,0,2108,0,0,2108,T
4-HA,352,1,0,2151,0,2152,G
4-HA,353,0,2123,0,4,2127,T
4-HA,354,2,0,2139,1,2142,G
4-HA,355,0,1,0,2131,2132,C
4-HA,356,0,0,0,2141,2141,C
4-HA,357,2134,0,0,0,2134,A
4-HA,358,2,0,2211,0,2213,G
4-HA,359,2206,0,0,0,2206,A
4-HA,360,1,2224,0,1,2226,T
4-HA,361,0,2220,0,1,2221,T
4-HA,362,2223,0,1,0,2224,A
4-HA,363,0,2210,0,0,2210,T
4-HA,364,0,0,2203,0,2203,G
4-HA,365,1,2,0,2198,2201,C
4-HA,366,0,0,0,2202,2202,C
4-HA,367,0,2216,0,0,2216,T
4-HA,368,0,0,0,2365,2365,C
4-HA,369,4,1,0,2381,2386,C
4-HA,370,1,0,0,2390,2391,C
4-HA,371,0,2391,0,1,2392,T
4-HA,372,0,2404,0,0,2404,T
4-HA,373,2413,0,1,0,2414,A
4-HA,374,0,1,2461,0,2462,G
4-HA,375,1,0,2456,0,2457,G
4-HA,376,0,2437,0,0,2437,T
4-HA,377,3,2,0,2424,2429,C
4-HA,378,2399,0,2,2,2403,A
4-HA,379,0,0,0,2480,2480,C
4-HA,380,0,2480,0,0,2480,T
4-HA,381,2473,0,2,0,2475,A
4-HA,382,1,0,2468,0,2469,G
4-HA,383,0,2426,0,3,2429,T
4-HA,384,0,2445,0,1,2446,T
4-HA,385,0,0,2465,0,2465,G
4-HA,386,0,1,0,2461,2462,C
4-HA,387,1,1,1,2460,2463,C
4-HA,388,0,2446,0,2,2448,T
4-HA,389,2,1,0,2458,2461,C
4-HA,390,2562,0,0,0,2562,A
4-HA,391,0,2555,0,2,2557,T
4-HA,392,0,0,0,2559,2559,C
4-HA,393,5,6,0,2547,2558,C
4-HA,394,2,2,2546,0,2550,G
4-HA,395,2,1,2540,0,2543,G
4-HA,396,0,0,0,2567,2567,C
4-HA,397,2586,0,1,0,2587,A
4-HA,398,0,4,1,2620,2625,C
4-HA,399,2576,0,1,0,2577,A
4-HA,400,0,0,0,2606,2606,C
4-HA,401,0,2601,0,1,2602,T
4-HA,402,1,1,2627,0,2629,G
4-HA,403,0,5,2641,0,2646,G
4-HA,404,2632,0,1,0,2633,A
4-HA,405,1,0,2677,0,2678,G
4-HA,406,0,2650,0,0,2650,T
4-HA,407,0,2651,0,0,2651,T
4-HA,408,1,2659,0,0,2660,T
4-HA,409,2643,0,1,0,2644,A
4-HA,410,2645,0,2,1,2648,A
4-HA,411,1,1,0,2663,2665,C
4-HA,412,2625,1,0,0,2626,A
4-HA,413,2617,0,2,0,2619,A
4-HA,414,0,2619,0,1,2620,T
4-HA,415,0,1,2609,0,2610,G
4-HA,416,2603,0,1,0,2604,A
4-HA,417,2608,0,1,0,2609,A
4-HA,418,2612,0,4,1,2617,A
4-HA,419,0,0,2609,0,2609,G
4-HA,420,0,0,0,2639,2639,C
4-HA,421,0,2629,0,3,2632,T
4-HA,422,0,2636,0,0,2636,T
4-HA,423,2,0,0,2658,2660,C
4-HA,424,2663,0,0,0,2663,A
4-HA,425,2669,0,1,0,2670,A
4-HA,426,0,2667,0,2,2669,T
4-HA,427,1,2666,0,1,2668,T
4-HA,428,0,2,2722,0,2724,G
4-HA,429,0,2,2739,0,2741,G
4-HA,430,2735,0,3,0,2738,A
4-HA,431,0,0,0,2758,2758,C
4-HA,432,0,2729,0,1,2730,T
4-HA,433,0,1,2746,0,2747,G
4-HA,434,0,2,2738,0,2740,G
4-HA,435,2742,0,3,0,2745,A
4-HA,436,0,0,2765,2,2767,G
4-HA,437,1,2709,0,2,2712,T
4-HA,438,7,0,0,2686,2693,C
4-HA,439,2718,0,3,0,2721,A
4-HA,440,0,0,0,2735,2735,C
4-HA,441,0,2721,0,1,2722,T
4-HA,442,3,0,0,2728,2731,C
4-HA,443,2712,0,0,0,2712,A
4-HA,444,2730,0,0,0,2730,A
4-HA,445,2700,0,2,0,2702,A
4-HA,446,2716,0,0,1,2717,A
4-HA,447,0,0,0,2738,2738,C
4-HA,448,0,2,2713,0,2715,G
4-HA,449,0,4,2750,0,2754,G
4-HA,450,2755,0,2,0,2757,A
4-HA,451,2761,0,1,0,2762,A
4-HA,452,0,3,0,2761,2764,C
4-HA,453,2755,0,0,0,2755,A
4-HA,454,2782,0,6,0,2788,A
4-HA,455,0,0,2811,0,2811,G
4-HA,456,0,0,0,2800,2800,C
4-HA,457,0,2779,0,1,2780,T
4-HA,458,2,0,0,2803,2805,C
4-HA,459,0,2795,0,1,2796,T
4-HA,460,0,0,2799,0,2799,G
4-HA,461,0,1,0,2797,2798,C
4-HA,462,0,2797,0,6,2803,T
4-HA,463,0,2873,0,3,2876,T
4-HA,464,1,1,2924,0,2926,G
4-HA,465,1,1,0,2960,2962,C
4-HA,466,2960,0,0,0,2960,A
4-HA,467,0,2956,0,0,2956,T
4-HA,468,2956,0,0,0,2956,A
4-HA,469,2929,0,2,0,2931,A
4-HA,470,1,2,2935,0,2938,G
4-HA,471,0,0,2919,0,2919,G
4-HA,472,2835,0,0,0,2835,A
4-HA,473,0,1,2822,0,2823,G
4-HA,474,2800,0,1,1,2802,A
4-HA,475,0,2867,0,1,2868,T
4-HA,476,2,0,0,2887,2889,C
4-HA,477,0,2894,0,0,2894,T
4-HA,478,2893,1,0,0,2894,A
4-HA,479,2878,0,0,0,2878,A
4-HA,480,2864,0,0,0,2864,A
4-HA,481,2866,0,1,0,2867,A
4-HA,482,2859,1,1,0,2861,A
4-HA,483,0,0,0,2889,2889,C
4-HA,484,2823,0,1,1,2825,A
4-HA,485,0,0,2827,0,2827,G
4-HA,486,0,2817,1,3,2821,T
4-HA,487,0,2857,0,2,2859,T
4-HA,488,0,2869,0,1,2870,T
4-HA,489,2,1,0,2920,2923,C
4-HA,490,0,2928,0,0,2928,T
4-HA,491,0,2938,0,0,2938,T
4-HA,492,0,2932,0,1,2933,T
4-HA,493,2929,0,5,1,2935,A
4-HA,494,0,0,2937,0,2937,G
4-HA,495,0,2927,0,0,2927,T
4-HA,496,2939,0,2,2,2943,A
4-HA,497,0,0,2946,0,2946,G
4-HA,498,2907,0,3,0,2910,A
4-HA,499,0,2918,0,0,2918,T
4-HA,500,0,2916,0,0,2916,T
4-HA,501,0,2,2974,0,2976,G
4-HA,502,2970,0,0,0,2970,A
4-HA,503,2980,0,0,1,2981,A
4-HA,504,0,2975,1,0,2976,T
4-HA,505,0,2949,1,0,2950,T
4-HA,506,3,0,2974,0,2977,G
4-HA,507,0,0,2964,0,2964,G
4-HA,508,0,2967,0,1,2968,T
4-HA,509,0,2969,0,1,2970,T
4-HA,510,0,3,2923,0,2926,G
4-HA,511,2933,1,2,0,2936,A
4-HA,512,0,1,0,2935,2936,C
4-HA,513,0,2,0,2916,2918,C
4-HA,514,5,0,0,2971,2976,C
4-HA,515,2962,0,0,2,2964,A
4-HA,516,0,0,0,2991,2991,C
4-HA,517,0,2977,0,1,2978,T
4-HA,518,0,2990,0,0,2990,T
4-HA,519,2992,0,0,1,2993,A
4-HA,520,2970,0,0,1,2971,A
4-HA,521,2961,0,0,1,2962,A
4-HA,522,0,1,0,2894,2895,C
4-HA,523,0,2981,0,0,2981,T
4-HA,524,1,2983,0,1,2985,T
4-HA,525,3,1,0,3009,3013,C
4-HA,526,3010,0,0,0,3010,A
4-HA,527,3012,0,0,1,3013,A
4-HA,528,3017,0,0,0,3017,A
4-HA,529,0,3011,0,0,3011,T
4-HA,530,3042,0,0,1,3043,A
4-HA,531,2,0,0,3054,3056,C
4-HA,532,1,0,0,2979,2980,C
4-HA,533,2,1,0,3002,3005,C
4-HA,534,2983,0,2,0,2985,A
4-HA,535,0,2,3094,0,3096,G
4-HA,536,1,0,0,3106,3107,C
4-HA,537,3123,0,0,0,3123,A
4-HA,538,0,3118,0,2,3120,T
4-HA,539,0,3074,0,1,3075,T
4-HA,540,3,4,3172,0,3179,G
4-HA,541,3189,0,1,0,3190,A
4-HA,542,3193,0,5,0,3198,A
4-HA,543,0,5,1,3188,3194,C
4-HA,544,0,2,3142,0,3144,G
4-HA,545,0,3153,0,1,3154,T
4-HA,546,1,2,3182,0,3185,G
4-HA,547,3164,0,5,0,3169,A
4-HA,548,0,1,0,3181,3182,C
4-HA,549,0,3103,0,2,3105,T
4-HA,550,3184,0,1,0,3185,A
4-HA,551,0,3177,0,0,3177,T
4-HA,552,0,0,3192,0,3192,G
4-HA,553,1,3,0,3187,3191,C
4-HA,554,4,1,0,3163,3168,C
4-HA,555,3154,0,1,0,3155,A
4-HA,556,3146,0,0,0,3146,A
4-HA,557,3189,0,1,0,3190,A
4-HA,558,1,1,0,3212,3214,C
4-HA,559,3123,0,0,0,3123,A
4-HA,560,3124,0,0,0,3124,A
4-HA,561,0,3091,1,0,3092,T
4-HA,562,0,3,3095,0,3098,G
4-HA,563,3102,0,1,0,3103,A
4-HA,564,3093,0,1,0,3094,A
4-HA,565,1,1,0,3054,3056,C
4-HA,566,3072,0,0,1,3073,A
4-HA,567,3097,1,0,0,3098,A
4-HA,568,0,3093,0,0,3093,T
4-HA,569,0,3093,0,0,3093,T
4-HA,570,0,3111,0,0,3111,T
4-HA,571,5,3,3084,0,3092,G
4-HA,572,3089,1,2,1,3093,A
4-HA,573,0,1,0,3102,3103,C
4-HA,574,3096,0,0,0,3096,A
4-HA,575,3092,0,0,0,3092,A
4-HA,576,3148,0,0,0,3148,A
4-HA,577,0,3153,0,1,3154,T
4-HA,578,0,3137,0,0,3137,T
4-HA,579,1,1,3157,0,3159,G
4-HA,580,1,3151,0,1,3153,T
4-HA,581,3160,0,3,0,3163,A
4-HA,582,0,1,0,3234,3235,C
4-HA,583,3220,0,0,1,3221,A
4-HA,584,0,3248,0,0,3248,T
4-HA,585,0,3215,0,0,3215,T
4-HA,586,0,3213,0,0,3213,T
4-HA,587,0,3,3199,0,3202,G
4-HA,588,0,2,3191,0,3193,G
4-HA,589,1,3,3177,0,3181,G
4-HA,590,0,5,3192,0,3197,G
4-HA,591,0,1,3142,0,3143,G
4-HA,592,1,1,3231,0,3233,G
4-HA,593,0,3198,2,1,3201,T
4-HA,594,0,3216,0,1,3217,T
4-HA,595,4,1,0,3206,3211,C
4-HA,596,3202,0,4,0,3206,A
4-HA,597,0,0,0,3232,3232,C
4-HA,598,1,1,0,3226,3228,C
4-HA,599,3213,0,0,1,3214,A
4-HA,600,1,2,0,3276,3279,C
4-HA,601,0,1,0,3229,3230,C
4-HA,602,0,1,1,3191,3193,C
4-HA,603,3,1,3205,0,3209,G
4-HA,604,1,0,3284,0,3285,G
4-HA,605,1,0,3291,0,3292,G
4-HA,606,0,3236,0,1,3237,T
4-HA,607,3285,0,1,0,3286,A
4-HA,608,0,1,0,3264,3265,C
4-HA,609,0,1,3240,0,3241,G
4-HA,610,0,4,3274,0,3278,G
4-HA,611,3296,0,0,0,3296,A
4-HA,612,0,2,0,3293,3295,C
4-HA,613,3222,0,0,0,3222,A
4-HA,614,3210,1,2,0,3213,A
4-HA,615,3198,0,2,0,3200,A
4-HA,616,0,2,3240,0,3242,G
4-HA,617,3228,0,5,0,3233,A
4-HA,618,0,0,0,3255,3255,C
4-HA,619,1,2,0,3210,3213,C
4-HA,620,3224,1,1,0,3226,A
4-HA,621,3229,0,2,0,3231,A
4-HA,622,3248,0,3,0,3251,A
4-HA,623,0,3245,0,0,3245,T
4-HA,624,0,0,0,3269,3269,C
4-HA,625,0,3085,0,3,3088,T
4-HA,626,1,3053,0,2,3056,T
4-HA,627,1,0,0,3104,3105,C
4-HA,628,2,0,0,3107,3109,C
4-HA,629,0,3106,0,2,3108,T
4-HA,630,0,1,3129,0,3130,G
4-HA,631,1,3082,0,1,3084,T
4-HA,632,3116,0,0,0,3116,A
4-HA,633,0,3095,0,0,3095,T
4-HA,634,0,0,3114,0,3114,G
4-HA,635,0,0,0,3093,3093,C
4-HA,636,1,3072,0,1,3074,T
4-HA,637,4,4,0,3088,3096,C
4-HA,638,3098,0,3,0,3101,A
4-HA,639,3084,1,2,0,3087,A
4-HA,640,2,1,3085,0,3088,G
4-HA,641,0,0,0,3124,3124,C
4-HA,642,3114,0,2,0,3116,A
4-HA,643,1,3085,0,1,3087,T
4-HA,644,0,1,0,3089,3090,C
4-HA,645,3090,0,4,0,3094,A
4-HA,646,0,1,3103,0,3104,G
4-HA,647,0,2,3100,0,3102,G
4-HA,648,3108,0,0,1,3109,A
4-HA,649,3088,0,0,0,3088,A
4-HA,650,2,2,3133,1,3138,G
4-HA,651,3127,1,2,0,3130,A
4-HA,652,3151,0,0,0,3151,A
4-HA,653,1,3174,1,3,3179,T
4-HA,654,2,0,0,3177,3179,C
4-HA,655,3158,0,3,0,3161,A
4-HA,656,0,1,0,3150,3151,C
4-HA,657,3149,0,2,0,3151,A
4-HA,658,0,1,3203,0,3204,G
4-HA,659,2,3135,1,0,3138,T
4-HA,660,4,0,0,3149,3153,C
4-HA,661,0,3113,0,0,3113,T
4-HA,662,1,1,0,3183,3185,C
4-HA,663,0,3185,0,1,3186,T
4-HA,664,3194,0,0,0,3194,A
4-HA,665,1,0,0,3190,3191,C
4-HA,666,0,1,0,3201,3202,C
4-HA,667,3153,0,0,0,3153,A
4-HA,668,3143,1,0,2,3146,A
4-HA,669,3133,0,0,0,3133,A
4-HA,670,3136,0,1,0,3137,A
4-HA,671,1,0,3124,0,3125,G
4-HA,672,3062,0,0,0,3062,A
4-HA,673,3040,0,3,0,3043,A
4-HA,674,1,0,3050,0,3051,G
4-HA,675,0,2,0,3042,3044,C
4-HA,676,2,1,1,3060,3064,C
4-HA,677,3078,0,1,0,3079,A
4-HA,678,3081,3,0,0,3084,A
4-HA,679,1,0,0,3093,3094,C
4-HA,680,3094,0,1,0,3095,A
4-HA,681,3090,0,0,4,3094,A
4-HA,682,3091,0,1,0,3092,A
4-HA,683,0,0,0,3157,3157,C
4-HA,684,1,3144,0,0,3145,T
4-HA,685,1,1,3151,0,3153,G
4-HA,686,0,3132,0,2,3134,T
4-HA,687,3149,0,0,0,3149,A
4-HA,688,3150,0,2,0,3152,A
4-HA,689,0,3110,0,1,3111,T
4-HA,690,1,0,0,3147,3148,C
4-HA,691,1,1,0,3136,3138,C
4-HA,692,0,2,0,3111,3113,C
4-HA,693,2,2,3109,0,3113,G
4-HA,694,3103,0,2,1,3106,A
4-HA,695,3102,0,2,0,3104,A
4-HA,696,0,3125,0,0,3125,T
4-HA,697,3133,0,0,0,3133,A
4-HA,698,1,3092,0,1,3094,T
4-HA,699,1,0,0,3092,3093,C
4-HA,700,0,1,3091,0,3092,G
4-HA,701,0,3,3155,0,3158,G
4-HA,702,3154,0,0,0,3154,A
4-HA,703,0,3186,0,0,3186,T
4-HA,704,2,0,1,3196,3199,C
4-HA,705,0,3200,0,1,3201,T
4-HA,706,3184,0,0,0,3184,A
4-HA,707,0,2,3197,1,3200,G
4-HA,708,3199,0,5,0,3204,A
4-HA,709,0,0,0,3197,3197,C
4-HA,710,0,0,0,3095,3095,C
4-HA,711,1,0,1,3105,3107,C
4-HA,712,3094,0,1,0,3095,A
4-HA,713,0,2,3242,0,3244,G
4-HA,714,3237,0,2,0,3239,A
4-HA,715,1,0,3289,0,3290,G
4-HA,716,1,3243,1,0,3245,T
4-HA,717,3222,0,3,0,3225,A
4-HA,718,3225,0,2,1,3228,A
4-HA,719,1,1,3269,0,3271,G
4-HA,720,1,1,3278,0,3280,G
4-HA,721,3253,1,0,0,3254,A
4-HA,722,3014,0,2,0,3016,A
4-HA,723,0,3016,0,1,3017,T
4-HA,724,3014,0,0,0,3014,A
4-HA,725,0,3005,1,0,3006,T
4-HA,726,2,0,0,3041,3043,C
4-HA,727,2,1,0,3042,3045,C
4-HA,728,4,0,0,2996,3000,C
4-HA,729,0,2975,0,2,2977,T
4-HA,730,2990,0,1,0,2991,A
4-HA,731,0,1,2986,0,2987,G
4-HA,732,1,0,0,3002,3003,C
4-HA,733,2917,0,1,0,2918,A
4-HA,734,1,2,2995,0,2998,G
4-HA,735,2952,0,1,0,2953,A
4-HA,736,2951,0,0,0,2951,A
4-HA,737,0,2959,0,0,2959,T
4-HA,738,2959,0,1,0,2960,A
4-HA,739,2969,1,2,0,2972,A
4-HA,740,1,1,2964,0,2966,G
4-HA,741,0,1,0,2973,2974,C
4-HA,742,2973,0,1,0,2974,A
4-HA,743,0,2904,0,2,2906,T
4-HA,744,0,1,0,3048,3049,C
4-HA,745,0,3037,0,0,3037,T
4-HA,746,3056,2,0,0,3058,A
4-HA,747,0,3063,0,2,3065,T
4-HA,748,0,3021,0,1,3022,T
4-HA,749,0,3,3041,0,3044,G
4-HA,750,0,2,3014,0,3016,G
4-HA,751,3010,0,4,0,3014,A
4-HA,752,2,0,0,3028,3030,C
4-HA,753,2866,0,0,1,2867,A
4-HA,754,2923,0,0,1,2924,A
4-HA,755,0,3044,1,0,3045,T
4-HA,756,3063,0,1,0,3064,A
4-HA,757,1,0,3079,0,3080,G
4-HA,758,0,3068,0,0,3068,T
4-HA,759,3068,1,2,0,3071,A
4-HA,760,3078,0,0,1,3079,A
4-HA,761,3096,0,0,1,3097,A
4-HA,762,3123,0,2,0,3125,A
4-HA,763,2,1,0,3182,3185,C
4-HA,764,4,1,0,3051,3056,C
4-HA,765,1,3,3047,0,3051,G
4-HA,766,2,0,3073,0,3075,G
4-HA,767,0,2,3098,0,3100,G
4-HA,768,3099,0,0,0,3099,A
4-HA,769,0,3,3136,0,3139,G
4-HA,770,3159,0,4,0,3163,A
4-HA,771,0,3,0,3174,3177,C
4-HA,772,3174,0,0,4,3178,A
4-HA,773,0,3182,1,1,3184,T
4-HA,774,3173,0,1,0,3174,A
4-HA,775,0,1,0,3243,3244,C
4-HA,776,0,3221,1,3,3225,T
4-HA,777,0,3264,1,1,3266,T
4-HA,778,0,3277,1,1,3279,T
4-HA,779,0,3263,1,0,3264,T
4-HA,780,1,1,3298,0,3300,G
4-HA,781,3303,1,0,0,3304,A
4-HA,782,0,3295,1,2,3298,T
4-HA,783,0,3382,1,9,3392,T
4-HA,784,3376,0,2,1,3379,A
4-HA,785,3388,0,2,1,3391,A
4-HA,786,0,0,0,3436,3436,C
4-HA,787,3413,0,1,1,3415,A
4-HA,788,2,0,3533,0,3535,G
4-HA,789,0,1,0,3516,3517,C
4-HA,790,3516,0,1,1,3518,A
4-HA,791,0,0,0,3544,3544,C
4-HA,792,3500,0,1,1,3502,A
4-HA,793,0,5,3548,0,3553,G
4-HA,794,0,2,3539,0,3541,G
4-HA,795,0,3,3659,0,3662,G
4-HA,796,3644,0,1,0,3645,A
4-HA,797,3673,1,0,0,3674,A
4-HA,798,0,3681,1,1,3683,T
4-HA,799,1,1,0,3680,3682,C
4-HA,800,0,3702,0,0,3702,T
4-HA,801,3714,0,0,0,3714,A
4-HA,802,3696,0,5,0,3701,A
4-HA,803,0,3687,1,2,3690,T
4-HA,804,0,3602,0,0,3602,T
4-HA,805,1,1,3639,0,3641,G
4-HA,806,0,1,0,3724,3725,C
4-HA,807,0,3837,1,6,3844,T
4-HA,808,8,0,0,3921,3929,C
4-HA,809,2,8,0,3942,3952,C
4-HA,810,0,3940,2,1,3943,T
4-HA,811,3950,0,1,1,3952,A
4-HA,812,0,4,3965,0,3969,G
4-HA,813,0,12,3983,0,3995,G
4-HA,814,2,0,3984,0,3986,G
4-HA,815,1,0,3941,0,3942,G
4-HA,816,0,3856,0,3,3859,T
4-HA,817,0,3838,0,0,3838,T
4-HA,818,3836,0,0,0,3836,A
4-HA,819,0,0,0,3905,3905,C
4-HA,820,0,3897,0,2,3899,T
4-HA,821,0,3920,0,4,3924,T
4-HA,822,0,1,0,3912,3913,C
4-HA,823,3896,1,0,0,3897,A
4-HA,824,3901,0,0,0,3901,A
4-HA,825,3913,0,1,0,3914,A
4-HA,826,3935,0,0,0,3935,A
4-HA,827,0,3941,0,1,3942,T
4-HA,828,3907,0,1,0,3908,A
4-HA,829,0,0,0,3916,3916,C
4-HA,830,0,0,3912,0,3912,G
4-HA,831,3903,0,3,0,3906,A
4-HA,832,3898,0,3,0,3901,A
4-HA,833,0,0,3983,0,3983,G
4-HA,834,0,3945,0,0,3945,T
4-HA,835,0,3,3989,0,3992,G
4-HA,836,1,3,3995,0,3999,G
4-HA,837,0,3,3990,1,3994,G
4-HA,838,4000,0,2,0,4002,A
4-HA,839,4010,0,0,0,4010,A
4-HA,840,4017,1,0,0,4018,A
4-HA,841,4000,0,5,0,4005,A
4-HA,842,1,2,4064,0,4067,G
4-HA,843,1,0,0,4046,4047,C
4-HA,844,0,4043,0,5,4048,T
4-HA,845,7,3,1,4096,4107,C
4-HA,846,4112,0,0,0,4112,A
4-HA,847,4137,0,1,0,4138,A
4-HA,848,0,4148,0,2,4150,T
4-HA,849,4197,0,1,0,4198,A
4-HA,850,4194,0,1,0,4195,A
4-HA,851,0,4134,0,2,4136,T
4-HA,852,0,5,4153,0,4158,G
4-HA,853,4124,0,3,0,4127,A
4-HA,854,0,1,4237,0,4238,G
4-HA,855,4230,0,1,0,4231,A
4-HA,856,0,4201,0,3,4204,T
4-HA,857,4,0,0,4293,4297,C
4-HA,858,4267,0,1,0,4268,A
4-HA,859,0,3,4348,0,4351,G
4-HA,860,4342,0,1,0,4343,A
4-HA,861,0,4343,1,0,4344,T
4-HA,862,0,0,4326,0,4326,G
4-HA,863,0,0,0,4250,4250,C
4-HA,864,4262,1,4,0,4267,A
4-HA,865,2,0,0,4334,4336,C
4-HA,866,4,1,0,4293,4298,C
4-HA,867,8,0,0,4317,4325,C
4-HA,868,4275,0,0,0,4275,A
4-HA,869,0,4252,0,2,4254,T
4-HA,870,0,4252,0,2,4254,T
4-HA,871,2,3,4303,0,4308,G
4-HA,872,3,0,4283,0,4286,G
4-HA,873,0,3,1,4312,4316,C
4-HA,874,4246,0,1,0,4247,A
4-HA,875,4224,0,1,0,4225,A
4-HA,876,4291,1,1,0,4293,A
4-HA,877,1,4300,0,1,4302,T
4-HA,878,0,1,4290,0,4291,G
4-HA,879,0,0,0,4302,4302,C
4-HA,880,4250,0,3,0,4253,A
4-HA,881,4365,0,1,0,4366,A
4-HA,882,0,4361,0,4,4365,T
4-HA,883,1,4385,0,0,4386,T
4-HA,884,2,0,0,4397,4399,C
4-HA,885,0,4335,0,1,4336,T
4-HA,886,0,1,4379,0,4380,G
4-HA,887,4375,0,2,0,4377,A
4-HA,888,4389,0,3,0,4392,A
4-HA,889,0,4395,0,1,4396,T
4-HA,890,0,0,4341,0,4341,G
4-HA,891,0,1,0,4353,4354,C
4-HA,892,4368,0,1,0,4369,A
4-HA,893,1,4349,0,3,4353,T
4-HA,894,3,2,0,4351,4356,C
4-HA,895,4304,0,2,0,4306,A
4-HA,896,1,2,0,4472,4475,C
4-HA,897,0,4412,0,8,4420,T
4-HA,898,4,0,0,4467,4471,C
4-HA,899,4,0,0,4447,4451,C
4-HA,900,4498,0,0,0,4498,A
4-HA,901,4476,0,0,0,4476,A
4-HA,902,4471,0,1,1,4473,A
4-HA,903,0,4348,0,1,4349,T
4-HA,904,0,2,4380,0,4382,G
4-HA,905,0,2,4400,0,4402,G
4-HA,906,4372,1,3,0,4376,A
4-HA,907,4381,0,6,0,4387,A
4-HA,908,0,1,4396,0,4397,G
4-HA,909,3,2,0,4365,4370,C
4-HA,910,4351,0,0,0,4351,A
4-HA,911,0,4357,0,0,4357,T
4-HA,912,0,4334,0,0,4334,T
4-HA,913,1,1,0,4463,4465,C
4-HA,914,3,0,1,4440,4444,C
4-HA,915,4,0,0,4454,4458,C
4-HA,916,4452,0,2,0,4454,A
4-HA,917,4531,0,0,0,4531,A
4-HA,918,0,4601,0,1,4602,T
4-HA,919,0,4,4592,0,4596,G
4-HA,920,4585,0,0,0,4585,A
4-HA,921,0,2,0,4583,4585,C
4-HA,922,4495,0,1,0,4496,A
4-HA,923,4503,0,2,1,4506,A
4-HA,924,4466,0,2,0,4468,A
4-HA,925,1,0,0,4511,4512,C
4-HA,926,5,0,0,4445,4450,C
4-HA,927,4398,0,0,0,4398,A
4-HA,928,0,4391,0,1,4392,T
4-HA,929,0,4371,0,1,4372,T
4-HA,930,7,1,0,4401,4409,C
4-HA,931,2,2,1,4410,4415,C
4-HA,932,4423,0,0,0,4423,A
4-HA,933,4410,0,0,0,4410,A
4-HA,934,4403,0,2,0,4405,A
4-HA,935,4458,0,1,0,4459,A
4-HA,936,0,4433,0,0,4433,T
4-HA,937,3,0,4445,0,4448,G
4-HA,938,0,4424,0,2,4426,T
4-HA,939,4468,0,0,0,4468,A
4-HA,940,4478,0,0,0,4478,A
4-HA,941,4462,0,0,1,4463,A
4-HA,942,0,0,0,4472,4472,C
4-HA,943,4400,0,2,0,4402,A
4-HA,944,0,4,4477,0,4481,G
4-HA,945,1,0,4496,0,4497,G
4-HA,946,4583,1,6,0,4590,A
4-HA,947,1,4565,0,4,4570,T
4-HA,948,19,3,0,4614,4636,C
4-HA,949,4639,0,4,1,4644,A
4-HA,950,1,2,0,4805,4808,C
4-HA,951,4794,0,1,0,4795,A
4-HA,952,0,4941,0,0,4941,T
4-HA,953,4793,0,3,0,4796,A
4-HA,954,1,3,0,4768,4772,C
4-HA,955,2,5,4608,0,4615,G
4-HA,956,2,1,4587,0,4590,G
4-HA,957,0,2,4566,0,4568,G
4-HA,958,1,0,4573,0,4574,G
4-HA,959,0,2,0,4508,4510,C
4-HA,960,1,5,0,4522,4528,C
4-HA,961,1,4441,0,5,4447,T
4-HA,962,3,0,4797,0,4800,G
4-HA,963,0,4767,0,4,4771,T
4-HA,964,2,1,0,4787,4790,C
4-HA,965,1,0,0,4804,4805,C
4-HA,966,1,0,0,4807,4808,C
4-HA,967,4785,2,1,0,4788,A
4-HA,968,0,0,4818,0,4818,G
4-HA,969,4810,0,1,0,4811,A
4-HA,970,0,4796,1,2,4799,T
4-HA,971,4447,1,3,0,4451,A
4-HA,972,1,4388,0,13,4402,T
4-HA,973,2,0,4407,0,4409,G
4-HA,974,1,4385,0,0,4386,T
4-HA,975,1,4346,1,1,4349,T
4-HA,976,4400,0,2,0,4402,A
4-HA,977,4342,0,2,0,4344,A
4-HA,978,2,9,4356,0,4367,G
4-HA,979,1,0,0,4364,4365,C
4-HA,980,4305,0,0,0,4305,A
4-HA,981,4298,1,2,1,4302,A
4-HA,982,4271,0,1,0,4272,A
4-HA,983,4277,0,2,0,4279,A
4-HA,984,0,0,0,4282,4282,C
4-HA,985,4231,0,0,0,4231,A
4-HA,986,0,0,0,4289,4289,C
4-HA,987,0,4225,0,0,4225,T
4-HA,988,3,0,0,4257,4260,C
4-HA,989,0,4264,0,1,4265,T
4-HA,990,2,2,4286,0,4290,G
4-HA,991,4289,1,1,0,4291,A
4-HA,992,4285,0,1,0,4286,A
4-HA,993,4281,0,0,0,4281,A
4-HA,994,0,4254,0,0,4254,T
4-HA,995,0,4222,0,3,4225,T
4-HA,996,1,0,4257,0,4258,G
4-HA,997,0,2,4233,0,4235,G
4-HA,998,0,0,0,4256,4256,C
4-HA,999,4241,0,1,2,4244,A
4-HA,1000,4221,1,1,1,4224,A
4-HA,1001,1,2,0,4231,4234,C
4-HA,1002,4219,1,2,1,4223,A
4-HA,1003,1,10,4252,0,4263,G
4-HA,1004,0,4,4233,0,4237,G
4-HA,1005,0,2,4201,0,4203,G
4-HA,1006,4158,0,4,0,4162,A
4-HA,1007,1,4164,0,2,4167,T
4-HA,1008,0,0,4199,0,4199,G
4-HA,1009,1,2,0,4183,4186,C
4-HA,1010,0,2,4223,0,4225,G
4-HA,1011,4256,0,1,1,4258,A
4-HA,1012,4202,0,0,0,4202,A
4-HA,1013,4244,0,0,0,4244,A
4-HA,1014,0,4193,0,0,4193,T
4-HA,1015,0,1,4279,1,4281,G
4-HA,1016,1,4251,0,1,4253,T
4-HA,1017,4244,2,4,0,4250,A
4-HA,1018,1,1,0,4240,4242,C
4-HA,1019,1,1,0,4245,4247,C
4-HA,1020,4189,0,1,0,4190,A
4-HA,1021,0,3,4168,2,4173,G
4-HA,1022,4124,0,0,0,4124,A
4-HA,1023,3,3,4161,0,4167,G
4-HA,1024,4114,0,2,1,4117,A
4-HA,1025,4107,1,6,1,4115,A
4-HA,1026,4100,0,6,1,4107,A
4-HA,1027,0,1,0,4110,4111,C
4-HA,1028,4111,0,0,0,4111,A
4-HA,1029,4148,1,0,1,4150,A
4-HA,1030,4129,0,0,1,4130,A
4-HA,1031,0,2,0,4161,4163,C
4-HA,1032,0,4150,0,0,4150,T
4-HA,1033,4134,0,0,0,4134,A
4-HA,1034,0,1,4126,0,4127,G
4-HA,1035,4092,0,2,0,4094,A
4-HA,1036,0,1,4179,0,4180,G
4-HA,1037,3,3,4161,0,4167,G
4-HA,1038,2,1,0,4116,4119,C
4-HA,1039,4116,0,1,2,4119,A
4-HA,1040,1,4114,0,1,4116,T
4-HA,1041,4162,0,0,1,4163,A
4-HA,1042,0,4141,1,1,4143,T
4-HA,1043,0,4140,0,2,4142,T
4-HA,1044,0,4144,0,0,4144,T
4-HA,1045,3,3,4044,0,4050,G
4-HA,1046,0,0,4045,0,4045,G
4-HA,1047,2,3,0,4010,4015,C
4-HA,1048,2,1,4027,0,4030,G
4-HA,1049,1,0,0,3990,3991,C
4-HA,1050,3969,1,1,0,3971,A
4-HA,1051,3993,1,0,0,3994,A
4-HA,1052,0,3981,2,0,3983,T
4-HA,1053,3,2,0,4010,4015,C
4-HA,1054,1,1,4018,0,4020,G
4-HA,1055,1,3,0,3989,3993,C
4-HA,1056,1,10,4018,0,4029,G
4-HA,1057,0,0,4042,0,4042,G
4-HA,1058,1,1,4052,0,4054,G
4-HA,1059,0,4013,1,3,4017,T
4-HA,1060,1,3995,2,1,3999,T
4-HA,1061,0,4002,1,0,4003,T
4-HA,1062,3,0,1,4012,4016,C
4-HA,1063,4026,1,3,0,4030,A
4-HA,1064,1,4022,2,1,4026,T
4-HA,1065,4022,0,1,0,4023,A
4-HA,1066,0,2,4049,0,4051,G
4-HA,1067,3967,0,0,0,3967,A
4-HA,1068,4005,0,2,0,4007,A
4-HA,1069,3994,0,0,0,3994,A
4-HA,1070,3998,0,2,0,4000,A
4-HA,1071,0,4004,0,0,4004,T
4-HA,1072,2,3,4046,0,4051,G
4-HA,1073,0,1,4054,0,4055,G
4-HA,1074,0,4009,0,0,4009,T
4-HA,1075,0,3999,1,0,4000,T
4-HA,1076,0,8,3999,0,4007,G
4-HA,1077,1,5,4015,0,4021,G
4-HA,1078,0,1,4034,0,4035,G
4-HA,1079,3972,0,12,1,3985,A
4-HA,1080,1,1,4019,0,4021,G
4-HA,1081,0,4,3975,0,3979,G
4-HA,1082,1,4,4004,0,4009,G
4-HA,1083,3978,0,2,1,3981,A
4-HA,1084,4026,0,0,0,4026,A
4-HA,1085,0,4029,0,1,4030,T
4-HA,1086,2,4,4026,0,4032,G
4-HA,1087,0,0,4083,0,4083,G
4-HA,1088,0,4029,0,2,4031,T
4-HA,1089,1,4,4043,0,4048,G
4-HA,1090,0,1,4036,1,4038,G
4-HA,1091,3935,1,3,0,3939,A
4-HA,1092,0,3974,0,1,3975,T
4-HA,1093,0,2,4014,0,4016,G
4-HA,1094,1,0,4051,0,4052,G
4-HA,1095,0,3959,1,0,3960,T
4-HA,1096,0,3907,0,2,3909,T
4-HA,1097,0,4,3889,0,3893,G
4-HA,1098,1,0,3950,0,3951,G
4-HA,1099,0,3915,0,0,3915,T
4-HA,1100,3940,0,3,0,3943,A
4-HA,1101,0,3,0,3767,3770,C
4-HA,1102,1,5,3800,0,3806,G
4-HA,1103,0,1,3918,0,3919,G
4-HA,1104,0,3887,2,5,3894,T
4-HA,1105,0,3908,0,0,3908,T
4-HA,1106,1,3885,0,0,3886,T
4-HA,1107,2,0,0,3831,3833,C
4-HA,1108,3828,3,3,1,3835,A
4-HA,1109,13,1,3820,0,3834,G
4-HA,1110,3,0,3821,0,3824,G
4-HA,1111,1,2,0,3805,3808,C
4-HA,1112,3683,0,0,1,3684,A
4-HA,1113,1,3717,0,2,3720,T
4-HA,1114,4,1,0,3725,3730,C
4-HA,1115,3743,1,0,0,3744,A
4-HA,1116,3737,0,0,0,3737,A
4-HA,1117,3739,0,2,1,3742,A
4-HA,1118,3760,0,0,0,3760,A
4-HA,1119,0,3737,0,0,3737,T
4-HA,1120,1,3730,0,0,3731,T
4-HA,1121,1,2,0,3750,3753,C
4-HA,1122,1,3739,0,0,3740,T
4-HA,1123,0,2,3756,0,3758,G
4-HA,1124,3730,0,9,1,3740,A
4-HA,1125,1,6,3743,0,3750,G
4-HA,1126,0,3,3743,1,3747,G
4-HA,1127,1,0,3769,0,3770,G
4-HA,1128,3742,0,2,0,3744,A
4-HA,1129,3745,0,2,0,3747,A
4-HA,1130,0,5,3737,0,3742,G
4-HA,1131,3774,0,5,0,3779,A
4-HA,1132,0,5,3787,0,3792,G
4-HA,1133,0,3,3800,1,3804,G
4-HA,1134,3779,0,2,0,3781,A
4-HA,1135,0,2,0,3785,3787,C
4-HA,1136,3758,0,2,0,3760,A
4-HA,1137,3744,1,5,0,3750,A
4-HA,1138,1,0,3748,0,3749,G
4-HA,1139,0,1,0,3760,3761,C
4-HA,1140,3717,0,2,0,3719,A
4-HA,1141,1,2,3709,0,3712,G
4-HA,1142,1,1,0,3687,3689,C
4-HA,1143,3695,0,1,0,3696,A
4-HA,1144,0,2,3725,0,3727,G
4-HA,1145,3682,0,1,0,3683,A
4-HA,1146,0,3733,0,3,3736,T
4-HA,1147,0,0,0,3758,3758,C
4-HA,1148,0,3720,0,6,3726,T
4-HA,1149,5,1,0,3773,3779,C
4-HA,1150,3776,0,0,0,3776,A
4-HA,1151,3780,0,0,0,3780,A
4-HA,1152,3769,0,3,0,3772,A
4-HA,1153,3728,1,6,0,3735,A
4-HA,1154,0,0,3736,0,3736,G
4-HA,1155,0,2,0,3651,3653,C
4-HA,1156,3646,1,2,0,3649,A
4-HA,1157,0,0,0,3709,3709,C
4-HA,1158,1,3677,0,2,3680,T
4-HA,1159,3,1,0,3684,3688,C
4-HA,1160,3704,0,0,0,3704,A
4-HA,1161,3758,0,2,1,3761,A
4-HA,1162,0,1,3762,0,3763,G
4-HA,1163,4,0,0,3763,3767,C
4-HA,1164,3745,0,3,0,3748,A
4-HA,1165,0,1,3744,0,3745,G
4-HA,1166,1,0,0,3690,3691,C
4-HA,1167,3700,0,1,0,3701,A
4-HA,1168,3675,1,2,0,3678,A
4-HA,1169,0,3625,0,0,3625,T
4-HA,1170,2,0,0,3588,3590,C
4-HA,1171,1,6,3608,0,3615,G
4-HA,1172,3588,0,10,0,3598,A
4-HA,1173,0,3581,0,3,3584,T
4-HA,1174,6,1,0,3565,3572,C
4-HA,1175,3568,0,0,0,3568,A
4-HA,1176,3646,0,1,0,3647,A
4-HA,1177,3648,0,0,0,3648,A
4-HA,1178,0,3620,0,3,3623,T
4-HA,1179,2,0,0,3647,3649,C
4-HA,1180,3597,0,1,0,3598,A
4-HA,1181,3619,0,2,0,3621,A
4-HA,1182,0,3610,0,1,3611,T
4-HA,1183,0,2,3612,1,3615,G
4-HA,1184,2,1,3584,0,3587,G
4-HA,1185,3,3,3542,0,3548,G
4-HA,1186,3544,1,1,0,3546,A
4-HA,1187,3537,0,3,0,3540,A
4-HA,1188,0,0,3595,0,3595,G
4-HA,1189,0,0,0,3596,3596,C
4-HA,1190,0,3576,0,4,3580,T
4-HA,1191,1,3,3692,0,3696,G
4-HA,1192,3692,0,3,0,3695,A
4-HA,1193,3703,0,1,0,3704,A
4-HA,1194,0,3699,0,0,3699,T
4-HA,1195,3630,0,1,0,3631,A
4-HA,1196,0,6,3616,0,3622,G
4-HA,1197,3340,1,5,0,3346,A
4-HA,1198,0,3358,0,0,3358,T
4-HA,1199,0,3373,1,0,3374,T
4-HA,1200,0,1,3381,0,3382,G
4-HA,1201,3356,0,0,0,3356,A
4-HA,1202,0,3338,0,0,3338,T
4-HA,1203,2,1,0,3361,3364,C
4-HA,1204,1,1,3363,0,3365,G
4-HA,1205,0,1,3349,0,3350,G
4-HA,1206,1,0,3361,0,3362,G
4-HA,1207,3360,0,0,0,3360,A
4-HA,1208,3364,0,2,2,3368,A
4-HA,1209,3341,0,1,0,3342,A
4-HA,1210,3324,0,2,0,3326,A
4-HA,1211,0,1,0,3352,3353,C
4-HA,1212,1,0,0,3353,3354,C
4-HA,1213,3345,0,1,0,3346,A
4-HA,1214,3315,0,1,0,3316,A
4-HA,1215,0,3,0,3341,3344,C
4-HA,1216,1,4,3345,0,3350,G
4-HA,1217,3343,0,1,0,3344,A
4-HA,1218,1,2,3339,0,3342,G
4-HA,1219,3323,0,0,1,3324,A
4-HA,1220,3320,0,0,0,3320,A
4-HA,1221,3317,0,0,0,3317,A
4-HA,1222,0,3314,0,3,3317,T
4-HA,1223,2,3299,0,2,3303,T
4-HA,1224,3,0,0,3308,3311,C
4-HA,1225,2,3,0,3314,3319,C
4-HA,1226,3326,0,0,0,3326,A
4-HA,1227,0,3294,0,2,3296,T
4-HA,1228,1,0,0,3319,3320,C
4-HA,1229,3291,0,1,1,3293,A
4-HA,1230,0,1,3317,0,3318,G
4-HA,1231,3287,0,0,0,3287,A
4-HA,1232,0,3287,0,1,3288,T
4-HA,1233,1,3273,0,1,3275,T
4-HA,1234,1,2,3281,0,3284,G
4-HA,1235,3283,0,0,1,3284,A
4-HA,1236,3295,0,0,0,3295,A
4-HA,1237,3291,1,2,0,3294,A
4-HA,1238,3290,0,0,0,3290,A
4-HA,1239,3241,0,2,1,3244,A
4-HA,1240,2,1,3241,0,3244,G
4-HA,1241,3239,0,1,0,3240,A
4-HA,1242,3239,0,0,0,3239,A
4-HA,1243,0,3180,0,1,3181,T
4-HA,1244,0,3192,0,0,3192,T
4-HA,1245,0,0,0,3202,3202,C
4-HA,1246,0,3195,1,2,3198,T
4-HA,1247,1,0,1,3192,3194,C
4-HA,1248,3190,0,1,0,3191,A
4-HA,1249,1,3,3193,0,3197,G
4-HA,1250,3177,1,1,0,3179,A
4-HA,1251,3157,0,1,0,3158,A
4-HA,1252,1,0,3198,0,3199,G
4-HA,1253,0,3154,1,1,3156,T
4-HA,1254,6,0,1,3170,3177,C
4-HA,1255,0,2,3168,0,3170,G
4-HA,1256,3155,0,0,0,3155,A
4-HA,1257,3162,1,4,1,3168,A
4-HA,1258,1,6,3163,0,3170,G
4-HA,1259,1,1,3167,0,3169,G
4-HA,1260,0,5,3162,0,3167,G
4-HA,1261,3102,0,4,0,3106,A
4-HA,1262,2,1,3115,0,3118,G
4-HA,1263,3112,0,2,0,3114,A
4-HA,1264,3268,0,0,0,3268,A
4-HA,1265,0,3247,0,0,3247,T
4-HA,1266,0,3236,0,0,3236,T
4-HA,1267,3,0,0,3227,3230,C
4-HA,1268,3148,0,6,0,3154,A
4-HA,1269,1,3,3164,0,3168,G
4-HA,1270,1,2,3144,1,3148,G
4-HA,1271,3104,0,2,0,3106,A
4-HA,1272,1,1,0,3148,3150,C
4-HA,1273,1,0,0,2912,2913,C
4-HA,1274,1,2895,1,3,2900,T
4-HA,1275,0,2813,0,103,2916,T
4-HA,1276,1,3,2916,0,2920,G
4-HA,1277,2916,0,0,0,2916,A
4-HA,1278,0,0,2960,1,2961,G
4-HA,1279,2931,0,1,0,2932,A
4-HA,1280,2544,0,0,0,2544,A
4-HA,1281,2501,0,2,0,2503,A
4-HA,1282,0,2466,0,0,2466,T
4-HA,1283,2508,0,2,0,2510,A
4-HA,1284,0,2489,0,0,2489,T
4-HA,1285,2,0,2512,0,2514,G
4-HA,1286,0,2501,1,1,2503,T
4-HA,1287,0,2445,1,1,2447,T
4-HA,1288,2,1,2439,0,2442,G
4-HA,1289,2409,0,1,1,2411,A
4-HA,1290,1,1,2412,0,2414,G
4-HA,1291,3,4,2404,0,2411,G
4-HA,1292,2356,0,0,0,2356,A
4-HA,1293,0,1,0,2445,2446,C
4-HA,1294,2401,0,0,0,2401,A
4-HA,1295,0,1,0,2403,2404,C
4-HA,1296,0,2396,0,2,2398,T
4-HA,1297,2521,1,1,0,2523,A
4-HA,1298,2560,0,0,0,2560,A
4-HA,1299,2555,0,0,0,2555,A
4-HA,1300,2585,0,0,0,2585,A
4-HA,1301,0,2582,0,0,2582,T
4-HA,1302,2464,0,0,0,2464,A
4-HA,1303,0,3,2474,0,2477,G
4-HA,1304,2400,0,0,0,2400,A
4-HA,1305,0,2417,0,1,2418,T
4-HA,1306,0,0,0,2416,2416,C
4-HA,1307,0,2367,0,0,2367,T
4-HA,1308,4,0,0,2437,2441,C
4-HA,1309,0,2436,0,0,2436,T
4-HA,1310,0,2,2482,0,2484,G
4-HA,1311,1,0,2522,0,2523,G
4-HA,1312,0,2514,0,4,2518,T
4-HA,1313,1,0,0,2527,2528,C
4-HA,1314,2531,1,1,0,2533,A
4-HA,1315,0,2532,0,5,2537,T
4-HA,1316,2542,0,0,0,2542,A
4-HA,1317,0,0,0,2543,2543,C
4-HA,1318,2474,0,0,0,2474,A
4-HA,1319,2471,0,3,0,2474,A
4-HA,1320,0,1,0,2384,2385,C
4-HA,1321,1,1,2375,0,2377,G
4-HA,1322,0,0,0,2391,2391,C
4-HA,1323,0,3,2358,0,2361,G
4-HA,1324,0,3,2362,0,2365,G
4-HA,1325,2368,0,1,0,2369,A
4-HA,1326,0,0,2409,0,2409,G
4-HA,1327,0,0,0,2418,2418,C
4-HA,1328,0,2414,0,6,2420,T
4-HA,1329,1,2425,0,4,2430,T
4-HA,1330,10,1,0,2421,2432,C
4-HA,1331,0,2445,0,0,2445,T
4-HA,1332,0,2450,0,1,2451,T
4-HA,1333,0,0,2448,0,2448,G
4-HA,1334,0,2429,0,1,2430,T
4-HA,1335,0,2396,0,0,2396,T
4-HA,1336,0,0,2430,0,2430,G
4-HA,1337,0,1,1,2414,2416,C
4-HA,1338,1,0,0,2424,2425,C
4-HA,1339,6,1,0,2425,2432,C
4-HA,1340,0,2429,0,5,2434,T
4-HA,1341,0,3,2459,0,2462,G
4-HA,1342,0,0,2461,0,2461,G
4-HA,1343,2462,0,0,0,2462,A
4-HA,1344,0,3,2471,0,2474,G
4-HA,1345,2440,0,2,0,2442,A
4-HA,1346,2444,0,2,0,2446,A
4-HA,1347,1,1,0,2481,2483,C
4-HA,1348,2,0,0,2482,2484,C
4-HA,1349,2490,0,1,0,2491,A
4-HA,1350,2571,0,0,0,2571,A
4-HA,1351,0,1,0,2580,2581,C
4-HA,1352,2595,0,1,0,2596,A
4-HA,1353,0,2589,0,0,2589,T
4-HA,1354,2579,0,2,0,2581,A
4-HA,1355,0,2,0,2622,2624,C
4-HA,1356,2591,1,0,0,2592,A
4-HA,1357,2588,0,1,0,2589,A
4-HA,1358,0,2565,0,2,2567,T
4-HA,1359,3,2464,0,0,2467,T
4-HA,1360,0,1,2501,0,2502,G
4-HA,1361,2526,0,0,0,2526,A
4-HA,1362,0,2511,0,2,2513,T
4-HA,1363,1,0,0,2523,2524,C
4-HA,1364,0,2497,0,1,2498,T
4-HA,1365,2515,0,0,0,2515,A
4-HA,1366,2509,0,2,0,2511,A
4-HA,1367,0,0,0,2508,2508,C
4-HA,1368,0,2490,0,1,2491,T
4-HA,1369,2,2,2490,0,2494,G
4-HA,1370,2497,0,3,0,2500,A
4-HA,1371,0,0,0,2496,2496,C
4-HA,1372,0,2490,0,4,2494,T
4-HA,1373,3,0,0,2511,2514,C
4-HA,1374,2509,0,0,0,2509,A
4-HA,1375,0,1,2558,0,2559,G
4-HA,1376,2552,0,2,0,2554,A
4-HA,1377,2554,0,0,0,2554,A
4-HA,1378,2560,0,0,0,2560,A
4-HA,1379,0,2553,0,0,2553,T
4-HA,1380,1,2,2583,0,2586,G
4-HA,1381,2577,0,2,0,2579,A
4-HA,1382,2587,0,2,1,2590,A
4-HA,1383,1,2,1,2592,2596,C
4-HA,1384,2552,0,0,0,2552,A
4-HA,1385,2552,0,1,0,2553,A
4-HA,1386,2547,0,0,1,2548,A
4-HA,1387,0,2,0,2558,2560,C
4-HA,1388,0,2528,0,2,2530,T
4-HA,1389,0,0,2557,0,2557,G
4-HA,1390,0,2518,2,0,2520,T
4-HA,1391,0,2528,0,0,2528,T
4-HA,1392,0,2537,0,4,2541,T
4-HA,1393,1,2,2547,0,2550,G
4-HA,1394,2540,0,1,0,2541,A
4-HA,1395,2539,0,1,0,2540,A
4-HA,1396,2539,0,0,0,2539,A
4-HA,1397,2544,0,1,0,2545,A
4-HA,1398,2527,0,1,0,2528,A
4-HA,1399,2533,0,1,0,2534,A
4-HA,1400,1,0,0,2547,2548,C
4-HA,1401,2540,0,0,0,2540,A
4-HA,1402,2543,0,0,0,2543,A
4-HA,1403,2540,0,3,1,2544,A
4-HA,1404,2,1,2548,0,2551,G
4-HA,1405,2551,1,2,0,2554,A
4-HA,1406,2541,0,1,0,2542,A
4-HA,1407,2,1,2529,0,2532,G
4-HA,1408,1,0,0,2535,2536,C
4-HA,1409,2547,0,1,0,2548,A
4-HA,1410,2568,0,0,0,2568,A
4-HA,1411,0,2,0,2552,2554,C
4-HA,1412,0,2544,0,0,2544,T
4-HA,1413,2,2,2563,0,2567,G
4-HA,1414,2532,1,5,0,2538,A
4-HA,1415,0,1,2550,0,2551,G
4-HA,1416,0,1,2552,0,2553,G
4-HA,1417,1,2,2551,1,2555,G
4-HA,1418,2557,0,0,0,2557,A
4-HA,1419,2538,0,1,0,2539,A
4-HA,1420,2538,0,2,0,2540,A
4-HA,1421,2565,0,0,0,2565,A
4-HA,1422,1,2552,0,0,2553,T
4-HA,1423,0,0,2559,0,2559,G
4-HA,1424,0,1,0,2549,2550,C
4-HA,1425,0,2532,0,1,2533,T
4-HA,1426,2,1,2543,0,2546,G
4-HA,1427,2549,0,1,0,2550,A
4-HA,1428,0,2,2655,0,2657,G
4-HA,1429,0,1,2686,2,2689,G
4-HA,1430,2667,0,0,0,2667,A
4-HA,1431,0,2658,0,0,2658,T
4-HA,1432,2641,0,2,0,2643,A
4-HA,1433,0,2621,0,0,2621,T
4-HA,1434,0,1,2672,0,2673,G
4-HA,1435,1,0,2687,0,2688,G
4-HA,1436,4,1,2685,0,2690,G
4-HA,1437,1,1,0,2577,2579,C
4-HA,1438,2532,0,0,0,2532,A
4-HA,1439,2529,0,0,0,2529,A
4-HA,1440,1,2518,0,0,2519,T
4-HA,1441,0,0,2531,0,2531,G
4-HA,1442,2,0,2523,0,2525,G
4-HA,1443,0,2486,0,1,2487,T
4-HA,1444,0,2446,0,0,2446,T
4-HA,1445,1,0,2452,0,2453,G
4-HA,1446,0,2464,1,2,2467,T
4-HA,1447,0,2470,0,2,2472,T
4-HA,1448,0,2464,0,0,2464,T
4-HA,1449,3,1,0,2479,2483,C
4-HA,1450,2472,1,1,0,2474,A
4-HA,1451,2480,0,0,0,2480,A
4-HA,1452,2480,0,0,0,2480,A
4-HA,1453,2511,0,0,0,2511,A
4-HA,1454,0,2485,1,0,2486,T
4-HA,1455,2469,0,0,0,2469,A
4-HA,1456,0,2475,0,0,2475,T
4-HA,1457,2439,2,0,0,2441,A
4-HA,1458,0,3,0,2487,2490,C
4-HA,1459,3,0,0,2481,2484,C
4-HA,1460,2483,0,1,0,2484,A
4-HA,1461,0,0,0,2488,2488,C
4-HA,1462,2483,0,2,0,2485,A
4-HA,1463,2482,0,0,0,2482,A
4-HA,1464,2487,0,6,0,2493,A
4-HA,1465,0,2483,1,0,2484,T
4-HA,1466,0,0,2495,0,2495,G
4-HA,1467,0,2452,0,2,2454,T
4-HA,1468,1,3,2475,0,2479,G
4-HA,1469,2474,0,5,1,2480,A
4-HA,1470,0,1,0,2472,2473,C
4-HA,1471,2443,0,1,0,2444,A
4-HA,1472,2443,0,1,0,2444,A
4-HA,1473,0,2477,0,2,2479,T
4-HA,1474,2,0,2496,0,2498,G
4-HA,1475,0,1,0,2459,2460,C
4-HA,1476,1,0,0,2486,2487,C
4-HA,1477,1,2474,0,3,2478,T
4-HA,1478,0,0,2559,0,2559,G
4-HA,1479,0,0,0,2566,2566,C
4-HA,1480,2575,0,0,0,2575,A
4-HA,1481,1,2576,0,0,2577,T
4-HA,1482,2499,0,0,0,2499,A
4-HA,1483,1,2,2501,0,2504,G
4-HA,1484,0,1,2500,0,2501,G
4-HA,1485,2493,0,1,0,2494,A
4-HA,1486,0,2468,0,0,2468,T
4-HA,1487,2,0,0,2345,2347,C
4-HA,1488,2353,0,0,0,2353,A
4-HA,1489,2354,0,1,0,2355,A
4-HA,1490,1,2347,0,0,2348,T
4-HA,1491,1,1,0,2360,2362,C
4-HA,1492,2332,0,0,0,2332,A
4-HA,1493,0,0,2343,0,2343,G
4-HA,1494,2353,0,1,0,2354,A
4-HA,1495,2353,0,1,0,2354,A
4-HA,1496,2350,0,2,0,2352,A
4-HA,1497,0,2329,0,1,2330,T
4-HA,1498,0,1,2318,0,2319,G
4-HA,1499,0,2,2330,0,2332,G
4-HA,1500,2327,0,1,0,2328,A
4-HA,1501,2346,0,1,0,2347,A
4-HA,1502,1,1,0,2344,2346,C
4-HA,1503,0,2314,2,0,2316,T
4-HA,1504,0,2339,0,0,2339,T
4-HA,1505,2333,0,0,0,2333,A
4-HA,1506,1,2326,0,3,2330,T
4-HA,1507,0,7,2320,0,2327,G
4-HA,1508,2311,0,2,0,2313,A
4-HA,1509,0,1,0,2304,2305,C
4-HA,1510,1,0,0,2299,2300,C
4-HA,1511,2294,0,0,0,2294,A
4-HA,1512,0,1,0,2336,2337,C
4-HA,1513,3,2,2401,0,2406,G
4-HA,1514,2441,0,1,0,2442,A
4-HA,1515,0,2463,0,0,2463,T
4-HA,1516,1,1,2546,0,2548,G
4-HA,1517,0,2528,0,1,2529,T
4-HA,1518,2608,0,3,0,2611,A
4-HA,1519,0,2604,0,2,2606,T
4-HA,1520,2601,1,0,0,2602,A
4-HA,1521,0,1,0,2598,2599,C
4-HA,1522,2331,0,0,0,2331,A
4-HA,1523,0,0,2348,0,2348,G
4-HA,1524,2202,0,0,0,2202,A
4-HA,1525,0,0,2141,0,2141,G
4-HA,1526,2133,0,0,0,2133,A
4-HA,1527,0,1949,0,0,1949,T
4-HA,1528,0,1,1940,0,1941,G
4-HA,1529,1938,0,2,0,1940,A
4-HA,1530,1927,0,3,0,1930,A
4-HA,1531,0,0,1960,0,1960,G
4-HA,1532,1,0,0,1920,1921,C
4-HA,1533,1915,0,0,0,1915,A
4-HA,1534,1,1897,0,0,1898,T
4-HA,1535,0,1893,0,1,1894,T
4-HA,1536,1901,0,1,0,1902,A
4-HA,1537,1893,0,0,0,1893,A
4-HA,1538,1897,0,1,0,1898,A
4-HA,1539,1,0,0,1896,1897,C
4-HA,1540,1814,0,0,0,1814,A
4-HA,1541,1818,0,0,0,1818,A
4-HA,1542,0,1,0,1815,1816,C
4-HA,1543,1,1,0,1805,1807,C
4-HA,1544,0,0,1809,0,1809,G
4-HA,1545,0,1,1820,0,1821,G
4-HA,1546,0,1818,0,2,1820,T
4-HA,1547,0,1814,0,0,1814,T
4-HA,1548,0,1788,0,2,1790,T
4-HA,1549,0,0,0,1806,1806,C
4-HA,1550,1799,0,2,0,1801,A
4-HA,1551,0,5,1809,0,1814,G
4-HA,1552,1819,0,0,0,1819,A
4-HA,1553,0,1802,0,0,1802,T
4-HA,1554,3,0,0,1753,1756,C
4-HA,1555,1747,0,0,0,1747,A
4-HA,1556,1756,0,0,0,1756,A
4-HA,1557,1,3,1744,0,1748,G
4-HA,1558,0,2,1738,0,1740,G
4-HA,1559,0,0,1737,0,1737,G
4-HA,1560,1693,0,0,0,1693,A
4-HA,1561,0,0,1703,0,1703,G
4-HA,1562,0,1711,0,0,1711,T
4-HA,1563,0,1707,0,0,1707,T
4-HA,1564,1,0,1717,0,1718,G
4-HA,1565,1704,1,4,0,1709,A
4-HA,1566,0,0,1714,0,1714,G
4-HA,1567,0,0,0,1707,1707,C
4-HA,1568,1,1689,0,2,1692,T
4-HA,1569,0,2,1688,0,1690,G
4-HA,1570,1686,0,1,0,1687,A
4-HA,1571,1699,0,2,0,1701,A
4-HA,1572,0,0,1698,0,1698,G
4-HA,1573,0,1663,0,0,1663,T
4-HA,1574,1,0,0,1660,1661,C
4-HA,1575,1626,0,4,1,1631,A
4-HA,1576,0,3,1634,0,1637,G
4-HA,1577,0,2,1630,0,1632,G
4-HA,1578,0,0,1595,0,1595,G
4-HA,1579,0,1648,0,1,1649,T
4-HA,1580,1648,0,1,0,1649,A
4-HA,1581,0,2,0,1646,1648,C
4-HA,1582,1644,0,0,0,1644,A
4-HA,1583,1644,0,0,0,1644,A
4-HA,1584,1642,0,1,0,1643,A
4-HA,1585,0,0,1657,0,1657,G
4-HA,1586,1610,1,1,0,1612,A
4-HA,1587,0,1540,0,3,1543,T
4-HA,1588,0,1529,0,0,1529,T
4-HA,1589,0,1,1534,0,1535,G
4-HA,1590,0,4,1529,0,1533,G
4-HA,1591,1536,1,0,0,1537,A
4-HA,1592,0,1537,0,0,1537,T
4-HA,1593,35,0,0,1500,1535,C
4-HA,1594,0,2,1,1496,1499,C
4-HA,1595,0,1484,0,0,1484,T
4-HA,1596,1494,0,0,0,1494,A
4-HA,1597,0,1494,0,0,1494,T
4-HA,1598,0,0,1479,0,1479,G
4-HA,1599,0,0,1479,0,1479,G
4-HA,1600,1446,0,0,0,1446,A
4-HA,1601,0,1447,0,1,1448,T
4-HA,1602,0,1412,1,1,1414,T
4-HA,1603,0,1406,0,0,1406,T
4-HA,1604,0,2,0,1400,1402,C
4-HA,1605,0,0,0,1401,1401,C
4-HA,1606,0,1397,0,0,1397,T
4-HA,1607,0,1389,0,0,1389,T
4-HA,1608,0,1379,0,0,1379,T
4-HA,1609,0,0,1385,0,1385,G
4-HA,1610,0,0,0,1390,1390,C
4-HA,1611,1,1,1,1390,1393,C
4-HA,1612,1367,0,0,0,1367,A
4-HA,1613,1,1362,0,0,1363,T
4-HA,1614,1376,0,0,0,1376,A
4-HA,1615,0,1368,0,1,1369,T
4-HA,1616,1,0,0,1371,1372,C
4-HA,1617,1362,0,1,0,1363,A
4-HA,1618,0,1349,1,0,1350,T
4-HA,1619,0,0,1354,0,1354,G
4-HA,1620,0,1348,0,0,1348,T
4-HA,1621,0,1323,0,0,1323,T
4-HA,1622,0,1331,0,0,1331,T
4-HA,1623,0,1291,0,0,1291,T
4-HA,1624,0,1292,0,0,1292,T
4-HA,1625,0,1295,0,0,1295,T
4-HA,1626,0,0,1295,0,1295,G
4-HA,1627,0,0,0,1285,1285,C
4-HA,1628,0,1249,0,0,1249,T
4-HA,1629,0,1251,0,0,1251,T
4-HA,1630,0,1248,0,0,1248,T
4-HA,1631,0,0,1266,0,1266,G
4-HA,1632,0,1262,0,0,1262,T
4-HA,1633,1,0,1261,0,1262,G
4-HA,1634,0,1259,0,3,1262,T
4-HA,1635,0,1224,0,1,1225,T
4-HA,1636,0,1,1232,0,1233,G
4-HA,1637,0,0,0,1226,1226,C
4-HA,1638,0,1223,0,1,1224,T
4-HA,1639,0,1233,0,0,1233,T
4-HA,1640,0,1165,0,0,1165,T
4-HA,1641,2,1,1175,0,1178,G
4-HA,1642,0,1173,0,0,1173,T
4-HA,1643,0,1173,0,0,1173,T
4-HA,1644,1,0,1173,0,1174,G
4-HA,1645,0,0,1141,0,1141,G
4-HA,1646,1,2,1133,0,1136,G
4-HA,1647,0,0,1145,0,1145,G
4-HA,1648,0,1118,0,2,1120,T
4-HA,1649,0,1108,0,1,1109,T
4-HA,1650,1,0,0,1092,1093,C
4-HA,1651,1082,0,0,0,1082,A
4-HA,1652,0,1081,0,0,1081,T
4-HA,1653,2,0,1,1076,1079,C
4-HA,1654,1067,0,0,0,1067,A
4-HA,1655,0,1032,0,0,1032,T
4-HA,1656,0,1,1023,0,1024,G
4-HA,1657,0,1006,0,1,1007,T
4-HA,1658,1,1,989,0,991,G
4-HA,1659,0,0,955,0,955,G
4-HA,1660,0,0,953,0,953,G
4-HA,1661,0,0,0,915,915,C
4-HA,1662,0,0,0,893,893,C
4-HA,1663,0,853,0,2,855,T
4-HA,1664,0,0,857,0,857,G
4-HA,1665,0,1,0,845,846,C
4-HA,1666,0,0,0,855,855,C
4-HA,1667,851,0,0,0,851,A
4-HA,1668,836,0,0,0,836,A
4-HA,1669,836,0,0,0,836,A
4-HA,1670,830,0,0,0,830,A
4-HA,1671,831,0,0,0,831,A
4-HA,1672,0,1,832,0,833,G
4-HA,1673,2,0,797,0,799,G
4-HA,1674,0,0,0,789,789,C
4-HA,1675,791,0,2,0,793,A
4-HA,1676,789,0,0,1,790,A
4-HA,1677,0,1,0,788,789,C
4-HA,1678,790,0,0,0,790,A
4-HA,1679,0,787,0,0,787,T
4-HA,1680,0,771,0,0,771,T
4-HA,1681,741,0,1,0,742,A
4-HA,1682,0,0,739,0,739,G
4-HA,1683,0,1,736,0,737,G
4-HA,1684,0,713,0,0,713,T
4-HA,1685,0,0,658,0,658,G
4-HA,1686,0,0,0,633,633,C
4-HA,1687,629,0,0,0,629,A
4-HA,1688,626,0,0,0,626,A
4-HA,1689,0,1,0,623,624,C
4-HA,1690,614,0,0,0,614,A
4-HA,1691,0,597,0,0,597,T
4-HA,1692,0,559,0,0,559,T
4-HA,1693,0,559,0,0,559,T
4-HA,1694,0,0,554,0,554,G
4-HA,1695,0,1,0,551,552,C
4-HA,1696,551,0,0,0,551,A
4-HA,1697,0,517,0,0,517,T
4-HA,1698,0,500,0,0,500,T
4-HA,1699,0,479,0,0,479,T
4-HA,1700,0,0,483,0,483,G
4-HA,1701,469,0,0,0,469,A
5-NP,1,271,0,0,0,271,A
5-NP,2,0,272,0,0,272,T
5-NP,3,0,0,270,0,270,G
5-NP,4,0,0,267,0,267,G
5-NP,5,0,0,0,277,277,C
5-NP,6,0,0,280,0,280,G
5-NP,7,0,288,0,0,288,T
5-NP,8,0,0,0,293,293,C
5-NP,9,1,0,0,293,294,C
5-NP,10,0,0,0,296,296,C
5-NP,11,291,0,0,0,291,A
5-NP,12,290,0,0,0,290,A
5-NP,13,0,1,296,0,297,G
5-NP,14,0,0,304,0,304,G
5-NP,15,0,0,0,312,312,C
5-NP,16,309,0,0,0,309,A
5-NP,17,0,0,0,317,317,C
5-NP,18,0,0,0,314,314,C
5-NP,19,316,0,0,0,316,A
5-NP,20,316,0,1,0,317,A
5-NP,21,318,0,0,0,318,A
5-NP,22,0,0,0,318,318,C
5-NP,23,0,0,318,0,318,G
5-NP,24,0,0,349,0,349,G
5-NP,25,0,347,0,0,347,T
5-NP,26,0,0,0,381,381,C
5-NP,27,0,377,0,0,377,T
5-NP,28,0,387,0,0,387,T
5-NP,29,389,0,0,0,389,A
5-NP,30,0,387,0,0,387,T
5-NP,31,0,0,392,0,392,G
5-NP,32,391,0,0,0,391,A
5-NP,33,387,0,0,0,387,A
5-NP,34,0,0,0,392,392,C
5-NP,35,382,1,0,0,383,A
5-NP,36,0,0,415,0,415,G
5-NP,37,406,0,0,0,406,A
5-NP,38,0,414,0,0,414,T
5-NP,39,1,0,416,0,417,G
5-NP,40,0,1,415,0,416,G
5-NP,41,414,0,0,0,414,A
5-NP,42,421,0,0,0,421,A
5-NP,43,420,0,0,0,420,A
5-NP,44,0,0,0,434,434,C
5-NP,45,0,428,0,0,428,T
5-NP,46,0,0,437,0,437,G
5-NP,47,430,0,0,0,430,A
5-NP,48,0,437,0,0,437,T
5-NP,49,0,1,434,0,435,G
5-NP,50,0,0,438,0,438,G
5-NP,51,0,1,431,0,432,G
5-NP,52,0,0,437,0,437,G
5-NP,53,435,0,0,0,435,A
5-NP,54,0,438,0,0,438,T
5-NP,55,0,1,0,437,438,C
5-NP,56,0,0,441,0,441,G
5-NP,57,0,0,0,441,441,C
5-NP,58,0,0,0,442,442,C
5-NP,59,440,0,0,0,440,A
5-NP,60,0,0,445,0,445,G
5-NP,61,446,0,0,0,446,A
5-NP,62,456,0,0,0,456,A
5-NP,63,0,456,0,1,457,T
5-NP,64,0,0,453,0,453,G
5-NP,65,0,0,0,460,460,C
5-NP,66,457,0,0,0,457,A
5-NP,67,459,0,0,0,459,A
5-NP,68,0,0,0,460,460,C
5-NP,69,0,458,0,1,459,T
5-NP,70,0,0,460,0,460,G
5-NP,71,467,0,1,0,468,A
5-NP,72,0,0,496,0,496,G
5-NP,73,493,0,0,0,493,A
5-NP,74,0,495,0,0,495,T
5-NP,75,0,493,0,0,493,T
5-NP,76,494,0,1,0,495,A
5-NP,77,0,0,497,0,497,G
5-NP,78,0,0,498,0,498,G
5-NP,79,0,0,495,0,495,G
5-NP,80,0,0,0,494,494,C
5-NP,81,486,0,0,0,486,A
5-NP,82,0,481,0,0,481,T
5-NP,83,0,1,0,485,486,C
5-NP,84,0,0,0,488,488,C
5-NP,85,0,0,493,0,493,G
5-NP,86,0,492,0,0,492,T
5-NP,87,0,0,0,493,493,C
5-NP,88,1,2,496,0,499,G
5-NP,89,0,1,502,0,503,G
5-NP,90,0,0,506,0,506,G
5-NP,91,502,1,0,0,503,A
5-NP,92,504,0,0,0,504,A
5-NP,93,9,0,497,0,506,G
5-NP,94,505,0,0,0,505,A
5-NP,95,0,509,0,0,509,T
5-NP,96,0,0,508,0,508,G
5-NP,97,511,0,0,0,511,A
5-NP,98,0,508,0,0,508,T
5-NP,99,0,504,0,0,504,T
5-NP,100,0,1,501,0,502,G
5-NP,101,504,0,0,0,504,A
5-NP,102,0,504,0,1,505,T
5-NP,103,0,0,506,0,506,G
5-NP,104,1,0,522,0,523,G
5-NP,105,522,0,0,0,522,A
5-NP,106,524,0,0,0,524,A
5-NP,107,0,524,0,0,524,T
5-NP,108,0,526,0,0,526,T
5-NP,109,0,1,524,0,525,G
5-NP,110,0,0,525,0,525,G
5-NP,111,0,0,525,0,525,G
5-NP,112,521,1,0,0,522,A
5-NP,113,0,0,525,0,525,G
5-NP,114,526,0,0,0,526,A
5-NP,115,0,536,0,0,536,T
5-NP,116,0,539,0,0,539,T
5-NP,117,1,0,0,538,539,C
5-NP,118,0,538,0,0,538,T
5-NP,119,545,0,0,0,545,A
5-NP,120,0,0,0,549,549,C
5-NP,121,567,0,0,0,567,A
5-NP,122,0,565,0,0,565,T
5-NP,123,0,0,0,555,555,C
5-NP,124,0,1,0,559,560,C
5-NP,125,558,0,0,0,558,A
5-NP,126,571,0,0,0,571,A
5-NP,127,572,0,0,0,572,A
5-NP,128,0,570,0,0,570,T
5-NP,129,0,0,571,0,571,G
5-NP,130,0,559,0,0,559,T
5-NP,131,0,0,563,0,563,G
5-NP,132,0,0,0,564,564,C
5-NP,133,563,0,0,0,563,A
5-NP,134,0,0,0,563,563,C
5-NP,135,0,553,0,0,553,T
5-NP,136,0,0,581,0,581,G
5-NP,137,588,0,0,0,588,A
5-NP,138,596,0,0,0,596,A
5-NP,139,0,0,0,613,613,C
5-NP,140,0,614,0,0,614,T
5-NP,141,0,616,0,0,616,T
5-NP,142,614,0,0,0,614,A
5-NP,143,613,0,0,0,613,A
5-NP,144,619,0,0,0,619,A
5-NP,145,0,0,0,613,613,C
5-NP,146,0,601,0,0,601,T
5-NP,147,0,1,0,607,608,C
5-NP,148,597,0,0,0,597,A
5-NP,149,0,0,602,0,602,G
5-NP,150,0,605,0,0,605,T
5-NP,151,0,0,611,0,611,G
5-NP,152,612,0,0,0,612,A
5-NP,153,0,621,0,0,621,T
5-NP,154,0,0,0,629,629,C
5-NP,155,626,0,0,0,626,A
5-NP,156,0,626,0,1,627,T
5-NP,157,0,1,629,0,630,G
5-NP,158,623,0,0,0,623,A
5-NP,159,621,0,0,0,621,A
5-NP,160,0,1,621,0,622,G
5-NP,161,0,0,608,0,608,G
5-NP,162,1,0,612,0,613,G
5-NP,163,0,0,0,613,613,C
5-NP,164,0,0,621,0,621,G
5-NP,165,0,0,623,0,623,G
5-NP,166,0,622,0,0,622,T
5-NP,167,0,621,0,0,621,T
5-NP,168,0,1,618,0,619,G
5-NP,169,685,0,0,0,685,A
5-NP,170,0,686,0,0,686,T
5-NP,171,0,0,0,684,684,C
5-NP,172,0,0,1,686,687,C
5-NP,173,682,0,0,0,682,A
5-NP,174,0,1,688,1,690,G
5-NP,175,685,0,0,0,685,A
5-NP,176,688,0,0,0,688,A
5-NP,177,0,0,0,693,693,C
5-NP,178,657,0,0,0,657,A
5-NP,179,0,0,662,0,662,G
5-NP,180,0,0,0,659,659,C
5-NP,181,0,662,0,0,662,T
5-NP,182,0,666,0,0,666,T
5-NP,183,0,1,669,0,670,G
5-NP,184,671,0,2,0,673,A
5-NP,185,0,1,0,669,670,C
5-NP,186,672,0,0,0,672,A
5-NP,187,675,0,1,0,676,A
5-NP,188,0,672,0,0,672,T
5-NP,189,668,0,0,0,668,A
5-NP,190,0,0,669,0,669,G
5-NP,191,660,0,1,0,661,A
5-NP,192,1,1,660,0,662,G
5-NP,193,664,0,0,0,664,A
5-NP,194,665,0,0,0,665,A
5-NP,195,667,0,0,0,667,A
5-NP,196,681,0,0,0,681,A
5-NP,197,0,679,0,0,679,T
5-NP,198,0,0,682,0,682,G
5-NP,199,0,0,678,0,678,G
5-NP,200,0,667,0,1,668,T
5-NP,201,655,0,0,0,655,A
5-NP,202,0,0,0,667,667,C
5-NP,203,0,672,0,0,672,T
5-NP,204,0,0,0,683,683,C
5-NP,205,0,674,0,0,674,T
5-NP,206,2,0,0,675,677,C
5-NP,207,0,676,0,0,676,T
5-NP,208,0,1,682,0,683,G
5-NP,209,0,0,0,679,679,C
5-NP,210,0,677,0,1,678,T
5-NP,211,0,677,0,0,677,T
5-NP,212,0,678,0,0,678,T
5-NP,213,0,672,0,1,673,T
5-NP,214,0,0,679,0,679,G
5-NP,215,673,0,0,2,675,A
5-NP,216,0,677,0,0,677,T
5-NP,217,0,0,672,0,672,G
5-NP,218,674,0,0,0,674,A
5-NP,219,670,0,1,0,671,A
5-NP,220,670,0,0,0,670,A
5-NP,221,0,0,669,0,669,G
5-NP,222,664,0,3,0,667,A
5-NP,223,666,0,1,1,668,A
5-NP,224,0,2,678,0,680,G
5-NP,225,0,1,690,0,691,G
5-NP,226,693,0,0,0,693,A
5-NP,227,701,0,1,0,702,A
5-NP,228,0,699,0,0,699,T
5-NP,229,698,0,0,1,699,A
5-NP,230,693,0,0,1,694,A
5-NP,231,698,0,0,0,698,A
5-NP,232,0,693,0,0,693,T
5-NP,233,682,0,0,1,683,A
5-NP,234,0,0,0,694,694,C
5-NP,235,1,0,0,687,688,C
5-NP,236,0,690,0,0,690,T
5-NP,237,0,1,692,0,693,G
5-NP,238,0,0,692,0,692,G
5-NP,239,695,0,0,0,695,A
5-NP,240,697,0,2,0,699,A
5-NP,241,0,0,704,0,704,G
5-NP,242,701,0,0,0,701,A
5-NP,243,699,0,1,0,700,A
5-NP,244,0,0,0,700,700,C
5-NP,245,691,0,1,1,693,A
5-NP,246,0,0,0,718,718,C
5-NP,247,0,0,0,705,705,C
5-NP,248,0,0,0,713,713,C
5-NP,249,0,1,0,715,716,C
5-NP,250,712,0,0,0,712,A
5-NP,251,0,0,711,0,711,G
5-NP,252,0,1,0,704,705,C
5-NP,253,0,0,703,0,703,G
5-NP,254,0,0,0,707,707,C
5-NP,255,2,1,699,0,702,G
5-NP,256,0,1,707,0,708,G
5-NP,257,1,2,707,0,710,G
5-NP,258,0,2,710,0,712,G
5-NP,259,712,0,0,0,712,A
5-NP,260,714,1,0,0,715,A
5-NP,261,713,0,1,0,714,A
5-NP,262,0,0,713,0,713,G
5-NP,263,706,1,0,0,707,A
5-NP,264,0,695,0,0,695,T
5-NP,265,1,0,0,698,699,C
5-NP,266,1,0,0,696,697,C
5-NP,267,1,0,0,706,707,C
5-NP,268,710,0,0,0,710,A
5-NP,269,713,0,0,0,713,A
5-NP,270,0,0,713,0,713,G
5-NP,271,714,0,0,0,714,A
5-NP,272,710,0,0,0,710,A
5-NP,273,713,0,0,0,713,A
5-NP,274,710,0,0,0,710,A
5-NP,275,0,0,0,711,711,C
5-NP,276,0,705,0,0,705,T
5-NP,277,0,0,709,0,709,G
5-NP,278,0,0,710,0,710,G
5-NP,279,0,0,706,0,706,G
5-NP,280,0,0,698,0,698,G
5-NP,281,0,0,711,0,711,G
5-NP,282,2,0,721,0,723,G
5-NP,283,1,0,0,756,757,C
5-NP,284,1,0,0,766,767,C
5-NP,285,2,0,0,766,768,C
5-NP,286,841,0,0,0,841,A
5-NP,287,0,842,0,0,842,T
5-NP,288,868,0,1,0,869,A
5-NP,289,0,874,0,0,874,T
5-NP,290,858,2,1,0,861,A
5-NP,291,0,0,0,866,866,C
5-NP,292,793,0,1,0,794,A
5-NP,293,0,0,816,0,816,G
5-NP,294,0,0,810,0,810,G
5-NP,295,762,0,0,0,762,A
5-NP,296,0,0,770,0,770,G
5-NP,297,744,0,0,0,744,A
5-NP,298,726,0,0,0,726,A
5-NP,299,0,746,1,0,747,T
5-NP,300,747,0,0,0,747,A
5-NP,301,0,0,746,0,746,G
5-NP,302,729,0,0,0,729,A
5-NP,303,0,723,0,0,723,T
5-NP,304,0,1,729,0,730,G
5-NP,305,0,0,727,0,727,G
5-NP,306,727,0,0,0,727,A
5-NP,307,734,0,1,0,735,A
5-NP,308,735,0,0,0,735,A
5-NP,309,740,0,0,0,740,A
5-NP,310,0,730,0,0,730,T
5-NP,311,0,0,739,0,739,G
5-NP,312,0,0,737,0,737,G
5-NP,313,736,0,0,0,736,A
5-NP,314,0,729,0,0,729,T
5-NP,315,0,0,735,0,735,G
5-NP,316,731,0,0,0,731,A
5-NP,317,0,0,732,0,732,G
5-NP,318,0,0,729,0,729,G
5-NP,319,0,0,737,0,737,G
5-NP,320,760,0,0,0,760,A
5-NP,321,751,0,1,0,752,A
5-NP,322,0,0,0,765,765,C
5-NP,323,0,761,0,0,761,T
5-NP,324,0,0,0,781,781,C
5-NP,325,1,0,792,0,793,G
5-NP,326,0,805,0,2,807,T
5-NP,327,0,0,0,814,814,C
5-NP,328,0,0,0,931,931,C
5-NP,329,0,926,0,1,927,T
5-NP,330,0,932,0,0,932,T
5-NP,331,0,932,0,0,932,T
5-NP,332,935,0,0,0,935,A
5-NP,333,0,940,0,0,940,T
5-NP,334,1,0,942,0,943,G
5-NP,335,940,0,4,0,944,A
5-NP,336,0,1,0,945,946,C
5-NP,337,928,0,1,0,929,A
5-NP,338,931,0,0,0,931,A
5-NP,339,930,0,0,0,930,A
5-NP,340,0,0,999,0,999,G
5-NP,341,995,0,0,0,995,A
5-NP,342,996,0,2,0,998,A
5-NP,343,0,0,1056,0,1056,G
5-NP,344,1068,0,0,0,1068,A
5-NP,345,1082,0,1,0,1083,A
5-NP,346,1080,0,0,0,1080,A
5-NP,347,0,1077,0,0,1077,T
5-NP,348,1080,0,1,0,1081,A
5-NP,349,1075,0,0,0,1075,A
5-NP,350,0,1,1100,0,1101,G
5-NP,351,1,0,1088,0,1089,G
5-NP,352,0,0,0,1088,1088,C
5-NP,353,0,1,1088,0,1089,G
5-NP,354,1096,1,0,0,1097,A
5-NP,355,1116,0,0,0,1116,A
5-NP,356,0,1108,0,0,1108,T
5-NP,357,2,0,0,1117,1119,C
5-NP,358,0,1117,0,0,1117,T
5-NP,359,0,4,1112,0,1116,G
5-NP,360,0,0,1109,0,1109,G
5-NP,361,0,1,0,1112,1113,C
5-NP,362,0,0,1112,0,1112,G
5-NP,363,0,0,0,1119,1119,C
5-NP,364,1,0,0,1115,1116,C
5-NP,365,1126,0,0,0,1126,A
5-NP,366,1153,0,0,0,1153,A
5-NP,367,0,0,1194,0,1194,G
5-NP,368,0,0,0,1192,1192,C
5-NP,369,4,0,0,1210,1214,C
5-NP,370,1220,0,0,0,1220,A
5-NP,371,1252,0,1,0,1253,A
5-NP,372,0,0,0,1273,1273,C
5-NP,373,1274,0,2,0,1276,A
5-NP,374,1310,0,0,0,1310,A
5-NP,375,0,1313,0,0,1313,T
5-NP,376,0,0,1346,0,1346,G
5-NP,377,0,0,1349,0,1349,G
5-NP,378,0,1334,0,0,1334,T
5-NP,379,1,1,1346,0,1348,G
5-NP,380,1341,0,0,0,1341,A
5-NP,381,1,0,1393,0,1394,G
5-NP,382,0,1,1391,0,1392,G
5-NP,383,1410,0,0,0,1410,A
5-NP,384,0,1587,0,1,1588,T
5-NP,385,0,0,1624,0,1624,G
5-NP,386,0,0,0,1633,1633,C
5-NP,387,0,1642,0,2,1644,T
5-NP,388,1661,0,0,0,1661,A
5-NP,389,0,0,0,1704,1704,C
5-NP,390,1699,0,1,0,1700,A
5-NP,391,0,1697,0,1,1698,T
5-NP,392,0,0,0,1691,1691,C
5-NP,393,0,1639,0,0,1639,T
5-NP,394,0,2,1696,0,1698,G
5-NP,395,2,1,1739,0,1742,G
5-NP,396,0,1740,1,1,1742,T
5-NP,397,0,0,0,1748,1748,C
5-NP,398,0,1745,0,1,1746,T
5-NP,399,1786,0,1,0,1787,A
5-NP,400,1789,0,1,0,1790,A
5-NP,401,0,0,0,1811,1811,C
5-NP,402,0,1804,0,2,1806,T
5-NP,403,3,0,0,1832,1835,C
5-NP,404,1824,0,2,0,1826,A
5-NP,405,0,0,0,1921,1921,C
5-NP,406,1918,0,0,0,1918,A
5-NP,407,0,1926,0,1,1927,T
5-NP,408,1907,0,1,0,1908,A
5-NP,409,1913,1,2,0,1916,A
5-NP,410,1,1937,0,1,1939,T
5-NP,411,0,2,1958,0,1960,G
5-NP,412,1949,0,1,1,1951,A
5-NP,413,0,1931,0,0,1931,T
5-NP,414,0,1900,0,0,1900,T
5-NP,415,0,1913,0,0,1913,T
5-NP,416,0,1,1895,0,1896,G
5-NP,417,1,1,1900,0,1902,G
5-NP,418,0,1,0,1901,1902,C
5-NP,419,1905,0,0,0,1905,A
5-NP,420,0,1912,0,1,1913,T
5-NP,421,0,1907,0,4,1911,T
5-NP,422,1,1,0,1910,1912,C
5-NP,423,1,0,1,1920,1922,C
5-NP,424,1965,0,0,0,1965,A
5-NP,425,1964,0,0,0,1964,A
5-NP,426,0,1962,0,0,1962,T
5-NP,427,0,1968,0,0,1968,T
5-NP,428,0,1967,0,1,1968,T
5-NP,429,1,0,1981,0,1982,G
5-NP,430,1983,0,0,0,1983,A
5-NP,431,1983,0,1,0,1984,A
5-NP,432,0,1995,0,0,1995,T
5-NP,433,0,3,1986,0,1989,G
5-NP,434,2071,0,2,0,2073,A
5-NP,435,0,2080,0,0,2080,T
5-NP,436,1,0,2105,1,2107,G
5-NP,437,0,0,0,2152,2152,C
5-NP,438,2143,1,0,0,2144,A
5-NP,439,2247,1,1,0,2249,A
5-NP,440,0,0,0,2251,2251,C
5-NP,441,2289,0,0,0,2289,A
5-NP,442,0,2334,0,0,2334,T
5-NP,443,2301,0,4,0,2305,A
5-NP,444,1,0,0,2339,2340,C
5-NP,445,2,1,0,2346,2349,C
5-NP,446,2314,0,0,0,2314,A
5-NP,447,0,1,2345,0,2346,G
5-NP,448,2307,0,0,0,2307,A
5-NP,449,0,3,2374,0,2377,G
5-NP,450,0,1,2356,0,2357,G
5-NP,451,2354,0,3,0,2357,A
5-NP,452,0,0,0,2372,2372,C
5-NP,453,2362,0,1,0,2363,A
5-NP,454,2353,0,4,0,2357,A
5-NP,455,0,2,2365,0,2367,G
5-NP,456,2361,0,1,0,2362,A
5-NP,457,0,0,2382,0,2382,G
5-NP,458,0,1,0,2369,2370,C
5-NP,459,0,2354,0,5,2359,T
5-NP,460,2,1,0,2363,2366,C
5-NP,461,0,2359,0,1,2360,T
5-NP,462,0,2371,0,0,2371,T
5-NP,463,0,1,2386,0,2387,G
5-NP,464,0,2383,0,0,2383,T
5-NP,465,0,2372,0,0,2372,T
5-NP,466,1,1,0,2382,2384,C
5-NP,467,0,3,2370,0,2373,G
5-NP,468,2392,0,2,0,2394,A
5-NP,469,2411,0,2,0,2413,A
5-NP,470,1,0,0,2434,2435,C
5-NP,471,0,2430,0,1,2431,T
5-NP,472,0,2,2450,0,2452,G
5-NP,473,0,1,2463,0,2464,G
5-NP,474,2459,0,1,0,2460,A
5-NP,475,2464,0,4,0,2468,A
5-NP,476,0,2450,0,0,2450,T
5-NP,477,0,5,2460,0,2465,G
5-NP,478,0,2,2462,0,2464,G
5-NP,479,2477,0,1,0,2478,A
5-NP,480,0,2498,0,0,2498,T
5-NP,481,3,1,0,2497,2501,C
5-NP,482,1,1,1,2514,2517,C
5-NP,483,1,0,0,2549,2550,C
5-NP,484,2575,0,0,0,2575,A
5-NP,485,0,0,2614,0,2614,G
5-NP,486,2610,0,0,1,2611,A
5-NP,487,2618,1,0,0,2619,A
5-NP,488,0,2600,0,0,2600,T
5-NP,489,0,1,2644,0,2645,G
5-NP,490,0,2615,0,0,2615,T
5-NP,491,1,2,2639,0,2642,G
5-NP,492,0,0,0,2651,2651,C
5-NP,493,0,2640,0,3,2643,T
5-NP,494,3,0,0,2833,2836,C
5-NP,495,1,2820,0,1,2822,T
5-NP,496,3,1,0,2980,2984,C
5-NP,497,0,2971,0,3,2974,T
5-NP,498,0,1,2997,0,2998,G
5-NP,499,3032,0,0,0,3032,A
5-NP,500,0,3007,0,2,3009,T
5-NP,501,1,1,3013,0,3015,G
5-NP,502,1,1,0,3017,3019,C
5-NP,503,2929,1,2,0,2932,A
5-NP,504,0,1,3038,0,3039,G
5-NP,505,0,2,2962,0,2964,G
5-NP,506,1,1,3007,0,3009,G
5-NP,507,0,1,0,3006,3007,C
5-NP,508,0,2998,0,1,2999,T
5-NP,509,0,4,1,3025,3030,C
5-NP,510,0,5,3019,0,3024,G
5-NP,511,3055,1,2,0,3058,A
5-NP,512,1,0,1,3072,3074,C
5-NP,513,0,3031,0,2,3033,T
5-NP,514,1,0,1,3199,3201,C
5-NP,515,0,3190,0,0,3190,T
5-NP,516,3,2,0,3631,3636,C
5-NP,517,1,0,0,3633,3634,C
5-NP,518,3,1,0,3647,3651,C
5-NP,519,0,3659,0,2,3661,T
5-NP,520,3635,0,4,0,3639,A
5-NP,521,0,1,3641,0,3642,G
5-NP,522,3608,0,1,0,3609,A
5-NP,523,3554,0,2,1,3557,A
5-NP,524,0,3,3585,1,3589,G
5-NP,525,0,0,3568,1,3569,G
5-NP,526,0,3500,0,0,3500,T
5-NP,527,0,0,0,3531,3531,C
5-NP,528,3,4,0,3537,3544,C
5-NP,529,1,1,3552,0,3554,G
5-NP,530,0,0,3566,1,3567,G
5-NP,531,3562,1,0,0,3563,A
5-NP,532,0,1,3620,0,3621,G
5-NP,533,0,2,0,3633,3635,C
5-NP,534,0,3585,0,1,3586,T
5-NP,535,0,0,3610,0,3610,G
5-NP,536,0,1,0,3611,3612,C
5-NP,537,3607,0,1,0,3608,A
5-NP,538,0,6,3629,0,3635,G
5-NP,539,0,2,3612,0,3614,G
5-NP,540,0,3529,0,3,3532,T
5-NP,541,1,2,3598,0,3601,G
5-NP,542,0,1,0,3606,3607,C
5-NP,543,0,3616,1,3,3620,T
5-NP,544,0,0,3636,0,3636,G
5-NP,545,2,0,1,3630,3633,C
5-NP,546,3690,0,1,0,3691,A
5-NP,547,0,3,3779,0,3782,G
5-NP,548,0,3748,0,3,3751,T
5-NP,549,5,0,0,3758,3763,C
5-NP,550,3769,0,0,0,3769,A
5-NP,551,3756,1,3,0,3760,A
5-NP,552,3746,2,9,0,3757,A
5-NP,553,0,5,3777,0,3782,G
5-NP,554,0,5,3793,0,3798,G
5-NP,555,3788,0,0,0,3788,A
5-NP,556,3776,0,1,0,3777,A
5-NP,557,0,3763,0,1,3764,T
5-NP,558,4,1,0,3767,3772,C
5-NP,559,4,6,3767,0,3777,G
5-NP,560,1,1,3870,0,3872,G
5-NP,561,2,2,3877,0,3881,G
5-NP,562,3850,0,0,0,3850,A
5-NP,563,0,0,0,3893,3893,C
5-NP,564,3872,0,0,0,3872,A
5-NP,565,3967,0,3,0,3970,A
5-NP,566,1,3987,0,1,3989,T
5-NP,567,0,2,4009,0,4011,G
5-NP,568,1,0,4049,0,4050,G
5-NP,569,1,3950,0,0,3951,T
5-NP,570,1,3,4023,0,4027,G
5-NP,571,4000,0,1,0,4001,A
5-NP,572,0,4025,0,0,4025,T
5-NP,573,0,1,4025,0,4026,G
5-NP,574,0,2,4108,0,4110,G
5-NP,575,4091,0,1,0,4092,A
5-NP,576,4124,0,0,0,4124,A
5-NP,577,0,1,0,4089,4090,C
5-NP,578,1,4067,2,0,4070,T
5-NP,579,4048,0,4,0,4052,A
5-NP,580,4202,0,2,0,4204,A
5-NP,581,0,4216,0,0,4216,T
5-NP,582,3,3,0,4224,4230,C
5-NP,583,4140,0,0,0,4140,A
5-NP,584,1,0,4206,0,4207,G
5-NP,585,4167,0,1,0,4168,A
5-NP,586,4175,0,1,0,4176,A
5-NP,587,0,4194,0,0,4194,T
5-NP,588,1,5,4177,0,4183,G
5-NP,589,1,1,4231,0,4233,G
5-NP,590,0,4201,0,7,4208,T
5-NP,591,7,2,0,4227,4236,C
5-NP,592,4244,0,0,0,4244,A
5-NP,593,4215,0,0,0,4215,A
5-NP,594,4250,0,0,0,4250,A
5-NP,595,0,5,1,4239,4245,C
5-NP,596,2,2,4233,1,4238,G
5-NP,597,0,0,4232,0,4232,G
5-NP,598,0,5,4175,0,4180,G
5-NP,599,1,5,4207,0,4213,G
5-NP,600,3,4,4234,0,4241,G
5-NP,601,4236,0,5,0,4241,A
5-NP,602,0,4210,0,4,4214,T
5-NP,603,1,2,0,4235,4238,C
5-NP,604,4237,0,2,0,4239,A
5-NP,605,4239,0,0,0,4239,A
5-NP,606,0,0,0,4213,4213,C
5-NP,607,0,3,4196,0,4199,G
5-NP,608,4161,0,1,0,4162,A
5-NP,609,0,4148,0,1,4149,T
5-NP,610,1,1,1,4168,4171,C
5-NP,611,0,2,4183,0,4185,G
5-NP,612,4155,1,0,0,4156,A
5-NP,613,4158,0,1,0,4159,A
5-NP,614,4168,0,0,0,4168,A
5-NP,615,0,4223,0,0,4223,T
5-NP,616,0,4232,1,3,4236,T
5-NP,617,0,4228,0,0,4228,T
5-NP,618,0,4244,0,0,4244,T
5-NP,619,0,4255,1,1,4257,T
5-NP,620,0,5,4248,1,4254,G
5-NP,621,0,1,4251,0,4252,G
5-NP,622,4220,0,0,0,4220,A
5-NP,623,0,5,4259,0,4264,G
5-NP,624,4186,0,1,0,4187,A
5-NP,625,1,4,4360,0,4365,G
5-NP,626,0,0,4370,0,4370,G
5-NP,627,2,4326,0,1,4329,T
5-NP,628,1,4,4390,0,4395,G
5-NP,629,4374,0,6,2,4382,A
5-NP,630,2,4,4416,0,4422,G
5-NP,631,4404,0,6,0,4410,A
5-NP,632,4390,0,1,0,4391,A
5-NP,633,0,4400,0,1,4401,T
5-NP,634,0,5,4278,0,4283,G
5-NP,635,1,2,4254,0,4257,G
5-NP,636,4202,1,11,0,4214,A
5-NP,637,1,3,0,4222,4226,C
5-NP,638,1,0,4224,0,4225,G
5-NP,639,1,3,4304,0,4308,G
5-NP,640,4295,0,2,0,4297,A
5-NP,641,4313,0,1,0,4314,A
5-NP,642,4348,0,2,0,4350,A
5-NP,643,4347,0,4,0,4351,A
5-NP,644,2,0,1,4411,4414,C
5-NP,645,4397,0,1,0,4398,A
5-NP,646,4393,0,1,0,4394,A
5-NP,647,1,7,4397,0,4405,G
5-NP,648,4271,1,1,0,4273,A
5-NP,649,4291,0,0,0,4291,A
5-NP,650,2,0,4374,0,4376,G
5-NP,651,0,4328,0,0,4328,T
5-NP,652,0,0,4576,0,4576,G
5-NP,653,0,2,0,4563,4565,C
5-NP,654,1,4573,0,3,4577,T
5-NP,655,0,4616,0,1,4617,T
5-NP,656,4664,1,0,0,4665,A
5-NP,657,0,4662,0,3,4665,T
5-NP,658,0,3,4687,0,4690,G
5-NP,659,4602,0,3,0,4605,A
5-NP,660,0,2,4609,0,4611,G
5-NP,661,4375,1,3,0,4379,A
5-NP,662,0,5,4398,0,4403,G
5-NP,663,4368,0,1,0,4369,A
5-NP,664,4417,0,1,0,4418,A
5-NP,665,0,4366,0,1,4367,T
5-NP,666,2,0,4434,0,4436,G
5-NP,667,0,4375,0,8,4383,T
5-NP,668,2,1,4408,0,4411,G
5-NP,669,1,1,0,4403,4405,C
5-NP,670,4393,0,0,0,4393,A
5-NP,671,4399,0,6,0,4405,A
5-NP,672,0,1,0,4397,4398,C
5-NP,673,4366,0,0,0,4366,A
5-NP,674,0,4377,0,0,4377,T
5-NP,675,0,4320,1,1,4322,T
5-NP,676,1,0,0,4329,4330,C
5-NP,677,0,4317,0,4,4321,T
5-NP,678,0,4329,0,5,4334,T
5-NP,679,4335,0,0,1,4336,A
5-NP,680,4318,0,0,0,4318,A
5-NP,681,4320,0,2,0,4322,A
5-NP,682,0,4,4320,0,4324,G
5-NP,683,0,2,4306,0,4308,G
5-NP,684,4291,1,2,0,4294,A
5-NP,685,4284,0,0,0,4284,A
5-NP,686,4277,0,0,0,4277,A
5-NP,687,4354,0,1,0,4355,A
5-NP,688,1,4338,0,0,4339,T
5-NP,689,0,4329,1,2,4332,T
5-NP,690,0,4334,0,1,4335,T
5-NP,691,2,3,0,4347,4352,C
5-NP,692,4355,0,0,0,4355,A
5-NP,693,4350,0,1,0,4351,A
5-NP,694,4330,0,1,0,4331,A
5-NP,695,1,1,0,4398,4400,C
5-NP,696,4350,1,0,0,4351,A
5-NP,697,0,0,4406,0,4406,G
5-NP,698,0,5,0,4410,4415,C
5-NP,699,0,4386,0,0,4386,T
5-NP,700,2,0,4489,0,4491,G
5-NP,701,0,1,0,4480,4481,C
5-NP,702,4519,2,3,0,4524,A
5-NP,703,0,0,0,4523,4523,C
5-NP,704,4488,1,2,0,4491,A
5-NP,705,4494,0,4,0,4498,A
5-NP,706,4422,0,5,0,4427,A
5-NP,707,0,5,4590,0,4595,G
5-NP,708,4574,1,5,0,4580,A
5-NP,709,1,0,4660,0,4661,G
5-NP,710,0,1,0,4661,4662,C
5-NP,711,4669,1,0,0,4670,A
5-NP,712,4796,0,6,0,4802,A
5-NP,713,0,4838,1,0,4839,T
5-NP,714,3,3,4840,0,4846,G
5-NP,715,1,0,4861,0,4862,G
5-NP,716,0,4705,0,3,4708,T
5-NP,717,2,3,4729,0,4734,G
5-NP,718,0,3,4734,0,4737,G
5-NP,719,4760,0,3,0,4763,A
5-NP,720,1,4744,0,1,4746,T
5-NP,721,4,0,0,4653,4657,C
5-NP,722,4672,0,0,0,4672,A
5-NP,723,4701,0,1,0,4702,A
5-NP,724,0,2,4737,0,4739,G
5-NP,725,0,4690,1,1,4692,T
5-NP,726,0,2,4713,0,4715,G
5-NP,727,4657,0,5,0,4662,A
5-NP,728,0,3,4670,0,4673,G
5-NP,729,4674,0,2,0,4676,A
5-NP,730,1,0,4674,0,4675,G
5-NP,731,4640,0,1,0,4641,A
5-NP,732,4584,0,1,0,4585,A
5-NP,733,4604,0,4,0,4608,A
5-NP,734,0,0,4627,0,4627,G
5-NP,735,1,4576,0,0,4577,T
5-NP,736,7,3,0,4607,4617,C
5-NP,737,3,4,4589,0,4596,G
5-NP,738,2,5,4585,1,4593,G
5-NP,739,4610,0,1,1,4612,A
5-NP,740,4623,0,2,0,4625,A
5-NP,741,0,1,0,4648,4649,C
5-NP,742,2,0,0,4615,4617,C
5-NP,743,8,1,1,4630,4640,C
5-NP,744,4635,0,3,0,4638,A
5-NP,745,0,2,4660,0,4662,G
5-NP,746,0,4,4650,0,4654,G
5-NP,747,4636,0,10,0,4646,A
5-NP,748,4639,0,1,1,4641,A
5-NP,749,4598,1,1,1,4601,A
5-NP,750,0,1,0,4631,4632,C
5-NP,751,2,0,4607,0,4609,G
5-NP,752,2,1,0,4594,4597,C
5-NP,753,0,4588,0,3,4591,T
5-NP,754,4,3,4603,0,4610,G
5-NP,755,4590,1,3,1,4595,A
5-NP,756,0,0,4670,0,4670,G
5-NP,757,4678,2,1,0,4681,A
5-NP,758,2,4646,0,0,4648,T
5-NP,759,3,1,0,4631,4635,C
5-NP,760,15,0,4640,0,4655,G
5-NP,761,4627,0,2,0,4629,A
5-NP,762,4634,0,0,1,4635,A
5-NP,763,0,2,4645,0,4647,G
5-NP,764,4654,0,1,0,4655,A
5-NP,765,0,4610,0,1,4611,T
5-NP,766,2,1,0,4659,4662,C
5-NP,767,0,4659,0,7,4666,T
5-NP,768,5,2,0,4704,4711,C
5-NP,769,4737,0,2,0,4739,A
5-NP,770,1,4730,0,3,4734,T
5-NP,771,4753,1,0,0,4754,A
5-NP,772,0,4742,0,0,4742,T
5-NP,773,0,4720,0,0,4720,T
5-NP,774,0,4714,0,0,4714,T
5-NP,775,1,4660,0,0,4661,T
5-NP,776,0,4667,0,0,4667,T
5-NP,777,4680,0,2,0,4682,A
5-NP,778,1,1,4665,0,4667,G
5-NP,779,0,0,0,4665,4665,C
5-NP,780,4671,0,2,1,4674,A
5-NP,781,4651,2,1,0,4654,A
5-NP,782,0,5,4824,0,4829,G
5-NP,783,4812,0,0,0,4812,A
5-NP,784,0,4804,0,0,4804,T
5-NP,785,4,1,0,4846,4851,C
5-NP,786,1,4825,0,4,4830,T
5-NP,787,2,1,4943,0,4946,G
5-NP,788,0,1,0,4958,4959,C
5-NP,789,4967,0,2,0,4969,A
5-NP,790,1,5015,1,0,5017,T
5-NP,791,0,4875,0,4,4879,T
5-NP,792,1,4,5143,0,5148,G
5-NP,793,5226,0,0,0,5226,A
5-NP,794,0,5221,0,0,5221,T
5-NP,795,5244,0,0,1,5245,A
5-NP,796,0,5116,0,1,5117,T
5-NP,797,0,5095,0,0,5095,T
5-NP,798,1,3,5130,0,5134,G
5-NP,799,5074,0,1,0,5075,A
5-NP,800,0,2,5107,0,5109,G
5-NP,801,4819,0,7,0,4826,A
5-NP,802,0,4,4761,0,4765,G
5-NP,803,0,3,4837,0,4840,G
5-NP,804,4816,0,2,0,4818,A
5-NP,805,1,4777,1,1,4780,T
5-NP,806,4,0,0,4819,4823,C
5-NP,807,4814,0,1,0,4815,A
5-NP,808,1,1,4826,0,4828,G
5-NP,809,0,4806,0,2,4808,T
5-NP,810,0,4770,0,1,4771,T
5-NP,811,0,1,4768,0,4769,G
5-NP,812,1,2,0,4747,4750,C
5-NP,813,0,4741,0,7,4748,T
5-NP,814,11,1,0,4759,4771,C
5-NP,815,4773,0,0,0,4773,A
5-NP,816,1,2,1,4790,4794,C
5-NP,817,4794,0,2,0,4796,A
5-NP,818,4819,0,0,1,4820,A
5-NP,819,4786,0,0,0,4786,A
5-NP,820,0,4769,1,1,4771,T
5-NP,821,2,0,0,4807,4809,C
5-NP,822,0,4803,0,1,4804,T
5-NP,823,0,4797,0,2,4799,T
5-NP,824,1,3,4817,0,4821,G
5-NP,825,2,0,0,4807,4809,C
5-NP,826,2,1,0,4855,4858,C
5-NP,827,0,4876,0,1,4877,T
5-NP,828,4824,1,1,0,4826,A
5-NP,829,1,0,0,4898,4899,C
5-NP,830,4,2,1,4903,4910,C
5-NP,831,0,4889,0,3,4892,T
5-NP,832,1,2,4962,0,4965,G
5-NP,833,0,2,0,4912,4914,C
5-NP,834,0,0,0,4948,4948,C
5-NP,835,1,4878,1,6,4886,T
5-NP,836,1,0,4941,0,4942,G
5-NP,837,0,4883,1,0,4884,T
5-NP,838,1,2,4967,0,4970,G
5-NP,839,1,4,0,4968,4973,C
5-NP,840,0,3,5077,0,5080,G
5-NP,841,1,4992,0,0,4993,T
5-NP,842,4987,2,3,0,4992,A
5-NP,843,0,4993,0,1,4994,T
5-NP,844,0,3,4985,0,4988,G
5-NP,845,1,5,5141,0,5147,G
5-NP,846,5115,1,2,0,5118,A
5-NP,847,0,1,0,5044,5045,C
5-NP,848,2,0,0,5032,5034,C
5-NP,849,2,4961,0,5,4968,T
5-NP,850,0,1,5195,0,5196,G
5-NP,851,0,1,0,5198,5199,C
5-NP,852,5228,0,6,0,5234,A
5-NP,853,1,1,5316,0,5318,G
5-NP,854,0,5096,0,1,5097,T
5-NP,855,5292,0,3,0,5295,A
5-NP,856,0,5273,0,4,5277,T
5-NP,857,0,0,0,5247,5247,C
5-NP,858,4,0,0,5270,5274,C
5-NP,859,5060,0,1,0,5061,A
5-NP,860,2,0,5076,0,5078,G
5-NP,861,0,5058,0,1,5059,T
5-NP,862,1,4,5095,0,5100,G
5-NP,863,1,4,5077,0,5082,G
5-NP,864,1,1,5006,0,5008,G
5-NP,865,0,4993,0,1,4994,T
5-NP,866,4990,0,0,0,4990,A
5-NP,867,1,8,0,4976,4985,C
5-NP,868,0,3,4966,0,4969,G
5-NP,869,4922,0,2,0,4924,A
5-NP,870,0,0,0,4944,4944,C
5-NP,871,0,4807,0,1,4808,T
5-NP,872,0,4801,0,2,4803,T
5-NP,873,4,0,0,4803,4807,C
5-NP,874,0,5,4803,0,4808,G
5-NP,875,4782,1,1,0,4784,A
5-NP,876,4805,0,1,1,4807,A
5-NP,877,4807,0,2,0,4809,A
5-NP,878,4804,0,0,0,4804,A
5-NP,879,4796,0,2,0,4798,A
5-NP,880,0,2,4824,0,4826,G
5-NP,881,4809,0,1,0,4810,A
5-NP,882,0,8,4837,1,4846,G
5-NP,883,0,6,4873,0,4879,G
5-NP,884,3,1,4899,0,4903,G
5-NP,885,4907,0,5,0,4912,A
5-NP,886,0,4902,1,0,4903,T
5-NP,887,4943,0,1,0,4944,A
5-NP,888,0,4915,0,2,4917,T
5-NP,889,0,4928,0,0,4928,T
5-NP,890,4,1,0,4989,4994,C
5-NP,891,2,0,1,4965,4968,C
5-NP,892,0,4900,0,0,4900,T
5-NP,893,0,4899,0,1,4900,T
5-NP,894,1,2,4956,0,4959,G
5-NP,895,1,0,4980,0,4981,G
5-NP,896,0,4921,0,1,4922,T
5-NP,897,1,4,4907,0,4912,G
5-NP,898,1,2,4871,0,4874,G
5-NP,899,1,0,5097,0,5098,G
5-NP,900,5072,0,5,0,5077,A
5-NP,901,5084,0,4,0,5088,A
5-NP,902,0,5103,0,1,5104,T
5-NP,903,5010,0,4,0,5014,A
5-NP,904,0,4,5001,0,5005,G
5-NP,905,4911,0,7,0,4918,A
5-NP,906,0,0,1,4921,4922,C
5-NP,907,3,0,0,4875,4878,C
5-NP,908,8,1,0,4789,4798,C
5-NP,909,0,4847,0,4,4851,T
5-NP,910,0,4851,0,1,4852,T
5-NP,911,0,4842,0,4,4846,T
5-NP,912,2,1,0,4857,4860,C
5-NP,913,4849,0,0,0,4849,A
5-NP,914,4860,1,1,0,4862,A
5-NP,915,4838,0,2,0,4840,A
5-NP,916,0,0,1,4845,4846,C
5-NP,917,1,4723,0,1,4725,T
5-NP,918,4709,0,2,0,4711,A
5-NP,919,0,1,0,4757,4758,C
5-NP,920,0,4733,2,1,4736,T
5-NP,921,1,4714,0,1,4716,T
5-NP,922,1,0,0,4759,4760,C
5-NP,923,4736,0,0,0,4736,A
5-NP,924,4743,0,0,0,4743,A
5-NP,925,4731,0,0,0,4731,A
5-NP,926,4717,1,0,0,4718,A
5-NP,927,1,4691,0,0,4692,T
5-NP,928,4617,0,3,0,4620,A
5-NP,929,1,0,4677,0,4678,G
5-NP,930,2,1,0,4693,4696,C
5-NP,931,0,2,0,4748,4750,C
5-NP,932,4765,0,1,0,4766,A
5-NP,933,4765,0,0,1,4766,A
5-NP,934,4931,1,2,0,4934,A
5-NP,935,0,4933,1,0,4934,T
5-NP,936,4971,0,1,0,4972,A
5-NP,937,0,4970,0,0,4970,T
5-NP,938,4877,0,1,0,4878,A
5-NP,939,0,0,0,4899,4899,C
5-NP,940,4799,0,1,1,4801,A
5-NP,941,0,1,4935,0,4936,G
5-NP,942,0,0,0,4918,4918,C
5-NP,943,1,4762,0,5,4768,T
5-NP,944,0,4820,1,0,4821,T
5-NP,945,4835,0,1,0,4836,A
5-NP,946,4833,0,0,0,4833,A
5-NP,947,0,4824,0,0,4824,T
5-NP,948,1,2,0,4825,4828,C
5-NP,949,4672,0,5,0,4677,A
5-NP,950,1,6,4727,0,4734,G
5-NP,951,4704,0,3,0,4707,A
5-NP,952,0,0,0,4746,4746,C
5-NP,953,2,0,0,4721,4723,C
5-NP,954,2,4666,0,4,4672,T
5-NP,955,4704,0,0,0,4704,A
5-NP,956,4699,0,1,0,4700,A
5-NP,957,2,1,0,4708,4711,C
5-NP,958,0,4,4708,0,4712,G
5-NP,959,4621,1,1,0,4623,A
5-NP,960,0,4,4637,1,4642,G
5-NP,961,4604,0,1,0,4605,A
5-NP,962,4644,0,0,0,4644,A
5-NP,963,0,4619,0,0,4619,T
5-NP,964,2,1,0,4576,4579,C
5-NP,965,3,1,0,4598,4602,C
5-NP,966,4536,0,4,0,4540,A
5-NP,967,1,0,4564,0,4565,G
5-NP,968,2,1,0,4560,4563,C
5-NP,969,4592,0,1,0,4593,A
5-NP,970,1,3,0,4631,4635,C
5-NP,971,4575,1,3,0,4579,A
5-NP,972,0,0,0,4593,4593,C
5-NP,973,4581,0,1,0,4582,A
5-NP,974,4598,0,4,0,4602,A
5-NP,975,2,3,4591,0,4596,G
5-NP,976,4559,0,2,0,4561,A
5-NP,977,1,0,4561,0,4562,G
5-NP,978,0,4465,0,3,4468,T
5-NP,979,6,0,0,4455,4461,C
5-NP,980,4461,0,2,0,4463,A
5-NP,981,1,0,4450,0,4451,G
5-NP,982,1,0,0,4431,4432,C
5-NP,983,0,4411,0,2,4413,T
5-NP,984,1,2,4434,0,4437,G
5-NP,985,2,0,4463,0,4465,G
5-NP,986,0,4410,0,1,4411,T
5-NP,987,1,0,4466,0,4467,G
5-NP,988,1,4414,0,1,4416,T
5-NP,989,0,3,4427,0,4430,G
5-NP,990,1,1,4429,0,4431,G
5-NP,991,4402,1,1,1,4405,A
5-NP,992,0,4393,0,4,4397,T
5-NP,993,2,6,4241,0,4249,G
5-NP,994,3,1,4222,0,4226,G
5-NP,995,0,2,0,4214,4216,C
5-NP,996,4185,0,5,0,4190,A
5-NP,997,0,4173,0,6,4179,T
5-NP,998,1,0,4163,0,4164,G
5-NP,999,2,4,0,4148,4154,C
5-NP,1000,6,0,0,4164,4170,C
5-NP,1001,4197,1,0,0,4198,A
5-NP,1002,0,4176,0,1,4177,T
5-NP,1003,0,4125,0,0,4125,T
5-NP,1004,0,0,0,4159,4159,C
5-NP,1005,0,4112,0,0,4112,T
5-NP,1006,0,0,4114,0,4114,G
5-NP,1007,0,0,0,4105,4105,C
5-NP,1008,1,3998,0,4,4003,T
5-NP,1009,1,0,4029,0,4030,G
5-NP,1010,0,1,0,3978,3979,C
5-NP,1011,3982,0,0,1,3983,A
5-NP,1012,0,3989,0,0,3989,T
5-NP,1013,0,3954,0,2,3956,T
5-NP,1014,0,3954,0,0,3954,T
5-NP,1015,1,4,3946,0,3951,G
5-NP,1016,3944,1,2,0,3947,A
5-NP,1017,3952,0,1,0,3953,A
5-NP,1018,2,2,3981,0,3985,G
5-NP,1019,3956,1,1,0,3958,A
5-NP,1020,1,3932,0,0,3933,T
5-NP,1021,1,3931,0,1,3933,T
5-NP,1022,0,3942,0,0,3942,T
5-NP,1023,3937,1,0,0,3938,A
5-NP,1024,3939,0,1,0,3940,A
5-NP,1025,1,0,3937,0,3938,G
5-NP,1026,3922,0,1,0,3923,A
5-NP,1027,0,3911,0,0,3911,T
5-NP,1028,0,3854,0,0,3854,T
5-NP,1029,2,0,3878,0,3880,G
5-NP,1030,1,3876,0,3,3880,T
5-NP,1031,0,3886,0,1,3887,T
5-NP,1032,3886,0,0,0,3886,A
5-NP,1033,3874,0,0,0,3874,A
5-NP,1034,1,0,3879,1,3881,G
5-NP,1035,0,1,0,3874,3875,C
5-NP,1036,0,3801,1,5,3807,T
5-NP,1037,0,3816,1,0,3817,T
5-NP,1038,5,0,0,3811,3816,C
5-NP,1039,3805,0,1,0,3806,A
5-NP,1040,0,3772,0,0,3772,T
5-NP,1041,0,0,1,3802,3803,C
5-NP,1042,3748,1,1,0,3750,A
5-NP,1043,0,2,3753,0,3755,G
5-NP,1044,3710,0,3,0,3713,A
5-NP,1045,0,5,3695,0,3700,G
5-NP,1046,0,8,3701,0,3709,G
5-NP,1047,1,4,3690,0,3695,G
5-NP,1048,3666,0,5,0,3671,A
5-NP,1049,0,0,0,3695,3695,C
5-NP,1050,3696,0,0,0,3696,A
5-NP,1051,3702,0,0,0,3702,A
5-NP,1052,3719,0,0,0,3719,A
5-NP,1053,3743,0,5,0,3748,A
5-NP,1054,1,0,3754,0,3755,G
5-NP,1055,0,3664,0,2,3666,T
5-NP,1056,3651,0,2,0,3653,A
5-NP,1057,0,3619,0,4,3623,T
5-NP,1058,2,0,0,3625,3627,C
5-NP,1059,3,3595,0,0,3598,T
5-NP,1060,2,0,0,3625,3627,C
5-NP,1061,3,0,0,3602,3605,C
5-NP,1062,0,3566,0,0,3566,T
5-NP,1063,0,0,0,3600,3600,C
5-NP,1064,0,3,3597,0,3600,G
5-NP,1065,0,1,3610,0,3611,G
5-NP,1066,0,3,3610,0,3613,G
5-NP,1067,2,4,3580,0,3586,G
5-NP,1068,0,3,3594,0,3597,G
5-NP,1069,3546,0,2,0,3548,A
5-NP,1070,3546,0,0,1,3547,A
5-NP,1071,3530,0,6,0,3536,A
5-NP,1072,0,1,0,3556,3557,C
5-NP,1073,0,3543,0,4,3547,T
5-NP,1074,1,1,3572,0,3574,G
5-NP,1075,0,3528,0,1,3529,T
5-NP,1076,2,1,1,3534,3538,C
5-NP,1077,3587,1,2,0,3590,A
5-NP,1078,3593,0,0,0,3593,A
5-NP,1079,2,0,0,3612,3614,C
5-NP,1080,0,3602,0,2,3604,T
5-NP,1081,3547,1,1,0,3549,A
5-NP,1082,3,2,3553,0,3558,G
5-NP,1083,3487,1,1,1,3490,A
5-NP,1084,0,3,3499,0,3502,G
5-NP,1085,0,3,3495,0,3498,G
5-NP,1086,3377,0,5,0,3382,A
5-NP,1087,0,0,3460,0,3460,G
5-NP,1088,0,3395,0,5,3400,T
5-NP,1089,3405,0,2,1,3408,A
5-NP,1090,0,2,0,3400,3402,C
5-NP,1091,3373,1,0,0,3374,A
5-NP,1092,3364,0,1,0,3365,A
5-NP,1093,3345,0,1,0,3346,A
5-NP,1094,1,3299,0,0,3300,T
5-NP,1095,1,3295,0,0,3296,T
5-NP,1096,0,3,3211,1,3215,G
5-NP,1097,0,0,0,3171,3171,C
5-NP,1098,0,3162,0,5,3167,T
5-NP,1099,0,3170,0,1,3171,T
5-NP,1100,2,1,0,3170,3173,C
5-NP,1101,3189,0,0,0,3189,A
5-NP,1102,3189,1,1,0,3191,A
5-NP,1103,3185,0,0,0,3185,A
5-NP,1104,0,3186,0,0,3186,T
5-NP,1105,0,3,3191,1,3195,G
5-NP,1106,3138,1,3,0,3142,A
5-NP,1107,1,2,3158,1,3162,G
5-NP,1108,3169,0,3,0,3172,A
5-NP,1109,3165,0,1,0,3166,A
5-NP,1110,0,0,0,3176,3176,C
5-NP,1111,3131,1,1,0,3133,A
5-NP,1112,0,3134,0,0,3134,T
5-NP,1113,3,1,3189,0,3193,G
5-NP,1114,0,1,3205,0,3206,G
5-NP,1115,3188,0,2,0,3190,A
5-NP,1116,0,3152,0,2,3154,T
5-NP,1117,3119,0,2,0,3121,A
5-NP,1118,3310,0,1,0,3311,A
5-NP,1119,0,3257,0,0,3257,T
5-NP,1120,3254,0,0,0,3254,A
5-NP,1121,1,3220,0,0,3221,T
5-NP,1122,1,6,3017,0,3024,G
5-NP,1123,0,1,2960,0,2961,G
5-NP,1124,2,1,2938,0,2941,G
5-NP,1125,2934,0,0,0,2934,A
5-NP,1126,0,2913,0,2,2915,T
5-NP,1127,3,1,1,2381,2386,C
5-NP,1128,3,0,2379,0,2382,G
5-NP,1129,2373,0,2,0,2375,A
5-NP,1130,1,0,2381,0,2382,G
5-NP,1131,1,1,0,2368,2370,C
5-NP,1132,2348,0,1,0,2349,A
5-NP,1133,0,0,0,2449,2449,C
5-NP,1134,0,2411,0,1,2412,T
5-NP,1135,4,2,0,2431,2437,C
5-NP,1136,0,2438,0,6,2444,T
5-NP,1137,0,2416,0,0,2416,T
5-NP,1138,0,3,2420,0,2423,G
5-NP,1139,2407,1,4,0,2412,A
5-NP,1140,2413,0,1,0,2414,A
5-NP,1141,0,0,1,2417,2418,C
5-NP,1142,0,2023,0,1,2024,T
5-NP,1143,1,1,2026,0,2028,G
5-NP,1144,1976,0,1,0,1977,A
5-NP,1145,1,0,1991,0,1992,G
5-NP,1146,1990,0,0,1,1991,A
5-NP,1147,1975,0,0,0,1975,A
5-NP,1148,0,0,1990,0,1990,G
5-NP,1149,0,2,0,1958,1960,C
5-NP,1150,4,3,1955,0,1962,G
5-NP,1151,0,1,1945,0,1946,G
5-NP,1152,0,1,1949,0,1950,G
5-NP,1153,0,1923,0,2,1925,T
5-NP,1154,1898,0,0,0,1898,A
5-NP,1155,0,0,0,1901,1901,C
5-NP,1156,0,1710,0,1,1711,T
5-NP,1157,0,0,1711,0,1711,G
5-NP,1158,1,0,1680,0,1681,G
5-NP,1159,1,0,1686,0,1687,G
5-NP,1160,0,0,1,1657,1658,C
5-NP,1161,0,0,0,1613,1613,C
5-NP,1162,1635,1,0,0,1636,A
5-NP,1163,0,1629,0,2,1631,T
5-NP,1164,1630,0,1,0,1631,A
5-NP,1165,1632,0,0,0,1632,A
5-NP,1166,1,1,1606,0,1608,G
5-NP,1167,1,1,1631,0,1633,G
5-NP,1168,1600,0,0,0,1600,A
5-NP,1169,0,0,0,1600,1600,C
5-NP,1170,2,1,0,1610,1613,C
5-NP,1171,1598,0,2,0,1600,A
5-NP,1172,0,3,1622,0,1625,G
5-NP,1173,0,0,1632,0,1632,G
5-NP,1174,1604,0,2,0,1606,A
5-NP,1175,1,0,1626,0,1627,G
5-NP,1176,0,1560,0,1,1561,T
5-NP,1177,0,0,1582,0,1582,G
5-NP,1178,0,1,1601,0,1602,G
5-NP,1179,1588,0,2,0,1590,A
5-NP,1180,0,1,1604,0,1605,G
5-NP,1181,0,1,1579,0,1580,G
5-NP,1182,1569,0,0,0,1569,A
5-NP,1183,1574,0,0,0,1574,A
5-NP,1184,1567,0,2,0,1569,A
5-NP,1185,0,1,0,1580,1581,C
5-NP,1186,1578,1,1,0,1580,A
5-NP,1187,0,0,0,1615,1615,C
5-NP,1188,0,1591,0,2,1593,T
5-NP,1189,1625,0,0,0,1625,A
5-NP,1190,1618,0,0,0,1618,A
5-NP,1191,0,1626,0,0,1626,T
5-NP,1192,1,0,0,1648,1649,C
5-NP,1193,1635,0,0,0,1635,A
5-NP,1194,1645,1,0,0,1646,A
5-NP,1195,2,2,0,1644,1648,C
5-NP,1196,1608,0,0,0,1608,A
5-NP,1197,0,4,1604,0,1608,G
5-NP,1198,1564,0,5,0,1569,A
5-NP,1199,0,1,1575,0,1576,G
5-NP,1200,0,1,1570,0,1571,G
5-NP,1201,0,0,1559,0,1559,G
5-NP,1202,0,1,0,1567,1568,C
5-NP,1203,1,0,0,1561,1562,C
5-NP,1204,0,1528,0,0,1528,T
5-NP,1205,2,0,0,1557,1559,C
5-NP,1206,0,3,0,1562,1565,C
5-NP,1207,1,0,1562,0,1563,G
5-NP,1208,0,0,0,1566,1566,C
5-NP,1209,1543,0,0,0,1543,A
5-NP,1210,0,2,1594,1,1597,G
5-NP,1211,1,0,1588,0,1589,G
5-NP,1212,1,0,0,1595,1596,C
5-NP,1213,1,0,0,1612,1613,C
5-NP,1214,1595,0,1,0,1596,A
5-NP,1215,1593,0,0,0,1593,A
5-NP,1216,1587,0,1,0,1588,A
5-NP,1217,0,0,0,1609,1609,C
5-NP,1218,1,0,0,1614,1615,C
5-NP,1219,1538,0,0,0,1538,A
5-NP,1220,0,0,1565,0,1565,G
5-NP,1221,1,1543,0,0,1544,T
5-NP,1222,0,0,1568,0,1568,G
5-NP,1223,0,1542,0,2,1544,T
5-NP,1224,1,1,1562,0,1564,G
5-NP,1225,0,0,0,1567,1567,C
5-NP,1226,1557,0,0,0,1557,A
5-NP,1227,1578,0,0,0,1578,A
5-NP,1228,0,0,0,1578,1578,C
5-NP,1229,1,0,0,1584,1585,C
5-NP,1230,0,1576,0,0,1576,T
5-NP,1231,1575,0,0,0,1575,A
5-NP,1232,1,1,0,1566,1568,C
5-NP,1233,0,0,1577,0,1577,G
5-NP,1234,0,1571,1,0,1572,T
5-NP,1235,0,1577,0,2,1579,T
5-NP,1236,0,1559,0,1,1560,T
5-NP,1237,0,1553,0,0,1553,T
5-NP,1238,0,0,0,1552,1552,C
5-NP,1239,0,1543,0,1,1544,T
5-NP,1240,0,0,1569,0,1569,G
5-NP,1241,0,1553,0,0,1553,T
5-NP,1242,1562,0,0,0,1562,A
5-NP,1243,0,0,0,1570,1570,C
5-NP,1244,1554,0,0,0,1554,A
5-NP,1245,1553,0,0,0,1553,A
5-NP,1246,1550,0,0,0,1550,A
5-NP,1247,0,0,1556,0,1556,G
5-NP,1248,1553,0,1,0,1554,A
5-NP,1249,1516,0,0,0,1516,A
5-NP,1250,1508,0,5,0,1513,A
5-NP,1251,1,0,0,1515,1516,C
5-NP,1252,0,0,0,1505,1505,C
5-NP,1253,0,1498,0,2,1500,T
5-NP,1254,1,0,0,1508,1509,C
5-NP,1255,1,1,0,1508,1510,C
5-NP,1256,3,0,0,1511,1514,C
5-NP,1257,1515,0,0,0,1515,A
5-NP,1258,1,1521,0,0,1522,T
5-NP,1259,0,1521,0,1,1522,T
5-NP,1260,0,1519,0,2,1521,T
5-NP,1261,2,1,1521,1,1525,G
5-NP,1262,1526,0,0,0,1526,A
5-NP,1263,1522,0,0,0,1522,A
5-NP,1264,1521,0,1,0,1522,A
5-NP,1265,1514,0,1,0,1515,A
5-NP,1266,1,0,1525,0,1526,G
5-NP,1267,0,1512,0,0,1512,T
5-NP,1268,2,0,0,1518,1520,C
5-NP,1269,1519,0,2,1,1522,A
5-NP,1270,1535,0,1,0,1536,A
5-NP,1271,0,1,0,1537,1538,C
5-NP,1272,0,1,0,1560,1561,C
5-NP,1273,1561,1,0,0,1562,A
5-NP,1274,0,1549,0,1,1550,T
5-NP,1275,0,1,0,1559,1560,C
5-NP,1276,1542,2,0,0,1544,A
5-NP,1277,0,1552,0,3,1555,T
5-NP,1278,0,1,1546,0,1547,G
5-NP,1279,0,0,1547,0,1547,G
5-NP,1280,0,0,0,1549,1549,C
5-NP,1281,1519,0,0,0,1519,A
5-NP,1282,0,0,1513,0,1513,G
5-NP,1283,1,0,0,1506,1507,C
5-NP,1284,1513,0,0,0,1513,A
5-NP,1285,0,1514,0,2,1516,T
5-NP,1286,0,1501,0,1,1502,T
5-NP,1287,0,0,0,1507,1507,C
5-NP,1288,1500,0,0,0,1500,A
5-NP,1289,0,1,0,1521,1522,C
5-NP,1290,1,1519,0,0,1520,T
5-NP,1291,0,1,1517,1,1519,G
5-NP,1292,0,2,1517,0,1519,G
5-NP,1293,1520,0,0,0,1520,A
5-NP,1294,1519,0,0,0,1519,A
5-NP,1295,1519,0,2,0,1521,A
5-NP,1296,0,1505,0,0,1505,T
5-NP,1297,1503,0,0,0,1503,A
5-NP,1298,1,0,0,1500,1501,C
5-NP,1299,0,0,1488,0,1488,G
5-NP,1300,0,0,1476,0,1476,G
5-NP,1301,1471,0,0,0,1471,A
5-NP,1302,1450,0,0,0,1450,A
5-NP,1303,1,2,1459,0,1462,G
5-NP,1304,0,0,1474,0,1474,G
5-NP,1305,1478,1,0,0,1479,A
5-NP,1306,1471,0,1,0,1472,A
5-NP,1307,0,0,1472,0,1472,G
5-NP,1308,1467,0,2,0,1469,A
5-NP,1309,1464,0,1,0,1465,A
5-NP,1310,2,0,0,1474,1476,C
5-NP,1311,0,1465,1,0,1466,T
5-NP,1312,0,1480,0,0,1480,T
5-NP,1313,1,0,0,1476,1477,C
5-NP,1314,1479,1,2,0,1482,A
5-NP,1315,0,0,1486,0,1486,G
5-NP,1316,1468,1,2,0,1471,A
5-NP,1317,0,0,0,1479,1479,C
5-NP,1318,1471,0,0,0,1471,A
5-NP,1319,0,1439,0,1,1440,T
5-NP,1320,0,0,1443,0,1443,G
5-NP,1321,1427,1,2,0,1430,A
5-NP,1322,1,3,1442,0,1446,G
5-NP,1323,1,0,1436,0,1437,G
5-NP,1324,1,0,1437,0,1438,G
5-NP,1325,0,0,0,1439,1439,C
5-NP,1326,1422,0,3,0,1425,A
5-NP,1327,1,0,1440,0,1441,G
5-NP,1328,1439,0,1,0,1440,A
5-NP,1329,1447,0,1,0,1448,A
5-NP,1330,1445,0,0,0,1445,A
5-NP,1331,0,1428,1,0,1429,T
5-NP,1332,0,0,0,1444,1444,C
5-NP,1333,1445,0,0,0,1445,A
5-NP,1334,0,1437,1,0,1438,T
5-NP,1335,1442,0,2,0,1444,A
5-NP,1336,1438,0,0,0,1438,A
5-NP,1337,0,3,1451,0,1454,G
5-NP,1338,1435,0,0,0,1435,A
5-NP,1339,1454,0,0,0,1454,A
5-NP,1340,1,1420,0,0,1421,T
5-NP,1341,0,0,1427,0,1427,G
5-NP,1342,1416,1,2,0,1419,A
5-NP,1343,0,1424,0,0,1424,T
5-NP,1344,0,1,1427,0,1428,G
5-NP,1345,0,0,1426,0,1426,G
5-NP,1346,1404,0,2,0,1406,A
5-NP,1347,1404,0,0,0,1404,A
5-NP,1348,1358,0,2,0,1360,A
5-NP,1349,0,0,1379,0,1379,G
5-NP,1350,0,1370,0,0,1370,T
5-NP,1351,0,0,1374,0,1374,G
5-NP,1352,0,0,0,1371,1371,C
5-NP,1353,1372,0,2,0,1374,A
5-NP,1354,1367,0,1,0,1368,A
5-NP,1355,1374,0,0,0,1374,A
5-NP,1356,1380,0,0,2,1382,A
5-NP,1357,1,1,0,1378,1380,C
5-NP,1358,1,0,0,1371,1372,C
5-NP,1359,1353,0,0,0,1353,A
5-NP,1360,0,0,1359,0,1359,G
5-NP,1361,1358,1,1,0,1360,A
5-NP,1362,1361,0,1,0,1362,A
5-NP,1363,0,0,1353,0,1353,G
5-NP,1364,1341,0,0,0,1341,A
5-NP,1365,1305,0,1,0,1306,A
5-NP,1366,0,0,1324,0,1324,G
5-NP,1367,0,1301,0,0,1301,T
5-NP,1368,2,1,1312,0,1315,G
5-NP,1369,0,1287,0,2,1289,T
5-NP,1370,0,0,0,1293,1293,C
5-NP,1371,1303,0,0,0,1303,A
5-NP,1372,0,1302,0,0,1302,T
5-NP,1373,0,1295,0,0,1295,T
5-NP,1374,0,0,0,1306,1306,C
5-NP,1375,0,0,0,1288,1288,C
5-NP,1376,0,1,1278,0,1279,G
5-NP,1377,1250,0,0,0,1250,A
5-NP,1378,0,1,1270,0,1271,G
5-NP,1379,0,1,1282,0,1283,G
5-NP,1380,1,3,1273,0,1277,G
5-NP,1381,1244,0,0,1,1245,A
5-NP,1382,0,0,1248,0,1248,G
5-NP,1383,0,0,1248,0,1248,G
5-NP,1384,1,2,1234,0,1237,G
5-NP,1385,0,2,1243,0,1245,G
5-NP,1386,1229,0,0,0,1229,A
5-NP,1387,0,0,1230,0,1230,G
5-NP,1388,0,1197,0,0,1197,T
5-NP,1389,1,0,0,1172,1173,C
5-NP,1390,0,1185,0,0,1185,T
5-NP,1391,0,1181,0,0,1181,T
5-NP,1392,2,0,0,1179,1181,C
5-NP,1393,2,2,1176,0,1180,G
5-NP,1394,1174,0,0,0,1174,A
5-NP,1395,1,1,1171,0,1173,G
5-NP,1396,0,1,0,1155,1156,C
5-NP,1397,1,1151,0,1,1153,T
5-NP,1398,1,0,0,1150,1151,C
5-NP,1399,0,1151,0,0,1151,T
5-NP,1400,1,0,0,1150,1151,C
5-NP,1401,1158,0,0,0,1158,A
5-NP,1402,0,0,1162,0,1162,G
5-NP,1403,1153,0,1,0,1154,A
5-NP,1404,0,0,0,1153,1153,C
5-NP,1405,0,0,1147,0,1147,G
5-NP,1406,1131,0,0,0,1131,A
5-NP,1407,0,2,1126,0,1128,G
5-NP,1408,1124,0,0,0,1124,A
5-NP,1409,1114,0,2,0,1116,A
5-NP,1410,0,0,1112,0,1112,G
5-NP,1411,2,0,1097,0,1099,G
5-NP,1412,0,2,0,1098,1100,C
5-NP,1413,1096,0,0,0,1096,A
5-NP,1414,1090,1,1,0,1092,A
5-NP,1415,0,0,0,1090,1090,C
5-NP,1416,0,0,1095,0,1095,G
5-NP,1417,1096,0,0,0,1096,A
5-NP,1418,1091,0,0,0,1091,A
5-NP,1419,1,0,0,1081,1082,C
5-NP,1420,0,1,0,1076,1077,C
5-NP,1421,4,1,0,1060,1065,C
5-NP,1422,0,0,1079,0,1079,G
5-NP,1423,1067,0,0,0,1067,A
5-NP,1424,0,1069,0,1,1070,T
5-NP,1425,1,0,0,1045,1046,C
5-NP,1426,0,0,1046,0,1046,G
5-NP,1427,0,1040,1,1,1042,T
5-NP,1428,0,0,1031,0,1031,G
5-NP,1429,0,0,0,1022,1022,C
5-NP,1430,1,0,0,1018,1019,C
5-NP,1431,0,0,0,1019,1019,C
5-NP,1432,0,995,0,0,995,T
5-NP,1433,0,0,0,1020,1020,C
5-NP,1434,0,1021,0,0,1021,T
5-NP,1435,0,1024,0,0,1024,T
5-NP,1436,0,1029,0,0,1029,T
5-NP,1437,0,1016,0,0,1016,T
5-NP,1438,0,0,1029,0,1029,G
5-NP,1439,1023,0,0,0,1023,A
5-NP,1440,0,1010,0,0,1010,T
5-NP,1441,1004,0,0,0,1004,A
5-NP,1442,0,850,0,2,852,T
5-NP,1443,0,0,861,0,861,G
5-NP,1444,847,0,2,0,849,A
5-NP,1445,0,0,861,0,861,G
5-NP,1446,0,856,0,1,857,T
5-NP,1447,839,0,0,0,839,A
5-NP,1448,840,0,0,0,840,A
5-NP,1449,0,835,0,0,835,T
5-NP,1450,0,0,831,0,831,G
5-NP,1451,832,0,0,0,832,A
5-NP,1452,735,0,0,1,736,A
5-NP,1453,1,0,729,0,730,G
5-NP,1454,0,0,680,0,680,G
5-NP,1455,680,0,0,0,680,A
5-NP,1456,0,673,0,0,673,T
5-NP,1457,1,0,0,669,670,C
5-NP,1458,0,664,0,0,664,T
5-NP,1459,0,665,0,0,665,T
5-NP,1460,668,0,0,0,668,A
5-NP,1461,0,660,0,0,660,T
5-NP,1462,0,659,0,0,659,T
5-NP,1463,0,650,0,0,650,T
5-NP,1464,0,0,0,637,637,C
5-NP,1465,0,604,0,1,605,T
5-NP,1466,0,601,0,0,601,T
5-NP,1467,0,0,0,601,601,C
5-NP,1468,0,0,603,0,603,G
5-NP,1469,0,0,599,0,599,G
5-NP,1470,599,0,0,0,599,A
5-NP,1471,0,1,595,0,596,G
5-NP,1472,597,0,0,0,597,A
5-NP,1473,0,0,0,590,590,C
5-NP,1474,563,0,0,0,563,A
5-NP,1475,561,0,0,0,561,A
5-NP,1476,0,557,0,2,559,T
5-NP,1477,0,0,561,0,561,G
5-NP,1478,0,0,0,557,557,C
5-NP,1479,536,0,0,0,536,A
5-NP,1480,0,0,535,0,535,G
5-NP,1481,533,0,0,2,535,A
5-NP,1482,491,0,0,0,491,A
5-NP,1483,0,0,489,0,489,G
5-NP,1484,353,0,0,0,353,A
5-NP,1485,1,0,349,0,350,G
5-NP,1486,0,319,0,0,319,T
5-NP,1487,315,0,0,0,315,A
5-NP,1488,0,285,0,0,285,T
5-NP,1489,0,0,287,0,287,G
5-NP,1490,286,0,0,0,286,A
5-NP,1491,0,0,0,287,287,C
5-NP,1492,188,0,0,0,188,A
5-NP,1493,185,0,0,0,185,A
5-NP,1494,0,122,0,0,122,T
5-NP,1495,0,119,0,0,119,T
5-NP,1496,116,0,0,0,116,A
5-NP,1497,113,0,0,0,113,A
6-NA,1,121,0,0,0,121,A
6-NA,2,0,120,0,0,120,T
6-NA,3,0,0,122,0,122,G
6-NA,4,118,0,2,0,120,A
6-NA,5,128,0,0,0,128,A
6-NA,6,0,128,0,0,128,T
6-NA,7,0,0,0,128,128,C
6-NA,8,0,0,0,126,126,C
6-NA,9,127,0,0,0,127,A
6-NA,10,138,0,0,0,138,A
6-NA,11,139,0,0,0,139,A
6-NA,12,0,141,0,0,141,T
6-NA,13,0,0,0,144,144,C
6-NA,14,145,0,0,0,145,A
6-NA,15,145,0,0,0,145,A
6-NA,16,145,0,0,0,145,A
6-NA,17,153,0,0,0,153,A
6-NA,18,0,1,172,0,173,G
6-NA,19,182,0,0,0,182,A
6-NA,20,0,182,0,0,182,T
6-NA,21,185,0,0,0,185,A
6-NA,22,186,0,0,0,186,A
6-NA,23,0,189,0,0,189,T
6-NA,24,190,0,0,0,190,A
6-NA,25,192,0,0,0,192,A
6-NA,26,0,1,0,195,196,C
6-NA,27,0,0,204,0,204,G
6-NA,28,203,0,0,0,203,A
6-NA,29,0,202,0,0,202,T
6-NA,30,0,204,0,0,204,T
6-NA,31,0,0,209,0,209,G
6-NA,32,0,1,225,0,226,G
6-NA,33,0,1,0,228,229,C
6-NA,34,0,227,0,0,227,T
6-NA,35,0,0,0,238,238,C
6-NA,36,0,239,0,0,239,T
6-NA,37,0,1,243,0,244,G
6-NA,38,0,244,0,0,244,T
6-NA,39,0,246,0,0,246,T
6-NA,40,0,260,0,0,260,T
6-NA,41,1,0,0,263,264,C
6-NA,42,0,265,0,0,265,T
6-NA,43,0,0,0,266,266,C
6-NA,44,0,268,0,0,268,T
6-NA,45,0,0,0,271,271,C
6-NA,46,266,0,0,1,267,A
6-NA,47,0,0,0,290,290,C
6-NA,48,0,0,0,290,290,C
6-NA,49,290,0,0,1,291,A
6-NA,50,0,293,0,0,293,T
6-NA,51,0,304,0,1,305,T
6-NA,52,0,302,0,0,302,T
6-NA,53,0,0,0,315,315,C
6-NA,54,0,0,0,313,313,C
6-NA,55,317,0,1,1,319,A
6-NA,56,0,0,0,330,330,C
6-NA,57,329,0,0,1,330,A
6-NA,58,345,0,0,1,346,A
6-NA,59,0,348,0,0,348,T
6-NA,60,366,0,0,1,367,A
6-NA,61,0,367,0,0,367,T
6-NA,62,0,1,366,0,367,G
6-NA,63,0,0,0,366,366,C
6-NA,64,0,368,0,0,368,T
6-NA,65,0,372,1,0,373,T
6-NA,66,1,0,0,370,371,C
6-NA,67,0,370,0,0,370,T
6-NA,68,0,371,0,0,371,T
6-NA,69,1,0,0,368,369,C
6-NA,70,367,0,0,1,368,A
6-NA,71,0,368,0,0,368,T
6-NA,72,0,1,370,0,371,G
6-NA,73,0,0,0,370,370,C
6-NA,74,370,0,0,1,371,A
6-NA,75,373,0,0,1,374,A
6-NA,76,373,0,0,1,374,A
6-NA,77,0,379,0,0,379,T
6-NA,78,0,378,0,0,378,T
6-NA,79,0,1,378,0,379,G
6-NA,80,0,0,0,379,379,C
6-NA,81,0,0,0,380,380,C
6-NA,82,382,0,0,1,383,A
6-NA,83,0,383,0,0,383,T
6-NA,84,0,0,0,413,413,C
6-NA,85,0,417,0,0,417,T
6-NA,86,0,413,0,1,414,T
6-NA,87,1,1,424,0,426,G
6-NA,88,421,0,0,0,421,A
6-NA,89,0,429,0,0,429,T
6-NA,90,428,0,0,0,428,A
6-NA,91,426,0,1,0,427,A
6-NA,92,0,0,0,485,485,C
6-NA,93,0,483,0,0,483,T
6-NA,94,488,0,0,0,488,A
6-NA,95,0,0,0,509,509,C
6-NA,96,0,507,0,0,507,T
6-NA,97,0,0,515,0,515,G
6-NA,98,0,512,0,0,512,T
6-NA,99,516,0,0,0,516,A
6-NA,100,526,0,0,0,526,A
6-NA,101,0,0,0,514,514,C
6-NA,102,506,0,0,0,506,A
6-NA,103,0,509,0,0,509,T
6-NA,104,0,504,0,0,504,T
6-NA,105,0,0,503,0,503,G
6-NA,106,0,0,0,501,501,C
6-NA,107,510,0,0,0,510,A
6-NA,108,0,513,0,0,513,T
6-NA,109,0,510,0,0,510,T
6-NA,110,0,507,0,0,507,T
6-NA,111,0,0,0,511,511,C
6-NA,112,511,0,0,0,511,A
6-NA,113,513,0,0,0,513,A
6-NA,114,0,0,512,0,512,G
6-NA,115,0,0,0,512,512,C
6-NA,116,512,0,0,0,512,A
6-NA,117,535,0,0,0,535,A
6-NA,118,0,542,0,0,542,T
6-NA,119,544,0,1,0,545,A
6-NA,120,0,544,0,0,544,T
6-NA,121,0,0,552,0,552,G
6-NA,122,548,0,0,0,548,A
6-NA,123,564,0,0,0,564,A
6-NA,124,0,563,0,0,563,T
6-NA,125,0,565,0,0,565,T
6-NA,126,2,0,0,564,566,C
6-NA,127,561,0,0,0,561,A
6-NA,128,562,1,0,0,563,A
6-NA,129,0,0,0,561,561,C
6-NA,130,0,560,0,2,562,T
6-NA,131,0,1,0,558,559,C
6-NA,132,0,0,1,554,555,C
6-NA,133,0,0,0,566,566,C
6-NA,134,2,0,0,567,569,C
6-NA,135,0,0,0,568,568,C
6-NA,136,0,0,0,569,569,C
6-NA,137,0,0,0,573,573,C
6-NA,138,573,0,0,0,573,A
6-NA,139,568,0,0,0,568,A
6-NA,140,571,0,1,0,572,A
6-NA,141,0,0,0,584,584,C
6-NA,142,584,0,0,0,584,A
6-NA,143,589,0,1,0,590,A
6-NA,144,0,0,0,591,591,C
6-NA,145,1,0,0,602,603,C
6-NA,146,675,0,0,0,675,A
6-NA,147,686,0,0,0,686,A
6-NA,148,0,0,686,0,686,G
6-NA,149,0,681,0,0,681,T
6-NA,150,442,0,235,0,677,A
6-NA,151,713,0,0,0,713,A
6-NA,152,0,715,0,0,715,T
6-NA,153,0,0,716,0,716,G
6-NA,154,0,0,0,713,713,C
6-NA,155,0,674,0,1,675,T
6-NA,156,0,0,710,0,710,G
6-NA,157,0,705,0,0,705,T
6-NA,158,0,0,706,0,706,G
6-NA,159,0,710,0,1,711,T
6-NA,160,0,1,701,0,702,G
6-NA,161,699,0,4,1,704,A
6-NA,162,708,0,0,0,708,A
6-NA,163,1,0,0,706,707,C
6-NA,164,1,0,0,707,708,C
6-NA,165,708,0,2,0,710,A
6-NA,166,710,0,1,0,711,A
6-NA,167,0,0,0,733,733,C
6-NA,168,729,0,0,0,729,A
6-NA,169,738,0,1,0,739,A
6-NA,170,0,744,0,0,744,T
6-NA,171,745,0,0,0,745,A
6-NA,172,738,0,0,0,738,A
6-NA,173,0,746,0,0,746,T
6-NA,174,742,0,0,0,742,A
6-NA,175,1,0,747,0,748,G
6-NA,176,734,0,0,0,734,A
6-NA,177,734,0,0,0,734,A
6-NA,178,739,0,0,0,739,A
6-NA,179,0,0,738,0,738,G
6-NA,180,746,0,0,0,746,A
6-NA,181,739,0,0,0,739,A
6-NA,182,770,0,0,0,770,A
6-NA,183,0,0,0,771,771,C
6-NA,184,769,0,0,0,769,A
6-NA,185,0,775,0,0,775,T
6-NA,186,782,0,1,0,783,A
6-NA,187,787,0,0,0,787,A
6-NA,188,0,0,0,791,791,C
6-NA,189,794,0,0,0,794,A
6-NA,190,0,0,815,0,815,G
6-NA,191,813,0,0,0,813,A
6-NA,192,0,0,814,0,814,G
6-NA,193,817,0,0,0,817,A
6-NA,194,0,835,0,0,835,T
6-NA,195,833,0,0,0,833,A
6-NA,196,0,0,852,0,852,G
6-NA,197,0,833,0,0,833,T
6-NA,198,0,0,862,0,862,G
6-NA,199,0,850,0,2,852,T
6-NA,200,854,0,0,0,854,A
6-NA,201,0,858,0,0,858,T
6-NA,202,0,0,0,862,862,C
6-NA,203,0,850,0,0,850,T
6-NA,204,0,3,866,0,869,G
6-NA,205,867,0,3,0,870,A
6-NA,206,1,0,0,869,870,C
6-NA,207,0,0,0,865,865,C
6-NA,208,864,0,1,0,865,A
6-NA,209,860,0,1,0,861,A
6-NA,210,0,0,0,884,884,C
6-NA,211,880,0,0,0,880,A
6-NA,212,0,0,0,912,912,C
6-NA,213,0,0,0,900,900,C
6-NA,214,921,1,0,0,922,A
6-NA,215,1,0,0,960,961,C
6-NA,216,0,0,0,960,960,C
6-NA,217,969,0,0,0,969,A
6-NA,218,0,966,0,0,966,T
6-NA,219,955,0,0,0,955,A
6-NA,220,0,2,954,0,956,G
6-NA,221,939,0,0,0,939,A
6-NA,222,0,1,957,0,958,G
6-NA,223,941,0,0,0,941,A
6-NA,224,934,0,1,0,935,A
6-NA,225,0,0,940,0,940,G
6-NA,226,0,2,936,0,938,G
6-NA,227,939,1,0,0,940,A
6-NA,228,947,0,1,0,948,A
6-NA,229,949,0,0,0,949,A
6-NA,230,1,942,0,0,943,T
6-NA,231,937,0,0,0,937,A
6-NA,232,0,937,0,1,938,T
6-NA,233,0,0,940,0,940,G
6-NA,234,0,0,0,941,941,C
6-NA,235,0,0,0,937,937,C
6-NA,236,1,0,0,942,943,C
6-NA,237,2,0,0,947,949,C
6-NA,238,950,0,0,0,950,A
6-NA,239,972,0,0,0,972,A
6-NA,240,975,0,0,0,975,A
6-NA,241,0,0,0,975,975,C
6-NA,242,0,975,0,0,975,T
6-NA,243,971,0,0,0,971,A
6-NA,244,0,0,969,0,969,G
6-NA,245,0,0,0,968,968,C
6-NA,246,971,0,1,0,972,A
6-NA,247,0,0,992,0,992,G
6-NA,248,977,0,0,0,977,A
6-NA,249,997,1,0,0,998,A
6-NA,250,0,1003,0,2,1005,T
6-NA,251,1000,0,3,0,1003,A
6-NA,252,0,0,0,1004,1004,C
6-NA,253,1004,0,0,0,1004,A
6-NA,254,0,0,999,0,999,G
6-NA,255,988,0,0,0,988,A
6-NA,256,992,0,0,0,992,A
6-NA,257,988,0,0,0,988,A
6-NA,258,0,976,0,0,976,T
6-NA,259,0,974,0,0,974,T
6-NA,260,0,2,968,0,970,G
6-NA,261,0,1,972,0,973,G
6-NA,262,1,974,0,2,977,T
6-NA,263,2,0,0,970,972,C
6-NA,264,979,0,0,0,979,A
6-NA,265,980,0,0,0,980,A
6-NA,266,981,0,0,0,981,A
6-NA,267,1,0,978,0,979,G
6-NA,268,0,0,0,979,979,C
6-NA,269,1,1,0,972,974,C
6-NA,270,0,0,974,0,974,G
6-NA,271,0,0,0,981,981,C
6-NA,272,986,0,0,0,986,A
6-NA,273,1000,0,0,0,1000,A
6-NA,274,0,994,0,0,994,T
6-NA,275,0,0,1009,0,1009,G
6-NA,276,0,1004,0,0,1004,T
6-NA,277,0,3,1000,0,1003,G
6-NA,278,1028,1,1,0,1030,A
6-NA,279,0,0,0,1044,1044,C
6-NA,280,1078,0,0,0,1078,A
6-NA,281,0,1083,0,0,1083,T
6-NA,282,0,1075,0,0,1075,T
6-NA,283,1077,0,0,0,1077,A
6-NA,284,0,0,0,1075,1075,C
6-NA,285,1070,0,0,1,1071,A
6-NA,286,0,2,1059,0,1061,G
6-NA,287,0,0,1048,0,1048,G
6-NA,288,0,0,1026,0,1026,G
6-NA,289,0,1036,0,1,1037,T
6-NA,290,0,1055,0,1,1056,T
6-NA,291,0,1055,0,0,1055,T
6-NA,292,0,1,1057,0,1058,G
6-NA,293,0,0,0,1060,1060,C
6-NA,294,1056,0,0,0,1056,A
6-NA,295,0,0,0,1059,1059,C
6-NA,296,0,0,0,1045,1045,C
6-NA,297,0,1045,0,2,1047,T
6-NA,298,0,1045,0,0,1045,T
6-NA,299,0,1055,0,0,1055,T
6-NA,300,0,1060,0,0,1060,T
6-NA,301,0,1074,0,1,1075,T
6-NA,302,0,0,0,1076,1076,C
6-NA,303,0,1069,0,0,1069,T
6-NA,304,1074,1,1,0,1076,A
6-NA,305,1073,0,1,0,1074,A
6-NA,306,0,0,1082,0,1082,G
6-NA,307,0,0,1079,0,1079,G
6-NA,308,1079,0,0,0,1079,A
6-NA,309,0,0,0,1086,1086,C
6-NA,310,1080,0,0,0,1080,A
6-NA,311,1075,1,0,0,1076,A
6-NA,312,0,1076,0,0,1076,T
6-NA,313,0,1064,0,0,1064,T
6-NA,314,0,1,0,1094,1095,C
6-NA,315,0,2,1096,0,1098,G
6-NA,316,1096,0,0,0,1096,A
6-NA,317,0,1098,0,0,1098,T
6-NA,318,0,1096,0,0,1096,T
6-NA,319,1093,0,0,0,1093,A
6-NA,320,1,2,1092,0,1095,G
6-NA,321,0,0,1097,0,1097,G
6-NA,322,0,0,0,1093,1093,C
6-NA,323,0,1087,0,0,1087,T
6-NA,324,0,1094,0,1,1095,T
6-NA,325,0,1094,0,0,1094,T
6-NA,326,1,0,0,1094,1095,C
6-NA,327,1,0,0,1097,1098,C
6-NA,328,1,0,1093,0,1094,G
6-NA,329,0,0,0,1104,1104,C
6-NA,330,0,1094,0,1,1095,T
6-NA,331,0,2,1138,0,1140,G
6-NA,332,1,0,1130,0,1131,G
6-NA,333,0,1127,0,0,1127,T
6-NA,334,0,1,1132,0,1133,G
6-NA,335,0,2,1118,0,1120,G
6-NA,336,0,1,1126,0,1127,G
6-NA,337,0,3,1124,0,1127,G
6-NA,338,1123,0,0,0,1123,A
6-NA,339,0,1,0,1132,1133,C
6-NA,340,1113,0,0,0,1113,A
6-NA,341,0,1112,0,0,1112,T
6-NA,342,0,0,0,1118,1118,C
6-NA,343,0,1121,0,0,1121,T
6-NA,344,0,2,1123,0,1125,G
6-NA,345,0,2,1122,0,1124,G
6-NA,346,1,0,1128,0,1129,G
6-NA,347,0,1128,1,1,1130,T
6-NA,348,0,1,1116,0,1117,G
6-NA,349,1112,0,1,0,1113,A
6-NA,350,1,0,0,1135,1136,C
6-NA,351,1135,0,0,0,1135,A
6-NA,352,1180,1,0,0,1181,A
6-NA,353,0,1,1187,0,1188,G
6-NA,354,1184,0,1,0,1185,A
6-NA,355,0,1,1231,0,1232,G
6-NA,356,1256,1,0,0,1257,A
6-NA,357,1352,0,0,0,1352,A
6-NA,358,0,0,0,1703,1703,C
6-NA,359,2,0,0,1820,1822,C
6-NA,360,0,1829,0,2,1831,T
6-NA,361,0,1847,0,0,1847,T
6-NA,362,1847,0,0,0,1847,A
6-NA,363,0,1852,0,0,1852,T
6-NA,364,0,0,1982,0,1982,G
6-NA,365,0,1981,0,1,1982,T
6-NA,366,0,0,2050,0,2050,G
6-NA,367,0,2020,0,2,2022,T
6-NA,368,0,1,0,2014,2015,C
6-NA,369,2043,2,0,3,2048,A
6-NA,370,0,2050,0,1,2051,T
6-NA,371,0,1,2041,0,2042,G
6-NA,372,0,1,0,2044,2045,C
6-NA,373,1,1,2045,0,2047,G
6-NA,374,2363,0,2,0,2365,A
6-NA,375,0,2363,0,0,2363,T
6-NA,376,0,0,0,2422,2422,C
6-NA,377,0,0,1,2426,2427,C
6-NA,378,0,2483,0,3,2486,T
6-NA,379,2,3,2525,0,2530,G
6-NA,380,2537,0,0,0,2537,A
6-NA,381,0,1,0,2535,2536,C
6-NA,382,2550,0,0,0,2550,A
6-NA,383,2511,0,1,0,2512,A
6-NA,384,1,0,2634,0,2635,G
6-NA,385,0,2631,0,2,2633,T
6-NA,386,0,0,2686,0,2686,G
6-NA,387,0,2676,0,1,2677,T
6-NA,388,0,2674,0,3,2677,T
6-NA,389,2686,0,2,0,2688,A
6-NA,390,0,2670,1,0,2671,T
6-NA,391,4,0,0,2728,2732,C
6-NA,392,2729,0,0,0,2729,A
6-NA,393,2708,1,1,0,2710,A
6-NA,394,0,2703,0,0,2703,T
6-NA,395,1,2699,0,1,2701,T
6-NA,396,0,2705,0,1,2706,T
6-NA,397,1,1,2696,0,2698,G
6-NA,398,0,2,0,2847,2849,C
6-NA,399,0,0,0,2854,2854,C
6-NA,400,3,0,0,2865,2868,C
6-NA,401,0,2863,0,2,2865,T
6-NA,402,1,2852,0,0,2853,T
6-NA,403,1,2,2898,0,2901,G
6-NA,404,0,3,2909,0,2912,G
6-NA,405,2916,0,6,0,2922,A
6-NA,406,0,0,0,2927,2927,C
6-NA,407,2871,0,0,0,2871,A
6-NA,408,0,5,2949,1,2955,G
6-NA,409,0,3,2931,0,2934,G
6-NA,410,1,2,3057,0,3060,G
6-NA,411,3044,1,4,0,3049,A
6-NA,412,3049,0,0,0,3049,A
6-NA,413,0,2,0,3063,3065,C
6-NA,414,3057,0,3,0,3060,A
6-NA,415,3346,0,4,0,3350,A
6-NA,416,0,0,1,3366,3367,C
6-NA,417,3348,0,0,0,3348,A
6-NA,418,0,0,0,3401,3401,C
6-NA,419,0,3363,0,2,3365,T
6-NA,420,3400,0,0,0,3400,A
6-NA,421,3396,0,2,0,3398,A
6-NA,422,3429,0,2,0,3431,A
6-NA,423,0,0,0,3453,3453,C
6-NA,424,3339,0,0,0,3339,A
6-NA,425,3375,0,1,0,3376,A
6-NA,426,0,1,0,3412,3413,C
6-NA,427,0,0,3397,0,3397,G
6-NA,428,0,3384,0,0,3384,T
6-NA,429,3353,0,1,0,3354,A
6-NA,430,1,4,0,3417,3422,C
6-NA,431,3411,0,0,0,3411,A
6-NA,432,0,3437,0,2,3439,T
6-NA,433,1,3439,1,1,3442,T
6-NA,434,4,1,0,3601,3606,C
6-NA,435,3719,1,0,0,3720,A
6-NA,436,3751,0,0,0,3751,A
6-NA,437,3744,0,0,1,3745,A
6-NA,438,0,3745,0,0,3745,T
6-NA,439,3715,0,0,0,3715,A
6-NA,440,3833,0,2,1,3836,A
6-NA,441,1,2,0,3845,3848,C
6-NA,442,3831,0,5,1,3837,A
6-NA,443,1,0,0,3911,3912,C
6-NA,444,3818,0,1,1,3820,A
6-NA,445,1,0,4624,0,4625,G
6-NA,446,0,4609,0,0,4609,T
6-NA,447,4683,1,0,1,4685,A
6-NA,448,0,3,0,4718,4721,C
6-NA,449,1,8,4707,0,4716,G
6-NA,450,0,4885,0,3,4888,T
6-NA,451,2,4,4933,0,4939,G
6-NA,452,4915,0,2,0,4917,A
6-NA,453,0,4963,0,0,4963,T
6-NA,454,4734,0,4,1,4739,A
6-NA,455,1,3,4720,0,4724,G
6-NA,456,1,10,4691,0,4702,G
6-NA,457,4694,1,5,1,4701,A
6-NA,458,1,3,0,4782,4786,C
6-NA,459,2,0,0,4691,4693,C
6-NA,460,5,0,0,4763,4768,C
6-NA,461,2,2,0,4782,4786,C
6-NA,462,0,4809,0,2,4811,T
6-NA,463,0,4900,0,2,4902,T
6-NA,464,4919,0,2,2,4923,A
6-NA,465,1,4902,0,0,4903,T
6-NA,466,1,0,0,4911,4912,C
6-NA,467,5,5,4860,0,4870,G
6-NA,468,0,3,4847,0,4850,G
6-NA,469,4864,1,3,1,4869,A
6-NA,470,0,0,0,4903,4903,C
6-NA,471,4,0,0,4873,4877,C
6-NA,472,4,0,0,5166,5170,C
6-NA,473,2,5150,0,2,5154,T
6-NA,474,5243,0,0,0,5243,A
6-NA,475,0,5228,0,3,5231,T
6-NA,476,0,5256,0,2,5258,T
6-NA,477,0,2,5278,0,5280,G
6-NA,478,5233,0,2,0,5235,A
6-NA,479,0,5256,1,1,5258,T
6-NA,480,0,4,5271,0,5275,G
6-NA,481,5103,1,0,0,5104,A
6-NA,482,5123,0,1,0,5124,A
6-NA,483,0,5136,0,1,5137,T
6-NA,484,0,6,5206,0,5212,G
6-NA,485,5250,0,1,1,5252,A
6-NA,486,0,0,5380,0,5380,G
6-NA,487,0,5355,0,1,5356,T
6-NA,488,0,5384,0,1,5385,T
6-NA,489,5386,1,2,0,5389,A
6-NA,490,1,3,5393,0,5397,G
6-NA,491,2,2,5395,0,5399,G
6-NA,492,2,5338,0,4,5344,T
6-NA,493,2,1,5396,0,5399,G
6-NA,494,0,5333,0,9,5342,T
6-NA,495,0,5329,0,8,5337,T
6-NA,496,8,1,0,5327,5336,C
6-NA,497,7,1,0,5330,5338,C
6-NA,498,4,9,0,5311,5324,C
6-NA,499,1,5496,0,2,5499,T
6-NA,500,0,5518,0,3,5521,T
6-NA,501,1,5507,0,3,5511,T
6-NA,502,1,39,0,5498,5538,C
6-NA,503,5515,0,0,0,5515,A
6-NA,504,0,5674,1,3,5678,T
6-NA,505,0,2,0,5685,5687,C
6-NA,506,0,5597,0,2,5599,T
6-NA,507,1,2,5546,1,5550,G
6-NA,508,0,10,5537,0,5547,G
6-NA,509,6,6,5459,1,5472,G
6-NA,510,3,4,5581,0,5588,G
6-NA,511,5567,0,7,0,5574,A
6-NA,512,3,0,0,5664,5667,C
6-NA,513,5,1,0,5598,5604,C
6-NA,514,5655,0,2,0,5657,A
6-NA,515,5672,0,2,0,5674,A
6-NA,516,0,0,5661,0,5661,G
6-NA,517,7,2,1,5680,5690,C
6-NA,518,5695,0,2,0,5697,A
6-NA,519,5742,0,2,1,5745,A
6-NA,520,3,1,5772,0,5776,G
6-NA,521,0,5717,0,0,5717,T
6-NA,522,1,0,5891,1,5893,G
6-NA,523,1,5835,0,2,5838,T
6-NA,524,2,1,6018,0,6021,G
6-NA,525,2,0,1,6046,6049,C
6-NA,526,6038,1,4,0,6043,A
6-NA,527,0,6112,0,0,6112,T
6-NA,528,5990,0,2,0,5992,A
6-NA,529,1,0,6155,0,6156,G
6-NA,530,1,2,0,6136,6139,C
6-NA,531,6037,0,1,0,6038,A
6-NA,532,0,6029,0,4,6033,T
6-NA,533,2,3,5892,2,5899,G
6-NA,534,2,1,6266,0,6269,G
6-NA,535,1,6273,0,3,6277,T
6-NA,536,7,0,0,6248,6255,C
6-NA,537,6,1,0,6287,6294,C
6-NA,538,6288,0,4,0,6292,A
6-NA,539,0,0,6474,1,6475,G
6-NA,540,2,1,0,6484,6487,C
6-NA,541,0,6479,0,10,6489,T
6-NA,542,6,0,0,6527,6533,C
6-NA,543,6370,1,3,1,6375,A
6-NA,544,6468,0,3,0,6471,A
6-NA,545,3,0,6507,0,6510,G
6-NA,546,0,6516,0,2,6518,T
6-NA,547,0,6537,0,4,6541,T
6-NA,548,2,3,6545,0,6550,G
6-NA,549,3,6526,0,2,6531,T
6-NA,550,5,1,0,6529,6535,C
6-NA,551,6526,2,3,0,6531,A
6-NA,552,0,1,0,6589,6590,C
6-NA,553,4,3,6584,0,6591,G
6-NA,554,6613,1,1,0,6615,A
6-NA,555,0,6697,0,6,6703,T
6-NA,556,2,0,6852,0,6854,G
6-NA,557,0,5,6877,0,6882,G
6-NA,558,6865,0,3,0,6868,A
6-NA,559,6890,0,1,1,6892,A
6-NA,560,6957,1,3,0,6961,A
6-NA,561,6963,0,16,0,6979,A
6-NA,562,3,1,7019,0,7023,G
6-NA,563,0,1,0,7015,7016,C
6-NA,564,6991,1,3,0,6995,A
6-NA,565,0,6991,1,0,6992,T
6-NA,566,3,3,7082,0,7088,G
6-NA,567,0,0,7102,0,7102,G
6-NA,568,0,0,0,7200,7200,C
6-NA,569,1,7162,0,6,7169,T
6-NA,570,2,1,7234,0,7237,G
6-NA,571,2,3,0,7220,7225,C
6-NA,572,7248,0,2,0,7250,A
6-NA,573,0,7550,0,2,7552,T
6-NA,574,0,1,7585,0,7586,G
6-NA,575,1,7649,0,1,7651,T
6-NA,576,0,7826,0,3,7829,T
6-NA,577,0,7839,0,5,7844,T
6-NA,578,4,0,8363,0,8367,G
6-NA,579,0,8286,0,7,8293,T
6-NA,580,8381,0,0,0,8381,A
6-NA,581,1,8414,0,1,8416,T
6-NA,582,8310,0,3,1,8314,A
6-NA,583,8353,0,3,1,8357,A
6-NA,584,0,4,0,8309,8313,C
6-NA,585,4,7,8256,1,8268,G
6-NA,586,0,7,8277,1,8285,G
6-NA,587,0,16,8126,0,8142,G
6-NA,588,3,10,8168,0,8181,G
6-NA,589,3,2,8210,0,8215,G
6-NA,590,8128,0,8,0,8136,A
6-NA,591,0,8213,0,0,8213,T
6-NA,592,4,7,8236,0,8247,G
6-NA,593,8259,1,11,0,8271,A
6-NA,594,0,8335,0,1,8336,T
6-NA,595,8316,0,1,0,8317,A
6-NA,596,8338,0,0,1,8339,A
6-NA,597,8374,0,1,0,8375,A
6-NA,598,8364,1,7,0,8372,A
6-NA,599,8392,2,1,0,8395,A
6-NA,600,0,8403,0,1,8404,T
6-NA,601,0,1,8391,0,8392,G
6-NA,602,1,1,0,8379,8381,C
6-NA,603,8373,1,6,0,8380,A
6-NA,604,8383,0,2,0,8385,A
6-NA,605,0,1,0,8485,8486,C
6-NA,606,0,8473,0,4,8477,T
6-NA,607,4,1,8497,2,8504,G
6-NA,608,6,3,0,8477,8486,C
6-NA,609,1,8498,0,10,8509,T
6-NA,610,8530,0,6,0,8536,A
6-NA,611,3,0,8557,0,8560,G
6-NA,612,1,0,0,8617,8618,C
6-NA,613,0,8609,0,12,8621,T
6-NA,614,0,8583,0,6,8589,T
6-NA,615,9,0,0,8710,8719,C
6-NA,616,8716,1,2,0,8719,A
6-NA,617,1,8740,0,1,8742,T
6-NA,618,1,8767,1,2,8771,T
6-NA,619,1,8761,1,1,8764,T
6-NA,620,8773,0,2,0,8775,A
6-NA,621,1,2,1,8824,8828,C
6-NA,622,8785,0,1,1,8787,A
6-NA,623,8814,1,8,0,8823,A
6-NA,624,0,8841,0,1,8842,T
6-NA,625,4,9,8835,0,8848,G
6-NA,626,3,4,8821,0,8828,G
6-NA,627,2,1,8829,0,8832,G
6-NA,628,8784,0,9,0,8793,A
6-NA,629,8715,0,9,0,8724,A
6-NA,630,0,1,9085,0,9086,G
6-NA,631,2,1,0,9871,9874,C
6-NA,632,2,9929,0,6,9937,T
6-NA,633,0,10076,0,4,10080,T
6-NA,634,3,1,10111,0,10115,G
6-NA,635,2,10056,0,1,10059,T
6-NA,636,10223,1,8,1,10233,A
6-NA,637,0,4,10266,0,10270,G
6-NA,638,10211,0,5,1,10217,A
6-NA,639,2,10226,1,2,10231,T
6-NA,640,9568,0,0,0,9568,A
6-NA,641,0,0,9574,1,9575,G
6-NA,642,3,9434,0,8,9445,T
6-NA,643,6,2,9365,0,9373,G
6-NA,644,1,9800,1,5,9807,T
6-NA,645,1,9826,0,4,9831,T
6-NA,646,3,0,9987,0,9990,G
6-NA,647,0,9949,0,10,9959,T
6-NA,648,0,9973,0,4,9977,T
6-NA,649,0,9980,0,7,9987,T
6-NA,650,8,1,0,9865,9874,C
6-NA,651,9851,1,8,0,9860,A
6-NA,652,0,9814,0,2,9816,T
6-NA,653,5,9,9801,0,9815,G
6-NA,654,7,2,10381,1,10391,G
6-NA,655,1,10288,0,7,10296,T
6-NA,656,14,4,0,10274,10292,C
6-NA,657,6,1,1,10313,10321,C
6-NA,658,10371,3,1,2,10377,A
6-NA,659,10445,0,1,0,10446,A
6-NA,660,10435,4,9,1,10449,A
6-NA,661,1,7,10493,0,10501,G
6-NA,662,10446,0,9,1,10456,A
6-NA,663,10197,1,2,2,10202,A
6-NA,664,10184,0,3,1,10188,A
6-NA,665,0,10165,0,1,10166,T
6-NA,666,6,0,0,10475,10481,C
6-NA,667,7,2,0,10468,10477,C
6-NA,668,0,10449,0,7,10456,T
6-NA,669,5,2,0,10473,10480,C
6-NA,670,10460,0,6,2,10468,A
6-NA,671,1,6,10501,0,10508,G
6-NA,672,1,9,10468,0,10478,G
6-NA,673,10764,0,12,0,10776,A
6-NA,674,2,0,0,10793,10795,C
6-NA,675,7,1,0,10583,10591,C
6-NA,676,9,7,0,10636,10652,C
6-NA,677,10645,1,11,0,10657,A
6-NA,678,7,5,10673,1,10686,G
6-NA,679,1,8,10715,0,10724,G
6-NA,680,10660,0,3,1,10664,A
6-NA,681,4,1,10829,0,10834,G
6-NA,682,0,10641,1,5,10647,T
6-NA,683,8,1,0,10692,10701,C
6-NA,684,10680,0,9,0,10689,A
6-NA,685,4,3,10792,0,10799,G
6-NA,686,10741,0,7,0,10748,A
6-NA,687,10732,2,3,0,10737,A
6-NA,688,0,10727,0,1,10728,T
6-NA,689,3,1,10733,0,10737,G
6-NA,690,2,5,1,10735,10743,C
6-NA,691,5,2,10800,0,10807,G
6-NA,692,0,10767,0,2,10769,T
6-NA,693,0,10803,1,5,10809,T
6-NA,694,0,10792,0,2,10794,T
6-NA,695,1,10,10860,0,10871,G
6-NA,696,1,10894,0,5,10900,T
6-NA,697,10922,1,5,0,10928,A
6-NA,698,0,10856,0,6,10862,T
6-NA,699,11,2,0,10898,10911,C
6-NA,700,10905,3,2,0,10910,A
6-NA,701,10882,2,4,0,10888,A
6-NA,702,1,10903,0,2,10906,T
6-NA,703,1,8,10889,0,10898,G
6-NA,704,3,8,10909,0,10920,G
6-NA,705,11115,0,4,0,11119,A
6-NA,706,11135,0,3,1,11139,A
6-NA,707,3,3,0,11246,11252,C
6-NA,708,1,11323,0,5,11329,T
6-NA,709,0,11351,0,1,11352,T
6-NA,710,14,1,11686,1,11702,G
6-NA,711,1,11685,0,4,11690,T
6-NA,712,11687,1,6,0,11694,A
6-NA,713,2,1,1,11827,11831,C
6-NA,714,11606,2,5,1,11614,A
6-NA,715,3,1,12445,0,12449,G
6-NA,716,4,12355,0,3,12362,T
6-NA,717,12889,1,2,1,12893,A
6-NA,718,19,3,12958,0,12980,G
6-NA,719,0,12730,1,2,12733,T
6-NA,720,12761,0,2,1,12764,A
6-NA,721,12728,0,4,1,12733,A
6-NA,722,0,12703,0,1,12704,T
6-NA,723,14,19,12728,1,12762,G
6-NA,724,12418,2,12,4,12436,A
6-NA,725,0,0,1,12593,12594,C
6-NA,726,0,12329,0,4,12333,T
6-NA,727,1,3,12375,0,12379,G
6-NA,728,12236,4,15,1,12256,A
6-NA,729,1,12375,2,8,12386,T
6-NA,730,1,21,12364,0,12386,G
6-NA,731,6,10,12247,2,12265,G
6-NA,732,1,8,12290,0,12299,G
6-NA,733,12104,1,14,0,12119,A
6-NA,734,5,1,12160,0,12166,G
6-NA,735,1,12096,0,4,12101,T
6-NA,736,8,0,12152,0,12160,G
6-NA,737,1,5,0,12302,12308,C
6-NA,738,0,12282,0,5,12287,T
6-NA,739,0,12283,0,3,12286,T
6-NA,740,8,6,1,12307,12322,C
6-NA,741,12304,1,26,4,12335,A
6-NA,742,2,9,12380,0,12391,G
6-NA,743,5,9,12364,0,12378,G
6-NA,744,12344,0,1,0,12345,A
6-NA,745,12270,0,6,0,12276,A
6-NA,746,12126,0,7,0,12133,A
6-NA,747,12171,2,14,0,12187,A
6-NA,748,2,3,12250,0,12255,G
6-NA,749,1,0,1,12248,12250,C
6-NA,750,1,12236,1,1,12239,T
6-NA,751,2,8,12231,0,12241,G
6-NA,752,12195,1,8,1,12205,A
6-NA,753,1,12326,0,8,12335,T
6-NA,754,12352,0,11,1,12364,A
6-NA,755,0,83,0,12802,12885,C
6-NA,756,0,12854,0,1,12855,T
6-NA,757,12864,0,2,0,12866,A
6-NA,758,12855,2,1,0,12858,A
6-NA,759,12864,1,1,0,12866,A
6-NA,760,13169,1,1,0,13171,A
6-NA,761,0,13189,0,0,13189,T
6-NA,762,13128,3,4,0,13135,A
6-NA,763,3,0,0,13252,13255,C
6-NA,764,0,12855,0,9,12864,T
6-NA,765,12989,0,3,1,12993,A
6-NA,766,0,12909,2,10,12921,T
6-NA,767,0,13391,0,7,13398,T
6-NA,768,14,5,0,13437,13456,C
6-NA,769,13192,1,7,0,13200,A
6-NA,770,0,13204,0,4,13208,T
6-NA,771,0,13199,0,3,13202,T
6-NA,772,1,7,13252,1,13261,G
6-NA,773,13083,3,8,1,13095,A
6-NA,774,2,7,13101,1,13111,G
6-NA,775,1,12,13102,0,13115,G
6-NA,776,12609,0,14,2,12625,A
6-NA,777,2,19,12819,1,12841,G
6-NA,778,4,11,12819,1,12835,G
6-NA,779,1,9,12831,0,12841,G
6-NA,780,1,8,12869,0,12878,G
6-NA,781,12774,3,5,0,12782,A
6-NA,782,12894,0,5,1,12900,A
6-NA,783,12878,0,3,0,12881,A
6-NA,784,12814,1,4,0,12819,A
6-NA,785,1,12792,0,0,12793,T
6-NA,786,15,10,0,12762,12787,C
6-NA,787,4,0,12898,0,12902,G
6-NA,788,5,12840,0,7,12852,T
6-NA,789,2,12822,0,10,12834,T
6-NA,790,13,3,0,12859,12875,C
6-NA,791,12901,0,0,0,12901,A
6-NA,792,0,13608,1,4,13613,T
6-NA,793,13579,0,2,0,13581,A
6-NA,794,1,1,0,13709,13711,C
6-NA,795,1,13656,1,11,13669,T
6-NA,796,13691,0,6,0,13697,A
6-NA,797,5,2,13650,0,13657,G
6-NA,798,3,5,0,13652,13660,C
6-NA,799,13633,1,2,0,13636,A
6-NA,800,0,4,0,13713,13717,C
6-NA,801,13241,2,1,1,13245,A
6-NA,802,1,13469,0,3,13473,T
6-NA,803,1,13438,0,5,13444,T
6-NA,804,2,1,14383,0,14386,G
6-NA,805,1,14326,0,3,14330,T
6-NA,806,14,7,2,14290,14313,C
6-NA,807,14310,1,12,1,14324,A
6-NA,808,2,5,14296,1,14304,G
6-NA,809,3,6,14270,0,14279,G
6-NA,810,14234,1,3,0,14238,A
6-NA,811,14045,0,4,0,14049,A
6-NA,812,2,1,14236,0,14239,G
6-NA,813,2,13477,0,2,13481,T
6-NA,814,4,2,13546,0,13552,G
6-NA,815,2,3,0,13531,13536,C
6-NA,816,1,13543,0,10,13554,T
6-NA,817,8,0,0,13593,13601,C
6-NA,818,13587,1,4,0,13592,A
6-NA,819,13320,1,17,0,13338,A
6-NA,820,1,2,0,13478,13481,C
6-NA,821,13606,0,2,0,13608,A
6-NA,822,2,13637,0,0,13639,T
6-NA,823,1,1,13997,0,13999,G
6-NA,824,2,13892,0,8,13902,T
6-NA,825,12,3,0,13949,13964,C
6-NA,826,5,10,13968,0,13983,G
6-NA,827,13849,1,5,0,13855,A
6-NA,828,1,4,13882,0,13887,G
6-NA,829,0,6,13909,0,13915,G
6-NA,830,13780,1,7,0,13788,A
6-NA,831,3,0,13947,0,13950,G
6-NA,832,0,13616,0,7,13623,T
6-NA,833,2,2,13646,0,13650,G
6-NA,834,3,0,0,13806,13809,C
6-NA,835,55,13725,0,15,13795,T
6-NA,836,18,2,1,13836,13857,C
6-NA,837,7,6,0,13886,13899,C
6-NA,838,2,13927,1,12,13942,T
6-NA,839,1,1,13948,0,13950,G
6-NA,840,0,5,0,13802,13807,C
6-NA,841,1,13761,0,8,13770,T
6-NA,842,13893,1,3,0,13897,A
6-NA,843,1,13597,0,6,13604,T
6-NA,844,5,7,0,13688,13700,C
6-NA,845,11,5,1,13660,13677,C
6-NA,846,3,13592,0,6,13601,T
6-NA,847,3,7,0,13786,13796,C
6-NA,848,8,9,13772,0,13789,G
6-NA,849,13834,0,7,0,13841,A
6-NA,850,0,13880,0,1,13881,T
6-NA,851,13881,0,1,0,13882,A
6-NA,852,0,13859,0,5,13864,T
6-NA,853,5,12,0,13821,13838,C
6-NA,854,6,3,2,13840,13851,C
6-NA,855,0,13769,0,15,13784,T
6-NA,856,1,6,13761,0,13768,G
6-NA,857,3,0,13734,0,13737,G
6-NA,858,2,13874,1,9,13886,T
6-NA,859,0,2,13931,0,13933,G
6-NA,860,1,13837,2,12,13852,T
6-NA,861,20,2,0,13879,13901,C
6-NA,862,13893,0,8,1,13902,A
6-NA,863,1,3,13921,0,13925,G
6-NA,864,13881,0,6,0,13887,A
6-NA,865,1,13787,1,3,13792,T
6-NA,866,2,2,13823,0,13827,G
6-NA,867,0,13615,1,4,13620,T
6-NA,868,2,2,13649,0,13653,G
6-NA,869,0,13584,0,12,13596,T
6-NA,870,11,1,0,13672,13684,C
6-NA,871,3,13643,0,9,13655,T
6-NA,872,4,1,13648,0,13653,G
6-NA,873,3,2,0,13663,13668,C
6-NA,874,13643,1,13,0,13657,A
6-NA,875,15,4,13661,1,13681,G
6-NA,876,13350,0,11,0,13361,A
6-NA,877,0,6,13382,0,13388,G
6-NA,878,13315,0,9,0,13324,A
6-NA,879,0,3,0,13412,13415,C
6-NA,880,13382,2,1,1,13386,A
6-NA,881,13410,0,4,1,13415,A
6-NA,882,4,2,0,13497,13503,C
6-NA,883,0,13481,1,4,13486,T
6-NA,884,7,5,13497,0,13509,G
6-NA,885,2,3,13460,0,13465,G
6-NA,886,13430,2,11,0,13443,A
6-NA,887,13431,2,5,0,13438,A
6-NA,888,13135,0,8,0,13143,A
6-NA,889,1,7,13080,0,13088,G
6-NA,890,0,12,12885,0,12897,G
6-NA,891,12627,0,8,7,12642,A
6-NA,892,1,12979,0,1,12981,T
6-NA,893,8,1,1,13053,13063,C
6-NA,894,4,1,0,13355,13360,C
6-NA,895,13384,2,3,0,13389,A
6-NA,896,13366,0,4,0,13370,A
6-NA,897,0,13371,0,1,13372,T
6-NA,898,12940,0,8,0,12948,A
6-NA,899,7,3,12850,0,12860,G
6-NA,900,2,2,12829,0,12833,G
6-NA,901,1,3,0,12809,12813,C
6-NA,902,8,2,0,12751,12761,C
6-NA,903,8,5,0,12421,12434,C
6-NA,904,12487,0,4,0,12491,A
6-NA,905,1,12592,1,4,12598,T
6-NA,906,7,5,0,12663,12675,C
6-NA,907,2,5,12703,0,12710,G
6-NA,908,0,12604,0,2,12606,T
6-NA,909,12356,1,5,0,12362,A
6-NA,910,1,2,12651,2,12656,G
6-NA,911,12607,1,3,0,12611,A
6-NA,912,1,12714,0,11,12726,T
6-NA,913,12449,0,0,0,12449,A
6-NA,914,0,12309,1,1,12311,T
6-NA,915,12300,0,3,1,12304,A
6-NA,916,12267,1,1,0,12269,A
6-NA,917,12491,1,12,1,12505,A
6-NA,918,1,0,0,12761,12762,C
6-NA,919,12406,2,1,0,12409,A
6-NA,920,2,12337,1,1,12341,T
6-NA,921,12269,0,3,0,12272,A
6-NA,922,12283,0,5,0,12288,A
6-NA,923,12267,3,14,0,12284,A
6-NA,924,2,8,12349,0,12359,G
6-NA,925,3,7,12403,0,12413,G
6-NA,926,11888,0,6,0,11894,A
6-NA,927,1,11851,0,5,11857,T
6-NA,928,10,5,0,11908,11923,C
6-NA,929,11978,0,5,0,11983,A
6-NA,930,0,11995,0,8,12003,T
6-NA,931,11983,0,9,0,11992,A
6-NA,932,1,0,12050,1,12052,G
6-NA,933,2,3,0,11850,11855,C
6-NA,934,11576,0,2,0,11578,A
6-NA,935,0,11180,1,2,11183,T
6-NA,936,0,11227,0,1,11228,T
6-NA,937,3,1,11379,1,11384,G
6-NA,938,0,11347,0,6,11353,T
6-NA,939,1,11406,1,3,11411,T
6-NA,940,0,11348,1,5,11354,T
6-NA,941,13,11,1,11267,11292,C
6-NA,942,6,0,1,11302,11309,C
6-NA,943,11369,0,9,0,11378,A
6-NA,944,1,0,11494,1,11496,G
6-NA,945,0,11431,0,4,11435,T
6-NA,946,0,11257,0,1,11258,T
6-NA,947,11240,1,0,1,11242,A
6-NA,948,1,11112,1,2,11116,T
6-NA,949,0,10926,8,9,10943,T
6-NA,950,0,11016,0,1,11017,T
6-NA,951,2,0,11090,0,11092,G
6-NA,952,0,11048,1,2,11051,T
6-NA,953,2,1,11260,0,11263,G
6-NA,954,1,11210,0,10,11221,T
6-NA,955,2,11132,0,7,11141,T
6-NA,956,9,2,0,11140,11151,C
6-NA,957,11114,2,11,1,11128,A
6-NA,958,2,10,11185,0,11197,G
6-NA,959,2,4,11163,0,11169,G
6-NA,960,11071,0,6,0,11077,A
6-NA,961,2,45,0,11126,11173,C
6-NA,962,0,10974,0,3,10977,T
6-NA,963,0,11007,0,0,11007,T
6-NA,964,2,0,11320,1,11323,G
6-NA,965,0,11292,1,3,11296,T
6-NA,966,2,11282,0,10,11294,T
6-NA,967,3,3,11221,0,11227,G
6-NA,968,1,9,11193,0,11203,G
6-NA,969,11134,2,15,0,11151,A
6-NA,970,1,2,11200,1,11204,G
6-NA,971,11173,1,13,0,11187,A
6-NA,972,1,1,0,11137,11139,C
6-NA,973,10717,0,8,0,10725,A
6-NA,974,0,4,0,10742,10746,C
6-NA,975,10691,0,8,11,10710,A
6-NA,976,3,5,0,10787,10795,C
6-NA,977,5,1,1,10656,10663,C
6-NA,978,5,6,0,10713,10724,C
6-NA,979,10709,0,4,0,10713,A
6-NA,980,2,5,10761,0,10768,G
6-NA,981,10751,0,3,0,10754,A
6-NA,982,10779,0,3,0,10782,A
6-NA,983,10727,0,0,0,10727,A
6-NA,984,10691,0,1,0,10692,A
6-NA,985,10624,0,1,1,10626,A
6-NA,986,10614,0,1,0,10615,A
6-NA,987,0,4,0,10652,10656,C
6-NA,988,3,14,10597,1,10615,G
6-NA,989,10555,1,5,0,10561,A
6-NA,990,2,5,0,10562,10569,C
6-NA,991,10534,0,9,0,10543,A
6-NA,992,2,2,10599,0,10603,G
6-NA,993,2,0,0,10865,10867,C
6-NA,994,0,10774,0,15,10789,T
6-NA,995,12,6,0,10875,10893,C
6-NA,996,6,4,0,10937,10947,C
6-NA,997,10963,1,11,1,10976,A
6-NA,998,1,0,11049,0,11050,G
6-NA,999,1,0,0,11032,11033,C
6-NA,1000,10967,0,4,0,10971,A
6-NA,1001,0,2,11012,0,11014,G
6-NA,1002,2,10566,0,3,10571,T
6-NA,1003,10570,0,7,0,10577,A
6-NA,1004,4,3,10595,0,10602,G
6-NA,1005,3,2,0,10555,10560,C
6-NA,1006,7,1,1,10599,10608,C
6-NA,1007,10477,0,2,6,10485,A
6-NA,1008,0,10479,0,3,10482,T
6-NA,1009,0,10464,0,6,10470,T
6-NA,1010,2,0,10703,1,10706,G
6-NA,1011,0,10611,0,3,10614,T
6-NA,1012,0,10603,2,4,10609,T
6-NA,1013,3,10592,0,2,10597,T
6-NA,1014,3,12,10474,0,10489,G
6-NA,1015,10,7,10560,0,10577,G
6-NA,1016,10475,0,4,0,10479,A
6-NA,1017,0,10589,0,3,10592,T
6-NA,1018,9,1,0,10590,10600,C
6-NA,1019,11,5,0,10467,10483,C
6-NA,1020,5,10480,0,10,10495,T
6-NA,1021,10517,1,12,0,10530,A
6-NA,1022,10537,0,4,0,10541,A
6-NA,1023,0,4,0,10680,10684,C
6-NA,1024,10476,0,2,0,10478,A
6-NA,1025,10511,1,1,0,10513,A
6-NA,1026,0,10444,0,1,10445,T
6-NA,1027,1,7,10430,0,10438,G
6-NA,1028,10304,3,8,0,10315,A
6-NA,1029,3,9,9992,0,10004,G
6-NA,1030,13,3,10142,0,10158,G
6-NA,1031,10105,0,4,0,10109,A
6-NA,1032,10158,1,11,0,10170,A
6-NA,1033,0,4,10218,0,10222,G
6-NA,1034,0,3,10237,0,10240,G
6-NA,1035,0,10002,0,4,10006,T
6-NA,1036,2,19,10073,0,10094,G
6-NA,1037,2,3,10268,0,10273,G
6-NA,1038,1,10063,0,9,10073,T
6-NA,1039,18,1,1,10088,10108,C
6-NA,1040,10075,0,2,1,10078,A
6-NA,1041,0,10138,0,4,10142,T
6-NA,1042,5,11,10080,1,10097,G
6-NA,1043,1,12,9998,0,10011,G
6-NA,1044,3,8,9655,0,9666,G
6-NA,1045,1,1,10123,0,10125,G
6-NA,1046,1,10097,1,5,10104,T
6-NA,1047,2,4,10138,1,10145,G
6-NA,1048,10093,0,1,0,10094,A
6-NA,1049,10100,0,5,0,10105,A
6-NA,1050,10123,1,20,1,10145,A
6-NA,1051,2,6,10194,0,10202,G
6-NA,1052,1,1,10086,0,10088,G
6-NA,1053,0,1,1,10016,10018,C
6-NA,1054,1,9773,1,8,9783,T
6-NA,1055,5,5,9757,0,9767,G
6-NA,1056,1,3,9754,0,9758,G
6-NA,1057,2,0,9842,0,9844,G
6-NA,1058,3,1,0,9796,9800,C
6-NA,1059,5,2,0,9847,9854,C
6-NA,1060,0,9728,2,14,9744,T
6-NA,1061,0,9758,0,2,9760,T
6-NA,1062,0,9796,0,2,9798,T
6-NA,1063,3,4,9807,0,9814,G
6-NA,1064,9761,0,9,0,9770,A
6-NA,1065,0,9726,1,1,9728,T
6-NA,1066,5,4,9571,0,9580,G
6-NA,1067,9447,0,8,0,9455,A
6-NA,1068,0,9484,1,2,9487,T
6-NA,1069,12,14,9509,0,9535,G
6-NA,1070,8,5,9621,0,9634,G
6-NA,1071,9560,1,1,0,9562,A
6-NA,1072,9587,0,5,0,9592,A
6-NA,1073,9583,0,1,0,9584,A
6-NA,1074,0,9547,0,2,9549,T
6-NA,1075,2,3,9582,0,9587,G
6-NA,1076,9549,0,9,0,9558,A
6-NA,1077,2,4,1,9563,9570,C
6-NA,1078,4,0,9615,0,9619,G
6-NA,1079,0,9353,0,4,9357,T
6-NA,1080,4,1,9432,0,9437,G
6-NA,1081,0,9408,0,5,9413,T
6-NA,1082,2,5,9427,0,9434,G
6-NA,1083,0,2,9507,0,9509,G
6-NA,1084,9389,0,5,0,9394,A
6-NA,1085,2,9414,0,0,9416,T
6-NA,1086,10,6,9371,0,9387,G
6-NA,1087,2,2,9354,1,9359,G
6-NA,1088,1,3,9421,0,9425,G
6-NA,1089,9303,0,2,0,9305,A
6-NA,1090,9281,1,7,0,9289,A
6-NA,1091,2,4,9306,0,9312,G
6-NA,1092,9153,1,0,0,9154,A
6-NA,1093,9143,0,5,0,9148,A
6-NA,1094,0,4,0,9126,9130,C
6-NA,1095,2,2,9107,1,9112,G
6-NA,1096,9055,0,2,0,9057,A
6-NA,1097,2,8875,0,2,8879,T
6-NA,1098,15,1,0,8949,8965,C
6-NA,1099,8948,0,11,1,8960,A
6-NA,1100,1,0,8979,1,8981,G
6-NA,1101,2,1,0,8948,8951,C
6-NA,1102,0,5,8958,1,8964,G
6-NA,1103,8903,1,1,0,8905,A
6-NA,1104,0,4,8955,0,8959,G
6-NA,1105,8920,0,6,1,8927,A
6-NA,1106,8927,1,8,0,8936,A
6-NA,1107,0,1,9024,0,9025,G
6-NA,1108,0,8915,0,7,8922,T
6-NA,1109,10,4,0,8877,8891,C
6-NA,1110,8853,0,3,0,8856,A
6-NA,1111,0,1,1,9093,9095,C
6-NA,1112,4,0,9100,0,9104,G
6-NA,1113,2,0,0,9106,9108,C
6-NA,1114,0,9036,0,4,9040,T
6-NA,1115,0,9091,0,3,9094,T
6-NA,1116,8951,0,7,0,8958,A
6-NA,1117,1,8,9139,0,9148,G
6-NA,1118,0,5,9128,0,9133,G
6-NA,1119,1,3,9267,1,9272,G
6-NA,1120,0,8714,0,6,8720,T
6-NA,1121,8740,0,2,0,8742,A
6-NA,1122,0,8720,0,4,8724,T
6-NA,1123,1,4,8711,0,8716,G
6-NA,1124,8712,2,1,0,8715,A
6-NA,1125,8664,0,4,0,8668,A
6-NA,1126,8235,0,14,0,8249,A
6-NA,1127,3,3,0,8304,8310,C
6-NA,1128,8,1,0,8114,8123,C
6-NA,1129,0,7941,1,8,7950,T
6-NA,1130,0,7925,0,12,7937,T
6-NA,1131,5,1,0,7953,7959,C
6-NA,1132,7972,1,4,0,7977,A
6-NA,1133,7974,2,0,0,7976,A
6-NA,1134,7961,1,3,0,7965,A
6-NA,1135,1,0,8022,0,8023,G
6-NA,1136,1,7832,1,1,7835,T
6-NA,1137,12,4,2,7867,7885,C
6-NA,1138,7995,1,1,1,7998,A
6-NA,1139,1,7981,0,3,7985,T
6-NA,1140,0,8024,0,6,8030,T
6-NA,1141,0,4,8020,2,8026,G
6-NA,1142,7990,0,3,0,7993,A
6-NA,1143,7984,1,8,0,7993,A
6-NA,1144,0,5,8023,1,8029,G
6-NA,1145,0,1,7993,0,7994,G
6-NA,1146,2,4,0,7958,7964,C
6-NA,1147,0,7718,2,6,7726,T
6-NA,1148,10,3,7742,0,7755,G
6-NA,1149,4,0,7863,0,7867,G
6-NA,1150,1,7820,0,10,7831,T
6-NA,1151,9,1,0,7813,7823,C
6-NA,1152,4,4,0,7788,7796,C
6-NA,1153,7752,1,7,0,7760,A
6-NA,1154,7784,0,3,0,7787,A
6-NA,1155,3,4,0,7857,7864,C
6-NA,1156,4,3,0,7821,7828,C
6-NA,1157,7,6,0,7816,7829,C
6-NA,1158,1,7466,0,1,7468,T
6-NA,1159,7462,0,3,0,7465,A
6-NA,1160,7447,0,1,0,7448,A
6-NA,1161,1,1,7507,0,7509,G
6-NA,1162,2,7371,0,14,7387,T
6-NA,1163,5,0,1,7421,7427,C
6-NA,1164,9,4,0,7306,7319,C
6-NA,1165,7330,0,1,0,7331,A
6-NA,1166,7303,0,0,0,7303,A
6-NA,1167,7329,0,1,0,7330,A
6-NA,1168,0,7294,0,0,7294,T
6-NA,1169,0,7267,4,3,7274,T
6-NA,1170,1,0,7238,0,7239,G
6-NA,1171,0,3,0,7191,7194,C
6-NA,1172,7209,1,4,0,7214,A
6-NA,1173,0,2,7230,0,7232,G
6-NA,1174,7227,1,1,0,7229,A
6-NA,1175,1,7356,0,1,7358,T
6-NA,1176,7362,0,0,1,7363,A
6-NA,1177,7345,0,2,0,7347,A
6-NA,1178,7335,0,4,0,7339,A
6-NA,1179,0,7296,0,0,7296,T
6-NA,1180,7257,1,8,0,7266,A
6-NA,1181,1,1,7260,1,7263,G
6-NA,1182,4,1,7198,0,7203,G
6-NA,1183,2,0,0,7181,7183,C
6-NA,1184,6917,0,3,1,6921,A
6-NA,1185,6991,1,2,0,6994,A
6-NA,1186,1,2,7028,0,7031,G
6-NA,1187,1,6994,0,8,7003,T
6-NA,1188,10,1,0,7008,7019,C
6-NA,1189,7042,0,3,0,7045,A
6-NA,1190,0,7016,0,0,7016,T
6-NA,1191,7069,0,2,0,7071,A
6-NA,1192,1,0,7081,1,7083,G
6-NA,1193,0,7083,0,0,7083,T
6-NA,1194,0,6848,0,1,6849,T
6-NA,1195,2,4,6731,0,6737,G
6-NA,1196,6676,1,9,1,6687,A
6-NA,1197,1,3,1,6675,6680,C
6-NA,1198,6590,0,1,0,6591,A
6-NA,1199,0,0,6684,0,6684,G
6-NA,1200,6603,2,7,0,6612,A
6-NA,1201,2,10,6800,0,6812,G
6-NA,1202,1,0,6819,0,6820,G
6-NA,1203,1,6767,0,1,6769,T
6-NA,1204,6760,7,2,0,6769,A
6-NA,1205,6741,0,12,0,6753,A
6-NA,1206,0,6746,2,1,6749,T
6-NA,1207,6716,0,1,0,6717,A
6-NA,1208,2,7,6516,0,6525,G
6-NA,1209,3,3,6347,0,6353,G
6-NA,1210,0,5665,1,2,5668,T
6-NA,1211,5,1,0,5641,5647,C
6-NA,1212,1,2,0,5626,5629,C
6-NA,1213,4,0,5639,0,5643,G
6-NA,1214,2,1,5655,0,5658,G
6-NA,1215,0,5646,1,2,5649,T
6-NA,1216,0,5617,0,1,5618,T
6-NA,1217,5567,0,1,0,5568,A
6-NA,1218,0,5429,0,0,5429,T
6-NA,1219,0,5436,0,0,5436,T
6-NA,1220,2,1,1,5418,5422,C
6-NA,1221,1,5200,0,3,5204,T
6-NA,1222,0,4,5217,0,5221,G
6-NA,1223,7,0,5212,0,5219,G
6-NA,1224,0,5204,0,3,5207,T
6-NA,1225,5224,0,0,0,5224,A
6-NA,1226,0,5148,0,1,5149,T
6-NA,1227,0,5140,0,7,5147,T
6-NA,1228,0,5141,0,4,5145,T
6-NA,1229,1,5140,0,6,5147,T
6-NA,1230,2,3,0,5146,5151,C
6-NA,1231,0,5039,0,7,5046,T
6-NA,1232,3,1,0,5095,5099,C
6-NA,1233,0,5091,0,0,5091,T
6-NA,1234,0,0,5189,0,5189,G
6-NA,1235,0,5186,0,1,5187,T
6-NA,1236,0,5153,0,2,5155,T
6-NA,1237,2,0,5173,0,5175,G
6-NA,1238,5113,0,0,0,5113,A
6-NA,1239,5102,2,13,0,5117,A
6-NA,1240,1,1,5139,0,5141,G
6-NA,1241,1,1,5125,0,5127,G
6-NA,1242,6,1,0,5127,5134,C
6-NA,1243,5050,0,1,0,5051,A
6-NA,1244,5049,0,3,1,5053,A
6-NA,1245,5073,0,0,0,5073,A
6-NA,1246,5083,0,8,0,5091,A
6-NA,1247,0,0,5078,0,5078,G
6-NA,1248,2,4,0,5073,5079,C
6-NA,1249,1,4989,0,5,4995,T
6-NA,1250,5,1,5046,0,5052,G
6-NA,1251,0,0,0,5047,5047,C
6-NA,1252,5054,0,3,0,5057,A
6-NA,1253,1,5030,0,5,5036,T
6-NA,1254,3,4,0,4990,4997,C
6-NA,1255,4994,0,1,0,4995,A
6-NA,1256,5010,0,0,0,5010,A
6-NA,1257,0,4974,0,2,4976,T
6-NA,1258,3,4,0,5017,5024,C
6-NA,1259,1,0,4939,0,4940,G
6-NA,1260,0,0,5042,0,5042,G
6-NA,1261,1,5031,0,4,5036,T
6-NA,1262,3,0,5036,0,5039,G
6-NA,1263,1,0,0,5053,5054,C
6-NA,1264,0,5041,0,12,5053,T
6-NA,1265,0,5107,0,0,5107,T
6-NA,1266,0,5111,0,1,5112,T
6-NA,1267,0,5126,0,0,5126,T
6-NA,1268,5155,0,0,0,5155,A
6-NA,1269,0,4937,0,1,4938,T
6-NA,1270,5,0,4952,1,4958,G
6-NA,1271,0,4878,0,5,4883,T
6-NA,1272,0,2,4827,0,4829,G
6-NA,1273,1,4,4924,0,4929,G
6-NA,1274,4812,0,2,0,4814,A
6-NA,1275,2,0,4876,0,4878,G
6-NA,1276,0,4845,0,1,4846,T
6-NA,1277,0,4813,0,3,4816,T
6-NA,1278,2,0,4868,0,4870,G
6-NA,1279,4850,1,4,0,4855,A
6-NA,1280,0,4856,0,0,4856,T
6-NA,1281,4829,0,3,0,4832,A
6-NA,1282,4647,2,4,0,4653,A
6-NA,1283,0,5,4690,0,4695,G
6-NA,1284,1,1,4610,0,4612,G
6-NA,1285,0,1,4580,1,4582,G
6-NA,1286,0,0,4572,0,4572,G
6-NA,1287,4509,0,8,0,4517,A
6-NA,1288,4495,0,5,0,4500,A
6-NA,1289,0,3,4515,0,4518,G
6-NA,1290,4517,0,7,0,4524,A
6-NA,1291,4524,0,3,0,4527,A
6-NA,1292,4465,0,5,0,4470,A
6-NA,1293,4385,0,4,1,4390,A
6-NA,1294,1,3,4406,1,4411,G
6-NA,1295,4349,0,3,0,4352,A
6-NA,1296,2,2,4344,1,4349,G
6-NA,1297,0,3,4344,0,4347,G
6-NA,1298,4299,0,1,0,4300,A
6-NA,1299,4307,0,1,0,4308,A
6-NA,1300,4295,0,4,0,4299,A
6-NA,1301,1,0,0,4323,4324,C
6-NA,1302,0,4292,0,1,4293,T
6-NA,1303,2,0,4316,1,4319,G
6-NA,1304,4324,0,2,0,4326,A
6-NA,1305,4306,1,4,0,4311,A
6-NA,1306,0,1,4325,0,4326,G
6-NA,1307,0,4267,0,7,4274,T
6-NA,1308,3,1,0,4334,4338,C
6-NA,1309,0,4319,0,6,4325,T
6-NA,1310,0,4300,0,3,4303,T
6-NA,1311,1,1,4308,0,4310,G
6-NA,1312,0,4281,0,5,4286,T
6-NA,1313,0,1,4279,0,4280,G
6-NA,1314,2,3,4257,0,4262,G
6-NA,1315,4192,0,2,0,4194,A
6-NA,1316,2,0,0,4195,4197,C
6-NA,1317,6,0,0,4115,4121,C
6-NA,1318,1,4135,0,6,4142,T
6-NA,1319,3,1,0,4148,4152,C
6-NA,1320,4170,0,1,0,4171,A
6-NA,1321,4170,0,0,0,4170,A
6-NA,1322,4168,0,1,0,4169,A
6-NA,1323,0,2,0,4208,4210,C
6-NA,1324,4106,0,0,0,4106,A
6-NA,1325,1,0,4149,0,4150,G
6-NA,1326,0,4069,1,0,4070,T
6-NA,1327,4072,0,1,0,4073,A
6-NA,1328,0,4063,0,1,4064,T
6-NA,1329,0,4014,0,0,4014,T
6-NA,1330,1,0,4049,0,4050,G
6-NA,1331,0,4024,0,4,4028,T
6-NA,1332,0,3862,0,6,3868,T
6-NA,1333,1,0,3874,0,3875,G
6-NA,1334,0,3621,0,2,3623,T
6-NA,1335,2,1,3635,0,3638,G
6-NA,1336,1,3614,0,3,3618,T
6-NA,1337,0,3563,0,1,3564,T
6-NA,1338,1,3568,0,1,3570,T
6-NA,1339,0,3458,0,0,3458,T
6-NA,1340,1,1,3465,0,3467,G
6-NA,1341,0,3465,1,2,3468,T
6-NA,1342,1,2,3438,0,3441,G
6-NA,1343,0,1,3425,0,3426,G
6-NA,1344,3,3,0,3354,3360,C
6-NA,1345,3339,0,2,0,3341,A
6-NA,1346,1,0,0,3383,3384,C
6-NA,1347,1,11,0,3363,3375,C
6-NA,1348,0,3384,0,2,3386,T
6-NA,1349,1,0,0,3407,3408,C
6-NA,1350,3406,0,6,0,3412,A
6-NA,1351,0,3,3434,0,3437,G
6-NA,1352,0,1,3438,0,3439,G
6-NA,1353,1,3401,1,1,3404,T
6-NA,1354,3389,0,1,0,3390,A
6-NA,1355,0,1,0,3223,3224,C
6-NA,1356,3188,0,3,0,3191,A
6-NA,1357,0,3181,1,1,3183,T
6-NA,1358,3095,0,2,0,3097,A
6-NA,1359,0,3088,0,2,3090,T
6-NA,1360,0,0,2865,0,2865,G
6-NA,1361,1,1,2853,0,2855,G
6-NA,1362,2824,0,1,0,2825,A
6-NA,1363,2796,0,1,0,2797,A
6-NA,1364,0,0,0,2785,2785,C
6-NA,1365,2336,0,0,0,2336,A
6-NA,1366,0,0,2334,0,2334,G
6-NA,1367,0,0,2315,0,2315,G
6-NA,1368,0,1,0,2317,2318,C
6-NA,1369,0,2323,0,1,2324,T
6-NA,1370,2,0,0,2185,2187,C
6-NA,1371,2179,0,1,0,2180,A
6-NA,1372,0,2175,0,4,2179,T
6-NA,1373,4,0,2182,0,2186,G
6-NA,1374,0,0,2176,0,2176,G
6-NA,1375,0,0,0,2085,2085,C
6-NA,1376,0,0,0,2070,2070,C
6-NA,1377,1,1940,0,1,1942,T
6-NA,1378,0,0,1942,0,1942,G
6-NA,1379,1941,0,1,0,1942,A
6-NA,1380,0,1936,2,0,1938,T
6-NA,1381,0,2,1902,0,1904,G
6-NA,1382,1,1,1871,0,1873,G
6-NA,1383,0,0,1766,0,1766,G
6-NA,1384,0,0,1752,0,1752,G
6-NA,1385,0,0,0,1713,1713,C
6-NA,1386,0,3,1717,0,1720,G
6-NA,1387,0,0,1701,0,1701,G
6-NA,1388,1671,0,0,0,1671,A
6-NA,1389,0,0,1,1663,1664,C
6-NA,1390,1656,0,0,0,1656,A
6-NA,1391,0,1636,0,0,1636,T
6-NA,1392,1,0,0,1615,1616,C
6-NA,1393,1602,0,1,0,1603,A
6-NA,1394,1610,0,0,0,1610,A
6-NA,1395,0,1601,0,1,1602,T
6-NA,1396,1,2,0,1555,1558,C
6-NA,1397,0,1516,0,0,1516,T
6-NA,1398,2,0,0,1332,1334,C
6-NA,1399,1317,0,3,0,1320,A
6-NA,1400,0,1315,0,1,1316,T
6-NA,1401,1,0,1310,0,1311,G
6-NA,1402,0,1,0,1306,1307,C
6-NA,1403,1,0,0,1254,1255,C
6-NA,1404,1,1130,3,0,1134,T
6-NA,1405,1126,0,0,0,1126,A
6-NA,1406,1,1126,0,0,1127,T
6-NA,1407,1107,0,0,0,1107,A
6-NA,1408,0,1102,0,0,1102,T
6-NA,1409,1005,0,0,0,1005,A
6-NA,1410,960,0,0,0,960,A
7-M,1,212,0,0,0,212,A
7-M,2,0,217,0,0,217,T
7-M,3,0,0,221,0,221,G
7-M,4,225,0,0,0,225,A
7-M,5,0,0,259,0,259,G
7-M,6,0,0,0,279,279,C
7-M,7,0,0,0,295,295,C
7-M,8,0,381,0,0,381,T
7-M,9,0,391,0,0,391,T
7-M,10,0,0,0,397,397,C
7-M,11,0,396,0,0,396,T
7-M,12,409,0,0,0,409,A
7-M,13,411,0,0,0,411,A
7-M,14,0,0,0,412,412,C
7-M,15,0,0,0,411,411,C
7-M,16,0,2,408,0,410,G
7-M,17,410,0,1,0,411,A
7-M,18,0,0,423,0,423,G
7-M,19,0,0,444,0,444,G
7-M,20,0,426,0,0,426,T
7-M,21,0,1,0,441,442,C
7-M,22,0,0,443,0,443,G
7-M,23,456,0,1,0,457,A
7-M,24,465,0,0,0,465,A
7-M,25,471,0,0,0,471,A
7-M,26,0,0,0,513,513,C
7-M,27,0,0,520,0,520,G
7-M,28,0,510,0,0,510,T
7-M,29,532,0,0,0,532,A
7-M,30,0,536,0,0,536,T
7-M,31,0,0,547,0,547,G
7-M,32,0,548,0,0,548,T
7-M,33,0,620,0,0,620,T
7-M,34,0,0,0,643,643,C
7-M,35,0,650,0,1,651,T
7-M,36,0,1,0,678,679,C
7-M,37,0,680,0,1,681,T
7-M,38,0,0,0,721,721,C
7-M,39,0,727,0,0,727,T
7-M,40,729,0,0,0,729,A
7-M,41,0,733,0,0,733,T
7-M,42,0,0,0,740,740,C
7-M,43,1,0,751,0,752,G
7-M,44,0,756,0,1,757,T
7-M,45,0,756,0,0,756,T
7-M,46,2,0,0,775,777,C
7-M,47,1,0,0,808,809,C
7-M,48,815,0,0,0,815,A
7-M,49,0,812,0,0,812,T
7-M,50,0,0,0,813,813,C
7-M,51,810,0,0,0,810,A
7-M,52,0,0,805,0,805,G
7-M,53,0,0,814,0,814,G
7-M,54,0,1,0,817,818,C
7-M,55,1,0,0,818,819,C
7-M,56,0,0,0,832,832,C
7-M,57,1,0,0,869,870,C
7-M,58,0,0,0,871,871,C
7-M,59,0,873,0,1,874,T
7-M,60,1,0,0,875,876,C
7-M,61,874,0,0,0,874,A
7-M,62,874,0,0,0,874,A
7-M,63,896,0,1,0,897,A
7-M,64,0,0,915,0,915,G
7-M,65,0,0,0,910,910,C
7-M,66,0,0,0,907,907,C
7-M,67,0,1,912,0,913,G
7-M,68,907,0,2,0,909,A
7-M,69,0,0,918,0,918,G
7-M,70,925,0,0,0,925,A
7-M,71,0,932,0,0,932,T
7-M,72,1,0,0,928,929,C
7-M,73,1,0,927,0,928,G
7-M,74,0,1,0,931,932,C
7-M,75,1,0,928,0,929,G
7-M,76,0,0,0,935,935,C
7-M,77,931,0,0,0,931,A
7-M,78,0,0,945,0,945,G
7-M,79,921,0,0,0,921,A
7-M,80,0,0,1006,1,1007,G
7-M,81,1003,1,1,0,1005,A
7-M,82,0,0,0,1022,1022,C
7-M,83,0,1029,0,0,1029,T
7-M,84,0,1021,0,0,1021,T
7-M,85,1,0,1032,0,1033,G
7-M,86,1032,0,0,0,1032,A
7-M,87,1032,0,0,0,1032,A
7-M,88,1,0,1035,0,1036,G
7-M,89,1016,1,0,0,1017,A
7-M,90,0,1036,0,0,1036,T
7-M,91,0,0,1042,0,1042,G
7-M,92,0,1039,0,1,1040,T
7-M,93,0,0,0,1040,1040,C
7-M,94,0,1043,1,0,1044,T
7-M,95,0,1037,0,0,1037,T
7-M,96,0,1045,0,1,1046,T
7-M,97,0,0,1043,0,1043,G
7-M,98,0,0,0,1040,1040,C
7-M,99,0,1044,0,0,1044,T
7-M,100,0,0,1030,0,1030,G
7-M,101,0,3,1028,0,1031,G
7-M,102,1022,0,2,0,1024,A
7-M,103,1050,0,0,0,1050,A
7-M,104,1049,0,0,0,1049,A
7-M,105,1054,0,0,0,1054,A
7-M,106,1049,0,0,0,1049,A
7-M,107,1055,0,2,0,1057,A
7-M,108,1,0,0,1068,1069,C
7-M,109,1065,0,0,0,1065,A
7-M,110,0,0,0,1070,1070,C
7-M,111,1060,0,1,0,1061,A
7-M,112,0,0,1100,0,1100,G
7-M,113,1113,0,0,0,1113,A
7-M,114,0,1142,0,0,1142,T
7-M,115,0,0,0,1163,1163,C
7-M,116,0,1162,1,0,1163,T
7-M,117,0,1162,0,1,1163,T
7-M,118,0,2,1161,0,1163,G
7-M,119,1158,0,1,0,1159,A
7-M,120,0,1,1159,0,1160,G
7-M,121,0,0,1153,0,1153,G
7-M,122,0,1,0,1167,1168,C
7-M,123,0,1162,0,0,1162,T
7-M,124,0,0,0,1277,1277,C
7-M,125,0,1268,0,1,1269,T
7-M,126,1,0,0,1289,1290,C
7-M,127,1287,0,1,0,1288,A
7-M,128,0,1286,0,2,1288,T
7-M,129,0,0,1289,0,1289,G
7-M,130,0,2,1294,0,1296,G
7-M,131,1287,0,0,0,1287,A
7-M,132,1279,0,1,0,1280,A
7-M,133,0,1240,0,3,1243,T
7-M,134,0,1,1301,0,1302,G
7-M,135,0,1,1356,0,1357,G
7-M,136,0,0,0,1360,1360,C
7-M,137,0,1368,0,0,1368,T
7-M,138,1371,0,0,0,1371,A
7-M,139,1355,0,0,0,1355,A
7-M,140,1380,0,1,0,1381,A
7-M,141,0,0,1392,0,1392,G
7-M,142,1384,1,1,0,1386,A
7-M,143,0,0,0,1390,1390,C
7-M,144,1351,0,1,0,1352,A
7-M,145,1350,0,1,0,1351,A
7-M,146,0,0,1376,0,1376,G
7-M,147,1374,2,1,0,1377,A
7-M,148,1,0,0,1382,1383,C
7-M,149,1,0,0,1382,1383,C
7-M,150,1378,0,1,1,1380,A
7-M,151,1400,0,1,0,1401,A
7-M,152,0,1409,0,0,1409,T
7-M,153,0,1407,0,0,1407,T
7-M,154,1,0,1,1427,1429,C
7-M,155,0,1415,0,0,1415,T
7-M,156,0,1,1419,0,1420,G
7-M,157,0,1412,0,5,1417,T
7-M,158,0,0,0,1421,1421,C
7-M,159,1416,0,1,0,1417,A
7-M,160,0,0,0,1456,1456,C
7-M,161,0,0,0,1455,1455,C
7-M,162,0,1449,0,1,1450,T
7-M,163,0,0,0,1462,1462,C
7-M,164,0,1452,1,0,1453,T
7-M,165,0,1,1505,0,1506,G
7-M,166,1500,0,1,0,1501,A
7-M,167,0,1,0,1514,1515,C
7-M,168,0,1518,0,0,1518,T
7-M,169,1501,0,2,0,1503,A
7-M,170,1503,0,0,0,1503,A
7-M,171,1482,0,1,0,1483,A
7-M,172,0,0,1484,0,1484,G
7-M,173,0,0,1495,0,1495,G
7-M,174,0,1,1509,0,1510,G
7-M,175,1513,0,0,0,1513,A
7-M,176,1,1522,0,0,1523,T
7-M,177,0,1531,0,0,1531,T
7-M,178,0,1530,0,2,1532,T
7-M,179,0,1538,0,0,1538,T
7-M,180,0,0,1531,0,1531,G
7-M,181,2,0,1532,0,1534,G
7-M,182,0,2,1540,0,1542,G
7-M,183,0,0,1538,0,1538,G
7-M,184,0,1510,0,0,1510,T
7-M,185,0,1519,0,1,1520,T
7-M,186,0,1524,1,0,1525,T
7-M,187,0,0,1564,0,1564,G
7-M,188,0,1564,0,0,1564,T
7-M,189,0,1,1574,0,1575,G
7-M,190,0,1581,0,0,1581,T
7-M,191,0,1574,0,1,1575,T
7-M,192,0,0,0,1596,1596,C
7-M,193,1597,0,2,0,1599,A
7-M,194,0,1,0,1624,1625,C
7-M,195,1,1,1609,0,1611,G
7-M,196,1,2,0,1613,1616,C
7-M,197,0,1589,0,2,1591,T
7-M,198,0,0,0,1648,1648,C
7-M,199,1649,0,0,0,1649,A
7-M,200,0,0,0,1667,1667,C
7-M,201,0,0,0,1658,1658,C
7-M,202,2,0,1669,0,1671,G
7-M,203,0,1681,0,1,1682,T
7-M,204,1,0,1700,0,1701,G
7-M,205,0,2,0,1697,1699,C
7-M,206,1,1,0,1687,1689,C
7-M,207,2,0,0,1698,1700,C
7-M,208,1685,0,1,0,1686,A
7-M,209,0,0,1723,0,1723,G
7-M,210,0,1706,0,0,1706,T
7-M,211,0,2,1717,0,1719,G
7-M,212,1748,0,0,0,1748,A
7-M,213,0,1,1748,0,1749,G
7-M,214,0,1,0,1738,1739,C
7-M,215,0,1,1751,0,1752,G
7-M,216,1734,0,1,0,1735,A
7-M,217,1,1,1757,0,1759,G
7-M,218,0,1,1760,0,1761,G
7-M,219,1750,0,1,0,1751,A
7-M,220,0,0,0,1796,1796,C
7-M,221,0,1778,0,2,1780,T
7-M,222,0,0,1783,0,1783,G
7-M,223,0,0,0,1770,1770,C
7-M,224,1769,0,6,2,1777,A
7-M,225,1,0,1831,0,1832,G
7-M,226,1,0,0,1814,1815,C
7-M,227,1,1,1829,0,1831,G
7-M,228,0,1834,0,1,1835,T
7-M,229,1811,0,3,0,1814,A
7-M,230,0,0,1820,0,1820,G
7-M,231,1805,0,1,0,1806,A
7-M,232,0,0,0,1816,1816,C
7-M,233,0,0,1823,0,1823,G
7-M,234,0,0,0,1808,1808,C
7-M,235,0,1789,0,0,1789,T
7-M,236,1,1777,0,0,1778,T
7-M,237,0,1770,0,0,1770,T
7-M,238,2,0,1799,0,1801,G
7-M,239,0,1800,0,0,1800,T
7-M,240,0,0,0,1800,1800,C
7-M,241,1,0,1,1802,1804,C
7-M,242,1810,0,0,1,1811,A
7-M,243,1809,0,0,0,1809,A
7-M,244,1803,0,0,0,1803,A
7-M,245,1805,1,0,0,1806,A
7-M,246,0,1806,0,0,1806,T
7-M,247,0,1,1795,0,1796,G
7-M,248,0,1,0,1777,1778,C
7-M,249,3,0,0,1786,1789,C
7-M,250,1,1,0,1803,1805,C
7-M,251,0,1805,0,0,1805,T
7-M,252,0,0,0,1867,1867,C
7-M,253,1871,0,1,0,1872,A
7-M,254,1893,0,0,0,1893,A
7-M,255,0,1943,0,1,1944,T
7-M,256,0,1,1931,0,1932,G
7-M,257,0,1,1934,0,1935,G
7-M,258,0,1862,2,0,1864,T
7-M,259,1966,2,0,0,1968,A
7-M,260,1970,0,0,0,1970,A
7-M,261,0,1974,0,0,1974,T
7-M,262,0,2,1967,0,1969,G
7-M,263,0,2,1966,0,1968,G
7-M,264,1887,0,3,0,1890,A
7-M,265,0,2,1890,0,1892,G
7-M,266,1859,1,1,0,1861,A
7-M,267,0,2,0,1840,1842,C
7-M,268,2,1,0,1923,1926,C
7-M,269,4,0,0,1932,1936,C
7-M,270,1968,0,0,0,1968,A
7-M,271,1966,0,1,0,1967,A
7-M,272,1969,0,0,0,1969,A
7-M,273,0,1972,0,1,1973,T
7-M,274,2014,0,0,0,2014,A
7-M,275,2014,0,0,0,2014,A
7-M,276,0,1,0,1980,1981,C
7-M,277,1964,0,1,0,1965,A
7-M,278,0,1963,0,0,1963,T
7-M,279,0,3,1982,0,1985,G
7-M,280,0,0,1985,0,1985,G
7-M,281,1986,0,2,0,1988,A
7-M,282,0,0,0,1991,1991,C
7-M,283,1949,0,0,0,1949,A
7-M,284,1962,0,0,0,1962,A
7-M,285,1954,0,0,0,1954,A
7-M,286,0,1,1983,0,1984,G
7-M,287,0,0,0,2017,2017,C
7-M,288,1998,0,0,0,1998,A
7-M,289,0,0,2035,0,2035,G
7-M,290,0,2023,0,0,2023,T
7-M,291,1,2031,0,1,2033,T
7-M,292,2050,0,0,0,2050,A
7-M,293,2040,0,0,1,2041,A
7-M,294,2043,1,1,0,2045,A
7-M,295,1,1,0,2068,2070,C
7-M,296,0,2036,0,0,2036,T
7-M,297,0,0,2237,2,2239,G
7-M,298,1,2205,0,1,2207,T
7-M,299,2233,0,0,0,2233,A
7-M,300,0,2235,1,0,2236,T
7-M,301,2230,0,0,0,2230,A
7-M,302,1,3,2231,0,2235,G
7-M,303,0,2,2213,1,2216,G
7-M,304,2220,0,0,0,2220,A
7-M,305,2214,0,1,0,2215,A
7-M,306,2113,0,1,0,2114,A
7-M,307,0,0,0,2158,2158,C
7-M,308,0,2164,0,0,2164,T
7-M,309,0,2171,0,0,2171,T
7-M,310,2165,4,1,0,2170,A
7-M,311,2158,1,2,0,2161,A
7-M,312,1,1,2169,0,2171,G
7-M,313,2159,0,3,0,2162,A
7-M,314,0,5,2167,0,2172,G
7-M,315,0,0,2180,0,2180,G
7-M,316,0,2,2185,0,2187,G
7-M,317,2171,0,4,0,2175,A
7-M,318,0,1,2179,0,2180,G
7-M,319,2191,0,2,0,2193,A
7-M,320,0,2196,1,0,2197,T
7-M,321,2207,0,0,0,2207,A
7-M,322,2198,0,1,1,2200,A
7-M,323,1,0,0,2209,2210,C
7-M,324,28,0,2167,1,2196,G
7-M,325,0,2181,0,5,2186,T
7-M,326,0,2172,0,3,2175,T
7-M,327,2,0,0,2186,2188,C
7-M,328,2,0,0,2190,2192,C
7-M,329,2187,0,0,0,2187,A
7-M,330,0,2198,2,1,2201,T
7-M,331,0,7,2173,0,2180,G
7-M,332,0,4,2168,0,2172,G
7-M,333,0,3,2160,0,2163,G
7-M,334,1,0,2171,0,2172,G
7-M,335,1,2,1,2152,2156,C
7-M,336,1,0,0,2165,2166,C
7-M,337,2177,0,0,0,2177,A
7-M,338,2190,0,0,0,2190,A
7-M,339,2189,0,0,0,2189,A
7-M,340,0,1,2203,0,2204,G
7-M,341,2219,0,0,0,2219,A
7-M,342,2202,0,1,0,2203,A
7-M,343,2197,0,0,0,2197,A
7-M,344,0,2196,0,0,2196,T
7-M,345,2196,0,1,0,2197,A
7-M,346,0,0,2191,0,2191,G
7-M,347,1,0,0,2176,2177,C
7-M,348,0,2169,0,1,2170,T
7-M,349,1,0,0,2179,2180,C
7-M,350,0,2151,0,2,2153,T
7-M,351,0,0,0,2224,2224,C
7-M,352,2232,0,1,0,2233,A
7-M,353,0,0,2228,0,2228,G
7-M,354,0,2207,0,2,2209,T
7-M,355,0,2241,0,0,2241,T
7-M,356,2248,0,0,0,2248,A
7-M,357,0,2239,0,0,2239,T
7-M,358,0,2230,0,0,2230,T
7-M,359,4,0,1,2241,2246,C
7-M,360,0,2175,0,0,2175,T
7-M,361,0,0,2197,0,2197,G
7-M,362,0,0,0,2188,2188,C
7-M,363,0,2188,0,0,2188,T
7-M,364,0,0,2182,0,2182,G
7-M,365,3,0,2170,0,2173,G
7-M,366,0,2161,0,2,2163,T
7-M,367,0,0,2181,0,2181,G
7-M,368,0,1,0,2174,2175,C
7-M,369,2167,0,2,0,2169,A
7-M,370,0,0,0,2186,2186,C
7-M,371,0,2171,0,0,2171,T
7-M,372,0,2196,0,1,2197,T
7-M,373,0,0,2201,0,2201,G
7-M,374,0,2,0,2186,2188,C
7-M,375,0,1,0,2198,2199,C
7-M,376,2197,0,0,0,2197,A
7-M,377,1,1,2206,0,2208,G
7-M,378,0,2198,0,0,2198,T
7-M,379,0,2196,0,0,2196,T
7-M,380,0,0,2216,0,2216,G
7-M,381,1,0,0,2191,2192,C
7-M,382,2188,0,1,2,2191,A
7-M,383,0,2189,0,2,2191,T
7-M,384,0,1,2179,0,2180,G
7-M,385,0,0,2218,0,2218,G
7-M,386,1,0,2235,0,2236,G
7-M,387,1,2,0,2229,2232,C
7-M,388,0,0,0,2277,2277,C
7-M,389,0,2283,0,5,2288,T
7-M,390,1,0,0,2317,2318,C
7-M,391,2414,0,1,1,2416,A
7-M,392,0,2431,0,0,2431,T
7-M,393,2492,0,0,0,2492,A
7-M,394,0,2469,0,0,2469,T
7-M,395,2441,0,0,0,2441,A
7-M,396,0,0,0,2572,2572,C
7-M,397,2500,0,0,0,2500,A
7-M,398,2490,0,0,0,2490,A
7-M,399,0,2478,0,0,2478,T
7-M,400,2358,0,0,1,2359,A
7-M,401,0,1,2378,0,2379,G
7-M,402,1,1,2330,0,2332,G
7-M,403,2308,1,0,0,2309,A
7-M,404,0,2324,0,0,2324,T
7-M,405,0,2,2182,0,2184,G
7-M,406,1,4,2170,1,2176,G
7-M,407,0,2,2157,0,2159,G
7-M,408,1,3,2200,0,2204,G
7-M,409,4,0,2179,0,2183,G
7-M,410,0,1,0,2173,2174,C
7-M,411,0,2155,0,0,2155,T
7-M,412,0,1,2165,0,2166,G
7-M,413,0,2161,0,0,2161,T
7-M,414,2168,0,0,0,2168,A
7-M,415,2151,0,2,0,2153,A
7-M,416,0,1,0,2180,2181,C
7-M,417,2,0,0,2150,2152,C
7-M,418,2133,0,1,0,2134,A
7-M,419,0,0,0,2148,2148,C
7-M,420,0,2144,0,1,2145,T
7-M,421,0,1,2157,0,2158,G
7-M,422,2145,0,0,0,2145,A
7-M,423,2124,0,0,0,2124,A
7-M,424,0,0,2144,0,2144,G
7-M,425,0,2113,0,0,2113,T
7-M,426,0,2,2122,0,2124,G
7-M,427,0,1,2131,0,2132,G
7-M,428,2,0,0,2144,2146,C
7-M,429,2150,0,0,0,2150,A
7-M,430,0,2125,0,6,2131,T
7-M,431,0,2134,0,0,2134,T
7-M,432,21,2111,0,0,2132,T
7-M,433,0,3,2183,0,2186,G
7-M,434,0,0,2182,0,2182,G
7-M,435,0,1,0,2172,2173,C
7-M,436,1,0,0,2188,2189,C
7-M,437,0,2170,0,5,2175,T
7-M,438,0,3,2243,1,2247,G
7-M,439,0,0,2255,0,2255,G
7-M,440,0,2239,0,0,2239,T
7-M,441,2258,0,0,0,2258,A
7-M,442,0,2146,0,0,2146,T
7-M,443,0,2,2176,0,2178,G
7-M,444,1,2172,0,0,2173,T
7-M,445,2,0,2181,0,2183,G
7-M,446,0,2,0,2187,2189,C
7-M,447,2119,0,2,0,2121,A
7-M,448,2117,0,0,0,2117,A
7-M,449,0,1,0,2130,2131,C
7-M,450,2127,0,0,0,2127,A
7-M,451,0,2136,0,0,2136,T
7-M,452,1,0,2112,0,2113,G
7-M,453,0,2074,0,0,2074,T
7-M,454,2,2,2079,0,2083,G
7-M,455,2063,0,3,0,2066,A
7-M,456,0,1,2069,0,2070,G
7-M,457,0,1,0,2059,2060,C
7-M,458,2028,0,1,0,2029,A
7-M,459,0,0,2045,0,2045,G
7-M,460,2033,0,0,0,2033,A
7-M,461,0,2033,0,0,2033,T
7-M,462,0,2024,0,2,2026,T
7-M,463,0,0,2036,0,2036,G
7-M,464,0,0,0,2036,2036,C
7-M,465,0,2033,0,1,2034,T
7-M,466,0,0,2032,0,2032,G
7-M,467,2034,0,0,0,2034,A
7-M,468,0,0,0,2120,2120,C
7-M,469,0,2126,0,2,2128,T
7-M,470,3,1,0,2128,2132,C
7-M,471,2,1,0,2116,2119,C
7-M,472,4,0,0,2119,2123,C
7-M,473,2126,0,1,0,2127,A
7-M,474,1,1,2132,0,2134,G
7-M,475,0,0,0,2146,2146,C
7-M,476,2149,0,0,0,2149,A
7-M,477,0,0,0,2140,2140,C
7-M,478,2014,0,2,0,2016,A
7-M,479,0,1,2060,0,2061,G
7-M,480,0,0,2055,0,2055,G
7-M,481,2,2030,0,0,2032,T
7-M,482,0,1,0,2077,2078,C
7-M,483,0,2073,0,3,2076,T
7-M,484,1,0,0,2083,2084,C
7-M,485,2077,0,1,0,2078,A
7-M,486,0,2073,0,0,2073,T
7-M,487,2079,0,0,0,2079,A
7-M,488,0,0,2047,0,2047,G
7-M,489,0,0,2035,0,2035,G
7-M,490,0,2,0,2040,2042,C
7-M,491,1967,0,0,0,1967,A
7-M,492,1,1,1947,0,1949,G
7-M,493,1959,0,0,0,1959,A
7-M,494,0,1961,0,1,1962,T
7-M,495,0,1,1964,0,1965,G
7-M,496,1,0,1951,0,1952,G
7-M,497,0,1923,1,0,1924,T
7-M,498,0,0,1949,0,1949,G
7-M,499,1,1,1942,0,1944,G
7-M,500,0,1,0,1954,1955,C
7-M,501,1936,0,0,0,1936,A
7-M,502,1924,0,0,0,1924,A
7-M,503,0,1,0,1950,1951,C
7-M,504,1948,1,0,0,1949,A
7-M,505,1941,0,0,0,1941,A
7-M,506,0,1,0,1945,1946,C
7-M,507,0,1,0,1916,1917,C
7-M,508,1900,0,0,0,1900,A
7-M,509,1900,0,1,0,1901,A
7-M,510,0,1903,0,0,1903,T
7-M,511,0,0,0,1912,1912,C
7-M,512,0,0,0,1907,1907,C
7-M,513,1880,0,3,0,1883,A
7-M,514,0,1884,0,1,1885,T
7-M,515,0,1889,0,0,1889,T
7-M,516,1892,0,2,1,1895,A
7-M,517,1897,0,1,0,1898,A
7-M,518,0,1896,0,0,1896,T
7-M,519,1892,0,0,0,1892,A
7-M,520,1888,0,0,0,1888,A
7-M,521,1875,0,0,2,1877,A
7-M,522,1883,0,0,0,1883,A
7-M,523,0,0,0,1927,1927,C
7-M,524,1928,0,0,0,1928,A
7-M,525,0,1914,0,0,1914,T
7-M,526,1,1,1918,0,1920,G
7-M,527,1911,0,1,0,1912,A
7-M,528,0,4,1921,0,1925,G
7-M,529,1918,0,1,1,1920,A
7-M,530,1921,0,0,0,1921,A
7-M,531,0,1,0,1936,1937,C
7-M,532,1880,0,1,0,1881,A
7-M,533,1,4,1897,0,1902,G
7-M,534,1882,0,0,0,1882,A
7-M,535,1884,0,1,0,1885,A
7-M,536,0,1877,0,1,1878,T
7-M,537,0,0,1881,0,1881,G
7-M,538,0,0,1875,0,1875,G
7-M,539,0,1858,0,0,1858,T
7-M,540,0,1841,0,0,1841,T
7-M,541,0,1862,0,1,1863,T
7-M,542,0,1881,0,0,1881,T
7-M,543,0,1,1900,0,1901,G
7-M,544,0,0,1897,0,1897,G
7-M,545,1,0,0,1879,1880,C
7-M,546,5,1,0,1902,1908,C
7-M,547,1865,0,0,0,1865,A
7-M,548,0,0,1907,0,1907,G
7-M,549,0,0,0,1913,1913,C
7-M,550,1919,1,0,0,1920,A
7-M,551,0,0,0,1953,1953,C
7-M,552,0,1937,0,1,1938,T
7-M,553,1940,0,0,0,1940,A
7-M,554,0,0,0,1960,1960,C
7-M,555,1994,0,1,0,1995,A
7-M,556,0,0,2005,0,2005,G
7-M,557,0,0,0,1941,1941,C
7-M,558,0,1928,0,0,1928,T
7-M,559,1930,0,0,0,1930,A
7-M,560,1883,0,1,0,1884,A
7-M,561,0,3,1901,0,1904,G
7-M,562,0,1,1911,0,1912,G
7-M,563,1,0,0,1907,1908,C
7-M,564,0,1839,0,1,1840,T
7-M,565,1832,0,2,0,1834,A
7-M,566,0,1838,0,0,1838,T
7-M,567,0,2,1837,0,1839,G
7-M,568,2,1,1852,0,1855,G
7-M,569,1811,0,2,0,1813,A
7-M,570,1,0,1806,0,1807,G
7-M,571,0,0,0,1795,1795,C
7-M,572,1791,0,0,0,1791,A
7-M,573,1784,0,0,0,1784,A
7-M,574,1780,0,0,0,1780,A
7-M,575,0,1798,0,0,1798,T
7-M,576,0,0,1807,0,1807,G
7-M,577,0,0,1784,0,1784,G
7-M,578,0,0,0,1780,1780,C
7-M,579,0,1757,0,1,1758,T
7-M,580,1,1,1772,1,1775,G
7-M,581,0,0,1798,0,1798,G
7-M,582,1796,0,1,0,1797,A
7-M,583,0,1786,0,0,1786,T
7-M,584,3,0,0,1764,1767,C
7-M,585,1776,0,0,0,1776,A
7-M,586,1786,0,0,0,1786,A
7-M,587,0,0,1795,0,1795,G
7-M,588,0,1784,0,0,1784,T
7-M,589,0,4,1786,0,1790,G
7-M,590,1771,0,0,0,1771,A
7-M,591,1737,0,2,1,1740,A
7-M,592,0,1,0,1757,1758,C
7-M,593,1765,0,0,0,1765,A
7-M,594,0,0,1770,0,1770,G
7-M,595,0,0,1744,0,1744,G
7-M,596,0,2,0,1748,1750,C
7-M,597,1738,0,3,0,1741,A
7-M,598,1,0,1766,0,1767,G
7-M,599,0,0,0,1759,1759,C
7-M,600,1,0,1761,1,1763,G
7-M,601,0,0,1756,0,1756,G
7-M,602,1748,0,1,0,1749,A
7-M,603,0,2,1763,0,1765,G
7-M,604,0,0,1772,0,1772,G
7-M,605,0,0,0,1759,1759,C
7-M,606,2,1,0,1785,1788,C
7-M,607,1781,0,1,0,1782,A
7-M,608,0,1786,0,0,1786,T
7-M,609,0,1,1784,0,1785,G
7-M,610,0,2,1788,0,1790,G
7-M,611,1764,0,0,0,1764,A
7-M,612,0,3,1784,0,1787,G
7-M,613,1729,0,0,0,1729,A
7-M,614,0,1774,0,0,1774,T
7-M,615,0,1769,0,0,1769,T
7-M,616,2,0,1760,0,1762,G
7-M,617,1,2,0,1753,1756,C
7-M,618,0,1763,0,1,1764,T
7-M,619,1780,0,0,0,1780,A
7-M,620,0,0,1786,0,1786,G
7-M,621,0,1758,0,0,1758,T
7-M,622,2,0,0,1767,1769,C
7-M,623,1722,0,2,0,1724,A
7-M,624,0,0,1748,0,1748,G
7-M,625,0,0,1737,0,1737,G
7-M,626,0,0,0,1726,1726,C
7-M,627,1,0,0,1733,1734,C
7-M,628,1747,0,0,0,1747,A
7-M,629,0,2,1761,0,1763,G
7-M,630,0,0,1753,0,1753,G
7-M,631,0,0,0,1753,1753,C
7-M,632,1772,0,0,0,1772,A
7-M,633,1,1,1760,0,1762,G
7-M,634,1739,0,1,0,1740,A
7-M,635,0,1745,0,0,1745,T
7-M,636,1,0,1746,0,1747,G
7-M,637,0,2,1800,0,1802,G
7-M,638,0,1746,0,1,1747,T
7-M,639,0,0,1759,0,1759,G
7-M,640,0,0,0,1757,1757,C
7-M,641,1757,0,1,1,1759,A
7-M,642,0,1,1777,0,1778,G
7-M,643,1,0,1771,0,1772,G
7-M,644,0,0,0,1771,1771,C
7-M,645,1770,0,1,0,1771,A
7-M,646,1726,0,1,0,1727,A
7-M,647,0,1732,0,0,1732,T
7-M,648,0,1,1729,0,1730,G
7-M,649,1727,0,0,0,1727,A
7-M,650,1,3,1730,0,1734,G
7-M,651,1678,0,1,0,1679,A
7-M,652,0,0,1692,0,1692,G
7-M,653,0,0,0,1693,1693,C
7-M,654,1,3,0,1721,1725,C
7-M,655,1736,0,0,0,1736,A
7-M,656,0,1740,0,0,1740,T
7-M,657,0,1740,0,0,1740,T
7-M,658,0,2,1739,0,1741,G
7-M,659,1,2,1734,0,1737,G
7-M,660,0,0,1749,0,1749,G
7-M,661,1741,0,0,0,1741,A
7-M,662,0,0,0,1717,1717,C
7-M,663,0,1662,0,3,1665,T
7-M,664,1,0,0,1672,1673,C
7-M,665,1671,1,0,0,1672,A
7-M,666,0,1724,0,1,1725,T
7-M,667,1,0,0,1747,1748,C
7-M,668,0,0,0,1744,1744,C
7-M,669,0,1737,0,1,1738,T
7-M,670,1742,0,1,0,1743,A
7-M,671,1,0,1747,0,1748,G
7-M,672,1,1808,0,1,1810,T
7-M,673,0,1774,0,2,1776,T
7-M,674,2,2,0,1776,1780,C
7-M,675,0,1,0,1726,1727,C
7-M,676,1715,0,0,1,1716,A
7-M,677,0,0,1747,0,1747,G
7-M,678,0,1739,0,0,1739,T
7-M,679,1741,0,0,0,1741,A
7-M,680,0,1,0,1736,1737,C
7-M,681,0,1635,0,0,1635,T
7-M,682,0,1,1701,0,1702,G
7-M,683,0,0,1696,0,1696,G
7-M,684,0,1684,0,1,1685,T
7-M,685,0,1630,0,2,1632,T
7-M,686,0,1670,0,0,1670,T
7-M,687,1663,0,0,0,1663,A
7-M,688,1670,1,0,1,1672,A
7-M,689,0,2,1681,0,1683,G
7-M,690,1654,0,0,0,1654,A
7-M,691,1,0,1644,0,1645,G
7-M,692,1579,0,0,0,1579,A
7-M,693,0,1577,0,1,1578,T
7-M,694,1,3,1579,0,1583,G
7-M,695,1578,0,0,0,1578,A
7-M,696,0,1566,0,0,1566,T
7-M,697,2,0,0,1580,1582,C
7-M,698,0,1564,0,0,1564,T
7-M,699,0,1570,0,0,1570,T
7-M,700,0,2,0,1571,1573,C
7-M,701,0,1573,0,0,1573,T
7-M,702,0,1574,0,0,1574,T
7-M,703,0,1,1579,0,1580,G
7-M,704,1575,0,0,0,1575,A
7-M,705,1568,0,0,1,1569,A
7-M,706,1574,0,0,0,1574,A
7-M,707,1573,0,0,0,1573,A
7-M,708,0,1571,0,0,1571,T
7-M,709,0,1575,1,0,1576,T
7-M,710,0,1583,0,0,1583,T
7-M,711,0,0,1579,0,1579,G
7-M,712,0,0,0,1572,1572,C
7-M,713,1575,1,1,0,1577,A
7-M,714,1,3,1579,0,1583,G
7-M,715,1560,0,0,0,1560,A
7-M,716,0,2,0,1608,1610,C
7-M,717,0,0,0,1598,1598,C
7-M,718,0,1596,0,2,1598,T
7-M,719,1625,0,0,0,1625,A
7-M,720,0,1616,0,0,1616,T
7-M,721,0,0,0,1624,1624,C
7-M,722,1627,0,1,1,1629,A
7-M,723,0,1,1625,0,1626,G
7-M,724,1619,0,0,0,1619,A
7-M,725,1575,0,0,0,1575,A
7-M,726,1571,1,1,0,1573,A
7-M,727,0,0,0,1575,1575,C
7-M,728,0,1,1578,0,1579,G
7-M,729,1552,0,0,0,1552,A
7-M,730,1558,0,0,0,1558,A
7-M,731,0,1575,0,0,1575,T
7-M,732,0,3,1569,0,1572,G
7-M,733,0,2,1584,0,1586,G
7-M,734,0,0,1583,0,1583,G
7-M,735,0,2,1570,0,1572,G
7-M,736,1,0,1593,0,1594,G
7-M,737,0,1559,0,0,1559,T
7-M,738,0,0,1566,0,1566,G
7-M,739,0,0,0,1569,1569,C
7-M,740,1566,0,0,0,1566,A
7-M,741,0,0,1584,0,1584,G
7-M,742,1561,0,1,0,1562,A
7-M,743,0,1557,0,0,1557,T
7-M,744,0,0,1549,0,1549,G
7-M,745,0,1,0,1522,1523,C
7-M,746,1529,0,0,0,1529,A
7-M,747,1516,0,0,0,1516,A
7-M,748,1,1,0,1529,1531,C
7-M,749,0,1,1525,0,1526,G
7-M,750,1535,0,0,0,1535,A
7-M,751,0,1525,0,0,1525,T
7-M,752,0,1521,0,2,1523,T
7-M,753,2,0,0,1535,1537,C
7-M,754,1515,0,0,0,1515,A
7-M,755,1517,0,0,0,1517,A
7-M,756,0,0,1518,0,1518,G
7-M,757,0,1484,0,0,1484,T
7-M,758,0,1,1484,0,1485,G
7-M,759,1461,0,1,0,1462,A
7-M,760,1,0,0,1462,1463,C
7-M,761,1,0,0,1459,1460,C
7-M,762,6,1,0,1456,1463,C
7-M,763,1,0,1463,0,1464,G
7-M,764,0,0,0,1464,1464,C
7-M,765,0,1474,0,0,1474,T
7-M,766,0,1482,0,0,1482,T
7-M,767,0,1,1483,0,1484,G
7-M,768,0,1477,0,1,1478,T
7-M,769,0,1474,0,1,1475,T
7-M,770,0,1,1468,0,1469,G
7-M,771,0,1430,0,0,1430,T
7-M,772,0,1422,0,0,1422,T
7-M,773,0,0,1419,0,1419,G
7-M,774,0,1,0,1402,1403,C
7-M,775,0,0,0,1417,1417,C
7-M,776,0,0,1427,0,1427,G
7-M,777,1,1,0,1407,1409,C
7-M,778,1,1,1430,0,1432,G
7-M,779,1421,0,0,0,1421,A
7-M,780,1436,0,1,0,1437,A
7-M,781,0,1442,0,1,1443,T
7-M,782,1443,0,0,0,1443,A
7-M,783,0,1455,0,1,1456,T
7-M,784,0,0,0,1480,1480,C
7-M,785,1471,0,1,0,1472,A
7-M,786,0,1465,0,0,1465,T
7-M,787,0,1458,0,1,1459,T
7-M,788,0,1,1443,0,1444,G
7-M,789,0,2,1445,0,1447,G
7-M,790,0,0,1452,0,1452,G
7-M,791,1439,0,0,0,1439,A
7-M,792,0,1432,0,1,1433,T
7-M,793,0,0,0,1393,1393,C
7-M,794,0,1388,0,3,1391,T
7-M,795,1,1385,0,0,1386,T
7-M,796,0,0,1399,0,1399,G
7-M,797,0,0,0,1402,1402,C
7-M,798,1389,0,0,0,1389,A
7-M,799,0,0,0,1408,1408,C
7-M,800,0,1379,0,0,1379,T
7-M,801,0,1386,0,2,1388,T
7-M,802,1,2,1379,0,1382,G
7-M,803,1388,1,0,0,1389,A
7-M,804,0,1391,0,0,1391,T
7-M,805,1360,0,0,0,1360,A
7-M,806,0,1354,0,0,1354,T
7-M,807,0,1337,0,0,1337,T
7-M,808,0,0,1341,0,1341,G
7-M,809,0,1325,0,0,1325,T
7-M,810,0,0,1322,0,1322,G
7-M,811,0,2,1317,0,1319,G
7-M,812,1295,0,0,0,1295,A
7-M,813,0,1303,0,0,1303,T
7-M,814,0,1298,0,1,1299,T
7-M,815,3,0,0,1289,1292,C
7-M,816,0,1292,0,3,1295,T
7-M,817,0,1285,1,0,1286,T
7-M,818,0,0,1287,0,1287,G
7-M,819,1270,0,0,0,1270,A
7-M,820,0,1270,0,0,1270,T
7-M,821,0,0,0,1267,1267,C
7-M,822,0,0,1263,0,1263,G
7-M,823,0,1258,0,3,1261,T
7-M,824,0,0,0,1257,1257,C
7-M,825,0,1249,0,2,1251,T
7-M,826,0,1258,0,0,1258,T
7-M,827,0,1259,0,0,1259,T
7-M,828,0,1257,0,1,1258,T
7-M,829,0,1265,0,0,1265,T
7-M,830,0,1265,0,2,1267,T
7-M,831,0,1261,0,0,1261,T
7-M,832,0,0,0,1264,1264,C
7-M,833,1256,1,1,0,1258,A
7-M,834,1259,0,0,0,1259,A
7-M,835,1258,0,0,0,1258,A
7-M,836,0,1257,1,0,1258,T
7-M,837,0,0,1262,0,1262,G
7-M,838,2,1,0,1247,1250,C
7-M,839,0,0,1258,0,1258,G
7-M,840,0,1267,1,1,1269,T
7-M,841,0,0,0,1272,1272,C
7-M,842,0,1267,1,0,1268,T
7-M,843,1273,0,0,0,1273,A
7-M,844,0,1260,1,0,1261,T
7-M,845,2,0,0,1259,1261,C
7-M,846,0,1,1261,0,1262,G
7-M,847,1244,0,0,0,1244,A
7-M,848,1,0,0,1248,1249,C
7-M,849,0,1215,1,2,1218,T
7-M,850,0,0,0,1247,1247,C
7-M,851,0,1237,1,1,1239,T
7-M,852,0,1241,1,1,1243,T
7-M,853,1,0,0,1240,1241,C
7-M,854,1242,0,0,0,1242,A
7-M,855,1239,0,1,0,1240,A
7-M,856,1237,0,0,0,1237,A
7-M,857,1,0,0,1233,1234,C
7-M,858,1218,1,0,0,1219,A
7-M,859,0,0,0,1172,1172,C
7-M,860,1,2,1145,0,1148,G
7-M,861,1,0,1200,0,1201,G
7-M,862,1,0,0,1179,1180,C
7-M,863,0,1,0,1191,1192,C
7-M,864,0,1193,0,2,1195,T
7-M,865,0,1204,1,0,1205,T
7-M,866,1205,0,0,0,1205,A
7-M,867,1210,0,0,0,1210,A
7-M,868,1208,0,0,0,1208,A
7-M,869,1204,0,3,0,1207,A
7-M,870,1,1,1180,0,1182,G
7-M,871,1028,0,0,0,1028,A
7-M,872,0,0,1020,0,1020,G
7-M,873,0,0,1022,0,1022,G
7-M,874,1,0,0,1012,1013,C
7-M,875,1,0,0,992,993,C
7-M,876,0,0,0,1007,1007,C
7-M,877,0,1017,1,0,1018,T
7-M,878,0,1015,0,1,1016,T
7-M,879,0,0,0,1021,1021,C
7-M,880,0,1021,1,1,1023,T
7-M,881,1028,0,0,0,1028,A
7-M,882,1,0,0,1022,1023,C
7-M,883,1,1,1010,0,1012,G
7-M,884,0,0,1011,0,1011,G
7-M,885,988,0,0,0,988,A
7-M,886,974,0,0,0,974,A
7-M,887,0,0,974,0,974,G
7-M,888,0,1,975,0,976,G
7-M,889,962,0,0,0,962,A
7-M,890,1,0,969,0,970,G
7-M,891,0,962,1,0,963,T
7-M,892,958,0,1,0,959,A
7-M,893,1,0,0,948,949,C
7-M,894,0,0,0,952,952,C
7-M,895,1,930,2,1,934,T
7-M,896,0,0,942,0,942,G
7-M,897,897,0,0,0,897,A
7-M,898,1,0,910,0,911,G
7-M,899,0,884,0,0,884,T
7-M,900,2,1,0,883,886,C
7-M,901,0,864,0,1,865,T
7-M,902,863,0,0,0,863,A
7-M,903,0,863,0,0,863,T
7-M,904,0,0,860,0,860,G
7-M,905,838,1,0,0,839,A
7-M,906,0,0,840,0,840,G
7-M,907,0,0,765,0,765,G
7-M,908,0,0,763,0,763,G
7-M,909,759,0,0,0,759,A
7-M,910,754,0,0,0,754,A
7-M,911,0,1,755,0,756,G
7-M,912,752,0,0,0,752,A
7-M,913,750,0,1,0,751,A
7-M,914,0,748,0,0,748,T
7-M,915,734,0,0,0,734,A
7-M,916,0,730,0,1,731,T
7-M,917,0,4,0,719,723,C
7-M,918,1,0,724,0,725,G
7-M,919,722,0,0,0,722,A
7-M,920,709,0,0,0,709,A
7-M,921,713,0,0,0,713,A
7-M,922,0,0,702,0,702,G
7-M,923,0,1,708,0,709,G
7-M,924,692,0,0,0,692,A
7-M,925,693,0,2,0,695,A
7-M,926,0,0,0,695,695,C
7-M,927,683,0,0,0,683,A
7-M,928,1,0,687,0,688,G
7-M,929,1,0,0,689,690,C
7-M,930,689,0,0,0,689,A
7-M,931,0,0,688,0,688,G
7-M,932,644,0,0,0,644,A
7-M,933,643,0,2,0,645,A
7-M,934,0,641,0,0,641,T
7-M,935,0,0,626,0,626,G
7-M,936,0,0,0,626,626,C
7-M,937,0,590,0,0,590,T
7-M,938,0,0,590,0,590,G
7-M,939,0,583,0,0,583,T
7-M,940,0,0,586,0,586,G
7-M,941,0,2,580,0,582,G
7-M,942,561,0,0,0,561,A
7-M,943,0,557,0,1,558,T
7-M,944,0,0,535,0,535,G
7-M,945,0,1,0,526,527,C
7-M,946,0,510,0,1,511,T
7-M,947,0,0,503,0,503,G
7-M,948,498,0,0,0,498,A
7-M,949,0,1,0,498,499,C
7-M,950,0,0,498,0,498,G
7-M,951,484,0,0,0,484,A
7-M,952,0,0,0,488,488,C
7-M,953,467,0,0,0,467,A
7-M,954,0,0,471,0,471,G
7-M,955,0,462,0,1,463,T
7-M,956,1,0,0,449,450,C
7-M,957,456,0,0,0,456,A
7-M,958,0,448,0,1,449,T
7-M,959,0,450,0,0,450,T
7-M,960,0,451,0,0,451,T
7-M,961,0,445,0,0,445,T
7-M,962,0,0,442,0,442,G
7-M,963,0,417,0,1,418,T
7-M,964,0,0,0,419,419,C
7-M,965,402,0,0,0,402,A
7-M,966,0,0,402,0,402,G
7-M,967,0,0,0,399,399,C
7-M,968,399,0,0,0,399,A
7-M,969,0,400,0,0,400,T
7-M,970,378,0,0,0,378,A
7-M,971,1,0,374,0,375,G
7-M,972,368,0,0,0,368,A
7-M,973,0,0,368,0,368,G
7-M,974,0,360,0,0,360,T
7-M,975,0,225,0,0,225,T
7-M,976,0,0,216,0,216,G
7-M,977,1,0,216,0,217,G
7-M,978,217,0,0,0,217,A
7-M,979,0,0,213,0,213,G
7-M,980,0,146,0,0,146,T
7-M,981,139,0,0,0,139,A
7-M,982,136,0,0,0,136,A
8-NS,1,627,0,0,0,627,A
8-NS,2,0,629,0,0,629,T
8-NS,3,0,0,662,0,662,G
8-NS,4,0,1,709,0,710,G
8-NS,5,737,0,0,0,737,A
8-NS,6,0,1257,0,0,1257,T
8-NS,7,0,1261,0,1,1262,T
8-NS,8,0,0,0,1293,1293,C
8-NS,9,0,1,0,1301,1302,C
8-NS,10,1302,0,3,0,1305,A
8-NS,11,1321,0,1,1,1323,A
8-NS,12,0,0,0,1327,1327,C
8-NS,13,1333,0,0,0,1333,A
8-NS,14,0,0,0,1375,1375,C
8-NS,15,0,1379,0,1,1380,T
8-NS,16,1,0,1381,0,1382,G
8-NS,17,0,1370,0,0,1370,T
8-NS,18,1378,0,2,0,1380,A
8-NS,19,0,1639,0,1,1640,T
8-NS,20,1,0,0,1649,1650,C
8-NS,21,1647,0,0,1,1648,A
8-NS,22,1654,0,0,1,1655,A
8-NS,23,0,0,1675,0,1675,G
8-NS,24,0,1696,0,0,1696,T
8-NS,25,0,1703,0,0,1703,T
8-NS,26,0,1717,0,0,1717,T
8-NS,27,0,0,0,1715,1715,C
8-NS,28,1,1,0,1730,1732,C
8-NS,29,1722,1,3,2,1728,A
8-NS,30,0,1,1757,0,1758,G
8-NS,31,1,0,1775,0,1776,G
8-NS,32,0,1735,0,0,1735,T
8-NS,33,1785,1,0,0,1786,A
8-NS,34,0,1,1797,0,1798,G
8-NS,35,1807,0,2,0,1809,A
8-NS,36,0,1821,0,1,1822,T
8-NS,37,0,1828,0,0,1828,T
8-NS,38,0,1,1836,0,1837,G
8-NS,39,0,1,0,1844,1845,C
8-NS,40,0,1842,0,2,1844,T
8-NS,41,0,1861,0,1,1862,T
8-NS,42,0,1868,0,5,1873,T
8-NS,43,1,1,0,1909,1911,C
8-NS,44,0,1908,0,3,1911,T
8-NS,45,0,1907,0,0,1907,T
8-NS,46,0,1906,0,0,1906,T
8-NS,47,1,0,1922,0,1923,G
8-NS,48,0,0,1907,0,1907,G
8-NS,49,2,0,0,1923,1925,C
8-NS,50,1924,1,1,0,1926,A
8-NS,51,0,1936,0,0,1936,T
8-NS,52,1967,0,2,0,1969,A
8-NS,53,0,2026,0,0,2026,T
8-NS,54,0,0,0,2029,2029,C
8-NS,55,2,1,0,2016,2019,C
8-NS,56,1,1,2019,0,2021,G
8-NS,57,0,1,2024,0,2025,G
8-NS,58,2028,0,1,0,2029,A
8-NS,59,2043,0,1,0,2044,A
8-NS,60,2052,0,1,0,2053,A
8-NS,61,1,0,0,2085,2086,C
8-NS,62,2085,0,0,0,2085,A
8-NS,63,2083,0,5,1,2089,A
8-NS,64,0,0,2165,0,2165,G
8-NS,65,0,2172,0,2,2174,T
8-NS,66,0,2173,0,0,2173,T
8-NS,67,1,0,2171,0,2172,G
8-NS,68,0,2170,0,3,2173,T
8-NS,69,2177,0,2,0,2179,A
8-NS,70,1,4,2174,0,2179,G
8-NS,71,2292,0,0,0,2292,A
8-NS,72,0,0,0,2319,2319,C
8-NS,73,6,0,0,2287,2293,C
8-NS,74,2299,0,1,0,2300,A
8-NS,75,2302,0,0,0,2302,A
8-NS,76,0,3,2419,0,2422,G
8-NS,77,2416,0,1,0,2417,A
8-NS,78,2446,1,0,0,2447,A
8-NS,79,0,0,0,2458,2458,C
8-NS,80,0,2413,0,6,2419,T
8-NS,81,1,3,2444,0,2448,G
8-NS,82,2422,0,6,0,2428,A
8-NS,83,2,0,2496,0,2498,G
8-NS,84,0,2497,0,0,2497,T
8-NS,85,0,1,2464,0,2465,G
8-NS,86,2491,0,5,0,2496,A
8-NS,87,1,2490,0,2,2493,T
8-NS,88,0,0,2528,0,2528,G
8-NS,89,2,2,0,2557,2561,C
8-NS,90,1,1,0,2569,2571,C
8-NS,91,0,1,0,2583,2584,C
8-NS,92,4,1,1,2576,2582,C
8-NS,93,2604,0,1,1,2606,A
8-NS,94,0,2639,0,3,2642,T
8-NS,95,0,2666,0,1,2667,T
8-NS,96,2,0,0,2673,2675,C
8-NS,97,2,0,0,2686,2688,C
8-NS,98,0,2676,0,5,2681,T
8-NS,99,0,2679,0,4,2683,T
8-NS,100,0,3,2667,0,2670,G
8-NS,101,2667,0,1,0,2668,A
8-NS,102,0,2670,0,2,2672,T
8-NS,103,2,0,0,2668,2670,C
8-NS,104,0,4,2636,0,2640,G
8-NS,105,2,0,2647,0,2649,G
8-NS,106,0,0,0,2666,2666,C
8-NS,107,0,2662,0,5,2667,T
8-NS,108,0,2684,0,4,2688,T
8-NS,109,1,5,0,2673,2679,C
8-NS,110,0,0,2699,0,2699,G
8-NS,111,0,0,0,2697,2697,C
8-NS,112,0,0,0,2711,2711,C
8-NS,113,1,3,2704,0,2708,G
8-NS,114,2689,0,1,0,2690,A
8-NS,115,0,1,2803,0,2804,G
8-NS,116,2793,1,1,0,2795,A
8-NS,117,1,2811,0,1,2813,T
8-NS,118,0,0,0,2828,2828,C
8-NS,119,2815,0,1,0,2816,A
8-NS,120,0,0,2837,0,2837,G
8-NS,121,2798,0,3,0,2801,A
8-NS,122,1,0,2837,0,2838,G
8-NS,123,0,1,2861,0,2862,G
8-NS,124,0,2907,0,1,2908,T
8-NS,125,2,0,0,3043,3045,C
8-NS,126,2,1,0,3051,3054,C
8-NS,127,1,1,1,3090,3093,C
8-NS,128,1,3093,0,1,3095,T
8-NS,129,3107,0,0,0,3107,A
8-NS,130,3086,0,3,0,3089,A
8-NS,131,1,14,3134,0,3149,G
8-NS,132,0,5,3121,0,3126,G
8-NS,133,0,2,3127,0,3129,G
8-NS,134,3,1,3068,0,3072,G
8-NS,135,3032,0,1,0,3033,A
8-NS,136,3080,0,5,0,3085,A
8-NS,137,1,0,3107,0,3108,G
8-NS,138,3183,0,0,0,3183,A
8-NS,139,1,3,3205,0,3209,G
8-NS,140,0,0,3208,0,3208,G
8-NS,141,0,1,0,3238,3239,C
8-NS,142,3242,0,2,0,3244,A
8-NS,143,3248,0,4,0,3252,A
8-NS,144,0,3262,0,1,3263,T
8-NS,145,3284,0,3,0,3287,A
8-NS,146,1,0,0,3340,3341,C
8-NS,147,0,3266,0,6,3272,T
8-NS,148,0,0,0,3282,3282,C
8-NS,149,0,3213,0,9,3222,T
8-NS,150,5,2,0,3257,3264,C
8-NS,151,1,3,3308,0,3312,G
8-NS,152,16,0,3468,0,3484,G
8-NS,153,0,3481,0,3,3484,T
8-NS,154,3,0,0,3518,3521,C
8-NS,155,0,3489,0,4,3493,T
8-NS,156,3515,0,2,1,3518,A
8-NS,157,1,3,3516,0,3520,G
8-NS,158,3505,0,7,0,3512,A
8-NS,159,0,0,0,3614,3614,C
8-NS,160,3573,0,0,0,3573,A
8-NS,161,0,3518,0,0,3518,T
8-NS,162,5,2,0,3510,3517,C
8-NS,163,3524,0,2,0,3526,A
8-NS,164,3512,0,3,0,3515,A
8-NS,165,3490,0,3,0,3493,A
8-NS,166,6,0,3495,0,3501,G
8-NS,167,1,1,0,3529,3531,C
8-NS,168,3480,0,3,0,3483,A
8-NS,169,0,1,3496,1,3498,G
8-NS,170,1,2,0,3489,3492,C
8-NS,171,1,0,0,3528,3529,C
8-NS,172,3537,0,4,0,3541,A
8-NS,173,0,0,0,3597,3597,C
8-NS,174,3,0,0,3589,3592,C
8-NS,175,6,0,0,3592,3598,C
8-NS,176,3631,0,2,0,3633,A
8-NS,177,0,3645,0,1,3646,T
8-NS,178,1,0,3659,0,3660,G
8-NS,179,0,3634,0,2,3636,T
8-NS,180,0,3634,0,6,3640,T
8-NS,181,0,1,3637,0,3638,G
8-NS,182,0,0,3621,0,3621,G
8-NS,183,3586,0,3,0,3589,A
8-NS,184,3602,0,2,0,3604,A
8-NS,185,3530,0,3,1,3534,A
8-NS,186,1,1,3568,0,3570,G
8-NS,187,0,0,0,3562,3562,C
8-NS,188,3569,0,0,0,3569,A
8-NS,189,3572,0,0,0,3572,A
8-NS,190,3556,0,0,0,3556,A
8-NS,191,0,3609,0,1,3610,T
8-NS,192,0,3606,0,1,3607,T
8-NS,193,0,1,3657,0,3658,G
8-NS,194,0,3639,0,4,3643,T
8-NS,195,3641,1,4,0,3646,A
8-NS,196,0,3,3640,0,3643,G
8-NS,197,3641,0,1,1,3643,A
8-NS,198,3650,0,2,0,3652,A
8-NS,199,3657,0,0,0,3657,A
8-NS,200,3631,0,3,0,3634,A
8-NS,201,0,2,3639,0,3641,G
8-NS,202,3582,1,0,0,3583,A
8-NS,203,0,3589,0,0,3589,T
8-NS,204,0,3594,0,0,3594,T
8-NS,205,1,0,0,3596,3597,C
8-NS,206,2,3594,0,4,3600,T
8-NS,207,0,1,3598,0,3599,G
8-NS,208,3592,0,5,0,3597,A
8-NS,209,3600,0,2,0,3602,A
8-NS,210,3596,0,0,0,3596,A
8-NS,211,0,0,3624,0,3624,G
8-NS,212,3610,1,2,0,3613,A
8-NS,213,3616,0,3,0,3619,A
8-NS,214,0,1,3647,0,3648,G
8-NS,215,3662,1,1,0,3664,A
8-NS,216,3674,0,3,0,3677,A
8-NS,217,0,3691,1,1,3693,T
8-NS,218,1,12,0,3714,3727,C
8-NS,219,0,3711,0,6,3717,T
8-NS,220,1,1,3719,0,3721,G
8-NS,221,3724,0,4,1,3729,A
8-NS,222,1,3713,0,3,3717,T
8-NS,223,2,1,3713,0,3716,G
8-NS,224,3675,0,3,1,3679,A
8-NS,225,1,1,3681,1,3684,G
8-NS,226,1,0,3670,0,3671,G
8-NS,227,1,1,0,3656,3658,C
8-NS,228,3665,1,1,0,3667,A
8-NS,229,0,0,0,3767,3767,C
8-NS,230,0,3748,0,3,3751,T
8-NS,231,0,3775,0,1,3776,T
8-NS,232,3793,1,0,0,3794,A
8-NS,233,3796,0,3,0,3799,A
8-NS,234,3783,0,3,0,3786,A
8-NS,235,3776,0,2,1,3779,A
8-NS,236,0,3766,0,0,3766,T
8-NS,237,0,5,3773,0,3778,G
8-NS,238,3780,0,4,0,3784,A
8-NS,239,1,1,0,3782,3784,C
8-NS,240,3,2,0,3778,3783,C
8-NS,241,3779,0,5,0,3784,A
8-NS,242,0,3768,0,3,3771,T
8-NS,243,2,2,3873,0,3877,G
8-NS,244,0,0,3902,0,3902,G
8-NS,245,0,3895,0,2,3897,T
8-NS,246,5,0,0,4090,4095,C
8-NS,247,0,4070,1,7,4078,T
8-NS,248,3,1,0,4115,4119,C
8-NS,249,1,0,0,4129,4130,C
8-NS,250,4130,0,12,0,4142,A
8-NS,251,0,0,0,4194,4194,C
8-NS,252,4113,0,3,1,4117,A
8-NS,253,0,1,0,4151,4152,C
8-NS,254,2,0,0,4120,4122,C
8-NS,255,1,3952,0,6,3959,T
8-NS,256,2,1,3973,0,3976,G
8-NS,257,0,2,0,3960,3962,C
8-NS,258,0,3919,0,5,3924,T
8-NS,259,0,3931,0,13,3944,T
8-NS,260,1,2,1,3956,3960,C
8-NS,261,1,1,3960,0,3962,G
8-NS,262,1,1,0,3967,3969,C
8-NS,263,0,3,3966,0,3969,G
8-NS,264,4128,1,3,0,4132,A
8-NS,265,0,4148,0,0,4148,T
8-NS,266,4263,0,1,0,4264,A
8-NS,267,0,3,0,4290,4293,C
8-NS,268,4261,0,8,0,4269,A
8-NS,269,0,4374,0,0,4374,T
8-NS,270,4367,1,1,0,4369,A
8-NS,271,4373,0,4,0,4377,A
8-NS,272,0,10,0,4377,4387,C
8-NS,273,0,4253,1,3,4257,T
8-NS,274,0,4,4305,0,4309,G
8-NS,275,4206,1,7,1,4215,A
8-NS,276,0,2,0,4247,4249,C
8-NS,277,4227,0,8,0,4235,A
8-NS,278,1,4216,0,3,4220,T
8-NS,279,1,3,4218,0,4222,G
8-NS,280,4214,1,1,0,4216,A
8-NS,281,0,4,0,4340,4344,C
8-NS,282,0,4334,0,0,4334,T
8-NS,283,4394,0,1,0,4395,A
8-NS,284,0,4361,0,1,4362,T
8-NS,285,0,4356,0,1,4357,T
8-NS,286,0,2,4362,0,4364,G
8-NS,287,4323,1,3,0,4327,A
8-NS,288,0,2,4309,0,4311,G
8-NS,289,1,2,4317,0,4320,G
8-NS,290,4213,0,1,0,4214,A
8-NS,291,4232,0,3,0,4235,A
8-NS,292,0,4164,0,0,4164,T
8-NS,293,0,4178,0,1,4179,T
8-NS,294,3,0,4248,0,4251,G
8-NS,295,0,4227,2,6,4235,T
8-NS,296,7,3,0,4245,4255,C
8-NS,297,4248,0,4,1,4253,A
8-NS,298,4243,0,1,0,4244,A
8-NS,299,2,0,4241,0,4243,G
8-NS,300,4251,0,1,0,4252,A
8-NS,301,4246,1,3,0,4250,A
8-NS,302,4243,0,2,0,4245,A
8-NS,303,0,0,1,4259,4260,C
8-NS,304,1,4169,0,6,4176,T
8-NS,305,0,2,4254,0,4256,G
8-NS,306,2,2,4309,0,4313,G
8-NS,307,12,4272,1,6,4291,T
8-NS,308,1,4274,0,8,4283,T
8-NS,309,3,0,0,4275,4278,C
8-NS,310,4281,1,2,0,4284,A
8-NS,311,0,4346,0,5,4351,T
8-NS,312,2,3,4360,0,4365,G
8-NS,313,1,1,0,4401,4403,C
8-NS,314,0,4371,0,6,4377,T
8-NS,315,4306,0,3,0,4309,A
8-NS,316,4356,1,1,0,4358,A
8-NS,317,0,4386,0,2,4388,T
8-NS,318,0,0,4381,0,4381,G
8-NS,319,1,2,0,4355,4358,C
8-NS,320,4,1,0,4304,4309,C
8-NS,321,3,0,0,4300,4303,C
8-NS,322,4294,0,3,0,4297,A
8-NS,323,4305,0,2,1,4308,A
8-NS,324,0,0,4337,0,4337,G
8-NS,325,0,0,0,4326,4326,C
8-NS,326,4332,0,1,0,4333,A
8-NS,327,2,4,4359,0,4365,G
8-NS,328,4343,0,2,0,4345,A
8-NS,329,4355,0,1,2,4358,A
8-NS,330,4354,0,0,0,4354,A
8-NS,331,4303,0,4,0,4307,A
8-NS,332,0,4347,0,1,4348,T
8-NS,333,1,5,4362,0,4368,G
8-NS,334,1,0,4368,0,4369,G
8-NS,335,4355,0,6,0,4361,A
8-NS,336,4340,0,2,0,4342,A
8-NS,337,0,4,4316,0,4320,G
8-NS,338,0,4,4312,0,4316,G
8-NS,339,4324,0,3,0,4327,A
8-NS,340,0,4,0,4339,4343,C
8-NS,341,5,0,0,4340,4345,C
8-NS,342,0,4328,1,2,4331,T
8-NS,343,3,1,0,4404,4408,C
8-NS,344,0,4409,0,1,4410,T
8-NS,345,0,4426,0,1,4427,T
8-NS,346,0,4430,0,1,4431,T
8-NS,347,4,0,4424,0,4428,G
8-NS,348,0,1,0,4471,4472,C
8-NS,349,4444,0,1,0,4445,A
8-NS,350,0,4431,1,1,4433,T
8-NS,351,3,8,0,4443,4454,C
8-NS,352,4481,1,0,1,4483,A
8-NS,353,0,2,4595,0,4597,G
8-NS,354,4576,0,4,5,4585,A
8-NS,355,4604,1,4,0,4609,A
8-NS,356,0,4579,1,1,4581,T
8-NS,357,2,3,4537,2,4544,G
8-NS,358,25,4,4547,0,4576,G
8-NS,359,4559,0,5,0,4564,A
8-NS,360,0,4,1,4545,4550,C
8-NS,361,9,2,0,4463,4474,C
8-NS,362,4414,1,2,0,4417,A
8-NS,363,1,2,4445,0,4448,G
8-NS,364,3,1,4429,0,4433,G
8-NS,365,0,2,1,4461,4464,C
8-NS,366,4444,0,2,0,4446,A
8-NS,367,4454,0,1,0,4455,A
8-NS,368,0,4452,0,1,4453,T
8-NS,369,3,1,0,4461,4465,C
8-NS,370,4466,0,1,0,4467,A
8-NS,371,1,4435,0,4,4440,T
8-NS,372,1,4,4397,0,4402,G
8-NS,373,1,2,4416,0,4419,G
8-NS,374,4386,0,6,0,4392,A
8-NS,375,1,1,4427,1,4430,G
8-NS,376,4381,0,2,0,4383,A
8-NS,377,4384,0,1,0,4385,A
8-NS,378,4394,0,4,1,4399,A
8-NS,379,4391,2,3,0,4396,A
8-NS,380,4416,0,3,1,4420,A
8-NS,381,14,1,0,4424,4439,C
8-NS,382,4412,0,2,0,4414,A
8-NS,383,1,4383,0,1,4385,T
8-NS,384,1,0,0,4370,4371,C
8-NS,385,4371,1,2,0,4374,A
8-NS,386,0,4382,0,4,4386,T
8-NS,387,0,0,4401,0,4401,G
8-NS,388,0,4383,0,7,4390,T
8-NS,389,1,4358,0,2,4361,T
8-NS,390,0,3,4356,2,4361,G
8-NS,391,4328,0,4,0,4332,A
8-NS,392,4332,0,3,0,4335,A
8-NS,393,4338,0,4,0,4342,A
8-NS,394,1,1,4341,0,4343,G
8-NS,395,0,0,1,4298,4299,C
8-NS,396,2,3,4300,0,4305,G
8-NS,397,4294,0,3,0,4297,A
8-NS,398,4284,2,6,1,4293,A
8-NS,399,0,4284,1,2,4287,T
8-NS,400,0,4288,0,7,4295,T
8-NS,401,0,4296,1,1,4298,T
8-NS,402,2,0,0,4309,4311,C
8-NS,403,4269,1,2,1,4273,A
8-NS,404,2,1,4297,0,4300,G
8-NS,405,0,4273,0,4,4277,T
8-NS,406,1,0,4283,0,4284,G
8-NS,407,1,4264,0,1,4266,T
8-NS,408,3,4,4295,0,4302,G
8-NS,409,4323,0,1,2,4326,A
8-NS,410,1,4310,0,7,4318,T
8-NS,411,0,4318,1,1,4320,T
8-NS,412,0,4318,0,0,4318,T
8-NS,413,0,4298,0,1,4299,T
8-NS,414,0,4308,0,1,4309,T
8-NS,415,1,6,4291,0,4298,G
8-NS,416,4293,1,3,0,4297,A
8-NS,417,0,2,0,4295,4297,C
8-NS,418,5,0,0,4246,4251,C
8-NS,419,2,6,4275,0,4283,G
8-NS,420,4500,1,2,1,4504,A
8-NS,421,0,4,0,4597,4601,C
8-NS,422,0,4601,1,1,4603,T
8-NS,423,4623,1,3,1,4628,A
8-NS,424,2,1,4626,0,4629,G
8-NS,425,4620,0,9,0,4629,A
8-NS,426,3,2,4657,0,4662,G
8-NS,427,4635,1,7,0,4643,A
8-NS,428,1,0,0,4754,4755,C
8-NS,429,3,0,0,4564,4567,C
8-NS,430,4448,0,2,0,4450,A
8-NS,431,1,4672,2,2,4677,T
8-NS,432,4645,0,5,0,4650,A
8-NS,433,2,0,4981,0,4983,G
8-NS,434,0,4924,1,0,4925,T
8-NS,435,4913,0,2,0,4915,A
8-NS,436,0,4903,0,6,4909,T
8-NS,437,0,4822,0,1,4823,T
8-NS,438,4940,0,0,0,4940,A
8-NS,439,1,4,0,4953,4958,C
8-NS,440,0,4737,0,5,4742,T
8-NS,441,4734,0,1,0,4735,A
8-NS,442,4347,0,1,0,4348,A
8-NS,443,1,6,4374,0,4381,G
8-NS,444,1,1,4357,0,4359,G
8-NS,445,0,0,4347,0,4347,G
8-NS,446,0,2,0,4292,4294,C
8-NS,447,0,4229,0,13,4242,T
8-NS,448,0,4231,0,3,4234,T
8-NS,449,1,4272,0,3,4276,T
8-NS,450,4,1,0,4288,4293,C
8-NS,451,4315,0,1,0,4316,A
8-NS,452,0,0,1,4338,4339,C
8-NS,453,0,1,0,4292,4293,C
8-NS,454,3,6,4296,0,4305,G
8-NS,455,4249,0,0,0,4249,A
8-NS,456,4272,0,5,0,4277,A
8-NS,457,1,5,4307,0,4313,G
8-NS,458,4259,1,2,0,4262,A
8-NS,459,2,4,4261,0,4267,G
8-NS,460,0,4,4206,0,4210,G
8-NS,461,0,3,4228,0,4231,G
8-NS,462,4204,1,11,0,4216,A
8-NS,463,1,1,4214,0,4216,G
8-NS,464,0,1,0,4217,4218,C
8-NS,465,4222,0,3,0,4225,A
8-NS,466,4208,0,8,0,4216,A
8-NS,467,0,4231,0,3,4234,T
8-NS,468,1,4231,0,0,4232,T
8-NS,469,0,0,4220,0,4220,G
8-NS,470,0,4176,0,2,4178,T
8-NS,471,0,4177,0,3,4180,T
8-NS,472,1,2,4168,0,4171,G
8-NS,473,0,0,4158,0,4158,G
8-NS,474,1,0,1,4147,4149,C
8-NS,475,0,4,4178,0,4182,G
8-NS,476,4183,0,0,0,4183,A
8-NS,477,4210,0,1,0,4211,A
8-NS,478,4213,0,1,0,4214,A
8-NS,479,0,4217,1,1,4219,T
8-NS,480,1,0,0,4221,4222,C
8-NS,481,0,4187,0,7,4194,T
8-NS,482,1,1,0,4216,4218,C
8-NS,483,4215,0,4,0,4219,A
8-NS,484,0,1,0,4224,4225,C
8-NS,485,2,0,0,4225,4227,C
8-NS,486,4189,0,2,0,4191,A
8-NS,487,1,4170,1,2,4174,T
8-NS,488,0,4139,0,3,4142,T
8-NS,489,3,0,4153,0,4156,G
8-NS,490,1,2,0,4113,4116,C
8-NS,491,3,2,0,4108,4113,C
8-NS,492,1,4110,0,8,4119,T
8-NS,493,0,4111,1,5,4117,T
8-NS,494,1,1,0,4126,4128,C
8-NS,495,1,4114,1,8,4124,T
8-NS,496,0,4133,0,1,4134,T
8-NS,497,0,4220,0,5,4225,T
8-NS,498,0,4178,1,15,4194,T
8-NS,499,2,0,0,4202,4204,C
8-NS,500,2,2,0,4200,4204,C
8-NS,501,4198,0,6,0,4204,A
8-NS,502,0,1,4238,0,4239,G
8-NS,503,0,6,4211,0,4217,G
8-NS,504,4281,0,3,0,4284,A
8-NS,505,2,2,0,4292,4296,C
8-NS,506,4328,1,1,0,4330,A
8-NS,507,0,4345,1,2,4348,T
8-NS,508,4338,0,4,0,4342,A
8-NS,509,4,0,0,4619,4623,C
8-NS,510,0,4612,1,6,4619,T
8-NS,511,4567,0,1,0,4568,A
8-NS,512,1,4534,0,3,4538,T
8-NS,513,1,4390,0,4,4395,T
8-NS,514,3,5,4404,0,4412,G
8-NS,515,4241,0,5,0,4246,A
8-NS,516,1,6,4246,0,4253,G
8-NS,517,1,2,4209,0,4212,G
8-NS,518,3915,1,1,4,3921,A
8-NS,519,1,3949,2,0,3952,T
8-NS,520,0,1,3937,0,3938,G
8-NS,521,0,3923,1,3,3927,T
8-NS,522,4,3,1,3937,3945,C
8-NS,523,3939,0,1,1,3941,A
8-NS,524,3935,0,2,0,3937,A
8-NS,525,3940,0,1,0,3941,A
8-NS,526,3918,0,0,0,3918,A
8-NS,527,3932,0,0,1,3933,A
8-NS,528,0,3928,1,0,3929,T
8-NS,529,5,0,3919,0,3924,G
8-NS,530,0,1,0,3937,3938,C
8-NS,531,3933,0,0,0,3933,A
8-NS,532,3944,0,0,0,3944,A
8-NS,533,0,3949,0,0,3949,T
8-NS,534,0,3972,1,0,3973,T
8-NS,535,0,1,3963,0,3964,G
8-NS,536,1,3,3922,0,3926,G
8-NS,537,5,2,3913,0,3920,G
8-NS,538,1,0,3948,0,3949,G
8-NS,539,0,3890,0,2,3892,T
8-NS,540,3,0,0,3926,3929,C
8-NS,541,2,0,0,3927,3929,C
8-NS,542,0,3916,0,4,3920,T
8-NS,543,2,0,0,3955,3957,C
8-NS,544,3953,0,1,0,3954,A
8-NS,545,0,3945,1,0,3946,T
8-NS,546,1,3,0,3959,3963,C
8-NS,547,7,4,3922,0,3933,G
8-NS,548,0,2,3940,0,3942,G
8-NS,549,3860,0,6,0,3866,A
8-NS,550,1,5,3882,0,3888,G
8-NS,551,0,7,3893,0,3900,G
8-NS,552,3842,0,4,0,3846,A
8-NS,553,0,0,0,3907,3907,C
8-NS,554,0,3890,0,3,3893,T
8-NS,555,0,3909,1,0,3910,T
8-NS,556,0,2,3924,0,3926,G
8-NS,557,3890,0,0,0,3890,A
8-NS,558,3893,0,6,0,3899,A
8-NS,559,0,3900,0,0,3900,T
8-NS,560,0,5,3833,0,3838,G
8-NS,561,1,0,3878,0,3879,G
8-NS,562,3815,1,6,1,3823,A
8-NS,563,3849,0,4,0,3853,A
8-NS,564,0,4018,1,1,4020,T
8-NS,565,0,1,4039,0,4040,G
8-NS,566,4056,0,3,0,4059,A
8-NS,567,1,4054,0,2,4057,T
8-NS,568,4052,0,2,0,4054,A
8-NS,569,4071,1,1,0,4073,A
8-NS,570,3,2,0,4030,4035,C
8-NS,571,3968,0,5,1,3974,A
8-NS,572,0,1,0,4001,4002,C
8-NS,573,3725,0,4,0,3729,A
8-NS,574,1,0,3762,0,3763,G
8-NS,575,0,3725,0,8,3733,T
8-NS,576,0,3715,1,3,3719,T
8-NS,577,3,0,0,3733,3736,C
8-NS,578,1,9,3701,0,3711,G
8-NS,579,3691,0,4,0,3695,A
8-NS,580,1,0,3711,0,3712,G
8-NS,581,0,3654,0,4,3658,T
8-NS,582,1,1,0,3661,3663,C
8-NS,583,0,3616,0,5,3621,T
8-NS,584,3,0,0,3618,3621,C
8-NS,585,1,3651,0,8,3660,T
8-NS,586,3655,0,3,1,3659,A
8-NS,587,3652,1,0,1,3654,A
8-NS,588,3641,1,1,0,3643,A
8-NS,589,3676,0,0,0,3676,A
8-NS,590,3674,1,0,0,3675,A
8-NS,591,0,3642,0,0,3642,T
8-NS,592,0,1,0,3671,3672,C
8-NS,593,0,3635,0,3,3638,T
8-NS,594,3648,0,0,0,3648,A
8-NS,595,0,2,0,3654,3656,C
8-NS,596,3646,2,1,0,3649,A
8-NS,597,0,0,3651,0,3651,G
8-NS,598,3580,0,2,0,3582,A
8-NS,599,1,1,3587,0,3589,G
8-NS,600,3575,0,1,0,3576,A
8-NS,601,0,3520,0,2,3522,T
8-NS,602,1,3510,0,1,3512,T
8-NS,603,3,4,0,3530,3537,C
8-NS,604,0,1,3539,0,3540,G
8-NS,605,3,0,0,3541,3544,C
8-NS,606,0,3514,0,1,3515,T
8-NS,607,1,3525,0,4,3530,T
8-NS,608,0,4,3511,1,3516,G
8-NS,609,1,3,3520,0,3524,G
8-NS,610,3525,0,1,0,3526,A
8-NS,611,1,0,3526,0,3527,G
8-NS,612,3505,0,0,0,3505,A
8-NS,613,3469,0,5,0,3474,A
8-NS,614,0,1,3531,0,3532,G
8-NS,615,2,0,0,3533,3535,C
8-NS,616,3529,0,1,0,3530,A
8-NS,617,0,0,3598,0,3598,G
8-NS,618,1,3567,1,0,3569,T
8-NS,619,3597,0,0,0,3597,A
8-NS,620,3597,0,1,0,3598,A
8-NS,621,1,3577,0,0,3578,T
8-NS,622,0,0,3597,0,3597,G
8-NS,623,3470,0,4,0,3474,A
8-NS,624,0,5,3523,1,3529,G
8-NS,625,3504,0,5,0,3509,A
8-NS,626,3398,0,2,0,3400,A
8-NS,627,1,3388,0,0,3389,T
8-NS,628,1,6,3357,0,3364,G
8-NS,629,1,2,3358,0,3361,G
8-NS,630,1,1,3351,0,3353,G
8-NS,631,2,2,3322,0,3326,G
8-NS,632,0,1,3323,1,3325,G
8-NS,633,3211,0,2,0,3213,A
8-NS,634,0,3047,0,7,3054,T
8-NS,635,2,0,0,3141,3143,C
8-NS,636,0,3134,0,5,3139,T
8-NS,637,0,0,0,3165,3165,C
8-NS,638,2,2,0,3166,3170,C
8-NS,639,3177,0,0,0,3177,A
8-NS,640,0,0,0,3173,3173,C
8-NS,641,0,3116,0,4,3120,T
8-NS,642,1,3108,0,5,3114,T
8-NS,643,3068,0,2,0,3070,A
8-NS,644,1,0,0,3079,3080,C
8-NS,645,0,3044,0,6,3050,T
8-NS,646,4,3,0,3043,3050,C
8-NS,647,1,0,0,3026,3027,C
8-NS,648,3015,0,0,0,3015,A
8-NS,649,3014,0,1,0,3015,A
8-NS,650,3017,0,0,0,3017,A
8-NS,651,3019,0,3,3,3025,A
8-NS,652,0,1,0,3021,3022,C
8-NS,653,2956,1,2,0,2959,A
8-NS,654,1,0,2963,0,2964,G
8-NS,655,2952,0,1,0,2953,A
8-NS,656,2949,0,0,0,2949,A
8-NS,657,2948,0,1,0,2949,A
8-NS,658,3,1,0,2940,2944,C
8-NS,659,3,2,2936,0,2941,G
8-NS,660,2,2,2930,0,2934,G
8-NS,661,2,2,2943,0,2947,G
8-NS,662,2944,0,2,0,2946,A
8-NS,663,2931,0,0,0,2931,A
8-NS,664,2931,0,4,0,2935,A
8-NS,665,0,2925,0,2,2927,T
8-NS,666,1,0,2940,0,2941,G
8-NS,667,1,0,2936,0,2937,G
8-NS,668,0,2,0,2911,2913,C
8-NS,669,0,1,2932,0,2933,G
8-NS,670,2917,0,2,0,2919,A
8-NS,671,0,1,2927,0,2928,G
8-NS,672,2930,1,2,0,2933,A
8-NS,673,2931,0,0,0,2931,A
8-NS,674,2,2,0,2933,2937,C
8-NS,675,2896,0,5,0,2901,A
8-NS,676,0,1,2886,0,2887,G
8-NS,677,0,1,0,2870,2871,C
8-NS,678,0,2891,0,1,2892,T
8-NS,679,2891,0,2,0,2893,A
8-NS,680,2,2,2866,0,2870,G
8-NS,681,0,0,2871,0,2871,G
8-NS,682,0,2831,0,10,2841,T
8-NS,683,6,0,0,2807,2813,C
8-NS,684,2825,0,1,0,2826,A
8-NS,685,2817,0,1,0,2818,A
8-NS,686,2817,0,0,0,2817,A
8-NS,687,2833,0,3,0,2836,A
8-NS,688,0,1,2829,0,2830,G
8-NS,689,0,2763,1,2,2766,T
8-NS,690,0,2760,7,4,2771,T
8-NS,691,0,2766,0,0,2766,T
8-NS,692,0,1,2776,0,2777,G
8-NS,693,2772,0,3,0,2775,A
8-NS,694,2773,1,3,0,2777,A
8-NS,695,0,0,2778,0,2778,G
8-NS,696,2724,0,3,0,2727,A
8-NS,697,0,0,2730,0,2730,G
8-NS,698,2720,0,2,1,2723,A
8-NS,699,0,2722,0,5,2727,T
8-NS,700,2732,0,1,0,2733,A
8-NS,701,2717,0,1,0,2718,A
8-NS,702,1,0,2716,0,2717,G
8-NS,703,2564,0,1,0,2565,A
8-NS,704,0,2546,0,2,2548,T
8-NS,705,1,0,2570,0,2571,G
8-NS,706,2,0,2550,0,2552,G
8-NS,707,0,3,0,2538,2541,C
8-NS,708,0,2550,0,0,2550,T
8-NS,709,2556,0,0,0,2556,A
8-NS,710,2549,0,1,0,2550,A
8-NS,711,0,2554,0,1,2555,T
8-NS,712,0,2544,0,1,2545,T
8-NS,713,0,0,2546,0,2546,G
8-NS,714,2508,1,2,0,2511,A
8-NS,715,2498,0,4,0,2502,A
8-NS,716,0,0,2504,0,2504,G
8-NS,717,2503,0,0,0,2503,A
8-NS,718,2476,0,2,0,2478,A
8-NS,719,1,0,2491,0,2492,G
8-NS,720,0,2428,0,2,2430,T
8-NS,721,0,1,2433,0,2434,G
8-NS,722,2399,0,2,0,2401,A
8-NS,723,0,2,2398,0,2400,G
8-NS,724,2392,1,5,0,2398,A
8-NS,725,1,0,0,2380,2381,C
8-NS,726,2353,0,1,0,2354,A
8-NS,727,0,0,0,2361,2361,C
8-NS,728,2180,0,1,0,2181,A
8-NS,729,0,1,2213,0,2214,G
8-NS,730,2215,0,0,0,2215,A
8-NS,731,0,2184,0,3,2187,T
8-NS,732,0,2181,0,2,2183,T
8-NS,733,2185,0,3,0,2188,A
8-NS,734,2186,0,0,0,2186,A
8-NS,735,2185,0,1,0,2186,A
8-NS,736,2175,0,2,0,2177,A
8-NS,737,2168,0,0,1,2169,A
8-NS,738,0,0,0,2077,2077,C
8-NS,739,1952,0,0,0,1952,A
8-NS,740,1950,0,1,0,1951,A
8-NS,741,0,0,0,1957,1957,C
8-NS,742,0,1931,0,5,1936,T
8-NS,743,0,1,1953,0,1954,G
8-NS,744,1950,0,0,0,1950,A
8-NS,745,1962,0,0,0,1962,A
8-NS,746,1957,0,1,0,1958,A
8-NS,747,1927,1,1,0,1929,A
8-NS,748,0,1919,0,0,1919,T
8-NS,749,1891,0,0,1,1892,A
8-NS,750,0,0,1895,0,1895,G
8-NS,751,0,0,0,1901,1901,C
8-NS,752,0,1850,0,2,1852,T
8-NS,753,0,1846,0,1,1847,T
8-NS,754,0,1828,0,1,1829,T
8-NS,755,0,1,1830,1,1832,G
8-NS,756,1830,0,0,0,1830,A
8-NS,757,1839,0,3,0,1842,A
8-NS,758,0,0,0,1837,1837,C
8-NS,759,1784,0,0,0,1784,A
8-NS,760,1787,0,1,0,1788,A
8-NS,761,1795,0,1,0,1796,A
8-NS,762,0,1787,0,1,1788,T
8-NS,763,1787,0,0,0,1787,A
8-NS,764,1758,0,1,0,1759,A
8-NS,765,0,0,0,1761,1761,C
8-NS,766,1749,0,0,0,1749,A
8-NS,767,0,1705,0,1,1706,T
8-NS,768,0,1654,0,3,1657,T
8-NS,769,2,1,0,1650,1653,C
8-NS,770,1638,0,0,0,1638,A
8-NS,771,0,1627,0,2,1629,T
8-NS,772,0,0,1626,0,1626,G
8-NS,773,0,0,0,1596,1596,C
8-NS,774,1579,0,0,0,1579,A
8-NS,775,1571,0,4,0,1575,A
8-NS,776,0,1,1566,0,1567,G
8-NS,777,0,0,0,1585,1585,C
8-NS,778,1565,0,0,0,1565,A
8-NS,779,0,1561,0,1,1562,T
8-NS,780,0,1558,0,0,1558,T
8-NS,781,1545,0,3,0,1548,A
8-NS,782,0,0,0,1565,1565,C
8-NS,783,1549,0,1,0,1550,A
8-NS,784,1525,0,0,0,1525,A
8-NS,785,0,0,0,1527,1527,C
8-NS,786,0,1275,0,2,1277,T
8-NS,787,1,1,1277,0,1279,G
8-NS,788,0,0,0,1246,1246,C
8-NS,789,0,1220,0,1,1221,T
8-NS,790,0,0,1222,0,1222,G
8-NS,791,0,1200,0,1,1201,T
8-NS,792,0,1198,1,0,1199,T
8-NS,793,1,1200,0,0,1201,T
8-NS,794,0,1,1187,0,1188,G
8-NS,795,1187,0,1,0,1188,A
8-NS,796,1161,0,1,0,1162,A
8-NS,797,1,0,1156,0,1157,G
8-NS,798,1,1145,1,1,1148,T
8-NS,799,1,0,1090,0,1091,G
8-NS,800,0,0,1094,0,1094,G
8-NS,801,1090,0,1,0,1091,A
8-NS,802,1087,0,2,0,1089,A
8-NS,803,0,0,0,1085,1085,C
8-NS,804,1062,0,3,0,1065,A
8-NS,805,1,0,1060,0,1061,G
8-NS,806,0,0,1043,0,1043,G
8-NS,807,1030,0,2,0,1032,A
8-NS,808,0,0,1026,0,1026,G
8-NS,809,860,0,1,0,861,A
8-NS,810,0,857,0,0,857,T
8-NS,811,854,0,0,0,854,A
8-NS,812,836,0,1,0,837,A
8-NS,813,0,0,840,0,840,G
8-NS,814,752,0,0,0,752,A
8-NS,815,741,0,0,0,741,A
8-NS,816,0,0,0,741,741,C
8-NS,817,0,652,0,2,654,T
8-NS,818,0,642,0,0,642,T
8-NS,819,0,641,0,0,641,T
8-NS,820,0,0,0,637,637,C
8-NS,821,0,613,0,0,613,T
8-NS,822,0,0,0,596,596,C
8-NS,823,580,0,0,0,580,A
8-NS,824,0,575,0,0,575,T
8-NS,825,0,567,0,1,568,T
8-NS,826,0,569,0,0,569,T
8-NS,827,1,1,0,566,568,C
8-NS,828,549,0,0,0,549,A
8-NS,829,0,0,546,0,546,G
8-NS,830,1,0,0,544,545,C
8-NS,831,0,504,1,2,507,T
8-NS,832,0,501,1,0,502,T
8-NS,833,488,0,0,0,488,A
8-NS,834,0,487,0,0,487,T
8-NS,835,0,485,0,0,485,T
8-NS,836,0,479,0,0,479,T
8-NS,837,456,0,0,0,456,A
8-NS,838,441,0,1,0,442,A
8-NS,839,0,425,0,0,425,T
8-NS,840,0,1,425,0,426,G
8-NS,841,412,0,0,0,412,A
8-NS,842,0,369,0,0,369,T
8-NS,843,363,0,0,0,363,A
8-NS,844,360,0,0,1,361,A
8-NS,845,360,0,0,0,360,A
8-NS,846,359,0,0,0,359,A
8-NS,847,351,0,0,0,351,A
8-NS,848,354,0,1,0,355,A
8-NS,849,0,0,0,350,350,C
8-NS,850,286,0,0,0,286,A
8-NS,851,0,0,0,306,306,C
8-NS,852,2,0,0,286,288,C
8-NS,853,0,0,0,283,283,C
8-NS,854,0,267,0,0,267,T
8-NS,855,0,253,0,0,253,T
8-NS,856,0,0,254,0,254,G
8-NS,857,0,243,0,0,243,T
8-NS,858,0,236,0,0,236,T
8-NS,859,0,229,0,0,229,T
8-NS,860,0,0,0,85,85,C
8-NS,861,0,68,0,0,68,T
8-NS,862,60,0,0,0,60,A
8-NS,863,0,0,0,59,59,C
