Gene,Position,A,T,G,C,Coverage,Consensus
1-PB2,1,202,0,0,0,202,A
1-PB2,2,0,204,0,0,204,T
1-PB2,3,0,0,205,0,205,G
1-PB2,4,0,4,202,0,206,G
1-PB2,5,207,0,0,0,207,A
1-PB2,6,205,0,0,0,205,A
1-PB2,7,207,0,0,0,207,A
1-PB2,8,0,0,205,0,205,G
1-PB2,9,203,0,0,0,203,A
1-PB2,10,0,0,208,0,208,G
1-PB2,11,0,234,0,1,235,T
1-PB2,12,233,0,0,0,233,A
1-PB2,13,236,0,0,0,236,A
1-PB2,14,235,0,0,0,235,A
1-PB2,15,237,0,0,0,237,A
1-PB2,16,0,1,247,0,248,G
1-PB2,17,245,0,0,0,245,A
1-PB2,18,246,0,1,0,247,A
1-PB2,19,0,0,0,248,248,C
1-PB2,20,0,249,0,0,249,T
1-PB2,21,252,0,0,0,252,A
1-PB2,22,0,0,0,250,250,C
1-PB2,23,0,0,252,0,252,G
1-PB2,24,0,0,253,0,253,G
1-PB2,25,256,0,0,0,256,A
1-PB2,26,260,0,0,0,260,A
1-PB2,27,0,261,0,0,261,T
1-PB2,28,1,0,0,258,259,C
1-PB2,29,0,259,0,0,259,T
1-PB2,30,1,0,263,0,264,G
1-PB2,31,263,0,0,0,263,A
1-PB2,32,0,264,0,0,264,T
1-PB2,33,0,0,262,0,262,G
1-PB2,34,0,267,0,0,267,T
1-PB2,35,0,0,0,264,264,C
1-PB2,36,0,0,266,0,266,G
1-PB2,37,0,0,0,265,265,C
1-PB2,38,265,0,0,0,265,A
1-PB2,39,0,0,268,0,268,G
1-PB2,40,0,278,0,0,278,T
1-PB2,41,0,0,0,279,279,C
1-PB2,42,0,279,0,0,279,T
1-PB2,43,0,0,0,280,280,C
1-PB2,44,0,1,278,0,279,G
1-PB2,45,0,0,0,280,280,C
1-PB2,46,282,0,1,0,283,A
1-PB2,47,0,0,0,288,288,C
1-PB2,48,0,286,0,0,286,T
1-PB2,49,0,0,0,294,294,C
1-PB2,50,0,0,293,0,293,G
1-PB2,51,0,0,0,294,294,C
1-PB2,52,0,0,298,0,298,G
1-PB2,53,291,0,0,0,291,A
1-PB2,54,0,2,293,0,295,G
1-PB2,55,303,0,0,0,303,A
1-PB2,56,0,305,0,0,305,T
1-PB2,57,306,0,0,0,306,A
1-PB2,58,0,0,0,308,308,C
1-PB2,59,0,307,0,0,307,T
1-PB2,60,0,0,304,0,304,G
1-PB2,61,308,0,0,0,308,A
1-PB2,62,0,0,0,311,311,C
1-PB2,63,312,0,0,0,312,A
1-PB2,64,311,0,0,0,311,A
1-PB2,65,319,0,0,0,319,A
1-PB2,66,323,0,0,0,323,A
1-PB2,67,321,0,0,0,321,A
1-PB2,68,0,0,0,324,324,C
1-PB2,69,0,0,0,326,326,C
1-PB2,70,327,0,0,0,327,A
1-PB2,71,0,0,0,335,335,C
1-PB2,72,334,0,0,0,334,A
1-PB2,73,0,0,346,0,346,G
1-PB2,74,0,338,0,0,338,T
1-PB2,75,0,1,355,0,356,G
1-PB2,76,0,2,361,0,363,G
1-PB2,77,362,0,0,0,362,A
1-PB2,78,0,0,0,382,382,C
1-PB2,79,0,0,0,381,381,C
1-PB2,80,383,0,0,0,383,A
1-PB2,81,0,380,1,0,381,T
1-PB2,82,376,0,0,0,376,A
1-PB2,83,0,379,0,0,379,T
1-PB2,84,0,0,380,0,380,G
1-PB2,85,0,0,382,0,382,G
1-PB2,86,1,0,0,389,390,C
1-PB2,87,0,0,0,388,388,C
1-PB2,88,386,0,0,0,386,A
1-PB2,89,0,417,0,0,417,T
1-PB2,90,413,0,0,0,413,A
1-PB2,91,434,0,0,0,434,A
1-PB2,92,0,437,0,0,437,T
1-PB2,93,0,440,0,0,440,T
1-PB2,94,447,0,0,0,447,A
1-PB2,95,449,0,1,0,450,A
1-PB2,96,0,0,455,0,455,G
1-PB2,97,458,0,1,0,459,A
1-PB2,98,450,0,0,0,450,A
1-PB2,99,0,0,472,0,472,G
1-PB2,100,0,468,0,0,468,T
1-PB2,101,473,0,0,0,473,A
1-PB2,102,0,0,0,473,473,C
1-PB2,103,470,0,0,0,470,A
1-PB2,104,0,1,0,488,489,C
1-PB2,105,483,0,0,0,483,A
1-PB2,106,0,483,0,0,483,T
1-PB2,107,1,0,0,489,490,C
1-PB2,108,0,1,483,0,484,G
1-PB2,109,0,0,482,0,482,G
1-PB2,110,0,0,478,0,478,G
1-PB2,111,0,1,474,0,475,G
1-PB2,112,482,0,1,0,483,A
1-PB2,113,0,1,481,0,482,G
1-PB2,114,486,1,0,0,487,A
1-PB2,115,0,0,0,491,491,C
1-PB2,116,486,1,0,0,487,A
1-PB2,117,0,0,499,0,499,G
1-PB2,118,0,1,502,0,503,G
1-PB2,119,499,0,0,0,499,A
1-PB2,120,504,0,1,0,505,A
1-PB2,121,503,0,0,0,503,A
1-PB2,122,508,0,0,0,508,A
1-PB2,123,0,0,502,0,502,G
1-PB2,124,504,0,1,0,505,A
1-PB2,125,505,0,1,0,506,A
1-PB2,126,0,0,0,501,501,C
1-PB2,127,0,1,0,504,505,C
1-PB2,128,0,0,0,512,512,C
1-PB2,129,0,0,512,0,512,G
1-PB2,130,0,510,0,0,510,T
1-PB2,131,0,0,0,512,512,C
1-PB2,132,515,0,0,1,516,A
1-PB2,133,0,0,0,525,525,C
1-PB2,134,0,525,0,0,525,T
1-PB2,135,0,525,0,0,525,T
1-PB2,136,528,0,0,0,528,A
1-PB2,137,0,1,536,0,537,G
1-PB2,138,0,1,535,0,536,G
1-PB2,139,536,0,0,0,536,A
1-PB2,140,0,533,0,0,533,T
1-PB2,141,0,0,550,0,550,G
1-PB2,142,555,0,0,0,555,A
1-PB2,143,555,0,1,1,557,A
1-PB2,144,551,0,0,0,551,A
1-PB2,145,0,553,0,0,553,T
1-PB2,146,0,1,553,0,554,G
1-PB2,147,0,1,554,0,555,G
1-PB2,148,546,0,0,0,546,A
1-PB2,149,0,546,0,0,546,T
1-PB2,150,1,0,549,0,550,G
1-PB2,151,550,0,0,0,550,A
1-PB2,152,0,548,0,0,548,T
1-PB2,153,0,1,544,0,545,G
1-PB2,154,0,0,546,0,546,G
1-PB2,155,0,0,0,554,554,C
1-PB2,156,551,0,0,0,551,A
1-PB2,157,556,0,0,0,556,A
1-PB2,158,0,552,0,0,552,T
1-PB2,159,0,1,573,0,574,G
1-PB2,160,571,0,1,0,572,A
1-PB2,161,574,0,0,0,574,A
1-PB2,162,576,0,1,0,577,A
1-PB2,163,0,577,0,0,577,T
1-PB2,164,580,0,0,0,580,A
1-PB2,165,0,0,0,587,587,C
1-PB2,166,1,0,0,581,582,C
1-PB2,167,1,0,0,582,583,C
1-PB2,168,587,0,0,0,587,A
1-PB2,169,579,0,0,0,579,A
1-PB2,170,0,578,0,1,579,T
1-PB2,171,0,0,0,585,585,C
1-PB2,172,577,0,0,0,577,A
1-PB2,173,0,0,0,591,591,C
1-PB2,174,0,587,0,0,587,T
1-PB2,175,0,1,596,0,597,G
1-PB2,176,0,0,0,593,593,C
1-PB2,177,1,595,0,0,596,T
1-PB2,178,0,1,600,0,601,G
1-PB2,179,600,0,2,0,602,A
1-PB2,180,1,1,0,605,607,C
1-PB2,181,607,0,0,0,607,A
1-PB2,182,598,0,0,0,598,A
1-PB2,183,600,0,1,2,603,A
1-PB2,184,608,0,0,0,608,A
1-PB2,185,0,0,610,0,610,G
1-PB2,186,0,0,604,0,604,G
1-PB2,187,609,0,0,0,609,A
1-PB2,188,0,612,0,0,612,T
1-PB2,189,610,0,0,0,610,A
1-PB2,190,614,0,0,0,614,A
1-PB2,191,0,0,0,612,612,C
1-PB2,192,616,1,0,0,617,A
1-PB2,193,0,0,615,0,615,G
1-PB2,194,603,0,0,0,603,A
1-PB2,195,609,0,0,0,609,A
1-PB2,196,612,0,1,0,613,A
1-PB2,197,0,614,0,0,614,T
1-PB2,198,0,1,614,0,615,G
1-PB2,199,608,0,0,0,608,A
1-PB2,200,0,617,0,0,617,T
1-PB2,201,0,614,0,1,615,T
1-PB2,202,1,0,0,610,611,C
1-PB2,203,1,0,0,618,619,C
1-PB2,204,619,0,0,0,619,A
1-PB2,205,0,0,620,0,620,G
1-PB2,206,623,0,0,0,623,A
1-PB2,207,0,2,621,0,623,G
1-PB2,208,613,0,0,0,613,A
1-PB2,209,0,3,619,0,622,G
1-PB2,210,624,0,0,0,624,A
1-PB2,211,622,0,0,0,622,A
1-PB2,212,628,0,0,0,628,A
1-PB2,213,0,624,0,0,624,T
1-PB2,214,0,2,626,0,628,G
1-PB2,215,630,0,0,0,630,A
1-PB2,216,633,0,0,0,633,A
1-PB2,217,0,0,0,629,629,C
1-PB2,218,629,0,0,0,629,A
1-PB2,219,629,0,0,0,629,A
1-PB2,220,0,0,638,0,638,G
1-PB2,221,0,1,636,0,637,G
1-PB2,222,646,0,0,0,646,A
1-PB2,223,0,0,0,650,650,C
1-PB2,224,653,0,0,0,653,A
1-PB2,225,654,0,0,0,654,A
1-PB2,226,678,0,0,0,678,A
1-PB2,227,0,0,0,686,686,C
1-PB2,228,0,679,0,1,680,T
1-PB2,229,2,0,0,687,689,C
1-PB2,230,0,681,0,1,682,T
1-PB2,231,688,0,0,0,688,A
1-PB2,232,0,686,0,0,686,T
1-PB2,233,0,1,693,0,694,G
1-PB2,234,0,0,703,0,703,G
1-PB2,235,686,0,0,0,686,A
1-PB2,236,0,0,693,0,693,G
1-PB2,237,0,687,0,0,687,T
1-PB2,238,692,0,0,0,692,A
1-PB2,239,693,0,0,0,693,A
1-PB2,240,692,0,0,0,692,A
1-PB2,241,692,0,0,0,692,A
1-PB2,242,0,683,0,0,683,T
1-PB2,243,0,2,687,0,689,G
1-PB2,244,686,0,1,0,687,A
1-PB2,245,0,0,686,0,686,G
1-PB2,246,0,679,0,0,679,T
1-PB2,247,0,0,681,0,681,G
1-PB2,248,687,0,0,0,687,A
1-PB2,249,0,689,0,1,690,T
1-PB2,250,0,1,687,0,688,G
1-PB2,251,0,0,0,678,678,C
1-PB2,252,0,687,0,0,687,T
1-PB2,253,0,0,705,0,705,G
1-PB2,254,0,2,700,0,702,G
1-PB2,255,711,0,0,0,711,A
1-PB2,256,0,701,0,0,701,T
1-PB2,257,0,0,0,711,711,C
1-PB2,258,717,0,0,0,717,A
1-PB2,259,0,2,731,0,733,G
1-PB2,260,735,0,0,0,735,A
1-PB2,261,0,732,0,1,733,T
1-PB2,262,719,0,0,0,719,A
1-PB2,263,0,1,725,0,726,G
1-PB2,264,723,0,1,0,724,A
1-PB2,265,0,0,726,0,726,G
1-PB2,266,0,712,0,0,712,T
1-PB2,267,2,0,715,0,717,G
1-PB2,268,715,0,0,0,715,A
1-PB2,269,0,717,0,0,717,T
1-PB2,270,2,0,725,0,727,G
1-PB2,271,0,0,736,0,736,G
1-PB2,272,0,732,0,1,733,T
1-PB2,273,737,0,0,0,737,A
1-PB2,274,0,722,0,1,723,T
1-PB2,275,1,0,0,724,725,C
1-PB2,276,737,1,0,0,738,A
1-PB2,277,0,0,0,757,757,C
1-PB2,278,0,0,0,749,749,C
1-PB2,279,0,747,1,0,748,T
1-PB2,280,0,741,0,0,741,T
1-PB2,281,0,744,0,1,745,T
1-PB2,282,0,2,751,0,753,G
1-PB2,283,0,2,751,0,753,G
1-PB2,284,0,0,0,758,758,C
1-PB2,285,0,750,0,0,750,T
1-PB2,286,0,0,753,0,753,G
1-PB2,287,0,755,0,1,756,T
1-PB2,288,761,0,0,0,761,A
1-PB2,289,758,0,0,0,758,A
1-PB2,290,0,0,0,759,759,C
1-PB2,291,750,0,0,0,750,A
1-PB2,292,0,748,0,0,748,T
1-PB2,293,0,0,745,0,745,G
1-PB2,294,0,0,750,0,750,G
1-PB2,295,0,747,0,2,749,T
1-PB2,296,0,0,756,0,756,G
1-PB2,297,0,0,758,0,758,G
1-PB2,298,761,0,0,0,761,A
1-PB2,299,764,0,0,0,764,A
1-PB2,300,0,767,0,0,767,T
1-PB2,301,765,0,0,0,765,A
1-PB2,302,0,1,779,0,780,G
1-PB2,303,771,0,1,0,772,A
1-PB2,304,771,0,0,0,771,A
1-PB2,305,773,0,0,0,773,A
1-PB2,306,0,765,0,0,765,T
1-PB2,307,0,2,758,0,760,G
1-PB2,308,0,4,755,0,759,G
1-PB2,309,764,0,1,0,765,A
1-PB2,310,0,0,0,770,770,C
1-PB2,311,0,0,0,755,755,C
1-PB2,312,1,0,0,761,762,C
1-PB2,313,0,0,767,0,767,G
1-PB2,314,0,769,0,0,769,T
1-PB2,315,0,0,776,0,776,G
1-PB2,316,781,0,0,0,781,A
1-PB2,317,0,0,0,779,779,C
1-PB2,318,781,0,1,0,782,A
1-PB2,319,779,0,0,0,779,A
1-PB2,320,0,0,795,0,795,G
1-PB2,321,0,794,0,0,794,T
1-PB2,322,794,0,0,0,794,A
1-PB2,323,2,0,0,788,790,C
1-PB2,324,0,0,771,0,771,G
1-PB2,325,0,0,782,0,782,G
1-PB2,326,0,787,0,0,787,T
1-PB2,327,0,0,0,789,789,C
1-PB2,328,1,0,0,795,796,C
1-PB2,329,795,0,0,0,795,A
1-PB2,330,0,792,0,0,792,T
1-PB2,331,0,798,0,0,798,T
1-PB2,332,813,0,0,0,813,A
1-PB2,333,0,0,0,801,801,C
1-PB2,334,1,0,0,779,780,C
1-PB2,335,3,0,0,787,790,C
1-PB2,336,779,2,0,0,781,A
1-PB2,337,791,0,0,0,791,A
1-PB2,338,789,0,0,0,789,A
1-PB2,339,785,0,0,0,785,A
1-PB2,340,0,0,794,0,794,G
1-PB2,341,0,759,0,0,759,T
1-PB2,342,0,0,780,0,780,G
1-PB2,343,0,782,0,2,784,T
1-PB2,344,786,0,0,0,786,A
1-PB2,345,0,0,0,778,778,C
1-PB2,346,780,0,0,0,780,A
1-PB2,347,779,0,0,0,779,A
1-PB2,348,0,2,780,0,782,G
1-PB2,349,772,0,0,0,772,A
1-PB2,350,0,0,0,776,776,C
1-PB2,351,0,773,0,0,773,T
1-PB2,352,0,778,0,0,778,T
1-PB2,353,778,0,0,0,778,A
1-PB2,354,0,781,0,0,781,T
1-PB2,355,0,778,0,0,778,T
1-PB2,356,0,769,0,0,769,T
1-PB2,357,0,0,0,773,773,C
1-PB2,358,0,2,765,0,767,G
1-PB2,359,767,0,1,0,768,A
1-PB2,360,1,1,0,769,771,C
1-PB2,361,768,0,0,0,768,A
1-PB2,362,768,0,0,0,768,A
1-PB2,363,763,0,1,0,764,A
1-PB2,364,0,0,772,0,772,G
1-PB2,365,0,756,0,1,757,T
1-PB2,366,1,0,0,769,770,C
1-PB2,367,0,0,773,0,773,G
1-PB2,368,768,0,0,0,768,A
1-PB2,369,765,0,0,0,765,A
1-PB2,370,761,0,1,0,762,A
1-PB2,371,0,1,792,0,793,G
1-PB2,372,1,1,790,0,792,G
1-PB2,373,0,774,0,0,774,T
1-PB2,374,0,783,0,0,783,T
1-PB2,375,783,0,0,0,783,A
1-PB2,376,786,0,0,0,786,A
1-PB2,377,780,0,0,0,780,A
1-PB2,378,787,0,0,0,787,A
1-PB2,379,0,0,0,798,798,C
1-PB2,380,793,0,0,0,793,A
1-PB2,381,0,781,0,0,781,T
1-PB2,382,0,1,782,0,783,G
1-PB2,383,0,0,777,1,778,G
1-PB2,384,782,0,0,0,782,A
1-PB2,385,780,0,0,0,780,A
1-PB2,386,0,0,0,789,789,C
1-PB2,387,1,0,0,797,798,C
1-PB2,388,0,784,0,1,785,T
1-PB2,389,0,785,0,0,785,T
1-PB2,390,1,790,0,0,791,T
1-PB2,391,1,2,788,0,791,G
1-PB2,392,0,0,793,0,793,G
1-PB2,393,2,0,0,780,782,C
1-PB2,394,2,1,0,778,781,C
1-PB2,395,0,2,0,779,781,C
1-PB2,396,0,779,0,1,780,T
1-PB2,397,0,0,787,0,787,G
1-PB2,398,0,787,0,0,787,T
1-PB2,399,0,783,0,0,783,T
1-PB2,400,0,0,0,785,785,C
1-PB2,401,785,0,0,0,785,A
1-PB2,402,0,783,0,0,783,T
1-PB2,403,0,784,0,0,784,T
1-PB2,404,0,785,0,0,785,T
1-PB2,405,0,785,0,0,785,T
1-PB2,406,781,0,0,0,781,A
1-PB2,407,0,0,779,0,779,G
1-PB2,408,776,0,0,0,776,A
1-PB2,409,778,0,0,0,778,A
1-PB2,410,783,0,0,0,783,A
1-PB2,411,0,767,0,0,767,T
1-PB2,412,1,0,0,776,777,C
1-PB2,413,775,0,0,0,775,A
1-PB2,414,777,0,1,0,778,A
1-PB2,415,0,0,776,0,776,G
1-PB2,416,0,777,0,0,777,T
1-PB2,417,1,0,0,772,773,C
1-PB2,418,783,0,0,0,783,A
1-PB2,419,781,0,0,0,781,A
1-PB2,420,0,0,780,0,780,G
1-PB2,421,779,0,0,0,779,A
1-PB2,422,0,775,0,0,775,T
1-PB2,423,781,0,0,0,781,A
1-PB2,424,0,4,0,780,784,C
1-PB2,425,1,0,783,0,784,G
1-PB2,426,0,0,0,795,795,C
1-PB2,427,797,0,0,0,797,A
1-PB2,428,0,0,799,0,799,G
1-PB2,429,795,0,0,0,795,A
1-PB2,430,798,0,0,0,798,A
1-PB2,431,0,0,805,0,805,G
1-PB2,432,787,0,0,0,787,A
1-PB2,433,0,0,803,0,803,G
1-PB2,434,0,798,0,0,798,T
1-PB2,435,797,0,1,0,798,A
1-PB2,436,0,1,818,0,819,G
1-PB2,437,812,0,0,0,812,A
1-PB2,438,1,0,0,843,844,C
1-PB2,439,827,0,0,0,827,A
1-PB2,440,0,816,0,0,816,T
1-PB2,441,811,0,0,0,811,A
1-PB2,442,809,0,0,0,809,A
1-PB2,443,809,0,0,0,809,A
1-PB2,444,0,0,0,812,812,C
1-PB2,445,1,0,0,802,803,C
1-PB2,446,2,0,0,795,797,C
1-PB2,447,0,743,0,1,744,T
1-PB2,448,0,1,746,0,747,G
1-PB2,449,0,0,757,0,757,G
1-PB2,450,0,756,0,0,756,T
1-PB2,451,1,0,0,757,758,C
1-PB2,452,766,0,0,0,766,A
1-PB2,453,0,762,0,0,762,T
1-PB2,454,0,0,763,0,763,G
1-PB2,455,0,0,0,760,760,C
1-PB2,456,752,0,0,0,752,A
1-PB2,457,0,0,753,0,753,G
1-PB2,458,736,0,0,0,736,A
1-PB2,459,0,0,0,745,745,C
1-PB2,460,0,3,0,741,744,C
1-PB2,461,0,737,0,0,737,T
1-PB2,462,0,0,0,743,743,C
1-PB2,463,739,0,0,0,739,A
1-PB2,464,0,0,736,0,736,G
1-PB2,465,0,740,0,0,740,T
1-PB2,466,0,0,733,0,733,G
1-PB2,467,1,0,0,730,731,C
1-PB2,468,0,0,0,732,732,C
1-PB2,469,740,0,0,0,740,A
1-PB2,470,736,0,0,0,736,A
1-PB2,471,741,0,0,0,741,A
1-PB2,472,0,1,743,0,744,G
1-PB2,473,718,0,0,0,718,A
1-PB2,474,0,2,720,0,722,G
1-PB2,475,1,0,714,0,715,G
1-PB2,476,1,0,0,716,717,C
1-PB2,477,713,0,2,0,715,A
1-PB2,478,0,0,0,718,718,C
1-PB2,479,722,0,0,0,722,A
1-PB2,480,734,0,0,0,734,A
1-PB2,481,0,0,743,0,743,G
1-PB2,482,746,0,0,0,746,A
1-PB2,483,0,739,0,0,739,T
1-PB2,484,0,0,744,0,744,G
1-PB2,485,0,742,0,0,742,T
1-PB2,486,748,0,0,0,748,A
1-PB2,487,748,0,0,0,748,A
1-PB2,488,0,752,0,0,752,T
1-PB2,489,0,729,0,0,729,T
1-PB2,490,722,0,0,0,722,A
1-PB2,491,0,708,0,0,708,T
1-PB2,492,0,0,705,0,705,G
1-PB2,493,0,1,706,0,707,G
1-PB2,494,704,0,0,0,704,A
1-PB2,495,694,1,0,1,696,A
1-PB2,496,1,1,699,0,701,G
1-PB2,497,0,693,0,0,693,T
1-PB2,498,0,701,0,0,701,T
1-PB2,499,0,0,700,0,700,G
1-PB2,500,0,695,0,1,696,T
1-PB2,501,0,693,0,0,693,T
1-PB2,502,0,698,0,0,698,T
1-PB2,503,0,697,0,0,697,T
1-PB2,504,0,702,0,1,703,T
1-PB2,505,2,0,0,697,699,C
1-PB2,506,1,0,0,700,701,C
1-PB2,507,1,0,0,705,706,C
1-PB2,508,696,0,0,0,696,A
1-PB2,509,694,0,0,0,694,A
1-PB2,510,0,702,0,0,702,T
1-PB2,511,0,0,701,0,701,G
1-PB2,512,705,0,0,0,705,A
1-PB2,513,701,0,0,0,701,A
1-PB2,514,0,0,706,0,706,G
1-PB2,515,0,690,0,1,691,T
1-PB2,516,0,0,695,0,695,G
1-PB2,517,0,1,697,0,698,G
1-PB2,518,0,1,690,0,691,G
1-PB2,519,700,0,2,0,702,A
1-PB2,520,0,1,699,0,700,G
1-PB2,521,0,0,0,686,686,C
1-PB2,522,0,0,0,702,702,C
1-PB2,523,709,0,1,0,710,A
1-PB2,524,0,0,717,0,717,G
1-PB2,525,0,1,725,0,726,G
1-PB2,526,720,0,0,0,720,A
1-PB2,527,0,715,0,0,715,T
1-PB2,528,723,0,1,0,724,A
1-PB2,529,0,0,0,721,721,C
1-PB2,530,0,725,0,0,725,T
1-PB2,531,719,0,0,0,719,A
1-PB2,532,722,0,0,0,722,A
1-PB2,533,0,1,0,730,731,C
1-PB2,534,713,0,0,0,713,A
1-PB2,535,0,711,0,0,711,T
1-PB2,536,1,0,0,713,714,C
1-PB2,537,705,0,0,0,705,A
1-PB2,538,0,2,712,0,714,G
1-PB2,539,712,0,0,0,712,A
1-PB2,540,711,0,0,0,711,A
1-PB2,541,0,712,0,0,712,T
1-PB2,542,1,1,0,704,706,C
1-PB2,543,700,0,0,0,700,A
1-PB2,544,0,0,0,721,721,C
1-PB2,545,724,0,0,0,724,A
1-PB2,546,728,0,0,0,728,A
1-PB2,547,0,725,0,0,725,T
1-PB2,548,0,724,0,0,724,T
1-PB2,549,720,0,1,0,721,A
1-PB2,550,725,0,0,0,725,A
1-PB2,551,0,0,0,728,728,C
1-PB2,552,721,0,0,0,721,A
1-PB2,553,721,0,0,0,721,A
1-PB2,554,0,731,0,0,731,T
1-PB2,555,723,0,0,0,723,A
1-PB2,556,719,0,0,0,719,A
1-PB2,557,0,0,0,724,724,C
1-PB2,558,0,721,0,0,721,T
1-PB2,559,719,0,0,0,719,A
1-PB2,560,710,0,0,0,710,A
1-PB2,561,711,0,0,0,711,A
1-PB2,562,0,0,717,0,717,G
1-PB2,563,698,0,1,0,699,A
1-PB2,564,0,3,700,0,703,G
1-PB2,565,700,0,0,0,700,A
1-PB2,566,708,0,0,0,708,A
1-PB2,567,704,0,0,0,704,A
1-PB2,568,706,0,0,0,706,A
1-PB2,569,701,0,1,0,702,A
1-PB2,570,702,0,0,0,702,A
1-PB2,571,0,1,707,0,708,G
1-PB2,572,705,0,0,0,705,A
1-PB2,573,701,0,0,0,701,A
1-PB2,574,0,2,701,0,703,G
1-PB2,575,705,0,0,0,705,A
1-PB2,576,707,0,0,0,707,A
1-PB2,577,0,0,0,712,712,C
1-PB2,578,0,694,0,0,694,T
1-PB2,579,0,0,0,703,703,C
1-PB2,580,1,0,0,712,713,C
1-PB2,581,0,1,712,0,713,G
1-PB2,582,706,0,0,0,706,A
1-PB2,583,0,1,708,0,709,G
1-PB2,584,706,0,0,0,706,A
1-PB2,585,0,707,0,0,707,T
1-PB2,586,0,702,0,0,702,T
1-PB2,587,0,1,696,0,697,G
1-PB2,588,0,0,0,698,698,C
1-PB2,589,703,0,1,0,704,A
1-PB2,590,701,0,2,0,703,A
1-PB2,591,703,0,0,0,703,A
1-PB2,592,704,0,0,0,704,A
1-PB2,593,0,702,0,0,702,T
1-PB2,594,0,702,0,0,702,T
1-PB2,595,0,697,0,0,697,T
1-PB2,596,0,0,0,698,698,C
1-PB2,597,1,683,0,4,688,T
1-PB2,598,0,0,0,761,761,C
1-PB2,599,1,0,0,777,778,C
1-PB2,600,1,0,0,914,915,C
1-PB2,601,0,914,0,1,915,T
1-PB2,602,0,928,0,0,928,T
1-PB2,603,0,0,940,0,940,G
1-PB2,604,924,0,2,1,927,A
1-PB2,605,0,974,0,0,974,T
1-PB2,606,1,3,992,0,996,G
1-PB2,607,0,0,1158,0,1158,G
1-PB2,608,0,1194,0,0,1194,T
1-PB2,609,0,1202,0,1,1203,T
1-PB2,610,1,0,1318,0,1319,G
1-PB2,611,1,1,0,1331,1333,C
1-PB2,612,1381,0,0,0,1381,A
1-PB2,613,0,1390,0,4,1394,T
1-PB2,614,1411,0,0,3,1414,A
1-PB2,615,0,1,0,1527,1528,C
1-PB2,616,1743,0,0,18,1761,A
1-PB2,617,0,1813,0,1,1814,T
1-PB2,618,0,1,1907,0,1908,G
1-PB2,619,0,1916,0,4,1920,T
1-PB2,620,0,1914,0,0,1914,T
1-PB2,621,1927,0,0,0,1927,A
1-PB2,622,0,3,1912,0,1915,G
1-PB2,623,1961,0,0,0,1961,A
1-PB2,624,0,2,1986,0,1988,G
1-PB2,625,1949,0,0,0,1949,A
1-PB2,626,0,3,1959,0,1962,G
1-PB2,627,1923,0,1,0,1924,A
1-PB2,628,1,2,1944,0,1947,G
1-PB2,629,1969,0,1,1,1971,A
1-PB2,630,1973,0,0,0,1973,A
1-PB2,631,1,0,0,1986,1987,C
1-PB2,632,0,1986,0,0,1986,T
1-PB2,633,0,1988,0,1,1989,T
1-PB2,634,0,3,1989,0,1992,G
1-PB2,635,0,1986,0,1,1987,T
1-PB2,636,2001,0,0,0,2001,A
1-PB2,637,0,1,0,1987,1988,C
1-PB2,638,0,5,1981,0,1986,G
1-PB2,639,1987,0,2,0,1989,A
1-PB2,640,1989,0,1,0,1990,A
1-PB2,641,2028,0,0,0,2028,A
1-PB2,642,2028,0,0,0,2028,A
1-PB2,643,2024,1,1,2,2028,A
1-PB2,644,0,1,0,2039,2040,C
1-PB2,645,2045,0,0,0,2045,A
1-PB2,646,2042,0,2,0,2044,A
1-PB2,647,0,5,2050,0,2055,G
1-PB2,648,2066,0,0,0,2066,A
1-PB2,649,0,2073,0,0,2073,T
1-PB2,650,0,2072,0,0,2072,T
1-PB2,651,1,2078,0,1,2080,T
1-PB2,652,4,0,0,2077,2081,C
1-PB2,653,1,2084,0,1,2086,T
1-PB2,654,4,0,0,2080,2084,C
1-PB2,655,3,1,0,2082,2086,C
1-PB2,656,2,0,0,2094,2096,C
1-PB2,657,2088,0,5,0,2093,A
1-PB2,658,1,0,2110,0,2111,G
1-PB2,659,0,2118,0,0,2118,T
1-PB2,660,0,2107,5,0,2112,T
1-PB2,661,0,0,2110,0,2110,G
1-PB2,662,0,1,0,2107,2108,C
1-PB2,663,0,2104,0,5,2109,T
1-PB2,664,1,0,2122,0,2123,G
1-PB2,665,0,1,2101,0,2102,G
1-PB2,666,3,2,0,2100,2105,C
1-PB2,667,0,2,2128,0,2130,G
1-PB2,668,1,4,2153,0,2158,G
1-PB2,669,2157,0,0,0,2157,A
1-PB2,670,2166,1,2,0,2169,A
1-PB2,671,0,0,0,2150,2150,C
1-PB2,672,2182,0,0,0,2182,A
1-PB2,673,2180,0,0,0,2180,A
1-PB2,674,0,0,2265,0,2265,G
1-PB2,675,0,4,0,2309,2313,C
1-PB2,676,2345,0,2,0,2347,A
1-PB2,677,0,0,2918,0,2918,G
1-PB2,678,0,2922,0,0,2922,T
1-PB2,679,2926,1,0,0,2927,A
1-PB2,680,0,2944,0,0,2944,T
1-PB2,681,2956,0,0,0,2956,A
1-PB2,682,0,2973,0,1,2974,T
1-PB2,683,2955,0,0,0,2955,A
1-PB2,684,1,1,0,2999,3001,C
1-PB2,685,2920,0,0,0,2920,A
1-PB2,686,0,2837,0,1,2838,T
1-PB2,687,0,2788,1,0,2789,T
1-PB2,688,0,6,2784,0,2790,G
1-PB2,689,2780,0,1,1,2782,A
1-PB2,690,2786,0,0,0,2786,A
1-PB2,691,0,0,2838,0,2838,G
1-PB2,692,0,2810,1,0,2811,T
1-PB2,693,0,2804,1,0,2805,T
1-PB2,694,0,2810,0,0,2810,T
1-PB2,695,0,2818,0,2,2820,T
1-PB2,696,2838,0,0,0,2838,A
1-PB2,697,2,1,0,2849,2852,C
1-PB2,698,2845,0,0,0,2845,A
1-PB2,699,0,2848,0,0,2848,T
1-PB2,700,0,2834,1,0,2835,T
1-PB2,701,0,2850,0,0,2850,T
1-PB2,702,0,9,2853,0,2862,G
1-PB2,703,2846,1,0,0,2847,A
1-PB2,704,0,0,0,2889,2889,C
1-PB2,705,0,2881,0,1,2882,T
1-PB2,706,7,0,0,2880,2887,C
1-PB2,707,2875,0,3,0,2878,A
1-PB2,708,1,2,2872,0,2875,G
1-PB2,709,0,4,2921,0,2925,G
1-PB2,710,0,3,2935,0,2938,G
1-PB2,711,2928,1,3,0,2932,A
1-PB2,712,2940,0,3,0,2943,A
1-PB2,713,1,2,0,2950,2953,C
1-PB2,714,1,1,2974,0,2976,G
1-PB2,715,0,2947,0,1,2948,T
1-PB2,716,0,2,2987,0,2989,G
1-PB2,717,0,2971,0,1,2972,T
1-PB2,718,0,2978,0,0,2978,T
1-PB2,719,0,1,2996,2,2999,G
1-PB2,720,1,2,2988,0,2991,G
1-PB2,721,0,6,3012,1,3019,G
1-PB2,722,3000,1,1,0,3002,A
1-PB2,723,3002,0,3,0,3005,A
1-PB2,724,2,0,0,3077,3079,C
1-PB2,725,3058,0,4,0,3062,A
1-PB2,726,3132,0,0,0,3132,A
1-PB2,727,3147,0,0,0,3147,A
1-PB2,728,0,3183,0,0,3183,T
1-PB2,729,0,4,3213,0,3217,G
1-PB2,730,0,3201,0,1,3202,T
1-PB2,731,3220,0,1,0,3221,A
1-PB2,732,2,1,0,3208,3211,C
1-PB2,733,3169,0,2,0,3171,A
1-PB2,734,0,1,0,3176,3177,C
1-PB2,735,0,3105,0,4,3109,T
1-PB2,736,4,0,0,3300,3304,C
1-PB2,737,2,0,0,3311,3313,C
1-PB2,738,3359,0,4,0,3363,A
1-PB2,739,0,2,3414,0,3416,G
1-PB2,740,0,0,3479,0,3479,G
1-PB2,741,1,3425,0,2,3428,T
1-PB2,742,1,4,3461,0,3466,G
1-PB2,743,0,3,3407,1,3411,G
1-PB2,744,3349,0,2,0,3351,A
1-PB2,745,0,4,3429,0,3433,G
1-PB2,746,0,6,3423,1,3430,G
1-PB2,747,3373,0,4,0,3377,A
1-PB2,748,0,0,3450,0,3450,G
1-PB2,749,0,3342,0,1,3343,T
1-PB2,750,0,4,3395,0,3399,G
1-PB2,751,3376,0,3,0,3379,A
1-PB2,752,2,6,3419,0,3427,G
1-PB2,753,1,6,3437,0,3444,G
1-PB2,754,3413,1,0,0,3414,A
1-PB2,755,3416,0,3,0,3419,A
1-PB2,756,0,3447,0,0,3447,T
1-PB2,757,0,4,3421,0,3425,G
1-PB2,758,3410,1,3,0,3414,A
1-PB2,759,0,1,0,3427,3428,C
1-PB2,760,1,5,3425,0,3431,G
1-PB2,761,3426,0,1,0,3427,A
1-PB2,762,1,3432,0,1,3434,T
1-PB2,763,1,0,3474,0,3475,G
1-PB2,764,0,3445,0,3,3448,T
1-PB2,765,0,3445,0,2,3447,T
1-PB2,766,2,11,3465,1,3479,G
1-PB2,767,3473,0,1,1,3475,A
1-PB2,768,0,2,0,3467,3469,C
1-PB2,769,6,0,1,3454,3461,C
1-PB2,770,3438,0,1,0,3439,A
1-PB2,771,3445,0,0,0,3445,A
1-PB2,772,3450,0,1,0,3451,A
1-PB2,773,0,2,3509,0,3511,G
1-PB2,774,4,0,0,3519,3523,C
1-PB2,775,0,0,0,3521,3521,C
1-PB2,776,0,3553,0,2,3555,T
1-PB2,777,3561,0,0,0,3561,A
1-PB2,778,3555,0,0,0,3555,A
1-PB2,779,0,3558,0,0,3558,T
1-PB2,780,0,3554,0,0,3554,T
1-PB2,781,3532,1,6,0,3539,A
1-PB2,782,0,3476,0,0,3476,T
1-PB2,783,0,3465,0,1,3466,T
1-PB2,784,0,0,3458,0,3458,G
1-PB2,785,4,2,0,3444,3450,C
1-PB2,786,1,2,3444,0,3447,G
1-PB2,787,1,1,3474,1,3477,G
1-PB2,788,0,0,0,3463,3463,C
1-PB2,789,0,0,0,3487,3487,C
1-PB2,790,3491,0,2,0,3493,A
1-PB2,791,0,8,3553,0,3561,G
1-PB2,792,1,10,3584,0,3595,G
1-PB2,793,3573,0,4,0,3577,A
1-PB2,794,3601,1,6,0,3608,A
1-PB2,795,1,0,0,3627,3628,C
1-PB2,796,3623,0,2,1,3626,A
1-PB2,797,0,3671,0,0,3671,T
1-PB2,798,3745,0,2,0,3747,A
1-PB2,799,1,0,3774,0,3775,G
1-PB2,800,0,3740,0,0,3740,T
1-PB2,801,3734,1,0,0,3735,A
1-PB2,802,3727,1,0,0,3728,A
1-PB2,803,0,4,3744,0,3748,G
1-PB2,804,3719,0,4,0,3723,A
1-PB2,805,3694,0,0,0,3694,A
1-PB2,806,3,3,3692,0,3698,G
1-PB2,807,3618,1,3,0,3622,A
1-PB2,808,0,1,3624,0,3625,G
1-PB2,809,1,0,0,3631,3632,C
1-PB2,810,2,0,0,3647,3649,C
1-PB2,811,5,2,3654,0,3661,G
1-PB2,812,0,1,0,3679,3680,C
1-PB2,813,3691,0,3,0,3694,A
1-PB2,814,0,1,3915,0,3916,G
1-PB2,815,0,3900,0,2,3902,T
1-PB2,816,3936,1,1,0,3938,A
1-PB2,817,0,3909,1,1,3911,T
1-PB2,818,4,1,0,3961,3966,C
1-PB2,819,3960,1,1,1,3963,A
1-PB2,820,1,1,3947,0,3949,G
1-PB2,821,0,3,0,3948,3951,C
1-PB2,822,3874,0,1,0,3875,A
1-PB2,823,0,1,3823,1,3825,G
1-PB2,824,3830,0,1,0,3831,A
1-PB2,825,1,3828,0,0,3829,T
1-PB2,826,2,0,0,3832,3834,C
1-PB2,827,4,0,0,3856,3860,C
1-PB2,828,3847,0,0,0,3847,A
1-PB2,829,0,0,0,3879,3879,C
1-PB2,830,0,3845,0,3,3848,T
1-PB2,831,3874,0,0,0,3874,A
1-PB2,832,0,2,3851,0,3853,G
1-PB2,833,2,0,0,3842,3844,C
1-PB2,834,3824,0,0,0,3824,A
1-PB2,835,1,3834,0,1,3836,T
1-PB2,836,0,1,0,3862,3863,C
1-PB2,837,0,3880,0,0,3880,T
1-PB2,838,0,3965,0,0,3965,T
1-PB2,839,0,3975,0,0,3975,T
1-PB2,840,3985,1,0,0,3986,A
1-PB2,841,0,3965,1,0,3966,T
1-PB2,842,0,3972,0,0,3972,T
1-PB2,843,0,2,3958,0,3960,G
1-PB2,844,0,5,3940,1,3946,G
1-PB2,845,3911,0,6,0,3917,A
1-PB2,846,2,1,3917,0,3920,G
1-PB2,847,3866,0,0,0,3866,A
1-PB2,848,0,3860,0,0,3860,T
1-PB2,849,0,1,3919,0,3920,G
1-PB2,850,0,3893,0,1,3894,T
1-PB2,851,3,2,3909,0,3914,G
1-PB2,852,1,0,0,3916,3917,C
1-PB2,853,3,0,0,3912,3915,C
1-PB2,854,3903,0,7,0,3910,A
1-PB2,855,2,1,0,3921,3924,C
1-PB2,856,3893,0,2,0,3895,A
1-PB2,857,0,0,3937,0,3937,G
1-PB2,858,1,0,0,3848,3849,C
1-PB2,859,3868,0,2,0,3870,A
1-PB2,860,1,0,0,3860,3861,C
1-PB2,861,3860,1,5,1,3867,A
1-PB2,862,0,0,0,3902,3902,C
1-PB2,863,3896,0,0,0,3896,A
1-PB2,864,3901,0,2,4,3907,A
1-PB2,865,3883,0,8,0,3891,A
1-PB2,866,0,3808,0,0,3808,T
1-PB2,867,0,3819,0,1,3820,T
1-PB2,868,0,1,3797,0,3798,G
1-PB2,869,1,2,3753,0,3756,G
1-PB2,870,0,0,1,3759,3760,C
1-PB2,871,10,5,3765,0,3780,G
1-PB2,872,2,7,3825,0,3834,G
1-PB2,873,0,6,3797,0,3803,G
1-PB2,874,3691,0,2,0,3693,A
1-PB2,875,0,1,0,3761,3762,C
1-PB2,876,3744,0,1,0,3745,A
1-PB2,877,3816,0,0,0,3816,A
1-PB2,878,2,2,3779,0,3783,G
1-PB2,879,0,1,3884,0,3885,G
1-PB2,880,3713,0,3,0,3716,A
1-PB2,881,0,3722,1,1,3724,T
1-PB2,882,3,11,3632,0,3646,G
1-PB2,883,0,2,3727,0,3729,G
1-PB2,884,1,3525,0,1,3527,T
1-PB2,885,0,4,3692,0,3696,G
1-PB2,886,1,6,3715,0,3722,G
1-PB2,887,3552,0,1,0,3553,A
1-PB2,888,3,0,0,3564,3567,C
1-PB2,889,3577,0,1,0,3578,A
1-PB2,890,0,4041,0,1,4042,T
1-PB2,891,1,4082,0,0,4083,T
1-PB2,892,7,4,0,3975,3986,C
1-PB2,893,1,4012,0,4,4017,T
1-PB2,894,0,4045,0,0,4045,T
1-PB2,895,3999,0,0,0,3999,A
1-PB2,896,0,4,4027,0,4031,G
1-PB2,897,4031,0,4,0,4035,A
1-PB2,898,0,0,0,4006,4006,C
1-PB2,899,3565,0,0,0,3565,A
1-PB2,900,1,3,3593,0,3597,G
1-PB2,901,3574,0,0,0,3574,A
1-PB2,902,3568,0,1,0,3569,A
1-PB2,903,2,0,0,3426,3428,C
1-PB2,904,2,0,0,3584,3586,C
1-PB2,905,3,1,0,3641,3645,C
1-PB2,906,2,6,3531,0,3539,G
1-PB2,907,3519,0,1,1,3521,A
1-PB2,908,0,1,0,3603,3604,C
1-PB2,909,1,3586,0,2,3589,T
1-PB2,910,0,5,3620,0,3625,G
1-PB2,911,3559,1,4,0,3564,A
1-PB2,912,3662,0,4,0,3666,A
1-PB2,913,0,9,3653,0,3662,G
1-PB2,914,3602,0,0,0,3602,A
1-PB2,915,3648,0,0,0,3648,A
1-PB2,916,0,0,0,3586,3586,C
1-PB2,917,3589,0,0,0,3589,A
1-PB2,918,3658,0,12,0,3670,A
1-PB2,919,0,0,3608,0,3608,G
1-PB2,920,1,0,0,3616,3617,C
1-PB2,921,0,3656,0,1,3657,T
1-PB2,922,3,1,3734,0,3738,G
1-PB2,923,0,3667,0,1,3668,T
1-PB2,924,0,2,3794,0,3796,G
1-PB2,925,0,7,3928,0,3935,G
1-PB2,926,3814,0,3,0,3817,A
1-PB2,927,0,3849,0,9,3858,T
1-PB2,928,3899,0,4,0,3903,A
1-PB2,929,0,3850,0,1,3851,T
1-PB2,930,3972,1,0,0,3973,A
1-PB2,931,0,3898,0,1,3899,T
1-PB2,932,0,1,3887,1,3889,G
1-PB2,933,1,2,0,3805,3808,C
1-PB2,934,3686,0,0,0,3686,A
1-PB2,935,3733,0,3,0,3736,A
1-PB2,936,0,3,3700,0,3703,G
1-PB2,937,0,0,3730,1,3731,G
1-PB2,938,1,0,1,3663,3665,C
1-PB2,939,0,3659,0,3,3662,T
1-PB2,940,1,2,3666,1,3670,G
1-PB2,941,0,0,0,3679,3679,C
1-PB2,942,3698,1,1,0,3700,A
1-PB2,943,3729,0,0,0,3729,A
1-PB2,944,0,3662,0,0,3662,T
1-PB2,945,1,7,3695,0,3703,G
1-PB2,946,1,5,3685,0,3691,G
1-PB2,947,0,1,3708,0,3709,G
1-PB2,948,3578,0,2,0,3580,A
1-PB2,949,0,3587,0,1,3588,T
1-PB2,950,0,3666,0,5,3671,T
1-PB2,951,0,6,3645,1,3652,G
1-PB2,952,3632,2,2,0,3636,A
1-PB2,953,0,8,3702,0,3710,G
1-PB2,954,3696,0,0,0,3696,A
1-PB2,955,3690,0,0,0,3690,A
1-PB2,956,0,3582,0,0,3582,T
1-PB2,957,7,1,1,3641,3650,C
1-PB2,958,3665,0,9,0,3674,A
1-PB2,959,1,1,3660,0,3662,G
1-PB2,960,0,0,0,3628,3628,C
1-PB2,961,2,3574,0,3,3579,T
1-PB2,962,4,2,0,3652,3658,C
1-PB2,963,3647,0,1,0,3648,A
1-PB2,964,0,3677,0,2,3679,T
1-PB2,965,11,6,0,3710,3727,C
1-PB2,966,2,3,0,3743,3748,C
1-PB2,967,0,3727,0,6,3733,T
1-PB2,968,0,3703,1,2,3706,T
1-PB2,969,4,1,1,3712,3718,C
1-PB2,970,3747,0,2,0,3749,A
1-PB2,971,2,1,3777,1,3781,G
1-PB2,972,0,2,0,3700,3702,C
1-PB2,973,1,3635,0,9,3645,T
1-PB2,974,0,3707,0,1,3708,T
1-PB2,975,1,3723,0,0,3724,T
1-PB2,976,1,4,3709,0,3714,G
1-PB2,977,0,1,3716,0,3717,G
1-PB2,978,0,3619,2,1,3622,T
1-PB2,979,0,5,3761,0,3766,G
1-PB2,980,1,2,3725,0,3728,G
1-PB2,981,4,1,3774,0,3779,G
1-PB2,982,0,3663,2,0,3665,T
1-PB2,983,0,3742,0,0,3742,T
1-PB2,984,0,3777,0,0,3777,T
1-PB2,985,3782,0,1,0,3783,A
1-PB2,986,1,1,0,3794,3796,C
1-PB2,987,3799,0,1,0,3800,A
1-PB2,988,0,3784,1,1,3786,T
1-PB2,989,0,3750,0,0,3750,T
1-PB2,990,0,3750,1,5,3756,T
1-PB2,991,3750,1,0,0,3751,A
1-PB2,992,3754,0,2,0,3756,A
1-PB2,993,3760,1,2,0,3763,A
1-PB2,994,3748,0,3,1,3752,A
1-PB2,995,0,9,3760,0,3769,G
1-PB2,996,3751,0,0,0,3751,A
1-PB2,997,3743,1,3,0,3747,A
1-PB2,998,1,0,0,3756,3757,C
1-PB2,999,3745,0,0,0,3745,A
1-PB2,1000,3750,0,3,0,3753,A
1-PB2,1001,0,1,3732,0,3733,G
1-PB2,1002,3,1,1,3747,3752,C
1-PB2,1003,1,2,3742,0,3745,G
1-PB2,1004,3,6,3738,2,3749,G
1-PB2,1005,3,2,3731,0,3736,G
1-PB2,1006,0,3665,0,1,3666,T
1-PB2,1007,13,1,0,3707,3721,C
1-PB2,1008,3773,0,1,0,3774,A
1-PB2,1009,0,3675,1,4,3680,T
1-PB2,1010,7,0,0,3761,3768,C
1-PB2,1011,3766,1,4,0,3771,A
1-PB2,1012,2,0,3795,0,3797,G
1-PB2,1013,0,3707,1,0,3708,T
1-PB2,1014,11,0,0,3724,3735,C
1-PB2,1015,3759,0,1,0,3760,A
1-PB2,1016,3784,0,1,1,3786,A
1-PB2,1017,3780,0,0,0,3780,A
1-PB2,1018,3790,0,1,0,3791,A
1-PB2,1019,3793,1,1,1,3796,A
1-PB2,1020,3785,0,7,0,3792,A
1-PB2,1021,0,1,3813,0,3814,G
1-PB2,1022,3797,0,1,0,3798,A
1-PB2,1023,3783,0,2,0,3785,A
1-PB2,1024,1,5,3790,0,3796,G
1-PB2,1025,3769,0,1,0,3770,A
1-PB2,1026,3689,0,6,0,3695,A
1-PB2,1027,0,3,3693,0,3696,G
1-PB2,1028,3669,1,4,0,3674,A
1-PB2,1029,2,5,3692,0,3699,G
1-PB2,1030,1,4,3761,0,3766,G
1-PB2,1031,1,3704,0,0,3705,T
1-PB2,1032,1,0,3797,0,3798,G
1-PB2,1033,1,0,0,3792,3793,C
1-PB2,1034,0,3795,0,9,3804,T
1-PB2,1035,0,3835,1,2,3838,T
1-PB2,1036,3835,0,0,0,3835,A
1-PB2,1037,1,5,0,3809,3815,C
1-PB2,1038,3817,1,2,0,3820,A
1-PB2,1039,0,2,3795,0,3797,G
1-PB2,1040,1,1,3773,0,3775,G
1-PB2,1041,2,2,0,3703,3707,C
1-PB2,1042,3719,0,0,0,3719,A
1-PB2,1043,3723,0,4,1,3728,A
1-PB2,1044,0,3787,0,1,3788,T
1-PB2,1045,5,1,0,3807,3813,C
1-PB2,1046,0,3780,0,4,3784,T
1-PB2,1047,5,0,1,3813,3819,C
1-PB2,1048,2,1,0,3805,3808,C
1-PB2,1049,3824,0,0,0,3824,A
1-PB2,1050,3827,0,1,2,3830,A
1-PB2,1051,3833,0,0,0,3833,A
1-PB2,1052,1,1,0,3839,3841,C
1-PB2,1053,3743,0,0,0,3743,A
1-PB2,1054,0,3677,3,1,3681,T
1-PB2,1055,0,3688,0,0,3688,T
1-PB2,1056,0,4,3740,0,3744,G
1-PB2,1057,3732,0,1,0,3733,A
1-PB2,1058,3815,0,2,0,3817,A
1-PB2,1059,3826,0,2,0,3828,A
1-PB2,1060,3818,0,0,0,3818,A
1-PB2,1061,0,3821,0,0,3821,T
1-PB2,1062,3846,0,1,0,3847,A
1-PB2,1063,3838,0,5,1,3844,A
1-PB2,1064,4,5,3914,0,3923,G
1-PB2,1065,3871,0,4,0,3875,A
1-PB2,1066,0,0,3986,0,3986,G
1-PB2,1067,1,3912,0,2,3915,T
1-PB2,1068,3969,0,0,0,3969,A
1-PB2,1069,0,3,0,4029,4032,C
1-PB2,1070,4008,0,1,0,4009,A
1-PB2,1071,0,3995,0,0,3995,T
1-PB2,1072,0,6,4017,1,4024,G
1-PB2,1073,3894,0,9,2,3905,A
1-PB2,1074,0,1,3960,0,3961,G
1-PB2,1075,0,4,3908,0,3912,G
1-PB2,1076,0,2,4046,0,4048,G
1-PB2,1077,1,2,4047,0,4050,G
1-PB2,1078,0,3939,0,0,3939,T
1-PB2,1079,4030,0,1,0,4031,A
1-PB2,1080,1,3999,0,0,4000,T
1-PB2,1081,0,3,4029,0,4032,G
1-PB2,1082,4013,0,2,1,4016,A
1-PB2,1083,1,4,4009,0,4014,G
1-PB2,1084,1,7,3961,1,3970,G
1-PB2,1085,3744,0,1,0,3745,A
1-PB2,1086,1,0,3834,0,3835,G
1-PB2,1087,0,3815,1,4,3820,T
1-PB2,1088,1,3919,0,1,3921,T
1-PB2,1089,16,2,1,3922,3941,C
1-PB2,1090,3929,0,5,0,3934,A
1-PB2,1091,1,0,0,3957,3958,C
1-PB2,1092,3949,0,0,0,3949,A
1-PB2,1093,3931,0,2,0,3933,A
1-PB2,1094,1,3931,0,1,3933,T
1-PB2,1095,1,7,3875,0,3883,G
1-PB2,1096,1,1,3882,0,3884,G
1-PB2,1097,0,3754,1,2,3757,T
1-PB2,1098,4,3,3798,0,3805,G
1-PB2,1099,0,3,3791,0,3794,G
1-PB2,1100,0,2,3791,0,3793,G
1-PB2,1101,1,1,3830,0,3832,G
1-PB2,1102,3802,0,15,0,3817,A
1-PB2,1103,3827,1,1,0,3829,A
1-PB2,1104,3831,0,2,1,3834,A
1-PB2,1105,3747,1,7,0,3755,A
1-PB2,1106,1,5,3799,0,3805,G
1-PB2,1107,3761,0,5,1,3767,A
1-PB2,1108,2,0,3760,0,3762,G
1-PB2,1109,2,1,0,3757,3760,C
1-PB2,1110,3754,0,1,0,3755,A
1-PB2,1111,3750,0,1,0,3751,A
1-PB2,1112,0,1,0,3839,3840,C
1-PB2,1113,3848,0,2,0,3850,A
1-PB2,1114,0,0,3927,0,3927,G
1-PB2,1115,1,0,0,3883,3884,C
1-PB2,1116,0,3874,0,2,3876,T
1-PB2,1117,3993,1,3,0,3997,A
1-PB2,1118,0,3968,0,2,3970,T
1-PB2,1119,4000,0,1,0,4001,A
1-PB2,1120,2,2,0,3994,3998,C
1-PB2,1121,0,3811,0,2,3813,T
1-PB2,1122,3844,0,10,1,3855,A
1-PB2,1123,3795,0,0,0,3795,A
1-PB2,1124,1,4,3780,1,3786,G
1-PB2,1125,3777,1,0,0,3778,A
1-PB2,1126,3698,0,1,0,3699,A
1-PB2,1127,3700,0,0,0,3700,A
1-PB2,1128,3664,0,4,0,3668,A
1-PB2,1129,1,1,3677,0,3679,G
1-PB2,1130,0,0,0,3652,3652,C
1-PB2,1131,3682,0,0,0,3682,A
1-PB2,1132,3681,1,1,0,3683,A
1-PB2,1133,2,2,0,3685,3689,C
1-PB2,1134,3,1,0,3689,3693,C
1-PB2,1135,3719,0,1,0,3720,A
1-PB2,1136,0,1,3737,0,3738,G
1-PB2,1137,3718,0,1,0,3719,A
1-PB2,1138,3709,0,0,0,3709,A
1-PB2,1139,0,7,3763,0,3770,G
1-PB2,1140,3726,0,4,0,3730,A
1-PB2,1141,0,3699,0,2,3701,T
1-PB2,1142,0,3669,0,2,3671,T
1-PB2,1143,0,4,3707,0,3711,G
1-PB2,1144,0,1,3765,0,3766,G
1-PB2,1145,0,3691,0,6,3697,T
1-PB2,1146,0,3660,0,0,3660,T
1-PB2,1147,9,0,0,3716,3725,C
1-PB2,1148,3794,0,1,0,3795,A
1-PB2,1149,2,1,3881,0,3884,G
1-PB2,1150,0,0,0,3900,3900,C
1-PB2,1151,0,3907,0,4,3911,T
1-PB2,1152,5,0,1,3941,3947,C
1-PB2,1153,3919,1,3,0,3923,A
1-PB2,1154,1,3937,0,1,3939,T
1-PB2,1155,3945,1,4,0,3950,A
1-PB2,1156,0,0,3970,0,3970,G
1-PB2,1157,0,3803,0,0,3803,T
1-PB2,1158,0,5,3832,0,3837,G
1-PB2,1159,3719,1,0,0,3720,A
1-PB2,1160,2,0,3775,0,3777,G
1-PB2,1161,1,3742,0,1,3744,T
1-PB2,1162,2,2,3748,0,3752,G
1-PB2,1163,0,4,3749,0,3753,G
1-PB2,1164,3756,0,0,0,3756,A
1-PB2,1165,3755,0,0,0,3755,A
1-PB2,1166,6,8,3748,1,3763,G
1-PB2,1167,3724,0,4,0,3728,A
1-PB2,1168,0,6,3739,0,3745,G
1-PB2,1169,3709,1,5,0,3715,A
1-PB2,1170,2,2,0,3711,3715,C
1-PB2,1171,0,12,3731,1,3744,G
1-PB2,1172,3700,0,2,0,3702,A
1-PB2,1173,3709,1,1,0,3711,A
1-PB2,1174,38,0,0,3681,3719,C
1-PB2,1175,3709,0,0,0,3709,A
1-PB2,1176,0,0,3847,0,3847,G
1-PB2,1177,0,3779,1,5,3785,T
1-PB2,1178,5,0,0,3803,3808,C
1-PB2,1179,3846,0,0,0,3846,A
1-PB2,1180,3818,0,3,0,3821,A
1-PB2,1181,2,3811,0,0,3813,T
1-PB2,1182,3851,0,0,0,3851,A
1-PB2,1183,0,0,3810,0,3810,G
1-PB2,1184,0,1,2,3774,3777,C
1-PB2,1185,3,1,0,3674,3678,C
1-PB2,1186,1,5,3672,1,3679,G
1-PB2,1187,3678,0,0,0,3678,A
1-PB2,1188,3665,0,3,0,3668,A
1-PB2,1189,1,1,3710,1,3713,G
1-PB2,1190,3,1,1,3792,3797,C
1-PB2,1191,3810,0,1,0,3811,A
1-PB2,1192,3803,0,5,0,3808,A
1-PB2,1193,0,3805,0,0,3805,T
1-PB2,1194,3843,0,2,0,3845,A
1-PB2,1195,3840,0,1,0,3841,A
1-PB2,1196,0,3839,0,0,3839,T
1-PB2,1197,7,0,0,3819,3826,C
1-PB2,1198,3,0,3816,0,3819,G
1-PB2,1199,0,3724,1,2,3727,T
1-PB2,1200,0,5,3728,0,3733,G
1-PB2,1201,1,2,3752,0,3755,G
1-PB2,1202,0,0,0,3734,3734,C
1-PB2,1203,3,4,0,3771,3778,C
1-PB2,1204,3735,0,2,0,3737,A
1-PB2,1205,0,3748,0,0,3748,T
1-PB2,1206,9,2,3769,0,3780,G
1-PB2,1207,3,2,3829,0,3834,G
1-PB2,1208,4,3677,0,3,3684,T
1-PB2,1209,1,0,3824,0,3825,G
1-PB2,1210,0,3637,1,2,3640,T
1-PB2,1211,1,3689,0,1,3691,T
1-PB2,1212,0,3709,1,0,3710,T
1-PB2,1213,0,3682,0,1,3683,T
1-PB2,1214,10,0,0,3747,3757,C
1-PB2,1215,3757,1,5,2,3765,A
1-PB2,1216,2,1,0,3927,3930,C
1-PB2,1217,3916,0,2,1,3919,A
1-PB2,1218,3920,1,0,0,3921,A
1-PB2,1219,0,2,3953,0,3955,G
1-PB2,1220,3882,1,1,0,3884,A
1-PB2,1221,191,9,3750,0,3950,G
1-PB2,1222,0,8,3984,0,3992,G
1-PB2,1223,3969,0,2,0,3971,A
1-PB2,1224,1,3972,0,0,3973,T
1-PB2,1225,0,3931,0,0,3931,T
1-PB2,1226,1,1,3953,0,3955,G
1-PB2,1227,1,1,0,3890,3892,C
1-PB2,1228,3920,0,2,0,3922,A
1-PB2,1229,0,3963,0,0,3963,T
1-PB2,1230,0,6,4061,0,4067,G
1-PB2,1231,4070,0,2,0,4072,A
1-PB2,1232,0,4090,0,1,4091,T
1-PB2,1233,4093,1,0,0,4094,A
1-PB2,1234,4079,1,0,0,4080,A
1-PB2,1235,4081,0,1,0,4082,A
1-PB2,1236,4084,0,1,0,4085,A
1-PB2,1237,0,1,4065,0,4066,G
1-PB2,1238,2,1,0,4128,4131,C
1-PB2,1239,4173,0,1,0,4174,A
1-PB2,1240,0,0,4264,0,4264,G
1-PB2,1241,0,4259,0,1,4260,T
1-PB2,1242,0,4258,7,2,4267,T
1-PB2,1243,4272,0,0,0,4272,A
1-PB2,1244,1,3,4264,0,4268,G
1-PB2,1245,4218,1,4,0,4223,A
1-PB2,1246,0,7,4236,0,4243,G
1-PB2,1247,2,0,4211,0,4213,G
1-PB2,1248,0,4022,0,2,4024,T
1-PB2,1249,1,7,4111,0,4119,G
1-PB2,1250,4101,1,11,0,4113,A
1-PB2,1251,2,1,0,4124,4127,C
1-PB2,1252,3,3,0,4162,4168,C
1-PB2,1253,1,4108,1,7,4117,T
1-PB2,1254,0,7,4142,0,4149,G
1-PB2,1255,4123,0,1,0,4124,A
1-PB2,1256,4123,0,1,0,4124,A
1-PB2,1257,0,4135,0,1,4136,T
1-PB2,1258,0,4159,0,2,4161,T
1-PB2,1259,0,4149,0,3,4152,T
1-PB2,1260,9,2,0,4143,4154,C
1-PB2,1261,4,2,4152,0,4158,G
1-PB2,1262,1,4119,0,4,4124,T
1-PB2,1263,4,0,0,4135,4139,C
1-PB2,1264,4156,0,1,1,4158,A
1-PB2,1265,4147,2,1,0,4150,A
1-PB2,1266,0,1,0,4152,4153,C
1-PB2,1267,4123,0,0,0,4123,A
1-PB2,1268,0,2,4166,0,4168,G
1-PB2,1269,4118,0,4,0,4122,A
1-PB2,1270,0,1,4145,0,4146,G
1-PB2,1271,3,0,0,4149,4152,C
1-PB2,1272,4165,0,1,0,4166,A
1-PB2,1273,4265,0,1,0,4266,A
1-PB2,1274,4262,1,1,1,4265,A
1-PB2,1275,0,4228,0,1,4229,T
1-PB2,1276,5,2,0,4261,4268,C
1-PB2,1277,4257,0,0,0,4257,A
1-PB2,1278,0,5,4227,0,4232,G
1-PB2,1279,4156,0,3,0,4159,A
1-PB2,1280,0,3,4249,0,4252,G
1-PB2,1281,1,1,4351,0,4353,G
1-PB2,1282,0,4314,0,2,4316,T
1-PB2,1283,0,4347,0,1,4348,T
1-PB2,1284,0,7,4333,0,4340,G
1-PB2,1285,4350,0,2,0,4352,A
1-PB2,1286,4346,1,8,0,4355,A
1-PB2,1287,2,1,0,4350,4353,C
1-PB2,1288,4,0,0,4308,4312,C
1-PB2,1289,0,1,0,4343,4344,C
1-PB2,1290,3,1,1,4311,4316,C
1-PB2,1291,4327,0,1,0,4328,A
1-PB2,1292,1,4326,1,1,4329,T
1-PB2,1293,0,1,4336,1,4338,G
1-PB2,1294,1,4,0,4355,4360,C
1-PB2,1295,4342,0,0,0,4342,A
1-PB2,1296,0,4290,0,2,4292,T
1-PB2,1297,5,0,0,4306,4311,C
1-PB2,1298,4303,0,1,0,4304,A
1-PB2,1299,0,0,4334,0,4334,G
1-PB2,1300,0,2,0,4321,4323,C
1-PB2,1301,0,4328,1,9,4338,T
1-PB2,1302,0,4345,0,0,4345,T
1-PB2,1303,0,4341,1,1,4343,T
1-PB2,1304,0,4335,1,0,4336,T
1-PB2,1305,4360,0,1,0,4361,A
1-PB2,1306,4348,0,7,0,4355,A
1-PB2,1307,0,6,4347,0,4353,G
1-PB2,1308,1,0,4297,0,4298,G
1-PB2,1309,1,0,0,4269,4270,C
1-PB2,1310,4290,0,0,0,4290,A
1-PB2,1311,2,4293,1,0,4296,T
1-PB2,1312,0,4289,1,1,4291,T
1-PB2,1313,1,4306,0,0,4307,T
1-PB2,1314,0,4313,1,0,4314,T
1-PB2,1315,3,2,0,4341,4346,C
1-PB2,1316,4341,1,2,0,4344,A
1-PB2,1317,1,4,4339,0,4344,G
1-PB2,1318,4317,0,3,0,4320,A
1-PB2,1319,4329,0,2,2,4333,A
1-PB2,1320,4311,0,3,0,4314,A
1-PB2,1321,0,1,4315,0,4316,G
1-PB2,1322,4339,0,0,0,4339,A
1-PB2,1323,0,4327,0,0,4327,T
1-PB2,1324,1,2,4336,1,4340,G
1-PB2,1325,3,0,0,4318,4321,C
1-PB2,1326,0,4,4355,0,4359,G
1-PB2,1327,4308,0,5,0,4313,A
1-PB2,1328,4336,0,1,0,4337,A
1-PB2,1329,4346,0,0,0,4346,A
1-PB2,1330,0,0,4355,0,4355,G
1-PB2,1331,0,4276,0,2,4278,T
1-PB2,1332,0,1,4292,0,4293,G
1-PB2,1333,1,4,0,4214,4219,C
1-PB2,1334,0,4272,0,3,4275,T
1-PB2,1335,0,4295,0,0,4295,T
1-PB2,1336,0,4284,0,0,4284,T
1-PB2,1337,1,4292,1,0,4294,T
1-PB2,1338,0,4247,0,2,4249,T
1-PB2,1339,12,1,0,4289,4302,C
1-PB2,1340,4314,0,2,0,4316,A
1-PB2,1341,4310,1,0,0,4311,A
1-PB2,1342,4302,0,1,1,4304,A
1-PB2,1343,4320,0,0,0,4320,A
1-PB2,1344,0,4309,0,0,4309,T
1-PB2,1345,0,4335,0,0,4335,T
1-PB2,1346,1,4,4312,1,4318,G
1-PB2,1347,0,4,4310,0,4314,G
1-PB2,1348,7,3,4300,0,4310,G
1-PB2,1349,1,6,4337,0,4344,G
1-PB2,1350,4338,0,1,1,4340,A
1-PB2,1351,1,1,4399,0,4401,G
1-PB2,1352,0,4398,0,1,4399,T
1-PB2,1353,1,4379,1,1,4382,T
1-PB2,1354,4,9,4400,0,4413,G
1-PB2,1355,4405,0,4,0,4409,A
1-PB2,1356,4414,0,8,0,4422,A
1-PB2,1357,0,9,0,4517,4526,C
1-PB2,1358,4500,2,2,0,4504,A
1-PB2,1359,1,0,0,4580,4581,C
1-PB2,1360,4522,0,1,0,4523,A
1-PB2,1361,0,4499,0,0,4499,T
1-PB2,1362,0,4487,0,3,4490,T
1-PB2,1363,0,8,4517,0,4525,G
1-PB2,1364,4526,0,1,0,4527,A
1-PB2,1365,1,0,0,4509,4510,C
1-PB2,1366,4371,0,3,0,4374,A
1-PB2,1367,1,0,4478,0,4479,G
1-PB2,1368,1,4316,0,2,4319,T
1-PB2,1369,7,1,4389,0,4397,G
1-PB2,1370,1,4348,0,5,4354,T
1-PB2,1371,0,8,4392,1,4401,G
1-PB2,1372,4368,0,5,0,4373,A
1-PB2,1373,0,4370,0,1,4371,T
1-PB2,1374,1,6,4384,1,4392,G
1-PB2,1375,2,2,4367,0,4371,G
1-PB2,1376,1,3,4344,0,4348,G
1-PB2,1377,4328,0,0,0,4328,A
1-PB2,1378,4285,0,3,0,4288,A
1-PB2,1379,0,4266,0,10,4276,T
1-PB2,1380,0,7,4295,0,4302,G
1-PB2,1381,4304,0,0,0,4304,A
1-PB2,1382,0,4270,0,0,4270,T
1-PB2,1383,0,4255,0,0,4255,T
1-PB2,1384,0,3,4255,0,4258,G
1-PB2,1385,0,10,4329,0,4339,G
1-PB2,1386,4242,1,3,0,4246,A
1-PB2,1387,0,1,4293,0,4294,G
1-PB2,1388,2,4230,0,0,4232,T
1-PB2,1389,4251,0,0,0,4251,A
1-PB2,1390,0,4227,0,1,4228,T
1-PB2,1391,0,4264,0,0,4264,T
1-PB2,1392,4280,0,2,0,4282,A
1-PB2,1393,3,0,0,4261,4264,C
1-PB2,1394,5,3,0,4211,4219,C
1-PB2,1395,4188,0,2,0,4190,A
1-PB2,1396,0,3,4207,0,4210,G
1-PB2,1397,4237,0,0,0,4237,A
1-PB2,1398,0,4215,1,2,4218,T
1-PB2,1399,4201,0,1,0,4202,A
1-PB2,1400,2,4147,0,1,4150,T
1-PB2,1401,0,10,4122,0,4132,G
1-PB2,1402,4119,0,3,0,4122,A
1-PB2,1403,2,0,0,4068,4070,C
1-PB2,1404,1,4024,0,7,4032,T
1-PB2,1405,8,0,0,4007,4015,C
1-PB2,1406,1,0,0,4015,4016,C
1-PB2,1407,4051,0,1,0,4052,A
1-PB2,1408,4086,0,0,0,4086,A
1-PB2,1409,1,1,4133,0,4135,G
1-PB2,1410,3,3,0,4097,4103,C
1-PB2,1411,4101,1,1,0,4103,A
1-PB2,1412,0,1,1,4085,4087,C
1-PB2,1413,4084,0,2,0,4086,A
1-PB2,1414,0,4,4095,0,4099,G
1-PB2,1415,4064,0,0,0,4064,A
1-PB2,1416,0,1,4079,0,4080,G
1-PB2,1417,4087,0,0,0,4087,A
1-PB2,1418,0,3997,0,2,3999,T
1-PB2,1419,2,0,4042,0,4044,G
1-PB2,1420,0,4000,0,1,4001,T
1-PB2,1421,8,1,1,3988,3998,C
1-PB2,1422,4004,0,4,0,4008,A
1-PB2,1423,4009,1,1,0,4011,A
1-PB2,1424,0,3986,0,5,3991,T
1-PB2,1425,0,3,3998,0,4001,G
1-PB2,1426,3957,0,1,0,3958,A
1-PB2,1427,0,3,3956,0,3959,G
1-PB2,1428,3906,0,1,0,3907,A
1-PB2,1429,2,3,3914,0,3919,G
1-PB2,1430,0,10,4009,0,4019,G
1-PB2,1431,4011,0,1,0,4012,A
1-PB2,1432,4008,0,0,0,4008,A
1-PB2,1433,0,4006,0,0,4006,T
1-PB2,1434,4000,0,3,0,4003,A
1-PB2,1435,3999,0,2,0,4001,A
1-PB2,1436,0,10,4007,0,4017,G
1-PB2,1437,3979,0,6,0,3985,A
1-PB2,1438,0,1,3992,0,3993,G
1-PB2,1439,0,3793,0,1,3794,T
1-PB2,1440,5,0,1,3790,3796,C
1-PB2,1441,3828,0,4,0,3832,A
1-PB2,1442,1,0,3844,0,3845,G
1-PB2,1443,1,3,0,3828,3832,C
1-PB2,1444,3844,0,0,0,3844,A
1-PB2,1445,3842,0,1,0,3843,A
1-PB2,1446,3847,0,1,0,3848,A
1-PB2,1447,3843,0,0,0,3843,A
1-PB2,1448,0,3833,0,1,3834,T
1-PB2,1449,0,3,3841,0,3844,G
1-PB2,1450,3,2,3821,0,3826,G
1-PB2,1451,1,2,3834,1,3838,G
1-PB2,1452,0,3773,0,4,3777,T
1-PB2,1453,0,1,3808,0,3809,G
1-PB2,1454,2,3763,0,0,3765,T
1-PB2,1455,0,6,3770,1,3777,G
1-PB2,1456,0,4,3833,0,3837,G
1-PB2,1457,3820,0,1,0,3821,A
1-PB2,1458,0,3794,0,1,3795,T
1-PB2,1459,2,5,3811,1,3819,G
1-PB2,1460,3807,0,1,0,3808,A
1-PB2,1461,3819,0,0,0,3819,A
1-PB2,1462,1,3786,0,15,3802,T
1-PB2,1463,3750,0,0,0,3750,A
1-PB2,1464,2,0,0,3900,3902,C
1-PB2,1465,0,3805,0,6,3811,T
1-PB2,1466,3,1,0,3854,3858,C
1-PB2,1467,4,3,0,3881,3888,C
1-PB2,1468,3882,4,2,0,3888,A
1-PB2,1469,0,1,4001,0,4002,G
1-PB2,1470,0,3968,0,1,3969,T
1-PB2,1471,3984,0,2,0,3986,A
1-PB2,1472,0,1,0,3978,3979,C
1-PB2,1473,3712,0,1,0,3713,A
1-PB2,1474,0,5,3725,0,3730,G
1-PB2,1475,3600,0,9,0,3609,A
1-PB2,1476,0,1,3657,0,3658,G
1-PB2,1477,3534,0,9,1,3544,A
1-PB2,1478,0,2,3430,0,3432,G
1-PB2,1479,0,1,3413,0,3414,G
1-PB2,1480,0,1,3418,1,3420,G
1-PB2,1481,0,3328,0,1,3329,T
1-PB2,1482,0,5,3361,1,3367,G
1-PB2,1483,2,1,3377,0,3380,G
1-PB2,1484,0,3331,0,0,3331,T
1-PB2,1485,0,3,3398,0,3401,G
1-PB2,1486,0,0,3382,0,3382,G
1-PB2,1487,0,3324,3,3,3330,T
1-PB2,1488,0,3333,1,2,3336,T
1-PB2,1489,3294,0,2,0,3296,A
1-PB2,1490,0,1,3286,0,3287,G
1-PB2,1491,0,1,1,3280,3282,C
1-PB2,1492,3285,0,0,0,3285,A
1-PB2,1493,0,3268,0,1,3269,T
1-PB2,1494,0,3128,0,0,3128,T
1-PB2,1495,0,6,3121,0,3127,G
1-PB2,1496,3108,0,0,0,3108,A
1-PB2,1497,0,3096,0,0,3096,T
1-PB2,1498,7,1,0,3110,3118,C
1-PB2,1499,1,2,3099,0,3102,G
1-PB2,1500,3,1,3133,0,3137,G
1-PB2,1501,0,3110,0,1,3111,T
1-PB2,1502,0,3117,1,0,3118,T
1-PB2,1503,0,3100,1,0,3101,T
1-PB2,1504,1,3107,0,1,3109,T
1-PB2,1505,0,3125,0,0,3125,T
1-PB2,1506,0,4,3142,0,3146,G
1-PB2,1507,3120,0,4,0,3124,A
1-PB2,1508,0,1,3137,0,3138,G
1-PB2,1509,3023,0,0,0,3023,A
1-PB2,1510,1,0,3035,0,3036,G
1-PB2,1511,0,3022,0,4,3026,T
1-PB2,1512,0,3006,1,0,3007,T
1-PB2,1513,1,2,0,3026,3029,C
1-PB2,1514,0,2,3049,0,3051,G
1-PB2,1515,3051,1,1,0,3053,A
1-PB2,1516,0,6,3041,0,3047,G
1-PB2,1517,3021,0,2,0,3023,A
1-PB2,1518,0,2,0,3018,3020,C
1-PB2,1519,3,0,0,3015,3018,C
1-PB2,1520,3004,0,3,0,3007,A
1-PB2,1521,3007,0,2,0,3009,A
1-PB2,1522,0,2,0,3016,3018,C
1-PB2,1523,0,3,3019,0,3022,G
1-PB2,1524,0,2989,0,0,2989,T
1-PB2,1525,2,1,3004,0,3007,G
1-PB2,1526,1,3,2989,0,2993,G
1-PB2,1527,3,3,2999,1,3006,G
1-PB2,1528,2963,0,3,0,2966,A
1-PB2,1529,2983,1,0,0,2984,A
1-PB2,1530,0,2907,0,0,2907,T
1-PB2,1531,2,2,2958,0,2962,G
1-PB2,1532,0,2938,0,3,2941,T
1-PB2,1533,2947,0,0,0,2947,A
1-PB2,1534,0,2935,1,0,2936,T
1-PB2,1535,0,2906,1,0,2907,T
1-PB2,1536,2956,0,0,0,2956,A
1-PB2,1537,0,2917,0,1,2918,T
1-PB2,1538,0,2885,0,1,2886,T
1-PB2,1539,2884,0,0,0,2884,A
1-PB2,1540,0,2531,1,3,2535,T
1-PB2,1541,2,0,0,2594,2596,C
1-PB2,1542,0,2529,0,3,2532,T
1-PB2,1543,6,1,0,2552,2559,C
1-PB2,1544,3,0,0,2560,2563,C
1-PB2,1545,0,2494,0,2,2496,T
1-PB2,1546,3,1,2503,0,2507,G
1-PB2,1547,2489,0,0,0,2489,A
1-PB2,1548,0,2,2488,0,2490,G
1-PB2,1549,0,1,2472,0,2473,G
1-PB2,1550,2257,1,1,0,2259,A
1-PB2,1551,0,2,2265,0,2267,G
1-PB2,1552,0,0,2260,0,2260,G
1-PB2,1553,0,2078,1,0,2079,T
1-PB2,1554,3,0,0,2099,2102,C
1-PB2,1555,2076,0,1,0,2077,A
1-PB2,1556,0,0,2097,0,2097,G
1-PB2,1557,0,2084,0,1,2085,T
1-PB2,1558,0,4,2096,0,2100,G
1-PB2,1559,2082,1,1,1,2085,A
1-PB2,1560,2006,0,0,0,2006,A
1-PB2,1561,2010,0,2,1,2013,A
1-PB2,1562,1,2,0,2008,2011,C
1-PB2,1563,1969,1,0,0,1970,A
1-PB2,1564,0,0,0,1981,1981,C
1-PB2,1565,1879,0,1,0,1880,A
1-PB2,1566,0,0,1876,0,1876,G
1-PB2,1567,0,0,1866,0,1866,G
1-PB2,1568,0,3,1870,0,1873,G
1-PB2,1569,1855,2,1,0,1858,A
1-PB2,1570,1848,0,0,0,1848,A
1-PB2,1571,0,0,0,1849,1849,C
1-PB2,1572,0,1820,0,1,1821,T
1-PB2,1573,1,2,1830,0,1833,G
1-PB2,1574,1813,0,0,0,1813,A
1-PB2,1575,0,1,1819,0,1820,G
1-PB2,1576,1776,0,1,0,1777,A
1-PB2,1577,0,5,1689,0,1694,G
1-PB2,1578,1678,0,0,0,1678,A
1-PB2,1579,2,0,1,1677,1680,C
1-PB2,1580,0,1612,0,1,1613,T
1-PB2,1581,0,4,1627,0,1631,G
1-PB2,1582,1620,0,0,0,1620,A
1-PB2,1583,0,0,0,1619,1619,C
1-PB2,1584,1613,0,0,0,1613,A
1-PB2,1585,1609,0,0,0,1609,A
1-PB2,1586,0,1603,0,0,1603,T
1-PB2,1587,1608,0,1,0,1609,A
1-PB2,1588,1599,0,0,0,1599,A
1-PB2,1589,1,1,0,1614,1616,C
1-PB2,1590,0,1496,0,1,1497,T
1-PB2,1591,0,1488,0,0,1488,T
1-PB2,1592,1464,0,0,0,1464,A
1-PB2,1593,1,1458,0,0,1459,T
1-PB2,1594,0,1456,1,0,1457,T
1-PB2,1595,2,0,0,1455,1457,C
1-PB2,1596,1341,0,0,0,1341,A
1-PB2,1597,0,1337,0,0,1337,T
1-PB2,1598,0,0,0,1291,1291,C
1-PB2,1599,1,0,1282,0,1283,G
1-PB2,1600,0,1290,0,1,1291,T
1-PB2,1601,2,0,0,1278,1280,C
1-PB2,1602,2,1,1276,0,1279,G
1-PB2,1603,1270,0,0,0,1270,A
1-PB2,1604,0,1274,0,0,1274,T
1-PB2,1605,1,1,1274,0,1276,G
1-PB2,1606,1273,0,2,0,1275,A
1-PB2,1607,0,1272,0,0,1272,T
1-PB2,1608,1,0,1270,0,1271,G
1-PB2,1609,0,1229,4,0,1233,T
1-PB2,1610,2,1,1224,0,1227,G
1-PB2,1611,0,1,1225,0,1226,G
1-PB2,1612,0,2,1226,0,1228,G
1-PB2,1613,1181,0,0,0,1181,A
1-PB2,1614,0,0,1190,0,1190,G
1-PB2,1615,1106,0,0,0,1106,A
1-PB2,1616,1,1081,0,0,1082,T
1-PB2,1617,0,1049,0,0,1049,T
1-PB2,1618,1044,0,1,0,1045,A
1-PB2,1619,1037,0,0,0,1037,A
1-PB2,1620,0,0,0,1020,1020,C
1-PB2,1621,0,0,951,0,951,G
1-PB2,1622,0,0,924,0,924,G
1-PB2,1623,0,788,0,0,788,T
1-PB2,1624,1,0,0,772,773,C
1-PB2,1625,0,0,0,771,771,C
1-PB2,1626,0,726,0,0,726,T
1-PB2,1627,0,1,731,0,732,G
1-PB2,1628,726,0,0,0,726,A
1-PB2,1629,0,0,730,0,730,G
1-PB2,1630,0,720,0,0,720,T
1-PB2,1631,2,0,0,716,718,C
1-PB2,1632,0,2,713,0,715,G
1-PB2,1633,1,0,721,0,722,G
1-PB2,1634,0,712,0,1,713,T
1-PB2,1635,0,719,0,0,719,T
1-PB2,1636,0,722,0,0,722,T
1-PB2,1637,0,720,0,0,720,T
1-PB2,1638,1,0,725,0,726,G
1-PB2,1639,0,0,728,0,728,G
1-PB2,1640,0,719,0,0,719,T
1-PB2,1641,0,0,0,725,725,C
1-PB2,1642,717,0,0,0,717,A
1-PB2,1643,741,0,0,0,741,A
1-PB2,1644,0,751,0,0,751,T
1-PB2,1645,740,0,0,0,740,A
1-PB2,1646,0,0,0,753,753,C
1-PB2,1647,1,0,0,745,746,C
1-PB2,1648,0,749,0,0,749,T
1-PB2,1649,746,0,0,0,746,A
1-PB2,1650,0,743,0,0,743,T
1-PB2,1651,1,0,1,749,751,C
1-PB2,1652,728,0,1,0,729,A
1-PB2,1653,733,0,0,0,733,A
1-PB2,1654,0,727,0,0,727,T
1-PB2,1655,1,3,697,0,701,G
1-PB2,1656,0,2,704,0,706,G
1-PB2,1657,702,0,1,0,703,A
1-PB2,1658,1,680,0,0,681,T
1-PB2,1659,0,0,0,673,673,C
1-PB2,1660,682,0,0,0,682,A
1-PB2,1661,0,677,0,0,677,T
1-PB2,1662,1,0,0,684,685,C
1-PB2,1663,686,0,0,0,686,A
1-PB2,1664,0,1,685,0,686,G
1-PB2,1665,690,0,0,0,690,A
1-PB2,1666,691,0,0,0,691,A
1-PB2,1667,693,0,0,0,693,A
1-PB2,1668,0,688,0,0,688,T
1-PB2,1669,0,685,0,2,687,T
1-PB2,1670,0,1,680,1,682,G
1-PB2,1671,0,0,677,0,677,G
1-PB2,1672,0,0,671,0,671,G
1-PB2,1673,675,0,0,0,675,A
1-PB2,1674,678,0,0,0,678,A
1-PB2,1675,0,0,662,0,662,G
1-PB2,1676,0,0,0,673,673,C
1-PB2,1677,0,670,0,0,670,T
1-PB2,1678,0,0,678,0,678,G
1-PB2,1679,0,676,0,0,676,T
1-PB2,1680,1,0,0,681,682,C
1-PB2,1681,687,0,0,0,687,A
1-PB2,1682,684,0,0,0,684,A
1-PB2,1683,686,0,0,0,686,A
1-PB2,1684,692,0,0,0,692,A
1-PB2,1685,0,693,0,0,693,T
1-PB2,1686,0,693,0,0,693,T
1-PB2,1687,4,0,0,681,685,C
1-PB2,1688,695,0,0,0,695,A
1-PB2,1689,691,0,0,0,691,A
1-PB2,1690,0,687,0,0,687,T
1-PB2,1691,1,1,678,0,680,G
1-PB2,1692,0,1,689,0,690,G
1-PB2,1693,0,691,0,0,691,T
1-PB2,1694,2,0,0,695,697,C
1-PB2,1695,0,691,0,0,691,T
1-PB2,1696,0,0,0,699,699,C
1-PB2,1697,699,0,0,0,699,A
1-PB2,1698,0,0,698,0,698,G
1-PB2,1699,696,0,0,0,696,A
1-PB2,1700,700,0,0,0,700,A
1-PB2,1701,0,681,0,0,681,T
1-PB2,1702,2,0,0,666,668,C
1-PB2,1703,0,0,0,687,687,C
1-PB2,1704,0,677,0,0,677,T
1-PB2,1705,0,1,675,0,676,G
1-PB2,1706,0,0,0,676,676,C
1-PB2,1707,678,0,0,0,678,A
1-PB2,1708,687,0,0,0,687,A
1-PB2,1709,0,678,0,0,678,T
1-PB2,1710,0,0,688,0,688,G
1-PB2,1711,0,693,0,0,693,T
1-PB2,1712,0,671,0,0,671,T
1-PB2,1713,0,0,674,0,674,G
1-PB2,1714,0,669,0,0,669,T
1-PB2,1715,678,0,0,0,678,A
1-PB2,1716,0,0,0,675,675,C
1-PB2,1717,667,0,0,0,667,A
1-PB2,1718,672,1,2,0,675,A
1-PB2,1719,0,0,0,667,667,C
1-PB2,1720,660,0,0,0,660,A
1-PB2,1721,661,0,0,0,661,A
1-PB2,1722,653,0,0,0,653,A
1-PB2,1723,656,0,0,0,656,A
1-PB2,1724,0,650,0,0,650,T
1-PB2,1725,0,0,648,0,648,G
1-PB2,1726,0,0,657,0,657,G
1-PB2,1727,654,0,0,0,654,A
1-PB2,1728,657,0,0,0,657,A
1-PB2,1729,0,655,0,0,655,T
1-PB2,1730,0,659,0,0,659,T
1-PB2,1731,0,659,0,0,659,T
1-PB2,1732,0,1,647,0,648,G
1-PB2,1733,658,0,1,0,659,A
1-PB2,1734,649,0,0,0,649,A
1-PB2,1735,0,0,0,652,652,C
1-PB2,1736,0,0,0,645,645,C
1-PB2,1737,650,0,0,0,650,A
1-PB2,1738,0,660,0,0,660,T
1-PB2,1739,0,656,0,0,656,T
1-PB2,1740,0,655,0,0,655,T
1-PB2,1741,1,0,0,657,658,C
1-PB2,1742,656,0,2,0,658,A
1-PB2,1743,656,0,0,0,656,A
1-PB2,1744,0,659,0,0,659,T
1-PB2,1745,0,1,0,670,671,C
1-PB2,1746,0,659,0,0,659,T
1-PB2,1747,0,663,0,3,666,T
1-PB2,1748,0,668,0,0,668,T
1-PB2,1749,609,0,63,0,672,A
1-PB2,1750,0,0,662,0,662,G
1-PB2,1751,0,661,0,2,663,T
1-PB2,1752,2,0,0,673,675,C
1-PB2,1753,0,0,0,674,674,C
1-PB2,1754,0,0,0,659,659,C
1-PB2,1755,0,0,0,659,659,C
1-PB2,1756,666,0,0,0,666,A
1-PB2,1757,662,0,1,0,663,A
1-PB2,1758,0,0,669,0,669,G
1-PB2,1759,1,0,661,0,662,G
1-PB2,1760,1,0,1,661,663,C
1-PB2,1761,0,0,0,665,665,C
1-PB2,1762,669,0,1,0,670,A
1-PB2,1763,0,678,0,0,678,T
1-PB2,1764,0,678,0,0,678,T
1-PB2,1765,681,0,0,0,681,A
1-PB2,1766,0,0,680,0,680,G
1-PB2,1767,674,0,0,0,674,A
1-PB2,1768,700,0,0,0,700,A
1-PB2,1769,0,0,698,0,698,G
1-PB2,1770,0,0,0,704,704,C
1-PB2,1771,0,0,0,707,707,C
1-PB2,1772,697,0,0,0,697,A
1-PB2,1773,702,0,1,0,703,A
1-PB2,1774,0,707,0,0,707,T
1-PB2,1775,701,0,0,0,701,A
1-PB2,1776,0,0,0,712,712,C
1-PB2,1777,660,0,0,1,661,A
1-PB2,1778,0,0,662,0,662,G
1-PB2,1779,0,635,0,0,635,T
1-PB2,1780,0,0,641,0,641,G
1-PB2,1781,0,0,639,0,639,G
1-PB2,1782,0,0,643,0,643,G
1-PB2,1783,0,627,0,0,627,T
1-PB2,1784,0,634,0,0,634,T
1-PB2,1785,0,640,0,0,640,T
1-PB2,1786,1,0,645,0,646,G
1-PB2,1787,0,639,0,0,639,T
1-PB2,1788,1,0,0,643,644,C
1-PB2,1789,635,0,0,0,635,A
1-PB2,1790,0,1,622,1,624,G
1-PB2,1791,622,0,0,0,622,A
1-PB2,1792,624,0,0,0,624,A
1-PB2,1793,0,0,0,623,623,C
1-PB2,1794,0,607,0,0,607,T
1-PB2,1795,2,0,0,615,617,C
1-PB2,1796,0,627,0,0,627,T
1-PB2,1797,625,0,0,0,625,A
1-PB2,1798,0,627,0,0,627,T
1-PB2,1799,0,621,0,0,621,T
1-PB2,1800,1,1,0,609,611,C
1-PB2,1801,0,0,0,619,619,C
1-PB2,1802,616,0,1,0,617,A
1-PB2,1803,622,0,0,0,622,A
1-PB2,1804,0,0,0,615,615,C
1-PB2,1805,611,0,0,0,611,A
1-PB2,1806,609,0,0,0,609,A
1-PB2,1807,607,0,0,0,607,A
1-PB2,1808,0,609,0,0,609,T
1-PB2,1809,0,0,615,0,615,G
1-PB2,1810,602,0,0,0,602,A
1-PB2,1811,0,1,602,0,603,G
1-PB2,1812,601,0,0,0,601,A
1-PB2,1813,0,0,595,0,595,G
1-PB2,1814,606,0,1,0,607,A
1-PB2,1815,0,0,0,607,607,C
1-PB2,1816,0,0,607,0,607,G
1-PB2,1817,0,599,0,0,599,T
1-PB2,1818,604,0,0,0,604,A
1-PB2,1819,0,0,0,612,612,C
1-PB2,1820,0,607,0,0,607,T
1-PB2,1821,0,608,0,0,608,T
1-PB2,1822,0,1,608,0,609,G
1-PB2,1823,0,2,602,0,604,G
1-PB2,1824,0,4,603,0,607,G
1-PB2,1825,596,0,0,0,596,A
1-PB2,1826,0,0,0,608,608,C
1-PB2,1827,602,0,0,0,602,A
1-PB2,1828,0,613,0,0,613,T
1-PB2,1829,0,609,0,0,609,T
1-PB2,1830,0,610,0,0,610,T
1-PB2,1831,0,3,595,0,598,G
1-PB2,1832,602,0,0,0,602,A
1-PB2,1833,0,0,0,599,599,C
1-PB2,1834,602,0,1,0,603,A
1-PB2,1835,0,0,0,600,600,C
1-PB2,1836,2,0,0,575,577,C
1-PB2,1837,596,0,0,0,596,A
1-PB2,1838,0,0,0,588,588,C
1-PB2,1839,0,0,0,601,601,C
1-PB2,1840,0,0,0,602,602,C
1-PB2,1841,602,0,0,0,602,A
1-PB2,1842,0,1,615,0,616,G
1-PB2,1843,613,0,0,0,613,A
1-PB2,1844,0,638,0,0,638,T
1-PB2,1845,632,0,0,0,632,A
1-PB2,1846,630,0,0,0,630,A
1-PB2,1847,0,625,0,0,625,T
1-PB2,1848,623,0,1,0,624,A
1-PB2,1849,625,0,0,0,625,A
1-PB2,1850,622,0,0,0,622,A
1-PB2,1851,0,1,623,0,624,G
1-PB2,1852,0,0,0,618,618,C
1-PB2,1853,0,595,0,0,595,T
1-PB2,1854,0,587,0,0,587,T
1-PB2,1855,0,0,0,594,594,C
1-PB2,1856,0,589,0,1,590,T
1-PB2,1857,1,0,0,592,593,C
1-PB2,1858,3,0,0,599,602,C
1-PB2,1859,0,0,0,607,607,C
1-PB2,1860,0,608,0,0,608,T
1-PB2,1861,2,606,0,0,608,T
1-PB2,1862,0,607,0,0,607,T
1-PB2,1863,0,606,0,1,607,T
1-PB2,1864,0,0,611,0,611,G
1-PB2,1865,0,1,0,609,610,C
1-PB2,1866,601,0,2,0,603,A
1-PB2,1867,0,0,600,0,600,G
1-PB2,1868,0,0,0,596,596,C
1-PB2,1869,0,597,0,0,597,T
1-PB2,1870,0,0,595,0,595,G
1-PB2,1871,0,0,0,590,590,C
1-PB2,1872,0,588,0,0,588,T
1-PB2,1873,0,0,0,581,581,C
1-PB2,1874,2,1,0,594,597,C
1-PB2,1875,602,0,0,0,602,A
1-PB2,1876,0,0,0,609,609,C
1-PB2,1877,0,0,1,611,612,C
1-PB2,1878,609,0,0,0,609,A
1-PB2,1879,609,0,0,0,609,A
1-PB2,1880,607,0,0,0,607,A
1-PB2,1881,0,0,612,0,612,G
1-PB2,1882,0,0,0,603,603,C
1-PB2,1883,601,0,0,0,601,A
1-PB2,1884,604,0,1,0,605,A
1-PB2,1885,599,0,0,0,599,A
1-PB2,1886,3,0,601,0,604,G
1-PB2,1887,0,0,0,600,600,C
1-PB2,1888,601,0,0,0,601,A
1-PB2,1889,0,0,612,0,612,G
1-PB2,1890,605,0,0,0,605,A
1-PB2,1891,617,0,0,0,617,A
1-PB2,1892,0,609,0,1,610,T
1-PB2,1893,0,0,614,0,614,G
1-PB2,1894,0,0,0,615,615,C
1-PB2,1895,608,0,0,0,608,A
1-PB2,1896,0,0,612,0,612,G
1-PB2,1897,0,609,0,0,609,T
1-PB2,1898,0,640,0,0,640,T
1-PB2,1899,3,0,0,633,636,C
1-PB2,1900,0,634,0,0,634,T
1-PB2,1901,0,0,0,633,633,C
1-PB2,1902,0,637,0,0,637,T
1-PB2,1903,0,634,2,1,637,T
1-PB2,1904,0,1,0,642,643,C
1-PB2,1905,630,0,0,0,630,A
1-PB2,1906,0,0,0,639,639,C
1-PB2,1907,0,613,0,0,613,T
1-PB2,1908,0,1,620,0,621,G
1-PB2,1909,617,0,0,0,617,A
1-PB2,1910,0,0,0,632,632,C
1-PB2,1911,0,623,0,0,623,T
1-PB2,1912,0,1,627,0,628,G
1-PB2,1913,0,624,0,0,624,T
1-PB2,1914,0,0,630,0,630,G
1-PB2,1915,618,0,1,0,619,A
1-PB2,1916,628,0,0,1,629,A
1-PB2,1917,0,636,0,0,636,T
1-PB2,1918,0,0,633,0,633,G
1-PB2,1919,0,623,0,1,624,T
1-PB2,1920,0,623,0,0,623,T
1-PB2,1921,621,0,0,0,621,A
1-PB2,1922,0,1,627,0,628,G
1-PB2,1923,0,1,623,0,624,G
1-PB2,1924,0,0,626,0,626,G
1-PB2,1925,0,0,622,0,622,G
1-PB2,1926,610,0,0,0,610,A
1-PB2,1927,0,602,0,0,602,T
1-PB2,1928,1,0,0,610,611,C
1-PB2,1929,611,0,0,0,611,A
1-PB2,1930,0,0,626,0,626,G
1-PB2,1931,0,0,625,0,625,G
1-PB2,1932,0,1,628,0,629,G
1-PB2,1933,621,0,0,0,621,A
1-PB2,1934,0,621,0,0,621,T
1-PB2,1935,1,2,622,0,625,G
1-PB2,1936,623,0,0,0,623,A
1-PB2,1937,0,1,637,0,638,G
1-PB2,1938,640,0,0,0,640,A
1-PB2,1939,631,0,0,0,631,A
1-PB2,1940,0,636,0,0,636,T
1-PB2,1941,641,0,0,0,641,A
1-PB2,1942,0,0,0,647,647,C
1-PB2,1943,0,643,0,1,644,T
1-PB2,1944,0,641,0,0,641,T
1-PB2,1945,0,0,636,0,636,G
1-PB2,1946,0,625,0,0,625,T
1-PB2,1947,631,0,0,0,631,A
1-PB2,1948,625,1,0,0,626,A
1-PB2,1949,0,0,617,0,617,G
1-PB2,1950,0,0,611,0,611,G
1-PB2,1951,1,1,602,0,604,G
1-PB2,1952,0,0,604,0,604,G
1-PB2,1953,1,0,0,607,608,C
1-PB2,1954,611,0,0,0,611,A
1-PB2,1955,624,0,0,0,624,A
1-PB2,1956,0,620,0,0,620,T
1-PB2,1957,0,616,0,0,616,T
1-PB2,1958,0,0,0,643,643,C
1-PB2,1959,0,631,0,0,631,T
1-PB2,1960,3,1,0,634,638,C
1-PB2,1961,1,0,0,639,640,C
1-PB2,1962,0,637,0,0,637,T
1-PB2,1963,0,0,652,0,652,G
1-PB2,1964,0,636,0,0,636,T
1-PB2,1965,640,0,0,0,640,A
1-PB2,1966,0,635,0,0,635,T
1-PB2,1967,1,626,0,0,627,T
1-PB2,1968,0,0,0,637,637,C
1-PB2,1969,628,0,0,0,628,A
1-PB2,1970,630,0,0,0,630,A
1-PB2,1971,0,1,0,634,635,C
1-PB2,1972,0,622,0,0,622,T
1-PB2,1973,621,0,0,0,621,A
1-PB2,1974,0,0,0,638,638,C
1-PB2,1975,637,0,0,0,637,A
1-PB2,1976,634,0,0,0,634,A
1-PB2,1977,0,0,0,633,633,C
1-PB2,1978,635,0,0,0,635,A
1-PB2,1979,624,0,1,0,625,A
1-PB2,1980,0,0,625,0,625,G
1-PB2,1981,629,0,0,0,629,A
1-PB2,1982,1,0,0,623,624,C
1-PB2,1983,0,0,0,617,617,C
1-PB2,1984,621,0,0,0,621,A
1-PB2,1985,0,0,0,645,645,C
1-PB2,1986,0,641,0,0,641,T
1-PB2,1987,641,0,0,0,641,A
1-PB2,1988,643,0,0,0,643,A
1-PB2,1989,638,0,0,0,638,A
1-PB2,1990,643,0,0,0,643,A
1-PB2,1991,0,1,646,0,647,G
1-PB2,1992,636,0,0,0,636,A
1-PB2,1993,0,0,0,640,640,C
1-PB2,1994,0,629,0,1,630,T
1-PB2,1995,630,0,0,0,630,A
1-PB2,1996,627,0,0,0,627,A
1-PB2,1997,0,0,0,625,625,C
1-PB2,1998,628,0,0,0,628,A
1-PB2,1999,626,0,0,0,626,A
1-PB2,2000,0,615,0,0,615,T
1-PB2,2001,0,603,0,0,603,T
1-PB2,2002,1,0,0,620,621,C
1-PB2,2003,0,606,0,0,606,T
1-PB2,2004,0,0,0,625,625,C
1-PB2,2005,0,0,622,0,622,G
1-PB2,2006,0,2,624,0,626,G
1-PB2,2007,623,0,0,0,623,A
1-PB2,2008,617,0,0,0,617,A
1-PB2,2009,619,0,0,0,619,A
1-PB2,2010,608,0,5,0,613,A
1-PB2,2011,0,0,620,0,620,G
1-PB2,2012,606,0,0,0,606,A
1-PB2,2013,0,607,0,0,607,T
1-PB2,2014,1,0,617,0,618,G
1-PB2,2015,0,0,0,599,599,C
1-PB2,2016,0,0,0,601,601,C
1-PB2,2017,0,0,608,0,608,G
1-PB2,2018,0,0,608,0,608,G
1-PB2,2019,0,1,0,608,609,C
1-PB2,2020,600,0,0,0,600,A
1-PB2,2021,0,0,0,630,630,C
1-PB2,2022,0,620,0,0,620,T
1-PB2,2023,0,621,0,0,621,T
1-PB2,2024,0,620,0,0,620,T
1-PB2,2025,629,0,0,0,629,A
1-PB2,2026,630,0,0,0,630,A
1-PB2,2027,0,631,0,0,631,T
1-PB2,2028,596,0,2,0,598,A
1-PB2,2029,0,1,601,0,602,G
1-PB2,2030,604,0,0,0,604,A
1-PB2,2031,599,0,0,0,599,A
1-PB2,2032,0,0,596,0,596,G
1-PB2,2033,589,0,0,0,589,A
1-PB2,2034,0,0,0,595,595,C
1-PB2,2035,0,1,0,597,598,C
1-PB2,2036,0,0,0,597,597,C
1-PB2,2037,596,0,0,0,596,A
1-PB2,2038,0,0,608,0,608,G
1-PB2,2039,609,0,0,0,609,A
1-PB2,2040,0,608,0,0,608,T
1-PB2,2041,0,1,608,0,609,G
1-PB2,2042,595,0,0,0,595,A
1-PB2,2043,596,0,0,0,596,A
1-PB2,2044,596,0,0,0,596,A
1-PB2,2045,0,0,593,0,593,G
1-PB2,2046,0,0,0,593,593,C
1-PB2,2047,583,0,0,0,583,A
1-PB2,2048,0,0,0,594,594,C
1-PB2,2049,596,0,0,0,596,A
1-PB2,2050,0,569,0,0,569,T
1-PB2,2051,0,0,0,592,592,C
1-PB2,2052,1,1,0,593,595,C
1-PB2,2053,0,0,597,0,597,G
1-PB2,2054,1,0,600,0,601,G
1-PB2,2055,590,0,0,0,590,A
1-PB2,2056,1,1,593,0,595,G
1-PB2,2057,0,586,0,0,586,T
1-PB2,2058,2,0,582,0,584,G
1-PB2,2059,0,0,589,0,589,G
1-PB2,2060,586,0,0,0,586,A
1-PB2,2061,1,1,582,0,584,G
1-PB2,2062,0,573,0,1,574,T
1-PB2,2063,1,0,0,565,566,C
1-PB2,2064,0,1,0,564,565,C
1-PB2,2065,0,0,576,0,576,G
1-PB2,2066,0,0,0,571,571,C
1-PB2,2067,0,0,0,574,574,C
1-PB2,2068,0,0,580,0,580,G
1-PB2,2069,0,570,0,0,570,T
1-PB2,2070,1,0,0,581,582,C
1-PB2,2071,0,578,0,1,579,T
1-PB2,2072,0,585,0,0,585,T
1-PB2,2073,1,0,587,0,588,G
1-PB2,2074,574,0,4,0,578,A
1-PB2,2075,0,0,579,1,580,G
1-PB2,2076,578,0,0,0,578,A
1-PB2,2077,0,0,563,0,563,G
1-PB2,2078,0,0,565,0,565,G
1-PB2,2079,0,1,566,0,567,G
1-PB2,2080,0,562,0,0,562,T
1-PB2,2081,0,559,0,0,559,T
1-PB2,2082,0,565,0,0,565,T
1-PB2,2083,0,1,0,562,563,C
1-PB2,2084,0,557,0,0,557,T
1-PB2,2085,1,0,0,579,580,C
1-PB2,2086,578,0,1,0,579,A
1-PB2,2087,0,576,0,1,577,T
1-PB2,2088,1,576,0,0,577,T
1-PB2,2089,579,0,0,0,579,A
1-PB2,2090,0,578,0,0,578,T
1-PB2,2091,570,0,0,0,570,A
1-PB2,2092,0,0,577,0,577,G
1-PB2,2093,0,0,573,0,573,G
1-PB2,2094,0,542,0,0,542,T
1-PB2,2095,545,0,0,0,545,A
1-PB2,2096,541,0,0,0,541,A
1-PB2,2097,0,0,545,0,545,G
1-PB2,2098,0,0,546,0,546,G
1-PB2,2099,539,1,0,0,540,A
1-PB2,2100,535,0,1,0,536,A
1-PB2,2101,0,0,534,0,534,G
1-PB2,2102,528,0,0,0,528,A
1-PB2,2103,0,0,0,532,532,C
1-PB2,2104,528,0,0,0,528,A
1-PB2,2105,0,1,524,0,525,G
1-PB2,2106,524,0,0,0,524,A
1-PB2,2107,522,0,0,0,522,A
1-PB2,2108,0,1,521,0,522,G
1-PB2,2109,517,0,0,0,517,A
1-PB2,2110,0,506,0,0,506,T
1-PB2,2111,510,0,1,0,511,A
1-PB2,2112,0,0,0,511,511,C
1-PB2,2113,0,0,508,0,508,G
1-PB2,2114,0,1,511,0,512,G
1-PB2,2115,507,0,0,0,507,A
1-PB2,2116,0,0,0,502,502,C
1-PB2,2117,0,0,0,504,504,C
1-PB2,2118,495,0,1,0,496,A
1-PB2,2119,0,0,506,0,506,G
1-PB2,2120,0,0,0,507,507,C
1-PB2,2121,510,0,0,0,510,A
1-PB2,2122,0,500,0,1,501,T
1-PB2,2123,0,486,0,0,486,T
1-PB2,2124,490,0,0,1,491,A
1-PB2,2125,490,0,0,0,490,A
1-PB2,2126,0,1,490,0,491,G
1-PB2,2127,0,0,0,486,486,C
1-PB2,2128,459,0,0,0,459,A
1-PB2,2129,0,458,0,0,458,T
1-PB2,2130,1,0,0,462,463,C
1-PB2,2131,462,0,0,0,462,A
1-PB2,2132,464,0,0,0,464,A
1-PB2,2133,0,460,0,0,460,T
1-PB2,2134,0,0,459,0,459,G
1-PB2,2135,452,0,0,0,452,A
1-PB2,2136,452,0,0,0,452,A
1-PB2,2137,0,0,0,449,449,C
1-PB2,2138,0,436,0,0,436,T
1-PB2,2139,0,1,450,0,451,G
1-PB2,2140,450,0,0,0,450,A
1-PB2,2141,0,0,444,0,444,G
1-PB2,2142,0,445,0,0,445,T
1-PB2,2143,441,0,0,0,441,A
1-PB2,2144,435,0,0,0,435,A
1-PB2,2145,0,1,0,438,439,C
1-PB2,2146,0,0,0,428,428,C
1-PB2,2147,0,428,0,0,428,T
1-PB2,2148,0,413,0,0,413,T
1-PB2,2149,0,0,410,0,410,G
1-PB2,2150,0,0,0,412,412,C
1-PB2,2151,412,0,0,0,412,A
1-PB2,2152,411,0,0,0,411,A
1-PB2,2153,409,0,0,0,409,A
1-PB2,2154,405,0,0,0,405,A
1-PB2,2155,1,1,406,0,408,G
1-PB2,2156,0,0,409,0,409,G
1-PB2,2157,0,0,413,0,413,G
1-PB2,2158,0,1,408,0,409,G
1-PB2,2159,411,0,0,0,411,A
1-PB2,2160,410,0,0,0,410,A
1-PB2,2161,408,0,0,0,408,A
1-PB2,2162,411,0,0,0,411,A
1-PB2,2163,0,0,413,0,413,G
1-PB2,2164,0,0,403,0,403,G
1-PB2,2165,0,0,0,400,400,C
1-PB2,2166,0,406,0,0,406,T
1-PB2,2167,406,0,0,0,406,A
1-PB2,2168,406,0,0,0,406,A
1-PB2,2169,0,404,0,0,404,T
1-PB2,2170,0,0,410,0,410,G
1-PB2,2171,0,391,0,0,391,T
1-PB2,2172,0,0,391,0,391,G
1-PB2,2173,0,0,0,387,387,C
1-PB2,2174,0,390,0,0,390,T
1-PB2,2175,391,0,0,0,391,A
1-PB2,2176,385,0,0,0,385,A
1-PB2,2177,0,383,0,0,383,T
1-PB2,2178,0,1,0,383,384,C
1-PB2,2179,0,2,373,0,375,G
1-PB2,2180,0,0,373,0,373,G
1-PB2,2181,0,0,372,0,372,G
1-PB2,2182,0,0,0,376,376,C
1-PB2,2183,375,0,0,0,375,A
1-PB2,2184,373,0,0,0,373,A
1-PB2,2185,0,1,373,0,374,G
1-PB2,2186,0,0,374,0,374,G
1-PB2,2187,370,0,0,0,370,A
1-PB2,2188,0,0,372,0,372,G
1-PB2,2189,353,0,0,0,353,A
1-PB2,2190,0,0,0,355,355,C
1-PB2,2191,0,0,357,0,357,G
1-PB2,2192,0,348,0,1,349,T
1-PB2,2193,0,0,351,0,351,G
1-PB2,2194,1,0,356,0,357,G
1-PB2,2195,0,346,0,0,346,T
1-PB2,2196,0,0,349,0,349,G
1-PB2,2197,0,340,0,0,340,T
1-PB2,2198,0,334,0,0,334,T
1-PB2,2199,0,0,333,0,333,G
1-PB2,2200,0,0,333,0,333,G
1-PB2,2201,0,330,0,1,331,T
1-PB2,2202,328,0,0,0,328,A
1-PB2,2203,319,0,0,0,319,A
1-PB2,2204,0,306,0,0,306,T
1-PB2,2205,0,0,304,0,304,G
1-PB2,2206,297,0,0,0,297,A
1-PB2,2207,293,0,0,0,293,A
1-PB2,2208,293,0,0,0,293,A
1-PB2,2209,0,0,0,299,299,C
1-PB2,2210,0,1,294,0,295,G
1-PB2,2211,296,0,0,0,296,A
1-PB2,2212,295,0,0,0,295,A
1-PB2,2213,296,0,0,0,296,A
1-PB2,2214,297,0,0,0,297,A
1-PB2,2215,0,0,0,295,295,C
1-PB2,2216,0,0,293,0,293,G
1-PB2,2217,0,0,288,0,288,G
1-PB2,2218,0,0,293,0,293,G
1-PB2,2219,290,0,0,0,290,A
1-PB2,2220,0,0,0,292,292,C
1-PB2,2221,0,284,0,0,284,T
1-PB2,2222,0,0,0,284,284,C
1-PB2,2223,0,286,0,0,286,T
1-PB2,2224,282,0,0,0,282,A
1-PB2,2225,0,1,283,0,284,G
1-PB2,2226,0,0,0,286,286,C
1-PB2,2227,282,0,0,0,282,A
1-PB2,2228,0,282,0,0,282,T
1-PB2,2229,269,0,0,0,269,A
1-PB2,2230,1,0,0,269,270,C
1-PB2,2231,0,225,0,0,225,T
1-PB2,2232,0,222,0,0,222,T
1-PB2,2233,219,0,0,0,219,A
1-PB2,2234,2,1,0,216,219,C
1-PB2,2235,0,218,0,0,218,T
1-PB2,2236,0,0,217,0,217,G
1-PB2,2237,204,0,1,0,205,A
1-PB2,2238,0,0,0,206,206,C
1-PB2,2239,197,0,0,0,197,A
1-PB2,2240,0,0,196,0,196,G
1-PB2,2241,0,0,0,193,193,C
1-PB2,2242,0,0,0,196,196,C
1-PB2,2243,198,0,0,0,198,A
1-PB2,2244,0,0,197,0,197,G
1-PB2,2245,195,0,0,0,195,A
1-PB2,2246,0,0,0,191,191,C
1-PB2,2247,184,0,1,0,185,A
1-PB2,2248,0,0,181,0,181,G
1-PB2,2249,0,0,0,171,171,C
1-PB2,2250,0,0,174,0,174,G
1-PB2,2251,171,1,0,0,172,A
1-PB2,2252,0,0,0,168,168,C
1-PB2,2253,0,0,0,173,173,C
1-PB2,2254,171,0,0,0,171,A
1-PB2,2255,171,0,0,0,171,A
1-PB2,2256,167,0,1,0,168,A
1-PB2,2257,169,0,0,0,169,A
1-PB2,2258,0,0,167,0,167,G
1-PB2,2259,168,0,0,0,168,A
1-PB2,2260,167,0,0,0,167,A
1-PB2,2261,0,164,0,0,164,T
1-PB2,2262,0,163,0,0,163,T
1-PB2,2263,0,0,0,166,166,C
1-PB2,2264,0,0,166,0,166,G
1-PB2,2265,0,0,164,0,164,G
1-PB2,2266,163,0,0,0,163,A
1-PB2,2267,0,160,0,0,160,T
1-PB2,2268,0,0,160,0,160,G
1-PB2,2269,0,0,160,0,160,G
1-PB2,2270,0,0,0,157,157,C
1-PB2,2271,0,0,0,159,159,C
1-PB2,2272,158,0,0,0,158,A
1-PB2,2273,0,156,0,0,156,T
1-PB2,2274,0,0,0,161,161,C
1-PB2,2275,160,0,0,0,160,A
1-PB2,2276,161,0,0,0,161,A
1-PB2,2277,0,157,0,0,157,T
1-PB2,2278,0,144,0,0,144,T
1-PB2,2279,138,0,0,0,138,A
1-PB2,2280,136,0,0,0,136,A
2-PB1,1,244,0,0,0,244,A
2-PB1,2,0,250,0,0,250,T
2-PB1,3,0,0,255,0,255,G
2-PB1,4,0,1,276,0,277,G
2-PB1,5,320,0,0,0,320,A
2-PB1,6,0,350,0,0,350,T
2-PB1,7,0,1,349,0,350,G
2-PB1,8,0,350,0,2,352,T
2-PB1,9,1,0,0,379,380,C
2-PB1,10,383,0,0,0,383,A
2-PB1,11,404,0,0,0,404,A
2-PB1,12,0,407,0,0,407,T
2-PB1,13,1,1,0,408,410,C
2-PB1,14,1,0,0,437,438,C
2-PB1,15,0,2,446,0,448,G
2-PB1,16,508,0,0,0,508,A
2-PB1,17,0,0,0,512,512,C
2-PB1,18,0,512,0,2,514,T
2-PB1,19,1,0,0,600,601,C
2-PB1,20,0,603,0,0,603,T
2-PB1,21,604,0,0,1,605,A
2-PB1,22,0,0,0,608,608,C
2-PB1,23,0,609,0,0,609,T
2-PB1,24,1,0,663,0,664,G
2-PB1,25,0,672,0,0,672,T
2-PB1,26,0,679,0,0,679,T
2-PB1,27,0,0,0,672,672,C
2-PB1,28,0,0,0,674,674,C
2-PB1,29,0,801,0,0,801,T
2-PB1,30,817,0,0,0,817,A
2-PB1,31,811,0,0,0,811,A
2-PB1,32,813,0,0,0,813,A
2-PB1,33,0,1,814,0,815,G
2-PB1,34,0,0,829,0,829,G
2-PB1,35,0,807,0,0,807,T
2-PB1,36,0,832,0,0,832,T
2-PB1,37,0,0,0,829,829,C
2-PB1,38,1,0,0,834,835,C
2-PB1,39,844,0,0,0,844,A
2-PB1,40,0,0,838,0,838,G
2-PB1,41,0,0,0,844,844,C
2-PB1,42,0,0,841,0,841,G
2-PB1,43,0,0,0,854,854,C
2-PB1,44,854,0,0,0,854,A
2-PB1,45,858,0,0,0,858,A
2-PB1,46,855,0,1,0,856,A
2-PB1,47,859,0,0,0,859,A
2-PB1,48,0,861,0,0,861,T
2-PB1,49,0,0,899,0,899,G
2-PB1,50,0,0,0,914,914,C
2-PB1,51,2,2,0,924,928,C
2-PB1,52,923,0,0,0,923,A
2-PB1,53,0,932,0,0,932,T
2-PB1,54,994,0,0,0,994,A
2-PB1,55,1003,0,1,0,1004,A
2-PB1,56,0,0,1039,0,1039,G
2-PB1,57,1,0,0,1048,1049,C
2-PB1,58,1053,0,0,0,1053,A
2-PB1,59,0,1,0,1094,1095,C
2-PB1,60,1086,0,0,0,1086,A
2-PB1,61,1151,0,1,0,1152,A
2-PB1,62,0,0,0,1157,1157,C
2-PB1,63,1165,0,0,0,1165,A
2-PB1,64,0,1188,0,0,1188,T
2-PB1,65,0,1192,0,0,1192,T
2-PB1,66,3,0,0,1472,1475,C
2-PB1,67,1,1,0,1484,1486,C
2-PB1,68,1,0,0,1506,1507,C
2-PB1,69,0,1522,0,1,1523,T
2-PB1,70,0,1522,0,1,1523,T
2-PB1,71,1665,0,0,0,1665,A
2-PB1,72,0,1680,0,0,1680,T
2-PB1,73,1688,0,0,0,1688,A
2-PB1,74,0,0,0,1708,1708,C
2-PB1,75,1,1671,0,2,1674,T
2-PB1,76,0,0,1690,0,1690,G
2-PB1,77,0,2,1674,0,1676,G
2-PB1,78,1675,0,2,0,1677,A
2-PB1,79,0,5,1686,0,1691,G
2-PB1,80,1678,0,1,0,1679,A
2-PB1,81,1,1699,0,0,1700,T
2-PB1,82,1,0,0,1805,1806,C
2-PB1,83,1,0,0,1810,1811,C
2-PB1,84,0,1823,0,0,1823,T
2-PB1,85,1,0,1,1946,1948,C
2-PB1,86,1,1,1,1955,1958,C
2-PB1,87,1973,0,0,0,1973,A
2-PB1,88,0,1979,0,1,1980,T
2-PB1,89,1974,1,1,0,1976,A
2-PB1,90,0,1,0,1989,1990,C
2-PB1,91,1983,0,0,0,1983,A
2-PB1,92,0,0,2057,0,2057,G
2-PB1,93,1,0,0,2072,2073,C
2-PB1,94,1,0,0,2079,2080,C
2-PB1,95,2069,0,0,0,2069,A
2-PB1,96,0,2085,0,2,2087,T
2-PB1,97,0,2,2075,0,2077,G
2-PB1,98,0,5,2164,0,2169,G
2-PB1,99,2181,1,4,0,2186,A
2-PB1,100,2208,0,3,0,2211,A
2-PB1,101,1,0,0,2217,2218,C
2-PB1,102,2204,0,3,0,2207,A
2-PB1,103,1,5,2255,0,2261,G
2-PB1,104,0,5,2292,0,2297,G
2-PB1,105,2291,0,1,0,2292,A
2-PB1,106,2335,0,0,0,2335,A
2-PB1,107,1,1,0,2342,2344,C
2-PB1,108,2352,0,2,0,2354,A
2-PB1,109,1,0,2587,0,2588,G
2-PB1,110,0,6,2547,0,2553,G
2-PB1,111,0,1,2617,0,2618,G
2-PB1,112,0,2615,0,0,2615,T
2-PB1,113,2648,0,1,0,2649,A
2-PB1,114,1,0,0,2681,2682,C
2-PB1,115,2795,0,1,1,2797,A
2-PB1,116,1,6,0,2894,2901,C
2-PB1,117,5,0,0,2904,2909,C
2-PB1,118,2874,0,0,0,2874,A
2-PB1,119,0,2882,0,1,2883,T
2-PB1,120,0,5,2881,0,2886,G
2-PB1,121,0,8,2867,0,2875,G
2-PB1,122,2874,0,4,0,2878,A
2-PB1,123,1,2,0,2908,2911,C
2-PB1,124,2868,0,0,0,2868,A
2-PB1,125,0,0,1,2927,2928,C
2-PB1,126,2914,1,0,0,2915,A
2-PB1,127,0,1,2973,0,2974,G
2-PB1,128,1,2966,0,1,2968,T
2-PB1,129,6,0,0,3058,3064,C
2-PB1,130,3059,0,1,0,3060,A
2-PB1,131,3083,1,1,0,3085,A
2-PB1,132,0,0,0,3093,3093,C
2-PB1,133,3093,0,0,0,3093,A
2-PB1,134,0,2,3104,0,3106,G
2-PB1,135,3079,0,0,0,3079,A
2-PB1,136,3083,0,1,0,3084,A
2-PB1,137,0,1,0,3101,3102,C
2-PB1,138,3079,0,1,0,3080,A
2-PB1,139,1,1,0,3098,3100,C
2-PB1,140,3076,0,0,0,3076,A
2-PB1,141,0,3055,0,0,3055,T
2-PB1,142,6,2,0,3263,3271,C
2-PB1,143,3269,0,0,0,3269,A
2-PB1,144,3292,0,0,0,3292,A
2-PB1,145,0,3356,0,2,3358,T
2-PB1,146,3426,0,1,0,3427,A
2-PB1,147,0,3439,0,0,3439,T
2-PB1,148,0,3414,0,0,3414,T
2-PB1,149,2,0,0,3414,3416,C
2-PB1,150,3371,0,7,1,3379,A
2-PB1,151,0,2,3384,0,3386,G
2-PB1,152,3354,0,0,1,3355,A
2-PB1,153,0,3,3379,0,3382,G
2-PB1,154,3285,0,1,0,3286,A
2-PB1,155,1,1,3302,0,3304,G
2-PB1,156,1,4,3283,0,3288,G
2-PB1,157,0,4,3399,0,3403,G
2-PB1,158,0,5,3398,0,3403,G
2-PB1,159,14,1,3411,0,3426,G
2-PB1,160,3420,0,2,0,3422,A
2-PB1,161,3438,0,3,0,3441,A
2-PB1,162,0,1,3485,0,3486,G
2-PB1,163,0,3423,0,2,3425,T
2-PB1,164,1,5,3447,0,3453,G
2-PB1,165,0,4,3425,0,3429,G
2-PB1,166,3435,2,5,0,3442,A
2-PB1,167,1,1,0,3467,3469,C
2-PB1,168,0,7,3455,0,3462,G
2-PB1,169,3465,0,4,0,3469,A
2-PB1,170,1,0,0,3517,3518,C
2-PB1,171,3515,0,5,0,3520,A
2-PB1,172,3521,0,0,0,3521,A
2-PB1,173,3521,0,0,0,3521,A
2-PB1,174,0,3566,0,0,3566,T
2-PB1,175,3593,0,0,0,3593,A
2-PB1,176,0,2,0,3591,3593,C
2-PB1,177,3572,0,0,0,3572,A
2-PB1,178,2,3,3567,0,3572,G
2-PB1,179,3550,0,1,0,3551,A
2-PB1,180,3599,1,0,1,3601,A
2-PB1,181,3581,0,0,0,3581,A
2-PB1,182,0,0,0,3618,3618,C
2-PB1,183,0,3569,0,0,3569,T
2-PB1,184,0,4,3547,0,3551,G
2-PB1,185,0,5,3494,0,3499,G
2-PB1,186,0,5,3440,0,3445,G
2-PB1,187,3,1,3480,0,3484,G
2-PB1,188,2,1,0,3558,3561,C
2-PB1,189,3586,0,1,0,3587,A
2-PB1,190,0,0,0,3680,3680,C
2-PB1,191,3,0,0,3664,3667,C
2-PB1,192,3,0,0,3684,3687,C
2-PB1,193,3,0,0,3709,3712,C
2-PB1,194,3734,0,2,0,3736,A
2-PB1,195,3758,0,1,0,3759,A
2-PB1,196,1,0,0,3756,3757,C
2-PB1,197,1,3738,0,2,3741,T
2-PB1,198,8,1,0,3744,3753,C
2-PB1,199,3694,0,1,0,3695,A
2-PB1,200,3735,1,1,0,3737,A
2-PB1,201,1,0,1,3744,3746,C
2-PB1,202,2,0,0,3728,3730,C
2-PB1,203,4,1,0,3761,3766,C
2-PB1,204,3750,0,1,0,3751,A
2-PB1,205,3762,0,0,0,3762,A
2-PB1,206,0,3769,0,0,3769,T
2-PB1,207,2,3768,0,0,3770,T
2-PB1,208,0,2,3794,0,3796,G
2-PB1,209,3746,2,1,1,3750,A
2-PB1,210,1,3754,0,0,3755,T
2-PB1,211,1,2,3749,0,3752,G
2-PB1,212,0,5,3764,2,3771,G
2-PB1,213,3826,0,6,0,3832,A
2-PB1,214,1,1,0,3860,3862,C
2-PB1,215,5,1,1,3825,3832,C
2-PB1,216,3860,0,2,0,3862,A
2-PB1,217,0,0,0,3943,3943,C
2-PB1,218,0,3928,1,1,3930,T
2-PB1,219,3967,2,1,0,3970,A
2-PB1,220,1,1,0,4034,4036,C
2-PB1,221,3,0,0,4014,4017,C
2-PB1,222,0,3942,0,5,3947,T
2-PB1,223,0,5,3967,0,3972,G
2-PB1,224,3974,0,0,0,3974,A
2-PB1,225,0,2,4015,0,4017,G
2-PB1,226,0,5,3992,0,3997,G
2-PB1,227,4004,0,0,0,4004,A
2-PB1,228,0,4009,0,0,4009,T
2-PB1,229,3985,0,0,0,3985,A
2-PB1,230,3971,0,0,0,3971,A
2-PB1,231,0,3965,0,1,3966,T
2-PB1,232,1,12,3953,1,3967,G
2-PB1,233,3958,2,2,0,3962,A
2-PB1,234,3940,0,1,0,3941,A
2-PB1,235,0,1,0,3965,3966,C
2-PB1,236,3,0,0,3925,3928,C
2-PB1,237,3943,0,0,0,3943,A
2-PB1,238,3923,0,0,0,3923,A
2-PB1,239,0,1,3949,0,3950,G
2-PB1,240,0,3884,0,1,3885,T
2-PB1,241,1,4,3943,0,3948,G
2-PB1,242,0,5,3979,0,3984,G
2-PB1,243,3977,0,9,0,3986,A
2-PB1,244,0,3984,0,1,3985,T
2-PB1,245,4037,0,0,0,4037,A
2-PB1,246,0,4073,0,1,4074,T
2-PB1,247,2,0,4086,0,4088,G
2-PB1,248,0,3,0,4084,4087,C
2-PB1,249,4108,0,1,0,4109,A
2-PB1,250,0,0,0,4198,4198,C
2-PB1,251,4170,0,0,0,4170,A
2-PB1,252,4227,0,1,0,4228,A
2-PB1,253,4214,0,1,0,4215,A
2-PB1,254,0,1,0,4246,4247,C
2-PB1,255,4139,0,1,0,4140,A
2-PB1,256,0,10,4154,0,4164,G
2-PB1,257,4133,0,1,0,4134,A
2-PB1,258,1,1,0,4179,4181,C
2-PB1,259,0,4081,0,1,4082,T
2-PB1,260,0,1,4173,0,4174,G
2-PB1,261,1,4092,0,2,4095,T
2-PB1,262,8,0,4286,0,4294,G
2-PB1,263,0,4286,0,0,4286,T
2-PB1,264,7,1,0,4288,4296,C
2-PB1,265,3,1,0,4310,4314,C
2-PB1,266,0,4290,0,4,4294,T
2-PB1,267,4,4,4275,1,4284,G
2-PB1,268,1,2,4284,0,4287,G
2-PB1,269,4203,1,2,0,4206,A
2-PB1,270,0,1,4261,0,4262,G
2-PB1,271,0,1,4180,0,4181,G
2-PB1,272,0,0,0,4188,4188,C
2-PB1,273,0,4200,0,4,4204,T
2-PB1,274,4221,0,1,0,4222,A
2-PB1,275,2,4196,0,0,4198,T
2-PB1,276,0,5,4208,0,4213,G
2-PB1,277,1,0,4173,0,4174,G
2-PB1,278,2,1,0,4188,4191,C
2-PB1,279,1,1,0,4167,4169,C
2-PB1,280,1,4149,0,0,4150,T
2-PB1,281,0,4336,0,1,4337,T
2-PB1,282,2,2,0,4320,4324,C
2-PB1,283,2,0,0,4344,4346,C
2-PB1,284,0,4348,0,3,4351,T
2-PB1,285,0,4344,0,2,4346,T
2-PB1,286,1,4,4375,0,4380,G
2-PB1,287,4344,0,0,0,4344,A
2-PB1,288,4365,0,0,0,4365,A
2-PB1,289,0,7,4350,0,4357,G
2-PB1,290,4265,1,1,0,4267,A
2-PB1,291,4284,0,1,0,4285,A
2-PB1,292,0,4258,0,0,4258,T
2-PB1,293,5,1,0,4265,4271,C
2-PB1,294,6,0,0,4243,4249,C
2-PB1,295,3,0,0,4260,4263,C
2-PB1,296,4223,1,2,0,4226,A
2-PB1,297,1,0,0,4306,4307,C
2-PB1,298,0,0,1,4294,4295,C
2-PB1,299,3,1,0,4311,4315,C
2-PB1,300,4291,0,0,1,4292,A
2-PB1,301,1,3,4311,1,4316,G
2-PB1,302,1,1,4329,0,4331,G
2-PB1,303,0,4232,0,2,4234,T
2-PB1,304,4362,0,0,0,4362,A
2-PB1,305,1,4346,0,0,4347,T
2-PB1,306,0,0,0,4378,4378,C
2-PB1,307,0,4342,0,0,4342,T
2-PB1,308,0,4368,0,0,4368,T
2-PB1,309,0,4385,0,0,4385,T
2-PB1,310,1,4,4364,1,4370,G
2-PB1,311,4319,0,4,0,4323,A
2-PB1,312,2,7,4329,0,4338,G
2-PB1,313,4301,1,1,0,4303,A
2-PB1,314,4316,2,1,0,4319,A
2-PB1,315,2,1,0,4344,4347,C
2-PB1,316,0,4263,1,1,4265,T
2-PB1,317,5,1,0,4335,4341,C
2-PB1,318,4326,1,1,0,4328,A
2-PB1,319,0,4327,0,2,4329,T
2-PB1,320,1,3,4331,1,4336,G
2-PB1,321,3,1,0,4377,4381,C
2-PB1,322,3,0,0,4412,4415,C
2-PB1,323,1,4402,0,1,4404,T
2-PB1,324,0,4377,0,4,4381,T
2-PB1,325,1,9,4373,0,4383,G
2-PB1,326,4380,1,1,0,4382,A
2-PB1,327,4373,0,2,0,4375,A
2-PB1,328,4399,1,1,1,4402,A
2-PB1,329,1,0,0,4457,4458,C
2-PB1,330,4388,0,0,0,4388,A
2-PB1,331,4407,0,1,0,4408,A
2-PB1,332,0,4402,0,0,4402,T
2-PB1,333,0,1,4397,0,4398,G
2-PB1,334,1,5,4389,0,4395,G
2-PB1,335,4327,1,3,0,4331,A
2-PB1,336,4326,0,4,0,4330,A
2-PB1,337,1,0,4344,0,4345,G
2-PB1,338,2,0,0,4335,4337,C
2-PB1,339,3,2,0,4344,4349,C
2-PB1,340,13,0,4369,2,4384,G
2-PB1,341,0,4337,0,1,4338,T
2-PB1,342,0,4359,0,1,4360,T
2-PB1,343,9,0,0,4389,4398,C
2-PB1,344,4403,1,2,0,4406,A
2-PB1,345,4465,1,4,2,4472,A
2-PB1,346,0,1,0,4475,4476,C
2-PB1,347,4473,0,0,0,4473,A
2-PB1,348,0,5,4479,1,4485,G
2-PB1,349,4396,0,6,0,4402,A
2-PB1,350,1,0,0,4435,4436,C
2-PB1,351,4442,1,1,0,4444,A
2-PB1,352,4436,0,2,0,4438,A
2-PB1,353,0,7,4461,0,4468,G
2-PB1,354,8,4,4399,0,4411,G
2-PB1,355,0,2,4397,0,4399,G
2-PB1,356,2,4218,1,0,4221,T
2-PB1,357,2,3,4304,0,4309,G
2-PB1,358,0,8,4314,0,4322,G
2-PB1,359,4355,1,6,0,4362,A
2-PB1,360,2,0,0,4383,4385,C
2-PB1,361,4351,0,0,0,4351,A
2-PB1,362,4395,0,0,0,4395,A
2-PB1,363,4384,0,0,0,4384,A
2-PB1,364,0,0,0,4384,4384,C
2-PB1,365,0,4371,1,0,4372,T
2-PB1,366,4410,1,0,0,4411,A
2-PB1,367,4342,0,1,2,4345,A
2-PB1,368,2,0,0,4398,4400,C
2-PB1,369,1,3,0,4385,4389,C
2-PB1,370,5,1,0,4404,4410,C
2-PB1,371,4316,0,0,0,4316,A
2-PB1,372,4294,0,0,0,4294,A
2-PB1,373,0,4,4294,0,4298,G
2-PB1,374,1,2,4283,0,4286,G
2-PB1,375,0,4191,0,0,4191,T
2-PB1,376,8,0,0,4281,4289,C
2-PB1,377,2,2,4296,0,4300,G
2-PB1,378,4,1,0,4249,4254,C
2-PB1,379,6,2,1,4307,4316,C
2-PB1,380,4313,1,1,0,4315,A
2-PB1,381,0,4,4391,0,4395,G
2-PB1,382,4403,0,0,0,4403,A
2-PB1,383,0,0,0,4468,4468,C
2-PB1,384,0,4422,0,0,4422,T
2-PB1,385,0,4415,0,1,4416,T
2-PB1,386,4424,1,1,0,4426,A
2-PB1,387,0,4419,0,1,4420,T
2-PB1,388,0,15,4427,0,4442,G
2-PB1,389,4388,0,8,0,4396,A
2-PB1,390,0,4324,0,0,4324,T
2-PB1,391,0,4227,0,6,4233,T
2-PB1,392,1,4,4214,0,4219,G
2-PB1,393,0,8,4202,0,4210,G
2-PB1,394,4269,0,4,0,4273,A
2-PB1,395,1,2,0,4280,4283,C
2-PB1,396,4256,1,0,0,4257,A
2-PB1,397,0,4223,0,0,4223,T
2-PB1,398,0,4273,0,1,4274,T
2-PB1,399,4292,1,1,0,4294,A
2-PB1,400,4285,0,1,0,4286,A
2-PB1,401,4292,0,3,0,4295,A
2-PB1,402,1,3,0,4307,4311,C
2-PB1,403,4238,0,2,0,4240,A
2-PB1,404,0,2,4254,0,4256,G
2-PB1,405,4234,0,3,0,4237,A
2-PB1,406,4227,0,2,0,4229,A
2-PB1,407,4230,0,0,0,4230,A
2-PB1,408,0,4135,0,0,4135,T
2-PB1,409,11,0,0,4194,4205,C
2-PB1,410,4216,0,2,1,4219,A
2-PB1,411,4214,0,1,0,4215,A
2-PB1,412,0,1,0,4211,4212,C
2-PB1,413,2,0,0,4184,4186,C
2-PB1,414,2,3,4164,0,4169,G
2-PB1,415,0,1,4137,0,4138,G
2-PB1,416,2,2,0,4173,4177,C
2-PB1,417,4185,0,2,1,4188,A
2-PB1,418,1,0,4189,0,4190,G
2-PB1,419,1,0,0,4219,4220,C
2-PB1,420,4235,0,1,0,4236,A
2-PB1,421,4229,0,0,0,4229,A
2-PB1,422,1,0,0,4227,4228,C
2-PB1,423,0,4188,1,2,4191,T
2-PB1,424,0,1,4351,0,4352,G
2-PB1,425,0,0,0,4354,4354,C
2-PB1,426,4369,5,2,2,4378,A
2-PB1,427,1,4345,0,1,4347,T
2-PB1,428,0,4303,0,0,4303,T
2-PB1,429,4469,4,2,1,4476,A
2-PB1,430,0,0,4432,0,4432,G
2-PB1,431,3,1,0,4353,4357,C
2-PB1,432,1,1,0,4428,4430,C
2-PB1,433,4323,1,2,0,4326,A
2-PB1,434,4347,0,2,0,4349,A
2-PB1,435,0,0,0,4356,4356,C
2-PB1,436,4341,0,6,0,4347,A
2-PB1,437,0,0,0,4465,4465,C
2-PB1,438,8,0,1,4299,4308,C
2-PB1,439,4313,2,1,1,4317,A
2-PB1,440,0,4274,0,1,4275,T
2-PB1,441,4320,0,0,1,4321,A
2-PB1,442,1,6,4302,0,4309,G
2-PB1,443,4289,0,1,0,4290,A
2-PB1,444,4230,0,0,0,4230,A
2-PB1,445,0,1,4247,0,4248,G
2-PB1,446,0,4105,1,3,4109,T
2-PB1,447,2,4098,0,1,4101,T
2-PB1,448,0,4153,0,1,4154,T
2-PB1,449,0,4183,1,0,4184,T
2-PB1,450,0,4204,0,0,4204,T
2-PB1,451,4181,1,4,1,4187,A
2-PB1,452,0,3,4182,1,4186,G
2-PB1,453,4169,0,0,0,4169,A
2-PB1,454,0,4109,0,0,4109,T
2-PB1,455,5,2,0,4113,4120,C
2-PB1,456,0,7,4111,0,4118,G
2-PB1,457,4104,0,0,0,4104,A
2-PB1,458,4103,0,0,0,4103,A
2-PB1,459,2,3,0,4114,4119,C
2-PB1,460,2,7,4125,0,4134,G
2-PB1,461,1,4,4279,0,4284,G
2-PB1,462,4287,0,1,0,4288,A
2-PB1,463,0,4258,0,0,4258,T
2-PB1,464,0,4286,1,1,4288,T
2-PB1,465,4272,0,15,1,4288,A
2-PB1,466,4279,0,6,0,4285,A
2-PB1,467,0,1,0,4283,4284,C
2-PB1,468,4258,0,1,1,4260,A
2-PB1,469,0,0,4262,0,4262,G
2-PB1,470,0,1,0,4139,4140,C
2-PB1,471,2,4135,0,1,4138,T
2-PB1,472,4163,0,2,2,4167,A
2-PB1,473,4168,0,0,1,4169,A
2-PB1,474,1,4150,0,0,4151,T
2-PB1,475,1,10,4196,0,4207,G
2-PB1,476,4184,0,1,0,4185,A
2-PB1,477,4175,0,1,0,4176,A
2-PB1,478,2,4100,0,0,4102,T
2-PB1,479,6,1,1,4124,4132,C
2-PB1,480,4132,0,1,1,4134,A
2-PB1,481,1,2,4110,0,4113,G
2-PB1,482,0,6,4088,0,4094,G
2-PB1,483,4110,0,2,1,4113,A
2-PB1,484,4078,0,0,0,4078,A
2-PB1,485,0,4,4178,0,4182,G
2-PB1,486,0,0,4150,0,4150,G
2-PB1,487,1,0,0,4163,4164,C
2-PB1,488,0,4202,0,1,4203,T
2-PB1,489,4211,0,2,0,4213,A
2-PB1,490,4210,0,4,2,4216,A
2-PB1,491,0,4212,2,0,4214,T
2-PB1,492,4222,0,0,0,4222,A
2-PB1,493,1,5,4229,0,4235,G
2-PB1,494,4032,1,0,0,4033,A
2-PB1,495,0,3960,1,0,3961,T
2-PB1,496,1,3952,0,2,3955,T
2-PB1,497,0,3860,0,0,3860,T
2-PB1,498,2,0,0,3974,3976,C
2-PB1,499,5,0,0,3976,3981,C
2-PB1,500,0,3983,0,1,3984,T
2-PB1,501,5,0,0,4077,4082,C
2-PB1,502,4081,0,0,0,4081,A
2-PB1,503,4076,0,1,1,4078,A
2-PB1,504,0,4,4078,0,4082,G
2-PB1,505,0,3,4118,0,4121,G
2-PB1,506,4118,0,0,1,4119,A
2-PB1,507,0,3974,0,3,3977,T
2-PB1,508,0,0,4024,0,4024,G
2-PB1,509,0,3983,0,2,3985,T
2-PB1,510,1,3,4032,0,4036,G
2-PB1,511,4025,0,5,0,4030,A
2-PB1,512,0,4030,0,3,4033,T
2-PB1,513,2,6,3986,0,3994,G
2-PB1,514,0,10,3974,0,3984,G
2-PB1,515,4000,0,3,1,4004,A
2-PB1,516,3991,2,1,0,3994,A
2-PB1,517,1,3852,0,0,3853,T
2-PB1,518,4,0,1,3930,3935,C
2-PB1,519,3927,1,0,0,3928,A
2-PB1,520,3910,0,0,0,3910,A
2-PB1,521,0,3914,0,2,3916,T
2-PB1,522,1,8,3950,0,3959,G
2-PB1,523,18,5,3950,0,3973,G
2-PB1,524,3949,2,2,0,3953,A
2-PB1,525,1,3934,0,0,3935,T
2-PB1,526,3965,0,3,0,3968,A
2-PB1,527,3931,0,1,0,3932,A
2-PB1,528,3950,0,0,0,3950,A
2-PB1,529,0,3,3991,0,3994,G
2-PB1,530,3954,0,3,0,3957,A
2-PB1,531,1,3,3920,0,3924,G
2-PB1,532,0,9,3914,0,3923,G
2-PB1,533,3897,1,2,0,3900,A
2-PB1,534,3895,0,1,1,3897,A
2-PB1,535,3904,0,1,0,3905,A
2-PB1,536,0,3890,0,1,3891,T
2-PB1,537,0,2,3936,0,3938,G
2-PB1,538,2,4,3919,0,3925,G
2-PB1,539,3882,0,6,0,3888,A
2-PB1,540,1,3,3922,0,3926,G
2-PB1,541,3904,1,0,0,3905,A
2-PB1,542,0,3966,0,0,3966,T
2-PB1,543,3972,0,1,0,3973,A
2-PB1,544,3999,2,1,0,4002,A
2-PB1,545,1,0,0,3984,3985,C
2-PB1,546,3957,0,0,0,3957,A
2-PB1,547,3961,2,1,0,3964,A
2-PB1,548,0,1,0,3934,3935,C
2-PB1,549,3905,0,3,0,3908,A
2-PB1,550,1,0,0,3915,3916,C
2-PB1,551,3874,0,2,0,3876,A
2-PB1,552,2,0,0,3868,3870,C
2-PB1,553,0,3793,0,3,3796,T
2-PB1,554,0,3811,2,1,3814,T
2-PB1,555,0,3782,3,0,3785,T
2-PB1,556,3,1,0,3839,3843,C
2-PB1,557,3859,0,2,0,3861,A
2-PB1,558,3849,0,0,1,3850,A
2-PB1,559,3862,0,3,0,3865,A
2-PB1,560,0,6,3895,0,3901,G
2-PB1,561,3855,0,0,0,3855,A
2-PB1,562,3864,1,2,1,3868,A
2-PB1,563,3858,0,1,0,3859,A
2-PB1,564,3881,1,1,0,3883,A
2-PB1,565,3874,0,5,0,3879,A
2-PB1,566,0,1,3876,0,3877,G
2-PB1,567,0,3,3871,0,3874,G
2-PB1,568,3828,0,2,0,3830,A
2-PB1,569,0,4,3895,0,3899,G
2-PB1,570,3881,0,5,0,3886,A
2-PB1,571,0,0,3957,0,3957,G
2-PB1,572,0,3903,0,0,3903,T
2-PB1,573,3978,0,1,0,3979,A
2-PB1,574,3954,0,2,0,3956,A
2-PB1,575,0,3,3969,0,3972,G
2-PB1,576,0,4,3964,1,3969,G
2-PB1,577,1,4,3942,0,3947,G
2-PB1,578,3954,0,4,0,3958,A
2-PB1,579,2,3,0,3939,3944,C
2-PB1,580,3916,0,3,0,3919,A
2-PB1,581,3930,1,2,0,3933,A
2-PB1,582,0,0,0,3888,3888,C
2-PB1,583,3926,0,0,0,3926,A
2-PB1,584,0,3859,0,0,3859,T
2-PB1,585,0,7,3845,1,3853,G
2-PB1,586,3860,0,5,1,3866,A
2-PB1,587,1,0,1,3785,3787,C
2-PB1,588,8,0,0,3797,3805,C
2-PB1,589,3846,0,0,0,3846,A
2-PB1,590,3829,0,1,0,3830,A
2-PB1,591,0,6,3839,0,3845,G
2-PB1,592,3845,0,1,0,3846,A
2-PB1,593,3855,0,1,0,3856,A
2-PB1,594,3828,0,1,0,3829,A
2-PB1,595,3829,0,3,0,3832,A
2-PB1,596,0,3796,0,0,3796,T
2-PB1,597,0,2,3821,1,3824,G
2-PB1,598,1,1,3797,0,3799,G
2-PB1,599,0,3719,0,5,3724,T
2-PB1,600,11,1,0,3697,3709,C
2-PB1,601,3756,0,0,0,3756,A
2-PB1,602,0,1,0,3889,3890,C
2-PB1,603,3949,0,0,0,3949,A
2-PB1,604,0,0,0,3944,3944,C
2-PB1,605,3940,0,0,0,3940,A
2-PB1,606,4020,0,1,0,4021,A
2-PB1,607,3997,0,1,0,3998,A
2-PB1,608,2,5,4179,1,4187,G
2-PB1,609,4176,0,1,0,4177,A
2-PB1,610,4208,0,2,0,4210,A
2-PB1,611,0,1,0,4285,4286,C
2-PB1,612,4217,1,0,1,4219,A
2-PB1,613,4227,1,1,1,4230,A
2-PB1,614,0,4184,0,0,4184,T
2-PB1,615,4196,0,1,0,4197,A
2-PB1,616,1,6,4177,0,4184,G
2-PB1,617,0,3,4084,0,4087,G
2-PB1,618,0,5,4056,0,4061,G
2-PB1,619,4058,0,1,0,4059,A
2-PB1,620,4037,0,0,0,4037,A
2-PB1,621,0,6,4061,0,4067,G
2-PB1,622,4043,0,0,0,4043,A
2-PB1,623,4065,0,0,0,4065,A
2-PB1,624,4071,0,0,0,4071,A
2-PB1,625,4085,0,0,0,4085,A
2-PB1,626,4139,0,2,1,4142,A
2-PB1,627,4142,2,2,0,4146,A
2-PB1,628,1,1,0,4150,4152,C
2-PB1,629,4149,1,0,0,4150,A
2-PB1,630,4144,1,1,0,4146,A
2-PB1,631,4116,0,9,1,4126,A
2-PB1,632,0,3,4174,0,4177,G
2-PB1,633,4194,0,1,0,4195,A
2-PB1,634,1,0,4312,0,4313,G
2-PB1,635,2,4183,0,1,4186,T
2-PB1,636,2,5,4716,0,4723,G
2-PB1,637,4765,0,2,0,4767,A
2-PB1,638,4763,0,0,1,4764,A
2-PB1,639,0,4788,1,0,4789,T
2-PB1,640,4833,0,1,0,4834,A
2-PB1,641,4809,0,7,0,4816,A
2-PB1,642,1,6,4808,0,4815,G
2-PB1,643,4695,1,3,0,4699,A
2-PB1,644,0,3,4694,0,4697,G
2-PB1,645,4470,0,5,0,4475,A
2-PB1,646,1,4,4461,0,4466,G
2-PB1,647,0,2,4429,0,4431,G
2-PB1,648,1,0,0,4434,4435,C
2-PB1,649,1,4429,0,5,4435,T
2-PB1,650,4551,1,4,0,4556,A
2-PB1,651,3,1,0,4703,4707,C
2-PB1,652,7,0,0,4732,4739,C
2-PB1,653,0,4765,0,2,4767,T
2-PB1,654,4918,0,0,0,4918,A
2-PB1,655,4900,1,0,0,4901,A
2-PB1,656,0,4904,0,0,4904,T
2-PB1,657,4918,0,0,0,4918,A
2-PB1,658,4888,0,1,0,4889,A
2-PB1,659,2,8,4891,0,4901,G
2-PB1,660,4711,0,3,0,4714,A
2-PB1,661,0,3,4882,0,4885,G
2-PB1,662,0,0,0,5200,5200,C
2-PB1,663,0,5155,0,5,5160,T
2-PB1,664,1,5206,0,1,5208,T
2-PB1,665,2,5226,0,1,5229,T
2-PB1,666,1112,10,4102,1,5225,G
2-PB1,667,5294,1,5,0,5300,A
2-PB1,668,0,2,0,5299,5301,C
2-PB1,669,5307,0,0,0,5307,A
2-PB1,670,0,5236,1,0,5237,T
2-PB1,671,0,4893,0,3,4896,T
2-PB1,672,0,15,4929,0,4944,G
2-PB1,673,4952,0,0,0,4952,A
2-PB1,674,4937,0,7,0,4944,A
2-PB1,675,1,3,0,4943,4947,C
2-PB1,676,4947,0,1,0,4948,A
2-PB1,677,0,3,0,4950,4953,C
2-PB1,678,0,7,4950,1,4958,G
2-PB1,679,4920,0,5,0,4925,A
2-PB1,680,0,4937,0,3,4940,T
2-PB1,681,0,19,4954,0,4973,G
2-PB1,682,4984,1,5,0,4990,A
2-PB1,683,3,0,0,5017,5020,C
2-PB1,684,12,2,0,5016,5030,C
2-PB1,685,5042,1,1,0,5044,A
2-PB1,686,5070,1,0,0,5071,A
2-PB1,687,5066,0,5,1,5072,A
2-PB1,688,0,3,5158,0,5161,G
2-PB1,689,5188,0,3,0,5191,A
2-PB1,690,0,5138,1,2,5141,T
2-PB1,691,0,4,5179,0,5183,G
2-PB1,692,1,4,1,5129,5135,C
2-PB1,693,5140,1,4,0,5145,A
2-PB1,694,0,7,5174,0,5181,G
2-PB1,695,5110,1,1,1,5113,A
2-PB1,696,1,7,5133,0,5141,G
2-PB1,697,4990,1,1,0,4992,A
2-PB1,698,1,5,4989,0,4995,G
2-PB1,699,4943,1,7,0,4951,A
2-PB1,700,1,6,4960,0,4967,G
2-PB1,701,5,0,4940,0,4945,G
2-PB1,702,2,1,0,4943,4946,C
2-PB1,703,4963,0,0,0,4963,A
2-PB1,704,4964,1,0,0,4965,A
2-PB1,705,4980,1,3,0,4984,A
2-PB1,706,0,4993,0,2,4995,T
2-PB1,707,0,5011,0,0,5011,T
2-PB1,708,5009,0,0,0,5009,A
2-PB1,709,5008,0,2,0,5010,A
2-PB1,710,5013,0,0,2,5015,A
2-PB1,711,5023,0,1,1,5025,A
2-PB1,712,4994,0,0,0,4994,A
2-PB1,713,1,1,4992,0,4994,G
2-PB1,714,4972,0,2,0,4974,A
2-PB1,715,4977,1,4,0,4982,A
2-PB1,716,2,3,5030,0,5035,G
2-PB1,717,0,2,5075,1,5078,G
2-PB1,718,0,1,5090,0,5091,G
2-PB1,719,1,0,0,5137,5138,C
2-PB1,720,0,5149,0,2,5151,T
2-PB1,721,5190,0,0,0,5190,A
2-PB1,722,0,5237,0,1,5238,T
2-PB1,723,1,5230,0,2,5233,T
2-PB1,724,1,2,5263,0,5266,G
2-PB1,725,2,5,0,5236,5243,C
2-PB1,726,5156,0,4,1,5161,A
2-PB1,727,5164,0,5,0,5169,A
2-PB1,728,3,0,0,5157,5160,C
2-PB1,729,5114,1,0,0,5115,A
2-PB1,730,3,0,0,5128,5131,C
2-PB1,731,5,1,0,5048,5054,C
2-PB1,732,3,1,0,5077,5081,C
2-PB1,733,1,3,5086,0,5090,G
2-PB1,734,1,2,5082,0,5085,G
2-PB1,735,0,5,5093,0,5098,G
2-PB1,736,5087,0,4,0,5091,A
2-PB1,737,0,5051,1,3,5055,T
2-PB1,738,0,3,5089,1,5093,G
2-PB1,739,1,3,0,5054,5058,C
2-PB1,740,5139,0,1,4,5144,A
2-PB1,741,5215,0,2,0,5217,A
2-PB1,742,5240,0,1,0,5241,A
2-PB1,743,0,5230,1,0,5231,T
2-PB1,744,0,5236,2,2,5240,T
2-PB1,745,5220,0,0,0,5220,A
2-PB1,746,0,2,5205,0,5207,G
2-PB1,747,5160,0,13,0,5173,A
2-PB1,748,1,5,5189,0,5195,G
2-PB1,749,1,6,5100,0,5107,G
2-PB1,750,1,0,5195,0,5196,G
2-PB1,751,0,5087,0,4,5091,T
2-PB1,752,0,5178,0,4,5182,T
2-PB1,753,17,0,0,5177,5194,C
2-PB1,754,2,0,5271,0,5273,G
2-PB1,755,0,5236,0,8,5244,T
2-PB1,756,0,2,5276,0,5278,G
2-PB1,757,0,5238,0,2,5240,T
2-PB1,758,5233,0,0,1,5234,A
2-PB1,759,3,0,0,5237,5240,C
2-PB1,760,0,4981,0,2,4983,T
2-PB1,761,0,5004,0,0,5004,T
2-PB1,762,0,1,0,4996,4997,C
2-PB1,763,1,1,4977,0,4979,G
2-PB1,764,0,4969,0,2,4971,T
2-PB1,765,0,4972,0,1,4973,T
2-PB1,766,1,18,4945,0,4964,G
2-PB1,767,4924,0,1,0,4925,A
2-PB1,768,4955,0,2,0,4957,A
2-PB1,769,4975,0,7,1,4983,A
2-PB1,770,1,1,0,5006,5008,C
2-PB1,771,1,4962,0,0,4963,T
2-PB1,772,1,4941,0,0,4942,T
2-PB1,773,0,4948,0,1,4949,T
2-PB1,774,5012,0,6,1,5019,A
2-PB1,775,0,0,5007,0,5007,G
2-PB1,776,0,1,0,5029,5030,C
2-PB1,777,0,5037,0,1,5038,T
2-PB1,778,4977,0,3,0,4980,A
2-PB1,779,0,9,4986,0,4995,G
2-PB1,780,4973,0,0,0,4973,A
2-PB1,781,4963,0,3,0,4966,A
2-PB1,782,0,1,4996,0,4997,G
2-PB1,783,1,0,0,4898,4899,C
2-PB1,784,4920,0,0,0,4920,A
2-PB1,785,0,4891,0,1,4892,T
2-PB1,786,0,4892,0,2,4894,T
2-PB1,787,0,4896,1,0,4897,T
2-PB1,788,0,2,4900,0,4902,G
2-PB1,789,2,11,0,4880,4893,C
2-PB1,790,4,6,4916,0,4926,G
2-PB1,791,4897,1,4,0,4902,A
2-PB1,792,4892,0,1,0,4893,A
2-PB1,793,4892,0,1,0,4893,A
2-PB1,794,5016,0,1,0,5017,A
2-PB1,795,6,4,5032,0,5042,G
2-PB1,796,1,0,0,5035,5036,C
2-PB1,797,1,5040,0,8,5049,T
2-PB1,798,0,5055,0,0,5055,T
2-PB1,799,1,4,5051,2,5058,G
2-PB1,800,5039,0,3,0,5042,A
2-PB1,801,5038,0,4,0,5042,A
2-PB1,802,0,1,0,5078,5079,C
2-PB1,803,4972,0,0,0,4972,A
2-PB1,804,0,0,5256,0,5256,G
2-PB1,805,1,5194,0,2,5197,T
2-PB1,806,10,0,0,5199,5209,C
2-PB1,807,0,5223,1,1,5225,T
2-PB1,808,0,5,5224,0,5229,G
2-PB1,809,1,8,5205,0,5214,G
2-PB1,810,5205,0,2,1,5208,A
2-PB1,811,1,0,1,5233,5235,C
2-PB1,812,0,5118,0,2,5120,T
2-PB1,813,1,4851,0,2,4854,T
2-PB1,814,8,7,0,4832,4847,C
2-PB1,815,2,4,0,4851,4857,C
2-PB1,816,1,5,4891,0,4897,G
2-PB1,817,1,3,4874,0,4878,G
2-PB1,818,0,4822,0,1,4823,T
2-PB1,819,0,4856,0,0,4856,T
2-PB1,820,0,2,4845,0,4847,G
2-PB1,821,0,4,4826,1,4831,G
2-PB1,822,1,4,4878,1,4884,G
2-PB1,823,2,5,4891,0,4898,G
2-PB1,824,1,1,4937,0,4939,G
2-PB1,825,0,4857,0,2,4859,T
2-PB1,826,4883,0,0,0,4883,A
2-PB1,827,4895,0,1,0,4896,A
2-PB1,828,0,4921,1,2,4924,T
2-PB1,829,0,14,4919,0,4933,G
2-PB1,830,4882,0,7,0,4889,A
2-PB1,831,4837,0,0,0,4837,A
2-PB1,832,4860,0,0,1,4861,A
2-PB1,833,4841,0,0,1,4842,A
2-PB1,834,0,4,4808,0,4812,G
2-PB1,835,4785,0,3,0,4788,A
2-PB1,836,4747,0,2,0,4749,A
2-PB1,837,1,5,4743,0,4749,G
2-PB1,838,1,1,4710,0,4712,G
2-PB1,839,1,0,0,4680,4681,C
2-PB1,840,2,3,0,4726,4731,C
2-PB1,841,4752,0,0,0,4752,A
2-PB1,842,4762,0,0,0,4762,A
2-PB1,843,4739,0,2,0,4741,A
2-PB1,844,0,1,0,4760,4761,C
2-PB1,845,0,4738,0,3,4741,T
2-PB1,846,0,0,4792,0,4792,G
2-PB1,847,4,1,4767,0,4772,G
2-PB1,848,1,1,0,4778,4780,C
2-PB1,849,4815,0,1,0,4816,A
2-PB1,850,4794,0,0,0,4794,A
2-PB1,851,4787,1,1,0,4789,A
2-PB1,852,0,4818,0,0,4818,T
2-PB1,853,0,2,4817,0,4819,G
2-PB1,854,0,4789,0,0,4789,T
2-PB1,855,0,4670,0,1,4671,T
2-PB1,856,1,1,4666,0,4668,G
2-PB1,857,0,4641,0,2,4643,T
2-PB1,858,1,7,4653,0,4661,G
2-PB1,859,4657,1,8,0,4666,A
2-PB1,860,0,5,4682,0,4687,G
2-PB1,861,4678,0,1,0,4679,A
2-PB1,862,4660,1,0,0,4661,A
2-PB1,863,4644,0,2,0,4646,A
2-PB1,864,4657,0,2,0,4659,A
2-PB1,865,4687,0,1,1,4689,A
2-PB1,866,1,4646,0,1,4648,T
2-PB1,867,0,5,4661,0,4666,G
2-PB1,868,4648,0,2,1,4651,A
2-PB1,869,0,4587,0,1,4588,T
2-PB1,870,5,17,4638,0,4660,G
2-PB1,871,4629,1,1,0,4631,A
2-PB1,872,2,0,1,4648,4651,C
2-PB1,873,0,4654,0,0,4654,T
2-PB1,874,4684,0,1,0,4685,A
2-PB1,875,4705,1,1,0,4707,A
2-PB1,876,1,4674,0,0,4675,T
2-PB1,877,0,4696,0,0,4696,T
2-PB1,878,11,2,0,4729,4742,C
2-PB1,879,4712,0,2,0,4714,A
2-PB1,880,0,3,0,4728,4731,C
2-PB1,881,4688,1,5,0,4694,A
2-PB1,882,4693,1,4,0,4698,A
2-PB1,883,6,7,4688,0,4701,G
2-PB1,884,4755,0,1,0,4756,A
2-PB1,885,0,4,1,4745,4750,C
2-PB1,886,4727,1,1,0,4729,A
2-PB1,887,0,1,0,4698,4699,C
2-PB1,888,4663,0,6,0,4669,A
2-PB1,889,0,6,4690,1,4697,G
2-PB1,890,4658,0,8,0,4666,A
2-PB1,891,0,0,4595,0,4595,G
2-PB1,892,2,1,0,4568,4571,C
2-PB1,893,0,4521,0,4,4525,T
2-PB1,894,0,4586,0,3,4589,T
2-PB1,895,0,4556,0,0,4556,T
2-PB1,896,5,0,0,4603,4608,C
2-PB1,897,0,4608,0,3,4611,T
2-PB1,898,0,4585,0,0,4585,T
2-PB1,899,0,4579,0,5,4584,T
2-PB1,900,4,0,0,4584,4588,C
2-PB1,901,4547,0,2,0,4549,A
2-PB1,902,2,1,0,4601,4604,C
2-PB1,903,4568,0,3,0,4571,A
2-PB1,904,4568,0,0,0,4568,A
2-PB1,905,0,4536,0,1,4537,T
2-PB1,906,14,0,0,4589,4603,C
2-PB1,907,4607,0,0,1,4608,A
2-PB1,908,0,1,0,4659,4660,C
2-PB1,909,0,4609,0,0,4609,T
2-PB1,910,2,5,4628,0,4635,G
2-PB1,911,2,5,4573,0,4580,G
2-PB1,912,2,8,4674,0,4684,G
2-PB1,913,1,7,4669,1,4678,G
2-PB1,914,4622,0,3,0,4625,A
2-PB1,915,3,1,0,4452,4456,C
2-PB1,916,4560,0,0,1,4561,A
2-PB1,917,4758,0,0,1,4759,A
2-PB1,918,0,0,0,4809,4809,C
2-PB1,919,4783,0,1,0,4784,A
2-PB1,920,2,0,0,4791,4793,C
2-PB1,921,1,4599,1,4,4605,T
2-PB1,922,4654,0,3,2,4659,A
2-PB1,923,4644,0,3,0,4647,A
2-PB1,924,0,0,4632,0,4632,G
2-PB1,925,1,4572,0,1,4574,T
2-PB1,926,0,5,4273,0,4278,G
2-PB1,927,0,6,4247,0,4253,G
2-PB1,928,4243,1,3,0,4247,A
2-PB1,929,4260,0,6,0,4266,A
2-PB1,930,0,4252,0,0,4252,T
2-PB1,931,1,3,4239,0,4243,G
2-PB1,932,4255,0,3,0,4258,A
2-PB1,933,4217,0,0,0,4217,A
2-PB1,934,4225,0,3,1,4229,A
2-PB1,935,4231,3,1,0,4235,A
2-PB1,936,0,4127,0,0,4127,T
2-PB1,937,15,1,0,4182,4198,C
2-PB1,938,4219,1,1,0,4221,A
2-PB1,939,4191,0,3,0,4194,A
2-PB1,940,4189,0,2,1,4192,A
2-PB1,941,4121,0,1,1,4123,A
2-PB1,942,3,0,0,4189,4192,C
2-PB1,943,5,0,0,4158,4163,C
2-PB1,944,5,0,0,4156,4161,C
2-PB1,945,0,4130,0,2,4132,T
2-PB1,946,4,1,0,4184,4189,C
2-PB1,947,0,8,4172,3,4183,G
2-PB1,948,4162,0,1,0,4163,A
2-PB1,949,4167,0,0,0,4167,A
2-PB1,950,1,4177,1,1,4180,T
2-PB1,951,2,0,4186,0,4188,G
2-PB1,952,1,4120,2,2,4125,T
2-PB1,953,0,4070,0,5,4075,T
2-PB1,954,0,4133,0,0,4133,T
2-PB1,955,0,4117,0,1,4118,T
2-PB1,956,0,4125,0,0,4125,T
2-PB1,957,2,5,4104,0,4111,G
2-PB1,958,0,1,4051,0,4052,G
2-PB1,959,2,3,0,4063,4068,C
2-PB1,960,2,1,4018,0,4021,G
2-PB1,961,4018,0,1,0,4019,A
2-PB1,962,0,4103,1,1,4105,T
2-PB1,963,0,9,4226,1,4236,G
2-PB1,964,4409,1,1,0,4411,A
2-PB1,965,1,4409,0,3,4413,T
2-PB1,966,0,4422,0,1,4423,T
2-PB1,967,4422,0,5,0,4427,A
2-PB1,968,1,3,0,4441,4445,C
2-PB1,969,4467,0,1,0,4468,A
2-PB1,970,0,4433,0,0,4433,T
2-PB1,971,4254,1,1,0,4256,A
2-PB1,972,0,2,0,4301,4303,C
2-PB1,973,3926,0,2,0,3928,A
2-PB1,974,0,3920,0,0,3920,T
2-PB1,975,3,0,0,3910,3913,C
2-PB1,976,3874,1,0,12,3887,A
2-PB1,977,0,0,0,3912,3912,C
2-PB1,978,3913,0,0,0,3913,A
2-PB1,979,3912,0,1,0,3913,A
2-PB1,980,3915,0,0,0,3915,A
2-PB1,981,2,3,3757,0,3762,G
2-PB1,982,3902,0,0,0,3902,A
2-PB1,983,3897,0,0,0,3897,A
2-PB1,984,1,3852,0,0,3853,T
2-PB1,985,11,2,0,3867,3880,C
2-PB1,986,3910,0,5,0,3915,A
2-PB1,987,3926,0,0,0,3926,A
2-PB1,988,0,0,0,3938,3938,C
2-PB1,989,1,1,0,3929,3931,C
2-PB1,990,1,3736,0,0,3737,T
2-PB1,991,1,3,3802,0,3806,G
2-PB1,992,3771,2,2,0,3775,A
2-PB1,993,4,2,3744,1,3751,G
2-PB1,994,0,3734,0,2,3736,T
2-PB1,995,13,6,3658,0,3677,G
2-PB1,996,2,2,3792,1,3797,G
2-PB1,997,0,3805,0,4,3809,T
2-PB1,998,1,3773,0,3,3777,T
2-PB1,999,12,0,1,3801,3814,C
2-PB1,1000,3800,0,0,0,3800,A
2-PB1,1001,0,5,3822,0,3827,G
2-PB1,1002,3828,1,0,1,3830,A
2-PB1,1003,3842,0,0,0,3842,A
2-PB1,1004,3813,0,0,0,3813,A
2-PB1,1005,0,0,0,3474,3474,C
2-PB1,1006,3493,0,0,1,3494,A
2-PB1,1007,0,3411,0,2,3413,T
2-PB1,1008,1,1,0,3520,3522,C
2-PB1,1009,1,0,1,3516,3518,C
2-PB1,1010,2,3413,0,8,3423,T
2-PB1,1011,0,9,3403,0,3412,G
2-PB1,1012,3378,0,1,0,3379,A
2-PB1,1013,0,0,3401,0,3401,G
2-PB1,1014,2,0,0,3365,3367,C
2-PB1,1015,3317,0,0,0,3317,A
2-PB1,1016,0,3270,0,0,3270,T
2-PB1,1017,2,3,0,3283,3288,C
2-PB1,1018,1,1,3289,1,3292,G
2-PB1,1019,0,2,0,3380,3382,C
2-PB1,1020,3405,0,4,0,3409,A
2-PB1,1021,1,0,0,3475,3476,C
2-PB1,1022,3,1,0,3485,3489,C
2-PB1,1023,3504,1,1,0,3506,A
2-PB1,1024,3544,0,2,0,3546,A
2-PB1,1025,0,3553,0,0,3553,T
2-PB1,1026,3551,0,0,0,3551,A
2-PB1,1027,3542,0,0,0,3542,A
2-PB1,1028,1,3434,0,9,3444,T
2-PB1,1029,1,0,3459,0,3460,G
2-PB1,1030,0,3359,0,2,3361,T
2-PB1,1031,1,3279,0,4,3284,T
2-PB1,1032,9,3,0,3322,3334,C
2-PB1,1033,1,3346,0,1,3348,T
2-PB1,1034,5,0,1,3366,3372,C
2-PB1,1035,3391,0,2,0,3393,A
2-PB1,1036,3378,0,1,0,3379,A
2-PB1,1037,3370,0,0,0,3370,A
2-PB1,1038,2,1,0,3399,3402,C
2-PB1,1039,3395,0,1,0,3396,A
2-PB1,1040,3388,0,0,0,3388,A
2-PB1,1041,3362,0,1,0,3363,A
2-PB1,1042,3375,0,2,1,3378,A
2-PB1,1043,0,3392,0,6,3398,T
2-PB1,1044,0,5,3403,0,3408,G
2-PB1,1045,0,1,3381,0,3382,G
2-PB1,1046,0,1,0,3377,3378,C
2-PB1,1047,3374,1,2,1,3378,A
2-PB1,1048,3389,0,5,0,3394,A
2-PB1,1049,0,5,3414,0,3419,G
2-PB1,1050,3392,0,2,0,3394,A
2-PB1,1051,1,0,0,3430,3431,C
2-PB1,1052,0,3396,0,1,3397,T
2-PB1,1053,1,3,3442,0,3446,G
2-PB1,1054,1,1,3414,0,3416,G
2-PB1,1055,0,4,3448,0,3452,G
2-PB1,1056,3456,0,2,0,3458,A
2-PB1,1057,3468,0,2,0,3470,A
2-PB1,1058,3461,0,2,0,3463,A
2-PB1,1059,3438,0,5,0,3443,A
2-PB1,1060,0,2,3510,0,3512,G
2-PB1,1061,0,4,3499,1,3504,G
2-PB1,1062,3495,0,3,0,3498,A
2-PB1,1063,0,3488,0,0,3488,T
2-PB1,1064,3465,0,1,1,3467,A
2-PB1,1065,2,0,1,3488,3491,C
2-PB1,1066,3521,0,0,0,3521,A
2-PB1,1067,0,3498,0,0,3498,T
2-PB1,1068,0,2,3513,0,3515,G
2-PB1,1069,0,3467,0,0,3467,T
2-PB1,1070,1,3449,0,3,3453,T
2-PB1,1071,10,5,0,3448,3463,C
2-PB1,1072,1,4,3476,0,3481,G
2-PB1,1073,3442,0,6,0,3448,A
2-PB1,1074,0,5,3532,1,3538,G
2-PB1,1075,3461,0,2,0,3463,A
2-PB1,1076,0,0,3501,0,3501,G
2-PB1,1077,0,3458,0,2,3460,T
2-PB1,1078,3472,0,0,0,3472,A
2-PB1,1079,3496,0,5,0,3501,A
2-PB1,1080,2,5,3489,0,3496,G
2-PB1,1081,3493,0,3,0,3496,A
2-PB1,1082,1,3,3534,0,3538,G
2-PB1,1083,3475,0,1,0,3476,A
2-PB1,1084,3491,0,1,1,3493,A
2-PB1,1085,1,3469,0,1,3471,T
2-PB1,1086,0,5,3454,0,3459,G
2-PB1,1087,3453,1,2,0,3456,A
2-PB1,1088,3431,0,8,0,3439,A
2-PB1,1089,0,1,3421,0,3422,G
2-PB1,1090,0,0,0,3395,3395,C
2-PB1,1091,0,3330,1,1,3332,T
2-PB1,1092,2,0,0,3360,3362,C
2-PB1,1093,2,2,0,3386,3390,C
2-PB1,1094,1,2,3394,0,3397,G
2-PB1,1095,1,6,3415,0,3422,G
2-PB1,1096,3429,0,3,0,3432,A
2-PB1,1097,3,1,1,3453,3458,C
2-PB1,1098,3468,0,1,0,3469,A
2-PB1,1099,1,0,0,3515,3516,C
2-PB1,1100,3514,0,2,0,3516,A
2-PB1,1101,3517,0,2,0,3519,A
2-PB1,1102,3499,0,5,0,3504,A
2-PB1,1103,1,3488,0,0,3489,T
2-PB1,1104,3499,1,0,0,3500,A
2-PB1,1105,1,1,0,3474,3476,C
2-PB1,1106,0,0,0,3451,3451,C
2-PB1,1107,1,3411,0,4,3416,T
2-PB1,1108,2,3,3451,0,3456,G
2-PB1,1109,1,1,0,3472,3474,C
2-PB1,1110,3482,0,0,0,3482,A
2-PB1,1111,0,3,3476,0,3479,G
2-PB1,1112,3460,1,0,0,3461,A
2-PB1,1113,3447,1,1,0,3449,A
2-PB1,1114,3454,0,0,0,3454,A
2-PB1,1115,0,3445,0,0,3445,T
2-PB1,1116,0,0,3458,0,3458,G
2-PB1,1117,0,1,0,3423,3424,C
2-PB1,1118,0,3452,0,2,3454,T
2-PB1,1119,3481,1,1,1,3484,A
2-PB1,1120,0,1,3455,0,3456,G
2-PB1,1121,3,0,0,3450,3453,C
2-PB1,1122,3474,0,1,0,3475,A
2-PB1,1123,3465,0,4,0,3469,A
2-PB1,1124,0,1,3439,0,3440,G
2-PB1,1125,0,0,0,3418,3418,C
2-PB1,1126,3412,0,3,0,3415,A
2-PB1,1127,0,3443,0,0,3443,T
2-PB1,1128,0,3458,0,2,3460,T
2-PB1,1129,1,8,3528,0,3537,G
2-PB1,1130,3568,0,5,0,3573,A
2-PB1,1131,2,0,0,3522,3524,C
2-PB1,1132,0,0,0,3553,3553,C
2-PB1,1133,1,3518,0,4,3523,T
2-PB1,1134,0,3,3598,0,3601,G
2-PB1,1135,3600,1,0,0,3601,A
2-PB1,1136,3612,0,1,0,3613,A
2-PB1,1137,2,1,3652,1,3656,G
2-PB1,1138,0,3541,0,1,3542,T
2-PB1,1139,3584,0,0,0,3584,A
2-PB1,1140,0,3580,0,1,3581,T
2-PB1,1141,1,3563,0,0,3564,T
2-PB1,1142,0,3545,0,0,3545,T
2-PB1,1143,7,2,0,3536,3545,C
2-PB1,1144,3539,0,1,0,3540,A
2-PB1,1145,3550,0,2,0,3552,A
2-PB1,1146,0,3496,0,1,3497,T
2-PB1,1147,0,10,3505,1,3516,G
2-PB1,1148,3506,2,0,0,3508,A
2-PB1,1149,3508,0,0,0,3508,A
2-PB1,1150,0,3445,2,1,3448,T
2-PB1,1151,6,0,0,3506,3512,C
2-PB1,1152,3519,0,3,0,3522,A
2-PB1,1153,3516,0,0,0,3516,A
2-PB1,1154,0,0,0,3518,3518,C
2-PB1,1155,3514,0,1,0,3515,A
2-PB1,1156,3500,0,1,0,3501,A
2-PB1,1157,3,3,3500,0,3506,G
2-PB1,1158,0,3,3517,0,3520,G
2-PB1,1159,3502,0,0,0,3502,A
2-PB1,1160,3505,0,2,0,3507,A
2-PB1,1161,0,6,3503,0,3509,G
2-PB1,1162,3507,0,1,0,3508,A
2-PB1,1163,3511,0,1,0,3512,A
2-PB1,1164,3516,0,0,0,3516,A
2-PB1,1165,3511,0,0,0,3511,A
2-PB1,1166,0,3478,0,0,3478,T
2-PB1,1167,0,3464,0,0,3464,T
2-PB1,1168,4,5,3471,0,3480,G
2-PB1,1169,3463,0,3,0,3466,A
2-PB1,1170,1,1,3470,1,3473,G
2-PB1,1171,3471,0,0,0,3471,A
2-PB1,1172,3511,0,1,0,3512,A
2-PB1,1173,3562,0,2,0,3564,A
2-PB1,1174,3565,0,1,0,3566,A
2-PB1,1175,0,3558,0,0,3558,T
2-PB1,1176,3576,0,0,0,3576,A
2-PB1,1177,3566,1,2,1,3570,A
2-PB1,1178,0,3,3554,0,3557,G
2-PB1,1179,1,2,3538,0,3541,G
2-PB1,1180,2,1,0,3499,3502,C
2-PB1,1181,2,0,0,3497,3499,C
2-PB1,1182,1,3429,0,4,3434,T
2-PB1,1183,4,1,0,3843,3848,C
2-PB1,1184,0,3897,0,1,3898,T
2-PB1,1185,1,3893,0,1,3895,T
2-PB1,1186,3,0,0,4010,4013,C
2-PB1,1187,0,3999,0,3,4002,T
2-PB1,1188,4042,0,0,0,4042,A
2-PB1,1189,4036,0,1,0,4037,A
2-PB1,1190,0,4024,0,0,4024,T
2-PB1,1191,4056,0,0,0,4056,A
2-PB1,1192,1,5,3963,0,3969,G
2-PB1,1193,3708,0,2,0,3710,A
2-PB1,1194,1,3704,0,0,3705,T
2-PB1,1195,0,4,3654,0,3658,G
2-PB1,1196,5,0,3645,0,3650,G
2-PB1,1197,1,2,0,3664,3667,C
2-PB1,1198,3681,0,1,0,3682,A
2-PB1,1199,1,0,0,3689,3690,C
2-PB1,1200,3658,0,4,0,3662,A
2-PB1,1201,1,0,3773,0,3774,G
2-PB1,1202,0,1,0,3751,3752,C
2-PB1,1203,3785,0,0,0,3785,A
2-PB1,1204,0,3860,0,1,3861,T
2-PB1,1205,8,4,0,3792,3804,C
2-PB1,1206,3835,1,0,0,3836,A
2-PB1,1207,0,3820,0,1,3821,T
2-PB1,1208,1,3811,0,1,3813,T
2-PB1,1209,2,5,3807,0,3814,G
2-PB1,1210,3676,0,4,0,3680,A
2-PB1,1211,1,0,3747,0,3748,G
2-PB1,1212,1,1,0,3718,3720,C
2-PB1,1213,7,0,0,3658,3665,C
2-PB1,1214,2,1,0,3747,3750,C
2-PB1,1215,0,3738,0,4,3742,T
2-PB1,1216,0,5,3957,0,3962,G
2-PB1,1217,0,5,4001,0,4006,G
2-PB1,1218,3978,1,5,0,3984,A
2-PB1,1219,4084,0,1,0,4085,A
2-PB1,1220,0,3997,0,1,3998,T
2-PB1,1221,1,9,4064,1,4075,G
2-PB1,1222,4111,0,5,0,4116,A
2-PB1,1223,0,4133,0,0,4133,T
2-PB1,1224,0,5,4130,0,4135,G
2-PB1,1225,4102,0,2,2,4106,A
2-PB1,1226,0,4062,0,0,4062,T
2-PB1,1227,0,6,4055,0,4061,G
2-PB1,1228,1,5,4072,0,4078,G
2-PB1,1229,1,3,4057,0,4061,G
2-PB1,1230,1,1,0,4061,4063,C
2-PB1,1231,4118,0,0,0,4118,A
2-PB1,1232,0,4141,0,1,4142,T
2-PB1,1233,0,1,4249,0,4250,G
2-PB1,1234,0,4236,0,9,4245,T
2-PB1,1235,0,4260,0,2,4262,T
2-PB1,1236,9,0,0,4270,4279,C
2-PB1,1237,4259,0,2,0,4261,A
2-PB1,1238,4256,1,6,0,4263,A
2-PB1,1239,1,2,0,4261,4264,C
2-PB1,1240,4285,0,1,0,4286,A
2-PB1,1241,0,4240,0,1,4241,T
2-PB1,1242,0,1,4268,0,4269,G
2-PB1,1243,1,3,0,4247,4251,C
2-PB1,1244,0,4300,0,0,4300,T
2-PB1,1245,4338,0,5,0,4343,A
2-PB1,1246,4325,1,1,1,4328,A
2-PB1,1247,1,1,4393,0,4395,G
2-PB1,1248,0,4370,0,0,4370,T
2-PB1,1249,4373,0,1,0,4374,A
2-PB1,1250,2,0,0,4416,4418,C
2-PB1,1251,3,2,4412,1,4418,G
2-PB1,1252,1,1,4600,0,4602,G
2-PB1,1253,0,4552,0,0,4552,T
2-PB1,1254,0,4543,1,2,4546,T
2-PB1,1255,0,4569,0,0,4569,T
2-PB1,1256,0,4567,0,1,4568,T
2-PB1,1257,4571,0,6,0,4577,A
2-PB1,1258,0,5,4547,0,4552,G
2-PB1,1259,0,7,4518,0,4525,G
2-PB1,1260,4471,1,5,0,4477,A
2-PB1,1261,0,2,4449,0,4451,G
2-PB1,1262,0,4472,0,11,4483,T
2-PB1,1263,5,0,0,4473,4478,C
2-PB1,1264,0,4483,0,3,4486,T
2-PB1,1265,5,0,0,4504,4509,C
2-PB1,1266,1,7,4529,0,4537,G
2-PB1,1267,4609,0,0,0,4609,A
2-PB1,1268,0,4626,0,3,4629,T
2-PB1,1269,4653,0,0,1,4654,A
2-PB1,1270,1,0,0,4661,4662,C
2-PB1,1271,2,4601,0,9,4612,T
2-PB1,1272,0,5,4638,0,4643,G
2-PB1,1273,4620,0,0,1,4621,A
2-PB1,1274,4650,0,0,0,4650,A
2-PB1,1275,0,4661,1,1,4663,T
2-PB1,1276,5,0,0,4590,4595,C
2-PB1,1277,0,4573,1,1,4575,T
2-PB1,1278,0,4580,1,1,4582,T
2-PB1,1279,5,7,4573,1,4586,G
2-PB1,1280,0,9,4559,0,4568,G
2-PB1,1281,4524,0,8,0,4532,A
2-PB1,1282,0,0,0,4580,4580,C
2-PB1,1283,4547,0,1,0,4548,A
2-PB1,1284,4555,0,0,1,4556,A
2-PB1,1285,4530,0,7,0,4537,A
2-PB1,1286,4559,0,4,1,4564,A
2-PB1,1287,1,3,4627,2,4633,G
2-PB1,1288,4651,1,1,0,4653,A
2-PB1,1289,4656,0,1,1,4658,A
2-PB1,1290,4652,0,1,0,4653,A
2-PB1,1291,0,4633,1,1,4635,T
2-PB1,1292,4657,0,1,0,4658,A
2-PB1,1293,1,2,0,4784,4787,C
2-PB1,1294,4710,1,4,0,4715,A
2-PB1,1295,2,0,0,4761,4763,C
2-PB1,1296,5,3,0,4722,4730,C
2-PB1,1297,4717,1,1,0,4719,A
2-PB1,1298,4764,0,0,0,4764,A
2-PB1,1299,1,10,4855,2,4868,G
2-PB1,1300,4901,0,7,0,4908,A
2-PB1,1301,1,0,0,4996,4997,C
2-PB1,1302,4911,0,2,0,4913,A
2-PB1,1303,5026,0,4,1,5031,A
2-PB1,1304,1,1,0,5061,5063,C
2-PB1,1305,5100,0,0,0,5100,A
2-PB1,1306,0,5106,0,0,5106,T
2-PB1,1307,5060,1,1,1,5063,A
2-PB1,1308,1,0,0,5124,5125,C
2-PB1,1309,0,4963,0,2,4965,T
2-PB1,1310,1,3,5061,0,5065,G
2-PB1,1311,0,1,5041,0,5042,G
2-PB1,1312,1,4896,0,4,4901,T
2-PB1,1313,1,2,4950,0,4953,G
2-PB1,1314,1,3,4891,0,4895,G
2-PB1,1315,6,6,4893,0,4905,G
2-PB1,1316,4901,1,2,0,4904,A
2-PB1,1317,1,4860,0,1,4862,T
2-PB1,1318,1,7,4835,0,4843,G
2-PB1,1319,1,1,4793,1,4796,G
2-PB1,1320,4,1,4818,0,4823,G
2-PB1,1321,1,3,0,4895,4899,C
2-PB1,1322,1,4852,0,14,4867,T
2-PB1,1323,7,2,0,4924,4933,C
2-PB1,1324,1,1,0,4951,4953,C
2-PB1,1325,4971,0,2,0,4973,A
2-PB1,1326,4942,1,0,1,4944,A
2-PB1,1327,0,4885,1,0,4886,T
2-PB1,1328,9,0,0,4894,4903,C
2-PB1,1329,7,2,0,4860,4869,C
2-PB1,1330,0,4849,0,2,4851,T
2-PB1,1331,5,0,0,4821,4826,C
2-PB1,1332,7,0,0,4821,4828,C
2-PB1,1333,3,4,4858,5,4870,G
2-PB1,1334,4841,0,1,1,4843,A
2-PB1,1335,0,2,0,4857,4859,C
2-PB1,1336,0,8,4889,0,4897,G
2-PB1,1337,4869,0,0,1,4870,A
2-PB1,1338,0,4878,0,2,4880,T
2-PB1,1339,0,4874,0,0,4874,T
2-PB1,1340,0,4866,0,3,4869,T
2-PB1,1341,0,4897,0,2,4899,T
2-PB1,1342,1,1,4894,0,4896,G
2-PB1,1343,0,4,0,4875,4879,C
2-PB1,1344,4,0,0,4851,4855,C
2-PB1,1345,6,2,0,5009,5017,C
2-PB1,1346,2,4993,0,6,5001,T
2-PB1,1347,4,1,0,5153,5158,C
2-PB1,1348,5194,2,1,0,5197,A
2-PB1,1349,1,5218,0,4,5223,T
2-PB1,1350,5224,0,2,0,5226,A
2-PB1,1351,1,2,5333,1,5337,G
2-PB1,1352,1,5255,0,2,5258,T
2-PB1,1353,0,8,5298,0,5306,G
2-PB1,1354,5187,1,0,0,5188,A
2-PB1,1355,5178,0,2,0,5180,A
2-PB1,1356,0,5028,0,0,5028,T
2-PB1,1357,0,3,5001,0,5004,G
2-PB1,1358,2,2,0,5023,5027,C
2-PB1,1359,5004,0,4,0,5008,A
2-PB1,1360,2,2,0,5029,5033,C
2-PB1,1361,5,2,0,4977,4984,C
2-PB1,1362,4947,1,0,0,4948,A
2-PB1,1363,4931,0,0,0,4931,A
2-PB1,1364,4932,0,1,0,4933,A
2-PB1,1365,1,4845,0,1,4847,T
2-PB1,1366,10,0,0,5009,5019,C
2-PB1,1367,5015,0,0,0,5015,A
2-PB1,1368,1,5014,0,1,5016,T
2-PB1,1369,1,8,5032,0,5041,G
2-PB1,1370,5023,2,5,1,5031,A
2-PB1,1371,1,2,5080,0,5083,G
2-PB1,1372,4,3,5059,0,5066,G
2-PB1,1373,4,10,5072,0,5086,G
2-PB1,1374,5058,0,4,0,5062,A
2-PB1,1375,5139,0,3,0,5142,A
2-PB1,1376,0,5158,0,0,5158,T
2-PB1,1377,5143,1,3,1,5148,A
2-PB1,1378,1,0,0,5170,5171,C
2-PB1,1379,5180,0,0,0,5180,A
2-PB1,1380,5150,0,8,1,5159,A
2-PB1,1381,0,0,5137,0,5137,G
2-PB1,1382,0,1,0,5105,5106,C
2-PB1,1383,5109,0,1,1,5111,A
2-PB1,1384,0,3,5115,0,5118,G
2-PB1,1385,0,8,5121,0,5129,G
2-PB1,1386,5059,0,2,0,5061,A
2-PB1,1387,1,6,5141,0,5148,G
2-PB1,1388,0,5056,0,2,5058,T
2-PB1,1389,0,9,5111,0,5120,G
2-PB1,1390,1,2,5132,0,5135,G
2-PB1,1391,5117,1,6,0,5124,A
2-PB1,1392,2,5122,1,10,5135,T
2-PB1,1393,5084,0,0,0,5084,A
2-PB1,1394,0,9,5106,0,5115,G
2-PB1,1395,5151,0,0,0,5151,A
2-PB1,1396,0,5140,0,1,5141,T
2-PB1,1397,1,5123,0,0,5124,T
2-PB1,1398,9,0,0,5197,5206,C
2-PB1,1399,0,5192,0,1,5193,T
2-PB1,1400,5213,2,1,0,5216,A
2-PB1,1401,1,1,0,5192,5194,C
2-PB1,1402,5109,1,6,0,5116,A
2-PB1,1403,13,5,5055,1,5074,G
2-PB1,1404,0,12,4981,0,4993,G
2-PB1,1405,5037,1,9,0,5047,A
2-PB1,1406,4,0,0,4982,4986,C
2-PB1,1407,4,0,0,4950,4954,C
2-PB1,1408,2,4928,0,8,4938,T
2-PB1,1409,3,1,4927,1,4932,G
2-PB1,1410,2,0,0,4944,4946,C
2-PB1,1411,4996,0,1,1,4998,A
2-PB1,1412,4997,0,1,0,4998,A
2-PB1,1413,1,1,5005,0,5007,G
2-PB1,1414,0,4933,0,2,4935,T
2-PB1,1415,1,4955,0,1,4957,T
2-PB1,1416,4891,0,2,0,4893,A
2-PB1,1417,0,0,4893,0,4893,G
2-PB1,1418,0,4842,0,4,4846,T
2-PB1,1419,1,2,4845,0,4848,G
2-PB1,1420,1,3,4833,0,4837,G
2-PB1,1421,0,10,4870,0,4880,G
2-PB1,1422,4851,3,1,0,4855,A
2-PB1,1423,4866,0,1,0,4867,A
2-PB1,1424,0,4845,0,0,4845,T
2-PB1,1425,10,1,0,4846,4857,C
2-PB1,1426,4871,0,4,0,4875,A
2-PB1,1427,4874,2,1,0,4877,A
2-PB1,1428,1,0,0,4855,4856,C
2-PB1,1429,4869,0,2,0,4871,A
2-PB1,1430,0,4776,0,0,4776,T
2-PB1,1431,0,8,4771,0,4779,G
2-PB1,1432,4752,0,7,0,4759,A
2-PB1,1433,2,2,4763,0,4767,G
2-PB1,1434,0,0,0,4761,4761,C
2-PB1,1435,4775,0,2,0,4777,A
2-PB1,1436,4776,0,0,0,4776,A
2-PB1,1437,4772,0,0,0,4772,A
2-PB1,1438,4816,0,1,0,4817,A
2-PB1,1439,4805,0,3,0,4808,A
2-PB1,1440,2,2,4781,0,4785,G
2-PB1,1441,4744,0,0,0,4744,A
2-PB1,1442,4708,1,4,0,4713,A
2-PB1,1443,0,3,4815,0,4818,G
2-PB1,1444,1,4785,0,4,4790,T
2-PB1,1445,10,0,0,4775,4785,C
2-PB1,1446,5,0,0,4845,4850,C
2-PB1,1447,0,4833,0,3,4836,T
2-PB1,1448,4909,0,0,1,4910,A
2-PB1,1449,0,4884,0,7,4891,T
2-PB1,1450,4891,0,1,0,4892,A
2-PB1,1451,0,4896,0,1,4897,T
2-PB1,1452,4820,0,0,0,4820,A
2-PB1,1453,4834,0,2,0,4836,A
2-PB1,1454,4817,0,0,0,4817,A
2-PB1,1455,0,4802,0,7,4809,T
2-PB1,1456,4785,0,0,0,4785,A
2-PB1,1457,4780,0,1,0,4781,A
2-PB1,1458,4800,0,0,0,4800,A
2-PB1,1459,4756,1,3,0,4760,A
2-PB1,1460,0,1,0,4802,4803,C
2-PB1,1461,4603,2,1,0,4606,A
2-PB1,1462,1,3,4612,0,4616,G
2-PB1,1463,1,6,4607,0,4614,G
2-PB1,1464,2,5,4596,0,4603,G
2-PB1,1465,4565,0,6,0,4571,A
2-PB1,1466,2,3,0,4639,4644,C
2-PB1,1467,4607,0,0,0,4607,A
2-PB1,1468,0,4618,3,2,4623,T
2-PB1,1469,0,4627,0,2,4629,T
2-PB1,1470,1,4638,0,2,4641,T
2-PB1,1471,0,10,4615,0,4625,G
2-PB1,1472,4579,0,0,0,4579,A
2-PB1,1473,4610,0,2,0,4612,A
2-PB1,1474,0,4588,0,1,4589,T
2-PB1,1475,0,4503,0,2,4505,T
2-PB1,1476,12,1,0,4537,4550,C
2-PB1,1477,4474,0,2,0,4476,A
2-PB1,1478,0,0,0,4508,4508,C
2-PB1,1479,0,4500,0,0,4500,T
2-PB1,1480,4532,0,1,0,4533,A
2-PB1,1481,1,0,4487,0,4488,G
2-PB1,1482,2,1,0,4476,4479,C
2-PB1,1483,0,4442,0,12,4454,T
2-PB1,1484,0,4503,0,0,4503,T
2-PB1,1485,0,4493,0,0,4493,T
2-PB1,1486,4,4504,0,0,4508,T
2-PB1,1487,0,4511,0,0,4511,T
2-PB1,1488,0,4515,0,0,4515,T
2-PB1,1489,0,4508,0,0,4508,T
2-PB1,1490,4479,2,1,0,4482,A
2-PB1,1491,0,4446,0,1,4447,T
2-PB1,1492,7,1,0,4472,4480,C
2-PB1,1493,1,7,4507,0,4515,G
2-PB1,1494,4586,0,1,0,4587,A
2-PB1,1495,1,4591,1,0,4593,T
2-PB1,1496,4601,1,0,0,4602,A
2-PB1,1497,0,4653,0,3,4656,T
2-PB1,1498,3,7,4603,0,4613,G
2-PB1,1499,0,7,4615,0,4622,G
2-PB1,1500,4666,0,2,0,4668,A
2-PB1,1501,0,4577,0,0,4577,T
2-PB1,1502,0,4604,0,1,4605,T
2-PB1,1503,0,4492,0,0,4492,T
2-PB1,1504,6,1,4500,0,4507,G
2-PB1,1505,1,4458,0,1,4460,T
2-PB1,1506,0,2,4454,0,4456,G
2-PB1,1507,1,1,4416,1,4419,G
2-PB1,1508,4,1,0,4351,4356,C
2-PB1,1509,0,4466,2,1,4469,T
2-PB1,1510,4490,0,1,0,4491,A
2-PB1,1511,4503,0,0,0,4503,A
2-PB1,1512,0,4491,1,0,4492,T
2-PB1,1513,0,4514,1,0,4515,T
2-PB1,1514,0,4516,5,0,4521,T
2-PB1,1515,0,4532,1,2,4535,T
2-PB1,1516,4532,0,3,0,4535,A
2-PB1,1517,0,0,4542,0,4542,G
2-PB1,1518,2,2,0,4556,4560,C
2-PB1,1519,4564,0,1,0,4565,A
2-PB1,1520,1,4531,2,0,4534,T
2-PB1,1521,3,7,4465,1,4476,G
2-PB1,1522,0,6,4509,0,4515,G
2-PB1,1523,4485,1,1,1,4488,A
2-PB1,1524,1,0,4449,0,4450,G
2-PB1,1525,0,0,0,4401,4401,C
2-PB1,1526,2,4439,1,0,4442,T
2-PB1,1527,5,2,4431,0,4438,G
2-PB1,1528,5,1,0,4319,4325,C
2-PB1,1529,2,1,0,4337,4340,C
2-PB1,1530,6,2,0,4431,4439,C
2-PB1,1531,4382,0,0,0,4382,A
2-PB1,1532,0,4,4514,0,4518,G
2-PB1,1533,0,4530,1,1,4532,T
2-PB1,1534,0,4509,1,2,4512,T
2-PB1,1535,0,4508,1,0,4509,T
2-PB1,1536,0,4456,1,4,4461,T
2-PB1,1537,3,2,4471,1,4477,G
2-PB1,1538,1,5,4454,0,4460,G
2-PB1,1539,4469,1,5,0,4475,A
2-PB1,1540,3,2,4466,0,4471,G
2-PB1,1541,0,4297,1,1,4299,T
2-PB1,1542,4288,0,1,0,4289,A
2-PB1,1543,0,4314,1,1,4316,T
2-PB1,1544,3,0,0,4364,4367,C
2-PB1,1545,0,4373,1,1,4375,T
2-PB1,1546,3,2,4380,0,4385,G
2-PB1,1547,1,7,4401,0,4409,G
2-PB1,1548,4431,1,0,0,4432,A
2-PB1,1549,4439,0,3,0,4442,A
2-PB1,1550,1,4394,0,1,4396,T
2-PB1,1551,4300,0,0,0,4300,A
2-PB1,1552,4301,0,2,0,4303,A
2-PB1,1553,4292,0,0,0,4292,A
2-PB1,1554,0,0,0,4301,4301,C
2-PB1,1555,1,10,4242,1,4254,G
2-PB1,1556,4190,0,1,0,4191,A
2-PB1,1557,0,0,4165,0,4165,G
2-PB1,1558,2,4134,1,3,4140,T
2-PB1,1559,7,1,0,4182,4190,C
2-PB1,1560,4204,0,4,0,4208,A
2-PB1,1561,1,1,4231,0,4233,G
2-PB1,1562,2,2,0,4241,4245,C
2-PB1,1563,0,4245,0,3,4248,T
2-PB1,1564,2,5,4362,0,4369,G
2-PB1,1565,4324,0,4,0,4328,A
2-PB1,1566,0,4336,0,1,4337,T
2-PB1,1567,4344,1,0,0,4345,A
2-PB1,1568,1,4292,0,2,4295,T
2-PB1,1569,0,3,4353,0,4356,G
2-PB1,1570,4133,0,4,1,4138,A
2-PB1,1571,0,1,4153,0,4154,G
2-PB1,1572,0,3889,0,0,3889,T
2-PB1,1573,4020,0,0,0,4020,A
2-PB1,1574,0,4008,0,1,4009,T
2-PB1,1575,1,4011,0,1,4013,T
2-PB1,1576,0,2,4033,0,4035,G
2-PB1,1577,1,3,4108,0,4112,G
2-PB1,1578,3944,0,4,0,3948,A
2-PB1,1579,1,2,3970,0,3973,G
2-PB1,1580,0,3738,0,1,3739,T
2-PB1,1581,3746,0,3,0,3749,A
2-PB1,1582,3744,1,2,0,3747,A
2-PB1,1583,0,5,0,3757,3762,C
2-PB1,1584,3760,0,1,0,3761,A
2-PB1,1585,0,0,3800,0,3800,G
2-PB1,1586,0,3492,2,1,3495,T
2-PB1,1587,2,7,3529,0,3538,G
2-PB1,1588,3550,0,5,0,3555,A
2-PB1,1589,0,3556,1,1,3558,T
2-PB1,1590,3548,0,0,0,3548,A
2-PB1,1591,3570,0,0,0,3570,A
2-PB1,1592,3447,1,2,0,3450,A
2-PB1,1593,0,6,3461,0,3467,G
2-PB1,1594,3329,1,2,0,3332,A
2-PB1,1595,3322,0,1,0,3323,A
2-PB1,1596,0,2,0,3329,3331,C
2-PB1,1597,3232,0,1,0,3233,A
2-PB1,1598,3252,0,5,0,3257,A
2-PB1,1599,0,0,0,3254,3254,C
2-PB1,1600,3281,0,0,0,3281,A
2-PB1,1601,0,3258,5,2,3265,T
2-PB1,1602,1,2,3224,0,3227,G
2-PB1,1603,3220,1,4,0,3225,A
2-PB1,1604,0,3203,0,0,3203,T
2-PB1,1605,3192,0,1,0,3193,A
2-PB1,1606,3207,0,0,0,3207,A
2-PB1,1607,3187,0,3,1,3191,A
2-PB1,1608,1,2,0,3201,3204,C
2-PB1,1609,3082,0,1,0,3083,A
2-PB1,1610,3070,0,1,0,3071,A
2-PB1,1611,0,2971,0,1,2972,T
2-PB1,1612,0,6,2995,0,3001,G
2-PB1,1613,3025,0,2,0,3027,A
2-PB1,1614,2,0,0,3047,3049,C
2-PB1,1615,3,1,0,3001,3005,C
2-PB1,1616,0,2925,0,1,2926,T
2-PB1,1617,0,2879,0,1,2880,T
2-PB1,1618,0,4,2890,0,2894,G
2-PB1,1619,0,2,2892,0,2894,G
2-PB1,1620,2906,0,6,0,2912,A
2-PB1,1621,0,0,0,2906,2906,C
2-PB1,1622,2,1,0,2892,2895,C
2-PB1,1623,2875,0,2,0,2877,A
2-PB1,1624,0,2,2901,0,2903,G
2-PB1,1625,1,1,0,2913,2915,C
2-PB1,1626,2930,0,1,0,2931,A
2-PB1,1627,2913,0,3,1,2917,A
2-PB1,1628,1,1,0,2906,2908,C
2-PB1,1629,2895,0,0,0,2895,A
2-PB1,1630,1,1,2921,0,2923,G
2-PB1,1631,0,1,0,2906,2907,C
2-PB1,1632,2,1,0,2919,2922,C
2-PB1,1633,5,1,0,2924,2930,C
2-PB1,1634,2951,0,0,0,2951,A
2-PB1,1635,2946,0,1,0,2947,A
2-PB1,1636,2953,0,0,0,2953,A
2-PB1,1637,0,2927,0,1,2928,T
2-PB1,1638,2,2,2927,0,2931,G
2-PB1,1639,1,1,2847,0,2849,G
2-PB1,1640,0,3,0,2860,2863,C
2-PB1,1641,3,2855,0,2,2860,T
2-PB1,1642,3,0,0,2912,2915,C
2-PB1,1643,1,2895,0,6,2902,T
2-PB1,1644,3,0,0,2926,2929,C
2-PB1,1645,5,2,0,2959,2966,C
2-PB1,1646,2977,0,1,1,2979,A
2-PB1,1647,2971,0,0,0,2971,A
2-PB1,1648,1,2939,0,2,2942,T
2-PB1,1649,0,2944,0,0,2944,T
2-PB1,1650,0,2,2959,0,2961,G
2-PB1,1651,0,2893,0,2,2895,T
2-PB1,1652,0,2902,0,1,2903,T
2-PB1,1653,5,6,1,2913,2925,C
2-PB1,1654,2927,0,0,0,2927,A
2-PB1,1655,1,2896,0,2,2899,T
2-PB1,1656,1,1,0,2921,2923,C
2-PB1,1657,2938,0,1,0,2939,A
2-PB1,1658,2934,0,0,1,2935,A
2-PB1,1659,2928,0,2,0,2930,A
2-PB1,1660,0,4,3012,0,3016,G
2-PB1,1661,3004,0,0,0,3004,A
2-PB1,1662,0,2999,0,1,3000,T
2-PB1,1663,0,3010,0,1,3011,T
2-PB1,1664,3017,0,0,0,3017,A
2-PB1,1665,0,0,0,3063,3063,C
2-PB1,1666,3059,0,7,0,3066,A
2-PB1,1667,0,5,3090,0,3095,G
2-PB1,1668,3079,0,2,0,3081,A
2-PB1,1669,0,3171,0,0,3171,T
2-PB1,1670,3178,1,0,0,3179,A
2-PB1,1671,1,2,0,3328,3331,C
2-PB1,1672,3392,1,7,0,3400,A
2-PB1,1673,2,0,0,3601,3603,C
2-PB1,1674,3584,0,0,0,3584,A
2-PB1,1675,0,3599,0,0,3599,T
2-PB1,1676,3592,0,0,0,3592,A
2-PB1,1677,0,3563,0,0,3563,T
2-PB1,1678,3503,1,2,0,3506,A
2-PB1,1679,0,1,3473,0,3474,G
2-PB1,1680,0,4,3441,0,3445,G
2-PB1,1681,0,3266,0,3,3269,T
2-PB1,1682,2,5,3286,0,3293,G
2-PB1,1683,1,1,0,3341,3343,C
2-PB1,1684,4,1,0,3394,3399,C
2-PB1,1685,3448,0,1,0,3449,A
2-PB1,1686,0,3441,0,7,3448,T
2-PB1,1687,3452,1,2,0,3455,A
2-PB1,1688,0,2,3460,0,3462,G
2-PB1,1689,3402,0,2,0,3404,A
2-PB1,1690,1,0,3420,0,3421,G
2-PB1,1691,0,11,3375,0,3386,G
2-PB1,1692,3278,0,6,1,3285,A
2-PB1,1693,13,8,3277,0,3298,G
2-PB1,1694,3257,1,8,0,3266,A
2-PB1,1695,1,0,0,3289,3290,C
2-PB1,1696,3273,0,3,0,3276,A
2-PB1,1697,2,0,0,3330,3332,C
2-PB1,1698,3324,0,3,0,3327,A
2-PB1,1699,1,0,0,3338,3339,C
2-PB1,1700,3328,0,0,0,3328,A
2-PB1,1701,3338,0,0,0,3338,A
2-PB1,1702,3340,0,1,0,3341,A
2-PB1,1703,0,3306,1,1,3308,T
2-PB1,1704,5,0,0,3317,3322,C
2-PB1,1705,3,0,0,3330,3333,C
2-PB1,1706,3315,0,5,0,3320,A
2-PB1,1707,0,2,3319,0,3321,G
2-PB1,1708,3320,0,4,0,3324,A
2-PB1,1709,0,1,0,3332,3333,C
2-PB1,1710,1,8,3328,0,3337,G
2-PB1,1711,3290,1,0,0,3291,A
2-PB1,1712,9,2,3298,0,3309,G
2-PB1,1713,3303,0,0,0,3303,A
2-PB1,1714,3308,0,1,0,3309,A
2-PB1,1715,0,4,3315,0,3319,G
2-PB1,1716,3303,0,2,1,3306,A
2-PB1,1717,0,3302,1,1,3304,T
2-PB1,1718,6,0,0,3289,3295,C
2-PB1,1719,3306,0,0,0,3306,A
2-PB1,1720,0,3276,0,0,3276,T
2-PB1,1721,0,3268,0,0,3268,T
2-PB1,1722,4,3,0,3288,3295,C
2-PB1,1723,0,4,3306,1,3311,G
2-PB1,1724,3275,0,2,0,3277,A
2-PB1,1725,1,2,3291,1,3295,G
2-PB1,1726,3261,0,2,0,3263,A
2-PB1,1727,0,3368,0,0,3368,T
2-PB1,1728,3367,0,2,0,3369,A
2-PB1,1729,3379,0,0,0,3379,A
2-PB1,1730,3366,0,2,1,3369,A
2-PB1,1731,1,0,3372,0,3373,G
2-PB1,1732,3385,0,0,1,3386,A
2-PB1,1733,3323,0,0,0,3323,A
2-PB1,1734,0,0,3328,0,3328,G
2-PB1,1735,0,0,0,3322,3322,C
2-PB1,1736,0,3304,0,1,3305,T
2-PB1,1737,0,0,3332,0,3332,G
2-PB1,1738,1,3293,0,2,3296,T
2-PB1,1739,0,2,3302,0,3304,G
2-PB1,1740,2,4,3287,1,3294,G
2-PB1,1741,0,5,3322,0,3327,G
2-PB1,1742,3347,1,1,1,3350,A
2-PB1,1743,1,3329,0,0,3330,T
2-PB1,1744,9,14,0,3282,3305,C
2-PB1,1745,3340,1,0,0,3341,A
2-PB1,1746,3341,0,0,1,3342,A
2-PB1,1747,3349,1,1,0,3351,A
2-PB1,1748,0,0,0,3357,3357,C
2-PB1,1749,3,0,1,3326,3330,C
2-PB1,1750,2,1,0,3327,3330,C
2-PB1,1751,3356,0,1,0,3357,A
2-PB1,1752,3381,0,0,0,3381,A
2-PB1,1753,0,3346,0,0,3346,T
2-PB1,1754,5,1,0,3377,3383,C
2-PB1,1755,3363,0,0,0,3363,A
2-PB1,1756,3342,0,1,0,3343,A
2-PB1,1757,0,3,3365,0,3368,G
2-PB1,1758,0,3,3335,0,3338,G
2-PB1,1759,1,3,3336,0,3340,G
2-PB1,1760,1,1,0,3359,3361,C
2-PB1,1761,3361,0,0,0,3361,A
2-PB1,1762,0,5,3402,0,3407,G
2-PB1,1763,0,1,3460,0,3461,G
2-PB1,1764,3456,0,4,0,3460,A
2-PB1,1765,2,0,0,3508,3510,C
2-PB1,1766,0,3486,0,0,3486,T
2-PB1,1767,3568,0,0,0,3568,A
2-PB1,1768,0,3558,0,1,3559,T
2-PB1,1769,0,3575,0,2,3577,T
2-PB1,1770,1,4,3574,0,3579,G
2-PB1,1771,0,0,3572,0,3572,G
2-PB1,1772,0,3505,0,3,3508,T
2-PB1,1773,3547,0,0,0,3547,A
2-PB1,1774,0,3494,1,2,3497,T
2-PB1,1775,5,0,0,3529,3534,C
2-PB1,1776,3484,0,0,1,3485,A
2-PB1,1777,1,5,3513,0,3519,G
2-PB1,1778,3482,0,1,0,3483,A
2-PB1,1779,0,3494,0,0,3494,T
2-PB1,1780,0,5,3411,0,3416,G
2-PB1,1781,0,4,3412,0,3416,G
2-PB1,1782,0,5,3405,0,3410,G
2-PB1,1783,1,4,3408,0,3413,G
2-PB1,1784,0,5,3425,0,3430,G
2-PB1,1785,3372,1,7,0,3380,A
2-PB1,1786,2,2,0,3384,3388,C
2-PB1,1787,6,0,0,3387,3393,C
2-PB1,1788,3417,0,1,0,3418,A
2-PB1,1789,3618,0,0,0,3618,A
2-PB1,1790,3609,1,2,1,3613,A
2-PB1,1791,0,0,0,3690,3690,C
2-PB1,1792,0,3667,0,1,3668,T
2-PB1,1793,0,3669,0,1,3670,T
2-PB1,1794,3696,1,0,0,3697,A
2-PB1,1795,0,3687,0,1,3688,T
2-PB1,1796,3679,0,0,0,3679,A
2-PB1,1797,1,0,0,3705,3706,C
2-PB1,1798,3493,0,2,0,3495,A
2-PB1,1799,3493,1,3,0,3497,A
2-PB1,1800,0,3426,0,3,3429,T
2-PB1,1801,3478,0,0,1,3479,A
2-PB1,1802,0,3451,1,0,3452,T
2-PB1,1803,5,0,0,3443,3448,C
2-PB1,1804,4,0,0,3447,3451,C
2-PB1,1805,0,4,3468,0,3472,G
2-PB1,1806,1,8,3456,0,3465,G
2-PB1,1807,3457,0,0,0,3457,A
2-PB1,1808,3475,0,0,0,3475,A
2-PB1,1809,0,3471,0,0,3471,T
2-PB1,1810,3,0,0,3485,3488,C
2-PB1,1811,0,3475,0,0,3475,T
2-PB1,1812,0,3488,0,2,3490,T
2-PB1,1813,3,0,0,3486,3489,C
2-PB1,1814,3489,0,1,0,3490,A
2-PB1,1815,0,2,0,3495,3497,C
2-PB1,1816,3504,0,0,1,3505,A
2-PB1,1817,0,3613,0,0,3613,T
2-PB1,1818,5,0,0,3631,3636,C
2-PB1,1819,5,0,0,3603,3608,C
2-PB1,1820,1,4,0,3629,3634,C
2-PB1,1821,1,3628,1,3,3633,T
2-PB1,1822,1,1,3647,0,3649,G
2-PB1,1823,3632,0,0,0,3632,A
2-PB1,1824,3629,0,0,0,3629,A
2-PB1,1825,1,1,3646,0,3648,G
2-PB1,1826,0,3461,0,3,3464,T
2-PB1,1827,4,9,0,3483,3496,C
2-PB1,1828,0,3440,0,1,3441,T
2-PB1,1829,1,0,3516,0,3517,G
2-PB1,1830,1,0,0,3507,3508,C
2-PB1,1831,0,3511,1,3,3515,T
2-PB1,1832,0,3521,0,1,3522,T
2-PB1,1833,3513,0,0,1,3514,A
2-PB1,1834,3528,1,0,0,3529,A
2-PB1,1835,3515,0,1,0,3516,A
2-PB1,1836,0,1,3540,0,3541,G
2-PB1,1837,1,3477,0,0,3478,T
2-PB1,1838,2,4,3441,0,3447,G
2-PB1,1839,2,4,3414,0,3420,G
2-PB1,1840,0,4,3420,0,3424,G
2-PB1,1841,3445,0,2,0,3447,A
2-PB1,1842,1,0,3445,0,3446,G
2-PB1,1843,4,4,0,3410,3418,C
2-PB1,1844,0,3429,0,11,3440,T
2-PB1,1845,0,3,3431,0,3434,G
2-PB1,1846,3396,1,2,0,3399,A
2-PB1,1847,0,3437,0,0,3437,T
2-PB1,1848,1,3,3435,0,3439,G
2-PB1,1849,0,2,3434,0,3436,G
2-PB1,1850,3409,0,3,0,3412,A
2-PB1,1851,0,3420,0,1,3421,T
2-PB1,1852,0,8,3414,0,3422,G
2-PB1,1853,3385,0,1,0,3386,A
2-PB1,1854,0,8,3402,0,3410,G
2-PB1,1855,3433,0,1,0,3434,A
2-PB1,1856,3424,0,1,0,3425,A
2-PB1,1857,0,3405,0,0,3405,T
2-PB1,1858,0,3382,0,0,3382,T
2-PB1,1859,3398,0,0,0,3398,A
2-PB1,1860,0,3364,0,1,3365,T
2-PB1,1861,5,3,0,3379,3387,C
2-PB1,1862,4,5,3373,0,3382,G
2-PB1,1863,1,5,3321,0,3327,G
2-PB1,1864,2,3,3321,1,3327,G
2-PB1,1865,1,2,3341,0,3344,G
2-PB1,1866,3342,0,1,0,3343,A
2-PB1,1867,3350,0,3,0,3353,A
2-PB1,1868,0,5,3364,0,3369,G
2-PB1,1869,3367,0,4,0,3371,A
2-PB1,1870,8,0,0,3365,3373,C
2-PB1,1871,0,3357,0,0,3357,T
2-PB1,1872,0,3423,0,0,3423,T
2-PB1,1873,0,3426,0,0,3426,T
2-PB1,1874,2,4,3421,0,3427,G
2-PB1,1875,0,3437,0,4,3441,T
2-PB1,1876,3430,0,2,0,3432,A
2-PB1,1877,3404,0,2,1,3407,A
2-PB1,1878,0,3335,1,1,3337,T
2-PB1,1879,2,0,0,3370,3372,C
2-PB1,1880,1,1,0,3347,3349,C
2-PB1,1881,3,0,0,3311,3314,C
2-PB1,1882,6,2,0,3337,3345,C
2-PB1,1883,0,3337,0,17,3354,T
2-PB1,1884,0,5,3361,0,3366,G
2-PB1,1885,3318,0,0,0,3318,A
2-PB1,1886,3331,0,1,0,3332,A
2-PB1,1887,0,3339,0,2,3341,T
2-PB1,1888,7,2,0,3312,3321,C
2-PB1,1889,1,2,0,3303,3306,C
2-PB1,1890,4,0,0,3288,3292,C
2-PB1,1891,0,3298,0,5,3303,T
2-PB1,1892,0,3334,0,0,3334,T
2-PB1,1893,0,3315,0,0,3315,T
2-PB1,1894,1,0,3335,0,3336,G
2-PB1,1895,0,3295,0,2,3297,T
2-PB1,1896,6,0,0,3310,3316,C
2-PB1,1897,3283,0,5,0,3288,A
2-PB1,1898,2,2,3317,0,3321,G
2-PB1,1899,1,0,0,3289,3290,C
2-PB1,1900,2,0,0,3304,3306,C
2-PB1,1901,3321,0,0,0,3321,A
2-PB1,1902,0,3335,0,0,3335,T
2-PB1,1903,3325,1,3,1,3330,A
2-PB1,1904,3325,0,0,0,3325,A
2-PB1,1905,3328,0,2,0,3330,A
2-PB1,1906,0,3,3346,0,3349,G
2-PB1,1907,3289,0,0,0,3289,A
2-PB1,1908,3300,0,1,0,3301,A
2-PB1,1909,3301,1,0,0,3302,A
2-PB1,1910,2,3259,0,0,3261,T
2-PB1,1911,0,3291,0,0,3291,T
2-PB1,1912,0,11,3288,0,3299,G
2-PB1,1913,3295,1,2,0,3298,A
2-PB1,1914,3245,0,0,0,3245,A
2-PB1,1915,0,3296,0,0,3296,T
2-PB1,1916,1,0,0,3324,3325,C
2-PB1,1917,1,3329,0,0,3330,T
2-PB1,1918,4,0,3376,0,3380,G
2-PB1,1919,1,3371,0,2,3374,T
2-PB1,1920,3409,0,1,0,3410,A
2-PB1,1921,3397,0,1,0,3398,A
2-PB1,1922,3385,0,0,0,3385,A
2-PB1,1923,1,2,0,3408,3411,C
2-PB1,1924,3330,0,0,0,3330,A
2-PB1,1925,3375,0,0,0,3375,A
2-PB1,1926,0,3371,0,0,3371,T
2-PB1,1927,1,0,3357,0,3358,G
2-PB1,1928,0,0,0,3361,3361,C
2-PB1,1929,0,3357,0,3,3360,T
2-PB1,1930,2,2,3440,0,3444,G
2-PB1,1931,0,3419,0,0,3419,T
2-PB1,1932,3460,0,4,0,3464,A
2-PB1,1933,1,1,3456,1,3459,G
2-PB1,1934,0,3382,0,1,3383,T
2-PB1,1935,3376,0,3,0,3379,A
2-PB1,1936,3339,0,0,0,3339,A
2-PB1,1937,0,3306,0,0,3306,T
2-PB1,1938,0,1,3299,0,3300,G
2-PB1,1939,3,1,1,3227,3232,C
2-PB1,1940,3,0,0,3226,3229,C
2-PB1,1941,3181,0,2,0,3183,A
2-PB1,1942,1,1,3185,0,3187,G
2-PB1,1943,2,2,0,3218,3222,C
2-PB1,1944,2,0,2,3206,3210,C
2-PB1,1945,4,1,0,3221,3226,C
2-PB1,1946,3215,1,2,0,3218,A
2-PB1,1947,0,3211,0,2,3213,T
2-PB1,1948,1,5,3207,0,3213,G
2-PB1,1949,1,1,3215,0,3217,G
2-PB1,1950,2,3185,0,2,3189,T
2-PB1,1951,4,1,0,3176,3181,C
2-PB1,1952,3,10,1,3080,3094,C
2-PB1,1953,1,0,3133,0,3134,G
2-PB1,1954,0,2,3119,0,3121,G
2-PB1,1955,3,0,0,3055,3058,C
2-PB1,1956,2,2,0,3112,3116,C
2-PB1,1957,3129,0,0,1,3130,A
2-PB1,1958,3143,0,0,0,3143,A
2-PB1,1959,3129,0,1,0,3130,A
2-PB1,1960,3147,0,0,0,3147,A
2-PB1,1961,1,2,3200,0,3203,G
2-PB1,1962,0,3094,1,0,3095,T
2-PB1,1963,3143,0,0,0,3143,A
2-PB1,1964,0,3133,0,1,3134,T
2-PB1,1965,0,3,3147,0,3150,G
2-PB1,1966,0,5,3178,0,3183,G
2-PB1,1967,3165,0,0,0,3165,A
2-PB1,1968,3184,0,0,0,3184,A
2-PB1,1969,0,3162,0,0,3162,T
2-PB1,1970,3125,0,1,0,3126,A
2-PB1,1971,0,3111,0,1,3112,T
2-PB1,1972,0,1,3095,0,3096,G
2-PB1,1973,3094,0,1,0,3095,A
2-PB1,1974,0,3057,0,4,3061,T
2-PB1,1975,1,1,2985,0,2987,G
2-PB1,1976,2,0,0,2963,2965,C
2-PB1,1977,4,8,0,2942,2954,C
2-PB1,1978,0,0,2979,0,2979,G
2-PB1,1979,0,2963,0,1,2964,T
2-PB1,1980,0,2971,0,0,2971,T
2-PB1,1981,0,1,2976,0,2977,G
2-PB1,1982,2,1,0,3008,3011,C
2-PB1,1983,3014,0,4,0,3018,A
2-PB1,1984,3043,0,1,0,3044,A
2-PB1,1985,0,0,0,3052,3052,C
2-PB1,1986,0,3008,0,0,3008,T
2-PB1,1987,3008,0,0,0,3008,A
2-PB1,1988,0,0,0,3011,3011,C
2-PB1,1989,2997,0,4,0,3001,A
2-PB1,1990,0,0,0,2999,2999,C
2-PB1,1991,2858,0,2,0,2860,A
2-PB1,1992,0,0,0,3003,3003,C
2-PB1,1993,0,2876,0,0,2876,T
2-PB1,1994,5,0,0,2934,2939,C
2-PB1,1995,1,1,0,2950,2952,C
2-PB1,1996,0,2890,1,3,2894,T
2-PB1,1997,2,1,2930,0,2933,G
2-PB1,1998,0,1,2943,0,2944,G
2-PB1,1999,2924,0,0,1,2925,A
2-PB1,2000,0,2915,0,0,2915,T
2-PB1,2001,0,2643,0,0,2643,T
2-PB1,2002,7,0,0,2668,2675,C
2-PB1,2003,4,1,0,2654,2659,C
2-PB1,2004,5,0,0,2674,2679,C
2-PB1,2005,2697,0,1,0,2698,A
2-PB1,2006,2688,0,1,0,2689,A
2-PB1,2007,0,2,2699,0,2701,G
2-PB1,2008,2678,0,0,0,2678,A
2-PB1,2009,0,1,2680,0,2681,G
2-PB1,2010,0,2,2681,0,2683,G
2-PB1,2011,2630,0,1,0,2631,A
2-PB1,2012,2634,0,6,0,2640,A
2-PB1,2013,0,0,0,2633,2633,C
2-PB1,2014,0,0,0,2628,2628,C
2-PB1,2015,1,0,2657,0,2658,G
2-PB1,2016,1,0,0,2644,2645,C
2-PB1,2017,0,2645,0,0,2645,T
2-PB1,2018,6,1,0,2636,2643,C
2-PB1,2019,0,2633,0,2,2635,T
2-PB1,2020,2766,0,0,0,2766,A
2-PB1,2021,0,2753,0,0,2753,T
2-PB1,2022,0,2736,0,1,2737,T
2-PB1,2023,9,0,0,2741,2750,C
2-PB1,2024,0,2661,0,0,2661,T
2-PB1,2025,2661,0,1,1,2663,A
2-PB1,2026,2657,0,3,0,2660,A
2-PB1,2027,2654,0,0,1,2655,A
2-PB1,2028,1,2,0,2649,2652,C
2-PB1,2029,2442,0,1,0,2443,A
2-PB1,2030,0,0,0,2451,2451,C
2-PB1,2031,2414,1,0,0,2415,A
2-PB1,2032,2426,0,4,0,2430,A
2-PB1,2033,0,0,2446,0,2446,G
2-PB1,2034,1,0,0,2406,2407,C
2-PB1,2035,2,0,0,2431,2433,C
2-PB1,2036,2418,0,1,0,2419,A
2-PB1,2037,2409,0,0,0,2409,A
2-PB1,2038,2410,0,3,0,2413,A
2-PB1,2039,1,1,2422,0,2424,G
2-PB1,2040,1,0,2410,0,2411,G
2-PB1,2041,2,1,2355,0,2358,G
2-PB1,2042,0,5,2370,1,2376,G
2-PB1,2043,2364,0,1,0,2365,A
2-PB1,2044,2380,0,0,0,2380,A
2-PB1,2045,0,2375,0,0,2375,T
2-PB1,2046,0,2365,1,0,2366,T
2-PB1,2047,1,0,0,2374,2375,C
2-PB1,2048,0,2368,0,1,2369,T
2-PB1,2049,0,2367,0,0,2367,T
2-PB1,2050,0,4,2369,0,2373,G
2-PB1,2051,2347,0,4,0,2351,A
2-PB1,2052,7,1,2346,0,2354,G
2-PB1,2053,0,3,2351,0,2354,G
2-PB1,2054,2353,0,0,0,2353,A
2-PB1,2055,0,2338,0,1,2339,T
2-PB1,2056,3,9,2334,0,2346,G
2-PB1,2057,2328,0,2,0,2330,A
2-PB1,2058,2334,0,4,0,2338,A
2-PB1,2059,0,0,0,2355,2355,C
2-PB1,2060,2334,0,1,0,2335,A
2-PB1,2061,0,1,2349,0,2350,G
2-PB1,2062,2344,1,1,0,2346,A
2-PB1,2063,0,2329,0,0,2329,T
2-PB1,2064,2,1,2343,0,2346,G
2-PB1,2065,0,2356,0,1,2357,T
2-PB1,2066,2358,0,0,0,2358,A
2-PB1,2067,0,0,0,2350,2350,C
2-PB1,2068,5,2,0,2339,2346,C
2-PB1,2069,2314,0,3,0,2317,A
2-PB1,2070,0,0,2297,0,2297,G
2-PB1,2071,2277,0,0,0,2277,A
2-PB1,2072,2264,0,0,0,2264,A
2-PB1,2073,0,1,2260,0,2261,G
2-PB1,2074,0,2134,0,0,2134,T
2-PB1,2075,0,1,2134,0,2135,G
2-PB1,2076,1,1,1,2128,2131,C
2-PB1,2077,1,2136,0,4,2141,T
2-PB1,2078,0,0,2147,0,2147,G
2-PB1,2079,0,2,0,2129,2131,C
2-PB1,2080,2137,0,1,1,2139,A
2-PB1,2081,2125,0,2,0,2127,A
2-PB1,2082,1,0,0,2102,2103,C
2-PB1,2083,0,2097,0,3,2100,T
2-PB1,2084,0,2085,0,0,2085,T
2-PB1,2085,0,0,2082,0,2082,G
2-PB1,2086,0,2062,0,1,2063,T
2-PB1,2087,0,2052,0,0,2052,T
2-PB1,2088,7,1,0,2060,2068,C
2-PB1,2089,0,2,2072,0,2074,G
2-PB1,2090,2068,0,0,0,2068,A
2-PB1,2091,0,1,2058,0,2059,G
2-PB1,2092,2065,0,0,0,2065,A
2-PB1,2093,2070,0,1,0,2071,A
2-PB1,2094,2067,0,0,0,2067,A
2-PB1,2095,0,2032,0,0,2032,T
2-PB1,2096,0,2053,0,1,2054,T
2-PB1,2097,0,2053,0,0,2053,T
2-PB1,2098,0,2055,0,1,2056,T
2-PB1,2099,0,2042,0,0,2042,T
2-PB1,2100,2,0,0,2043,2045,C
2-PB1,2101,2,0,0,2041,2043,C
2-PB1,2102,4,0,1,2061,2066,C
2-PB1,2103,1,2052,0,3,2056,T
2-PB1,2104,2062,0,0,0,2062,A
2-PB1,2105,0,0,2060,0,2060,G
2-PB1,2106,0,2042,1,2,2045,T
2-PB1,2107,2069,0,0,0,2069,A
2-PB1,2108,0,0,2074,0,2074,G
2-PB1,2109,0,2047,0,0,2047,T
2-PB1,2110,1,2065,0,1,2067,T
2-PB1,2111,11,0,1,2077,2089,C
2-PB1,2112,2106,0,0,0,2106,A
2-PB1,2113,0,2102,0,0,2102,T
2-PB1,2114,2100,0,0,0,2100,A
2-PB1,2115,0,2106,0,0,2106,T
2-PB1,2116,2042,0,2,0,2044,A
2-PB1,2117,0,1,2021,0,2022,G
2-PB1,2118,0,4,2002,0,2006,G
2-PB1,2119,1807,1,1,0,1809,A
2-PB1,2120,0,1,1811,0,1812,G
2-PB1,2121,1716,0,1,0,1717,A
2-PB1,2122,3,0,1,1696,1700,C
2-PB1,2123,1,1,0,1654,1656,C
2-PB1,2124,2,0,1660,0,1662,G
2-PB1,2125,1660,0,1,0,1661,A
2-PB1,2126,0,1647,0,0,1647,T
2-PB1,2127,0,1655,1,0,1656,T
2-PB1,2128,0,2,1650,0,1652,G
2-PB1,2129,0,5,1640,0,1645,G
2-PB1,2130,1648,0,1,0,1649,A
2-PB1,2131,1643,0,0,0,1643,A
2-PB1,2132,0,1620,0,0,1620,T
2-PB1,2133,0,1621,0,0,1621,T
2-PB1,2134,0,1613,0,0,1613,T
2-PB1,2135,2,0,0,1625,1627,C
2-PB1,2136,0,1629,0,1,1630,T
2-PB1,2137,1619,0,1,0,1620,A
2-PB1,2138,0,1,1620,0,1621,G
2-PB1,2139,1,0,0,1607,1608,C
2-PB1,2140,1611,0,0,0,1611,A
2-PB1,2141,0,1609,0,2,1611,T
2-PB1,2142,0,0,1583,0,1583,G
2-PB1,2143,0,1,1600,0,1601,G
2-PB1,2144,1,1584,1,0,1586,T
2-PB1,2145,0,1,1590,0,1591,G
2-PB1,2146,0,0,1586,0,1586,G
2-PB1,2147,1546,0,3,0,1549,A
2-PB1,2148,1,1,1553,0,1555,G
2-PB1,2149,1,1,1542,0,1544,G
2-PB1,2150,1,0,0,1466,1467,C
2-PB1,2151,2,0,0,1514,1516,C
2-PB1,2152,1411,0,4,0,1415,A
2-PB1,2153,0,1407,0,0,1407,T
2-PB1,2154,0,1,1412,1,1414,G
2-PB1,2155,0,0,1422,0,1422,G
2-PB1,2156,0,1377,0,1,1378,T
2-PB1,2157,0,0,1384,0,1384,G
2-PB1,2158,0,1331,0,5,1336,T
2-PB1,2159,7,0,0,1310,1317,C
2-PB1,2160,0,1337,0,0,1337,T
2-PB1,2161,1321,1,1,0,1323,A
2-PB1,2162,0,2,1315,0,1317,G
2-PB1,2163,0,2,1255,0,1257,G
2-PB1,2164,0,1,1241,0,1242,G
2-PB1,2165,0,0,0,1157,1157,C
2-PB1,2166,2,1,1,1122,1126,C
2-PB1,2167,1,3,0,1130,1134,C
2-PB1,2168,0,0,1145,0,1145,G
2-PB1,2169,0,3,1154,0,1157,G
2-PB1,2170,1155,0,0,0,1155,A
2-PB1,2171,0,1136,0,0,1136,T
2-PB1,2172,0,1107,0,0,1107,T
2-PB1,2173,0,0,1098,0,1098,G
2-PB1,2174,1093,0,1,0,1094,A
2-PB1,2175,0,1089,0,0,1089,T
2-PB1,2176,0,0,1088,0,1088,G
2-PB1,2177,0,1,0,1072,1073,C
2-PB1,2178,1,0,0,1074,1075,C
2-PB1,2179,1078,0,0,0,1078,A
2-PB1,2180,0,0,1075,0,1075,G
2-PB1,2181,1074,0,0,0,1074,A
2-PB1,2182,1073,0,0,0,1073,A
2-PB1,2183,1,1057,0,0,1058,T
2-PB1,2184,0,1035,0,1,1036,T
2-PB1,2185,0,2,1038,0,1040,G
2-PB1,2186,1027,0,2,0,1029,A
2-PB1,2187,0,0,0,1017,1017,C
2-PB1,2188,0,1010,0,1,1011,T
2-PB1,2189,0,998,0,0,998,T
2-PB1,2190,2,0,0,1001,1003,C
2-PB1,2191,0,0,1007,0,1007,G
2-PB1,2192,1007,0,1,0,1008,A
2-PB1,2193,5,0,987,0,992,G
2-PB1,2194,0,991,0,1,992,T
2-PB1,2195,1,0,0,996,997,C
2-PB1,2196,0,999,0,0,999,T
2-PB1,2197,0,2,991,0,993,G
2-PB1,2198,0,0,994,0,994,G
2-PB1,2199,996,0,0,0,996,A
2-PB1,2200,937,0,0,1,938,A
2-PB1,2201,0,0,942,0,942,G
2-PB1,2202,0,2,941,0,943,G
2-PB1,2203,940,0,4,0,944,A
2-PB1,2204,0,938,0,0,938,T
2-PB1,2205,0,944,0,0,944,T
2-PB1,2206,939,0,0,0,939,A
2-PB1,2207,933,0,1,0,934,A
2-PB1,2208,0,0,937,0,937,G
2-PB1,2209,935,0,0,0,935,A
2-PB1,2210,892,0,0,0,892,A
2-PB1,2211,0,0,819,0,819,G
2-PB1,2212,0,0,823,0,823,G
2-PB1,2213,820,0,0,0,820,A
2-PB1,2214,822,0,2,0,824,A
2-PB1,2215,0,0,823,0,823,G
2-PB1,2216,744,0,0,0,744,A
2-PB1,2217,0,0,744,0,744,G
2-PB1,2218,0,687,0,0,687,T
2-PB1,2219,0,677,0,0,677,T
2-PB1,2220,4,0,0,674,678,C
2-PB1,2221,0,656,0,0,656,T
2-PB1,2222,0,0,0,671,671,C
2-PB1,2223,0,669,1,0,670,T
2-PB1,2224,0,2,661,0,663,G
2-PB1,2225,653,0,0,0,653,A
2-PB1,2226,0,0,647,0,647,G
2-PB1,2227,632,0,1,0,633,A
2-PB1,2228,0,606,0,0,606,T
2-PB1,2229,2,0,0,587,589,C
2-PB1,2230,584,0,0,0,584,A
2-PB1,2231,1,578,0,0,579,T
2-PB1,2232,0,0,581,0,581,G
2-PB1,2233,578,0,0,0,578,A
2-PB1,2234,574,0,0,0,574,A
2-PB1,2235,0,0,566,0,566,G
2-PB1,2236,559,0,0,0,559,A
2-PB1,2237,0,540,0,0,540,T
2-PB1,2238,0,0,0,549,549,C
2-PB1,2239,0,505,0,0,505,T
2-PB1,2240,0,0,509,0,509,G
2-PB1,2241,0,504,0,0,504,T
2-PB1,2242,1,491,0,2,494,T
2-PB1,2243,2,0,0,481,483,C
2-PB1,2244,1,0,0,480,481,C
2-PB1,2245,477,0,0,0,477,A
2-PB1,2246,0,0,0,473,473,C
2-PB1,2247,1,0,0,442,443,C
2-PB1,2248,441,0,0,0,441,A
2-PB1,2249,0,403,0,1,404,T
2-PB1,2250,0,393,0,0,393,T
2-PB1,2251,0,0,394,0,394,G
2-PB1,2252,390,0,0,0,390,A
2-PB1,2253,387,1,1,0,389,A
2-PB1,2254,0,0,387,0,387,G
2-PB1,2255,337,0,0,0,337,A
2-PB1,2256,333,0,1,0,334,A
2-PB1,2257,0,0,0,329,329,C
2-PB1,2258,0,313,0,1,314,T
2-PB1,2259,0,0,0,316,316,C
2-PB1,2260,307,0,0,0,307,A
2-PB1,2261,0,0,307,0,307,G
2-PB1,2262,304,0,0,0,304,A
2-PB1,2263,0,0,0,294,294,C
2-PB1,2264,0,0,290,0,290,G
2-PB1,2265,0,0,285,0,285,G
2-PB1,2266,0,0,0,284,284,C
2-PB1,2267,286,0,1,0,287,A
2-PB1,2268,285,0,0,0,285,A
2-PB1,2269,282,0,0,0,282,A
2-PB1,2270,283,0,0,0,283,A
2-PB1,2271,281,0,0,0,281,A
2-PB1,2272,0,270,0,0,270,T
2-PB1,2273,258,0,0,0,258,A
2-PB1,2274,260,0,0,0,260,A
3-PA,1,52,0,0,0,52,A
3-PA,2,0,55,0,0,55,T
3-PA,3,0,0,61,0,61,G
3-PA,4,0,0,60,0,60,G
3-PA,5,57,0,0,0,57,A
3-PA,6,58,0,0,0,58,A
3-PA,7,0,0,58,0,58,G
3-PA,8,62,0,0,0,62,A
3-PA,9,0,62,0,0,62,T
3-PA,10,0,63,0,0,63,T
3-PA,11,0,63,0,0,63,T
3-PA,12,0,62,0,0,62,T
3-PA,13,0,0,62,0,62,G
3-PA,14,0,61,0,0,61,T
3-PA,15,0,0,63,0,63,G
3-PA,16,0,0,0,64,64,C
3-PA,17,0,0,64,0,64,G
3-PA,18,72,0,0,0,72,A
3-PA,19,0,0,0,69,69,C
3-PA,20,72,0,0,0,72,A
3-PA,21,72,0,0,0,72,A
3-PA,22,0,79,0,0,79,T
3-PA,23,0,0,80,0,80,G
3-PA,24,0,0,0,82,82,C
3-PA,25,0,82,0,0,82,T
3-PA,26,0,84,0,0,84,T
3-PA,27,0,0,0,84,84,C
3-PA,28,89,0,0,0,89,A
3-PA,29,99,0,1,0,100,A
3-PA,30,0,0,0,105,105,C
3-PA,31,0,0,0,106,106,C
3-PA,32,0,0,0,105,105,C
3-PA,33,104,0,0,0,104,A
3-PA,34,109,0,0,0,109,A
3-PA,35,0,109,0,0,109,T
3-PA,36,0,1,108,0,109,G
3-PA,37,109,0,0,0,109,A
3-PA,38,0,111,0,0,111,T
3-PA,39,0,112,0,0,112,T
3-PA,40,0,0,114,0,114,G
3-PA,41,0,113,0,1,114,T
3-PA,42,0,0,0,113,113,C
3-PA,43,0,0,113,0,113,G
3-PA,44,115,0,0,0,115,A
3-PA,45,114,0,0,0,114,A
3-PA,46,0,0,0,116,116,C
3-PA,47,0,117,0,0,117,T
3-PA,48,0,117,0,0,117,T
3-PA,49,0,0,117,0,117,G
3-PA,50,0,0,0,116,116,C
3-PA,51,116,0,0,0,116,A
3-PA,52,0,0,117,0,117,G
3-PA,53,117,0,0,0,117,A
3-PA,54,116,0,0,0,116,A
3-PA,55,117,0,0,0,117,A
3-PA,56,117,0,0,0,117,A
3-PA,57,116,0,0,0,116,A
3-PA,58,0,0,119,0,119,G
3-PA,59,0,0,0,121,121,C
3-PA,60,122,0,0,0,122,A
3-PA,61,128,1,0,0,129,A
3-PA,62,0,127,0,0,127,T
3-PA,63,0,0,129,0,129,G
3-PA,64,131,0,0,0,131,A
3-PA,65,132,0,0,0,132,A
3-PA,66,132,0,0,0,132,A
3-PA,67,0,0,139,0,139,G
3-PA,68,142,0,0,0,142,A
3-PA,69,0,0,161,0,161,G
3-PA,70,0,162,0,0,162,T
3-PA,71,163,0,0,0,163,A
3-PA,72,0,164,0,0,164,T
3-PA,73,0,1,162,0,163,G
3-PA,74,0,0,165,0,165,G
3-PA,75,0,0,162,0,162,G
3-PA,76,0,0,163,0,163,G
3-PA,77,158,0,0,0,158,A
3-PA,78,0,0,161,0,161,G
3-PA,79,0,0,167,0,167,G
3-PA,80,169,0,0,0,169,A
3-PA,81,0,169,0,0,169,T
3-PA,82,0,0,0,171,171,C
3-PA,83,0,172,0,0,172,T
3-PA,84,0,0,172,0,172,G
3-PA,85,169,0,0,0,169,A
3-PA,86,172,0,0,0,172,A
3-PA,87,172,0,0,0,172,A
3-PA,88,173,1,0,0,174,A
3-PA,89,0,172,0,0,172,T
3-PA,90,0,174,0,0,174,T
3-PA,91,0,0,173,0,173,G
3-PA,92,173,0,0,0,173,A
3-PA,93,171,0,2,0,173,A
3-PA,94,170,0,0,0,170,A
3-PA,95,0,0,0,174,174,C
3-PA,96,174,0,0,0,174,A
3-PA,97,171,0,0,0,171,A
3-PA,98,174,0,0,0,174,A
3-PA,99,0,0,0,172,172,C
3-PA,100,177,0,0,0,177,A
3-PA,101,175,0,0,0,175,A
3-PA,102,178,0,0,0,178,A
3-PA,103,1,173,0,0,174,T
3-PA,104,0,178,0,0,178,T
3-PA,105,0,177,0,0,177,T
3-PA,106,0,0,175,0,175,G
3-PA,107,0,0,0,175,175,C
3-PA,108,179,0,0,0,179,A
3-PA,109,0,0,183,0,183,G
3-PA,110,0,0,0,188,188,C
3-PA,111,200,0,0,0,200,A
3-PA,112,202,0,0,0,202,A
3-PA,113,0,209,0,0,209,T
3-PA,114,213,0,0,0,213,A
3-PA,115,0,213,0,0,213,T
3-PA,116,0,0,220,0,220,G
3-PA,117,0,0,0,221,221,C
3-PA,118,218,0,0,0,218,A
3-PA,119,0,0,0,224,224,C
3-PA,120,0,220,0,0,220,T
3-PA,121,2,0,0,260,262,C
3-PA,122,264,1,0,0,265,A
3-PA,123,0,0,0,274,274,C
3-PA,124,0,275,0,0,275,T
3-PA,125,0,273,0,0,273,T
3-PA,126,0,0,274,0,274,G
3-PA,127,0,0,276,0,276,G
3-PA,128,269,0,0,0,269,A
3-PA,129,0,0,284,0,284,G
3-PA,130,0,0,279,0,279,G
3-PA,131,0,269,0,0,269,T
3-PA,132,0,0,294,0,294,G
3-PA,133,0,292,0,0,292,T
3-PA,134,0,1,297,0,298,G
3-PA,135,0,294,0,1,295,T
3-PA,136,0,297,0,0,297,T
3-PA,137,0,298,0,0,298,T
3-PA,138,0,0,0,301,301,C
3-PA,139,302,0,0,0,302,A
3-PA,140,0,306,0,0,306,T
3-PA,141,0,0,312,0,312,G
3-PA,142,0,308,0,0,308,T
3-PA,143,313,0,0,0,313,A
3-PA,144,0,309,0,0,309,T
3-PA,145,0,311,0,0,311,T
3-PA,146,0,0,0,315,315,C
3-PA,147,312,0,0,0,312,A
3-PA,148,0,0,309,0,309,G
3-PA,149,312,0,0,0,312,A
3-PA,150,0,314,0,0,314,T
3-PA,151,0,314,0,0,314,T
3-PA,152,0,313,0,0,313,T
3-PA,153,0,0,0,311,311,C
3-PA,154,0,0,0,322,322,C
3-PA,155,322,0,0,0,322,A
3-PA,156,0,323,0,0,323,T
3-PA,157,0,323,0,0,323,T
3-PA,158,0,324,0,0,324,T
3-PA,159,0,0,0,323,323,C
3-PA,160,324,0,0,0,324,A
3-PA,161,0,336,0,0,336,T
3-PA,162,1,0,0,336,337,C
3-PA,163,335,0,0,0,335,A
3-PA,164,335,0,0,0,335,A
3-PA,165,0,335,0,1,336,T
3-PA,166,0,1,342,0,343,G
3-PA,167,343,0,0,0,343,A
3-PA,168,343,0,0,0,343,A
3-PA,169,0,0,0,343,343,C
3-PA,170,341,0,0,0,341,A
3-PA,171,341,0,0,0,341,A
3-PA,172,0,0,347,0,347,G
3-PA,173,0,0,339,0,339,G
3-PA,174,0,1,0,344,345,C
3-PA,175,0,1,346,0,347,G
3-PA,176,363,0,0,0,363,A
3-PA,177,366,0,0,0,366,A
3-PA,178,0,370,0,0,370,T
3-PA,179,0,0,0,374,374,C
3-PA,180,373,0,0,0,373,A
3-PA,181,376,0,0,0,376,A
3-PA,182,0,379,0,0,379,T
3-PA,183,379,0,0,0,379,A
3-PA,184,0,0,387,0,387,G
3-PA,185,0,379,0,0,379,T
3-PA,186,0,2,382,0,384,G
3-PA,187,0,0,384,0,384,G
3-PA,188,0,384,0,0,384,T
3-PA,189,389,0,0,0,389,A
3-PA,190,0,2,392,0,394,G
3-PA,191,393,0,0,0,393,A
3-PA,192,393,0,0,0,393,A
3-PA,193,0,0,0,394,394,C
3-PA,194,0,392,0,0,392,T
3-PA,195,0,390,0,0,390,T
3-PA,196,0,1,390,0,391,G
3-PA,197,386,0,1,0,387,A
3-PA,198,0,0,0,390,390,C
3-PA,199,0,1,386,0,387,G
3-PA,200,385,0,0,0,385,A
3-PA,201,0,403,0,0,403,T
3-PA,202,2,0,0,406,408,C
3-PA,203,0,0,0,410,410,C
3-PA,204,407,0,0,0,407,A
3-PA,205,411,0,0,0,411,A
3-PA,206,414,0,0,0,414,A
3-PA,207,0,413,0,0,413,T
3-PA,208,1,0,409,0,410,G
3-PA,209,0,0,0,410,410,C
3-PA,210,412,0,1,0,413,A
3-PA,211,1,0,0,421,422,C
3-PA,212,0,417,0,0,417,T
3-PA,213,0,0,471,0,471,G
3-PA,214,0,475,0,0,475,T
3-PA,215,0,477,0,0,477,T
3-PA,216,482,0,0,0,482,A
3-PA,217,479,0,0,0,479,A
3-PA,218,480,0,0,0,480,A
3-PA,219,0,0,482,0,482,G
3-PA,220,0,0,0,477,477,C
3-PA,221,465,0,0,0,465,A
3-PA,222,0,0,0,473,473,C
3-PA,223,462,0,0,0,462,A
3-PA,224,0,1,473,0,474,G
3-PA,225,467,0,0,0,467,A
3-PA,226,0,474,0,0,474,T
3-PA,227,0,473,0,0,473,T
3-PA,228,0,474,0,0,474,T
3-PA,229,0,0,472,0,472,G
3-PA,230,471,0,0,0,471,A
3-PA,231,474,0,0,0,474,A
3-PA,232,471,0,1,0,472,A
3-PA,233,0,463,0,0,463,T
3-PA,234,466,0,0,0,466,A
3-PA,235,473,0,0,0,473,A
3-PA,236,0,470,0,0,470,T
3-PA,237,0,0,1,474,475,C
3-PA,238,0,0,475,0,475,G
3-PA,239,469,0,0,0,469,A
3-PA,240,0,2,472,0,474,G
3-PA,241,0,0,481,0,481,G
3-PA,242,0,0,475,0,475,G
3-PA,243,0,0,481,0,481,G
3-PA,244,473,0,1,0,474,A
3-PA,245,0,0,484,0,484,G
3-PA,246,486,0,0,0,486,A
3-PA,247,0,1,488,0,489,G
3-PA,248,487,0,0,0,487,A
3-PA,249,0,0,0,496,496,C
3-PA,250,486,0,1,0,487,A
3-PA,251,1,0,495,0,496,G
3-PA,252,497,0,0,0,497,A
3-PA,253,502,0,0,3,505,A
3-PA,254,0,0,0,501,501,C
3-PA,255,493,0,0,0,493,A
3-PA,256,496,0,0,0,496,A
3-PA,257,0,492,0,0,492,T
3-PA,258,1,0,506,0,507,G
3-PA,259,0,1,507,0,508,G
3-PA,260,0,0,0,500,500,C
3-PA,261,0,0,0,502,502,C
3-PA,262,0,505,0,0,505,T
3-PA,263,0,0,513,0,513,G
3-PA,264,0,0,508,0,508,G
3-PA,265,513,0,0,0,513,A
3-PA,266,0,0,0,518,518,C
3-PA,267,504,0,1,0,505,A
3-PA,268,0,0,565,0,565,G
3-PA,269,1,558,0,0,559,T
3-PA,270,574,0,0,0,574,A
3-PA,271,0,0,569,0,569,G
3-PA,272,0,563,0,0,563,T
3-PA,273,565,0,2,0,567,A
3-PA,274,568,0,0,0,568,A
3-PA,275,563,0,0,0,563,A
3-PA,276,0,0,0,572,572,C
3-PA,277,541,0,0,0,541,A
3-PA,278,0,0,551,0,551,G
3-PA,279,0,546,0,0,546,T
3-PA,280,562,0,0,0,562,A
3-PA,281,0,557,0,0,557,T
3-PA,282,0,0,0,574,574,C
3-PA,283,0,571,0,0,571,T
3-PA,284,0,0,572,0,572,G
3-PA,285,0,0,0,572,572,C
3-PA,286,573,0,0,0,573,A
3-PA,287,567,0,3,0,570,A
3-PA,288,0,0,0,571,571,C
3-PA,289,571,0,0,0,571,A
3-PA,290,0,0,0,590,590,C
3-PA,291,0,583,0,0,583,T
3-PA,292,588,0,0,0,588,A
3-PA,293,0,0,0,585,585,C
3-PA,294,0,581,0,0,581,T
3-PA,295,0,1,581,0,582,G
3-PA,296,0,0,582,0,582,G
3-PA,297,573,0,1,0,574,A
3-PA,298,0,0,574,0,574,G
3-PA,299,1,1,0,560,562,C
3-PA,300,0,577,0,0,577,T
3-PA,301,0,0,577,0,577,G
3-PA,302,0,1,577,0,578,G
3-PA,303,579,0,0,0,579,A
3-PA,304,581,0,0,0,581,A
3-PA,305,576,0,1,0,577,A
3-PA,306,576,0,1,0,577,A
3-PA,307,0,1,0,584,585,C
3-PA,308,1,1,0,579,581,C
3-PA,309,0,0,583,0,583,G
3-PA,310,579,0,0,0,579,A
3-PA,311,580,0,0,0,580,A
3-PA,312,0,0,586,0,586,G
3-PA,313,0,584,0,0,584,T
3-PA,314,0,585,0,5,590,T
3-PA,315,0,585,0,0,585,T
3-PA,316,1,0,0,589,590,C
3-PA,317,0,599,0,0,599,T
3-PA,318,595,0,0,0,595,A
3-PA,319,0,0,0,596,596,C
3-PA,320,2,0,0,593,595,C
3-PA,321,594,0,0,0,594,A
3-PA,322,0,1,597,0,598,G
3-PA,323,597,0,0,0,597,A
3-PA,324,0,0,0,585,585,C
3-PA,325,0,602,0,0,602,T
3-PA,326,0,604,1,0,605,T
3-PA,327,0,0,614,0,614,G
3-PA,328,0,613,0,0,613,T
3-PA,329,615,0,1,0,616,A
3-PA,330,0,611,0,0,611,T
3-PA,331,0,2,606,0,608,G
3-PA,332,629,0,0,0,629,A
3-PA,333,0,626,0,0,626,T
3-PA,334,0,626,0,0,626,T
3-PA,335,630,0,0,0,630,A
3-PA,336,0,0,0,621,621,C
3-PA,337,626,0,0,0,626,A
3-PA,338,624,0,0,0,624,A
3-PA,339,0,0,627,0,627,G
3-PA,340,0,1,627,0,628,G
3-PA,341,611,0,0,0,611,A
3-PA,342,0,2,612,0,614,G
3-PA,343,612,0,0,0,612,A
3-PA,344,613,0,1,0,614,A
3-PA,345,0,0,0,612,612,C
3-PA,346,606,0,0,0,606,A
3-PA,347,0,0,603,0,603,G
3-PA,348,603,0,0,0,603,A
3-PA,349,0,603,0,0,603,T
3-PA,350,0,602,0,0,602,T
3-PA,351,1,0,0,597,598,C
3-PA,352,598,0,0,0,598,A
3-PA,353,0,593,0,0,593,T
3-PA,354,0,0,1,598,599,C
3-PA,355,0,1,597,0,598,G
3-PA,356,593,0,0,0,593,A
3-PA,357,593,0,1,0,594,A
3-PA,358,598,0,0,0,598,A
3-PA,359,0,600,0,0,600,T
3-PA,360,0,597,0,0,597,T
3-PA,361,0,0,601,0,601,G
3-PA,362,0,0,591,0,591,G
3-PA,363,1,0,594,0,595,G
3-PA,364,0,0,597,0,597,G
3-PA,365,0,585,0,0,585,T
3-PA,366,1,1,599,0,601,G
3-PA,367,603,0,0,0,603,A
3-PA,368,0,1,0,597,598,C
3-PA,369,604,0,2,0,606,A
3-PA,370,605,0,0,0,605,A
3-PA,371,0,2,608,0,610,G
3-PA,372,0,1,611,0,612,G
3-PA,373,612,0,1,0,613,A
3-PA,374,0,2,612,0,614,G
3-PA,375,602,0,0,0,602,A
3-PA,376,0,0,607,0,607,G
3-PA,377,599,0,0,0,599,A
3-PA,378,596,0,0,0,596,A
3-PA,379,1,0,604,0,605,G
3-PA,380,0,597,0,0,597,T
3-PA,381,0,1,0,614,615,C
3-PA,382,0,0,0,602,602,C
3-PA,383,613,1,0,0,614,A
3-PA,384,0,0,0,622,622,C
3-PA,385,640,0,0,0,640,A
3-PA,386,0,648,0,0,648,T
3-PA,387,662,0,0,0,662,A
3-PA,388,0,645,0,0,645,T
3-PA,389,647,0,0,0,647,A
3-PA,390,0,640,0,0,640,T
3-PA,391,0,633,0,0,633,T
3-PA,392,642,0,0,0,642,A
3-PA,393,0,0,0,646,646,C
3-PA,394,0,0,0,627,627,C
3-PA,395,0,619,0,0,619,T
3-PA,396,0,609,0,0,609,T
3-PA,397,0,0,605,0,605,G
3-PA,398,608,0,0,0,608,A
3-PA,399,607,1,0,0,608,A
3-PA,400,606,0,0,0,606,A
3-PA,401,584,0,3,0,587,A
3-PA,402,0,1,588,0,589,G
3-PA,403,0,1,587,0,588,G
3-PA,404,0,0,0,586,586,C
3-PA,405,0,0,0,594,594,C
3-PA,406,597,0,0,0,597,A
3-PA,407,592,0,0,0,592,A
3-PA,408,0,592,0,0,592,T
3-PA,409,594,0,1,0,595,A
3-PA,410,597,0,0,0,597,A
3-PA,411,0,2,593,0,595,G
3-PA,412,595,0,1,0,596,A
3-PA,413,0,593,0,0,593,T
3-PA,414,0,600,0,0,600,T
3-PA,415,596,0,0,0,596,A
3-PA,416,597,0,0,0,597,A
3-PA,417,594,0,0,0,594,A
3-PA,418,0,593,0,0,593,T
3-PA,419,0,0,0,595,595,C
3-PA,420,0,587,0,0,587,T
3-PA,421,0,0,595,0,595,G
3-PA,422,584,0,8,0,592,A
3-PA,423,1,2,596,0,599,G
3-PA,424,599,0,1,0,600,A
3-PA,425,600,0,0,0,600,A
3-PA,426,1,0,0,604,605,C
3-PA,427,599,0,1,0,600,A
3-PA,428,0,0,0,601,601,C
3-PA,429,603,0,0,0,603,A
3-PA,430,0,1,0,603,604,C
3-PA,431,597,0,2,0,599,A
3-PA,432,0,0,0,613,613,C
3-PA,433,614,0,0,0,614,A
3-PA,434,1,606,0,0,607,T
3-PA,435,0,595,0,0,595,T
3-PA,436,1,0,0,611,612,C
3-PA,437,602,1,2,0,605,A
3-PA,438,0,0,0,611,611,C
3-PA,439,606,0,0,0,606,A
3-PA,440,0,604,0,0,604,T
3-PA,441,0,594,0,0,594,T
3-PA,442,0,598,0,1,599,T
3-PA,443,0,593,0,0,593,T
3-PA,444,0,0,0,605,605,C
3-PA,445,0,597,0,1,598,T
3-PA,446,1,0,0,610,611,C
3-PA,447,607,0,0,0,607,A
3-PA,448,0,606,0,0,606,T
3-PA,449,0,603,0,0,603,T
3-PA,450,2,0,0,611,613,C
3-PA,451,599,0,0,0,599,A
3-PA,452,0,2,0,606,608,C
3-PA,453,0,599,0,0,599,T
3-PA,454,0,0,610,0,610,G
3-PA,455,0,0,604,0,604,G
3-PA,456,0,1,600,0,601,G
3-PA,457,0,0,607,0,607,G
3-PA,458,599,0,0,0,599,A
3-PA,459,0,0,600,0,600,G
3-PA,460,0,2,598,0,600,G
3-PA,461,599,0,0,0,599,A
3-PA,462,597,0,0,0,597,A
3-PA,463,592,0,0,0,592,A
3-PA,464,0,578,0,0,578,T
3-PA,465,0,1,577,0,578,G
3-PA,466,0,0,578,0,578,G
3-PA,467,0,0,0,571,571,C
3-PA,468,0,0,0,574,574,C
3-PA,469,574,0,0,0,574,A
3-PA,470,0,0,0,580,580,C
3-PA,471,581,0,0,0,581,A
3-PA,472,578,0,1,0,579,A
3-PA,473,578,0,0,1,579,A
3-PA,474,0,1,583,0,584,G
3-PA,475,0,0,573,0,573,G
3-PA,476,0,0,0,586,586,C
3-PA,477,588,0,0,0,588,A
3-PA,478,2,1,589,0,592,G
3-PA,479,593,0,0,0,593,A
3-PA,480,0,0,0,596,596,C
3-PA,481,0,597,0,0,597,T
3-PA,482,595,0,1,0,596,A
3-PA,483,0,0,0,594,594,C
3-PA,484,575,0,0,0,575,A
3-PA,485,0,0,0,579,579,C
3-PA,486,0,558,0,0,558,T
3-PA,487,0,0,0,564,564,C
3-PA,488,0,558,0,0,558,T
3-PA,489,2,0,0,564,566,C
3-PA,490,0,3,558,0,561,G
3-PA,491,562,0,0,0,562,A
3-PA,492,0,1,0,559,560,C
3-PA,493,0,0,567,0,567,G
3-PA,494,568,0,0,0,568,A
3-PA,495,0,0,568,0,568,G
3-PA,496,0,0,570,0,570,G
3-PA,497,574,0,0,0,574,A
3-PA,498,574,0,0,0,574,A
3-PA,499,573,0,0,0,573,A
3-PA,500,0,0,571,0,571,G
3-PA,501,0,0,0,569,569,C
3-PA,502,564,0,0,0,564,A
3-PA,503,1,0,570,0,571,G
3-PA,504,0,0,578,0,578,G
3-PA,505,1,0,574,0,575,G
3-PA,506,0,0,0,569,569,C
3-PA,507,0,574,0,0,574,T
3-PA,508,575,0,0,0,575,A
3-PA,509,0,1,580,0,581,G
3-PA,510,1,0,595,0,596,G
3-PA,511,597,0,0,0,597,A
3-PA,512,0,584,0,0,584,T
3-PA,513,0,582,0,0,582,T
3-PA,514,579,0,0,0,579,A
3-PA,515,581,0,1,0,582,A
3-PA,516,0,0,587,0,587,G
3-PA,517,575,0,0,0,575,A
3-PA,518,0,0,0,577,577,C
3-PA,519,0,0,0,528,528,C
3-PA,520,525,0,1,0,526,A
3-PA,521,0,1,524,0,525,G
3-PA,522,0,0,529,0,529,G
3-PA,523,0,0,0,528,528,C
3-PA,524,0,524,0,1,525,T
3-PA,525,1,0,534,0,535,G
3-PA,526,0,534,0,0,534,T
3-PA,527,0,531,0,0,531,T
3-PA,528,0,537,0,0,537,T
3-PA,529,528,0,0,0,528,A
3-PA,530,0,0,0,537,537,C
3-PA,531,1,2,0,526,529,C
3-PA,532,526,0,0,0,526,A
3-PA,533,0,523,0,0,523,T
3-PA,534,505,0,0,0,505,A
3-PA,535,505,0,1,0,506,A
3-PA,536,0,1,515,0,516,G
3-PA,537,511,0,2,0,513,A
3-PA,538,0,0,0,512,512,C
3-PA,539,509,0,0,0,509,A
3-PA,540,507,0,0,0,507,A
3-PA,541,0,1,507,0,508,G
3-PA,542,510,0,0,0,510,A
3-PA,543,509,0,0,0,509,A
3-PA,544,509,0,0,0,509,A
3-PA,545,1,484,0,0,485,T
3-PA,546,0,1,506,0,507,G
3-PA,547,1,0,501,0,502,G
3-PA,548,0,0,0,496,496,C
3-PA,549,1,0,0,503,504,C
3-PA,550,504,0,0,0,504,A
3-PA,551,503,0,0,0,503,A
3-PA,552,0,472,0,0,472,T
3-PA,553,484,0,0,0,484,A
3-PA,554,0,1,479,0,480,G
3-PA,555,482,0,0,0,482,A
3-PA,556,0,1,480,0,481,G
3-PA,557,0,0,480,0,480,G
3-PA,558,0,1,0,471,472,C
3-PA,559,1,0,0,469,470,C
3-PA,560,0,476,0,0,476,T
3-PA,561,0,0,0,480,480,C
3-PA,562,0,481,0,0,481,T
3-PA,563,0,0,482,0,482,G
3-PA,564,0,0,478,0,478,G
3-PA,565,0,0,475,0,475,G
3-PA,566,463,0,0,0,463,A
3-PA,567,0,450,0,1,451,T
3-PA,568,0,432,0,1,433,T
3-PA,569,1,0,0,486,487,C
3-PA,570,1,0,0,449,450,C
3-PA,571,0,433,0,0,433,T
3-PA,572,0,426,0,0,426,T
3-PA,573,0,430,0,0,430,T
3-PA,574,0,0,0,432,432,C
3-PA,575,0,0,434,0,434,G
3-PA,576,0,431,0,0,431,T
3-PA,577,1,0,0,433,434,C
3-PA,578,421,0,0,0,421,A
3-PA,579,0,0,492,0,492,G
3-PA,580,0,499,0,0,499,T
3-PA,581,0,0,0,497,497,C
3-PA,582,0,0,0,494,494,C
3-PA,583,0,2,501,0,503,G
3-PA,584,497,0,0,3,500,A
3-PA,585,505,0,0,0,505,A
3-PA,586,503,0,0,0,503,A
3-PA,587,0,0,510,0,510,G
3-PA,588,500,0,0,0,500,A
3-PA,589,0,1,514,0,515,G
3-PA,590,0,0,507,0,507,G
3-PA,591,0,0,0,517,517,C
3-PA,592,0,0,519,0,519,G
3-PA,593,517,0,0,0,517,A
3-PA,594,521,0,0,0,521,A
3-PA,595,0,1,520,0,521,G
3-PA,596,527,0,0,1,528,A
3-PA,597,520,0,0,0,520,A
3-PA,598,516,0,0,1,517,A
3-PA,599,0,0,0,524,524,C
3-PA,600,524,0,0,0,524,A
3-PA,601,520,0,0,0,520,A
3-PA,602,0,522,0,0,522,T
3-PA,603,0,527,0,0,527,T
3-PA,604,0,1,519,0,520,G
3-PA,605,516,0,0,0,516,A
3-PA,606,525,0,0,0,525,A
3-PA,607,0,0,524,0,524,G
3-PA,608,530,0,0,0,530,A
3-PA,609,520,0,0,0,520,A
3-PA,610,529,0,0,0,529,A
3-PA,611,529,0,0,0,529,A
3-PA,612,531,0,0,0,531,A
3-PA,613,0,535,0,0,535,T
3-PA,614,0,535,0,0,535,T
3-PA,615,0,537,0,0,537,T
3-PA,616,0,1,531,0,532,G
3-PA,617,527,0,0,0,527,A
3-PA,618,539,0,0,0,539,A
3-PA,619,534,0,0,0,534,A
3-PA,620,0,546,0,0,546,T
3-PA,621,1,0,0,607,608,C
3-PA,622,608,0,0,0,608,A
3-PA,623,0,0,0,620,620,C
3-PA,624,613,0,1,3,617,A
3-PA,625,0,0,635,0,635,G
3-PA,626,0,2,659,0,661,G
3-PA,627,664,0,0,0,664,A
3-PA,628,681,0,0,0,681,A
3-PA,629,0,0,0,696,696,C
3-PA,630,0,684,0,0,684,T
3-PA,631,727,0,0,0,727,A
3-PA,632,0,743,0,0,743,T
3-PA,633,0,0,773,0,773,G
3-PA,634,0,0,0,771,771,C
3-PA,635,0,0,761,0,761,G
3-PA,636,0,758,0,1,759,T
3-PA,637,756,1,1,0,758,A
3-PA,638,0,0,763,0,763,G
3-PA,639,0,0,754,0,754,G
3-PA,640,0,0,0,758,758,C
3-PA,641,0,750,0,0,750,T
3-PA,642,0,753,0,0,753,T
3-PA,643,0,0,751,0,751,G
3-PA,644,0,0,1,750,751,C
3-PA,645,0,0,0,762,762,C
3-PA,646,1,2,763,0,766,G
3-PA,647,762,0,0,0,762,A
3-PA,648,0,0,0,777,777,C
3-PA,649,1,0,0,772,773,C
3-PA,650,782,0,0,0,782,A
3-PA,651,779,0,1,0,780,A
3-PA,652,775,0,1,0,776,A
3-PA,653,0,0,778,0,778,G
3-PA,654,0,784,0,0,784,T
3-PA,655,3,0,0,783,786,C
3-PA,656,0,784,0,0,784,T
3-PA,657,1,1,0,790,792,C
3-PA,658,3,0,0,798,801,C
3-PA,659,2,1,0,801,804,C
3-PA,660,803,0,0,0,803,A
3-PA,661,1,0,0,819,820,C
3-PA,662,0,1,0,810,811,C
3-PA,663,1,1,812,1,815,G
3-PA,664,817,0,0,0,817,A
3-PA,665,828,0,0,0,828,A
3-PA,666,0,0,0,828,828,C
3-PA,667,0,821,0,0,821,T
3-PA,668,0,852,0,0,852,T
3-PA,669,0,0,0,862,862,C
3-PA,670,0,856,0,1,857,T
3-PA,671,1,0,0,863,864,C
3-PA,672,0,0,0,861,861,C
3-PA,673,1,855,0,0,856,T
3-PA,674,0,0,861,0,861,G
3-PA,675,0,0,0,864,864,C
3-PA,676,1,0,0,874,875,C
3-PA,677,0,871,0,0,871,T
3-PA,678,0,871,0,0,871,T
3-PA,679,0,1,868,0,869,G
3-PA,680,861,0,2,0,863,A
3-PA,681,0,1,884,0,885,G
3-PA,682,882,0,0,0,882,A
3-PA,683,888,0,0,0,888,A
3-PA,684,0,908,0,0,908,T
3-PA,685,0,914,0,0,914,T
3-PA,686,1,912,0,1,914,T
3-PA,687,0,914,0,1,915,T
3-PA,688,907,0,2,0,909,A
3-PA,689,0,0,908,0,908,G
3-PA,690,909,0,1,0,910,A
3-PA,691,0,1,933,0,934,G
3-PA,692,1,0,0,940,941,C
3-PA,693,0,0,0,957,957,C
3-PA,694,0,976,0,0,976,T
3-PA,695,1008,0,1,0,1009,A
3-PA,696,0,1015,0,0,1015,T
3-PA,697,0,1,1027,0,1028,G
3-PA,698,0,1022,0,0,1022,T
3-PA,699,0,0,1031,0,1031,G
3-PA,700,0,1,1019,0,1020,G
3-PA,701,1002,0,2,0,1004,A
3-PA,702,0,1006,0,0,1006,T
3-PA,703,0,2,986,0,988,G
3-PA,704,0,0,1028,0,1028,G
3-PA,705,1026,0,0,0,1026,A
3-PA,706,0,1025,0,1,1026,T
3-PA,707,0,1033,0,1,1034,T
3-PA,708,1,1,0,1026,1028,C
3-PA,709,0,4,1022,0,1026,G
3-PA,710,1036,0,0,1,1037,A
3-PA,711,1033,0,1,1,1035,A
3-PA,712,0,0,0,1042,1042,C
3-PA,713,2,0,0,1027,1029,C
3-PA,714,0,0,1022,1,1023,G
3-PA,715,1026,0,0,0,1026,A
3-PA,716,1025,0,0,0,1025,A
3-PA,717,2,2,0,1036,1040,C
3-PA,718,0,1,1038,0,1039,G
3-PA,719,1,0,1043,0,1044,G
3-PA,720,0,0,0,1061,1061,C
3-PA,721,0,1066,0,1,1067,T
3-PA,722,0,0,1089,0,1089,G
3-PA,723,1,0,0,1094,1095,C
3-PA,724,1101,0,0,0,1101,A
3-PA,725,0,1098,0,0,1098,T
3-PA,726,0,1098,0,0,1098,T
3-PA,727,0,1,1098,0,1099,G
3-PA,728,1064,0,2,0,1066,A
3-PA,729,2,1,1069,0,1072,G
3-PA,730,0,0,1062,0,1062,G
3-PA,731,0,2,1060,1,1063,G
3-PA,732,1,0,0,1066,1067,C
3-PA,733,1057,0,0,0,1057,A
3-PA,734,1060,0,3,1,1064,A
3-PA,735,1,0,1067,0,1068,G
3-PA,736,0,0,0,1067,1067,C
3-PA,737,0,1076,0,1,1077,T
3-PA,738,0,1074,0,0,1074,T
3-PA,739,0,1082,0,0,1082,T
3-PA,740,2,1,0,1078,1081,C
3-PA,741,0,1077,0,0,1077,T
3-PA,742,2,0,0,1084,1086,C
3-PA,743,1086,0,0,0,1086,A
3-PA,744,1080,0,0,0,1080,A
3-PA,745,1076,0,0,0,1076,A
3-PA,746,0,1081,0,0,1081,T
3-PA,747,0,0,1121,0,1121,G
3-PA,748,0,1121,0,2,1123,T
3-PA,749,2,0,0,1141,1143,C
3-PA,750,5,1,0,1141,1147,C
3-PA,751,1153,0,0,0,1153,A
3-PA,752,1155,0,0,0,1155,A
3-PA,753,1154,0,0,1,1155,A
3-PA,754,0,1,1180,0,1181,G
3-PA,755,1164,0,0,0,1164,A
3-PA,756,1146,0,5,0,1151,A
3-PA,757,0,0,1171,0,1171,G
3-PA,758,0,1147,0,0,1147,T
3-PA,759,0,1,1159,0,1160,G
3-PA,760,1154,0,0,0,1154,A
3-PA,761,1160,0,0,0,1160,A
3-PA,762,0,1162,0,0,1162,T
3-PA,763,0,3,1159,0,1162,G
3-PA,764,0,1,0,1158,1159,C
3-PA,765,1,0,0,1167,1168,C
3-PA,766,1,0,0,1173,1174,C
3-PA,767,1178,0,0,0,1178,A
3-PA,768,1184,0,0,0,1184,A
3-PA,769,1190,1,0,0,1191,A
3-PA,770,0,1196,0,0,1196,T
3-PA,771,0,1199,0,0,1199,T
3-PA,772,0,0,1196,0,1196,G
3-PA,773,1193,0,3,0,1196,A
3-PA,774,1193,0,0,0,1193,A
3-PA,775,0,0,0,1197,1197,C
3-PA,776,2,0,0,1198,1200,C
3-PA,777,0,1175,0,0,1175,T
3-PA,778,0,1220,0,2,1222,T
3-PA,779,0,1229,0,0,1229,T
3-PA,780,0,1253,0,0,1253,T
3-PA,781,1,0,0,1255,1256,C
3-PA,782,0,1252,0,0,1252,T
3-PA,783,0,0,1261,0,1261,G
3-PA,784,1248,0,1,0,1249,A
3-PA,785,1269,0,1,0,1270,A
3-PA,786,0,3,1271,0,1274,G
3-PA,787,1271,0,1,0,1272,A
3-PA,788,0,0,0,1280,1280,C
3-PA,789,1271,0,0,0,1271,A
3-PA,790,1273,0,2,0,1275,A
3-PA,791,0,0,0,1394,1394,C
3-PA,792,1394,0,0,0,1394,A
3-PA,793,0,0,0,1401,1401,C
3-PA,794,3,1,0,1385,1389,C
3-PA,795,1398,0,0,0,1398,A
3-PA,796,1391,0,1,0,1392,A
3-PA,797,0,2,1387,0,1389,G
3-PA,798,1381,0,1,0,1382,A
3-PA,799,0,0,0,1386,1386,C
3-PA,800,0,0,0,1326,1326,C
3-PA,801,1326,0,2,0,1328,A
3-PA,802,1327,0,0,0,1327,A
3-PA,803,1,1325,0,1,1327,T
3-PA,804,3,1,0,1335,1339,C
3-PA,805,1333,0,0,0,1333,A
3-PA,806,1317,0,0,0,1317,A
3-PA,807,1323,0,0,0,1323,A
3-PA,808,0,1,0,1343,1344,C
3-PA,809,0,1326,0,0,1326,T
3-PA,810,0,1328,0,1,1329,T
3-PA,811,2,0,0,1336,1338,C
3-PA,812,2,2,0,1340,1344,C
3-PA,813,0,1,1348,0,1349,G
3-PA,814,1345,0,0,0,1345,A
3-PA,815,1352,0,0,0,1352,A
3-PA,816,0,1335,0,16,1351,T
3-PA,817,0,3,1336,0,1339,G
3-PA,818,0,1,1328,0,1329,G
3-PA,819,1336,0,1,0,1337,A
3-PA,820,0,1,0,1351,1352,C
3-PA,821,1,0,1,1332,1334,C
3-PA,822,0,1371,0,1,1372,T
3-PA,823,2,0,0,1426,1428,C
3-PA,824,0,0,0,1445,1445,C
3-PA,825,0,1446,0,1,1447,T
3-PA,826,0,1453,0,0,1453,T
3-PA,827,0,0,1500,0,1500,G
3-PA,828,0,1497,0,1,1498,T
3-PA,829,0,1497,0,0,1497,T
3-PA,830,1489,0,0,0,1489,A
3-PA,831,0,1461,0,1,1462,T
3-PA,832,2,0,0,1455,1457,C
3-PA,833,1433,0,0,2,1435,A
3-PA,834,1,0,1423,1,1425,G
3-PA,835,0,0,0,1428,1428,C
3-PA,836,1,0,1390,0,1391,G
3-PA,837,0,0,1423,0,1423,G
3-PA,838,0,1406,0,3,1409,T
3-PA,839,1,0,0,1441,1442,C
3-PA,840,5,0,1,1439,1445,C
3-PA,841,1460,0,0,0,1460,A
3-PA,842,1462,0,0,0,1462,A
3-PA,843,1463,0,1,0,1464,A
3-PA,844,0,1451,0,1,1452,T
3-PA,845,0,1467,0,0,1467,T
3-PA,846,2,0,0,1466,1468,C
3-PA,847,0,0,0,1465,1465,C
3-PA,848,0,1444,0,2,1446,T
3-PA,849,3,0,0,1457,1460,C
3-PA,850,2,0,0,1477,1479,C
3-PA,851,0,1467,0,0,1467,T
3-PA,852,0,0,1474,0,1474,G
3-PA,853,1458,1,0,0,1459,A
3-PA,854,0,1477,0,1,1478,T
3-PA,855,0,3,1469,0,1472,G
3-PA,856,0,1,1452,0,1453,G
3-PA,857,1439,0,0,0,1439,A
3-PA,858,1,1449,0,0,1450,T
3-PA,859,0,0,1460,0,1460,G
3-PA,860,0,0,0,1510,1510,C
3-PA,861,0,1511,0,0,1511,T
3-PA,862,0,1511,0,0,1511,T
3-PA,863,0,1521,0,1,1522,T
3-PA,864,1513,1,0,0,1514,A
3-PA,865,1521,0,1,1,1523,A
3-PA,866,1518,0,0,0,1518,A
3-PA,867,1517,0,0,0,1517,A
3-PA,868,0,1521,0,1,1522,T
3-PA,869,0,1450,0,1,1451,T
3-PA,870,0,5,1440,0,1445,G
3-PA,871,1420,0,2,0,1422,A
3-PA,872,1,0,1433,0,1434,G
3-PA,873,2,0,0,1438,1440,C
3-PA,874,1450,0,0,0,1450,A
3-PA,875,0,1489,0,0,1489,T
3-PA,876,0,1495,0,0,1495,T
3-PA,877,0,1,1475,0,1476,G
3-PA,878,1479,0,2,0,1481,A
3-PA,879,1478,1,2,0,1481,A
3-PA,880,0,2,1483,0,1485,G
3-PA,881,1476,0,0,0,1476,A
3-PA,882,0,1,0,1484,1485,C
3-PA,883,1,0,0,1471,1472,C
3-PA,884,6,0,0,1471,1477,C
3-PA,885,1485,0,0,0,1485,A
3-PA,886,1491,1,0,0,1492,A
3-PA,887,0,0,1495,0,1495,G
3-PA,888,0,1490,0,4,1494,T
3-PA,889,1,0,0,1513,1514,C
3-PA,890,1505,4,1,0,1510,A
3-PA,891,0,0,0,1521,1521,C
3-PA,892,0,0,1524,0,1524,G
3-PA,893,1519,0,1,0,1520,A
3-PA,894,1524,0,2,0,1526,A
3-PA,895,0,1,1569,0,1570,G
3-PA,896,0,2,1564,0,1566,G
3-PA,897,1543,1,2,0,1546,A
3-PA,898,2,1,1582,0,1585,G
3-PA,899,1573,0,0,1,1574,A
3-PA,900,1581,0,1,0,1582,A
3-PA,901,0,0,1582,0,1582,G
3-PA,902,0,0,1544,0,1544,G
3-PA,903,0,1,1565,0,1566,G
3-PA,904,1524,0,1,0,1525,A
3-PA,905,0,1514,0,0,1514,T
3-PA,906,2,0,0,1533,1535,C
3-PA,907,2,0,1,1646,1649,C
3-PA,908,1,0,0,1687,1688,C
3-PA,909,1718,0,1,0,1719,A
3-PA,910,0,1709,0,0,1709,T
3-PA,911,0,1737,0,0,1737,T
3-PA,912,1786,0,0,0,1786,A
3-PA,913,0,1780,0,2,1782,T
3-PA,914,1774,1,0,0,1775,A
3-PA,915,0,1768,0,0,1768,T
3-PA,916,0,2,1626,0,1628,G
3-PA,917,1607,0,1,0,1608,A
3-PA,918,0,1609,0,1,1610,T
3-PA,919,1,0,1610,0,1611,G
3-PA,920,0,0,0,1598,1598,C
3-PA,921,5,3,1596,0,1604,G
3-PA,922,1611,0,2,0,1613,A
3-PA,923,0,1606,0,1,1607,T
3-PA,924,3,0,0,1623,1626,C
3-PA,925,1621,1,0,0,1622,A
3-PA,926,1609,0,1,0,1610,A
3-PA,927,0,0,1623,0,1623,G
3-PA,928,0,1601,0,0,1601,T
3-PA,929,0,1,1626,0,1627,G
3-PA,930,0,2,0,1630,1632,C
3-PA,931,1631,0,3,0,1634,A
3-PA,932,0,1638,0,0,1638,T
3-PA,933,1644,0,0,0,1644,A
3-PA,934,1666,0,0,0,1666,A
3-PA,935,1669,1,0,0,1670,A
3-PA,936,1654,0,2,0,1656,A
3-PA,937,1647,0,2,0,1649,A
3-PA,938,0,1,0,1662,1663,C
3-PA,939,1642,0,0,0,1642,A
3-PA,940,0,1635,0,0,1635,T
3-PA,941,0,1637,0,0,1637,T
3-PA,942,4,1,0,1642,1647,C
3-PA,943,0,1644,0,0,1644,T
3-PA,944,0,1642,1,0,1643,T
3-PA,945,0,1645,4,0,1649,T
3-PA,946,1,3,1637,0,1641,G
3-PA,947,1,1,1636,0,1638,G
3-PA,948,1638,0,0,0,1638,A
3-PA,949,0,1641,0,0,1641,T
3-PA,950,0,4,1641,1,1646,G
3-PA,951,0,0,1659,0,1659,G
3-PA,952,1675,0,2,0,1677,A
3-PA,953,1669,0,0,0,1669,A
3-PA,954,1684,0,2,0,1686,A
3-PA,955,8,3,1678,0,1689,G
3-PA,956,1678,0,0,0,1678,A
3-PA,957,1840,0,1,0,1841,A
3-PA,958,2,2,1,1858,1863,C
3-PA,959,1,0,0,1885,1886,C
3-PA,960,0,1867,0,3,1870,T
3-PA,961,0,1905,0,0,1905,T
3-PA,962,1901,0,2,0,1903,A
3-PA,963,0,1905,0,0,1905,T
3-PA,964,1908,0,0,0,1908,A
3-PA,965,0,1929,0,0,1929,T
3-PA,966,1828,0,0,0,1828,A
3-PA,967,0,0,1827,0,1827,G
3-PA,968,1,1802,0,2,1805,T
3-PA,969,4,0,0,1817,1821,C
3-PA,970,1815,0,1,0,1816,A
3-PA,971,1807,0,0,0,1807,A
3-PA,972,1811,0,1,0,1812,A
3-PA,973,0,1,0,1817,1818,C
3-PA,974,3,1,0,1807,1811,C
3-PA,975,1793,0,1,0,1794,A
3-PA,976,1,0,0,1803,1804,C
3-PA,977,1802,0,0,0,1802,A
3-PA,978,0,0,0,1807,1807,C
3-PA,979,0,2,1811,0,1813,G
3-PA,980,1770,0,0,0,1770,A
3-PA,981,1798,0,0,0,1798,A
3-PA,982,1779,0,4,0,1783,A
3-PA,983,1781,0,2,0,1783,A
3-PA,984,0,1,1816,0,1817,G
3-PA,985,1,2,1783,0,1786,G
3-PA,986,1,1,1771,1,1774,G
3-PA,987,0,0,1780,1,1781,G
3-PA,988,1814,0,0,0,1814,A
3-PA,989,0,1818,0,0,1818,T
3-PA,990,1824,0,0,0,1824,A
3-PA,991,1825,0,0,0,1825,A
3-PA,992,1832,1,0,0,1833,A
3-PA,993,0,1817,0,1,1818,T
3-PA,994,0,1811,0,0,1811,T
3-PA,995,8,0,0,1817,1825,C
3-PA,996,1836,1,0,0,1837,A
3-PA,997,1833,0,0,0,1833,A
3-PA,998,1834,0,0,0,1834,A
3-PA,999,0,1834,0,0,1834,T
3-PA,1000,0,1833,0,3,1836,T
3-PA,1001,1829,0,3,0,1832,A
3-PA,1002,2,0,0,1829,1831,C
3-PA,1003,1,0,0,1834,1835,C
3-PA,1004,0,1811,0,0,1811,T
3-PA,1005,0,1,1832,0,1833,G
3-PA,1006,0,0,0,1823,1823,C
3-PA,1007,0,1851,0,1,1852,T
3-PA,1008,1,1,1874,0,1876,G
3-PA,1009,1,1860,0,3,1864,T
3-PA,1010,6,0,0,1871,1877,C
3-PA,1011,1895,0,1,0,1896,A
3-PA,1012,0,1887,0,2,1889,T
3-PA,1013,0,4,1891,0,1895,G
3-PA,1014,0,3,1868,0,1871,G
3-PA,1015,1882,0,2,0,1884,A
3-PA,1016,1913,0,2,0,1915,A
3-PA,1017,0,0,1902,0,1902,G
3-PA,1018,1,0,0,1914,1915,C
3-PA,1019,1915,0,0,0,1915,A
3-PA,1020,1930,1,1,0,1932,A
3-PA,1021,0,0,1941,0,1941,G
3-PA,1022,0,1936,0,1,1937,T
3-PA,1023,1938,0,0,0,1938,A
3-PA,1024,0,0,0,1933,1933,C
3-PA,1025,0,1899,0,0,1899,T
3-PA,1026,0,0,1938,0,1938,G
3-PA,1027,0,1914,1,1,1916,T
3-PA,1028,4,0,0,1922,1926,C
3-PA,1029,1932,0,0,0,1932,A
3-PA,1030,0,3,1941,0,1944,G
3-PA,1031,1933,0,0,0,1933,A
3-PA,1032,1942,0,0,0,1942,A
3-PA,1033,0,1944,0,0,1944,T
3-PA,1034,0,1950,0,0,1950,T
3-PA,1035,1,0,1939,0,1940,G
3-PA,1036,0,0,0,1930,1930,C
3-PA,1037,1938,2,1,0,1941,A
3-PA,1038,0,2,1946,0,1948,G
3-PA,1039,0,7,1911,0,1918,G
3-PA,1040,1952,0,1,0,1953,A
3-PA,1041,0,0,0,1953,1953,C
3-PA,1042,1932,0,2,0,1934,A
3-PA,1043,0,1940,0,1,1941,T
3-PA,1044,0,1948,0,2,1950,T
3-PA,1045,0,4,1956,0,1960,G
3-PA,1046,1952,0,2,0,1954,A
3-PA,1047,1954,0,6,0,1960,A
3-PA,1048,1947,0,1,0,1948,A
3-PA,1049,1949,0,0,0,1949,A
3-PA,1050,0,1934,0,1,1935,T
3-PA,1051,0,4,1945,0,1949,G
3-PA,1052,1925,0,3,0,1928,A
3-PA,1053,0,2,1952,0,1954,G
3-PA,1054,2,6,1931,0,1939,G
3-PA,1055,1922,0,1,0,1923,A
3-PA,1056,0,1,1946,0,1947,G
3-PA,1057,1945,1,0,0,1946,A
3-PA,1058,1933,0,3,0,1936,A
3-PA,1059,1,1,1940,0,1942,G
3-PA,1060,0,0,1916,0,1916,G
3-PA,1061,0,1933,0,5,1938,T
3-PA,1062,0,1946,0,1,1947,T
3-PA,1063,1,0,0,1954,1955,C
3-PA,1064,2,0,1,1978,1981,C
3-PA,1065,1983,0,1,0,1984,A
3-PA,1066,1973,0,1,1,1975,A
3-PA,1067,0,2,1987,0,1989,G
3-PA,1068,9,2,1990,0,2001,G
3-PA,1069,1980,0,0,0,1980,A
3-PA,1070,2,0,0,1993,1995,C
3-PA,1071,0,2007,0,2,2009,T
3-PA,1072,2007,0,0,0,2007,A
3-PA,1073,2011,0,1,0,2012,A
3-PA,1074,2005,0,1,0,2006,A
3-PA,1075,2007,0,1,0,2008,A
3-PA,1076,1992,0,0,0,1992,A
3-PA,1077,0,0,0,1981,1981,C
3-PA,1078,1975,0,0,0,1975,A
3-PA,1079,0,1967,0,0,1967,T
3-PA,1080,0,0,1991,0,1991,G
3-PA,1081,1969,1,2,0,1972,A
3-PA,1082,1974,0,3,0,1977,A
3-PA,1083,1,2,1983,0,1986,G
3-PA,1084,1984,0,0,0,1984,A
3-PA,1085,1990,0,0,0,1990,A
3-PA,1086,1986,0,0,0,1986,A
3-PA,1087,1968,0,0,0,1968,A
3-PA,1088,0,1,0,1980,1981,C
3-PA,1089,2,4,1975,0,1981,G
3-PA,1090,1983,0,2,0,1985,A
3-PA,1091,0,0,1983,0,1983,G
3-PA,1092,1,1952,2,0,1955,T
3-PA,1093,7,0,1,1986,1994,C
3-PA,1094,2004,0,0,0,2004,A
3-PA,1095,2032,0,0,0,2032,A
3-PA,1096,1,0,0,2024,2025,C
3-PA,1097,0,2027,1,1,2029,T
3-PA,1098,0,3,2056,0,2059,G
3-PA,1099,2047,0,1,0,2048,A
3-PA,1100,2060,0,1,0,2061,A
3-PA,1101,0,1,2056,0,2057,G
3-PA,1102,0,1973,0,2,1975,T
3-PA,1103,0,1,1991,0,1992,G
3-PA,1104,2,2,1973,0,1977,G
3-PA,1105,0,1,1996,0,1997,G
3-PA,1106,1,0,0,1998,1999,C
3-PA,1107,0,1965,0,1,1966,T
3-PA,1108,11,0,0,1976,1987,C
3-PA,1109,0,1978,0,0,1978,T
3-PA,1110,0,1997,0,1,1998,T
3-PA,1111,0,1,2021,0,2022,G
3-PA,1112,0,2,2029,0,2031,G
3-PA,1113,0,2003,0,4,2007,T
3-PA,1114,0,6,2012,0,2018,G
3-PA,1115,2015,0,0,0,2015,A
3-PA,1116,2027,0,1,0,2028,A
3-PA,1117,2032,0,3,0,2035,A
3-PA,1118,2042,0,1,0,2043,A
3-PA,1119,0,1,0,2038,2039,C
3-PA,1120,2026,0,1,0,2027,A
3-PA,1121,0,2015,0,0,2015,T
3-PA,1122,0,3,1996,1,2000,G
3-PA,1123,1,0,1997,0,1998,G
3-PA,1124,1,1,0,2001,2003,C
3-PA,1125,2005,0,3,0,2008,A
3-PA,1126,3,0,0,1990,1993,C
3-PA,1127,2,0,0,2028,2030,C
3-PA,1128,2068,1,0,0,2069,A
3-PA,1129,0,4,2080,0,2084,G
3-PA,1130,2064,0,0,0,2064,A
3-PA,1131,3,1,2108,0,2112,G
3-PA,1132,2098,0,0,0,2098,A
3-PA,1133,2098,0,0,0,2098,A
3-PA,1134,0,2,2103,0,2105,G
3-PA,1135,1,0,2091,0,2092,G
3-PA,1136,0,2019,0,1,2020,T
3-PA,1137,2086,0,0,0,2086,A
3-PA,1138,0,3,2077,0,2080,G
3-PA,1139,2058,0,1,0,2059,A
3-PA,1140,1,0,0,2071,2072,C
3-PA,1141,0,2048,0,1,2049,T
3-PA,1142,0,2047,0,0,2047,T
3-PA,1143,0,2070,0,0,2070,T
3-PA,1144,0,3,2073,1,2077,G
3-PA,1145,2070,0,1,0,2071,A
3-PA,1146,2078,0,0,0,2078,A
3-PA,1147,2075,0,1,1,2077,A
3-PA,1148,2067,0,0,0,2067,A
3-PA,1149,0,0,0,2085,2085,C
3-PA,1150,0,2078,1,0,2079,T
3-PA,1151,0,0,2104,0,2104,G
3-PA,1152,0,0,0,2092,2092,C
3-PA,1153,2108,0,2,0,2110,A
3-PA,1154,0,0,2098,0,2098,G
3-PA,1155,2093,0,1,0,2094,A
3-PA,1156,0,2,2154,0,2156,G
3-PA,1157,2167,0,0,0,2167,A
3-PA,1158,1,1,1,2133,2136,C
3-PA,1159,2152,0,2,0,2154,A
3-PA,1160,0,2130,0,0,2130,T
3-PA,1161,2143,0,1,0,2144,A
3-PA,1162,2130,1,3,0,2134,A
3-PA,1163,0,1,2121,0,2122,G
3-PA,1164,0,1,0,2120,2121,C
3-PA,1165,2,2,2092,0,2096,G
3-PA,1166,2106,0,5,0,2111,A
3-PA,1167,0,2098,0,0,2098,T
3-PA,1168,0,2108,0,0,2108,T
3-PA,1169,0,2099,0,1,2100,T
3-PA,1170,2,2,2113,0,2117,G
3-PA,1171,2114,0,1,0,2115,A
3-PA,1172,2106,0,3,0,2109,A
3-PA,1173,2,2,2111,0,2115,G
3-PA,1174,1,1,0,2157,2159,C
3-PA,1175,2160,0,1,0,2161,A
3-PA,1176,2290,0,3,0,2293,A
3-PA,1177,0,2291,1,0,2292,T
3-PA,1178,2298,0,1,1,2300,A
3-PA,1179,1,2299,0,1,2301,T
3-PA,1180,0,3,2309,0,2312,G
3-PA,1181,2342,0,1,0,2343,A
3-PA,1182,0,2320,0,0,2320,T
3-PA,1183,2279,0,1,0,2280,A
3-PA,1184,1,2,2269,0,2272,G
3-PA,1185,0,2198,0,2,2200,T
3-PA,1186,0,3,2204,0,2207,G
3-PA,1187,2208,0,0,0,2208,A
3-PA,1188,0,1,0,2170,2171,C
3-PA,1189,0,5,2163,0,2168,G
3-PA,1190,2175,0,1,0,2176,A
3-PA,1191,2175,0,1,0,2176,A
3-PA,1192,0,1,0,2165,2166,C
3-PA,1193,1,0,0,2204,2205,C
3-PA,1194,0,2198,0,0,2198,T
3-PA,1195,0,1,2263,0,2264,G
3-PA,1196,2251,1,0,0,2252,A
3-PA,1197,2255,0,0,0,2255,A
3-PA,1198,0,2243,0,0,2243,T
3-PA,1199,0,2236,0,1,2237,T
3-PA,1200,2238,0,1,0,2239,A
3-PA,1201,2223,0,1,0,2224,A
3-PA,1202,1,2,2229,0,2232,G
3-PA,1203,0,1,2219,1,2221,G
3-PA,1204,0,2166,0,2,2168,T
3-PA,1205,4,1,0,2179,2184,C
3-PA,1206,2164,0,2,0,2166,A
3-PA,1207,0,0,0,2237,2237,C
3-PA,1208,0,2224,1,2,2227,T
3-PA,1209,0,2216,0,2,2218,T
3-PA,1210,0,2247,0,0,2247,T
3-PA,1211,0,0,0,2239,2239,C
3-PA,1212,2235,0,1,0,2236,A
3-PA,1213,2241,0,0,0,2241,A
3-PA,1214,0,0,2266,0,2266,G
3-PA,1215,0,1,0,2246,2247,C
3-PA,1216,0,2236,0,0,2236,T
3-PA,1217,0,1,2291,0,2292,G
3-PA,1218,0,3,2287,0,2290,G
3-PA,1219,2314,1,3,0,2318,A
3-PA,1220,0,2330,0,1,2331,T
3-PA,1221,2329,0,0,0,2329,A
3-PA,1222,0,2,0,2346,2348,C
3-PA,1223,2311,1,0,0,2312,A
3-PA,1224,0,4,2330,0,2334,G
3-PA,1225,2323,1,1,0,2325,A
3-PA,1226,2294,0,0,0,2294,A
3-PA,1227,0,2262,0,0,2262,T
3-PA,1228,1,5,2284,1,2291,G
3-PA,1229,2278,0,2,0,2280,A
3-PA,1230,0,0,2305,0,2305,G
3-PA,1231,0,2295,0,1,2296,T
3-PA,1232,0,2279,0,1,2280,T
3-PA,1233,5,1,0,2295,2301,C
3-PA,1234,2336,0,0,0,2336,A
3-PA,1235,2334,0,1,0,2335,A
3-PA,1236,0,0,0,2328,2328,C
3-PA,1237,2300,0,2,0,2302,A
3-PA,1238,2279,0,32,0,2311,A
3-PA,1239,0,0,2271,0,2271,G
3-PA,1240,1,1,2279,0,2281,G
3-PA,1241,0,0,0,2258,2258,C
3-PA,1242,0,0,0,2270,2270,C
3-PA,1243,0,2241,0,4,2245,T
3-PA,1244,1,0,2286,0,2287,G
3-PA,1245,3,2269,0,0,2272,T
3-PA,1246,0,2,2304,0,2306,G
3-PA,1247,2296,1,3,1,2301,A
3-PA,1248,0,0,2303,0,2303,G
3-PA,1249,0,0,0,2270,2270,C
3-PA,1250,0,2267,1,0,2268,T
3-PA,1251,2305,0,2,0,2307,A
3-PA,1252,2306,0,0,0,2306,A
3-PA,1253,0,0,0,2308,2308,C
3-PA,1254,0,2292,0,2,2294,T
3-PA,1255,0,5,2288,0,2293,G
3-PA,1256,2280,0,1,0,2281,A
3-PA,1257,1,2262,0,1,2264,T
3-PA,1258,1,2282,0,0,2283,T
3-PA,1259,8,0,0,2281,2289,C
3-PA,1260,2307,0,3,0,2310,A
3-PA,1261,0,0,2331,0,2331,G
3-PA,1262,1,2305,0,1,2307,T
3-PA,1263,3,0,0,2312,2315,C
3-PA,1264,0,2308,0,1,2309,T
3-PA,1265,2,1,2400,1,2404,G
3-PA,1266,0,2,2406,0,2408,G
3-PA,1267,2406,0,0,0,2406,A
3-PA,1268,0,2417,0,0,2417,T
3-PA,1269,2340,0,0,1,2341,A
3-PA,1270,0,2,2343,1,2346,G
3-PA,1271,2322,1,1,0,2324,A
3-PA,1272,4,0,2323,0,2327,G
3-PA,1273,0,1,1,2301,2303,C
3-PA,1274,0,2254,0,0,2254,T
3-PA,1275,2,2253,0,0,2255,T
3-PA,1276,0,2,2265,1,2268,G
3-PA,1277,2273,0,0,0,2273,A
3-PA,1278,0,2270,0,1,2271,T
3-PA,1279,1,4,2265,0,2270,G
3-PA,1280,2281,0,1,0,2282,A
3-PA,1281,2272,0,0,0,2272,A
3-PA,1282,2287,0,2,0,2289,A
3-PA,1283,0,2243,0,0,2243,T
3-PA,1284,0,2275,0,0,2275,T
3-PA,1285,0,0,2289,0,2289,G
3-PA,1286,0,2,2293,0,2295,G
3-PA,1287,2286,1,3,0,2290,A
3-PA,1288,0,0,2296,0,2296,G
3-PA,1289,2271,0,2,0,2273,A
3-PA,1290,1,0,2279,0,2280,G
3-PA,1291,0,4,2285,0,2289,G
3-PA,1292,2304,0,4,0,2308,A
3-PA,1293,0,1,0,2311,2312,C
3-PA,1294,1,0,2292,0,2293,G
3-PA,1295,1,2296,0,0,2297,T
3-PA,1296,2292,0,6,0,2298,A
3-PA,1297,0,0,2305,0,2305,G
3-PA,1298,0,1,0,2293,2294,C
3-PA,1299,1,1,0,2241,2243,C
3-PA,1300,0,0,0,2244,2244,C
3-PA,1301,2,0,0,2286,2288,C
3-PA,1302,2306,0,0,0,2306,A
3-PA,1303,2355,0,0,0,2355,A
3-PA,1304,4,2328,0,1,2333,T
3-PA,1305,0,2337,0,0,2337,T
3-PA,1306,0,4,2333,1,2338,G
3-PA,1307,2299,0,2,0,2301,A
3-PA,1308,0,2,2299,0,2301,G
3-PA,1309,1,0,0,2293,2294,C
3-PA,1310,2288,0,0,0,2288,A
3-PA,1311,1,0,0,2310,2311,C
3-PA,1312,2271,0,0,0,2271,A
3-PA,1313,0,2303,0,0,2303,T
3-PA,1314,0,2306,1,0,2307,T
3-PA,1315,2,0,2320,0,2322,G
3-PA,1316,0,0,0,2282,2282,C
3-PA,1317,2298,0,2,0,2300,A
3-PA,1318,2301,0,1,0,2302,A
3-PA,1319,1,1,2309,0,2311,G
3-PA,1320,0,1,0,2278,2279,C
3-PA,1321,2281,1,1,0,2283,A
3-PA,1322,0,2241,1,2,2244,T
3-PA,1323,1,2,2248,0,2251,G
3-PA,1324,2243,0,3,0,2246,A
3-PA,1325,0,2,2244,0,2246,G
3-PA,1326,2247,0,1,0,2248,A
3-PA,1327,2254,0,0,0,2254,A
3-PA,1328,1,1,2239,0,2241,G
3-PA,1329,0,8,2232,0,2240,G
3-PA,1330,2251,0,0,0,2251,A
3-PA,1331,2243,1,0,0,2244,A
3-PA,1332,0,2244,0,1,2245,T
3-PA,1333,0,2244,0,0,2244,T
3-PA,1334,2254,7,0,1,2262,A
3-PA,1335,0,2249,0,0,2249,T
3-PA,1336,0,2246,0,0,2246,T
3-PA,1337,0,2245,0,0,2245,T
3-PA,1338,2,0,0,2218,2220,C
3-PA,1339,2237,0,1,0,2238,A
3-PA,1340,0,0,0,2265,2265,C
3-PA,1341,2267,0,0,0,2267,A
3-PA,1342,0,0,2274,0,2274,G
3-PA,1343,0,0,0,2270,2270,C
3-PA,1344,2267,0,0,0,2267,A
3-PA,1345,0,1,2259,0,2260,G
3-PA,1346,2257,0,1,0,2258,A
3-PA,1347,2,3,2259,0,2264,G
3-PA,1348,0,0,2267,0,2267,G
3-PA,1349,0,2214,1,3,2218,T
3-PA,1350,0,3,2240,0,2243,G
3-PA,1351,1,2202,0,6,2209,T
3-PA,1352,2,0,0,2211,2213,C
3-PA,1353,1,0,0,2241,2242,C
3-PA,1354,2,0,0,2228,2230,C
3-PA,1355,2263,0,0,0,2263,A
3-PA,1356,2,2256,0,1,2259,T
3-PA,1357,0,2258,1,0,2259,T
3-PA,1358,1,0,2267,0,2268,G
3-PA,1359,0,2235,0,2,2237,T
3-PA,1360,2206,0,0,0,2206,A
3-PA,1361,4,1,2203,0,2208,G
3-PA,1362,2133,0,2,0,2135,A
3-PA,1363,1,1,2132,1,2135,G
3-PA,1364,3,0,0,2106,2109,C
3-PA,1365,3,0,0,2100,2103,C
3-PA,1366,2123,2,0,0,2125,A
3-PA,1367,0,0,1,2139,2140,C
3-PA,1368,0,2129,1,0,2130,T
3-PA,1369,0,3,2133,0,2136,G
3-PA,1370,2127,0,1,1,2129,A
3-PA,1371,2106,0,1,0,2107,A
3-PA,1372,0,2143,0,1,2144,T
3-PA,1373,2154,0,1,0,2155,A
3-PA,1374,0,0,0,2180,2180,C
3-PA,1375,2120,0,1,0,2121,A
3-PA,1376,0,2120,0,1,2121,T
3-PA,1377,2099,0,0,0,2099,A
3-PA,1378,2111,0,0,0,2111,A
3-PA,1379,0,2091,0,0,2091,T
3-PA,1380,1,6,2067,0,2074,G
3-PA,1381,2051,0,5,0,2056,A
3-PA,1382,2021,1,3,0,2025,A
3-PA,1383,0,0,2024,0,2024,G
3-PA,1384,2,2,2002,0,2006,G
3-PA,1385,0,0,2042,0,2042,G
3-PA,1386,0,1,2020,0,2021,G
3-PA,1387,0,2,2049,1,2052,G
3-PA,1388,0,2014,0,0,2014,T
3-PA,1389,2024,0,0,0,2024,A
3-PA,1390,0,2028,0,0,2028,T
3-PA,1391,2039,0,1,0,2040,A
3-PA,1392,2,2,0,2170,2174,C
3-PA,1393,2127,0,0,0,2127,A
3-PA,1394,0,2069,0,0,2069,T
3-PA,1395,0,2046,0,0,2046,T
3-PA,1396,2030,0,0,0,2030,A
3-PA,1397,2060,0,0,0,2060,A
3-PA,1398,1,0,0,2055,2056,C
3-PA,1399,2017,0,0,0,2017,A
3-PA,1400,0,1,0,2020,2021,C
3-PA,1401,0,1807,0,0,1807,T
3-PA,1402,0,0,1850,0,1850,G
3-PA,1403,0,0,0,1824,1824,C
3-PA,1404,2,0,0,1822,1824,C
3-PA,1405,1,0,0,1833,1834,C
3-PA,1406,0,1793,0,1,1794,T
3-PA,1407,0,0,1823,0,1823,G
3-PA,1408,0,0,0,1815,1815,C
3-PA,1409,0,1804,0,1,1805,T
3-PA,1410,4,0,0,1841,1845,C
3-PA,1411,1785,0,1,0,1786,A
3-PA,1412,1797,0,0,0,1797,A
3-PA,1413,0,1787,0,3,1790,T
3-PA,1414,0,1,1784,0,1785,G
3-PA,1415,0,0,0,1763,1763,C
3-PA,1416,1718,0,0,0,1718,A
3-PA,1417,0,1693,0,0,1693,T
3-PA,1418,0,1,1,1690,1692,C
3-PA,1419,1,0,0,1714,1715,C
3-PA,1420,0,1659,0,0,1659,T
3-PA,1421,1,1,1690,0,1692,G
3-PA,1422,0,1681,0,1,1682,T
3-PA,1423,0,1,1678,0,1679,G
3-PA,1424,0,1,0,1675,1676,C
3-PA,1425,1657,0,0,0,1657,A
3-PA,1426,0,0,1664,0,1664,G
3-PA,1427,1,0,0,1663,1664,C
3-PA,1428,1649,0,0,0,1649,A
3-PA,1429,1643,0,1,0,1644,A
3-PA,1430,0,1591,0,0,1591,T
3-PA,1431,0,4,1588,0,1592,G
3-PA,1432,0,2,1583,0,1585,G
3-PA,1433,1588,0,0,0,1588,A
3-PA,1434,1,0,0,1570,1571,C
3-PA,1435,0,1,1574,0,1575,G
3-PA,1436,1587,0,0,0,1587,A
3-PA,1437,0,1581,0,0,1581,T
3-PA,1438,0,1580,0,1,1581,T
3-PA,1439,0,1572,0,3,1575,T
3-PA,1440,2,1564,0,0,1566,T
3-PA,1441,5,0,0,1568,1573,C
3-PA,1442,1583,0,2,0,1585,A
3-PA,1443,1582,0,1,0,1583,A
3-PA,1444,2,0,0,1576,1578,C
3-PA,1445,0,1558,1,0,1559,T
3-PA,1446,1567,0,0,0,1567,A
3-PA,1447,1561,0,0,0,1561,A
3-PA,1448,0,1546,0,0,1546,T
3-PA,1449,0,1531,0,1,1532,T
3-PA,1450,1,0,1,1549,1551,C
3-PA,1451,1,0,0,1549,1550,C
3-PA,1452,1,0,0,1544,1545,C
3-PA,1453,1551,0,0,0,1551,A
3-PA,1454,0,1554,0,2,1556,T
3-PA,1455,0,1,1558,0,1559,G
3-PA,1456,1555,0,0,0,1555,A
3-PA,1457,0,1551,0,0,1551,T
3-PA,1458,1548,0,0,0,1548,A
3-PA,1459,1544,0,0,0,1544,A
3-PA,1460,0,0,1545,0,1545,G
3-PA,1461,0,0,0,1532,1532,C
3-PA,1462,1534,0,0,0,1534,A
3-PA,1463,1488,0,2,0,1490,A
3-PA,1464,0,0,1505,0,1505,G
3-PA,1465,0,1494,0,1,1495,T
3-PA,1466,0,1,1486,0,1487,G
3-PA,1467,1,2,0,1484,1487,C
3-PA,1468,1484,0,0,0,1484,A
3-PA,1469,0,2,1506,0,1508,G
3-PA,1470,1504,0,1,0,1505,A
3-PA,1471,1509,0,1,0,1510,A
3-PA,1472,1,0,1,1506,1508,C
3-PA,1473,0,1479,0,0,1479,T
3-PA,1474,1495,0,0,0,1495,A
3-PA,1475,1489,0,0,0,1489,A
3-PA,1476,1488,0,1,0,1489,A
3-PA,1477,0,1,1491,0,1492,G
3-PA,1478,1427,0,2,0,1429,A
3-PA,1479,0,0,1423,0,1423,G
3-PA,1480,0,2,1370,0,1372,G
3-PA,1481,1,1,1383,0,1385,G
3-PA,1482,1380,0,1,0,1381,A
3-PA,1483,1352,0,0,0,1352,A
3-PA,1484,0,0,1352,0,1352,G
3-PA,1485,1,0,1334,0,1335,G
3-PA,1486,1,1,0,1332,1334,C
3-PA,1487,1,2,1339,0,1342,G
3-PA,1488,1342,1,0,0,1343,A
3-PA,1489,1345,0,1,0,1346,A
3-PA,1490,1340,0,0,0,1340,A
3-PA,1491,1338,0,0,0,1338,A
3-PA,1492,1333,0,1,0,1334,A
3-PA,1493,0,0,0,1330,1330,C
3-PA,1494,2,1,0,1332,1335,C
3-PA,1495,1336,0,0,0,1336,A
3-PA,1496,1340,0,0,0,1340,A
3-PA,1497,0,1333,0,0,1333,T
3-PA,1498,0,1333,0,0,1333,T
3-PA,1499,0,1337,0,0,1337,T
3-PA,1500,1341,0,0,0,1341,A
3-PA,1501,0,1339,0,0,1339,T
3-PA,1502,1341,0,0,0,1341,A
3-PA,1503,0,1329,0,1,1330,T
3-PA,1504,0,1,1308,0,1309,G
3-PA,1505,0,4,1284,0,1288,G
3-PA,1506,1292,0,0,0,1292,A
3-PA,1507,0,1288,0,0,1288,T
3-PA,1508,0,1261,0,0,1261,T
3-PA,1509,1,1,0,1261,1263,C
3-PA,1510,1259,1,1,0,1261,A
3-PA,1511,0,1264,0,2,1266,T
3-PA,1512,1,0,0,1265,1266,C
3-PA,1513,1269,1,0,0,1270,A
3-PA,1514,0,1261,0,0,1261,T
3-PA,1515,1252,0,0,0,1252,A
3-PA,1516,1250,1,0,0,1251,A
3-PA,1517,1247,0,2,0,1249,A
3-PA,1518,0,1,1234,0,1235,G
3-PA,1519,0,0,1219,0,1219,G
3-PA,1520,0,1,1200,0,1201,G
3-PA,1521,1194,0,0,0,1194,A
3-PA,1522,1177,0,1,0,1178,A
3-PA,1523,1,0,1181,0,1182,G
3-PA,1524,1180,1,0,0,1181,A
3-PA,1525,0,1166,0,1,1167,T
3-PA,1526,3,0,0,1163,1166,C
3-PA,1527,0,1141,0,0,1141,T
3-PA,1528,2,0,1,1144,1147,C
3-PA,1529,1142,0,0,0,1142,A
3-PA,1530,0,1142,0,0,1142,T
3-PA,1531,0,1144,0,0,1144,T
3-PA,1532,0,1138,0,0,1138,T
3-PA,1533,1138,0,0,0,1138,A
3-PA,1534,1137,0,0,0,1137,A
3-PA,1535,0,1,1129,0,1130,G
3-PA,1536,1093,0,0,0,1093,A
3-PA,1537,1100,0,0,0,1100,A
3-PA,1538,1099,0,1,0,1100,A
3-PA,1539,0,1092,0,0,1092,T
3-PA,1540,0,6,1095,0,1101,G
3-PA,1541,1106,0,0,0,1106,A
3-PA,1542,0,1,0,1101,1102,C
3-PA,1543,1090,0,3,0,1093,A
3-PA,1544,0,0,0,1092,1092,C
3-PA,1545,1068,0,0,0,1068,A
3-PA,1546,0,0,1072,0,1072,G
3-PA,1547,1070,0,0,0,1070,A
3-PA,1548,1,0,0,1057,1058,C
3-PA,1549,0,0,1040,0,1040,G
3-PA,1550,0,991,0,0,991,T
3-PA,1551,1,1,990,0,992,G
3-PA,1552,1,0,993,0,994,G
3-PA,1553,1,998,0,1,1000,T
3-PA,1554,988,0,0,0,988,A
3-PA,1555,977,0,0,0,977,A
3-PA,1556,969,0,0,0,969,A
3-PA,1557,0,955,0,0,955,T
3-PA,1558,0,948,0,0,948,T
3-PA,1559,0,935,0,0,935,T
3-PA,1560,0,913,0,0,913,T
3-PA,1561,0,0,917,0,917,G
3-PA,1562,0,905,0,0,905,T
3-PA,1563,0,2,905,0,907,G
3-PA,1564,897,0,0,0,897,A
3-PA,1565,0,1,890,0,891,G
3-PA,1566,1,0,0,885,886,C
3-PA,1567,892,0,0,0,892,A
3-PA,1568,0,889,0,0,889,T
3-PA,1569,0,1,889,0,890,G
3-PA,1570,0,2,885,0,887,G
3-PA,1571,884,0,2,0,886,A
3-PA,1572,1,1,887,0,889,G
3-PA,1573,0,870,0,0,870,T
3-PA,1574,0,846,0,0,846,T
3-PA,1575,0,851,0,0,851,T
3-PA,1576,0,840,0,1,841,T
3-PA,1577,1,0,0,849,850,C
3-PA,1578,1,841,0,0,842,T
3-PA,1579,0,0,0,831,831,C
3-PA,1580,0,811,0,1,812,T
3-PA,1581,3,0,0,804,807,C
3-PA,1582,801,1,0,0,802,A
3-PA,1583,1,0,0,804,805,C
3-PA,1584,0,785,0,0,785,T
3-PA,1585,0,3,783,0,786,G
3-PA,1586,779,0,1,0,780,A
3-PA,1587,1,0,0,781,782,C
3-PA,1588,0,0,0,778,778,C
3-PA,1589,0,0,0,767,767,C
3-PA,1590,1,0,765,0,766,G
3-PA,1591,762,0,1,0,763,A
3-PA,1592,0,1,765,0,766,G
3-PA,1593,754,0,1,0,755,A
3-PA,1594,0,1,0,725,726,C
3-PA,1595,0,714,0,0,714,T
3-PA,1596,0,667,0,0,667,T
3-PA,1597,0,1,675,0,676,G
3-PA,1598,665,0,1,0,666,A
3-PA,1599,0,0,668,0,668,G
3-PA,1600,0,0,0,660,660,C
3-PA,1601,0,0,0,639,639,C
3-PA,1602,640,0,0,0,640,A
3-PA,1603,0,0,0,643,643,C
3-PA,1604,641,0,0,0,641,A
3-PA,1605,0,640,0,0,640,T
3-PA,1606,633,0,0,0,633,A
3-PA,1607,635,0,0,0,635,A
3-PA,1608,633,0,0,1,634,A
3-PA,1609,0,621,0,0,621,T
3-PA,1610,0,1,614,0,615,G
3-PA,1611,0,0,552,0,552,G
3-PA,1612,0,0,546,0,546,G
3-PA,1613,534,0,0,0,534,A
3-PA,1614,0,0,528,0,528,G
3-PA,1615,518,0,0,0,518,A
3-PA,1616,510,0,0,0,510,A
3-PA,1617,512,0,0,0,512,A
3-PA,1618,0,509,0,0,509,T
3-PA,1619,495,0,0,0,495,A
3-PA,1620,0,0,0,495,495,C
3-PA,1621,0,274,1,0,275,T
3-PA,1622,0,0,273,0,273,G
3-PA,1623,0,189,0,0,189,T
3-PA,1624,0,0,190,0,190,G
3-PA,1625,1,174,0,0,175,T
3-PA,1626,0,0,0,113,113,C
3-PA,1627,0,0,0,109,109,C
3-PA,1628,0,101,0,0,101,T
3-PA,1629,0,98,0,0,98,T
3-PA,1630,0,0,103,0,103,G
3-PA,1631,101,0,0,0,101,A
3-PA,1632,0,0,103,0,103,G
3-PA,1633,101,0,0,0,101,A
3-PA,1634,0,98,0,0,98,T
3-PA,1635,99,0,1,0,100,A
3-PA,1636,0,0,105,0,105,G
3-PA,1637,0,0,102,0,102,G
3-PA,1638,101,0,0,0,101,A
3-PA,1639,0,1,101,0,102,G
3-PA,1640,103,0,0,0,103,A
3-PA,1641,0,103,0,0,103,T
3-PA,1642,104,0,0,0,104,A
3-PA,1643,0,102,0,0,102,T
3-PA,1644,0,0,107,0,107,G
3-PA,1645,0,109,0,0,109,T
3-PA,1646,0,109,0,0,109,T
3-PA,1647,108,0,0,0,108,A
3-PA,1648,1,0,0,108,109,C
3-PA,1649,0,107,0,0,107,T
3-PA,1650,108,0,0,0,108,A
3-PA,1651,107,0,0,0,107,A
3-PA,1652,0,0,109,0,109,G
3-PA,1653,107,0,0,0,107,A
3-PA,1654,106,0,0,0,106,A
3-PA,1655,0,0,104,0,104,G
3-PA,1656,0,105,0,0,105,T
3-PA,1657,0,0,105,0,105,G
3-PA,1658,0,0,0,103,103,C
3-PA,1659,1,0,0,104,105,C
3-PA,1660,104,0,0,2,106,A
3-PA,1661,0,104,0,0,104,T
3-PA,1662,105,0,0,0,105,A
3-PA,1663,0,0,105,0,105,G
3-PA,1664,0,0,105,0,105,G
3-PA,1665,0,0,0,104,104,C
3-PA,1666,1,0,0,102,103,C
3-PA,1667,103,0,0,0,103,A
3-PA,1668,103,0,0,0,103,A
3-PA,1669,103,0,0,0,103,A
3-PA,1670,0,106,0,0,106,T
3-PA,1671,0,103,0,0,103,T
3-PA,1672,0,103,0,0,103,T
3-PA,1673,0,0,0,104,104,C
3-PA,1674,102,0,0,0,102,A
3-PA,1675,103,0,0,0,103,A
3-PA,1676,0,0,102,0,102,G
3-PA,1677,0,0,99,0,99,G
3-PA,1678,0,0,0,100,100,C
3-PA,1679,0,0,0,103,103,C
3-PA,1680,0,0,99,0,99,G
3-PA,1681,105,0,0,0,105,A
3-PA,1682,0,106,0,0,106,T
3-PA,1683,0,0,112,0,112,G
3-PA,1684,0,110,0,0,110,T
3-PA,1685,0,113,0,0,113,T
3-PA,1686,0,0,0,112,112,C
3-PA,1687,0,115,0,1,116,T
3-PA,1688,0,115,1,0,116,T
3-PA,1689,0,1,117,0,118,G
3-PA,1690,0,115,0,0,115,T
3-PA,1691,115,0,0,0,115,A
3-PA,1692,0,115,0,0,115,T
3-PA,1693,0,0,116,0,116,G
3-PA,1694,0,113,0,0,113,T
3-PA,1695,0,0,114,0,114,G
3-PA,1696,109,0,0,0,109,A
3-PA,1697,0,0,110,0,110,G
3-PA,1698,0,0,106,0,106,G
3-PA,1699,106,0,0,0,106,A
3-PA,1700,0,0,0,105,105,C
3-PA,1701,105,0,0,0,105,A
3-PA,1702,103,0,0,0,103,A
3-PA,1703,105,0,0,0,105,A
3-PA,1704,0,0,0,107,107,C
3-PA,1705,0,0,107,0,107,G
3-PA,1706,0,0,110,0,110,G
3-PA,1707,109,0,0,0,109,A
3-PA,1708,107,0,0,0,107,A
3-PA,1709,0,0,0,105,105,C
3-PA,1710,108,0,0,0,108,A
3-PA,1711,0,108,0,0,108,T
3-PA,1712,0,0,0,107,107,C
3-PA,1713,106,0,0,0,106,A
3-PA,1714,105,0,0,0,105,A
3-PA,1715,106,0,0,0,106,A
3-PA,1716,0,0,107,0,107,G
3-PA,1717,0,0,106,0,106,G
3-PA,1718,0,101,0,0,101,T
3-PA,1719,0,0,0,104,104,C
3-PA,1720,105,0,0,0,105,A
3-PA,1721,101,0,0,0,101,A
3-PA,1722,104,0,0,0,104,A
3-PA,1723,101,0,0,0,101,A
3-PA,1724,0,107,0,0,107,T
3-PA,1725,0,0,104,0,104,G
3-PA,1726,103,0,0,0,103,A
3-PA,1727,104,0,0,0,104,A
3-PA,1728,102,0,0,0,102,A
3-PA,1729,0,103,0,0,103,T
3-PA,1730,0,0,105,0,105,G
3-PA,1731,0,0,102,0,102,G
3-PA,1732,0,0,104,0,104,G
3-PA,1733,0,0,106,0,106,G
3-PA,1734,103,0,0,0,103,A
3-PA,1735,105,0,0,0,105,A
3-PA,1736,0,105,0,0,105,T
3-PA,1737,0,1,103,0,104,G
3-PA,1738,0,0,103,0,103,G
3-PA,1739,103,0,0,0,103,A
3-PA,1740,0,0,104,0,104,G
3-PA,1741,103,0,0,0,103,A
3-PA,1742,0,102,0,0,102,T
3-PA,1743,0,0,104,0,104,G
3-PA,1744,99,0,0,0,99,A
3-PA,1745,0,0,99,0,99,G
3-PA,1746,99,0,0,0,99,A
3-PA,1747,0,0,0,99,99,C
3-PA,1748,0,0,99,0,99,G
3-PA,1749,0,99,0,0,99,T
3-PA,1750,0,99,0,0,99,T
3-PA,1751,0,0,99,0,99,G
3-PA,1752,0,0,0,96,96,C
3-PA,1753,0,0,0,98,98,C
3-PA,1754,0,97,0,1,98,T
3-PA,1755,0,0,0,99,99,C
3-PA,1756,1,0,0,97,98,C
3-PA,1757,0,100,0,0,100,T
3-PA,1758,0,100,0,0,100,T
3-PA,1759,0,0,0,100,100,C
3-PA,1760,100,0,0,0,100,A
3-PA,1761,0,0,101,0,101,G
3-PA,1762,0,101,0,0,101,T
3-PA,1763,0,0,0,101,101,C
3-PA,1764,101,0,0,0,101,A
3-PA,1765,0,0,0,99,99,C
3-PA,1766,0,96,0,0,96,T
3-PA,1767,0,98,0,0,98,T
3-PA,1768,0,0,0,106,106,C
3-PA,1769,106,0,0,0,106,A
3-PA,1770,1,0,105,0,106,G
3-PA,1771,0,0,0,105,105,C
3-PA,1772,102,0,0,0,102,A
3-PA,1773,0,0,104,0,104,G
3-PA,1774,99,0,0,0,99,A
3-PA,1775,0,102,0,0,102,T
3-PA,1776,0,0,0,103,103,C
3-PA,1777,0,0,101,0,101,G
3-PA,1778,101,0,0,0,101,A
3-PA,1779,0,0,101,0,101,G
3-PA,1780,99,0,0,0,99,A
3-PA,1781,0,0,100,0,100,G
3-PA,1782,0,0,0,99,99,C
3-PA,1783,101,0,0,0,101,A
3-PA,1784,0,102,0,0,102,T
3-PA,1785,0,0,102,0,102,G
3-PA,1786,104,0,0,0,104,A
3-PA,1787,0,104,0,0,104,T
3-PA,1788,0,105,0,0,105,T
3-PA,1789,0,0,106,0,106,G
3-PA,1790,104,0,0,0,104,A
3-PA,1791,108,0,0,0,108,A
3-PA,1792,0,0,108,0,108,G
3-PA,1793,0,0,0,106,106,C
3-PA,1794,0,0,0,105,105,C
3-PA,1795,0,0,106,0,106,G
3-PA,1796,105,0,0,0,105,A
3-PA,1797,0,0,105,0,105,G
3-PA,1798,0,103,0,0,103,T
3-PA,1799,1,0,0,102,103,C
3-PA,1800,1,0,0,103,104,C
3-PA,1801,0,103,0,0,103,T
3-PA,1802,0,0,0,107,107,C
3-PA,1803,0,0,107,0,107,G
3-PA,1804,0,0,110,0,110,G
3-PA,1805,0,109,0,0,109,T
3-PA,1806,0,109,0,0,109,T
3-PA,1807,109,0,0,0,109,A
3-PA,1808,109,0,0,0,109,A
3-PA,1809,107,0,0,0,107,A
3-PA,1810,0,0,111,0,111,G
3-PA,1811,110,0,0,0,110,A
3-PA,1812,0,0,109,0,109,G
3-PA,1813,108,0,1,0,109,A
3-PA,1814,110,0,0,0,110,A
3-PA,1815,107,0,1,0,108,A
3-PA,1816,0,0,110,0,110,G
3-PA,1817,109,0,0,0,109,A
3-PA,1818,0,0,0,107,107,C
3-PA,1819,109,0,0,0,109,A
3-PA,1820,0,110,0,0,110,T
3-PA,1821,1,0,109,0,110,G
3-PA,1822,113,0,0,0,113,A
3-PA,1823,0,0,0,110,110,C
3-PA,1824,0,0,0,111,111,C
3-PA,1825,110,0,0,0,110,A
3-PA,1826,111,0,0,0,111,A
3-PA,1827,111,0,0,0,111,A
3-PA,1828,0,0,112,0,112,G
3-PA,1829,110,0,0,0,110,A
3-PA,1830,0,0,111,0,111,G
3-PA,1831,0,109,0,0,109,T
3-PA,1832,0,110,0,0,110,T
3-PA,1833,0,110,0,0,110,T
3-PA,1834,0,110,0,0,110,T
3-PA,1835,0,107,0,1,108,T
3-PA,1836,0,111,0,0,111,T
3-PA,1837,0,0,111,0,111,G
3-PA,1838,111,0,0,0,111,A
3-PA,1839,0,0,113,0,113,G
3-PA,1840,113,0,0,0,113,A
3-PA,1841,113,0,0,0,113,A
3-PA,1842,0,113,0,0,113,T
3-PA,1843,112,0,0,0,112,A
3-PA,1844,112,0,0,0,112,A
3-PA,1845,0,0,112,0,112,G
3-PA,1846,0,116,0,0,116,T
3-PA,1847,1,0,0,115,116,C
3-PA,1848,116,0,0,0,116,A
3-PA,1849,0,1,115,0,116,G
3-PA,1850,117,0,0,0,117,A
3-PA,1851,117,0,0,0,117,A
3-PA,1852,0,0,117,0,117,G
3-PA,1853,0,0,0,116,116,C
3-PA,1854,113,0,0,0,113,A
3-PA,1855,0,112,0,0,112,T
3-PA,1856,0,0,109,0,109,G
3-PA,1857,0,0,113,0,113,G
3-PA,1858,0,0,0,112,112,C
3-PA,1859,0,0,0,114,114,C
3-PA,1860,0,1,0,114,115,C
3-PA,1861,114,0,0,0,114,A
3-PA,1862,0,113,0,1,114,T
3-PA,1863,0,115,0,0,115,T
3-PA,1864,0,0,116,0,116,G
3-PA,1865,0,0,115,0,115,G
3-PA,1866,0,0,116,0,116,G
3-PA,1867,0,0,113,0,113,G
3-PA,1868,111,0,0,0,111,A
3-PA,1869,0,0,108,0,108,G
3-PA,1870,0,104,0,0,104,T
3-PA,1871,0,0,0,100,100,C
3-PA,1872,0,0,0,108,108,C
3-PA,1873,0,0,0,107,107,C
3-PA,1874,0,0,0,107,107,C
3-PA,1875,0,0,0,107,107,C
3-PA,1876,111,0,0,0,111,A
3-PA,1877,109,0,0,0,109,A
3-PA,1878,0,1,107,0,108,G
3-PA,1879,0,0,109,0,109,G
3-PA,1880,0,0,108,0,108,G
3-PA,1881,98,0,0,0,98,A
3-PA,1882,0,0,102,0,102,G
3-PA,1883,0,101,0,0,101,T
3-PA,1884,0,0,100,0,100,G
3-PA,1885,0,0,102,0,102,G
3-PA,1886,103,0,0,0,103,A
3-PA,1887,101,0,0,0,101,A
3-PA,1888,0,0,102,0,102,G
3-PA,1889,101,0,1,0,102,A
3-PA,1890,101,0,0,0,101,A
3-PA,1891,0,0,101,0,101,G
3-PA,1892,0,3,98,0,101,G
3-PA,1893,0,101,0,0,101,T
3-PA,1894,0,97,0,0,97,T
3-PA,1895,1,0,0,100,101,C
3-PA,1896,0,0,0,98,98,C
3-PA,1897,100,0,0,0,100,A
3-PA,1898,0,100,0,0,100,T
3-PA,1899,0,101,0,0,101,T
3-PA,1900,0,0,99,0,99,G
3-PA,1901,0,0,99,0,99,G
3-PA,1902,0,0,97,0,97,G
3-PA,1903,101,0,0,0,101,A
3-PA,1904,99,0,0,0,99,A
3-PA,1905,99,0,0,0,99,A
3-PA,1906,0,0,99,0,99,G
3-PA,1907,0,101,0,0,101,T
3-PA,1908,0,0,0,100,100,C
3-PA,1909,0,99,0,0,99,T
3-PA,1910,0,0,101,0,101,G
3-PA,1911,0,100,0,0,100,T
3-PA,1912,101,0,0,0,101,A
3-PA,1913,0,0,100,0,100,G
3-PA,1914,0,0,100,0,100,G
3-PA,1915,99,0,0,0,99,A
3-PA,1916,0,0,0,99,99,C
3-PA,1917,0,99,0,0,99,T
3-PA,1918,0,0,0,106,106,C
3-PA,1919,0,107,0,0,107,T
3-PA,1920,107,0,0,0,107,A
3-PA,1921,0,106,0,0,106,T
3-PA,1922,0,107,0,0,107,T
3-PA,1923,0,0,108,0,108,G
3-PA,1924,0,0,109,0,109,G
3-PA,1925,0,0,0,107,107,C
3-PA,1926,0,108,0,0,108,T
3-PA,1927,102,0,0,0,102,A
3-PA,1928,105,0,0,0,105,A
3-PA,1929,0,0,104,0,104,G
3-PA,1930,0,103,0,0,103,T
3-PA,1931,0,0,0,105,105,C
3-PA,1932,101,0,0,0,101,A
3-PA,1933,0,0,102,0,102,G
3-PA,1934,0,101,0,0,101,T
3-PA,1935,105,0,0,0,105,A
3-PA,1936,0,103,0,0,103,T
3-PA,1937,0,104,0,0,104,T
3-PA,1938,0,0,0,104,104,C
3-PA,1939,105,0,0,0,105,A
3-PA,1940,104,0,0,0,104,A
3-PA,1941,0,104,0,0,104,T
3-PA,1942,104,0,0,0,104,A
3-PA,1943,0,0,105,0,105,G
3-PA,1944,0,0,0,101,101,C
3-PA,1945,0,0,0,104,104,C
3-PA,1946,0,102,0,0,102,T
3-PA,1947,0,0,104,0,104,G
3-PA,1948,0,103,0,0,103,T
3-PA,1949,104,0,0,0,104,A
3-PA,1950,0,101,0,0,101,T
3-PA,1951,0,0,100,0,100,G
3-PA,1952,0,0,0,99,99,C
3-PA,1953,97,0,0,0,97,A
3-PA,1954,0,96,0,0,96,T
3-PA,1955,0,0,0,95,95,C
3-PA,1956,93,0,0,0,93,A
3-PA,1957,0,0,0,97,97,C
3-PA,1958,1,0,0,94,95,C
3-PA,1959,93,0,0,0,93,A
3-PA,1960,0,0,0,97,97,C
3-PA,1961,94,0,0,0,94,A
3-PA,1962,94,0,0,0,94,A
3-PA,1963,0,91,0,0,91,T
3-PA,1964,0,93,0,0,93,T
3-PA,1965,0,0,93,0,93,G
3-PA,1966,0,0,90,0,90,G
3-PA,1967,90,0,0,0,90,A
3-PA,1968,89,0,0,0,89,A
3-PA,1969,0,0,88,0,88,G
3-PA,1970,0,0,88,0,88,G
3-PA,1971,88,0,0,0,88,A
3-PA,1972,0,85,0,0,85,T
3-PA,1973,0,88,0,0,88,T
3-PA,1974,0,87,0,1,88,T
3-PA,1975,0,87,0,0,87,T
3-PA,1976,0,0,0,85,85,C
3-PA,1977,85,1,0,0,86,A
3-PA,1978,0,0,87,0,87,G
3-PA,1979,0,0,0,85,85,C
3-PA,1980,0,0,85,0,85,G
3-PA,1981,0,0,87,0,87,G
3-PA,1982,85,0,0,0,85,A
3-PA,1983,0,0,88,0,88,G
3-PA,1984,0,87,0,0,87,T
3-PA,1985,0,0,0,87,87,C
3-PA,1986,88,0,0,0,88,A
3-PA,1987,87,0,0,0,87,A
3-PA,1988,0,0,89,0,89,G
3-PA,1989,87,0,1,0,88,A
3-PA,1990,87,0,0,0,87,A
3-PA,1991,89,0,0,0,89,A
3-PA,1992,86,0,0,0,86,A
3-PA,1993,0,0,0,88,88,C
3-PA,1994,0,84,0,0,84,T
3-PA,1995,0,0,85,0,85,G
3-PA,1996,0,0,0,85,85,C
3-PA,1997,0,83,0,0,83,T
3-PA,1998,0,0,0,83,83,C
3-PA,1999,0,0,0,83,83,C
3-PA,2000,0,84,0,0,84,T
3-PA,2001,0,85,0,0,85,T
3-PA,2002,0,0,83,0,83,G
3-PA,2003,0,83,0,0,83,T
3-PA,2004,0,83,0,0,83,T
3-PA,2005,0,0,82,0,82,G
3-PA,2006,0,84,0,0,84,T
3-PA,2007,0,84,0,0,84,T
3-PA,2008,0,0,0,83,83,C
3-PA,2009,82,0,0,0,82,A
3-PA,2010,0,0,83,0,83,G
3-PA,2011,0,0,82,0,82,G
3-PA,2012,0,0,0,81,81,C
3-PA,2013,0,81,0,0,81,T
3-PA,2014,1,0,0,83,84,C
3-PA,2015,0,84,0,0,84,T
3-PA,2016,0,84,0,0,84,T
3-PA,2017,83,0,0,0,83,A
3-PA,2018,0,0,83,0,83,G
3-PA,2019,0,0,84,0,84,G
3-PA,2020,0,0,83,0,83,G
3-PA,2021,82,0,0,0,82,A
3-PA,2022,0,0,0,80,80,C
3-PA,2023,77,0,0,0,77,A
3-PA,2024,78,0,0,0,78,A
3-PA,2025,0,0,0,75,75,C
3-PA,2026,0,0,0,75,75,C
3-PA,2027,0,76,0,0,76,T
3-PA,2028,0,0,0,76,76,C
3-PA,2029,0,0,77,0,77,G
3-PA,2030,77,0,0,0,77,A
3-PA,2031,76,0,0,0,76,A
3-PA,2032,0,0,0,77,77,C
3-PA,2033,0,0,0,74,74,C
3-PA,2034,0,75,0,0,75,T
3-PA,2035,0,0,73,0,73,G
3-PA,2036,0,0,74,0,74,G
3-PA,2037,0,0,75,0,75,G
3-PA,2038,73,0,0,0,73,A
3-PA,2039,0,0,0,70,70,C
3-PA,2040,0,0,0,71,71,C
3-PA,2041,0,70,0,1,71,T
3-PA,2042,0,72,0,0,72,T
3-PA,2043,0,72,0,0,72,T
3-PA,2044,0,0,71,0,71,G
3-PA,2045,72,0,0,0,72,A
3-PA,2046,0,70,0,0,70,T
3-PA,2047,0,0,0,71,71,C
3-PA,2048,0,67,0,0,67,T
3-PA,2049,0,68,0,0,68,T
3-PA,2050,0,0,67,0,67,G
3-PA,2051,0,0,68,0,68,G
3-PA,2052,0,0,68,0,68,G
3-PA,2053,0,0,67,0,67,G
3-PA,2054,0,0,68,0,68,G
3-PA,2055,0,0,66,0,66,G
3-PA,2056,0,0,0,65,65,C
3-PA,2057,0,66,0,0,66,T
3-PA,2058,69,0,0,0,69,A
3-PA,2059,0,66,0,0,66,T
3-PA,2060,66,0,0,0,66,A
3-PA,2061,0,66,0,0,66,T
3-PA,2062,0,0,67,0,67,G
3-PA,2063,66,0,0,0,66,A
3-PA,2064,64,0,0,0,64,A
3-PA,2065,0,0,63,0,63,G
3-PA,2066,0,0,0,64,64,C
3-PA,2067,57,0,0,0,57,A
3-PA,2068,58,0,0,0,58,A
3-PA,2069,0,57,0,0,57,T
3-PA,2070,0,57,0,0,57,T
3-PA,2071,0,0,58,0,58,G
3-PA,2072,56,0,0,0,56,A
3-PA,2073,0,0,55,0,55,G
3-PA,2074,0,0,57,0,57,G
3-PA,2075,56,0,0,0,56,A
3-PA,2076,0,0,55,0,55,G
3-PA,2077,0,55,0,0,55,T
3-PA,2078,0,0,55,0,55,G
3-PA,2079,0,0,0,52,52,C
3-PA,2080,0,0,0,52,52,C
3-PA,2081,0,54,0,0,54,T
3-PA,2082,0,1,53,0,54,G
3-PA,2083,54,0,0,0,54,A
3-PA,2084,0,54,0,0,54,T
3-PA,2085,0,52,0,0,52,T
3-PA,2086,51,0,0,0,51,A
3-PA,2087,50,0,0,0,50,A
3-PA,2088,0,49,0,0,49,T
3-PA,2089,0,0,50,0,50,G
3-PA,2090,50,0,0,0,50,A
3-PA,2091,0,48,0,0,48,T
3-PA,2092,0,0,0,49,49,C
3-PA,2093,0,0,0,49,49,C
3-PA,2094,0,0,0,48,48,C
3-PA,2095,0,47,0,0,47,T
3-PA,2096,0,0,49,0,49,G
3-PA,2097,1,0,50,0,51,G
3-PA,2098,0,0,50,0,50,G
3-PA,2099,0,47,0,0,47,T
3-PA,2100,0,45,0,0,45,T
3-PA,2101,0,45,0,0,45,T
3-PA,2102,0,44,0,0,44,T
3-PA,2103,0,0,43,0,43,G
3-PA,2104,0,0,0,42,42,C
3-PA,2105,0,42,0,0,42,T
3-PA,2106,0,0,0,42,42,C
3-PA,2107,41,0,0,0,41,A
3-PA,2108,40,0,0,0,40,A
3-PA,2109,0,39,0,0,39,T
3-PA,2110,0,0,40,0,40,G
3-PA,2111,0,0,0,41,41,C
3-PA,2112,0,0,41,0,41,G
3-PA,2113,0,40,0,0,40,T
3-PA,2114,0,0,0,41,41,C
3-PA,2115,0,40,0,0,40,T
3-PA,2116,0,40,0,0,40,T
3-PA,2117,0,0,41,0,41,G
3-PA,2118,0,0,41,0,41,G
3-PA,2119,0,41,0,0,41,T
3-PA,2120,0,40,0,0,40,T
3-PA,2121,0,0,0,40,40,C
3-PA,2122,40,0,0,0,40,A
3-PA,2123,39,0,0,0,39,A
3-PA,2124,0,0,0,40,40,C
3-PA,2125,0,38,0,0,38,T
3-PA,2126,0,0,0,40,40,C
3-PA,2127,0,0,0,38,38,C
3-PA,2128,0,36,0,0,36,T
3-PA,2129,0,38,0,0,38,T
3-PA,2130,0,0,0,38,38,C
3-PA,2131,0,0,0,37,37,C
3-PA,2132,0,37,0,0,37,T
3-PA,2133,0,0,37,0,37,G
3-PA,2134,37,0,0,0,37,A
3-PA,2135,0,0,0,36,36,C
3-PA,2136,34,0,0,0,34,A
3-PA,2137,0,0,0,32,32,C
3-PA,2138,32,0,0,0,32,A
3-PA,2139,0,31,0,0,31,T
3-PA,2140,0,0,31,0,31,G
3-PA,2141,0,0,0,31,31,C
3-PA,2142,30,0,0,0,30,A
3-PA,2143,0,29,0,0,29,T
3-PA,2144,0,29,0,0,29,T
3-PA,2145,30,0,0,0,30,A
3-PA,2146,29,0,1,0,30,A
3-PA,2147,30,0,0,0,30,A
3-PA,2148,30,0,0,0,30,A
3-PA,2149,0,29,0,0,29,T
3-PA,2150,18,0,0,0,18,A
3-PA,2151,0,0,18,0,18,G
4-HA,1,57,0,0,0,57,A
4-HA,2,0,56,0,0,56,T
4-HA,3,0,0,58,0,58,G
4-HA,4,58,0,0,0,58,A
4-HA,5,59,0,0,0,59,A
4-HA,6,0,0,64,0,64,G
4-HA,7,62,0,0,0,62,A
4-HA,8,0,0,0,66,66,C
4-HA,9,0,68,0,0,68,T
4-HA,10,70,0,0,0,70,A
4-HA,11,0,75,0,0,75,T
4-HA,12,0,0,0,75,75,C
4-HA,13,75,0,0,0,75,A
4-HA,14,0,77,0,0,77,T
4-HA,15,0,77,0,0,77,T
4-HA,16,0,0,83,0,83,G
4-HA,17,0,0,0,83,83,C
4-HA,18,0,83,0,0,83,T
4-HA,19,0,84,0,0,84,T
4-HA,20,0,83,0,0,83,T
4-HA,21,0,0,87,0,87,G
4-HA,22,88,0,0,1,89,A
4-HA,23,0,0,94,0,94,G
4-HA,24,0,0,0,95,95,C
4-HA,25,0,96,0,0,96,T
4-HA,26,102,0,0,1,103,A
4-HA,27,0,0,0,103,103,C
4-HA,28,104,0,0,0,104,A
4-HA,29,0,110,0,0,110,T
4-HA,30,0,110,0,0,110,T
4-HA,31,0,0,0,112,112,C
4-HA,32,0,110,0,0,110,T
4-HA,33,112,0,0,0,112,A
4-HA,34,0,114,0,0,114,T
4-HA,35,0,0,114,0,114,G
4-HA,36,0,114,0,0,114,T
4-HA,37,0,0,0,115,115,C
4-HA,38,0,114,0,0,114,T
4-HA,39,0,1,114,0,115,G
4-HA,40,0,0,116,0,116,G
4-HA,41,0,115,0,0,115,T
4-HA,42,0,114,0,0,114,T
4-HA,43,0,116,0,0,116,T
4-HA,44,0,116,0,0,116,T
4-HA,45,0,0,0,116,116,C
4-HA,46,0,0,113,1,114,G
4-HA,47,0,0,0,119,119,C
4-HA,48,0,120,0,0,120,T
4-HA,49,0,0,0,120,120,C
4-HA,50,118,0,0,1,119,A
4-HA,51,117,0,0,1,118,A
4-HA,52,117,0,0,1,118,A
4-HA,53,119,0,0,0,119,A
4-HA,54,118,0,0,0,118,A
4-HA,55,0,0,0,120,120,C
4-HA,56,0,120,0,0,120,T
4-HA,57,0,120,0,0,120,T
4-HA,58,0,0,0,120,120,C
4-HA,59,0,0,0,120,120,C
4-HA,60,0,120,0,0,120,T
4-HA,61,0,0,120,0,120,G
4-HA,62,115,0,0,1,116,A
4-HA,63,119,0,0,1,120,A
4-HA,64,123,0,0,1,124,A
4-HA,65,122,0,0,1,123,A
4-HA,66,0,128,0,0,128,T
4-HA,67,0,1,126,0,127,G
4-HA,68,129,0,0,0,129,A
4-HA,69,0,0,0,132,132,C
4-HA,70,130,0,0,1,131,A
4-HA,71,130,0,0,1,131,A
4-HA,72,0,0,0,136,136,C
4-HA,73,135,0,0,1,136,A
4-HA,74,0,0,133,0,133,G
4-HA,75,0,0,0,134,134,C
4-HA,76,133,0,0,1,134,A
4-HA,77,0,0,0,139,139,C
4-HA,78,0,0,140,0,140,G
4-HA,79,0,0,142,0,142,G
4-HA,80,1,1,0,141,143,C
4-HA,81,143,0,0,0,143,A
4-HA,82,142,0,0,0,142,A
4-HA,83,0,1,0,145,146,C
4-HA,84,0,0,141,0,141,G
4-HA,85,0,0,0,143,143,C
4-HA,86,0,146,0,0,146,T
4-HA,87,0,0,146,0,146,G
4-HA,88,0,145,0,0,145,T
4-HA,89,0,0,160,0,160,G
4-HA,90,0,0,0,159,159,C
4-HA,91,0,0,0,162,162,C
4-HA,92,0,160,0,0,160,T
4-HA,93,0,163,0,0,163,T
4-HA,94,0,0,162,0,162,G
4-HA,95,0,0,161,0,161,G
4-HA,96,0,0,167,0,167,G
4-HA,97,1,0,0,167,168,C
4-HA,98,170,0,0,0,170,A
4-HA,99,0,0,0,169,169,C
4-HA,100,0,0,0,171,171,C
4-HA,101,183,0,0,0,183,A
4-HA,102,0,187,0,0,187,T
4-HA,103,0,0,184,0,184,G
4-HA,104,0,1,0,183,184,C
4-HA,105,184,0,0,0,184,A
4-HA,106,0,0,191,0,191,G
4-HA,107,0,190,0,0,190,T
4-HA,108,192,0,0,0,192,A
4-HA,109,0,0,0,193,193,C
4-HA,110,0,0,0,190,190,C
4-HA,111,190,0,0,0,190,A
4-HA,112,188,0,0,0,188,A
4-HA,113,187,0,1,0,188,A
4-HA,114,0,0,0,189,189,C
4-HA,115,0,0,187,0,187,G
4-HA,116,0,0,197,0,197,G
4-HA,117,190,0,0,0,190,A
4-HA,118,197,0,0,0,197,A
4-HA,119,0,0,0,197,197,C
4-HA,120,196,0,0,0,196,A
4-HA,121,202,0,0,0,202,A
4-HA,122,0,202,0,0,202,T
4-HA,123,200,1,0,0,201,A
4-HA,124,0,0,201,0,201,G
4-HA,125,0,196,0,0,196,T
4-HA,126,0,1,199,0,200,G
4-HA,127,198,0,0,0,198,A
4-HA,128,199,0,0,0,199,A
4-HA,129,200,0,0,0,200,A
4-HA,130,198,0,0,0,198,A
4-HA,131,0,0,0,202,202,C
4-HA,132,203,0,0,0,203,A
4-HA,133,200,0,0,0,200,A
4-HA,134,0,202,0,0,202,T
4-HA,135,0,0,0,201,201,C
4-HA,136,202,0,0,0,202,A
4-HA,137,0,0,0,203,203,C
4-HA,138,0,0,204,0,204,G
4-HA,139,201,0,0,0,201,A
4-HA,140,201,0,0,0,201,A
4-HA,141,0,199,0,0,199,T
4-HA,142,0,0,201,0,201,G
4-HA,143,200,0,0,0,200,A
4-HA,144,0,0,0,201,201,C
4-HA,145,0,0,0,200,200,C
4-HA,146,203,0,0,0,203,A
4-HA,147,203,0,0,0,203,A
4-HA,148,204,0,0,0,204,A
4-HA,149,0,206,0,0,206,T
4-HA,150,0,205,0,0,205,T
4-HA,151,0,0,205,0,205,G
4-HA,152,203,0,0,0,203,A
4-HA,153,206,0,0,0,206,A
4-HA,154,0,0,207,0,207,G
4-HA,155,0,207,0,0,207,T
4-HA,156,0,215,0,0,215,T
4-HA,157,216,0,0,0,216,A
4-HA,158,0,0,0,217,217,C
4-HA,159,0,215,0,0,215,T
4-HA,160,217,0,0,0,217,A
4-HA,161,218,0,0,0,218,A
4-HA,162,0,219,0,0,219,T
4-HA,163,1,0,221,0,222,G
4-HA,164,0,0,0,227,227,C
4-HA,165,0,224,0,0,224,T
4-HA,166,228,0,0,0,228,A
4-HA,167,1,0,0,227,228,C
4-HA,168,0,228,0,0,228,T
4-HA,169,0,3,224,0,227,G
4-HA,170,227,0,0,0,227,A
4-HA,171,0,0,230,0,230,G
4-HA,172,0,0,0,227,227,C
4-HA,173,0,222,0,0,222,T
4-HA,174,0,0,222,0,222,G
4-HA,175,1,0,225,0,226,G
4-HA,176,0,224,0,0,224,T
4-HA,177,0,227,0,0,227,T
4-HA,178,2,0,0,224,226,C
4-HA,179,227,0,0,0,227,A
4-HA,180,0,0,226,0,226,G
4-HA,181,227,0,0,0,227,A
4-HA,182,0,0,224,0,224,G
4-HA,183,0,228,0,0,228,T
4-HA,184,0,228,0,0,228,T
4-HA,185,0,0,0,224,224,C
4-HA,186,0,0,0,224,224,C
4-HA,187,0,226,0,0,226,T
4-HA,188,0,0,0,228,228,C
4-HA,189,228,0,0,0,228,A
4-HA,190,226,0,0,0,226,A
4-HA,191,0,0,1,228,229,C
4-HA,192,230,0,0,0,230,A
4-HA,193,0,0,232,0,232,G
4-HA,194,0,0,231,0,231,G
4-HA,195,0,219,0,1,220,T
4-HA,196,0,1,229,0,230,G
4-HA,197,232,0,0,0,232,A
4-HA,198,230,0,0,0,230,A
4-HA,199,238,0,0,0,238,A
4-HA,200,0,240,0,0,240,T
4-HA,201,241,0,0,0,241,A
4-HA,202,0,236,0,0,236,T
4-HA,203,0,0,235,0,235,G
4-HA,204,0,0,0,240,240,C
4-HA,205,0,0,239,0,239,G
4-HA,206,240,0,0,0,240,A
4-HA,207,0,0,0,238,238,C
4-HA,208,235,0,0,0,235,A
4-HA,209,0,0,241,0,241,G
4-HA,210,0,240,0,0,240,T
4-HA,211,0,0,0,245,245,C
4-HA,212,0,0,0,241,241,C
4-HA,213,0,246,0,0,246,T
4-HA,214,0,0,0,249,249,C
4-HA,215,247,0,1,0,248,A
4-HA,216,0,250,0,0,250,T
4-HA,217,0,0,0,251,251,C
4-HA,218,241,0,0,0,241,A
4-HA,219,0,0,244,0,244,G
4-HA,220,241,0,0,0,241,A
4-HA,221,0,243,0,0,243,T
4-HA,222,0,0,0,244,244,C
4-HA,223,0,0,0,243,243,C
4-HA,224,0,245,0,0,245,T
4-HA,225,0,248,0,0,248,T
4-HA,226,0,0,245,0,245,G
4-HA,227,247,0,0,0,247,A
4-HA,228,0,249,0,0,249,T
4-HA,229,0,0,252,0,252,G
4-HA,230,0,0,246,0,246,G
4-HA,231,250,0,1,0,251,A
4-HA,232,0,0,249,0,249,G
4-HA,233,249,0,0,0,249,A
4-HA,234,0,0,249,0,249,G
4-HA,235,250,1,0,0,251,A
4-HA,236,252,0,0,0,252,A
4-HA,237,0,0,0,258,258,C
4-HA,238,0,256,0,0,256,T
4-HA,239,0,0,262,0,262,G
4-HA,240,0,0,0,261,261,C
4-HA,241,260,0,0,0,260,A
4-HA,242,0,0,0,266,266,C
4-HA,243,260,0,0,0,260,A
4-HA,244,0,0,0,295,295,C
4-HA,245,0,299,0,0,299,T
4-HA,246,301,0,0,0,301,A
4-HA,247,300,0,0,0,300,A
4-HA,248,0,303,0,0,303,T
4-HA,249,303,0,0,0,303,A
4-HA,250,0,0,305,0,305,G
4-HA,251,304,0,0,0,304,A
4-HA,252,0,294,0,0,294,T
4-HA,253,0,0,293,0,293,G
4-HA,254,0,0,0,293,293,C
4-HA,255,0,288,0,0,288,T
4-HA,256,1,1,0,314,316,C
4-HA,257,0,315,0,0,315,T
4-HA,258,321,0,0,0,321,A
4-HA,259,0,317,0,0,317,T
4-HA,260,0,319,0,0,319,T
4-HA,261,0,1,333,0,334,G
4-HA,262,0,1,330,0,331,G
4-HA,263,0,1,340,1,342,G
4-HA,264,333,0,0,0,333,A
4-HA,265,0,0,335,0,335,G
4-HA,266,336,0,0,0,336,A
4-HA,267,0,0,1,483,484,C
4-HA,268,0,0,0,521,521,C
4-HA,269,0,0,0,547,547,C
4-HA,270,0,557,0,0,557,T
4-HA,271,0,1,0,576,577,C
4-HA,272,572,0,0,0,572,A
4-HA,273,319,0,339,0,658,G
4-HA,274,0,668,0,0,668,T
4-HA,275,0,0,686,0,686,G
4-HA,276,0,691,0,0,691,T
4-HA,277,1,1,682,0,684,G
4-HA,278,679,1,1,0,681,A
4-HA,279,0,682,0,0,682,T
4-HA,280,0,1,681,0,682,G
4-HA,281,1,0,680,0,681,G
4-HA,282,0,0,0,686,686,C
4-HA,283,0,680,0,0,680,T
4-HA,284,0,686,0,0,686,T
4-HA,285,1,0,0,691,692,C
4-HA,286,1,0,0,690,691,C
4-HA,287,693,0,0,0,693,A
4-HA,288,691,0,1,0,692,A
4-HA,289,699,0,0,0,699,A
4-HA,290,697,0,0,0,697,A
4-HA,291,0,708,0,0,708,T
4-HA,292,711,0,0,0,711,A
4-HA,293,707,0,2,0,709,A
4-HA,294,0,0,716,0,716,G
4-HA,295,718,0,0,0,718,A
4-HA,296,722,0,0,0,722,A
4-HA,297,718,0,0,0,718,A
4-HA,298,0,725,0,0,725,T
4-HA,299,3,0,724,0,727,G
4-HA,300,1,0,723,0,724,G
4-HA,301,0,1,720,0,721,G
4-HA,302,717,0,0,0,717,A
4-HA,303,0,0,0,735,735,C
4-HA,304,1,0,0,734,735,C
4-HA,305,0,756,0,2,758,T
4-HA,306,0,752,0,1,753,T
4-HA,307,0,753,0,0,753,T
4-HA,308,0,765,0,0,765,T
4-HA,309,0,769,0,0,769,T
4-HA,310,1,0,766,0,767,G
4-HA,311,0,765,0,0,765,T
4-HA,312,0,764,0,0,764,T
4-HA,313,0,2,766,0,768,G
4-HA,314,761,0,0,0,761,A
4-HA,315,768,0,0,0,768,A
4-HA,316,1,0,0,772,773,C
4-HA,317,0,0,772,0,772,G
4-HA,318,1,0,0,782,783,C
4-HA,319,783,0,1,0,784,A
4-HA,320,0,0,788,0,788,G
4-HA,321,0,0,0,782,782,C
4-HA,322,790,0,0,0,790,A
4-HA,323,789,0,0,0,789,A
4-HA,324,790,1,1,0,792,A
4-HA,325,0,0,839,0,839,G
4-HA,326,0,0,0,833,833,C
4-HA,327,1,0,0,846,847,C
4-HA,328,0,848,0,1,849,T
4-HA,329,858,0,1,0,859,A
4-HA,330,0,0,0,877,877,C
4-HA,331,878,0,0,0,878,A
4-HA,332,0,1,879,0,880,G
4-HA,333,0,1,0,877,878,C
4-HA,334,867,0,0,0,867,A
4-HA,335,877,0,0,0,877,A
4-HA,336,0,0,0,932,932,C
4-HA,337,0,935,0,0,935,T
4-HA,338,1,0,942,0,943,G
4-HA,339,0,945,0,0,945,T
4-HA,340,0,944,0,1,945,T
4-HA,341,948,0,0,0,948,A
4-HA,342,0,0,0,1048,1048,C
4-HA,343,5,0,0,1051,1056,C
4-HA,344,0,0,0,1100,1100,C
4-HA,345,0,1083,0,1,1084,T
4-HA,346,0,1086,0,0,1086,T
4-HA,347,1082,0,1,1,1084,A
4-HA,348,0,1096,0,0,1096,T
4-HA,349,0,4,1089,0,1093,G
4-HA,350,1076,0,2,0,1078,A
4-HA,351,0,1068,0,0,1068,T
4-HA,352,2,0,1081,0,1083,G
4-HA,353,0,1075,0,0,1075,T
4-HA,354,0,0,1076,0,1076,G
4-HA,355,0,3,0,1072,1075,C
4-HA,356,2,1,0,1076,1079,C
4-HA,357,0,1,1102,0,1103,G
4-HA,358,0,3,1122,0,1125,G
4-HA,359,1112,0,0,0,1112,A
4-HA,360,0,1139,0,0,1139,T
4-HA,361,0,1138,0,0,1138,T
4-HA,362,1143,0,0,0,1143,A
4-HA,363,0,1138,0,1,1139,T
4-HA,364,1,1,1134,0,1136,G
4-HA,365,0,0,0,1130,1130,C
4-HA,366,1,0,0,1140,1141,C
4-HA,367,1,1143,0,0,1144,T
4-HA,368,3,0,0,1205,1208,C
4-HA,369,2,0,0,1230,1232,C
4-HA,370,3,0,0,1228,1231,C
4-HA,371,0,1220,0,2,1222,T
4-HA,372,0,1230,0,0,1230,T
4-HA,373,1225,0,1,0,1226,A
4-HA,374,0,1,1249,0,1250,G
4-HA,375,1,1,1255,0,1257,G
4-HA,376,0,1237,0,1,1238,T
4-HA,377,2,1,0,1240,1243,C
4-HA,378,1220,0,0,0,1220,A
4-HA,379,0,0,0,1276,1276,C
4-HA,380,0,1274,0,1,1275,T
4-HA,381,1279,0,1,0,1280,A
4-HA,382,0,0,1270,0,1270,G
4-HA,383,0,1266,0,0,1266,T
4-HA,384,0,1267,0,0,1267,T
4-HA,385,0,0,1283,0,1283,G
4-HA,386,0,0,0,1282,1282,C
4-HA,387,2,1,0,1282,1285,C
4-HA,388,0,1277,0,2,1279,T
4-HA,389,1,0,0,1294,1295,C
4-HA,390,1328,0,0,0,1328,A
4-HA,391,0,1337,0,0,1337,T
4-HA,392,0,0,0,1333,1333,C
4-HA,393,2,1,0,1336,1339,C
4-HA,394,1,0,1329,1,1331,G
4-HA,395,1,0,1320,0,1321,G
4-HA,396,0,0,0,1342,1342,C
4-HA,397,1355,0,0,0,1355,A
4-HA,398,0,0,0,1383,1383,C
4-HA,399,1361,0,1,0,1362,A
4-HA,400,0,0,0,1381,1381,C
4-HA,401,0,1370,0,2,1372,T
4-HA,402,0,2,1374,0,1376,G
4-HA,403,0,1,1380,0,1381,G
4-HA,404,1374,0,0,0,1374,A
4-HA,405,0,0,1417,0,1417,G
4-HA,406,1,1407,0,0,1408,T
4-HA,407,0,1413,0,0,1413,T
4-HA,408,0,1400,0,24,1424,T
4-HA,409,1417,0,0,0,1417,A
4-HA,410,1412,0,1,0,1413,A
4-HA,411,1,0,0,1425,1426,C
4-HA,412,1403,0,4,0,1407,A
4-HA,413,1388,0,1,0,1389,A
4-HA,414,1387,0,0,0,1387,A
4-HA,415,0,3,1400,0,1403,G
4-HA,416,1399,0,0,0,1399,A
4-HA,417,1400,0,0,0,1400,A
4-HA,418,1395,0,4,0,1399,A
4-HA,419,0,0,1409,0,1409,G
4-HA,420,4,0,0,1411,1415,C
4-HA,421,0,1417,0,1,1418,T
4-HA,422,0,1420,0,0,1420,T
4-HA,423,1,1,0,1435,1437,C
4-HA,424,1442,0,1,0,1443,A
4-HA,425,1444,0,0,0,1444,A
4-HA,426,0,1445,0,0,1445,T
4-HA,427,0,1437,0,0,1437,T
4-HA,428,0,2,1465,0,1467,G
4-HA,429,0,4,1477,0,1481,G
4-HA,430,1472,1,2,0,1475,A
4-HA,431,0,0,0,1496,1496,C
4-HA,432,0,1488,0,1,1489,T
4-HA,433,0,0,1491,0,1491,G
4-HA,434,0,2,1478,0,1480,G
4-HA,435,1460,0,1,0,1461,A
4-HA,436,0,0,1494,0,1494,G
4-HA,437,0,1483,0,1,1484,T
4-HA,438,3,0,0,1481,1484,C
4-HA,439,1501,0,0,0,1501,A
4-HA,440,0,1,0,1505,1506,C
4-HA,441,0,1494,0,1,1495,T
4-HA,442,1,0,0,1501,1502,C
4-HA,443,1485,0,0,0,1485,A
4-HA,444,1492,0,0,0,1492,A
4-HA,445,1493,0,0,0,1493,A
4-HA,446,1503,0,0,0,1503,A
4-HA,447,0,0,0,1513,1513,C
4-HA,448,0,0,1512,0,1512,G
4-HA,449,0,6,1513,0,1519,G
4-HA,450,1520,1,0,0,1521,A
4-HA,451,1526,0,0,0,1526,A
4-HA,452,0,0,0,1546,1546,C
4-HA,453,1541,0,0,0,1541,A
4-HA,454,1543,0,1,0,1544,A
4-HA,455,0,0,1545,0,1545,G
4-HA,456,0,0,0,1551,1551,C
4-HA,457,0,1539,0,1,1540,T
4-HA,458,1,0,0,1565,1566,C
4-HA,459,0,1558,0,0,1558,T
4-HA,460,0,1,1560,0,1561,G
4-HA,461,0,0,0,1561,1561,C
4-HA,462,0,1558,1,2,1561,T
4-HA,463,0,1621,0,0,1621,T
4-HA,464,1,0,1658,0,1659,G
4-HA,465,1,1,0,1676,1678,C
4-HA,466,1672,0,0,0,1672,A
4-HA,467,0,1665,0,0,1665,T
4-HA,468,1663,0,0,0,1663,A
4-HA,469,1650,0,0,0,1650,A
4-HA,470,1,2,1643,0,1646,G
4-HA,471,0,1,1651,0,1652,G
4-HA,472,1612,0,1,0,1613,A
4-HA,473,1,3,1622,0,1626,G
4-HA,474,1610,0,1,0,1611,A
4-HA,475,0,1677,0,0,1677,T
4-HA,476,1,1,0,1702,1704,C
4-HA,477,0,1703,0,0,1703,T
4-HA,478,1713,0,0,0,1713,A
4-HA,479,1703,0,0,0,1703,A
4-HA,480,0,1709,0,0,1709,T
4-HA,481,1708,0,0,0,1708,A
4-HA,482,1701,0,1,0,1702,A
4-HA,483,0,3,0,1705,1708,C
4-HA,484,1673,0,1,0,1674,A
4-HA,485,0,0,1676,0,1676,G
4-HA,486,0,1659,0,2,1661,T
4-HA,487,0,1691,0,0,1691,T
4-HA,488,0,1697,0,0,1697,T
4-HA,489,0,0,0,1732,1732,C
4-HA,490,0,1725,0,1,1726,T
4-HA,491,1,1733,0,0,1734,T
4-HA,492,1,1731,0,0,1732,T
4-HA,493,1727,0,0,0,1727,A
4-HA,494,0,1,1730,0,1731,G
4-HA,495,0,1709,0,1,1710,T
4-HA,496,1731,0,0,0,1731,A
4-HA,497,1,0,1734,0,1735,G
4-HA,498,1713,0,1,0,1714,A
4-HA,499,1,1713,0,1,1715,T
4-HA,500,0,1721,0,0,1721,T
4-HA,501,0,3,1738,0,1741,G
4-HA,502,1742,1,1,0,1744,A
4-HA,503,1736,0,0,0,1736,A
4-HA,504,0,1738,0,1,1739,T
4-HA,505,0,1741,0,1,1742,T
4-HA,506,1,3,1758,0,1762,G
4-HA,507,0,0,1757,0,1757,G
4-HA,508,0,1742,0,0,1742,T
4-HA,509,0,1752,0,0,1752,T
4-HA,510,0,3,1741,0,1744,G
4-HA,511,1745,0,1,0,1746,A
4-HA,512,0,0,0,1733,1733,C
4-HA,513,1,0,0,1724,1725,C
4-HA,514,1,2,0,1746,1749,C
4-HA,515,1746,0,1,0,1747,A
4-HA,516,0,0,0,1747,1747,C
4-HA,517,0,1726,0,0,1726,T
4-HA,518,4,0,0,1736,1740,C
4-HA,519,1759,0,0,0,1759,A
4-HA,520,1756,1,0,0,1757,A
4-HA,521,1764,0,0,0,1764,A
4-HA,522,1778,0,3,0,1781,A
4-HA,523,0,1809,0,0,1809,T
4-HA,524,0,1801,0,0,1801,T
4-HA,525,5,2,0,1807,1814,C
4-HA,526,1813,0,1,0,1814,A
4-HA,527,1809,0,0,0,1809,A
4-HA,528,1815,0,0,0,1815,A
4-HA,529,0,1805,0,1,1806,T
4-HA,530,1817,1,0,0,1818,A
4-HA,531,0,0,0,1824,1824,C
4-HA,532,0,0,0,1795,1795,C
4-HA,533,1,0,0,1803,1804,C
4-HA,534,1805,0,0,0,1805,A
4-HA,535,0,2,1863,0,1865,G
4-HA,536,0,0,0,1868,1868,C
4-HA,537,1877,0,0,0,1877,A
4-HA,538,0,1875,0,0,1875,T
4-HA,539,1,1864,0,1,1866,T
4-HA,540,0,1,1954,0,1955,G
4-HA,541,1949,0,1,0,1950,A
4-HA,542,1947,0,0,0,1947,A
4-HA,543,0,1895,0,1,1896,T
4-HA,544,0,0,1909,0,1909,G
4-HA,545,0,1908,0,0,1908,T
4-HA,546,1,0,1924,0,1925,G
4-HA,547,1922,0,2,0,1924,A
4-HA,548,0,0,0,1925,1925,C
4-HA,549,0,1862,0,1,1863,T
4-HA,550,1911,0,0,0,1911,A
4-HA,551,1,1908,0,1,1910,T
4-HA,552,0,1,1923,0,1924,G
4-HA,553,0,0,0,1912,1912,C
4-HA,554,4,0,0,1922,1926,C
4-HA,555,1924,0,0,0,1924,A
4-HA,556,1919,0,0,1,1920,A
4-HA,557,1948,0,0,8,1956,A
4-HA,558,0,1,0,1961,1962,C
4-HA,559,1934,0,0,0,1934,A
4-HA,560,1912,0,0,10,1922,A
4-HA,561,0,1926,0,0,1926,T
4-HA,562,1,5,1916,0,1922,G
4-HA,563,1924,0,1,0,1925,A
4-HA,564,1934,0,0,0,1934,A
4-HA,565,0,0,1,1902,1903,C
4-HA,566,1912,0,1,0,1913,A
4-HA,567,1908,0,0,0,1908,A
4-HA,568,0,1900,0,0,1900,T
4-HA,569,0,1906,0,1,1907,T
4-HA,570,0,1919,0,0,1919,T
4-HA,571,1,5,1899,0,1905,G
4-HA,572,1912,0,4,0,1916,A
4-HA,573,0,0,0,1925,1925,C
4-HA,574,1931,0,0,0,1931,A
4-HA,575,1934,0,0,0,1934,A
4-HA,576,1940,0,0,0,1940,A
4-HA,577,1,1951,0,0,1952,T
4-HA,578,1,1947,0,0,1948,T
4-HA,579,0,1,1959,0,1960,G
4-HA,580,0,1954,0,2,1956,T
4-HA,581,1961,0,2,1,1964,A
4-HA,582,2,1,0,2002,2005,C
4-HA,583,1998,0,0,0,1998,A
4-HA,584,0,2016,1,0,2017,T
4-HA,585,0,1994,0,0,1994,T
4-HA,586,0,1994,0,0,1994,T
4-HA,587,0,0,1994,0,1994,G
4-HA,588,1,3,1971,0,1975,G
4-HA,589,1,5,1958,0,1964,G
4-HA,590,0,1,1961,0,1962,G
4-HA,591,0,1,1949,1,1951,G
4-HA,592,1,0,2004,0,2005,G
4-HA,593,0,1973,0,1,1974,T
4-HA,594,0,1991,0,0,1991,T
4-HA,595,5,1,0,1983,1989,C
4-HA,596,1993,0,3,0,1996,A
4-HA,597,1,0,0,1992,1993,C
4-HA,598,4,0,0,1990,1994,C
4-HA,599,1996,0,2,1,1999,A
4-HA,600,2,1,0,2006,2009,C
4-HA,601,0,0,0,1996,1996,C
4-HA,602,3,0,0,1994,1997,C
4-HA,603,0,0,1998,0,1998,G
4-HA,604,1,0,2055,0,2056,G
4-HA,605,0,1,2063,0,2064,G
4-HA,606,0,2019,0,2,2021,T
4-HA,607,2048,0,0,0,2048,A
4-HA,608,0,5,0,2032,2037,C
4-HA,609,2,1,2022,0,2025,G
4-HA,610,1,1,2029,1,2032,G
4-HA,611,2046,2,0,0,2048,A
4-HA,612,1,0,0,2053,2054,C
4-HA,613,1994,0,0,1,1995,A
4-HA,614,1981,0,1,0,1982,A
4-HA,615,2,1984,0,0,1986,T
4-HA,616,0,5,1997,0,2002,G
4-HA,617,1998,0,2,0,2000,A
4-HA,618,1,0,1,2005,2007,C
4-HA,619,4,0,0,1982,1986,C
4-HA,620,2000,0,0,0,2000,A
4-HA,621,1987,0,0,0,1987,A
4-HA,622,2006,0,0,0,2006,A
4-HA,623,0,1979,0,0,1979,T
4-HA,624,6,1,0,2006,2013,C
4-HA,625,0,1919,0,1,1920,T
4-HA,626,0,1893,0,0,1893,T
4-HA,627,1,0,0,1934,1935,C
4-HA,628,2,0,1,1931,1934,C
4-HA,629,0,1938,0,0,1938,T
4-HA,630,2,0,1951,0,1953,G
4-HA,631,0,1936,1,0,1937,T
4-HA,632,1955,0,0,0,1955,A
4-HA,633,0,1945,0,2,1947,T
4-HA,634,1,1,1949,0,1951,G
4-HA,635,0,0,0,1947,1947,C
4-HA,636,0,1932,0,2,1934,T
4-HA,637,1,0,0,1945,1946,C
4-HA,638,1958,0,1,0,1959,A
4-HA,639,1944,0,2,0,1946,A
4-HA,640,0,0,1949,0,1949,G
4-HA,641,1,0,0,1972,1973,C
4-HA,642,1971,0,1,0,1972,A
4-HA,643,0,1952,1,0,1953,T
4-HA,644,2,0,0,1965,1967,C
4-HA,645,1952,0,4,0,1956,A
4-HA,646,0,0,1962,0,1962,G
4-HA,647,0,3,1955,0,1958,G
4-HA,648,1962,0,4,0,1966,A
4-HA,649,1954,0,0,0,1954,A
4-HA,650,0,2,1970,0,1972,G
4-HA,651,1977,0,0,0,1977,A
4-HA,652,1990,0,1,0,1991,A
4-HA,653,0,1985,2,2,1989,T
4-HA,654,2,2,0,1990,1994,C
4-HA,655,1984,0,0,0,1984,A
4-HA,656,0,1,0,1981,1982,C
4-HA,657,1971,1,1,0,1973,A
4-HA,658,0,0,1994,0,1994,G
4-HA,659,0,1939,1,1,1941,T
4-HA,660,7,0,0,1972,1979,C
4-HA,661,0,1948,1,2,1951,T
4-HA,662,4,0,0,1989,1993,C
4-HA,663,0,1994,1,1,1996,T
4-HA,664,1997,0,0,0,1997,A
4-HA,665,0,0,1,1990,1991,C
4-HA,666,3,0,0,2004,2007,C
4-HA,667,1983,1,0,0,1984,A
4-HA,668,1978,0,0,1,1979,A
4-HA,669,1976,0,0,0,1976,A
4-HA,670,1967,0,0,0,1967,A
4-HA,671,0,1,1970,0,1971,G
4-HA,672,1960,0,0,0,1960,A
4-HA,673,1952,0,0,0,1952,A
4-HA,674,0,1,1965,0,1966,G
4-HA,675,1,2,0,1936,1939,C
4-HA,676,0,0,0,1968,1968,C
4-HA,677,1975,0,0,0,1975,A
4-HA,678,1975,0,4,0,1979,A
4-HA,679,2,0,0,1983,1985,C
4-HA,680,1983,0,1,0,1984,A
4-HA,681,1,3,1943,0,1947,G
4-HA,682,1966,1,1,0,1968,A
4-HA,683,1,1,0,2027,2029,C
4-HA,684,0,2026,1,1,2028,T
4-HA,685,3,1,2027,0,2031,G
4-HA,686,0,2029,1,0,2030,T
4-HA,687,2042,0,0,0,2042,A
4-HA,688,2042,0,1,0,2043,A
4-HA,689,0,2021,0,1,2022,T
4-HA,690,4,0,0,2024,2028,C
4-HA,691,1,1,0,2013,2015,C
4-HA,692,1,1,0,1976,1978,C
4-HA,693,1,0,1991,0,1992,G
4-HA,694,1972,0,0,0,1972,A
4-HA,695,1974,0,0,0,1974,A
4-HA,696,0,1964,1,0,1965,T
4-HA,697,1972,0,0,0,1972,A
4-HA,698,0,1922,1,0,1923,T
4-HA,699,1,0,0,1939,1940,C
4-HA,700,0,3,1926,0,1929,G
4-HA,701,0,4,1962,0,1966,G
4-HA,702,1972,0,0,0,1972,A
4-HA,703,0,1983,1,0,1984,T
4-HA,704,2,0,0,1985,1987,C
4-HA,705,0,1988,1,1,1990,T
4-HA,706,2000,0,2,0,2002,A
4-HA,707,0,2,2015,0,2017,G
4-HA,708,2009,0,1,0,2010,A
4-HA,709,2,0,0,2007,2009,C
4-HA,710,2,0,0,1968,1970,C
4-HA,711,3,4,0,1981,1988,C
4-HA,712,1995,0,0,0,1995,A
4-HA,713,0,0,2068,0,2068,G
4-HA,714,2063,1,2,1,2067,A
4-HA,715,0,0,2086,0,2086,G
4-HA,716,0,2057,1,0,2058,T
4-HA,717,2072,0,1,0,2073,A
4-HA,718,2071,0,1,0,2072,A
4-HA,719,0,1,2087,0,2088,G
4-HA,720,0,3,2086,0,2089,G
4-HA,721,2068,1,0,0,2069,A
4-HA,722,1949,0,2,0,1951,A
4-HA,723,0,1926,0,1,1927,T
4-HA,724,1930,0,2,0,1932,A
4-HA,725,0,1918,0,0,1918,T
4-HA,726,2,0,0,1932,1934,C
4-HA,727,1,0,0,1934,1935,C
4-HA,728,2,0,1,1916,1919,C
4-HA,729,0,1905,0,0,1905,T
4-HA,730,1923,0,0,0,1923,A
4-HA,731,1,0,1901,0,1902,G
4-HA,732,1,0,0,1910,1911,C
4-HA,733,1878,1,0,0,1879,A
4-HA,734,0,2,1918,0,1920,G
4-HA,735,1901,0,1,0,1902,A
4-HA,736,1907,0,0,0,1907,A
4-HA,737,0,1902,0,0,1902,T
4-HA,738,1910,0,0,0,1910,A
4-HA,739,1904,0,2,0,1906,A
4-HA,740,0,0,1887,0,1887,G
4-HA,741,0,0,0,1896,1896,C
4-HA,742,1897,0,0,0,1897,A
4-HA,743,0,1830,0,1,1831,T
4-HA,744,1,0,0,1913,1914,C
4-HA,745,0,1895,0,1,1896,T
4-HA,746,1912,1,1,0,1914,A
4-HA,747,0,1893,0,0,1893,T
4-HA,748,0,1893,0,0,1893,T
4-HA,749,0,2,1903,0,1905,G
4-HA,750,0,4,1892,0,1896,G
4-HA,751,1885,0,3,0,1888,A
4-HA,752,1,0,0,1890,1891,C
4-HA,753,1792,0,1,0,1793,A
4-HA,754,1819,0,1,0,1820,A
4-HA,755,0,1890,0,0,1890,T
4-HA,756,1903,0,0,0,1903,A
4-HA,757,1,0,1914,0,1915,G
4-HA,758,1,1895,0,1,1897,T
4-HA,759,1901,0,1,0,1902,A
4-HA,760,1920,0,1,0,1921,A
4-HA,761,1943,0,0,0,1943,A
4-HA,762,1956,0,1,1,1958,A
4-HA,763,1,0,0,1989,1990,C
4-HA,764,1,2,0,1904,1907,C
4-HA,765,2,5,1886,0,1893,G
4-HA,766,1,2,1902,0,1905,G
4-HA,767,0,3,1931,1,1935,G
4-HA,768,1947,0,1,0,1948,A
4-HA,769,1,2,1978,0,1981,G
4-HA,770,2020,0,2,0,2022,A
4-HA,771,0,3,0,2033,2036,C
4-HA,772,2034,0,1,8,2043,A
4-HA,773,0,2049,0,0,2049,T
4-HA,774,2041,0,13,0,2054,A
4-HA,775,0,0,0,2104,2104,C
4-HA,776,0,2090,0,0,2090,T
4-HA,777,0,2099,0,0,2099,T
4-HA,778,0,2121,0,0,2121,T
4-HA,779,0,2125,0,0,2125,T
4-HA,780,0,4,2155,0,2159,G
4-HA,781,2175,0,0,0,2175,A
4-HA,782,0,2171,0,0,2171,T
4-HA,783,0,2247,0,0,2247,T
4-HA,784,2240,1,0,0,2241,A
4-HA,785,2256,0,0,0,2256,A
4-HA,786,1,0,0,2286,2287,C
4-HA,787,2283,0,2,0,2285,A
4-HA,788,1,2,2364,0,2367,G
4-HA,789,0,0,1,2368,2369,C
4-HA,790,2376,0,1,0,2377,A
4-HA,791,0,0,0,2400,2400,C
4-HA,792,2390,0,2,0,2392,A
4-HA,793,0,4,2424,0,2428,G
4-HA,794,0,1,2412,0,2413,G
4-HA,795,0,5,2500,0,2505,G
4-HA,796,2476,0,2,0,2478,A
4-HA,797,2521,0,2,0,2523,A
4-HA,798,0,2532,0,0,2532,T
4-HA,799,0,1,0,2550,2551,C
4-HA,800,0,2571,0,1,2572,T
4-HA,801,2579,1,1,0,2581,A
4-HA,802,2576,0,0,0,2576,A
4-HA,803,3,2560,0,0,2563,T
4-HA,804,0,2506,1,1,2508,T
4-HA,805,0,1,2536,0,2537,G
4-HA,806,3,0,0,2622,2625,C
4-HA,807,0,2686,0,2,2688,T
4-HA,808,7,1,0,2772,2780,C
4-HA,809,1,1,0,2782,2784,C
4-HA,810,0,2792,0,2,2794,T
4-HA,811,2785,0,1,0,2786,A
4-HA,812,0,3,2795,0,2798,G
4-HA,813,2,1,2821,0,2824,G
4-HA,814,0,4,2813,0,2817,G
4-HA,815,0,0,2813,0,2813,G
4-HA,816,0,2751,0,1,2752,T
4-HA,817,0,2768,0,3,2771,T
4-HA,818,2764,0,1,0,2765,A
4-HA,819,0,0,0,2815,2815,C
4-HA,820,0,2819,0,2,2821,T
4-HA,821,0,2874,0,1,2875,T
4-HA,822,4,1,0,2863,2868,C
4-HA,823,2865,0,1,0,2866,A
4-HA,824,2864,1,2,0,2867,A
4-HA,825,2860,0,0,0,2860,A
4-HA,826,2928,0,1,0,2929,A
4-HA,827,0,2929,0,2,2931,T
4-HA,828,2925,0,0,0,2925,A
4-HA,829,0,0,0,2917,2917,C
4-HA,830,2900,0,0,0,2900,A
4-HA,831,2904,0,0,0,2904,A
4-HA,832,2902,0,2,0,2904,A
4-HA,833,1,0,2934,0,2935,G
4-HA,834,0,2921,0,1,2922,T
4-HA,835,0,2,2958,0,2960,G
4-HA,836,2,4,2944,1,2951,G
4-HA,837,1,5,2956,0,2962,G
4-HA,838,2963,0,2,1,2966,A
4-HA,839,2970,0,1,0,2971,A
4-HA,840,2982,0,0,0,2982,A
4-HA,841,2965,0,5,0,2970,A
4-HA,842,1,1,3013,0,3015,G
4-HA,843,0,1,0,3002,3003,C
4-HA,844,0,2984,1,3,2988,T
4-HA,845,4,1,0,3024,3029,C
4-HA,846,3060,0,2,1,3063,A
4-HA,847,3087,1,0,0,3088,A
4-HA,848,1,3095,0,0,3096,T
4-HA,849,3123,0,2,0,3125,A
4-HA,850,3118,0,2,0,3120,A
4-HA,851,0,3090,0,3,3093,T
4-HA,852,0,6,3085,0,3091,G
4-HA,853,3089,0,2,0,3091,A
4-HA,854,0,6,3167,0,3173,G
4-HA,855,3190,1,1,0,3192,A
4-HA,856,0,3161,0,0,3161,T
4-HA,857,6,2,0,3232,3240,C
4-HA,858,3226,1,2,0,3229,A
4-HA,859,0,2,3294,0,3296,G
4-HA,860,3284,0,0,0,3284,A
4-HA,861,0,3296,0,0,3296,T
4-HA,862,1,2,3279,0,3282,G
4-HA,863,1,3,0,3222,3226,C
4-HA,864,3227,0,5,1,3233,A
4-HA,865,4,1,1,3333,3339,C
4-HA,866,0,1,0,3307,3308,C
4-HA,867,3,0,0,3354,3357,C
4-HA,868,3323,1,0,1,3325,A
4-HA,869,0,3313,0,0,3313,T
4-HA,870,0,3328,0,2,3330,T
4-HA,871,1,9,3354,1,3365,G
4-HA,872,2,1,3346,0,3349,G
4-HA,873,1,1,0,3378,3380,C
4-HA,874,3359,0,1,1,3361,A
4-HA,875,3349,0,1,0,3350,A
4-HA,876,3394,0,0,1,3395,A
4-HA,877,0,3398,0,0,3398,T
4-HA,878,1,0,3402,0,3403,G
4-HA,879,0,1,0,3412,3413,C
4-HA,880,3382,0,0,0,3382,A
4-HA,881,3490,0,1,0,3491,A
4-HA,882,0,3484,0,0,3484,T
4-HA,883,0,3499,0,0,3499,T
4-HA,884,5,0,0,3518,3523,C
4-HA,885,0,3482,0,3,3485,T
4-HA,886,1,8,3516,0,3525,G
4-HA,887,3518,0,0,0,3518,A
4-HA,888,3527,2,0,0,3529,A
4-HA,889,0,3528,0,2,3530,T
4-HA,890,1,0,3502,1,3504,G
4-HA,891,1,0,0,3540,3541,C
4-HA,892,3550,0,0,1,3551,A
4-HA,893,1,3528,0,3,3532,T
4-HA,894,6,0,0,3524,3530,C
4-HA,895,3555,0,1,1,3557,A
4-HA,896,0,0,0,3695,3695,C
4-HA,897,0,3661,0,3,3664,T
4-HA,898,5,0,0,3677,3682,C
4-HA,899,10,1,0,3680,3691,C
4-HA,900,3734,0,1,0,3735,A
4-HA,901,3710,0,1,2,3713,A
4-HA,902,3709,1,3,1,3714,A
4-HA,903,0,3616,1,0,3617,T
4-HA,904,1,6,3642,1,3650,G
4-HA,905,1,1,3639,0,3641,G
4-HA,906,3651,1,3,1,3656,A
4-HA,907,3629,0,8,1,3638,A
4-HA,908,0,1,3659,0,3660,G
4-HA,909,3,0,0,3645,3648,C
4-HA,910,3651,0,1,1,3653,A
4-HA,911,0,3647,0,0,3647,T
4-HA,912,0,3609,0,4,3613,T
4-HA,913,3,0,0,3716,3719,C
4-HA,914,2,0,0,3731,3733,C
4-HA,915,3,1,0,3752,3756,C
4-HA,916,3737,0,1,1,3739,A
4-HA,917,3802,0,0,2,3804,A
4-HA,918,0,3876,0,2,3878,T
4-HA,919,1,9,3862,0,3872,G
4-HA,920,3839,0,17,1,3857,A
4-HA,921,1,4,1,3864,3870,C
4-HA,922,3813,0,0,1,3814,A
4-HA,923,3822,0,0,1,3823,A
4-HA,924,3776,0,2,1,3779,A
4-HA,925,1,0,0,3816,3817,C
4-HA,926,7,2,0,3785,3794,C
4-HA,927,3762,0,1,1,3764,A
4-HA,928,0,3747,0,2,3749,T
4-HA,929,0,3720,1,0,3721,T
4-HA,930,6,1,0,3769,3776,C
4-HA,931,4,2,0,3780,3786,C
4-HA,932,3802,0,0,0,3802,A
4-HA,933,3791,0,0,1,3792,A
4-HA,934,3788,0,0,1,3789,A
4-HA,935,3853,0,0,1,3854,A
4-HA,936,0,3843,0,0,3843,T
4-HA,937,1,0,3845,0,3846,G
4-HA,938,0,3793,0,2,3795,T
4-HA,939,2,3843,0,0,3845,T
4-HA,940,3922,0,0,0,3922,A
4-HA,941,3909,1,2,1,3913,A
4-HA,942,1,26,0,3895,3922,C
4-HA,943,3898,1,6,0,3905,A
4-HA,944,0,6,3931,0,3937,G
4-HA,945,0,11,3974,0,3985,G
4-HA,946,4067,0,2,0,4069,A
4-HA,947,0,4063,0,2,4065,T
4-HA,948,11,0,0,4147,4158,C
4-HA,949,4199,0,4,2,4205,A
4-HA,950,12,0,1,4311,4324,C
4-HA,951,4336,0,4,1,4341,A
4-HA,952,0,4465,0,1,4466,T
4-HA,953,4403,0,0,1,4404,A
4-HA,954,3,1,0,4346,4350,C
4-HA,955,1,5,4227,1,4234,G
4-HA,956,3,5,4175,0,4183,G
4-HA,957,2,1,4085,0,4088,G
4-HA,958,0,2,4140,0,4142,G
4-HA,959,2,1,0,4141,4144,C
4-HA,960,1,1,0,4157,4159,C
4-HA,961,0,4101,0,6,4107,T
4-HA,962,2,1,4446,0,4449,G
4-HA,963,0,4399,0,9,4408,T
4-HA,964,8,0,0,4468,4476,C
4-HA,965,3,0,0,4475,4478,C
4-HA,966,4,1,1,4517,4523,C
4-HA,967,4519,0,3,0,4522,A
4-HA,968,2,3,4544,0,4549,G
4-HA,969,4528,0,0,0,4528,A
4-HA,970,0,4528,0,1,4529,T
4-HA,971,4357,0,0,0,4357,A
4-HA,972,0,4303,0,1,4304,T
4-HA,973,1,2,4325,0,4328,G
4-HA,974,1,4291,0,1,4293,T
4-HA,975,0,4272,0,0,4272,T
4-HA,976,4332,0,0,0,4332,A
4-HA,977,4267,0,5,0,4272,A
4-HA,978,0,3,4304,0,4307,G
4-HA,979,2,2,0,4285,4289,C
4-HA,980,4272,0,1,0,4273,A
4-HA,981,4276,0,3,0,4279,A
4-HA,982,4254,0,2,0,4256,A
4-HA,983,4253,0,3,1,4257,A
4-HA,984,1,1,0,4254,4256,C
4-HA,985,4229,1,0,0,4230,A
4-HA,986,2,2,0,4277,4281,C
4-HA,987,1,4205,0,0,4206,T
4-HA,988,8,1,1,4238,4248,C
4-HA,989,0,4252,0,2,4254,T
4-HA,990,2,6,4279,0,4287,G
4-HA,991,4267,1,4,0,4272,A
4-HA,992,4263,0,1,0,4264,A
4-HA,993,4272,0,0,0,4272,A
4-HA,994,1,4273,0,2,4276,T
4-HA,995,0,4258,0,1,4259,T
4-HA,996,4,6,4266,0,4276,G
4-HA,997,1,2,4243,0,4246,G
4-HA,998,2,1,0,4289,4292,C
4-HA,999,4288,0,3,0,4291,A
4-HA,1000,4276,1,0,0,4277,A
4-HA,1001,12,1,0,4294,4307,C
4-HA,1002,4266,0,3,0,4269,A
4-HA,1003,0,7,4296,1,4304,G
4-HA,1004,0,5,4269,0,4274,G
4-HA,1005,4,4,4271,0,4279,G
4-HA,1006,4265,0,3,0,4268,A
4-HA,1007,0,4238,0,3,4241,T
4-HA,1008,0,1,4275,0,4276,G
4-HA,1009,0,2,0,4285,4287,C
4-HA,1010,2,8,4307,0,4317,G
4-HA,1011,4327,0,2,0,4329,A
4-HA,1012,4304,1,0,1,4306,A
4-HA,1013,4359,0,2,0,4361,A
4-HA,1014,0,4303,0,0,4303,T
4-HA,1015,0,0,4390,0,4390,G
4-HA,1016,1,4360,0,3,4364,T
4-HA,1017,4350,0,4,0,4354,A
4-HA,1018,2,0,0,4333,4335,C
4-HA,1019,4,0,1,4345,4350,C
4-HA,1020,4314,0,9,0,4323,A
4-HA,1021,1,7,4308,0,4316,G
4-HA,1022,4266,0,1,0,4267,A
4-HA,1023,2,5,4289,0,4296,G
4-HA,1024,4280,0,1,0,4281,A
4-HA,1025,4274,0,3,0,4277,A
4-HA,1026,4266,1,10,0,4277,A
4-HA,1027,2,0,0,4284,4286,C
4-HA,1028,4283,0,0,0,4283,A
4-HA,1029,4316,0,2,0,4318,A
4-HA,1030,4294,1,1,0,4296,A
4-HA,1031,3,1,1,4345,4350,C
4-HA,1032,0,4301,0,2,4303,T
4-HA,1033,4287,0,1,0,4288,A
4-HA,1034,0,6,4289,0,4295,G
4-HA,1035,4224,2,7,0,4233,A
4-HA,1036,0,4,4328,0,4332,G
4-HA,1037,1,1,4298,0,4300,G
4-HA,1038,2,1,0,4260,4263,C
4-HA,1039,4283,3,1,1,4288,A
4-HA,1040,0,4289,0,2,4291,T
4-HA,1041,4301,3,1,0,4305,A
4-HA,1042,1,4287,0,2,4290,T
4-HA,1043,1,4291,0,0,4292,T
4-HA,1044,1,4294,0,1,4296,T
4-HA,1045,1,4,4230,0,4235,G
4-HA,1046,0,1,4242,0,4243,G
4-HA,1047,2,3,0,4185,4190,C
4-HA,1048,1,1,4232,0,4234,G
4-HA,1049,0,5,0,4204,4209,C
4-HA,1050,4204,0,0,0,4204,A
4-HA,1051,4188,0,1,0,4189,A
4-HA,1052,0,4153,0,1,4154,T
4-HA,1053,9,2,0,4230,4241,C
4-HA,1054,1,4,4251,0,4256,G
4-HA,1055,1,2,0,4232,4235,C
4-HA,1056,0,8,4259,0,4267,G
4-HA,1057,2,1,4292,0,4295,G
4-HA,1058,0,1,4322,0,4323,G
4-HA,1059,0,4215,0,3,4218,T
4-HA,1060,0,4232,0,1,4233,T
4-HA,1061,0,4252,0,4,4256,T
4-HA,1062,7,0,0,4270,4277,C
4-HA,1063,4273,0,4,1,4278,A
4-HA,1064,0,4289,0,3,4292,T
4-HA,1065,4276,0,3,0,4279,A
4-HA,1066,1,7,4318,0,4326,G
4-HA,1067,4271,0,0,1,4272,A
4-HA,1068,4280,0,0,0,4280,A
4-HA,1069,4268,1,0,0,4269,A
4-HA,1070,4264,0,1,0,4265,A
4-HA,1071,1,4299,0,0,4300,T
4-HA,1072,1,2,4323,0,4326,G
4-HA,1073,5,2,4309,0,4316,G
4-HA,1074,1,4235,0,3,4239,T
4-HA,1075,0,4276,0,2,4278,T
4-HA,1076,0,7,4268,0,4275,G
4-HA,1077,1,4,4291,0,4296,G
4-HA,1078,0,5,4333,1,4339,G
4-HA,1079,4259,0,7,1,4267,A
4-HA,1080,1,1,4341,0,4343,G
4-HA,1081,0,5,4309,1,4315,G
4-HA,1082,3,3,4389,0,4395,G
4-HA,1083,4336,1,4,0,4341,A
4-HA,1084,4397,0,2,0,4399,A
4-HA,1085,0,4414,0,1,4415,T
4-HA,1086,1,7,4482,1,4491,G
4-HA,1087,9,1,4551,0,4561,G
4-HA,1088,0,4451,0,2,4453,T
4-HA,1089,0,4,4530,0,4534,G
4-HA,1090,0,1,4506,0,4507,G
4-HA,1091,4387,1,6,0,4394,A
4-HA,1092,1,4451,0,4,4456,T
4-HA,1093,3,10,4491,0,4504,G
4-HA,1094,2,1,4552,0,4555,G
4-HA,1095,0,4450,0,1,4451,T
4-HA,1096,0,4375,0,3,4378,T
4-HA,1097,2,3,4379,0,4384,G
4-HA,1098,1,3,4411,0,4415,G
4-HA,1099,0,4337,0,6,4343,T
4-HA,1100,4425,0,2,0,4427,A
4-HA,1101,0,2,0,4271,4273,C
4-HA,1102,2,7,4321,0,4330,G
4-HA,1103,1,1,4429,0,4431,G
4-HA,1104,0,4418,1,4,4423,T
4-HA,1105,0,4404,0,3,4407,T
4-HA,1106,0,4407,0,1,4408,T
4-HA,1107,6,4,0,4365,4375,C
4-HA,1108,4383,1,6,2,4392,A
4-HA,1109,0,4,4364,0,4368,G
4-HA,1110,0,2,4361,0,4363,G
4-HA,1111,1,0,0,4344,4345,C
4-HA,1112,4255,0,0,0,4255,A
4-HA,1113,0,4258,0,2,4260,T
4-HA,1114,3,1,0,4281,4285,C
4-HA,1115,4304,0,2,0,4306,A
4-HA,1116,4296,0,0,0,4296,A
4-HA,1117,4291,0,0,0,4291,A
4-HA,1118,4314,0,2,0,4316,A
4-HA,1119,0,4291,0,1,4292,T
4-HA,1120,0,4291,0,1,4292,T
4-HA,1121,6,0,0,4312,4318,C
4-HA,1122,1,4307,0,1,4309,T
4-HA,1123,1,2,4298,0,4301,G
4-HA,1124,4253,2,3,1,4259,A
4-HA,1125,4252,0,5,2,4259,A
4-HA,1126,0,3,4289,0,4292,G
4-HA,1127,0,3,4358,0,4361,G
4-HA,1128,4317,1,1,1,4320,A
4-HA,1129,4340,0,1,1,4342,A
4-HA,1130,2,7,4336,0,4345,G
4-HA,1131,4360,1,5,0,4366,A
4-HA,1132,1,0,4402,0,4403,G
4-HA,1133,0,11,4406,0,4417,G
4-HA,1134,4396,0,13,0,4409,A
4-HA,1135,0,1,0,4390,4391,C
4-HA,1136,4381,0,4,2,4387,A
4-HA,1137,4374,0,4,0,4378,A
4-HA,1138,0,2,4395,0,4397,G
4-HA,1139,3,2,0,4373,4378,C
4-HA,1140,4360,0,2,1,4363,A
4-HA,1141,1,2,4365,0,4368,G
4-HA,1142,3,0,0,4331,4334,C
4-HA,1143,4336,1,4,0,4341,A
4-HA,1144,0,5,4415,0,4420,G
4-HA,1145,4359,0,2,0,4361,A
4-HA,1146,0,4406,1,3,4410,T
4-HA,1147,9,2,0,4437,4448,C
4-HA,1148,2,4408,1,9,4420,T
4-HA,1149,6,1,0,4456,4463,C
4-HA,1150,4469,0,2,0,4471,A
4-HA,1151,4462,1,1,0,4464,A
4-HA,1152,4461,1,1,0,4463,A
4-HA,1153,4411,0,4,0,4415,A
4-HA,1154,3,2,4397,0,4402,G
4-HA,1155,0,2,0,4330,4332,C
4-HA,1156,4320,1,0,0,4321,A
4-HA,1157,0,1,1,4369,4371,C
4-HA,1158,0,4337,1,4,4342,T
4-HA,1159,8,0,0,4378,4386,C
4-HA,1160,4413,0,0,1,4414,A
4-HA,1161,4463,0,3,0,4466,A
4-HA,1162,1,0,4457,0,4458,G
4-HA,1163,0,0,0,4446,4446,C
4-HA,1164,4439,0,0,1,4440,A
4-HA,1165,2,1,4424,0,4427,G
4-HA,1166,2,0,0,4378,4380,C
4-HA,1167,4396,0,0,0,4396,A
4-HA,1168,4365,1,1,0,4367,A
4-HA,1169,0,4272,1,3,4276,T
4-HA,1170,3,6,0,4306,4315,C
4-HA,1171,3,5,4336,0,4344,G
4-HA,1172,4317,0,3,0,4320,A
4-HA,1173,1,4269,1,7,4278,T
4-HA,1174,13,0,0,4278,4291,C
4-HA,1175,4311,0,5,0,4316,A
4-HA,1176,4397,0,1,1,4399,A
4-HA,1177,4412,0,4,0,4416,A
4-HA,1178,0,4326,3,2,4331,T
4-HA,1179,9,0,0,4391,4400,C
4-HA,1180,4368,0,1,0,4369,A
4-HA,1181,4369,0,2,1,4372,A
4-HA,1182,0,4372,1,0,4373,T
4-HA,1183,0,4,4385,0,4389,G
4-HA,1184,1,2,4359,0,4362,G
4-HA,1185,2,4,4322,0,4328,G
4-HA,1186,4317,0,0,0,4317,A
4-HA,1187,4343,0,3,0,4346,A
4-HA,1188,0,2,4361,0,4363,G
4-HA,1189,2,0,0,4350,4352,C
4-HA,1190,0,4362,1,3,4366,T
4-HA,1191,1,3,4517,0,4521,G
4-HA,1192,4541,0,2,0,4543,A
4-HA,1193,4542,0,6,1,4549,A
4-HA,1194,1,4531,1,1,4534,T
4-HA,1195,4484,0,2,0,4486,A
4-HA,1196,0,5,4462,0,4467,G
4-HA,1197,4177,0,8,1,4186,A
4-HA,1198,0,4147,0,1,4148,T
4-HA,1199,0,4184,1,6,4191,T
4-HA,1200,1,7,4197,0,4205,G
4-HA,1201,4175,0,1,0,4176,A
4-HA,1202,1,4139,1,2,4143,T
4-HA,1203,6,1,0,4178,4185,C
4-HA,1204,4,3,4181,0,4188,G
4-HA,1205,2,5,4156,0,4163,G
4-HA,1206,2,5,4183,0,4190,G
4-HA,1207,4167,0,0,0,4167,A
4-HA,1208,4170,0,0,0,4170,A
4-HA,1209,4164,0,10,0,4174,A
4-HA,1210,4133,0,11,0,4144,A
4-HA,1211,3,1,0,4163,4167,C
4-HA,1212,7,6,1,4158,4172,C
4-HA,1213,4172,0,0,0,4172,A
4-HA,1214,4158,0,2,0,4160,A
4-HA,1215,3,0,0,4164,4167,C
4-HA,1216,0,2,4195,0,4197,G
4-HA,1217,4179,1,1,0,4181,A
4-HA,1218,1,5,4179,0,4185,G
4-HA,1219,4190,0,1,1,4192,A
4-HA,1220,4185,0,1,0,4186,A
4-HA,1221,4185,0,2,1,4188,A
4-HA,1222,0,4147,0,2,4149,T
4-HA,1223,1,4095,0,7,4103,T
4-HA,1224,9,1,0,4158,4168,C
4-HA,1225,14,2,1,4164,4181,C
4-HA,1226,4185,1,1,1,4188,A
4-HA,1227,0,4137,2,1,4140,T
4-HA,1228,4,2,0,4172,4178,C
4-HA,1229,4175,1,0,1,4177,A
4-HA,1230,0,1,4204,0,4205,G
4-HA,1231,4156,0,0,1,4157,A
4-HA,1232,0,4164,1,1,4166,T
4-HA,1233,0,4171,0,0,4171,T
4-HA,1234,1,3,4192,0,4196,G
4-HA,1235,4190,0,3,1,4194,A
4-HA,1236,4206,0,0,0,4206,A
4-HA,1237,4214,0,2,0,4216,A
4-HA,1238,4205,0,0,2,4207,A
4-HA,1239,4177,0,4,1,4182,A
4-HA,1240,1,2,4160,0,4163,G
4-HA,1241,4158,0,2,0,4160,A
4-HA,1242,4167,0,2,1,4170,A
4-HA,1243,0,4082,0,2,4084,T
4-HA,1244,0,4102,0,1,4103,T
4-HA,1245,3,0,0,4117,4120,C
4-HA,1246,0,4125,0,3,4128,T
4-HA,1247,3,0,1,4123,4127,C
4-HA,1248,4123,0,2,0,4125,A
4-HA,1249,0,2,4138,0,4140,G
4-HA,1250,4114,0,1,1,4116,A
4-HA,1251,4102,0,0,1,4103,A
4-HA,1252,1,0,4119,0,4120,G
4-HA,1253,1,3979,0,2,3982,T
4-HA,1254,12,0,1,4085,4098,C
4-HA,1255,0,4,4108,2,4114,G
4-HA,1256,4076,0,4,0,4080,A
4-HA,1257,4080,0,8,0,4088,A
4-HA,1258,1,2,4105,0,4108,G
4-HA,1259,1,4,4110,0,4115,G
4-HA,1260,0,7,4128,0,4135,G
4-HA,1261,4041,0,6,1,4048,A
4-HA,1262,0,9,4068,0,4077,G
4-HA,1263,4070,0,3,0,4073,A
4-HA,1264,4222,0,1,0,4223,A
4-HA,1265,0,4220,0,0,4220,T
4-HA,1266,0,4196,0,0,4196,T
4-HA,1267,6,1,0,4215,4222,C
4-HA,1268,4120,0,16,1,4137,A
4-HA,1269,2,2,4155,0,4159,G
4-HA,1270,12,7,4105,0,4124,G
4-HA,1271,4084,0,6,0,4090,A
4-HA,1272,2,1,0,4099,4102,C
4-HA,1273,7,0,0,3901,3908,C
4-HA,1274,2,3870,0,4,3876,T
4-HA,1275,1,3817,1,90,3909,T
4-HA,1276,0,5,3957,0,3962,G
4-HA,1277,3953,0,4,0,3957,A
4-HA,1278,1,2,4014,0,4017,G
4-HA,1279,4002,0,3,0,4005,A
4-HA,1280,3732,1,28,1,3762,A
4-HA,1281,3724,1,6,2,3733,A
4-HA,1282,0,3696,0,0,3696,T
4-HA,1283,3743,0,14,0,3757,A
4-HA,1284,0,3723,0,1,3724,T
4-HA,1285,0,0,3760,0,3760,G
4-HA,1286,0,3739,0,3,3742,T
4-HA,1287,0,3672,0,1,3673,T
4-HA,1288,0,1,3652,0,3653,G
4-HA,1289,3626,0,2,0,3628,A
4-HA,1290,1,4,3653,0,3658,G
4-HA,1291,0,8,3642,0,3650,G
4-HA,1292,3590,1,5,0,3596,A
4-HA,1293,0,2,0,3688,3690,C
4-HA,1294,3634,0,2,0,3636,A
4-HA,1295,1,1,0,3836,3838,C
4-HA,1296,3,2,0,3869,3874,C
4-HA,1297,3872,0,1,13,3886,A
4-HA,1298,3966,0,0,0,3966,A
4-HA,1299,3771,0,2,177,3950,A
4-HA,1300,3978,0,2,0,3980,A
4-HA,1301,0,3948,0,12,3960,T
4-HA,1302,3875,0,2,0,3877,A
4-HA,1303,1,3,3891,0,3895,G
4-HA,1304,3731,0,1,0,3732,A
4-HA,1305,0,3715,0,3,3718,T
4-HA,1306,4,0,0,3721,3725,C
4-HA,1307,0,3649,0,2,3651,T
4-HA,1308,3,0,1,3724,3728,C
4-HA,1309,1,3718,0,3,3722,T
4-HA,1310,0,2,3771,0,3773,G
4-HA,1311,1,0,3833,0,3834,G
4-HA,1312,0,3830,0,5,3835,T
4-HA,1313,8,3,0,3841,3852,C
4-HA,1314,3853,0,1,0,3854,A
4-HA,1315,0,3861,1,6,3868,T
4-HA,1316,3859,1,0,1,3861,A
4-HA,1317,0,1,0,3859,3860,C
4-HA,1318,3777,0,0,1,3778,A
4-HA,1319,3800,0,3,0,3803,A
4-HA,1320,0,3,0,3739,3742,C
4-HA,1321,2,3,3695,0,3700,G
4-HA,1322,0,0,0,3714,3714,C
4-HA,1323,0,4,3680,0,3684,G
4-HA,1324,2,4,3683,0,3689,G
4-HA,1325,3689,0,2,0,3691,A
4-HA,1326,0,1,3732,0,3733,G
4-HA,1327,0,0,0,3724,3724,C
4-HA,1328,0,3692,0,11,3703,T
4-HA,1329,0,3709,1,16,3726,T
4-HA,1330,5,0,0,3737,3742,C
4-HA,1331,5,3759,0,2,3766,T
4-HA,1332,0,3761,0,2,3763,T
4-HA,1333,1,1,3758,0,3760,G
4-HA,1334,1,3700,2,6,3709,T
4-HA,1335,0,3680,0,3,3683,T
4-HA,1336,1,1,3706,0,3708,G
4-HA,1337,3,2,0,3688,3693,C
4-HA,1338,7,0,0,3666,3673,C
4-HA,1339,1,1,0,3692,3694,C
4-HA,1340,0,3718,0,4,3722,T
4-HA,1341,0,1,3759,1,3761,G
4-HA,1342,1,5,3737,0,3743,G
4-HA,1343,3746,1,0,0,3747,A
4-HA,1344,0,4,3769,0,3773,G
4-HA,1345,3752,0,2,1,3755,A
4-HA,1346,3759,0,4,0,3763,A
4-HA,1347,3,21,0,3741,3765,C
4-HA,1348,4,0,0,3773,3777,C
4-HA,1349,3806,0,1,1,3808,A
4-HA,1350,3907,1,4,0,3912,A
4-HA,1351,0,3,0,3927,3930,C
4-HA,1352,3953,0,1,0,3954,A
4-HA,1353,0,3935,1,2,3938,T
4-HA,1354,3922,0,1,0,3923,A
4-HA,1355,3,1,0,3983,3987,C
4-HA,1356,3941,0,0,0,3941,A
4-HA,1357,3931,0,1,0,3932,A
4-HA,1358,0,3889,0,0,3889,T
4-HA,1359,0,3795,0,1,3796,T
4-HA,1360,0,12,3839,0,3851,G
4-HA,1361,3875,0,0,0,3875,A
4-HA,1362,1,3844,0,8,3853,T
4-HA,1363,6,0,0,3888,3894,C
4-HA,1364,0,3857,1,2,3860,T
4-HA,1365,3870,0,3,0,3873,A
4-HA,1366,3868,0,1,0,3869,A
4-HA,1367,2,0,0,3865,3867,C
4-HA,1368,1,3848,0,2,3851,T
4-HA,1369,2,8,3813,0,3823,G
4-HA,1370,3819,0,4,0,3823,A
4-HA,1371,13,5,0,3796,3814,C
4-HA,1372,0,3773,0,6,3779,T
4-HA,1373,7,0,0,3832,3839,C
4-HA,1374,3830,1,7,2,3840,A
4-HA,1375,2,2,3890,0,3894,G
4-HA,1376,3865,1,6,1,3873,A
4-HA,1377,3879,0,4,0,3883,A
4-HA,1378,3894,1,1,1,3897,A
4-HA,1379,0,3884,0,1,3885,T
4-HA,1380,3,10,3917,0,3930,G
4-HA,1381,3904,0,6,0,3910,A
4-HA,1382,3910,0,10,0,3920,A
4-HA,1383,1,1,0,3931,3933,C
4-HA,1384,3891,0,0,0,3891,A
4-HA,1385,3872,1,2,0,3875,A
4-HA,1386,3855,0,1,0,3856,A
4-HA,1387,1,1,0,3893,3895,C
4-HA,1388,0,3839,0,1,3840,T
4-HA,1389,1,1,3874,0,3876,G
4-HA,1390,1,3814,0,3,3818,T
4-HA,1391,1,3828,0,2,3831,T
4-HA,1392,0,3843,0,0,3843,T
4-HA,1393,0,4,3841,0,3845,G
4-HA,1394,3853,0,0,0,3853,A
4-HA,1395,3861,0,1,1,3863,A
4-HA,1396,3849,0,0,0,3849,A
4-HA,1397,3830,0,0,0,3830,A
4-HA,1398,3807,0,1,0,3808,A
4-HA,1399,3830,0,0,1,3831,A
4-HA,1400,1,1,0,3842,3844,C
4-HA,1401,3844,0,1,0,3845,A
4-HA,1402,3846,0,0,0,3846,A
4-HA,1403,3832,0,6,0,3838,A
4-HA,1404,1,2,3831,0,3834,G
4-HA,1405,3846,0,0,0,3846,A
4-HA,1406,3830,0,4,1,3835,A
4-HA,1407,1,2,3822,1,3826,G
4-HA,1408,0,0,0,3811,3811,C
4-HA,1409,3842,0,3,0,3845,A
4-HA,1410,3833,1,1,0,3835,A
4-HA,1411,0,0,0,3816,3816,C
4-HA,1412,1,3774,0,0,3775,T
4-HA,1413,0,3,3854,0,3857,G
4-HA,1414,3814,1,0,0,3815,A
4-HA,1415,2,3,3830,0,3835,G
4-HA,1416,2,7,3825,0,3834,G
4-HA,1417,4,11,3842,0,3857,G
4-HA,1418,3863,1,4,0,3868,A
4-HA,1419,3854,0,1,0,3855,A
4-HA,1420,3837,0,1,1,3839,A
4-HA,1421,3866,0,1,0,3867,A
4-HA,1422,1,3846,0,0,3847,T
4-HA,1423,0,1,3850,0,3851,G
4-HA,1424,1,1,1,3830,3833,C
4-HA,1425,0,3839,0,3,3842,T
4-HA,1426,0,4,3851,0,3855,G
4-HA,1427,3851,0,2,0,3853,A
4-HA,1428,1,3,3970,0,3974,G
4-HA,1429,1,3,4019,0,4023,G
4-HA,1430,3993,0,4,0,3997,A
4-HA,1431,0,3963,0,8,3971,T
4-HA,1432,3950,1,3,0,3954,A
4-HA,1433,2,3928,0,3,3933,T
4-HA,1434,2,5,3946,0,3953,G
4-HA,1435,0,4,3994,0,3998,G
4-HA,1436,0,1,3971,0,3972,G
4-HA,1437,0,2,0,3829,3831,C
4-HA,1438,3788,0,0,0,3788,A
4-HA,1439,3791,0,0,0,3791,A
4-HA,1440,0,3779,0,0,3779,T
4-HA,1441,0,9,3778,0,3787,G
4-HA,1442,1,1,3780,0,3782,G
4-HA,1443,1,3654,1,2,3658,T
4-HA,1444,0,3635,0,1,3636,T
4-HA,1445,2,0,3648,0,3650,G
4-HA,1446,2,3627,0,6,3635,T
4-HA,1447,0,3645,0,3,3648,T
4-HA,1448,0,3652,0,3,3655,T
4-HA,1449,10,1,0,3655,3666,C
4-HA,1450,3682,0,1,0,3683,A
4-HA,1451,3684,2,0,0,3686,A
4-HA,1452,3685,0,2,0,3687,A
4-HA,1453,3716,0,1,0,3717,A
4-HA,1454,0,3690,0,0,3690,T
4-HA,1455,3665,0,1,0,3666,A
4-HA,1456,0,3663,0,1,3664,T
4-HA,1457,3644,0,1,0,3645,A
4-HA,1458,3,1,0,3652,3656,C
4-HA,1459,2,3,0,3649,3654,C
4-HA,1460,3651,1,4,0,3656,A
4-HA,1461,0,0,0,3670,3670,C
4-HA,1462,3646,0,0,0,3646,A
4-HA,1463,3658,0,1,0,3659,A
4-HA,1464,3646,0,0,1,3647,A
4-HA,1465,0,3644,0,1,3645,T
4-HA,1466,1,2,3661,0,3664,G
4-HA,1467,0,3608,0,5,3613,T
4-HA,1468,5,15,3622,0,3642,G
4-HA,1469,3642,0,9,0,3651,A
4-HA,1470,1,0,0,3640,3641,C
4-HA,1471,3614,0,0,0,3614,A
4-HA,1472,3601,0,1,0,3602,A
4-HA,1473,0,3593,1,0,3594,T
4-HA,1474,0,2,3610,0,3612,G
4-HA,1475,0,3,0,3534,3537,C
4-HA,1476,3,1,0,3588,3592,C
4-HA,1477,0,3579,0,3,3582,T
4-HA,1478,3,2,3668,0,3673,G
4-HA,1479,0,0,0,3674,3674,C
4-HA,1480,3687,0,2,0,3689,A
4-HA,1481,0,3683,1,0,3684,T
4-HA,1482,3573,2,1,0,3576,A
4-HA,1483,0,0,3580,1,3581,G
4-HA,1484,0,6,3559,0,3565,G
4-HA,1485,3559,1,1,0,3561,A
4-HA,1486,0,3504,1,0,3505,T
4-HA,1487,7,0,0,3382,3389,C
4-HA,1488,3410,0,1,0,3411,A
4-HA,1489,3409,0,2,0,3411,A
4-HA,1490,0,3383,0,4,3387,T
4-HA,1491,7,1,0,3394,3402,C
4-HA,1492,3354,0,2,0,3356,A
4-HA,1493,1,5,3365,0,3371,G
4-HA,1494,3382,0,1,0,3383,A
4-HA,1495,3379,0,2,0,3381,A
4-HA,1496,3366,0,0,0,3366,A
4-HA,1497,1,3339,1,1,3342,T
4-HA,1498,2,1,3329,1,3333,G
4-HA,1499,0,12,3325,0,3337,G
4-HA,1500,3331,1,1,0,3333,A
4-HA,1501,3331,2,2,0,3335,A
4-HA,1502,2,2,0,3331,3335,C
4-HA,1503,0,3293,1,1,3295,T
4-HA,1504,0,3329,1,0,3330,T
4-HA,1505,3332,0,2,0,3334,A
4-HA,1506,1,3312,1,1,3315,T
4-HA,1507,0,24,3300,0,3324,G
4-HA,1508,3279,0,4,0,3283,A
4-HA,1509,1,1,0,3278,3280,C
4-HA,1510,5,2,0,3241,3248,C
4-HA,1511,3246,2,2,0,3250,A
4-HA,1512,0,5,0,3283,3288,C
4-HA,1513,1,2,3346,0,3349,G
4-HA,1514,3394,0,0,0,3394,A
4-HA,1515,0,3403,0,0,3403,T
4-HA,1516,2,0,3504,0,3506,G
4-HA,1517,0,3463,1,4,3468,T
4-HA,1518,3577,0,1,0,3578,A
4-HA,1519,1,3551,0,0,3552,T
4-HA,1520,3554,0,2,0,3556,A
4-HA,1521,1,1,0,3557,3559,C
4-HA,1522,3229,0,2,0,3231,A
4-HA,1523,0,3,3230,0,3233,G
4-HA,1524,3001,0,2,0,3003,A
4-HA,1525,0,1,2913,0,2914,G
4-HA,1526,2888,0,1,0,2889,A
4-HA,1527,0,2655,1,0,2656,T
4-HA,1528,0,7,2646,0,2653,G
4-HA,1529,2647,0,1,0,2648,A
4-HA,1530,2634,0,5,0,2639,A
4-HA,1531,1,0,2679,0,2680,G
4-HA,1532,0,0,0,2610,2610,C
4-HA,1533,2608,0,0,0,2608,A
4-HA,1534,1,2584,1,2,2588,T
4-HA,1535,0,2587,1,1,2589,T
4-HA,1536,2601,0,0,0,2601,A
4-HA,1537,2593,0,1,0,2594,A
4-HA,1538,2590,0,1,0,2591,A
4-HA,1539,1,1,0,2592,2594,C
4-HA,1540,2509,0,1,0,2510,A
4-HA,1541,2513,0,0,0,2513,A
4-HA,1542,2,0,0,2498,2500,C
4-HA,1543,3,1,0,2486,2490,C
4-HA,1544,0,1,2492,0,2493,G
4-HA,1545,1,0,2506,0,2507,G
4-HA,1546,0,2509,1,3,2513,T
4-HA,1547,0,2488,0,1,2489,T
4-HA,1548,3,1,0,2493,2497,C
4-HA,1549,3,3,1,2490,2497,C
4-HA,1550,2493,0,2,0,2495,A
4-HA,1551,0,4,2495,0,2499,G
4-HA,1552,2502,0,1,0,2503,A
4-HA,1553,0,2483,0,1,2484,T
4-HA,1554,2,2,0,2402,2406,C
4-HA,1555,2396,0,0,0,2396,A
4-HA,1556,2374,1,2,0,2377,A
4-HA,1557,0,4,2391,0,2395,G
4-HA,1558,2,3,2369,0,2374,G
4-HA,1559,0,3,2369,0,2372,G
4-HA,1560,2308,0,5,0,2313,A
4-HA,1561,0,0,2324,0,2324,G
4-HA,1562,0,2335,0,3,2338,T
4-HA,1563,0,2331,1,0,2332,T
4-HA,1564,0,3,2345,0,2348,G
4-HA,1565,2318,0,0,0,2318,A
4-HA,1566,0,0,2318,0,2318,G
4-HA,1567,0,0,0,2307,2307,C
4-HA,1568,0,2296,1,2,2299,T
4-HA,1569,0,0,2301,0,2301,G
4-HA,1570,2298,0,0,0,2298,A
4-HA,1571,2293,0,3,0,2296,A
4-HA,1572,0,0,2299,0,2299,G
4-HA,1573,0,2229,0,1,2230,T
4-HA,1574,4,1,0,2233,2238,C
4-HA,1575,2208,0,2,0,2210,A
4-HA,1576,1,0,2202,0,2203,G
4-HA,1577,0,5,2200,0,2205,G
4-HA,1578,2,1,2128,1,2132,G
4-HA,1579,0,2213,0,0,2213,T
4-HA,1580,2177,2,2,0,2181,A
4-HA,1581,0,0,0,2208,2208,C
4-HA,1582,2199,0,0,0,2199,A
4-HA,1583,2206,0,0,0,2206,A
4-HA,1584,2198,0,1,0,2199,A
4-HA,1585,0,4,2205,0,2209,G
4-HA,1586,2135,0,1,0,2136,A
4-HA,1587,0,2056,1,4,2061,T
4-HA,1588,0,2046,0,1,2047,T
4-HA,1589,0,2,2047,0,2049,G
4-HA,1590,0,0,2032,0,2032,G
4-HA,1591,2002,0,1,0,2003,A
4-HA,1592,0,2012,0,1,2013,T
4-HA,1593,2,0,0,1983,1985,C
4-HA,1594,2,2,0,1963,1967,C
4-HA,1595,0,1973,0,1,1974,T
4-HA,1596,1976,0,0,0,1976,A
4-HA,1597,0,1973,0,4,1977,T
4-HA,1598,0,5,1978,0,1983,G
4-HA,1599,0,5,1974,0,1979,G
4-HA,1600,1903,0,4,0,1907,A
4-HA,1601,0,1913,0,3,1916,T
4-HA,1602,0,1883,0,1,1884,T
4-HA,1603,2,1882,0,0,1884,T
4-HA,1604,4,0,0,1867,1871,C
4-HA,1605,2,0,1,1874,1877,C
4-HA,1606,0,1833,0,2,1835,T
4-HA,1607,0,1833,0,0,1833,T
4-HA,1608,0,1813,0,1,1814,T
4-HA,1609,0,0,1822,0,1822,G
4-HA,1610,0,2,1,1807,1810,C
4-HA,1611,4,1,0,1816,1821,C
4-HA,1612,1800,0,0,0,1800,A
4-HA,1613,0,1774,0,4,1778,T
4-HA,1614,1784,0,0,0,1784,A
4-HA,1615,0,1758,0,3,1761,T
4-HA,1616,4,0,0,1766,1770,C
4-HA,1617,1769,0,1,0,1770,A
4-HA,1618,0,1730,0,0,1730,T
4-HA,1619,0,0,1745,0,1745,G
4-HA,1620,0,1725,1,0,1726,T
4-HA,1621,0,1703,0,1,1704,T
4-HA,1622,0,1703,1,0,1704,T
4-HA,1623,0,1648,0,0,1648,T
4-HA,1624,0,1651,0,1,1652,T
4-HA,1625,0,1648,0,0,1648,T
4-HA,1626,1,0,1639,0,1640,G
4-HA,1627,1,2,0,1599,1602,C
4-HA,1628,0,1570,0,3,1573,T
4-HA,1629,0,1585,0,0,1585,T
4-HA,1630,0,1576,0,2,1578,T
4-HA,1631,0,0,1606,0,1606,G
4-HA,1632,0,1603,0,0,1603,T
4-HA,1633,0,0,1601,1,1602,G
4-HA,1634,0,1600,0,1,1601,T
4-HA,1635,0,1562,0,1,1563,T
4-HA,1636,0,2,1558,0,1560,G
4-HA,1637,0,0,0,1527,1527,C
4-HA,1638,0,1548,0,5,1553,T
4-HA,1639,0,1554,0,0,1554,T
4-HA,1640,0,1468,0,1,1469,T
4-HA,1641,1,1,1484,0,1486,G
4-HA,1642,0,1476,0,0,1476,T
4-HA,1643,0,1463,0,1,1464,T
4-HA,1644,1,1,1468,0,1470,G
4-HA,1645,1,0,1413,0,1414,G
4-HA,1646,0,1,1414,0,1415,G
4-HA,1647,0,1,1408,0,1409,G
4-HA,1648,0,1368,0,7,1375,T
4-HA,1649,0,1364,0,0,1364,T
4-HA,1650,4,0,0,1340,1344,C
4-HA,1651,1325,0,2,0,1327,A
4-HA,1652,0,1300,1,1,1302,T
4-HA,1653,4,0,0,1319,1323,C
4-HA,1654,1307,0,1,0,1308,A
4-HA,1655,0,1270,0,0,1270,T
4-HA,1656,0,0,1267,0,1267,G
4-HA,1657,0,1235,1,2,1238,T
4-HA,1658,1,1,1219,0,1221,G
4-HA,1659,0,0,1180,0,1180,G
4-HA,1660,1,0,1164,0,1165,G
4-HA,1661,1,1,0,1120,1122,C
4-HA,1662,0,0,0,1103,1103,C
4-HA,1663,0,1054,0,1,1055,T
4-HA,1664,1,0,1045,0,1046,G
4-HA,1665,0,0,0,1031,1031,C
4-HA,1666,2,0,0,1044,1046,C
4-HA,1667,1058,0,1,0,1059,A
4-HA,1668,1039,0,0,1,1040,A
4-HA,1669,1045,0,0,0,1045,A
4-HA,1670,1044,0,0,0,1044,A
4-HA,1671,1043,0,1,0,1044,A
4-HA,1672,0,0,1035,0,1035,G
4-HA,1673,1,0,993,0,994,G
4-HA,1674,0,0,1,966,967,C
4-HA,1675,971,0,1,0,972,A
4-HA,1676,973,0,2,0,975,A
4-HA,1677,0,0,0,973,973,C
4-HA,1678,974,0,0,0,974,A
4-HA,1679,0,962,0,0,962,T
4-HA,1680,0,967,0,0,967,T
4-HA,1681,924,3,0,0,927,A
4-HA,1682,0,0,920,0,920,G
4-HA,1683,0,0,919,0,919,G
4-HA,1684,0,874,0,1,875,T
4-HA,1685,0,0,800,0,800,G
4-HA,1686,0,0,0,760,760,C
4-HA,1687,742,0,0,0,742,A
4-HA,1688,740,0,0,0,740,A
4-HA,1689,0,0,0,745,745,C
4-HA,1690,737,0,0,0,737,A
4-HA,1691,0,726,0,0,726,T
4-HA,1692,0,674,0,0,674,T
4-HA,1693,0,672,0,1,673,T
4-HA,1694,0,0,677,0,677,G
4-HA,1695,0,0,0,663,663,C
4-HA,1696,659,0,0,0,659,A
4-HA,1697,0,621,0,1,622,T
4-HA,1698,0,606,0,0,606,T
4-HA,1699,0,599,0,0,599,T
4-HA,1700,0,0,596,0,596,G
4-HA,1701,563,0,0,0,563,A
5-NP,1,344,0,0,0,344,A
5-NP,2,0,344,0,0,344,T
5-NP,3,0,0,343,0,343,G
5-NP,4,0,0,338,0,338,G
5-NP,5,0,0,0,348,348,C
5-NP,6,0,0,349,0,349,G
5-NP,7,0,366,0,0,366,T
5-NP,8,0,0,0,378,378,C
5-NP,9,1,0,0,378,379,C
5-NP,10,0,0,0,378,378,C
5-NP,11,374,0,1,0,375,A
5-NP,12,370,0,1,0,371,A
5-NP,13,0,3,378,0,381,G
5-NP,14,0,0,388,0,388,G
5-NP,15,0,0,0,397,397,C
5-NP,16,398,0,0,0,398,A
5-NP,17,0,0,0,401,401,C
5-NP,18,0,0,0,402,402,C
5-NP,19,404,0,0,0,404,A
5-NP,20,407,0,0,0,407,A
5-NP,21,405,0,0,0,405,A
5-NP,22,0,0,0,416,416,C
5-NP,23,0,0,413,0,413,G
5-NP,24,0,0,448,0,448,G
5-NP,25,0,442,0,0,442,T
5-NP,26,1,0,0,507,508,C
5-NP,27,0,507,0,0,507,T
5-NP,28,0,516,0,0,516,T
5-NP,29,510,0,0,0,510,A
5-NP,30,0,515,0,0,515,T
5-NP,31,0,2,510,0,512,G
5-NP,32,517,0,0,0,517,A
5-NP,33,518,0,1,0,519,A
5-NP,34,0,0,0,518,518,C
5-NP,35,512,0,0,0,512,A
5-NP,36,0,1,550,0,551,G
5-NP,37,538,0,0,0,538,A
5-NP,38,0,554,0,0,554,T
5-NP,39,0,0,550,0,550,G
5-NP,40,0,0,543,0,543,G
5-NP,41,543,0,1,0,544,A
5-NP,42,543,0,0,0,543,A
5-NP,43,554,0,1,0,555,A
5-NP,44,0,0,0,570,570,C
5-NP,45,0,572,1,0,573,T
5-NP,46,1,0,578,0,579,G
5-NP,47,558,0,1,0,559,A
5-NP,48,0,578,0,0,578,T
5-NP,49,0,1,576,0,577,G
5-NP,50,0,0,577,0,577,G
5-NP,51,1,0,573,0,574,G
5-NP,52,0,0,570,0,570,G
5-NP,53,577,0,0,0,577,A
5-NP,54,0,580,0,0,580,T
5-NP,55,0,0,0,586,586,C
5-NP,56,0,0,577,0,577,G
5-NP,57,1,0,0,589,590,C
5-NP,58,0,0,0,590,590,C
5-NP,59,592,0,0,0,592,A
5-NP,60,0,0,598,0,598,G
5-NP,61,592,0,0,0,592,A
5-NP,62,617,0,0,0,617,A
5-NP,63,0,617,0,0,617,T
5-NP,64,0,0,623,0,623,G
5-NP,65,0,0,0,622,622,C
5-NP,66,623,0,0,0,623,A
5-NP,67,634,0,0,0,634,A
5-NP,68,0,0,0,642,642,C
5-NP,69,0,639,0,0,639,T
5-NP,70,0,0,645,0,645,G
5-NP,71,642,0,0,0,642,A
5-NP,72,0,2,692,0,694,G
5-NP,73,693,0,0,0,693,A
5-NP,74,0,699,0,0,699,T
5-NP,75,0,704,0,0,704,T
5-NP,76,695,0,0,0,695,A
5-NP,77,0,1,696,0,697,G
5-NP,78,7,1,689,0,697,G
5-NP,79,0,0,693,0,693,G
5-NP,80,0,0,0,697,697,C
5-NP,81,690,0,0,0,690,A
5-NP,82,1,693,0,0,694,T
5-NP,83,2,0,0,704,706,C
5-NP,84,2,0,0,700,702,C
5-NP,85,0,0,710,0,710,G
5-NP,86,0,701,0,0,701,T
5-NP,87,1,0,0,707,708,C
5-NP,88,0,1,711,0,712,G
5-NP,89,0,0,708,1,709,G
5-NP,90,1,2,711,0,714,G
5-NP,91,703,0,0,0,703,A
5-NP,92,709,0,0,0,709,A
5-NP,93,0,1,723,0,724,G
5-NP,94,709,0,1,0,710,A
5-NP,95,0,726,0,0,726,T
5-NP,96,0,0,737,0,737,G
5-NP,97,723,0,0,0,723,A
5-NP,98,0,737,0,0,737,T
5-NP,99,0,737,0,0,737,T
5-NP,100,0,4,734,0,738,G
5-NP,101,723,0,0,0,723,A
5-NP,102,0,729,0,0,729,T
5-NP,103,0,1,739,0,740,G
5-NP,104,0,0,736,0,736,G
5-NP,105,1,0,727,0,728,G
5-NP,106,766,0,0,0,766,A
5-NP,107,0,766,0,0,766,T
5-NP,108,0,771,0,0,771,T
5-NP,109,0,0,772,0,772,G
5-NP,110,0,0,770,0,770,G
5-NP,111,0,1,775,0,776,G
5-NP,112,772,0,2,0,774,A
5-NP,113,0,1,779,0,780,G
5-NP,114,772,0,0,0,772,A
5-NP,115,0,790,0,0,790,T
5-NP,116,0,798,0,0,798,T
5-NP,117,0,0,0,801,801,C
5-NP,118,0,800,0,0,800,T
5-NP,119,808,0,0,0,808,A
5-NP,120,0,0,0,815,815,C
5-NP,121,831,0,1,0,832,A
5-NP,122,0,838,0,1,839,T
5-NP,123,1,0,0,840,841,C
5-NP,124,0,1,0,843,844,C
5-NP,125,849,0,0,0,849,A
5-NP,126,862,0,0,0,862,A
5-NP,127,860,0,0,0,860,A
5-NP,128,0,865,0,0,865,T
5-NP,129,0,0,861,0,861,G
5-NP,130,0,853,0,0,853,T
5-NP,131,0,0,863,0,863,G
5-NP,132,0,1,0,860,861,C
5-NP,133,862,0,0,0,862,A
5-NP,134,0,0,0,870,870,C
5-NP,135,0,859,0,1,860,T
5-NP,136,0,1,890,0,891,G
5-NP,137,894,0,1,0,895,A
5-NP,138,911,0,1,0,912,A
5-NP,139,0,0,0,933,933,C
5-NP,140,0,928,0,0,928,T
5-NP,141,0,931,0,0,931,T
5-NP,142,923,1,0,0,924,A
5-NP,143,923,0,0,0,923,A
5-NP,144,930,0,1,0,931,A
5-NP,145,1,0,0,933,934,C
5-NP,146,0,917,0,1,918,T
5-NP,147,3,0,0,920,923,C
5-NP,148,921,0,0,0,921,A
5-NP,149,0,0,937,0,937,G
5-NP,150,0,931,0,2,933,T
5-NP,151,1,2,937,0,940,G
5-NP,152,946,0,0,0,946,A
5-NP,153,0,945,0,0,945,T
5-NP,154,3,0,0,953,956,C
5-NP,155,956,0,1,0,957,A
5-NP,156,0,954,0,1,955,T
5-NP,157,0,0,954,0,954,G
5-NP,158,950,0,1,0,951,A
5-NP,159,940,0,3,0,943,A
5-NP,160,0,0,951,0,951,G
5-NP,161,0,0,938,0,938,G
5-NP,162,0,0,936,0,936,G
5-NP,163,0,1,0,935,936,C
5-NP,164,0,0,948,0,948,G
5-NP,165,0,0,948,0,948,G
5-NP,166,1,942,0,0,943,T
5-NP,167,0,944,0,0,944,T
5-NP,168,0,0,943,0,943,G
5-NP,169,1025,0,1,0,1026,A
5-NP,170,0,1033,0,0,1033,T
5-NP,171,0,0,0,1034,1034,C
5-NP,172,0,1,0,1028,1029,C
5-NP,173,1028,0,0,0,1028,A
5-NP,174,0,1,1029,0,1030,G
5-NP,175,1029,0,0,0,1029,A
5-NP,176,1036,0,0,0,1036,A
5-NP,177,0,1,0,1052,1053,C
5-NP,178,1006,0,0,0,1006,A
5-NP,179,2,0,1019,1,1022,G
5-NP,180,0,0,0,1019,1019,C
5-NP,181,0,1022,0,0,1022,T
5-NP,182,1,1034,0,0,1035,T
5-NP,183,0,1,1032,0,1033,G
5-NP,184,1034,0,1,0,1035,A
5-NP,185,0,0,0,1044,1044,C
5-NP,186,1044,0,0,3,1047,A
5-NP,187,1045,0,0,0,1045,A
5-NP,188,0,1043,0,0,1043,T
5-NP,189,1043,0,0,0,1043,A
5-NP,190,0,1,1056,0,1057,G
5-NP,191,1047,0,1,0,1048,A
5-NP,192,0,0,1051,0,1051,G
5-NP,193,1046,0,0,0,1046,A
5-NP,194,1050,0,0,0,1050,A
5-NP,195,1056,0,0,0,1056,A
5-NP,196,1063,0,0,0,1063,A
5-NP,197,0,1073,0,0,1073,T
5-NP,198,0,1,1071,0,1072,G
5-NP,199,0,0,1071,0,1071,G
5-NP,200,0,1055,0,0,1055,T
5-NP,201,1052,0,0,0,1052,A
5-NP,202,0,0,0,1057,1057,C
5-NP,203,0,1059,0,0,1059,T
5-NP,204,0,0,0,1074,1074,C
5-NP,205,0,1055,0,1,1056,T
5-NP,206,1,0,0,1064,1065,C
5-NP,207,0,1068,0,0,1068,T
5-NP,208,0,1,1071,0,1072,G
5-NP,209,0,0,0,1076,1076,C
5-NP,210,0,1067,0,0,1067,T
5-NP,211,0,1071,1,0,1072,T
5-NP,212,0,1075,0,0,1075,T
5-NP,213,0,1062,0,4,1066,T
5-NP,214,0,1,1070,0,1071,G
5-NP,215,1054,0,0,1,1055,A
5-NP,216,0,1063,0,1,1064,T
5-NP,217,0,4,1061,0,1065,G
5-NP,218,1063,0,1,0,1064,A
5-NP,219,1062,0,1,0,1063,A
5-NP,220,1066,0,0,0,1066,A
5-NP,221,0,0,1064,0,1064,G
5-NP,222,1060,0,0,0,1060,A
5-NP,223,1058,0,0,0,1058,A
5-NP,224,0,1,1071,0,1072,G
5-NP,225,0,2,1104,0,1106,G
5-NP,226,1103,0,0,0,1103,A
5-NP,227,1114,0,0,0,1114,A
5-NP,228,0,1107,0,0,1107,T
5-NP,229,1120,0,0,0,1120,A
5-NP,230,1118,0,0,0,1118,A
5-NP,231,1122,0,0,0,1122,A
5-NP,232,0,1116,0,0,1116,T
5-NP,233,1106,1,0,0,1107,A
5-NP,234,2,0,0,1112,1114,C
5-NP,235,2,1,0,1100,1103,C
5-NP,236,0,1101,0,4,1105,T
5-NP,237,0,1,1117,0,1118,G
5-NP,238,0,2,1125,0,1127,G
5-NP,239,1130,0,0,0,1130,A
5-NP,240,1129,0,0,0,1129,A
5-NP,241,0,2,1132,0,1134,G
5-NP,242,1123,1,1,0,1125,A
5-NP,243,1121,0,2,0,1123,A
5-NP,244,0,1,0,1118,1119,C
5-NP,245,1107,0,1,0,1108,A
5-NP,246,0,0,0,1149,1149,C
5-NP,247,1,0,0,1132,1133,C
5-NP,248,1,0,0,1137,1138,C
5-NP,249,1,1,0,1142,1144,C
5-NP,250,1140,0,1,0,1141,A
5-NP,251,1,0,1138,0,1139,G
5-NP,252,0,0,0,1132,1132,C
5-NP,253,1107,0,1,0,1108,A
5-NP,254,0,0,0,1119,1119,C
5-NP,255,0,0,1125,0,1125,G
5-NP,256,0,1,1128,0,1129,G
5-NP,257,0,2,1132,0,1134,G
5-NP,258,0,1,1131,0,1132,G
5-NP,259,1130,0,1,0,1131,A
5-NP,260,1136,0,0,0,1136,A
5-NP,261,1144,0,1,0,1145,A
5-NP,262,0,2,1137,0,1139,G
5-NP,263,1134,0,0,0,1134,A
5-NP,264,0,1110,0,0,1110,T
5-NP,265,2,0,0,1110,1112,C
5-NP,266,3,0,0,1109,1112,C
5-NP,267,1,0,0,1131,1132,C
5-NP,268,1136,0,0,0,1136,A
5-NP,269,1137,0,2,0,1139,A
5-NP,270,0,0,1148,0,1148,G
5-NP,271,1140,0,0,0,1140,A
5-NP,272,1143,0,0,0,1143,A
5-NP,273,1143,0,0,0,1143,A
5-NP,274,1144,0,0,0,1144,A
5-NP,275,0,0,0,1141,1141,C
5-NP,276,0,1131,0,2,1133,T
5-NP,277,0,1,1137,0,1138,G
5-NP,278,0,2,1133,0,1135,G
5-NP,279,0,0,1130,0,1130,G
5-NP,280,0,3,1127,0,1130,G
5-NP,281,0,2,1125,0,1127,G
5-NP,282,0,0,1137,0,1137,G
5-NP,283,2,0,0,1181,1183,C
5-NP,284,1,0,0,1190,1191,C
5-NP,285,0,0,0,1206,1206,C
5-NP,286,1364,0,0,0,1364,A
5-NP,287,0,1358,0,1,1359,T
5-NP,288,1408,0,0,0,1408,A
5-NP,289,0,1412,0,1,1413,T
5-NP,290,1400,0,0,0,1400,A
5-NP,291,0,0,0,1399,1399,C
5-NP,292,1328,0,0,0,1328,A
5-NP,293,0,1,1343,0,1344,G
5-NP,294,0,3,1333,0,1336,G
5-NP,295,1211,0,1,0,1212,A
5-NP,296,0,1,1226,0,1227,G
5-NP,297,1176,0,0,0,1176,A
5-NP,298,1,0,1207,0,1208,G
5-NP,299,0,1189,0,0,1189,T
5-NP,300,1200,0,0,0,1200,A
5-NP,301,1,0,1201,0,1202,G
5-NP,302,1184,0,2,0,1186,A
5-NP,303,0,1175,0,1,1176,T
5-NP,304,0,1,1182,0,1183,G
5-NP,305,1,0,1185,0,1186,G
5-NP,306,1180,0,0,0,1180,A
5-NP,307,1175,0,0,0,1175,A
5-NP,308,1175,0,0,0,1175,A
5-NP,309,1172,0,0,0,1172,A
5-NP,310,0,1170,0,0,1170,T
5-NP,311,1,1,1179,0,1181,G
5-NP,312,1,0,1179,0,1180,G
5-NP,313,1182,0,2,0,1184,A
5-NP,314,0,1167,0,0,1167,T
5-NP,315,1,0,1175,0,1176,G
5-NP,316,1171,0,0,0,1171,A
5-NP,317,0,1,1180,0,1181,G
5-NP,318,0,0,1164,0,1164,G
5-NP,319,0,2,1160,0,1162,G
5-NP,320,1175,0,0,0,1175,A
5-NP,321,1170,0,0,0,1170,A
5-NP,322,0,0,0,1201,1201,C
5-NP,323,0,1181,0,1,1182,T
5-NP,324,0,0,0,1202,1202,C
5-NP,325,1,0,1216,0,1217,G
5-NP,326,0,1215,0,3,1218,T
5-NP,327,0,1,0,1236,1237,C
5-NP,328,0,0,0,1331,1331,C
5-NP,329,0,1345,0,0,1345,T
5-NP,330,0,1355,0,1,1356,T
5-NP,331,0,1360,0,1,1361,T
5-NP,332,1365,0,0,0,1365,A
5-NP,333,0,1363,0,0,1363,T
5-NP,334,0,2,1361,0,1363,G
5-NP,335,1371,0,2,1,1374,A
5-NP,336,0,0,0,1373,1373,C
5-NP,337,1357,0,1,0,1358,A
5-NP,338,1361,0,0,0,1361,A
5-NP,339,1364,0,0,0,1364,A
5-NP,340,0,1,1418,0,1419,G
5-NP,341,1401,0,1,0,1402,A
5-NP,342,1412,0,0,0,1412,A
5-NP,343,0,1,1469,0,1470,G
5-NP,344,1475,0,1,0,1476,A
5-NP,345,1482,0,1,0,1483,A
5-NP,346,1475,6,0,0,1481,A
5-NP,347,0,1480,0,0,1480,T
5-NP,348,1481,0,1,0,1482,A
5-NP,349,1470,0,1,0,1471,A
5-NP,350,0,2,1493,0,1495,G
5-NP,351,1,0,1473,0,1474,G
5-NP,352,0,0,0,1472,1472,C
5-NP,353,0,0,1482,0,1482,G
5-NP,354,1480,0,0,0,1480,A
5-NP,355,1498,0,0,0,1498,A
5-NP,356,0,1503,0,0,1503,T
5-NP,357,3,0,0,1502,1505,C
5-NP,358,0,1504,0,0,1504,T
5-NP,359,0,1,1505,0,1506,G
5-NP,360,0,0,1501,0,1501,G
5-NP,361,0,0,0,1503,1503,C
5-NP,362,0,1,1500,0,1501,G
5-NP,363,0,0,0,1498,1498,C
5-NP,364,2,0,0,1494,1496,C
5-NP,365,1512,0,2,0,1514,A
5-NP,366,1520,2,1,0,1523,A
5-NP,367,0,0,1561,0,1561,G
5-NP,368,2,0,0,1559,1561,C
5-NP,369,1,1,0,1588,1590,C
5-NP,370,1596,0,1,0,1597,A
5-NP,371,1614,1,0,0,1615,A
5-NP,372,0,0,0,1639,1639,C
5-NP,373,1637,0,1,0,1638,A
5-NP,374,1662,0,1,0,1663,A
5-NP,375,0,1661,0,0,1661,T
5-NP,376,0,1,1691,0,1692,G
5-NP,377,1,1,1698,0,1700,G
5-NP,378,0,1676,0,1,1677,T
5-NP,379,0,2,1693,0,1695,G
5-NP,380,1684,0,1,1,1686,A
5-NP,381,1,2,1713,0,1716,G
5-NP,382,0,3,1712,0,1715,G
5-NP,383,1742,0,0,0,1742,A
5-NP,384,0,1859,0,0,1859,T
5-NP,385,0,2,1874,0,1876,G
5-NP,386,0,0,1,1878,1879,C
5-NP,387,0,1881,0,1,1882,T
5-NP,388,1905,1,0,0,1906,A
5-NP,389,0,0,0,1942,1942,C
5-NP,390,1940,0,0,0,1940,A
5-NP,391,0,1940,0,0,1940,T
5-NP,392,1,0,0,1932,1933,C
5-NP,393,0,1859,0,1,1860,T
5-NP,394,0,1,1942,0,1943,G
5-NP,395,0,1,1982,0,1983,G
5-NP,396,1,1970,0,2,1973,T
5-NP,397,3,0,0,1983,1986,C
5-NP,398,0,1984,0,0,1984,T
5-NP,399,2011,0,0,0,2011,A
5-NP,400,2006,1,1,0,2008,A
5-NP,401,1,0,0,2015,2016,C
5-NP,402,0,2012,0,1,2013,T
5-NP,403,4,0,0,2047,2051,C
5-NP,404,2035,0,0,1,2036,A
5-NP,405,0,1,0,2121,2122,C
5-NP,406,2128,0,0,0,2128,A
5-NP,407,0,2133,1,2,2136,T
5-NP,408,2119,0,0,1,2120,A
5-NP,409,2118,0,1,1,2120,A
5-NP,410,0,2130,0,0,2130,T
5-NP,411,0,1,2167,1,2169,G
5-NP,412,2158,0,0,0,2158,A
5-NP,413,0,2152,0,1,2153,T
5-NP,414,0,2124,0,0,2124,T
5-NP,415,1,2129,0,0,2130,T
5-NP,416,0,3,2109,0,2112,G
5-NP,417,1,1,2097,0,2099,G
5-NP,418,0,0,0,2114,2114,C
5-NP,419,2112,0,0,0,2112,A
5-NP,420,2,2115,0,1,2118,T
5-NP,421,0,2103,0,2,2105,T
5-NP,422,4,0,0,2105,2109,C
5-NP,423,0,0,0,2120,2120,C
5-NP,424,2149,0,0,0,2149,A
5-NP,425,2153,0,0,0,2153,A
5-NP,426,0,2156,0,0,2156,T
5-NP,427,0,2149,0,0,2149,T
5-NP,428,0,2155,0,0,2155,T
5-NP,429,0,3,2177,0,2180,G
5-NP,430,2167,0,2,0,2169,A
5-NP,431,2174,0,0,0,2174,A
5-NP,432,0,2191,0,1,2192,T
5-NP,433,0,1,2177,0,2178,G
5-NP,434,2237,0,2,0,2239,A
5-NP,435,0,2244,0,0,2244,T
5-NP,436,1,1,2256,0,2258,G
5-NP,437,1,1,0,2311,2313,C
5-NP,438,2297,0,6,0,2303,A
5-NP,439,2404,0,2,0,2406,A
5-NP,440,0,0,0,2413,2413,C
5-NP,441,2455,0,0,0,2455,A
5-NP,442,0,2488,0,0,2488,T
5-NP,443,2422,0,0,0,2422,A
5-NP,444,2,0,0,2458,2460,C
5-NP,445,4,1,0,2475,2480,C
5-NP,446,2429,0,1,0,2430,A
5-NP,447,2,2,2453,0,2457,G
5-NP,448,2414,0,0,0,2414,A
5-NP,449,0,6,2455,1,2462,G
5-NP,450,0,5,2453,0,2458,G
5-NP,451,2433,0,1,0,2434,A
5-NP,452,1,0,0,2465,2466,C
5-NP,453,2438,1,0,0,2439,A
5-NP,454,2438,0,1,0,2439,A
5-NP,455,0,3,2439,0,2442,G
5-NP,456,2413,0,2,0,2415,A
5-NP,457,0,1,2429,0,2430,G
5-NP,458,0,0,0,2453,2453,C
5-NP,459,0,2430,1,0,2431,T
5-NP,460,1,0,0,2448,2449,C
5-NP,461,0,2431,0,2,2433,T
5-NP,462,0,2456,1,0,2457,T
5-NP,463,0,0,2474,0,2474,G
5-NP,464,1,2455,0,0,2456,T
5-NP,465,0,2444,0,1,2445,T
5-NP,466,4,1,0,2448,2453,C
5-NP,467,0,4,2452,1,2457,G
5-NP,468,2466,0,1,0,2467,A
5-NP,469,2480,0,2,0,2482,A
5-NP,470,1,0,0,2511,2512,C
5-NP,471,0,2509,0,3,2512,T
5-NP,472,0,2,2548,0,2550,G
5-NP,473,1,2,2548,0,2551,G
5-NP,474,2541,0,0,0,2541,A
5-NP,475,2558,0,1,0,2559,A
5-NP,476,0,2556,0,4,2560,T
5-NP,477,0,0,2569,1,2570,G
5-NP,478,0,2,2574,0,2576,G
5-NP,479,2582,0,0,0,2582,A
5-NP,480,0,2631,0,0,2631,T
5-NP,481,2,1,0,2629,2632,C
5-NP,482,3,0,0,2646,2649,C
5-NP,483,1,0,0,2675,2676,C
5-NP,484,2720,0,1,0,2721,A
5-NP,485,0,6,2767,0,2773,G
5-NP,486,2770,0,1,0,2771,A
5-NP,487,2766,0,0,0,2766,A
5-NP,488,0,2760,1,0,2761,T
5-NP,489,0,1,2812,1,2814,G
5-NP,490,0,2781,0,1,2782,T
5-NP,491,0,2,2825,0,2827,G
5-NP,492,0,1,0,2842,2843,C
5-NP,493,2,2832,0,1,2835,T
5-NP,494,6,0,0,3062,3068,C
5-NP,495,0,3077,0,1,3078,T
5-NP,496,3,0,0,3232,3235,C
5-NP,497,1,3224,0,6,3231,T
5-NP,498,3,5,3225,0,3233,G
5-NP,499,3247,0,0,1,3248,A
5-NP,500,0,3255,0,0,3255,T
5-NP,501,0,1,3258,0,3259,G
5-NP,502,1,1,0,3262,3264,C
5-NP,503,3174,1,4,0,3179,A
5-NP,504,0,3,3266,0,3269,G
5-NP,505,0,5,3190,0,3195,G
5-NP,506,0,0,3236,0,3236,G
5-NP,507,1,0,0,3263,3264,C
5-NP,508,0,3228,0,3,3231,T
5-NP,509,2,0,0,3284,3286,C
5-NP,510,2,7,3282,1,3292,G
5-NP,511,3313,1,2,1,3317,A
5-NP,512,2,1,0,3340,3343,C
5-NP,513,1,3305,0,1,3307,T
5-NP,514,4,0,0,3497,3501,C
5-NP,515,0,3481,0,2,3483,T
5-NP,516,9,0,0,3976,3985,C
5-NP,517,2,1,1,3981,3985,C
5-NP,518,2,1,0,4028,4031,C
5-NP,519,0,4030,0,2,4032,T
5-NP,520,4013,0,0,0,4013,A
5-NP,521,0,2,4018,0,4020,G
5-NP,522,3996,0,0,0,3996,A
5-NP,523,3922,0,0,0,3922,A
5-NP,524,0,5,3927,0,3932,G
5-NP,525,0,5,3876,0,3881,G
5-NP,526,1,3792,1,0,3794,T
5-NP,527,6,0,1,3882,3889,C
5-NP,528,5,0,1,3858,3864,C
5-NP,529,4,6,3880,0,3890,G
5-NP,530,1,5,3885,0,3891,G
5-NP,531,3876,0,2,0,3878,A
5-NP,532,0,1,3956,0,3957,G
5-NP,533,1,1,0,3984,3986,C
5-NP,534,0,3940,0,2,3942,T
5-NP,535,1,0,3958,0,3959,G
5-NP,536,0,0,0,3992,3992,C
5-NP,537,3946,2,6,0,3954,A
5-NP,538,0,5,3976,0,3981,G
5-NP,539,0,1,3985,0,3986,G
5-NP,540,1,3893,0,1,3895,T
5-NP,541,0,1,3954,0,3955,G
5-NP,542,1,2,0,3989,3992,C
5-NP,543,0,3993,0,4,3997,T
5-NP,544,2,2,4021,1,4026,G
5-NP,545,2,1,0,4032,4035,C
5-NP,546,4096,1,2,1,4100,A
5-NP,547,0,0,4192,0,4192,G
5-NP,548,0,4144,0,1,4145,T
5-NP,549,9,0,0,4162,4171,C
5-NP,550,4161,0,0,0,4161,A
5-NP,551,4153,0,1,6,4160,A
5-NP,552,4157,1,8,0,4166,A
5-NP,553,2,3,4208,0,4213,G
5-NP,554,0,4,4198,0,4202,G
5-NP,555,4190,0,2,0,4192,A
5-NP,556,4171,0,7,0,4178,A
5-NP,557,0,4199,0,0,4199,T
5-NP,558,6,2,0,4210,4218,C
5-NP,559,0,7,4216,0,4223,G
5-NP,560,0,2,4302,0,4304,G
5-NP,561,5,7,4313,0,4325,G
5-NP,562,4316,0,1,0,4317,A
5-NP,563,2,1,0,4375,4378,C
5-NP,564,4319,0,1,0,4320,A
5-NP,565,4415,0,1,0,4416,A
5-NP,566,0,4479,0,1,4480,T
5-NP,567,2,2,4523,0,4527,G
5-NP,568,2,2,4581,0,4585,G
5-NP,569,1,4478,0,0,4479,T
5-NP,570,0,3,4609,0,4612,G
5-NP,571,4549,1,3,0,4553,A
5-NP,572,0,4606,0,1,4607,T
5-NP,573,1,2,4622,1,4626,G
5-NP,574,0,8,4657,0,4665,G
5-NP,575,4573,0,3,0,4576,A
5-NP,576,4681,0,0,0,4681,A
5-NP,577,1,0,0,4664,4665,C
5-NP,578,0,4574,0,0,4574,T
5-NP,579,2,6,4815,0,4823,G
5-NP,580,4733,0,0,0,4733,A
5-NP,581,0,4783,0,0,4783,T
5-NP,582,5,0,0,4832,4837,C
5-NP,583,4756,0,0,0,4756,A
5-NP,584,0,6,4905,0,4911,G
5-NP,585,4812,1,6,0,4819,A
5-NP,586,4840,0,1,0,4841,A
5-NP,587,0,4899,0,0,4899,T
5-NP,588,2,6,4836,1,4845,G
5-NP,589,6,2,4887,0,4895,G
5-NP,590,0,4826,0,7,4833,T
5-NP,591,11,0,0,4876,4887,C
5-NP,592,4889,1,0,0,4890,A
5-NP,593,4850,0,0,0,4850,A
5-NP,594,4870,1,5,0,4876,A
5-NP,595,2,3,0,4873,4878,C
5-NP,596,1,2,4887,0,4890,G
5-NP,597,0,11,4850,0,4861,G
5-NP,598,3,5,4827,0,4835,G
5-NP,599,3,9,4847,0,4859,G
5-NP,600,4835,0,2,0,4837,A
5-NP,601,4887,0,2,0,4889,A
5-NP,602,0,4852,0,0,4852,T
5-NP,603,16,1,0,4876,4893,C
5-NP,604,4905,0,4,0,4909,A
5-NP,605,4895,0,2,0,4897,A
5-NP,606,2,2,0,4887,4891,C
5-NP,607,3,16,4844,0,4863,G
5-NP,608,4834,0,0,1,4835,A
5-NP,609,0,4796,0,2,4798,T
5-NP,610,14,1,0,4817,4832,C
5-NP,611,1,11,4864,0,4876,G
5-NP,612,4769,1,0,0,4770,A
5-NP,613,4826,1,0,1,4828,A
5-NP,614,4829,0,0,1,4830,A
5-NP,615,0,4884,0,0,4884,T
5-NP,616,0,4888,0,1,4889,T
5-NP,617,0,4897,0,0,4897,T
5-NP,618,0,4931,0,0,4931,T
5-NP,619,0,4948,0,1,4949,T
5-NP,620,0,5,4951,0,4956,G
5-NP,621,1,9,4945,0,4955,G
5-NP,622,4856,0,4,0,4860,A
5-NP,623,0,6,4948,1,4955,G
5-NP,624,4847,2,1,0,4850,A
5-NP,625,0,1,5122,0,5123,G
5-NP,626,2,3,5154,0,5159,G
5-NP,627,0,4938,1,5,4944,T
5-NP,628,2,14,5138,1,5155,G
5-NP,629,5137,0,3,0,5140,A
5-NP,630,2,4,5188,1,5195,G
5-NP,631,5150,2,4,0,5156,A
5-NP,632,5157,0,1,1,5159,A
5-NP,633,1,5161,0,2,5164,T
5-NP,634,4,5,5041,0,5050,G
5-NP,635,0,3,5016,0,5019,G
5-NP,636,3,0,4968,0,4971,G
5-NP,637,2,4,0,4944,4950,C
5-NP,638,2,5,5038,0,5045,G
5-NP,639,0,4,5097,0,5101,G
5-NP,640,5036,1,4,0,5041,A
5-NP,641,5042,1,0,0,5043,A
5-NP,642,5184,0,0,0,5184,A
5-NP,643,5181,1,4,5,5191,A
5-NP,644,0,0,0,5239,5239,C
5-NP,645,5250,0,0,0,5250,A
5-NP,646,5228,1,3,0,5232,A
5-NP,647,1,4,5242,0,5247,G
5-NP,648,5104,1,0,1,5106,A
5-NP,649,5123,0,0,0,5123,A
5-NP,650,0,0,5252,0,5252,G
5-NP,651,2,5150,0,1,5153,T
5-NP,652,0,2,5508,0,5510,G
5-NP,653,5,0,0,5467,5472,C
5-NP,654,0,5493,1,7,5501,T
5-NP,655,0,5544,1,2,5547,T
5-NP,656,5607,0,0,0,5607,A
5-NP,657,0,5592,1,1,5594,T
5-NP,658,2,5,5622,0,5629,G
5-NP,659,5507,2,7,1,5517,A
5-NP,660,0,8,5528,0,5536,G
5-NP,661,5346,0,0,0,5346,A
5-NP,662,0,7,5378,0,5385,G
5-NP,663,5382,1,2,1,5386,A
5-NP,664,5461,0,0,0,5461,A
5-NP,665,0,5422,0,0,5422,T
5-NP,666,1,2,5480,0,5483,G
5-NP,667,0,5406,0,1,5407,T
5-NP,668,1,1,5469,0,5471,G
5-NP,669,0,3,0,5452,5455,C
5-NP,670,5444,0,3,0,5447,A
5-NP,671,5470,0,5,0,5475,A
5-NP,672,0,0,0,5447,5447,C
5-NP,673,5417,0,1,0,5418,A
5-NP,674,0,5424,0,0,5424,T
5-NP,675,0,5369,0,17,5386,T
5-NP,676,10,0,0,5383,5393,C
5-NP,677,0,5391,0,0,5391,T
5-NP,678,0,5408,0,1,5409,T
5-NP,679,5407,0,1,1,5409,A
5-NP,680,5379,2,7,0,5388,A
5-NP,681,5387,0,1,0,5388,A
5-NP,682,1,2,5403,0,5406,G
5-NP,683,0,12,5363,0,5375,G
5-NP,684,5380,0,2,0,5382,A
5-NP,685,5389,1,0,1,5391,A
5-NP,686,5382,0,0,0,5382,A
5-NP,687,5454,0,0,0,5454,A
5-NP,688,1,5423,0,0,5424,T
5-NP,689,1,5408,1,0,5410,T
5-NP,690,0,5399,0,0,5399,T
5-NP,691,7,2,0,5423,5432,C
5-NP,692,5459,0,1,0,5460,A
5-NP,693,5448,0,1,0,5449,A
5-NP,694,5451,1,1,0,5453,A
5-NP,695,1,2,0,5518,5521,C
5-NP,696,5474,0,0,0,5474,A
5-NP,697,1,0,5556,0,5557,G
5-NP,698,0,0,0,5565,5565,C
5-NP,699,2,5564,0,1,5567,T
5-NP,700,0,1,5674,0,5675,G
5-NP,701,0,2,0,5640,5642,C
5-NP,702,5708,0,1,1,5710,A
5-NP,703,1,3,0,5690,5694,C
5-NP,704,5700,0,0,0,5700,A
5-NP,705,5711,0,5,0,5716,A
5-NP,706,5642,2,0,0,5644,A
5-NP,707,1,14,5788,0,5803,G
5-NP,708,5772,0,13,0,5785,A
5-NP,709,3,0,5827,0,5830,G
5-NP,710,1,4,0,5844,5849,C
5-NP,711,5846,0,2,0,5848,A
5-NP,712,5986,1,4,0,5991,A
5-NP,713,0,5991,1,1,5993,T
5-NP,714,3,8,6035,0,6046,G
5-NP,715,3,1,6035,1,6040,G
5-NP,716,1,5913,0,3,5917,T
5-NP,717,0,6,5966,2,5974,G
5-NP,718,6,11,5967,0,5984,G
5-NP,719,5988,1,3,0,5992,A
5-NP,720,1,5968,0,1,5970,T
5-NP,721,10,0,0,5875,5885,C
5-NP,722,5935,0,0,0,5935,A
5-NP,723,5957,2,1,0,5960,A
5-NP,724,2,1,5990,0,5993,G
5-NP,725,0,5931,0,1,5932,T
5-NP,726,1,16,5937,0,5954,G
5-NP,727,5898,0,7,0,5905,A
5-NP,728,0,11,5882,0,5893,G
5-NP,729,5924,0,5,0,5929,A
5-NP,730,2,13,5871,0,5886,G
5-NP,731,5863,1,2,1,5867,A
5-NP,732,5796,0,2,0,5798,A
5-NP,733,5830,0,5,0,5835,A
5-NP,734,1,3,5815,0,5819,G
5-NP,735,2,5725,0,0,5727,T
5-NP,736,13,4,1,5798,5816,C
5-NP,737,1,3,5804,0,5808,G
5-NP,738,0,8,5772,0,5780,G
5-NP,739,5842,0,0,0,5842,A
5-NP,740,5804,0,1,1,5806,A
5-NP,741,2,3,0,5829,5834,C
5-NP,742,6,1,0,5806,5813,C
5-NP,743,10,3,0,5838,5851,C
5-NP,744,5845,0,1,0,5846,A
5-NP,745,1,2,5865,0,5868,G
5-NP,746,0,8,5855,1,5864,G
5-NP,747,5871,0,0,0,5871,A
5-NP,748,5868,0,2,0,5870,A
5-NP,749,5839,0,0,0,5839,A
5-NP,750,2,0,0,5859,5861,C
5-NP,751,1,4,5836,0,5841,G
5-NP,752,1,0,1,5840,5842,C
5-NP,753,0,5806,0,4,5810,T
5-NP,754,0,10,5828,0,5838,G
5-NP,755,5821,0,2,1,5824,A
5-NP,756,13,7,5874,0,5894,G
5-NP,757,5894,0,2,0,5896,A
5-NP,758,1,5806,0,1,5808,T
5-NP,759,7,2,0,5837,5846,C
5-NP,760,9,9,5871,0,5889,G
5-NP,761,5843,2,0,0,5845,A
5-NP,762,5858,1,1,0,5860,A
5-NP,763,1,4,5865,0,5870,G
5-NP,764,5866,0,1,1,5868,A
5-NP,765,0,5840,0,6,5846,T
5-NP,766,10,2,1,5889,5902,C
5-NP,767,1,5901,0,4,5906,T
5-NP,768,10,2,0,5936,5948,C
5-NP,769,5993,1,0,0,5994,A
5-NP,770,1,5969,0,0,5970,T
5-NP,771,6004,0,1,0,6005,A
5-NP,772,0,5992,0,0,5992,T
5-NP,773,0,5946,0,0,5946,T
5-NP,774,0,5931,0,11,5942,T
5-NP,775,0,5878,1,2,5881,T
5-NP,776,1,5888,1,2,5892,T
5-NP,777,5926,0,1,0,5927,A
5-NP,778,3,0,5882,0,5885,G
5-NP,779,3,0,0,5920,5923,C
5-NP,780,5899,1,4,0,5904,A
5-NP,781,5883,0,1,0,5884,A
5-NP,782,2,10,6007,0,6019,G
5-NP,783,5998,0,2,0,6000,A
5-NP,784,2,5967,0,0,5969,T
5-NP,785,8,0,0,6065,6073,C
5-NP,786,0,5993,0,18,6011,T
5-NP,787,2,1,6189,0,6192,G
5-NP,788,0,0,0,6194,6194,C
5-NP,789,6197,0,2,0,6199,A
5-NP,790,0,6241,1,0,6242,T
5-NP,791,0,6107,0,3,6110,T
5-NP,792,0,7,6424,0,6431,G
5-NP,793,6521,0,1,1,6523,A
5-NP,794,0,6503,0,2,6505,T
5-NP,795,6554,0,0,0,6554,A
5-NP,796,0,6424,0,0,6424,T
5-NP,797,0,6384,0,1,6385,T
5-NP,798,1,11,6429,1,6442,G
5-NP,799,6358,0,1,0,6359,A
5-NP,800,12,5,6404,0,6421,G
5-NP,801,6155,0,4,0,6159,A
5-NP,802,1,2,6129,0,6132,G
5-NP,803,0,7,6182,0,6189,G
5-NP,804,6146,0,3,0,6149,A
5-NP,805,1,6083,0,1,6085,T
5-NP,806,11,2,0,6158,6171,C
5-NP,807,6151,0,2,1,6154,A
5-NP,808,1,1,6189,0,6191,G
5-NP,809,0,6171,1,0,6172,T
5-NP,810,0,6119,0,2,6121,T
5-NP,811,2,0,6125,1,6128,G
5-NP,812,0,0,0,6058,6058,C
5-NP,813,0,6068,0,3,6071,T
5-NP,814,18,0,0,6069,6087,C
5-NP,815,6087,1,0,1,6089,A
5-NP,816,2,2,0,6121,6125,C
5-NP,817,6159,0,0,0,6159,A
5-NP,818,6176,0,1,0,6177,A
5-NP,819,6142,0,2,0,6144,A
5-NP,820,0,6069,0,0,6069,T
5-NP,821,5,3,0,6163,6171,C
5-NP,822,0,6109,2,4,6115,T
5-NP,823,0,6142,1,5,6148,T
5-NP,824,5,1,6151,0,6157,G
5-NP,825,4,1,0,6150,6155,C
5-NP,826,6,1,0,6206,6213,C
5-NP,827,1,6239,0,6,6246,T
5-NP,828,6192,1,0,0,6193,A
5-NP,829,2,1,0,6262,6265,C
5-NP,830,4,1,0,6289,6294,C
5-NP,831,1,6249,0,1,6251,T
5-NP,832,0,1,6339,1,6341,G
5-NP,833,2,3,1,6184,6190,C
5-NP,834,6,0,1,6297,6304,C
5-NP,835,3,6233,0,10,6246,T
5-NP,836,0,0,6487,0,6487,G
5-NP,837,0,6379,0,3,6382,T
5-NP,838,1,6,6534,0,6541,G
5-NP,839,34,2,2,6515,6553,C
5-NP,840,2,3,6702,0,6707,G
5-NP,841,0,6614,0,2,6616,T
5-NP,842,6612,0,0,0,6612,A
5-NP,843,0,6592,0,2,6594,T
5-NP,844,5,16,6596,1,6618,G
5-NP,845,0,14,6711,1,6726,G
5-NP,846,6690,0,6,0,6696,A
5-NP,847,1,0,0,6550,6551,C
5-NP,848,2,1,0,6530,6533,C
5-NP,849,1,6388,0,4,6393,T
5-NP,850,4,3,6634,0,6641,G
5-NP,851,4,10,0,6645,6659,C
5-NP,852,6704,0,6,0,6710,A
5-NP,853,0,1,6794,0,6795,G
5-NP,854,0,6592,1,2,6595,T
5-NP,855,6798,1,0,0,6799,A
5-NP,856,0,6730,1,2,6733,T
5-NP,857,5,0,0,6736,6741,C
5-NP,858,3,0,0,6749,6752,C
5-NP,859,6529,0,3,0,6532,A
5-NP,860,2,2,6563,0,6567,G
5-NP,861,0,6501,0,2,6503,T
5-NP,862,1,6,6577,0,6584,G
5-NP,863,1,7,6518,0,6526,G
5-NP,864,2,1,6460,0,6463,G
5-NP,865,0,6464,0,2,6466,T
5-NP,866,6468,1,0,0,6469,A
5-NP,867,2,1,0,6456,6459,C
5-NP,868,0,7,6412,1,6420,G
5-NP,869,6355,0,0,0,6355,A
5-NP,870,2,1,0,6390,6393,C
5-NP,871,0,6246,0,0,6246,T
5-NP,872,0,6260,0,2,6262,T
5-NP,873,8,4,0,6304,6316,C
5-NP,874,2,15,6301,1,6319,G
5-NP,875,6281,0,4,0,6285,A
5-NP,876,6293,0,0,1,6294,A
5-NP,877,6333,0,0,0,6333,A
5-NP,878,6312,0,0,1,6313,A
5-NP,879,6300,0,2,1,6303,A
5-NP,880,1,2,6324,0,6327,G
5-NP,881,6273,0,12,0,6285,A
5-NP,882,1,5,6329,0,6335,G
5-NP,883,1,12,6359,1,6373,G
5-NP,884,0,4,6401,1,6406,G
5-NP,885,6397,1,2,0,6400,A
5-NP,886,1,6399,0,4,6404,T
5-NP,887,6435,0,5,0,6440,A
5-NP,888,0,6424,0,1,6425,T
5-NP,889,0,6413,0,0,6413,T
5-NP,890,13,2,0,6461,6476,C
5-NP,891,2,0,0,6454,6456,C
5-NP,892,0,6395,0,1,6396,T
5-NP,893,0,6402,1,0,6403,T
5-NP,894,1,7,6468,0,6476,G
5-NP,895,1,2,6489,0,6492,G
5-NP,896,0,6423,0,2,6425,T
5-NP,897,1,3,6430,0,6434,G
5-NP,898,1,4,6400,0,6405,G
5-NP,899,1,10,6596,1,6608,G
5-NP,900,6594,2,5,0,6601,A
5-NP,901,6628,0,1,0,6629,A
5-NP,902,1,6626,1,0,6628,T
5-NP,903,6560,1,3,0,6564,A
5-NP,904,0,3,6533,0,6536,G
5-NP,905,6428,0,17,0,6445,A
5-NP,906,1,5,1,6429,6436,C
5-NP,907,8,0,0,6357,6365,C
5-NP,908,6,0,0,6341,6347,C
5-NP,909,0,6417,0,6,6423,T
5-NP,910,0,6418,0,3,6421,T
5-NP,911,0,6424,0,2,6426,T
5-NP,912,11,1,0,6429,6441,C
5-NP,913,6451,0,1,0,6452,A
5-NP,914,6437,0,1,0,6438,A
5-NP,915,6422,0,3,0,6425,A
5-NP,916,0,0,0,6426,6426,C
5-NP,917,0,6297,0,0,6297,T
5-NP,918,6234,0,1,0,6235,A
5-NP,919,0,0,0,6291,6291,C
5-NP,920,0,6249,1,3,6253,T
5-NP,921,0,6225,0,1,6226,T
5-NP,922,8,0,0,6290,6298,C
5-NP,923,6305,0,0,0,6305,A
5-NP,924,6300,0,0,1,6301,A
5-NP,925,6268,0,1,1,6270,A
5-NP,926,6269,0,0,0,6269,A
5-NP,927,0,6203,0,0,6203,T
5-NP,928,6150,0,2,0,6152,A
5-NP,929,0,0,6181,0,6181,G
5-NP,930,4,2,0,6191,6197,C
5-NP,931,5,1,1,6275,6282,C
5-NP,932,6296,1,1,0,6298,A
5-NP,933,6299,0,1,0,6300,A
5-NP,934,6471,1,0,0,6472,A
5-NP,935,1,6492,0,0,6493,T
5-NP,936,6522,0,0,0,6522,A
5-NP,937,0,6510,1,0,6511,T
5-NP,938,6421,0,2,1,6424,A
5-NP,939,0,1,0,6442,6443,C
5-NP,940,6316,2,4,0,6322,A
5-NP,941,1,0,6421,0,6422,G
5-NP,942,0,0,0,6394,6394,C
5-NP,943,0,6234,0,3,6237,T
5-NP,944,0,6318,0,0,6318,T
5-NP,945,6360,1,1,0,6362,A
5-NP,946,6372,0,0,0,6372,A
5-NP,947,0,6309,0,0,6309,T
5-NP,948,9,49,0,6283,6341,C
5-NP,949,6191,1,0,0,6192,A
5-NP,950,2,7,6224,1,6234,G
5-NP,951,6195,0,0,0,6195,A
5-NP,952,2,1,0,6241,6244,C
5-NP,953,9,1,0,6208,6218,C
5-NP,954,0,6133,0,1,6134,T
5-NP,955,6214,0,1,0,6215,A
5-NP,956,6182,0,1,1,6184,A
5-NP,957,0,1,0,6225,6226,C
5-NP,958,0,9,6207,2,6218,G
5-NP,959,6110,1,0,0,6111,A
5-NP,960,1,2,6118,1,6122,G
5-NP,961,6085,0,2,0,6087,A
5-NP,962,6133,0,0,0,6133,A
5-NP,963,0,6088,0,1,6089,T
5-NP,964,10,0,3,6018,6031,C
5-NP,965,5,1,0,6048,6054,C
5-NP,966,5941,0,5,1,5947,A
5-NP,967,1,2,5958,0,5961,G
5-NP,968,2,1,1,5947,5951,C
5-NP,969,5999,0,5,0,6004,A
5-NP,970,0,1,1,6014,6016,C
5-NP,971,5943,1,0,1,5945,A
5-NP,972,2,0,0,5952,5954,C
5-NP,973,5952,0,2,0,5954,A
5-NP,974,5960,0,3,0,5963,A
5-NP,975,0,3,5935,0,5938,G
5-NP,976,5912,0,3,0,5915,A
5-NP,977,1,0,5911,0,5912,G
5-NP,978,1,5775,1,2,5779,T
5-NP,979,9,0,0,5766,5775,C
5-NP,980,5782,0,5,0,5787,A
5-NP,981,0,0,5763,0,5763,G
5-NP,982,0,2,0,5741,5743,C
5-NP,983,0,5721,0,1,5722,T
5-NP,984,1,4,5750,1,5756,G
5-NP,985,0,0,5776,0,5776,G
5-NP,986,1,5738,0,3,5742,T
5-NP,987,2,0,5783,0,5785,G
5-NP,988,0,5712,0,3,5715,T
5-NP,989,3,4,5701,0,5708,G
5-NP,990,0,4,5688,0,5692,G
5-NP,991,5675,0,2,0,5677,A
5-NP,992,0,5698,0,2,5700,T
5-NP,993,3,4,5493,0,5500,G
5-NP,994,0,4,5448,0,5452,G
5-NP,995,3,7,0,5448,5458,C
5-NP,996,5400,1,2,0,5403,A
5-NP,997,0,5409,2,3,5414,T
5-NP,998,2,0,5376,0,5378,G
5-NP,999,3,2,1,5361,5367,C
5-NP,1000,3,0,0,5395,5398,C
5-NP,1001,5400,0,1,0,5401,A
5-NP,1002,0,5379,0,3,5382,T
5-NP,1003,0,5292,0,9,5301,T
5-NP,1004,13,0,1,5331,5345,C
5-NP,1005,0,5307,0,2,5309,T
5-NP,1006,1,1,5291,0,5293,G
5-NP,1007,1,0,0,5288,5289,C
5-NP,1008,0,5144,1,4,5149,T
5-NP,1009,2,2,5175,0,5179,G
5-NP,1010,2,0,0,5093,5095,C
5-NP,1011,5114,0,1,0,5115,A
5-NP,1012,0,5109,0,2,5111,T
5-NP,1013,0,5092,0,2,5094,T
5-NP,1014,0,5095,1,2,5098,T
5-NP,1015,0,7,5087,0,5094,G
5-NP,1016,5082,0,6,1,5089,A
5-NP,1017,5085,0,2,0,5087,A
5-NP,1018,1,8,5099,0,5108,G
5-NP,1019,5084,2,0,0,5086,A
5-NP,1020,0,5067,0,0,5067,T
5-NP,1021,0,5056,0,0,5056,T
5-NP,1022,1,5071,0,0,5072,T
5-NP,1023,5071,1,1,0,5073,A
5-NP,1024,5070,0,0,0,5070,A
5-NP,1025,0,6,5064,0,5070,G
5-NP,1026,5050,0,0,0,5050,A
5-NP,1027,0,5035,0,1,5036,T
5-NP,1028,0,5008,0,1,5009,T
5-NP,1029,0,2,5045,0,5047,G
5-NP,1030,1,5037,0,4,5042,T
5-NP,1031,1,5036,0,0,5037,T
5-NP,1032,4905,1,151,0,5057,A
5-NP,1033,5039,1,2,1,5043,A
5-NP,1034,0,0,5040,0,5040,G
5-NP,1035,0,1,0,5038,5039,C
5-NP,1036,0,4941,0,10,4951,T
5-NP,1037,0,4921,0,1,4922,T
5-NP,1038,12,1,0,4935,4948,C
5-NP,1039,4942,0,1,0,4943,A
5-NP,1040,2,4886,0,1,4889,T
5-NP,1041,5,1,0,4934,4940,C
5-NP,1042,4892,0,0,0,4892,A
5-NP,1043,0,5,4881,0,4886,G
5-NP,1044,4808,1,4,1,4814,A
5-NP,1045,2,8,4815,0,4825,G
5-NP,1046,0,3,4801,0,4804,G
5-NP,1047,0,6,4779,0,4785,G
5-NP,1048,4785,0,5,0,4790,A
5-NP,1049,1,0,0,4808,4809,C
5-NP,1050,4825,0,1,0,4826,A
5-NP,1051,4834,0,0,0,4834,A
5-NP,1052,4832,0,0,0,4832,A
5-NP,1053,4851,0,3,1,4855,A
5-NP,1054,0,1,4869,0,4870,G
5-NP,1055,1,4760,0,2,4763,T
5-NP,1056,4742,1,1,0,4744,A
5-NP,1057,1,4686,0,2,4689,T
5-NP,1058,6,0,0,4695,4701,C
5-NP,1059,1,4611,0,1,4613,T
5-NP,1060,7,0,0,4656,4663,C
5-NP,1061,4,0,0,4649,4653,C
5-NP,1062,0,4581,0,2,4583,T
5-NP,1063,5,1,0,4648,4654,C
5-NP,1064,1,6,4652,0,4659,G
5-NP,1065,0,3,4675,0,4678,G
5-NP,1066,0,5,4651,0,4656,G
5-NP,1067,2,4,4665,1,4672,G
5-NP,1068,3,3,4667,0,4673,G
5-NP,1069,4611,0,0,2,4613,A
5-NP,1070,4616,0,1,0,4617,A
5-NP,1071,4598,0,0,0,4598,A
5-NP,1072,0,0,0,4631,4631,C
5-NP,1073,1,4621,0,0,4622,T
5-NP,1074,2,1,4648,0,4651,G
5-NP,1075,0,4605,0,3,4608,T
5-NP,1076,7,0,0,4617,4624,C
5-NP,1077,4682,2,3,0,4687,A
5-NP,1078,4699,1,0,0,4700,A
5-NP,1079,2,1,0,4715,4718,C
5-NP,1080,0,4687,0,1,4688,T
5-NP,1081,4666,0,1,0,4667,A
5-NP,1082,0,5,4670,0,4675,G
5-NP,1083,4568,0,0,0,4568,A
5-NP,1084,1,3,4587,0,4591,G
5-NP,1085,0,6,4592,0,4598,G
5-NP,1086,4443,0,3,0,4446,A
5-NP,1087,0,1,4546,0,4547,G
5-NP,1088,0,4478,0,2,4480,T
5-NP,1089,4474,0,11,0,4485,A
5-NP,1090,0,1,0,4507,4508,C
5-NP,1091,4472,0,0,0,4472,A
5-NP,1092,4462,0,0,0,4462,A
5-NP,1093,4451,0,0,0,4451,A
5-NP,1094,0,4384,0,0,4384,T
5-NP,1095,0,4365,0,2,4367,T
5-NP,1096,0,0,4287,0,4287,G
5-NP,1097,0,0,0,4261,4261,C
5-NP,1098,0,4249,1,4,4254,T
5-NP,1099,0,4254,0,3,4257,T
5-NP,1100,9,2,1,4265,4277,C
5-NP,1101,4297,0,3,0,4300,A
5-NP,1102,4304,0,0,0,4304,A
5-NP,1103,4306,1,2,0,4309,A
5-NP,1104,1,4302,0,0,4303,T
5-NP,1105,0,5,4306,0,4311,G
5-NP,1106,4215,0,6,1,4222,A
5-NP,1107,0,13,4253,0,4266,G
5-NP,1108,4258,2,5,0,4265,A
5-NP,1109,4260,0,0,0,4260,A
5-NP,1110,1,0,0,4274,4275,C
5-NP,1111,4237,0,0,0,4237,A
5-NP,1112,0,4229,0,5,4234,T
5-NP,1113,0,2,4317,0,4319,G
5-NP,1114,2,1,4347,0,4350,G
5-NP,1115,4314,1,1,0,4316,A
5-NP,1116,0,4277,1,1,4279,T
5-NP,1117,4248,0,2,0,4250,A
5-NP,1118,4453,0,2,0,4455,A
5-NP,1119,0,4366,1,2,4369,T
5-NP,1120,4356,1,6,0,4363,A
5-NP,1121,0,4329,0,0,4329,T
5-NP,1122,0,3,4121,0,4124,G
5-NP,1123,1,5,4018,0,4024,G
5-NP,1124,0,2,4015,0,4017,G
5-NP,1125,3978,0,1,0,3979,A
5-NP,1126,0,3946,0,0,3946,T
5-NP,1127,3,2,0,3447,3452,C
5-NP,1128,1,5,3465,0,3471,G
5-NP,1129,3445,0,4,0,3449,A
5-NP,1130,3,0,3453,0,3456,G
5-NP,1131,1,1,0,3430,3432,C
5-NP,1132,3411,0,0,0,3411,A
5-NP,1133,0,0,0,3524,3524,C
5-NP,1134,0,3477,0,2,3479,T
5-NP,1135,7,0,0,3536,3543,C
5-NP,1136,0,3532,0,1,3533,T
5-NP,1137,0,3510,0,4,3514,T
5-NP,1138,0,8,3520,0,3528,G
5-NP,1139,3509,0,2,0,3511,A
5-NP,1140,3514,0,1,0,3515,A
5-NP,1141,3,0,0,3524,3527,C
5-NP,1142,0,3122,1,1,3124,T
5-NP,1143,0,3,3121,0,3124,G
5-NP,1144,3072,0,1,0,3073,A
5-NP,1145,0,0,3095,0,3095,G
5-NP,1146,3133,1,1,0,3135,A
5-NP,1147,3141,0,1,0,3142,A
5-NP,1148,1,2,3152,0,3155,G
5-NP,1149,2,0,0,3118,3120,C
5-NP,1150,441,0,2680,0,3121,G
5-NP,1151,1,2,3128,1,3132,G
5-NP,1152,1,1,3144,0,3146,G
5-NP,1153,0,3120,0,0,3120,T
5-NP,1154,3082,0,1,0,3083,A
5-NP,1155,1,2,0,3066,3069,C
5-NP,1156,0,2769,0,8,2777,T
5-NP,1157,1,3,2802,0,2806,G
5-NP,1158,0,3,2752,0,2755,G
5-NP,1159,1,0,2754,0,2755,G
5-NP,1160,2,1,0,2711,2714,C
5-NP,1161,2,0,0,2691,2693,C
5-NP,1162,2725,0,0,0,2725,A
5-NP,1163,0,2737,0,0,2737,T
5-NP,1164,2749,0,0,0,2749,A
5-NP,1165,2733,0,1,0,2734,A
5-NP,1166,0,2,2706,0,2708,G
5-NP,1167,0,1,2733,0,2734,G
5-NP,1168,2677,0,1,0,2678,A
5-NP,1169,1,1,0,2692,2694,C
5-NP,1170,4,2,1,2699,2706,C
5-NP,1171,2697,0,4,0,2701,A
5-NP,1172,0,1,2745,0,2746,G
5-NP,1173,0,0,2760,0,2760,G
5-NP,1174,2723,0,0,0,2723,A
5-NP,1175,0,0,2749,0,2749,G
5-NP,1176,0,2661,0,3,2664,T
5-NP,1177,2,3,2678,0,2683,G
5-NP,1178,0,2,2709,0,2711,G
5-NP,1179,2686,2,3,0,2691,A
5-NP,1180,0,1,2725,0,2726,G
5-NP,1181,1,3,2688,0,2692,G
5-NP,1182,2671,0,0,0,2671,A
5-NP,1183,2683,0,1,0,2684,A
5-NP,1184,2699,0,0,0,2699,A
5-NP,1185,0,0,0,2695,2695,C
5-NP,1186,2686,0,0,0,2686,A
5-NP,1187,0,0,0,2748,2748,C
5-NP,1188,0,2700,0,1,2701,T
5-NP,1189,2764,0,0,0,2764,A
5-NP,1190,2754,0,1,0,2755,A
5-NP,1191,0,2732,0,1,2733,T
5-NP,1192,8,2,0,2764,2774,C
5-NP,1193,2743,1,0,0,2744,A
5-NP,1194,2737,0,0,0,2737,A
5-NP,1195,8,0,0,2732,2740,C
5-NP,1196,2679,0,0,0,2679,A
5-NP,1197,0,1,2673,0,2674,G
5-NP,1198,2599,0,2,0,2601,A
5-NP,1199,1,1,2618,0,2620,G
5-NP,1200,0,1,2617,0,2618,G
5-NP,1201,1,2,2574,0,2577,G
5-NP,1202,1,1,0,2556,2558,C
5-NP,1203,1,0,0,2560,2561,C
5-NP,1204,0,2517,0,1,2518,T
5-NP,1205,2,0,0,2559,2561,C
5-NP,1206,1,5,0,2579,2585,C
5-NP,1207,2,2,2572,0,2576,G
5-NP,1208,1,1,0,2577,2579,C
5-NP,1209,2548,0,2,0,2550,A
5-NP,1210,0,1,2588,0,2589,G
5-NP,1211,0,2,2579,0,2581,G
5-NP,1212,1,0,0,2601,2602,C
5-NP,1213,1,1,3,2622,2627,C
5-NP,1214,2582,0,1,0,2583,A
5-NP,1215,2591,0,0,0,2591,A
5-NP,1216,2604,0,1,1,2606,A
5-NP,1217,1,0,0,2615,2616,C
5-NP,1218,4,0,0,2618,2622,C
5-NP,1219,2496,0,0,0,2496,A
5-NP,1220,0,1,2526,0,2527,G
5-NP,1221,0,2497,0,0,2497,T
5-NP,1222,0,0,2554,0,2554,G
5-NP,1223,0,2470,0,2,2472,T
5-NP,1224,1,0,2511,0,2512,G
5-NP,1225,2,1,0,2495,2498,C
5-NP,1226,2510,0,0,0,2510,A
5-NP,1227,2504,0,0,0,2504,A
5-NP,1228,0,2,0,2503,2505,C
5-NP,1229,1,0,0,2533,2534,C
5-NP,1230,0,2514,0,1,2515,T
5-NP,1231,2517,0,0,0,2517,A
5-NP,1232,0,0,0,2515,2515,C
5-NP,1233,0,2,2518,0,2520,G
5-NP,1234,1,2487,0,0,2488,T
5-NP,1235,0,2507,0,2,2509,T
5-NP,1236,0,2484,0,0,2484,T
5-NP,1237,0,2462,0,0,2462,T
5-NP,1238,5,0,0,2463,2468,C
5-NP,1239,0,2444,0,1,2445,T
5-NP,1240,1,1,2483,0,2485,G
5-NP,1241,0,2462,0,1,2463,T
5-NP,1242,2477,0,1,0,2478,A
5-NP,1243,3,0,0,2495,2498,C
5-NP,1244,2465,0,1,0,2466,A
5-NP,1245,2460,0,1,1,2462,A
5-NP,1246,2470,0,1,0,2471,A
5-NP,1247,0,3,2456,0,2459,G
5-NP,1248,2440,0,1,0,2441,A
5-NP,1249,2397,0,1,0,2398,A
5-NP,1250,2374,0,5,0,2379,A
5-NP,1251,1,1,0,2380,2382,C
5-NP,1252,0,0,0,2319,2319,C
5-NP,1253,0,2276,0,2,2278,T
5-NP,1254,3,1,0,2300,2304,C
5-NP,1255,3,0,0,2305,2308,C
5-NP,1256,2,0,0,2314,2316,C
5-NP,1257,2308,0,0,0,2308,A
5-NP,1258,0,2299,0,0,2299,T
5-NP,1259,0,2312,0,0,2312,T
5-NP,1260,0,2333,0,0,2333,T
5-NP,1261,0,4,2333,0,2337,G
5-NP,1262,2326,0,0,0,2326,A
5-NP,1263,2324,0,0,0,2324,A
5-NP,1264,2329,0,1,0,2330,A
5-NP,1265,2321,0,1,0,2322,A
5-NP,1266,0,0,2333,0,2333,G
5-NP,1267,0,2287,0,1,2288,T
5-NP,1268,7,0,1,2309,2317,C
5-NP,1269,2330,0,2,0,2332,A
5-NP,1270,2322,0,2,1,2325,A
5-NP,1271,0,0,0,2328,2328,C
5-NP,1272,5,0,0,2343,2348,C
5-NP,1273,2351,0,1,0,2352,A
5-NP,1274,0,2305,0,0,2305,T
5-NP,1275,3,1,1,2356,2361,C
5-NP,1276,2340,0,2,0,2342,A
5-NP,1277,1,2345,1,3,2350,T
5-NP,1278,67,3,2265,0,2335,G
5-NP,1279,0,3,2335,0,2338,G
5-NP,1280,0,0,0,2339,2339,C
5-NP,1281,2296,0,2,0,2298,A
5-NP,1282,0,1,2297,0,2298,G
5-NP,1283,5,1,0,2245,2251,C
5-NP,1284,2266,0,0,0,2266,A
5-NP,1285,0,2241,0,2,2243,T
5-NP,1286,0,2223,0,5,2228,T
5-NP,1287,1,1,0,2234,2236,C
5-NP,1288,2240,0,0,0,2240,A
5-NP,1289,1,4,0,2243,2248,C
5-NP,1290,0,2204,0,0,2204,T
5-NP,1291,0,2,2185,0,2187,G
5-NP,1292,0,4,2191,0,2195,G
5-NP,1293,2190,0,1,0,2191,A
5-NP,1294,2197,0,0,0,2197,A
5-NP,1295,2192,0,0,0,2192,A
5-NP,1296,0,2161,0,0,2161,T
5-NP,1297,2177,0,0,0,2177,A
5-NP,1298,0,0,0,2160,2160,C
5-NP,1299,0,3,2133,0,2136,G
5-NP,1300,0,1,2138,0,2139,G
5-NP,1301,2078,1,2,0,2081,A
5-NP,1302,0,0,2103,0,2103,G
5-NP,1303,0,4,2093,0,2097,G
5-NP,1304,0,2,2108,0,2110,G
5-NP,1305,2110,0,2,0,2112,A
5-NP,1306,2107,0,0,0,2107,A
5-NP,1307,2,3,2109,0,2114,G
5-NP,1308,2096,0,1,0,2097,A
5-NP,1309,2091,0,1,0,2092,A
5-NP,1310,1,0,0,2098,2099,C
5-NP,1311,0,2072,0,1,2073,T
5-NP,1312,0,2068,1,0,2069,T
5-NP,1313,1,0,0,2096,2097,C
5-NP,1314,2096,0,2,0,2098,A
5-NP,1315,1,5,2090,0,2096,G
5-NP,1316,2092,0,0,0,2092,A
5-NP,1317,1,0,0,2093,2094,C
5-NP,1318,2084,0,0,0,2084,A
5-NP,1319,0,2021,0,0,2021,T
5-NP,1320,1,1,2041,0,2043,G
5-NP,1321,2011,0,2,1,2014,A
5-NP,1322,0,0,2021,0,2021,G
5-NP,1323,0,6,2000,0,2006,G
5-NP,1324,1,1,2008,0,2010,G
5-NP,1325,0,0,0,1997,1997,C
5-NP,1326,1991,1,0,0,1992,A
5-NP,1327,0,4,1990,0,1994,G
5-NP,1328,1995,0,0,1,1996,A
5-NP,1329,2004,0,0,0,2004,A
5-NP,1330,1994,0,0,0,1994,A
5-NP,1331,0,1972,0,0,1972,T
5-NP,1332,5,0,0,1989,1994,C
5-NP,1333,1983,0,0,0,1983,A
5-NP,1334,0,1959,0,0,1959,T
5-NP,1335,1991,0,1,0,1992,A
5-NP,1336,1982,0,0,0,1982,A
5-NP,1337,0,3,1998,0,2001,G
5-NP,1338,1958,0,0,0,1958,A
5-NP,1339,1968,1,0,0,1969,A
5-NP,1340,0,1912,0,0,1912,T
5-NP,1341,1,1,1938,0,1940,G
5-NP,1342,1928,0,1,0,1929,A
5-NP,1343,0,1924,0,1,1925,T
5-NP,1344,0,4,1924,0,1928,G
5-NP,1345,0,1,1927,0,1928,G
5-NP,1346,1874,0,1,0,1875,A
5-NP,1347,1878,0,1,0,1879,A
5-NP,1348,0,0,1846,0,1846,G
5-NP,1349,0,1,1857,0,1858,G
5-NP,1350,1,1814,0,2,1817,T
5-NP,1351,1,1,1826,0,1828,G
5-NP,1352,0,0,0,1816,1816,C
5-NP,1353,1831,0,0,0,1831,A
5-NP,1354,1830,0,0,0,1830,A
5-NP,1355,1827,0,0,0,1827,A
5-NP,1356,1817,0,0,0,1817,A
5-NP,1357,2,0,0,1828,1830,C
5-NP,1358,1,0,0,1826,1827,C
5-NP,1359,1809,0,0,0,1809,A
5-NP,1360,0,0,1810,0,1810,G
5-NP,1361,1803,0,0,0,1803,A
5-NP,1362,1803,0,0,0,1803,A
5-NP,1363,0,1,1802,0,1803,G
5-NP,1364,1782,1,0,0,1783,A
5-NP,1365,1734,0,1,0,1735,A
5-NP,1366,0,0,1771,0,1771,G
5-NP,1367,0,1722,0,3,1725,T
5-NP,1368,0,1,1760,0,1761,G
5-NP,1369,0,1715,0,1,1716,T
5-NP,1370,5,0,0,1721,1726,C
5-NP,1371,1737,0,1,0,1738,A
5-NP,1372,2,1713,0,0,1715,T
5-NP,1373,0,1690,0,0,1690,T
5-NP,1374,2,0,0,1713,1715,C
5-NP,1375,1,0,0,1692,1693,C
5-NP,1376,1,1,1700,0,1702,G
5-NP,1377,0,3,1698,0,1701,G
5-NP,1378,0,3,1684,0,1687,G
5-NP,1379,0,1,1682,0,1683,G
5-NP,1380,0,0,1691,0,1691,G
5-NP,1381,1619,0,0,0,1619,A
5-NP,1382,8,1,1619,0,1628,G
5-NP,1383,0,0,1623,0,1623,G
5-NP,1384,0,2,1620,0,1622,G
5-NP,1385,0,2,1621,0,1623,G
5-NP,1386,1612,0,0,0,1612,A
5-NP,1387,0,0,1620,0,1620,G
5-NP,1388,0,1589,1,0,1590,T
5-NP,1389,0,1574,0,1,1575,T
5-NP,1390,0,1584,0,0,1584,T
5-NP,1391,0,1577,0,1,1578,T
5-NP,1392,1,0,0,1577,1578,C
5-NP,1393,1,0,1583,0,1584,G
5-NP,1394,1561,0,2,0,1563,A
5-NP,1395,1,1,1568,0,1570,G
5-NP,1396,1,0,0,1531,1532,C
5-NP,1397,0,1534,0,2,1536,T
5-NP,1398,0,0,0,1554,1554,C
5-NP,1399,0,1535,0,0,1535,T
5-NP,1400,5,0,0,1556,1561,C
5-NP,1401,1559,0,1,0,1560,A
5-NP,1402,1,1,1568,0,1570,G
5-NP,1403,1564,0,1,0,1565,A
5-NP,1404,0,0,0,1545,1545,C
5-NP,1405,0,1,1557,0,1558,G
5-NP,1406,1533,0,0,0,1533,A
5-NP,1407,1,0,1547,0,1548,G
5-NP,1408,1518,0,0,0,1518,A
5-NP,1409,1525,0,0,0,1525,A
5-NP,1410,0,0,1512,0,1512,G
5-NP,1411,0,1,1498,0,1499,G
5-NP,1412,0,0,0,1483,1483,C
5-NP,1413,1478,0,0,0,1478,A
5-NP,1414,1477,0,0,0,1477,A
5-NP,1415,0,1,0,1472,1473,C
5-NP,1416,0,1,1474,0,1475,G
5-NP,1417,1480,0,0,0,1480,A
5-NP,1418,1449,0,1,0,1450,A
5-NP,1419,0,1,0,1443,1444,C
5-NP,1420,0,0,0,1431,1431,C
5-NP,1421,2,0,0,1429,1431,C
5-NP,1422,1,2,1454,0,1457,G
5-NP,1423,1424,0,0,0,1424,A
5-NP,1424,0,1427,0,0,1427,T
5-NP,1425,2,1,0,1405,1408,C
5-NP,1426,0,0,1418,0,1418,G
5-NP,1427,0,1380,0,0,1380,T
5-NP,1428,0,1,1390,0,1391,G
5-NP,1429,0,0,0,1354,1354,C
5-NP,1430,2,1,0,1342,1345,C
5-NP,1431,2,0,0,1375,1377,C
5-NP,1432,0,1345,0,1,1346,T
5-NP,1433,0,1,0,1378,1379,C
5-NP,1434,0,1374,0,2,1376,T
5-NP,1435,0,1369,0,1,1370,T
5-NP,1436,0,1389,0,0,1389,T
5-NP,1437,0,1383,0,0,1383,T
5-NP,1438,7,0,1389,0,1396,G
5-NP,1439,1392,1,1,0,1394,A
5-NP,1440,0,1366,0,0,1366,T
5-NP,1441,1368,0,0,0,1368,A
5-NP,1442,0,1145,0,0,1145,T
5-NP,1443,0,3,1167,0,1170,G
5-NP,1444,1153,0,0,0,1153,A
5-NP,1445,0,1,1159,0,1160,G
5-NP,1446,0,1156,0,1,1157,T
5-NP,1447,1129,0,0,0,1129,A
5-NP,1448,1131,1,0,0,1132,A
5-NP,1449,0,1118,0,1,1119,T
5-NP,1450,0,1,1125,0,1126,G
5-NP,1451,1118,0,0,0,1118,A
5-NP,1452,992,0,1,0,993,A
5-NP,1453,0,0,985,1,986,G
5-NP,1454,0,1,915,0,916,G
5-NP,1455,913,0,0,0,913,A
5-NP,1456,0,891,0,1,892,T
5-NP,1457,3,0,0,893,896,C
5-NP,1458,0,878,0,0,878,T
5-NP,1459,0,885,0,0,885,T
5-NP,1460,886,0,0,0,886,A
5-NP,1461,0,877,0,0,877,T
5-NP,1462,0,876,0,0,876,T
5-NP,1463,0,859,0,0,859,T
5-NP,1464,0,0,0,832,832,C
5-NP,1465,0,804,0,0,804,T
5-NP,1466,0,793,0,0,793,T
5-NP,1467,2,0,0,799,801,C
5-NP,1468,0,1,800,0,801,G
5-NP,1469,0,0,802,0,802,G
5-NP,1470,796,0,4,0,800,A
5-NP,1471,1,0,804,0,805,G
5-NP,1472,791,0,0,0,791,A
5-NP,1473,1,0,0,773,774,C
5-NP,1474,747,0,0,0,747,A
5-NP,1475,744,0,0,0,744,A
5-NP,1476,0,738,0,2,740,T
5-NP,1477,1,0,739,0,740,G
5-NP,1478,0,1,0,734,735,C
5-NP,1479,719,0,0,0,719,A
5-NP,1480,0,0,721,0,721,G
5-NP,1481,711,0,0,0,711,A
5-NP,1482,665,0,1,0,666,A
5-NP,1483,0,0,655,0,655,G
5-NP,1484,423,0,1,0,424,A
5-NP,1485,0,0,422,0,422,G
5-NP,1486,0,398,0,0,398,T
5-NP,1487,393,0,0,0,393,A
5-NP,1488,0,0,0,397,397,C
5-NP,1489,0,0,363,0,363,G
5-NP,1490,361,0,0,0,361,A
5-NP,1491,0,0,0,346,346,C
5-NP,1492,270,0,0,0,270,A
5-NP,1493,271,0,0,0,271,A
5-NP,1494,0,220,0,0,220,T
5-NP,1495,0,212,0,0,212,T
5-NP,1496,213,0,0,0,213,A
5-NP,1497,199,0,0,0,199,A
6-NA,1,20,0,0,0,20,A
6-NA,2,0,20,0,0,20,T
6-NA,3,0,0,20,0,20,G
6-NA,4,22,0,0,0,22,A
6-NA,5,22,0,0,0,22,A
6-NA,6,0,22,0,0,22,T
6-NA,7,0,0,0,22,22,C
6-NA,8,0,0,0,22,22,C
6-NA,9,22,0,0,0,22,A
6-NA,10,22,0,0,0,22,A
6-NA,11,22,0,0,0,22,A
6-NA,12,0,22,0,1,23,T
6-NA,13,0,0,0,23,23,C
6-NA,14,23,0,0,0,23,A
6-NA,15,24,0,0,0,24,A
6-NA,16,24,0,0,0,24,A
6-NA,17,26,0,0,0,26,A
6-NA,18,0,1,29,0,30,G
6-NA,19,31,0,0,0,31,A
6-NA,20,0,33,0,0,33,T
6-NA,21,33,0,0,0,33,A
6-NA,22,33,0,0,0,33,A
6-NA,23,0,33,0,0,33,T
6-NA,24,33,0,0,0,33,A
6-NA,25,34,0,0,0,34,A
6-NA,26,0,0,0,35,35,C
6-NA,27,0,0,36,0,36,G
6-NA,28,35,0,0,0,35,A
6-NA,29,0,37,0,0,37,T
6-NA,30,0,38,0,0,38,T
6-NA,31,0,0,37,0,37,G
6-NA,32,0,0,41,0,41,G
6-NA,33,0,0,0,41,41,C
6-NA,34,0,40,0,1,41,T
6-NA,35,1,0,0,42,43,C
6-NA,36,0,43,0,0,43,T
6-NA,37,0,0,45,0,45,G
6-NA,38,0,45,0,0,45,T
6-NA,39,0,44,0,1,45,T
6-NA,40,0,48,0,0,48,T
6-NA,41,0,0,0,51,51,C
6-NA,42,0,50,0,0,50,T
6-NA,43,0,0,0,50,50,C
6-NA,44,0,51,0,0,51,T
6-NA,45,0,0,0,50,50,C
6-NA,46,51,0,0,0,51,A
6-NA,47,0,0,0,53,53,C
6-NA,48,0,0,0,52,52,C
6-NA,49,53,0,0,0,53,A
6-NA,50,0,54,0,0,54,T
6-NA,51,0,57,0,1,58,T
6-NA,52,0,56,0,0,56,T
6-NA,53,0,0,0,59,59,C
6-NA,54,0,0,0,59,59,C
6-NA,55,59,0,0,0,59,A
6-NA,56,0,0,0,59,59,C
6-NA,57,58,0,0,0,58,A
6-NA,58,60,0,0,0,60,A
6-NA,59,0,59,0,0,59,T
6-NA,60,63,0,0,0,63,A
6-NA,61,0,64,0,0,64,T
6-NA,62,0,0,65,0,65,G
6-NA,63,0,0,0,66,66,C
6-NA,64,0,65,0,0,65,T
6-NA,65,0,69,0,0,69,T
6-NA,66,1,0,0,69,70,C
6-NA,67,0,70,0,0,70,T
6-NA,68,0,69,0,0,69,T
6-NA,69,0,0,0,70,70,C
6-NA,70,69,0,0,0,69,A
6-NA,71,0,69,0,0,69,T
6-NA,72,0,0,69,0,69,G
6-NA,73,0,0,0,69,69,C
6-NA,74,70,0,0,0,70,A
6-NA,75,70,0,0,0,70,A
6-NA,76,71,0,0,0,71,A
6-NA,77,0,73,0,0,73,T
6-NA,78,0,73,0,0,73,T
6-NA,79,0,0,71,0,71,G
6-NA,80,0,0,0,72,72,C
6-NA,81,1,0,0,72,73,C
6-NA,82,72,0,0,0,72,A
6-NA,83,0,73,0,0,73,T
6-NA,84,1,0,0,77,78,C
6-NA,85,0,79,0,0,79,T
6-NA,86,0,79,0,0,79,T
6-NA,87,0,0,86,0,86,G
6-NA,88,81,0,0,0,81,A
6-NA,89,0,86,0,0,86,T
6-NA,90,87,0,0,0,87,A
6-NA,91,85,0,1,0,86,A
6-NA,92,0,0,0,101,101,C
6-NA,93,0,101,0,0,101,T
6-NA,94,104,0,0,0,104,A
6-NA,95,0,0,0,113,113,C
6-NA,96,0,111,0,0,111,T
6-NA,97,0,0,114,0,114,G
6-NA,98,0,113,0,0,113,T
6-NA,99,113,0,0,0,113,A
6-NA,100,111,0,0,0,111,A
6-NA,101,0,0,0,112,112,C
6-NA,102,110,0,0,0,110,A
6-NA,103,0,111,0,0,111,T
6-NA,104,0,108,0,0,108,T
6-NA,105,0,0,109,0,109,G
6-NA,106,0,0,0,108,108,C
6-NA,107,111,0,0,0,111,A
6-NA,108,0,111,0,0,111,T
6-NA,109,0,111,0,0,111,T
6-NA,110,0,112,0,0,112,T
6-NA,111,0,0,0,112,112,C
6-NA,112,112,0,0,0,112,A
6-NA,113,114,0,0,0,114,A
6-NA,114,0,0,112,0,112,G
6-NA,115,0,0,0,112,112,C
6-NA,116,114,0,0,0,114,A
6-NA,117,114,0,0,0,114,A
6-NA,118,0,117,0,0,117,T
6-NA,119,117,0,0,0,117,A
6-NA,120,0,117,0,0,117,T
6-NA,121,0,1,119,0,120,G
6-NA,122,119,0,0,0,119,A
6-NA,123,121,0,0,0,121,A
6-NA,124,0,121,0,0,121,T
6-NA,125,0,120,0,0,120,T
6-NA,126,1,0,0,119,120,C
6-NA,127,117,0,0,0,117,A
6-NA,128,118,0,0,0,118,A
6-NA,129,0,0,0,118,118,C
6-NA,130,0,119,0,0,119,T
6-NA,131,0,0,0,118,118,C
6-NA,132,0,0,0,119,119,C
6-NA,133,0,0,0,118,118,C
6-NA,134,0,0,0,119,119,C
6-NA,135,1,1,0,116,118,C
6-NA,136,0,0,0,121,121,C
6-NA,137,0,0,0,120,120,C
6-NA,138,119,0,0,0,119,A
6-NA,139,120,0,0,0,120,A
6-NA,140,119,0,0,0,119,A
6-NA,141,0,0,0,121,121,C
6-NA,142,121,0,0,0,121,A
6-NA,143,125,0,0,0,125,A
6-NA,144,0,0,0,127,127,C
6-NA,145,0,0,0,125,125,C
6-NA,146,130,0,0,0,130,A
6-NA,147,131,0,0,0,131,A
6-NA,148,0,0,135,0,135,G
6-NA,149,0,131,0,0,131,T
6-NA,150,0,0,135,0,135,G
6-NA,151,133,0,0,0,133,A
6-NA,152,0,133,0,0,133,T
6-NA,153,0,0,133,0,133,G
6-NA,154,0,0,0,133,133,C
6-NA,155,0,129,0,0,129,T
6-NA,156,0,0,136,0,136,G
6-NA,157,0,134,0,0,134,T
6-NA,158,0,0,135,0,135,G
6-NA,159,0,136,0,0,136,T
6-NA,160,0,0,135,0,135,G
6-NA,161,135,0,0,0,135,A
6-NA,162,137,0,0,0,137,A
6-NA,163,0,0,0,136,136,C
6-NA,164,0,0,0,136,136,C
6-NA,165,135,0,0,0,135,A
6-NA,166,134,0,0,0,134,A
6-NA,167,0,0,0,138,138,C
6-NA,168,140,0,0,0,140,A
6-NA,169,139,0,0,0,139,A
6-NA,170,0,142,0,0,142,T
6-NA,171,140,0,0,0,140,A
6-NA,172,138,0,0,0,138,A
6-NA,173,0,141,0,0,141,T
6-NA,174,141,0,0,0,141,A
6-NA,175,0,0,137,0,137,G
6-NA,176,138,0,0,0,138,A
6-NA,177,134,0,0,0,134,A
6-NA,178,137,0,0,0,137,A
6-NA,179,0,0,135,0,135,G
6-NA,180,136,0,0,0,136,A
6-NA,181,140,0,0,0,140,A
6-NA,182,145,0,0,0,145,A
6-NA,183,0,0,0,149,149,C
6-NA,184,148,0,0,0,148,A
6-NA,185,0,152,0,0,152,T
6-NA,186,148,0,0,0,148,A
6-NA,187,154,0,0,0,154,A
6-NA,188,0,0,0,155,155,C
6-NA,189,154,0,0,0,154,A
6-NA,190,0,0,157,0,157,G
6-NA,191,155,0,0,0,155,A
6-NA,192,0,0,158,0,158,G
6-NA,193,156,0,0,0,156,A
6-NA,194,0,162,0,0,162,T
6-NA,195,165,0,0,0,165,A
6-NA,196,0,0,169,0,169,G
6-NA,197,0,162,0,0,162,T
6-NA,198,0,0,173,0,173,G
6-NA,199,0,170,0,0,170,T
6-NA,200,168,0,0,0,168,A
6-NA,201,0,168,0,0,168,T
6-NA,202,1,0,0,166,167,C
6-NA,203,0,166,0,0,166,T
6-NA,204,0,0,166,1,167,G
6-NA,205,165,0,0,0,165,A
6-NA,206,0,0,0,166,166,C
6-NA,207,0,0,0,168,168,C
6-NA,208,170,0,0,0,170,A
6-NA,209,168,0,0,0,168,A
6-NA,210,0,0,0,170,170,C
6-NA,211,169,0,0,0,169,A
6-NA,212,0,0,0,172,172,C
6-NA,213,0,0,0,169,169,C
6-NA,214,173,0,0,0,173,A
6-NA,215,0,0,0,182,182,C
6-NA,216,0,0,0,183,183,C
6-NA,217,182,0,0,0,182,A
6-NA,218,0,182,0,0,182,T
6-NA,219,180,0,0,0,180,A
6-NA,220,0,0,178,0,178,G
6-NA,221,176,0,0,0,176,A
6-NA,222,0,0,176,0,176,G
6-NA,223,178,0,0,0,178,A
6-NA,224,175,0,0,0,175,A
6-NA,225,0,0,175,0,175,G
6-NA,226,0,0,172,0,172,G
6-NA,227,177,0,0,0,177,A
6-NA,228,178,0,0,0,178,A
6-NA,229,179,0,0,0,179,A
6-NA,230,0,177,0,0,177,T
6-NA,231,178,0,0,0,178,A
6-NA,232,0,176,0,0,176,T
6-NA,233,0,0,175,0,175,G
6-NA,234,0,0,0,175,175,C
6-NA,235,0,0,0,176,176,C
6-NA,236,0,1,0,178,179,C
6-NA,237,0,0,0,178,178,C
6-NA,238,182,0,0,0,182,A
6-NA,239,180,0,0,0,180,A
6-NA,240,181,0,0,0,181,A
6-NA,241,0,176,0,0,176,T
6-NA,242,0,180,0,0,180,T
6-NA,243,181,0,0,0,181,A
6-NA,244,0,0,178,0,178,G
6-NA,245,0,0,0,180,180,C
6-NA,246,180,0,0,0,180,A
6-NA,247,0,1,183,0,184,G
6-NA,248,178,0,1,0,179,A
6-NA,249,187,0,0,0,187,A
6-NA,250,0,188,0,0,188,T
6-NA,251,188,0,0,0,188,A
6-NA,252,0,0,0,187,187,C
6-NA,253,186,0,0,0,186,A
6-NA,254,0,0,184,0,184,G
6-NA,255,184,0,0,0,184,A
6-NA,256,183,0,0,0,183,A
6-NA,257,181,0,0,0,181,A
6-NA,258,0,176,0,0,176,T
6-NA,259,0,179,0,0,179,T
6-NA,260,0,0,181,0,181,G
6-NA,261,1,0,178,0,179,G
6-NA,262,0,180,0,0,180,T
6-NA,263,0,0,0,180,180,C
6-NA,264,181,0,0,0,181,A
6-NA,265,182,0,0,0,182,A
6-NA,266,183,0,0,0,183,A
6-NA,267,178,0,0,0,178,A
6-NA,268,0,0,0,180,180,C
6-NA,269,1,1,0,175,177,C
6-NA,270,0,0,179,0,179,G
6-NA,271,0,0,0,175,175,C
6-NA,272,181,0,0,0,181,A
6-NA,273,182,0,0,0,182,A
6-NA,274,0,178,0,0,178,T
6-NA,275,0,0,177,0,177,G
6-NA,276,0,0,0,179,179,C
6-NA,277,0,0,181,0,181,G
6-NA,278,179,0,0,0,179,A
6-NA,279,0,1,0,185,186,C
6-NA,280,183,0,0,0,183,A
6-NA,281,0,190,0,0,190,T
6-NA,282,0,186,0,0,186,T
6-NA,283,189,0,0,0,189,A
6-NA,284,0,0,0,189,189,C
6-NA,285,190,0,0,0,190,A
6-NA,286,0,0,186,0,186,G
6-NA,287,0,0,186,0,186,G
6-NA,288,185,0,0,0,185,A
6-NA,289,0,183,0,0,183,T
6-NA,290,0,181,0,0,181,T
6-NA,291,0,183,0,0,183,T
6-NA,292,0,0,181,0,181,G
6-NA,293,0,0,0,182,182,C
6-NA,294,183,0,0,0,183,A
6-NA,295,0,0,0,183,183,C
6-NA,296,0,0,0,183,183,C
6-NA,297,0,184,0,0,184,T
6-NA,298,0,182,0,0,182,T
6-NA,299,0,188,0,0,188,T
6-NA,300,0,185,0,0,185,T
6-NA,301,0,188,0,0,188,T
6-NA,302,0,0,0,191,191,C
6-NA,303,0,191,1,0,192,T
6-NA,304,193,0,0,0,193,A
6-NA,305,190,0,0,0,190,A
6-NA,306,0,0,193,0,193,G
6-NA,307,0,0,188,0,188,G
6-NA,308,193,0,0,0,193,A
6-NA,309,0,0,0,195,195,C
6-NA,310,191,0,0,0,191,A
6-NA,311,192,0,0,0,192,A
6-NA,312,0,193,0,0,193,T
6-NA,313,0,189,0,0,189,T
6-NA,314,0,0,0,195,195,C
6-NA,315,0,0,193,0,193,G
6-NA,316,194,0,0,0,194,A
6-NA,317,0,194,0,0,194,T
6-NA,318,0,194,0,0,194,T
6-NA,319,194,0,0,0,194,A
6-NA,320,0,0,192,0,192,G
6-NA,321,0,0,192,0,192,G
6-NA,322,0,0,0,195,195,C
6-NA,323,0,191,0,0,191,T
6-NA,324,0,189,0,0,189,T
6-NA,325,0,193,0,0,193,T
6-NA,326,0,0,0,191,191,C
6-NA,327,0,0,0,190,190,C
6-NA,328,0,0,193,0,193,G
6-NA,329,0,0,0,194,194,C
6-NA,330,0,193,0,0,193,T
6-NA,331,0,0,198,0,198,G
6-NA,332,0,0,201,0,201,G
6-NA,333,0,199,0,0,199,T
6-NA,334,0,0,202,0,202,G
6-NA,335,0,0,201,0,201,G
6-NA,336,1,0,202,0,203,G
6-NA,337,0,0,202,0,202,G
6-NA,338,201,0,0,0,201,A
6-NA,339,0,0,0,209,209,C
6-NA,340,208,0,0,0,208,A
6-NA,341,0,207,0,0,207,T
6-NA,342,0,0,0,207,207,C
6-NA,343,0,206,0,0,206,T
6-NA,344,0,0,209,0,209,G
6-NA,345,0,0,207,0,207,G
6-NA,346,0,1,209,0,210,G
6-NA,347,0,203,0,1,204,T
6-NA,348,0,1,210,0,211,G
6-NA,349,210,0,0,0,210,A
6-NA,350,0,0,0,223,223,C
6-NA,351,223,0,1,0,224,A
6-NA,352,251,0,0,0,251,A
6-NA,353,0,0,263,0,263,G
6-NA,354,261,0,0,0,261,A
6-NA,355,0,0,295,0,295,G
6-NA,356,314,0,0,0,314,A
6-NA,357,374,0,0,0,374,A
6-NA,358,0,1,0,589,590,C
6-NA,359,0,0,0,685,685,C
6-NA,360,0,689,0,1,690,T
6-NA,361,0,708,0,0,708,T
6-NA,362,700,0,0,0,700,A
6-NA,363,1,713,0,1,715,T
6-NA,364,0,0,764,0,764,G
6-NA,365,0,769,0,1,770,T
6-NA,366,0,0,794,0,794,G
6-NA,367,0,794,0,0,794,T
6-NA,368,3,0,0,796,799,C
6-NA,369,803,5,0,1,809,A
6-NA,370,0,811,0,2,813,T
6-NA,371,0,0,811,0,811,G
6-NA,372,0,1,0,808,809,C
6-NA,373,1,2,809,0,812,G
6-NA,374,954,0,0,0,954,A
6-NA,375,0,964,0,0,964,T
6-NA,376,1,0,0,986,987,C
6-NA,377,1,1,0,989,991,C
6-NA,378,0,1026,0,1,1027,T
6-NA,379,0,6,1042,0,1048,G
6-NA,380,1052,0,0,0,1052,A
6-NA,381,0,0,0,1055,1055,C
6-NA,382,1056,0,0,0,1056,A
6-NA,383,1059,0,0,0,1059,A
6-NA,384,0,0,1120,0,1120,G
6-NA,385,0,1119,0,0,1119,T
6-NA,386,3,0,1150,0,1153,G
6-NA,387,0,1157,0,0,1157,T
6-NA,388,0,1159,0,0,1159,T
6-NA,389,1164,0,0,0,1164,A
6-NA,390,0,1162,0,2,1164,T
6-NA,391,3,0,0,1190,1193,C
6-NA,392,1193,0,0,0,1193,A
6-NA,393,1188,0,0,0,1188,A
6-NA,394,0,1190,0,0,1190,T
6-NA,395,0,1194,0,1,1195,T
6-NA,396,0,1194,0,0,1194,T
6-NA,397,0,1,1192,0,1193,G
6-NA,398,0,0,1,1275,1276,C
6-NA,399,3,0,0,1271,1274,C
6-NA,400,3,0,0,1280,1283,C
6-NA,401,1,1277,1,7,1286,T
6-NA,402,1,1294,0,1,1296,T
6-NA,403,0,1,1305,0,1306,G
6-NA,404,0,1,1307,0,1308,G
6-NA,405,1318,0,3,0,1321,A
6-NA,406,1,0,0,1327,1328,C
6-NA,407,1313,0,0,0,1313,A
6-NA,408,1,0,1361,0,1362,G
6-NA,409,0,0,1344,0,1344,G
6-NA,410,0,3,1389,0,1392,G
6-NA,411,1389,0,0,0,1389,A
6-NA,412,1409,0,1,0,1410,A
6-NA,413,0,0,0,1431,1431,C
6-NA,414,1431,0,0,0,1431,A
6-NA,415,1607,0,0,0,1607,A
6-NA,416,1,0,0,1635,1636,C
6-NA,417,1631,0,1,0,1632,A
6-NA,418,0,0,0,1666,1666,C
6-NA,419,0,1665,0,1,1666,T
6-NA,420,1679,0,2,0,1681,A
6-NA,421,1681,0,1,0,1682,A
6-NA,422,1685,0,2,1,1688,A
6-NA,423,0,0,0,1701,1701,C
6-NA,424,1665,0,0,0,1665,A
6-NA,425,1672,0,0,0,1672,A
6-NA,426,0,0,0,1683,1683,C
6-NA,427,0,0,1678,0,1678,G
6-NA,428,1,1661,0,3,1665,T
6-NA,429,0,2,1681,0,1683,G
6-NA,430,0,1,0,1698,1699,C
6-NA,431,1706,0,0,0,1706,A
6-NA,432,0,1711,0,0,1711,T
6-NA,433,0,1718,0,3,1721,T
6-NA,434,5,0,0,1739,1744,C
6-NA,435,1765,0,2,0,1767,A
6-NA,436,1771,0,3,0,1774,A
6-NA,437,1775,0,0,0,1775,A
6-NA,438,0,1788,1,1,1790,T
6-NA,439,1,5,1783,0,1789,G
6-NA,440,1822,2,1,0,1825,A
6-NA,441,1,1,0,1841,1843,C
6-NA,442,1826,0,1,0,1827,A
6-NA,443,0,1,0,1894,1895,C
6-NA,444,1876,0,0,0,1876,A
6-NA,445,0,1,2375,6,2382,G
6-NA,446,0,2413,0,0,2413,T
6-NA,447,2459,0,1,0,2460,A
6-NA,448,2,1,0,2477,2480,C
6-NA,449,1,0,2472,0,2473,G
6-NA,450,1,2569,0,1,2571,T
6-NA,451,1,3,2578,0,2582,G
6-NA,452,2569,1,0,0,2570,A
6-NA,453,0,2631,0,0,2631,T
6-NA,454,2508,1,3,0,2512,A
6-NA,455,1,4,2496,0,2501,G
6-NA,456,1,7,2451,1,2460,G
6-NA,457,2513,0,6,0,2519,A
6-NA,458,0,0,0,2582,2582,C
6-NA,459,3,1,0,2558,2562,C
6-NA,460,1,0,0,2608,2609,C
6-NA,461,3,0,0,2621,2624,C
6-NA,462,0,2634,0,1,2635,T
6-NA,463,1,2692,0,1,2694,T
6-NA,464,2700,0,1,0,2701,A
6-NA,465,1,2687,1,0,2689,T
6-NA,466,0,3,0,2707,2710,C
6-NA,467,0,4,2650,1,2655,G
6-NA,468,0,10,2637,0,2647,G
6-NA,469,2687,0,1,0,2688,A
6-NA,470,0,0,1,2715,2716,C
6-NA,471,2,0,0,2709,2711,C
6-NA,472,3,0,0,2896,2899,C
6-NA,473,0,2891,0,1,2892,T
6-NA,474,2922,0,1,1,2924,A
6-NA,475,1,2934,0,1,2936,T
6-NA,476,0,2946,0,0,2946,T
6-NA,477,1,5,2934,0,2940,G
6-NA,478,2940,0,1,1,2942,A
6-NA,479,0,2959,0,0,2959,T
6-NA,480,0,7,2954,0,2961,G
6-NA,481,2879,0,1,1,2881,A
6-NA,482,2891,0,2,1,2894,A
6-NA,483,0,2920,0,0,2920,T
6-NA,484,0,2,2970,0,2972,G
6-NA,485,2918,0,1,0,2919,A
6-NA,486,0,0,3039,0,3039,G
6-NA,487,0,3013,0,0,3013,T
6-NA,488,0,3063,0,0,3063,T
6-NA,489,3063,0,2,0,3065,A
6-NA,490,0,2,3054,0,3056,G
6-NA,491,1,0,3055,0,3056,G
6-NA,492,0,3055,0,1,3056,T
6-NA,493,0,1,3057,0,3058,G
6-NA,494,0,3066,0,2,3068,T
6-NA,495,0,3059,0,0,3059,T
6-NA,496,5,0,0,3081,3086,C
6-NA,497,0,0,0,3121,3121,C
6-NA,498,0,3128,1,5,3134,T
6-NA,499,0,3131,0,0,3131,T
6-NA,500,0,3132,0,0,3132,T
6-NA,501,0,3134,0,1,3135,T
6-NA,502,4,0,0,3152,3156,C
6-NA,503,3136,0,0,0,3136,A
6-NA,504,0,3212,0,2,3214,T
6-NA,505,4,0,0,3206,3210,C
6-NA,506,0,3200,0,0,3200,T
6-NA,507,0,5,3159,0,3164,G
6-NA,508,0,4,3102,2,3108,G
6-NA,509,2,3,3107,1,3113,G
6-NA,510,0,7,3183,0,3190,G
6-NA,511,3202,1,5,0,3208,A
6-NA,512,3,0,0,3246,3249,C
6-NA,513,2,1,0,3245,3248,C
6-NA,514,3257,0,2,0,3259,A
6-NA,515,3274,1,1,0,3276,A
6-NA,516,10,0,3265,0,3275,G
6-NA,517,0,1,0,3303,3304,C
6-NA,518,3302,0,0,0,3302,A
6-NA,519,3358,0,3,0,3361,A
6-NA,520,0,1,3395,0,3396,G
6-NA,521,0,3389,0,1,3390,T
6-NA,522,0,28,3456,0,3484,G
6-NA,523,0,3436,0,4,3440,T
6-NA,524,0,0,3566,0,3566,G
6-NA,525,1,2,0,3566,3569,C
6-NA,526,3557,1,3,0,3561,A
6-NA,527,1,3624,0,0,3625,T
6-NA,528,3572,0,2,1,3575,A
6-NA,529,1,1,3632,0,3634,G
6-NA,530,0,1,0,3630,3631,C
6-NA,531,3593,0,2,0,3595,A
6-NA,532,0,3601,0,1,3602,T
6-NA,533,0,6,3538,0,3544,G
6-NA,534,1,0,3698,0,3699,G
6-NA,535,0,3720,0,2,3722,T
6-NA,536,2,1,0,3680,3683,C
6-NA,537,6,0,0,3700,3706,C
6-NA,538,3727,0,2,0,3729,A
6-NA,539,1,2,3807,0,3810,G
6-NA,540,0,0,0,3814,3814,C
6-NA,541,0,3841,0,1,3842,T
6-NA,542,3,0,0,3839,3842,C
6-NA,543,3780,0,1,0,3781,A
6-NA,544,3825,1,0,1,3827,A
6-NA,545,0,0,3870,0,3870,G
6-NA,546,0,3888,0,0,3888,T
6-NA,547,0,3890,0,1,3891,T
6-NA,548,0,2,3876,0,3878,G
6-NA,549,0,3880,0,1,3881,T
6-NA,550,4,1,0,3879,3884,C
6-NA,551,3881,0,0,0,3881,A
6-NA,552,1,0,0,3911,3912,C
6-NA,553,1,6,3903,0,3910,G
6-NA,554,3892,0,1,0,3893,A
6-NA,555,0,3968,0,1,3969,T
6-NA,556,1,5,4024,0,4030,G
6-NA,557,2,2,4038,0,4042,G
6-NA,558,4024,0,3,0,4027,A
6-NA,559,4036,0,0,1,4037,A
6-NA,560,4072,0,1,0,4073,A
6-NA,561,4083,0,8,0,4091,A
6-NA,562,1,4,4122,0,4127,G
6-NA,563,2,1,0,4133,4136,C
6-NA,564,4124,0,3,0,4127,A
6-NA,565,0,4137,0,2,4139,T
6-NA,566,1,4,4146,0,4151,G
6-NA,567,0,3,4108,0,4111,G
6-NA,568,1,1,1,4193,4196,C
6-NA,569,1,4193,0,3,4197,T
6-NA,570,1,1,4199,0,4201,G
6-NA,571,1,1,0,4199,4201,C
6-NA,572,4203,0,1,0,4204,A
6-NA,573,0,4373,0,0,4373,T
6-NA,574,1,4,4383,0,4388,G
6-NA,575,0,4404,0,0,4404,T
6-NA,576,0,4487,0,4,4491,T
6-NA,577,0,4504,1,1,4506,T
6-NA,578,0,1,4696,0,4697,G
6-NA,579,1,4667,2,3,4673,T
6-NA,580,4719,1,1,0,4721,A
6-NA,581,0,4737,0,2,4739,T
6-NA,582,4684,0,1,0,4685,A
6-NA,583,4698,1,3,0,4702,A
6-NA,584,0,4,0,4691,4695,C
6-NA,585,4,8,4661,0,4673,G
6-NA,586,0,9,4656,0,4665,G
6-NA,587,1,6,4626,0,4633,G
6-NA,588,1,6,4627,0,4634,G
6-NA,589,1,6,4643,0,4650,G
6-NA,590,4585,0,7,0,4592,A
6-NA,591,0,4660,0,1,4661,T
6-NA,592,0,13,4672,0,4685,G
6-NA,593,4683,0,6,0,4689,A
6-NA,594,0,4726,0,0,4726,T
6-NA,595,4725,0,1,0,4726,A
6-NA,596,4817,0,0,0,4817,A
6-NA,597,4825,0,3,0,4828,A
6-NA,598,4819,0,1,0,4820,A
6-NA,599,4829,1,0,0,4830,A
6-NA,600,0,4831,0,11,4842,T
6-NA,601,0,1,4822,0,4823,G
6-NA,602,3,1,0,4835,4839,C
6-NA,603,4853,0,3,0,4856,A
6-NA,604,4850,0,5,0,4855,A
6-NA,605,2,0,0,4907,4909,C
6-NA,606,1,4898,0,1,4900,T
6-NA,607,1,2,4921,0,4924,G
6-NA,608,1,1,0,4920,4922,C
6-NA,609,0,4936,0,2,4938,T
6-NA,610,4928,0,6,0,4934,A
6-NA,611,1,1,4941,0,4943,G
6-NA,612,0,7,0,4971,4978,C
6-NA,613,0,4982,0,6,4988,T
6-NA,614,3,4973,0,0,4976,T
6-NA,615,6,2,2,5028,5038,C
6-NA,616,5055,0,0,0,5055,A
6-NA,617,0,5073,0,0,5073,T
6-NA,618,0,5063,0,0,5063,T
6-NA,619,0,5110,0,1,5111,T
6-NA,620,5113,0,0,1,5114,A
6-NA,621,0,1,2,5159,5162,C
6-NA,622,5137,0,1,0,5138,A
6-NA,623,5151,1,3,0,5155,A
6-NA,624,0,5187,0,0,5187,T
6-NA,625,0,6,5177,1,5184,G
6-NA,626,12,4,5132,0,5148,G
6-NA,627,3,5,5152,0,5160,G
6-NA,628,5101,0,1,0,5102,A
6-NA,629,0,3,5297,0,5300,G
6-NA,630,2,1,5340,0,5343,G
6-NA,631,3,1,0,5623,5627,C
6-NA,632,0,5706,0,2,5708,T
6-NA,633,1,5793,0,14,5808,T
6-NA,634,3,4,5847,0,5854,G
6-NA,635,0,5825,0,0,5825,T
6-NA,636,5948,1,3,0,5952,A
6-NA,637,0,4,5990,0,5994,G
6-NA,638,5903,0,3,0,5906,A
6-NA,639,0,5916,0,0,5916,T
6-NA,640,5623,0,1,0,5624,A
6-NA,641,0,2,5638,0,5640,G
6-NA,642,2,5553,0,1,5556,T
6-NA,643,4,0,5493,18,5515,G
6-NA,644,0,5712,0,2,5714,T
6-NA,645,1,5713,0,0,5714,T
6-NA,646,3,1,5792,0,5796,G
6-NA,647,0,5772,0,6,5778,T
6-NA,648,1,5802,0,2,5805,T
6-NA,649,0,5776,2,4,5782,T
6-NA,650,3,1,1,5766,5771,C
6-NA,651,5726,7,6,0,5739,A
6-NA,652,0,5722,0,6,5728,T
6-NA,653,0,8,5733,0,5741,G
6-NA,654,1,2,5930,0,5933,G
6-NA,655,0,5918,1,7,5926,T
6-NA,656,11,1,0,5890,5902,C
6-NA,657,5,3,0,5946,5954,C
6-NA,658,5963,0,2,0,5965,A
6-NA,659,6010,0,0,0,6010,A
6-NA,660,5991,11,3,0,6005,A
6-NA,661,0,9,6015,0,6024,G
6-NA,662,6033,0,1,0,6034,A
6-NA,663,5919,0,1,1,5921,A
6-NA,664,5915,0,1,0,5916,A
6-NA,665,0,5885,0,0,5885,T
6-NA,666,5,1,0,5991,5997,C
6-NA,667,6,3,0,6016,6025,C
6-NA,668,2,5977,0,3,5982,T
6-NA,669,2,0,1,6002,6005,C
6-NA,670,6005,0,7,0,6012,A
6-NA,671,1,4,6025,0,6030,G
6-NA,672,0,14,6021,1,6036,G
6-NA,673,6120,0,5,0,6125,A
6-NA,674,3,1,0,6113,6117,C
6-NA,675,4,1,0,6049,6054,C
6-NA,676,7,0,0,6085,6092,C
6-NA,677,6082,0,2,1,6085,A
6-NA,678,1,7,6130,0,6138,G
6-NA,679,1,9,6160,0,6170,G
6-NA,680,6132,0,4,0,6136,A
6-NA,681,1,3,6217,0,6221,G
6-NA,682,0,6114,0,10,6124,T
6-NA,683,6,0,0,6161,6167,C
6-NA,684,6179,0,5,0,6184,A
6-NA,685,1,11,6219,0,6231,G
6-NA,686,6194,0,2,0,6196,A
6-NA,687,6183,0,0,1,6184,A
6-NA,688,0,6166,0,0,6166,T
6-NA,689,0,3,6220,0,6223,G
6-NA,690,3,2,0,6219,6224,C
6-NA,691,3,1,6273,0,6277,G
6-NA,692,1,6214,0,1,6216,T
6-NA,693,0,6245,0,3,6248,T
6-NA,694,0,6251,0,2,6253,T
6-NA,695,1,1,6287,0,6289,G
6-NA,696,1,6286,0,4,6291,T
6-NA,697,6297,1,1,0,6299,A
6-NA,698,1,6244,1,4,6250,T
6-NA,699,14,2,0,6290,6306,C
6-NA,700,6315,0,2,0,6317,A
6-NA,701,6293,0,8,0,6301,A
6-NA,702,0,6298,0,1,6299,T
6-NA,703,5,10,6278,0,6293,G
6-NA,704,1,13,6318,1,6333,G
6-NA,705,6426,1,2,0,6429,A
6-NA,706,6418,1,6,0,6425,A
6-NA,707,0,2,0,6453,6455,C
6-NA,708,0,6499,0,3,6502,T
6-NA,709,1,6501,0,0,6502,T
6-NA,710,2,3,6664,1,6670,G
6-NA,711,1,6648,1,0,6650,T
6-NA,712,6638,0,3,0,6641,A
6-NA,713,19,4,0,6713,6736,C
6-NA,714,6647,0,0,0,6647,A
6-NA,715,1,1,7036,1,7039,G
6-NA,716,1,6997,0,3,7001,T
6-NA,717,7273,0,2,0,7275,A
6-NA,718,0,2,7303,0,7305,G
6-NA,719,1,7204,0,2,7207,T
6-NA,720,7221,0,0,0,7221,A
6-NA,721,7211,0,1,1,7213,A
6-NA,722,0,7180,0,6,7186,T
6-NA,723,2,15,7200,0,7217,G
6-NA,724,7034,2,1,0,7037,A
6-NA,725,1,1,0,7118,7120,C
6-NA,726,0,7017,0,3,7020,T
6-NA,727,2,4,7045,0,7051,G
6-NA,728,6952,0,5,0,6957,A
6-NA,729,0,7041,0,1,7042,T
6-NA,730,2,6,7025,2,7035,G
6-NA,731,0,9,6974,1,6984,G
6-NA,732,1,9,6992,0,7002,G
6-NA,733,6872,1,15,1,6889,A
6-NA,734,18,1,6934,0,6953,G
6-NA,735,0,6898,0,4,6902,T
6-NA,736,4,1,6941,0,6946,G
6-NA,737,0,1,0,6913,6914,C
6-NA,738,0,6856,0,1,6857,T
6-NA,739,0,6854,0,1,6855,T
6-NA,740,4,3,0,6895,6902,C
6-NA,741,2,9,6874,0,6885,G
6-NA,742,1,8,6904,0,6913,G
6-NA,743,3,11,6910,1,6925,G
6-NA,744,6889,2,5,1,6897,A
6-NA,745,6901,1,4,1,6907,A
6-NA,746,6886,0,0,1,6887,A
6-NA,747,6916,0,11,1,6928,A
6-NA,748,0,1,6943,1,6945,G
6-NA,749,2,0,0,6928,6930,C
6-NA,750,0,6932,1,3,6936,T
6-NA,751,0,9,6936,0,6945,G
6-NA,752,6895,1,9,0,6905,A
6-NA,753,0,7000,0,1,7001,T
6-NA,754,6977,0,9,0,6986,A
6-NA,755,1,2,0,7255,7258,C
6-NA,756,0,7252,0,1,7253,T
6-NA,757,7272,0,0,1,7273,A
6-NA,758,7262,1,0,1,7264,A
6-NA,759,7252,0,0,2,7254,A
6-NA,760,7357,0,0,0,7357,A
6-NA,761,0,7362,0,0,7362,T
6-NA,762,7321,0,2,0,7323,A
6-NA,763,2,2,0,7389,7393,C
6-NA,764,0,7190,0,2,7192,T
6-NA,765,7259,0,1,0,7260,A
6-NA,766,0,7186,0,3,7189,T
6-NA,767,0,7604,1,2,7607,T
6-NA,768,17,1,0,7705,7723,C
6-NA,769,7641,0,1,0,7642,A
6-NA,770,0,7595,0,5,7600,T
6-NA,771,0,7644,0,1,7645,T
6-NA,772,7563,0,11,0,7574,A
6-NA,773,7575,1,0,0,7576,A
6-NA,774,1,6,7609,0,7616,G
6-NA,775,0,8,7587,0,7595,G
6-NA,776,7190,0,7,0,7197,A
6-NA,777,0,3,7323,0,7326,G
6-NA,778,0,5,7281,0,7286,G
6-NA,779,3,8,7268,0,7279,G
6-NA,780,3,15,7290,0,7308,G
6-NA,781,7322,1,2,1,7326,A
6-NA,782,7346,1,2,0,7349,A
6-NA,783,7327,0,1,1,7329,A
6-NA,784,7283,0,1,0,7284,A
6-NA,785,0,7232,0,2,7234,T
6-NA,786,16,1,0,7280,7297,C
6-NA,787,1,0,7351,0,7352,G
6-NA,788,1,7312,0,1,7314,T
6-NA,789,0,7294,2,4,7300,T
6-NA,790,21,2,0,7303,7326,C
6-NA,791,7337,1,0,0,7338,A
6-NA,792,0,7675,0,2,7677,T
6-NA,793,7635,0,0,1,7636,A
6-NA,794,0,1,0,7726,7727,C
6-NA,795,0,7678,1,17,7696,T
6-NA,796,7704,0,2,1,7707,A
6-NA,797,4,4,7658,10,7676,G
6-NA,798,4,4,0,7671,7679,C
6-NA,799,7672,1,0,1,7674,A
6-NA,800,1,2,0,7689,7692,C
6-NA,801,7510,0,0,0,7510,A
6-NA,802,0,7548,0,0,7548,T
6-NA,803,1,7544,0,1,7546,T
6-NA,804,0,3,7884,0,7887,G
6-NA,805,0,7845,0,6,7851,T
6-NA,806,17,4,6,7831,7858,C
6-NA,807,7870,0,12,1,7883,A
6-NA,808,1,12,7869,0,7882,G
6-NA,809,1,8,7867,1,7877,G
6-NA,810,7844,0,0,0,7844,A
6-NA,811,7789,0,2,0,7791,A
6-NA,812,2,0,7849,0,7851,G
6-NA,813,0,7565,0,1,7566,T
6-NA,814,2,5,7595,0,7602,G
6-NA,815,3,11,1,7542,7557,C
6-NA,816,0,7588,1,4,7593,T
6-NA,817,9,0,0,7633,7642,C
6-NA,818,7635,0,1,0,7636,A
6-NA,819,2,1,7654,0,7657,G
6-NA,820,3,1,3,7643,7650,C
6-NA,821,7648,1,4,0,7653,A
6-NA,822,1,7636,0,1,7638,T
6-NA,823,2,2,7797,0,7801,G
6-NA,824,0,7734,0,2,7736,T
6-NA,825,11,1,0,7784,7796,C
6-NA,826,2,7,7788,1,7798,G
6-NA,827,7717,1,3,1,7722,A
6-NA,828,1,8,7720,0,7729,G
6-NA,829,0,11,7733,0,7744,G
6-NA,830,7680,0,5,0,7685,A
6-NA,831,1,1,7755,0,7757,G
6-NA,832,2,7584,0,2,7588,T
6-NA,833,3,4,7620,0,7627,G
6-NA,834,0,3,0,7661,7664,C
6-NA,835,0,7645,0,8,7653,T
6-NA,836,18,1,0,7702,7721,C
6-NA,837,8,1,0,7743,7752,C
6-NA,838,1,7775,1,8,7785,T
6-NA,839,0,2,7796,1,7799,G
6-NA,840,0,0,0,7755,7755,C
6-NA,841,0,7725,0,6,7731,T
6-NA,842,7778,0,0,0,7778,A
6-NA,843,1,7627,0,6,7634,T
6-NA,844,9,1,0,7680,7690,C
6-NA,845,6,5,0,7696,7707,C
6-NA,846,4,7616,0,5,7625,T
6-NA,847,5,4,0,7759,7768,C
6-NA,848,1,9,7754,1,7765,G
6-NA,849,7776,0,8,0,7784,A
6-NA,850,0,7812,1,3,7816,T
6-NA,851,7764,0,2,0,7766,A
6-NA,852,1,7764,1,3,7769,T
6-NA,853,8,1,3,7749,7761,C
6-NA,854,3,2,1,7760,7766,C
6-NA,855,1,7742,0,5,7748,T
6-NA,856,3,4,7761,0,7768,G
6-NA,857,1,1,7761,0,7763,G
6-NA,858,0,7824,0,4,7828,T
6-NA,859,0,4,7860,0,7864,G
6-NA,860,0,7830,0,2,7832,T
6-NA,861,23,0,0,7821,7844,C
6-NA,862,7837,0,3,0,7840,A
6-NA,863,0,3,7837,0,7840,G
6-NA,864,7837,1,4,0,7842,A
6-NA,865,0,7784,1,2,7787,T
6-NA,866,2,3,7803,0,7808,G
6-NA,867,0,7700,0,2,7702,T
6-NA,868,3,2,7707,2,7714,G
6-NA,869,0,7699,0,7,7706,T
6-NA,870,14,0,1,7686,7701,C
6-NA,871,0,7692,0,9,7701,T
6-NA,872,2,1,7698,0,7701,G
6-NA,873,3,2,0,7695,7700,C
6-NA,874,7713,3,4,1,7721,A
6-NA,875,1,13,7699,1,7714,G
6-NA,876,7579,1,7,0,7587,A
6-NA,877,2,8,7664,3,7677,G
6-NA,878,7631,0,8,0,7639,A
6-NA,879,3,0,0,7725,7728,C
6-NA,880,7734,0,1,0,7735,A
6-NA,881,7689,3,6,1,7699,A
6-NA,882,2,400,0,7310,7712,C
6-NA,883,2,7722,0,2,7726,T
6-NA,884,3,2,7723,0,7728,G
6-NA,885,0,7,7680,0,7687,G
6-NA,886,7624,0,4,0,7628,A
6-NA,887,7576,0,2,0,7578,A
6-NA,888,7354,0,5,0,7359,A
6-NA,889,1,2,7418,1,7422,G
6-NA,890,2,3,7365,0,7370,G
6-NA,891,5,0,0,7354,7359,C
6-NA,892,0,7290,0,16,7306,T
6-NA,893,9,2,0,7391,7402,C
6-NA,894,8,2,0,7492,7502,C
6-NA,895,7539,0,0,0,7539,A
6-NA,896,7500,0,3,0,7503,A
6-NA,897,0,7523,0,3,7526,T
6-NA,898,7344,0,2,0,7346,A
6-NA,899,0,1,7301,0,7302,G
6-NA,900,2,3,7270,0,7275,G
6-NA,901,3,5,0,7256,7264,C
6-NA,902,1,0,0,7168,7169,C
6-NA,903,11,2,0,7085,7098,C
6-NA,904,7135,1,3,0,7139,A
6-NA,905,1,7145,0,9,7155,T
6-NA,906,5,1,1,7222,7229,C
6-NA,907,5,1,7259,1,7266,G
6-NA,908,0,7204,0,1,7205,T
6-NA,909,7062,0,0,1,7063,A
6-NA,910,1,7,7220,0,7228,G
6-NA,911,7177,0,2,1,7180,A
6-NA,912,0,7232,0,2,7234,T
6-NA,913,7108,2,0,0,7110,A
6-NA,914,0,7061,0,2,7063,T
6-NA,915,7056,0,0,0,7056,A
6-NA,916,7045,0,1,0,7046,A
6-NA,917,7151,0,1,2,7154,A
6-NA,918,2,0,1,7292,7295,C
6-NA,919,7115,0,1,1,7117,A
6-NA,920,0,7082,2,0,7084,T
6-NA,921,7032,0,1,0,7033,A
6-NA,922,7034,0,4,0,7038,A
6-NA,923,7026,1,4,1,7032,A
6-NA,924,2,6,7048,0,7056,G
6-NA,925,2,12,7081,0,7095,G
6-NA,926,6849,0,2,1,6852,A
6-NA,927,0,6774,0,4,6778,T
6-NA,928,9,3,1,6817,6830,C
6-NA,929,6868,0,1,7,6876,A
6-NA,930,1,6864,0,3,6868,T
6-NA,931,6866,0,7,0,6873,A
6-NA,932,2,0,6880,0,6882,G
6-NA,933,4,1,0,6806,6811,C
6-NA,934,6705,0,0,0,6705,A
6-NA,935,1,6518,0,1,6520,T
6-NA,936,1,6567,0,0,6568,T
6-NA,937,2,0,6716,0,6718,G
6-NA,938,1,6675,0,2,6678,T
6-NA,939,1,6758,1,1,6761,T
6-NA,940,0,6715,1,4,6720,T
6-NA,941,10,0,0,6714,6724,C
6-NA,942,6,1,0,6767,6774,C
6-NA,943,6824,0,10,0,6834,A
6-NA,944,3,1,6905,0,6909,G
6-NA,945,0,6872,4,3,6879,T
6-NA,946,1,6703,1,3,6708,T
6-NA,947,6736,0,2,0,6738,A
6-NA,948,1,6638,1,2,6642,T
6-NA,949,1,5,6678,1,6685,G
6-NA,950,2,6591,1,6,6600,T
6-NA,951,1,1,6649,1,6652,G
6-NA,952,0,6463,2,2,6467,T
6-NA,953,0,1,6569,0,6570,G
6-NA,954,0,6535,1,3,6539,T
6-NA,955,1,6501,1,3,6506,T
6-NA,956,16,2,1,6505,6524,C
6-NA,957,6465,0,11,1,6477,A
6-NA,958,1,5,6491,0,6497,G
6-NA,959,2,14,6453,0,6469,G
6-NA,960,6386,0,1,0,6387,A
6-NA,961,2,0,0,6443,6445,C
6-NA,962,0,6318,1,4,6323,T
6-NA,963,1,6338,1,1,6341,T
6-NA,964,0,2,6486,0,6488,G
6-NA,965,0,6466,1,2,6469,T
6-NA,966,1,6491,1,2,6495,T
6-NA,967,2,2,6444,0,6448,G
6-NA,968,0,13,6423,1,6437,G
6-NA,969,6402,2,12,0,6416,A
6-NA,970,2,7,6440,0,6449,G
6-NA,971,6425,0,5,0,6430,A
6-NA,972,1,3,0,6366,6370,C
6-NA,973,6205,0,3,0,6208,A
6-NA,974,1,0,0,6189,6190,C
6-NA,975,6176,1,8,0,6185,A
6-NA,976,1,0,0,6251,6252,C
6-NA,977,4,3,0,6163,6170,C
6-NA,978,5,1,0,6214,6220,C
6-NA,979,6240,0,3,0,6243,A
6-NA,980,0,10,6240,0,6250,G
6-NA,981,6240,1,0,0,6241,A
6-NA,982,6299,0,1,0,6300,A
6-NA,983,6277,0,2,0,6279,A
6-NA,984,6250,0,1,0,6251,A
6-NA,985,6220,0,3,0,6223,A
6-NA,986,6213,0,1,2,6216,A
6-NA,987,0,86,0,6160,6246,C
6-NA,988,1,16,6203,1,6221,G
6-NA,989,6200,2,4,0,6206,A
6-NA,990,2,0,0,6184,6186,C
6-NA,991,6149,1,4,0,6154,A
6-NA,992,2,10,6178,0,6190,G
6-NA,993,1,0,0,6282,6283,C
6-NA,994,0,6160,1,4,6165,T
6-NA,995,8,0,2,6257,6267,C
6-NA,996,5,1,2,6300,6308,C
6-NA,997,6330,0,7,0,6337,A
6-NA,998,4,1,6385,0,6390,G
6-NA,999,4,1,0,6363,6368,C
6-NA,1000,6363,1,1,0,6365,A
6-NA,1001,0,0,6402,0,6402,G
6-NA,1002,2,6157,1,0,6160,T
6-NA,1003,6142,0,2,0,6144,A
6-NA,1004,0,1,6141,0,6142,G
6-NA,1005,3,2,0,6052,6057,C
6-NA,1006,6,1,0,6123,6130,C
6-NA,1007,6086,1,1,0,6088,A
6-NA,1008,0,6066,0,0,6066,T
6-NA,1009,0,6096,0,0,6096,T
6-NA,1010,1,0,6233,0,6234,G
6-NA,1011,0,6174,0,2,6176,T
6-NA,1012,0,6165,0,3,6168,T
6-NA,1013,2,6165,0,4,6171,T
6-NA,1014,1,11,6117,0,6129,G
6-NA,1015,3,6,6169,0,6178,G
6-NA,1016,6124,2,2,0,6128,A
6-NA,1017,2,6110,0,4,6116,T
6-NA,1018,7,8,0,6103,6118,C
6-NA,1019,8,1,0,6032,6041,C
6-NA,1020,4,6054,1,0,6059,T
6-NA,1021,6085,0,8,0,6093,A
6-NA,1022,6100,0,5,0,6105,A
6-NA,1023,3,2,0,6153,6158,C
6-NA,1024,6045,0,1,0,6046,A
6-NA,1025,6116,0,2,0,6118,A
6-NA,1026,0,6120,0,1,6121,T
6-NA,1027,0,4,6186,0,6190,G
6-NA,1028,6154,0,3,0,6157,A
6-NA,1029,6101,1,23,0,6125,A
6-NA,1030,2,5,6155,0,6162,G
6-NA,1031,6117,1,1,1,6120,A
6-NA,1032,5961,0,1,0,5962,A
6-NA,1033,1,4,5983,0,5988,G
6-NA,1034,0,0,5979,1,5980,G
6-NA,1035,0,5787,1,2,5790,T
6-NA,1036,1,5,5868,1,5875,G
6-NA,1037,6,3,5997,0,6006,G
6-NA,1038,1,5858,1,4,5864,T
6-NA,1039,12,2,0,5921,5935,C
6-NA,1040,5930,0,0,0,5930,A
6-NA,1041,1,5918,1,3,5923,T
6-NA,1042,4,2,5932,0,5938,G
6-NA,1043,0,8,5955,0,5963,G
6-NA,1044,5870,0,11,0,5881,A
6-NA,1045,2,2,6027,0,6031,G
6-NA,1046,0,5791,3,3,5797,T
6-NA,1047,0,3,5836,0,5839,G
6-NA,1048,5789,0,1,1,5791,A
6-NA,1049,5810,0,4,0,5814,A
6-NA,1050,5815,0,7,0,5822,A
6-NA,1051,6,2,5799,0,5807,G
6-NA,1052,1,2,5724,0,5727,G
6-NA,1053,0,0,0,5717,5717,C
6-NA,1054,0,5554,1,8,5563,T
6-NA,1055,1,1,5576,0,5578,G
6-NA,1056,2,6,5537,0,5545,G
6-NA,1057,2,1,5577,0,5580,G
6-NA,1058,2,2,1,5490,5495,C
6-NA,1059,6,12,0,5542,5560,C
6-NA,1060,1,5531,2,8,5542,T
6-NA,1061,0,5558,1,1,5560,T
6-NA,1062,2,5602,1,2,5607,T
6-NA,1063,0,4,5614,1,5619,G
6-NA,1064,5593,0,2,1,5596,A
6-NA,1065,1,5580,1,1,5583,T
6-NA,1066,3,8,5483,1,5495,G
6-NA,1067,5411,0,3,1,5415,A
6-NA,1068,0,5432,1,3,5436,T
6-NA,1069,0,8,5439,0,5447,G
6-NA,1070,2,10,5482,0,5494,G
6-NA,1071,5498,0,1,0,5499,A
6-NA,1072,5473,1,2,0,5476,A
6-NA,1073,5474,2,1,0,5477,A
6-NA,1074,0,5428,0,0,5428,T
6-NA,1075,1,5,5485,0,5491,G
6-NA,1076,5447,0,6,1,5454,A
6-NA,1077,7,4,0,5427,5438,C
6-NA,1078,2,0,5487,0,5489,G
6-NA,1079,2,5327,1,0,5330,T
6-NA,1080,0,3,5410,0,5413,G
6-NA,1081,0,5352,1,0,5353,T
6-NA,1082,2,10,5365,0,5377,G
6-NA,1083,0,3,5420,0,5423,G
6-NA,1084,5354,0,2,0,5356,A
6-NA,1085,1,5340,1,1,5343,T
6-NA,1086,1,4,5333,0,5338,G
6-NA,1087,3,1,5305,0,5309,G
6-NA,1088,1,4,5324,1,5330,G
6-NA,1089,5262,0,4,0,5266,A
6-NA,1090,5283,0,0,0,5283,A
6-NA,1091,1,5,5265,0,5271,G
6-NA,1092,5219,0,1,0,5220,A
6-NA,1093,5209,0,2,0,5211,A
6-NA,1094,0,5,0,5198,5203,C
6-NA,1095,1,8,5188,0,5197,G
6-NA,1096,5141,0,5,0,5146,A
6-NA,1097,0,5043,0,0,5043,T
6-NA,1098,18,1,1,5047,5067,C
6-NA,1099,5074,0,5,0,5079,A
6-NA,1100,0,1,5092,1,5094,G
6-NA,1101,2,4,0,5063,5069,C
6-NA,1102,2,7,5077,0,5086,G
6-NA,1103,5036,0,2,0,5038,A
6-NA,1104,0,8,5080,0,5088,G
6-NA,1105,5078,0,1,0,5079,A
6-NA,1106,5076,1,2,0,5079,A
6-NA,1107,4,2,5099,0,5105,G
6-NA,1108,0,5000,0,8,5008,T
6-NA,1109,9,0,0,5024,5033,C
6-NA,1110,4991,0,3,0,4994,A
6-NA,1111,5,0,0,5104,5109,C
6-NA,1112,0,3,5120,0,5123,G
6-NA,1113,0,0,0,5100,5100,C
6-NA,1114,0,5073,0,1,5074,T
6-NA,1115,0,5090,0,0,5090,T
6-NA,1116,5053,0,3,0,5056,A
6-NA,1117,0,3,5153,0,5156,G
6-NA,1118,1,7,5128,0,5136,G
6-NA,1119,0,2,5230,0,5232,G
6-NA,1120,0,4896,1,4,4901,T
6-NA,1121,4953,0,0,0,4953,A
6-NA,1122,0,4930,1,1,4932,T
6-NA,1123,1,2,4929,1,4933,G
6-NA,1124,4937,0,1,0,4938,A
6-NA,1125,4912,0,3,0,4915,A
6-NA,1126,4631,0,1,0,4632,A
6-NA,1127,0,2,0,4655,4657,C
6-NA,1128,7,2,0,4557,4566,C
6-NA,1129,0,4500,0,5,4505,T
6-NA,1130,1,4498,0,2,4501,T
6-NA,1131,3,1,0,4523,4527,C
6-NA,1132,4546,0,3,0,4549,A
6-NA,1133,4549,0,1,0,4550,A
6-NA,1134,4547,1,1,0,4549,A
6-NA,1135,0,3,4549,0,4552,G
6-NA,1136,1,4392,0,4,4397,T
6-NA,1137,24,3,0,4434,4461,C
6-NA,1138,4526,1,3,0,4530,A
6-NA,1139,0,4514,0,2,4516,T
6-NA,1140,1,4540,0,2,4543,T
6-NA,1141,2,3,4535,1,4541,G
6-NA,1142,4525,1,1,0,4527,A
6-NA,1143,4524,2,6,0,4532,A
6-NA,1144,7,2,4499,0,4508,G
6-NA,1145,0,2,4445,0,4447,G
6-NA,1146,1,0,0,4428,4429,C
6-NA,1147,1,4300,0,2,4303,T
6-NA,1148,0,2,4336,0,4338,G
6-NA,1149,0,2,4392,0,4394,G
6-NA,1150,1,4330,1,9,4341,T
6-NA,1151,7,0,0,4327,4334,C
6-NA,1152,4,1,0,4334,4339,C
6-NA,1153,4336,3,2,0,4341,A
6-NA,1154,4322,0,2,0,4324,A
6-NA,1155,0,2,0,4323,4325,C
6-NA,1156,3,3,0,4273,4279,C
6-NA,1157,5,1,0,4268,4274,C
6-NA,1158,4,6,0,4138,4148,C
6-NA,1159,4182,1,2,0,4185,A
6-NA,1160,4176,0,3,0,4179,A
6-NA,1161,0,1,4211,1,4213,G
6-NA,1162,0,4121,0,5,4126,T
6-NA,1163,5,1,0,4161,4167,C
6-NA,1164,7,2,0,4137,4146,C
6-NA,1165,4169,0,0,0,4169,A
6-NA,1166,4155,0,1,0,4156,A
6-NA,1167,4162,0,0,0,4162,A
6-NA,1168,0,4144,0,1,4145,T
6-NA,1169,0,4151,0,1,4152,T
6-NA,1170,1,1,4146,0,4148,G
6-NA,1171,2,1,2,4109,4114,C
6-NA,1172,4115,1,6,0,4122,A
6-NA,1173,0,1,4132,0,4133,G
6-NA,1174,4134,0,2,0,4136,A
6-NA,1175,0,4178,0,0,4178,T
6-NA,1176,4192,0,0,0,4192,A
6-NA,1177,4182,0,0,0,4182,A
6-NA,1178,4179,0,2,0,4181,A
6-NA,1179,0,4134,2,0,4136,T
6-NA,1180,4144,0,1,0,4145,A
6-NA,1181,0,2,4127,0,4129,G
6-NA,1182,1,0,4089,0,4090,G
6-NA,1183,3,0,0,4072,4075,C
6-NA,1184,3978,0,0,0,3978,A
6-NA,1185,4013,0,2,0,4015,A
6-NA,1186,12,1,4040,0,4053,G
6-NA,1187,0,4031,0,1,4032,T
6-NA,1188,12,0,0,4019,4031,C
6-NA,1189,4048,0,1,0,4049,A
6-NA,1190,0,4025,0,0,4025,T
6-NA,1191,4051,0,2,0,4053,A
6-NA,1192,0,1,4068,0,4069,G
6-NA,1193,0,4050,0,0,4050,T
6-NA,1194,0,3903,1,2,3906,T
6-NA,1195,1,5,3866,0,3872,G
6-NA,1196,3840,0,2,0,3842,A
6-NA,1197,1,2,0,3826,3829,C
6-NA,1198,3774,0,0,0,3774,A
6-NA,1199,0,3,3826,0,3829,G
6-NA,1200,3740,0,8,0,3748,A
6-NA,1201,1,1,3848,0,3850,G
6-NA,1202,1,1,3840,0,3842,G
6-NA,1203,0,3806,0,2,3808,T
6-NA,1204,3817,1,1,0,3819,A
6-NA,1205,3796,0,3,0,3799,A
6-NA,1206,0,3775,0,0,3775,T
6-NA,1207,3768,0,2,0,3770,A
6-NA,1208,0,2,3640,0,3642,G
6-NA,1209,2,0,3525,0,3527,G
6-NA,1210,1,3123,0,2,3126,T
6-NA,1211,9,0,1,3057,3067,C
6-NA,1212,4,1,1,3090,3096,C
6-NA,1213,6,1,3087,0,3094,G
6-NA,1214,1,0,3108,0,3109,G
6-NA,1215,0,3107,0,0,3107,T
6-NA,1216,0,3096,0,1,3097,T
6-NA,1217,3054,1,0,0,3055,A
6-NA,1218,0,2941,0,0,2941,T
6-NA,1219,0,2954,0,1,2955,T
6-NA,1220,3,0,0,2944,2947,C
6-NA,1221,0,2827,0,2,2829,T
6-NA,1222,0,3,2803,1,2807,G
6-NA,1223,1,0,2815,0,2816,G
6-NA,1224,0,2808,0,0,2808,T
6-NA,1225,2816,0,0,0,2816,A
6-NA,1226,0,2761,0,1,2762,T
6-NA,1227,0,2776,0,2,2778,T
6-NA,1228,0,2744,0,0,2744,T
6-NA,1229,0,2741,0,1,2742,T
6-NA,1230,0,0,0,2762,2762,C
6-NA,1231,0,2696,0,2,2698,T
6-NA,1232,4,1,0,2742,2747,C
6-NA,1233,0,2736,0,1,2737,T
6-NA,1234,1,1,2794,0,2796,G
6-NA,1235,0,2773,0,1,2774,T
6-NA,1236,0,2747,0,1,2748,T
6-NA,1237,1,0,2754,0,2755,G
6-NA,1238,2723,0,2,0,2725,A
6-NA,1239,2724,0,0,0,2724,A
6-NA,1240,0,4,2727,0,2731,G
6-NA,1241,1,0,2720,1,2722,G
6-NA,1242,3,1,0,2703,2707,C
6-NA,1243,2690,0,0,2,2692,A
6-NA,1244,2687,0,2,0,2689,A
6-NA,1245,2693,0,1,0,2694,A
6-NA,1246,2679,0,20,0,2699,A
6-NA,1247,0,0,2682,0,2682,G
6-NA,1248,2,0,0,2663,2665,C
6-NA,1249,0,2636,0,1,2637,T
6-NA,1250,0,2,2649,0,2651,G
6-NA,1251,2,0,0,2650,2652,C
6-NA,1252,2668,0,0,0,2668,A
6-NA,1253,0,2606,0,3,2609,T
6-NA,1254,1,0,0,2640,2641,C
6-NA,1255,2653,0,0,0,2653,A
6-NA,1256,2629,0,1,0,2630,A
6-NA,1257,0,2605,0,0,2605,T
6-NA,1258,2,0,0,2650,2652,C
6-NA,1259,1,2,2628,0,2631,G
6-NA,1260,0,1,2647,0,2648,G
6-NA,1261,0,2631,0,1,2632,T
6-NA,1262,1,1,2641,0,2643,G
6-NA,1263,3,0,0,2635,2638,C
6-NA,1264,0,2635,0,5,2640,T
6-NA,1265,0,2653,0,0,2653,T
6-NA,1266,0,2660,0,1,2661,T
6-NA,1267,0,2668,0,0,2668,T
6-NA,1268,2682,0,1,0,2683,A
6-NA,1269,0,2611,0,0,2611,T
6-NA,1270,0,0,2628,0,2628,G
6-NA,1271,0,2583,0,5,2588,T
6-NA,1272,0,1,2558,0,2559,G
6-NA,1273,1,4,2572,0,2577,G
6-NA,1274,2521,0,0,0,2521,A
6-NA,1275,0,0,2543,0,2543,G
6-NA,1276,0,2531,0,1,2532,T
6-NA,1277,0,2527,0,1,2528,T
6-NA,1278,1,4,2538,1,2544,G
6-NA,1279,2531,1,3,0,2535,A
6-NA,1280,0,2537,0,0,2537,T
6-NA,1281,2523,0,0,0,2523,A
6-NA,1282,2461,0,1,0,2462,A
6-NA,1283,0,2,2475,0,2477,G
6-NA,1284,0,4,2435,0,2439,G
6-NA,1285,1,1,2431,0,2433,G
6-NA,1286,0,1,2422,0,2423,G
6-NA,1287,2399,0,0,0,2399,A
6-NA,1288,2385,0,1,0,2386,A
6-NA,1289,0,4,2408,0,2412,G
6-NA,1290,2398,0,2,0,2400,A
6-NA,1291,2405,0,1,0,2406,A
6-NA,1292,2380,0,0,0,2380,A
6-NA,1293,2335,1,2,0,2338,A
6-NA,1294,0,2,2341,0,2343,G
6-NA,1295,2322,0,1,0,2323,A
6-NA,1296,2,2,2317,0,2321,G
6-NA,1297,0,2,2323,0,2325,G
6-NA,1298,2296,0,1,0,2297,A
6-NA,1299,2292,0,1,0,2293,A
6-NA,1300,2284,0,4,0,2288,A
6-NA,1301,0,0,1,2293,2294,C
6-NA,1302,0,2283,0,0,2283,T
6-NA,1303,0,3,2298,0,2301,G
6-NA,1304,2293,0,0,0,2293,A
6-NA,1305,2289,0,2,0,2291,A
6-NA,1306,0,1,2282,0,2283,G
6-NA,1307,0,2243,0,3,2246,T
6-NA,1308,3,0,0,2257,2260,C
6-NA,1309,0,2253,0,0,2253,T
6-NA,1310,0,2246,0,1,2247,T
6-NA,1311,0,0,2257,0,2257,G
6-NA,1312,0,2239,0,2,2241,T
6-NA,1313,0,2,2246,0,2248,G
6-NA,1314,0,4,2234,0,2238,G
6-NA,1315,2205,0,0,0,2205,A
6-NA,1316,0,0,0,2181,2181,C
6-NA,1317,2126,0,0,0,2126,A
6-NA,1318,0,2089,0,2,2091,T
6-NA,1319,0,0,0,2121,2121,C
6-NA,1320,0,3,2125,0,2128,G
6-NA,1321,2154,0,3,0,2157,A
6-NA,1322,2162,2,2,0,2166,A
6-NA,1323,0,0,0,2174,2174,C
6-NA,1324,2156,0,0,0,2156,A
6-NA,1325,1,3,2176,0,2180,G
6-NA,1326,0,2159,0,1,2160,T
6-NA,1327,2143,0,4,0,2147,A
6-NA,1328,0,2135,1,1,2137,T
6-NA,1329,0,2069,0,0,2069,T
6-NA,1330,1,0,2096,0,2097,G
6-NA,1331,0,2063,0,2,2065,T
6-NA,1332,0,2013,0,2,2015,T
6-NA,1333,0,0,2024,0,2024,G
6-NA,1334,0,1814,0,1,1815,T
6-NA,1335,0,0,1822,0,1822,G
6-NA,1336,0,1804,1,3,1808,T
6-NA,1337,0,1786,0,3,1789,T
6-NA,1338,0,1791,0,0,1791,T
6-NA,1339,0,1754,0,0,1754,T
6-NA,1340,0,0,1760,0,1760,G
6-NA,1341,0,1756,0,2,1758,T
6-NA,1342,0,2,1750,0,1752,G
6-NA,1343,0,0,1741,0,1741,G
6-NA,1344,0,4,0,1704,1708,C
6-NA,1345,1699,0,0,0,1699,A
6-NA,1346,0,1,5,1711,1717,C
6-NA,1347,3,0,0,1719,1722,C
6-NA,1348,1,1696,0,2,1699,T
6-NA,1349,2,0,0,1724,1726,C
6-NA,1350,1729,0,4,0,1733,A
6-NA,1351,1,0,1733,0,1734,G
6-NA,1352,0,0,1728,0,1728,G
6-NA,1353,0,1727,0,0,1727,T
6-NA,1354,1720,0,0,0,1720,A
6-NA,1355,6,3,0,1627,1636,C
6-NA,1356,1612,0,0,0,1612,A
6-NA,1357,0,1607,0,0,1607,T
6-NA,1358,1557,0,8,0,1565,A
6-NA,1359,1,1555,0,0,1556,T
6-NA,1360,0,2,1430,0,1432,G
6-NA,1361,0,0,1424,0,1424,G
6-NA,1362,1417,0,0,0,1417,A
6-NA,1363,1387,0,0,0,1387,A
6-NA,1364,0,9,0,1361,1370,C
6-NA,1365,1124,0,0,0,1124,A
6-NA,1366,0,0,1122,0,1122,G
6-NA,1367,0,1,1105,0,1106,G
6-NA,1368,1,0,0,1091,1092,C
6-NA,1369,0,1093,0,1,1094,T
6-NA,1370,3,1,0,1038,1042,C
6-NA,1371,1032,0,1,1,1034,A
6-NA,1372,0,1029,0,0,1029,T
6-NA,1373,0,0,1038,0,1038,G
6-NA,1374,0,0,1031,0,1031,G
6-NA,1375,0,1,0,989,990,C
6-NA,1376,1,0,0,969,970,C
6-NA,1377,0,924,0,0,924,T
6-NA,1378,0,1,915,0,916,G
6-NA,1379,920,0,1,0,921,A
6-NA,1380,0,916,0,0,916,T
6-NA,1381,0,0,894,0,894,G
6-NA,1382,0,0,876,0,876,G
6-NA,1383,3,0,830,0,833,G
6-NA,1384,0,0,823,0,823,G
6-NA,1385,0,0,0,793,793,C
6-NA,1386,0,0,807,0,807,G
6-NA,1387,1,1,801,0,803,G
6-NA,1388,781,0,1,0,782,A
6-NA,1389,0,0,0,775,775,C
6-NA,1390,775,0,0,0,775,A
6-NA,1391,0,756,0,0,756,T
6-NA,1392,1,0,0,747,748,C
6-NA,1393,723,0,24,0,747,A
6-NA,1394,748,0,1,0,749,A
6-NA,1395,0,739,0,0,739,T
6-NA,1396,3,0,0,723,726,C
6-NA,1397,1,705,0,2,708,T
6-NA,1398,3,0,0,586,589,C
6-NA,1399,593,0,0,0,593,A
6-NA,1400,0,580,0,1,581,T
6-NA,1401,0,0,585,0,585,G
6-NA,1402,1,0,0,568,569,C
6-NA,1403,1,0,0,554,555,C
6-NA,1404,0,479,0,0,479,T
6-NA,1405,479,0,1,0,480,A
6-NA,1406,0,478,0,0,478,T
6-NA,1407,467,0,1,0,468,A
6-NA,1408,0,462,0,0,462,T
6-NA,1409,423,0,0,0,423,A
6-NA,1410,405,0,0,0,405,A
7-M,1,40,0,0,0,40,A
7-M,2,0,42,0,0,42,T
7-M,3,0,0,42,0,42,G
7-M,4,42,0,0,0,42,A
7-M,5,0,0,46,0,46,G
7-M,6,0,0,0,51,51,C
7-M,7,0,0,0,54,54,C
7-M,8,0,71,0,0,71,T
7-M,9,0,71,0,0,71,T
7-M,10,0,0,0,70,70,C
7-M,11,0,70,0,1,71,T
7-M,12,73,0,0,0,73,A
7-M,13,73,0,0,0,73,A
7-M,14,0,0,0,73,73,C
7-M,15,0,0,0,74,74,C
7-M,16,0,0,73,0,73,G
7-M,17,72,0,0,0,72,A
7-M,18,0,0,73,0,73,G
7-M,19,0,0,80,0,80,G
7-M,20,0,81,0,0,81,T
7-M,21,0,0,0,81,81,C
7-M,22,0,0,82,0,82,G
7-M,23,87,0,0,0,87,A
7-M,24,88,0,0,0,88,A
7-M,25,89,0,0,0,89,A
7-M,26,0,0,0,101,101,C
7-M,27,0,0,102,0,102,G
7-M,28,0,102,0,0,102,T
7-M,29,101,0,1,0,102,A
7-M,30,0,103,0,0,103,T
7-M,31,0,0,102,0,102,G
7-M,32,0,104,0,0,104,T
7-M,33,0,117,0,0,117,T
7-M,34,0,0,0,121,121,C
7-M,35,0,120,0,0,120,T
7-M,36,0,0,0,129,129,C
7-M,37,0,127,0,0,127,T
7-M,38,0,0,0,136,136,C
7-M,39,0,135,0,0,135,T
7-M,40,135,0,0,0,135,A
7-M,41,0,138,0,0,138,T
7-M,42,0,0,0,138,138,C
7-M,43,0,0,138,0,138,G
7-M,44,0,142,0,0,142,T
7-M,45,0,142,0,0,142,T
7-M,46,0,0,0,144,144,C
7-M,47,0,0,0,149,149,C
7-M,48,150,0,0,0,150,A
7-M,49,0,149,0,0,149,T
7-M,50,0,0,0,149,149,C
7-M,51,149,0,0,0,149,A
7-M,52,0,0,145,0,145,G
7-M,53,0,0,145,0,145,G
7-M,54,0,0,0,145,145,C
7-M,55,0,0,0,146,146,C
7-M,56,0,0,0,150,150,C
7-M,57,0,0,0,155,155,C
7-M,58,0,0,0,158,158,C
7-M,59,0,157,0,0,157,T
7-M,60,0,0,0,157,157,C
7-M,61,156,0,0,0,156,A
7-M,62,158,0,0,0,158,A
7-M,63,159,0,1,0,160,A
7-M,64,0,0,165,0,165,G
7-M,65,0,0,0,163,163,C
7-M,66,1,0,0,165,166,C
7-M,67,0,0,166,0,166,G
7-M,68,160,0,0,0,160,A
7-M,69,0,0,165,0,165,G
7-M,70,163,0,0,0,163,A
7-M,71,0,166,0,0,166,T
7-M,72,0,0,0,167,167,C
7-M,73,0,0,167,0,167,G
7-M,74,0,0,0,170,170,C
7-M,75,0,0,167,0,167,G
7-M,76,0,0,0,169,169,C
7-M,77,170,0,0,0,170,A
7-M,78,0,0,172,0,172,G
7-M,79,163,0,0,0,163,A
7-M,80,0,0,185,0,185,G
7-M,81,187,0,0,0,187,A
7-M,82,0,0,0,192,192,C
7-M,83,0,191,0,0,191,T
7-M,84,0,189,0,0,189,T
7-M,85,0,0,193,0,193,G
7-M,86,192,0,0,0,192,A
7-M,87,188,0,0,0,188,A
7-M,88,0,0,192,0,192,G
7-M,89,192,0,0,0,192,A
7-M,90,0,197,0,0,197,T
7-M,91,0,0,197,0,197,G
7-M,92,0,198,0,0,198,T
7-M,93,0,0,0,199,199,C
7-M,94,0,199,0,0,199,T
7-M,95,0,202,0,0,202,T
7-M,96,0,198,0,0,198,T
7-M,97,0,0,199,0,199,G
7-M,98,0,0,0,201,201,C
7-M,99,0,200,0,0,200,T
7-M,100,0,0,203,0,203,G
7-M,101,0,0,199,0,199,G
7-M,102,0,1,201,0,202,G
7-M,103,199,0,0,0,199,A
7-M,104,204,0,0,0,204,A
7-M,105,204,0,0,0,204,A
7-M,106,205,0,0,0,205,A
7-M,107,207,1,0,0,208,A
7-M,108,0,0,0,211,211,C
7-M,109,208,0,0,0,208,A
7-M,110,0,0,0,212,212,C
7-M,111,210,0,1,0,211,A
7-M,112,0,0,221,0,221,G
7-M,113,227,0,0,0,227,A
7-M,114,0,233,0,0,233,T
7-M,115,0,0,0,234,234,C
7-M,116,0,233,0,0,233,T
7-M,117,0,232,0,0,232,T
7-M,118,0,0,231,0,231,G
7-M,119,232,0,0,0,232,A
7-M,120,0,0,234,0,234,G
7-M,121,0,2,230,0,232,G
7-M,122,0,0,0,234,234,C
7-M,123,0,228,0,1,229,T
7-M,124,0,0,0,245,245,C
7-M,125,0,245,0,0,245,T
7-M,126,0,0,0,249,249,C
7-M,127,249,0,0,0,249,A
7-M,128,0,253,0,0,253,T
7-M,129,0,0,252,0,252,G
7-M,130,0,0,251,0,251,G
7-M,131,248,0,0,0,248,A
7-M,132,250,0,0,0,250,A
7-M,133,0,249,0,0,249,T
7-M,134,0,0,267,0,267,G
7-M,135,0,0,284,0,284,G
7-M,136,0,0,0,284,284,C
7-M,137,0,286,0,0,286,T
7-M,138,281,0,0,0,281,A
7-M,139,284,0,0,0,284,A
7-M,140,286,0,0,0,286,A
7-M,141,0,0,281,0,281,G
7-M,142,289,0,0,0,289,A
7-M,143,0,0,0,285,285,C
7-M,144,279,0,0,0,279,A
7-M,145,279,0,0,0,279,A
7-M,146,0,1,280,0,281,G
7-M,147,285,0,1,0,286,A
7-M,148,0,0,0,285,285,C
7-M,149,1,0,0,283,284,C
7-M,150,283,0,1,0,284,A
7-M,151,295,0,0,0,295,A
7-M,152,0,294,0,0,294,T
7-M,153,0,294,0,0,294,T
7-M,154,0,0,0,296,296,C
7-M,155,0,296,0,0,296,T
7-M,156,0,0,295,0,295,G
7-M,157,0,295,0,0,295,T
7-M,158,0,0,0,295,295,C
7-M,159,299,0,0,0,299,A
7-M,160,0,0,0,302,302,C
7-M,161,0,0,0,299,299,C
7-M,162,0,300,0,0,300,T
7-M,163,0,0,0,303,303,C
7-M,164,0,303,0,0,303,T
7-M,165,0,3,310,0,313,G
7-M,166,307,1,1,0,309,A
7-M,167,0,0,0,316,316,C
7-M,168,0,315,0,0,315,T
7-M,169,309,0,0,0,309,A
7-M,170,308,0,0,0,308,A
7-M,171,0,0,309,0,309,G
7-M,172,0,0,311,0,311,G
7-M,173,1,1,308,0,310,G
7-M,174,0,2,307,0,309,G
7-M,175,310,0,0,0,310,A
7-M,176,0,309,0,0,309,T
7-M,177,0,315,0,0,315,T
7-M,178,0,318,0,0,318,T
7-M,179,0,318,0,0,318,T
7-M,180,0,1,316,0,317,G
7-M,181,0,0,318,0,318,G
7-M,182,0,2,316,0,318,G
7-M,183,0,0,316,0,316,G
7-M,184,0,309,0,0,309,T
7-M,185,0,315,0,0,315,T
7-M,186,0,317,0,0,317,T
7-M,187,0,0,322,0,322,G
7-M,188,0,326,0,0,326,T
7-M,189,0,0,321,0,321,G
7-M,190,0,328,0,0,328,T
7-M,191,0,324,0,0,324,T
7-M,192,0,0,0,335,335,C
7-M,193,335,0,0,0,335,A
7-M,194,0,0,0,342,342,C
7-M,195,0,0,334,0,334,G
7-M,196,0,0,0,339,339,C
7-M,197,0,338,0,0,338,T
7-M,198,1,0,0,341,342,C
7-M,199,342,0,0,0,342,A
7-M,200,0,0,0,345,345,C
7-M,201,0,0,0,347,347,C
7-M,202,0,0,347,0,347,G
7-M,203,0,341,0,0,341,T
7-M,204,0,0,345,0,345,G
7-M,205,0,0,0,351,351,C
7-M,206,0,0,0,355,355,C
7-M,207,0,1,0,351,352,C
7-M,208,348,0,0,0,348,A
7-M,209,0,0,352,0,352,G
7-M,210,0,348,0,1,349,T
7-M,211,0,1,352,0,353,G
7-M,212,360,0,0,0,360,A
7-M,213,0,0,357,0,357,G
7-M,214,0,0,0,359,359,C
7-M,215,0,1,359,0,360,G
7-M,216,354,0,0,0,354,A
7-M,217,0,1,359,0,360,G
7-M,218,0,0,360,0,360,G
7-M,219,361,0,0,0,361,A
7-M,220,0,0,0,367,367,C
7-M,221,0,364,0,0,364,T
7-M,222,0,0,362,0,362,G
7-M,223,0,0,0,362,362,C
7-M,224,363,0,2,0,365,A
7-M,225,0,0,376,0,376,G
7-M,226,0,0,0,379,379,C
7-M,227,0,0,380,0,380,G
7-M,228,0,379,0,0,379,T
7-M,229,378,0,0,0,378,A
7-M,230,0,0,374,0,374,G
7-M,231,375,0,0,0,375,A
7-M,232,0,0,0,377,377,C
7-M,233,1,0,374,0,375,G
7-M,234,0,0,0,375,375,C
7-M,235,0,372,0,0,372,T
7-M,236,0,370,0,0,370,T
7-M,237,0,374,0,0,374,T
7-M,238,0,0,378,0,378,G
7-M,239,0,380,0,0,380,T
7-M,240,0,0,0,380,380,C
7-M,241,0,0,0,381,381,C
7-M,242,384,0,0,0,384,A
7-M,243,386,0,0,0,386,A
7-M,244,385,0,0,0,385,A
7-M,245,386,0,0,0,386,A
7-M,246,0,384,0,0,384,T
7-M,247,0,0,384,0,384,G
7-M,248,1,0,0,380,381,C
7-M,249,4,0,0,377,381,C
7-M,250,0,0,0,384,384,C
7-M,251,0,383,0,0,383,T
7-M,252,1,0,0,399,400,C
7-M,253,397,0,0,0,397,A
7-M,254,401,0,0,0,401,A
7-M,255,0,403,0,0,403,T
7-M,256,0,0,406,0,406,G
7-M,257,0,0,405,0,405,G
7-M,258,0,2,409,0,411,G
7-M,259,412,1,1,0,414,A
7-M,260,408,0,0,0,408,A
7-M,261,0,397,0,0,397,T
7-M,262,0,0,402,0,402,G
7-M,263,0,1,398,1,400,G
7-M,264,398,0,1,0,399,A
7-M,265,0,0,395,0,395,G
7-M,266,397,0,2,0,399,A
7-M,267,0,0,0,391,391,C
7-M,268,2,0,0,399,401,C
7-M,269,0,1,0,410,411,C
7-M,270,416,0,0,0,416,A
7-M,271,417,0,0,0,417,A
7-M,272,411,0,0,0,411,A
7-M,273,0,415,0,0,415,T
7-M,274,423,0,0,0,423,A
7-M,275,420,0,0,0,420,A
7-M,276,0,0,0,424,424,C
7-M,277,420,0,2,0,422,A
7-M,278,0,419,0,0,419,T
7-M,279,0,0,429,0,429,G
7-M,280,0,0,429,0,429,G
7-M,281,426,0,0,0,426,A
7-M,282,0,0,0,427,427,C
7-M,283,420,0,0,0,420,A
7-M,284,427,0,0,0,427,A
7-M,285,425,0,0,0,425,A
7-M,286,0,0,426,0,426,G
7-M,287,0,0,0,440,440,C
7-M,288,436,0,0,0,436,A
7-M,289,2,0,440,0,442,G
7-M,290,0,433,0,0,433,T
7-M,291,0,441,0,0,441,T
7-M,292,442,0,0,0,442,A
7-M,293,444,0,0,0,444,A
7-M,294,441,0,0,0,441,A
7-M,295,0,0,0,444,444,C
7-M,296,0,437,0,0,437,T
7-M,297,0,0,467,0,467,G
7-M,298,0,465,0,0,465,T
7-M,299,470,0,0,0,470,A
7-M,300,0,467,0,0,467,T
7-M,301,467,0,0,0,467,A
7-M,302,0,0,464,0,464,G
7-M,303,445,0,0,0,445,A
7-M,304,446,0,0,0,446,A
7-M,305,448,0,0,0,448,A
7-M,306,454,0,0,0,454,A
7-M,307,0,0,0,463,463,C
7-M,308,0,459,0,0,459,T
7-M,309,0,462,0,1,463,T
7-M,310,455,0,0,0,455,A
7-M,311,457,0,0,0,457,A
7-M,312,0,0,462,0,462,G
7-M,313,461,0,0,0,461,A
7-M,314,0,1,457,0,458,G
7-M,315,0,0,463,0,463,G
7-M,316,0,1,453,0,454,G
7-M,317,454,0,0,0,454,A
7-M,318,0,1,462,0,463,G
7-M,319,459,0,0,0,459,A
7-M,320,0,461,0,0,461,T
7-M,321,461,0,0,0,461,A
7-M,322,458,0,0,0,458,A
7-M,323,0,0,0,475,475,C
7-M,324,0,0,467,0,467,G
7-M,325,0,469,0,0,469,T
7-M,326,0,460,0,1,461,T
7-M,327,2,0,0,464,466,C
7-M,328,0,0,0,468,468,C
7-M,329,467,0,0,0,467,A
7-M,330,0,465,0,0,465,T
7-M,331,0,0,462,0,462,G
7-M,332,0,0,461,0,461,G
7-M,333,1,0,448,0,449,G
7-M,334,0,0,451,1,452,G
7-M,335,0,0,0,451,451,C
7-M,336,2,0,0,454,456,C
7-M,337,459,0,0,0,459,A
7-M,338,467,0,1,0,468,A
7-M,339,468,0,1,0,469,A
7-M,340,0,0,469,0,469,G
7-M,341,468,0,0,0,468,A
7-M,342,467,0,0,0,467,A
7-M,343,467,0,0,0,467,A
7-M,344,1,465,0,0,466,T
7-M,345,465,0,0,0,465,A
7-M,346,2,0,459,0,461,G
7-M,347,0,0,0,464,464,C
7-M,348,0,455,0,0,455,T
7-M,349,0,0,0,459,459,C
7-M,350,0,460,0,0,460,T
7-M,351,2,0,0,467,469,C
7-M,352,472,0,0,0,472,A
7-M,353,0,0,473,0,473,G
7-M,354,0,466,0,1,467,T
7-M,355,0,474,0,0,474,T
7-M,356,478,0,0,0,478,A
7-M,357,0,480,0,0,480,T
7-M,358,0,468,0,1,469,T
7-M,359,1,0,0,475,476,C
7-M,360,0,465,0,0,465,T
7-M,361,0,0,472,0,472,G
7-M,362,0,0,0,468,468,C
7-M,363,0,467,0,0,467,T
7-M,364,0,1,462,0,463,G
7-M,365,0,1,465,1,467,G
7-M,366,0,467,0,0,467,T
7-M,367,0,0,461,0,461,G
7-M,368,0,0,0,459,459,C
7-M,369,458,0,1,1,460,A
7-M,370,0,0,0,459,459,C
7-M,371,0,453,0,0,453,T
7-M,372,0,463,0,0,463,T
7-M,373,0,0,457,0,457,G
7-M,374,0,0,0,457,457,C
7-M,375,0,0,0,460,460,C
7-M,376,457,0,0,0,457,A
7-M,377,0,0,461,0,461,G
7-M,378,0,460,0,1,461,T
7-M,379,0,459,0,1,460,T
7-M,380,0,0,466,0,466,G
7-M,381,0,0,0,465,465,C
7-M,382,459,0,2,0,461,A
7-M,383,0,464,0,0,464,T
7-M,384,0,2,462,0,464,G
7-M,385,0,0,453,0,453,G
7-M,386,0,0,465,0,465,G
7-M,387,1,0,0,450,451,C
7-M,388,2,0,0,470,472,C
7-M,389,0,476,0,1,477,T
7-M,390,1,0,0,488,489,C
7-M,391,513,0,0,0,513,A
7-M,392,0,515,0,0,515,T
7-M,393,532,0,0,0,532,A
7-M,394,0,531,0,0,531,T
7-M,395,522,0,0,0,522,A
7-M,396,1,0,0,546,547,C
7-M,397,531,0,0,0,531,A
7-M,398,534,0,0,0,534,A
7-M,399,0,526,0,0,526,T
7-M,400,508,0,0,0,508,A
7-M,401,0,0,516,0,516,G
7-M,402,1,0,501,0,502,G
7-M,403,491,0,0,0,491,A
7-M,404,0,500,0,0,500,T
7-M,405,0,0,478,0,478,G
7-M,406,0,0,478,0,478,G
7-M,407,0,0,478,0,478,G
7-M,408,0,0,479,0,479,G
7-M,409,0,1,479,0,480,G
7-M,410,0,0,0,481,481,C
7-M,411,0,473,0,1,474,T
7-M,412,0,1,481,0,482,G
7-M,413,0,485,0,0,485,T
7-M,414,486,0,0,0,486,A
7-M,415,476,0,0,0,476,A
7-M,416,0,0,0,479,479,C
7-M,417,0,0,0,473,473,C
7-M,418,474,0,0,0,474,A
7-M,419,0,0,0,477,477,C
7-M,420,0,473,0,0,473,T
7-M,421,0,0,472,0,472,G
7-M,422,464,0,0,0,464,A
7-M,423,471,0,0,0,471,A
7-M,424,0,0,471,0,471,G
7-M,425,0,470,0,0,470,T
7-M,426,1,4,463,0,468,G
7-M,427,0,0,473,0,473,G
7-M,428,0,0,0,475,475,C
7-M,429,473,0,0,0,473,A
7-M,430,0,466,0,0,466,T
7-M,431,0,468,0,0,468,T
7-M,432,0,464,0,0,464,T
7-M,433,0,0,477,0,477,G
7-M,434,0,0,474,0,474,G
7-M,435,0,0,0,466,466,C
7-M,436,0,0,0,468,468,C
7-M,437,0,475,3,0,478,T
7-M,438,0,1,490,0,491,G
7-M,439,0,0,497,0,497,G
7-M,440,0,496,0,0,496,T
7-M,441,495,0,0,0,495,A
7-M,442,0,481,0,0,481,T
7-M,443,0,0,488,0,488,G
7-M,444,0,492,0,0,492,T
7-M,445,2,0,491,0,493,G
7-M,446,0,0,0,492,492,C
7-M,447,477,0,1,0,478,A
7-M,448,474,0,0,0,474,A
7-M,449,2,0,0,474,476,C
7-M,450,477,0,0,0,477,A
7-M,451,0,483,0,0,483,T
7-M,452,0,0,479,0,479,G
7-M,453,0,473,0,0,473,T
7-M,454,0,0,475,0,475,G
7-M,455,472,0,0,0,472,A
7-M,456,1,0,473,0,474,G
7-M,457,0,0,0,472,472,C
7-M,458,467,1,1,0,469,A
7-M,459,0,1,461,0,462,G
7-M,460,469,0,0,0,469,A
7-M,461,0,458,0,0,458,T
7-M,462,0,472,0,0,472,T
7-M,463,1,0,470,0,471,G
7-M,464,0,1,0,466,467,C
7-M,465,0,470,0,0,470,T
7-M,466,0,0,469,0,469,G
7-M,467,463,0,0,0,463,A
7-M,468,0,0,0,480,480,C
7-M,469,0,479,0,2,481,T
7-M,470,0,0,0,483,483,C
7-M,471,0,0,0,480,480,C
7-M,472,0,0,0,486,486,C
7-M,473,483,0,0,0,483,A
7-M,474,0,0,488,0,488,G
7-M,475,0,0,0,481,481,C
7-M,476,488,0,0,0,488,A
7-M,477,0,0,0,487,487,C
7-M,478,472,0,1,0,473,A
7-M,479,0,0,476,0,476,G
7-M,480,0,0,485,0,485,G
7-M,481,0,478,0,1,479,T
7-M,482,1,0,0,486,487,C
7-M,483,0,485,0,0,485,T
7-M,484,2,0,0,483,485,C
7-M,485,489,0,0,0,489,A
7-M,486,0,489,0,0,489,T
7-M,487,484,0,1,0,485,A
7-M,488,0,0,479,0,479,G
7-M,489,0,0,483,0,483,G
7-M,490,0,0,0,481,481,C
7-M,491,472,0,0,0,472,A
7-M,492,0,0,469,0,469,G
7-M,493,471,0,0,0,471,A
7-M,494,0,478,0,0,478,T
7-M,495,0,0,474,0,474,G
7-M,496,0,0,473,0,473,G
7-M,497,0,470,0,1,471,T
7-M,498,0,0,469,0,469,G
7-M,499,0,0,476,0,476,G
7-M,500,0,0,0,479,479,C
7-M,501,473,0,1,0,474,A
7-M,502,471,0,0,0,471,A
7-M,503,0,0,0,480,480,C
7-M,504,486,0,0,0,486,A
7-M,505,487,0,0,0,487,A
7-M,506,1,0,0,486,487,C
7-M,507,0,0,0,487,487,C
7-M,508,483,0,0,0,483,A
7-M,509,485,0,1,0,486,A
7-M,510,0,485,0,0,485,T
7-M,511,1,0,0,483,484,C
7-M,512,1,0,0,486,487,C
7-M,513,486,0,1,0,487,A
7-M,514,0,479,0,0,479,T
7-M,515,0,484,0,0,484,T
7-M,516,488,0,0,1,489,A
7-M,517,490,0,0,0,490,A
7-M,518,0,492,0,1,493,T
7-M,519,488,0,1,0,489,A
7-M,520,490,0,0,0,490,A
7-M,521,485,0,0,0,485,A
7-M,522,488,0,0,0,488,A
7-M,523,0,0,0,495,495,C
7-M,524,493,0,0,0,493,A
7-M,525,0,489,0,0,489,T
7-M,526,0,1,497,0,498,G
7-M,527,490,0,0,0,490,A
7-M,528,0,0,493,0,493,G
7-M,529,494,0,1,0,495,A
7-M,530,489,0,0,0,489,A
7-M,531,0,1,0,493,494,C
7-M,532,480,0,0,0,480,A
7-M,533,0,1,488,0,489,G
7-M,534,476,0,0,0,476,A
7-M,535,487,0,0,0,487,A
7-M,536,0,474,0,0,474,T
7-M,537,0,2,476,0,478,G
7-M,538,0,0,478,0,478,G
7-M,539,0,469,0,1,470,T
7-M,540,0,464,0,0,464,T
7-M,541,0,469,0,0,469,T
7-M,542,0,472,0,0,472,T
7-M,543,0,0,473,0,473,G
7-M,544,0,0,476,0,476,G
7-M,545,0,1,0,461,462,C
7-M,546,0,0,0,472,472,C
7-M,547,468,0,0,0,468,A
7-M,548,0,0,482,0,482,G
7-M,549,0,0,0,473,473,C
7-M,550,477,0,0,0,477,A
7-M,551,0,0,0,475,475,C
7-M,552,0,483,0,0,483,T
7-M,553,479,0,1,0,480,A
7-M,554,0,0,0,492,492,C
7-M,555,496,0,0,1,497,A
7-M,556,1,0,500,0,501,G
7-M,557,0,0,0,489,489,C
7-M,558,0,486,0,0,486,T
7-M,559,493,0,0,0,493,A
7-M,560,492,0,0,1,493,A
7-M,561,0,0,497,1,498,G
7-M,562,0,1,495,0,496,G
7-M,563,0,1,0,484,485,C
7-M,564,0,471,0,0,471,T
7-M,565,470,0,0,0,470,A
7-M,566,0,469,0,0,469,T
7-M,567,0,0,473,0,473,G
7-M,568,0,2,467,0,469,G
7-M,569,466,0,1,0,467,A
7-M,570,0,0,472,0,472,G
7-M,571,0,1,0,454,455,C
7-M,572,457,0,0,0,457,A
7-M,573,454,0,1,0,455,A
7-M,574,455,0,0,0,455,A
7-M,575,0,463,0,0,463,T
7-M,576,0,0,465,0,465,G
7-M,577,0,1,456,0,457,G
7-M,578,0,0,0,457,457,C
7-M,579,0,461,0,0,461,T
7-M,580,1,0,457,0,458,G
7-M,581,0,0,464,0,464,G
7-M,582,462,0,0,0,462,A
7-M,583,0,461,0,0,461,T
7-M,584,0,0,0,463,463,C
7-M,585,465,0,0,0,465,A
7-M,586,466,0,1,0,467,A
7-M,587,0,0,472,0,472,G
7-M,588,0,470,0,0,470,T
7-M,589,0,1,471,0,472,G
7-M,590,462,0,0,0,462,A
7-M,591,0,0,462,0,462,G
7-M,592,0,0,0,463,463,C
7-M,593,462,0,0,0,462,A
7-M,594,0,0,462,0,462,G
7-M,595,0,0,464,0,464,G
7-M,596,0,0,0,462,462,C
7-M,597,456,0,0,0,456,A
7-M,598,0,0,464,0,464,G
7-M,599,0,0,0,463,463,C
7-M,600,1,0,459,0,460,G
7-M,601,0,0,464,0,464,G
7-M,602,459,0,0,0,459,A
7-M,603,0,0,461,0,461,G
7-M,604,0,0,463,0,463,G
7-M,605,1,0,0,460,461,C
7-M,606,0,5,0,459,464,C
7-M,607,463,0,0,0,463,A
7-M,608,0,467,0,0,467,T
7-M,609,0,0,469,1,470,G
7-M,610,0,1,462,0,463,G
7-M,611,464,0,0,0,464,A
7-M,612,0,0,461,0,461,G
7-M,613,452,0,0,0,452,A
7-M,614,0,457,0,0,457,T
7-M,615,0,456,0,0,456,T
7-M,616,0,0,455,0,455,G
7-M,617,0,0,0,452,452,C
7-M,618,0,458,0,0,458,T
7-M,619,460,0,0,0,460,A
7-M,620,0,0,458,0,458,G
7-M,621,0,452,0,0,452,T
7-M,622,0,0,0,458,458,C
7-M,623,450,0,0,0,450,A
7-M,624,0,1,458,0,459,G
7-M,625,0,0,455,0,455,G
7-M,626,0,0,0,452,452,C
7-M,627,0,0,0,451,451,C
7-M,628,458,0,0,0,458,A
7-M,629,1,0,462,0,463,G
7-M,630,0,0,463,0,463,G
7-M,631,0,0,0,460,460,C
7-M,632,462,0,0,0,462,A
7-M,633,0,2,461,0,463,G
7-M,634,453,0,0,0,453,A
7-M,635,0,452,0,0,452,T
7-M,636,0,2,458,0,460,G
7-M,637,0,0,465,0,465,G
7-M,638,0,449,0,0,449,T
7-M,639,0,0,446,0,446,G
7-M,640,0,0,0,448,448,C
7-M,641,444,0,0,0,444,A
7-M,642,1,1,451,0,453,G
7-M,643,0,0,451,0,451,G
7-M,644,0,0,0,450,450,C
7-M,645,457,0,0,0,457,A
7-M,646,440,0,0,0,440,A
7-M,647,0,437,0,0,437,T
7-M,648,0,1,441,0,442,G
7-M,649,432,0,0,0,432,A
7-M,650,0,1,436,0,437,G
7-M,651,422,0,1,0,423,A
7-M,652,0,0,430,0,430,G
7-M,653,0,0,0,423,423,C
7-M,654,0,0,0,432,432,C
7-M,655,431,0,0,0,431,A
7-M,656,0,434,0,0,434,T
7-M,657,0,437,0,0,437,T
7-M,658,0,0,433,0,433,G
7-M,659,0,1,434,0,435,G
7-M,660,0,1,435,0,436,G
7-M,661,429,0,1,0,430,A
7-M,662,0,0,0,426,426,C
7-M,663,0,419,0,0,419,T
7-M,664,0,0,0,425,425,C
7-M,665,424,0,0,0,424,A
7-M,666,0,438,0,0,438,T
7-M,667,0,0,0,441,441,C
7-M,668,0,0,0,441,441,C
7-M,669,0,439,0,0,439,T
7-M,670,439,0,0,0,439,A
7-M,671,0,0,449,0,449,G
7-M,672,0,474,0,0,474,T
7-M,673,0,466,0,1,467,T
7-M,674,0,0,0,468,468,C
7-M,675,1,0,0,467,468,C
7-M,676,460,0,0,0,460,A
7-M,677,0,0,464,0,464,G
7-M,678,0,464,0,0,464,T
7-M,679,456,0,0,0,456,A
7-M,680,0,0,0,455,455,C
7-M,681,0,411,0,1,412,T
7-M,682,1,0,427,0,428,G
7-M,683,0,0,440,0,440,G
7-M,684,0,439,0,0,439,T
7-M,685,0,0,0,441,441,C
7-M,686,0,432,0,0,432,T
7-M,687,431,0,0,0,431,A
7-M,688,429,0,1,0,430,A
7-M,689,0,2,433,0,435,G
7-M,690,429,0,0,0,429,A
7-M,691,0,0,427,0,427,G
7-M,692,413,0,1,0,414,A
7-M,693,0,416,0,0,416,T
7-M,694,0,0,415,0,415,G
7-M,695,413,0,1,0,414,A
7-M,696,0,410,0,0,410,T
7-M,697,0,1,0,410,411,C
7-M,698,0,406,0,0,406,T
7-M,699,0,407,0,0,407,T
7-M,700,1,0,0,408,409,C
7-M,701,1,411,0,0,412,T
7-M,702,0,409,0,1,410,T
7-M,703,0,1,410,0,411,G
7-M,704,410,0,0,0,410,A
7-M,705,409,0,0,0,409,A
7-M,706,408,0,0,0,408,A
7-M,707,408,0,0,0,408,A
7-M,708,0,411,0,0,411,T
7-M,709,0,413,0,0,413,T
7-M,710,0,416,0,0,416,T
7-M,711,0,0,412,0,412,G
7-M,712,0,0,1,410,411,C
7-M,713,414,0,0,0,414,A
7-M,714,0,0,413,0,413,G
7-M,715,409,0,0,0,409,A
7-M,716,0,0,0,415,415,C
7-M,717,1,0,0,415,416,C
7-M,718,0,413,0,0,413,T
7-M,719,415,0,0,0,415,A
7-M,720,0,414,0,0,414,T
7-M,721,0,0,0,418,418,C
7-M,722,418,0,0,0,418,A
7-M,723,1,0,413,0,414,G
7-M,724,413,0,0,0,413,A
7-M,725,395,0,0,0,395,A
7-M,726,396,0,0,0,396,A
7-M,727,0,0,0,399,399,C
7-M,728,0,0,398,0,398,G
7-M,729,389,0,0,0,389,A
7-M,730,390,1,0,0,391,A
7-M,731,0,395,0,0,395,T
7-M,732,0,0,392,0,392,G
7-M,733,0,0,389,0,389,G
7-M,734,0,2,391,0,393,G
7-M,735,373,0,0,0,373,A
7-M,736,0,0,384,0,384,G
7-M,737,0,385,0,0,385,T
7-M,738,0,0,388,0,388,G
7-M,739,0,0,0,385,385,C
7-M,740,380,0,1,0,381,A
7-M,741,0,0,384,0,384,G
7-M,742,375,0,1,0,376,A
7-M,743,0,378,0,1,379,T
7-M,744,0,1,378,0,379,G
7-M,745,0,0,0,375,375,C
7-M,746,375,0,1,0,376,A
7-M,747,373,0,0,0,373,A
7-M,748,0,0,0,380,380,C
7-M,749,0,0,378,0,378,G
7-M,750,380,0,0,0,380,A
7-M,751,0,380,0,0,380,T
7-M,752,0,380,0,0,380,T
7-M,753,0,0,0,377,377,C
7-M,754,376,0,0,0,376,A
7-M,755,376,0,0,0,376,A
7-M,756,0,0,377,0,377,G
7-M,757,0,370,0,0,370,T
7-M,758,0,2,367,0,369,G
7-M,759,363,0,0,0,363,A
7-M,760,1,0,0,364,365,C
7-M,761,0,0,0,362,362,C
7-M,762,0,0,0,362,362,C
7-M,763,0,0,368,0,368,G
7-M,764,0,0,0,369,369,C
7-M,765,0,368,0,0,368,T
7-M,766,0,371,0,0,371,T
7-M,767,0,0,367,0,367,G
7-M,768,0,366,0,1,367,T
7-M,769,0,367,0,0,367,T
7-M,770,0,0,363,0,363,G
7-M,771,0,347,0,0,347,T
7-M,772,0,347,0,0,347,T
7-M,773,0,0,343,0,343,G
7-M,774,0,0,0,342,342,C
7-M,775,0,0,0,343,343,C
7-M,776,0,0,346,0,346,G
7-M,777,0,0,0,339,339,C
7-M,778,0,0,343,0,343,G
7-M,779,343,0,0,0,343,A
7-M,780,344,0,0,0,344,A
7-M,781,0,347,0,0,347,T
7-M,782,345,0,0,0,345,A
7-M,783,0,346,0,0,346,T
7-M,784,3,0,0,347,350,C
7-M,785,351,0,0,0,351,A
7-M,786,0,351,0,0,351,T
7-M,787,0,349,0,0,349,T
7-M,788,0,1,346,0,347,G
7-M,789,0,0,349,0,349,G
7-M,790,0,0,347,0,347,G
7-M,791,343,0,0,0,343,A
7-M,792,0,342,0,0,342,T
7-M,793,0,0,0,336,336,C
7-M,794,0,334,0,0,334,T
7-M,795,0,332,0,0,332,T
7-M,796,1,0,334,0,335,G
7-M,797,0,0,0,335,335,C
7-M,798,333,0,0,0,333,A
7-M,799,0,0,0,336,336,C
7-M,800,0,328,1,0,329,T
7-M,801,0,334,0,0,334,T
7-M,802,0,1,329,0,330,G
7-M,803,330,0,0,0,330,A
7-M,804,0,332,0,0,332,T
7-M,805,325,0,0,0,325,A
7-M,806,0,325,0,0,325,T
7-M,807,0,319,0,0,319,T
7-M,808,0,0,319,0,319,G
7-M,809,0,313,0,0,313,T
7-M,810,0,1,309,0,310,G
7-M,811,0,0,311,0,311,G
7-M,812,309,0,0,0,309,A
7-M,813,0,306,0,0,306,T
7-M,814,0,309,0,0,309,T
7-M,815,0,0,0,308,308,C
7-M,816,0,305,0,0,305,T
7-M,817,0,304,0,0,304,T
7-M,818,0,0,305,0,305,G
7-M,819,301,0,0,0,301,A
7-M,820,0,298,0,0,298,T
7-M,821,0,0,0,304,304,C
7-M,822,0,0,297,0,297,G
7-M,823,0,300,0,0,300,T
7-M,824,0,0,0,292,292,C
7-M,825,0,293,0,1,294,T
7-M,826,0,294,0,0,294,T
7-M,827,0,297,0,0,297,T
7-M,828,0,295,0,0,295,T
7-M,829,0,297,0,0,297,T
7-M,830,0,300,0,0,300,T
7-M,831,0,296,0,0,296,T
7-M,832,0,0,0,297,297,C
7-M,833,296,0,0,0,296,A
7-M,834,299,0,0,0,299,A
7-M,835,297,0,0,0,297,A
7-M,836,0,298,0,0,298,T
7-M,837,0,0,295,0,295,G
7-M,838,0,0,0,294,294,C
7-M,839,0,0,298,0,298,G
7-M,840,0,297,0,1,298,T
7-M,841,0,0,0,295,295,C
7-M,842,0,297,0,0,297,T
7-M,843,300,0,0,0,300,A
7-M,844,0,295,0,0,295,T
7-M,845,0,0,0,297,297,C
7-M,846,1,0,297,0,298,G
7-M,847,295,0,0,0,295,A
7-M,848,0,0,0,292,292,C
7-M,849,0,280,0,1,281,T
7-M,850,0,0,0,287,287,C
7-M,851,0,281,0,1,282,T
7-M,852,0,280,0,0,280,T
7-M,853,1,0,0,281,282,C
7-M,854,280,0,0,0,280,A
7-M,855,283,0,0,0,283,A
7-M,856,280,0,0,0,280,A
7-M,857,0,0,0,283,283,C
7-M,858,283,0,0,0,283,A
7-M,859,0,0,0,264,264,C
7-M,860,0,0,256,0,256,G
7-M,861,0,0,264,0,264,G
7-M,862,0,0,0,256,256,C
7-M,863,1,0,0,259,260,C
7-M,864,0,260,0,0,260,T
7-M,865,0,263,0,0,263,T
7-M,866,261,0,0,0,261,A
7-M,867,263,0,0,0,263,A
7-M,868,265,0,0,0,265,A
7-M,869,260,0,0,0,260,A
7-M,870,0,0,256,0,256,G
7-M,871,213,0,0,0,213,A
7-M,872,0,0,209,0,209,G
7-M,873,0,0,212,0,212,G
7-M,874,0,0,0,207,207,C
7-M,875,0,1,0,204,205,C
7-M,876,0,0,0,208,208,C
7-M,877,0,212,0,0,212,T
7-M,878,0,206,0,0,206,T
7-M,879,0,0,1,205,206,C
7-M,880,0,206,0,0,206,T
7-M,881,207,0,0,0,207,A
7-M,882,0,0,0,213,213,C
7-M,883,0,0,209,0,209,G
7-M,884,0,0,208,0,208,G
7-M,885,206,0,0,0,206,A
7-M,886,205,0,0,0,205,A
7-M,887,0,0,205,0,205,G
7-M,888,0,1,203,0,204,G
7-M,889,199,0,1,0,200,A
7-M,890,0,0,201,0,201,G
7-M,891,0,200,0,0,200,T
7-M,892,200,0,0,0,200,A
7-M,893,0,0,0,195,195,C
7-M,894,0,0,0,193,193,C
7-M,895,0,183,0,1,184,T
7-M,896,0,0,191,0,191,G
7-M,897,186,0,0,0,186,A
7-M,898,0,0,187,0,187,G
7-M,899,0,182,0,0,182,T
7-M,900,0,0,0,182,182,C
7-M,901,0,182,0,0,182,T
7-M,902,181,0,0,0,181,A
7-M,903,0,179,0,0,179,T
7-M,904,0,0,179,0,179,G
7-M,905,172,0,0,0,172,A
7-M,906,0,0,171,0,171,G
7-M,907,0,1,150,0,151,G
7-M,908,1,0,151,0,152,G
7-M,909,150,0,0,0,150,A
7-M,910,150,0,0,0,150,A
7-M,911,0,1,149,0,150,G
7-M,912,148,0,0,0,148,A
7-M,913,149,0,0,0,149,A
7-M,914,0,146,0,0,146,T
7-M,915,145,0,0,0,145,A
7-M,916,0,142,0,0,142,T
7-M,917,0,1,0,141,142,C
7-M,918,0,0,142,0,142,G
7-M,919,142,0,0,0,142,A
7-M,920,141,0,0,0,141,A
7-M,921,141,0,0,0,141,A
7-M,922,0,0,139,0,139,G
7-M,923,0,1,138,0,139,G
7-M,924,136,0,0,0,136,A
7-M,925,136,0,0,0,136,A
7-M,926,0,0,0,136,136,C
7-M,927,135,0,0,0,135,A
7-M,928,0,0,136,0,136,G
7-M,929,0,0,0,137,137,C
7-M,930,136,0,0,0,136,A
7-M,931,0,0,137,0,137,G
7-M,932,132,0,0,0,132,A
7-M,933,134,0,0,0,134,A
7-M,934,0,131,0,0,131,T
7-M,935,0,0,132,0,132,G
7-M,936,0,0,0,128,128,C
7-M,937,0,123,0,1,124,T
7-M,938,0,0,125,0,125,G
7-M,939,0,122,0,0,122,T
7-M,940,0,0,120,0,120,G
7-M,941,0,0,118,0,118,G
7-M,942,119,0,0,0,119,A
7-M,943,0,117,0,0,117,T
7-M,944,0,0,112,0,112,G
7-M,945,0,0,0,107,107,C
7-M,946,0,100,0,0,100,T
7-M,947,0,0,97,0,97,G
7-M,948,95,0,0,0,95,A
7-M,949,0,0,0,94,94,C
7-M,950,0,0,94,0,94,G
7-M,951,92,0,0,0,92,A
7-M,952,0,0,0,94,94,C
7-M,953,90,0,0,0,90,A
7-M,954,0,0,89,0,89,G
7-M,955,0,90,0,0,90,T
7-M,956,0,0,0,89,89,C
7-M,957,90,0,0,0,90,A
7-M,958,0,90,0,0,90,T
7-M,959,0,86,0,0,86,T
7-M,960,0,88,0,0,88,T
7-M,961,0,84,0,0,84,T
7-M,962,0,0,84,0,84,G
7-M,963,0,78,0,0,78,T
7-M,964,0,0,0,78,78,C
7-M,965,73,0,0,0,73,A
7-M,966,0,0,72,0,72,G
7-M,967,0,0,0,74,74,C
7-M,968,73,0,0,0,73,A
7-M,969,0,73,0,0,73,T
7-M,970,66,0,0,0,66,A
7-M,971,0,0,67,0,67,G
7-M,972,66,0,0,0,66,A
7-M,973,0,0,65,0,65,G
7-M,974,0,62,0,0,62,T
7-M,975,0,44,0,0,44,T
7-M,976,0,0,45,0,45,G
7-M,977,0,0,44,0,44,G
7-M,978,42,0,0,0,42,A
7-M,979,0,0,43,0,43,G
7-M,980,0,34,0,0,34,T
7-M,981,33,0,0,0,33,A
7-M,982,33,0,0,0,33,A
8-NS,1,460,0,0,0,460,A
8-NS,2,0,466,0,0,466,T
8-NS,3,0,0,486,0,486,G
8-NS,4,2,0,518,0,520,G
8-NS,5,554,0,0,0,554,A
8-NS,6,0,1088,0,0,1088,T
8-NS,7,0,1097,0,0,1097,T
8-NS,8,0,0,0,1139,1139,C
8-NS,9,0,1,0,1132,1133,C
8-NS,10,1139,0,0,0,1139,A
8-NS,11,1150,0,1,0,1151,A
8-NS,12,0,0,0,1146,1146,C
8-NS,13,1152,1,0,0,1153,A
8-NS,14,0,0,0,1163,1163,C
8-NS,15,0,1173,0,1,1174,T
8-NS,16,0,0,1269,0,1269,G
8-NS,17,0,1267,0,1,1268,T
8-NS,18,0,0,1287,0,1287,G
8-NS,19,0,1287,0,2,1289,T
8-NS,20,3,0,0,1289,1292,C
8-NS,21,1293,0,0,0,1293,A
8-NS,22,1292,1,1,0,1294,A
8-NS,23,0,0,1301,0,1301,G
8-NS,24,0,1339,0,0,1339,T
8-NS,25,0,1338,0,0,1338,T
8-NS,26,0,1346,0,0,1346,T
8-NS,27,2,0,0,1345,1347,C
8-NS,28,1,1,0,1355,1357,C
8-NS,29,1356,0,1,0,1357,A
8-NS,30,0,2,1368,0,1370,G
8-NS,31,0,0,1373,0,1373,G
8-NS,32,0,1334,0,1,1335,T
8-NS,33,1394,0,0,0,1394,A
8-NS,34,1,2,1402,0,1405,G
8-NS,35,1399,0,0,0,1399,A
8-NS,36,0,1409,0,0,1409,T
8-NS,37,0,1399,0,8,1407,T
8-NS,38,0,0,1420,0,1420,G
8-NS,39,0,0,0,1421,1421,C
8-NS,40,0,1429,0,3,1432,T
8-NS,41,0,1444,0,0,1444,T
8-NS,42,0,1450,0,0,1450,T
8-NS,43,0,0,0,1467,1467,C
8-NS,44,0,1463,0,1,1464,T
8-NS,45,0,1474,0,0,1474,T
8-NS,46,0,1468,0,1,1469,T
8-NS,47,0,2,1481,0,1483,G
8-NS,48,0,0,1465,0,1465,G
8-NS,49,0,0,1,1479,1480,C
8-NS,50,1481,0,0,0,1481,A
8-NS,51,0,1486,0,0,1486,T
8-NS,52,1500,0,0,0,1500,A
8-NS,53,1,1532,0,0,1533,T
8-NS,54,2,1,0,1538,1541,C
8-NS,55,2,1,0,1533,1536,C
8-NS,56,1,1,1529,0,1531,G
8-NS,57,0,1,1530,0,1531,G
8-NS,58,1540,0,2,0,1542,A
8-NS,59,1556,0,0,0,1556,A
8-NS,60,1563,0,0,0,1563,A
8-NS,61,0,0,0,1596,1596,C
8-NS,62,1597,0,1,0,1598,A
8-NS,63,1590,1,2,0,1593,A
8-NS,64,0,0,1673,0,1673,G
8-NS,65,0,1677,0,0,1677,T
8-NS,66,0,1685,0,0,1685,T
8-NS,67,2,2,1687,0,1691,G
8-NS,68,0,1687,2,1,1690,T
8-NS,69,1692,0,1,0,1693,A
8-NS,70,0,6,1699,0,1705,G
8-NS,71,1801,0,2,0,1803,A
8-NS,72,1,0,0,1826,1827,C
8-NS,73,4,1,0,1802,1807,C
8-NS,74,1816,0,0,0,1816,A
8-NS,75,1822,0,1,0,1823,A
8-NS,76,0,6,1924,0,1930,G
8-NS,77,1928,0,0,0,1928,A
8-NS,78,1948,0,1,0,1949,A
8-NS,79,0,0,0,1956,1956,C
8-NS,80,0,1940,0,2,1942,T
8-NS,81,10,2,1958,0,1970,G
8-NS,82,1933,0,4,0,1937,A
8-NS,83,0,0,1998,0,1998,G
8-NS,84,0,2017,0,1,2018,T
8-NS,85,1,3,1984,0,1988,G
8-NS,86,2001,0,1,0,2002,A
8-NS,87,1,2022,0,0,2023,T
8-NS,88,0,1,2038,0,2039,G
8-NS,89,0,2,0,2061,2063,C
8-NS,90,2,2,0,2063,2067,C
8-NS,91,1,0,0,2096,2097,C
8-NS,92,3,0,1,2093,2097,C
8-NS,93,2109,0,1,0,2110,A
8-NS,94,0,2142,0,1,2143,T
8-NS,95,0,2162,0,0,2162,T
8-NS,96,0,0,0,2168,2168,C
8-NS,97,1,0,0,2173,2174,C
8-NS,98,1,2179,0,3,2183,T
8-NS,99,1,2169,0,2,2172,T
8-NS,100,0,7,2164,0,2171,G
8-NS,101,2158,0,1,0,2159,A
8-NS,102,0,2174,0,1,2175,T
8-NS,103,1,0,0,2176,2177,C
8-NS,104,0,1,2144,0,2145,G
8-NS,105,2,1,2135,0,2138,G
8-NS,106,1,0,1,2170,2172,C
8-NS,107,0,2150,0,0,2150,T
8-NS,108,0,2184,0,0,2184,T
8-NS,109,3,0,0,2180,2183,C
8-NS,110,6,1,2180,0,2187,G
8-NS,111,1,0,0,2194,2195,C
8-NS,112,1,0,0,2199,2200,C
8-NS,113,2,7,2200,0,2209,G
8-NS,114,2163,1,0,1,2165,A
8-NS,115,0,0,2248,0,2248,G
8-NS,116,2236,0,0,0,2236,A
8-NS,117,0,2257,0,0,2257,T
8-NS,118,1,0,0,2267,2268,C
8-NS,119,2262,0,1,0,2263,A
8-NS,120,1,0,2250,0,2251,G
8-NS,121,2243,0,3,0,2246,A
8-NS,122,0,3,2267,0,2270,G
8-NS,123,0,0,2309,0,2309,G
8-NS,124,0,2319,0,0,2319,T
8-NS,125,2,0,0,2447,2449,C
8-NS,126,2,0,0,2461,2463,C
8-NS,127,3,0,0,2499,2502,C
8-NS,128,0,2488,0,16,2504,T
8-NS,129,2502,0,0,0,2502,A
8-NS,130,2493,0,0,0,2493,A
8-NS,131,0,1,2540,0,2541,G
8-NS,132,0,2,2524,0,2526,G
8-NS,133,1,3,2491,0,2495,G
8-NS,134,0,3,2466,0,2469,G
8-NS,135,2451,0,0,0,2451,A
8-NS,136,2498,1,3,0,2502,A
8-NS,137,0,1,2526,0,2527,G
8-NS,138,2555,0,2,0,2557,A
8-NS,139,0,1,2595,0,2596,G
8-NS,140,0,2,2558,0,2560,G
8-NS,141,0,0,0,2626,2626,C
8-NS,142,2617,0,1,0,2618,A
8-NS,143,2626,0,4,0,2630,A
8-NS,144,0,2622,0,22,2644,T
8-NS,145,2666,0,1,0,2667,A
8-NS,146,0,0,0,2711,2711,C
8-NS,147,0,2683,0,0,2683,T
8-NS,148,1,0,0,2678,2679,C
8-NS,149,0,2624,0,1,2625,T
8-NS,150,2,1,0,2668,2671,C
8-NS,151,0,1,2692,0,2693,G
8-NS,152,1,0,2820,0,2821,G
8-NS,153,0,2798,0,2,2800,T
8-NS,154,3,0,0,2849,2852,C
8-NS,155,0,2814,0,1,2815,T
8-NS,156,2855,0,0,1,2856,A
8-NS,157,0,4,2845,0,2849,G
8-NS,158,2850,0,1,0,2851,A
8-NS,159,2,1,0,2915,2918,C
8-NS,160,2882,1,1,0,2884,A
8-NS,161,0,2849,0,16,2865,T
8-NS,162,1,0,0,2867,2868,C
8-NS,163,2856,0,0,0,2856,A
8-NS,164,2852,0,0,0,2852,A
8-NS,165,2834,0,0,0,2834,A
8-NS,166,1,1,2830,0,2832,G
8-NS,167,2,0,0,2866,2868,C
8-NS,168,2809,0,4,4,2817,A
8-NS,169,0,1,2821,0,2822,G
8-NS,170,1,2,0,2830,2833,C
8-NS,171,5,1,0,2842,2848,C
8-NS,172,2867,0,3,0,2870,A
8-NS,173,3,0,0,2898,2901,C
8-NS,174,7,0,0,2898,2905,C
8-NS,175,2,1,0,2908,2911,C
8-NS,176,2910,28,1,0,2939,A
8-NS,177,0,2956,0,0,2956,T
8-NS,178,0,4,2961,0,2965,G
8-NS,179,0,2944,0,0,2944,T
8-NS,180,0,2955,0,0,2955,T
8-NS,181,0,4,2929,0,2933,G
8-NS,182,0,4,2901,0,2905,G
8-NS,183,2873,0,2,1,2876,A
8-NS,184,2900,1,0,0,2901,A
8-NS,185,2872,0,1,0,2873,A
8-NS,186,3,2,2896,0,2901,G
8-NS,187,1,1,0,2903,2905,C
8-NS,188,2895,0,1,0,2896,A
8-NS,189,2882,2,8,1,2893,A
8-NS,190,2881,0,1,0,2882,A
8-NS,191,0,2907,0,11,2918,T
8-NS,192,0,2922,0,12,2934,T
8-NS,193,0,0,2969,0,2969,G
8-NS,194,0,2936,0,13,2949,T
8-NS,195,2961,1,1,0,2963,A
8-NS,196,1,4,2951,0,2956,G
8-NS,197,2946,0,0,0,2946,A
8-NS,198,2949,1,0,0,2950,A
8-NS,199,2956,0,0,0,2956,A
8-NS,200,2948,0,1,1,2950,A
8-NS,201,0,2,2954,0,2956,G
8-NS,202,2932,0,1,0,2933,A
8-NS,203,0,2952,0,0,2952,T
8-NS,204,0,2959,0,0,2959,T
8-NS,205,2,0,0,2953,2955,C
8-NS,206,0,2960,1,0,2961,T
8-NS,207,1,6,2948,0,2955,G
8-NS,208,2952,0,0,0,2952,A
8-NS,209,2955,0,1,0,2956,A
8-NS,210,2956,0,1,0,2957,A
8-NS,211,1,3,2957,0,2961,G
8-NS,212,2966,0,1,0,2967,A
8-NS,213,2963,0,0,0,2963,A
8-NS,214,0,2,2989,0,2991,G
8-NS,215,2990,0,1,0,2991,A
8-NS,216,3004,0,2,0,3006,A
8-NS,217,0,3014,0,0,3014,T
8-NS,218,8,0,0,3030,3038,C
8-NS,219,0,3025,0,12,3037,T
8-NS,220,0,1,3048,0,3049,G
8-NS,221,3037,0,1,0,3038,A
8-NS,222,0,3050,0,0,3050,T
8-NS,223,2,4,3033,0,3039,G
8-NS,224,3015,0,3,1,3019,A
8-NS,225,2,5,3003,0,3010,G
8-NS,226,0,1,3003,0,3004,G
8-NS,227,2,1,0,3008,3011,C
8-NS,228,3006,0,1,0,3007,A
8-NS,229,0,0,0,3098,3098,C
8-NS,230,0,3076,0,15,3091,T
8-NS,231,0,3092,0,9,3101,T
8-NS,232,3123,0,1,0,3124,A
8-NS,233,3130,0,1,0,3131,A
8-NS,234,3124,1,2,0,3127,A
8-NS,235,3118,0,1,0,3119,A
8-NS,236,0,3116,0,0,3116,T
8-NS,237,1,6,3106,0,3113,G
8-NS,238,3117,0,1,0,3118,A
8-NS,239,1,1,0,3119,3121,C
8-NS,240,2,0,1,3104,3107,C
8-NS,241,3135,0,0,0,3135,A
8-NS,242,0,3123,0,1,3124,T
8-NS,243,0,5,3181,0,3186,G
8-NS,244,37,3,3164,0,3204,G
8-NS,245,0,3187,0,0,3187,T
8-NS,246,4,0,0,3329,3333,C
8-NS,247,0,3310,0,5,3315,T
8-NS,248,3,2,1,3332,3338,C
8-NS,249,1,2,0,3346,3349,C
8-NS,250,3374,0,3,1,3378,A
8-NS,251,0,1,0,3407,3408,C
8-NS,252,3359,0,2,0,3361,A
8-NS,253,1,1,0,3373,3375,C
8-NS,254,0,1,1,3347,3349,C
8-NS,255,1,3208,0,1,3210,T
8-NS,256,11,1,3250,0,3262,G
8-NS,257,0,0,0,3245,3245,C
8-NS,258,1,3199,0,1,3201,T
8-NS,259,0,3245,0,0,3245,T
8-NS,260,3,4,0,3259,3266,C
8-NS,261,1,1,3268,0,3270,G
8-NS,262,1,2,0,3276,3279,C
8-NS,263,0,4,3283,0,3287,G
8-NS,264,3392,0,1,0,3393,A
8-NS,265,0,3408,0,1,3409,T
8-NS,266,3510,0,2,0,3512,A
8-NS,267,1,1,0,3530,3532,C
8-NS,268,3521,1,0,0,3522,A
8-NS,269,0,3577,0,1,3578,T
8-NS,270,3564,0,1,1,3566,A
8-NS,271,3578,2,0,0,3580,A
8-NS,272,1,0,0,3578,3579,C
8-NS,273,1,3482,0,1,3484,T
8-NS,274,3,8,3531,0,3542,G
8-NS,275,3485,1,3,1,3490,A
8-NS,276,1,0,0,3507,3508,C
8-NS,277,3487,0,0,0,3487,A
8-NS,278,0,3468,0,1,3469,T
8-NS,279,0,7,3470,0,3477,G
8-NS,280,3475,1,1,0,3477,A
8-NS,281,1,1,0,3564,3566,C
8-NS,282,0,3574,0,0,3574,T
8-NS,283,3621,0,1,0,3622,A
8-NS,284,0,3596,0,1,3597,T
8-NS,285,0,3608,0,2,3610,T
8-NS,286,0,2,3631,0,3633,G
8-NS,287,3612,1,3,0,3616,A
8-NS,288,1,2,3602,0,3605,G
8-NS,289,0,11,3582,0,3593,G
8-NS,290,3511,0,1,0,3512,A
8-NS,291,3537,0,1,0,3538,A
8-NS,292,0,3485,0,1,3486,T
8-NS,293,0,3524,0,1,3525,T
8-NS,294,1,0,3564,0,3565,G
8-NS,295,1,3551,0,2,3554,T
8-NS,296,7,0,0,3571,3578,C
8-NS,297,3579,0,0,0,3579,A
8-NS,298,3582,0,0,0,3582,A
8-NS,299,0,7,3570,0,3577,G
8-NS,300,3581,1,0,0,3582,A
8-NS,301,3571,0,2,0,3573,A
8-NS,302,3556,1,0,0,3557,A
8-NS,303,1,0,0,3593,3594,C
8-NS,304,0,3553,0,0,3553,T
8-NS,305,1,7,3620,0,3628,G
8-NS,306,0,1,3648,0,3649,G
8-NS,307,0,3629,1,0,3630,T
8-NS,308,0,3641,0,1,3642,T
8-NS,309,4,1,0,3633,3638,C
8-NS,310,3654,0,1,1,3656,A
8-NS,311,1,3690,0,3,3694,T
8-NS,312,2,0,3708,0,3710,G
8-NS,313,1,1,0,3693,3695,C
8-NS,314,0,3682,0,2,3684,T
8-NS,315,3628,0,1,1,3630,A
8-NS,316,3649,0,0,0,3649,A
8-NS,317,0,3661,0,0,3661,T
8-NS,318,1,1,3661,0,3663,G
8-NS,319,1,0,0,3628,3629,C
8-NS,320,3,0,0,3553,3556,C
8-NS,321,8,0,1,3582,3591,C
8-NS,322,3626,0,2,0,3628,A
8-NS,323,3655,0,0,0,3655,A
8-NS,324,1,1,3630,0,3632,G
8-NS,325,1,1,0,3645,3647,C
8-NS,326,3653,0,0,0,3653,A
8-NS,327,0,3,3664,0,3667,G
8-NS,328,3655,1,0,0,3656,A
8-NS,329,3657,1,1,1,3660,A
8-NS,330,3669,0,2,1,3672,A
8-NS,331,0,0,3703,0,3703,G
8-NS,332,0,3645,0,2,3647,T
8-NS,333,1,1,3675,0,3677,G
8-NS,334,0,1,3666,0,3667,G
8-NS,335,3685,0,2,1,3688,A
8-NS,336,3670,1,7,0,3678,A
8-NS,337,0,2,3642,0,3644,G
8-NS,338,0,1,3648,1,3650,G
8-NS,339,3657,0,1,1,3659,A
8-NS,340,3,0,0,3612,3615,C
8-NS,341,0,1,0,3638,3639,C
8-NS,342,0,3644,0,1,3645,T
8-NS,343,5,0,1,3661,3667,C
8-NS,344,0,3675,0,0,3675,T
8-NS,345,0,3692,0,0,3692,T
8-NS,346,0,3704,0,1,3705,T
8-NS,347,1,1,3689,0,3691,G
8-NS,348,1,0,0,3705,3706,C
8-NS,349,3709,0,2,1,3712,A
8-NS,350,0,3671,0,5,3676,T
8-NS,351,4,8,0,3695,3707,C
8-NS,352,3730,0,1,1,3732,A
8-NS,353,0,2,3809,0,3811,G
8-NS,354,3785,0,0,6,3791,A
8-NS,355,3793,1,0,1,3795,A
8-NS,356,0,3793,1,1,3795,T
8-NS,357,0,4,3754,0,3758,G
8-NS,358,12,4,3752,0,3768,G
8-NS,359,3764,0,5,1,3770,A
8-NS,360,2,0,0,3737,3739,C
8-NS,361,2,0,0,3690,3692,C
8-NS,362,3647,0,2,1,3650,A
8-NS,363,1,3,3677,0,3681,G
8-NS,364,3,1,3678,0,3682,G
8-NS,365,4,1,0,3690,3695,C
8-NS,366,3684,0,0,1,3685,A
8-NS,367,3692,0,1,1,3694,A
8-NS,368,0,3678,0,0,3678,T
8-NS,369,11,0,0,3679,3690,C
8-NS,370,3702,0,0,1,3703,A
8-NS,371,1,3676,0,0,3677,T
8-NS,372,0,3,3644,1,3648,G
8-NS,373,2,11,3648,0,3661,G
8-NS,374,3633,0,2,1,3636,A
8-NS,375,2,5,3670,0,3677,G
8-NS,376,3608,0,0,0,3608,A
8-NS,377,3648,0,0,0,3648,A
8-NS,378,3654,0,0,1,3655,A
8-NS,379,3642,0,1,0,3643,A
8-NS,380,3657,0,2,1,3660,A
8-NS,381,1,0,0,3666,3667,C
8-NS,382,3651,1,1,0,3653,A
8-NS,383,0,3605,0,0,3605,T
8-NS,384,1,2,0,3617,3620,C
8-NS,385,3617,0,3,2,3622,A
8-NS,386,0,3628,0,1,3629,T
8-NS,387,1,1,3630,0,3632,G
8-NS,388,0,3627,0,3,3630,T
8-NS,389,0,3616,0,2,3618,T
8-NS,390,1,2,3607,2,3612,G
8-NS,391,3586,0,5,0,3591,A
8-NS,392,3589,0,1,1,3591,A
8-NS,393,3589,0,2,1,3592,A
8-NS,394,0,0,3575,0,3575,G
8-NS,395,3,1,0,3543,3547,C
8-NS,396,0,4,3566,0,3570,G
8-NS,397,3569,1,2,0,3572,A
8-NS,398,3564,0,1,0,3565,A
8-NS,399,0,3533,0,0,3533,T
8-NS,400,0,3538,0,2,3540,T
8-NS,401,0,3548,0,0,3548,T
8-NS,402,8,1,1,3563,3573,C
8-NS,403,3551,0,3,0,3554,A
8-NS,404,1,0,3550,0,3551,G
8-NS,405,0,3542,0,2,3544,T
8-NS,406,1,0,3543,0,3544,G
8-NS,407,1,3526,0,3,3530,T
8-NS,408,0,6,3537,0,3543,G
8-NS,409,3547,0,1,0,3548,A
8-NS,410,0,3533,0,1,3534,T
8-NS,411,0,3533,0,0,3533,T
8-NS,412,1,3503,0,1,3505,T
8-NS,413,1,3511,0,1,3513,T
8-NS,414,0,3534,0,0,3534,T
8-NS,415,1,7,3537,0,3545,G
8-NS,416,3516,1,3,0,3520,A
8-NS,417,0,3431,0,0,3431,T
8-NS,418,8,0,1,3501,3510,C
8-NS,419,0,6,3523,0,3529,G
8-NS,420,3682,0,1,0,3683,A
8-NS,421,2,0,0,3717,3719,C
8-NS,422,0,3745,0,0,3745,T
8-NS,423,3767,0,2,0,3769,A
8-NS,424,0,1,3758,0,3759,G
8-NS,425,3762,0,10,0,3772,A
8-NS,426,0,6,3786,0,3792,G
8-NS,427,3772,0,1,0,3773,A
8-NS,428,1,1,0,3855,3857,C
8-NS,429,5,2,1,3719,3727,C
8-NS,430,3672,0,1,0,3673,A
8-NS,431,0,3833,0,1,3834,T
8-NS,432,3821,0,2,0,3823,A
8-NS,433,1,1,4095,1,4098,G
8-NS,434,1,4034,0,0,4035,T
8-NS,435,4030,0,1,0,4031,A
8-NS,436,0,4017,0,1,4018,T
8-NS,437,0,3920,0,0,3920,T
8-NS,438,3986,0,0,0,3986,A
8-NS,439,0,0,0,3977,3977,C
8-NS,440,0,3830,0,0,3830,T
8-NS,441,3833,0,0,0,3833,A
8-NS,442,3479,1,2,0,3482,A
8-NS,443,0,2,3495,0,3497,G
8-NS,444,0,4,3465,0,3469,G
8-NS,445,0,0,3469,0,3469,G
8-NS,446,0,0,0,3441,3441,C
8-NS,447,1,3400,0,3,3404,T
8-NS,448,0,3400,0,0,3400,T
8-NS,449,0,3425,0,0,3425,T
8-NS,450,2,0,0,3424,3426,C
8-NS,451,3452,0,2,0,3454,A
8-NS,452,0,0,0,3478,3478,C
8-NS,453,3,0,0,3447,3450,C
8-NS,454,0,2,3460,0,3462,G
8-NS,455,3397,0,0,0,3397,A
8-NS,456,3429,0,0,0,3429,A
8-NS,457,0,3,3450,0,3453,G
8-NS,458,3438,0,0,0,3438,A
8-NS,459,1,1,3454,0,3456,G
8-NS,460,0,3,3396,1,3400,G
8-NS,461,0,6,3432,0,3438,G
8-NS,462,3411,0,6,0,3417,A
8-NS,463,1,4,3409,0,3414,G
8-NS,464,0,1,0,3407,3408,C
8-NS,465,3433,0,0,0,3433,A
8-NS,466,3434,0,1,0,3435,A
8-NS,467,0,3433,0,0,3433,T
8-NS,468,1,3425,0,0,3426,T
8-NS,469,0,1,3412,0,3413,G
8-NS,470,0,3377,0,0,3377,T
8-NS,471,0,3364,0,3,3367,T
8-NS,472,1,3,3373,0,3377,G
8-NS,473,1,1,3361,0,3363,G
8-NS,474,1,2,0,3351,3354,C
8-NS,475,1,3,3379,0,3383,G
8-NS,476,3389,0,0,0,3389,A
8-NS,477,3400,0,0,0,3400,A
8-NS,478,3406,0,0,0,3406,A
8-NS,479,0,3416,0,0,3416,T
8-NS,480,4,1,0,3400,3405,C
8-NS,481,0,3377,0,2,3379,T
8-NS,482,6,0,0,3382,3388,C
8-NS,483,3401,0,3,0,3404,A
8-NS,484,1,1,0,3395,3397,C
8-NS,485,6,0,0,3405,3411,C
8-NS,486,3388,0,0,0,3388,A
8-NS,487,0,3371,1,1,3373,T
8-NS,488,0,3344,0,2,3346,T
8-NS,489,0,4,3342,0,3346,G
8-NS,490,1,1,0,3301,3303,C
8-NS,491,0,0,0,3317,3317,C
8-NS,492,0,3324,0,5,3329,T
8-NS,493,0,3296,0,1,3297,T
8-NS,494,4,0,1,3299,3304,C
8-NS,495,0,3307,0,1,3308,T
8-NS,496,0,3321,0,0,3321,T
8-NS,497,0,3356,0,0,3356,T
8-NS,498,1,3326,0,0,3327,T
8-NS,499,4,0,0,3352,3356,C
8-NS,500,3,1,0,3351,3355,C
8-NS,501,3360,0,1,0,3361,A
8-NS,502,0,1,3386,0,3387,G
8-NS,503,0,3,3361,1,3365,G
8-NS,504,3416,0,1,0,3417,A
8-NS,505,0,1,0,3422,3423,C
8-NS,506,3434,0,1,0,3435,A
8-NS,507,0,3426,2,2,3430,T
8-NS,508,3417,0,2,0,3419,A
8-NS,509,1,2,1,3636,3640,C
8-NS,510,0,3622,1,5,3628,T
8-NS,511,3614,0,0,0,3614,A
8-NS,512,0,3577,0,0,3577,T
8-NS,513,0,3514,0,0,3514,T
8-NS,514,0,5,3508,0,3513,G
8-NS,515,3391,0,2,0,3393,A
8-NS,516,0,4,3395,0,3399,G
8-NS,517,0,1,3390,0,3391,G
8-NS,518,3141,0,0,1,3142,A
8-NS,519,0,3162,0,1,3163,T
8-NS,520,0,0,3133,0,3133,G
8-NS,521,3,3094,0,1,3098,T
8-NS,522,6,1,0,3105,3112,C
8-NS,523,3135,0,1,10,3146,A
8-NS,524,3151,0,0,0,3151,A
8-NS,525,3139,1,0,0,3140,A
8-NS,526,3130,0,0,0,3130,A
8-NS,527,3133,0,0,0,3133,A
8-NS,528,0,3130,0,0,3130,T
8-NS,529,2,2,3123,0,3127,G
8-NS,530,0,0,0,3141,3141,C
8-NS,531,3155,0,0,0,3155,A
8-NS,532,3142,0,1,0,3143,A
8-NS,533,0,3145,0,3,3148,T
8-NS,534,0,3162,0,0,3162,T
8-NS,535,0,3,3157,0,3160,G
8-NS,536,0,2,3112,0,3114,G
8-NS,537,0,3,3080,0,3083,G
8-NS,538,1,1,3117,0,3119,G
8-NS,539,0,3078,0,4,3082,T
8-NS,540,5,0,0,3072,3077,C
8-NS,541,1,0,0,3082,3083,C
8-NS,542,0,3074,0,6,3080,T
8-NS,543,9,0,0,3102,3111,C
8-NS,544,3111,1,0,0,3112,A
8-NS,545,0,3062,0,0,3062,T
8-NS,546,4,0,0,3107,3111,C
8-NS,547,0,4,3086,0,3090,G
8-NS,548,0,3,3088,0,3091,G
8-NS,549,3052,0,2,0,3054,A
8-NS,550,0,4,3067,0,3071,G
8-NS,551,0,1,3070,0,3071,G
8-NS,552,3048,0,3,0,3051,A
8-NS,553,0,0,0,3074,3074,C
8-NS,554,0,3076,0,0,3076,T
8-NS,555,0,3078,0,1,3079,T
8-NS,556,0,3,3085,0,3088,G
8-NS,557,3073,1,0,0,3074,A
8-NS,558,3074,0,5,0,3079,A
8-NS,559,0,3077,0,0,3077,T
8-NS,560,0,4,3029,0,3033,G
8-NS,561,0,7,3036,0,3043,G
8-NS,562,2995,0,0,0,2995,A
8-NS,563,3010,0,3,0,3013,A
8-NS,564,0,3122,1,0,3123,T
8-NS,565,0,3,3141,0,3144,G
8-NS,566,3144,0,3,0,3147,A
8-NS,567,0,3140,0,1,3141,T
8-NS,568,3151,1,1,0,3153,A
8-NS,569,3154,0,3,0,3157,A
8-NS,570,2,0,0,3118,3120,C
8-NS,571,3077,0,1,0,3078,A
8-NS,572,1,1,0,3096,3098,C
8-NS,573,2918,0,1,0,2919,A
8-NS,574,1,0,2943,0,2944,G
8-NS,575,0,2926,0,0,2926,T
8-NS,576,0,2900,0,1,2901,T
8-NS,577,3,0,0,2922,2925,C
8-NS,578,15,5,2902,0,2922,G
8-NS,579,2908,0,0,0,2908,A
8-NS,580,0,1,2928,0,2929,G
8-NS,581,0,2874,0,2,2876,T
8-NS,582,2,0,0,2859,2861,C
8-NS,583,0,2827,0,5,2832,T
8-NS,584,3,1,0,2817,2821,C
8-NS,585,0,2877,0,0,2877,T
8-NS,586,2878,0,0,0,2878,A
8-NS,587,2874,0,0,0,2874,A
8-NS,588,2856,0,0,0,2856,A
8-NS,589,2890,0,0,0,2890,A
8-NS,590,2888,0,0,0,2888,A
8-NS,591,0,2845,0,2,2847,T
8-NS,592,3,0,0,2877,2880,C
8-NS,593,0,2850,0,2,2852,T
8-NS,594,2863,0,1,0,2864,A
8-NS,595,2,0,0,2870,2872,C
8-NS,596,2869,1,0,0,2870,A
8-NS,597,0,2,2862,0,2864,G
8-NS,598,2813,0,3,0,2816,A
8-NS,599,0,5,2817,0,2822,G
8-NS,600,2814,0,0,0,2814,A
8-NS,601,0,2764,0,0,2764,T
8-NS,602,0,2761,0,0,2761,T
8-NS,603,4,1,0,2760,2765,C
8-NS,604,1,0,2776,0,2777,G
8-NS,605,1,0,0,2748,2749,C
8-NS,606,1,2735,0,3,2739,T
8-NS,607,0,2769,0,0,2769,T
8-NS,608,0,5,2761,0,2766,G
8-NS,609,0,6,2762,0,2768,G
8-NS,610,2784,1,0,0,2785,A
8-NS,611,0,4,2782,0,2786,G
8-NS,612,2783,0,2,0,2785,A
8-NS,613,2769,0,1,0,2770,A
8-NS,614,0,0,2787,1,2788,G
8-NS,615,2,1,0,2782,2785,C
8-NS,616,2795,0,2,0,2797,A
8-NS,617,1,1,2822,0,2824,G
8-NS,618,0,2788,0,0,2788,T
8-NS,619,2822,1,0,0,2823,A
8-NS,620,2817,0,0,0,2817,A
8-NS,621,0,2813,0,0,2813,T
8-NS,622,0,3,2830,0,2833,G
8-NS,623,2738,0,2,0,2740,A
8-NS,624,0,2,2801,0,2803,G
8-NS,625,2781,0,2,0,2783,A
8-NS,626,2707,0,0,0,2707,A
8-NS,627,0,2688,0,0,2688,T
8-NS,628,2604,0,1,0,2605,A
8-NS,629,0,2,2614,0,2616,G
8-NS,630,0,3,2601,0,2604,G
8-NS,631,1,1,2580,0,2582,G
8-NS,632,0,1,2612,0,2613,G
8-NS,633,2490,0,2,0,2492,A
8-NS,634,1,1,0,2470,2472,C
8-NS,635,7,0,0,2449,2456,C
8-NS,636,1,2368,0,9,2378,T
8-NS,637,3,0,0,2397,2400,C
8-NS,638,0,1,1,2420,2422,C
8-NS,639,2444,0,0,0,2444,A
8-NS,640,6,0,1,2433,2440,C
8-NS,641,0,2410,1,0,2411,T
8-NS,642,0,2405,1,0,2406,T
8-NS,643,2345,1,1,0,2347,A
8-NS,644,0,0,0,2326,2326,C
8-NS,645,0,2287,1,4,2292,T
8-NS,646,3,0,0,2304,2307,C
8-NS,647,3,3,0,2293,2299,C
8-NS,648,2296,0,0,0,2296,A
8-NS,649,2308,0,0,0,2308,A
8-NS,650,2298,0,0,0,2298,A
8-NS,651,2305,0,0,0,2305,A
8-NS,652,1,0,0,2298,2299,C
8-NS,653,2261,0,0,0,2261,A
8-NS,654,0,4,2259,0,2263,G
8-NS,655,2252,0,0,0,2252,A
8-NS,656,2244,0,0,0,2244,A
8-NS,657,2247,0,2,0,2249,A
8-NS,658,0,3,0,2240,2243,C
8-NS,659,0,0,2250,0,2250,G
8-NS,660,1,1,2248,0,2250,G
8-NS,661,1,4,2244,0,2249,G
8-NS,662,2243,0,1,0,2244,A
8-NS,663,2249,0,0,0,2249,A
8-NS,664,2249,0,0,0,2249,A
8-NS,665,0,2226,1,1,2228,T
8-NS,666,0,2,2244,0,2246,G
8-NS,667,0,2,2230,0,2232,G
8-NS,668,1,7,0,2199,2207,C
8-NS,669,2,0,2225,0,2227,G
8-NS,670,2218,0,0,0,2218,A
8-NS,671,1,2,2216,0,2219,G
8-NS,672,2221,0,0,0,2221,A
8-NS,673,2219,0,1,0,2220,A
8-NS,674,2,0,0,2207,2209,C
8-NS,675,2186,0,1,0,2187,A
8-NS,676,0,0,2164,0,2164,G
8-NS,677,0,0,0,2148,2148,C
8-NS,678,0,2176,0,0,2176,T
8-NS,679,2174,0,0,0,2174,A
8-NS,680,0,2,2141,1,2144,G
8-NS,681,1,0,2137,0,2138,G
8-NS,682,0,2075,1,30,2106,T
8-NS,683,7,0,0,2092,2099,C
8-NS,684,2111,0,0,0,2111,A
8-NS,685,2102,0,10,0,2112,A
8-NS,686,2109,0,1,0,2110,A
8-NS,687,2116,0,0,0,2116,A
8-NS,688,0,0,2108,0,2108,G
8-NS,689,0,2058,1,1,2060,T
8-NS,690,0,2048,1,0,2049,T
8-NS,691,0,2055,1,3,2059,T
8-NS,692,1,1,2061,0,2063,G
8-NS,693,2081,0,1,0,2082,A
8-NS,694,2080,0,0,0,2080,A
8-NS,695,0,3,2079,0,2082,G
8-NS,696,2040,0,0,0,2040,A
8-NS,697,0,1,2035,0,2036,G
8-NS,698,2032,0,0,0,2032,A
8-NS,699,0,2021,1,0,2022,T
8-NS,700,2038,0,0,0,2038,A
8-NS,701,2016,0,1,0,2017,A
8-NS,702,0,2,2009,0,2011,G
8-NS,703,1861,0,0,0,1861,A
8-NS,704,1,1842,0,0,1843,T
8-NS,705,0,2,1852,0,1854,G
8-NS,706,1,0,1845,0,1846,G
8-NS,707,2,0,0,1811,1813,C
8-NS,708,0,1840,0,0,1840,T
8-NS,709,1837,0,0,1,1838,A
8-NS,710,1836,0,0,2,1838,A
8-NS,711,0,1837,0,0,1837,T
8-NS,712,0,1835,0,0,1835,T
8-NS,713,0,1,1829,0,1830,G
8-NS,714,1802,0,1,0,1803,A
8-NS,715,1793,0,1,0,1794,A
8-NS,716,0,2,1780,0,1782,G
8-NS,717,1794,0,0,0,1794,A
8-NS,718,1761,0,1,0,1762,A
8-NS,719,0,0,1761,0,1761,G
8-NS,720,0,1719,0,1,1720,T
8-NS,721,0,4,1712,0,1716,G
8-NS,722,1711,0,2,0,1713,A
8-NS,723,0,1,1711,0,1712,G
8-NS,724,1706,0,5,0,1711,A
8-NS,725,0,0,0,1703,1703,C
8-NS,726,1687,0,1,0,1688,A
8-NS,727,0,0,0,1691,1691,C
8-NS,728,1567,0,0,0,1567,A
8-NS,729,1,0,1572,0,1573,G
8-NS,730,1570,0,1,0,1571,A
8-NS,731,0,1532,0,0,1532,T
8-NS,732,0,1546,0,0,1546,T
8-NS,733,1552,0,0,0,1552,A
8-NS,734,1539,0,1,0,1540,A
8-NS,735,1549,0,0,0,1549,A
8-NS,736,1535,1,1,0,1537,A
8-NS,737,1535,0,1,0,1536,A
8-NS,738,0,0,0,1487,1487,C
8-NS,739,1403,1,0,0,1404,A
8-NS,740,1400,0,0,0,1400,A
8-NS,741,0,0,0,1397,1397,C
8-NS,742,0,1387,0,1,1388,T
8-NS,743,0,1,1396,1,1398,G
8-NS,744,1395,0,0,0,1395,A
8-NS,745,1396,0,0,0,1396,A
8-NS,746,1397,0,0,0,1397,A
8-NS,747,1372,1,1,0,1374,A
8-NS,748,0,1368,0,0,1368,T
8-NS,749,1346,0,0,0,1346,A
8-NS,750,0,0,1329,0,1329,G
8-NS,751,0,2,0,1334,1336,C
8-NS,752,0,1293,0,0,1293,T
8-NS,753,0,1295,0,0,1295,T
8-NS,754,0,1289,0,0,1289,T
8-NS,755,0,9,1292,1,1302,G
8-NS,756,1297,0,0,0,1297,A
8-NS,757,1288,0,2,0,1290,A
8-NS,758,0,1,0,1300,1301,C
8-NS,759,1268,0,0,0,1268,A
8-NS,760,1262,0,1,0,1263,A
8-NS,761,1268,0,0,0,1268,A
8-NS,762,1,1251,0,1,1253,T
8-NS,763,1263,0,0,0,1263,A
8-NS,764,1225,1,3,0,1229,A
8-NS,765,0,0,0,1228,1228,C
8-NS,766,1223,0,2,0,1225,A
8-NS,767,0,1189,0,0,1189,T
8-NS,768,0,1153,0,0,1153,T
8-NS,769,3,0,1,1148,1152,C
8-NS,770,1143,0,2,0,1145,A
8-NS,771,0,1136,0,0,1136,T
8-NS,772,0,1,1138,0,1139,G
8-NS,773,0,0,0,1099,1099,C
8-NS,774,1099,0,0,0,1099,A
8-NS,775,1082,0,1,0,1083,A
8-NS,776,0,0,1078,0,1078,G
8-NS,777,1,0,0,1077,1078,C
8-NS,778,1057,0,0,0,1057,A
8-NS,779,0,1047,0,0,1047,T
8-NS,780,0,1041,0,0,1041,T
8-NS,781,1042,0,0,0,1042,A
8-NS,782,0,0,0,1037,1037,C
8-NS,783,1007,1,1,0,1009,A
8-NS,784,0,0,852,0,852,G
8-NS,785,0,0,0,846,846,C
8-NS,786,0,847,0,0,847,T
8-NS,787,0,0,852,0,852,G
8-NS,788,0,0,0,844,844,C
8-NS,789,0,838,0,0,838,T
8-NS,790,1,0,832,0,833,G
8-NS,791,0,828,0,2,830,T
8-NS,792,0,827,0,1,828,T
8-NS,793,0,827,0,1,828,T
8-NS,794,0,0,824,0,824,G
8-NS,795,827,0,1,0,828,A
8-NS,796,820,0,3,0,823,A
8-NS,797,0,0,822,0,822,G
8-NS,798,0,806,0,0,806,T
8-NS,799,0,0,756,0,756,G
8-NS,800,0,0,758,0,758,G
8-NS,801,762,0,0,0,762,A
8-NS,802,759,0,0,0,759,A
8-NS,803,3,1,0,745,749,C
8-NS,804,737,0,0,0,737,A
8-NS,805,0,0,730,1,731,G
8-NS,806,0,2,716,0,718,G
8-NS,807,708,0,2,0,710,A
8-NS,808,0,1,703,0,704,G
8-NS,809,583,0,0,0,583,A
8-NS,810,0,575,0,1,576,T
8-NS,811,577,0,0,0,577,A
8-NS,812,572,1,0,0,573,A
8-NS,813,0,3,567,0,570,G
8-NS,814,509,0,0,0,509,A
8-NS,815,504,0,0,0,504,A
8-NS,816,0,0,0,493,493,C
8-NS,817,0,419,0,0,419,T
8-NS,818,0,412,0,0,412,T
8-NS,819,0,401,0,0,401,T
8-NS,820,0,0,0,407,407,C
8-NS,821,0,394,0,0,394,T
8-NS,822,1,0,0,386,387,C
8-NS,823,374,0,0,0,374,A
8-NS,824,0,368,0,0,368,T
8-NS,825,0,363,0,1,364,T
8-NS,826,0,358,0,0,358,T
8-NS,827,1,1,0,358,360,C
8-NS,828,346,0,0,0,346,A
8-NS,829,0,0,344,0,344,G
8-NS,830,0,0,0,343,343,C
8-NS,831,0,316,0,0,316,T
8-NS,832,0,317,0,0,317,T
8-NS,833,307,0,0,0,307,A
8-NS,834,0,305,0,0,305,T
8-NS,835,0,300,0,0,300,T
8-NS,836,1,301,1,0,303,T
8-NS,837,292,0,0,0,292,A
8-NS,838,284,1,0,0,285,A
8-NS,839,0,280,0,0,280,T
8-NS,840,0,0,277,0,277,G
8-NS,841,268,0,0,0,268,A
8-NS,842,1,234,0,0,235,T
8-NS,843,229,0,1,0,230,A
8-NS,844,231,0,0,0,231,A
8-NS,845,230,1,0,0,231,A
8-NS,846,227,0,1,0,228,A
8-NS,847,228,0,0,0,228,A
8-NS,848,220,0,1,0,221,A
8-NS,849,0,0,0,221,221,C
8-NS,850,180,0,0,0,180,A
8-NS,851,1,0,0,193,194,C
8-NS,852,1,0,1,181,183,C
8-NS,853,0,0,0,178,178,C
8-NS,854,0,161,0,0,161,T
8-NS,855,0,153,0,0,153,T
8-NS,856,0,0,160,0,160,G
8-NS,857,0,149,0,0,149,T
8-NS,858,0,144,0,0,144,T
8-NS,859,0,142,0,0,142,T
8-NS,860,0,0,0,55,55,C
8-NS,861,0,37,0,0,37,T
8-NS,862,35,0,0,0,35,A
8-NS,863,0,0,0,35,35,C
