Gene,Position,A,T,G,C,Coverage,Consensus
1-PB2,1,241,0,0,0,241,A
1-PB2,2,0,242,0,0,242,T
1-PB2,3,0,0,251,0,251,G
1-PB2,4,0,0,252,0,252,G
1-PB2,5,252,0,0,0,252,A
1-PB2,6,251,0,0,0,251,A
1-PB2,7,250,0,0,0,250,A
1-PB2,8,0,1,274,0,275,G
1-PB2,9,277,0,0,0,277,A
1-PB2,10,277,0,0,0,277,A
1-PB2,11,0,284,0,0,284,T
1-PB2,12,284,0,0,0,284,A
1-PB2,13,284,0,0,0,284,A
1-PB2,14,284,0,0,0,284,A
1-PB2,15,284,0,0,0,284,A
1-PB2,16,0,1,298,0,299,G
1-PB2,17,298,0,1,0,299,A
1-PB2,18,300,0,0,0,300,A
1-PB2,19,0,0,0,311,311,C
1-PB2,20,0,310,0,0,310,T
1-PB2,21,316,0,0,0,316,A
1-PB2,22,0,0,0,316,316,C
1-PB2,23,0,1,315,0,316,G
1-PB2,24,0,1,317,0,318,G
1-PB2,25,319,0,0,0,319,A
1-PB2,26,332,1,0,0,333,A
1-PB2,27,0,332,0,0,332,T
1-PB2,28,0,0,0,334,334,C
1-PB2,29,0,334,0,0,334,T
1-PB2,30,0,0,337,0,337,G
1-PB2,31,337,0,0,0,337,A
1-PB2,32,0,338,0,0,338,T
1-PB2,33,0,0,340,0,340,G
1-PB2,34,1,341,0,0,342,T
1-PB2,35,2,0,0,340,342,C
1-PB2,36,1,1,340,0,342,G
1-PB2,37,0,0,0,340,340,C
1-PB2,38,339,0,1,0,340,A
1-PB2,39,0,0,358,0,358,G
1-PB2,40,0,357,0,0,357,T
1-PB2,41,1,0,0,355,356,C
1-PB2,42,0,354,0,2,356,T
1-PB2,43,0,0,0,355,355,C
1-PB2,44,0,0,354,0,354,G
1-PB2,45,1,0,0,354,355,C
1-PB2,46,354,0,0,1,355,A
1-PB2,47,0,1,0,358,359,C
1-PB2,48,1,357,0,0,358,T
1-PB2,49,0,2,0,359,361,C
1-PB2,50,0,0,365,0,365,G
1-PB2,51,0,0,0,365,365,C
1-PB2,52,0,1,363,0,364,G
1-PB2,53,364,0,0,0,364,A
1-PB2,54,0,1,364,0,365,G
1-PB2,55,379,0,0,0,379,A
1-PB2,56,0,377,0,0,377,T
1-PB2,57,379,0,1,0,380,A
1-PB2,58,0,0,0,379,379,C
1-PB2,59,0,376,1,0,377,T
1-PB2,60,0,0,389,0,389,G
1-PB2,61,389,0,0,0,389,A
1-PB2,62,0,0,0,390,390,C
1-PB2,63,394,0,0,0,394,A
1-PB2,64,391,0,0,0,391,A
1-PB2,65,396,0,0,0,396,A
1-PB2,66,398,0,0,1,399,A
1-PB2,67,401,0,0,0,401,A
1-PB2,68,0,0,0,404,404,C
1-PB2,69,0,0,0,402,402,C
1-PB2,70,407,0,1,0,408,A
1-PB2,71,0,0,0,415,415,C
1-PB2,72,413,0,1,0,414,A
1-PB2,73,0,0,423,0,423,G
1-PB2,74,0,424,0,0,424,T
1-PB2,75,0,0,437,0,437,G
1-PB2,76,0,1,436,0,437,G
1-PB2,77,432,1,2,0,435,A
1-PB2,78,0,0,0,461,461,C
1-PB2,79,0,1,0,457,458,C
1-PB2,80,463,0,1,0,464,A
1-PB2,81,0,465,0,0,465,T
1-PB2,82,462,0,0,0,462,A
1-PB2,83,0,462,0,0,462,T
1-PB2,84,0,0,465,0,465,G
1-PB2,85,0,0,466,0,466,G
1-PB2,86,0,0,0,467,467,C
1-PB2,87,0,0,0,462,462,C
1-PB2,88,459,0,0,0,459,A
1-PB2,89,0,494,0,0,494,T
1-PB2,90,497,0,0,0,497,A
1-PB2,91,518,0,0,0,518,A
1-PB2,92,0,518,0,0,518,T
1-PB2,93,0,517,1,0,518,T
1-PB2,94,521,0,0,0,521,A
1-PB2,95,521,0,1,0,522,A
1-PB2,96,0,0,539,0,539,G
1-PB2,97,538,1,0,0,539,A
1-PB2,98,534,0,0,0,534,A
1-PB2,99,0,0,554,0,554,G
1-PB2,100,0,552,0,1,553,T
1-PB2,101,554,0,1,0,555,A
1-PB2,102,0,2,0,555,557,C
1-PB2,103,553,0,1,0,554,A
1-PB2,104,0,0,0,570,570,C
1-PB2,105,567,0,0,0,567,A
1-PB2,106,0,573,0,0,573,T
1-PB2,107,0,0,0,574,574,C
1-PB2,108,0,0,567,0,567,G
1-PB2,109,0,0,566,0,566,G
1-PB2,110,0,1,565,0,566,G
1-PB2,111,0,0,567,0,567,G
1-PB2,112,565,0,0,0,565,A
1-PB2,113,0,0,565,0,565,G
1-PB2,114,566,0,0,0,566,A
1-PB2,115,0,0,0,571,571,C
1-PB2,116,573,0,1,0,574,A
1-PB2,117,0,2,577,0,579,G
1-PB2,118,0,0,592,0,592,G
1-PB2,119,595,0,0,0,595,A
1-PB2,120,596,0,0,0,596,A
1-PB2,121,597,1,1,0,599,A
1-PB2,122,596,0,1,0,597,A
1-PB2,123,1,1,596,0,598,G
1-PB2,124,596,1,0,0,597,A
1-PB2,125,595,0,0,0,595,A
1-PB2,126,0,0,0,599,599,C
1-PB2,127,0,0,0,596,596,C
1-PB2,128,1,0,0,593,594,C
1-PB2,129,1,0,595,0,596,G
1-PB2,130,0,592,0,1,593,T
1-PB2,131,0,0,0,598,598,C
1-PB2,132,601,0,0,0,601,A
1-PB2,133,0,0,0,603,603,C
1-PB2,134,0,601,0,1,602,T
1-PB2,135,0,599,0,0,599,T
1-PB2,136,605,0,1,0,606,A
1-PB2,137,0,0,616,0,616,G
1-PB2,138,0,1,615,0,616,G
1-PB2,139,614,1,0,0,615,A
1-PB2,140,0,612,0,1,613,T
1-PB2,141,0,0,618,0,618,G
1-PB2,142,623,0,1,0,624,A
1-PB2,143,622,0,0,0,622,A
1-PB2,144,626,0,0,0,626,A
1-PB2,145,0,625,0,0,625,T
1-PB2,146,0,2,621,0,623,G
1-PB2,147,0,0,627,0,627,G
1-PB2,148,626,0,1,0,627,A
1-PB2,149,0,629,0,0,629,T
1-PB2,150,0,0,626,0,626,G
1-PB2,151,625,1,0,0,626,A
1-PB2,152,0,625,0,0,625,T
1-PB2,153,1,0,625,0,626,G
1-PB2,154,1,0,626,0,627,G
1-PB2,155,0,0,0,624,624,C
1-PB2,156,621,0,1,0,622,A
1-PB2,157,625,1,0,0,626,A
1-PB2,158,1,628,0,0,629,T
1-PB2,159,1,0,656,0,657,G
1-PB2,160,655,0,1,0,656,A
1-PB2,161,655,0,1,0,656,A
1-PB2,162,657,0,1,0,658,A
1-PB2,163,0,657,0,0,657,T
1-PB2,164,659,0,0,0,659,A
1-PB2,165,1,0,0,671,672,C
1-PB2,166,1,0,1,666,668,C
1-PB2,167,2,0,0,666,668,C
1-PB2,168,675,0,0,0,675,A
1-PB2,169,674,0,0,0,674,A
1-PB2,170,0,674,0,0,674,T
1-PB2,171,1,0,0,677,678,C
1-PB2,172,675,0,1,0,676,A
1-PB2,173,0,0,0,685,685,C
1-PB2,174,0,679,0,1,680,T
1-PB2,175,0,0,679,0,679,G
1-PB2,176,0,0,0,681,681,C
1-PB2,177,1,678,0,1,680,T
1-PB2,178,0,0,686,0,686,G
1-PB2,179,686,0,0,0,686,A
1-PB2,180,1,0,0,689,690,C
1-PB2,181,689,0,0,0,689,A
1-PB2,182,688,0,0,0,688,A
1-PB2,183,690,1,0,0,691,A
1-PB2,184,683,0,4,0,687,A
1-PB2,185,0,1,706,0,707,G
1-PB2,186,0,2,704,0,706,G
1-PB2,187,701,0,0,0,701,A
1-PB2,188,1,702,0,1,704,T
1-PB2,189,697,0,1,0,698,A
1-PB2,190,707,0,0,0,707,A
1-PB2,191,0,0,0,713,713,C
1-PB2,192,711,0,0,0,711,A
1-PB2,193,0,0,713,0,713,G
1-PB2,194,701,0,2,0,703,A
1-PB2,195,697,0,1,1,699,A
1-PB2,196,702,0,0,0,702,A
1-PB2,197,0,703,0,0,703,T
1-PB2,198,0,0,706,0,706,G
1-PB2,199,0,0,710,0,710,G
1-PB2,200,0,708,1,1,710,T
1-PB2,201,0,703,0,0,703,T
1-PB2,202,1,0,0,704,705,C
1-PB2,203,0,0,0,705,705,C
1-PB2,204,0,0,707,0,707,G
1-PB2,205,0,0,709,0,709,G
1-PB2,206,702,3,0,0,705,A
1-PB2,207,0,1,708,0,709,G
1-PB2,208,700,0,1,1,702,A
1-PB2,209,0,0,712,0,712,G
1-PB2,210,716,0,0,0,716,A
1-PB2,211,715,0,1,0,716,A
1-PB2,212,716,0,1,0,717,A
1-PB2,213,0,715,1,0,716,T
1-PB2,214,1,0,720,0,721,G
1-PB2,215,721,0,1,1,723,A
1-PB2,216,719,0,2,0,721,A
1-PB2,217,0,0,0,720,720,C
1-PB2,218,711,0,0,0,711,A
1-PB2,219,704,0,6,0,710,A
1-PB2,220,1,2,716,0,719,G
1-PB2,221,0,1,731,0,732,G
1-PB2,222,729,0,1,2,732,A
1-PB2,223,0,0,0,734,734,C
1-PB2,224,731,0,0,0,731,A
1-PB2,225,735,0,1,0,736,A
1-PB2,226,734,1,0,0,735,A
1-PB2,227,0,1,0,732,733,C
1-PB2,228,0,0,0,715,715,C
1-PB2,229,4,0,0,770,774,C
1-PB2,230,0,773,0,1,774,T
1-PB2,231,783,0,0,0,783,A
1-PB2,232,0,779,1,0,780,T
1-PB2,233,0,2,777,2,781,G
1-PB2,234,0,1,794,0,795,G
1-PB2,235,759,0,2,0,761,A
1-PB2,236,1,0,772,0,773,G
1-PB2,237,0,773,0,0,773,T
1-PB2,238,767,0,0,0,767,A
1-PB2,239,771,0,0,0,771,A
1-PB2,240,764,1,1,0,766,A
1-PB2,241,762,0,1,1,764,A
1-PB2,242,1,762,0,0,763,T
1-PB2,243,0,0,761,0,761,G
1-PB2,244,744,1,1,0,746,A
1-PB2,245,1,0,744,1,746,G
1-PB2,246,0,740,0,1,741,T
1-PB2,247,0,0,739,0,739,G
1-PB2,248,747,0,1,0,748,A
1-PB2,249,0,750,0,0,750,T
1-PB2,250,0,0,751,0,751,G
1-PB2,251,1,0,0,747,748,C
1-PB2,252,1,748,0,0,749,T
1-PB2,253,0,0,767,1,768,G
1-PB2,254,0,1,774,1,776,G
1-PB2,255,778,0,1,0,779,A
1-PB2,256,0,779,0,0,779,T
1-PB2,257,0,3,0,777,780,C
1-PB2,258,786,0,0,0,786,A
1-PB2,259,0,1,801,0,802,G
1-PB2,260,803,0,0,0,803,A
1-PB2,261,0,801,0,0,801,T
1-PB2,262,785,0,0,0,785,A
1-PB2,263,0,2,805,0,807,G
1-PB2,264,799,0,1,1,801,A
1-PB2,265,0,1,809,0,810,G
1-PB2,266,0,803,0,0,803,T
1-PB2,267,0,9,794,0,803,G
1-PB2,268,791,0,0,0,791,A
1-PB2,269,0,798,0,0,798,T
1-PB2,270,0,0,810,1,811,G
1-PB2,271,1,0,821,0,822,G
1-PB2,272,0,806,0,0,806,T
1-PB2,273,806,1,0,1,808,A
1-PB2,274,1,793,0,1,795,T
1-PB2,275,2,0,0,797,799,C
1-PB2,276,814,0,0,0,814,A
1-PB2,277,0,0,0,828,828,C
1-PB2,278,1,0,0,823,824,C
1-PB2,279,0,809,0,0,809,T
1-PB2,280,0,809,0,0,809,T
1-PB2,281,0,808,0,0,808,T
1-PB2,282,1,2,822,0,825,G
1-PB2,283,0,0,831,0,831,G
1-PB2,284,1,1,0,836,838,C
1-PB2,285,0,824,0,2,826,T
1-PB2,286,3,0,826,0,829,G
1-PB2,287,0,834,0,1,835,T
1-PB2,288,839,0,0,0,839,A
1-PB2,289,841,0,0,0,841,A
1-PB2,290,0,0,0,840,840,C
1-PB2,291,825,0,1,0,826,A
1-PB2,292,0,826,0,0,826,T
1-PB2,293,0,0,818,0,818,G
1-PB2,294,0,0,832,0,832,G
1-PB2,295,0,827,0,0,827,T
1-PB2,296,0,1,824,0,825,G
1-PB2,297,0,0,831,0,831,G
1-PB2,298,828,0,2,0,830,A
1-PB2,299,835,0,0,0,835,A
1-PB2,300,0,837,0,0,837,T
1-PB2,301,835,0,1,0,836,A
1-PB2,302,0,0,856,0,856,G
1-PB2,303,847,0,0,0,847,A
1-PB2,304,848,0,0,0,848,A
1-PB2,305,849,0,1,0,850,A
1-PB2,306,0,840,0,0,840,T
1-PB2,307,0,2,837,0,839,G
1-PB2,308,0,0,836,0,836,G
1-PB2,309,836,0,3,1,840,A
1-PB2,310,2,0,0,845,847,C
1-PB2,311,0,0,0,832,832,C
1-PB2,312,2,0,0,828,830,C
1-PB2,313,1,0,833,0,834,G
1-PB2,314,1,836,0,0,837,T
1-PB2,315,0,1,853,0,854,G
1-PB2,316,856,1,0,0,857,A
1-PB2,317,0,0,0,856,856,C
1-PB2,318,856,0,1,0,857,A
1-PB2,319,854,1,2,0,857,A
1-PB2,320,0,0,882,0,882,G
1-PB2,321,0,880,1,0,881,T
1-PB2,322,875,0,0,0,875,A
1-PB2,323,0,1,0,870,871,C
1-PB2,324,0,1,861,0,862,G
1-PB2,325,0,0,888,0,888,G
1-PB2,326,1,885,0,0,886,T
1-PB2,327,0,0,0,892,892,C
1-PB2,328,0,0,0,893,893,C
1-PB2,329,874,0,0,0,874,A
1-PB2,330,0,874,0,1,875,T
1-PB2,331,0,874,0,1,875,T
1-PB2,332,917,0,0,0,917,A
1-PB2,333,0,0,0,912,912,C
1-PB2,334,0,0,0,894,894,C
1-PB2,335,1,2,0,884,887,C
1-PB2,336,881,0,1,0,882,A
1-PB2,337,889,0,0,0,889,A
1-PB2,338,888,0,0,0,888,A
1-PB2,339,882,1,2,0,885,A
1-PB2,340,0,0,896,0,896,G
1-PB2,341,0,869,0,0,869,T
1-PB2,342,1,0,890,0,891,G
1-PB2,343,0,889,0,1,890,T
1-PB2,344,888,0,0,0,888,A
1-PB2,345,0,0,0,887,887,C
1-PB2,346,884,0,1,0,885,A
1-PB2,347,886,0,1,0,887,A
1-PB2,348,0,1,903,0,904,G
1-PB2,349,893,0,3,0,896,A
1-PB2,350,0,1,0,897,898,C
1-PB2,351,1,888,0,0,889,T
1-PB2,352,0,895,1,1,897,T
1-PB2,353,898,0,1,0,899,A
1-PB2,354,0,897,0,1,898,T
1-PB2,355,0,896,0,0,896,T
1-PB2,356,0,893,0,0,893,T
1-PB2,357,2,0,0,889,891,C
1-PB2,358,0,1,886,0,887,G
1-PB2,359,888,0,0,0,888,A
1-PB2,360,1,0,0,885,886,C
1-PB2,361,883,1,0,0,884,A
1-PB2,362,883,0,0,1,884,A
1-PB2,363,882,0,1,0,883,A
1-PB2,364,0,0,897,0,897,G
1-PB2,365,0,898,0,0,898,T
1-PB2,366,3,0,0,892,895,C
1-PB2,367,0,1,894,0,895,G
1-PB2,368,888,0,1,0,889,A
1-PB2,369,0,2,883,0,885,G
1-PB2,370,886,0,0,0,886,A
1-PB2,371,0,0,914,0,914,G
1-PB2,372,1,0,916,0,917,G
1-PB2,373,0,910,0,0,910,T
1-PB2,374,0,909,0,1,910,T
1-PB2,375,908,0,0,0,908,A
1-PB2,376,910,0,1,0,911,A
1-PB2,377,907,1,1,0,909,A
1-PB2,378,920,0,1,0,921,A
1-PB2,379,0,0,0,932,932,C
1-PB2,380,902,1,2,1,906,A
1-PB2,381,0,901,0,1,902,T
1-PB2,382,1,0,898,0,899,G
1-PB2,383,0,2,897,0,899,G
1-PB2,384,896,0,0,0,896,A
1-PB2,385,903,0,3,0,906,A
1-PB2,386,0,1,0,923,924,C
1-PB2,387,1,0,0,923,924,C
1-PB2,388,0,909,0,0,909,T
1-PB2,389,0,907,0,1,908,T
1-PB2,390,0,907,0,1,908,T
1-PB2,391,0,2,904,0,906,G
1-PB2,392,0,1,905,0,906,G
1-PB2,393,1,1,0,908,910,C
1-PB2,394,0,0,0,903,903,C
1-PB2,395,2,1,0,897,900,C
1-PB2,396,0,882,0,1,883,T
1-PB2,397,0,0,904,0,904,G
1-PB2,398,0,901,0,0,901,T
1-PB2,399,0,904,0,1,905,T
1-PB2,400,1,1,0,903,905,C
1-PB2,401,898,0,0,0,898,A
1-PB2,402,0,899,0,0,899,T
1-PB2,403,0,892,0,1,893,T
1-PB2,404,0,896,0,0,896,T
1-PB2,405,0,899,0,0,899,T
1-PB2,406,890,0,0,0,890,A
1-PB2,407,0,0,889,0,889,G
1-PB2,408,889,0,0,0,889,A
1-PB2,409,892,0,0,0,892,A
1-PB2,410,893,0,0,0,893,A
1-PB2,411,0,891,0,0,891,T
1-PB2,412,1,0,0,891,892,C
1-PB2,413,889,0,1,0,890,A
1-PB2,414,893,0,2,0,895,A
1-PB2,415,0,0,898,0,898,G
1-PB2,416,0,893,0,3,896,T
1-PB2,417,5,0,0,891,896,C
1-PB2,418,904,0,0,0,904,A
1-PB2,419,902,0,1,1,904,A
1-PB2,420,0,1,903,0,904,G
1-PB2,421,908,0,1,0,909,A
1-PB2,422,0,912,0,0,912,T
1-PB2,423,917,0,0,1,918,A
1-PB2,424,0,1,0,911,912,C
1-PB2,425,0,0,911,0,911,G
1-PB2,426,0,0,0,922,922,C
1-PB2,427,918,0,1,0,919,A
1-PB2,428,0,1,929,0,930,G
1-PB2,429,929,0,0,0,929,A
1-PB2,430,932,0,2,0,934,A
1-PB2,431,0,1,949,0,950,G
1-PB2,432,941,0,2,0,943,A
1-PB2,433,0,0,945,0,945,G
1-PB2,434,0,942,0,0,942,T
1-PB2,435,937,0,0,0,937,A
1-PB2,436,0,0,948,0,948,G
1-PB2,437,947,1,2,0,950,A
1-PB2,438,0,0,0,995,995,C
1-PB2,439,986,1,0,0,987,A
1-PB2,440,1,972,0,0,973,T
1-PB2,441,972,0,0,0,972,A
1-PB2,442,971,0,0,0,971,A
1-PB2,443,978,0,1,0,979,A
1-PB2,444,0,0,0,980,980,C
1-PB2,445,1,1,0,958,960,C
1-PB2,446,1,0,0,956,957,C
1-PB2,447,0,916,0,1,917,T
1-PB2,448,0,0,917,0,917,G
1-PB2,449,0,0,933,0,933,G
1-PB2,450,0,932,0,2,934,T
1-PB2,451,2,0,0,931,933,C
1-PB2,452,932,0,0,0,932,A
1-PB2,453,0,927,0,0,927,T
1-PB2,454,1,0,933,0,934,G
1-PB2,455,0,1,1,931,933,C
1-PB2,456,931,0,2,0,933,A
1-PB2,457,0,0,932,0,932,G
1-PB2,458,918,0,1,0,919,A
1-PB2,459,1,1,0,928,930,C
1-PB2,460,2,2,0,925,929,C
1-PB2,461,0,923,0,0,923,T
1-PB2,462,1,0,0,925,926,C
1-PB2,463,916,0,0,0,916,A
1-PB2,464,0,0,926,0,926,G
1-PB2,465,0,925,0,1,926,T
1-PB2,466,0,0,922,0,922,G
1-PB2,467,0,0,0,923,923,C
1-PB2,468,0,0,0,908,908,C
1-PB2,469,910,0,1,0,911,A
1-PB2,470,912,0,1,0,913,A
1-PB2,471,912,0,0,0,912,A
1-PB2,472,0,0,916,0,916,G
1-PB2,473,892,0,3,0,895,A
1-PB2,474,0,0,900,0,900,G
1-PB2,475,0,0,895,0,895,G
1-PB2,476,0,0,0,894,894,C
1-PB2,477,893,0,1,0,894,A
1-PB2,478,1,0,0,892,893,C
1-PB2,479,892,0,0,0,892,A
1-PB2,480,908,0,0,0,908,A
1-PB2,481,0,0,915,0,915,G
1-PB2,482,925,0,1,0,926,A
1-PB2,483,0,914,0,0,914,T
1-PB2,484,0,0,918,0,918,G
1-PB2,485,0,912,0,0,912,T
1-PB2,486,916,0,1,1,918,A
1-PB2,487,918,0,0,1,919,A
1-PB2,488,1,916,0,0,917,T
1-PB2,489,0,884,0,0,884,T
1-PB2,490,880,0,0,0,880,A
1-PB2,491,0,862,0,0,862,T
1-PB2,492,2,0,860,0,862,G
1-PB2,493,0,1,864,0,865,G
1-PB2,494,855,0,2,0,857,A
1-PB2,495,851,0,1,0,852,A
1-PB2,496,0,0,853,0,853,G
1-PB2,497,0,848,0,2,850,T
1-PB2,498,0,849,0,1,850,T
1-PB2,499,1,0,854,0,855,G
1-PB2,500,0,851,0,0,851,T
1-PB2,501,0,852,0,2,854,T
1-PB2,502,0,849,0,0,849,T
1-PB2,503,0,849,0,0,849,T
1-PB2,504,0,848,0,0,848,T
1-PB2,505,2,0,0,853,855,C
1-PB2,506,0,0,1,858,859,C
1-PB2,507,2,0,1,852,855,C
1-PB2,508,851,0,0,0,851,A
1-PB2,509,848,0,1,0,849,A
1-PB2,510,0,852,0,0,852,T
1-PB2,511,0,1,852,0,853,G
1-PB2,512,858,0,0,0,858,A
1-PB2,513,857,0,0,1,858,A
1-PB2,514,0,0,856,0,856,G
1-PB2,515,1,855,0,0,856,T
1-PB2,516,0,1,849,0,850,G
1-PB2,517,0,0,853,0,853,G
1-PB2,518,0,1,854,0,855,G
1-PB2,519,854,0,2,0,856,A
1-PB2,520,0,0,860,0,860,G
1-PB2,521,0,1,0,854,855,C
1-PB2,522,1,0,0,854,855,C
1-PB2,523,856,0,2,0,858,A
1-PB2,524,1,2,868,0,871,G
1-PB2,525,0,1,871,0,872,G
1-PB2,526,878,0,1,0,879,A
1-PB2,527,0,876,0,1,877,T
1-PB2,528,879,0,1,1,881,A
1-PB2,529,0,1,0,883,884,C
1-PB2,530,0,878,0,2,880,T
1-PB2,531,880,0,1,0,881,A
1-PB2,532,878,0,0,0,878,A
1-PB2,533,0,0,0,882,882,C
1-PB2,534,862,1,0,0,863,A
1-PB2,535,0,854,0,0,854,T
1-PB2,536,0,1,0,856,857,C
1-PB2,537,848,1,0,0,849,A
1-PB2,538,0,1,849,0,850,G
1-PB2,539,855,0,0,0,855,A
1-PB2,540,851,0,0,0,851,A
1-PB2,541,0,847,1,0,848,T
1-PB2,542,0,2,0,827,829,C
1-PB2,543,829,0,0,0,829,A
1-PB2,544,0,0,0,841,841,C
1-PB2,545,841,0,1,0,842,A
1-PB2,546,849,0,0,0,849,A
1-PB2,547,0,839,0,0,839,T
1-PB2,548,0,838,0,1,839,T
1-PB2,549,842,0,1,0,843,A
1-PB2,550,845,0,1,0,846,A
1-PB2,551,1,1,0,843,845,C
1-PB2,552,840,0,2,0,842,A
1-PB2,553,834,0,1,0,835,A
1-PB2,554,0,849,0,0,849,T
1-PB2,555,843,0,0,0,843,A
1-PB2,556,845,0,1,0,846,A
1-PB2,557,0,0,0,845,845,C
1-PB2,558,0,844,0,0,844,T
1-PB2,559,841,0,1,1,843,A
1-PB2,560,832,0,1,1,834,A
1-PB2,561,837,0,1,0,838,A
1-PB2,562,0,0,838,0,838,G
1-PB2,563,825,0,1,0,826,A
1-PB2,564,0,2,830,0,832,G
1-PB2,565,830,0,1,0,831,A
1-PB2,566,830,0,0,0,830,A
1-PB2,567,831,0,0,0,831,A
1-PB2,568,830,0,0,0,830,A
1-PB2,569,833,0,1,1,835,A
1-PB2,570,832,0,0,0,832,A
1-PB2,571,0,0,835,0,835,G
1-PB2,572,838,0,0,0,838,A
1-PB2,573,832,0,1,0,833,A
1-PB2,574,0,1,835,0,836,G
1-PB2,575,837,0,0,0,837,A
1-PB2,576,837,0,0,0,837,A
1-PB2,577,0,0,0,838,838,C
1-PB2,578,0,826,0,1,827,T
1-PB2,579,0,0,0,825,825,C
1-PB2,580,0,0,0,821,821,C
1-PB2,581,0,1,825,0,826,G
1-PB2,582,826,0,0,0,826,A
1-PB2,583,0,0,827,0,827,G
1-PB2,584,824,0,0,0,824,A
1-PB2,585,0,820,0,0,820,T
1-PB2,586,0,809,0,1,810,T
1-PB2,587,0,0,808,0,808,G
1-PB2,588,1,0,0,807,808,C
1-PB2,589,811,0,1,0,812,A
1-PB2,590,813,0,0,0,813,A
1-PB2,591,811,0,1,0,812,A
1-PB2,592,819,0,0,1,820,A
1-PB2,593,0,814,1,0,815,T
1-PB2,594,0,813,1,0,814,T
1-PB2,595,0,812,0,2,814,T
1-PB2,596,2,0,0,809,811,C
1-PB2,597,1,810,0,1,812,T
1-PB2,598,1,1,0,840,842,C
1-PB2,599,3,0,0,836,839,C
1-PB2,600,1,0,0,874,875,C
1-PB2,601,0,877,0,0,877,T
1-PB2,602,0,878,0,1,879,T
1-PB2,603,0,0,880,0,880,G
1-PB2,604,882,0,0,0,882,A
1-PB2,605,0,918,0,0,918,T
1-PB2,606,0,1,921,0,922,G
1-PB2,607,0,0,962,0,962,G
1-PB2,608,0,962,0,2,964,T
1-PB2,609,1,952,0,0,953,T
1-PB2,610,0,0,987,0,987,G
1-PB2,611,0,1,0,989,990,C
1-PB2,612,999,0,0,0,999,A
1-PB2,613,0,998,0,0,998,T
1-PB2,614,999,1,0,0,1000,A
1-PB2,615,0,0,0,1012,1012,C
1-PB2,616,1035,0,0,1,1036,A
1-PB2,617,0,1048,0,1,1049,T
1-PB2,618,1,0,1081,0,1082,G
1-PB2,619,2,1068,1,0,1071,T
1-PB2,620,0,1072,0,2,1074,T
1-PB2,621,1070,0,1,0,1071,A
1-PB2,622,0,0,1074,0,1074,G
1-PB2,623,1077,0,0,0,1077,A
1-PB2,624,0,1,1088,0,1089,G
1-PB2,625,1021,0,1,0,1022,A
1-PB2,626,0,2,1021,0,1023,G
1-PB2,627,1001,0,3,0,1004,A
1-PB2,628,0,2,1008,0,1010,G
1-PB2,629,1010,0,1,0,1011,A
1-PB2,630,1012,0,0,0,1012,A
1-PB2,631,0,0,0,1015,1015,C
1-PB2,632,0,1001,0,1,1002,T
1-PB2,633,0,1005,0,0,1005,T
1-PB2,634,1,0,1001,0,1002,G
1-PB2,635,0,1001,0,0,1001,T
1-PB2,636,1005,0,0,0,1005,A
1-PB2,637,0,0,1,1001,1002,C
1-PB2,638,1,0,997,0,998,G
1-PB2,639,999,0,1,0,1000,A
1-PB2,640,998,0,0,0,998,A
1-PB2,641,1007,0,2,0,1009,A
1-PB2,642,1006,1,1,0,1008,A
1-PB2,643,1008,0,1,0,1009,A
1-PB2,644,0,1,0,1011,1012,C
1-PB2,645,1007,0,1,0,1008,A
1-PB2,646,1012,0,0,0,1012,A
1-PB2,647,0,1,1018,0,1019,G
1-PB2,648,1015,0,3,0,1018,A
1-PB2,649,0,1019,0,0,1019,T
1-PB2,650,0,1015,0,0,1015,T
1-PB2,651,0,1019,0,0,1019,T
1-PB2,652,1,0,0,1023,1024,C
1-PB2,653,1,1018,0,2,1021,T
1-PB2,654,4,0,0,1015,1019,C
1-PB2,655,2,0,0,1020,1022,C
1-PB2,656,1,0,0,1021,1022,C
1-PB2,657,1026,0,0,0,1026,A
1-PB2,658,0,0,1026,0,1026,G
1-PB2,659,0,1028,0,1,1029,T
1-PB2,660,1,1024,0,0,1025,T
1-PB2,661,0,0,1021,0,1021,G
1-PB2,662,0,0,0,1022,1022,C
1-PB2,663,0,1021,0,0,1021,T
1-PB2,664,0,2,1025,0,1027,G
1-PB2,665,0,0,1026,0,1026,G
1-PB2,666,1,1,0,1025,1027,C
1-PB2,667,0,1,1022,0,1023,G
1-PB2,668,0,0,1032,0,1032,G
1-PB2,669,1036,0,0,0,1036,A
1-PB2,670,1035,0,1,0,1036,A
1-PB2,671,0,0,0,1035,1035,C
1-PB2,672,1033,0,0,0,1033,A
1-PB2,673,1033,1,0,0,1034,A
1-PB2,674,0,0,1077,0,1077,G
1-PB2,675,0,0,0,1095,1095,C
1-PB2,676,1104,0,0,0,1104,A
1-PB2,677,1,0,1282,0,1283,G
1-PB2,678,0,1280,0,1,1281,T
1-PB2,679,1289,0,0,0,1289,A
1-PB2,680,0,1291,1,0,1292,T
1-PB2,681,1291,1,2,0,1294,A
1-PB2,682,0,1292,1,0,1293,T
1-PB2,683,1259,0,0,0,1259,A
1-PB2,684,0,0,0,1273,1273,C
1-PB2,685,1196,0,1,0,1197,A
1-PB2,686,0,1122,0,2,1124,T
1-PB2,687,0,1075,0,1,1076,T
1-PB2,688,1,2,1076,0,1079,G
1-PB2,689,1075,0,2,0,1077,A
1-PB2,690,1070,0,0,0,1070,A
1-PB2,691,0,1,1089,0,1090,G
1-PB2,692,0,1082,0,1,1083,T
1-PB2,693,0,1072,0,0,1072,T
1-PB2,694,0,1068,0,2,1070,T
1-PB2,695,0,1075,0,0,1075,T
1-PB2,696,1086,2,0,0,1088,A
1-PB2,697,0,0,0,1094,1094,C
1-PB2,698,1092,0,0,0,1092,A
1-PB2,699,0,1087,0,0,1087,T
1-PB2,700,0,1075,0,1,1076,T
1-PB2,701,0,1074,0,2,1076,T
1-PB2,702,0,2,1079,0,1081,G
1-PB2,703,1083,1,0,0,1084,A
1-PB2,704,0,0,0,1088,1088,C
1-PB2,705,0,1081,0,0,1081,T
1-PB2,706,2,0,0,1083,1085,C
1-PB2,707,1080,0,1,0,1081,A
1-PB2,708,0,1,1073,0,1074,G
1-PB2,709,0,2,1090,0,1092,G
1-PB2,710,1,2,1089,0,1092,G
1-PB2,711,1093,1,0,0,1094,A
1-PB2,712,1096,0,0,0,1096,A
1-PB2,713,0,0,0,1092,1092,C
1-PB2,714,1,0,1097,0,1098,G
1-PB2,715,0,1096,0,0,1096,T
1-PB2,716,1,0,1100,0,1101,G
1-PB2,717,0,1093,0,1,1094,T
1-PB2,718,0,1097,0,0,1097,T
1-PB2,719,0,2,1097,0,1099,G
1-PB2,720,0,1,1098,0,1099,G
1-PB2,721,1,2,1103,0,1106,G
1-PB2,722,1099,0,1,0,1100,A
1-PB2,723,1095,0,0,0,1095,A
1-PB2,724,1,1,0,1118,1120,C
1-PB2,725,1116,0,0,0,1116,A
1-PB2,726,1144,1,0,0,1145,A
1-PB2,727,1150,0,0,0,1150,A
1-PB2,728,0,1153,0,1,1154,T
1-PB2,729,1,0,1165,0,1166,G
1-PB2,730,0,1152,0,0,1152,T
1-PB2,731,1148,0,1,0,1149,A
1-PB2,732,1,1,0,1149,1151,C
1-PB2,733,1131,0,1,0,1132,A
1-PB2,734,0,0,0,1129,1129,C
1-PB2,735,1,1101,0,0,1102,T
1-PB2,736,2,1,0,1154,1157,C
1-PB2,737,1,2,0,1155,1158,C
1-PB2,738,1168,0,0,0,1168,A
1-PB2,739,0,0,1173,0,1173,G
1-PB2,740,2,0,1200,1,1203,G
1-PB2,741,0,1198,0,0,1198,T
1-PB2,742,0,3,1196,0,1199,G
1-PB2,743,0,0,1170,0,1170,G
1-PB2,744,1160,0,0,0,1160,A
1-PB2,745,0,0,1163,0,1163,G
1-PB2,746,0,3,1159,0,1162,G
1-PB2,747,1121,0,0,0,1121,A
1-PB2,748,0,0,1123,0,1123,G
1-PB2,749,0,1106,0,0,1106,T
1-PB2,750,0,2,1106,0,1108,G
1-PB2,751,1108,0,0,0,1108,A
1-PB2,752,0,3,1108,0,1111,G
1-PB2,753,2,1,1110,0,1113,G
1-PB2,754,1106,1,2,0,1109,A
1-PB2,755,1107,0,0,0,1107,A
1-PB2,756,0,1105,0,0,1105,T
1-PB2,757,1,0,1101,0,1102,G
1-PB2,758,1102,0,1,0,1103,A
1-PB2,759,0,0,1,1095,1096,C
1-PB2,760,0,0,1093,0,1093,G
1-PB2,761,1094,0,0,0,1094,A
1-PB2,762,0,1091,0,0,1091,T
1-PB2,763,0,0,1093,0,1093,G
1-PB2,764,0,1087,0,1,1088,T
1-PB2,765,0,1081,0,1,1082,T
1-PB2,766,0,1,1091,0,1092,G
1-PB2,767,1091,1,1,0,1093,A
1-PB2,768,0,0,0,1090,1090,C
1-PB2,769,4,0,0,1088,1092,C
1-PB2,770,1078,0,0,0,1078,A
1-PB2,771,1077,0,0,0,1077,A
1-PB2,772,1080,0,1,0,1081,A
1-PB2,773,0,0,1081,0,1081,G
1-PB2,774,2,0,0,1078,1080,C
1-PB2,775,0,1074,0,1,1075,T
1-PB2,776,0,1117,0,0,1117,T
1-PB2,777,1120,0,1,0,1121,A
1-PB2,778,1120,0,0,0,1120,A
1-PB2,779,0,1120,0,0,1120,T
1-PB2,780,0,1111,0,1,1112,T
1-PB2,781,1115,0,1,0,1116,A
1-PB2,782,0,1092,0,2,1094,T
1-PB2,783,0,1087,0,0,1087,T
1-PB2,784,0,1,1084,0,1085,G
1-PB2,785,0,2,0,1070,1072,C
1-PB2,786,10,0,1062,0,1072,G
1-PB2,787,0,0,1091,0,1091,G
1-PB2,788,0,0,0,1087,1087,C
1-PB2,789,1,1,0,1089,1091,C
1-PB2,790,1088,1,2,0,1091,A
1-PB2,791,0,1,1103,0,1104,G
1-PB2,792,0,1,1107,1,1109,G
1-PB2,793,1108,0,1,0,1109,A
1-PB2,794,1105,0,2,0,1107,A
1-PB2,795,1,0,0,1118,1119,C
1-PB2,796,1102,0,1,0,1103,A
1-PB2,797,0,1111,0,0,1111,T
1-PB2,798,1115,0,0,0,1115,A
1-PB2,799,0,0,1126,0,1126,G
1-PB2,800,0,1108,0,0,1108,T
1-PB2,801,1095,0,1,0,1096,A
1-PB2,802,1092,0,0,1,1093,A
1-PB2,803,0,3,1092,0,1095,G
1-PB2,804,1086,0,1,0,1087,A
1-PB2,805,1070,0,1,0,1071,A
1-PB2,806,1,0,1066,0,1067,G
1-PB2,807,1032,0,1,0,1033,A
1-PB2,808,1,1,1030,0,1032,G
1-PB2,809,0,0,0,1027,1027,C
1-PB2,810,2,1,0,1023,1026,C
1-PB2,811,0,0,1025,0,1025,G
1-PB2,812,0,0,0,1030,1030,C
1-PB2,813,1035,0,0,0,1035,A
1-PB2,814,1,0,1137,0,1138,G
1-PB2,815,0,1134,0,0,1134,T
1-PB2,816,1140,0,1,0,1141,A
1-PB2,817,0,1134,0,0,1134,T
1-PB2,818,1,0,0,1140,1141,C
1-PB2,819,1135,1,4,0,1140,A
1-PB2,820,0,0,1141,0,1141,G
1-PB2,821,0,0,0,1141,1141,C
1-PB2,822,1110,0,0,0,1110,A
1-PB2,823,0,0,1109,0,1109,G
1-PB2,824,1110,0,1,0,1111,A
1-PB2,825,0,1108,0,0,1108,T
1-PB2,826,1,0,0,1108,1109,C
1-PB2,827,1,0,0,1109,1110,C
1-PB2,828,1108,0,1,0,1109,A
1-PB2,829,1,0,0,1108,1109,C
1-PB2,830,0,1108,0,0,1108,T
1-PB2,831,1106,0,0,0,1106,A
1-PB2,832,0,0,1101,0,1101,G
1-PB2,833,1,1,0,1094,1096,C
1-PB2,834,1096,0,1,0,1097,A
1-PB2,835,0,1096,0,1,1097,T
1-PB2,836,0,0,0,1105,1105,C
1-PB2,837,0,1102,0,0,1102,T
1-PB2,838,0,1122,0,0,1122,T
1-PB2,839,0,1121,0,1,1122,T
1-PB2,840,1124,0,0,0,1124,A
1-PB2,841,0,1124,0,0,1124,T
1-PB2,842,0,1121,0,0,1121,T
1-PB2,843,1,0,1116,0,1117,G
1-PB2,844,0,0,1115,0,1115,G
1-PB2,845,1090,0,0,0,1090,A
1-PB2,846,1,0,1086,0,1087,G
1-PB2,847,1068,0,0,0,1068,A
1-PB2,848,0,1057,0,0,1057,T
1-PB2,849,0,0,1064,0,1064,G
1-PB2,850,1,1058,0,2,1061,T
1-PB2,851,0,0,1063,0,1063,G
1-PB2,852,0,0,0,1064,1064,C
1-PB2,853,3,0,0,1052,1055,C
1-PB2,854,1052,0,1,0,1053,A
1-PB2,855,0,1,0,1055,1056,C
1-PB2,856,1039,0,1,0,1040,A
1-PB2,857,0,0,1059,0,1059,G
1-PB2,858,0,1,0,1029,1030,C
1-PB2,859,1035,0,0,0,1035,A
1-PB2,860,0,0,1,1036,1037,C
1-PB2,861,1030,0,0,0,1030,A
1-PB2,862,1,0,0,1037,1038,C
1-PB2,863,1035,0,0,0,1035,A
1-PB2,864,1035,0,0,0,1035,A
1-PB2,865,1030,1,1,0,1032,A
1-PB2,866,0,1006,0,0,1006,T
1-PB2,867,0,1008,0,0,1008,T
1-PB2,868,0,1,999,0,1000,G
1-PB2,869,0,0,995,0,995,G
1-PB2,870,0,0,0,994,994,C
1-PB2,871,0,2,991,0,993,G
1-PB2,872,0,0,994,0,994,G
1-PB2,873,981,1,2,0,984,A
1-PB2,874,1006,0,1,0,1007,A
1-PB2,875,0,0,0,1013,1013,C
1-PB2,876,1013,0,1,0,1014,A
1-PB2,877,1014,0,0,0,1014,A
1-PB2,878,0,1,1013,0,1014,G
1-PB2,879,0,0,1012,0,1012,G
1-PB2,880,1016,0,1,0,1017,A
1-PB2,881,0,955,0,0,955,T
1-PB2,882,0,1,953,0,954,G
1-PB2,883,0,0,958,0,958,G
1-PB2,884,0,949,0,0,949,T
1-PB2,885,0,1,949,0,950,G
1-PB2,886,0,0,940,0,940,G
1-PB2,887,931,1,0,0,932,A
1-PB2,888,0,1,0,931,932,C
1-PB2,889,918,0,0,0,918,A
1-PB2,890,1,1013,0,0,1014,T
1-PB2,891,0,999,0,2,1001,T
1-PB2,892,1,0,0,991,992,C
1-PB2,893,0,964,0,2,966,T
1-PB2,894,0,959,0,1,960,T
1-PB2,895,957,0,3,0,960,A
1-PB2,896,1,0,960,0,961,G
1-PB2,897,959,0,0,0,959,A
1-PB2,898,0,0,0,960,960,C
1-PB2,899,744,0,1,0,745,A
1-PB2,900,0,0,749,0,749,G
1-PB2,901,744,0,1,0,745,A
1-PB2,902,745,0,1,0,746,A
1-PB2,903,1,1,0,742,744,C
1-PB2,904,2,0,0,745,747,C
1-PB2,905,0,0,0,744,744,C
1-PB2,906,0,2,740,0,742,G
1-PB2,907,742,0,1,0,743,A
1-PB2,908,0,1,0,736,737,C
1-PB2,909,1,0,0,730,731,C
1-PB2,910,0,2,735,0,737,G
1-PB2,911,738,0,0,0,738,A
1-PB2,912,736,0,0,0,736,A
1-PB2,913,0,0,747,0,747,G
1-PB2,914,744,0,1,0,745,A
1-PB2,915,749,0,0,0,749,A
1-PB2,916,0,0,0,750,750,C
1-PB2,917,747,0,1,0,748,A
1-PB2,918,748,0,0,0,748,A
1-PB2,919,0,1,759,0,760,G
1-PB2,920,1,0,0,761,762,C
1-PB2,921,0,752,0,0,752,T
1-PB2,922,0,0,765,0,765,G
1-PB2,923,0,764,0,0,764,T
1-PB2,924,0,0,782,0,782,G
1-PB2,925,0,1,803,0,804,G
1-PB2,926,803,1,2,0,806,A
1-PB2,927,0,805,0,0,805,T
1-PB2,928,789,0,2,0,791,A
1-PB2,929,1,785,0,0,786,T
1-PB2,930,801,0,0,0,801,A
1-PB2,931,0,795,0,0,795,T
1-PB2,932,0,0,790,0,790,G
1-PB2,933,0,0,0,790,790,C
1-PB2,934,766,0,0,0,766,A
1-PB2,935,760,1,1,0,762,A
1-PB2,936,0,1,761,0,762,G
1-PB2,937,1,0,771,0,772,G
1-PB2,938,0,1,0,776,777,C
1-PB2,939,0,764,0,2,766,T
1-PB2,940,0,0,773,0,773,G
1-PB2,941,0,0,0,775,775,C
1-PB2,942,775,0,0,0,775,A
1-PB2,943,777,0,0,0,777,A
1-PB2,944,0,774,0,1,775,T
1-PB2,945,1,0,773,0,774,G
1-PB2,946,0,3,768,0,771,G
1-PB2,947,0,0,776,0,776,G
1-PB2,948,774,0,1,0,775,A
1-PB2,949,1,768,0,1,770,T
1-PB2,950,1,765,0,0,766,T
1-PB2,951,0,1,768,0,769,G
1-PB2,952,766,0,1,0,767,A
1-PB2,953,0,1,765,1,767,G
1-PB2,954,765,0,1,0,766,A
1-PB2,955,760,0,1,0,761,A
1-PB2,956,1,754,0,0,755,T
1-PB2,957,0,0,0,757,757,C
1-PB2,958,756,0,0,0,756,A
1-PB2,959,0,0,760,0,760,G
1-PB2,960,1,0,0,759,760,C
1-PB2,961,0,753,0,2,755,T
1-PB2,962,0,1,0,751,752,C
1-PB2,963,748,0,1,0,749,A
1-PB2,964,0,768,0,0,768,T
1-PB2,965,1,0,0,766,767,C
1-PB2,966,0,0,0,774,774,C
1-PB2,967,0,769,0,2,771,T
1-PB2,968,0,768,0,0,768,T
1-PB2,969,1,0,0,767,768,C
1-PB2,970,773,0,1,0,774,A
1-PB2,971,0,0,775,0,775,G
1-PB2,972,0,0,0,774,774,C
1-PB2,973,0,769,0,0,769,T
1-PB2,974,1,771,0,0,772,T
1-PB2,975,0,772,0,0,772,T
1-PB2,976,0,0,775,0,775,G
1-PB2,977,0,0,776,0,776,G
1-PB2,978,0,769,0,1,770,T
1-PB2,979,1,0,758,0,759,G
1-PB2,980,0,2,756,0,758,G
1-PB2,981,0,1,764,0,765,G
1-PB2,982,0,762,0,0,762,T
1-PB2,983,1,762,0,1,764,T
1-PB2,984,0,761,0,0,761,T
1-PB2,985,763,0,0,1,764,A
1-PB2,986,0,0,0,769,769,C
1-PB2,987,769,0,0,0,769,A
1-PB2,988,1,763,0,0,764,T
1-PB2,989,0,757,0,0,757,T
1-PB2,990,0,756,0,0,756,T
1-PB2,991,756,0,1,0,757,A
1-PB2,992,754,2,0,0,756,A
1-PB2,993,757,0,0,0,757,A
1-PB2,994,753,0,0,0,753,A
1-PB2,995,0,1,761,0,762,G
1-PB2,996,760,0,1,0,761,A
1-PB2,997,761,0,0,0,761,A
1-PB2,998,0,0,0,759,759,C
1-PB2,999,761,0,0,0,761,A
1-PB2,1000,759,0,0,0,759,A
1-PB2,1001,0,0,762,0,762,G
1-PB2,1002,0,1,0,757,758,C
1-PB2,1003,1,1,757,0,759,G
1-PB2,1004,1,0,754,0,755,G
1-PB2,1005,0,0,759,0,759,G
1-PB2,1006,0,752,0,2,754,T
1-PB2,1007,1,1,0,749,751,C
1-PB2,1008,756,0,1,0,757,A
1-PB2,1009,0,752,0,1,753,T
1-PB2,1010,0,0,0,750,750,C
1-PB2,1011,749,0,0,0,749,A
1-PB2,1012,2,0,753,0,755,G
1-PB2,1013,0,750,0,0,750,T
1-PB2,1014,1,0,0,750,751,C
1-PB2,1015,750,0,0,0,750,A
1-PB2,1016,752,0,0,0,752,A
1-PB2,1017,752,0,0,0,752,A
1-PB2,1018,753,0,0,0,753,A
1-PB2,1019,756,0,1,1,758,A
1-PB2,1020,758,0,0,0,758,A
1-PB2,1021,0,1,757,0,758,G
1-PB2,1022,751,1,0,0,752,A
1-PB2,1023,749,0,0,0,749,A
1-PB2,1024,0,0,752,0,752,G
1-PB2,1025,750,0,1,0,751,A
1-PB2,1026,722,0,6,0,728,A
1-PB2,1027,0,1,724,0,725,G
1-PB2,1028,718,0,1,0,719,A
1-PB2,1029,1,0,723,0,724,G
1-PB2,1030,1,0,732,0,733,G
1-PB2,1031,0,734,1,0,735,T
1-PB2,1032,1,0,749,0,750,G
1-PB2,1033,0,0,0,747,747,C
1-PB2,1034,1,744,1,1,747,T
1-PB2,1035,0,751,0,0,751,T
1-PB2,1036,754,0,0,0,754,A
1-PB2,1037,0,0,0,752,752,C
1-PB2,1038,750,0,1,0,751,A
1-PB2,1039,0,0,753,0,753,G
1-PB2,1040,1,0,755,0,756,G
1-PB2,1041,0,0,0,749,749,C
1-PB2,1042,747,0,0,0,747,A
1-PB2,1043,750,0,0,0,750,A
1-PB2,1044,0,762,0,2,764,T
1-PB2,1045,3,0,0,781,784,C
1-PB2,1046,0,783,0,0,783,T
1-PB2,1047,1,0,0,789,790,C
1-PB2,1048,0,1,0,792,793,C
1-PB2,1049,789,0,1,0,790,A
1-PB2,1050,787,0,0,0,787,A
1-PB2,1051,777,1,5,0,783,A
1-PB2,1052,0,0,0,793,793,C
1-PB2,1053,779,0,0,0,779,A
1-PB2,1054,0,770,0,0,770,T
1-PB2,1055,0,746,0,0,746,T
1-PB2,1056,0,0,743,0,743,G
1-PB2,1057,745,1,0,0,746,A
1-PB2,1058,0,0,739,0,739,G
1-PB2,1059,778,0,3,0,781,A
1-PB2,1060,783,0,0,0,783,A
1-PB2,1061,0,787,0,0,787,T
1-PB2,1062,787,0,0,0,787,A
1-PB2,1063,784,0,5,0,789,A
1-PB2,1064,1,0,814,0,815,G
1-PB2,1065,801,1,0,0,802,A
1-PB2,1066,0,0,822,0,822,G
1-PB2,1067,0,805,0,0,805,T
1-PB2,1068,808,0,0,0,808,A
1-PB2,1069,2,0,1,815,818,C
1-PB2,1070,811,0,1,0,812,A
1-PB2,1071,1,814,0,0,815,T
1-PB2,1072,1,0,811,0,812,G
1-PB2,1073,787,0,2,0,789,A
1-PB2,1074,0,1,791,0,792,G
1-PB2,1075,0,0,788,0,788,G
1-PB2,1076,0,2,822,0,824,G
1-PB2,1077,0,0,823,0,823,G
1-PB2,1078,0,817,0,0,817,T
1-PB2,1079,818,0,1,0,819,A
1-PB2,1080,0,810,0,1,811,T
1-PB2,1081,1,2,811,0,814,G
1-PB2,1082,814,1,2,0,817,A
1-PB2,1083,3,1,812,0,816,G
1-PB2,1084,0,1,808,0,809,G
1-PB2,1085,773,0,0,0,773,A
1-PB2,1086,0,0,801,0,801,G
1-PB2,1087,0,795,0,1,796,T
1-PB2,1088,0,816,0,2,818,T
1-PB2,1089,2,0,0,821,823,C
1-PB2,1090,824,0,0,0,824,A
1-PB2,1091,0,0,0,827,827,C
1-PB2,1092,824,0,0,0,824,A
1-PB2,1093,845,1,0,0,846,A
1-PB2,1094,1,848,0,0,849,T
1-PB2,1095,1,0,845,0,846,G
1-PB2,1096,1,0,848,0,849,G
1-PB2,1097,0,822,0,1,823,T
1-PB2,1098,0,1,832,0,833,G
1-PB2,1099,0,1,829,0,830,G
1-PB2,1100,0,0,834,0,834,G
1-PB2,1101,1,0,838,0,839,G
1-PB2,1102,837,0,0,0,837,A
1-PB2,1103,834,0,0,0,834,A
1-PB2,1104,834,0,0,0,834,A
1-PB2,1105,823,0,2,0,825,A
1-PB2,1106,1,0,837,0,838,G
1-PB2,1107,831,0,1,0,832,A
1-PB2,1108,1,0,834,0,835,G
1-PB2,1109,0,0,0,835,835,C
1-PB2,1110,829,0,0,0,829,A
1-PB2,1111,830,1,0,0,831,A
1-PB2,1112,0,0,0,842,842,C
1-PB2,1113,841,0,1,0,842,A
1-PB2,1114,0,0,855,0,855,G
1-PB2,1115,0,1,0,844,845,C
1-PB2,1116,0,844,0,0,844,T
1-PB2,1117,867,0,0,0,867,A
1-PB2,1118,0,866,0,0,866,T
1-PB2,1119,866,0,0,0,866,A
1-PB2,1120,0,0,0,869,869,C
1-PB2,1121,0,832,0,0,832,T
1-PB2,1122,832,0,0,0,832,A
1-PB2,1123,820,0,0,0,820,A
1-PB2,1124,0,0,820,0,820,G
1-PB2,1125,824,0,0,0,824,A
1-PB2,1126,806,0,0,0,806,A
1-PB2,1127,807,0,0,0,807,A
1-PB2,1128,807,0,0,0,807,A
1-PB2,1129,1,0,816,0,817,G
1-PB2,1130,0,0,0,817,817,C
1-PB2,1131,815,0,1,0,816,A
1-PB2,1132,816,0,1,0,817,A
1-PB2,1133,0,0,0,818,818,C
1-PB2,1134,0,0,0,816,816,C
1-PB2,1135,818,0,1,0,819,A
1-PB2,1136,0,0,824,0,824,G
1-PB2,1137,823,0,0,0,823,A
1-PB2,1138,820,0,1,0,821,A
1-PB2,1139,0,0,828,0,828,G
1-PB2,1140,825,0,1,0,826,A
1-PB2,1141,0,820,0,0,820,T
1-PB2,1142,0,818,0,1,819,T
1-PB2,1143,1,3,820,0,824,G
1-PB2,1144,0,0,841,0,841,G
1-PB2,1145,0,839,0,1,840,T
1-PB2,1146,0,834,0,1,835,T
1-PB2,1147,1,0,0,835,836,C
1-PB2,1148,828,0,0,0,828,A
1-PB2,1149,828,0,0,0,828,A
1-PB2,1150,1,0,0,884,885,C
1-PB2,1151,0,881,0,2,883,T
1-PB2,1152,1,0,0,887,888,C
1-PB2,1153,872,0,0,1,873,A
1-PB2,1154,0,869,0,1,870,T
1-PB2,1155,875,0,1,0,876,A
1-PB2,1156,0,0,878,0,878,G
1-PB2,1157,0,858,0,1,859,T
1-PB2,1158,0,2,869,0,871,G
1-PB2,1159,837,1,0,0,838,A
1-PB2,1160,0,0,843,0,843,G
1-PB2,1161,0,839,0,0,839,T
1-PB2,1162,1,0,838,0,839,G
1-PB2,1163,2,1,843,0,846,G
1-PB2,1164,846,0,0,0,846,A
1-PB2,1165,842,0,1,0,843,A
1-PB2,1166,1,0,841,0,842,G
1-PB2,1167,833,0,1,0,834,A
1-PB2,1168,0,0,841,0,841,G
1-PB2,1169,838,0,1,0,839,A
1-PB2,1170,0,0,0,843,843,C
1-PB2,1171,0,1,841,0,842,G
1-PB2,1172,835,1,3,0,839,A
1-PB2,1173,839,0,4,0,843,A
1-PB2,1174,0,0,0,847,847,C
1-PB2,1175,840,0,1,0,841,A
1-PB2,1176,0,0,882,0,882,G
1-PB2,1177,0,875,0,2,877,T
1-PB2,1178,2,0,0,881,883,C
1-PB2,1179,878,0,0,0,878,A
1-PB2,1180,880,0,0,0,880,A
1-PB2,1181,0,878,0,1,879,T
1-PB2,1182,876,0,0,0,876,A
1-PB2,1183,0,1,878,0,879,G
1-PB2,1184,1,0,0,875,876,C
1-PB2,1185,1,1,0,851,853,C
1-PB2,1186,0,0,853,0,853,G
1-PB2,1187,858,0,0,0,858,A
1-PB2,1188,853,0,3,0,856,A
1-PB2,1189,0,0,866,0,866,G
1-PB2,1190,0,1,0,886,887,C
1-PB2,1191,881,0,2,0,883,A
1-PB2,1192,891,0,0,0,891,A
1-PB2,1193,0,890,0,0,890,T
1-PB2,1194,894,0,1,1,896,A
1-PB2,1195,899,0,1,1,901,A
1-PB2,1196,0,901,0,0,901,T
1-PB2,1197,3,0,0,894,897,C
1-PB2,1198,0,0,898,0,898,G
1-PB2,1199,0,881,0,0,881,T
1-PB2,1200,1,0,875,0,876,G
1-PB2,1201,0,0,885,0,885,G
1-PB2,1202,0,0,0,885,885,C
1-PB2,1203,1,0,0,880,881,C
1-PB2,1204,874,0,1,0,875,A
1-PB2,1205,0,866,0,3,869,T
1-PB2,1206,1,0,871,0,872,G
1-PB2,1207,0,0,876,0,876,G
1-PB2,1208,0,876,0,0,876,T
1-PB2,1209,1,0,880,0,881,G
1-PB2,1210,0,866,0,2,868,T
1-PB2,1211,0,866,0,0,866,T
1-PB2,1212,0,872,0,0,872,T
1-PB2,1213,0,872,0,2,874,T
1-PB2,1214,1,0,0,882,883,C
1-PB2,1215,882,0,0,0,882,A
1-PB2,1216,0,0,0,926,926,C
1-PB2,1217,917,0,1,0,918,A
1-PB2,1218,929,0,0,0,929,A
1-PB2,1219,0,2,929,0,931,G
1-PB2,1220,929,0,0,0,929,A
1-PB2,1221,891,0,24,0,915,A
1-PB2,1222,2,0,936,0,938,G
1-PB2,1223,942,0,0,0,942,A
1-PB2,1224,0,943,0,0,943,T
1-PB2,1225,0,940,0,1,941,T
1-PB2,1226,0,0,941,0,941,G
1-PB2,1227,0,2,0,937,939,C
1-PB2,1228,940,0,2,1,943,A
1-PB2,1229,0,951,1,1,953,T
1-PB2,1230,0,0,994,0,994,G
1-PB2,1231,1000,0,0,0,1000,A
1-PB2,1232,0,1005,0,1,1006,T
1-PB2,1233,1003,0,0,0,1003,A
1-PB2,1234,1005,0,0,0,1005,A
1-PB2,1235,999,0,0,0,999,A
1-PB2,1236,1006,0,2,0,1008,A
1-PB2,1237,0,1,1010,0,1011,G
1-PB2,1238,0,0,0,1027,1027,C
1-PB2,1239,1032,0,1,0,1033,A
1-PB2,1240,0,0,1057,0,1057,G
1-PB2,1241,0,1052,0,1,1053,T
1-PB2,1242,0,1056,0,0,1056,T
1-PB2,1243,1058,0,1,0,1059,A
1-PB2,1244,0,1,1070,0,1071,G
1-PB2,1245,1066,0,2,0,1068,A
1-PB2,1246,0,0,1072,0,1072,G
1-PB2,1247,1,2,1055,0,1058,G
1-PB2,1248,0,1041,0,0,1041,T
1-PB2,1249,1,1,1040,0,1042,G
1-PB2,1250,1046,0,0,0,1046,A
1-PB2,1251,1,0,0,1052,1053,C
1-PB2,1252,1,0,0,1053,1054,C
1-PB2,1253,0,982,0,1,983,T
1-PB2,1254,0,0,984,0,984,G
1-PB2,1255,981,0,1,0,982,A
1-PB2,1256,978,0,0,1,979,A
1-PB2,1257,0,983,0,0,983,T
1-PB2,1258,0,978,0,2,980,T
1-PB2,1259,0,984,0,0,984,T
1-PB2,1260,0,1,0,986,987,C
1-PB2,1261,0,0,985,0,985,G
1-PB2,1262,1,986,0,2,989,T
1-PB2,1263,0,0,0,996,996,C
1-PB2,1264,991,0,2,0,993,A
1-PB2,1265,994,0,0,0,994,A
1-PB2,1266,0,0,0,994,994,C
1-PB2,1267,979,0,1,0,980,A
1-PB2,1268,0,1,991,0,992,G
1-PB2,1269,989,0,0,0,989,A
1-PB2,1270,0,0,986,0,986,G
1-PB2,1271,0,1,0,991,992,C
1-PB2,1272,993,0,0,0,993,A
1-PB2,1273,999,0,1,0,1000,A
1-PB2,1274,999,0,0,0,999,A
1-PB2,1275,0,996,0,0,996,T
1-PB2,1276,0,0,0,998,998,C
1-PB2,1277,995,0,1,0,996,A
1-PB2,1278,0,0,991,0,991,G
1-PB2,1279,1,0,0,999,1000,C
1-PB2,1280,0,0,1000,0,1000,G
1-PB2,1281,0,1,1057,0,1058,G
1-PB2,1282,0,1048,0,1,1049,T
1-PB2,1283,0,1048,0,0,1048,T
1-PB2,1284,2,1,1048,0,1051,G
1-PB2,1285,1055,0,1,0,1056,A
1-PB2,1286,1058,1,1,0,1060,A
1-PB2,1287,0,0,0,1064,1064,C
1-PB2,1288,1,2,0,1056,1059,C
1-PB2,1289,3,0,0,1059,1062,C
1-PB2,1290,2,0,0,1035,1037,C
1-PB2,1291,1045,0,0,0,1045,A
1-PB2,1292,0,1048,0,2,1050,T
1-PB2,1293,0,0,1053,0,1053,G
1-PB2,1294,0,0,0,1057,1057,C
1-PB2,1295,1051,0,0,0,1051,A
1-PB2,1296,0,1043,0,2,1045,T
1-PB2,1297,0,0,0,1045,1045,C
1-PB2,1298,1043,0,0,0,1043,A
1-PB2,1299,0,0,1055,0,1055,G
1-PB2,1300,0,0,0,1054,1054,C
1-PB2,1301,0,1030,0,2,1032,T
1-PB2,1302,0,1033,0,0,1033,T
1-PB2,1303,0,1027,0,1,1028,T
1-PB2,1304,0,1030,0,1,1031,T
1-PB2,1305,1033,0,0,0,1033,A
1-PB2,1306,1028,1,1,0,1030,A
1-PB2,1307,0,0,1032,0,1032,G
1-PB2,1308,0,0,1032,0,1032,G
1-PB2,1309,0,0,0,1024,1024,C
1-PB2,1310,1021,0,0,0,1021,A
1-PB2,1311,0,1019,0,1,1020,T
1-PB2,1312,0,1022,0,1,1023,T
1-PB2,1313,0,1022,0,0,1022,T
1-PB2,1314,0,1026,0,1,1027,T
1-PB2,1315,1,0,0,1027,1028,C
1-PB2,1316,1030,0,0,0,1030,A
1-PB2,1317,0,0,1030,0,1030,G
1-PB2,1318,1029,0,0,0,1029,A
1-PB2,1319,1029,0,1,0,1030,A
1-PB2,1320,1028,0,0,0,1028,A
1-PB2,1321,1,0,1028,0,1029,G
1-PB2,1322,1038,0,1,0,1039,A
1-PB2,1323,0,1039,0,1,1040,T
1-PB2,1324,0,0,1040,0,1040,G
1-PB2,1325,1,0,0,1038,1039,C
1-PB2,1326,0,1,1044,0,1045,G
1-PB2,1327,1042,0,0,0,1042,A
1-PB2,1328,1044,0,1,0,1045,A
1-PB2,1329,1042,0,1,0,1043,A
1-PB2,1330,0,0,1047,1,1048,G
1-PB2,1331,0,1044,0,1,1045,T
1-PB2,1332,0,0,1041,1,1042,G
1-PB2,1333,0,0,0,1041,1041,C
1-PB2,1334,0,1043,0,2,1045,T
1-PB2,1335,0,1042,0,0,1042,T
1-PB2,1336,1,1043,1,0,1045,T
1-PB2,1337,0,1044,0,2,1046,T
1-PB2,1338,0,1045,0,1,1046,T
1-PB2,1339,1,0,0,1045,1046,C
1-PB2,1340,1047,0,0,0,1047,A
1-PB2,1341,1050,0,1,0,1051,A
1-PB2,1342,1044,0,0,0,1044,A
1-PB2,1343,1051,0,0,0,1051,A
1-PB2,1344,0,1045,1,0,1046,T
1-PB2,1345,0,1051,0,0,1051,T
1-PB2,1346,0,2,1049,0,1051,G
1-PB2,1347,0,1,1051,0,1052,G
1-PB2,1348,0,0,1054,0,1054,G
1-PB2,1349,0,0,1073,0,1073,G
1-PB2,1350,1058,0,3,0,1061,A
1-PB2,1351,0,0,1087,0,1087,G
1-PB2,1352,0,1081,0,1,1082,T
1-PB2,1353,2,1077,0,2,1081,T
1-PB2,1354,1,1,1089,0,1091,G
1-PB2,1355,1089,0,1,0,1090,A
1-PB2,1356,1086,0,3,0,1089,A
1-PB2,1357,0,0,0,1121,1121,C
1-PB2,1358,1112,1,2,0,1115,A
1-PB2,1359,1,1,0,1135,1137,C
1-PB2,1360,1132,0,1,0,1133,A
1-PB2,1361,0,1133,0,1,1134,T
1-PB2,1362,0,2,0,1136,1138,C
1-PB2,1363,0,1,1137,0,1138,G
1-PB2,1364,1142,0,0,0,1142,A
1-PB2,1365,1,0,0,1143,1144,C
1-PB2,1366,1120,0,0,0,1120,A
1-PB2,1367,0,0,1151,0,1151,G
1-PB2,1368,0,1136,0,0,1136,T
1-PB2,1369,1,0,1149,0,1150,G
1-PB2,1370,0,1143,0,0,1143,T
1-PB2,1371,2,1,1148,0,1151,G
1-PB2,1372,1149,1,1,0,1151,A
1-PB2,1373,1,1149,0,0,1150,T
1-PB2,1374,0,2,1149,0,1151,G
1-PB2,1375,0,0,1154,0,1154,G
1-PB2,1376,1,1,1143,1,1146,G
1-PB2,1377,1142,0,3,0,1145,A
1-PB2,1378,1140,0,0,0,1140,A
1-PB2,1379,1,1134,0,0,1135,T
1-PB2,1380,0,1,1146,0,1147,G
1-PB2,1381,1147,0,0,0,1147,A
1-PB2,1382,0,1143,1,1,1145,T
1-PB2,1383,0,1151,0,0,1151,T
1-PB2,1384,0,3,1143,0,1146,G
1-PB2,1385,0,0,1170,0,1170,G
1-PB2,1386,1156,0,2,0,1158,A
1-PB2,1387,1,1,1170,0,1172,G
1-PB2,1388,0,1164,0,1,1165,T
1-PB2,1389,1163,0,1,0,1164,A
1-PB2,1390,0,1157,0,2,1159,T
1-PB2,1391,0,1164,0,1,1165,T
1-PB2,1392,1179,0,1,0,1180,A
1-PB2,1393,0,0,0,1176,1176,C
1-PB2,1394,0,1,0,1169,1170,C
1-PB2,1395,1163,1,0,0,1164,A
1-PB2,1396,1,0,1165,0,1166,G
1-PB2,1397,1184,0,0,0,1184,A
1-PB2,1398,0,1178,0,3,1181,T
1-PB2,1399,1175,0,0,1,1176,A
1-PB2,1400,1,1172,0,1,1174,T
1-PB2,1401,1,0,1168,2,1171,G
1-PB2,1402,1174,0,3,0,1177,A
1-PB2,1403,0,1,0,1178,1179,C
1-PB2,1404,2,1177,0,1,1180,T
1-PB2,1405,3,1,0,1178,1182,C
1-PB2,1406,2,1,1,1165,1169,C
1-PB2,1407,1171,0,0,0,1171,A
1-PB2,1408,1170,0,2,0,1172,A
1-PB2,1409,0,1,1188,1,1190,G
1-PB2,1410,1,1,0,1183,1185,C
1-PB2,1411,1182,0,1,0,1183,A
1-PB2,1412,0,0,0,1183,1183,C
1-PB2,1413,1175,0,3,0,1178,A
1-PB2,1414,0,0,1180,0,1180,G
1-PB2,1415,1179,0,1,0,1180,A
1-PB2,1416,0,0,1186,0,1186,G
1-PB2,1417,1189,0,1,0,1190,A
1-PB2,1418,0,1167,0,1,1168,T
1-PB2,1419,0,1,1175,0,1176,G
1-PB2,1420,0,1174,0,1,1175,T
1-PB2,1421,2,1,1,1171,1175,C
1-PB2,1422,1172,1,1,0,1174,A
1-PB2,1423,1178,0,0,0,1178,A
1-PB2,1424,0,1176,0,0,1176,T
1-PB2,1425,0,1,1175,0,1176,G
1-PB2,1426,1160,0,1,0,1161,A
1-PB2,1427,0,1,1164,1,1166,G
1-PB2,1428,1148,2,2,0,1152,A
1-PB2,1429,1,1,1158,0,1160,G
1-PB2,1430,3,0,1190,1,1194,G
1-PB2,1431,1191,0,1,0,1192,A
1-PB2,1432,1193,0,1,0,1194,A
1-PB2,1433,0,1195,0,1,1196,T
1-PB2,1434,1193,0,1,0,1194,A
1-PB2,1435,1190,1,1,1,1193,A
1-PB2,1436,0,1,1195,0,1196,G
1-PB2,1437,1190,0,2,0,1192,A
1-PB2,1438,1,0,1194,0,1195,G
1-PB2,1439,1,1138,0,0,1139,T
1-PB2,1440,0,0,0,1144,1144,C
1-PB2,1441,1137,0,1,0,1138,A
1-PB2,1442,3,0,1141,0,1144,G
1-PB2,1443,1,0,1,1180,1182,C
1-PB2,1444,1184,0,0,0,1184,A
1-PB2,1445,1177,0,2,0,1179,A
1-PB2,1446,1177,0,0,0,1177,A
1-PB2,1447,1179,1,1,0,1181,A
1-PB2,1448,0,1179,0,0,1179,T
1-PB2,1449,2,0,1177,0,1179,G
1-PB2,1450,0,0,1185,0,1185,G
1-PB2,1451,1,0,1183,1,1185,G
1-PB2,1452,1,1180,0,0,1181,T
1-PB2,1453,0,0,1182,0,1182,G
1-PB2,1454,0,1182,0,2,1184,T
1-PB2,1455,2,3,1180,0,1185,G
1-PB2,1456,1,1,1201,0,1203,G
1-PB2,1457,1200,2,1,0,1203,A
1-PB2,1458,0,1198,0,1,1199,T
1-PB2,1459,0,2,1198,0,1200,G
1-PB2,1460,1196,1,1,1,1199,A
1-PB2,1461,1201,0,0,0,1201,A
1-PB2,1462,0,1201,0,0,1201,T
1-PB2,1463,1192,0,1,0,1193,A
1-PB2,1464,1,1,1,1384,1387,C
1-PB2,1465,1,1364,0,0,1365,T
1-PB2,1466,4,0,0,1451,1455,C
1-PB2,1467,0,0,0,1453,1453,C
1-PB2,1468,1457,1,0,0,1458,A
1-PB2,1469,613,1,852,0,1466,G
1-PB2,1470,0,1471,0,3,1474,T
1-PB2,1471,1476,1,0,0,1477,A
1-PB2,1472,0,0,0,1478,1478,C
1-PB2,1473,1148,0,1,0,1149,A
1-PB2,1474,0,2,1147,0,1149,G
1-PB2,1475,1025,0,1,0,1026,A
1-PB2,1476,0,0,1028,0,1028,G
1-PB2,1477,1014,0,1,0,1015,A
1-PB2,1478,1,1,1006,0,1008,G
1-PB2,1479,2,3,1003,0,1008,G
1-PB2,1480,0,0,1008,0,1008,G
1-PB2,1481,0,995,0,1,996,T
1-PB2,1482,1,0,995,0,996,G
1-PB2,1483,1,0,995,0,996,G
1-PB2,1484,0,993,0,1,994,T
1-PB2,1485,1,0,1004,1,1006,G
1-PB2,1486,0,0,1003,0,1003,G
1-PB2,1487,0,992,0,0,992,T
1-PB2,1488,0,992,0,0,992,T
1-PB2,1489,988,0,2,0,990,A
1-PB2,1490,0,0,995,0,995,G
1-PB2,1491,0,0,0,997,997,C
1-PB2,1492,993,0,0,0,993,A
1-PB2,1493,0,988,0,1,989,T
1-PB2,1494,0,956,0,0,956,T
1-PB2,1495,0,0,962,0,962,G
1-PB2,1496,956,0,1,0,957,A
1-PB2,1497,0,960,0,0,960,T
1-PB2,1498,3,1,0,958,962,C
1-PB2,1499,0,2,950,0,952,G
1-PB2,1500,0,0,973,0,973,G
1-PB2,1501,0,968,0,1,969,T
1-PB2,1502,1,967,0,0,968,T
1-PB2,1503,0,966,0,3,969,T
1-PB2,1504,0,966,0,0,966,T
1-PB2,1505,0,964,0,1,965,T
1-PB2,1506,0,2,966,0,968,G
1-PB2,1507,968,0,1,0,969,A
1-PB2,1508,0,0,968,0,968,G
1-PB2,1509,939,0,1,0,940,A
1-PB2,1510,0,0,943,1,944,G
1-PB2,1511,0,945,0,1,946,T
1-PB2,1512,0,942,0,0,942,T
1-PB2,1513,1,0,0,941,942,C
1-PB2,1514,0,0,957,0,957,G
1-PB2,1515,955,0,1,0,956,A
1-PB2,1516,0,1,959,0,960,G
1-PB2,1517,952,0,3,0,955,A
1-PB2,1518,0,1,0,954,955,C
1-PB2,1519,1,0,0,949,950,C
1-PB2,1520,947,0,0,0,947,A
1-PB2,1521,953,0,0,0,953,A
1-PB2,1522,0,0,0,954,954,C
1-PB2,1523,0,0,956,0,956,G
1-PB2,1524,0,949,0,0,949,T
1-PB2,1525,0,0,950,0,950,G
1-PB2,1526,0,0,946,2,948,G
1-PB2,1527,0,1,950,0,951,G
1-PB2,1528,940,0,1,0,941,A
1-PB2,1529,944,0,0,0,944,A
1-PB2,1530,1,930,0,0,931,T
1-PB2,1531,0,0,976,0,976,G
1-PB2,1532,0,974,0,0,974,T
1-PB2,1533,974,0,0,0,974,A
1-PB2,1534,0,972,0,1,973,T
1-PB2,1535,0,969,0,0,969,T
1-PB2,1536,977,1,1,0,979,A
1-PB2,1537,0,976,0,1,977,T
1-PB2,1538,0,974,0,0,974,T
1-PB2,1539,969,0,0,0,969,A
1-PB2,1540,0,891,0,2,893,T
1-PB2,1541,0,0,0,904,904,C
1-PB2,1542,0,885,0,1,886,T
1-PB2,1543,3,0,0,883,886,C
1-PB2,1544,1,0,0,887,888,C
1-PB2,1545,0,861,0,1,862,T
1-PB2,1546,0,2,864,0,866,G
1-PB2,1547,859,0,0,0,859,A
1-PB2,1548,0,0,864,0,864,G
1-PB2,1549,0,0,863,0,863,G
1-PB2,1550,801,1,0,0,802,A
1-PB2,1551,0,0,814,0,814,G
1-PB2,1552,0,0,813,0,813,G
1-PB2,1553,0,773,0,1,774,T
1-PB2,1554,0,0,0,772,772,C
1-PB2,1555,769,0,0,0,769,A
1-PB2,1556,0,0,775,0,775,G
1-PB2,1557,1,769,1,0,771,T
1-PB2,1558,0,0,774,0,774,G
1-PB2,1559,773,1,1,0,775,A
1-PB2,1560,758,0,0,1,759,A
1-PB2,1561,763,0,0,0,763,A
1-PB2,1562,1,1,1,757,760,C
1-PB2,1563,760,0,0,0,760,A
1-PB2,1564,1,0,0,760,761,C
1-PB2,1565,733,0,0,1,734,A
1-PB2,1566,1,0,738,0,739,G
1-PB2,1567,0,1,733,0,734,G
1-PB2,1568,0,1,736,0,737,G
1-PB2,1569,735,0,0,0,735,A
1-PB2,1570,729,0,1,0,730,A
1-PB2,1571,0,1,1,730,732,C
1-PB2,1572,0,725,0,0,725,T
1-PB2,1573,0,0,722,0,722,G
1-PB2,1574,718,0,0,0,718,A
1-PB2,1575,1,0,720,0,721,G
1-PB2,1576,700,0,0,0,700,A
1-PB2,1577,0,0,677,0,677,G
1-PB2,1578,679,0,0,0,679,A
1-PB2,1579,0,0,0,680,680,C
1-PB2,1580,0,668,0,0,668,T
1-PB2,1581,1,0,681,0,682,G
1-PB2,1582,682,0,0,0,682,A
1-PB2,1583,0,0,0,688,688,C
1-PB2,1584,686,0,1,0,687,A
1-PB2,1585,682,0,0,0,682,A
1-PB2,1586,0,678,0,0,678,T
1-PB2,1587,685,0,0,0,685,A
1-PB2,1588,685,0,0,0,685,A
1-PB2,1589,1,0,0,692,693,C
1-PB2,1590,1,660,0,1,662,T
1-PB2,1591,0,656,0,0,656,T
1-PB2,1592,648,0,1,0,649,A
1-PB2,1593,0,651,0,0,651,T
1-PB2,1594,0,649,0,0,649,T
1-PB2,1595,1,0,0,647,648,C
1-PB2,1596,617,0,0,0,617,A
1-PB2,1597,0,616,0,1,617,T
1-PB2,1598,0,0,0,592,592,C
1-PB2,1599,0,0,592,0,592,G
1-PB2,1600,0,594,0,0,594,T
1-PB2,1601,1,0,0,584,585,C
1-PB2,1602,0,1,581,0,582,G
1-PB2,1603,584,1,0,0,585,A
1-PB2,1604,0,585,0,0,585,T
1-PB2,1605,0,1,582,0,583,G
1-PB2,1606,577,0,0,0,577,A
1-PB2,1607,0,577,0,0,577,T
1-PB2,1608,0,0,581,0,581,G
1-PB2,1609,0,574,0,0,574,T
1-PB2,1610,0,1,571,0,572,G
1-PB2,1611,0,0,575,0,575,G
1-PB2,1612,0,0,574,1,575,G
1-PB2,1613,561,0,0,0,561,A
1-PB2,1614,0,1,569,0,570,G
1-PB2,1615,553,0,0,0,553,A
1-PB2,1616,0,546,1,0,547,T
1-PB2,1617,0,540,0,4,544,T
1-PB2,1618,540,0,0,0,540,A
1-PB2,1619,539,0,1,0,540,A
1-PB2,1620,0,1,0,535,536,C
1-PB2,1621,1,0,519,0,520,G
1-PB2,1622,0,0,514,0,514,G
1-PB2,1623,0,483,0,2,485,T
1-PB2,1624,0,0,0,482,482,C
1-PB2,1625,0,0,0,485,485,C
1-PB2,1626,0,450,0,0,450,T
1-PB2,1627,0,1,451,0,452,G
1-PB2,1628,448,0,1,0,449,A
1-PB2,1629,0,0,450,0,450,G
1-PB2,1630,1,450,0,1,452,T
1-PB2,1631,1,0,0,437,438,C
1-PB2,1632,0,0,436,0,436,G
1-PB2,1633,0,3,438,0,441,G
1-PB2,1634,0,441,0,1,442,T
1-PB2,1635,0,441,0,1,442,T
1-PB2,1636,0,440,0,0,440,T
1-PB2,1637,0,441,1,0,442,T
1-PB2,1638,1,0,445,0,446,G
1-PB2,1639,0,0,451,0,451,G
1-PB2,1640,0,453,0,0,453,T
1-PB2,1641,1,0,0,449,450,C
1-PB2,1642,441,0,0,0,441,A
1-PB2,1643,449,0,2,0,451,A
1-PB2,1644,0,452,0,0,452,T
1-PB2,1645,453,0,0,0,453,A
1-PB2,1646,0,0,0,460,460,C
1-PB2,1647,1,0,0,445,446,C
1-PB2,1648,0,442,1,0,443,T
1-PB2,1649,449,0,0,0,449,A
1-PB2,1650,0,449,0,0,449,T
1-PB2,1651,0,0,0,448,448,C
1-PB2,1652,441,0,0,0,441,A
1-PB2,1653,443,0,0,0,443,A
1-PB2,1654,0,439,0,0,439,T
1-PB2,1655,0,0,432,0,432,G
1-PB2,1656,0,0,433,0,433,G
1-PB2,1657,431,0,0,0,431,A
1-PB2,1658,0,427,0,0,427,T
1-PB2,1659,0,0,0,421,421,C
1-PB2,1660,425,0,1,0,426,A
1-PB2,1661,0,424,0,0,424,T
1-PB2,1662,0,0,0,425,425,C
1-PB2,1663,426,0,0,0,426,A
1-PB2,1664,0,0,429,0,429,G
1-PB2,1665,425,0,0,0,425,A
1-PB2,1666,423,0,0,0,423,A
1-PB2,1667,424,0,0,0,424,A
1-PB2,1668,0,424,0,0,424,T
1-PB2,1669,0,420,0,0,420,T
1-PB2,1670,0,1,417,0,418,G
1-PB2,1671,0,0,418,0,418,G
1-PB2,1672,0,1,417,0,418,G
1-PB2,1673,421,0,1,0,422,A
1-PB2,1674,422,0,0,0,422,A
1-PB2,1675,0,0,421,0,421,G
1-PB2,1676,0,0,0,421,421,C
1-PB2,1677,0,417,0,0,417,T
1-PB2,1678,0,0,421,0,421,G
1-PB2,1679,0,422,0,0,422,T
1-PB2,1680,1,0,0,419,420,C
1-PB2,1681,421,0,0,0,421,A
1-PB2,1682,421,0,0,0,421,A
1-PB2,1683,420,0,0,0,420,A
1-PB2,1684,420,0,0,0,420,A
1-PB2,1685,0,421,0,0,421,T
1-PB2,1686,0,399,0,1,400,T
1-PB2,1687,0,0,0,399,399,C
1-PB2,1688,397,1,0,0,398,A
1-PB2,1689,396,0,0,0,396,A
1-PB2,1690,0,398,0,0,398,T
1-PB2,1691,0,0,401,0,401,G
1-PB2,1692,0,0,404,0,404,G
1-PB2,1693,0,404,0,0,404,T
1-PB2,1694,0,1,0,405,406,C
1-PB2,1695,0,406,0,0,406,T
1-PB2,1696,1,1,0,404,406,C
1-PB2,1697,406,0,0,0,406,A
1-PB2,1698,0,2,404,0,406,G
1-PB2,1699,404,0,0,0,404,A
1-PB2,1700,405,0,0,0,405,A
1-PB2,1701,0,398,0,0,398,T
1-PB2,1702,2,1,0,391,394,C
1-PB2,1703,0,0,0,369,369,C
1-PB2,1704,0,368,0,1,369,T
1-PB2,1705,0,0,370,0,370,G
1-PB2,1706,0,0,0,371,371,C
1-PB2,1707,367,0,0,0,367,A
1-PB2,1708,371,1,1,0,373,A
1-PB2,1709,0,373,0,0,373,T
1-PB2,1710,0,0,375,0,375,G
1-PB2,1711,0,379,0,0,379,T
1-PB2,1712,0,369,0,0,369,T
1-PB2,1713,0,0,375,0,375,G
1-PB2,1714,0,376,0,0,376,T
1-PB2,1715,375,0,0,0,375,A
1-PB2,1716,0,0,0,374,374,C
1-PB2,1717,366,0,1,0,367,A
1-PB2,1718,373,0,0,0,373,A
1-PB2,1719,0,0,0,371,371,C
1-PB2,1720,362,1,0,0,363,A
1-PB2,1721,362,0,0,0,362,A
1-PB2,1722,352,0,1,0,353,A
1-PB2,1723,355,0,0,0,355,A
1-PB2,1724,0,354,0,0,354,T
1-PB2,1725,0,0,352,0,352,G
1-PB2,1726,0,1,354,0,355,G
1-PB2,1727,354,0,0,0,354,A
1-PB2,1728,352,0,0,0,352,A
1-PB2,1729,0,353,0,0,353,T
1-PB2,1730,0,355,0,0,355,T
1-PB2,1731,0,353,0,0,353,T
1-PB2,1732,0,1,352,0,353,G
1-PB2,1733,353,0,1,0,354,A
1-PB2,1734,354,0,0,0,354,A
1-PB2,1735,0,0,0,349,349,C
1-PB2,1736,0,0,0,310,310,C
1-PB2,1737,308,0,0,0,308,A
1-PB2,1738,0,309,0,0,309,T
1-PB2,1739,0,309,0,0,309,T
1-PB2,1740,0,310,0,0,310,T
1-PB2,1741,0,0,0,310,310,C
1-PB2,1742,311,0,0,0,311,A
1-PB2,1743,311,0,0,0,311,A
1-PB2,1744,0,312,0,0,312,T
1-PB2,1745,0,0,0,314,314,C
1-PB2,1746,0,312,0,0,312,T
1-PB2,1747,0,309,0,1,310,T
1-PB2,1748,0,311,0,0,311,T
1-PB2,1749,313,0,0,0,313,A
1-PB2,1750,0,0,311,0,311,G
1-PB2,1751,0,309,0,0,309,T
1-PB2,1752,0,0,0,315,315,C
1-PB2,1753,0,0,0,309,309,C
1-PB2,1754,0,0,0,305,305,C
1-PB2,1755,1,0,0,304,305,C
1-PB2,1756,305,0,0,0,305,A
1-PB2,1757,303,0,0,0,303,A
1-PB2,1758,1,0,308,0,309,G
1-PB2,1759,0,0,309,0,309,G
1-PB2,1760,0,0,0,307,307,C
1-PB2,1761,0,0,0,308,308,C
1-PB2,1762,305,1,1,0,307,A
1-PB2,1763,0,307,0,0,307,T
1-PB2,1764,0,308,0,0,308,T
1-PB2,1765,309,0,0,0,309,A
1-PB2,1766,0,0,308,0,308,G
1-PB2,1767,295,0,0,0,295,A
1-PB2,1768,299,0,0,0,299,A
1-PB2,1769,0,0,303,0,303,G
1-PB2,1770,0,0,0,303,303,C
1-PB2,1771,1,0,0,301,302,C
1-PB2,1772,303,0,0,0,303,A
1-PB2,1773,307,0,0,0,307,A
1-PB2,1774,0,306,0,0,306,T
1-PB2,1775,310,0,0,0,310,A
1-PB2,1776,0,0,0,308,308,C
1-PB2,1777,292,1,0,0,293,A
1-PB2,1778,0,0,294,0,294,G
1-PB2,1779,0,289,0,0,289,T
1-PB2,1780,0,1,289,0,290,G
1-PB2,1781,0,0,290,0,290,G
1-PB2,1782,0,0,286,0,286,G
1-PB2,1783,0,285,0,0,285,T
1-PB2,1784,0,281,0,0,281,T
1-PB2,1785,0,284,0,0,284,T
1-PB2,1786,0,0,290,0,290,G
1-PB2,1787,1,290,0,0,291,T
1-PB2,1788,0,0,0,290,290,C
1-PB2,1789,283,0,0,0,283,A
1-PB2,1790,0,0,285,0,285,G
1-PB2,1791,284,0,0,0,284,A
1-PB2,1792,284,0,0,0,284,A
1-PB2,1793,0,0,0,284,284,C
1-PB2,1794,0,274,0,0,274,T
1-PB2,1795,1,0,0,279,280,C
1-PB2,1796,0,279,0,1,280,T
1-PB2,1797,281,0,0,0,281,A
1-PB2,1798,0,281,0,0,281,T
1-PB2,1799,0,280,0,0,280,T
1-PB2,1800,0,0,0,280,280,C
1-PB2,1801,1,0,0,279,280,C
1-PB2,1802,278,0,0,0,278,A
1-PB2,1803,277,0,1,0,278,A
1-PB2,1804,0,0,0,275,275,C
1-PB2,1805,273,0,0,0,273,A
1-PB2,1806,275,0,0,0,275,A
1-PB2,1807,273,0,0,0,273,A
1-PB2,1808,0,273,0,0,273,T
1-PB2,1809,0,0,276,0,276,G
1-PB2,1810,273,0,0,0,273,A
1-PB2,1811,0,0,274,0,274,G
1-PB2,1812,273,0,0,0,273,A
1-PB2,1813,0,0,273,0,273,G
1-PB2,1814,275,0,0,0,275,A
1-PB2,1815,0,0,0,271,271,C
1-PB2,1816,0,1,273,0,274,G
1-PB2,1817,0,274,0,0,274,T
1-PB2,1818,276,0,0,0,276,A
1-PB2,1819,0,0,0,276,276,C
1-PB2,1820,1,268,0,0,269,T
1-PB2,1821,0,268,0,0,268,T
1-PB2,1822,0,1,264,0,265,G
1-PB2,1823,0,0,265,1,266,G
1-PB2,1824,0,0,267,0,267,G
1-PB2,1825,263,0,0,0,263,A
1-PB2,1826,0,0,0,264,264,C
1-PB2,1827,265,0,0,0,265,A
1-PB2,1828,0,267,0,0,267,T
1-PB2,1829,0,267,0,0,267,T
1-PB2,1830,0,267,0,1,268,T
1-PB2,1831,0,0,267,0,267,G
1-PB2,1832,272,0,0,0,272,A
1-PB2,1833,0,0,0,271,271,C
1-PB2,1834,269,0,0,0,269,A
1-PB2,1835,0,0,0,270,270,C
1-PB2,1836,1,0,0,266,267,C
1-PB2,1837,269,0,0,0,269,A
1-PB2,1838,0,0,0,269,269,C
1-PB2,1839,0,0,0,268,268,C
1-PB2,1840,0,0,0,273,273,C
1-PB2,1841,275,0,0,0,275,A
1-PB2,1842,0,0,280,0,280,G
1-PB2,1843,280,0,0,0,280,A
1-PB2,1844,0,288,1,0,289,T
1-PB2,1845,285,0,1,1,287,A
1-PB2,1846,283,0,1,0,284,A
1-PB2,1847,0,284,0,0,284,T
1-PB2,1848,285,0,0,0,285,A
1-PB2,1849,285,0,0,0,285,A
1-PB2,1850,274,0,1,0,275,A
1-PB2,1851,0,0,279,0,279,G
1-PB2,1852,0,0,0,280,280,C
1-PB2,1853,0,269,0,1,270,T
1-PB2,1854,0,271,0,0,271,T
1-PB2,1855,1,1,0,267,269,C
1-PB2,1856,0,265,0,1,266,T
1-PB2,1857,0,0,0,280,280,C
1-PB2,1858,0,0,0,279,279,C
1-PB2,1859,1,0,0,279,280,C
1-PB2,1860,0,280,0,0,280,T
1-PB2,1861,0,278,0,2,280,T
1-PB2,1862,0,279,0,2,281,T
1-PB2,1863,1,279,0,1,281,T
1-PB2,1864,0,0,281,0,281,G
1-PB2,1865,0,1,0,279,280,C
1-PB2,1866,273,0,0,0,273,A
1-PB2,1867,0,0,275,0,275,G
1-PB2,1868,0,0,0,274,274,C
1-PB2,1869,0,273,0,0,273,T
1-PB2,1870,0,0,273,0,273,G
1-PB2,1871,1,0,0,273,274,C
1-PB2,1872,0,274,0,0,274,T
1-PB2,1873,0,0,0,277,277,C
1-PB2,1874,0,0,0,276,276,C
1-PB2,1875,277,0,0,0,277,A
1-PB2,1876,0,0,0,277,277,C
1-PB2,1877,0,0,0,276,276,C
1-PB2,1878,268,0,0,0,268,A
1-PB2,1879,270,0,1,0,271,A
1-PB2,1880,271,0,0,0,271,A
1-PB2,1881,0,0,272,0,272,G
1-PB2,1882,0,0,0,274,274,C
1-PB2,1883,271,0,0,0,271,A
1-PB2,1884,271,1,0,0,272,A
1-PB2,1885,271,0,0,0,271,A
1-PB2,1886,0,0,274,0,274,G
1-PB2,1887,1,0,0,274,275,C
1-PB2,1888,272,0,0,0,272,A
1-PB2,1889,0,0,272,0,272,G
1-PB2,1890,267,0,0,0,267,A
1-PB2,1891,272,0,0,0,272,A
1-PB2,1892,0,272,0,0,272,T
1-PB2,1893,1,0,268,0,269,G
1-PB2,1894,0,0,0,270,270,C
1-PB2,1895,265,0,0,0,265,A
1-PB2,1896,0,0,269,0,269,G
1-PB2,1897,0,268,0,0,268,T
1-PB2,1898,0,279,0,0,279,T
1-PB2,1899,1,0,0,280,281,C
1-PB2,1900,0,275,0,0,275,T
1-PB2,1901,0,1,0,276,277,C
1-PB2,1902,0,276,0,1,277,T
1-PB2,1903,0,276,0,1,277,T
1-PB2,1904,0,1,0,277,278,C
1-PB2,1905,277,0,0,0,277,A
1-PB2,1906,0,0,0,277,277,C
1-PB2,1907,0,264,0,0,264,T
1-PB2,1908,0,0,266,0,266,G
1-PB2,1909,262,0,1,0,263,A
1-PB2,1910,0,2,0,264,266,C
1-PB2,1911,0,261,0,0,261,T
1-PB2,1912,0,0,262,0,262,G
1-PB2,1913,0,259,0,0,259,T
1-PB2,1914,0,0,260,0,260,G
1-PB2,1915,255,1,1,0,257,A
1-PB2,1916,261,0,0,0,261,A
1-PB2,1917,0,259,0,0,259,T
1-PB2,1918,0,0,260,0,260,G
1-PB2,1919,0,254,0,0,254,T
1-PB2,1920,252,0,0,0,252,A
1-PB2,1921,251,0,0,0,251,A
1-PB2,1922,0,0,251,0,251,G
1-PB2,1923,0,0,251,0,251,G
1-PB2,1924,0,0,249,0,249,G
1-PB2,1925,0,0,251,0,251,G
1-PB2,1926,249,0,1,0,250,A
1-PB2,1927,1,249,0,0,250,T
1-PB2,1928,0,0,0,249,249,C
1-PB2,1929,249,0,0,0,249,A
1-PB2,1930,0,0,257,0,257,G
1-PB2,1931,0,1,257,0,258,G
1-PB2,1932,0,0,257,0,257,G
1-PB2,1933,258,0,0,0,258,A
1-PB2,1934,0,253,0,0,253,T
1-PB2,1935,0,2,253,0,255,G
1-PB2,1936,249,0,1,1,251,A
1-PB2,1937,0,0,257,0,257,G
1-PB2,1938,255,0,0,0,255,A
1-PB2,1939,252,1,0,1,254,A
1-PB2,1940,0,256,0,0,256,T
1-PB2,1941,255,1,0,0,256,A
1-PB2,1942,0,1,0,261,262,C
1-PB2,1943,0,259,0,1,260,T
1-PB2,1944,0,260,0,0,260,T
1-PB2,1945,1,0,261,0,262,G
1-PB2,1946,0,257,0,0,257,T
1-PB2,1947,257,0,0,0,257,A
1-PB2,1948,257,0,0,0,257,A
1-PB2,1949,0,1,253,0,254,G
1-PB2,1950,0,1,259,0,260,G
1-PB2,1951,0,0,258,0,258,G
1-PB2,1952,0,0,257,0,257,G
1-PB2,1953,0,0,0,259,259,C
1-PB2,1954,258,0,1,0,259,A
1-PB2,1955,260,0,0,0,260,A
1-PB2,1956,0,261,0,0,261,T
1-PB2,1957,0,260,0,0,260,T
1-PB2,1958,0,0,0,267,267,C
1-PB2,1959,0,264,0,1,265,T
1-PB2,1960,0,1,0,268,269,C
1-PB2,1961,0,1,0,269,270,C
1-PB2,1962,0,266,0,0,266,T
1-PB2,1963,1,0,273,0,274,G
1-PB2,1964,0,268,0,0,268,T
1-PB2,1965,268,0,0,0,268,A
1-PB2,1966,0,268,0,0,268,T
1-PB2,1967,0,262,0,0,262,T
1-PB2,1968,0,0,0,265,265,C
1-PB2,1969,259,0,0,0,259,A
1-PB2,1970,261,0,1,0,262,A
1-PB2,1971,0,0,0,261,261,C
1-PB2,1972,0,258,0,0,258,T
1-PB2,1973,261,0,0,0,261,A
1-PB2,1974,1,0,0,267,268,C
1-PB2,1975,268,0,0,0,268,A
1-PB2,1976,266,0,0,0,266,A
1-PB2,1977,0,0,0,267,267,C
1-PB2,1978,267,0,0,0,267,A
1-PB2,1979,264,0,0,0,264,A
1-PB2,1980,0,0,265,0,265,G
1-PB2,1981,265,0,0,0,265,A
1-PB2,1982,0,0,0,268,268,C
1-PB2,1983,1,0,0,259,260,C
1-PB2,1984,261,0,0,0,261,A
1-PB2,1985,0,0,0,269,269,C
1-PB2,1986,0,269,0,1,270,T
1-PB2,1987,270,0,0,0,270,A
1-PB2,1988,267,0,0,0,267,A
1-PB2,1989,266,0,0,0,266,A
1-PB2,1990,269,0,0,0,269,A
1-PB2,1991,0,0,269,0,269,G
1-PB2,1992,266,0,1,0,267,A
1-PB2,1993,0,0,0,267,267,C
1-PB2,1994,0,263,0,0,263,T
1-PB2,1995,263,0,0,0,263,A
1-PB2,1996,262,0,0,0,262,A
1-PB2,1997,0,0,0,264,264,C
1-PB2,1998,262,0,0,0,262,A
1-PB2,1999,260,0,0,0,260,A
1-PB2,2000,0,255,0,0,255,T
1-PB2,2001,0,256,0,0,256,T
1-PB2,2002,0,0,0,260,260,C
1-PB2,2003,0,255,0,0,255,T
1-PB2,2004,0,0,0,258,258,C
1-PB2,2005,1,0,257,0,258,G
1-PB2,2006,0,0,256,0,256,G
1-PB2,2007,257,0,0,0,257,A
1-PB2,2008,257,0,0,0,257,A
1-PB2,2009,254,1,0,0,255,A
1-PB2,2010,256,0,0,0,256,A
1-PB2,2011,0,0,257,0,257,G
1-PB2,2012,255,0,1,0,256,A
1-PB2,2013,0,258,0,0,258,T
1-PB2,2014,0,0,258,0,258,G
1-PB2,2015,0,0,0,257,257,C
1-PB2,2016,0,0,0,255,255,C
1-PB2,2017,0,1,254,0,255,G
1-PB2,2018,0,0,256,0,256,G
1-PB2,2019,0,0,0,251,251,C
1-PB2,2020,253,0,0,0,253,A
1-PB2,2021,0,0,0,255,255,C
1-PB2,2022,0,255,0,0,255,T
1-PB2,2023,0,255,0,0,255,T
1-PB2,2024,1,255,0,1,257,T
1-PB2,2025,257,0,0,0,257,A
1-PB2,2026,255,0,0,0,255,A
1-PB2,2027,0,258,0,0,258,T
1-PB2,2028,0,254,0,0,254,T
1-PB2,2029,0,0,254,0,254,G
1-PB2,2030,251,0,0,0,251,A
1-PB2,2031,249,0,0,0,249,A
1-PB2,2032,0,0,250,0,250,G
1-PB2,2033,250,1,0,0,251,A
1-PB2,2034,0,0,0,247,247,C
1-PB2,2035,0,0,0,248,248,C
1-PB2,2036,1,1,0,246,248,C
1-PB2,2037,245,0,0,0,245,A
1-PB2,2038,0,0,251,0,251,G
1-PB2,2039,251,0,0,0,251,A
1-PB2,2040,0,250,0,0,250,T
1-PB2,2041,0,0,249,0,249,G
1-PB2,2042,247,0,0,0,247,A
1-PB2,2043,247,0,0,0,247,A
1-PB2,2044,246,0,1,0,247,A
1-PB2,2045,0,0,247,0,247,G
1-PB2,2046,0,0,0,246,246,C
1-PB2,2047,240,0,1,0,241,A
1-PB2,2048,0,0,0,244,244,C
1-PB2,2049,244,0,0,0,244,A
1-PB2,2050,0,243,0,0,243,T
1-PB2,2051,0,0,0,247,247,C
1-PB2,2052,0,1,0,246,247,C
1-PB2,2053,1,0,246,0,247,G
1-PB2,2054,0,0,246,0,246,G
1-PB2,2055,244,0,0,0,244,A
1-PB2,2056,0,0,247,0,247,G
1-PB2,2057,0,238,0,0,238,T
1-PB2,2058,0,0,237,0,237,G
1-PB2,2059,0,0,236,0,236,G
1-PB2,2060,239,0,0,0,239,A
1-PB2,2061,0,0,239,0,239,G
1-PB2,2062,0,236,0,0,236,T
1-PB2,2063,1,0,0,235,236,C
1-PB2,2064,0,0,0,236,236,C
1-PB2,2065,0,0,236,0,236,G
1-PB2,2066,0,0,0,236,236,C
1-PB2,2067,0,0,0,236,236,C
1-PB2,2068,0,0,237,0,237,G
1-PB2,2069,0,238,0,0,238,T
1-PB2,2070,0,0,0,238,238,C
1-PB2,2071,0,235,0,0,235,T
1-PB2,2072,0,236,0,0,236,T
1-PB2,2073,1,0,235,0,236,G
1-PB2,2074,235,0,0,0,235,A
1-PB2,2075,0,0,233,0,233,G
1-PB2,2076,233,0,0,0,233,A
1-PB2,2077,0,0,231,0,231,G
1-PB2,2078,0,0,231,0,231,G
1-PB2,2079,0,0,230,0,230,G
1-PB2,2080,0,229,0,1,230,T
1-PB2,2081,0,230,0,0,230,T
1-PB2,2082,1,233,0,0,234,T
1-PB2,2083,0,0,0,236,236,C
1-PB2,2084,0,236,0,0,236,T
1-PB2,2085,0,0,0,243,243,C
1-PB2,2086,242,0,0,0,242,A
1-PB2,2087,0,241,0,0,241,T
1-PB2,2088,0,236,0,0,236,T
1-PB2,2089,239,0,0,0,239,A
1-PB2,2090,0,240,0,0,240,T
1-PB2,2091,237,0,1,0,238,A
1-PB2,2092,0,1,241,0,242,G
1-PB2,2093,1,0,241,0,242,G
1-PB2,2094,0,232,0,0,232,T
1-PB2,2095,230,0,0,0,230,A
1-PB2,2096,231,0,0,0,231,A
1-PB2,2097,0,0,232,0,232,G
1-PB2,2098,0,0,231,0,231,G
1-PB2,2099,231,0,0,0,231,A
1-PB2,2100,229,0,0,0,229,A
1-PB2,2101,0,0,230,0,230,G
1-PB2,2102,227,0,2,0,229,A
1-PB2,2103,0,0,0,228,228,C
1-PB2,2104,225,0,0,0,225,A
1-PB2,2105,0,0,226,0,226,G
1-PB2,2106,222,0,0,0,222,A
1-PB2,2107,219,0,0,0,219,A
1-PB2,2108,0,0,218,0,218,G
1-PB2,2109,0,0,213,0,213,G
1-PB2,2110,0,217,0,0,217,T
1-PB2,2111,218,0,0,0,218,A
1-PB2,2112,0,1,0,216,217,C
1-PB2,2113,0,0,217,0,217,G
1-PB2,2114,0,0,218,0,218,G
1-PB2,2115,217,0,0,0,217,A
1-PB2,2116,0,0,0,215,215,C
1-PB2,2117,0,0,0,212,212,C
1-PB2,2118,204,0,0,0,204,A
1-PB2,2119,0,0,212,0,212,G
1-PB2,2120,0,0,0,211,211,C
1-PB2,2121,212,0,0,0,212,A
1-PB2,2122,0,211,0,0,211,T
1-PB2,2123,0,203,0,0,203,T
1-PB2,2124,205,0,0,0,205,A
1-PB2,2125,204,0,0,0,204,A
1-PB2,2126,0,0,203,0,203,G
1-PB2,2127,0,0,0,204,204,C
1-PB2,2128,187,0,0,0,187,A
1-PB2,2129,0,193,0,0,193,T
1-PB2,2130,0,0,0,193,193,C
1-PB2,2131,192,0,0,0,192,A
1-PB2,2132,193,0,0,0,193,A
1-PB2,2133,0,192,0,0,192,T
1-PB2,2134,0,0,193,0,193,G
1-PB2,2135,189,0,0,0,189,A
1-PB2,2136,188,0,0,0,188,A
1-PB2,2137,0,0,0,189,189,C
1-PB2,2138,0,183,0,0,183,T
1-PB2,2139,0,0,188,0,188,G
1-PB2,2140,187,0,0,0,187,A
1-PB2,2141,0,0,187,0,187,G
1-PB2,2142,0,187,0,0,187,T
1-PB2,2143,187,0,0,0,187,A
1-PB2,2144,186,0,1,0,187,A
1-PB2,2145,0,1,0,188,189,C
1-PB2,2146,0,0,0,184,184,C
1-PB2,2147,0,184,0,0,184,T
1-PB2,2148,0,173,0,1,174,T
1-PB2,2149,0,0,174,0,174,G
1-PB2,2150,0,0,0,174,174,C
1-PB2,2151,173,0,0,0,173,A
1-PB2,2152,173,0,0,0,173,A
1-PB2,2153,172,0,0,0,172,A
1-PB2,2154,171,0,0,0,171,A
1-PB2,2155,0,0,173,0,173,G
1-PB2,2156,0,1,171,0,172,G
1-PB2,2157,0,0,170,0,170,G
1-PB2,2158,0,0,171,0,171,G
1-PB2,2159,171,0,0,0,171,A
1-PB2,2160,169,1,1,0,171,A
1-PB2,2161,171,0,0,0,171,A
1-PB2,2162,172,0,0,0,172,A
1-PB2,2163,0,0,175,0,175,G
1-PB2,2164,0,0,172,0,172,G
1-PB2,2165,0,0,0,172,172,C
1-PB2,2166,0,171,0,0,171,T
1-PB2,2167,170,0,0,0,170,A
1-PB2,2168,170,0,0,0,170,A
1-PB2,2169,0,169,1,0,170,T
1-PB2,2170,0,0,174,0,174,G
1-PB2,2171,0,167,0,0,167,T
1-PB2,2172,0,0,163,0,163,G
1-PB2,2173,0,0,0,163,163,C
1-PB2,2174,0,160,0,0,160,T
1-PB2,2175,158,0,0,0,158,A
1-PB2,2176,161,0,0,0,161,A
1-PB2,2177,0,161,0,0,161,T
1-PB2,2178,2,0,0,158,160,C
1-PB2,2179,0,1,151,0,152,G
1-PB2,2180,0,0,152,0,152,G
1-PB2,2181,0,0,153,0,153,G
1-PB2,2182,0,0,0,152,152,C
1-PB2,2183,154,0,0,0,154,A
1-PB2,2184,150,0,0,0,150,A
1-PB2,2185,0,0,152,0,152,G
1-PB2,2186,0,0,152,0,152,G
1-PB2,2187,152,0,0,0,152,A
1-PB2,2188,0,0,151,0,151,G
1-PB2,2189,149,0,0,0,149,A
1-PB2,2190,0,0,0,148,148,C
1-PB2,2191,0,0,147,0,147,G
1-PB2,2192,0,145,0,0,145,T
1-PB2,2193,0,0,147,0,147,G
1-PB2,2194,1,0,146,0,147,G
1-PB2,2195,0,145,0,0,145,T
1-PB2,2196,0,0,146,0,146,G
1-PB2,2197,0,141,0,0,141,T
1-PB2,2198,0,141,0,0,141,T
1-PB2,2199,1,0,140,0,141,G
1-PB2,2200,0,0,137,0,137,G
1-PB2,2201,0,137,0,0,137,T
1-PB2,2202,136,0,0,0,136,A
1-PB2,2203,133,0,0,0,133,A
1-PB2,2204,0,132,0,0,132,T
1-PB2,2205,0,1,130,0,131,G
1-PB2,2206,131,0,0,0,131,A
1-PB2,2207,130,0,0,0,130,A
1-PB2,2208,130,0,0,0,130,A
1-PB2,2209,0,0,0,129,129,C
1-PB2,2210,0,0,129,0,129,G
1-PB2,2211,127,0,0,0,127,A
1-PB2,2212,126,1,1,0,128,A
1-PB2,2213,128,0,0,0,128,A
1-PB2,2214,127,0,0,0,127,A
1-PB2,2215,0,0,0,127,127,C
1-PB2,2216,0,0,127,0,127,G
1-PB2,2217,0,0,125,0,125,G
1-PB2,2218,0,0,127,0,127,G
1-PB2,2219,127,0,0,0,127,A
1-PB2,2220,0,0,0,126,126,C
1-PB2,2221,0,126,0,0,126,T
1-PB2,2222,0,0,0,128,128,C
1-PB2,2223,0,127,0,0,127,T
1-PB2,2224,127,0,0,0,127,A
1-PB2,2225,0,0,128,0,128,G
1-PB2,2226,0,0,0,126,126,C
1-PB2,2227,126,0,0,0,126,A
1-PB2,2228,0,125,0,0,125,T
1-PB2,2229,120,0,0,0,120,A
1-PB2,2230,0,0,0,119,119,C
1-PB2,2231,0,103,0,0,103,T
1-PB2,2232,0,102,0,0,102,T
1-PB2,2233,101,0,0,0,101,A
1-PB2,2234,0,1,0,101,102,C
1-PB2,2235,0,101,0,0,101,T
1-PB2,2236,0,1,100,0,101,G
1-PB2,2237,98,0,0,0,98,A
1-PB2,2238,0,0,0,98,98,C
1-PB2,2239,93,0,1,0,94,A
1-PB2,2240,0,0,92,0,92,G
1-PB2,2241,0,0,0,94,94,C
1-PB2,2242,0,0,0,94,94,C
1-PB2,2243,92,0,0,0,92,A
1-PB2,2244,0,0,92,0,92,G
1-PB2,2245,93,0,0,0,93,A
1-PB2,2246,0,0,0,92,92,C
1-PB2,2247,85,0,0,0,85,A
1-PB2,2248,0,0,85,0,85,G
1-PB2,2249,0,0,0,81,81,C
1-PB2,2250,0,1,82,0,83,G
1-PB2,2251,83,0,0,0,83,A
1-PB2,2252,0,0,0,82,82,C
1-PB2,2253,0,0,0,83,83,C
1-PB2,2254,81,0,0,0,81,A
1-PB2,2255,81,0,0,0,81,A
1-PB2,2256,81,0,0,0,81,A
1-PB2,2257,80,0,1,0,81,A
1-PB2,2258,0,0,81,0,81,G
1-PB2,2259,80,0,0,0,80,A
1-PB2,2260,79,0,0,0,79,A
1-PB2,2261,0,78,0,0,78,T
1-PB2,2262,0,80,0,0,80,T
1-PB2,2263,0,0,0,80,80,C
1-PB2,2264,0,0,79,0,79,G
1-PB2,2265,0,0,80,0,80,G
1-PB2,2266,80,0,0,0,80,A
1-PB2,2267,0,77,0,0,77,T
1-PB2,2268,0,0,76,0,76,G
1-PB2,2269,0,0,77,0,77,G
1-PB2,2270,0,0,0,77,77,C
1-PB2,2271,0,0,0,76,76,C
1-PB2,2272,76,0,0,0,76,A
1-PB2,2273,0,76,0,0,76,T
1-PB2,2274,0,0,0,75,75,C
1-PB2,2275,75,0,0,0,75,A
1-PB2,2276,75,0,0,0,75,A
1-PB2,2277,0,74,0,0,74,T
1-PB2,2278,0,68,0,0,68,T
1-PB2,2279,66,0,0,0,66,A
1-PB2,2280,65,0,0,0,65,A
2-PB1,1,199,0,0,0,199,A
2-PB1,2,0,201,0,0,201,T
2-PB1,3,0,0,202,0,202,G
2-PB1,4,0,0,217,0,217,G
2-PB1,5,232,0,0,0,232,A
2-PB1,6,0,250,0,1,251,T
2-PB1,7,0,0,255,0,255,G
2-PB1,8,0,254,0,0,254,T
2-PB1,9,1,0,0,273,274,C
2-PB1,10,273,0,1,0,274,A
2-PB1,11,282,0,0,0,282,A
2-PB1,12,0,285,0,0,285,T
2-PB1,13,0,0,0,289,289,C
2-PB1,14,0,0,0,311,311,C
2-PB1,15,0,3,312,0,315,G
2-PB1,16,360,0,0,0,360,A
2-PB1,17,0,0,0,366,366,C
2-PB1,18,0,364,0,1,365,T
2-PB1,19,0,0,0,416,416,C
2-PB1,20,1,416,0,0,417,T
2-PB1,21,421,0,0,0,421,A
2-PB1,22,0,0,0,421,421,C
2-PB1,23,0,421,0,0,421,T
2-PB1,24,2,0,464,0,466,G
2-PB1,25,0,470,0,0,470,T
2-PB1,26,0,468,0,0,468,T
2-PB1,27,0,0,0,469,469,C
2-PB1,28,0,0,0,468,468,C
2-PB1,29,0,534,0,1,535,T
2-PB1,30,538,0,0,0,538,A
2-PB1,31,537,0,0,0,537,A
2-PB1,32,536,0,2,0,538,A
2-PB1,33,0,1,541,0,542,G
2-PB1,34,0,0,554,0,554,G
2-PB1,35,0,553,0,1,554,T
2-PB1,36,0,554,0,0,554,T
2-PB1,37,2,0,0,551,553,C
2-PB1,38,0,0,0,553,553,C
2-PB1,39,554,0,0,1,555,A
2-PB1,40,0,0,557,0,557,G
2-PB1,41,1,0,0,558,559,C
2-PB1,42,1,0,561,0,562,G
2-PB1,43,0,0,0,565,565,C
2-PB1,44,565,0,0,0,565,A
2-PB1,45,567,0,0,0,567,A
2-PB1,46,566,0,0,0,566,A
2-PB1,47,573,0,1,0,574,A
2-PB1,48,0,575,0,1,576,T
2-PB1,49,0,0,613,0,613,G
2-PB1,50,0,0,0,618,618,C
2-PB1,51,0,1,0,621,622,C
2-PB1,52,621,0,1,0,622,A
2-PB1,53,0,622,0,0,622,T
2-PB1,54,659,0,0,0,659,A
2-PB1,55,662,0,0,0,662,A
2-PB1,56,0,0,690,0,690,G
2-PB1,57,0,0,0,692,692,C
2-PB1,58,690,0,1,0,691,A
2-PB1,59,0,0,0,731,731,C
2-PB1,60,729,0,2,0,731,A
2-PB1,61,764,1,0,0,765,A
2-PB1,62,0,0,0,767,767,C
2-PB1,63,771,0,0,0,771,A
2-PB1,64,0,776,0,2,778,T
2-PB1,65,0,774,0,0,774,T
2-PB1,66,2,1,0,1002,1005,C
2-PB1,67,1,1,0,1008,1010,C
2-PB1,68,1,0,0,1019,1020,C
2-PB1,69,0,1027,0,1,1028,T
2-PB1,70,0,1027,0,1,1028,T
2-PB1,71,1124,0,0,0,1124,A
2-PB1,72,0,1130,0,0,1130,T
2-PB1,73,1135,0,0,0,1135,A
2-PB1,74,0,1,0,1148,1149,C
2-PB1,75,0,1138,0,3,1141,T
2-PB1,76,1,0,1151,0,1152,G
2-PB1,77,0,1,1151,0,1152,G
2-PB1,78,1154,0,2,0,1156,A
2-PB1,79,0,0,1155,0,1155,G
2-PB1,80,1147,0,2,0,1149,A
2-PB1,81,1,1148,0,0,1149,T
2-PB1,82,0,0,0,1216,1216,C
2-PB1,83,2,0,0,1219,1221,C
2-PB1,84,0,1222,0,2,1224,T
2-PB1,85,1,0,1,1297,1299,C
2-PB1,86,0,0,0,1297,1297,C
2-PB1,87,1307,0,0,1,1308,A
2-PB1,88,0,1310,0,0,1310,T
2-PB1,89,1307,0,0,0,1307,A
2-PB1,90,0,0,0,1312,1312,C
2-PB1,91,1302,1,1,0,1304,A
2-PB1,92,0,0,1354,0,1354,G
2-PB1,93,0,0,0,1366,1366,C
2-PB1,94,1,0,0,1354,1355,C
2-PB1,95,1352,1,1,1,1355,A
2-PB1,96,1,1355,0,3,1359,T
2-PB1,97,1,2,1355,0,1358,G
2-PB1,98,0,1,1422,0,1423,G
2-PB1,99,1440,0,1,0,1441,A
2-PB1,100,1443,1,3,0,1447,A
2-PB1,101,0,1,0,1448,1449,C
2-PB1,102,1443,0,0,0,1443,A
2-PB1,103,0,0,1472,0,1472,G
2-PB1,104,0,5,1486,0,1491,G
2-PB1,105,1487,0,0,0,1487,A
2-PB1,106,1491,0,2,0,1493,A
2-PB1,107,1,1,0,1497,1499,C
2-PB1,108,1498,0,3,0,1501,A
2-PB1,109,1,1,1627,0,1629,G
2-PB1,110,0,3,1625,0,1628,G
2-PB1,111,0,0,1654,0,1654,G
2-PB1,112,0,1651,0,0,1651,T
2-PB1,113,1637,1,1,0,1639,A
2-PB1,114,0,1,0,1658,1659,C
2-PB1,115,1700,0,0,0,1700,A
2-PB1,116,0,0,0,1756,1756,C
2-PB1,117,1,0,0,1749,1750,C
2-PB1,118,1718,1,2,0,1721,A
2-PB1,119,0,1721,0,1,1722,T
2-PB1,120,0,1,1736,0,1737,G
2-PB1,121,0,1,1747,0,1748,G
2-PB1,122,1744,1,2,0,1747,A
2-PB1,123,0,0,0,1753,1753,C
2-PB1,124,1737,0,0,0,1737,A
2-PB1,125,0,2,0,1769,1771,C
2-PB1,126,1786,0,1,0,1787,A
2-PB1,127,0,0,1813,0,1813,G
2-PB1,128,1,1812,0,3,1816,T
2-PB1,129,2,0,0,1853,1855,C
2-PB1,130,1852,0,2,0,1854,A
2-PB1,131,1872,0,1,0,1873,A
2-PB1,132,0,0,0,1873,1873,C
2-PB1,133,1867,1,2,0,1870,A
2-PB1,134,1,1,1895,0,1897,G
2-PB1,135,1876,1,2,0,1879,A
2-PB1,136,1877,0,1,0,1878,A
2-PB1,137,0,0,0,1882,1882,C
2-PB1,138,1867,1,1,0,1869,A
2-PB1,139,1,0,1,1865,1867,C
2-PB1,140,1857,0,2,0,1859,A
2-PB1,141,0,1845,0,2,1847,T
2-PB1,142,2,0,0,1987,1989,C
2-PB1,143,1993,1,0,0,1994,A
2-PB1,144,2020,0,1,1,2022,A
2-PB1,145,0,2047,0,1,2048,T
2-PB1,146,2103,0,1,0,2104,A
2-PB1,147,0,2102,0,0,2102,T
2-PB1,148,1,2069,2,0,2072,T
2-PB1,149,0,0,0,2081,2081,C
2-PB1,150,2047,2,3,0,2052,A
2-PB1,151,0,2,2053,0,2055,G
2-PB1,152,2048,2,0,0,2050,A
2-PB1,153,0,5,2045,0,2050,G
2-PB1,154,2029,0,1,0,2030,A
2-PB1,155,2,4,1998,0,2004,G
2-PB1,156,0,0,1998,1,1999,G
2-PB1,157,1,5,2063,1,2070,G
2-PB1,158,0,1,2072,0,2073,G
2-PB1,159,1,1,2087,0,2089,G
2-PB1,160,2087,1,2,0,2090,A
2-PB1,161,2089,0,2,0,2091,A
2-PB1,162,3,0,2104,0,2107,G
2-PB1,163,1,2090,1,1,2093,T
2-PB1,164,0,0,2099,0,2099,G
2-PB1,165,0,4,2098,0,2102,G
2-PB1,166,2099,0,1,0,2100,A
2-PB1,167,0,1,0,2101,2102,C
2-PB1,168,0,2078,1,2,2081,T
2-PB1,169,2147,2,0,0,2149,A
2-PB1,170,0,0,0,2159,2159,C
2-PB1,171,2160,0,0,0,2160,A
2-PB1,172,2161,0,3,0,2164,A
2-PB1,173,2159,0,3,0,2162,A
2-PB1,174,0,2194,0,0,2194,T
2-PB1,175,2193,0,1,0,2194,A
2-PB1,176,0,1,0,2190,2191,C
2-PB1,177,2172,0,0,0,2172,A
2-PB1,178,2,0,2177,0,2179,G
2-PB1,179,2182,0,0,0,2182,A
2-PB1,180,2201,0,0,0,2201,A
2-PB1,181,2201,1,0,0,2202,A
2-PB1,182,0,0,0,2215,2215,C
2-PB1,183,0,2197,0,0,2197,T
2-PB1,184,1,3,2187,0,2191,G
2-PB1,185,1,4,2191,0,2196,G
2-PB1,186,0,4,2190,0,2194,G
2-PB1,187,0,2,2194,0,2196,G
2-PB1,188,1,2,0,2194,2197,C
2-PB1,189,2196,0,1,0,2197,A
2-PB1,190,0,1,0,2269,2270,C
2-PB1,191,2,1,0,2261,2264,C
2-PB1,192,1,1,0,2267,2269,C
2-PB1,193,2,0,0,2272,2274,C
2-PB1,194,2282,0,2,1,2285,A
2-PB1,195,2310,0,1,0,2311,A
2-PB1,196,0,0,0,2310,2310,C
2-PB1,197,0,2300,0,0,2300,T
2-PB1,198,1,1,0,2305,2307,C
2-PB1,199,2270,0,3,0,2273,A
2-PB1,200,2312,0,1,1,2314,A
2-PB1,201,4,0,0,2310,2314,C
2-PB1,202,0,1,0,2304,2305,C
2-PB1,203,3,0,0,2309,2312,C
2-PB1,204,2305,0,1,0,2306,A
2-PB1,205,2315,0,0,0,2315,A
2-PB1,206,0,2317,0,0,2317,T
2-PB1,207,1,2318,1,5,2325,T
2-PB1,208,1,1,2324,1,2327,G
2-PB1,209,2312,2,3,1,2318,A
2-PB1,210,0,2317,0,1,2318,T
2-PB1,211,1,4,2311,0,2316,G
2-PB1,212,2,2,2351,0,2355,G
2-PB1,213,2368,0,3,0,2371,A
2-PB1,214,0,0,0,2378,2378,C
2-PB1,215,1,1,0,2375,2377,C
2-PB1,216,2372,2,2,0,2376,A
2-PB1,217,0,1,0,2409,2410,C
2-PB1,218,0,2410,0,2,2412,T
2-PB1,219,2430,0,2,0,2432,A
2-PB1,220,1,0,0,2448,2449,C
2-PB1,221,4,1,0,2428,2433,C
2-PB1,222,1,2408,1,4,2414,T
2-PB1,223,3,2,2421,1,2427,G
2-PB1,224,2423,0,4,0,2427,A
2-PB1,225,0,2,2448,0,2450,G
2-PB1,226,0,1,2447,1,2449,G
2-PB1,227,2454,0,1,0,2455,A
2-PB1,228,1,2443,0,0,2444,T
2-PB1,229,2416,0,4,1,2421,A
2-PB1,230,2416,0,3,1,2420,A
2-PB1,231,1,2419,0,1,2421,T
2-PB1,232,1,5,2420,0,2426,G
2-PB1,233,2422,2,4,0,2428,A
2-PB1,234,2413,0,2,0,2415,A
2-PB1,235,0,1,0,2418,2419,C
2-PB1,236,3,0,0,2385,2388,C
2-PB1,237,2390,1,2,1,2394,A
2-PB1,238,2400,0,0,0,2400,A
2-PB1,239,0,2,2404,0,2406,G
2-PB1,240,1,2409,0,1,2411,T
2-PB1,241,0,1,2405,0,2406,G
2-PB1,242,0,5,2428,1,2434,G
2-PB1,243,2429,0,2,0,2431,A
2-PB1,244,0,2423,2,1,2426,T
2-PB1,245,2431,0,1,1,2433,A
2-PB1,246,0,2463,0,3,2466,T
2-PB1,247,1,2,2480,0,2483,G
2-PB1,248,0,0,0,2485,2485,C
2-PB1,249,2482,2,3,0,2487,A
2-PB1,250,0,0,0,2546,2546,C
2-PB1,251,2516,0,0,0,2516,A
2-PB1,252,2557,1,0,0,2558,A
2-PB1,253,2556,1,1,0,2558,A
2-PB1,254,0,0,0,2568,2568,C
2-PB1,255,2508,0,3,0,2511,A
2-PB1,256,0,7,2540,0,2547,G
2-PB1,257,2528,0,2,0,2530,A
2-PB1,258,0,0,0,2537,2537,C
2-PB1,259,2,2445,0,3,2450,T
2-PB1,260,3,1,2484,0,2488,G
2-PB1,261,0,2460,0,3,2463,T
2-PB1,262,0,0,2563,0,2563,G
2-PB1,263,2,2557,0,1,2560,T
2-PB1,264,4,0,0,2568,2572,C
2-PB1,265,2,0,0,2562,2564,C
2-PB1,266,0,2545,0,3,2548,T
2-PB1,267,2,1,2544,1,2548,G
2-PB1,268,1,3,2540,0,2544,G
2-PB1,269,2510,1,2,0,2513,A
2-PB1,270,0,2,2553,0,2555,G
2-PB1,271,1,0,2494,0,2495,G
2-PB1,272,2,0,0,2502,2504,C
2-PB1,273,0,2502,0,5,2507,T
2-PB1,274,2517,0,0,0,2517,A
2-PB1,275,1,2513,0,1,2515,T
2-PB1,276,1,1,2512,0,2514,G
2-PB1,277,1,0,2518,0,2519,G
2-PB1,278,0,2,0,2515,2517,C
2-PB1,279,2446,1,3,2,2452,A
2-PB1,280,0,2452,0,2,2454,T
2-PB1,281,0,2498,0,1,2499,T
2-PB1,282,1,0,0,2509,2510,C
2-PB1,283,1,0,0,2505,2506,C
2-PB1,284,1,2507,0,1,2509,T
2-PB1,285,0,2503,0,5,2508,T
2-PB1,286,1,1,2517,0,2519,G
2-PB1,287,2512,0,1,0,2513,A
2-PB1,288,2520,0,0,0,2520,A
2-PB1,289,0,2,2519,0,2521,G
2-PB1,290,2484,1,0,0,2485,A
2-PB1,291,2490,0,0,1,2491,A
2-PB1,292,0,2488,0,2,2490,T
2-PB1,293,0,2,0,2490,2492,C
2-PB1,294,2,0,0,2495,2497,C
2-PB1,295,8,2,0,2476,2486,C
2-PB1,296,2486,0,2,0,2488,A
2-PB1,297,0,1,0,2499,2500,C
2-PB1,298,3,1,0,2496,2500,C
2-PB1,299,2,0,0,2497,2499,C
2-PB1,300,2474,0,1,0,2475,A
2-PB1,301,1,2,2484,0,2487,G
2-PB1,302,1,0,2490,1,2492,G
2-PB1,303,0,2490,0,2,2492,T
2-PB1,304,2507,0,0,0,2507,A
2-PB1,305,0,2499,0,0,2499,T
2-PB1,306,0,2,0,2491,2493,C
2-PB1,307,0,2483,1,5,2489,T
2-PB1,308,0,2490,0,2,2492,T
2-PB1,309,1,2477,0,3,2481,T
2-PB1,310,0,3,2472,1,2476,G
2-PB1,311,2453,0,4,0,2457,A
2-PB1,312,0,5,2446,2,2453,G
2-PB1,313,2426,0,2,0,2428,A
2-PB1,314,2442,0,0,0,2442,A
2-PB1,315,0,0,0,2447,2447,C
2-PB1,316,0,2419,1,2,2422,T
2-PB1,317,3,2,0,2425,2430,C
2-PB1,318,2430,0,2,0,2432,A
2-PB1,319,0,2428,0,3,2431,T
2-PB1,320,0,1,2440,0,2441,G
2-PB1,321,1,1,0,2466,2468,C
2-PB1,322,5,0,1,2466,2472,C
2-PB1,323,1,2459,1,1,2462,T
2-PB1,324,0,2432,0,2,2434,T
2-PB1,325,0,1,2448,0,2449,G
2-PB1,326,2468,1,2,1,2472,A
2-PB1,327,2465,1,2,0,2468,A
2-PB1,328,2462,1,4,0,2467,A
2-PB1,329,0,1,0,2480,2481,C
2-PB1,330,2430,1,2,1,2434,A
2-PB1,331,2437,1,0,2,2440,A
2-PB1,332,0,2439,0,1,2440,T
2-PB1,333,0,2,2440,0,2442,G
2-PB1,334,1,3,2432,0,2436,G
2-PB1,335,2416,0,3,1,2420,A
2-PB1,336,2419,0,2,0,2421,A
2-PB1,337,0,0,2418,0,2418,G
2-PB1,338,0,0,0,2430,2430,C
2-PB1,339,3,0,0,2418,2421,C
2-PB1,340,2,0,2447,2,2451,G
2-PB1,341,1,2424,0,5,2430,T
2-PB1,342,0,2432,0,3,2435,T
2-PB1,343,4,1,0,2456,2461,C
2-PB1,344,2463,0,2,1,2466,A
2-PB1,345,2482,1,3,0,2486,A
2-PB1,346,1,0,0,2487,2488,C
2-PB1,347,2482,0,2,0,2484,A
2-PB1,348,0,4,2485,0,2489,G
2-PB1,349,2462,0,1,0,2463,A
2-PB1,350,0,0,0,2467,2467,C
2-PB1,351,2464,0,2,1,2467,A
2-PB1,352,2481,0,4,1,2486,A
2-PB1,353,0,5,2493,0,2498,G
2-PB1,354,0,5,2469,0,2474,G
2-PB1,355,1,2,2479,0,2482,G
2-PB1,356,1,2420,0,2,2423,T
2-PB1,357,1,6,2415,0,2422,G
2-PB1,358,0,3,2415,1,2419,G
2-PB1,359,2416,1,3,0,2420,A
2-PB1,360,0,0,0,2420,2420,C
2-PB1,361,2385,0,0,0,2385,A
2-PB1,362,2428,0,1,0,2429,A
2-PB1,363,2420,0,1,1,2422,A
2-PB1,364,0,1,0,2416,2417,C
2-PB1,365,0,2422,1,0,2423,T
2-PB1,366,2413,0,2,0,2415,A
2-PB1,367,2432,0,1,0,2433,A
2-PB1,368,0,1,0,2431,2432,C
2-PB1,369,3,2,0,2419,2424,C
2-PB1,370,6,1,0,2409,2416,C
2-PB1,371,2364,0,1,0,2365,A
2-PB1,372,2363,1,3,0,2367,A
2-PB1,373,0,2,2363,0,2365,G
2-PB1,374,2,0,2361,0,2363,G
2-PB1,375,0,2359,0,3,2362,T
2-PB1,376,5,0,0,2338,2343,C
2-PB1,377,1,1,2340,1,2343,G
2-PB1,378,1,1,0,2337,2339,C
2-PB1,379,3,1,0,2344,2348,C
2-PB1,380,2345,1,0,0,2346,A
2-PB1,381,0,3,2395,0,2398,G
2-PB1,382,2426,0,3,0,2429,A
2-PB1,383,1,2,0,2422,2425,C
2-PB1,384,0,2406,0,2,2408,T
2-PB1,385,0,2410,0,0,2410,T
2-PB1,386,2409,0,2,0,2411,A
2-PB1,387,0,2423,0,3,2426,T
2-PB1,388,0,3,2429,0,2432,G
2-PB1,389,2416,0,0,0,2416,A
2-PB1,390,0,2367,1,4,2372,T
2-PB1,391,0,2320,0,1,2321,T
2-PB1,392,1,3,2307,0,2311,G
2-PB1,393,0,2,2313,0,2315,G
2-PB1,394,2340,0,1,0,2341,A
2-PB1,395,0,1,0,2334,2335,C
2-PB1,396,2305,1,0,0,2306,A
2-PB1,397,0,2295,0,1,2296,T
2-PB1,398,0,2306,0,2,2308,T
2-PB1,399,2326,0,1,0,2327,A
2-PB1,400,2324,1,0,0,2325,A
2-PB1,401,2329,0,1,0,2330,A
2-PB1,402,0,0,0,2326,2326,C
2-PB1,403,2298,0,0,0,2298,A
2-PB1,404,2,0,2321,0,2323,G
2-PB1,405,2314,0,0,0,2314,A
2-PB1,406,2312,0,1,0,2313,A
2-PB1,407,2317,0,1,0,2318,A
2-PB1,408,0,2295,0,1,2296,T
2-PB1,409,8,0,0,2310,2318,C
2-PB1,410,2307,0,1,0,2308,A
2-PB1,411,2311,0,1,0,2312,A
2-PB1,412,0,1,1,2309,2311,C
2-PB1,413,1,0,1,2295,2297,C
2-PB1,414,4,2,2292,0,2298,G
2-PB1,415,0,0,2297,0,2297,G
2-PB1,416,0,0,0,2308,2308,C
2-PB1,417,2298,0,4,0,2302,A
2-PB1,418,0,0,2300,0,2300,G
2-PB1,419,1,1,0,2300,2302,C
2-PB1,420,2305,0,0,0,2305,A
2-PB1,421,2307,2,0,0,2309,A
2-PB1,422,0,0,0,2310,2310,C
2-PB1,423,2,2297,0,3,2302,T
2-PB1,424,0,1,2375,0,2376,G
2-PB1,425,2,0,0,2372,2374,C
2-PB1,426,2369,3,2,0,2374,A
2-PB1,427,0,2372,0,1,2373,T
2-PB1,428,0,2338,0,3,2341,T
2-PB1,429,2423,3,4,1,2431,A
2-PB1,430,0,0,2426,0,2426,G
2-PB1,431,1,1,1,2412,2415,C
2-PB1,432,2,0,0,2414,2416,C
2-PB1,433,2304,0,3,1,2308,A
2-PB1,434,2327,0,0,1,2328,A
2-PB1,435,1,0,0,2348,2349,C
2-PB1,436,2354,0,2,0,2356,A
2-PB1,437,0,1,0,2417,2418,C
2-PB1,438,6,0,0,2307,2313,C
2-PB1,439,2306,1,2,0,2309,A
2-PB1,440,1,2311,1,1,2314,T
2-PB1,441,2312,1,1,0,2314,A
2-PB1,442,0,0,2312,0,2312,G
2-PB1,443,2293,0,1,0,2294,A
2-PB1,444,2271,0,1,0,2272,A
2-PB1,445,0,0,2288,0,2288,G
2-PB1,446,0,2165,2,1,2168,T
2-PB1,447,0,2170,1,1,2172,T
2-PB1,448,0,2179,0,2,2181,T
2-PB1,449,1,2176,0,0,2177,T
2-PB1,450,0,2179,0,1,2180,T
2-PB1,451,2182,0,0,0,2182,A
2-PB1,452,0,0,2182,1,2183,G
2-PB1,453,2174,1,1,1,2177,A
2-PB1,454,3,2163,0,0,2166,T
2-PB1,455,1,1,0,2163,2165,C
2-PB1,456,0,2141,1,1,2143,T
2-PB1,457,2150,1,1,0,2152,A
2-PB1,458,2150,0,2,0,2152,A
2-PB1,459,0,0,0,2164,2164,C
2-PB1,460,0,2,2171,0,2173,G
2-PB1,461,0,2,2198,0,2200,G
2-PB1,462,2186,0,1,0,2187,A
2-PB1,463,2,2182,0,1,2185,T
2-PB1,464,1,2180,0,1,2182,T
2-PB1,465,2181,0,7,0,2188,A
2-PB1,466,2179,0,4,1,2184,A
2-PB1,467,1,0,0,2185,2186,C
2-PB1,468,2168,1,2,0,2171,A
2-PB1,469,0,0,2179,0,2179,G
2-PB1,470,3,0,0,2121,2124,C
2-PB1,471,0,2120,0,2,2122,T
2-PB1,472,2117,0,1,0,2118,A
2-PB1,473,2115,1,0,0,2116,A
2-PB1,474,0,2114,1,0,2115,T
2-PB1,475,0,2,2144,0,2146,G
2-PB1,476,2131,0,0,0,2131,A
2-PB1,477,2132,0,0,0,2132,A
2-PB1,478,2,2098,1,2,2103,T
2-PB1,479,2,1,0,2102,2105,C
2-PB1,480,2106,0,3,1,2110,A
2-PB1,481,0,3,2101,0,2104,G
2-PB1,482,0,2,2104,0,2106,G
2-PB1,483,2099,1,1,0,2101,A
2-PB1,484,2076,0,0,0,2076,A
2-PB1,485,0,3,2153,0,2156,G
2-PB1,486,0,0,2160,1,2161,G
2-PB1,487,1,1,0,2161,2163,C
2-PB1,488,1,2155,0,1,2157,T
2-PB1,489,2162,0,1,1,2164,A
2-PB1,490,2160,0,3,1,2164,A
2-PB1,491,0,2161,0,1,2162,T
2-PB1,492,2164,0,2,0,2166,A
2-PB1,493,0,1,2173,0,2174,G
2-PB1,494,2010,0,0,0,2010,A
2-PB1,495,0,1982,0,4,1986,T
2-PB1,496,0,1977,0,0,1977,T
2-PB1,497,1,1971,0,1,1973,T
2-PB1,498,4,0,0,2022,2026,C
2-PB1,499,0,0,0,2029,2029,C
2-PB1,500,2,2027,0,0,2029,T
2-PB1,501,2,1,0,2028,2031,C
2-PB1,502,2020,0,2,0,2022,A
2-PB1,503,2021,1,1,0,2023,A
2-PB1,504,1,2,2026,0,2029,G
2-PB1,505,1,3,2038,0,2042,G
2-PB1,506,2032,1,2,0,2035,A
2-PB1,507,3,1966,0,2,1971,T
2-PB1,508,0,0,1983,0,1983,G
2-PB1,509,0,1967,0,3,1970,T
2-PB1,510,0,0,1982,0,1982,G
2-PB1,511,1986,0,3,0,1989,A
2-PB1,512,0,1983,1,1,1985,T
2-PB1,513,1,0,1976,0,1977,G
2-PB1,514,2,1,1954,1,1958,G
2-PB1,515,1953,0,1,0,1954,A
2-PB1,516,1956,1,2,0,1959,A
2-PB1,517,0,1951,0,0,1951,T
2-PB1,518,2,0,0,1948,1950,C
2-PB1,519,1927,0,0,0,1927,A
2-PB1,520,1931,0,2,0,1933,A
2-PB1,521,1,1926,1,3,1931,T
2-PB1,522,0,5,1952,2,1959,G
2-PB1,523,0,0,1970,0,1970,G
2-PB1,524,1950,2,4,0,1956,A
2-PB1,525,0,1960,0,0,1960,T
2-PB1,526,1958,0,0,1,1959,A
2-PB1,527,1952,0,0,0,1952,A
2-PB1,528,1951,0,1,0,1952,A
2-PB1,529,1,2,1968,0,1971,G
2-PB1,530,1946,0,6,1,1953,A
2-PB1,531,0,0,1940,0,1940,G
2-PB1,532,2,4,1922,0,1928,G
2-PB1,533,1925,0,0,0,1925,A
2-PB1,534,1930,0,0,1,1931,A
2-PB1,535,1925,0,3,0,1928,A
2-PB1,536,2,1930,0,0,1932,T
2-PB1,537,1,2,1953,0,1956,G
2-PB1,538,0,1,1946,0,1947,G
2-PB1,539,1925,0,5,0,1930,A
2-PB1,540,0,0,1945,0,1945,G
2-PB1,541,1924,0,0,1,1925,A
2-PB1,542,1,1957,0,3,1961,T
2-PB1,543,1959,0,1,1,1961,A
2-PB1,544,1972,0,2,0,1974,A
2-PB1,545,2,0,0,1982,1984,C
2-PB1,546,1942,0,0,1,1943,A
2-PB1,547,1948,0,1,0,1949,A
2-PB1,548,0,1,0,1948,1949,C
2-PB1,549,1926,0,2,0,1928,A
2-PB1,550,1,0,0,1921,1922,C
2-PB1,551,1886,0,1,1,1888,A
2-PB1,552,0,1,0,1910,1911,C
2-PB1,553,1,1890,1,2,1894,T
2-PB1,554,0,1889,1,1,1891,T
2-PB1,555,0,1895,0,1,1896,T
2-PB1,556,1,0,1,1894,1896,C
2-PB1,557,1899,0,1,0,1900,A
2-PB1,558,1900,0,0,0,1900,A
2-PB1,559,1902,0,1,1,1904,A
2-PB1,560,0,2,1921,0,1923,G
2-PB1,561,1894,0,0,0,1894,A
2-PB1,562,1894,1,0,0,1895,A
2-PB1,563,1896,0,1,0,1897,A
2-PB1,564,1893,0,3,1,1897,A
2-PB1,565,1895,0,4,0,1899,A
2-PB1,566,0,1,1904,0,1905,G
2-PB1,567,0,2,1902,0,1904,G
2-PB1,568,1876,1,5,0,1882,A
2-PB1,569,0,2,1918,0,1920,G
2-PB1,570,1907,0,5,0,1912,A
2-PB1,571,0,1,1962,0,1963,G
2-PB1,572,0,1953,0,1,1954,T
2-PB1,573,1957,0,1,0,1958,A
2-PB1,574,1953,0,2,0,1955,A
2-PB1,575,0,3,1952,0,1955,G
2-PB1,576,1,2,1961,0,1964,G
2-PB1,577,1,2,1962,1,1966,G
2-PB1,578,1927,0,2,0,1929,A
2-PB1,579,2,1,0,1935,1938,C
2-PB1,580,1896,0,0,0,1896,A
2-PB1,581,1900,0,0,0,1900,A
2-PB1,582,2,0,0,1898,1900,C
2-PB1,583,1896,1,2,1,1900,A
2-PB1,584,1,1885,0,0,1886,T
2-PB1,585,1,1,1876,0,1878,G
2-PB1,586,1880,0,2,0,1882,A
2-PB1,587,5,1,1,1869,1876,C
2-PB1,588,2,0,0,1850,1852,C
2-PB1,589,1862,0,0,0,1862,A
2-PB1,590,1868,0,1,0,1869,A
2-PB1,591,1,2,1874,0,1877,G
2-PB1,592,1876,0,0,0,1876,A
2-PB1,593,1876,0,2,0,1878,A
2-PB1,594,1869,0,0,0,1869,A
2-PB1,595,1874,0,1,0,1875,A
2-PB1,596,1,1868,0,0,1869,T
2-PB1,597,1,2,1863,1,1867,G
2-PB1,598,0,0,1883,0,1883,G
2-PB1,599,0,1864,0,3,1867,T
2-PB1,600,3,1,0,1855,1859,C
2-PB1,601,1868,0,1,0,1869,A
2-PB1,602,0,0,0,1928,1928,C
2-PB1,603,1943,0,0,0,1943,A
2-PB1,604,2,0,0,1938,1940,C
2-PB1,605,1940,0,3,0,1943,A
2-PB1,606,1965,0,2,0,1967,A
2-PB1,607,1950,0,3,0,1953,A
2-PB1,608,0,1,2044,0,2045,G
2-PB1,609,2035,1,1,1,2038,A
2-PB1,610,2050,0,1,0,2051,A
2-PB1,611,2,0,1,2081,2084,C
2-PB1,612,2026,1,0,0,2027,A
2-PB1,613,2029,0,1,0,2030,A
2-PB1,614,0,2024,1,1,2026,T
2-PB1,615,2013,1,3,1,2018,A
2-PB1,616,1,2,2008,0,2011,G
2-PB1,617,0,3,1957,0,1960,G
2-PB1,618,12,0,1953,0,1965,G
2-PB1,619,1959,0,0,0,1959,A
2-PB1,620,1920,0,3,0,1923,A
2-PB1,621,0,4,1933,0,1937,G
2-PB1,622,1937,0,0,0,1937,A
2-PB1,623,1936,1,0,0,1937,A
2-PB1,624,1942,0,3,0,1945,A
2-PB1,625,1956,0,1,0,1957,A
2-PB1,626,1979,0,0,0,1979,A
2-PB1,627,1979,1,1,2,1983,A
2-PB1,628,0,0,0,1986,1986,C
2-PB1,629,1980,0,0,0,1980,A
2-PB1,630,1983,0,1,0,1984,A
2-PB1,631,1971,0,2,0,1973,A
2-PB1,632,0,1,2020,0,2021,G
2-PB1,633,2013,0,2,0,2015,A
2-PB1,634,1,1,2073,0,2075,G
2-PB1,635,2,2036,0,0,2038,T
2-PB1,636,44,1,2178,1,2224,G
2-PB1,637,2227,0,3,0,2230,A
2-PB1,638,2225,1,0,0,2226,A
2-PB1,639,0,2249,1,1,2251,T
2-PB1,640,2250,0,3,0,2253,A
2-PB1,641,2207,1,3,0,2211,A
2-PB1,642,0,5,2204,0,2209,G
2-PB1,643,2123,0,8,0,2131,A
2-PB1,644,1,1,2137,0,2139,G
2-PB1,645,1998,0,2,0,2000,A
2-PB1,646,0,6,2005,0,2011,G
2-PB1,647,1,0,2014,0,2015,G
2-PB1,648,1,0,0,2006,2007,C
2-PB1,649,0,1998,0,2,2000,T
2-PB1,650,2040,1,0,0,2041,A
2-PB1,651,5,0,0,2113,2118,C
2-PB1,652,3,2,0,2108,2113,C
2-PB1,653,1,2114,1,5,2121,T
2-PB1,654,2179,0,1,0,2180,A
2-PB1,655,2178,0,0,1,2179,A
2-PB1,656,0,2173,0,1,2174,T
2-PB1,657,2165,0,1,0,2166,A
2-PB1,658,2158,1,1,1,2161,A
2-PB1,659,1,4,2153,1,2159,G
2-PB1,660,2092,0,4,0,2096,A
2-PB1,661,2,0,2114,0,2116,G
2-PB1,662,0,0,0,2111,2111,C
2-PB1,663,0,2076,0,2,2078,T
2-PB1,664,1,2074,0,2,2077,T
2-PB1,665,0,2078,1,0,2079,T
2-PB1,666,0,6,2073,0,2079,G
2-PB1,667,2123,0,0,0,2123,A
2-PB1,668,0,0,0,2130,2130,C
2-PB1,669,2116,0,1,0,2117,A
2-PB1,670,1,2104,0,1,2106,T
2-PB1,671,0,2090,0,1,2091,T
2-PB1,672,0,1,2116,0,2117,G
2-PB1,673,2115,2,2,1,2120,A
2-PB1,674,2122,0,2,0,2124,A
2-PB1,675,0,0,0,2121,2121,C
2-PB1,676,2115,0,1,0,2116,A
2-PB1,677,0,1,0,2105,2106,C
2-PB1,678,2,0,2109,0,2111,G
2-PB1,679,2111,0,0,0,2111,A
2-PB1,680,0,2122,0,1,2123,T
2-PB1,681,1,3,2141,0,2145,G
2-PB1,682,2150,0,4,0,2154,A
2-PB1,683,1,1,0,2151,2153,C
2-PB1,684,2,1,0,2150,2153,C
2-PB1,685,2153,0,1,0,2154,A
2-PB1,686,2161,3,4,1,2169,A
2-PB1,687,2164,2,2,1,2169,A
2-PB1,688,0,2,2204,0,2206,G
2-PB1,689,2214,2,1,0,2217,A
2-PB1,690,0,2186,1,1,2188,T
2-PB1,691,0,1,2192,0,2193,G
2-PB1,692,0,0,0,2187,2187,C
2-PB1,693,2182,0,6,0,2188,A
2-PB1,694,0,1,2199,0,2200,G
2-PB1,695,2175,0,2,0,2177,A
2-PB1,696,2,2,2178,0,2182,G
2-PB1,697,2123,0,0,0,2123,A
2-PB1,698,0,2,2120,0,2122,G
2-PB1,699,2097,2,6,0,2105,A
2-PB1,700,0,3,2097,0,2100,G
2-PB1,701,0,0,2098,0,2098,G
2-PB1,702,0,0,0,2094,2094,C
2-PB1,703,2086,0,4,0,2090,A
2-PB1,704,2093,0,0,0,2093,A
2-PB1,705,2095,2,1,0,2098,A
2-PB1,706,1,2098,1,1,2101,T
2-PB1,707,0,2096,1,0,2097,T
2-PB1,708,2099,1,0,0,2100,A
2-PB1,709,2090,0,3,2,2095,A
2-PB1,710,2100,0,0,1,2101,A
2-PB1,711,2096,0,0,1,2097,A
2-PB1,712,2097,1,2,2,2102,A
2-PB1,713,0,0,2108,0,2108,G
2-PB1,714,2105,0,1,0,2106,A
2-PB1,715,2093,1,2,0,2096,A
2-PB1,716,0,4,2122,1,2127,G
2-PB1,717,0,3,2131,0,2134,G
2-PB1,718,1,1,2134,0,2136,G
2-PB1,719,2,1,0,2133,2136,C
2-PB1,720,0,2139,0,2,2141,T
2-PB1,721,2146,0,0,0,2146,A
2-PB1,722,0,2154,1,1,2156,T
2-PB1,723,0,2153,0,1,2154,T
2-PB1,724,2,0,2156,0,2158,G
2-PB1,725,0,2,0,2133,2135,C
2-PB1,726,2075,1,2,0,2078,A
2-PB1,727,2082,0,0,1,2083,A
2-PB1,728,0,1,0,2076,2077,C
2-PB1,729,2072,0,0,1,2073,A
2-PB1,730,1,0,0,2074,2075,C
2-PB1,731,3,0,0,2024,2027,C
2-PB1,732,5,0,0,2035,2040,C
2-PB1,733,1,1,2039,0,2041,G
2-PB1,734,0,1,2045,1,2047,G
2-PB1,735,1,0,2050,0,2051,G
2-PB1,736,2042,0,1,0,2043,A
2-PB1,737,0,2036,0,1,2037,T
2-PB1,738,0,0,2036,0,2036,G
2-PB1,739,0,2,1,2023,2026,C
2-PB1,740,2052,0,1,0,2053,A
2-PB1,741,2069,0,0,1,2070,A
2-PB1,742,2082,0,0,1,2083,A
2-PB1,743,1,2073,0,0,2074,T
2-PB1,744,0,2075,0,0,2075,T
2-PB1,745,2064,0,2,0,2066,A
2-PB1,746,0,2,2059,0,2061,G
2-PB1,747,2038,1,6,2,2047,A
2-PB1,748,0,5,2059,0,2064,G
2-PB1,749,0,1,2031,0,2032,G
2-PB1,750,0,0,2061,0,2061,G
2-PB1,751,1,2028,0,1,2030,T
2-PB1,752,0,2030,0,2,2032,T
2-PB1,753,4,2,0,2021,2027,C
2-PB1,754,1,0,2045,0,2046,G
2-PB1,755,0,2045,0,2,2047,T
2-PB1,756,3,1,2039,0,2043,G
2-PB1,757,0,2043,0,1,2044,T
2-PB1,758,2028,0,0,0,2028,A
2-PB1,759,0,1,0,2019,2020,C
2-PB1,760,0,1913,0,3,1916,T
2-PB1,761,0,1928,0,0,1928,T
2-PB1,762,1,0,0,1918,1919,C
2-PB1,763,1,1,1907,0,1909,G
2-PB1,764,1,1903,0,1,1905,T
2-PB1,765,0,1895,0,4,1899,T
2-PB1,766,0,0,1895,0,1895,G
2-PB1,767,1897,0,0,2,1899,A
2-PB1,768,1886,1,5,0,1892,A
2-PB1,769,1899,0,2,0,1901,A
2-PB1,770,0,0,0,1911,1911,C
2-PB1,771,0,1895,0,3,1898,T
2-PB1,772,0,1886,0,0,1886,T
2-PB1,773,0,1890,0,0,1890,T
2-PB1,774,1904,0,3,0,1907,A
2-PB1,775,1,0,1906,0,1907,G
2-PB1,776,0,0,0,1918,1918,C
2-PB1,777,0,1913,0,2,1915,T
2-PB1,778,1904,0,1,1,1906,A
2-PB1,779,0,3,1897,0,1900,G
2-PB1,780,1904,0,0,0,1904,A
2-PB1,781,1900,0,2,1,1903,A
2-PB1,782,0,0,1908,0,1908,G
2-PB1,783,0,1845,0,0,1845,T
2-PB1,784,1859,0,2,0,1861,A
2-PB1,785,0,1852,0,0,1852,T
2-PB1,786,1,1854,0,0,1855,T
2-PB1,787,0,1851,0,0,1851,T
2-PB1,788,1,0,1854,0,1855,G
2-PB1,789,0,0,0,1854,1854,C
2-PB1,790,0,1,1853,0,1854,G
2-PB1,791,1837,0,1,0,1838,A
2-PB1,792,1836,0,1,0,1837,A
2-PB1,793,1840,0,3,0,1843,A
2-PB1,794,1878,0,4,0,1882,A
2-PB1,795,0,0,1895,0,1895,G
2-PB1,796,1,1,0,1895,1897,C
2-PB1,797,0,1890,0,6,1896,T
2-PB1,798,0,1898,0,1,1899,T
2-PB1,799,2,4,1890,0,1896,G
2-PB1,800,1897,0,0,0,1897,A
2-PB1,801,1893,0,3,0,1896,A
2-PB1,802,0,0,0,1901,1901,C
2-PB1,803,1821,0,0,0,1821,A
2-PB1,804,1,0,1918,0,1919,G
2-PB1,805,0,1868,0,0,1868,T
2-PB1,806,2,0,0,1863,1865,C
2-PB1,807,0,1866,1,3,1870,T
2-PB1,808,2,4,1867,0,1873,G
2-PB1,809,0,1,1862,0,1863,G
2-PB1,810,1869,0,2,0,1871,A
2-PB1,811,0,2,0,1867,1869,C
2-PB1,812,0,1810,0,4,1814,T
2-PB1,813,0,1731,0,3,1734,T
2-PB1,814,1,2,0,1725,1728,C
2-PB1,815,2,2,0,1734,1738,C
2-PB1,816,2,1,1739,0,1742,G
2-PB1,817,0,2,1735,0,1737,G
2-PB1,818,0,1727,0,1,1728,T
2-PB1,819,0,1726,0,0,1726,T
2-PB1,820,2,0,1720,1,1723,G
2-PB1,821,2,2,1722,0,1726,G
2-PB1,822,0,2,1728,0,1730,G
2-PB1,823,0,1,1725,1,1727,G
2-PB1,824,1,0,1737,0,1738,G
2-PB1,825,1,1720,0,2,1723,T
2-PB1,826,1722,0,0,0,1722,A
2-PB1,827,1727,1,1,0,1729,A
2-PB1,828,0,1730,0,1,1731,T
2-PB1,829,1,0,1739,0,1740,G
2-PB1,830,1712,1,0,0,1713,A
2-PB1,831,1700,0,0,0,1700,A
2-PB1,832,1704,0,0,0,1704,A
2-PB1,833,1694,0,2,0,1696,A
2-PB1,834,0,2,1692,0,1694,G
2-PB1,835,1687,0,0,0,1687,A
2-PB1,836,1674,0,2,0,1676,A
2-PB1,837,1,1,1679,0,1681,G
2-PB1,838,0,0,1673,0,1673,G
2-PB1,839,1,1,0,1669,1671,C
2-PB1,840,0,0,0,1666,1666,C
2-PB1,841,1661,1,3,0,1665,A
2-PB1,842,1665,0,1,0,1666,A
2-PB1,843,1668,0,0,0,1668,A
2-PB1,844,1,0,0,1673,1674,C
2-PB1,845,0,1666,0,2,1668,T
2-PB1,846,0,0,1685,0,1685,G
2-PB1,847,3,0,1682,0,1685,G
2-PB1,848,0,1,0,1685,1686,C
2-PB1,849,1687,0,0,0,1687,A
2-PB1,850,1684,1,1,0,1686,A
2-PB1,851,1687,1,0,1,1689,A
2-PB1,852,0,1683,0,0,1683,T
2-PB1,853,1,1,1690,0,1692,G
2-PB1,854,0,1684,0,1,1685,T
2-PB1,855,0,1612,1,0,1613,T
2-PB1,856,0,0,1614,0,1614,G
2-PB1,857,0,1607,1,1,1609,T
2-PB1,858,0,1,1616,0,1617,G
2-PB1,859,1614,0,0,0,1614,A
2-PB1,860,0,0,1618,0,1618,G
2-PB1,861,1616,1,1,0,1618,A
2-PB1,862,1605,0,0,1,1606,A
2-PB1,863,1599,0,3,0,1602,A
2-PB1,864,1602,1,0,1,1604,A
2-PB1,865,1606,0,1,0,1607,A
2-PB1,866,0,1601,0,1,1602,T
2-PB1,867,0,1,1597,0,1598,G
2-PB1,868,1596,0,2,0,1598,A
2-PB1,869,0,1585,0,1,1586,T
2-PB1,870,0,3,1586,0,1589,G
2-PB1,871,1589,0,1,0,1590,A
2-PB1,872,0,0,0,1595,1595,C
2-PB1,873,0,1596,0,1,1597,T
2-PB1,874,1583,0,0,0,1583,A
2-PB1,875,1592,0,2,0,1594,A
2-PB1,876,0,1583,0,2,1585,T
2-PB1,877,0,1597,0,2,1599,T
2-PB1,878,1,0,0,1605,1606,C
2-PB1,879,1585,0,1,0,1586,A
2-PB1,880,0,3,0,1586,1589,C
2-PB1,881,1550,0,5,0,1555,A
2-PB1,882,1553,1,1,0,1555,A
2-PB1,883,1,0,1554,0,1555,G
2-PB1,884,1567,0,1,0,1568,A
2-PB1,885,1,0,0,1564,1565,C
2-PB1,886,1540,2,2,0,1544,A
2-PB1,887,0,0,0,1540,1540,C
2-PB1,888,1520,0,2,0,1522,A
2-PB1,889,0,1,1524,0,1525,G
2-PB1,890,1520,0,0,0,1520,A
2-PB1,891,0,0,1523,0,1523,G
2-PB1,892,0,2,0,1518,1520,C
2-PB1,893,0,1473,0,4,1477,T
2-PB1,894,0,1484,0,1,1485,T
2-PB1,895,0,1486,0,0,1486,T
2-PB1,896,1,0,0,1490,1491,C
2-PB1,897,0,1479,0,3,1482,T
2-PB1,898,0,1464,0,1,1465,T
2-PB1,899,0,1462,0,1,1463,T
2-PB1,900,0,0,0,1459,1459,C
2-PB1,901,1458,1,2,0,1461,A
2-PB1,902,0,0,0,1465,1465,C
2-PB1,903,1448,0,2,0,1450,A
2-PB1,904,1451,0,0,0,1451,A
2-PB1,905,1,1452,0,0,1453,T
2-PB1,906,3,0,0,1461,1464,C
2-PB1,907,1468,1,0,0,1469,A
2-PB1,908,1,0,0,1475,1476,C
2-PB1,909,0,1457,0,0,1457,T
2-PB1,910,0,0,1456,2,1458,G
2-PB1,911,0,1,1456,0,1457,G
2-PB1,912,1,2,1472,0,1475,G
2-PB1,913,0,0,1471,0,1471,G
2-PB1,914,1438,0,2,0,1440,A
2-PB1,915,1,1,0,1366,1368,C
2-PB1,916,1382,0,1,0,1383,A
2-PB1,917,1432,1,0,0,1433,A
2-PB1,918,0,0,0,1443,1443,C
2-PB1,919,1427,0,3,0,1430,A
2-PB1,920,0,1,0,1428,1429,C
2-PB1,921,0,1364,0,0,1364,T
2-PB1,922,1372,0,1,0,1373,A
2-PB1,923,1368,0,3,0,1371,A
2-PB1,924,1,0,1374,0,1375,G
2-PB1,925,0,1360,0,2,1362,T
2-PB1,926,1,3,1257,0,1261,G
2-PB1,927,0,1,1243,0,1244,G
2-PB1,928,1232,0,1,0,1233,A
2-PB1,929,1235,0,0,0,1235,A
2-PB1,930,0,1234,0,0,1234,T
2-PB1,931,0,0,1232,0,1232,G
2-PB1,932,1230,1,0,0,1231,A
2-PB1,933,1212,0,1,0,1213,A
2-PB1,934,1217,0,0,0,1217,A
2-PB1,935,1220,0,0,0,1220,A
2-PB1,936,1,1205,1,0,1207,T
2-PB1,937,1,0,0,1211,1212,C
2-PB1,938,1209,0,0,0,1209,A
2-PB1,939,1209,0,0,0,1209,A
2-PB1,940,1206,0,1,0,1207,A
2-PB1,941,1206,0,2,0,1208,A
2-PB1,942,1,0,0,1211,1212,C
2-PB1,943,1,0,0,1185,1186,C
2-PB1,944,3,1,0,1177,1181,C
2-PB1,945,0,1174,0,3,1177,T
2-PB1,946,2,2,0,1178,1182,C
2-PB1,947,3,1,1178,0,1182,G
2-PB1,948,1183,0,1,0,1184,A
2-PB1,949,1178,0,1,0,1179,A
2-PB1,950,0,1181,0,0,1181,T
2-PB1,951,0,0,1181,0,1181,G
2-PB1,952,0,1164,0,3,1167,T
2-PB1,953,1,1167,0,1,1169,T
2-PB1,954,0,1174,0,1,1175,T
2-PB1,955,0,1171,0,0,1171,T
2-PB1,956,0,1166,0,0,1166,T
2-PB1,957,1,2,1166,0,1169,G
2-PB1,958,0,0,1169,0,1169,G
2-PB1,959,1,1,0,1166,1168,C
2-PB1,960,0,0,1157,0,1157,G
2-PB1,961,1160,0,0,0,1160,A
2-PB1,962,0,1179,0,0,1179,T
2-PB1,963,0,1,1199,0,1200,G
2-PB1,964,1225,0,0,0,1225,A
2-PB1,965,0,1231,0,2,1233,T
2-PB1,966,0,1230,0,2,1232,T
2-PB1,967,1234,0,2,0,1236,A
2-PB1,968,0,1,0,1237,1238,C
2-PB1,969,1241,0,1,0,1242,A
2-PB1,970,0,1237,0,0,1237,T
2-PB1,971,1150,0,0,0,1150,A
2-PB1,972,0,0,0,1140,1140,C
2-PB1,973,1007,0,1,0,1008,A
2-PB1,974,1,1001,0,3,1005,T
2-PB1,975,1,1,1,1002,1005,C
2-PB1,976,996,0,1,0,997,A
2-PB1,977,1,0,0,998,999,C
2-PB1,978,991,0,1,0,992,A
2-PB1,979,990,0,1,0,991,A
2-PB1,980,986,0,0,0,986,A
2-PB1,981,0,0,945,0,945,G
2-PB1,982,976,0,0,0,976,A
2-PB1,983,977,0,0,0,977,A
2-PB1,984,0,973,0,0,973,T
2-PB1,985,1,0,0,964,965,C
2-PB1,986,958,0,1,0,959,A
2-PB1,987,961,0,0,0,961,A
2-PB1,988,0,0,0,963,963,C
2-PB1,989,0,0,0,963,963,C
2-PB1,990,0,855,1,2,858,T
2-PB1,991,0,2,861,0,863,G
2-PB1,992,856,0,2,0,858,A
2-PB1,993,1,0,860,0,861,G
2-PB1,994,0,849,0,1,850,T
2-PB1,995,0,0,822,0,822,G
2-PB1,996,0,0,846,0,846,G
2-PB1,997,1,831,0,1,833,T
2-PB1,998,0,828,0,0,828,T
2-PB1,999,0,1,0,831,832,C
2-PB1,1000,809,0,0,0,809,A
2-PB1,1001,1,1,810,0,812,G
2-PB1,1002,809,0,1,0,810,A
2-PB1,1003,812,0,0,0,812,A
2-PB1,1004,801,0,2,0,803,A
2-PB1,1005,0,1,0,675,676,C
2-PB1,1006,675,0,1,0,676,A
2-PB1,1007,0,669,0,0,669,T
2-PB1,1008,2,0,0,678,680,C
2-PB1,1009,0,1,1,680,682,C
2-PB1,1010,0,627,0,0,627,T
2-PB1,1011,1,0,627,0,628,G
2-PB1,1012,621,0,2,0,623,A
2-PB1,1013,0,0,623,0,623,G
2-PB1,1014,0,0,0,609,609,C
2-PB1,1015,584,0,0,0,584,A
2-PB1,1016,0,592,0,0,592,T
2-PB1,1017,0,0,0,592,592,C
2-PB1,1018,1,0,587,1,589,G
2-PB1,1019,0,0,0,605,605,C
2-PB1,1020,492,0,114,1,607,A
2-PB1,1021,0,0,0,645,645,C
2-PB1,1022,0,0,0,646,646,C
2-PB1,1023,650,0,1,0,651,A
2-PB1,1024,658,0,1,0,659,A
2-PB1,1025,0,653,0,0,653,T
2-PB1,1026,647,0,0,0,647,A
2-PB1,1027,649,0,0,0,649,A
2-PB1,1028,0,627,0,0,627,T
2-PB1,1029,0,0,632,0,632,G
2-PB1,1030,0,622,1,0,623,T
2-PB1,1031,0,618,0,2,620,T
2-PB1,1032,0,0,0,618,618,C
2-PB1,1033,0,614,0,0,614,T
2-PB1,1034,1,0,0,617,618,C
2-PB1,1035,615,0,0,1,616,A
2-PB1,1036,617,0,0,0,617,A
2-PB1,1037,619,0,0,0,619,A
2-PB1,1038,0,0,0,619,619,C
2-PB1,1039,618,0,0,0,618,A
2-PB1,1040,618,0,0,0,618,A
2-PB1,1041,614,0,1,0,615,A
2-PB1,1042,615,0,1,0,616,A
2-PB1,1043,0,615,0,3,618,T
2-PB1,1044,0,2,617,0,619,G
2-PB1,1045,0,0,618,0,618,G
2-PB1,1046,0,0,0,615,615,C
2-PB1,1047,613,0,0,0,613,A
2-PB1,1048,617,0,0,0,617,A
2-PB1,1049,0,0,616,0,616,G
2-PB1,1050,616,0,0,0,616,A
2-PB1,1051,0,611,0,0,611,T
2-PB1,1052,0,619,0,0,619,T
2-PB1,1053,0,0,627,0,627,G
2-PB1,1054,0,1,623,0,624,G
2-PB1,1055,0,0,632,0,632,G
2-PB1,1056,632,0,0,0,632,A
2-PB1,1057,627,0,1,0,628,A
2-PB1,1058,628,0,0,0,628,A
2-PB1,1059,628,0,1,0,629,A
2-PB1,1060,0,1,649,0,650,G
2-PB1,1061,0,0,650,0,650,G
2-PB1,1062,655,1,0,0,656,A
2-PB1,1063,0,656,0,0,656,T
2-PB1,1064,653,0,0,0,653,A
2-PB1,1065,0,0,0,652,652,C
2-PB1,1066,654,0,1,0,655,A
2-PB1,1067,0,655,0,0,655,T
2-PB1,1068,0,0,656,0,656,G
2-PB1,1069,0,636,0,0,636,T
2-PB1,1070,0,633,0,0,633,T
2-PB1,1071,0,1,0,632,633,C
2-PB1,1072,0,0,635,0,635,G
2-PB1,1073,636,0,0,0,636,A
2-PB1,1074,0,0,646,0,646,G
2-PB1,1075,639,0,1,0,640,A
2-PB1,1076,0,0,644,0,644,G
2-PB1,1077,0,635,0,3,638,T
2-PB1,1078,636,0,0,0,636,A
2-PB1,1079,633,0,1,0,634,A
2-PB1,1080,0,0,641,0,641,G
2-PB1,1081,639,0,0,0,639,A
2-PB1,1082,0,0,650,0,650,G
2-PB1,1083,637,0,1,0,638,A
2-PB1,1084,643,0,1,0,644,A
2-PB1,1085,0,638,0,0,638,T
2-PB1,1086,0,0,636,0,636,G
2-PB1,1087,636,0,2,0,638,A
2-PB1,1088,638,0,0,0,638,A
2-PB1,1089,0,0,641,0,641,G
2-PB1,1090,0,0,0,634,634,C
2-PB1,1091,0,627,0,0,627,T
2-PB1,1092,0,0,0,629,629,C
2-PB1,1093,2,1,0,627,630,C
2-PB1,1094,0,1,629,0,630,G
2-PB1,1095,0,2,628,0,630,G
2-PB1,1096,632,0,0,0,632,A
2-PB1,1097,0,0,0,636,636,C
2-PB1,1098,635,0,1,0,636,A
2-PB1,1099,0,1,0,638,639,C
2-PB1,1100,642,0,0,0,642,A
2-PB1,1101,640,0,2,0,642,A
2-PB1,1102,638,1,0,0,639,A
2-PB1,1103,0,638,0,0,638,T
2-PB1,1104,637,0,0,0,637,A
2-PB1,1105,0,1,0,637,638,C
2-PB1,1106,0,0,0,630,630,C
2-PB1,1107,0,628,0,2,630,T
2-PB1,1108,0,0,636,0,636,G
2-PB1,1109,0,2,0,632,634,C
2-PB1,1110,634,0,1,0,635,A
2-PB1,1111,0,0,637,0,637,G
2-PB1,1112,633,0,1,0,634,A
2-PB1,1113,634,0,0,0,634,A
2-PB1,1114,631,0,1,0,632,A
2-PB1,1115,1,626,0,0,627,T
2-PB1,1116,1,0,628,0,629,G
2-PB1,1117,0,1,0,621,622,C
2-PB1,1118,0,622,0,2,624,T
2-PB1,1119,626,0,0,0,626,A
2-PB1,1120,0,0,626,0,626,G
2-PB1,1121,0,0,0,627,627,C
2-PB1,1122,629,0,0,0,629,A
2-PB1,1123,628,0,0,0,628,A
2-PB1,1124,0,0,626,0,626,G
2-PB1,1125,0,0,0,624,624,C
2-PB1,1126,620,0,0,0,620,A
2-PB1,1127,0,635,0,0,635,T
2-PB1,1128,0,636,0,0,636,T
2-PB1,1129,0,1,651,0,652,G
2-PB1,1130,653,0,2,0,655,A
2-PB1,1131,0,1,0,651,652,C
2-PB1,1132,1,1,0,653,655,C
2-PB1,1133,1,632,0,0,633,T
2-PB1,1134,0,0,646,0,646,G
2-PB1,1135,643,0,2,0,645,A
2-PB1,1136,644,0,0,0,644,A
2-PB1,1137,0,0,657,0,657,G
2-PB1,1138,0,639,0,0,639,T
2-PB1,1139,647,0,0,0,647,A
2-PB1,1140,0,641,0,0,641,T
2-PB1,1141,0,644,0,0,644,T
2-PB1,1142,0,641,0,0,641,T
2-PB1,1143,1,0,0,634,635,C
2-PB1,1144,636,0,2,0,638,A
2-PB1,1145,638,1,0,0,639,A
2-PB1,1146,1,632,0,0,633,T
2-PB1,1147,0,0,637,0,637,G
2-PB1,1148,631,1,0,0,632,A
2-PB1,1149,636,0,0,0,636,A
2-PB1,1150,0,633,0,1,634,T
2-PB1,1151,1,0,0,635,636,C
2-PB1,1152,634,0,2,0,636,A
2-PB1,1153,636,0,0,0,636,A
2-PB1,1154,0,0,0,637,637,C
2-PB1,1155,635,0,0,0,635,A
2-PB1,1156,636,0,1,0,637,A
2-PB1,1157,0,1,634,0,635,G
2-PB1,1158,1,0,640,0,641,G
2-PB1,1159,637,0,2,0,639,A
2-PB1,1160,640,0,1,0,641,A
2-PB1,1161,0,0,641,0,641,G
2-PB1,1162,642,0,0,0,642,A
2-PB1,1163,645,0,0,0,645,A
2-PB1,1164,644,0,0,0,644,A
2-PB1,1165,642,0,0,0,642,A
2-PB1,1166,0,639,0,0,639,T
2-PB1,1167,0,634,0,0,634,T
2-PB1,1168,0,1,636,0,637,G
2-PB1,1169,638,0,0,0,638,A
2-PB1,1170,0,0,640,0,640,G
2-PB1,1171,639,0,0,0,639,A
2-PB1,1172,642,0,1,0,643,A
2-PB1,1173,652,0,0,1,653,A
2-PB1,1174,655,0,1,0,656,A
2-PB1,1175,0,654,0,0,654,T
2-PB1,1176,653,0,0,0,653,A
2-PB1,1177,654,0,0,0,654,A
2-PB1,1178,1,0,652,0,653,G
2-PB1,1179,0,0,654,0,654,G
2-PB1,1180,0,0,0,646,646,C
2-PB1,1181,1,2,0,646,649,C
2-PB1,1182,0,641,0,0,641,T
2-PB1,1183,0,0,0,687,687,C
2-PB1,1184,0,693,0,1,694,T
2-PB1,1185,1,697,0,2,700,T
2-PB1,1186,1,0,0,707,708,C
2-PB1,1187,0,707,0,0,707,T
2-PB1,1188,708,0,0,0,708,A
2-PB1,1189,708,0,0,0,708,A
2-PB1,1190,0,708,0,0,708,T
2-PB1,1191,711,0,0,0,711,A
2-PB1,1192,0,1,694,1,696,G
2-PB1,1193,652,1,1,0,654,A
2-PB1,1194,0,657,0,0,657,T
2-PB1,1195,0,3,643,0,646,G
2-PB1,1196,0,0,653,0,653,G
2-PB1,1197,1,0,0,650,651,C
2-PB1,1198,654,0,0,0,654,A
2-PB1,1199,0,0,0,654,654,C
2-PB1,1200,649,0,0,0,649,A
2-PB1,1201,0,0,673,0,673,G
2-PB1,1202,0,0,0,675,675,C
2-PB1,1203,673,0,0,0,673,A
2-PB1,1204,0,689,0,2,691,T
2-PB1,1205,1,0,0,681,682,C
2-PB1,1206,683,0,0,0,683,A
2-PB1,1207,0,685,0,0,685,T
2-PB1,1208,0,683,0,0,683,T
2-PB1,1209,1,0,681,0,682,G
2-PB1,1210,664,0,0,0,664,A
2-PB1,1211,0,0,678,0,678,G
2-PB1,1212,0,0,0,671,671,C
2-PB1,1213,0,0,0,668,668,C
2-PB1,1214,2,0,0,684,686,C
2-PB1,1215,0,683,0,2,685,T
2-PB1,1216,0,0,771,0,771,G
2-PB1,1217,1,0,786,1,788,G
2-PB1,1218,786,0,4,0,790,A
2-PB1,1219,837,0,0,0,837,A
2-PB1,1220,1,816,0,0,817,T
2-PB1,1221,0,1,847,0,848,G
2-PB1,1222,863,0,1,0,864,A
2-PB1,1223,0,868,0,0,868,T
2-PB1,1224,0,0,879,0,879,G
2-PB1,1225,873,0,0,0,873,A
2-PB1,1226,0,863,0,0,863,T
2-PB1,1227,0,0,865,0,865,G
2-PB1,1228,0,0,898,0,898,G
2-PB1,1229,0,0,897,0,897,G
2-PB1,1230,0,0,0,893,893,C
2-PB1,1231,897,0,0,0,897,A
2-PB1,1232,0,914,0,0,914,T
2-PB1,1233,0,0,951,0,951,G
2-PB1,1234,1,950,0,1,952,T
2-PB1,1235,0,955,0,0,955,T
2-PB1,1236,3,0,0,955,958,C
2-PB1,1237,951,0,2,0,953,A
2-PB1,1238,955,1,0,0,956,A
2-PB1,1239,0,1,0,958,959,C
2-PB1,1240,960,0,1,0,961,A
2-PB1,1241,0,966,1,0,967,T
2-PB1,1242,0,0,1001,0,1001,G
2-PB1,1243,0,0,0,1005,1005,C
2-PB1,1244,0,1008,0,0,1008,T
2-PB1,1245,1025,0,1,0,1026,A
2-PB1,1246,1028,0,0,0,1028,A
2-PB1,1247,0,0,1065,0,1065,G
2-PB1,1248,0,1064,0,0,1064,T
2-PB1,1249,1061,0,0,0,1061,A
2-PB1,1250,0,0,0,1072,1072,C
2-PB1,1251,1,2,1088,0,1091,G
2-PB1,1252,0,0,1210,0,1210,G
2-PB1,1253,0,1209,0,0,1209,T
2-PB1,1254,0,1199,0,0,1199,T
2-PB1,1255,0,1204,0,0,1204,T
2-PB1,1256,0,1196,0,1,1197,T
2-PB1,1257,1196,0,3,0,1199,A
2-PB1,1258,0,0,1199,0,1199,G
2-PB1,1259,0,3,1197,0,1200,G
2-PB1,1260,1179,0,0,0,1179,A
2-PB1,1261,0,0,1182,0,1182,G
2-PB1,1262,0,1203,0,2,1205,T
2-PB1,1263,0,0,0,1207,1207,C
2-PB1,1264,0,1211,0,1,1212,T
2-PB1,1265,3,2,0,1203,1208,C
2-PB1,1266,1,3,1205,0,1209,G
2-PB1,1267,1269,0,2,0,1271,A
2-PB1,1268,0,1273,0,0,1273,T
2-PB1,1269,1278,0,0,0,1278,A
2-PB1,1270,1,0,0,1279,1280,C
2-PB1,1271,0,1265,1,3,1269,T
2-PB1,1272,1,0,1273,0,1274,G
2-PB1,1273,1275,0,0,0,1275,A
2-PB1,1274,1294,0,0,0,1294,A
2-PB1,1275,0,1294,0,1,1295,T
2-PB1,1276,1,0,0,1275,1276,C
2-PB1,1277,0,1272,0,1,1273,T
2-PB1,1278,0,1269,0,0,1269,T
2-PB1,1279,1,2,1268,0,1271,G
2-PB1,1280,1,1,1274,0,1276,G
2-PB1,1281,1272,0,0,0,1272,A
2-PB1,1282,0,0,0,1277,1277,C
2-PB1,1283,1263,0,1,0,1264,A
2-PB1,1284,1271,0,1,0,1272,A
2-PB1,1285,1276,0,1,0,1277,A
2-PB1,1286,1279,0,0,0,1279,A
2-PB1,1287,0,0,1319,0,1319,G
2-PB1,1288,1324,0,2,0,1326,A
2-PB1,1289,1321,0,1,1,1323,A
2-PB1,1290,1322,0,3,0,1325,A
2-PB1,1291,0,1323,0,1,1324,T
2-PB1,1292,1330,0,0,0,1330,A
2-PB1,1293,0,0,0,1407,1407,C
2-PB1,1294,1391,0,0,0,1391,A
2-PB1,1295,0,1,0,1394,1395,C
2-PB1,1296,0,1,0,1387,1388,C
2-PB1,1297,1384,0,0,1,1385,A
2-PB1,1298,1404,0,1,0,1405,A
2-PB1,1299,1,1,1471,0,1473,G
2-PB1,1300,1499,0,1,0,1500,A
2-PB1,1301,0,1,0,1511,1512,C
2-PB1,1302,1484,0,1,0,1485,A
2-PB1,1303,1541,0,2,1,1544,A
2-PB1,1304,0,1,0,1555,1556,C
2-PB1,1305,1581,1,0,0,1582,A
2-PB1,1306,0,1586,0,0,1586,T
2-PB1,1307,1576,1,2,0,1579,A
2-PB1,1308,1,0,0,1605,1606,C
2-PB1,1309,1,1583,0,0,1584,T
2-PB1,1310,1,3,1615,0,1619,G
2-PB1,1311,0,1,1615,0,1616,G
2-PB1,1312,0,1595,0,0,1595,T
2-PB1,1313,1,5,1589,0,1595,G
2-PB1,1314,0,2,1586,0,1588,G
2-PB1,1315,0,1,1596,0,1597,G
2-PB1,1316,1598,0,0,0,1598,A
2-PB1,1317,0,1587,0,0,1587,T
2-PB1,1318,1,2,1580,0,1583,G
2-PB1,1319,2,0,1590,0,1592,G
2-PB1,1320,2,2,1592,0,1596,G
2-PB1,1321,0,0,0,1622,1622,C
2-PB1,1322,1,1611,0,3,1615,T
2-PB1,1323,1,0,1,1628,1630,C
2-PB1,1324,0,1,0,1627,1628,C
2-PB1,1325,1629,1,0,0,1630,A
2-PB1,1326,1628,0,1,1,1630,A
2-PB1,1327,0,1630,0,1,1631,T
2-PB1,1328,3,0,3,1628,1634,C
2-PB1,1329,2,0,0,1626,1628,C
2-PB1,1330,1,1622,0,1,1624,T
2-PB1,1331,2,0,0,1619,1621,C
2-PB1,1332,2,2,1,1611,1616,C
2-PB1,1333,2,2,1616,0,1620,G
2-PB1,1334,1616,0,0,0,1616,A
2-PB1,1335,0,0,0,1620,1620,C
2-PB1,1336,0,1,1626,0,1627,G
2-PB1,1337,1643,0,1,0,1644,A
2-PB1,1338,0,1640,0,0,1640,T
2-PB1,1339,0,1643,0,0,1643,T
2-PB1,1340,0,1638,0,1,1639,T
2-PB1,1341,0,1648,0,0,1648,T
2-PB1,1342,0,0,1654,0,1654,G
2-PB1,1343,1,0,0,1674,1675,C
2-PB1,1344,3,0,0,1677,1680,C
2-PB1,1345,4,1,0,1752,1757,C
2-PB1,1346,0,1724,0,7,1731,T
2-PB1,1347,0,1,0,1792,1793,C
2-PB1,1348,1796,1,0,0,1797,A
2-PB1,1349,0,1805,0,3,1808,T
2-PB1,1350,1807,1,1,0,1809,A
2-PB1,1351,2,0,1825,0,1827,G
2-PB1,1352,0,1815,0,0,1815,T
2-PB1,1353,0,4,1830,0,1834,G
2-PB1,1354,1799,0,0,1,1800,A
2-PB1,1355,1799,0,3,0,1802,A
2-PB1,1356,0,1764,0,1,1765,T
2-PB1,1357,0,2,1769,0,1771,G
2-PB1,1358,2,1,0,1784,1787,C
2-PB1,1359,1782,0,4,0,1786,A
2-PB1,1360,0,0,0,1790,1790,C
2-PB1,1361,6,1,0,1779,1786,C
2-PB1,1362,1775,0,0,0,1775,A
2-PB1,1363,1775,0,0,0,1775,A
2-PB1,1364,1774,2,1,1,1778,A
2-PB1,1365,0,1753,0,0,1753,T
2-PB1,1366,1,1,0,1812,1814,C
2-PB1,1367,1811,0,3,0,1814,A
2-PB1,1368,0,1812,0,0,1812,T
2-PB1,1369,1,0,1812,0,1813,G
2-PB1,1370,1813,1,1,0,1815,A
2-PB1,1371,1,2,1823,0,1826,G
2-PB1,1372,0,1,1824,0,1825,G
2-PB1,1373,1,1,1836,1,1839,G
2-PB1,1374,1837,0,5,0,1842,A
2-PB1,1375,1859,0,1,0,1860,A
2-PB1,1376,2,1866,1,0,1869,T
2-PB1,1377,1869,0,2,0,1871,A
2-PB1,1378,0,0,0,1874,1874,C
2-PB1,1379,1884,0,0,0,1884,A
2-PB1,1380,1881,1,5,0,1887,A
2-PB1,1381,0,1,1881,0,1882,G
2-PB1,1382,1,1,0,1873,1875,C
2-PB1,1383,1869,0,0,0,1869,A
2-PB1,1384,1,3,1892,1,1897,G
2-PB1,1385,1,3,1891,0,1895,G
2-PB1,1386,1895,1,3,0,1899,A
2-PB1,1387,0,4,1912,0,1916,G
2-PB1,1388,0,1906,0,2,1908,T
2-PB1,1389,0,6,1919,0,1925,G
2-PB1,1390,2,0,1929,0,1931,G
2-PB1,1391,1923,0,4,0,1927,A
2-PB1,1392,0,1928,0,0,1928,T
2-PB1,1393,1913,0,0,0,1913,A
2-PB1,1394,1,2,1930,0,1933,G
2-PB1,1395,1957,1,0,0,1958,A
2-PB1,1396,1,1966,0,1,1968,T
2-PB1,1397,0,1966,0,1,1967,T
2-PB1,1398,2,0,0,2044,2046,C
2-PB1,1399,0,2038,0,1,2039,T
2-PB1,1400,2039,0,0,0,2039,A
2-PB1,1401,0,0,0,2040,2040,C
2-PB1,1402,2018,1,1,2,2022,A
2-PB1,1403,0,3,2028,0,2031,G
2-PB1,1404,10,3,2012,0,2025,G
2-PB1,1405,2047,0,0,0,2047,A
2-PB1,1406,0,1,0,2040,2041,C
2-PB1,1407,1,0,0,2010,2011,C
2-PB1,1408,2,1998,0,3,2003,T
2-PB1,1409,1,0,2011,1,2013,G
2-PB1,1410,0,0,0,2011,2011,C
2-PB1,1411,2015,0,2,0,2017,A
2-PB1,1412,2029,0,1,0,2030,A
2-PB1,1413,0,0,2042,0,2042,G
2-PB1,1414,0,2020,0,2,2022,T
2-PB1,1415,0,2020,0,0,2020,T
2-PB1,1416,1998,0,1,0,1999,A
2-PB1,1417,0,0,2003,0,2003,G
2-PB1,1418,0,1999,0,2,2001,T
2-PB1,1419,0,2,1995,0,1997,G
2-PB1,1420,2,4,1988,0,1994,G
2-PB1,1421,0,2,2007,0,2009,G
2-PB1,1422,2000,0,2,0,2002,A
2-PB1,1423,2006,0,2,1,2009,A
2-PB1,1424,1,2007,0,1,2009,T
2-PB1,1425,2,1,0,2009,2012,C
2-PB1,1426,2007,0,0,0,2007,A
2-PB1,1427,2014,0,1,0,2015,A
2-PB1,1428,1,0,0,2001,2002,C
2-PB1,1429,2008,2,1,1,2012,A
2-PB1,1430,1,1977,0,1,1979,T
2-PB1,1431,0,4,1981,0,1985,G
2-PB1,1432,1990,0,1,0,1991,A
2-PB1,1433,1,0,2006,0,2007,G
2-PB1,1434,0,0,0,2002,2002,C
2-PB1,1435,2000,0,1,0,2001,A
2-PB1,1436,2003,1,0,0,2004,A
2-PB1,1437,2005,1,1,0,2007,A
2-PB1,1438,2014,1,4,0,2019,A
2-PB1,1439,2018,0,3,0,2021,A
2-PB1,1440,0,0,2025,0,2025,G
2-PB1,1441,2010,1,0,1,2012,A
2-PB1,1442,1987,1,6,0,1994,A
2-PB1,1443,0,0,2079,0,2079,G
2-PB1,1444,0,2073,0,1,2074,T
2-PB1,1445,6,2,0,2058,2066,C
2-PB1,1446,2,1,0,2079,2082,C
2-PB1,1447,0,2073,0,1,2074,T
2-PB1,1448,2108,0,1,0,2109,A
2-PB1,1449,1,2105,0,0,2106,T
2-PB1,1450,2106,1,1,0,2108,A
2-PB1,1451,0,2104,0,1,2105,T
2-PB1,1452,2100,1,1,0,2102,A
2-PB1,1453,2110,0,0,0,2110,A
2-PB1,1454,2111,0,0,0,2111,A
2-PB1,1455,2,2100,0,1,2103,T
2-PB1,1456,2083,0,3,0,2086,A
2-PB1,1457,2088,0,0,0,2088,A
2-PB1,1458,2094,0,2,0,2096,A
2-PB1,1459,2098,1,3,0,2102,A
2-PB1,1460,1,1,0,2101,2103,C
2-PB1,1461,2017,0,3,0,2020,A
2-PB1,1462,3,5,2015,0,2023,G
2-PB1,1463,0,1,2019,0,2020,G
2-PB1,1464,1,3,2009,0,2013,G
2-PB1,1465,2022,1,2,0,2025,A
2-PB1,1466,0,1,0,2046,2047,C
2-PB1,1467,2026,0,2,0,2028,A
2-PB1,1468,0,2054,0,1,2055,T
2-PB1,1469,0,2047,0,3,2050,T
2-PB1,1470,0,2057,0,0,2057,T
2-PB1,1471,0,3,2061,0,2064,G
2-PB1,1472,2044,0,2,0,2046,A
2-PB1,1473,2041,0,1,0,2042,A
2-PB1,1474,0,2044,0,0,2044,T
2-PB1,1475,1,2017,0,3,2021,T
2-PB1,1476,0,0,0,2032,2032,C
2-PB1,1477,2021,0,2,0,2023,A
2-PB1,1478,0,1,2,2022,2025,C
2-PB1,1479,1,2020,0,1,2022,T
2-PB1,1480,2030,0,0,0,2030,A
2-PB1,1481,0,0,2031,0,2031,G
2-PB1,1482,1,1,0,2024,2026,C
2-PB1,1483,0,2008,0,3,2011,T
2-PB1,1484,0,2032,0,1,2033,T
2-PB1,1485,0,2019,0,0,2019,T
2-PB1,1486,0,2026,0,0,2026,T
2-PB1,1487,1,2023,0,2,2026,T
2-PB1,1488,0,2023,0,0,2023,T
2-PB1,1489,1,2024,0,0,2025,T
2-PB1,1490,2026,0,0,0,2026,A
2-PB1,1491,2,2017,0,0,2019,T
2-PB1,1492,3,3,0,2014,2020,C
2-PB1,1493,1,1,2033,0,2035,G
2-PB1,1494,2103,0,0,0,2103,A
2-PB1,1495,0,2106,0,0,2106,T
2-PB1,1496,2106,1,0,0,2107,A
2-PB1,1497,0,2126,0,1,2127,T
2-PB1,1498,1,3,2120,0,2124,G
2-PB1,1499,1,3,2122,1,2127,G
2-PB1,1500,2127,0,5,0,2132,A
2-PB1,1501,0,2120,0,0,2120,T
2-PB1,1502,1,2107,0,0,2108,T
2-PB1,1503,1,2057,0,2,2060,T
2-PB1,1504,0,0,2065,0,2065,G
2-PB1,1505,1,2061,0,2,2064,T
2-PB1,1506,0,0,2060,0,2060,G
2-PB1,1507,1,0,2056,0,2057,G
2-PB1,1508,1,0,0,2044,2045,C
2-PB1,1509,1,2044,0,2,2047,T
2-PB1,1510,2043,0,0,1,2044,A
2-PB1,1511,2061,0,1,1,2063,A
2-PB1,1512,0,2063,0,0,2063,T
2-PB1,1513,1,2056,3,0,2060,T
2-PB1,1514,0,2065,0,0,2065,T
2-PB1,1515,0,2068,0,1,2069,T
2-PB1,1516,2070,1,0,1,2072,A
2-PB1,1517,2,0,2082,0,2084,G
2-PB1,1518,2,1,0,2072,2075,C
2-PB1,1519,2076,0,2,0,2078,A
2-PB1,1520,0,2054,0,2,2056,T
2-PB1,1521,0,1,2035,1,2037,G
2-PB1,1522,0,1,2063,1,2065,G
2-PB1,1523,2056,0,4,0,2060,A
2-PB1,1524,0,0,2055,0,2055,G
2-PB1,1525,2,0,0,2054,2056,C
2-PB1,1526,0,2038,1,1,2040,T
2-PB1,1527,2,0,2057,0,2059,G
2-PB1,1528,1,0,0,2052,2053,C
2-PB1,1529,3,0,0,2046,2049,C
2-PB1,1530,2,0,0,2064,2066,C
2-PB1,1531,2030,0,2,0,2032,A
2-PB1,1532,1,0,2165,0,2166,G
2-PB1,1533,0,2166,1,0,2167,T
2-PB1,1534,0,2167,0,2,2169,T
2-PB1,1535,1,2162,1,2,2166,T
2-PB1,1536,0,2154,0,2,2156,T
2-PB1,1537,0,1,2143,0,2144,G
2-PB1,1538,1,3,2148,0,2152,G
2-PB1,1539,2138,1,8,1,2148,A
2-PB1,1540,1,0,2150,0,2151,G
2-PB1,1541,0,2014,0,3,2017,T
2-PB1,1542,0,0,2086,0,2086,G
2-PB1,1543,1,2078,0,2,2081,T
2-PB1,1544,4,1,0,2075,2080,C
2-PB1,1545,1,2078,0,1,2080,T
2-PB1,1546,1,0,2092,0,2093,G
2-PB1,1547,0,2,2125,0,2127,G
2-PB1,1548,2121,4,3,0,2128,A
2-PB1,1549,2135,0,1,1,2137,A
2-PB1,1550,0,2130,0,0,2130,T
2-PB1,1551,2049,1,3,0,2053,A
2-PB1,1552,2054,0,3,0,2057,A
2-PB1,1553,2057,1,1,0,2059,A
2-PB1,1554,0,2,0,2058,2060,C
2-PB1,1555,0,0,2046,0,2046,G
2-PB1,1556,2013,1,0,0,2014,A
2-PB1,1557,0,1,2013,0,2014,G
2-PB1,1558,1,2004,0,2,2007,T
2-PB1,1559,3,0,0,2016,2019,C
2-PB1,1560,2014,1,2,0,2017,A
2-PB1,1561,0,0,2051,0,2051,G
2-PB1,1562,2,1,0,2046,2049,C
2-PB1,1563,0,2043,0,3,2046,T
2-PB1,1564,1,2,2122,0,2125,G
2-PB1,1565,2118,0,3,0,2121,A
2-PB1,1566,0,2113,0,1,2114,T
2-PB1,1567,2115,0,2,0,2117,A
2-PB1,1568,1,2104,1,1,2107,T
2-PB1,1569,0,1,2116,0,2117,G
2-PB1,1570,2069,0,3,0,2072,A
2-PB1,1571,0,0,2117,0,2117,G
2-PB1,1572,1,0,0,2110,2111,C
2-PB1,1573,2040,0,1,0,2041,A
2-PB1,1574,0,2039,0,2,2041,T
2-PB1,1575,0,2043,0,1,2044,T
2-PB1,1576,0,4,2058,0,2062,G
2-PB1,1577,1,4,2123,1,2129,G
2-PB1,1578,2100,0,6,0,2106,A
2-PB1,1579,0,0,2112,0,2112,G
2-PB1,1580,1,2061,0,1,2063,T
2-PB1,1581,2057,0,0,0,2057,A
2-PB1,1582,2056,0,3,0,2059,A
2-PB1,1583,0,1,0,2076,2077,C
2-PB1,1584,2065,0,1,1,2067,A
2-PB1,1585,0,1,2115,0,2116,G
2-PB1,1586,0,1981,1,1,1983,T
2-PB1,1587,0,5,2000,0,2005,G
2-PB1,1588,2014,1,3,0,2018,A
2-PB1,1589,0,2014,0,2,2016,T
2-PB1,1590,2013,0,0,0,2013,A
2-PB1,1591,2007,0,2,0,2009,A
2-PB1,1592,1977,0,7,0,1984,A
2-PB1,1593,0,2,2001,0,2003,G
2-PB1,1594,1925,0,6,0,1931,A
2-PB1,1595,1925,1,2,0,1928,A
2-PB1,1596,1,3,0,1926,1930,C
2-PB1,1597,1889,0,0,0,1889,A
2-PB1,1598,1912,0,3,0,1915,A
2-PB1,1599,0,0,0,1912,1912,C
2-PB1,1600,1932,0,0,0,1932,A
2-PB1,1601,0,1926,1,2,1929,T
2-PB1,1602,1,2,1908,0,1911,G
2-PB1,1603,1908,0,2,0,1910,A
2-PB1,1604,2,1909,0,1,1912,T
2-PB1,1605,1892,0,0,0,1892,A
2-PB1,1606,1909,1,0,2,1912,A
2-PB1,1607,1911,1,0,0,1912,A
2-PB1,1608,0,0,0,1921,1921,C
2-PB1,1609,1877,0,0,0,1877,A
2-PB1,1610,1877,0,0,0,1877,A
2-PB1,1611,1,1854,0,1,1856,T
2-PB1,1612,0,4,1849,0,1853,G
2-PB1,1613,1896,0,0,0,1896,A
2-PB1,1614,1,0,0,1901,1902,C
2-PB1,1615,2,0,0,1883,1885,C
2-PB1,1616,0,1845,2,0,1847,T
2-PB1,1617,0,1823,0,1,1824,T
2-PB1,1618,0,0,1827,0,1827,G
2-PB1,1619,0,3,1830,0,1833,G
2-PB1,1620,1842,0,2,0,1844,A
2-PB1,1621,2,0,0,1836,1838,C
2-PB1,1622,1,0,0,1816,1817,C
2-PB1,1623,1803,0,2,0,1805,A
2-PB1,1624,0,0,1810,1,1811,G
2-PB1,1625,1,1,1,1809,1812,C
2-PB1,1626,1812,0,2,0,1814,A
2-PB1,1627,1807,0,4,0,1811,A
2-PB1,1628,1,0,1,1804,1806,C
2-PB1,1629,1796,0,1,0,1797,A
2-PB1,1630,0,0,1836,0,1836,G
2-PB1,1631,2,1,0,1828,1831,C
2-PB1,1632,2,0,0,1826,1828,C
2-PB1,1633,5,1,0,1813,1819,C
2-PB1,1634,1823,0,1,0,1824,A
2-PB1,1635,1819,0,1,0,1820,A
2-PB1,1636,1818,1,2,1,1822,A
2-PB1,1637,0,1824,0,1,1825,T
2-PB1,1638,1,3,1814,0,1818,G
2-PB1,1639,0,0,1806,0,1806,G
2-PB1,1640,0,1,0,1804,1805,C
2-PB1,1641,0,1789,0,2,1791,T
2-PB1,1642,0,0,0,1840,1840,C
2-PB1,1643,0,1838,0,3,1841,T
2-PB1,1644,0,1,0,1845,1846,C
2-PB1,1645,2,1,0,1847,1850,C
2-PB1,1646,1853,0,0,1,1854,A
2-PB1,1647,1852,1,1,0,1854,A
2-PB1,1648,0,1840,0,1,1841,T
2-PB1,1649,0,1823,1,2,1826,T
2-PB1,1650,0,0,1833,0,1833,G
2-PB1,1651,1,1792,0,3,1796,T
2-PB1,1652,0,1797,1,1,1799,T
2-PB1,1653,4,0,0,1795,1799,C
2-PB1,1654,1795,1,1,0,1797,A
2-PB1,1655,0,1793,1,0,1794,T
2-PB1,1656,4,0,0,1796,1800,C
2-PB1,1657,1800,0,0,1,1801,A
2-PB1,1658,1798,1,0,0,1799,A
2-PB1,1659,1788,1,5,1,1795,A
2-PB1,1660,1,3,1839,1,1844,G
2-PB1,1661,1838,1,1,0,1840,A
2-PB1,1662,0,1857,0,0,1857,T
2-PB1,1663,0,1859,0,0,1859,T
2-PB1,1664,1861,1,1,0,1863,A
2-PB1,1665,0,1,0,1884,1885,C
2-PB1,1666,1883,0,2,0,1885,A
2-PB1,1667,0,1,1898,0,1899,G
2-PB1,1668,1888,0,1,0,1889,A
2-PB1,1669,0,1890,0,1,1891,T
2-PB1,1670,1896,0,0,0,1896,A
2-PB1,1671,0,0,0,1996,1996,C
2-PB1,1672,2013,1,2,0,2016,A
2-PB1,1673,0,1,0,2125,2126,C
2-PB1,1674,2098,0,1,1,2100,A
2-PB1,1675,1,2112,0,1,2114,T
2-PB1,1676,2106,0,0,0,2106,A
2-PB1,1677,0,2105,0,0,2105,T
2-PB1,1678,2050,1,0,0,2051,A
2-PB1,1679,0,3,2047,0,2050,G
2-PB1,1680,0,0,2004,0,2004,G
2-PB1,1681,0,1902,0,2,1904,T
2-PB1,1682,1,1,1886,0,1888,G
2-PB1,1683,3,0,0,1948,1951,C
2-PB1,1684,0,2,0,1943,1945,C
2-PB1,1685,1959,1,2,0,1962,A
2-PB1,1686,0,1960,0,0,1960,T
2-PB1,1687,1966,0,1,0,1967,A
2-PB1,1688,0,1,1966,0,1967,G
2-PB1,1689,1930,0,1,0,1931,A
2-PB1,1690,0,1,1938,0,1939,G
2-PB1,1691,1,2,1930,0,1933,G
2-PB1,1692,1876,2,2,2,1882,A
2-PB1,1693,1,1,1886,0,1888,G
2-PB1,1694,1879,0,1,0,1880,A
2-PB1,1695,0,0,0,1887,1887,C
2-PB1,1696,1878,1,4,0,1883,A
2-PB1,1697,1,2,0,1903,1906,C
2-PB1,1698,1916,0,0,0,1916,A
2-PB1,1699,0,0,0,1912,1912,C
2-PB1,1700,1907,0,1,0,1908,A
2-PB1,1701,1920,0,1,0,1921,A
2-PB1,1702,1929,0,4,0,1933,A
2-PB1,1703,1,1926,0,1,1928,T
2-PB1,1704,2,2,0,1927,1931,C
2-PB1,1705,2,1,0,1919,1922,C
2-PB1,1706,1906,0,1,0,1907,A
2-PB1,1707,0,2,1903,0,1905,G
2-PB1,1708,1902,0,3,0,1905,A
2-PB1,1709,0,1,0,1921,1922,C
2-PB1,1710,1,2,1912,0,1915,G
2-PB1,1711,1897,0,5,0,1902,A
2-PB1,1712,0,0,1903,0,1903,G
2-PB1,1713,1901,0,1,0,1902,A
2-PB1,1714,1903,0,3,0,1906,A
2-PB1,1715,0,0,1917,0,1917,G
2-PB1,1716,1911,1,2,0,1914,A
2-PB1,1717,0,1902,0,2,1904,T
2-PB1,1718,3,1,0,1883,1887,C
2-PB1,1719,1895,0,0,0,1895,A
2-PB1,1720,1,1884,0,0,1885,T
2-PB1,1721,0,1875,2,0,1877,T
2-PB1,1722,0,0,0,1876,1876,C
2-PB1,1723,1,3,1876,0,1880,G
2-PB1,1724,1861,2,1,0,1864,A
2-PB1,1725,0,0,1875,0,1875,G
2-PB1,1726,1856,0,1,0,1857,A
2-PB1,1727,1,1916,0,0,1917,T
2-PB1,1728,1919,0,3,0,1922,A
2-PB1,1729,1925,1,1,0,1927,A
2-PB1,1730,1923,0,6,0,1929,A
2-PB1,1731,1,0,1929,1,1931,G
2-PB1,1732,1929,0,1,1,1931,A
2-PB1,1733,1884,0,3,0,1887,A
2-PB1,1734,1,0,1890,0,1891,G
2-PB1,1735,0,2,0,1898,1900,C
2-PB1,1736,0,1883,0,0,1883,T
2-PB1,1737,0,0,1887,0,1887,G
2-PB1,1738,0,1879,0,1,1880,T
2-PB1,1739,1,6,1867,0,1874,G
2-PB1,1740,0,0,1887,0,1887,G
2-PB1,1741,0,2,1903,1,1906,G
2-PB1,1742,1906,0,0,0,1906,A
2-PB1,1743,0,1878,0,1,1879,T
2-PB1,1744,1,0,0,1882,1883,C
2-PB1,1745,1885,0,0,0,1885,A
2-PB1,1746,1892,0,2,0,1894,A
2-PB1,1747,1905,0,2,0,1907,A
2-PB1,1748,2,2,0,1897,1901,C
2-PB1,1749,3,0,0,1891,1894,C
2-PB1,1750,1,0,0,1897,1898,C
2-PB1,1751,1883,2,12,0,1897,A
2-PB1,1752,1927,0,1,0,1928,A
2-PB1,1753,1,1914,0,0,1915,T
2-PB1,1754,1,0,0,1921,1922,C
2-PB1,1755,1916,0,0,0,1916,A
2-PB1,1756,1903,0,1,1,1905,A
2-PB1,1757,1,2,1929,0,1932,G
2-PB1,1758,0,1,1920,0,1921,G
2-PB1,1759,1,0,1910,0,1911,G
2-PB1,1760,1,3,0,1916,1920,C
2-PB1,1761,1881,0,6,0,1887,A
2-PB1,1762,0,0,1943,0,1943,G
2-PB1,1763,1,1,1942,0,1944,G
2-PB1,1764,1957,0,2,0,1959,A
2-PB1,1765,0,1,0,1977,1978,C
2-PB1,1766,0,1944,1,0,1945,T
2-PB1,1767,1991,1,1,0,1993,A
2-PB1,1768,0,1990,0,0,1990,T
2-PB1,1769,0,1987,0,0,1987,T
2-PB1,1770,1,0,1984,0,1985,G
2-PB1,1771,3,0,1991,0,1994,G
2-PB1,1772,0,1967,0,7,1974,T
2-PB1,1773,1970,0,1,0,1971,A
2-PB1,1774,0,1952,0,0,1952,T
2-PB1,1775,3,2,1,1947,1953,C
2-PB1,1776,1899,0,1,1,1901,A
2-PB1,1777,0,1,1913,0,1914,G
2-PB1,1778,1908,0,4,0,1912,A
2-PB1,1779,0,1896,0,1,1897,T
2-PB1,1780,1,4,1840,0,1845,G
2-PB1,1781,1,3,1842,0,1846,G
2-PB1,1782,1,4,1842,0,1847,G
2-PB1,1783,0,1,1854,0,1855,G
2-PB1,1784,2,2,1857,0,1861,G
2-PB1,1785,1856,0,3,0,1859,A
2-PB1,1786,0,0,0,1846,1846,C
2-PB1,1787,1,0,0,1846,1847,C
2-PB1,1788,1847,0,2,0,1849,A
2-PB1,1789,1963,0,2,0,1965,A
2-PB1,1790,1975,0,0,0,1975,A
2-PB1,1791,0,0,0,2004,2004,C
2-PB1,1792,0,1990,0,1,1991,T
2-PB1,1793,0,1977,0,3,1980,T
2-PB1,1794,1989,0,0,0,1989,A
2-PB1,1795,0,1984,0,2,1986,T
2-PB1,1796,1991,0,0,0,1991,A
2-PB1,1797,1,0,0,1988,1989,C
2-PB1,1798,1848,0,0,1,1849,A
2-PB1,1799,1849,0,1,0,1850,A
2-PB1,1800,0,1819,0,0,1819,T
2-PB1,1801,1856,0,0,0,1856,A
2-PB1,1802,0,1850,0,0,1850,T
2-PB1,1803,0,1,0,1838,1839,C
2-PB1,1804,2,0,0,1833,1835,C
2-PB1,1805,2,3,1829,1,1835,G
2-PB1,1806,2,1,1836,0,1839,G
2-PB1,1807,1851,0,0,0,1851,A
2-PB1,1808,1848,0,0,0,1848,A
2-PB1,1809,0,1850,0,0,1850,T
2-PB1,1810,1,1,0,1851,1853,C
2-PB1,1811,0,1844,0,1,1845,T
2-PB1,1812,0,1852,0,2,1854,T
2-PB1,1813,3,0,0,1849,1852,C
2-PB1,1814,1852,0,1,0,1853,A
2-PB1,1815,0,0,0,1857,1857,C
2-PB1,1816,1851,0,2,0,1853,A
2-PB1,1817,0,1980,0,0,1980,T
2-PB1,1818,3,2,0,1979,1984,C
2-PB1,1819,4,2,0,1986,1992,C
2-PB1,1820,3,0,1,1990,1994,C
2-PB1,1821,0,1991,0,5,1996,T
2-PB1,1822,0,0,1995,0,1995,G
2-PB1,1823,1991,0,0,0,1991,A
2-PB1,1824,1981,1,1,1,1984,A
2-PB1,1825,0,0,1988,0,1988,G
2-PB1,1826,0,1878,0,0,1878,T
2-PB1,1827,2,0,0,1872,1874,C
2-PB1,1828,0,1854,0,1,1855,T
2-PB1,1829,1,2,1878,0,1881,G
2-PB1,1830,0,1,0,1877,1878,C
2-PB1,1831,0,1883,0,0,1883,T
2-PB1,1832,0,1883,0,0,1883,T
2-PB1,1833,1879,1,1,0,1881,A
2-PB1,1834,1876,0,1,1,1878,A
2-PB1,1835,1876,1,0,0,1877,A
2-PB1,1836,1818,1,1,0,1820,A
2-PB1,1837,0,1845,0,0,1845,T
2-PB1,1838,1,0,1840,0,1841,G
2-PB1,1839,1,2,1838,0,1841,G
2-PB1,1840,0,3,1838,0,1841,G
2-PB1,1841,1835,0,5,0,1840,A
2-PB1,1842,0,0,1844,2,1846,G
2-PB1,1843,1,0,0,1837,1838,C
2-PB1,1844,0,1839,0,2,1841,T
2-PB1,1845,0,0,1842,0,1842,G
2-PB1,1846,1836,0,1,0,1837,A
2-PB1,1847,1,1846,0,0,1847,T
2-PB1,1848,0,2,1844,0,1846,G
2-PB1,1849,0,0,1846,2,1848,G
2-PB1,1850,1839,0,1,0,1840,A
2-PB1,1851,0,1845,0,2,1847,T
2-PB1,1852,0,0,1843,0,1843,G
2-PB1,1853,1832,0,2,0,1834,A
2-PB1,1854,1,2,1857,0,1860,G
2-PB1,1855,1855,0,1,0,1856,A
2-PB1,1856,1858,0,0,0,1858,A
2-PB1,1857,0,1851,0,0,1851,T
2-PB1,1858,0,1842,1,1,1844,T
2-PB1,1859,1848,1,0,0,1849,A
2-PB1,1860,0,1848,0,1,1849,T
2-PB1,1861,0,2,0,1838,1840,C
2-PB1,1862,2,5,1832,0,1839,G
2-PB1,1863,1,4,1810,0,1815,G
2-PB1,1864,1,2,1814,0,1817,G
2-PB1,1865,0,2,1825,0,1827,G
2-PB1,1866,1818,0,0,0,1818,A
2-PB1,1867,1821,0,2,1,1824,A
2-PB1,1868,0,1,1820,0,1821,G
2-PB1,1869,1833,1,1,0,1835,A
2-PB1,1870,0,1,0,1851,1852,C
2-PB1,1871,0,1826,3,1,1830,T
2-PB1,1872,0,1854,2,1,1857,T
2-PB1,1873,0,1867,0,2,1869,T
2-PB1,1874,0,0,1880,0,1880,G
2-PB1,1875,0,1878,0,0,1878,T
2-PB1,1876,1867,0,0,0,1867,A
2-PB1,1877,1861,0,3,1,1865,A
2-PB1,1878,0,1837,0,1,1838,T
2-PB1,1879,2,0,0,1837,1839,C
2-PB1,1880,1,0,0,1837,1838,C
2-PB1,1881,3,0,0,1831,1834,C
2-PB1,1882,1,0,0,1848,1849,C
2-PB1,1883,1,1842,1,0,1844,T
2-PB1,1884,1,1,1850,0,1852,G
2-PB1,1885,1846,1,2,0,1849,A
2-PB1,1886,1843,0,6,0,1849,A
2-PB1,1887,1,1851,0,4,1856,T
2-PB1,1888,1,0,0,1843,1844,C
2-PB1,1889,3,3,0,1839,1845,C
2-PB1,1890,1,1,0,1825,1827,C
2-PB1,1891,1,1812,0,7,1820,T
2-PB1,1892,0,1818,0,2,1820,T
2-PB1,1893,0,1820,0,0,1820,T
2-PB1,1894,1,0,1815,0,1816,G
2-PB1,1895,1,1809,0,1,1811,T
2-PB1,1896,1,0,0,1813,1814,C
2-PB1,1897,1794,0,4,0,1798,A
2-PB1,1898,0,3,1803,0,1806,G
2-PB1,1899,0,1,0,1798,1799,C
2-PB1,1900,2,0,0,1800,1802,C
2-PB1,1901,1807,0,2,0,1809,A
2-PB1,1902,0,1809,0,0,1809,T
2-PB1,1903,1801,1,3,0,1805,A
2-PB1,1904,1811,0,1,1,1813,A
2-PB1,1905,1813,0,2,0,1815,A
2-PB1,1906,0,1,1840,0,1841,G
2-PB1,1907,1793,0,4,1,1798,A
2-PB1,1908,1799,1,2,0,1802,A
2-PB1,1909,1803,0,3,0,1806,A
2-PB1,1910,0,1801,0,0,1801,T
2-PB1,1911,0,1793,1,0,1794,T
2-PB1,1912,0,5,1788,2,1795,G
2-PB1,1913,1779,0,0,0,1779,A
2-PB1,1914,0,0,1810,0,1810,G
2-PB1,1915,1,1782,0,1,1784,T
2-PB1,1916,1,1,0,1793,1795,C
2-PB1,1917,1,1778,0,4,1783,T
2-PB1,1918,1,0,1814,0,1815,G
2-PB1,1919,1,1811,1,2,1815,T
2-PB1,1920,1839,0,2,1,1842,A
2-PB1,1921,1838,0,1,0,1839,A
2-PB1,1922,1841,0,3,1,1845,A
2-PB1,1923,3,1,0,1845,1849,C
2-PB1,1924,1804,0,0,0,1804,A
2-PB1,1925,1838,0,0,0,1838,A
2-PB1,1926,0,1844,0,0,1844,T
2-PB1,1927,2,2,1826,0,1830,G
2-PB1,1928,0,0,0,1835,1835,C
2-PB1,1929,0,1803,0,0,1803,T
2-PB1,1930,0,1,1856,0,1857,G
2-PB1,1931,0,1857,0,1,1858,T
2-PB1,1932,1883,0,0,0,1883,A
2-PB1,1933,0,0,1887,0,1887,G
2-PB1,1934,0,1857,0,0,1857,T
2-PB1,1935,1849,0,0,0,1849,A
2-PB1,1936,1839,0,1,1,1841,A
2-PB1,1937,0,1823,1,0,1824,T
2-PB1,1938,1,0,1820,0,1821,G
2-PB1,1939,1,2,0,1786,1789,C
2-PB1,1940,5,0,0,1778,1783,C
2-PB1,1941,1746,0,2,0,1748,A
2-PB1,1942,2,1,1768,0,1771,G
2-PB1,1943,0,0,0,1790,1790,C
2-PB1,1944,1,0,0,1794,1795,C
2-PB1,1945,1,2,0,1788,1791,C
2-PB1,1946,1782,1,1,0,1784,A
2-PB1,1947,1,1784,0,1,1786,T
2-PB1,1948,2,1,1781,0,1784,G
2-PB1,1949,3,0,1794,0,1797,G
2-PB1,1950,0,1793,0,1,1794,T
2-PB1,1951,2,0,0,1755,1757,C
2-PB1,1952,3,0,0,1726,1729,C
2-PB1,1953,3,1713,0,2,1718,T
2-PB1,1954,0,0,1751,0,1751,G
2-PB1,1955,1,1,0,1740,1742,C
2-PB1,1956,2,1,0,1749,1752,C
2-PB1,1957,1748,1,0,0,1749,A
2-PB1,1958,1742,0,1,0,1743,A
2-PB1,1959,1744,0,0,0,1744,A
2-PB1,1960,1747,0,4,0,1751,A
2-PB1,1961,0,0,1786,0,1786,G
2-PB1,1962,1,1760,0,1,1762,T
2-PB1,1963,1763,0,0,0,1763,A
2-PB1,1964,1,1754,0,2,1757,T
2-PB1,1965,2,3,1751,2,1758,G
2-PB1,1966,0,3,1793,0,1796,G
2-PB1,1967,1787,0,2,0,1789,A
2-PB1,1968,1808,0,2,0,1810,A
2-PB1,1969,2,1795,0,1,1798,T
2-PB1,1970,1764,0,0,0,1764,A
2-PB1,1971,1,1760,0,0,1761,T
2-PB1,1972,0,1,1748,0,1749,G
2-PB1,1973,1750,0,1,0,1751,A
2-PB1,1974,0,1745,0,2,1747,T
2-PB1,1975,0,1,1699,0,1700,G
2-PB1,1976,2,1,0,1700,1703,C
2-PB1,1977,2,0,1,1678,1681,C
2-PB1,1978,1,0,1681,0,1682,G
2-PB1,1979,0,1677,0,1,1678,T
2-PB1,1980,0,1678,0,2,1680,T
2-PB1,1981,2,1,1680,0,1683,G
2-PB1,1982,0,1,0,1695,1696,C
2-PB1,1983,1695,0,1,0,1696,A
2-PB1,1984,1712,0,0,0,1712,A
2-PB1,1985,0,0,0,1710,1710,C
2-PB1,1986,2,1700,0,1,1703,T
2-PB1,1987,1709,0,0,0,1709,A
2-PB1,1988,1,2,0,1703,1706,C
2-PB1,1989,1705,2,2,0,1709,A
2-PB1,1990,0,0,0,1714,1714,C
2-PB1,1991,1670,2,0,0,1672,A
2-PB1,1992,0,0,0,1794,1794,C
2-PB1,1993,0,1754,0,0,1754,T
2-PB1,1994,5,0,0,1757,1762,C
2-PB1,1995,0,1,0,1760,1761,C
2-PB1,1996,0,1742,0,5,1747,T
2-PB1,1997,0,0,1749,0,1749,G
2-PB1,1998,1,2,1742,0,1745,G
2-PB1,1999,1746,0,0,0,1746,A
2-PB1,2000,1,1737,0,0,1738,T
2-PB1,2001,0,1570,0,5,1575,T
2-PB1,2002,1,0,0,1593,1594,C
2-PB1,2003,0,1,1,1579,1581,C
2-PB1,2004,6,0,1,1578,1585,C
2-PB1,2005,1592,1,0,0,1593,A
2-PB1,2006,1592,1,0,0,1593,A
2-PB1,2007,0,1,1594,0,1595,G
2-PB1,2008,1583,0,3,0,1586,A
2-PB1,2009,0,1,1592,0,1593,G
2-PB1,2010,0,1,1585,0,1586,G
2-PB1,2011,1576,0,1,0,1577,A
2-PB1,2012,1571,0,1,0,1572,A
2-PB1,2013,1,0,0,1570,1571,C
2-PB1,2014,4,0,0,1556,1560,C
2-PB1,2015,0,1,1579,0,1580,G
2-PB1,2016,1,0,0,1579,1580,C
2-PB1,2017,0,1577,0,1,1578,T
2-PB1,2018,1,0,0,1584,1585,C
2-PB1,2019,0,1580,0,0,1580,T
2-PB1,2020,1662,0,0,0,1662,A
2-PB1,2021,0,1654,0,1,1655,T
2-PB1,2022,0,1660,0,0,1660,T
2-PB1,2023,0,0,0,1659,1659,C
2-PB1,2024,0,1598,0,1,1599,T
2-PB1,2025,1600,0,2,0,1602,A
2-PB1,2026,1599,0,0,1,1600,A
2-PB1,2027,1597,0,0,0,1597,A
2-PB1,2028,0,2,0,1598,1600,C
2-PB1,2029,1493,0,0,0,1493,A
2-PB1,2030,1,0,0,1490,1491,C
2-PB1,2031,1480,0,0,0,1480,A
2-PB1,2032,1482,0,2,0,1484,A
2-PB1,2033,0,0,1492,0,1492,G
2-PB1,2034,1,2,0,1484,1487,C
2-PB1,2035,1,0,0,1492,1493,C
2-PB1,2036,1470,0,1,0,1471,A
2-PB1,2037,1474,1,2,0,1477,A
2-PB1,2038,1468,0,5,0,1473,A
2-PB1,2039,0,2,1486,1,1489,G
2-PB1,2040,1,4,1477,0,1482,G
2-PB1,2041,0,2,1460,0,1462,G
2-PB1,2042,0,5,1453,1,1459,G
2-PB1,2043,1452,0,0,0,1452,A
2-PB1,2044,1454,1,0,0,1455,A
2-PB1,2045,1,1454,0,0,1455,T
2-PB1,2046,0,1457,0,0,1457,T
2-PB1,2047,0,0,0,1464,1464,C
2-PB1,2048,1,1444,0,1,1446,T
2-PB1,2049,1,1437,0,0,1438,T
2-PB1,2050,0,0,1441,0,1441,G
2-PB1,2051,1436,0,1,0,1437,A
2-PB1,2052,0,2,1436,0,1438,G
2-PB1,2053,0,0,1425,1,1426,G
2-PB1,2054,1427,0,1,0,1428,A
2-PB1,2055,0,1420,0,1,1421,T
2-PB1,2056,0,4,1430,0,1434,G
2-PB1,2057,1433,0,0,0,1433,A
2-PB1,2058,1432,1,1,0,1434,A
2-PB1,2059,0,0,0,1437,1437,C
2-PB1,2060,1418,0,0,0,1418,A
2-PB1,2061,0,0,1428,0,1428,G
2-PB1,2062,1419,0,1,0,1420,A
2-PB1,2063,0,1415,0,1,1416,T
2-PB1,2064,0,0,1415,0,1415,G
2-PB1,2065,1,1419,0,0,1420,T
2-PB1,2066,1421,1,2,0,1424,A
2-PB1,2067,0,1,0,1421,1422,C
2-PB1,2068,3,1,1,1398,1403,C
2-PB1,2069,1393,0,0,0,1393,A
2-PB1,2070,1,0,1377,0,1378,G
2-PB1,2071,1364,0,2,0,1366,A
2-PB1,2072,1366,0,0,1,1367,A
2-PB1,2073,0,2,1365,0,1367,G
2-PB1,2074,1,1307,0,1,1309,T
2-PB1,2075,0,1,1304,0,1305,G
2-PB1,2076,0,0,0,1307,1307,C
2-PB1,2077,1,1301,0,2,1304,T
2-PB1,2078,1,0,1305,1,1307,G
2-PB1,2079,0,0,0,1305,1305,C
2-PB1,2080,1306,0,0,0,1306,A
2-PB1,2081,1308,0,1,0,1309,A
2-PB1,2082,0,0,0,1285,1285,C
2-PB1,2083,0,1276,0,3,1279,T
2-PB1,2084,0,1269,0,1,1270,T
2-PB1,2085,0,1,1267,0,1268,G
2-PB1,2086,1,1263,0,1,1265,T
2-PB1,2087,0,1262,0,1,1263,T
2-PB1,2088,1,1,0,1259,1261,C
2-PB1,2089,0,1,1260,0,1261,G
2-PB1,2090,1256,0,2,0,1258,A
2-PB1,2091,0,1,1258,0,1259,G
2-PB1,2092,1257,0,1,1,1259,A
2-PB1,2093,1259,0,0,0,1259,A
2-PB1,2094,1259,0,0,0,1259,A
2-PB1,2095,0,1256,1,0,1257,T
2-PB1,2096,0,1255,0,1,1256,T
2-PB1,2097,0,1256,0,0,1256,T
2-PB1,2098,0,1256,0,0,1256,T
2-PB1,2099,0,1255,0,2,1257,T
2-PB1,2100,1,0,0,1264,1265,C
2-PB1,2101,3,0,0,1254,1257,C
2-PB1,2102,1,0,0,1257,1258,C
2-PB1,2103,0,1256,0,1,1257,T
2-PB1,2104,1253,0,1,0,1254,A
2-PB1,2105,1,1,1253,0,1255,G
2-PB1,2106,0,1254,0,1,1255,T
2-PB1,2107,1269,0,1,0,1270,A
2-PB1,2108,1,1,1272,0,1274,G
2-PB1,2109,0,1260,0,1,1261,T
2-PB1,2110,0,1281,1,1,1283,T
2-PB1,2111,3,1,0,1282,1286,C
2-PB1,2112,1302,1,2,0,1305,A
2-PB1,2113,0,1306,0,0,1306,T
2-PB1,2114,1294,0,0,0,1294,A
2-PB1,2115,0,1293,0,0,1293,T
2-PB1,2116,1239,0,5,0,1244,A
2-PB1,2117,0,0,1243,0,1243,G
2-PB1,2118,0,1,1235,0,1236,G
2-PB1,2119,1122,0,3,0,1125,A
2-PB1,2120,1,1,1119,0,1121,G
2-PB1,2121,1057,0,2,0,1059,A
2-PB1,2122,0,0,0,1056,1056,C
2-PB1,2123,0,0,0,1029,1029,C
2-PB1,2124,1,0,1026,0,1027,G
2-PB1,2125,1029,0,0,0,1029,A
2-PB1,2126,0,1023,0,0,1023,T
2-PB1,2127,0,1023,0,0,1023,T
2-PB1,2128,0,0,1021,0,1021,G
2-PB1,2129,1,0,1018,0,1019,G
2-PB1,2130,1018,0,0,0,1018,A
2-PB1,2131,1020,0,0,0,1020,A
2-PB1,2132,0,1012,0,1,1013,T
2-PB1,2133,0,1008,0,2,1010,T
2-PB1,2134,0,1008,0,1,1009,T
2-PB1,2135,2,0,0,1009,1011,C
2-PB1,2136,0,1008,0,3,1011,T
2-PB1,2137,1007,0,2,0,1009,A
2-PB1,2138,0,0,1010,0,1010,G
2-PB1,2139,0,0,0,1008,1008,C
2-PB1,2140,1007,0,0,0,1007,A
2-PB1,2141,0,1002,0,0,1002,T
2-PB1,2142,0,0,987,0,987,G
2-PB1,2143,2,0,999,0,1001,G
2-PB1,2144,0,992,0,0,992,T
2-PB1,2145,0,1,993,1,995,G
2-PB1,2146,0,0,990,1,991,G
2-PB1,2147,975,0,5,0,980,A
2-PB1,2148,1,0,983,0,984,G
2-PB1,2149,0,0,984,0,984,G
2-PB1,2150,0,0,0,976,976,C
2-PB1,2151,0,1,1,965,967,C
2-PB1,2152,881,0,3,0,884,A
2-PB1,2153,0,878,0,1,879,T
2-PB1,2154,1,1,877,0,879,G
2-PB1,2155,1,0,884,0,885,G
2-PB1,2156,0,844,0,2,846,T
2-PB1,2157,0,0,841,0,841,G
2-PB1,2158,0,827,0,3,830,T
2-PB1,2159,1,0,0,821,822,C
2-PB1,2160,1,0,0,772,773,C
2-PB1,2161,774,0,0,0,774,A
2-PB1,2162,773,0,1,0,774,A
2-PB1,2163,0,0,783,0,783,G
2-PB1,2164,2,0,782,1,785,G
2-PB1,2165,1,0,0,784,785,C
2-PB1,2166,2,0,0,781,783,C
2-PB1,2167,0,0,1,782,783,C
2-PB1,2168,0,2,779,0,781,G
2-PB1,2169,1,1,784,0,786,G
2-PB1,2170,787,0,0,0,787,A
2-PB1,2171,0,783,0,0,783,T
2-PB1,2172,0,756,0,1,757,T
2-PB1,2173,0,0,740,0,740,G
2-PB1,2174,736,0,1,0,737,A
2-PB1,2175,0,737,0,0,737,T
2-PB1,2176,0,0,738,0,738,G
2-PB1,2177,0,1,1,729,731,C
2-PB1,2178,2,0,0,728,730,C
2-PB1,2179,727,0,0,0,727,A
2-PB1,2180,0,0,728,0,728,G
2-PB1,2181,728,0,0,0,728,A
2-PB1,2182,725,0,1,0,726,A
2-PB1,2183,0,727,0,0,727,T
2-PB1,2184,0,710,0,3,713,T
2-PB1,2185,1,1,715,0,717,G
2-PB1,2186,714,0,0,0,714,A
2-PB1,2187,0,2,0,711,713,C
2-PB1,2188,0,705,0,2,707,T
2-PB1,2189,0,694,0,1,695,T
2-PB1,2190,2,0,0,690,692,C
2-PB1,2191,0,0,693,0,693,G
2-PB1,2192,695,0,0,0,695,A
2-PB1,2193,0,0,676,0,676,G
2-PB1,2194,0,682,0,0,682,T
2-PB1,2195,3,0,0,677,680,C
2-PB1,2196,0,681,0,0,681,T
2-PB1,2197,0,0,680,0,680,G
2-PB1,2198,1,0,680,0,681,G
2-PB1,2199,682,0,0,0,682,A
2-PB1,2200,655,0,0,0,655,A
2-PB1,2201,0,0,656,0,656,G
2-PB1,2202,1,0,657,0,658,G
2-PB1,2203,658,0,0,0,658,A
2-PB1,2204,0,649,0,0,649,T
2-PB1,2205,0,650,0,0,650,T
2-PB1,2206,647,1,0,0,648,A
2-PB1,2207,646,0,0,0,646,A
2-PB1,2208,0,0,646,1,647,G
2-PB1,2209,641,0,1,0,642,A
2-PB1,2210,602,0,0,0,602,A
2-PB1,2211,0,1,560,0,561,G
2-PB1,2212,0,0,558,0,558,G
2-PB1,2213,558,0,0,0,558,A
2-PB1,2214,555,0,1,0,556,A
2-PB1,2215,0,0,556,0,556,G
2-PB1,2216,539,0,0,0,539,A
2-PB1,2217,0,0,538,0,538,G
2-PB1,2218,1,517,0,0,518,T
2-PB1,2219,1,514,0,0,515,T
2-PB1,2220,1,1,0,518,520,C
2-PB1,2221,0,502,0,0,502,T
2-PB1,2222,2,0,0,502,504,C
2-PB1,2223,0,502,1,1,504,T
2-PB1,2224,0,1,501,0,502,G
2-PB1,2225,484,0,1,0,485,A
2-PB1,2226,0,1,476,0,477,G
2-PB1,2227,472,0,0,0,472,A
2-PB1,2228,0,450,0,0,450,T
2-PB1,2229,1,0,1,433,435,C
2-PB1,2230,436,0,1,0,437,A
2-PB1,2231,0,435,0,0,435,T
2-PB1,2232,0,3,433,0,436,G
2-PB1,2233,436,0,0,0,436,A
2-PB1,2234,431,0,2,0,433,A
2-PB1,2235,0,1,422,0,423,G
2-PB1,2236,414,0,0,0,414,A
2-PB1,2237,0,412,0,0,412,T
2-PB1,2238,1,1,0,402,404,C
2-PB1,2239,0,385,0,1,386,T
2-PB1,2240,1,0,387,0,388,G
2-PB1,2241,0,388,0,0,388,T
2-PB1,2242,0,386,0,1,387,T
2-PB1,2243,1,0,0,387,388,C
2-PB1,2244,0,0,0,369,369,C
2-PB1,2245,362,0,0,0,362,A
2-PB1,2246,0,0,0,364,364,C
2-PB1,2247,1,2,0,343,346,C
2-PB1,2248,338,0,0,0,338,A
2-PB1,2249,0,316,0,0,316,T
2-PB1,2250,0,309,0,2,311,T
2-PB1,2251,0,0,312,0,312,G
2-PB1,2252,308,0,0,0,308,A
2-PB1,2253,303,0,0,0,303,A
2-PB1,2254,0,0,305,0,305,G
2-PB1,2255,277,0,0,0,277,A
2-PB1,2256,276,0,0,0,276,A
2-PB1,2257,0,0,0,276,276,C
2-PB1,2258,0,261,0,0,261,T
2-PB1,2259,1,0,0,260,261,C
2-PB1,2260,256,0,1,0,257,A
2-PB1,2261,1,0,256,0,257,G
2-PB1,2262,256,0,0,0,256,A
2-PB1,2263,0,1,0,247,248,C
2-PB1,2264,0,0,245,0,245,G
2-PB1,2265,0,0,236,0,236,G
2-PB1,2266,0,0,0,236,236,C
2-PB1,2267,235,0,0,0,235,A
2-PB1,2268,235,0,0,0,235,A
2-PB1,2269,231,0,1,0,232,A
2-PB1,2270,234,0,0,0,234,A
2-PB1,2271,234,0,0,0,234,A
2-PB1,2272,0,227,0,0,227,T
2-PB1,2273,217,0,0,0,217,A
2-PB1,2274,216,0,0,0,216,A
3-PA,1,86,0,0,0,86,A
3-PA,2,0,87,0,0,87,T
3-PA,3,0,0,94,0,94,G
3-PA,4,0,0,98,0,98,G
3-PA,5,96,0,0,0,96,A
3-PA,6,98,0,0,0,98,A
3-PA,7,0,0,102,0,102,G
3-PA,8,111,0,0,0,111,A
3-PA,9,0,111,0,0,111,T
3-PA,10,0,110,0,0,110,T
3-PA,11,0,114,0,0,114,T
3-PA,12,0,114,0,0,114,T
3-PA,13,0,0,118,0,118,G
3-PA,14,0,118,0,0,118,T
3-PA,15,0,0,118,0,118,G
3-PA,16,0,0,0,121,121,C
3-PA,17,0,1,119,0,120,G
3-PA,18,135,0,0,0,135,A
3-PA,19,1,0,0,137,138,C
3-PA,20,137,0,0,0,137,A
3-PA,21,141,0,0,0,141,A
3-PA,22,0,146,0,0,146,T
3-PA,23,0,0,178,0,178,G
3-PA,24,0,0,0,180,180,C
3-PA,25,0,180,0,1,181,T
3-PA,26,0,181,0,0,181,T
3-PA,27,1,0,0,181,182,C
3-PA,28,187,0,0,0,187,A
3-PA,29,191,0,0,0,191,A
3-PA,30,0,0,0,200,200,C
3-PA,31,1,0,0,199,200,C
3-PA,32,0,0,0,201,201,C
3-PA,33,0,0,204,0,204,G
3-PA,34,204,0,0,0,204,A
3-PA,35,0,204,0,0,204,T
3-PA,36,0,0,204,0,204,G
3-PA,37,206,0,0,0,206,A
3-PA,38,0,212,0,0,212,T
3-PA,39,0,213,0,0,213,T
3-PA,40,0,0,216,0,216,G
3-PA,41,0,215,1,0,216,T
3-PA,42,0,0,0,216,216,C
3-PA,43,0,0,216,0,216,G
3-PA,44,219,0,0,0,219,A
3-PA,45,219,0,0,0,219,A
3-PA,46,0,0,0,221,221,C
3-PA,47,0,221,0,0,221,T
3-PA,48,0,220,0,0,220,T
3-PA,49,0,1,221,0,222,G
3-PA,50,0,0,0,222,222,C
3-PA,51,223,0,1,0,224,A
3-PA,52,0,0,227,0,227,G
3-PA,53,226,0,0,0,226,A
3-PA,54,228,0,0,0,228,A
3-PA,55,227,0,0,0,227,A
3-PA,56,227,0,0,0,227,A
3-PA,57,232,0,1,0,233,A
3-PA,58,0,0,235,0,235,G
3-PA,59,0,1,0,246,247,C
3-PA,60,249,0,0,0,249,A
3-PA,61,267,0,0,0,267,A
3-PA,62,0,268,0,0,268,T
3-PA,63,0,0,275,0,275,G
3-PA,64,278,0,0,0,278,A
3-PA,65,279,0,0,0,279,A
3-PA,66,281,0,0,0,281,A
3-PA,67,0,1,298,0,299,G
3-PA,68,323,0,0,0,323,A
3-PA,69,0,0,366,0,366,G
3-PA,70,0,366,0,0,366,T
3-PA,71,367,0,0,1,368,A
3-PA,72,0,368,0,0,368,T
3-PA,73,2,1,367,0,370,G
3-PA,74,1,2,370,0,373,G
3-PA,75,0,0,372,0,372,G
3-PA,76,0,2,373,0,375,G
3-PA,77,373,0,0,0,373,A
3-PA,78,0,4,368,0,372,G
3-PA,79,0,0,385,1,386,G
3-PA,80,385,0,0,0,385,A
3-PA,81,0,390,0,0,390,T
3-PA,82,0,0,0,391,391,C
3-PA,83,0,389,0,0,389,T
3-PA,84,0,0,391,0,391,G
3-PA,85,390,0,0,0,390,A
3-PA,86,389,1,0,0,390,A
3-PA,87,390,0,0,0,390,A
3-PA,88,391,0,0,0,391,A
3-PA,89,0,391,0,1,392,T
3-PA,90,0,391,0,1,392,T
3-PA,91,0,2,392,0,394,G
3-PA,92,394,0,0,0,394,A
3-PA,93,395,0,0,0,395,A
3-PA,94,395,0,0,0,395,A
3-PA,95,0,0,0,397,397,C
3-PA,96,396,0,0,0,396,A
3-PA,97,400,0,0,0,400,A
3-PA,98,403,0,0,0,403,A
3-PA,99,0,2,0,406,408,C
3-PA,100,409,0,0,0,409,A
3-PA,101,415,0,0,0,415,A
3-PA,102,419,0,0,0,419,A
3-PA,103,0,417,0,0,417,T
3-PA,104,0,417,0,1,418,T
3-PA,105,0,419,0,0,419,T
3-PA,106,1,0,418,0,419,G
3-PA,107,0,0,0,421,421,C
3-PA,108,419,0,1,0,420,A
3-PA,109,0,0,437,0,437,G
3-PA,110,0,0,0,437,437,C
3-PA,111,456,0,0,0,456,A
3-PA,112,468,0,0,0,468,A
3-PA,113,0,477,0,0,477,T
3-PA,114,488,0,0,0,488,A
3-PA,115,0,490,0,0,490,T
3-PA,116,0,0,503,0,503,G
3-PA,117,1,0,0,503,504,C
3-PA,118,499,0,1,0,500,A
3-PA,119,0,0,0,506,506,C
3-PA,120,1,499,0,2,502,T
3-PA,121,0,0,0,627,627,C
3-PA,122,637,0,1,0,638,A
3-PA,123,0,0,0,654,654,C
3-PA,124,0,655,0,0,655,T
3-PA,125,0,655,0,0,655,T
3-PA,126,0,1,652,0,653,G
3-PA,127,0,0,661,0,661,G
3-PA,128,660,1,0,0,661,A
3-PA,129,0,2,667,0,669,G
3-PA,130,0,2,664,0,666,G
3-PA,131,0,654,0,1,655,T
3-PA,132,0,1,675,0,676,G
3-PA,133,0,677,0,1,678,T
3-PA,134,1,0,689,0,690,G
3-PA,135,0,687,0,2,689,T
3-PA,136,0,688,0,1,689,T
3-PA,137,0,690,0,1,691,T
3-PA,138,0,0,0,696,696,C
3-PA,139,695,0,1,1,697,A
3-PA,140,0,697,0,0,697,T
3-PA,141,0,0,713,0,713,G
3-PA,142,0,715,0,0,715,T
3-PA,143,721,0,0,0,721,A
3-PA,144,0,718,0,1,719,T
3-PA,145,0,720,0,0,720,T
3-PA,146,0,0,0,721,721,C
3-PA,147,720,0,0,0,720,A
3-PA,148,0,1,725,0,726,G
3-PA,149,726,0,1,0,727,A
3-PA,150,0,727,0,0,727,T
3-PA,151,0,727,0,0,727,T
3-PA,152,0,728,0,0,728,T
3-PA,153,0,0,0,725,725,C
3-PA,154,1,1,0,737,739,C
3-PA,155,740,0,0,0,740,A
3-PA,156,0,740,0,0,740,T
3-PA,157,0,740,0,0,740,T
3-PA,158,0,740,0,0,740,T
3-PA,159,0,0,0,740,740,C
3-PA,160,738,0,4,0,742,A
3-PA,161,0,759,0,1,760,T
3-PA,162,0,0,0,763,763,C
3-PA,163,761,0,1,0,762,A
3-PA,164,761,0,0,0,761,A
3-PA,165,0,763,0,1,764,T
3-PA,166,0,2,788,0,790,G
3-PA,167,789,0,0,0,789,A
3-PA,168,787,1,1,0,789,A
3-PA,169,0,0,0,791,791,C
3-PA,170,785,0,1,2,788,A
3-PA,171,790,0,0,0,790,A
3-PA,172,0,2,787,0,789,G
3-PA,173,1,1,791,0,793,G
3-PA,174,0,1,0,790,791,C
3-PA,175,0,1,790,0,791,G
3-PA,176,827,0,1,0,828,A
3-PA,177,830,0,0,0,830,A
3-PA,178,0,830,0,1,831,T
3-PA,179,0,0,0,846,846,C
3-PA,180,847,0,0,0,847,A
3-PA,181,842,0,2,0,844,A
3-PA,182,0,853,0,0,853,T
3-PA,183,847,1,1,0,849,A
3-PA,184,0,1,873,0,874,G
3-PA,185,0,878,0,0,878,T
3-PA,186,0,0,879,0,879,G
3-PA,187,0,0,882,0,882,G
3-PA,188,0,879,0,0,879,T
3-PA,189,881,0,0,0,881,A
3-PA,190,0,0,896,0,896,G
3-PA,191,892,0,0,0,892,A
3-PA,192,897,0,0,0,897,A
3-PA,193,0,0,0,898,898,C
3-PA,194,0,888,0,0,888,T
3-PA,195,0,889,0,0,889,T
3-PA,196,1,2,886,0,889,G
3-PA,197,889,1,1,0,891,A
3-PA,198,0,0,0,889,889,C
3-PA,199,0,1,886,0,887,G
3-PA,200,896,1,0,0,897,A
3-PA,201,1,912,0,1,914,T
3-PA,202,1,1,0,906,908,C
3-PA,203,0,0,0,922,922,C
3-PA,204,924,1,0,0,925,A
3-PA,205,928,0,0,0,928,A
3-PA,206,928,0,0,0,928,A
3-PA,207,0,927,0,0,927,T
3-PA,208,0,0,928,0,928,G
3-PA,209,0,0,0,923,923,C
3-PA,210,921,0,0,0,921,A
3-PA,211,0,0,0,949,949,C
3-PA,212,0,944,0,1,945,T
3-PA,213,0,1,1059,0,1060,G
3-PA,214,0,1059,0,2,1061,T
3-PA,215,1,1060,0,0,1061,T
3-PA,216,1056,0,4,0,1060,A
3-PA,217,1057,0,1,0,1058,A
3-PA,218,1060,0,1,0,1061,A
3-PA,219,0,1,1071,0,1072,G
3-PA,220,0,0,0,1063,1063,C
3-PA,221,1056,0,0,0,1056,A
3-PA,222,1,0,0,1056,1057,C
3-PA,223,1015,0,1,1,1017,A
3-PA,224,0,0,1058,1,1059,G
3-PA,225,1064,0,0,0,1064,A
3-PA,226,0,1061,0,0,1061,T
3-PA,227,0,1064,0,0,1064,T
3-PA,228,0,1058,0,0,1058,T
3-PA,229,0,2,1061,0,1063,G
3-PA,230,1063,0,0,0,1063,A
3-PA,231,1064,0,0,0,1064,A
3-PA,232,1058,0,0,0,1058,A
3-PA,233,0,1048,0,0,1048,T
3-PA,234,1050,0,0,0,1050,A
3-PA,235,1057,0,2,0,1059,A
3-PA,236,0,1061,0,0,1061,T
3-PA,237,0,0,0,1059,1059,C
3-PA,238,0,2,1055,0,1057,G
3-PA,239,1053,0,0,0,1053,A
3-PA,240,1,2,1053,0,1056,G
3-PA,241,0,1,1067,0,1068,G
3-PA,242,0,2,1061,0,1063,G
3-PA,243,0,2,1060,0,1062,G
3-PA,244,1054,1,1,0,1056,A
3-PA,245,1,2,1057,0,1060,G
3-PA,246,1080,0,5,1,1086,A
3-PA,247,1,2,1091,0,1094,G
3-PA,248,1091,0,1,0,1092,A
3-PA,249,0,0,0,1093,1093,C
3-PA,250,1091,0,0,0,1091,A
3-PA,251,0,3,1101,0,1104,G
3-PA,252,1103,0,0,0,1103,A
3-PA,253,1121,0,0,0,1121,A
3-PA,254,0,0,0,1118,1118,C
3-PA,255,1103,0,1,0,1104,A
3-PA,256,1101,0,0,0,1101,A
3-PA,257,1,1100,0,1,1102,T
3-PA,258,0,0,1162,0,1162,G
3-PA,259,1,0,1166,1,1168,G
3-PA,260,0,1,0,1156,1157,C
3-PA,261,2,0,0,1159,1161,C
3-PA,262,0,1154,0,0,1154,T
3-PA,263,3,3,1180,0,1186,G
3-PA,264,0,0,1187,0,1187,G
3-PA,265,1184,0,1,0,1185,A
3-PA,266,1,0,0,1183,1184,C
3-PA,267,1164,0,0,0,1164,A
3-PA,268,1,0,1296,0,1297,G
3-PA,269,0,1299,0,1,1300,T
3-PA,270,1319,0,1,0,1320,A
3-PA,271,0,3,1319,0,1322,G
3-PA,272,0,1302,0,1,1303,T
3-PA,273,1306,0,1,0,1307,A
3-PA,274,1304,0,0,0,1304,A
3-PA,275,1300,0,2,0,1302,A
3-PA,276,0,0,0,1315,1315,C
3-PA,277,1233,0,0,0,1233,A
3-PA,278,0,1,1255,0,1256,G
3-PA,279,0,1245,0,1,1246,T
3-PA,280,1265,0,0,0,1265,A
3-PA,281,0,1259,0,1,1260,T
3-PA,282,0,0,0,1274,1274,C
3-PA,283,0,1271,0,1,1272,T
3-PA,284,1,0,1269,0,1270,G
3-PA,285,0,1,0,1271,1272,C
3-PA,286,1269,1,1,0,1271,A
3-PA,287,1264,2,2,0,1268,A
3-PA,288,1,0,0,1278,1279,C
3-PA,289,1275,0,0,0,1275,A
3-PA,290,0,0,0,1333,1333,C
3-PA,291,0,1321,0,0,1321,T
3-PA,292,1320,1,0,0,1321,A
3-PA,293,0,0,0,1318,1318,C
3-PA,294,2,1312,0,2,1316,T
3-PA,295,1,3,1313,0,1317,G
3-PA,296,0,1,1309,0,1310,G
3-PA,297,1297,0,0,0,1297,A
3-PA,298,0,0,1303,0,1303,G
3-PA,299,1,1,0,1281,1283,C
3-PA,300,0,1286,0,1,1287,T
3-PA,301,0,4,1278,0,1282,G
3-PA,302,0,1,1279,0,1280,G
3-PA,303,0,0,1272,0,1272,G
3-PA,304,1270,0,1,0,1271,A
3-PA,305,1275,0,0,0,1275,A
3-PA,306,1282,0,1,0,1283,A
3-PA,307,0,0,0,1275,1275,C
3-PA,308,3,1,0,1277,1281,C
3-PA,309,0,3,1277,0,1280,G
3-PA,310,1282,0,1,0,1283,A
3-PA,311,1278,0,1,0,1279,A
3-PA,312,1,0,1300,0,1301,G
3-PA,313,0,1298,0,0,1298,T
3-PA,314,0,1296,1,2,1299,T
3-PA,315,0,1303,0,1,1304,T
3-PA,316,0,2,0,1301,1303,C
3-PA,317,0,1306,0,1,1307,T
3-PA,318,1310,0,0,0,1310,A
3-PA,319,0,0,0,1300,1300,C
3-PA,320,0,1,0,1305,1306,C
3-PA,321,1299,1,2,0,1302,A
3-PA,322,0,1,1315,0,1316,G
3-PA,323,1318,0,0,0,1318,A
3-PA,324,0,1317,0,0,1317,T
3-PA,325,0,1318,0,0,1318,T
3-PA,326,0,1318,0,0,1318,T
3-PA,327,1,0,1322,0,1323,G
3-PA,328,0,1322,0,1,1323,T
3-PA,329,1324,0,0,0,1324,A
3-PA,330,1,1322,0,0,1323,T
3-PA,331,0,1,1306,0,1307,G
3-PA,332,1363,0,0,0,1363,A
3-PA,333,1,1363,0,0,1364,T
3-PA,334,1,1363,0,0,1364,T
3-PA,335,1364,0,0,0,1364,A
3-PA,336,1,1,0,1356,1358,C
3-PA,337,1365,0,2,0,1367,A
3-PA,338,1367,0,1,0,1368,A
3-PA,339,0,1,1372,0,1373,G
3-PA,340,0,5,1378,0,1383,G
3-PA,341,1336,0,1,0,1337,A
3-PA,342,0,1,1352,0,1353,G
3-PA,343,1351,1,2,0,1354,A
3-PA,344,1349,1,2,0,1352,A
3-PA,345,0,0,0,1354,1354,C
3-PA,346,1334,1,2,0,1337,A
3-PA,347,0,0,1341,0,1341,G
3-PA,348,1338,0,0,0,1338,A
3-PA,349,0,1324,0,1,1325,T
3-PA,350,0,1323,0,0,1323,T
3-PA,351,0,1,0,1318,1319,C
3-PA,352,1321,0,0,0,1321,A
3-PA,353,0,1319,0,1,1320,T
3-PA,354,1,2,0,1315,1318,C
3-PA,355,0,0,1322,0,1322,G
3-PA,356,1329,0,0,0,1329,A
3-PA,357,1328,0,0,0,1328,A
3-PA,358,1330,0,1,0,1331,A
3-PA,359,0,1327,0,0,1327,T
3-PA,360,0,1324,0,0,1324,T
3-PA,361,0,3,1323,0,1326,G
3-PA,362,1,3,1321,0,1325,G
3-PA,363,0,0,1324,0,1324,G
3-PA,364,0,0,1333,0,1333,G
3-PA,365,0,1328,1,0,1329,T
3-PA,366,0,0,1338,0,1338,G
3-PA,367,1339,1,2,0,1342,A
3-PA,368,0,0,0,1351,1351,C
3-PA,369,1350,0,0,0,1350,A
3-PA,370,1347,0,2,0,1349,A
3-PA,371,1,0,1363,0,1364,G
3-PA,372,0,5,1356,0,1361,G
3-PA,373,1360,1,2,0,1363,A
3-PA,374,2,0,1363,0,1365,G
3-PA,375,1356,0,0,0,1356,A
3-PA,376,0,2,1354,0,1356,G
3-PA,377,1340,0,0,0,1340,A
3-PA,378,1335,0,2,0,1337,A
3-PA,379,0,0,1363,0,1363,G
3-PA,380,2,1336,0,0,1338,T
3-PA,381,0,0,0,1349,1349,C
3-PA,382,0,0,0,1351,1351,C
3-PA,383,1361,0,2,0,1363,A
3-PA,384,0,1,0,1385,1386,C
3-PA,385,1410,1,0,1,1412,A
3-PA,386,0,1444,0,0,1444,T
3-PA,387,1455,0,1,0,1456,A
3-PA,388,0,1426,1,0,1427,T
3-PA,389,1406,1,0,0,1407,A
3-PA,390,0,1390,0,1,1391,T
3-PA,391,0,1386,0,1,1387,T
3-PA,392,1410,0,0,0,1410,A
3-PA,393,0,1,0,1407,1408,C
3-PA,394,2,0,0,1353,1355,C
3-PA,395,0,1337,0,1,1338,T
3-PA,396,0,1311,0,0,1311,T
3-PA,397,0,4,1321,0,1325,G
3-PA,398,1323,0,0,1,1324,A
3-PA,399,1324,0,0,0,1324,A
3-PA,400,1325,0,1,0,1326,A
3-PA,401,1291,0,0,0,1291,A
3-PA,402,40,1,1260,0,1301,G
3-PA,403,0,0,1303,0,1303,G
3-PA,404,0,0,0,1305,1305,C
3-PA,405,0,0,0,1303,1303,C
3-PA,406,1302,0,0,0,1302,A
3-PA,407,1297,0,3,0,1300,A
3-PA,408,0,1301,0,0,1301,T
3-PA,409,1299,0,2,0,1301,A
3-PA,410,1300,0,1,0,1301,A
3-PA,411,0,1,1313,0,1314,G
3-PA,412,1309,0,1,0,1310,A
3-PA,413,0,1308,0,0,1308,T
3-PA,414,0,1304,0,1,1305,T
3-PA,415,1301,0,1,1,1303,A
3-PA,416,1306,0,0,0,1306,A
3-PA,417,1313,0,0,0,1313,A
3-PA,418,1,1317,0,0,1318,T
3-PA,419,1,0,0,1316,1317,C
3-PA,420,0,1287,0,1,1288,T
3-PA,421,1,1,1294,0,1296,G
3-PA,422,1294,0,1,0,1295,A
3-PA,423,0,1,1302,0,1303,G
3-PA,424,1304,0,0,0,1304,A
3-PA,425,1294,0,1,0,1295,A
3-PA,426,1,0,0,1292,1293,C
3-PA,427,1289,0,1,0,1290,A
3-PA,428,0,0,0,1294,1294,C
3-PA,429,1294,1,0,0,1295,A
3-PA,430,0,2,0,1301,1303,C
3-PA,431,1291,0,1,0,1292,A
3-PA,432,0,1,0,1316,1317,C
3-PA,433,1303,1,0,0,1304,A
3-PA,434,0,1312,0,0,1312,T
3-PA,435,0,1305,0,1,1306,T
3-PA,436,1,0,1,1309,1311,C
3-PA,437,1301,0,0,0,1301,A
3-PA,438,0,1,0,1308,1309,C
3-PA,439,1300,0,0,0,1300,A
3-PA,440,0,1299,1,0,1300,T
3-PA,441,0,1268,0,0,1268,T
3-PA,442,0,1284,0,2,1286,T
3-PA,443,0,1284,0,1,1285,T
3-PA,444,1,1,0,1289,1291,C
3-PA,445,0,1279,0,2,1281,T
3-PA,446,2,0,0,1285,1287,C
3-PA,447,1282,0,0,0,1282,A
3-PA,448,0,1275,0,1,1276,T
3-PA,449,0,1288,1,3,1292,T
3-PA,450,1,0,0,1291,1292,C
3-PA,451,1280,0,1,0,1281,A
3-PA,452,0,0,0,1291,1291,C
3-PA,453,0,1284,0,1,1285,T
3-PA,454,1,2,1282,0,1285,G
3-PA,455,0,3,1280,0,1283,G
3-PA,456,1250,0,3,0,1253,A
3-PA,457,0,0,1285,0,1285,G
3-PA,458,1281,0,1,0,1282,A
3-PA,459,0,2,1290,0,1292,G
3-PA,460,0,2,1291,0,1293,G
3-PA,461,1283,0,0,0,1283,A
3-PA,462,1280,1,0,0,1281,A
3-PA,463,1272,0,1,0,1273,A
3-PA,464,0,1259,0,0,1259,T
3-PA,465,0,1,1257,0,1258,G
3-PA,466,0,0,1251,0,1251,G
3-PA,467,0,0,0,1260,1260,C
3-PA,468,2,1,0,1249,1252,C
3-PA,469,1246,0,2,0,1248,A
3-PA,470,0,0,0,1251,1251,C
3-PA,471,1248,0,1,0,1249,A
3-PA,472,1258,0,2,0,1260,A
3-PA,473,1258,0,1,0,1259,A
3-PA,474,0,1,1263,0,1264,G
3-PA,475,0,0,1264,0,1264,G
3-PA,476,1,1,1,1265,1268,C
3-PA,477,1267,0,1,0,1268,A
3-PA,478,0,5,1263,0,1268,G
3-PA,479,1261,0,2,0,1263,A
3-PA,480,0,1,0,1271,1272,C
3-PA,481,1,1261,0,1,1263,T
3-PA,482,1259,0,0,0,1259,A
3-PA,483,0,1,0,1251,1252,C
3-PA,484,1243,0,0,0,1243,A
3-PA,485,0,0,0,1247,1247,C
3-PA,486,0,1218,0,0,1218,T
3-PA,487,1,0,0,1220,1221,C
3-PA,488,0,1214,0,1,1215,T
3-PA,489,1,0,0,1198,1199,C
3-PA,490,0,1,1195,0,1196,G
3-PA,491,1195,0,1,0,1196,A
3-PA,492,0,0,0,1192,1192,C
3-PA,493,0,0,1197,0,1197,G
3-PA,494,1190,0,1,0,1191,A
3-PA,495,0,0,1188,0,1188,G
3-PA,496,2,1,1182,0,1185,G
3-PA,497,1182,0,1,0,1183,A
3-PA,498,1179,1,0,0,1180,A
3-PA,499,1181,1,1,0,1183,A
3-PA,500,0,1,1185,0,1186,G
3-PA,501,0,2,0,1184,1186,C
3-PA,502,1177,0,1,0,1178,A
3-PA,503,1,1,1187,0,1189,G
3-PA,504,0,2,1189,0,1191,G
3-PA,505,1,0,1186,0,1187,G
3-PA,506,0,0,0,1188,1188,C
3-PA,507,0,1183,0,0,1183,T
3-PA,508,1181,0,1,0,1182,A
3-PA,509,1,0,1199,0,1200,G
3-PA,510,0,1,1260,0,1261,G
3-PA,511,1267,2,2,0,1271,A
3-PA,512,0,1243,0,1,1244,T
3-PA,513,0,1219,0,0,1219,T
3-PA,514,1218,0,1,1,1220,A
3-PA,515,1227,0,2,0,1229,A
3-PA,516,1,1,1227,0,1229,G
3-PA,517,1226,0,3,0,1229,A
3-PA,518,1,0,1,1221,1223,C
3-PA,519,1,2,0,1110,1113,C
3-PA,520,1104,0,1,0,1105,A
3-PA,521,0,2,1114,0,1116,G
3-PA,522,1,0,1115,0,1116,G
3-PA,523,0,9,0,1111,1120,C
3-PA,524,0,1105,0,1,1106,T
3-PA,525,1,1,1125,0,1127,G
3-PA,526,0,1122,0,0,1122,T
3-PA,527,0,1117,0,0,1117,T
3-PA,528,0,1123,0,0,1123,T
3-PA,529,1121,0,1,0,1122,A
3-PA,530,0,1,0,1130,1131,C
3-PA,531,1,1,0,1109,1111,C
3-PA,532,1103,1,0,0,1104,A
3-PA,533,0,1103,0,1,1104,T
3-PA,534,1076,0,0,0,1076,A
3-PA,535,1081,0,0,1,1082,A
3-PA,536,0,0,1100,0,1100,G
3-PA,537,1097,0,1,0,1098,A
3-PA,538,0,0,0,1096,1096,C
3-PA,539,1075,0,0,0,1075,A
3-PA,540,1072,0,2,0,1074,A
3-PA,541,0,1,1079,0,1080,G
3-PA,542,1077,0,0,0,1077,A
3-PA,543,1078,0,0,0,1078,A
3-PA,544,1072,0,0,0,1072,A
3-PA,545,1,1043,0,0,1044,T
3-PA,546,1,1,1055,0,1057,G
3-PA,547,0,1,1057,0,1058,G
3-PA,548,2,2,0,1040,1044,C
3-PA,549,1,0,0,1054,1055,C
3-PA,550,1049,0,2,0,1051,A
3-PA,551,1071,0,0,0,1071,A
3-PA,552,1,1,0,1067,1069,C
3-PA,553,1069,0,1,0,1070,A
3-PA,554,0,2,1068,0,1070,G
3-PA,555,1042,1,3,1,1047,A
3-PA,556,1,0,1064,1,1066,G
3-PA,557,1,0,1074,0,1075,G
3-PA,558,0,0,0,1060,1060,C
3-PA,559,4,0,0,1070,1074,C
3-PA,560,0,1044,0,0,1044,T
3-PA,561,1050,0,1,0,1051,A
3-PA,562,0,1056,0,0,1056,T
3-PA,563,0,0,1055,0,1055,G
3-PA,564,0,1,1053,0,1054,G
3-PA,565,1,1,1013,0,1015,G
3-PA,566,996,0,1,1,998,A
3-PA,567,0,989,0,2,991,T
3-PA,568,1,981,0,1,983,T
3-PA,569,0,2,0,1045,1047,C
3-PA,570,1,0,0,1030,1031,C
3-PA,571,0,977,0,0,977,T
3-PA,572,0,973,0,3,976,T
3-PA,573,0,974,0,0,974,T
3-PA,574,0,1,0,972,973,C
3-PA,575,2,0,977,0,979,G
3-PA,576,1,970,0,2,973,T
3-PA,577,1,1,0,974,976,C
3-PA,578,940,0,1,0,941,A
3-PA,579,0,1,995,0,996,G
3-PA,580,0,997,0,1,998,T
3-PA,581,1,0,0,992,993,C
3-PA,582,0,1,0,996,997,C
3-PA,583,6,2,992,0,1000,G
3-PA,584,999,0,0,1,1000,A
3-PA,585,1000,0,1,0,1001,A
3-PA,586,1000,1,2,0,1003,A
3-PA,587,2,0,1002,0,1004,G
3-PA,588,963,0,2,0,965,A
3-PA,589,0,0,970,0,970,G
3-PA,590,0,0,973,0,973,G
3-PA,591,1,0,0,971,972,C
3-PA,592,2,1,973,0,976,G
3-PA,593,973,0,0,0,973,A
3-PA,594,976,0,1,0,977,A
3-PA,595,0,4,977,0,981,G
3-PA,596,983,1,1,0,985,A
3-PA,597,981,0,1,0,982,A
3-PA,598,980,0,1,0,981,A
3-PA,599,0,0,0,986,986,C
3-PA,600,987,0,0,0,987,A
3-PA,601,983,0,0,0,983,A
3-PA,602,0,986,0,1,987,T
3-PA,603,0,984,0,0,984,T
3-PA,604,0,1,985,0,986,G
3-PA,605,984,0,0,0,984,A
3-PA,606,983,1,0,0,984,A
3-PA,607,0,1,984,0,985,G
3-PA,608,977,0,3,0,980,A
3-PA,609,976,0,0,0,976,A
3-PA,610,981,0,0,0,981,A
3-PA,611,985,0,1,0,986,A
3-PA,612,989,0,0,0,989,A
3-PA,613,0,984,0,0,984,T
3-PA,614,0,984,0,0,984,T
3-PA,615,1,981,0,4,986,T
3-PA,616,1,5,981,0,987,G
3-PA,617,987,0,0,0,987,A
3-PA,618,988,0,0,0,988,A
3-PA,619,986,0,2,0,988,A
3-PA,620,0,994,0,1,995,T
3-PA,621,1,1,1,1054,1057,C
3-PA,622,1055,0,0,1,1056,A
3-PA,623,0,0,0,1074,1074,C
3-PA,624,1070,0,1,0,1071,A
3-PA,625,0,1,1089,0,1090,G
3-PA,626,1,1,1111,0,1113,G
3-PA,627,1121,0,1,0,1122,A
3-PA,628,1131,0,0,0,1131,A
3-PA,629,0,0,0,1139,1139,C
3-PA,630,0,1085,0,1,1086,T
3-PA,631,1153,1,3,0,1157,A
3-PA,632,0,1152,0,1,1153,T
3-PA,633,0,0,1181,0,1181,G
3-PA,634,0,0,0,1165,1165,C
3-PA,635,0,1,1143,0,1144,G
3-PA,636,0,1142,0,0,1142,T
3-PA,637,1133,0,1,0,1134,A
3-PA,638,0,0,1137,0,1137,G
3-PA,639,0,3,1125,0,1128,G
3-PA,640,1,0,0,1109,1110,C
3-PA,641,0,1086,0,2,1088,T
3-PA,642,0,1080,0,1,1081,T
3-PA,643,0,0,1078,0,1078,G
3-PA,644,0,0,0,1080,1080,C
3-PA,645,3,1,0,1076,1080,C
3-PA,646,1,1,1095,0,1097,G
3-PA,647,1100,0,0,0,1100,A
3-PA,648,0,0,0,1097,1097,C
3-PA,649,3,1,0,1096,1100,C
3-PA,650,1099,0,0,0,1099,A
3-PA,651,1098,0,0,0,1098,A
3-PA,652,1098,0,0,0,1098,A
3-PA,653,0,0,1110,0,1110,G
3-PA,654,0,1104,0,1,1105,T
3-PA,655,2,0,0,1100,1102,C
3-PA,656,0,1092,0,0,1092,T
3-PA,657,1,0,0,1098,1099,C
3-PA,658,0,0,0,1104,1104,C
3-PA,659,1,0,0,1105,1106,C
3-PA,660,1110,0,0,0,1110,A
3-PA,661,0,1,0,1112,1113,C
3-PA,662,2,1,1,1096,1100,C
3-PA,663,1,0,1112,0,1113,G
3-PA,664,1121,0,0,1,1122,A
3-PA,665,1122,0,0,1,1123,A
3-PA,666,0,0,0,1132,1132,C
3-PA,667,0,1115,0,3,1118,T
3-PA,668,0,1134,0,2,1136,T
3-PA,669,1,0,0,1147,1148,C
3-PA,670,0,1133,0,3,1136,T
3-PA,671,2,1,0,1136,1139,C
3-PA,672,0,0,0,1136,1136,C
3-PA,673,2,1125,0,0,1127,T
3-PA,674,0,0,1147,0,1147,G
3-PA,675,1,0,0,1142,1143,C
3-PA,676,3,0,0,1143,1146,C
3-PA,677,0,1132,0,2,1134,T
3-PA,678,0,1132,0,0,1132,T
3-PA,679,0,0,1134,0,1134,G
3-PA,680,1133,0,0,0,1133,A
3-PA,681,2,0,1149,0,1151,G
3-PA,682,1149,1,0,0,1150,A
3-PA,683,1159,0,0,0,1159,A
3-PA,684,0,1177,0,0,1177,T
3-PA,685,1,1172,1,1,1175,T
3-PA,686,0,1172,0,1,1173,T
3-PA,687,0,1177,0,0,1177,T
3-PA,688,1174,0,1,0,1175,A
3-PA,689,0,0,1178,0,1178,G
3-PA,690,1162,1,3,0,1166,A
3-PA,691,1,2,1189,0,1192,G
3-PA,692,1,0,0,1178,1179,C
3-PA,693,0,0,0,1181,1181,C
3-PA,694,0,1198,0,0,1198,T
3-PA,695,1218,0,0,0,1218,A
3-PA,696,0,1215,0,0,1215,T
3-PA,697,0,0,1227,0,1227,G
3-PA,698,0,1219,0,2,1221,T
3-PA,699,2,3,1224,0,1229,G
3-PA,700,2,1,1206,0,1209,G
3-PA,701,1201,0,0,0,1201,A
3-PA,702,0,1195,0,1,1196,T
3-PA,703,2,0,1177,0,1179,G
3-PA,704,1,0,1196,0,1197,G
3-PA,705,1193,0,2,0,1195,A
3-PA,706,0,1195,0,1,1196,T
3-PA,707,1,1196,0,0,1197,T
3-PA,708,2,1,0,1188,1191,C
3-PA,709,1,4,1189,0,1194,G
3-PA,710,1198,1,2,0,1201,A
3-PA,711,1198,1,0,0,1199,A
3-PA,712,0,0,0,1208,1208,C
3-PA,713,1,1,0,1174,1176,C
3-PA,714,0,1,1176,0,1177,G
3-PA,715,1175,0,0,0,1175,A
3-PA,716,1175,0,2,0,1177,A
3-PA,717,0,0,0,1181,1181,C
3-PA,718,0,0,1171,0,1171,G
3-PA,719,0,0,1218,0,1218,G
3-PA,720,0,1,0,1216,1217,C
3-PA,721,0,1212,0,1,1213,T
3-PA,722,0,1,1238,0,1239,G
3-PA,723,0,1,0,1241,1242,C
3-PA,724,1244,1,0,0,1245,A
3-PA,725,0,1248,0,1,1249,T
3-PA,726,0,1231,0,0,1231,T
3-PA,727,1,1,1233,0,1235,G
3-PA,728,1205,0,1,0,1206,A
3-PA,729,0,4,1225,0,1229,G
3-PA,730,1,2,1220,0,1223,G
3-PA,731,0,0,1214,0,1214,G
3-PA,732,0,0,0,1209,1209,C
3-PA,733,1200,0,2,0,1202,A
3-PA,734,1206,0,0,0,1206,A
3-PA,735,0,0,1213,0,1213,G
3-PA,736,0,0,0,1215,1215,C
3-PA,737,0,1204,0,2,1206,T
3-PA,738,0,1206,0,0,1206,T
3-PA,739,0,1208,0,1,1209,T
3-PA,740,2,0,0,1210,1212,C
3-PA,741,1,1208,0,0,1209,T
3-PA,742,2,0,0,1212,1214,C
3-PA,743,1209,0,0,0,1209,A
3-PA,744,1199,0,1,0,1200,A
3-PA,745,1203,0,0,0,1203,A
3-PA,746,0,1202,0,0,1202,T
3-PA,747,0,0,1240,0,1240,G
3-PA,748,1,1235,0,1,1237,T
3-PA,749,1,0,0,1242,1243,C
3-PA,750,5,0,0,1240,1245,C
3-PA,751,1243,0,0,1,1244,A
3-PA,752,1247,0,1,0,1248,A
3-PA,753,1245,0,0,0,1245,A
3-PA,754,0,0,1257,0,1257,G
3-PA,755,1251,0,3,0,1254,A
3-PA,756,1205,0,0,0,1205,A
3-PA,757,0,1,1210,0,1211,G
3-PA,758,0,1201,0,1,1202,T
3-PA,759,1,1,1197,0,1199,G
3-PA,760,1189,0,0,0,1189,A
3-PA,761,1187,0,1,0,1188,A
3-PA,762,0,1200,0,0,1200,T
3-PA,763,1,0,1194,0,1195,G
3-PA,764,0,0,0,1193,1193,C
3-PA,765,3,0,0,1188,1191,C
3-PA,766,10,0,0,1177,1187,C
3-PA,767,1191,0,0,0,1191,A
3-PA,768,1204,0,0,0,1204,A
3-PA,769,1213,0,0,0,1213,A
3-PA,770,0,1211,0,0,1211,T
3-PA,771,0,1202,0,0,1202,T
3-PA,772,0,2,1200,0,1202,G
3-PA,773,1195,0,0,0,1195,A
3-PA,774,1199,0,0,1,1200,A
3-PA,775,3,0,0,1200,1203,C
3-PA,776,0,1,0,1192,1193,C
3-PA,777,0,1168,0,2,1170,T
3-PA,778,0,1184,0,0,1184,T
3-PA,779,0,1187,0,1,1188,T
3-PA,780,0,1189,0,2,1191,T
3-PA,781,0,0,0,1201,1201,C
3-PA,782,0,1195,0,1,1196,T
3-PA,783,0,0,1197,0,1197,G
3-PA,784,1190,0,1,0,1191,A
3-PA,785,1201,0,0,0,1201,A
3-PA,786,0,1,1207,0,1208,G
3-PA,787,1183,1,0,0,1184,A
3-PA,788,0,1,0,1187,1188,C
3-PA,789,1178,0,0,1,1179,A
3-PA,790,1189,0,1,0,1190,A
3-PA,791,0,0,0,1281,1281,C
3-PA,792,1280,0,1,0,1281,A
3-PA,793,0,0,0,1279,1279,C
3-PA,794,3,0,0,1261,1264,C
3-PA,795,1258,0,2,0,1260,A
3-PA,796,1263,1,2,0,1266,A
3-PA,797,1,2,1263,0,1266,G
3-PA,798,1271,0,1,0,1272,A
3-PA,799,1,2,1,1264,1268,C
3-PA,800,2,0,0,1174,1176,C
3-PA,801,1167,0,0,0,1167,A
3-PA,802,1166,0,1,0,1167,A
3-PA,803,0,1168,0,0,1168,T
3-PA,804,1,0,0,1166,1167,C
3-PA,805,1156,1,1,0,1158,A
3-PA,806,1155,0,0,0,1155,A
3-PA,807,1157,0,0,0,1157,A
3-PA,808,0,0,0,1171,1171,C
3-PA,809,0,1152,0,0,1152,T
3-PA,810,0,1154,0,0,1154,T
3-PA,811,0,0,1,1155,1156,C
3-PA,812,0,0,0,1156,1156,C
3-PA,813,1,2,1156,0,1159,G
3-PA,814,1156,0,1,0,1157,A
3-PA,815,1155,0,1,0,1156,A
3-PA,816,0,1159,0,0,1159,T
3-PA,817,0,3,1144,0,1147,G
3-PA,818,0,0,1146,0,1146,G
3-PA,819,1155,0,0,0,1155,A
3-PA,820,0,0,0,1158,1158,C
3-PA,821,1,0,0,1156,1157,C
3-PA,822,0,1172,0,1,1173,T
3-PA,823,3,1,0,1193,1197,C
3-PA,824,0,1,0,1187,1188,C
3-PA,825,1,1189,0,2,1192,T
3-PA,826,1,1191,0,2,1194,T
3-PA,827,0,0,1230,0,1230,G
3-PA,828,0,1214,1,3,1218,T
3-PA,829,0,1210,0,0,1210,T
3-PA,830,1212,0,1,0,1213,A
3-PA,831,0,1175,1,1,1177,T
3-PA,832,0,0,0,1167,1167,C
3-PA,833,1142,0,0,0,1142,A
3-PA,834,0,0,1143,0,1143,G
3-PA,835,1,1,0,1135,1137,C
3-PA,836,1,1,1095,0,1097,G
3-PA,837,0,0,1133,0,1133,G
3-PA,838,1,1135,0,3,1139,T
3-PA,839,5,0,0,1134,1139,C
3-PA,840,0,1,0,1138,1139,C
3-PA,841,1143,0,0,0,1143,A
3-PA,842,1149,0,1,0,1150,A
3-PA,843,1148,0,1,0,1149,A
3-PA,844,0,1147,0,0,1147,T
3-PA,845,0,1137,0,2,1139,T
3-PA,846,5,1,0,1119,1125,C
3-PA,847,1,0,0,1109,1110,C
3-PA,848,0,1107,0,0,1107,T
3-PA,849,0,1,0,1116,1117,C
3-PA,850,0,0,0,1117,1117,C
3-PA,851,0,1115,0,0,1115,T
3-PA,852,0,0,1122,0,1122,G
3-PA,853,1118,0,1,0,1119,A
3-PA,854,1,1117,1,0,1119,T
3-PA,855,0,2,1112,0,1114,G
3-PA,856,0,0,1090,0,1090,G
3-PA,857,1087,0,0,0,1087,A
3-PA,858,0,1076,0,0,1076,T
3-PA,859,0,0,1078,0,1078,G
3-PA,860,0,0,0,1154,1154,C
3-PA,861,0,1141,1,3,1145,T
3-PA,862,0,1152,0,0,1152,T
3-PA,863,0,1149,0,0,1149,T
3-PA,864,1153,0,1,0,1154,A
3-PA,865,1156,0,0,1,1157,A
3-PA,866,1153,0,1,2,1156,A
3-PA,867,1159,0,1,0,1160,A
3-PA,868,0,1158,0,1,1159,T
3-PA,869,0,1038,1,0,1039,T
3-PA,870,1,4,1041,0,1046,G
3-PA,871,1036,0,4,0,1040,A
3-PA,872,0,0,1054,0,1054,G
3-PA,873,1,0,1,1049,1051,C
3-PA,874,1045,1,0,0,1046,A
3-PA,875,0,1066,0,1,1067,T
3-PA,876,0,1066,0,1,1067,T
3-PA,877,0,0,1064,0,1064,G
3-PA,878,1067,0,0,0,1067,A
3-PA,879,1057,0,3,0,1060,A
3-PA,880,0,0,1062,1,1063,G
3-PA,881,1034,0,0,0,1034,A
3-PA,882,0,1,0,1040,1041,C
3-PA,883,1,0,0,1035,1036,C
3-PA,884,2,0,0,1018,1020,C
3-PA,885,1014,0,3,0,1017,A
3-PA,886,1022,0,0,0,1022,A
3-PA,887,0,0,1029,0,1029,G
3-PA,888,0,1029,0,1,1030,T
3-PA,889,2,0,0,1030,1032,C
3-PA,890,1030,0,2,0,1032,A
3-PA,891,1,2,0,1025,1028,C
3-PA,892,1,0,1027,0,1028,G
3-PA,893,1036,1,0,0,1037,A
3-PA,894,1033,1,3,0,1037,A
3-PA,895,0,1,1077,0,1078,G
3-PA,896,1,2,1070,0,1073,G
3-PA,897,1073,0,1,0,1074,A
3-PA,898,1,0,1079,0,1080,G
3-PA,899,1078,0,2,0,1080,A
3-PA,900,1080,1,1,0,1082,A
3-PA,901,0,1,1083,0,1084,G
3-PA,902,1,3,1077,0,1081,G
3-PA,903,0,1,1080,0,1081,G
3-PA,904,1049,0,0,0,1049,A
3-PA,905,0,1047,0,0,1047,T
3-PA,906,2,1,0,1040,1043,C
3-PA,907,2,0,0,1150,1152,C
3-PA,908,0,0,1,1173,1174,C
3-PA,909,1189,0,0,0,1189,A
3-PA,910,1,1189,0,1,1191,T
3-PA,911,0,1189,1,2,1192,T
3-PA,912,1215,0,2,0,1217,A
3-PA,913,0,1215,0,0,1215,T
3-PA,914,1216,0,0,0,1216,A
3-PA,915,0,1211,0,1,1212,T
3-PA,916,0,0,1110,0,1110,G
3-PA,917,1117,0,1,0,1118,A
3-PA,918,0,1107,0,0,1107,T
3-PA,919,0,0,1117,0,1117,G
3-PA,920,0,2,0,1106,1108,C
3-PA,921,1,0,1106,0,1107,G
3-PA,922,1119,0,0,0,1119,A
3-PA,923,0,1116,0,0,1116,T
3-PA,924,0,0,0,1117,1117,C
3-PA,925,1118,1,0,0,1119,A
3-PA,926,1111,1,2,0,1114,A
3-PA,927,0,0,1122,0,1122,G
3-PA,928,0,1110,1,2,1113,T
3-PA,929,0,2,1122,0,1124,G
3-PA,930,0,0,0,1138,1138,C
3-PA,931,1140,0,0,0,1140,A
3-PA,932,0,1141,0,0,1141,T
3-PA,933,1129,0,10,0,1139,A
3-PA,934,1160,0,0,1,1161,A
3-PA,935,1160,0,0,1,1161,A
3-PA,936,1157,0,0,0,1157,A
3-PA,937,1156,0,1,0,1157,A
3-PA,938,0,0,0,1158,1158,C
3-PA,939,1142,0,0,0,1142,A
3-PA,940,0,1139,1,0,1140,T
3-PA,941,0,1143,1,0,1144,T
3-PA,942,1,1,1,1144,1147,C
3-PA,943,0,1129,1,0,1130,T
3-PA,944,1,1129,1,1,1132,T
3-PA,945,0,1132,2,0,1134,T
3-PA,946,1,2,1128,0,1131,G
3-PA,947,2,0,1135,0,1137,G
3-PA,948,1136,0,1,0,1137,A
3-PA,949,0,1137,0,0,1137,T
3-PA,950,0,2,1138,0,1140,G
3-PA,951,0,2,1163,0,1165,G
3-PA,952,1166,0,1,0,1167,A
3-PA,953,1166,0,0,1,1167,A
3-PA,954,1166,0,1,0,1167,A
3-PA,955,1,3,1181,0,1185,G
3-PA,956,1181,0,0,1,1182,A
3-PA,957,1297,0,2,0,1299,A
3-PA,958,0,1,0,1322,1323,C
3-PA,959,2,0,0,1318,1320,C
3-PA,960,0,1309,0,3,1312,T
3-PA,961,0,1329,0,1,1330,T
3-PA,962,1336,0,1,0,1337,A
3-PA,963,0,1336,0,1,1337,T
3-PA,964,1334,0,0,1,1335,A
3-PA,965,1,1344,0,1,1346,T
3-PA,966,1260,0,0,0,1260,A
3-PA,967,2,0,1263,0,1265,G
3-PA,968,1,1248,0,0,1249,T
3-PA,969,0,0,0,1246,1246,C
3-PA,970,1230,0,1,0,1231,A
3-PA,971,1232,0,1,0,1233,A
3-PA,972,1231,0,1,1,1233,A
3-PA,973,0,0,0,1234,1234,C
3-PA,974,2,0,0,1228,1230,C
3-PA,975,1216,0,0,0,1216,A
3-PA,976,0,0,0,1229,1229,C
3-PA,977,1232,0,0,0,1232,A
3-PA,978,0,2,0,1241,1243,C
3-PA,979,0,2,1244,0,1246,G
3-PA,980,1241,0,3,0,1244,A
3-PA,981,1240,1,0,0,1241,A
3-PA,982,1237,0,3,0,1240,A
3-PA,983,1241,0,1,0,1242,A
3-PA,984,0,7,1237,0,1244,G
3-PA,985,0,2,1228,0,1230,G
3-PA,986,1,1,1238,0,1240,G
3-PA,987,1236,0,1,0,1237,A
3-PA,988,1237,0,1,0,1238,A
3-PA,989,0,1238,0,0,1238,T
3-PA,990,1244,1,0,0,1245,A
3-PA,991,1239,0,2,0,1241,A
3-PA,992,1255,0,1,0,1256,A
3-PA,993,0,1249,0,2,1251,T
3-PA,994,0,1251,0,0,1251,T
3-PA,995,1,0,0,1257,1258,C
3-PA,996,1260,0,0,0,1260,A
3-PA,997,1259,0,1,0,1260,A
3-PA,998,1263,0,0,0,1263,A
3-PA,999,0,1260,0,0,1260,T
3-PA,1000,0,1266,0,1,1267,T
3-PA,1001,1270,0,0,0,1270,A
3-PA,1002,0,0,0,1262,1262,C
3-PA,1003,0,2,0,1263,1265,C
3-PA,1004,0,1262,0,2,1264,T
3-PA,1005,0,1,1269,0,1270,G
3-PA,1006,1,0,0,1268,1269,C
3-PA,1007,0,1270,0,1,1271,T
3-PA,1008,1,1,1284,0,1286,G
3-PA,1009,0,1277,0,3,1280,T
3-PA,1010,1,1,0,1279,1281,C
3-PA,1011,1283,0,0,1,1284,A
3-PA,1012,0,1283,0,0,1283,T
3-PA,1013,0,0,1279,0,1279,G
3-PA,1014,0,3,1290,0,1293,G
3-PA,1015,1289,0,4,0,1293,A
3-PA,1016,1293,0,1,0,1294,A
3-PA,1017,1265,0,2,2,1269,A
3-PA,1018,0,0,0,1305,1305,C
3-PA,1019,1304,0,0,0,1304,A
3-PA,1020,1309,1,1,0,1311,A
3-PA,1021,0,0,1313,0,1313,G
3-PA,1022,0,1314,0,0,1314,T
3-PA,1023,1311,0,1,0,1312,A
3-PA,1024,0,0,0,1316,1316,C
3-PA,1025,0,1296,0,1,1297,T
3-PA,1026,0,0,1308,0,1308,G
3-PA,1027,0,1297,0,1,1298,T
3-PA,1028,4,0,0,1303,1307,C
3-PA,1029,1297,0,1,0,1298,A
3-PA,1030,0,0,1314,0,1314,G
3-PA,1031,1309,1,3,0,1313,A
3-PA,1032,1316,1,0,0,1317,A
3-PA,1033,1,1331,0,0,1332,T
3-PA,1034,0,1325,0,0,1325,T
3-PA,1035,1,0,1319,0,1320,G
3-PA,1036,0,2,0,1319,1321,C
3-PA,1037,1321,1,1,0,1323,A
3-PA,1038,2,2,1314,0,1318,G
3-PA,1039,1,2,1312,0,1315,G
3-PA,1040,1316,1,0,0,1317,A
3-PA,1041,0,0,0,1310,1310,C
3-PA,1042,2,1,1296,0,1299,G
3-PA,1043,0,1322,0,0,1322,T
3-PA,1044,1,1321,0,0,1322,T
3-PA,1045,0,1,1323,0,1324,G
3-PA,1046,1326,0,0,0,1326,A
3-PA,1047,1322,0,1,0,1323,A
3-PA,1048,1316,0,1,0,1317,A
3-PA,1049,1320,0,3,0,1323,A
3-PA,1050,0,1323,0,0,1323,T
3-PA,1051,1,1,1324,0,1326,G
3-PA,1052,1315,0,3,0,1318,A
3-PA,1053,0,2,1329,0,1331,G
3-PA,1054,0,1,1328,0,1329,G
3-PA,1055,1321,0,1,0,1322,A
3-PA,1056,0,0,1326,0,1326,G
3-PA,1057,1320,0,3,1,1324,A
3-PA,1058,1323,0,0,0,1323,A
3-PA,1059,0,1,1322,0,1323,G
3-PA,1060,1,0,1312,0,1313,G
3-PA,1061,0,1371,0,2,1373,T
3-PA,1062,0,1373,0,0,1373,T
3-PA,1063,4,0,0,1371,1375,C
3-PA,1064,2,0,0,1376,1378,C
3-PA,1065,1373,0,2,0,1375,A
3-PA,1066,1370,0,1,0,1371,A
3-PA,1067,0,0,1385,0,1385,G
3-PA,1068,5,0,1397,1,1403,G
3-PA,1069,1376,0,2,0,1378,A
3-PA,1070,0,0,1,1384,1385,C
3-PA,1071,0,1385,0,1,1386,T
3-PA,1072,1384,0,0,1,1385,A
3-PA,1073,1383,0,0,0,1383,A
3-PA,1074,1381,0,2,1,1384,A
3-PA,1075,1390,0,0,0,1390,A
3-PA,1076,1369,1,1,1,1372,A
3-PA,1077,0,1,0,1363,1364,C
3-PA,1078,1362,0,1,0,1363,A
3-PA,1079,0,1361,0,0,1361,T
3-PA,1080,0,3,1370,0,1373,G
3-PA,1081,1371,3,1,1,1376,A
3-PA,1082,1382,0,1,0,1383,A
3-PA,1083,1,0,1389,0,1390,G
3-PA,1084,1384,0,2,0,1386,A
3-PA,1085,1379,0,1,0,1380,A
3-PA,1086,1380,0,0,0,1380,A
3-PA,1087,1380,0,2,1,1383,A
3-PA,1088,0,1,0,1386,1387,C
3-PA,1089,1,2,1374,0,1377,G
3-PA,1090,1389,0,1,0,1390,A
3-PA,1091,0,0,1389,0,1389,G
3-PA,1092,1,1381,0,0,1382,T
3-PA,1093,0,1,0,1408,1409,C
3-PA,1094,1406,1,4,0,1411,A
3-PA,1095,1438,0,0,1,1439,A
3-PA,1096,0,1,0,1443,1444,C
3-PA,1097,0,1441,0,0,1441,T
3-PA,1098,1,2,1458,0,1461,G
3-PA,1099,1457,1,1,0,1459,A
3-PA,1100,1458,0,2,0,1460,A
3-PA,1101,0,0,1463,0,1463,G
3-PA,1102,0,1436,0,2,1438,T
3-PA,1103,0,2,1440,0,1442,G
3-PA,1104,0,2,1433,0,1435,G
3-PA,1105,1,0,1439,0,1440,G
3-PA,1106,0,1,0,1448,1449,C
3-PA,1107,0,1426,0,1,1427,T
3-PA,1108,4,1,0,1424,1429,C
3-PA,1109,1,1428,0,0,1429,T
3-PA,1110,0,1439,0,0,1439,T
3-PA,1111,3,3,1510,0,1516,G
3-PA,1112,2,1,1521,0,1524,G
3-PA,1113,1,1521,0,1,1523,T
3-PA,1114,1,0,1517,0,1518,G
3-PA,1115,1512,0,2,1,1515,A
3-PA,1116,1540,0,0,0,1540,A
3-PA,1117,1542,0,0,0,1542,A
3-PA,1118,1553,0,0,0,1553,A
3-PA,1119,0,0,1,1571,1572,C
3-PA,1120,1547,0,1,0,1548,A
3-PA,1121,0,1555,0,2,1557,T
3-PA,1122,1,2,1549,0,1552,G
3-PA,1123,1,0,1596,0,1597,G
3-PA,1124,0,1,0,1607,1608,C
3-PA,1125,1602,0,2,8,1612,A
3-PA,1126,0,0,0,1629,1629,C
3-PA,1127,3,0,0,1626,1629,C
3-PA,1128,1658,0,0,0,1658,A
3-PA,1129,1,3,1673,1,1678,G
3-PA,1130,1667,0,1,0,1668,A
3-PA,1131,6,0,1691,0,1697,G
3-PA,1132,1699,0,1,0,1700,A
3-PA,1133,1717,0,3,0,1720,A
3-PA,1134,0,3,1727,0,1730,G
3-PA,1135,0,2,1727,0,1729,G
3-PA,1136,0,1725,0,2,1727,T
3-PA,1137,1717,0,1,0,1718,A
3-PA,1138,0,2,1714,0,1716,G
3-PA,1139,1708,1,1,0,1710,A
3-PA,1140,1,1,0,1725,1727,C
3-PA,1141,0,1708,0,3,1711,T
3-PA,1142,0,1709,0,0,1709,T
3-PA,1143,0,1708,0,0,1708,T
3-PA,1144,0,1,1713,0,1714,G
3-PA,1145,1710,0,3,0,1713,A
3-PA,1146,1714,0,0,0,1714,A
3-PA,1147,1718,0,0,0,1718,A
3-PA,1148,1709,0,1,1,1711,A
3-PA,1149,0,0,0,1755,1755,C
3-PA,1150,1,1744,0,1,1746,T
3-PA,1151,1,0,1764,0,1765,G
3-PA,1152,0,1,0,1767,1768,C
3-PA,1153,1765,1,1,0,1767,A
3-PA,1154,0,1,1773,0,1774,G
3-PA,1155,1768,1,1,1,1771,A
3-PA,1156,0,1,1893,0,1894,G
3-PA,1157,1905,0,2,0,1907,A
3-PA,1158,0,0,0,1901,1901,C
3-PA,1159,1903,0,0,0,1903,A
3-PA,1160,0,1894,0,1,1895,T
3-PA,1161,1894,0,1,0,1895,A
3-PA,1162,1891,0,3,0,1894,A
3-PA,1163,0,1,1892,0,1893,G
3-PA,1164,1,2,0,1892,1895,C
3-PA,1165,0,2,1874,0,1876,G
3-PA,1166,1932,1,1,0,1934,A
3-PA,1167,0,1919,0,2,1921,T
3-PA,1168,1,1926,0,0,1927,T
3-PA,1169,0,1928,0,0,1928,T
3-PA,1170,0,2,1930,0,1932,G
3-PA,1171,1935,0,1,0,1936,A
3-PA,1172,1935,0,1,0,1936,A
3-PA,1173,1,1,1950,0,1952,G
3-PA,1174,0,0,0,2022,2022,C
3-PA,1175,1998,0,1,0,1999,A
3-PA,1176,2190,0,3,1,2194,A
3-PA,1177,0,2194,0,0,2194,T
3-PA,1178,2198,0,1,0,2199,A
3-PA,1179,0,2205,0,0,2205,T
3-PA,1180,2,3,2217,0,2222,G
3-PA,1181,2247,2,3,0,2252,A
3-PA,1182,0,2250,0,0,2250,T
3-PA,1183,2200,0,1,0,2201,A
3-PA,1184,1,1,2249,0,2251,G
3-PA,1185,0,2198,0,1,2199,T
3-PA,1186,0,2,2204,0,2206,G
3-PA,1187,2203,0,4,0,2207,A
3-PA,1188,42,2,0,2160,2204,C
3-PA,1189,0,3,2196,0,2199,G
3-PA,1190,2208,1,0,0,2209,A
3-PA,1191,2212,1,3,0,2216,A
3-PA,1192,1,1,0,2237,2239,C
3-PA,1193,2,2,0,2227,2231,C
3-PA,1194,0,2223,0,1,2224,T
3-PA,1195,2,5,2301,1,2309,G
3-PA,1196,2303,0,3,0,2306,A
3-PA,1197,2317,0,2,0,2319,A
3-PA,1198,0,2313,0,1,2314,T
3-PA,1199,0,2299,0,2,2301,T
3-PA,1200,2299,0,3,1,2303,A
3-PA,1201,2279,0,3,0,2282,A
3-PA,1202,0,3,2283,0,2286,G
3-PA,1203,0,0,2283,0,2283,G
3-PA,1204,0,2249,0,0,2249,T
3-PA,1205,4,0,0,2248,2252,C
3-PA,1206,2258,0,0,0,2258,A
3-PA,1207,0,0,0,2351,2351,C
3-PA,1208,2,2347,0,1,2350,T
3-PA,1209,0,2354,1,1,2356,T
3-PA,1210,1,2357,1,2,2361,T
3-PA,1211,2,0,0,2351,2353,C
3-PA,1212,2350,0,1,1,2352,A
3-PA,1213,2349,1,2,0,2352,A
3-PA,1214,0,0,2391,0,2391,G
3-PA,1215,1,0,0,2391,2392,C
3-PA,1216,0,2349,0,0,2349,T
3-PA,1217,1,7,2403,0,2411,G
3-PA,1218,0,2,2420,0,2422,G
3-PA,1219,2452,0,2,0,2454,A
3-PA,1220,1,2471,0,0,2472,T
3-PA,1221,2472,0,2,0,2474,A
3-PA,1222,0,0,0,2493,2493,C
3-PA,1223,2459,1,1,0,2461,A
3-PA,1224,0,0,2494,0,2494,G
3-PA,1225,2487,1,2,1,2491,A
3-PA,1226,2465,0,3,0,2468,A
3-PA,1227,0,2445,0,0,2445,T
3-PA,1228,0,3,2468,0,2471,G
3-PA,1229,2453,1,5,1,2460,A
3-PA,1230,0,0,2528,0,2528,G
3-PA,1231,0,2505,0,2,2507,T
3-PA,1232,1,2500,0,1,2502,T
3-PA,1233,6,0,0,2533,2539,C
3-PA,1234,2566,0,0,0,2566,A
3-PA,1235,2566,0,2,0,2568,A
3-PA,1236,1,0,0,2568,2569,C
3-PA,1237,2545,0,1,0,2546,A
3-PA,1238,2546,1,4,0,2551,A
3-PA,1239,1,2,2554,0,2557,G
3-PA,1240,1,0,2570,0,2571,G
3-PA,1241,0,1,0,2590,2591,C
3-PA,1242,1,0,1,2580,2582,C
3-PA,1243,1,2562,0,6,2569,T
3-PA,1244,1,0,2591,0,2592,G
3-PA,1245,2,2586,0,3,2591,T
3-PA,1246,0,5,2604,0,2609,G
3-PA,1247,2610,0,2,1,2613,A
3-PA,1248,4,0,2604,0,2608,G
3-PA,1249,0,0,0,2604,2604,C
3-PA,1250,0,2591,0,2,2593,T
3-PA,1251,2652,1,1,0,2654,A
3-PA,1252,2652,2,3,0,2657,A
3-PA,1253,0,0,0,2670,2670,C
3-PA,1254,1,2657,0,1,2659,T
3-PA,1255,4,4,2666,0,2674,G
3-PA,1256,2676,0,1,0,2677,A
3-PA,1257,0,2670,0,2,2672,T
3-PA,1258,0,2668,0,2,2670,T
3-PA,1259,4,1,0,2673,2678,C
3-PA,1260,2721,0,1,0,2722,A
3-PA,1261,0,2,2787,0,2789,G
3-PA,1262,0,2782,0,7,2789,T
3-PA,1263,3,0,0,2785,2788,C
3-PA,1264,0,2774,0,4,2778,T
3-PA,1265,2,1,2861,0,2864,G
3-PA,1266,1,2,2873,0,2876,G
3-PA,1267,2871,0,6,0,2877,A
3-PA,1268,1,2871,0,2,2874,T
3-PA,1269,2796,0,2,0,2798,A
3-PA,1270,1,7,2787,0,2795,G
3-PA,1271,2769,0,2,0,2771,A
3-PA,1272,0,1,2783,0,2784,G
3-PA,1273,0,1,0,2781,2782,C
3-PA,1274,1,2757,0,1,2759,T
3-PA,1275,3,0,0,2764,2767,C
3-PA,1276,6,1,2775,0,2782,G
3-PA,1277,2781,1,1,0,2783,A
3-PA,1278,0,2784,0,3,2787,T
3-PA,1279,0,3,2789,0,2792,G
3-PA,1280,2833,0,2,0,2835,A
3-PA,1281,2832,0,0,0,2832,A
3-PA,1282,2837,0,1,0,2838,A
3-PA,1283,0,2834,1,1,2836,T
3-PA,1284,0,2833,0,0,2833,T
3-PA,1285,1,0,2861,1,2863,G
3-PA,1286,4,5,2841,1,2851,G
3-PA,1287,2843,0,3,0,2846,A
3-PA,1288,1,1,2858,0,2860,G
3-PA,1289,2824,0,3,0,2827,A
3-PA,1290,0,5,2852,0,2857,G
3-PA,1291,1,4,2869,1,2875,G
3-PA,1292,2892,0,3,0,2895,A
3-PA,1293,0,0,0,2900,2900,C
3-PA,1294,0,0,2887,0,2887,G
3-PA,1295,1,2885,0,1,2887,T
3-PA,1296,2897,0,1,0,2898,A
3-PA,1297,1,0,2931,0,2932,G
3-PA,1298,1,0,1,2953,2955,C
3-PA,1299,6,4,1,2915,2926,C
3-PA,1300,4,3,1,2918,2926,C
3-PA,1301,5,0,0,2930,2935,C
3-PA,1302,2941,0,0,0,2941,A
3-PA,1303,3027,0,2,0,3029,A
3-PA,1304,1,3020,0,1,3022,T
3-PA,1305,0,3026,0,3,3029,T
3-PA,1306,1,9,3012,0,3022,G
3-PA,1307,2985,0,2,0,2987,A
3-PA,1308,1,1,2989,0,2991,G
3-PA,1309,0,1,0,2992,2993,C
3-PA,1310,2975,1,2,0,2978,A
3-PA,1311,1,1,0,3027,3029,C
3-PA,1312,2966,0,1,0,2967,A
3-PA,1313,1,3030,0,3,3034,T
3-PA,1314,1,3026,1,3,3031,T
3-PA,1315,2,0,3033,0,3035,G
3-PA,1316,1,2,0,3024,3027,C
3-PA,1317,3018,0,2,0,3020,A
3-PA,1318,3012,0,5,0,3017,A
3-PA,1319,0,0,3022,0,3022,G
3-PA,1320,0,2,0,3008,3010,C
3-PA,1321,3013,0,2,0,3015,A
3-PA,1322,1,2971,0,2,2974,T
3-PA,1323,2,5,2973,0,2980,G
3-PA,1324,2970,0,3,0,2973,A
3-PA,1325,2,2,2982,1,2987,G
3-PA,1326,2974,0,5,0,2979,A
3-PA,1327,2986,1,1,0,2988,A
3-PA,1328,1,1,2995,0,2997,G
3-PA,1329,1,3,3017,1,3022,G
3-PA,1330,3025,0,0,0,3025,A
3-PA,1331,3026,0,0,0,3026,A
3-PA,1332,0,3025,1,1,3027,T
3-PA,1333,0,3032,0,0,3032,T
3-PA,1334,3081,0,0,0,3081,A
3-PA,1335,1,3087,0,1,3089,T
3-PA,1336,0,3077,0,2,3079,T
3-PA,1337,1,3085,0,1,3087,T
3-PA,1338,2,0,0,3066,3068,C
3-PA,1339,3053,2,2,1,3058,A
3-PA,1340,0,1,0,3123,3124,C
3-PA,1341,3106,0,3,1,3110,A
3-PA,1342,1,1,3140,0,3142,G
3-PA,1343,0,3,0,3133,3136,C
3-PA,1344,3120,0,3,1,3124,A
3-PA,1345,0,1,3146,0,3147,G
3-PA,1346,3133,0,1,1,3135,A
3-PA,1347,2,3,3153,0,3158,G
3-PA,1348,1,1,3166,0,3168,G
3-PA,1349,0,3131,0,3,3134,T
3-PA,1350,1,1,3177,0,3179,G
3-PA,1351,0,3160,1,4,3165,T
3-PA,1352,7,2,0,3146,3155,C
3-PA,1353,2,2,0,3188,3192,C
3-PA,1354,4,0,1,3196,3201,C
3-PA,1355,3220,0,2,0,3222,A
3-PA,1356,0,3248,0,4,3252,T
3-PA,1357,0,3246,0,0,3246,T
3-PA,1358,1,0,3266,0,3267,G
3-PA,1359,0,3232,0,1,3233,T
3-PA,1360,3207,0,1,0,3208,A
3-PA,1361,1,0,3207,0,3208,G
3-PA,1362,3144,0,3,0,3147,A
3-PA,1363,1,0,3150,0,3151,G
3-PA,1364,1,1,0,3124,3126,C
3-PA,1365,1,1,0,3100,3102,C
3-PA,1366,3152,2,2,0,3156,A
3-PA,1367,0,2,0,3159,3161,C
3-PA,1368,2,3148,0,3,3153,T
3-PA,1369,0,0,3148,0,3148,G
3-PA,1370,3143,0,2,0,3145,A
3-PA,1371,3111,0,1,0,3112,A
3-PA,1372,0,3175,1,1,3177,T
3-PA,1373,3210,0,0,0,3210,A
3-PA,1374,1,2,1,3242,3246,C
3-PA,1375,3199,2,2,0,3203,A
3-PA,1376,1,3218,0,0,3219,T
3-PA,1377,3205,0,2,0,3207,A
3-PA,1378,3245,1,1,0,3247,A
3-PA,1379,1,3242,0,3,3246,T
3-PA,1380,2,2,3208,0,3212,G
3-PA,1381,3204,0,1,0,3205,A
3-PA,1382,3179,0,1,1,3181,A
3-PA,1383,2,3,3196,0,3201,G
3-PA,1384,2,9,3204,0,3215,G
3-PA,1385,2,3,3260,0,3265,G
3-PA,1386,2,3,3257,0,3262,G
3-PA,1387,2,0,3302,0,3304,G
3-PA,1388,0,3249,1,4,3254,T
3-PA,1389,3261,0,7,0,3268,A
3-PA,1390,1,3269,1,0,3271,T
3-PA,1391,3325,0,0,0,3325,A
3-PA,1392,1,0,0,3633,3634,C
3-PA,1393,3549,0,1,0,3550,A
3-PA,1394,0,3477,0,3,3480,T
3-PA,1395,1,3444,0,1,3446,T
3-PA,1396,3442,0,0,0,3442,A
3-PA,1397,3492,1,2,0,3495,A
3-PA,1398,0,0,0,3493,3493,C
3-PA,1399,3459,0,2,0,3461,A
3-PA,1400,3,0,0,3473,3476,C
3-PA,1401,0,3160,0,4,3164,T
3-PA,1402,1,1,3253,0,3255,G
3-PA,1403,1,2,0,3251,3254,C
3-PA,1404,4,2,0,3232,3238,C
3-PA,1405,5,0,0,3247,3252,C
3-PA,1406,0,3176,1,2,3179,T
3-PA,1407,0,0,3283,0,3283,G
3-PA,1408,3,2,0,3285,3290,C
3-PA,1409,0,3278,0,0,3278,T
3-PA,1410,5,1,0,3358,3364,C
3-PA,1411,3300,1,0,1,3302,A
3-PA,1412,3329,0,2,0,3331,A
3-PA,1413,0,3333,0,0,3333,T
3-PA,1414,2,0,3330,1,3333,G
3-PA,1415,1,2,1,3330,3334,C
3-PA,1416,3285,0,0,0,3285,A
3-PA,1417,2,3271,0,8,3281,T
3-PA,1418,3,0,0,3271,3274,C
3-PA,1419,4,0,0,3303,3307,C
3-PA,1420,0,3228,0,1,3229,T
3-PA,1421,1,0,3286,1,3288,G
3-PA,1422,1,3273,0,2,3276,T
3-PA,1423,8,0,3266,0,3274,G
3-PA,1424,1,5,1,3258,3265,C
3-PA,1425,3249,0,1,0,3250,A
3-PA,1426,1,2,3277,0,3280,G
3-PA,1427,1,1,0,3266,3268,C
3-PA,1428,3239,1,1,0,3241,A
3-PA,1429,3238,0,1,0,3239,A
3-PA,1430,0,3168,0,4,3172,T
3-PA,1431,1,4,3174,0,3179,G
3-PA,1432,1,2,3174,0,3177,G
3-PA,1433,3179,1,6,0,3186,A
3-PA,1434,0,1,0,3176,3177,C
3-PA,1435,0,4,3153,0,3157,G
3-PA,1436,3202,0,1,0,3203,A
3-PA,1437,0,3201,1,0,3202,T
3-PA,1438,0,3197,0,2,3199,T
3-PA,1439,0,3194,0,3,3197,T
3-PA,1440,0,3198,0,1,3199,T
3-PA,1441,2,0,0,3195,3197,C
3-PA,1442,3196,1,5,0,3202,A
3-PA,1443,3208,1,2,0,3211,A
3-PA,1444,0,1,0,3204,3205,C
3-PA,1445,1,3154,0,2,3157,T
3-PA,1446,3158,0,0,0,3158,A
3-PA,1447,3155,0,2,0,3157,A
3-PA,1448,0,3155,0,0,3155,T
3-PA,1449,0,3148,0,1,3149,T
3-PA,1450,1,1,0,3157,3159,C
3-PA,1451,1,2,0,3151,3154,C
3-PA,1452,3,2,0,3150,3155,C
3-PA,1453,3150,0,2,1,3153,A
3-PA,1454,1,3180,0,6,3187,T
3-PA,1455,0,2,3189,0,3191,G
3-PA,1456,3192,0,2,0,3194,A
3-PA,1457,0,3184,0,1,3185,T
3-PA,1458,3178,0,0,0,3178,A
3-PA,1459,3188,0,2,0,3190,A
3-PA,1460,1,1,3192,0,3194,G
3-PA,1461,0,0,0,3195,3195,C
3-PA,1462,3183,0,2,0,3185,A
3-PA,1463,3123,1,5,0,3129,A
3-PA,1464,1,0,3180,0,3181,G
3-PA,1465,0,3167,1,1,3169,T
3-PA,1466,1,0,3162,0,3163,G
3-PA,1467,2,1,0,3152,3155,C
3-PA,1468,3132,1,3,0,3136,A
3-PA,1469,1,2,3188,0,3191,G
3-PA,1470,3180,0,2,0,3182,A
3-PA,1471,3214,0,1,0,3215,A
3-PA,1472,1,2,0,3222,3225,C
3-PA,1473,0,3161,0,2,3163,T
3-PA,1474,3209,0,1,0,3210,A
3-PA,1475,3209,1,2,1,3213,A
3-PA,1476,3207,1,4,0,3212,A
3-PA,1477,0,0,3216,0,3216,G
3-PA,1478,3123,1,2,0,3126,A
3-PA,1479,146,3,2984,0,3133,G
3-PA,1480,0,5,3066,0,3071,G
3-PA,1481,0,1,3073,0,3074,G
3-PA,1482,3060,1,1,1,3063,A
3-PA,1483,2988,0,4,0,2992,A
3-PA,1484,0,1,2989,1,2991,G
3-PA,1485,0,1,2996,0,2997,G
3-PA,1486,0,1,0,2991,2992,C
3-PA,1487,0,2,2989,1,2992,G
3-PA,1488,2978,0,2,0,2980,A
3-PA,1489,2984,0,1,0,2985,A
3-PA,1490,2982,1,1,1,2985,A
3-PA,1491,2993,0,1,0,2994,A
3-PA,1492,2987,1,4,0,2992,A
3-PA,1493,3,0,0,2983,2986,C
3-PA,1494,6,0,0,2981,2987,C
3-PA,1495,2992,0,4,0,2996,A
3-PA,1496,3037,0,0,0,3037,A
3-PA,1497,0,3030,1,0,3031,T
3-PA,1498,0,3022,1,1,3024,T
3-PA,1499,0,3027,0,1,3028,T
3-PA,1500,3042,0,0,0,3042,A
3-PA,1501,2,3032,0,2,3036,T
3-PA,1502,3022,1,10,0,3033,A
3-PA,1503,0,3028,0,3,3031,T
3-PA,1504,1,4,2997,1,3003,G
3-PA,1505,0,3,2975,0,2978,G
3-PA,1506,2976,0,2,0,2978,A
3-PA,1507,0,2974,1,2,2977,T
3-PA,1508,0,2950,2,2,2954,T
3-PA,1509,1,1,0,2957,2959,C
3-PA,1510,2958,0,5,1,2964,A
3-PA,1511,2,2974,0,3,2979,T
3-PA,1512,0,1,1,2980,2982,C
3-PA,1513,2980,0,1,0,2981,A
3-PA,1514,0,2963,1,1,2965,T
3-PA,1515,2956,0,1,0,2957,A
3-PA,1516,2945,0,2,1,2948,A
3-PA,1517,2953,0,4,1,2958,A
3-PA,1518,0,7,2951,0,2958,G
3-PA,1519,0,1,2933,0,2934,G
3-PA,1520,1,3,2911,2,2917,G
3-PA,1521,2914,0,2,0,2916,A
3-PA,1522,2900,0,4,0,2904,A
3-PA,1523,1,4,2909,0,2914,G
3-PA,1524,2905,0,3,0,2908,A
3-PA,1525,1,2897,0,2,2900,T
3-PA,1526,3,0,0,2896,2899,C
3-PA,1527,1,2858,0,4,2863,T
3-PA,1528,3,2,0,2934,2939,C
3-PA,1529,2927,0,1,1,2929,A
3-PA,1530,0,2919,0,0,2919,T
3-PA,1531,0,2919,0,1,2920,T
3-PA,1532,0,2899,0,0,2899,T
3-PA,1533,2894,0,0,0,2894,A
3-PA,1534,2898,0,1,0,2899,A
3-PA,1535,1,4,2902,0,2907,G
3-PA,1536,1,2,2922,1,2926,G
3-PA,1537,2819,0,1,1,2821,A
3-PA,1538,2817,2,2,0,2821,A
3-PA,1539,1,2813,0,2,2816,T
3-PA,1540,0,2,2836,0,2838,G
3-PA,1541,2861,0,2,1,2864,A
3-PA,1542,0,0,0,2855,2855,C
3-PA,1543,2861,0,3,0,2864,A
3-PA,1544,0,1,0,2858,2859,C
3-PA,1545,2788,0,5,0,2793,A
3-PA,1546,0,1,2823,0,2824,G
3-PA,1547,2811,0,3,1,2815,A
3-PA,1548,1,1,0,2821,2823,C
3-PA,1549,1,1,2780,0,2782,G
3-PA,1550,0,2718,0,1,2719,T
3-PA,1551,2705,1,2,0,2708,A
3-PA,1552,0,1,2750,0,2751,G
3-PA,1553,0,2756,0,0,2756,T
3-PA,1554,2752,0,0,0,2752,A
3-PA,1555,2707,0,1,0,2708,A
3-PA,1556,2716,0,0,0,2716,A
3-PA,1557,3,2693,0,1,2697,T
3-PA,1558,1,2651,0,0,2652,T
3-PA,1559,0,2644,0,1,2645,T
3-PA,1560,2,2637,1,0,2640,T
3-PA,1561,1,0,2642,0,2643,G
3-PA,1562,2,2604,1,0,2607,T
3-PA,1563,0,5,2595,0,2600,G
3-PA,1564,2595,0,3,0,2598,A
3-PA,1565,0,0,2609,0,2609,G
3-PA,1566,0,1,0,2593,2594,C
3-PA,1567,2600,1,2,0,2603,A
3-PA,1568,0,2598,0,4,2602,T
3-PA,1569,0,1,2600,0,2601,G
3-PA,1570,0,0,2616,1,2617,G
3-PA,1571,2619,0,3,0,2622,A
3-PA,1572,0,0,2627,0,2627,G
3-PA,1573,0,2610,0,4,2614,T
3-PA,1574,0,2582,0,3,2585,T
3-PA,1575,1,2589,1,2,2593,T
3-PA,1576,0,2584,0,2,2586,T
3-PA,1577,2,0,1,2595,2598,C
3-PA,1578,1,2586,0,1,2588,T
3-PA,1579,0,0,0,2594,2594,C
3-PA,1580,0,2547,0,2,2549,T
3-PA,1581,4,1,0,2549,2554,C
3-PA,1582,2556,0,0,0,2556,A
3-PA,1583,0,0,0,2556,2556,C
3-PA,1584,0,2531,0,4,2535,T
3-PA,1585,2,6,2541,0,2549,G
3-PA,1586,2547,0,4,0,2551,A
3-PA,1587,3,0,0,2637,2640,C
3-PA,1588,4,1,0,2612,2617,C
3-PA,1589,2,2,0,2602,2606,C
3-PA,1590,1,2593,1,6,2601,T
3-PA,1591,2597,0,1,0,2598,A
3-PA,1592,0,4,2609,0,2613,G
3-PA,1593,2611,1,2,0,2614,A
3-PA,1594,0,1,0,2604,2605,C
3-PA,1595,0,2522,0,4,2526,T
3-PA,1596,0,2276,0,2,2278,T
3-PA,1597,1,4,2269,0,2274,G
3-PA,1598,2261,0,7,0,2268,A
3-PA,1599,1,0,2282,0,2283,G
3-PA,1600,1,0,0,2270,2271,C
3-PA,1601,3,2,1,2218,2224,C
3-PA,1602,2256,2,4,1,2263,A
3-PA,1603,0,1,0,2264,2265,C
3-PA,1604,2269,0,0,0,2269,A
3-PA,1605,0,2264,0,1,2265,T
3-PA,1606,2253,3,2,0,2258,A
3-PA,1607,2245,0,1,1,2247,A
3-PA,1608,2244,2,0,0,2246,A
3-PA,1609,0,2248,0,0,2248,T
3-PA,1610,1,4,2239,1,2245,G
3-PA,1611,0,3,2181,0,2184,G
3-PA,1612,0,2,2199,0,2201,G
3-PA,1613,2181,0,4,1,2186,A
3-PA,1614,0,2,2196,0,2198,G
3-PA,1615,2192,0,1,0,2193,A
3-PA,1616,2185,0,2,2,2189,A
3-PA,1617,2202,1,1,1,2205,A
3-PA,1618,0,2206,1,0,2207,T
3-PA,1619,2206,0,1,0,2207,A
3-PA,1620,0,0,1,2204,2205,C
3-PA,1621,0,1847,0,0,1847,T
3-PA,1622,0,1,1847,0,1848,G
3-PA,1623,0,1739,0,1,1740,T
3-PA,1624,0,0,1790,0,1790,G
3-PA,1625,1,1771,2,1,1775,T
3-PA,1626,1,0,0,1730,1731,C
3-PA,1627,1,0,0,1721,1722,C
3-PA,1628,1,1715,0,2,1718,T
3-PA,1629,0,1727,1,0,1728,T
3-PA,1630,0,1,1725,0,1726,G
3-PA,1631,1727,0,4,1,1732,A
3-PA,1632,0,0,1755,0,1755,G
3-PA,1633,1670,2,1,0,1673,A
3-PA,1634,0,1669,0,2,1671,T
3-PA,1635,1644,0,3,0,1647,A
3-PA,1636,0,1,1688,0,1689,G
3-PA,1637,0,2,1701,0,1703,G
3-PA,1638,1686,1,5,1,1693,A
3-PA,1639,0,0,1696,0,1696,G
3-PA,1640,1684,0,1,0,1685,A
3-PA,1641,1,1669,0,2,1672,T
3-PA,1642,1682,0,1,1,1684,A
3-PA,1643,1,1671,0,2,1674,T
3-PA,1644,2,0,1685,0,1687,G
3-PA,1645,2,1662,0,2,1666,T
3-PA,1646,0,1654,0,1,1655,T
3-PA,1647,1685,0,0,0,1685,A
3-PA,1648,2,1,0,1678,1681,C
3-PA,1649,0,1656,1,0,1657,T
3-PA,1650,1652,1,1,0,1654,A
3-PA,1651,1639,0,3,0,1642,A
3-PA,1652,1,0,1648,1,1650,G
3-PA,1653,1643,0,0,0,1643,A
3-PA,1654,1616,1,0,0,1617,A
3-PA,1655,0,1,1588,0,1589,G
3-PA,1656,0,1592,0,3,1595,T
3-PA,1657,1,0,1619,0,1620,G
3-PA,1658,1,0,0,1615,1616,C
3-PA,1659,1,0,0,1619,1620,C
3-PA,1660,1617,0,1,0,1618,A
3-PA,1661,1,1606,0,1,1608,T
3-PA,1662,1606,0,0,0,1606,A
3-PA,1663,0,0,1604,1,1605,G
3-PA,1664,3,0,1596,0,1599,G
3-PA,1665,0,1,0,1591,1592,C
3-PA,1666,1,2,0,1580,1583,C
3-PA,1667,1592,0,0,0,1592,A
3-PA,1668,1591,0,1,0,1592,A
3-PA,1669,1590,0,0,0,1590,A
3-PA,1670,0,1604,0,1,1605,T
3-PA,1671,0,1603,0,1,1604,T
3-PA,1672,1,1603,0,0,1604,T
3-PA,1673,1,0,0,1599,1600,C
3-PA,1674,1573,0,0,0,1573,A
3-PA,1675,1572,1,5,1,1579,A
3-PA,1676,0,0,1589,0,1589,G
3-PA,1677,0,1,1601,0,1602,G
3-PA,1678,0,1,0,1593,1594,C
3-PA,1679,1,0,0,1578,1579,C
3-PA,1680,1588,0,0,0,1588,A
3-PA,1681,1617,1,1,0,1619,A
3-PA,1682,0,1626,0,0,1626,T
3-PA,1683,0,1,1690,0,1691,G
3-PA,1684,1,1689,0,1,1691,T
3-PA,1685,1,1743,0,1,1745,T
3-PA,1686,1,1,0,1770,1772,C
3-PA,1687,0,1750,0,0,1750,T
3-PA,1688,0,1744,0,0,1744,T
3-PA,1689,1640,0,2,0,1642,A
3-PA,1690,0,1651,0,1,1652,T
3-PA,1691,1659,0,0,0,1659,A
3-PA,1692,1,1673,0,0,1674,T
3-PA,1693,1,0,1675,0,1676,G
3-PA,1694,1,1593,0,3,1597,T
3-PA,1695,0,1,1595,0,1596,G
3-PA,1696,1589,0,0,0,1589,A
3-PA,1697,1,0,1596,0,1597,G
3-PA,1698,0,1,1601,0,1602,G
3-PA,1699,1600,1,1,0,1602,A
3-PA,1700,0,1,0,1599,1600,C
3-PA,1701,1591,0,1,0,1592,A
3-PA,1702,1588,0,4,0,1592,A
3-PA,1703,1597,0,0,0,1597,A
3-PA,1704,1,1,0,1593,1595,C
3-PA,1705,0,2,1592,0,1594,G
3-PA,1706,1,0,1609,0,1610,G
3-PA,1707,1594,0,2,0,1596,A
3-PA,1708,1601,0,1,0,1602,A
3-PA,1709,1,0,0,1613,1614,C
3-PA,1710,1609,0,0,1,1610,A
3-PA,1711,0,1615,0,2,1617,T
3-PA,1712,0,0,0,1612,1612,C
3-PA,1713,1608,0,4,0,1612,A
3-PA,1714,1612,0,1,0,1613,A
3-PA,1715,1588,0,4,0,1592,A
3-PA,1716,0,1,1607,0,1608,G
3-PA,1717,0,0,1617,0,1617,G
3-PA,1718,0,1593,0,0,1593,T
3-PA,1719,3,0,0,1585,1588,C
3-PA,1720,1585,1,0,0,1586,A
3-PA,1721,1598,0,1,0,1599,A
3-PA,1722,1596,0,1,0,1597,A
3-PA,1723,1601,0,0,0,1601,A
3-PA,1724,0,1604,0,0,1604,T
3-PA,1725,1,1,1606,0,1608,G
3-PA,1726,1601,0,0,0,1601,A
3-PA,1727,1595,0,1,1,1597,A
3-PA,1728,1599,0,1,0,1600,A
3-PA,1729,0,1602,0,0,1602,T
3-PA,1730,0,1,1615,0,1616,G
3-PA,1731,0,2,1615,0,1617,G
3-PA,1732,0,2,1611,0,1613,G
3-PA,1733,1,1,1622,0,1624,G
3-PA,1734,1611,0,0,0,1611,A
3-PA,1735,1616,0,1,2,1619,A
3-PA,1736,0,1616,0,0,1616,T
3-PA,1737,0,2,1626,0,1628,G
3-PA,1738,2,1,1635,0,1638,G
3-PA,1739,1614,0,4,0,1618,A
3-PA,1740,0,1,1628,0,1629,G
3-PA,1741,1615,1,3,0,1619,A
3-PA,1742,0,1595,0,3,1598,T
3-PA,1743,0,0,1602,0,1602,G
3-PA,1744,1587,0,2,0,1589,A
3-PA,1745,0,2,1596,0,1598,G
3-PA,1746,1593,0,0,0,1593,A
3-PA,1747,1,0,0,1584,1585,C
3-PA,1748,1,0,1583,0,1584,G
3-PA,1749,0,1573,0,1,1574,T
3-PA,1750,0,1574,0,1,1575,T
3-PA,1751,0,0,1577,0,1577,G
3-PA,1752,1,2,0,1571,1574,C
3-PA,1753,2,2,0,1579,1583,C
3-PA,1754,0,1571,1,1,1573,T
3-PA,1755,0,0,0,1604,1604,C
3-PA,1756,2,0,0,1602,1604,C
3-PA,1757,0,1604,0,3,1607,T
3-PA,1758,1,1607,0,0,1608,T
3-PA,1759,0,0,0,1613,1613,C
3-PA,1760,1603,1,1,1,1606,A
3-PA,1761,0,0,1603,0,1603,G
3-PA,1762,0,1599,0,4,1603,T
3-PA,1763,3,0,0,1596,1599,C
3-PA,1764,1576,0,0,0,1576,A
3-PA,1765,1,0,0,1614,1615,C
3-PA,1766,0,1617,0,1,1618,T
3-PA,1767,2,0,0,1619,1621,C
3-PA,1768,1,1,0,1621,1623,C
3-PA,1769,1624,0,3,0,1627,A
3-PA,1770,0,1,1627,0,1628,G
3-PA,1771,0,0,2,1630,1632,C
3-PA,1772,1626,0,0,0,1626,A
3-PA,1773,0,0,1640,0,1640,G
3-PA,1774,1585,0,2,0,1587,A
3-PA,1775,0,1591,0,0,1591,T
3-PA,1776,2,1,0,1585,1588,C
3-PA,1777,1,2,1586,0,1589,G
3-PA,1778,1584,1,0,0,1585,A
3-PA,1779,0,2,1590,0,1592,G
3-PA,1780,1580,0,3,0,1583,A
3-PA,1781,1,0,1590,0,1591,G
3-PA,1782,1,0,0,1577,1578,C
3-PA,1783,1576,0,1,1,1578,A
3-PA,1784,0,1581,0,0,1581,T
3-PA,1785,1,1,1599,0,1601,G
3-PA,1786,1605,0,0,0,1605,A
3-PA,1787,0,1604,0,1,1605,T
3-PA,1788,2,1595,0,1,1598,T
3-PA,1789,0,0,1595,1,1596,G
3-PA,1790,1585,0,1,0,1586,A
3-PA,1791,1591,0,0,0,1591,A
3-PA,1792,0,1,1595,0,1596,G
3-PA,1793,0,1,0,1590,1591,C
3-PA,1794,0,0,0,1566,1566,C
3-PA,1795,0,1,1559,0,1560,G
3-PA,1796,1558,0,1,0,1559,A
3-PA,1797,0,0,1565,0,1565,G
3-PA,1798,0,1556,0,2,1558,T
3-PA,1799,2,0,0,1561,1563,C
3-PA,1800,1,0,0,1554,1555,C
3-PA,1801,0,1556,0,2,1558,T
3-PA,1802,0,1,0,1576,1577,C
3-PA,1803,1,2,1578,0,1581,G
3-PA,1804,0,1,1631,0,1632,G
3-PA,1805,0,1626,0,0,1626,T
3-PA,1806,0,1613,0,1,1614,T
3-PA,1807,1614,0,1,0,1615,A
3-PA,1808,1611,1,2,0,1614,A
3-PA,1809,1613,0,1,1,1615,A
3-PA,1810,0,0,1645,0,1645,G
3-PA,1811,1621,0,3,0,1624,A
3-PA,1812,0,1,1627,0,1628,G
3-PA,1813,1577,1,3,0,1581,A
3-PA,1814,1583,0,1,0,1584,A
3-PA,1815,1586,0,4,0,1590,A
3-PA,1816,0,0,1602,0,1602,G
3-PA,1817,1593,1,1,0,1595,A
3-PA,1818,1,0,0,1596,1597,C
3-PA,1819,1567,0,2,0,1569,A
3-PA,1820,0,1564,0,0,1564,T
3-PA,1821,0,4,1560,0,1564,G
3-PA,1822,1576,0,2,0,1578,A
3-PA,1823,0,0,0,1579,1579,C
3-PA,1824,0,0,0,1573,1573,C
3-PA,1825,1555,0,2,0,1557,A
3-PA,1826,1555,0,0,0,1555,A
3-PA,1827,1547,1,4,0,1552,A
3-PA,1828,0,1,1568,0,1569,G
3-PA,1829,1560,0,0,0,1560,A
3-PA,1830,0,0,1572,0,1572,G
3-PA,1831,0,1545,0,2,1547,T
3-PA,1832,0,1541,0,0,1541,T
3-PA,1833,1,1534,0,1,1536,T
3-PA,1834,0,1541,0,2,1543,T
3-PA,1835,0,1543,0,1,1544,T
3-PA,1836,2,1544,0,0,1546,T
3-PA,1837,0,0,1546,1,1547,G
3-PA,1838,1529,2,0,1,1532,A
3-PA,1839,1,2,1549,0,1552,G
3-PA,1840,1543,0,0,0,1543,A
3-PA,1841,1543,0,0,0,1543,A
3-PA,1842,0,1542,0,2,1544,T
3-PA,1843,1542,1,1,0,1544,A
3-PA,1844,1561,0,1,2,1564,A
3-PA,1845,1575,0,1,0,1576,A
3-PA,1846,0,1580,0,0,1580,T
3-PA,1847,0,1,0,1583,1584,C
3-PA,1848,1558,1,2,0,1561,A
3-PA,1849,0,0,1563,0,1563,G
3-PA,1850,1564,1,0,0,1565,A
3-PA,1851,1574,0,2,0,1576,A
3-PA,1852,0,0,1594,0,1594,G
3-PA,1853,1,0,0,1570,1571,C
3-PA,1854,1560,0,0,0,1560,A
3-PA,1855,0,1549,0,3,1552,T
3-PA,1856,1,2,1554,0,1557,G
3-PA,1857,1,1,1567,0,1569,G
3-PA,1858,0,1,0,1559,1560,C
3-PA,1859,0,0,1,1599,1600,C
3-PA,1860,3,1,0,1594,1598,C
3-PA,1861,1602,0,1,1,1604,A
3-PA,1862,0,1600,1,1,1602,T
3-PA,1863,0,1604,0,1,1605,T
3-PA,1864,0,5,1600,0,1605,G
3-PA,1865,0,4,1592,0,1596,G
3-PA,1866,1,2,1576,0,1579,G
3-PA,1867,1,5,1573,0,1579,G
3-PA,1868,1515,0,2,0,1517,A
3-PA,1869,3,0,1525,0,1528,G
3-PA,1870,0,1514,0,1,1515,T
3-PA,1871,5,0,0,1532,1537,C
3-PA,1872,2,0,0,1581,1583,C
3-PA,1873,3,1,0,1574,1578,C
3-PA,1874,2,0,0,1575,1577,C
3-PA,1875,3,3,0,1572,1578,C
3-PA,1876,1576,0,3,0,1579,A
3-PA,1877,1579,0,2,0,1581,A
3-PA,1878,0,1,1582,0,1583,G
3-PA,1879,1,0,1562,1,1564,G
3-PA,1880,1,2,1578,0,1581,G
3-PA,1881,1438,0,0,0,1438,A
3-PA,1882,0,0,1447,0,1447,G
3-PA,1883,0,1439,0,0,1439,T
3-PA,1884,0,0,1445,0,1445,G
3-PA,1885,2,0,1450,0,1452,G
3-PA,1886,1453,0,0,0,1453,A
3-PA,1887,1445,0,2,0,1447,A
3-PA,1888,0,2,1445,0,1447,G
3-PA,1889,1433,0,1,0,1434,A
3-PA,1890,1436,1,0,0,1437,A
3-PA,1891,0,0,1430,0,1430,G
3-PA,1892,0,0,1431,0,1431,G
3-PA,1893,1,1421,0,1,1423,T
3-PA,1894,0,1408,0,0,1408,T
3-PA,1895,3,0,0,1418,1421,C
3-PA,1896,2,2,0,1420,1424,C
3-PA,1897,1423,0,0,0,1423,A
3-PA,1898,0,1427,0,1,1428,T
3-PA,1899,0,1420,0,1,1421,T
3-PA,1900,0,2,1427,0,1429,G
3-PA,1901,0,1,1428,0,1429,G
3-PA,1902,0,2,1425,0,1427,G
3-PA,1903,1426,0,1,0,1427,A
3-PA,1904,1416,0,2,1,1419,A
3-PA,1905,1427,0,0,0,1427,A
3-PA,1906,0,0,1460,0,1460,G
3-PA,1907,0,1446,1,0,1447,T
3-PA,1908,5,1,0,1469,1475,C
3-PA,1909,0,1460,0,0,1460,T
3-PA,1910,1,0,1473,0,1474,G
3-PA,1911,0,1470,0,1,1471,T
3-PA,1912,1468,2,1,0,1471,A
3-PA,1913,0,2,1473,0,1475,G
3-PA,1914,0,1,1456,0,1457,G
3-PA,1915,1405,1,4,0,1410,A
3-PA,1916,0,0,0,1411,1411,C
3-PA,1917,0,1385,0,3,1388,T
3-PA,1918,0,1,0,1470,1471,C
3-PA,1919,0,1464,0,0,1464,T
3-PA,1920,1462,0,0,1,1463,A
3-PA,1921,0,1459,0,3,1462,T
3-PA,1922,0,1450,0,0,1450,T
3-PA,1923,0,2,1467,0,1469,G
3-PA,1924,1,1,1458,1,1461,G
3-PA,1925,0,0,1,1457,1458,C
3-PA,1926,0,1453,0,1,1454,T
3-PA,1927,1354,0,2,0,1356,A
3-PA,1928,1367,0,0,0,1367,A
3-PA,1929,0,0,1374,0,1374,G
3-PA,1930,0,1373,0,0,1373,T
3-PA,1931,2,1,0,1374,1377,C
3-PA,1932,1342,0,2,0,1344,A
3-PA,1933,1,1,1393,0,1395,G
3-PA,1934,0,1392,0,0,1392,T
3-PA,1935,1424,0,1,0,1425,A
3-PA,1936,1,1430,0,0,1431,T
3-PA,1937,0,1437,0,0,1437,T
3-PA,1938,1,1,0,1438,1440,C
3-PA,1939,1434,0,1,0,1435,A
3-PA,1940,1429,0,0,1,1430,A
3-PA,1941,0,1434,0,1,1435,T
3-PA,1942,1370,0,0,0,1370,A
3-PA,1943,2,0,1379,0,1381,G
3-PA,1944,0,1,0,1359,1360,C
3-PA,1945,1,0,0,1362,1363,C
3-PA,1946,0,1321,0,1,1322,T
3-PA,1947,1,0,1352,0,1353,G
3-PA,1948,0,1350,0,1,1351,T
3-PA,1949,1358,0,1,0,1359,A
3-PA,1950,0,1356,0,2,1358,T
3-PA,1951,2,0,1336,0,1338,G
3-PA,1952,0,3,0,1331,1334,C
3-PA,1953,1294,0,2,0,1296,A
3-PA,1954,0,1290,0,2,1292,T
3-PA,1955,2,0,0,1290,1292,C
3-PA,1956,1255,0,0,0,1255,A
3-PA,1957,0,0,0,1263,1263,C
3-PA,1958,2,1,0,1259,1262,C
3-PA,1959,1263,0,0,0,1263,A
3-PA,1960,0,0,0,1277,1277,C
3-PA,1961,1253,0,1,0,1254,A
3-PA,1962,1260,0,0,0,1260,A
3-PA,1963,0,1257,0,0,1257,T
3-PA,1964,0,1260,0,0,1260,T
3-PA,1965,0,0,1257,0,1257,G
3-PA,1966,0,0,1248,0,1248,G
3-PA,1967,1240,1,3,0,1244,A
3-PA,1968,1244,0,3,0,1247,A
3-PA,1969,0,0,1241,1,1242,G
3-PA,1970,0,1,1243,0,1244,G
3-PA,1971,1237,0,2,0,1239,A
3-PA,1972,0,1237,0,1,1238,T
3-PA,1973,0,1238,0,2,1240,T
3-PA,1974,0,1242,0,0,1242,T
3-PA,1975,1,1240,0,0,1241,T
3-PA,1976,0,0,0,1239,1239,C
3-PA,1977,1239,0,2,0,1241,A
3-PA,1978,0,1,1239,0,1240,G
3-PA,1979,0,1,0,1231,1232,C
3-PA,1980,0,0,1228,0,1228,G
3-PA,1981,0,1,1226,0,1227,G
3-PA,1982,1222,0,0,0,1222,A
3-PA,1983,0,0,1230,0,1230,G
3-PA,1984,0,1227,0,0,1227,T
3-PA,1985,2,0,0,1243,1245,C
3-PA,1986,1244,0,2,0,1246,A
3-PA,1987,1244,0,2,0,1246,A
3-PA,1988,0,0,1249,0,1249,G
3-PA,1989,1245,0,0,0,1245,A
3-PA,1990,1239,0,1,0,1240,A
3-PA,1991,1239,0,2,0,1241,A
3-PA,1992,1217,0,2,0,1219,A
3-PA,1993,0,0,0,1225,1225,C
3-PA,1994,0,1198,0,0,1198,T
3-PA,1995,1,0,1201,0,1202,G
3-PA,1996,0,0,0,1199,1199,C
3-PA,1997,1,1197,0,0,1198,T
3-PA,1998,1,0,0,1200,1201,C
3-PA,1999,1,1,0,1194,1196,C
3-PA,2000,0,1197,0,1,1198,T
3-PA,2001,0,1200,0,1,1201,T
3-PA,2002,1,1,1197,0,1199,G
3-PA,2003,1,1198,0,1,1200,T
3-PA,2004,0,1181,0,0,1181,T
3-PA,2005,1,2,1183,0,1186,G
3-PA,2006,1,1178,0,1,1180,T
3-PA,2007,0,1169,0,0,1169,T
3-PA,2008,0,0,0,1172,1172,C
3-PA,2009,1151,0,0,0,1151,A
3-PA,2010,0,2,1157,0,1159,G
3-PA,2011,0,1,1153,0,1154,G
3-PA,2012,2,0,0,1157,1159,C
3-PA,2013,0,1154,0,1,1155,T
3-PA,2014,1,0,0,1167,1168,C
3-PA,2015,0,1153,0,3,1156,T
3-PA,2016,0,1158,0,1,1159,T
3-PA,2017,1161,0,1,0,1162,A
3-PA,2018,0,1,1158,0,1159,G
3-PA,2019,2,0,1138,1,1141,G
3-PA,2020,0,3,1140,0,1143,G
3-PA,2021,1112,0,1,0,1113,A
3-PA,2022,0,0,1,1111,1112,C
3-PA,2023,1057,0,2,0,1059,A
3-PA,2024,1072,0,1,0,1073,A
3-PA,2025,1,0,0,1076,1077,C
3-PA,2026,0,0,0,1079,1079,C
3-PA,2027,0,1078,0,0,1078,T
3-PA,2028,1,0,1,1067,1069,C
3-PA,2029,1,1,1072,0,1074,G
3-PA,2030,1075,0,1,0,1076,A
3-PA,2031,1075,0,1,0,1076,A
3-PA,2032,0,0,0,1082,1082,C
3-PA,2033,0,0,0,1053,1053,C
3-PA,2034,0,1033,0,2,1035,T
3-PA,2035,1,2,1030,0,1033,G
3-PA,2036,2,1,1031,0,1034,G
3-PA,2037,1,0,1029,0,1030,G
3-PA,2038,1035,0,0,0,1035,A
3-PA,2039,1,0,0,1036,1037,C
3-PA,2040,1,1,0,1036,1038,C
3-PA,2041,0,1011,0,2,1013,T
3-PA,2042,0,1011,0,2,1013,T
3-PA,2043,1,1013,0,0,1014,T
3-PA,2044,0,0,1015,1,1016,G
3-PA,2045,1021,0,0,0,1021,A
3-PA,2046,0,1019,0,0,1019,T
3-PA,2047,0,1,0,1019,1020,C
3-PA,2048,0,998,0,0,998,T
3-PA,2049,1,994,0,0,995,T
3-PA,2050,0,2,992,0,994,G
3-PA,2051,1,1,985,0,987,G
3-PA,2052,0,1,987,0,988,G
3-PA,2053,0,2,988,0,990,G
3-PA,2054,0,0,975,1,976,G
3-PA,2055,1,0,974,0,975,G
3-PA,2056,0,0,0,972,972,C
3-PA,2057,0,967,0,2,969,T
3-PA,2058,987,0,1,0,988,A
3-PA,2059,0,987,0,0,987,T
3-PA,2060,986,0,1,0,987,A
3-PA,2061,0,986,0,0,986,T
3-PA,2062,1,1,941,1,944,G
3-PA,2063,940,0,0,0,940,A
3-PA,2064,927,1,2,0,930,A
3-PA,2065,0,0,930,0,930,G
3-PA,2066,0,0,0,939,939,C
3-PA,2067,878,0,0,0,878,A
3-PA,2068,896,0,0,0,896,A
3-PA,2069,0,897,0,0,897,T
3-PA,2070,1,893,0,0,894,T
3-PA,2071,0,0,896,0,896,G
3-PA,2072,888,0,2,0,890,A
3-PA,2073,0,0,893,0,893,G
3-PA,2074,0,1,887,0,888,G
3-PA,2075,846,0,1,0,847,A
3-PA,2076,0,0,849,0,849,G
3-PA,2077,0,794,0,0,794,T
3-PA,2078,0,0,794,0,794,G
3-PA,2079,1,1,0,788,790,C
3-PA,2080,1,1,0,789,791,C
3-PA,2081,0,790,0,0,790,T
3-PA,2082,0,1,788,0,789,G
3-PA,2083,788,0,0,0,788,A
3-PA,2084,0,791,0,0,791,T
3-PA,2085,0,752,0,0,752,T
3-PA,2086,746,0,0,0,746,A
3-PA,2087,743,0,1,0,744,A
3-PA,2088,0,741,0,0,741,T
3-PA,2089,0,0,740,0,740,G
3-PA,2090,731,0,0,0,731,A
3-PA,2091,0,709,0,1,710,T
3-PA,2092,0,1,0,710,711,C
3-PA,2093,3,0,0,703,706,C
3-PA,2094,1,0,0,704,705,C
3-PA,2095,0,695,0,3,698,T
3-PA,2096,0,1,697,0,698,G
3-PA,2097,0,0,697,0,697,G
3-PA,2098,0,0,697,0,697,G
3-PA,2099,0,691,0,1,692,T
3-PA,2100,0,666,0,0,666,T
3-PA,2101,1,663,0,2,666,T
3-PA,2102,0,660,1,0,661,T
3-PA,2103,0,0,663,0,663,G
3-PA,2104,0,0,0,665,665,C
3-PA,2105,0,658,0,1,659,T
3-PA,2106,1,0,0,657,658,C
3-PA,2107,628,0,1,0,629,A
3-PA,2108,630,0,0,0,630,A
3-PA,2109,0,631,0,0,631,T
3-PA,2110,0,0,630,0,630,G
3-PA,2111,1,0,0,626,627,C
3-PA,2112,1,0,611,0,612,G
3-PA,2113,0,608,1,0,609,T
3-PA,2114,1,1,0,606,608,C
3-PA,2115,0,606,1,0,607,T
3-PA,2116,0,603,2,1,606,T
3-PA,2117,0,2,599,0,601,G
3-PA,2118,0,0,606,0,606,G
3-PA,2119,0,601,0,0,601,T
3-PA,2120,1,593,1,1,596,T
3-PA,2121,1,0,0,583,584,C
3-PA,2122,579,0,0,0,579,A
3-PA,2123,579,0,1,0,580,A
3-PA,2124,0,0,0,578,578,C
3-PA,2125,0,574,0,0,574,T
3-PA,2126,2,0,1,570,573,C
3-PA,2127,0,0,0,544,544,C
3-PA,2128,1,537,1,2,541,T
3-PA,2129,0,538,0,1,539,T
3-PA,2130,1,0,0,536,537,C
3-PA,2131,0,0,0,541,541,C
3-PA,2132,0,530,0,1,531,T
3-PA,2133,0,3,525,0,528,G
3-PA,2134,527,0,0,0,527,A
3-PA,2135,0,0,0,520,520,C
3-PA,2136,500,0,0,0,500,A
3-PA,2137,0,0,0,483,483,C
3-PA,2138,473,0,2,0,475,A
3-PA,2139,0,473,0,0,473,T
3-PA,2140,0,1,472,0,473,G
3-PA,2141,0,0,0,474,474,C
3-PA,2142,466,0,1,0,467,A
3-PA,2143,0,463,0,0,463,T
3-PA,2144,0,456,0,0,456,T
3-PA,2145,451,0,0,0,451,A
3-PA,2146,447,0,0,0,447,A
3-PA,2147,447,0,0,0,447,A
3-PA,2148,443,0,1,0,444,A
3-PA,2149,0,434,0,0,434,T
3-PA,2150,338,0,0,0,338,A
3-PA,2151,0,0,338,0,338,G
4-HA,1,414,0,0,0,414,A
4-HA,2,0,416,0,0,416,T
4-HA,3,0,0,422,0,422,G
4-HA,4,427,0,0,0,427,A
4-HA,5,432,0,0,0,432,A
4-HA,6,0,1,470,0,471,G
4-HA,7,469,0,1,0,470,A
4-HA,8,0,0,0,513,513,C
4-HA,9,0,517,0,0,517,T
4-HA,10,531,0,0,0,531,A
4-HA,11,0,550,0,0,550,T
4-HA,12,1,0,0,553,554,C
4-HA,13,557,0,0,0,557,A
4-HA,14,0,558,0,0,558,T
4-HA,15,0,557,0,0,557,T
4-HA,16,0,1,592,0,593,G
4-HA,17,0,0,0,596,596,C
4-HA,18,0,598,0,1,599,T
4-HA,19,0,599,0,0,599,T
4-HA,20,0,599,0,0,599,T
4-HA,21,1,1,646,0,648,G
4-HA,22,648,0,0,1,649,A
4-HA,23,0,0,673,0,673,G
4-HA,24,0,0,1,676,677,C
4-HA,25,0,676,1,0,677,T
4-HA,26,721,1,1,1,724,A
4-HA,27,0,0,0,734,734,C
4-HA,28,742,0,0,0,742,A
4-HA,29,0,775,1,0,776,T
4-HA,30,0,775,0,0,775,T
4-HA,31,1,0,0,783,784,C
4-HA,32,1,782,1,0,784,T
4-HA,33,800,0,1,0,801,A
4-HA,34,0,803,0,1,804,T
4-HA,35,0,0,805,0,805,G
4-HA,36,0,802,0,1,803,T
4-HA,37,0,1,0,802,803,C
4-HA,38,0,798,0,0,798,T
4-HA,39,0,1,803,0,804,G
4-HA,40,2,2,806,0,810,G
4-HA,41,0,806,0,0,806,T
4-HA,42,0,807,0,0,807,T
4-HA,43,1,807,0,1,809,T
4-HA,44,0,809,0,0,809,T
4-HA,45,0,1,1,808,810,C
4-HA,46,3,0,806,0,809,G
4-HA,47,0,0,0,829,829,C
4-HA,48,0,825,0,1,826,T
4-HA,49,1,1,0,837,839,C
4-HA,50,837,0,1,1,839,A
4-HA,51,840,0,0,1,841,A
4-HA,52,841,0,0,0,841,A
4-HA,53,840,0,1,0,841,A
4-HA,54,843,0,0,1,844,A
4-HA,55,0,0,0,847,847,C
4-HA,56,1,840,0,0,841,T
4-HA,57,0,849,0,0,849,T
4-HA,58,1,0,0,848,849,C
4-HA,59,1,0,0,848,849,C
4-HA,60,0,848,0,1,849,T
4-HA,61,0,1,855,0,856,G
4-HA,62,2,1,856,0,859,G
4-HA,63,858,0,0,0,858,A
4-HA,64,871,0,0,0,871,A
4-HA,65,867,0,0,0,867,A
4-HA,66,0,881,0,0,881,T
4-HA,67,0,0,885,0,885,G
4-HA,68,886,0,0,0,886,A
4-HA,69,0,0,0,893,893,C
4-HA,70,890,0,0,0,890,A
4-HA,71,892,0,1,0,893,A
4-HA,72,1,0,0,912,913,C
4-HA,73,913,0,0,0,913,A
4-HA,74,0,0,915,0,915,G
4-HA,75,1,0,0,914,915,C
4-HA,76,913,0,0,0,913,A
4-HA,77,0,0,0,927,927,C
4-HA,78,0,3,922,0,925,G
4-HA,79,1,0,939,0,940,G
4-HA,80,0,0,0,943,943,C
4-HA,81,937,0,0,0,937,A
4-HA,82,948,0,0,0,948,A
4-HA,83,0,1,0,960,961,C
4-HA,84,1,0,973,0,974,G
4-HA,85,0,0,0,977,977,C
4-HA,86,0,968,0,1,969,T
4-HA,87,0,0,980,0,980,G
4-HA,88,0,977,0,2,979,T
4-HA,89,1,0,1015,0,1016,G
4-HA,90,1,1,0,1029,1031,C
4-HA,91,1,0,0,1056,1057,C
4-HA,92,0,1046,0,1,1047,T
4-HA,93,0,1046,0,2,1048,T
4-HA,94,0,1,1048,0,1049,G
4-HA,95,0,2,1056,1,1059,G
4-HA,96,0,0,1074,0,1074,G
4-HA,97,0,1,0,1077,1078,C
4-HA,98,1061,0,0,0,1061,A
4-HA,99,0,0,0,1086,1086,C
4-HA,100,3,1,0,1077,1081,C
4-HA,101,1164,0,0,0,1164,A
4-HA,102,0,1161,0,2,1163,T
4-HA,103,1,1,1163,0,1165,G
4-HA,104,0,0,0,1168,1168,C
4-HA,105,1162,0,3,0,1165,A
4-HA,106,1,2,1264,0,1267,G
4-HA,107,0,1264,0,2,1266,T
4-HA,108,1285,0,0,0,1285,A
4-HA,109,1,1,0,1282,1284,C
4-HA,110,3,2,0,1255,1260,C
4-HA,111,1264,0,1,0,1265,A
4-HA,112,1262,0,0,0,1262,A
4-HA,113,1263,0,4,0,1267,A
4-HA,114,0,1,1,1275,1277,C
4-HA,115,0,2,1259,0,1261,G
4-HA,116,1,0,1283,0,1284,G
4-HA,117,1281,0,0,0,1281,A
4-HA,118,1277,2,4,0,1283,A
4-HA,119,0,3,0,1284,1287,C
4-HA,120,0,1,1282,0,1283,G
4-HA,121,1294,0,2,0,1296,A
4-HA,122,0,1299,0,1,1300,T
4-HA,123,1310,0,2,0,1312,A
4-HA,124,0,0,1312,0,1312,G
4-HA,125,0,1300,0,3,1303,T
4-HA,126,0,1,1303,0,1304,G
4-HA,127,1304,0,0,0,1304,A
4-HA,128,1302,0,1,0,1303,A
4-HA,129,1300,0,1,0,1301,A
4-HA,130,1302,0,0,0,1302,A
4-HA,131,0,0,0,1313,1313,C
4-HA,132,1309,0,0,0,1309,A
4-HA,133,1313,0,1,0,1314,A
4-HA,134,0,1312,0,0,1312,T
4-HA,135,1,0,0,1311,1312,C
4-HA,136,1313,0,1,0,1314,A
4-HA,137,1,1,0,1312,1314,C
4-HA,138,0,3,1312,0,1315,G
4-HA,139,1312,0,0,0,1312,A
4-HA,140,1304,0,1,0,1305,A
4-HA,141,0,1312,0,0,1312,T
4-HA,142,0,2,1315,0,1317,G
4-HA,143,1329,0,0,0,1329,A
4-HA,144,1,0,0,1327,1328,C
4-HA,145,1,0,0,1325,1326,C
4-HA,146,1348,0,0,0,1348,A
4-HA,147,1355,1,0,0,1356,A
4-HA,148,1353,1,0,0,1354,A
4-HA,149,0,1354,0,0,1354,T
4-HA,150,0,1353,0,0,1353,T
4-HA,151,1,0,1364,0,1365,G
4-HA,152,1365,0,1,0,1366,A
4-HA,153,1362,1,2,0,1365,A
4-HA,154,0,0,1377,0,1377,G
4-HA,155,0,1378,0,0,1378,T
4-HA,156,0,1408,0,0,1408,T
4-HA,157,1411,1,0,0,1412,A
4-HA,158,0,1,0,1421,1422,C
4-HA,159,0,1422,0,1,1423,T
4-HA,160,1421,0,1,0,1422,A
4-HA,161,1442,0,0,0,1442,A
4-HA,162,0,1441,0,2,1443,T
4-HA,163,0,0,1444,1,1445,G
4-HA,164,0,0,0,1492,1492,C
4-HA,165,0,1475,1,1,1477,T
4-HA,166,1477,0,1,0,1478,A
4-HA,167,0,0,0,1479,1479,C
4-HA,168,0,1475,0,1,1476,T
4-HA,169,0,1,1484,0,1485,G
4-HA,170,1475,0,1,0,1476,A
4-HA,171,0,0,1486,0,1486,G
4-HA,172,0,1,0,1485,1486,C
4-HA,173,0,1477,0,0,1477,T
4-HA,174,0,1,1516,1,1518,G
4-HA,175,0,1,1546,1,1548,G
4-HA,176,0,1555,0,0,1555,T
4-HA,177,0,1554,0,0,1554,T
4-HA,178,3,0,0,1551,1554,C
4-HA,179,1549,1,0,0,1550,A
4-HA,180,0,3,1554,0,1557,G
4-HA,181,1556,0,1,1,1558,A
4-HA,182,0,0,1584,0,1584,G
4-HA,183,1,1560,0,5,1566,T
4-HA,184,0,1565,0,2,1567,T
4-HA,185,1,0,0,1570,1571,C
4-HA,186,1,1,1,1575,1578,C
4-HA,187,1,1567,0,3,1571,T
4-HA,188,1,0,0,1577,1578,C
4-HA,189,1576,0,1,0,1577,A
4-HA,190,1575,0,0,0,1575,A
4-HA,191,0,3,0,1578,1581,C
4-HA,192,1547,0,0,0,1547,A
4-HA,193,1,2,1575,0,1578,G
4-HA,194,0,1,1575,0,1576,G
4-HA,195,1,1574,0,1,1576,T
4-HA,196,0,0,1572,1,1573,G
4-HA,197,1571,0,9,0,1580,A
4-HA,198,1579,1,2,0,1582,A
4-HA,199,1631,0,0,0,1631,A
4-HA,200,0,1629,0,0,1629,T
4-HA,201,1639,0,0,0,1639,A
4-HA,202,0,1624,0,2,1626,T
4-HA,203,0,0,1625,0,1625,G
4-HA,204,0,0,0,1634,1634,C
4-HA,205,2,1,1631,0,1634,G
4-HA,206,1628,0,2,0,1630,A
4-HA,207,1,0,0,1629,1630,C
4-HA,208,1603,0,1,0,1604,A
4-HA,209,0,0,1677,0,1677,G
4-HA,210,0,1676,0,0,1676,T
4-HA,211,2,1,0,1692,1695,C
4-HA,212,1,0,0,1691,1692,C
4-HA,213,0,1687,0,4,1691,T
4-HA,214,0,0,0,1714,1714,C
4-HA,215,1711,0,1,0,1712,A
4-HA,216,0,1711,0,1,1712,T
4-HA,217,2,0,0,1717,1719,C
4-HA,218,1654,0,2,0,1656,A
4-HA,219,0,0,1662,0,1662,G
4-HA,220,1654,0,0,0,1654,A
4-HA,221,0,1650,0,1,1651,T
4-HA,222,3,0,0,1649,1652,C
4-HA,223,3,1,0,1636,1640,C
4-HA,224,0,1636,0,0,1636,T
4-HA,225,0,1637,1,0,1638,T
4-HA,226,0,0,1636,0,1636,G
4-HA,227,1635,0,1,0,1636,A
4-HA,228,0,1632,0,0,1632,T
4-HA,229,2,2,1639,0,1643,G
4-HA,230,0,0,1636,0,1636,G
4-HA,231,1635,0,0,0,1635,A
4-HA,232,1632,0,0,0,1632,A
4-HA,233,1643,0,0,0,1643,A
4-HA,234,1653,0,1,0,1654,A
4-HA,235,1648,1,0,0,1649,A
4-HA,236,1659,0,1,1,1661,A
4-HA,237,0,0,0,1665,1665,C
4-HA,238,0,1656,0,0,1656,T
4-HA,239,0,0,1661,0,1661,G
4-HA,240,0,0,0,1658,1658,C
4-HA,241,1657,0,2,1,1660,A
4-HA,242,0,0,0,1710,1710,C
4-HA,243,1703,0,0,0,1703,A
4-HA,244,0,0,0,1939,1939,C
4-HA,245,0,1931,0,3,1934,T
4-HA,246,1975,0,1,0,1976,A
4-HA,247,1974,0,2,0,1976,A
4-HA,248,0,1980,0,0,1980,T
4-HA,249,1975,0,2,0,1977,A
4-HA,250,0,2,1977,0,1979,G
4-HA,251,1945,1,2,1,1949,A
4-HA,252,0,1924,0,0,1924,T
4-HA,253,2,1,1830,0,1833,G
4-HA,254,1,1,0,1835,1837,C
4-HA,255,0,1813,0,2,1815,T
4-HA,256,3,0,0,1937,1940,C
4-HA,257,0,1935,0,1,1936,T
4-HA,258,1970,0,0,0,1970,A
4-HA,259,0,1967,1,0,1968,T
4-HA,260,0,1956,0,0,1956,T
4-HA,261,0,2,1973,0,1975,G
4-HA,262,0,2,1964,0,1966,G
4-HA,263,1,1,1968,1,1971,G
4-HA,264,1952,0,5,0,1957,A
4-HA,265,0,2,1928,0,1930,G
4-HA,266,1896,2,1,0,1899,A
4-HA,267,0,0,0,2045,2045,C
4-HA,268,2,1,0,2070,2073,C
4-HA,269,3,0,0,2077,2080,C
4-HA,270,0,2072,0,4,2076,T
4-HA,271,0,0,1,2122,2123,C
4-HA,272,2125,0,1,0,2126,A
4-HA,273,1,0,2236,0,2237,G
4-HA,274,0,2231,0,0,2231,T
4-HA,275,0,13,2236,0,2249,G
4-HA,276,0,2197,0,0,2197,T
4-HA,277,0,1,2189,1,2191,G
4-HA,278,2175,12,2,0,2189,A
4-HA,279,1,2184,0,1,2186,T
4-HA,280,1,4,2168,0,2173,G
4-HA,281,2,1,2168,0,2171,G
4-HA,282,0,0,0,2145,2145,C
4-HA,283,0,2147,0,2,2149,T
4-HA,284,0,2143,0,2,2145,T
4-HA,285,1,1,0,2143,2145,C
4-HA,286,0,3,1,2141,2145,C
4-HA,287,2149,0,1,0,2150,A
4-HA,288,2154,0,1,0,2155,A
4-HA,289,2152,0,0,0,2152,A
4-HA,290,2156,1,2,0,2159,A
4-HA,291,0,2163,0,0,2163,T
4-HA,292,2162,0,0,1,2163,A
4-HA,293,2160,0,3,0,2163,A
4-HA,294,0,1,2175,0,2176,G
4-HA,295,2181,1,2,0,2184,A
4-HA,296,2200,0,0,0,2200,A
4-HA,297,2200,0,1,0,2201,A
4-HA,298,0,2200,0,0,2200,T
4-HA,299,1,2,2194,0,2197,G
4-HA,300,0,3,2193,0,2196,G
4-HA,301,1,4,2188,1,2194,G
4-HA,302,2195,0,3,0,2198,A
4-HA,303,2,1,0,2204,2207,C
4-HA,304,5,1,1,2203,2210,C
4-HA,305,0,2231,0,2,2233,T
4-HA,306,0,2231,1,3,2235,T
4-HA,307,0,2234,0,0,2234,T
4-HA,308,0,2247,1,0,2248,T
4-HA,309,1,2246,0,1,2248,T
4-HA,310,1,0,2263,0,2264,G
4-HA,311,0,2264,0,1,2265,T
4-HA,312,0,2255,0,0,2255,T
4-HA,313,3,4,2247,0,2254,G
4-HA,314,2243,0,0,0,2243,A
4-HA,315,2243,0,2,0,2245,A
4-HA,316,0,0,0,2248,2248,C
4-HA,317,0,0,2239,0,2239,G
4-HA,318,0,0,0,2275,2275,C
4-HA,319,2270,0,1,0,2271,A
4-HA,320,1,0,2281,0,2282,G
4-HA,321,0,3,0,2284,2287,C
4-HA,322,2288,0,1,0,2289,A
4-HA,323,2282,0,1,0,2283,A
4-HA,324,2294,0,4,0,2298,A
4-HA,325,3,0,2394,0,2397,G
4-HA,326,0,1,0,2390,2391,C
4-HA,327,3,0,1,2377,2381,C
4-HA,328,1,2381,0,1,2383,T
4-HA,329,2382,1,4,0,2387,A
4-HA,330,1,1,0,2396,2398,C
4-HA,331,2393,0,3,0,2396,A
4-HA,332,0,0,2399,0,2399,G
4-HA,333,2,1,0,2385,2388,C
4-HA,334,2341,1,3,0,2345,A
4-HA,335,2360,0,0,0,2360,A
4-HA,336,0,0,0,2459,2459,C
4-HA,337,0,2448,0,4,2452,T
4-HA,338,0,0,2471,0,2471,G
4-HA,339,0,2456,0,1,2457,T
4-HA,340,0,2450,0,3,2453,T
4-HA,341,2455,0,0,0,2455,A
4-HA,342,1,0,0,2620,2621,C
4-HA,343,4,0,0,2618,2622,C
4-HA,344,4,0,0,2679,2683,C
4-HA,345,0,2612,0,1,2613,T
4-HA,346,0,2606,0,1,2607,T
4-HA,347,2618,0,0,0,2618,A
4-HA,348,0,2619,0,1,2620,T
4-HA,349,0,2,2616,0,2618,G
4-HA,350,2611,0,2,0,2613,A
4-HA,351,0,2490,0,0,2490,T
4-HA,352,0,0,2516,0,2516,G
4-HA,353,0,2454,0,2,2456,T
4-HA,354,2,1,2446,0,2449,G
4-HA,355,0,0,0,2458,2458,C
4-HA,356,0,1,1,2455,2457,C
4-HA,357,4,1,2508,0,2513,G
4-HA,358,0,1,2550,0,2551,G
4-HA,359,2551,1,1,0,2553,A
4-HA,360,0,2555,0,0,2555,T
4-HA,361,0,2529,1,0,2530,T
4-HA,362,2555,0,1,0,2556,A
4-HA,363,0,2546,0,0,2546,T
4-HA,364,1,3,2548,0,2552,G
4-HA,365,0,0,0,2546,2546,C
4-HA,366,1,1,0,2523,2525,C
4-HA,367,0,2546,0,3,2549,T
4-HA,368,1,0,0,2645,2646,C
4-HA,369,0,2,0,2669,2671,C
4-HA,370,3,1,0,2677,2681,C
4-HA,371,1,2663,0,3,2667,T
4-HA,372,0,2671,0,1,2672,T
4-HA,373,2665,2,1,0,2668,A
4-HA,374,1,1,2732,1,2735,G
4-HA,375,1,0,2736,0,2737,G
4-HA,376,0,2713,0,1,2714,T
4-HA,377,4,2,0,2663,2669,C
4-HA,378,2647,1,2,1,2651,A
4-HA,379,1,0,0,2706,2707,C
4-HA,380,0,2709,0,3,2712,T
4-HA,381,2710,0,2,0,2712,A
4-HA,382,0,0,2709,0,2709,G
4-HA,383,2,2682,0,1,2685,T
4-HA,384,1,2674,0,0,2675,T
4-HA,385,0,2,2692,0,2694,G
4-HA,386,1,1,0,2696,2698,C
4-HA,387,0,1,0,2703,2704,C
4-HA,388,0,2677,0,3,2680,T
4-HA,389,1,0,0,2691,2692,C
4-HA,390,2761,0,3,0,2764,A
4-HA,391,0,2762,0,1,2763,T
4-HA,392,3,0,0,2765,2768,C
4-HA,393,3,2,0,2761,2766,C
4-HA,394,0,3,2751,1,2755,G
4-HA,395,3,0,2768,0,2771,G
4-HA,396,0,1,0,2783,2784,C
4-HA,397,2799,0,1,1,2801,A
4-HA,398,0,0,0,2823,2823,C
4-HA,399,2784,0,2,0,2786,A
4-HA,400,3,0,0,2789,2792,C
4-HA,401,0,2791,0,2,2793,T
4-HA,402,2,4,2813,0,2819,G
4-HA,403,0,4,2832,0,2836,G
4-HA,404,2812,0,5,0,2817,A
4-HA,405,1,0,2847,0,2848,G
4-HA,406,0,2830,0,2,2832,T
4-HA,407,0,2818,0,0,2818,T
4-HA,408,1,2816,0,2,2819,T
4-HA,409,2800,0,6,0,2806,A
4-HA,410,2809,1,3,0,2813,A
4-HA,411,0,1,0,2826,2827,C
4-HA,412,2792,0,0,0,2792,A
4-HA,413,2788,0,2,0,2790,A
4-HA,414,4,2769,0,1,2774,T
4-HA,415,3,2,2761,0,2766,G
4-HA,416,2768,0,0,0,2768,A
4-HA,417,2766,1,0,0,2767,A
4-HA,418,2769,0,6,0,2775,A
4-HA,419,2,1,2791,0,2794,G
4-HA,420,1,1,0,2813,2815,C
4-HA,421,1,2796,1,4,2802,T
4-HA,422,0,2798,0,4,2802,T
4-HA,423,1,0,0,2833,2834,C
4-HA,424,2829,0,1,0,2830,A
4-HA,425,2842,1,1,0,2844,A
4-HA,426,0,2837,0,4,2841,T
4-HA,427,0,2838,0,1,2839,T
4-HA,428,1,1,2891,0,2893,G
4-HA,429,2,2,2881,0,2885,G
4-HA,430,2884,1,4,0,2889,A
4-HA,431,0,3,0,2888,2891,C
4-HA,432,1,2873,0,4,2878,T
4-HA,433,1,3,2880,0,2884,G
4-HA,434,0,3,2887,0,2890,G
4-HA,435,2887,0,3,0,2890,A
4-HA,436,0,0,2897,0,2897,G
4-HA,437,1,2850,0,2,2853,T
4-HA,438,4,0,0,2843,2847,C
4-HA,439,2870,0,3,0,2873,A
4-HA,440,0,0,0,2885,2885,C
4-HA,441,0,2872,0,6,2878,T
4-HA,442,0,0,0,2886,2886,C
4-HA,443,2866,1,1,1,2869,A
4-HA,444,2884,0,3,0,2887,A
4-HA,445,2886,0,1,1,2888,A
4-HA,446,2891,1,2,0,2894,A
4-HA,447,1,2,0,2893,2896,C
4-HA,448,1,6,2858,0,2865,G
4-HA,449,1,3,2897,0,2901,G
4-HA,450,2897,1,5,0,2903,A
4-HA,451,2895,0,3,0,2898,A
4-HA,452,0,4,0,2900,2904,C
4-HA,453,2882,2,3,0,2887,A
4-HA,454,2903,0,2,0,2905,A
4-HA,455,1,1,2924,1,2927,G
4-HA,456,2,1,1,2935,2939,C
4-HA,457,0,2911,0,2,2913,T
4-HA,458,3,1,1,2914,2919,C
4-HA,459,0,2910,1,3,2914,T
4-HA,460,0,3,2915,1,2919,G
4-HA,461,0,2,0,2914,2916,C
4-HA,462,0,2916,0,5,2921,T
4-HA,463,0,2957,0,0,2957,T
4-HA,464,1,1,2981,0,2983,G
4-HA,465,0,0,1,3007,3008,C
4-HA,466,3004,0,4,0,3008,A
4-HA,467,0,2995,0,1,2996,T
4-HA,468,2986,1,3,0,2990,A
4-HA,469,2977,0,2,0,2979,A
4-HA,470,1,1,2976,0,2978,G
4-HA,471,0,5,2970,1,2976,G
4-HA,472,2883,0,1,0,2884,A
4-HA,473,1,2,2882,0,2885,G
4-HA,474,2858,0,3,0,2861,A
4-HA,475,0,2932,0,0,2932,T
4-HA,476,2,0,0,2960,2962,C
4-HA,477,1,2950,1,3,2955,T
4-HA,478,2961,0,0,0,2961,A
4-HA,479,2954,1,0,0,2955,A
4-HA,480,2929,3,1,0,2933,A
4-HA,481,2929,0,1,0,2930,A
4-HA,482,2932,1,4,0,2937,A
4-HA,483,0,4,0,2959,2963,C
4-HA,484,2879,1,2,0,2882,A
4-HA,485,0,0,2886,0,2886,G
4-HA,486,1,2867,0,3,2871,T
4-HA,487,0,2922,0,0,2922,T
4-HA,488,1,2923,0,2,2926,T
4-HA,489,4,1,0,2984,2989,C
4-HA,490,0,2986,0,0,2986,T
4-HA,491,0,2997,0,1,2998,T
4-HA,492,0,2999,0,2,3001,T
4-HA,493,2983,0,8,0,2991,A
4-HA,494,0,0,2994,0,2994,G
4-HA,495,0,2985,0,2,2987,T
4-HA,496,2995,0,0,0,2995,A
4-HA,497,1,4,3002,0,3007,G
4-HA,498,2957,0,3,1,2961,A
4-HA,499,0,2951,0,3,2954,T
4-HA,500,0,2949,0,4,2953,T
4-HA,501,2,6,2999,0,3007,G
4-HA,502,3009,0,2,0,3011,A
4-HA,503,3002,1,3,0,3006,A
4-HA,504,1,3008,0,0,3009,T
4-HA,505,0,2971,0,0,2971,T
4-HA,506,2,4,2994,0,3000,G
4-HA,507,1,0,3002,1,3004,G
4-HA,508,0,2995,1,4,3000,T
4-HA,509,1,2993,0,6,3000,T
4-HA,510,4,5,2963,0,2972,G
4-HA,511,2972,0,4,0,2976,A
4-HA,512,0,1,0,2969,2970,C
4-HA,513,6,1,0,2955,2962,C
4-HA,514,6,2,0,2979,2987,C
4-HA,515,2986,1,1,0,2988,A
4-HA,516,0,1,0,3011,3012,C
4-HA,517,0,3001,1,5,3007,T
4-HA,518,2,3005,1,6,3014,T
4-HA,519,3016,0,0,0,3016,A
4-HA,520,2945,0,0,42,2987,A
4-HA,521,2984,1,1,1,2987,A
4-HA,522,0,0,0,2903,2903,C
4-HA,523,0,2990,2,1,2993,T
4-HA,524,0,2999,0,1,3000,T
4-HA,525,4,1,0,3013,3018,C
4-HA,526,3017,1,2,0,3020,A
4-HA,527,3020,0,1,0,3021,A
4-HA,528,3026,0,3,0,3029,A
4-HA,529,1,3025,0,1,3027,T
4-HA,530,3058,0,2,0,3060,A
4-HA,531,1,1,0,3055,3057,C
4-HA,532,5,2,0,2994,3001,C
4-HA,533,6,1,0,3000,3007,C
4-HA,534,2977,0,2,0,2979,A
4-HA,535,0,1,3093,0,3094,G
4-HA,536,3,0,0,3103,3106,C
4-HA,537,3096,1,1,0,3098,A
4-HA,538,0,3094,0,2,3096,T
4-HA,539,1,3063,0,3,3067,T
4-HA,540,1,3,3129,1,3134,G
4-HA,541,3136,0,2,1,3139,A
4-HA,542,3130,0,7,1,3138,A
4-HA,543,2,1,0,3134,3137,C
4-HA,544,1,0,3054,0,3055,G
4-HA,545,0,3089,0,1,3090,T
4-HA,546,0,5,3094,0,3099,G
4-HA,547,3087,0,6,0,3093,A
4-HA,548,0,0,0,3102,3102,C
4-HA,549,1,3011,0,4,3016,T
4-HA,550,3070,0,1,0,3071,A
4-HA,551,1,3059,0,3,3063,T
4-HA,552,0,2,3086,1,3089,G
4-HA,553,1,1,1,3078,3081,C
4-HA,554,3,0,0,3057,3060,C
4-HA,555,3051,0,2,0,3053,A
4-HA,556,3051,0,2,0,3053,A
4-HA,557,3092,0,3,1,3096,A
4-HA,558,0,0,0,3103,3103,C
4-HA,559,3045,1,2,0,3048,A
4-HA,560,3058,1,1,0,3060,A
4-HA,561,0,3028,0,0,3028,T
4-HA,562,0,4,3035,0,3039,G
4-HA,563,3033,1,5,0,3039,A
4-HA,564,3031,1,3,0,3035,A
4-HA,565,1,1,0,2988,2990,C
4-HA,566,3006,0,0,0,3006,A
4-HA,567,3024,1,2,0,3027,A
4-HA,568,0,3021,0,0,3021,T
4-HA,569,0,3026,0,2,3028,T
4-HA,570,1,3031,0,2,3034,T
4-HA,571,0,7,3023,1,3031,G
4-HA,572,3028,1,5,0,3034,A
4-HA,573,2,0,0,3027,3029,C
4-HA,574,3036,1,0,0,3037,A
4-HA,575,3028,3,2,0,3033,A
4-HA,576,3079,0,1,0,3080,A
4-HA,577,0,3085,0,0,3085,T
4-HA,578,0,3073,0,0,3073,T
4-HA,579,0,0,3088,0,3088,G
4-HA,580,0,3077,0,0,3077,T
4-HA,581,3085,1,1,0,3087,A
4-HA,582,1,2,0,3135,3138,C
4-HA,583,3139,0,0,1,3140,A
4-HA,584,1,3171,0,0,3172,T
4-HA,585,0,3136,0,1,3137,T
4-HA,586,1,3124,0,1,3126,T
4-HA,587,0,4,3098,0,3102,G
4-HA,588,1,2,3082,0,3085,G
4-HA,589,1,4,3091,0,3096,G
4-HA,590,1,6,3089,1,3097,G
4-HA,591,0,2,3057,0,3059,G
4-HA,592,2,3,3097,1,3103,G
4-HA,593,2,3057,0,5,3064,T
4-HA,594,0,3074,0,0,3074,T
4-HA,595,1,1,0,3074,3076,C
4-HA,596,3072,1,7,0,3080,A
4-HA,597,0,0,0,3094,3094,C
4-HA,598,5,1,0,3085,3091,C
4-HA,599,3089,0,3,0,3092,A
4-HA,600,0,0,0,3098,3098,C
4-HA,601,3,1,0,3054,3058,C
4-HA,602,4,2,0,3043,3049,C
4-HA,603,3,2,3037,1,3043,G
4-HA,604,1,5,3109,0,3115,G
4-HA,605,1,1,3118,0,3120,G
4-HA,606,0,3102,0,0,3102,T
4-HA,607,3109,1,0,0,3110,A
4-HA,608,0,1,0,3095,3096,C
4-HA,609,5,2,3065,0,3072,G
4-HA,610,2,4,3112,0,3118,G
4-HA,611,3124,1,1,0,3126,A
4-HA,612,0,0,0,3124,3124,C
4-HA,613,3047,0,1,0,3048,A
4-HA,614,3046,0,0,0,3046,A
4-HA,615,3035,2,2,2,3041,A
4-HA,616,1,7,3110,0,3118,G
4-HA,617,3115,1,2,0,3118,A
4-HA,618,0,1,0,3112,3113,C
4-HA,619,4,1,0,3066,3071,C
4-HA,620,3081,0,2,0,3083,A
4-HA,621,3083,0,0,1,3084,A
4-HA,622,3118,1,2,0,3121,A
4-HA,623,0,3108,1,0,3109,T
4-HA,624,4,2,0,3115,3121,C
4-HA,625,1,2977,0,3,2981,T
4-HA,626,0,2968,0,2,2970,T
4-HA,627,1,2,0,2992,2995,C
4-HA,628,1,2,0,2996,2999,C
4-HA,629,0,2984,0,1,2985,T
4-HA,630,1,2,2997,0,3000,G
4-HA,631,0,2948,1,0,2949,T
4-HA,632,2975,0,0,0,2975,A
4-HA,633,1,2958,0,2,2961,T
4-HA,634,5,0,2977,0,2982,G
4-HA,635,0,2,0,2984,2986,C
4-HA,636,0,2943,1,3,2947,T
4-HA,637,6,6,0,2941,2953,C
4-HA,638,2946,0,6,1,2953,A
4-HA,639,2953,0,4,0,2957,A
4-HA,640,0,0,2964,0,2964,G
4-HA,641,1,0,0,2974,2975,C
4-HA,642,2978,0,0,0,2978,A
4-HA,643,0,2961,0,1,2962,T
4-HA,644,2,1,0,2957,2960,C
4-HA,645,2949,0,3,0,2952,A
4-HA,646,0,4,2970,0,2974,G
4-HA,647,1,9,2962,0,2972,G
4-HA,648,2978,0,2,0,2980,A
4-HA,649,2957,0,4,0,2961,A
4-HA,650,0,2,3035,0,3037,G
4-HA,651,3029,0,2,0,3031,A
4-HA,652,3054,1,5,0,3060,A
4-HA,653,0,3078,0,2,3080,T
4-HA,654,4,6,0,3071,3081,C
4-HA,655,3051,0,3,1,3055,A
4-HA,656,0,2,1,3062,3065,C
4-HA,657,3047,1,7,0,3055,A
4-HA,658,1,0,3085,2,3088,G
4-HA,659,0,3022,1,4,3027,T
4-HA,660,3,0,0,3019,3022,C
4-HA,661,0,2986,1,3,2990,T
4-HA,662,5,1,1,3029,3036,C
4-HA,663,1,3030,0,5,3036,T
4-HA,664,3061,1,0,0,3062,A
4-HA,665,3,3,0,3048,3054,C
4-HA,666,3,1,0,3045,3049,C
4-HA,667,3022,0,2,0,3024,A
4-HA,668,3028,0,0,0,3028,A
4-HA,669,3011,2,0,1,3014,A
4-HA,670,3012,0,3,0,3015,A
4-HA,671,0,2,3034,0,3036,G
4-HA,672,2976,2,1,1,2980,A
4-HA,673,2964,0,1,0,2965,A
4-HA,674,2,2,2973,0,2977,G
4-HA,675,1,3,0,2976,2980,C
4-HA,676,3,1,1,2982,2987,C
4-HA,677,2991,0,2,0,2993,A
4-HA,678,2998,7,1,0,3006,A
4-HA,679,0,0,0,3003,3003,C
4-HA,680,3023,1,1,1,3026,A
4-HA,681,3016,0,4,7,3027,A
4-HA,682,3017,0,3,0,3020,A
4-HA,683,1,2,0,3055,3058,C
4-HA,684,0,3033,0,3,3036,T
4-HA,685,3,0,3041,0,3044,G
4-HA,686,1,3037,0,2,3040,T
4-HA,687,3029,0,0,0,3029,A
4-HA,688,1,1,2999,0,3001,G
4-HA,689,0,3015,0,3,3018,T
4-HA,690,2,1,0,3042,3045,C
4-HA,691,0,2,1,3049,3052,C
4-HA,692,5,4,0,2997,3006,C
4-HA,693,2,3,3014,0,3019,G
4-HA,694,3013,0,0,0,3013,A
4-HA,695,3022,0,0,0,3022,A
4-HA,696,0,3029,0,0,3029,T
4-HA,697,3024,1,0,0,3025,A
4-HA,698,1,3018,1,0,3020,T
4-HA,699,2,3,0,2990,2995,C
4-HA,700,1,0,2987,0,2988,G
4-HA,701,3,1,3060,0,3064,G
4-HA,702,3064,1,2,0,3067,A
4-HA,703,0,3084,0,2,3086,T
4-HA,704,5,1,0,3075,3081,C
4-HA,705,1,3083,0,0,3084,T
4-HA,706,3078,1,4,0,3083,A
4-HA,707,0,6,3091,0,3097,G
4-HA,708,3115,1,1,0,3117,A
4-HA,709,3,1,0,3109,3113,C
4-HA,710,2,1,0,3015,3018,C
4-HA,711,4,0,0,3030,3034,C
4-HA,712,3023,0,2,0,3025,A
4-HA,713,1,1,3181,0,3183,G
4-HA,714,3182,0,3,0,3185,A
4-HA,715,2,0,3217,1,3220,G
4-HA,716,0,3198,0,2,3200,T
4-HA,717,3177,0,2,0,3179,A
4-HA,718,3175,0,4,0,3179,A
4-HA,719,1,3,3234,0,3238,G
4-HA,720,1,2,3261,1,3265,G
4-HA,721,3210,0,1,0,3211,A
4-HA,722,2972,0,2,0,2974,A
4-HA,723,1,2969,1,1,2972,T
4-HA,724,2988,1,1,0,2990,A
4-HA,725,0,2973,0,2,2975,T
4-HA,726,0,1,0,3005,3006,C
4-HA,727,3,0,0,2995,2998,C
4-HA,728,4,1,0,2939,2944,C
4-HA,729,0,2909,0,4,2913,T
4-HA,730,2926,0,0,0,2926,A
4-HA,731,0,0,2927,0,2927,G
4-HA,732,0,1,0,2929,2930,C
4-HA,733,2873,0,1,0,2874,A
4-HA,734,1,0,2933,0,2934,G
4-HA,735,2890,0,2,0,2892,A
4-HA,736,2888,1,1,0,2890,A
4-HA,737,0,2890,0,1,2891,T
4-HA,738,2890,0,1,0,2891,A
4-HA,739,2903,1,3,1,2908,A
4-HA,740,1,2,2904,0,2907,G
4-HA,741,0,0,0,2902,2902,C
4-HA,742,2908,1,0,1,2910,A
4-HA,743,0,2843,1,3,2847,T
4-HA,744,2,2,0,2949,2953,C
4-HA,745,0,2945,0,3,2948,T
4-HA,746,2958,2,1,0,2961,A
4-HA,747,0,2946,0,0,2946,T
4-HA,748,1,2915,0,1,2917,T
4-HA,749,0,2,2940,0,2942,G
4-HA,750,1,3,2917,0,2921,G
4-HA,751,2921,0,4,0,2925,A
4-HA,752,2,0,0,2920,2922,C
4-HA,753,2759,0,0,0,2759,A
4-HA,754,2810,0,0,1,2811,A
4-HA,755,0,2912,0,0,2912,T
4-HA,756,2924,1,0,0,2925,A
4-HA,757,0,2,2944,0,2946,G
4-HA,758,0,2923,0,1,2924,T
4-HA,759,2914,0,5,0,2919,A
4-HA,760,2907,0,1,0,2908,A
4-HA,761,2924,1,1,0,2926,A
4-HA,762,2938,0,1,0,2939,A
4-HA,763,0,0,0,2937,2937,C
4-HA,764,6,0,0,2799,2805,C
4-HA,765,4,4,2784,0,2792,G
4-HA,766,0,3,2812,0,2815,G
4-HA,767,0,1,2829,0,2830,G
4-HA,768,2826,0,3,0,2829,A
4-HA,769,0,2,2844,0,2846,G
4-HA,770,2862,0,2,0,2864,A
4-HA,771,1,2,1,2856,2860,C
4-HA,772,2854,1,2,0,2857,A
4-HA,773,1,2852,0,3,2856,T
4-HA,774,2859,0,4,0,2863,A
4-HA,775,0,1,0,2892,2893,C
4-HA,776,0,2877,0,4,2881,T
4-HA,777,0,2877,0,2,2879,T
4-HA,778,0,2876,0,2,2878,T
4-HA,779,1,2871,0,0,2872,T
4-HA,780,2,3,2886,0,2891,G
4-HA,781,2884,0,1,7,2892,A
4-HA,782,0,2885,1,4,2890,T
4-HA,783,0,2916,0,1,2917,T
4-HA,784,2902,1,0,0,2903,A
4-HA,785,2905,0,0,0,2905,A
4-HA,786,2,0,0,2915,2917,C
4-HA,787,2905,1,1,1,2908,A
4-HA,788,2,2,2962,0,2966,G
4-HA,789,0,0,0,2949,2949,C
4-HA,790,2947,0,3,0,2950,A
4-HA,791,2,2,0,2952,2956,C
4-HA,792,2927,0,1,0,2928,A
4-HA,793,0,2,2941,0,2943,G
4-HA,794,0,1,2932,1,2934,G
4-HA,795,1,2,2990,0,2993,G
4-HA,796,2978,1,2,0,2981,A
4-HA,797,2978,0,4,0,2982,A
4-HA,798,0,2970,0,2,2972,T
4-HA,799,2,2,0,2985,2989,C
4-HA,800,1,2985,0,0,2986,T
4-HA,801,2989,0,0,1,2990,A
4-HA,802,2965,0,10,0,2975,A
4-HA,803,2,2957,0,0,2959,T
4-HA,804,0,2859,0,1,2860,T
4-HA,805,2,1,2869,0,2872,G
4-HA,806,0,0,0,2899,2899,C
4-HA,807,3,2933,0,8,2944,T
4-HA,808,3,0,1,2992,2996,C
4-HA,809,2,1,0,2990,2993,C
4-HA,810,0,2979,0,1,2980,T
4-HA,811,2981,0,1,0,2982,A
4-HA,812,0,8,2974,0,2982,G
4-HA,813,1,7,2999,0,3007,G
4-HA,814,1,3,2993,2,2999,G
4-HA,815,0,0,2978,0,2978,G
4-HA,816,0,2918,0,1,2919,T
4-HA,817,0,2894,0,2,2896,T
4-HA,818,2894,0,2,0,2896,A
4-HA,819,2,1,0,2911,2914,C
4-HA,820,0,2903,0,2,2905,T
4-HA,821,1,2914,0,1,2916,T
4-HA,822,3,3,0,2904,2910,C
4-HA,823,2890,0,1,0,2891,A
4-HA,824,2888,1,2,0,2891,A
4-HA,825,2886,0,1,1,2888,A
4-HA,826,2906,0,1,0,2907,A
4-HA,827,0,2910,0,0,2910,T
4-HA,828,2888,0,0,0,2888,A
4-HA,829,0,1,0,2885,2886,C
4-HA,830,0,0,2878,0,2878,G
4-HA,831,2868,2,1,0,2871,A
4-HA,832,2869,0,1,0,2870,A
4-HA,833,0,0,2897,0,2897,G
4-HA,834,1,2885,0,1,2887,T
4-HA,835,3,1,2893,0,2897,G
4-HA,836,1,1,2895,0,2897,G
4-HA,837,0,1,2896,0,2897,G
4-HA,838,2898,1,1,0,2900,A
4-HA,839,2901,2,1,0,2904,A
4-HA,840,2902,0,0,1,2903,A
4-HA,841,2893,0,6,1,2900,A
4-HA,842,0,0,2943,0,2943,G
4-HA,843,0,0,0,2934,2934,C
4-HA,844,1,2906,1,7,2915,T
4-HA,845,6,1,0,2929,2936,C
4-HA,846,2922,1,1,0,2924,A
4-HA,847,2929,2,3,0,2934,A
4-HA,848,1,2930,0,1,2932,T
4-HA,849,2945,1,2,0,2948,A
4-HA,850,2950,0,1,1,2952,A
4-HA,851,0,2899,0,1,2900,T
4-HA,852,1,6,2889,0,2896,G
4-HA,853,2866,1,2,0,2869,A
4-HA,854,1,1,2913,0,2915,G
4-HA,855,2918,0,2,0,2920,A
4-HA,856,0,2901,0,2,2903,T
4-HA,857,4,3,0,2926,2933,C
4-HA,858,2912,0,1,0,2913,A
4-HA,859,1,1,2956,1,2959,G
4-HA,860,2951,2,4,0,2957,A
4-HA,861,2,2934,0,0,2936,T
4-HA,862,0,0,2927,0,2927,G
4-HA,863,1,3,0,2879,2883,C
4-HA,864,2888,1,3,0,2892,A
4-HA,865,2,1,1,2909,2913,C
4-HA,866,2,0,1,2886,2889,C
4-HA,867,5,1,0,2882,2888,C
4-HA,868,2844,0,1,0,2845,A
4-HA,869,0,2829,0,0,2829,T
4-HA,870,0,2832,0,3,2835,T
4-HA,871,4,3,2866,1,2874,G
4-HA,872,2,1,2860,0,2863,G
4-HA,873,2,2,0,2855,2859,C
4-HA,874,2803,0,1,0,2804,A
4-HA,875,2796,0,2,0,2798,A
4-HA,876,2839,0,1,0,2840,A
4-HA,877,0,2847,0,1,2848,T
4-HA,878,3,0,2850,0,2853,G
4-HA,879,0,0,0,2845,2845,C
4-HA,880,2806,2,1,0,2809,A
4-HA,881,2847,0,2,0,2849,A
4-HA,882,0,2854,0,0,2854,T
4-HA,883,0,2859,0,0,2859,T
4-HA,884,5,0,1,2860,2866,C
4-HA,885,0,2796,1,6,2803,T
4-HA,886,2,4,2818,0,2824,G
4-HA,887,2826,0,0,0,2826,A
4-HA,888,2829,0,1,0,2830,A
4-HA,889,0,2823,0,1,2824,T
4-HA,890,1,0,2786,1,2788,G
4-HA,891,0,0,0,2783,2783,C
4-HA,892,2781,0,1,0,2782,A
4-HA,893,0,2770,0,7,2777,T
4-HA,894,2,1,0,2768,2771,C
4-HA,895,2752,1,3,1,2757,A
4-HA,896,0,1,0,2825,2826,C
4-HA,897,0,2803,0,0,2803,T
4-HA,898,2,0,0,2813,2815,C
4-HA,899,5,0,0,2799,2804,C
4-HA,900,2810,1,0,1,2812,A
4-HA,901,2814,1,1,0,2816,A
4-HA,902,2810,1,2,1,2814,A
4-HA,903,0,2699,0,2,2701,T
4-HA,904,1,5,2706,0,2712,G
4-HA,905,0,0,2717,0,2717,G
4-HA,906,2718,0,2,0,2720,A
4-HA,907,2705,1,3,0,2709,A
4-HA,908,1,1,2716,0,2718,G
4-HA,909,0,2,0,2693,2695,C
4-HA,910,2663,1,1,0,2665,A
4-HA,911,0,2675,0,0,2675,T
4-HA,912,0,2670,0,0,2670,T
4-HA,913,4,0,0,2713,2717,C
4-HA,914,1,0,0,2708,2709,C
4-HA,915,3,1,1,2707,2712,C
4-HA,916,2705,1,4,0,2710,A
4-HA,917,2731,0,0,5,2736,A
4-HA,918,0,2748,0,2,2750,T
4-HA,919,1,5,2742,0,2748,G
4-HA,920,2740,0,2,0,2742,A
4-HA,921,0,4,0,2735,2739,C
4-HA,922,2663,1,0,0,2664,A
4-HA,923,2662,0,0,0,2662,A
4-HA,924,2657,2,2,0,2661,A
4-HA,925,0,0,0,2672,2672,C
4-HA,926,2,0,1,2630,2633,C
4-HA,927,2586,1,0,0,2587,A
4-HA,928,1,2582,0,0,2583,T
4-HA,929,1,2574,1,1,2577,T
4-HA,930,4,0,1,2589,2594,C
4-HA,931,2,2,0,2588,2592,C
4-HA,932,2587,1,0,0,2588,A
4-HA,933,2586,0,0,0,2586,A
4-HA,934,2579,0,1,0,2580,A
4-HA,935,2614,0,0,1,2615,A
4-HA,936,0,2612,2,0,2614,T
4-HA,937,1,0,2609,0,2610,G
4-HA,938,1,2595,0,1,2597,T
4-HA,939,2605,0,2,0,2607,A
4-HA,940,2599,0,1,1,2601,A
4-HA,941,2605,0,4,0,2609,A
4-HA,942,0,2,0,2612,2614,C
4-HA,943,2582,0,0,0,2582,A
4-HA,944,1,1,2575,0,2577,G
4-HA,945,0,4,2581,0,2585,G
4-HA,946,2595,0,3,0,2598,A
4-HA,947,0,2589,0,3,2592,T
4-HA,948,3,2,0,2592,2597,C
4-HA,949,2611,0,2,0,2613,A
4-HA,950,2,0,0,2677,2679,C
4-HA,951,2672,0,3,0,2675,A
4-HA,952,0,2728,0,0,2728,T
4-HA,953,2643,0,1,0,2644,A
4-HA,954,0,3,0,2624,2627,C
4-HA,955,3,4,2548,0,2555,G
4-HA,956,2,1,2558,1,2562,G
4-HA,957,0,2,2554,0,2556,G
4-HA,958,0,1,2558,0,2559,G
4-HA,959,1,0,1,2504,2506,C
4-HA,960,1,0,0,2486,2487,C
4-HA,961,0,2414,0,5,2419,T
4-HA,962,3,0,2554,0,2557,G
4-HA,963,1,2537,0,1,2539,T
4-HA,964,1,2,0,2542,2545,C
4-HA,965,0,4,0,2543,2547,C
4-HA,966,5,0,0,2519,2524,C
4-HA,967,2516,0,1,0,2517,A
4-HA,968,0,0,2532,1,2533,G
4-HA,969,2524,0,0,0,2524,A
4-HA,970,0,2525,1,0,2526,T
4-HA,971,2334,0,2,0,2336,A
4-HA,972,1,2291,0,1,2293,T
4-HA,973,1,0,2286,0,2287,G
4-HA,974,0,2283,1,1,2285,T
4-HA,975,0,2249,0,0,2249,T
4-HA,976,2260,0,2,0,2262,A
4-HA,977,2237,0,1,0,2238,A
4-HA,978,0,5,2250,0,2255,G
4-HA,979,1,1,0,2248,2250,C
4-HA,980,2217,0,0,0,2217,A
4-HA,981,2218,1,2,0,2221,A
4-HA,982,2203,0,2,0,2205,A
4-HA,983,2204,0,0,0,2204,A
4-HA,984,0,2,0,2210,2212,C
4-HA,985,2174,1,2,0,2177,A
4-HA,986,0,1,0,2196,2197,C
4-HA,987,0,2131,0,2,2133,T
4-HA,988,1,2,0,2157,2160,C
4-HA,989,1,2155,0,3,2159,T
4-HA,990,1,1,2174,0,2176,G
4-HA,991,2181,0,1,0,2182,A
4-HA,992,2177,0,1,0,2178,A
4-HA,993,2172,0,0,0,2172,A
4-HA,994,0,2151,0,0,2151,T
4-HA,995,0,2117,0,3,2120,T
4-HA,996,0,4,2126,0,2130,G
4-HA,997,0,0,2123,1,2124,G
4-HA,998,1,2,0,2128,2131,C
4-HA,999,2104,0,1,0,2105,A
4-HA,1000,2111,0,0,1,2112,A
4-HA,1001,2,0,0,2110,2112,C
4-HA,1002,2103,2,2,0,2107,A
4-HA,1003,1,2,2125,0,2128,G
4-HA,1004,0,2,2110,0,2112,G
4-HA,1005,0,1,2105,0,2106,G
4-HA,1006,2105,1,1,0,2107,A
4-HA,1007,0,2096,0,0,2096,T
4-HA,1008,1,0,2099,0,2100,G
4-HA,1009,1,2,0,2089,2092,C
4-HA,1010,4,3,2101,0,2108,G
4-HA,1011,2132,0,0,0,2132,A
4-HA,1012,2096,0,1,0,2097,A
4-HA,1013,2104,0,2,0,2106,A
4-HA,1014,0,2085,0,0,2085,T
4-HA,1015,1,1,2094,0,2096,G
4-HA,1016,0,2091,1,0,2092,T
4-HA,1017,2086,0,2,0,2088,A
4-HA,1018,1,0,0,2085,2086,C
4-HA,1019,1,0,0,2069,2070,C
4-HA,1020,2023,0,3,0,2026,A
4-HA,1021,0,0,2027,0,2027,G
4-HA,1022,1996,1,2,0,1999,A
4-HA,1023,3,1,2015,0,2019,G
4-HA,1024,1975,0,2,0,1977,A
4-HA,1025,1974,0,1,0,1975,A
4-HA,1026,1980,0,2,1,1983,A
4-HA,1027,0,0,0,1984,1984,C
4-HA,1028,1970,1,0,0,1971,A
4-HA,1029,1985,0,0,0,1985,A
4-HA,1030,1971,1,4,0,1976,A
4-HA,1031,3,0,0,1986,1989,C
4-HA,1032,0,1960,0,0,1960,T
4-HA,1033,1933,1,1,0,1935,A
4-HA,1034,0,1,1937,0,1938,G
4-HA,1035,1919,0,4,1,1924,A
4-HA,1036,0,2,1950,0,1952,G
4-HA,1037,0,1,1952,1,1954,G
4-HA,1038,0,0,1,1904,1905,C
4-HA,1039,1908,0,2,0,1910,A
4-HA,1040,0,1897,0,0,1897,T
4-HA,1041,1902,1,0,0,1903,A
4-HA,1042,0,1885,0,2,1887,T
4-HA,1043,0,1884,0,1,1885,T
4-HA,1044,0,1888,0,0,1888,T
4-HA,1045,0,2,1815,0,1817,G
4-HA,1046,1,0,1819,0,1820,G
4-HA,1047,1,0,0,1803,1804,C
4-HA,1048,0,0,1801,0,1801,G
4-HA,1049,2,0,0,1782,1784,C
4-HA,1050,1781,0,0,0,1781,A
4-HA,1051,1785,0,1,0,1786,A
4-HA,1052,0,1778,0,2,1780,T
4-HA,1053,1,1,0,1785,1787,C
4-HA,1054,0,0,1789,0,1789,G
4-HA,1055,1,0,0,1772,1773,C
4-HA,1056,1,4,1768,0,1773,G
4-HA,1057,2,2,1778,0,1782,G
4-HA,1058,1,0,1787,0,1788,G
4-HA,1059,0,1783,0,2,1785,T
4-HA,1060,0,1752,0,2,1754,T
4-HA,1061,2,1747,0,2,1751,T
4-HA,1062,2,0,0,1753,1755,C
4-HA,1063,1760,0,0,0,1760,A
4-HA,1064,1,1756,0,1,1758,T
4-HA,1065,1762,0,0,0,1762,A
4-HA,1066,0,0,1763,0,1763,G
4-HA,1067,1709,1,1,0,1711,A
4-HA,1068,1712,0,0,0,1712,A
4-HA,1069,1717,0,1,0,1718,A
4-HA,1070,1714,1,1,0,1716,A
4-HA,1071,0,1708,0,0,1708,T
4-HA,1072,1,0,1720,0,1721,G
4-HA,1073,0,2,1717,0,1719,G
4-HA,1074,1,1685,0,3,1689,T
4-HA,1075,0,1642,0,0,1642,T
4-HA,1076,0,2,1632,1,1635,G
4-HA,1077,3,0,1618,0,1621,G
4-HA,1078,0,1,1618,0,1619,G
4-HA,1079,1586,0,1,0,1587,A
4-HA,1080,0,3,1587,0,1590,G
4-HA,1081,1,0,1544,0,1545,G
4-HA,1082,3,0,1536,0,1539,G
4-HA,1083,1529,0,5,0,1534,A
4-HA,1084,1544,0,0,0,1544,A
4-HA,1085,0,1538,0,2,1540,T
4-HA,1086,1,3,1525,0,1529,G
4-HA,1087,1,0,1548,0,1549,G
4-HA,1088,0,1537,0,0,1537,T
4-HA,1089,0,2,1523,0,1525,G
4-HA,1090,1,0,1526,0,1527,G
4-HA,1091,1502,0,4,0,1506,A
4-HA,1092,0,1503,0,1,1504,T
4-HA,1093,3,0,1524,0,1527,G
4-HA,1094,0,1,1540,0,1541,G
4-HA,1095,0,1517,0,0,1517,T
4-HA,1096,1,1476,0,1,1478,T
4-HA,1097,2,2,1482,0,1486,G
4-HA,1098,1,0,1506,0,1507,G
4-HA,1099,0,1503,0,1,1504,T
4-HA,1100,1504,0,0,0,1504,A
4-HA,1101,1,2,0,1453,1456,C
4-HA,1102,1,1,1466,0,1468,G
4-HA,1103,0,0,1498,0,1498,G
4-HA,1104,0,1499,1,1,1501,T
4-HA,1105,0,1494,0,2,1496,T
4-HA,1106,2,1495,0,0,1497,T
4-HA,1107,1,0,0,1476,1477,C
4-HA,1108,1471,1,4,0,1476,A
4-HA,1109,2,0,1472,0,1474,G
4-HA,1110,0,1,1472,0,1473,G
4-HA,1111,0,0,0,1468,1468,C
4-HA,1112,1435,0,1,0,1436,A
4-HA,1113,0,1447,0,1,1448,T
4-HA,1114,1,1,0,1446,1448,C
4-HA,1115,1454,0,0,0,1454,A
4-HA,1116,1446,0,3,0,1449,A
4-HA,1117,1447,0,4,0,1451,A
4-HA,1118,1458,1,0,0,1459,A
4-HA,1119,0,1448,0,1,1449,T
4-HA,1120,0,1449,0,1,1450,T
4-HA,1121,1,0,0,1453,1454,C
4-HA,1122,2,1431,0,0,1433,T
4-HA,1123,0,2,1433,1,1436,G
4-HA,1124,1433,0,0,0,1433,A
4-HA,1125,1,1,1457,0,1459,G
4-HA,1126,0,1,1561,0,1562,G
4-HA,1127,1,2,1613,0,1616,G
4-HA,1128,1609,0,1,0,1610,A
4-HA,1129,1609,0,2,0,1611,A
4-HA,1130,0,360,1243,0,1603,G
4-HA,1131,1609,1,4,0,1614,A
4-HA,1132,2,2,1607,0,1611,G
4-HA,1133,0,0,1621,0,1621,G
4-HA,1134,1602,1,3,0,1606,A
4-HA,1135,0,0,0,1517,1517,C
4-HA,1136,1383,0,0,0,1383,A
4-HA,1137,1382,0,1,0,1383,A
4-HA,1138,1,1,1382,0,1384,G
4-HA,1139,0,0,0,1390,1390,C
4-HA,1140,1371,1,2,0,1374,A
4-HA,1141,1,0,1370,0,1371,G
4-HA,1142,1,0,0,1370,1371,C
4-HA,1143,1362,1,2,0,1365,A
4-HA,1144,1,2,1375,0,1378,G
4-HA,1145,1375,0,0,0,1375,A
4-HA,1146,1,1387,0,2,1390,T
4-HA,1147,2,0,0,1396,1398,C
4-HA,1148,0,1374,0,7,1381,T
4-HA,1149,2,0,0,1398,1400,C
4-HA,1150,1398,0,0,0,1398,A
4-HA,1151,1398,0,0,0,1398,A
4-HA,1152,1395,0,0,0,1395,A
4-HA,1153,1382,0,2,0,1384,A
4-HA,1154,2,0,1393,0,1395,G
4-HA,1155,1,0,0,1366,1367,C
4-HA,1156,1362,0,2,0,1364,A
4-HA,1157,0,0,0,1385,1385,C
4-HA,1158,0,1378,0,1,1379,T
4-HA,1159,0,0,0,1382,1382,C
4-HA,1160,1385,1,1,0,1387,A
4-HA,1161,1387,0,3,0,1390,A
4-HA,1162,0,0,1391,0,1391,G
4-HA,1163,0,1,0,1391,1392,C
4-HA,1164,1384,0,2,0,1386,A
4-HA,1165,1,2,1383,0,1386,G
4-HA,1166,0,1,0,1368,1369,C
4-HA,1167,1364,0,0,0,1364,A
4-HA,1168,1361,1,2,0,1364,A
4-HA,1169,1,1360,0,1,1362,T
4-HA,1170,1,0,0,1345,1346,C
4-HA,1171,1,2,1349,1,1353,G
4-HA,1172,1349,0,1,0,1350,A
4-HA,1173,1,1347,0,0,1348,T
4-HA,1174,0,0,0,1342,1342,C
4-HA,1175,1336,0,0,1,1337,A
4-HA,1176,1352,1,1,0,1354,A
4-HA,1177,1362,0,0,1,1363,A
4-HA,1178,1,1356,0,0,1357,T
4-HA,1179,1,0,0,1357,1358,C
4-HA,1180,1344,0,1,1,1346,A
4-HA,1181,1348,0,0,0,1348,A
4-HA,1182,0,1347,0,0,1347,T
4-HA,1183,0,0,1351,0,1351,G
4-HA,1184,0,1,1347,1,1349,G
4-HA,1185,1,0,1326,0,1327,G
4-HA,1186,1323,1,3,0,1327,A
4-HA,1187,1321,0,4,1,1326,A
4-HA,1188,0,1,1347,0,1348,G
4-HA,1189,0,0,0,1347,1347,C
4-HA,1190,0,1339,0,1,1340,T
4-HA,1191,0,2,1370,0,1372,G
4-HA,1192,1364,0,2,1,1367,A
4-HA,1193,1366,1,3,0,1370,A
4-HA,1194,0,1375,0,0,1375,T
4-HA,1195,1348,1,0,0,1349,A
4-HA,1196,2,2,1343,0,1347,G
4-HA,1197,1278,0,1,0,1279,A
4-HA,1198,0,1280,1,0,1281,T
4-HA,1199,2,1276,0,1,1279,T
4-HA,1200,0,3,1289,0,1292,G
4-HA,1201,1295,0,0,0,1295,A
4-HA,1202,0,1296,0,0,1296,T
4-HA,1203,0,2,0,1293,1295,C
4-HA,1204,1,1,1288,0,1290,G
4-HA,1205,1,3,1280,0,1284,G
4-HA,1206,0,2,1292,0,1294,G
4-HA,1207,1287,1,1,0,1289,A
4-HA,1208,1297,0,1,0,1298,A
4-HA,1209,1284,0,2,0,1286,A
4-HA,1210,1289,0,0,1,1290,A
4-HA,1211,0,1,0,1294,1295,C
4-HA,1212,2,0,1,1289,1292,C
4-HA,1213,1283,1,0,0,1284,A
4-HA,1214,1283,0,0,0,1283,A
4-HA,1215,0,3,0,1285,1288,C
4-HA,1216,0,2,1292,0,1294,G
4-HA,1217,1288,0,2,0,1290,A
4-HA,1218,1,2,1289,0,1292,G
4-HA,1219,1291,0,1,2,1294,A
4-HA,1220,1293,1,0,0,1294,A
4-HA,1221,1292,0,1,0,1293,A
4-HA,1222,0,1299,1,0,1300,T
4-HA,1223,0,1293,0,1,1294,T
4-HA,1224,1,0,0,1298,1299,C
4-HA,1225,1,1,0,1285,1287,C
4-HA,1226,1280,1,1,2,1284,A
4-HA,1227,0,1284,0,0,1284,T
4-HA,1228,2,0,0,1281,1283,C
4-HA,1229,1270,0,1,0,1271,A
4-HA,1230,0,0,1279,0,1279,G
4-HA,1231,1266,0,0,0,1266,A
4-HA,1232,0,1265,0,0,1265,T
4-HA,1233,0,1261,0,0,1261,T
4-HA,1234,0,3,1265,0,1268,G
4-HA,1235,1264,1,1,0,1266,A
4-HA,1236,1269,0,0,0,1269,A
4-HA,1237,1264,0,2,0,1266,A
4-HA,1238,1266,1,0,0,1267,A
4-HA,1239,1256,0,2,1,1259,A
4-HA,1240,0,0,1259,0,1259,G
4-HA,1241,1255,0,0,0,1255,A
4-HA,1242,1256,0,0,0,1256,A
4-HA,1243,2,1248,0,1,1251,T
4-HA,1244,0,1246,0,2,1248,T
4-HA,1245,1,1,0,1252,1254,C
4-HA,1246,0,1248,0,0,1248,T
4-HA,1247,0,0,0,1249,1249,C
4-HA,1248,1244,1,0,1,1246,A
4-HA,1249,1,0,1246,0,1247,G
4-HA,1250,1242,0,0,0,1242,A
4-HA,1251,1238,0,1,0,1239,A
4-HA,1252,0,0,1252,0,1252,G
4-HA,1253,0,1249,0,0,1249,T
4-HA,1254,2,0,0,1246,1248,C
4-HA,1255,0,1,1245,0,1246,G
4-HA,1256,1242,0,0,0,1242,A
4-HA,1257,1241,0,1,0,1242,A
4-HA,1258,2,2,1235,0,1239,G
4-HA,1259,0,0,1248,0,1248,G
4-HA,1260,1,1,1242,2,1246,G
4-HA,1261,1216,0,1,0,1217,A
4-HA,1262,0,1,1223,0,1224,G
4-HA,1263,1219,0,1,0,1220,A
4-HA,1264,1265,0,0,0,1265,A
4-HA,1265,1,1265,0,1,1267,T
4-HA,1266,0,1269,1,0,1270,T
4-HA,1267,1,0,0,1267,1268,C
4-HA,1268,1247,0,1,0,1248,A
4-HA,1269,0,1,1246,0,1247,G
4-HA,1270,0,2,1246,0,1248,G
4-HA,1271,1235,0,0,0,1235,A
4-HA,1272,0,0,0,1236,1236,C
4-HA,1273,0,0,0,1128,1128,C
4-HA,1274,0,1116,0,0,1116,T
4-HA,1275,0,1087,0,34,1121,T
4-HA,1276,0,3,1124,0,1127,G
4-HA,1277,1124,0,1,0,1125,A
4-HA,1278,0,2,1140,0,1142,G
4-HA,1279,1123,0,0,0,1123,A
4-HA,1280,929,0,0,0,929,A
4-HA,1281,921,0,1,0,922,A
4-HA,1282,0,908,0,2,910,T
4-HA,1283,921,0,2,0,923,A
4-HA,1284,0,911,0,0,911,T
4-HA,1285,1,0,908,0,909,G
4-HA,1286,0,906,0,1,907,T
4-HA,1287,0,865,0,0,865,T
4-HA,1288,0,1,869,0,870,G
4-HA,1289,856,0,0,0,856,A
4-HA,1290,0,2,859,0,861,G
4-HA,1291,0,0,857,0,857,G
4-HA,1292,852,0,1,0,853,A
4-HA,1293,0,0,0,898,898,C
4-HA,1294,883,0,0,0,883,A
4-HA,1295,0,0,0,882,882,C
4-HA,1296,1,870,0,1,872,T
4-HA,1297,913,0,1,0,914,A
4-HA,1298,923,0,2,1,926,A
4-HA,1299,929,0,0,0,929,A
4-HA,1300,931,0,1,1,933,A
4-HA,1301,0,934,0,0,934,T
4-HA,1302,884,0,0,0,884,A
4-HA,1303,1,1,901,0,903,G
4-HA,1304,870,0,1,0,871,A
4-HA,1305,0,879,1,0,880,T
4-HA,1306,0,0,0,874,874,C
4-HA,1307,0,868,0,1,869,T
4-HA,1308,0,0,0,884,884,C
4-HA,1309,1,880,0,1,882,T
4-HA,1310,1,0,906,0,907,G
4-HA,1311,0,0,928,0,928,G
4-HA,1312,1,917,0,0,918,T
4-HA,1313,2,1,0,916,919,C
4-HA,1314,920,0,0,0,920,A
4-HA,1315,0,922,0,1,923,T
4-HA,1316,923,0,0,0,923,A
4-HA,1317,1,0,0,922,923,C
4-HA,1318,898,0,1,0,899,A
4-HA,1319,904,0,1,0,905,A
4-HA,1320,0,0,1,893,894,C
4-HA,1321,0,1,893,0,894,G
4-HA,1322,0,0,1,893,894,C
4-HA,1323,0,0,892,0,892,G
4-HA,1324,0,1,890,0,891,G
4-HA,1325,889,1,2,0,892,A
4-HA,1326,0,0,908,0,908,G
4-HA,1327,0,1,0,906,907,C
4-HA,1328,1,898,0,2,901,T
4-HA,1329,0,900,0,2,902,T
4-HA,1330,1,1,0,905,907,C
4-HA,1331,0,904,0,2,906,T
4-HA,1332,1,904,0,2,907,T
4-HA,1333,5,0,899,0,904,G
4-HA,1334,0,906,0,0,906,T
4-HA,1335,0,890,0,0,890,T
4-HA,1336,0,1,900,0,901,G
4-HA,1337,0,0,0,898,898,C
4-HA,1338,0,0,0,885,885,C
4-HA,1339,4,0,0,894,898,C
4-HA,1340,0,899,0,0,899,T
4-HA,1341,0,1,905,0,906,G
4-HA,1342,1,0,906,0,907,G
4-HA,1343,907,0,1,0,908,A
4-HA,1344,2,2,907,0,911,G
4-HA,1345,905,0,1,0,906,A
4-HA,1346,908,0,1,0,909,A
4-HA,1347,1,0,0,920,921,C
4-HA,1348,2,0,0,920,922,C
4-HA,1349,924,0,1,0,925,A
4-HA,1350,940,0,2,0,942,A
4-HA,1351,0,2,0,945,947,C
4-HA,1352,946,0,2,0,948,A
4-HA,1353,0,941,0,1,942,T
4-HA,1354,941,0,1,0,942,A
4-HA,1355,0,0,0,964,964,C
4-HA,1356,943,0,0,0,943,A
4-HA,1357,944,0,2,0,946,A
4-HA,1358,1,938,1,0,940,T
4-HA,1359,0,917,0,1,918,T
4-HA,1360,0,1,931,0,932,G
4-HA,1361,933,0,0,0,933,A
4-HA,1362,0,932,0,5,937,T
4-HA,1363,1,0,0,936,937,C
4-HA,1364,1,919,0,2,922,T
4-HA,1365,924,0,1,0,925,A
4-HA,1366,923,0,2,0,925,A
4-HA,1367,0,0,0,924,924,C
4-HA,1368,0,919,0,3,922,T
4-HA,1369,0,2,915,0,917,G
4-HA,1370,914,0,0,0,914,A
4-HA,1371,1,0,0,911,912,C
4-HA,1372,0,909,0,1,910,T
4-HA,1373,2,0,0,911,913,C
4-HA,1374,907,0,0,0,907,A
4-HA,1375,2,0,919,0,921,G
4-HA,1376,917,1,0,0,918,A
4-HA,1377,919,0,0,0,919,A
4-HA,1378,922,0,0,0,922,A
4-HA,1379,0,917,0,0,917,T
4-HA,1380,0,0,933,0,933,G
4-HA,1381,928,0,2,0,930,A
4-HA,1382,930,0,0,0,930,A
4-HA,1383,0,0,0,930,930,C
4-HA,1384,917,0,0,0,917,A
4-HA,1385,920,0,0,0,920,A
4-HA,1386,919,0,0,0,919,A
4-HA,1387,1,0,0,922,923,C
4-HA,1388,1,918,0,0,919,T
4-HA,1389,0,0,923,0,923,G
4-HA,1390,0,913,0,0,913,T
4-HA,1391,0,913,0,1,914,T
4-HA,1392,0,914,0,0,914,T
4-HA,1393,0,0,915,0,915,G
4-HA,1394,915,0,0,0,915,A
4-HA,1395,914,0,0,0,914,A
4-HA,1396,910,1,0,0,911,A
4-HA,1397,911,1,0,1,913,A
4-HA,1398,909,0,0,0,909,A
4-HA,1399,913,0,0,0,913,A
4-HA,1400,0,0,0,916,916,C
4-HA,1401,914,0,1,0,915,A
4-HA,1402,913,0,1,0,914,A
4-HA,1403,914,1,0,0,915,A
4-HA,1404,0,0,916,0,916,G
4-HA,1405,917,0,0,0,917,A
4-HA,1406,914,0,1,0,915,A
4-HA,1407,0,1,913,0,914,G
4-HA,1408,1,0,0,911,912,C
4-HA,1409,908,0,2,0,910,A
4-HA,1410,914,0,0,0,914,A
4-HA,1411,0,0,1,914,915,C
4-HA,1412,0,910,0,0,910,T
4-HA,1413,0,0,917,1,918,G
4-HA,1414,908,0,0,0,908,A
4-HA,1415,1,1,915,0,917,G
4-HA,1416,0,2,914,0,916,G
4-HA,1417,0,0,917,0,917,G
4-HA,1418,919,0,0,0,919,A
4-HA,1419,913,0,1,0,914,A
4-HA,1420,910,0,1,0,911,A
4-HA,1421,919,0,1,0,920,A
4-HA,1422,0,913,0,0,913,T
4-HA,1423,1,0,917,0,918,G
4-HA,1424,0,0,0,914,914,C
4-HA,1425,0,907,0,1,908,T
4-HA,1426,0,1,907,0,908,G
4-HA,1427,905,0,1,0,906,A
4-HA,1428,0,1,948,0,949,G
4-HA,1429,0,1,961,0,962,G
4-HA,1430,947,1,4,0,952,A
4-HA,1431,0,948,0,0,948,T
4-HA,1432,939,1,2,0,942,A
4-HA,1433,0,937,0,1,938,T
4-HA,1434,0,2,945,0,947,G
4-HA,1435,1,0,950,0,951,G
4-HA,1436,0,0,945,0,945,G
4-HA,1437,0,2,0,910,912,C
4-HA,1438,896,0,0,0,896,A
4-HA,1439,892,0,1,0,893,A
4-HA,1440,0,896,0,2,898,T
4-HA,1441,1,2,894,0,897,G
4-HA,1442,1,0,901,0,902,G
4-HA,1443,0,885,0,0,885,T
4-HA,1444,0,859,0,1,860,T
4-HA,1445,0,2,861,0,863,G
4-HA,1446,0,865,0,1,866,T
4-HA,1447,0,869,0,0,869,T
4-HA,1448,1,865,0,0,866,T
4-HA,1449,0,0,0,871,871,C
4-HA,1450,867,0,1,0,868,A
4-HA,1451,869,0,0,0,869,A
4-HA,1452,873,0,0,0,873,A
4-HA,1453,882,0,0,0,882,A
4-HA,1454,0,879,0,0,879,T
4-HA,1455,872,0,0,0,872,A
4-HA,1456,0,869,0,1,870,T
4-HA,1457,870,0,0,0,870,A
4-HA,1458,1,0,0,877,878,C
4-HA,1459,1,1,0,869,871,C
4-HA,1460,871,0,1,0,872,A
4-HA,1461,0,1,0,873,874,C
4-HA,1462,868,0,0,0,868,A
4-HA,1463,866,0,0,0,866,A
4-HA,1464,859,0,0,1,860,A
4-HA,1465,0,856,0,0,856,T
4-HA,1466,2,0,860,0,862,G
4-HA,1467,1,852,0,0,853,T
4-HA,1468,0,0,858,0,858,G
4-HA,1469,860,0,0,0,860,A
4-HA,1470,0,1,0,861,862,C
4-HA,1471,853,0,2,0,855,A
4-HA,1472,851,0,0,0,851,A
4-HA,1473,1,851,0,0,852,T
4-HA,1474,0,1,859,0,860,G
4-HA,1475,1,0,0,856,857,C
4-HA,1476,0,1,0,857,858,C
4-HA,1477,0,857,0,1,858,T
4-HA,1478,0,0,874,0,874,G
4-HA,1479,0,0,0,876,876,C
4-HA,1480,875,0,1,0,876,A
4-HA,1481,1,872,0,0,873,T
4-HA,1482,841,0,2,0,843,A
4-HA,1483,0,1,849,0,850,G
4-HA,1484,1,0,846,0,847,G
4-HA,1485,843,0,1,0,844,A
4-HA,1486,0,844,0,1,845,T
4-HA,1487,1,0,0,804,805,C
4-HA,1488,803,0,2,0,805,A
4-HA,1489,811,0,0,0,811,A
4-HA,1490,1,809,0,0,810,T
4-HA,1491,1,0,0,811,812,C
4-HA,1492,795,0,0,0,795,A
4-HA,1493,0,0,802,0,802,G
4-HA,1494,803,0,0,0,803,A
4-HA,1495,804,0,0,0,804,A
4-HA,1496,801,0,1,0,802,A
4-HA,1497,0,802,0,0,802,T
4-HA,1498,0,1,798,0,799,G
4-HA,1499,1,1,797,1,800,G
4-HA,1500,796,0,1,0,797,A
4-HA,1501,804,0,0,0,804,A
4-HA,1502,1,1,0,801,803,C
4-HA,1503,0,797,0,1,798,T
4-HA,1504,0,803,0,0,803,T
4-HA,1505,803,0,0,0,803,A
4-HA,1506,2,800,0,0,802,T
4-HA,1507,0,1,804,0,805,G
4-HA,1508,799,1,1,0,801,A
4-HA,1509,0,0,0,808,808,C
4-HA,1510,1,0,0,803,804,C
4-HA,1511,789,0,0,0,789,A
4-HA,1512,1,0,0,787,788,C
4-HA,1513,0,778,0,0,778,T
4-HA,1514,872,0,0,0,872,A
4-HA,1515,0,881,0,0,881,T
4-HA,1516,0,0,895,0,895,G
4-HA,1517,0,893,0,0,893,T
4-HA,1518,880,0,0,0,880,A
4-HA,1519,0,880,0,1,881,T
4-HA,1520,877,0,0,1,878,A
4-HA,1521,0,0,0,874,874,C
4-HA,1522,745,0,1,0,746,A
4-HA,1523,1,2,752,0,755,G
4-HA,1524,689,0,0,0,689,A
4-HA,1525,0,0,678,0,678,G
4-HA,1526,674,1,1,0,676,A
4-HA,1527,0,642,0,1,643,T
4-HA,1528,0,1,639,0,640,G
4-HA,1529,637,0,3,0,640,A
4-HA,1530,635,0,0,0,635,A
4-HA,1531,0,0,647,0,647,G
4-HA,1532,0,0,0,632,632,C
4-HA,1533,628,0,0,0,628,A
4-HA,1534,0,627,1,1,629,T
4-HA,1535,0,630,0,0,630,T
4-HA,1536,631,0,1,0,632,A
4-HA,1537,628,0,1,0,629,A
4-HA,1538,629,0,2,0,631,A
4-HA,1539,1,0,0,628,629,C
4-HA,1540,603,0,0,0,603,A
4-HA,1541,602,0,0,0,602,A
4-HA,1542,0,0,0,601,601,C
4-HA,1543,1,1,1,593,596,C
4-HA,1544,0,0,597,0,597,G
4-HA,1545,0,0,605,0,605,G
4-HA,1546,0,602,0,1,603,T
4-HA,1547,0,603,0,0,603,T
4-HA,1548,0,592,0,0,592,T
4-HA,1549,1,0,0,593,594,C
4-HA,1550,594,0,1,0,595,A
4-HA,1551,0,1,600,0,601,G
4-HA,1552,599,0,0,0,599,A
4-HA,1553,0,596,0,1,597,T
4-HA,1554,0,1,0,583,584,C
4-HA,1555,584,0,0,0,584,A
4-HA,1556,583,0,0,0,583,A
4-HA,1557,1,0,584,0,585,G
4-HA,1558,0,0,582,0,582,G
4-HA,1559,0,1,582,0,583,G
4-HA,1560,560,0,2,0,562,A
4-HA,1561,3,0,564,0,567,G
4-HA,1562,1,566,0,0,567,T
4-HA,1563,0,569,0,0,569,T
4-HA,1564,0,2,565,0,567,G
4-HA,1565,566,0,0,1,567,A
4-HA,1566,0,0,568,0,568,G
4-HA,1567,0,0,0,566,566,C
4-HA,1568,1,562,0,0,563,T
4-HA,1569,0,0,566,0,566,G
4-HA,1570,564,1,0,1,566,A
4-HA,1571,565,0,0,0,565,A
4-HA,1572,0,0,566,0,566,G
4-HA,1573,0,559,0,0,559,T
4-HA,1574,0,0,0,557,557,C
4-HA,1575,547,0,1,0,548,A
4-HA,1576,0,2,545,0,547,G
4-HA,1577,0,2,547,0,549,G
4-HA,1578,0,0,538,0,538,G
4-HA,1579,0,547,0,1,548,T
4-HA,1580,552,0,0,0,552,A
4-HA,1581,0,0,0,549,549,C
4-HA,1582,550,0,0,0,550,A
4-HA,1583,550,0,0,0,550,A
4-HA,1584,552,0,1,0,553,A
4-HA,1585,0,0,555,0,555,G
4-HA,1586,543,0,1,0,544,A
4-HA,1587,0,522,0,1,523,T
4-HA,1588,0,522,0,0,522,T
4-HA,1589,0,0,522,0,522,G
4-HA,1590,0,0,525,0,525,G
4-HA,1591,523,0,1,0,524,A
4-HA,1592,0,525,0,0,525,T
4-HA,1593,0,0,0,523,523,C
4-HA,1594,1,0,0,510,511,C
4-HA,1595,0,505,0,1,506,T
4-HA,1596,506,1,0,0,507,A
4-HA,1597,0,506,0,1,507,T
4-HA,1598,0,1,503,0,504,G
4-HA,1599,0,0,503,0,503,G
4-HA,1600,491,0,2,0,493,A
4-HA,1601,0,488,0,0,488,T
4-HA,1602,0,479,0,1,480,T
4-HA,1603,0,480,0,0,480,T
4-HA,1604,0,0,0,479,479,C
4-HA,1605,0,0,0,476,476,C
4-HA,1606,0,463,1,1,465,T
4-HA,1607,0,460,0,0,460,T
4-HA,1608,0,457,0,0,457,T
4-HA,1609,0,0,458,0,458,G
4-HA,1610,0,0,0,457,457,C
4-HA,1611,1,0,0,456,457,C
4-HA,1612,453,0,0,0,453,A
4-HA,1613,0,446,0,0,446,T
4-HA,1614,449,0,0,0,449,A
4-HA,1615,0,446,0,1,447,T
4-HA,1616,0,0,0,444,444,C
4-HA,1617,446,0,0,0,446,A
4-HA,1618,0,431,0,1,432,T
4-HA,1619,0,0,437,0,437,G
4-HA,1620,0,434,0,0,434,T
4-HA,1621,0,431,0,0,431,T
4-HA,1622,0,431,0,0,431,T
4-HA,1623,0,426,0,0,426,T
4-HA,1624,0,425,0,0,425,T
4-HA,1625,0,425,0,0,425,T
4-HA,1626,0,1,423,0,424,G
4-HA,1627,0,0,0,424,424,C
4-HA,1628,0,415,0,0,415,T
4-HA,1629,0,414,0,0,414,T
4-HA,1630,0,412,0,1,413,T
4-HA,1631,0,1,416,0,417,G
4-HA,1632,0,417,0,0,417,T
4-HA,1633,0,0,417,0,417,G
4-HA,1634,0,417,0,0,417,T
4-HA,1635,0,401,0,1,402,T
4-HA,1636,0,0,404,0,404,G
4-HA,1637,0,0,0,403,403,C
4-HA,1638,0,400,0,2,402,T
4-HA,1639,0,402,0,1,403,T
4-HA,1640,0,384,0,0,384,T
4-HA,1641,0,1,385,0,386,G
4-HA,1642,0,386,0,0,386,T
4-HA,1643,0,384,0,2,386,T
4-HA,1644,0,1,382,0,383,G
4-HA,1645,0,1,375,0,376,G
4-HA,1646,0,1,375,0,376,G
4-HA,1647,0,0,378,0,378,G
4-HA,1648,0,358,0,0,358,T
4-HA,1649,0,357,0,1,358,T
4-HA,1650,0,1,0,352,353,C
4-HA,1651,346,0,0,0,346,A
4-HA,1652,0,344,0,0,344,T
4-HA,1653,0,1,0,344,345,C
4-HA,1654,340,0,0,0,340,A
4-HA,1655,0,332,0,1,333,T
4-HA,1656,0,0,330,0,330,G
4-HA,1657,0,320,0,1,321,T
4-HA,1658,0,0,318,0,318,G
4-HA,1659,0,1,309,0,310,G
4-HA,1660,0,0,310,0,310,G
4-HA,1661,0,0,0,305,305,C
4-HA,1662,0,0,0,301,301,C
4-HA,1663,0,285,0,1,286,T
4-HA,1664,0,0,286,0,286,G
4-HA,1665,0,0,0,285,285,C
4-HA,1666,0,0,0,287,287,C
4-HA,1667,283,0,2,0,285,A
4-HA,1668,284,0,0,0,284,A
4-HA,1669,284,0,0,0,284,A
4-HA,1670,284,0,0,0,284,A
4-HA,1671,284,0,0,0,284,A
4-HA,1672,1,0,281,0,282,G
4-HA,1673,1,0,270,0,271,G
4-HA,1674,1,0,0,267,268,C
4-HA,1675,270,0,1,0,271,A
4-HA,1676,269,1,0,0,270,A
4-HA,1677,0,0,0,270,270,C
4-HA,1678,268,0,0,0,268,A
4-HA,1679,0,266,0,0,266,T
4-HA,1680,0,267,0,0,267,T
4-HA,1681,254,0,1,0,255,A
4-HA,1682,0,0,252,0,252,G
4-HA,1683,1,0,251,0,252,G
4-HA,1684,0,248,0,0,248,T
4-HA,1685,0,0,225,0,225,G
4-HA,1686,1,0,0,217,218,C
4-HA,1687,213,0,0,0,213,A
4-HA,1688,211,0,1,0,212,A
4-HA,1689,0,0,0,213,213,C
4-HA,1690,211,0,0,0,211,A
4-HA,1691,0,206,0,0,206,T
4-HA,1692,0,196,0,0,196,T
4-HA,1693,0,195,0,1,196,T
4-HA,1694,0,0,196,0,196,G
4-HA,1695,0,0,0,193,193,C
4-HA,1696,192,0,0,0,192,A
4-HA,1697,0,184,0,0,184,T
4-HA,1698,0,180,0,1,181,T
4-HA,1699,0,177,0,0,177,T
4-HA,1700,0,0,177,0,177,G
4-HA,1701,172,0,0,0,172,A
5-NP,1,1697,0,0,0,1697,A
5-NP,2,0,1704,0,0,1704,T
5-NP,3,0,0,1692,0,1692,G
5-NP,4,0,0,1704,0,1704,G
5-NP,5,0,3,0,1712,1715,C
5-NP,6,1,0,1751,0,1752,G
5-NP,7,0,1815,0,1,1816,T
5-NP,8,2,1,0,1834,1837,C
5-NP,9,2,2,0,1844,1848,C
5-NP,10,4,1,0,1844,1849,C
5-NP,11,1855,0,2,0,1857,A
5-NP,12,1852,2,2,0,1856,A
5-NP,13,1,5,1862,0,1868,G
5-NP,14,1,1,1927,1,1930,G
5-NP,15,0,2,0,1935,1937,C
5-NP,16,1942,0,4,0,1946,A
5-NP,17,0,1,1,1964,1966,C
5-NP,18,2,0,0,1967,1969,C
5-NP,19,1983,0,0,0,1983,A
5-NP,20,1981,1,1,0,1983,A
5-NP,21,1974,0,4,1,1979,A
5-NP,22,0,3,0,1996,1999,C
5-NP,23,0,3,2006,0,2009,G
5-NP,24,0,3,2225,0,2228,G
5-NP,25,0,2224,0,4,2228,T
5-NP,26,2,1,0,2396,2399,C
5-NP,27,1,2388,0,5,2394,T
5-NP,28,0,2428,0,0,2428,T
5-NP,29,2434,0,0,0,2434,A
5-NP,30,0,2430,0,2,2432,T
5-NP,31,1,5,2450,0,2456,G
5-NP,32,2449,0,1,0,2450,A
5-NP,33,2432,0,1,0,2433,A
5-NP,34,0,2,0,2447,2449,C
5-NP,35,2418,1,1,0,2420,A
5-NP,36,0,3,2624,0,2627,G
5-NP,37,2623,2,1,0,2626,A
5-NP,38,0,2628,0,1,2629,T
5-NP,39,0,2,2627,0,2629,G
5-NP,40,1,3,2637,0,2641,G
5-NP,41,2647,2,2,0,2651,A
5-NP,42,2668,0,1,1,2670,A
5-NP,43,2662,1,7,1,2671,A
5-NP,44,0,0,0,2759,2759,C
5-NP,45,0,2734,0,1,2735,T
5-NP,46,0,1,2772,0,2773,G
5-NP,47,2756,0,4,1,2761,A
5-NP,48,0,2766,0,0,2766,T
5-NP,49,1,2,2767,0,2770,G
5-NP,50,2,4,2775,0,2781,G
5-NP,51,1,4,2775,0,2780,G
5-NP,52,0,3,2794,0,2797,G
5-NP,53,2789,1,1,1,2792,A
5-NP,54,0,2796,0,0,2796,T
5-NP,55,5,0,1,2812,2818,C
5-NP,56,2,0,2819,0,2821,G
5-NP,57,0,0,0,2862,2862,C
5-NP,58,1,2,0,2865,2868,C
5-NP,59,2863,0,0,1,2864,A
5-NP,60,1,2,2886,1,2890,G
5-NP,61,2888,0,0,0,2888,A
5-NP,62,2933,1,1,1,2936,A
5-NP,63,0,2938,0,0,2938,T
5-NP,64,1,2,2945,0,2948,G
5-NP,65,0,1,0,2982,2983,C
5-NP,66,2976,0,1,1,2978,A
5-NP,67,3031,0,4,0,3035,A
5-NP,68,2,1,0,3029,3032,C
5-NP,69,1,3017,0,0,3018,T
5-NP,70,0,0,3049,0,3049,G
5-NP,71,3089,2,6,0,3097,A
5-NP,72,1,5,3267,0,3273,G
5-NP,73,3260,0,3,0,3263,A
5-NP,74,1,3254,0,1,3256,T
5-NP,75,0,3264,0,0,3264,T
5-NP,76,3253,2,4,0,3259,A
5-NP,77,1,4,3285,1,3291,G
5-NP,78,0,6,3295,0,3301,G
5-NP,79,2,0,3300,0,3302,G
5-NP,80,1,1,2,3289,3293,C
5-NP,81,3256,0,1,1,3258,A
5-NP,82,0,3331,0,0,3331,T
5-NP,83,2,0,1,3414,3417,C
5-NP,84,3,4,0,3408,3415,C
5-NP,85,2,0,3425,0,3427,G
5-NP,86,0,3418,0,1,3419,T
5-NP,87,3403,0,4,0,3407,A
5-NP,88,2,5,3499,0,3506,G
5-NP,89,4,3,3497,0,3504,G
5-NP,90,1,3,3555,0,3559,G
5-NP,91,3518,0,2,0,3520,A
5-NP,92,3499,0,5,0,3504,A
5-NP,93,0,3,3515,0,3518,G
5-NP,94,3508,0,0,0,3508,A
5-NP,95,0,3518,0,4,3522,T
5-NP,96,1,3,3538,0,3542,G
5-NP,97,3525,1,5,1,3532,A
5-NP,98,0,3540,0,1,3541,T
5-NP,99,1,3513,0,1,3515,T
5-NP,100,0,3,3513,0,3516,G
5-NP,101,3513,0,3,0,3516,A
5-NP,102,1,3521,0,2,3524,T
5-NP,103,0,5,3526,0,3531,G
5-NP,104,0,3,3615,0,3618,G
5-NP,105,3620,1,2,0,3623,A
5-NP,106,3634,0,1,0,3635,A
5-NP,107,0,3631,0,0,3631,T
5-NP,108,0,3630,0,2,3632,T
5-NP,109,1,6,3644,1,3652,G
5-NP,110,1,4,3644,0,3649,G
5-NP,111,1,3,3646,0,3650,G
5-NP,112,3646,1,2,0,3649,A
5-NP,113,0,1,3647,0,3648,G
5-NP,114,3660,1,4,0,3665,A
5-NP,115,0,3734,1,1,3736,T
5-NP,116,0,3738,1,0,3739,T
5-NP,117,2,1,0,3748,3751,C
5-NP,118,1,3743,0,2,3746,T
5-NP,119,3789,0,5,0,3794,A
5-NP,120,1,2,0,3798,3801,C
5-NP,121,3888,0,1,1,3890,A
5-NP,122,4,3904,0,2,3910,T
5-NP,123,1,1,0,3886,3888,C
5-NP,124,5,2,1,3890,3898,C
5-NP,125,3899,0,1,0,3900,A
5-NP,126,3978,0,1,0,3979,A
5-NP,127,3973,0,1,1,3975,A
5-NP,128,0,3968,1,0,3969,T
5-NP,129,1,1,3974,0,3976,G
5-NP,130,0,3937,0,3,3940,T
5-NP,131,2,1,3964,0,3967,G
5-NP,132,2,3,0,3959,3964,C
5-NP,133,3947,1,3,0,3951,A
5-NP,134,0,0,0,3950,3950,C
5-NP,135,0,3925,0,5,3930,T
5-NP,136,0,4,4094,0,4098,G
5-NP,137,4126,1,2,0,4129,A
5-NP,138,4171,2,3,0,4176,A
5-NP,139,0,1,0,4222,4223,C
5-NP,140,0,4194,0,6,4200,T
5-NP,141,0,4224,0,1,4225,T
5-NP,142,4231,0,0,0,4231,A
5-NP,143,4215,0,6,0,4221,A
5-NP,144,4244,1,7,2,4254,A
5-NP,145,0,1,0,4262,4263,C
5-NP,146,0,4162,0,2,4164,T
5-NP,147,7,0,0,4183,4190,C
5-NP,148,4153,1,6,0,4160,A
5-NP,149,0,0,4218,0,4218,G
5-NP,150,1,4210,1,1,4213,T
5-NP,151,1,3,4241,0,4245,G
5-NP,152,4293,3,0,0,4296,A
5-NP,153,0,4285,0,0,4285,T
5-NP,154,12,4,0,4339,4355,C
5-NP,155,4361,1,2,1,4365,A
5-NP,156,2,4350,0,5,4357,T
5-NP,157,1,3,4356,0,4360,G
5-NP,158,4332,1,6,1,4340,A
5-NP,159,4328,1,7,0,4336,A
5-NP,160,0,6,4321,0,4327,G
5-NP,161,1,4,4295,0,4300,G
5-NP,162,1,1,4294,1,4297,G
5-NP,163,1,4,1,4281,4287,C
5-NP,164,0,4,4300,0,4304,G
5-NP,165,0,0,4316,0,4316,G
5-NP,166,0,4308,0,4,4312,T
5-NP,167,0,4315,0,1,4316,T
5-NP,168,1,1,4322,0,4324,G
5-NP,169,4617,0,5,0,4622,A
5-NP,170,0,4616,0,3,4619,T
5-NP,171,7,3,0,4609,4619,C
5-NP,172,4,1,0,4617,4622,C
5-NP,173,4608,1,3,0,4612,A
5-NP,174,2,8,4612,0,4622,G
5-NP,175,4619,0,4,1,4624,A
5-NP,176,4625,2,1,0,4628,A
5-NP,177,0,2,0,4640,4642,C
5-NP,178,4478,2,2,0,4482,A
5-NP,179,1,1,4523,0,4525,G
5-NP,180,0,1,0,4535,4536,C
5-NP,181,0,4528,0,5,4533,T
5-NP,182,0,4546,0,3,4549,T
5-NP,183,1,5,4552,0,4558,G
5-NP,184,4579,1,8,1,4589,A
5-NP,185,2,1,0,4598,4601,C
5-NP,186,4585,1,4,0,4590,A
5-NP,187,4609,0,2,0,4611,A
5-NP,188,1,4583,0,2,4586,T
5-NP,189,4593,0,3,0,4596,A
5-NP,190,0,1,4609,0,4610,G
5-NP,191,4582,0,6,0,4588,A
5-NP,192,0,4,4616,0,4620,G
5-NP,193,4596,1,0,1,4598,A
5-NP,194,4638,0,4,1,4643,A
5-NP,195,4644,1,3,0,4648,A
5-NP,196,4742,0,1,0,4743,A
5-NP,197,1,4745,0,3,4749,T
5-NP,198,0,6,4753,0,4759,G
5-NP,199,2,1,4755,0,4758,G
5-NP,200,0,4738,1,5,4744,T
5-NP,201,4676,0,2,0,4678,A
5-NP,202,2,1,0,4716,4719,C
5-NP,203,0,4722,0,2,4724,T
5-NP,204,9,0,0,4785,4794,C
5-NP,205,0,4708,0,12,4720,T
5-NP,206,3,1,0,4743,4747,C
5-NP,207,1,4737,0,4,4742,T
5-NP,208,3,0,4773,0,4776,G
5-NP,209,1,2,0,4767,4770,C
5-NP,210,0,4746,0,4,4750,T
5-NP,211,0,4736,1,2,4739,T
5-NP,212,0,4743,0,3,4746,T
5-NP,213,1,4707,0,3,4711,T
5-NP,214,0,2,4735,0,4737,G
5-NP,215,4716,0,7,3,4726,A
5-NP,216,1,4724,0,5,4730,T
5-NP,217,2,4,4720,0,4726,G
5-NP,218,4696,0,6,0,4702,A
5-NP,219,4709,1,2,0,4712,A
5-NP,220,4719,0,8,0,4727,A
5-NP,221,0,2,4729,0,4731,G
5-NP,222,4696,1,40,0,4737,A
5-NP,223,4720,0,5,0,4725,A
5-NP,224,1,4,4760,2,4767,G
5-NP,225,1,5,4894,0,4900,G
5-NP,226,4904,0,7,2,4913,A
5-NP,227,4937,0,2,0,4939,A
5-NP,228,0,4938,0,2,4940,T
5-NP,229,4939,0,3,0,4942,A
5-NP,230,4931,0,3,0,4934,A
5-NP,231,4939,1,5,1,4946,A
5-NP,232,2,4941,0,0,4943,T
5-NP,233,4933,0,5,0,4938,A
5-NP,234,1,1,0,4925,4927,C
5-NP,235,2,1,0,4860,4863,C
5-NP,236,1,4842,0,5,4848,T
5-NP,237,5,2,4852,0,4859,G
5-NP,238,1,3,4904,0,4908,G
5-NP,239,4911,1,1,1,4914,A
5-NP,240,4905,0,2,0,4907,A
5-NP,241,3,5,4944,0,4952,G
5-NP,242,4928,1,8,1,4938,A
5-NP,243,4902,0,5,1,4908,A
5-NP,244,0,3,0,4900,4903,C
5-NP,245,4902,2,5,0,4909,A
5-NP,246,6,0,0,4983,4989,C
5-NP,247,5,0,0,4923,4928,C
5-NP,248,6,0,0,4935,4941,C
5-NP,249,5,1,0,4949,4955,C
5-NP,250,4902,0,8,0,4910,A
5-NP,251,1,1,4912,0,4914,G
5-NP,252,2,1,1,4892,4896,C
5-NP,253,5,2,4902,0,4909,G
5-NP,254,2,1,0,4904,4907,C
5-NP,255,2,6,4856,0,4864,G
5-NP,256,1,4,4897,0,4902,G
5-NP,257,2,3,4898,0,4903,G
5-NP,258,0,2,4928,0,4930,G
5-NP,259,4921,0,1,0,4922,A
5-NP,260,4914,1,6,1,4922,A
5-NP,261,4916,1,13,0,4930,A
5-NP,262,1,1,4932,0,4934,G
5-NP,263,4920,0,6,0,4926,A
5-NP,264,2,4902,1,2,4907,T
5-NP,265,8,2,2,4873,4885,C
5-NP,266,6,0,0,4883,4889,C
5-NP,267,7,1,0,4896,4904,C
5-NP,268,4931,0,0,1,4932,A
5-NP,269,4918,0,1,0,4919,A
5-NP,270,1,4,4940,0,4945,G
5-NP,271,4933,0,1,0,4934,A
5-NP,272,4963,0,3,0,4966,A
5-NP,273,4957,1,0,1,4959,A
5-NP,274,4952,1,4,1,4958,A
5-NP,275,1,1,0,4974,4976,C
5-NP,276,1,4923,0,3,4927,T
5-NP,277,0,5,4925,0,4930,G
5-NP,278,5,7,4914,0,4926,G
5-NP,279,1,5,4902,0,4908,G
5-NP,280,3,9,4915,0,4927,G
5-NP,281,2,2,4911,0,4915,G
5-NP,282,2,5,4963,0,4970,G
5-NP,283,1,0,2,5282,5285,C
5-NP,284,7,4,0,5256,5267,C
5-NP,285,10,2,0,5304,5316,C
5-NP,286,5905,1,0,0,5906,A
5-NP,287,0,5928,0,2,5930,T
5-NP,288,6212,1,2,0,6215,A
5-NP,289,0,6216,0,4,6220,T
5-NP,290,6177,0,5,0,6182,A
5-NP,291,1,1,1,6223,6226,C
5-NP,292,5768,1,6,0,5775,A
5-NP,293,3,3,5856,0,5862,G
5-NP,294,3,5,5845,0,5853,G
5-NP,295,5337,1,0,0,5338,A
5-NP,296,0,10,5374,0,5384,G
5-NP,297,5133,0,9,1,5143,A
5-NP,298,1,1,5189,0,5191,G
5-NP,299,2,5177,1,2,5182,T
5-NP,300,5141,0,1,2,5144,A
5-NP,301,2,1,5163,0,5166,G
5-NP,302,5091,1,7,0,5099,A
5-NP,303,0,5088,0,3,5091,T
5-NP,304,0,1,5090,0,5091,G
5-NP,305,1,3,5119,1,5124,G
5-NP,306,5106,0,5,0,5111,A
5-NP,307,5084,1,2,0,5087,A
5-NP,308,5084,1,2,0,5087,A
5-NP,309,5100,0,6,0,5106,A
5-NP,310,0,5091,2,1,5094,T
5-NP,311,1,7,5125,2,5135,G
5-NP,312,0,3,5134,0,5137,G
5-NP,313,5129,1,5,0,5135,A
5-NP,314,0,5091,0,1,5092,T
5-NP,315,1,5,5099,0,5105,G
5-NP,316,5097,0,9,0,5106,A
5-NP,317,1,5,5112,0,5118,G
5-NP,318,2,5,5106,0,5113,G
5-NP,319,4,4,5102,2,5112,G
5-NP,320,5112,0,9,1,5122,A
5-NP,321,5116,1,7,0,5124,A
5-NP,322,2,1,0,5131,5134,C
5-NP,323,0,5113,1,6,5120,T
5-NP,324,5,2,0,5124,5131,C
5-NP,325,3,1,5135,1,5140,G
5-NP,326,0,5137,0,7,5144,T
5-NP,327,3,0,0,5125,5128,C
5-NP,328,2,1,0,5270,5273,C
5-NP,329,0,5237,1,7,5245,T
5-NP,330,2,5255,0,3,5260,T
5-NP,331,1,5246,0,2,5249,T
5-NP,332,5265,1,1,0,5267,A
5-NP,333,1,5258,0,3,5262,T
5-NP,334,2,3,5253,0,5258,G
5-NP,335,5261,2,5,0,5268,A
5-NP,336,1,1,0,5268,5270,C
5-NP,337,5169,1,1,0,5171,A
5-NP,338,5161,1,1,2,5165,A
5-NP,339,5171,1,6,0,5178,A
5-NP,340,2,3,5294,0,5299,G
5-NP,341,5271,0,5,1,5277,A
5-NP,342,5275,0,9,1,5285,A
5-NP,343,2,2,5392,0,5396,G
5-NP,344,5388,0,4,0,5392,A
5-NP,345,5381,0,10,0,5391,A
5-NP,346,5399,3,2,0,5404,A
5-NP,347,0,5393,1,0,5394,T
5-NP,348,5377,0,5,0,5382,A
5-NP,349,5304,1,5,0,5310,A
5-NP,350,0,8,5332,0,5340,G
5-NP,351,0,0,5330,1,5331,G
5-NP,352,1,3,0,5271,5275,C
5-NP,353,2,3,5270,0,5275,G
5-NP,354,5269,3,5,0,5277,A
5-NP,355,5300,0,0,2,5302,A
5-NP,356,0,5294,0,2,5296,T
5-NP,357,0,2,0,5310,5312,C
5-NP,358,0,5300,0,3,5303,T
5-NP,359,2,3,5268,0,5273,G
5-NP,360,5,2,5266,0,5273,G
5-NP,361,1,1,1,5275,5278,C
5-NP,362,3,1,5272,0,5276,G
5-NP,363,3,2,0,5265,5270,C
5-NP,364,6,1,0,5253,5260,C
5-NP,365,5280,1,1,0,5282,A
5-NP,366,5312,0,4,0,5316,A
5-NP,367,1,0,5376,0,5377,G
5-NP,368,3,6,0,5357,5366,C
5-NP,369,6,0,0,5378,5384,C
5-NP,370,5391,0,7,0,5398,A
5-NP,371,5435,1,7,1,5444,A
5-NP,372,2,2,0,5450,5454,C
5-NP,373,5452,1,3,1,5457,A
5-NP,374,5504,0,2,0,5506,A
5-NP,375,0,5499,0,2,5501,T
5-NP,376,0,8,5523,0,5531,G
5-NP,377,1,0,5539,0,5540,G
5-NP,378,1,5469,0,4,5474,T
5-NP,379,0,6,5467,0,5473,G
5-NP,380,5434,0,10,0,5444,A
5-NP,381,1,7,5501,0,5509,G
5-NP,382,0,5,5509,0,5514,G
5-NP,383,5526,2,2,0,5530,A
5-NP,384,2,5707,0,3,5712,T
5-NP,385,3,2,5713,1,5719,G
5-NP,386,2,5,0,5713,5720,C
5-NP,387,0,5718,0,6,5724,T
5-NP,388,5734,1,2,0,5737,A
5-NP,389,1,1,0,5787,5789,C
5-NP,390,5689,1,2,0,5692,A
5-NP,391,0,5668,0,9,5677,T
5-NP,392,4,1,1,5646,5652,C
5-NP,393,2,5444,0,5,5451,T
5-NP,394,2,7,5552,0,5561,G
5-NP,395,2,1,5654,0,5657,G
5-NP,396,0,5642,0,9,5651,T
5-NP,397,12,1,0,5627,5640,C
5-NP,398,0,5575,0,10,5585,T
5-NP,399,5617,0,4,0,5621,A
5-NP,400,5623,1,1,0,5625,A
5-NP,401,0,0,0,5659,5659,C
5-NP,402,2,5622,0,13,5637,T
5-NP,403,5,1,0,5638,5644,C
5-NP,404,5552,0,2,0,5554,A
5-NP,405,1,1,0,5715,5717,C
5-NP,406,5715,1,3,0,5719,A
5-NP,407,1,5725,1,1,5728,T
5-NP,408,5669,0,6,1,5676,A
5-NP,409,5692,1,5,0,5698,A
5-NP,410,2,5720,0,4,5726,T
5-NP,411,0,5,5762,0,5767,G
5-NP,412,5713,0,2,0,5715,A
5-NP,413,2,5655,0,6,5663,T
5-NP,414,2,5525,1,1,5529,T
5-NP,415,1,5529,0,6,5536,T
5-NP,416,3,9,5512,0,5524,G
5-NP,417,3,4,5522,0,5529,G
5-NP,418,2,2,0,5509,5513,C
5-NP,419,5494,0,3,0,5497,A
5-NP,420,0,5468,0,4,5472,T
5-NP,421,1,5464,0,6,5471,T
5-NP,422,3,2,0,5468,5473,C
5-NP,423,6,1,0,5457,5464,C
5-NP,424,5534,0,1,0,5535,A
5-NP,425,5543,1,3,0,5547,A
5-NP,426,0,5523,1,1,5525,T
5-NP,427,1,5526,0,1,5528,T
5-NP,428,0,5533,0,0,5533,T
5-NP,429,1,9,5560,1,5571,G
5-NP,430,5559,1,7,0,5567,A
5-NP,431,5569,1,1,0,5571,A
5-NP,432,3,5552,0,10,5565,T
5-NP,433,0,7,5511,1,5519,G
5-NP,434,5625,0,6,0,5631,A
5-NP,435,0,5634,1,3,5638,T
5-NP,436,1,1,5658,0,5660,G
5-NP,437,3,1,0,5758,5762,C
5-NP,438,5735,1,9,0,5745,A
5-NP,439,5925,1,9,0,5935,A
5-NP,440,2,0,0,5935,5937,C
5-NP,441,5987,0,1,0,5988,A
5-NP,442,0,6063,0,6,6069,T
5-NP,443,5962,3,6,0,5971,A
5-NP,444,0,3,0,6038,6041,C
5-NP,445,8,3,0,6017,6028,C
5-NP,446,5879,2,3,1,5885,A
5-NP,447,1,5,5929,0,5935,G
5-NP,448,5789,0,5,0,5794,A
5-NP,449,0,2,5901,0,5903,G
5-NP,450,1,7,5848,0,5856,G
5-NP,451,5780,1,8,0,5789,A
5-NP,452,1,6,0,5826,5833,C
5-NP,453,5751,0,5,0,5756,A
5-NP,454,5747,1,2,0,5750,A
5-NP,455,0,3,5769,0,5772,G
5-NP,456,5700,1,5,0,5706,A
5-NP,457,3,1,5749,1,5754,G
5-NP,458,0,2,0,5691,5693,C
5-NP,459,2,5632,0,13,5647,T
5-NP,460,3,0,0,5672,5675,C
5-NP,461,1,5637,0,5,5643,T
5-NP,462,2,5664,0,3,5669,T
5-NP,463,1,2,5684,0,5687,G
5-NP,464,2,5648,0,2,5652,T
5-NP,465,0,5653,1,4,5658,T
5-NP,466,7,1,1,5614,5623,C
5-NP,467,2,3,5597,0,5602,G
5-NP,468,5660,3,5,3,5671,A
5-NP,469,5671,2,1,1,5675,A
5-NP,470,0,0,0,5698,5698,C
5-NP,471,0,5684,0,6,5690,T
5-NP,472,3,3,5745,0,5751,G
5-NP,473,2,6,5771,0,5779,G
5-NP,474,5773,3,6,0,5782,A
5-NP,475,5782,1,5,1,5789,A
5-NP,476,1,5767,0,1,5769,T
5-NP,477,1,5,5753,0,5759,G
5-NP,478,2,4,5758,0,5764,G
5-NP,479,5774,0,6,0,5780,A
5-NP,480,5,5802,0,6,5813,T
5-NP,481,4,0,0,5770,5774,C
5-NP,482,8,3,0,5755,5766,C
5-NP,483,4,2,1,5777,5784,C
5-NP,484,5825,0,5,1,5831,A
5-NP,485,4,5,5856,1,5866,G
5-NP,486,5847,0,2,0,5849,A
5-NP,487,5837,2,2,2,5843,A
5-NP,488,0,5784,0,0,5784,T
5-NP,489,2,1,5822,0,5825,G
5-NP,490,2,5776,0,11,5789,T
5-NP,491,2,4,5799,0,5805,G
5-NP,492,0,2,0,5805,5807,C
5-NP,493,1,5749,0,13,5763,T
5-NP,494,9,0,0,6032,6041,C
5-NP,495,0,5997,1,4,6002,T
5-NP,496,7,0,1,6165,6173,C
5-NP,497,3,6149,1,8,6161,T
5-NP,498,3,1,6144,1,6149,G
5-NP,499,6157,1,8,0,6166,A
5-NP,500,2,6132,0,2,6136,T
5-NP,501,3,0,6131,1,6135,G
5-NP,502,2,2,0,6129,6133,C
5-NP,503,5904,1,6,0,5911,A
5-NP,504,3,8,6022,1,6034,G
5-NP,505,6,3,5935,1,5945,G
5-NP,506,1,0,5999,0,6000,G
5-NP,507,2,1,0,5978,5981,C
5-NP,508,0,5956,0,3,5959,T
5-NP,509,7,2,0,5957,5966,C
5-NP,510,3,6,5968,0,5977,G
5-NP,511,6009,3,11,0,6023,A
5-NP,512,0,2,0,6021,6023,C
5-NP,513,1,5898,0,9,5908,T
5-NP,514,5,1,0,6100,6106,C
5-NP,515,1,6044,0,10,6055,T
5-NP,516,4,1,0,6595,6600,C
5-NP,517,6,0,0,6608,6614,C
5-NP,518,7,5,0,6587,6599,C
5-NP,519,0,6582,0,11,6593,T
5-NP,520,6555,0,2,0,6557,A
5-NP,521,1,2,6568,0,6571,G
5-NP,522,6555,1,1,0,6557,A
5-NP,523,6383,2,9,1,6395,A
5-NP,524,1,5,6395,0,6401,G
5-NP,525,2,0,6228,0,6230,G
5-NP,526,3,6147,0,4,6154,T
5-NP,527,7,0,0,6147,6154,C
5-NP,528,4,2,0,6157,6163,C
5-NP,529,5,5,6154,2,6166,G
5-NP,530,3,8,6206,0,6217,G
5-NP,531,6189,1,7,0,6197,A
5-NP,532,1,2,6264,0,6267,G
5-NP,533,1,1,0,6270,6272,C
5-NP,534,3,6165,0,11,6179,T
5-NP,535,3,1,6172,0,6176,G
5-NP,536,2,4,0,6190,6196,C
5-NP,537,6176,4,12,1,6193,A
5-NP,538,1,5,6210,0,6216,G
5-NP,539,2,0,6219,0,6221,G
5-NP,540,1,6216,0,5,6222,T
5-NP,541,2,3,6168,0,6173,G
5-NP,542,0,1,1,6197,6199,C
5-NP,543,1,6168,0,9,6178,T
5-NP,544,1,2,6180,0,6183,G
5-NP,545,2,4,1,6177,6184,C
5-NP,546,6254,1,2,0,6257,A
5-NP,547,0,0,6354,0,6354,G
5-NP,548,2,6290,1,6,6299,T
5-NP,549,13,2,0,6307,6322,C
5-NP,550,6303,2,3,1,6309,A
5-NP,551,6311,0,8,1,6320,A
5-NP,552,6289,1,12,2,6304,A
5-NP,553,1,6,6323,0,6330,G
5-NP,554,0,9,6348,0,6357,G
5-NP,555,6343,0,4,0,6347,A
5-NP,556,6306,1,4,1,6312,A
5-NP,557,1,6301,1,1,6304,T
5-NP,558,8,4,0,6278,6290,C
5-NP,559,4,8,6284,0,6296,G
5-NP,560,0,5,6473,3,6481,G
5-NP,561,5,8,6482,1,6496,G
5-NP,562,6471,3,6,0,6480,A
5-NP,563,3,2,0,6472,6477,C
5-NP,564,6423,0,1,1,6425,A
5-NP,565,6509,1,8,0,6518,A
5-NP,566,0,6517,1,5,6523,T
5-NP,567,0,8,6555,0,6563,G
5-NP,568,1,2,6606,1,6610,G
5-NP,569,3,6447,1,6,6457,T
5-NP,570,1,7,6466,0,6474,G
5-NP,571,6462,4,10,0,6476,A
5-NP,572,0,6452,0,6,6458,T
5-NP,573,5,5,6458,0,6468,G
5-NP,574,1,9,6597,0,6607,G
5-NP,575,6585,1,8,1,6595,A
5-NP,576,6580,2,5,1,6588,A
5-NP,577,0,3,1,6545,6549,C
5-NP,578,0,6474,0,1,6475,T
5-NP,579,6449,2,3,2,6456,A
5-NP,580,6713,0,4,1,6718,A
5-NP,581,3,6719,0,1,6723,T
5-NP,582,4,1,0,6722,6727,C
5-NP,583,6539,1,1,2,6543,A
5-NP,584,1,11,6609,0,6621,G
5-NP,585,6600,1,5,0,6606,A
5-NP,586,6598,1,3,0,6602,A
5-NP,587,2,6601,0,1,6604,T
5-NP,588,0,10,6522,1,6533,G
5-NP,589,3,4,6580,1,6588,G
5-NP,590,2,6582,0,9,6593,T
5-NP,591,13,1,0,6584,6598,C
5-NP,592,6594,0,2,1,6597,A
5-NP,593,6566,0,1,0,6567,A
5-NP,594,6568,0,5,1,6574,A
5-NP,595,2,7,0,6558,6567,C
5-NP,596,2,8,6536,0,6546,G
5-NP,597,4,9,6544,0,6557,G
5-NP,598,5,8,6458,0,6471,G
5-NP,599,1,9,6499,1,6510,G
5-NP,600,7,5,6493,2,6507,G
5-NP,601,6493,0,11,0,6504,A
5-NP,602,1,6464,1,7,6473,T
5-NP,603,6,5,2,6449,6462,C
5-NP,604,6481,5,6,2,6494,A
5-NP,605,6488,1,9,0,6498,A
5-NP,606,1,1,0,6461,6463,C
5-NP,607,0,3,6452,0,6455,G
5-NP,608,6437,4,1,0,6442,A
5-NP,609,1,6427,0,0,6428,T
5-NP,610,7,2,0,6425,6434,C
5-NP,611,0,7,6438,0,6445,G
5-NP,612,6445,2,0,0,6447,A
5-NP,613,6429,0,4,1,6434,A
5-NP,614,6422,0,4,1,6427,A
5-NP,615,1,6512,0,0,6513,T
5-NP,616,1,6502,0,2,6505,T
5-NP,617,0,6474,2,1,6477,T
5-NP,618,0,6520,0,2,6522,T
5-NP,619,0,6525,0,2,6527,T
5-NP,620,1,6,6536,2,6545,G
5-NP,621,2,2,6544,0,6548,G
5-NP,622,6510,0,9,0,6519,A
5-NP,623,2,4,6537,0,6543,G
5-NP,624,6451,0,2,0,6453,A
5-NP,625,4,10,6681,0,6695,G
5-NP,626,0,0,6701,0,6701,G
5-NP,627,2,6683,0,8,6693,T
5-NP,628,3,10,6695,0,6708,G
5-NP,629,6704,2,13,0,6719,A
5-NP,630,3,7,6748,0,6758,G
5-NP,631,6737,1,10,0,6748,A
5-NP,632,6737,0,4,0,6741,A
5-NP,633,0,6729,0,5,6734,T
5-NP,634,0,4,6553,1,6558,G
5-NP,635,3,1,6528,0,6532,G
5-NP,636,6469,1,19,0,6489,A
5-NP,637,1,3,1,6510,6515,C
5-NP,638,1,5,6513,0,6519,G
5-NP,639,1,5,6602,0,6608,G
5-NP,640,6590,1,2,1,6594,A
5-NP,641,6605,1,3,1,6610,A
5-NP,642,6646,0,6,1,6653,A
5-NP,643,6660,1,12,4,6677,A
5-NP,644,1,2,0,6729,6732,C
5-NP,645,6719,0,6,1,6726,A
5-NP,646,6707,2,3,2,6714,A
5-NP,647,1,3,6715,1,6720,G
5-NP,648,6517,2,9,0,6528,A
5-NP,649,6545,1,4,1,6551,A
5-NP,650,2,0,6696,0,6698,G
5-NP,651,2,6681,0,2,6685,T
5-NP,652,3,5,6968,0,6976,G
5-NP,653,1,2,0,6921,6924,C
5-NP,654,1,6906,0,20,6927,T
5-NP,655,0,6942,0,7,6949,T
5-NP,656,7006,0,3,2,7011,A
5-NP,657,2,7017,1,2,7022,T
5-NP,658,2,11,7015,1,7029,G
5-NP,659,6859,2,9,0,6870,A
5-NP,660,6,5,6870,0,6881,G
5-NP,661,6531,2,9,0,6542,A
5-NP,662,0,5,6569,0,6574,G
5-NP,663,6539,0,5,1,6545,A
5-NP,664,6586,0,1,1,6588,A
5-NP,665,0,6549,0,2,6551,T
5-NP,666,1,2,6606,1,6610,G
5-NP,667,0,6574,0,8,6582,T
5-NP,668,3,3,6589,0,6595,G
5-NP,669,1,3,1,6579,6584,C
5-NP,670,6570,0,5,1,6576,A
5-NP,671,6552,3,11,1,6567,A
5-NP,672,2,0,0,6550,6552,C
5-NP,673,6491,0,4,1,6496,A
5-NP,674,0,6500,1,0,6501,T
5-NP,675,0,6440,0,4,6444,T
5-NP,676,5,3,0,6475,6483,C
5-NP,677,3,6450,0,3,6456,T
5-NP,678,3,6445,0,5,6453,T
5-NP,679,6465,0,2,0,6467,A
5-NP,680,6444,1,3,2,6450,A
5-NP,681,6445,1,3,1,6450,A
5-NP,682,0,2,6450,0,6452,G
5-NP,683,0,5,6443,0,6448,G
5-NP,684,6408,1,11,1,6421,A
5-NP,685,6406,1,1,0,6408,A
5-NP,686,6393,1,4,1,6399,A
5-NP,687,6486,0,8,2,6496,A
5-NP,688,2,6480,0,4,6486,T
5-NP,689,2,6474,0,0,6476,T
5-NP,690,2,6500,0,2,6504,T
5-NP,691,5,1,1,6494,6501,C
5-NP,692,6509,0,7,1,6517,A
5-NP,693,6508,2,5,0,6515,A
5-NP,694,6511,3,3,1,6518,A
5-NP,695,4,0,0,6589,6593,C
5-NP,696,5530,1,969,0,6500,A
5-NP,697,0,2,6597,0,6599,G
5-NP,698,4,0,0,6592,6596,C
5-NP,699,4,6590,0,5,6599,T
5-NP,700,4,3,6669,1,6677,G
5-NP,701,2,1,0,6635,6638,C
5-NP,702,6660,2,11,3,6676,A
5-NP,703,2,0,0,6673,6675,C
5-NP,704,6605,0,2,0,6607,A
5-NP,705,6611,1,3,0,6615,A
5-NP,706,6503,2,4,1,6510,A
5-NP,707,1,5,6715,0,6721,G
5-NP,708,6677,0,16,0,6693,A
5-NP,709,1,0,6726,0,6727,G
5-NP,710,3,4,0,6671,6678,C
5-NP,711,6674,0,4,0,6678,A
5-NP,712,6782,0,7,2,6791,A
5-NP,713,0,6784,0,2,6786,T
5-NP,714,3,7,6775,1,6786,G
5-NP,715,7,2,6800,0,6809,G
5-NP,716,3,6580,0,12,6595,T
5-NP,717,7,8,6566,0,6581,G
5-NP,718,0,7,6612,0,6619,G
5-NP,719,6601,0,10,0,6611,A
5-NP,720,3,6581,1,7,6592,T
5-NP,721,7,1,1,6478,6487,C
5-NP,722,6499,2,3,0,6504,A
5-NP,723,6521,2,4,0,6527,A
5-NP,724,3,1,6543,0,6547,G
5-NP,725,2,6505,0,5,6512,T
5-NP,726,2,12,6503,0,6517,G
5-NP,727,6426,3,8,0,6437,A
5-NP,728,0,6,6465,0,6471,G
5-NP,729,6458,1,5,0,6464,A
5-NP,730,2,5,6461,0,6468,G
5-NP,731,6429,1,4,0,6434,A
5-NP,732,6369,0,1,0,6370,A
5-NP,733,6383,1,4,0,6388,A
5-NP,734,1,0,6424,0,6425,G
5-NP,735,1,6405,0,2,6408,T
5-NP,736,15,0,0,6384,6399,C
5-NP,737,1,9,6367,1,6378,G
5-NP,738,2,13,6374,0,6389,G
5-NP,739,6392,0,4,0,6396,A
5-NP,740,6420,1,3,0,6424,A
5-NP,741,3,1,1,6411,6416,C
5-NP,742,7,3,1,6353,6364,C
5-NP,743,9,1,0,6381,6391,C
5-NP,744,6376,0,1,1,6378,A
5-NP,745,1,4,6383,1,6389,G
5-NP,746,2,3,6400,0,6405,G
5-NP,747,6371,1,1,3,6376,A
5-NP,748,6374,0,0,0,6374,A
5-NP,749,6354,1,5,1,6361,A
5-NP,750,1,4,0,6362,6367,C
5-NP,751,1,0,6363,0,6364,G
5-NP,752,1,2,0,6348,6351,C
5-NP,753,1,6338,1,5,6345,T
5-NP,754,3,11,6335,0,6349,G
5-NP,755,6325,0,2,1,6328,A
5-NP,756,1,5,6401,0,6407,G
5-NP,757,6403,1,3,0,6407,A
5-NP,758,0,6400,0,0,6400,T
5-NP,759,7,5,0,6334,6346,C
5-NP,760,11,5,6345,1,6362,G
5-NP,761,6357,3,1,2,6363,A
5-NP,762,6349,1,6,0,6356,A
5-NP,763,1,1,6378,0,6380,G
5-NP,764,6392,0,4,0,6396,A
5-NP,765,0,6335,0,4,6339,T
5-NP,766,3,2,1,6355,6361,C
5-NP,767,0,6357,0,8,6365,T
5-NP,768,9,5,1,6376,6391,C
5-NP,769,6398,2,2,0,6402,A
5-NP,770,0,6396,0,1,6397,T
5-NP,771,6405,0,0,0,6405,A
5-NP,772,0,6376,1,1,6378,T
5-NP,773,0,6348,2,1,6351,T
5-NP,774,0,6325,4,5,6334,T
5-NP,775,0,6244,1,3,6248,T
5-NP,776,0,6260,2,1,6263,T
5-NP,777,6252,0,2,0,6254,A
5-NP,778,2,1,6251,0,6254,G
5-NP,779,1,10,2,6245,6258,C
5-NP,780,6222,1,2,1,6226,A
5-NP,781,6219,1,2,0,6222,A
5-NP,782,0,9,6347,0,6356,G
5-NP,783,6343,1,4,1,6349,A
5-NP,784,2,6346,0,3,6351,T
5-NP,785,3,3,1,6373,6380,C
5-NP,786,3,6336,0,8,6347,T
5-NP,787,3,3,6468,0,6474,G
5-NP,788,3,4,0,6471,6478,C
5-NP,789,6482,1,2,0,6485,A
5-NP,790,1,6525,0,0,6526,T
5-NP,791,0,6317,2,5,6324,T
5-NP,792,4,3,6615,2,6624,G
5-NP,793,6673,3,4,1,6681,A
5-NP,794,1,6670,1,3,6675,T
5-NP,795,6681,1,5,1,6688,A
5-NP,796,2,6523,0,4,6529,T
5-NP,797,1,6461,0,4,6466,T
5-NP,798,2,10,6488,0,6500,G
5-NP,799,6418,0,7,0,6425,A
5-NP,800,1,5,6454,0,6460,G
5-NP,801,6069,1,10,1,6081,A
5-NP,802,0,5,6005,0,6010,G
5-NP,803,4,8,6021,0,6033,G
5-NP,804,6016,3,3,0,6022,A
5-NP,805,2,6011,0,7,6020,T
5-NP,806,5,1,0,6029,6035,C
5-NP,807,5986,0,5,1,5992,A
5-NP,808,1,0,6011,0,6012,G
5-NP,809,1,5978,0,3,5982,T
5-NP,810,0,5944,0,2,5946,T
5-NP,811,3,1,5941,1,5946,G
5-NP,812,1,1,0,5849,5851,C
5-NP,813,0,5857,0,5,5862,T
5-NP,814,7,2,1,5873,5883,C
5-NP,815,5894,3,3,1,5901,A
5-NP,816,0,2,0,5884,5886,C
5-NP,817,5878,0,1,0,5879,A
5-NP,818,5905,0,1,1,5907,A
5-NP,819,5911,0,0,0,5911,A
5-NP,820,0,5903,0,3,5906,T
5-NP,821,6,1,0,5896,5903,C
5-NP,822,3,5865,0,9,5877,T
5-NP,823,0,5851,0,1,5852,T
5-NP,824,3,2,5864,0,5869,G
5-NP,825,2,4,0,5860,5866,C
5-NP,826,4,1,0,5921,5926,C
5-NP,827,2,5886,0,6,5894,T
5-NP,828,5905,1,2,0,5908,A
5-NP,829,2,0,0,5885,5887,C
5-NP,830,5,1,0,5891,5897,C
5-NP,831,2,5860,0,7,5869,T
5-NP,832,5,5,5922,0,5932,G
5-NP,833,5,3,0,5912,5920,C
5-NP,834,6,2,1,5900,5909,C
5-NP,835,2,5796,0,6,5804,T
5-NP,836,7,1,5837,1,5846,G
5-NP,837,1,5818,0,3,5822,T
5-NP,838,2,1,5845,0,5848,G
5-NP,839,3,4,0,5849,5856,C
5-NP,840,6,1,5926,0,5933,G
5-NP,841,1,5829,0,3,5833,T
5-NP,842,5821,1,3,1,5826,A
5-NP,843,1,5815,2,4,5822,T
5-NP,844,5,8,5809,0,5822,G
5-NP,845,2,8,5922,2,5934,G
5-NP,846,5893,2,2,2,5899,A
5-NP,847,2,1,0,5819,5822,C
5-NP,848,4,1,2,5790,5797,C
5-NP,849,0,5676,1,7,5684,T
5-NP,850,2,2,5896,0,5900,G
5-NP,851,0,0,4,5898,5902,C
5-NP,852,5897,1,10,0,5908,A
5-NP,853,4,2,5959,0,5965,G
5-NP,854,4,5627,0,1,5632,T
5-NP,855,5771,1,3,0,5775,A
5-NP,856,1,5758,0,5,5764,T
5-NP,857,5,0,1,5725,5731,C
5-NP,858,8,2,0,5731,5741,C
5-NP,859,5380,0,4,1,5385,A
5-NP,860,3,1,5393,0,5397,G
5-NP,861,0,5366,0,3,5369,T
5-NP,862,2,10,5373,0,5385,G
5-NP,863,1,5,5362,0,5368,G
5-NP,864,3,4,5250,0,5257,G
5-NP,865,1,5236,0,6,5243,T
5-NP,866,5212,0,5,0,5217,A
5-NP,867,1,7,2,5201,5211,C
5-NP,868,2,9,5190,1,5202,G
5-NP,869,5165,2,5,0,5172,A
5-NP,870,1,0,0,5164,5165,C
5-NP,871,1,5004,0,1,5006,T
5-NP,872,0,4994,0,0,4994,T
5-NP,873,1,3,0,4972,4976,C
5-NP,874,2,2,4973,0,4977,G
5-NP,875,4975,0,3,0,4978,A
5-NP,876,4971,2,0,1,4974,A
5-NP,877,4986,0,1,0,4987,A
5-NP,878,4972,1,1,0,4974,A
5-NP,879,4943,1,10,0,4954,A
5-NP,880,0,4,4976,0,4980,G
5-NP,881,4938,0,12,0,4950,A
5-NP,882,1,7,4978,1,4987,G
5-NP,883,1,5,4982,0,4988,G
5-NP,884,3,4,4999,0,5006,G
5-NP,885,4994,1,9,0,5004,A
5-NP,886,0,4999,0,2,5001,T
5-NP,887,5005,1,6,0,5012,A
5-NP,888,0,4987,1,5,4993,T
5-NP,889,3,4968,1,1,4973,T
5-NP,890,0,1,1,4998,5000,C
5-NP,891,5,3,1,4929,4938,C
5-NP,892,0,4821,0,4,4825,T
5-NP,893,1,4818,1,1,4821,T
5-NP,894,3,3,4826,0,4832,G
5-NP,895,2,0,4838,0,4840,G
5-NP,896,2,4803,0,3,4808,T
5-NP,897,2,8,4776,0,4786,G
5-NP,898,3,2,4722,2,4729,G
5-NP,899,1,4,4834,0,4839,G
5-NP,900,4840,2,2,0,4844,A
5-NP,901,4844,1,0,0,4845,A
5-NP,902,1,4835,1,3,4840,T
5-NP,903,4759,0,2,0,4761,A
5-NP,904,0,2,4760,0,4762,G
5-NP,905,4717,2,10,0,4729,A
5-NP,906,0,0,0,4706,4706,C
5-NP,907,4,2,0,4655,4661,C
5-NP,908,11,1,0,4347,4359,C
5-NP,909,0,4364,1,5,4370,T
5-NP,910,1,4372,0,0,4373,T
5-NP,911,0,4364,1,6,4371,T
5-NP,912,7,2,1,4369,4379,C
5-NP,913,4363,0,1,0,4364,A
5-NP,914,4365,0,0,2,4367,A
5-NP,915,4355,0,0,1,4356,A
5-NP,916,0,0,0,4362,4362,C
5-NP,917,0,4205,0,1,4206,T
5-NP,918,4152,0,1,0,4153,A
5-NP,919,2,0,0,4183,4185,C
5-NP,920,0,4162,0,7,4169,T
5-NP,921,0,4170,1,3,4174,T
5-NP,922,4,1,1,4176,4182,C
5-NP,923,4161,0,1,1,4163,A
5-NP,924,4160,2,0,0,4162,A
5-NP,925,4136,0,0,0,4136,A
5-NP,926,4128,1,3,0,4132,A
5-NP,927,0,4082,0,0,4082,T
5-NP,928,3962,0,3,0,3965,A
5-NP,929,4,2,3997,0,4003,G
5-NP,930,1,0,0,4006,4007,C
5-NP,931,6,2,0,4026,4034,C
5-NP,932,4035,2,1,1,4039,A
5-NP,933,4043,2,0,0,4045,A
5-NP,934,4099,0,6,1,4106,A
5-NP,935,1,4116,0,2,4119,T
5-NP,936,4125,1,1,1,4128,A
5-NP,937,0,4115,0,4,4119,T
5-NP,938,3993,0,4,0,3997,A
5-NP,939,0,0,0,3998,3998,C
5-NP,940,3811,0,3,0,3814,A
5-NP,941,2,2,3871,0,3875,G
5-NP,942,2,0,0,3848,3850,C
5-NP,943,0,3649,1,5,3655,T
5-NP,944,1,3662,0,3,3666,T
5-NP,945,3645,0,4,1,3650,A
5-NP,946,3650,0,2,0,3652,A
5-NP,947,2,3648,0,0,3650,T
5-NP,948,3,1,0,3645,3649,C
5-NP,949,3418,0,4,0,3422,A
5-NP,950,0,4,3402,0,3406,G
5-NP,951,3397,0,2,0,3399,A
5-NP,952,0,2,0,3406,3408,C
5-NP,953,2,1,0,3358,3361,C
5-NP,954,0,3275,1,3,3279,T
5-NP,955,3298,0,0,0,3298,A
5-NP,956,3295,0,3,0,3298,A
5-NP,957,0,2,0,3300,3302,C
5-NP,958,2,2,3294,0,3298,G
5-NP,959,3194,0,0,0,3194,A
5-NP,960,0,2,3193,1,3196,G
5-NP,961,3128,2,7,0,3137,A
5-NP,962,3145,1,4,0,3150,A
5-NP,963,2,3142,1,1,3146,T
5-NP,964,2,1,2,3095,3100,C
5-NP,965,1,0,0,3098,3099,C
5-NP,966,3023,0,3,0,3026,A
5-NP,967,0,0,3033,0,3033,G
5-NP,968,0,1,0,3030,3031,C
5-NP,969,3039,0,1,0,3040,A
5-NP,970,2,0,0,3040,3042,C
5-NP,971,2973,1,1,0,2975,A
5-NP,972,3,0,0,2976,2979,C
5-NP,973,2971,0,0,0,2971,A
5-NP,974,2963,0,6,0,2969,A
5-NP,975,0,2,2977,0,2979,G
5-NP,976,2912,0,4,0,2916,A
5-NP,977,1,0,2921,0,2922,G
5-NP,978,2,2809,0,1,2812,T
5-NP,979,8,1,0,2786,2795,C
5-NP,980,2766,0,2,0,2768,A
5-NP,981,1,0,2754,0,2755,G
5-NP,982,1,0,0,2747,2748,C
5-NP,983,0,2705,0,1,2706,T
5-NP,984,1,1,2699,0,2701,G
5-NP,985,0,1,2683,1,2685,G
5-NP,986,1,2645,0,1,2647,T
5-NP,987,4,1,2647,0,2652,G
5-NP,988,1,2599,0,2,2602,T
5-NP,989,0,2,2596,0,2598,G
5-NP,990,0,3,2583,1,2587,G
5-NP,991,2550,1,2,0,2553,A
5-NP,992,0,2556,0,3,2559,T
5-NP,993,0,2,2371,0,2373,G
5-NP,994,1,0,2315,0,2316,G
5-NP,995,1,0,1,2296,2298,C
5-NP,996,2230,0,1,1,2232,A
5-NP,997,0,2216,10,2,2228,T
5-NP,998,2,1,2188,0,2191,G
5-NP,999,0,0,0,2205,2205,C
5-NP,1000,2,2,0,2199,2203,C
5-NP,1001,2175,0,0,1,2176,A
5-NP,1002,1,2154,0,3,2158,T
5-NP,1003,2,2092,0,1,2095,T
5-NP,1004,2,0,1,2094,2097,C
5-NP,1005,0,2007,0,0,2007,T
5-NP,1006,1,2,2004,1,2008,G
5-NP,1007,1,0,0,1996,1997,C
5-NP,1008,2,1742,0,2,1746,T
5-NP,1009,1,0,1746,0,1747,G
5-NP,1010,1,0,0,1621,1622,C
5-NP,1011,1619,0,0,0,1619,A
5-NP,1012,0,1617,0,1,1618,T
5-NP,1013,2,1563,0,1,1566,T
5-NP,1014,0,1569,0,0,1569,T
5-NP,1015,1,2,1558,0,1561,G
5-NP,1016,1561,0,1,0,1562,A
5-NP,1017,1556,0,2,0,1558,A
5-NP,1018,0,2,1568,0,1570,G
5-NP,1019,1567,0,0,0,1567,A
5-NP,1020,0,1559,1,0,1560,T
5-NP,1021,0,1559,0,0,1559,T
5-NP,1022,0,1559,0,3,1562,T
5-NP,1023,1561,0,0,0,1561,A
5-NP,1024,1563,1,1,0,1565,A
5-NP,1025,0,2,1562,0,1564,G
5-NP,1026,1567,0,0,0,1567,A
5-NP,1027,0,1556,0,1,1557,T
5-NP,1028,1,1521,0,0,1522,T
5-NP,1029,0,0,1531,0,1531,G
5-NP,1030,0,1526,0,4,1530,T
5-NP,1031,0,1529,0,0,1529,T
5-NP,1032,1527,0,2,0,1529,A
5-NP,1033,1528,0,1,0,1529,A
5-NP,1034,1,0,1531,0,1532,G
5-NP,1035,0,1,0,1529,1530,C
5-NP,1036,1,1491,0,2,1494,T
5-NP,1037,0,1494,0,3,1497,T
5-NP,1038,2,0,0,1490,1492,C
5-NP,1039,1489,0,3,0,1492,A
5-NP,1040,0,1487,1,3,1491,T
5-NP,1041,1,0,1,1488,1490,C
5-NP,1042,1475,1,2,0,1478,A
5-NP,1043,0,0,1479,0,1479,G
5-NP,1044,1453,0,0,0,1453,A
5-NP,1045,0,2,1453,0,1455,G
5-NP,1046,0,1,1448,0,1449,G
5-NP,1047,1,1,1444,1,1447,G
5-NP,1048,1447,1,2,0,1450,A
5-NP,1049,0,2,0,1449,1451,C
5-NP,1050,1447,0,3,0,1450,A
5-NP,1051,1450,0,0,0,1450,A
5-NP,1052,1451,0,1,0,1452,A
5-NP,1053,1444,1,1,0,1446,A
5-NP,1054,0,0,1458,0,1458,G
5-NP,1055,0,1406,0,0,1406,T
5-NP,1056,1392,0,0,0,1392,A
5-NP,1057,0,1383,0,2,1385,T
5-NP,1058,1,0,0,1381,1382,C
5-NP,1059,0,1367,1,1,1369,T
5-NP,1060,0,0,0,1380,1380,C
5-NP,1061,0,1,0,1367,1368,C
5-NP,1062,0,1355,0,0,1355,T
5-NP,1063,3,0,1,1348,1352,C
5-NP,1064,0,3,1346,0,1349,G
5-NP,1065,0,0,1348,0,1348,G
5-NP,1066,0,2,1352,0,1354,G
5-NP,1067,0,1,1348,0,1349,G
5-NP,1068,2,1,1344,0,1347,G
5-NP,1069,1328,0,1,0,1329,A
5-NP,1070,1330,0,0,0,1330,A
5-NP,1071,1331,0,2,0,1333,A
5-NP,1072,1,0,0,1336,1337,C
5-NP,1073,0,1329,0,0,1329,T
5-NP,1074,0,0,1336,0,1336,G
5-NP,1075,0,1325,0,2,1327,T
5-NP,1076,5,2,1,1317,1325,C
5-NP,1077,1332,0,1,0,1333,A
5-NP,1078,1326,2,0,1,1329,A
5-NP,1079,0,0,0,1336,1336,C
5-NP,1080,0,1330,0,1,1331,T
5-NP,1081,1297,0,0,7,1304,A
5-NP,1082,0,2,1305,0,1307,G
5-NP,1083,1289,0,1,0,1290,A
5-NP,1084,0,1,1287,0,1288,G
5-NP,1085,0,2,1281,0,1283,G
5-NP,1086,1227,0,0,0,1227,A
5-NP,1087,0,0,1242,0,1242,G
5-NP,1088,1,1227,1,0,1229,T
5-NP,1089,1229,1,1,0,1231,A
5-NP,1090,0,1,0,1227,1228,C
5-NP,1091,1206,0,0,0,1206,A
5-NP,1092,1206,0,0,0,1206,A
5-NP,1093,1192,0,0,0,1192,A
5-NP,1094,0,1183,0,0,1183,T
5-NP,1095,0,1173,0,0,1173,T
5-NP,1096,0,0,1132,0,1132,G
5-NP,1097,0,0,1,1116,1117,C
5-NP,1098,1,1113,0,2,1116,T
5-NP,1099,1,1112,0,1,1114,T
5-NP,1100,3,0,0,1111,1114,C
5-NP,1101,1113,0,0,0,1113,A
5-NP,1102,1114,0,0,0,1114,A
5-NP,1103,1114,0,1,0,1115,A
5-NP,1104,0,1110,0,0,1110,T
5-NP,1105,0,0,1113,0,1113,G
5-NP,1106,1080,0,2,0,1082,A
5-NP,1107,0,1,1079,1,1081,G
5-NP,1108,1084,0,2,0,1086,A
5-NP,1109,1084,0,1,0,1085,A
5-NP,1110,1,0,0,1081,1082,C
5-NP,1111,1067,0,0,0,1067,A
5-NP,1112,0,1067,0,0,1067,T
5-NP,1113,0,0,1065,0,1065,G
5-NP,1114,0,1,1063,0,1064,G
5-NP,1115,1059,1,1,0,1061,A
5-NP,1116,1,1031,0,1,1033,T
5-NP,1117,1012,0,0,0,1012,A
5-NP,1118,1026,0,2,0,1028,A
5-NP,1119,0,991,1,0,992,T
5-NP,1120,990,0,0,0,990,A
5-NP,1121,0,981,0,1,982,T
5-NP,1122,2,2,875,0,879,G
5-NP,1123,1,0,857,0,858,G
5-NP,1124,0,0,851,0,851,G
5-NP,1125,834,0,0,0,834,A
5-NP,1126,0,834,0,0,834,T
5-NP,1127,2,0,0,610,612,C
5-NP,1128,0,2,610,0,612,G
5-NP,1129,610,0,0,0,610,A
5-NP,1130,0,0,609,0,609,G
5-NP,1131,0,0,0,607,607,C
5-NP,1132,592,0,0,0,592,A
5-NP,1133,1,0,0,595,596,C
5-NP,1134,0,587,0,0,587,T
5-NP,1135,2,0,0,589,591,C
5-NP,1136,0,588,1,0,589,T
5-NP,1137,0,582,0,0,582,T
5-NP,1138,0,0,581,0,581,G
5-NP,1139,574,0,0,0,574,A
5-NP,1140,578,0,0,0,578,A
5-NP,1141,0,0,0,575,575,C
5-NP,1142,0,411,0,1,412,T
5-NP,1143,0,0,411,0,411,G
5-NP,1144,382,0,1,0,383,A
5-NP,1145,1,0,380,0,381,G
5-NP,1146,382,0,0,0,382,A
5-NP,1147,368,0,1,0,369,A
5-NP,1148,0,0,368,0,368,G
5-NP,1149,0,0,0,351,351,C
5-NP,1150,1,1,347,0,349,G
5-NP,1151,0,0,349,0,349,G
5-NP,1152,0,0,324,0,324,G
5-NP,1153,0,316,0,0,316,T
5-NP,1154,301,0,0,0,301,A
5-NP,1155,0,0,0,300,300,C
5-NP,1156,0,212,0,1,213,T
5-NP,1157,0,0,205,0,205,G
5-NP,1158,0,0,199,0,199,G
5-NP,1159,0,0,195,0,195,G
5-NP,1160,0,1,0,188,189,C
5-NP,1161,0,0,0,178,178,C
5-NP,1162,178,0,0,0,178,A
5-NP,1163,0,178,0,0,178,T
5-NP,1164,177,0,1,0,178,A
5-NP,1165,178,0,0,0,178,A
5-NP,1166,0,0,176,0,176,G
5-NP,1167,0,0,179,0,179,G
5-NP,1168,177,0,0,0,177,A
5-NP,1169,0,0,0,176,176,C
5-NP,1170,0,0,0,178,178,C
5-NP,1171,178,0,0,0,178,A
5-NP,1172,0,0,181,0,181,G
5-NP,1173,0,1,180,0,181,G
5-NP,1174,180,0,0,0,180,A
5-NP,1175,0,0,182,0,182,G
5-NP,1176,0,177,0,0,177,T
5-NP,1177,0,0,176,0,176,G
5-NP,1178,0,0,176,0,176,G
5-NP,1179,176,0,0,0,176,A
5-NP,1180,0,0,177,0,177,G
5-NP,1181,0,1,172,0,173,G
5-NP,1182,173,0,0,0,173,A
5-NP,1183,172,0,0,0,172,A
5-NP,1184,174,0,0,0,174,A
5-NP,1185,0,1,0,174,175,C
5-NP,1186,173,0,0,0,173,A
5-NP,1187,0,0,0,174,174,C
5-NP,1188,0,172,0,0,172,T
5-NP,1189,176,0,0,0,176,A
5-NP,1190,176,0,0,0,176,A
5-NP,1191,1,172,0,0,173,T
5-NP,1192,0,1,0,175,176,C
5-NP,1193,176,0,0,0,176,A
5-NP,1194,175,0,0,0,175,A
5-NP,1195,0,0,0,176,176,C
5-NP,1196,170,1,0,0,171,A
5-NP,1197,0,0,171,0,171,G
5-NP,1198,165,0,0,0,165,A
5-NP,1199,1,1,162,0,164,G
5-NP,1200,0,0,167,0,167,G
5-NP,1201,0,0,165,0,165,G
5-NP,1202,0,0,0,162,162,C
5-NP,1203,0,0,0,164,164,C
5-NP,1204,0,159,0,0,159,T
5-NP,1205,0,0,0,160,160,C
5-NP,1206,1,0,0,160,161,C
5-NP,1207,0,0,161,0,161,G
5-NP,1208,0,0,0,161,161,C
5-NP,1209,157,0,0,0,157,A
5-NP,1210,0,0,162,0,162,G
5-NP,1211,0,0,160,0,160,G
5-NP,1212,0,0,0,161,161,C
5-NP,1213,1,0,0,160,161,C
5-NP,1214,158,0,0,0,158,A
5-NP,1215,160,0,0,0,160,A
5-NP,1216,159,0,1,0,160,A
5-NP,1217,0,0,0,159,159,C
5-NP,1218,0,0,0,157,157,C
5-NP,1219,116,0,0,0,116,A
5-NP,1220,0,0,118,0,118,G
5-NP,1221,0,117,0,0,117,T
5-NP,1222,0,0,122,0,122,G
5-NP,1223,0,121,0,0,121,T
5-NP,1224,0,0,121,0,121,G
5-NP,1225,0,0,0,122,122,C
5-NP,1226,122,0,0,0,122,A
5-NP,1227,124,0,0,0,124,A
5-NP,1228,0,0,0,124,124,C
5-NP,1229,1,0,0,122,123,C
5-NP,1230,0,121,0,1,122,T
5-NP,1231,122,0,0,0,122,A
5-NP,1232,0,0,0,122,122,C
5-NP,1233,0,0,122,0,122,G
5-NP,1234,0,120,0,0,120,T
5-NP,1235,0,119,0,1,120,T
5-NP,1236,0,119,0,0,119,T
5-NP,1237,0,119,0,0,119,T
5-NP,1238,0,0,0,118,118,C
5-NP,1239,0,114,0,1,115,T
5-NP,1240,0,0,120,0,120,G
5-NP,1241,0,120,0,0,120,T
5-NP,1242,120,0,0,0,120,A
5-NP,1243,0,0,0,120,120,C
5-NP,1244,118,0,0,0,118,A
5-NP,1245,118,0,0,0,118,A
5-NP,1246,118,0,0,0,118,A
5-NP,1247,0,0,118,0,118,G
5-NP,1248,117,0,0,0,117,A
5-NP,1249,115,0,0,0,115,A
5-NP,1250,114,0,1,0,115,A
5-NP,1251,0,0,0,115,115,C
5-NP,1252,0,0,0,113,113,C
5-NP,1253,0,113,0,0,113,T
5-NP,1254,0,0,0,111,111,C
5-NP,1255,0,0,0,112,112,C
5-NP,1256,0,0,0,112,112,C
5-NP,1257,111,0,0,0,111,A
5-NP,1258,0,110,0,0,110,T
5-NP,1259,0,110,0,0,110,T
5-NP,1260,0,111,0,0,111,T
5-NP,1261,0,0,111,0,111,G
5-NP,1262,111,0,0,0,111,A
5-NP,1263,111,0,0,0,111,A
5-NP,1264,111,0,0,0,111,A
5-NP,1265,111,0,0,0,111,A
5-NP,1266,0,0,114,0,114,G
5-NP,1267,0,114,0,0,114,T
5-NP,1268,0,0,0,114,114,C
5-NP,1269,114,0,0,0,114,A
5-NP,1270,114,0,0,0,114,A
5-NP,1271,0,0,0,117,117,C
5-NP,1272,0,0,0,116,116,C
5-NP,1273,117,0,0,0,117,A
5-NP,1274,0,117,0,0,117,T
5-NP,1275,0,0,0,117,117,C
5-NP,1276,116,0,1,0,117,A
5-NP,1277,0,117,0,0,117,T
5-NP,1278,0,0,116,0,116,G
5-NP,1279,0,0,117,0,117,G
5-NP,1280,0,0,0,117,117,C
5-NP,1281,111,0,0,0,111,A
5-NP,1282,0,0,111,0,111,G
5-NP,1283,0,0,0,109,109,C
5-NP,1284,109,0,0,0,109,A
5-NP,1285,0,110,0,0,110,T
5-NP,1286,1,106,0,1,108,T
5-NP,1287,0,0,0,109,109,C
5-NP,1288,108,0,0,0,108,A
5-NP,1289,0,0,0,109,109,C
5-NP,1290,0,108,0,0,108,T
5-NP,1291,0,0,110,0,110,G
5-NP,1292,0,0,112,0,112,G
5-NP,1293,112,0,0,0,112,A
5-NP,1294,111,0,0,0,111,A
5-NP,1295,111,0,0,0,111,A
5-NP,1296,0,110,0,0,110,T
5-NP,1297,110,0,0,0,110,A
5-NP,1298,0,0,0,109,109,C
5-NP,1299,0,0,104,0,104,G
5-NP,1300,0,0,104,0,104,G
5-NP,1301,99,0,1,0,100,A
5-NP,1302,1,0,99,0,100,G
5-NP,1303,0,0,102,0,102,G
5-NP,1304,0,1,101,0,102,G
5-NP,1305,101,0,0,0,101,A
5-NP,1306,102,0,0,0,102,A
5-NP,1307,0,0,103,0,103,G
5-NP,1308,101,0,0,0,101,A
5-NP,1309,104,0,0,0,104,A
5-NP,1310,0,0,0,104,104,C
5-NP,1311,0,102,0,0,102,T
5-NP,1312,0,102,0,0,102,T
5-NP,1313,0,0,0,101,101,C
5-NP,1314,101,0,0,0,101,A
5-NP,1315,0,0,102,0,102,G
5-NP,1316,101,0,0,0,101,A
5-NP,1317,1,0,0,100,101,C
5-NP,1318,99,0,0,0,99,A
5-NP,1319,0,97,0,0,97,T
5-NP,1320,0,0,96,0,96,G
5-NP,1321,94,0,0,0,94,A
5-NP,1322,0,0,94,0,94,G
5-NP,1323,0,0,96,0,96,G
5-NP,1324,0,0,95,0,95,G
5-NP,1325,0,0,0,96,96,C
5-NP,1326,93,0,1,0,94,A
5-NP,1327,0,0,93,0,93,G
5-NP,1328,92,0,0,0,92,A
5-NP,1329,94,0,0,0,94,A
5-NP,1330,93,0,0,0,93,A
5-NP,1331,0,91,0,0,91,T
5-NP,1332,1,0,0,90,91,C
5-NP,1333,91,0,0,0,91,A
5-NP,1334,0,89,0,0,89,T
5-NP,1335,91,0,0,0,91,A
5-NP,1336,91,0,0,0,91,A
5-NP,1337,0,0,92,0,92,G
5-NP,1338,91,0,0,0,91,A
5-NP,1339,92,0,0,0,92,A
5-NP,1340,0,88,0,0,88,T
5-NP,1341,0,0,91,0,91,G
5-NP,1342,91,0,0,0,91,A
5-NP,1343,0,91,0,0,91,T
5-NP,1344,0,0,91,0,91,G
5-NP,1345,0,0,90,0,90,G
5-NP,1346,89,0,0,0,89,A
5-NP,1347,88,0,0,0,88,A
5-NP,1348,86,0,0,0,86,A
5-NP,1349,0,0,89,0,89,G
5-NP,1350,0,88,0,0,88,T
5-NP,1351,0,0,89,0,89,G
5-NP,1352,0,0,0,89,89,C
5-NP,1353,88,0,0,0,88,A
5-NP,1354,86,0,0,0,86,A
5-NP,1355,87,0,0,0,87,A
5-NP,1356,88,0,0,0,88,A
5-NP,1357,0,0,0,88,88,C
5-NP,1358,0,0,0,90,90,C
5-NP,1359,87,0,0,0,87,A
5-NP,1360,0,0,86,0,86,G
5-NP,1361,86,0,0,0,86,A
5-NP,1362,87,0,0,0,87,A
5-NP,1363,0,0,87,0,87,G
5-NP,1364,86,0,1,0,87,A
5-NP,1365,83,0,0,0,83,A
5-NP,1366,0,0,83,0,83,G
5-NP,1367,0,81,0,0,81,T
5-NP,1368,0,0,82,0,82,G
5-NP,1369,0,82,0,0,82,T
5-NP,1370,0,0,0,82,82,C
5-NP,1371,82,0,0,0,82,A
5-NP,1372,0,84,0,0,84,T
5-NP,1373,0,84,0,0,84,T
5-NP,1374,0,0,0,85,85,C
5-NP,1375,0,0,0,85,85,C
5-NP,1376,0,0,86,0,86,G
5-NP,1377,0,0,86,0,86,G
5-NP,1378,0,0,85,0,85,G
5-NP,1379,0,1,85,0,86,G
5-NP,1380,0,0,86,0,86,G
5-NP,1381,81,0,0,0,81,A
5-NP,1382,0,0,81,0,81,G
5-NP,1383,0,0,80,0,80,G
5-NP,1384,0,0,79,0,79,G
5-NP,1385,0,0,81,0,81,G
5-NP,1386,78,0,1,0,79,A
5-NP,1387,0,0,79,0,79,G
5-NP,1388,0,75,0,0,75,T
5-NP,1389,0,0,0,76,76,C
5-NP,1390,0,75,0,0,75,T
5-NP,1391,0,77,0,0,77,T
5-NP,1392,0,0,0,77,77,C
5-NP,1393,0,0,77,0,77,G
5-NP,1394,77,0,0,0,77,A
5-NP,1395,0,0,77,0,77,G
5-NP,1396,0,0,0,77,77,C
5-NP,1397,0,75,0,0,75,T
5-NP,1398,0,0,0,77,77,C
5-NP,1399,0,77,0,0,77,T
5-NP,1400,0,0,0,77,77,C
5-NP,1401,76,1,0,0,77,A
5-NP,1402,0,0,77,0,77,G
5-NP,1403,77,0,0,0,77,A
5-NP,1404,0,0,0,77,77,C
5-NP,1405,0,0,77,0,77,G
5-NP,1406,76,0,0,0,76,A
5-NP,1407,0,0,77,0,77,G
5-NP,1408,74,0,0,0,74,A
5-NP,1409,74,0,0,0,74,A
5-NP,1410,0,0,73,0,73,G
5-NP,1411,0,0,72,0,72,G
5-NP,1412,0,0,0,72,72,C
5-NP,1413,72,0,0,0,72,A
5-NP,1414,72,0,0,0,72,A
5-NP,1415,0,0,0,72,72,C
5-NP,1416,0,0,71,0,71,G
5-NP,1417,71,0,0,0,71,A
5-NP,1418,71,0,0,0,71,A
5-NP,1419,0,0,0,71,71,C
5-NP,1420,0,0,0,71,71,C
5-NP,1421,0,0,0,71,71,C
5-NP,1422,0,0,71,0,71,G
5-NP,1423,71,0,0,0,71,A
5-NP,1424,0,71,0,0,71,T
5-NP,1425,0,0,0,68,68,C
5-NP,1426,0,0,67,0,67,G
5-NP,1427,0,66,0,0,66,T
5-NP,1428,0,0,66,0,66,G
5-NP,1429,0,0,0,66,66,C
5-NP,1430,0,0,0,63,63,C
5-NP,1431,0,0,0,64,64,C
5-NP,1432,0,61,0,0,61,T
5-NP,1433,0,0,0,67,67,C
5-NP,1434,0,64,0,0,64,T
5-NP,1435,0,66,0,0,66,T
5-NP,1436,0,66,0,0,66,T
5-NP,1437,0,65,0,0,65,T
5-NP,1438,0,0,65,0,65,G
5-NP,1439,65,0,0,0,65,A
5-NP,1440,0,64,0,0,64,T
5-NP,1441,63,0,0,0,63,A
5-NP,1442,0,53,0,0,53,T
5-NP,1443,0,0,54,0,54,G
5-NP,1444,54,0,0,0,54,A
5-NP,1445,0,0,55,0,55,G
5-NP,1446,0,55,0,0,55,T
5-NP,1447,54,0,0,0,54,A
5-NP,1448,54,0,0,0,54,A
5-NP,1449,0,53,0,0,53,T
5-NP,1450,0,0,54,0,54,G
5-NP,1451,54,0,0,0,54,A
5-NP,1452,50,0,0,0,50,A
5-NP,1453,0,0,50,0,50,G
5-NP,1454,0,0,49,0,49,G
5-NP,1455,49,0,0,0,49,A
5-NP,1456,0,48,0,0,48,T
5-NP,1457,0,0,0,48,48,C
5-NP,1458,0,46,0,0,46,T
5-NP,1459,0,48,0,0,48,T
5-NP,1460,48,0,0,0,48,A
5-NP,1461,0,48,0,0,48,T
5-NP,1462,0,47,0,0,47,T
5-NP,1463,0,48,0,0,48,T
5-NP,1464,0,0,0,44,44,C
5-NP,1465,0,43,0,0,43,T
5-NP,1466,0,43,0,0,43,T
5-NP,1467,0,0,0,42,42,C
5-NP,1468,0,0,42,0,42,G
5-NP,1469,0,0,43,0,43,G
5-NP,1470,42,0,0,0,42,A
5-NP,1471,0,0,43,0,43,G
5-NP,1472,43,0,0,0,43,A
5-NP,1473,0,0,0,43,43,C
5-NP,1474,42,0,0,0,42,A
5-NP,1475,42,0,0,0,42,A
5-NP,1476,0,41,0,0,41,T
5-NP,1477,0,0,42,0,42,G
5-NP,1478,0,0,0,42,42,C
5-NP,1479,42,0,0,0,42,A
5-NP,1480,0,0,41,0,41,G
5-NP,1481,40,0,0,1,41,A
5-NP,1482,39,0,0,0,39,A
5-NP,1483,0,0,39,0,39,G
5-NP,1484,25,0,0,0,25,A
5-NP,1485,0,0,24,0,24,G
5-NP,1486,0,23,0,0,23,T
5-NP,1487,23,0,0,0,23,A
5-NP,1488,0,21,0,0,21,T
5-NP,1489,0,0,21,0,21,G
5-NP,1490,21,0,0,0,21,A
5-NP,1491,0,0,0,21,21,C
5-NP,1492,16,0,0,0,16,A
5-NP,1493,16,0,0,0,16,A
5-NP,1494,0,12,0,0,12,T
5-NP,1495,0,11,0,0,11,T
5-NP,1496,11,0,0,0,11,A
5-NP,1497,11,0,0,0,11,A
6-NA,1,123,0,0,0,123,A
6-NA,2,0,126,0,0,126,T
6-NA,3,0,0,126,0,126,G
6-NA,4,124,0,3,0,127,A
6-NA,5,136,0,0,0,136,A
6-NA,6,0,136,0,0,136,T
6-NA,7,0,2,0,135,137,C
6-NA,8,0,0,0,137,137,C
6-NA,9,138,0,0,0,138,A
6-NA,10,143,2,0,0,145,A
6-NA,11,146,0,0,0,146,A
6-NA,12,0,145,0,0,145,T
6-NA,13,0,0,0,145,145,C
6-NA,14,145,0,0,0,145,A
6-NA,15,147,0,0,0,147,A
6-NA,16,148,0,0,0,148,A
6-NA,17,150,0,0,0,150,A
6-NA,18,0,0,189,0,189,G
6-NA,19,197,0,0,0,197,A
6-NA,20,0,199,0,0,199,T
6-NA,21,201,0,0,0,201,A
6-NA,22,202,0,0,0,202,A
6-NA,23,0,207,0,0,207,T
6-NA,24,206,0,1,0,207,A
6-NA,25,207,0,0,0,207,A
6-NA,26,0,0,0,207,207,C
6-NA,27,0,207,0,0,207,T
6-NA,28,252,0,0,0,252,A
6-NA,29,0,251,0,0,251,T
6-NA,30,0,251,0,0,251,T
6-NA,31,0,0,253,0,253,G
6-NA,32,0,0,264,0,264,G
6-NA,33,0,1,0,266,267,C
6-NA,34,0,266,1,1,268,T
6-NA,35,0,0,0,277,277,C
6-NA,36,0,277,0,0,277,T
6-NA,37,0,0,289,0,289,G
6-NA,38,0,290,0,1,291,T
6-NA,39,0,291,0,0,291,T
6-NA,40,0,301,0,0,301,T
6-NA,41,1,0,0,301,302,C
6-NA,42,0,300,0,1,301,T
6-NA,43,0,0,0,303,303,C
6-NA,44,0,299,0,2,301,T
6-NA,45,0,1,0,308,309,C
6-NA,46,309,0,0,0,309,A
6-NA,47,0,0,0,326,326,C
6-NA,48,0,0,0,325,325,C
6-NA,49,323,0,0,0,323,A
6-NA,50,0,328,0,0,328,T
6-NA,51,0,338,0,0,338,T
6-NA,52,0,340,0,1,341,T
6-NA,53,0,0,0,357,357,C
6-NA,54,0,0,0,360,360,C
6-NA,55,361,0,1,1,363,A
6-NA,56,0,0,0,383,383,C
6-NA,57,383,0,0,0,383,A
6-NA,58,401,0,0,0,401,A
6-NA,59,0,399,0,0,399,T
6-NA,60,412,0,0,0,412,A
6-NA,61,0,413,0,0,413,T
6-NA,62,0,0,412,0,412,G
6-NA,63,0,0,0,413,413,C
6-NA,64,0,411,0,1,412,T
6-NA,65,0,420,0,1,421,T
6-NA,66,0,0,0,419,419,C
6-NA,67,0,421,0,0,421,T
6-NA,68,0,421,0,0,421,T
6-NA,69,0,0,0,420,420,C
6-NA,70,420,0,0,0,420,A
6-NA,71,0,425,0,0,425,T
6-NA,72,0,0,425,0,425,G
6-NA,73,0,0,0,426,426,C
6-NA,74,425,0,0,0,425,A
6-NA,75,426,0,0,0,426,A
6-NA,76,426,0,0,0,426,A
6-NA,77,0,428,0,0,428,T
6-NA,78,0,426,0,0,426,T
6-NA,79,0,0,426,0,426,G
6-NA,80,0,0,0,431,431,C
6-NA,81,0,0,0,433,433,C
6-NA,82,435,0,0,0,435,A
6-NA,83,0,435,0,0,435,T
6-NA,84,0,2,0,469,471,C
6-NA,85,0,475,0,0,475,T
6-NA,86,0,473,0,1,474,T
6-NA,87,1,1,486,0,488,G
6-NA,88,486,0,0,1,487,A
6-NA,89,0,491,0,1,492,T
6-NA,90,492,0,0,0,492,A
6-NA,91,495,0,0,0,495,A
6-NA,92,0,1,0,563,564,C
6-NA,93,1,559,0,1,561,T
6-NA,94,564,0,0,0,564,A
6-NA,95,0,0,0,576,576,C
6-NA,96,0,573,0,0,573,T
6-NA,97,1,0,588,0,589,G
6-NA,98,0,589,0,1,590,T
6-NA,99,588,0,0,0,588,A
6-NA,100,597,0,0,0,597,A
6-NA,101,0,2,0,584,586,C
6-NA,102,584,0,0,0,584,A
6-NA,103,0,594,0,0,594,T
6-NA,104,1,586,0,0,587,T
6-NA,105,1,0,587,1,589,G
6-NA,106,0,0,0,589,589,C
6-NA,107,597,0,0,0,597,A
6-NA,108,0,596,0,2,598,T
6-NA,109,0,599,0,0,599,T
6-NA,110,0,598,0,0,598,T
6-NA,111,0,0,0,599,599,C
6-NA,112,599,0,0,0,599,A
6-NA,113,602,0,1,0,603,A
6-NA,114,1,0,601,0,602,G
6-NA,115,0,0,0,603,603,C
6-NA,116,597,0,1,0,598,A
6-NA,117,622,0,0,0,622,A
6-NA,118,0,625,0,0,625,T
6-NA,119,626,0,2,0,628,A
6-NA,120,0,627,0,0,627,T
6-NA,121,0,0,638,0,638,G
6-NA,122,637,0,0,0,637,A
6-NA,123,650,0,0,0,650,A
6-NA,124,0,651,0,0,651,T
6-NA,125,0,652,0,0,652,T
6-NA,126,0,1,0,650,651,C
6-NA,127,646,0,1,0,647,A
6-NA,128,648,3,0,0,651,A
6-NA,129,0,1,0,649,650,C
6-NA,130,0,648,0,2,650,T
6-NA,131,3,0,0,646,649,C
6-NA,132,2,0,0,655,657,C
6-NA,133,0,0,0,673,673,C
6-NA,134,0,0,0,676,676,C
6-NA,135,0,0,0,674,674,C
6-NA,136,0,1,0,680,681,C
6-NA,137,0,0,0,687,687,C
6-NA,138,688,0,0,0,688,A
6-NA,139,688,0,0,0,688,A
6-NA,140,688,0,1,0,689,A
6-NA,141,0,1,0,705,706,C
6-NA,142,706,0,0,0,706,A
6-NA,143,712,0,1,0,713,A
6-NA,144,1,0,0,711,712,C
6-NA,145,0,0,0,713,713,C
6-NA,146,735,0,0,0,735,A
6-NA,147,737,0,0,0,737,A
6-NA,148,0,0,749,0,749,G
6-NA,149,0,748,0,0,748,T
6-NA,150,0,2,745,0,747,G
6-NA,151,756,0,0,0,756,A
6-NA,152,1,756,0,0,757,T
6-NA,153,0,1,756,0,757,G
6-NA,154,0,0,0,757,757,C
6-NA,155,0,752,0,3,755,T
6-NA,156,0,0,781,0,781,G
6-NA,157,0,779,0,0,779,T
6-NA,158,0,0,784,0,784,G
6-NA,159,0,795,1,1,797,T
6-NA,160,1,0,788,0,789,G
6-NA,161,790,1,3,0,794,A
6-NA,162,798,0,1,0,799,A
6-NA,163,5,0,0,791,796,C
6-NA,164,0,0,0,797,797,C
6-NA,165,797,0,0,0,797,A
6-NA,166,804,0,0,0,804,A
6-NA,167,0,1,0,830,831,C
6-NA,168,836,0,0,0,836,A
6-NA,169,843,0,0,0,843,A
6-NA,170,1,843,0,0,844,T
6-NA,171,843,0,1,1,845,A
6-NA,172,845,0,1,0,846,A
6-NA,173,0,842,0,1,843,T
6-NA,174,848,0,0,0,848,A
6-NA,175,0,0,849,0,849,G
6-NA,176,840,0,1,0,841,A
6-NA,177,848,1,0,0,849,A
6-NA,178,853,0,2,0,855,A
6-NA,179,0,1,857,0,858,G
6-NA,180,878,0,2,0,880,A
6-NA,181,881,0,0,0,881,A
6-NA,182,921,0,2,1,924,A
6-NA,183,0,1,0,929,930,C
6-NA,184,929,0,1,0,930,A
6-NA,185,1,941,1,0,943,T
6-NA,186,956,0,0,0,956,A
6-NA,187,960,1,1,1,963,A
6-NA,188,0,0,0,977,977,C
6-NA,189,964,0,1,0,965,A
6-NA,190,1,3,985,0,989,G
6-NA,191,971,0,1,0,972,A
6-NA,192,0,1,978,0,979,G
6-NA,193,982,0,1,0,983,A
6-NA,194,0,1016,0,0,1016,T
6-NA,195,1005,1,0,0,1006,A
6-NA,196,0,0,1017,0,1017,G
6-NA,197,0,1013,0,1,1014,T
6-NA,198,0,0,1035,0,1035,G
6-NA,199,0,1040,2,0,1042,T
6-NA,200,1042,0,1,0,1043,A
6-NA,201,2,1029,0,2,1033,T
6-NA,202,0,1,0,1041,1042,C
6-NA,203,1,1026,0,0,1027,T
6-NA,204,0,1,1044,0,1045,G
6-NA,205,1043,0,1,0,1044,A
6-NA,206,0,0,0,1042,1042,C
6-NA,207,4,0,0,1033,1037,C
6-NA,208,1033,0,1,0,1034,A
6-NA,209,1035,0,1,0,1036,A
6-NA,210,0,0,0,1049,1049,C
6-NA,211,1051,0,0,0,1051,A
6-NA,212,0,0,0,1080,1080,C
6-NA,213,0,0,0,1075,1075,C
6-NA,214,1103,0,1,0,1104,A
6-NA,215,0,1,0,1142,1143,C
6-NA,216,2,1,0,1142,1145,C
6-NA,217,1146,0,3,0,1149,A
6-NA,218,0,1156,0,0,1156,T
6-NA,219,1139,1,0,0,1140,A
6-NA,220,0,3,1140,0,1143,G
6-NA,221,1120,1,0,0,1121,A
6-NA,222,0,1,1148,0,1149,G
6-NA,223,1135,0,1,1,1137,A
6-NA,224,1132,0,0,0,1132,A
6-NA,225,0,0,1142,0,1142,G
6-NA,226,0,1,1151,0,1152,G
6-NA,227,1150,1,0,0,1151,A
6-NA,228,1153,0,0,0,1153,A
6-NA,229,1151,1,2,0,1154,A
6-NA,230,0,1153,0,0,1153,T
6-NA,231,1149,1,1,0,1151,A
6-NA,232,0,1154,0,0,1154,T
6-NA,233,2,0,1153,0,1155,G
6-NA,234,0,4,0,1154,1158,C
6-NA,235,2,0,0,1140,1142,C
6-NA,236,0,0,0,1145,1145,C
6-NA,237,1,1,0,1158,1160,C
6-NA,238,1157,0,0,0,1157,A
6-NA,239,1171,0,0,0,1171,A
6-NA,240,1176,0,0,0,1176,A
6-NA,241,1,0,0,1179,1180,C
6-NA,242,0,1173,0,0,1173,T
6-NA,243,1173,0,0,0,1173,A
6-NA,244,0,0,1171,0,1171,G
6-NA,245,0,0,0,1170,1170,C
6-NA,246,1173,0,1,0,1174,A
6-NA,247,0,1,1185,0,1186,G
6-NA,248,1175,0,2,1,1178,A
6-NA,249,1217,0,0,0,1217,A
6-NA,250,0,1213,0,1,1214,T
6-NA,251,1215,0,2,1,1218,A
6-NA,252,0,0,0,1213,1213,C
6-NA,253,1216,0,0,1,1217,A
6-NA,254,5,0,1217,0,1222,G
6-NA,255,1223,0,0,0,1223,A
6-NA,256,1216,0,0,0,1216,A
6-NA,257,1221,0,0,0,1221,A
6-NA,258,0,1199,0,1,1200,T
6-NA,259,0,1195,0,0,1195,T
6-NA,260,0,2,1197,0,1199,G
6-NA,261,1,0,1199,0,1200,G
6-NA,262,0,1197,0,1,1198,T
6-NA,263,1,0,0,1192,1193,C
6-NA,264,1191,0,0,0,1191,A
6-NA,265,1193,0,1,0,1194,A
6-NA,266,1191,1,3,0,1195,A
6-NA,267,2,0,1200,0,1202,G
6-NA,268,1,2,0,1200,1203,C
6-NA,269,1,1,0,1193,1195,C
6-NA,270,2,1,1194,0,1197,G
6-NA,271,1,0,0,1199,1200,C
6-NA,272,1205,0,2,0,1207,A
6-NA,273,1220,0,0,0,1220,A
6-NA,274,0,1219,0,1,1220,T
6-NA,275,0,0,1226,1,1227,G
6-NA,276,0,1224,0,1,1225,T
6-NA,277,0,2,1218,0,1220,G
6-NA,278,1241,0,5,0,1246,A
6-NA,279,0,0,1,1260,1261,C
6-NA,280,1272,0,0,0,1272,A
6-NA,281,0,1288,0,1,1289,T
6-NA,282,0,1289,0,1,1290,T
6-NA,283,1288,1,1,0,1290,A
6-NA,284,0,0,0,1290,1290,C
6-NA,285,1279,0,1,0,1280,A
6-NA,286,0,1,1278,0,1279,G
6-NA,287,0,2,1263,0,1265,G
6-NA,288,0,0,1224,0,1224,G
6-NA,289,0,1269,1,0,1270,T
6-NA,290,0,1268,0,1,1269,T
6-NA,291,0,1269,0,1,1270,T
6-NA,292,0,2,1266,0,1268,G
6-NA,293,0,1,0,1268,1269,C
6-NA,294,1269,1,1,0,1271,A
6-NA,295,0,2,0,1263,1265,C
6-NA,296,1,0,0,1251,1252,C
6-NA,297,0,1249,0,1,1250,T
6-NA,298,0,1254,0,0,1254,T
6-NA,299,0,1261,0,0,1261,T
6-NA,300,0,1258,1,2,1261,T
6-NA,301,0,1281,0,0,1281,T
6-NA,302,1,0,0,1282,1283,C
6-NA,303,0,1281,0,1,1282,T
6-NA,304,1276,0,0,1,1277,A
6-NA,305,1275,0,1,0,1276,A
6-NA,306,0,2,1283,0,1285,G
6-NA,307,0,1,1281,0,1282,G
6-NA,308,1280,0,2,0,1282,A
6-NA,309,1,1,0,1286,1288,C
6-NA,310,1272,1,1,1,1275,A
6-NA,311,1277,0,1,0,1278,A
6-NA,312,0,1278,0,0,1278,T
6-NA,313,0,1278,0,0,1278,T
6-NA,314,0,0,0,1298,1298,C
6-NA,315,1,1,1295,0,1297,G
6-NA,316,1295,0,0,0,1295,A
6-NA,317,0,1292,1,2,1295,T
6-NA,318,0,1293,0,1,1294,T
6-NA,319,1293,0,0,0,1293,A
6-NA,320,0,0,1295,0,1295,G
6-NA,321,0,2,1292,0,1294,G
6-NA,322,0,0,0,1294,1294,C
6-NA,323,0,1274,0,1,1275,T
6-NA,324,0,1279,1,2,1282,T
6-NA,325,0,1283,0,1,1284,T
6-NA,326,0,0,0,1286,1286,C
6-NA,327,0,2,0,1286,1288,C
6-NA,328,1,0,1287,0,1288,G
6-NA,329,1,1,0,1285,1287,C
6-NA,330,1,1281,0,0,1282,T
6-NA,331,1,2,1295,0,1298,G
6-NA,332,0,1,1291,0,1292,G
6-NA,333,0,1293,1,1,1295,T
6-NA,334,1,2,1300,0,1303,G
6-NA,335,0,1,1294,0,1295,G
6-NA,336,1,0,1299,0,1300,G
6-NA,337,2,1,1308,0,1311,G
6-NA,338,1307,0,1,0,1308,A
6-NA,339,2,0,0,1315,1317,C
6-NA,340,1291,0,0,0,1291,A
6-NA,341,1,1283,1,2,1287,T
6-NA,342,0,0,0,1288,1288,C
6-NA,343,1,1283,0,0,1284,T
6-NA,344,0,2,1292,0,1294,G
6-NA,345,0,0,1295,0,1295,G
6-NA,346,0,1,1329,0,1330,G
6-NA,347,1,1332,0,0,1333,T
6-NA,348,0,3,1319,0,1322,G
6-NA,349,1319,0,2,0,1321,A
6-NA,350,1,0,0,1346,1347,C
6-NA,351,1344,0,2,0,1346,A
6-NA,352,1357,0,0,0,1357,A
6-NA,353,0,1,1361,0,1362,G
6-NA,354,1351,0,1,0,1352,A
6-NA,355,1,3,1370,0,1374,G
6-NA,356,1376,0,3,0,1379,A
6-NA,357,1402,0,0,0,1402,A
6-NA,358,0,0,0,1496,1496,C
6-NA,359,0,0,0,1509,1509,C
6-NA,360,0,1503,1,2,1506,T
6-NA,361,1,1510,0,0,1511,T
6-NA,362,1508,0,0,0,1508,A
6-NA,363,0,1515,0,1,1516,T
6-NA,364,0,0,1541,1,1542,G
6-NA,365,1,1532,0,0,1533,T
6-NA,366,0,0,1533,0,1533,G
6-NA,367,0,1494,0,3,1497,T
6-NA,368,1,0,0,1491,1492,C
6-NA,369,1497,0,0,0,1497,A
6-NA,370,0,1500,0,0,1500,T
6-NA,371,0,0,1493,0,1493,G
6-NA,372,1,1,0,1493,1495,C
6-NA,373,2,3,1484,0,1489,G
6-NA,374,1559,0,1,0,1560,A
6-NA,375,1,1558,0,0,1559,T
6-NA,376,0,0,0,1576,1576,C
6-NA,377,2,0,4,1572,1578,C
6-NA,378,0,1570,0,5,1575,T
6-NA,379,2,4,1583,1,1590,G
6-NA,380,1587,1,0,0,1588,A
6-NA,381,1,0,0,1588,1589,C
6-NA,382,1584,0,0,0,1584,A
6-NA,383,1562,1,0,0,1563,A
6-NA,384,0,0,1603,0,1603,G
6-NA,385,0,1592,0,1,1593,T
6-NA,386,0,1,1616,0,1617,G
6-NA,387,0,1603,0,0,1603,T
6-NA,388,0,1597,0,0,1597,T
6-NA,389,1603,0,0,0,1603,A
6-NA,390,0,1600,0,0,1600,T
6-NA,391,1,1,0,1613,1615,C
6-NA,392,1611,1,0,1,1613,A
6-NA,393,1600,0,1,0,1601,A
6-NA,394,0,1599,0,0,1599,T
6-NA,395,0,1588,0,2,1590,T
6-NA,396,1,1592,0,0,1593,T
6-NA,397,0,1,1593,0,1594,G
6-NA,398,0,1,0,1635,1636,C
6-NA,399,1,0,0,1638,1639,C
6-NA,400,2,0,0,1638,1640,C
6-NA,401,1,1637,0,1,1639,T
6-NA,402,0,1641,0,1,1642,T
6-NA,403,2,0,1658,1,1661,G
6-NA,404,2,1,1662,0,1665,G
6-NA,405,1673,1,1,0,1675,A
6-NA,406,0,1,0,1676,1677,C
6-NA,407,1641,0,4,1,1646,A
6-NA,408,2,3,1661,0,1666,G
6-NA,409,0,1,1657,0,1658,G
6-NA,410,0,2,1714,0,1716,G
6-NA,411,1723,1,1,2,1727,A
6-NA,412,1716,1,2,0,1719,A
6-NA,413,1,1,0,1714,1716,C
6-NA,414,1616,0,2,0,1618,A
6-NA,415,1752,0,1,0,1753,A
6-NA,416,0,1,0,1758,1759,C
6-NA,417,1758,0,1,0,1759,A
6-NA,418,1,0,0,1765,1766,C
6-NA,419,0,1718,0,4,1722,T
6-NA,420,1747,0,0,0,1747,A
6-NA,421,1747,0,0,0,1747,A
6-NA,422,1771,0,0,0,1771,A
6-NA,423,0,0,0,1775,1775,C
6-NA,424,1677,0,0,0,1677,A
6-NA,425,1688,0,0,0,1688,A
6-NA,426,0,1,0,1691,1692,C
6-NA,427,0,0,1671,0,1671,G
6-NA,428,0,1666,0,0,1666,T
6-NA,429,1630,0,2,0,1632,A
6-NA,430,1,0,0,1657,1658,C
6-NA,431,1658,0,0,0,1658,A
6-NA,432,0,1666,0,2,1668,T
6-NA,433,0,1669,0,1,1670,T
6-NA,434,2,0,0,1718,1720,C
6-NA,435,1773,0,1,0,1774,A
6-NA,436,1778,0,1,0,1779,A
6-NA,437,1779,1,0,0,1780,A
6-NA,438,0,1780,0,0,1780,T
6-NA,439,1764,0,0,1,1765,A
6-NA,440,1837,0,1,0,1838,A
6-NA,441,1,0,0,1845,1846,C
6-NA,442,1842,1,5,1,1849,A
6-NA,443,0,1,0,1865,1866,C
6-NA,444,1808,0,0,0,1808,A
6-NA,445,1,0,1985,0,1986,G
6-NA,446,0,1986,0,0,1986,T
6-NA,447,2002,1,0,0,2003,A
6-NA,448,1,1,0,2014,2016,C
6-NA,449,2,2,1999,0,2003,G
6-NA,450,1,2005,0,0,2006,T
6-NA,451,2,3,2007,1,2013,G
6-NA,452,2037,0,1,0,2038,A
6-NA,453,1,2048,2,0,2051,T
6-NA,454,1965,0,2,1,1968,A
6-NA,455,1,0,1966,0,1967,G
6-NA,456,0,0,1956,0,1956,G
6-NA,457,1953,0,1,0,1954,A
6-NA,458,1942,1,2,1,1946,A
6-NA,459,3,1,0,2010,2014,C
6-NA,460,2,0,0,2022,2024,C
6-NA,461,3,0,1,2020,2024,C
6-NA,462,0,2029,0,2,2031,T
6-NA,463,0,2059,0,0,2059,T
6-NA,464,2061,0,0,0,2061,A
6-NA,465,0,2058,0,1,2059,T
6-NA,466,2,0,0,2053,2055,C
6-NA,467,1,4,2050,0,2055,G
6-NA,468,1,3,2038,0,2042,G
6-NA,469,2045,0,1,0,2046,A
6-NA,470,3,2,0,2050,2055,C
6-NA,471,1,0,0,2055,2056,C
6-NA,472,3,0,0,2132,2135,C
6-NA,473,0,2136,0,2,2138,T
6-NA,474,2152,0,0,0,2152,A
6-NA,475,0,2153,0,2,2155,T
6-NA,476,0,2155,0,3,2158,T
6-NA,477,1,0,2161,0,2162,G
6-NA,478,2153,1,1,0,2155,A
6-NA,479,0,2154,0,0,2154,T
6-NA,480,0,5,2147,0,2152,G
6-NA,481,2084,0,4,1,2089,A
6-NA,482,2088,0,0,1,2089,A
6-NA,483,1,2093,0,0,2094,T
6-NA,484,0,4,2121,1,2126,G
6-NA,485,2139,1,0,1,2141,A
6-NA,486,0,0,2166,0,2166,G
6-NA,487,1,2162,0,1,2164,T
6-NA,488,0,2168,0,2,2170,T
6-NA,489,2171,1,2,0,2174,A
6-NA,490,1,5,2172,3,2181,G
6-NA,491,0,2,2184,0,2186,G
6-NA,492,0,2181,0,1,2182,T
6-NA,493,0,0,2203,0,2203,G
6-NA,494,0,2179,0,5,2184,T
6-NA,495,0,2179,0,3,2182,T
6-NA,496,3,0,0,2206,2209,C
6-NA,497,2,0,0,2218,2220,C
6-NA,498,0,2200,0,7,2207,T
6-NA,499,0,2209,0,1,2210,T
6-NA,500,0,2194,1,4,2199,T
6-NA,501,1,2197,0,4,2202,T
6-NA,502,1,3,0,2203,2207,C
6-NA,503,2207,0,1,1,2209,A
6-NA,504,0,2237,0,1,2238,T
6-NA,505,0,0,0,2238,2238,C
6-NA,506,0,2227,0,0,2227,T
6-NA,507,0,2,2221,0,2223,G
6-NA,508,2,5,2203,0,2210,G
6-NA,509,2,1,2221,0,2224,G
6-NA,510,0,4,2231,0,2235,G
6-NA,511,2230,1,2,0,2233,A
6-NA,512,0,1,0,2258,2259,C
6-NA,513,4,1,0,2209,2214,C
6-NA,514,2239,0,3,0,2242,A
6-NA,515,2244,0,4,0,2248,A
6-NA,516,1,1,2249,0,2251,G
6-NA,517,1,1,0,2261,2263,C
6-NA,518,2253,0,2,1,2256,A
6-NA,519,2275,0,2,0,2277,A
6-NA,520,1,2,2281,0,2284,G
6-NA,521,0,2281,0,0,2281,T
6-NA,522,2,1,2322,0,2325,G
6-NA,523,2,2306,0,3,2311,T
6-NA,524,1,1,2359,0,2361,G
6-NA,525,0,2,1,2360,2363,C
6-NA,526,2356,0,0,0,2356,A
6-NA,527,0,2369,0,1,2370,T
6-NA,528,2340,0,1,0,2341,A
6-NA,529,0,0,2384,0,2384,G
6-NA,530,0,1,0,2377,2378,C
6-NA,531,2321,1,0,1,2323,A
6-NA,532,0,2317,0,1,2318,T
6-NA,533,1,2,2275,0,2278,G
6-NA,534,2,0,2392,0,2394,G
6-NA,535,1,2391,0,7,2399,T
6-NA,536,5,1,0,2390,2396,C
6-NA,537,2,0,0,2399,2401,C
6-NA,538,2402,0,0,0,2402,A
6-NA,539,1,0,2453,0,2454,G
6-NA,540,0,0,0,2467,2467,C
6-NA,541,0,2450,0,3,2453,T
6-NA,542,2,0,0,2472,2474,C
6-NA,543,2433,0,0,0,2433,A
6-NA,544,2447,0,5,0,2452,A
6-NA,545,0,0,2463,1,2464,G
6-NA,546,0,2658,0,0,2658,T
6-NA,547,0,2646,0,1,2647,T
6-NA,548,2,1,2637,0,2640,G
6-NA,549,2,2634,0,1,2637,T
6-NA,550,3,0,0,2636,2639,C
6-NA,551,2638,0,5,0,2643,A
6-NA,552,0,0,1,2653,2654,C
6-NA,553,3,1,2645,0,2649,G
6-NA,554,2670,1,0,0,2671,A
6-NA,555,0,2690,0,1,2691,T
6-NA,556,3,2,2728,0,2733,G
6-NA,557,0,6,2733,0,2739,G
6-NA,558,2742,1,2,0,2745,A
6-NA,559,2751,1,3,0,2755,A
6-NA,560,2766,0,1,0,2767,A
6-NA,561,2774,0,4,1,2779,A
6-NA,562,1,1,2806,0,2808,G
6-NA,563,1,0,0,2792,2793,C
6-NA,564,2793,0,3,0,2796,A
6-NA,565,1,2787,0,2,2790,T
6-NA,566,1,3,2818,0,2822,G
6-NA,567,3,0,2832,0,2835,G
6-NA,568,1,1,0,2854,2856,C
6-NA,569,0,2855,0,1,2856,T
6-NA,570,2,2,2869,0,2873,G
6-NA,571,0,0,0,2855,2855,C
6-NA,572,2864,0,1,0,2865,A
6-NA,573,0,2959,0,1,2960,T
6-NA,574,3,0,2966,0,2969,G
6-NA,575,0,2973,0,3,2976,T
6-NA,576,0,3014,1,7,3022,T
6-NA,577,1,3000,7,4,3012,T
6-NA,578,3,0,3170,0,3173,G
6-NA,579,0,3170,0,1,3171,T
6-NA,580,3174,0,1,0,3175,A
6-NA,581,0,3179,0,1,3180,T
6-NA,582,3154,0,0,0,3154,A
6-NA,583,3159,0,2,0,3161,A
6-NA,584,0,5,0,3145,3150,C
6-NA,585,1,4,3124,1,3130,G
6-NA,586,3,1,3137,0,3141,G
6-NA,587,1,3,3085,0,3089,G
6-NA,588,1,2,3099,0,3102,G
6-NA,589,1,1,3112,0,3114,G
6-NA,590,3100,0,3,0,3103,A
6-NA,591,3,3113,0,1,3117,T
6-NA,592,1,4,3127,0,3132,G
6-NA,593,3149,0,5,0,3154,A
6-NA,594,0,3163,0,0,3163,T
6-NA,595,3152,0,1,0,3153,A
6-NA,596,3347,0,3,0,3350,A
6-NA,597,3364,0,1,0,3365,A
6-NA,598,3365,0,1,0,3366,A
6-NA,599,3385,1,0,0,3386,A
6-NA,600,0,3388,0,0,3388,T
6-NA,601,2,4,3377,0,3383,G
6-NA,602,0,2,0,3381,3383,C
6-NA,603,3375,0,2,0,3377,A
6-NA,604,3383,1,3,0,3387,A
6-NA,605,1,2,0,3393,3396,C
6-NA,606,1,3383,0,2,3386,T
6-NA,607,1,1,3391,0,3393,G
6-NA,608,4,2,0,3385,3391,C
6-NA,609,0,3405,0,1,3406,T
6-NA,610,3410,0,0,0,3410,A
6-NA,611,1,1,3422,0,3424,G
6-NA,612,1,1,0,3438,3440,C
6-NA,613,0,3438,0,2,3440,T
6-NA,614,0,3440,0,3,3443,T
6-NA,615,4,1,0,3453,3458,C
6-NA,616,3471,0,0,0,3471,A
6-NA,617,0,3471,0,0,3471,T
6-NA,618,0,3472,0,2,3474,T
6-NA,619,0,3493,1,1,3495,T
6-NA,620,3493,0,0,0,3493,A
6-NA,621,2,0,0,3517,3519,C
6-NA,622,3503,0,1,0,3504,A
6-NA,623,3524,0,1,0,3525,A
6-NA,624,2,3511,0,0,3513,T
6-NA,625,1,5,3512,1,3519,G
6-NA,626,4,3,3504,0,3511,G
6-NA,627,3,6,3496,0,3505,G
6-NA,628,3496,2,5,1,3504,A
6-NA,629,0,3,3574,0,3577,G
6-NA,630,2,2,3598,0,3602,G
6-NA,631,2,1,0,3765,3768,C
6-NA,632,0,3753,0,11,3764,T
6-NA,633,1,3802,1,3,3807,T
6-NA,634,0,1,3850,0,3851,G
6-NA,635,0,3855,0,3,3858,T
6-NA,636,3905,1,6,0,3912,A
6-NA,637,1,2,3918,0,3921,G
6-NA,638,3875,1,2,1,3879,A
6-NA,639,1,3903,0,4,3908,T
6-NA,640,3732,0,2,0,3734,A
6-NA,641,0,2,3737,0,3739,G
6-NA,642,0,3567,0,1,3568,T
6-NA,643,2,3,3499,1,3505,G
6-NA,644,0,3620,0,4,3624,T
6-NA,645,0,3622,0,1,3623,T
6-NA,646,6,1,3680,0,3687,G
6-NA,647,0,3678,2,3,3683,T
6-NA,648,0,3687,1,5,3693,T
6-NA,649,1,3691,1,4,3697,T
6-NA,650,1,1,1,3661,3664,C
6-NA,651,3652,1,6,0,3659,A
6-NA,652,2,3641,0,1,3644,T
6-NA,653,2,4,3642,0,3648,G
6-NA,654,0,2,3793,0,3795,G
6-NA,655,0,3656,1,1,3658,T
6-NA,656,3,0,0,3557,3560,C
6-NA,657,5,1,0,3548,3554,C
6-NA,658,3571,1,1,0,3573,A
6-NA,659,3585,0,1,0,3586,A
6-NA,660,3587,0,3,1,3591,A
6-NA,661,0,2,3611,0,3613,G
6-NA,662,3600,0,1,0,3601,A
6-NA,663,3517,0,3,0,3520,A
6-NA,664,3528,0,3,0,3531,A
6-NA,665,2,3538,0,1,3541,T
6-NA,666,3,0,0,3626,3629,C
6-NA,667,1,0,1,3626,3628,C
6-NA,668,1,3618,0,5,3624,T
6-NA,669,2,0,0,3626,3628,C
6-NA,670,3615,1,4,2,3622,A
6-NA,671,0,1,3643,0,3644,G
6-NA,672,2,6,3633,0,3641,G
6-NA,673,3697,3,3,0,3703,A
6-NA,674,0,2,0,3692,3694,C
6-NA,675,3,2,2,3638,3645,C
6-NA,676,2,1,0,3649,3652,C
6-NA,677,3661,0,4,0,3665,A
6-NA,678,1,3,3662,0,3666,G
6-NA,679,1,6,3659,0,3666,G
6-NA,680,3654,5,6,0,3665,A
6-NA,681,2,0,3707,0,3709,G
6-NA,682,1,3647,0,6,3654,T
6-NA,683,8,1,0,3657,3666,C
6-NA,684,3652,1,5,0,3658,A
6-NA,685,2,5,3676,1,3684,G
6-NA,686,3669,0,2,0,3671,A
6-NA,687,3672,1,1,0,3674,A
6-NA,688,0,3667,0,1,3668,T
6-NA,689,1,0,3678,0,3679,G
6-NA,690,1,2,1,3667,3671,C
6-NA,691,1,2,3685,0,3688,G
6-NA,692,0,3679,1,0,3680,T
6-NA,693,1,3685,0,3,3689,T
6-NA,694,0,3668,0,3,3671,T
6-NA,695,0,2,3692,0,3694,G
6-NA,696,2,3696,0,4,3702,T
6-NA,697,3700,0,2,0,3702,A
6-NA,698,2,3696,0,0,3698,T
6-NA,699,1,1,0,3707,3709,C
6-NA,700,3692,1,2,0,3695,A
6-NA,701,3702,1,0,0,3703,A
6-NA,702,2,3697,0,1,3700,T
6-NA,703,1,3,3699,0,3703,G
6-NA,704,2,3,3691,0,3696,G
6-NA,705,3715,1,9,0,3725,A
6-NA,706,3719,2,1,1,3723,A
6-NA,707,0,2,0,3740,3742,C
6-NA,708,0,3741,0,6,3747,T
6-NA,709,0,3740,0,1,3741,T
6-NA,710,3,1,3742,0,3746,G
6-NA,711,1,16,0,3669,3686,C
6-NA,712,3746,1,1,0,3748,A
6-NA,713,1,1,0,3809,3811,C
6-NA,714,3811,0,2,0,3813,A
6-NA,715,4,1,4195,0,4200,G
6-NA,716,0,4198,0,0,4198,T
6-NA,717,4319,0,3,0,4322,A
6-NA,718,0,2,4340,0,4342,G
6-NA,719,1,4299,0,1,4301,T
6-NA,720,4294,1,1,0,4296,A
6-NA,721,4299,1,3,0,4303,A
6-NA,722,0,4274,0,2,4276,T
6-NA,723,1,6,4284,0,4291,G
6-NA,724,4091,0,4,0,4095,A
6-NA,725,1,0,0,4130,4131,C
6-NA,726,1,4055,0,1,4057,T
6-NA,727,1,3,4062,0,4066,G
6-NA,728,4045,3,3,0,4051,A
6-NA,729,0,4063,1,3,4067,T
6-NA,730,4,3,4058,1,4066,G
6-NA,731,2,7,4039,1,4049,G
6-NA,732,4,6,4028,0,4038,G
6-NA,733,3999,1,5,0,4005,A
6-NA,734,1,1,4007,0,4009,G
6-NA,735,1,3982,0,2,3985,T
6-NA,736,3,1,3992,1,3997,G
6-NA,737,0,0,0,4016,4016,C
6-NA,738,0,3998,0,5,4003,T
6-NA,739,1,4007,0,2,4010,T
6-NA,740,4,2,1,4010,4017,C
6-NA,741,4016,0,6,0,4022,A
6-NA,742,1,4,4039,0,4044,G
6-NA,743,1,0,4048,0,4049,G
6-NA,744,4043,1,6,0,4050,A
6-NA,745,4032,3,2,0,4037,A
6-NA,746,4009,2,1,0,4012,A
6-NA,747,4024,2,7,0,4033,A
6-NA,748,6,2,4038,0,4046,G
6-NA,749,0,2,2,4035,4039,C
6-NA,750,0,4036,1,2,4039,T
6-NA,751,1,3,4022,0,4026,G
6-NA,752,4018,3,4,0,4025,A
6-NA,753,0,4053,0,1,4054,T
6-NA,754,4074,0,2,0,4076,A
6-NA,755,1,2,0,4246,4249,C
6-NA,756,1,4215,1,3,4220,T
6-NA,757,4219,0,4,0,4223,A
6-NA,758,4217,3,0,0,4220,A
6-NA,759,4225,1,0,0,4226,A
6-NA,760,4316,1,1,0,4318,A
6-NA,761,0,4320,0,2,4322,T
6-NA,762,4297,1,3,1,4302,A
6-NA,763,3,1,0,4320,4324,C
6-NA,764,0,4154,0,2,4156,T
6-NA,765,4256,0,1,0,4257,A
6-NA,766,0,4231,0,2,4233,T
6-NA,767,2,4386,0,5,4393,T
6-NA,768,7,0,0,4403,4410,C
6-NA,769,4172,0,134,0,4306,A
6-NA,770,0,4305,0,3,4308,T
6-NA,771,0,4284,0,5,4289,T
6-NA,772,2,2,4310,0,4314,G
6-NA,773,4274,1,3,2,4280,A
6-NA,774,3,1,4242,0,4246,G
6-NA,775,2,6,4222,0,4230,G
6-NA,776,4074,1,1,1,4077,A
6-NA,777,0,6,4127,0,4133,G
6-NA,778,1,8,4129,0,4138,G
6-NA,779,0,6,4138,1,4145,G
6-NA,780,0,2,4159,0,4161,G
6-NA,781,4130,0,2,1,4133,A
6-NA,782,4141,1,5,0,4147,A
6-NA,783,4145,1,2,0,4148,A
6-NA,784,4137,1,5,0,4143,A
6-NA,785,1,4153,0,2,4156,T
6-NA,786,6,3,0,4113,4122,C
6-NA,787,0,0,4154,0,4154,G
6-NA,788,0,4137,0,1,4138,T
6-NA,789,1,4131,0,1,4133,T
6-NA,790,4,2,0,4140,4146,C
6-NA,791,4122,1,3,0,4126,A
6-NA,792,1,4306,0,0,4307,T
6-NA,793,4307,1,2,0,4310,A
6-NA,794,1,2,0,4321,4324,C
6-NA,795,0,4312,0,5,4317,T
6-NA,796,4303,2,7,0,4312,A
6-NA,797,1,1,4305,2,4309,G
6-NA,798,1,1,0,4300,4302,C
6-NA,799,4311,0,3,0,4314,A
6-NA,800,0,6,0,4317,4323,C
6-NA,801,4189,1,2,0,4192,A
6-NA,802,0,4929,0,1,4930,T
6-NA,803,1,4909,0,4,4914,T
6-NA,804,0,0,5102,0,5102,G
6-NA,805,1,5082,1,3,5087,T
6-NA,806,11,3,0,5070,5084,C
6-NA,807,5076,1,5,1,5083,A
6-NA,808,1,4,5098,0,5103,G
6-NA,809,0,4,5080,0,5084,G
6-NA,810,5084,0,3,0,5087,A
6-NA,811,5023,0,4,1,5028,A
6-NA,812,1,2,5063,0,5066,G
6-NA,813,0,4859,0,1,4860,T
6-NA,814,1,1,4881,0,4883,G
6-NA,815,1,0,0,4867,4868,C
6-NA,816,2,4860,0,8,4870,T
6-NA,817,3,1,0,4875,4879,C
6-NA,818,4836,0,2,0,4838,A
6-NA,819,2,0,4876,0,4878,G
6-NA,820,2,3,1,4873,4879,C
6-NA,821,4857,2,5,0,4864,A
6-NA,822,0,4854,0,1,4855,T
6-NA,823,3,1,4947,0,4951,G
6-NA,824,14,4934,0,7,4955,T
6-NA,825,3,2,0,4940,4945,C
6-NA,826,0,5,4934,0,4939,G
6-NA,827,4921,0,1,1,4923,A
6-NA,828,0,2,4902,1,4905,G
6-NA,829,0,4,4907,0,4911,G
6-NA,830,4874,0,9,0,4883,A
6-NA,831,2,0,4902,1,4905,G
6-NA,832,3,4794,0,3,4800,T
6-NA,833,4,1,4797,1,4803,G
6-NA,834,2,0,0,4821,4823,C
6-NA,835,1,4820,0,5,4826,T
6-NA,836,9,1,1,4815,4826,C
6-NA,837,1,2,1,4831,4835,C
6-NA,838,1,4836,0,1,4838,T
6-NA,839,4,0,4847,0,4851,G
6-NA,840,1,1,0,4804,4806,C
6-NA,841,0,4780,0,4,4784,T
6-NA,842,4801,0,3,0,4804,A
6-NA,843,0,4749,0,2,4751,T
6-NA,844,2,0,0,4772,4774,C
6-NA,845,5,2,1,4745,4753,C
6-NA,846,1,4744,0,3,4748,T
6-NA,847,3,2,1,4751,4757,C
6-NA,848,5,2,4753,0,4760,G
6-NA,849,4779,1,4,0,4784,A
6-NA,850,1,4774,0,9,4784,T
6-NA,851,4790,0,3,0,4793,A
6-NA,852,0,4779,1,3,4783,T
6-NA,853,3,0,4,4765,4772,C
6-NA,854,3,0,1,4758,4762,C
6-NA,855,0,4723,1,5,4729,T
6-NA,856,0,3,4745,0,4748,G
6-NA,857,4,1,4746,0,4751,G
6-NA,858,1,4772,1,11,4785,T
6-NA,859,1,0,4787,0,4788,G
6-NA,860,1,4747,1,5,4754,T
6-NA,861,4,4,0,4748,4756,C
6-NA,862,4746,1,5,0,4752,A
6-NA,863,1,1,4756,1,4759,G
6-NA,864,4736,8,4,0,4748,A
6-NA,865,0,4734,0,3,4737,T
6-NA,866,1,1,4737,0,4739,G
6-NA,867,0,4647,0,3,4650,T
6-NA,868,1,1,4632,7,4641,G
6-NA,869,0,4643,1,4,4648,T
6-NA,870,3,1,0,4655,4659,C
6-NA,871,1,4630,0,9,4640,T
6-NA,872,5,0,4637,0,4642,G
6-NA,873,3,3,0,4634,4640,C
6-NA,874,4634,2,3,0,4639,A
6-NA,875,1,3,4634,0,4638,G
6-NA,876,4592,1,3,0,4596,A
6-NA,877,1,3,4593,5,4602,G
6-NA,878,4593,1,5,0,4599,A
6-NA,879,2,2,1,4609,4614,C
6-NA,880,4602,0,4,0,4606,A
6-NA,881,4604,5,7,1,4617,A
6-NA,882,0,3,0,4787,4790,C
6-NA,883,2,4776,1,2,4781,T
6-NA,884,0,3,4786,0,4789,G
6-NA,885,0,2,4762,0,4764,G
6-NA,886,4745,2,3,1,4751,A
6-NA,887,4744,0,3,0,4747,A
6-NA,888,4685,0,10,0,4695,A
6-NA,889,0,1,4686,0,4687,G
6-NA,890,3,6,4636,1,4646,G
6-NA,891,4585,4,2,1,4592,A
6-NA,892,1,4684,0,3,4688,T
6-NA,893,7,0,0,4685,4692,C
6-NA,894,1,5,1,4735,4742,C
6-NA,895,4764,0,1,0,4765,A
6-NA,896,4751,1,3,1,4756,A
6-NA,897,0,4758,0,2,4760,T
6-NA,898,4642,0,3,0,4645,A
6-NA,899,1,2,4635,0,4638,G
6-NA,900,1,3,4615,0,4619,G
6-NA,901,3,4,0,4619,4626,C
6-NA,902,2,3,0,4600,4605,C
6-NA,903,5,0,0,4519,4524,C
6-NA,904,4540,1,4,0,4545,A
6-NA,905,0,4551,0,3,4554,T
6-NA,906,3,1,1,4553,4558,C
6-NA,907,0,0,4569,0,4569,G
6-NA,908,0,4555,0,0,4555,T
6-NA,909,4482,1,3,0,4486,A
6-NA,910,0,4,4561,0,4565,G
6-NA,911,4567,0,8,0,4575,A
6-NA,912,0,4570,0,3,4573,T
6-NA,913,4528,0,2,0,4530,A
6-NA,914,1,4472,0,1,4474,T
6-NA,915,4457,0,2,0,4459,A
6-NA,916,4459,0,1,1,4461,A
6-NA,917,4511,0,2,0,4513,A
6-NA,918,2,3,0,4571,4576,C
6-NA,919,4458,2,3,0,4463,A
6-NA,920,0,4463,0,1,4464,T
6-NA,921,4428,0,2,0,4430,A
6-NA,922,4430,1,3,0,4434,A
6-NA,923,4428,1,2,0,4431,A
6-NA,924,1,1,4473,0,4475,G
6-NA,925,0,3,4513,0,4516,G
6-NA,926,4377,2,8,0,4387,A
6-NA,927,0,4327,0,2,4329,T
6-NA,928,5,0,0,4428,4433,C
6-NA,929,4474,1,2,0,4477,A
6-NA,930,1,4471,0,4,4476,T
6-NA,931,4465,1,3,1,4470,A
6-NA,932,552,1,3833,1,4387,G
6-NA,933,0,1,0,4332,4333,C
6-NA,934,4251,0,3,0,4254,A
6-NA,935,0,3991,0,2,3993,T
6-NA,936,0,4048,0,0,4048,T
6-NA,937,0,0,4109,0,4109,G
6-NA,938,0,4113,0,2,4115,T
6-NA,939,0,4147,0,2,4149,T
6-NA,940,1,4143,0,4,4148,T
6-NA,941,3,1,0,4136,4140,C
6-NA,942,2,4,2,4131,4139,C
6-NA,943,4179,0,1,0,4180,A
6-NA,944,0,1,4209,0,4210,G
6-NA,945,0,4199,0,5,4204,T
6-NA,946,0,4075,0,4,4079,T
6-NA,947,4081,1,0,0,4082,A
6-NA,948,0,4035,0,1,4036,T
6-NA,949,3,0,4035,1,4039,G
6-NA,950,0,3973,0,4,3977,T
6-NA,951,2,0,3987,0,3989,G
6-NA,952,1,3902,0,2,3905,T
6-NA,953,3,1,3930,0,3934,G
6-NA,954,3,3920,1,3,3927,T
6-NA,955,0,3903,4,3,3910,T
6-NA,956,5,2,0,3902,3909,C
6-NA,957,3858,20,8,0,3886,A
6-NA,958,0,4,3886,0,3890,G
6-NA,959,0,5,3883,0,3888,G
6-NA,960,3850,0,7,0,3857,A
6-NA,961,1,0,1,3860,3862,C
6-NA,962,0,3728,1,1,3730,T
6-NA,963,0,3726,0,4,3730,T
6-NA,964,1,0,3781,0,3782,G
6-NA,965,0,3785,0,1,3786,T
6-NA,966,2,3773,0,3,3778,T
6-NA,967,2,1,3739,1,3743,G
6-NA,968,1,3,3736,0,3740,G
6-NA,969,3729,1,12,0,3742,A
6-NA,970,1,2,3750,0,3753,G
6-NA,971,3722,3,6,1,3732,A
6-NA,972,2,3,1,3707,3713,C
6-NA,973,3662,0,1,0,3663,A
6-NA,974,0,2,0,3672,3674,C
6-NA,975,3660,0,11,4,3675,A
6-NA,976,1,4,1,3657,3663,C
6-NA,977,5,1,0,3632,3638,C
6-NA,978,5,0,0,3645,3650,C
6-NA,979,3650,1,1,0,3652,A
6-NA,980,1,2,3662,0,3665,G
6-NA,981,3658,0,4,0,3662,A
6-NA,982,3667,0,3,0,3670,A
6-NA,983,3658,0,2,0,3660,A
6-NA,984,3658,0,1,1,3660,A
6-NA,985,3641,1,1,0,3643,A
6-NA,986,3652,2,2,0,3656,A
6-NA,987,0,4,0,3655,3659,C
6-NA,988,1,6,3644,0,3651,G
6-NA,989,3636,2,4,0,3642,A
6-NA,990,1,1,0,3637,3639,C
6-NA,991,3630,0,4,0,3634,A
6-NA,992,3,1,3641,0,3645,G
6-NA,993,1,0,0,3709,3710,C
6-NA,994,1,3702,0,3,3706,T
6-NA,995,5,1,0,3692,3698,C
6-NA,996,3,2,0,3712,3717,C
6-NA,997,3727,0,0,1,3728,A
6-NA,998,6,0,3735,0,3741,G
6-NA,999,0,0,0,3731,3731,C
6-NA,1000,3726,1,3,0,3730,A
6-NA,1001,0,2,3747,0,3749,G
6-NA,1002,1,3683,0,1,3685,T
6-NA,1003,3691,1,1,0,3693,A
6-NA,1004,1,1,3689,1,3692,G
6-NA,1005,1,3,0,3700,3704,C
6-NA,1006,4,3,1,3704,3712,C
6-NA,1007,3673,0,3,0,3676,A
6-NA,1008,0,3671,0,1,3672,T
6-NA,1009,0,3638,0,0,3638,T
6-NA,1010,2,0,3683,0,3685,G
6-NA,1011,0,3668,0,0,3668,T
6-NA,1012,0,3660,0,3,3663,T
6-NA,1013,3,3655,1,1,3660,T
6-NA,1014,3,4,3641,0,3648,G
6-NA,1015,1,4,3664,0,3669,G
6-NA,1016,3656,0,3,0,3659,A
6-NA,1017,3,3677,0,2,3682,T
6-NA,1018,3,0,0,3682,3685,C
6-NA,1019,2,2,0,3660,3664,C
6-NA,1020,5,3625,0,1,3631,T
6-NA,1021,3636,0,7,1,3644,A
6-NA,1022,3640,0,5,0,3645,A
6-NA,1023,1,0,1,3684,3686,C
6-NA,1024,3631,1,2,0,3634,A
6-NA,1025,3643,0,2,0,3645,A
6-NA,1026,0,3635,0,0,3635,T
6-NA,1027,0,3,3628,2,3633,G
6-NA,1028,3596,3,4,0,3603,A
6-NA,1029,2,1,3534,0,3537,G
6-NA,1030,1,3,3575,0,3579,G
6-NA,1031,3576,1,2,0,3579,A
6-NA,1032,3578,1,3,0,3582,A
6-NA,1033,2,2,3587,0,3591,G
6-NA,1034,0,1,3607,0,3608,G
6-NA,1035,1,3576,0,1,3578,T
6-NA,1036,1,5,3561,0,3567,G
6-NA,1037,0,0,3591,0,3591,G
6-NA,1038,1,3560,0,8,3569,T
6-NA,1039,10,0,1,3544,3555,C
6-NA,1040,3567,0,0,0,3567,A
6-NA,1041,0,3553,0,0,3553,T
6-NA,1042,1,6,3531,1,3539,G
6-NA,1043,0,4,3524,0,3528,G
6-NA,1044,1,0,3486,0,3487,G
6-NA,1045,2,0,3489,0,3491,G
6-NA,1046,1,3487,0,1,3489,T
6-NA,1047,3487,0,2,1,3490,A
6-NA,1048,3656,0,0,1,3657,A
6-NA,1049,3648,1,2,0,3651,A
6-NA,1050,3651,0,6,0,3657,A
6-NA,1051,1,0,3672,0,3673,G
6-NA,1052,3,1,3625,0,3629,G
6-NA,1053,3,4,0,3614,3621,C
6-NA,1054,0,3501,1,4,3506,T
6-NA,1055,3,2,3500,1,3506,G
6-NA,1056,1,0,3519,0,3520,G
6-NA,1057,2,0,3533,0,3535,G
6-NA,1058,1,2,0,3519,3522,C
6-NA,1059,6,0,0,3531,3537,C
6-NA,1060,0,3461,0,6,3467,T
6-NA,1061,0,3461,0,0,3461,T
6-NA,1062,0,3468,1,0,3469,T
6-NA,1063,0,2,3471,0,3473,G
6-NA,1064,3464,0,8,0,3472,A
6-NA,1065,1,3453,0,2,3456,T
6-NA,1066,3,0,3427,0,3430,G
6-NA,1067,3396,1,4,0,3401,A
6-NA,1068,0,3404,0,2,3406,T
6-NA,1069,1,1,3414,0,3416,G
6-NA,1070,3,3,3441,0,3447,G
6-NA,1071,3441,0,2,0,3443,A
6-NA,1072,3444,0,1,0,3445,A
6-NA,1073,3449,1,0,0,3450,A
6-NA,1074,0,3439,0,1,3440,T
6-NA,1075,3,2,3450,0,3455,G
6-NA,1076,3441,1,7,0,3449,A
6-NA,1077,0,0,0,3444,3444,C
6-NA,1078,1,2,3440,0,3443,G
6-NA,1079,2,3392,0,2,3396,T
6-NA,1080,2,0,3408,0,3410,G
6-NA,1081,0,3395,0,3,3398,T
6-NA,1082,1,1,3408,0,3410,G
6-NA,1083,1,2,3408,0,3411,G
6-NA,1084,3394,2,1,1,3398,A
6-NA,1085,0,3396,1,2,3399,T
6-NA,1086,1,3,3396,0,3400,G
6-NA,1087,2,5,3391,0,3398,G
6-NA,1088,2,3,3404,0,3409,G
6-NA,1089,3386,2,3,0,3391,A
6-NA,1090,3390,1,2,0,3393,A
6-NA,1091,0,3,3391,0,3394,G
6-NA,1092,3371,0,2,1,3374,A
6-NA,1093,3370,0,4,0,3374,A
6-NA,1094,0,2,0,3367,3369,C
6-NA,1095,1,6,3358,0,3365,G
6-NA,1096,3354,0,7,0,3361,A
6-NA,1097,0,3325,1,3,3329,T
6-NA,1098,5,0,0,3328,3333,C
6-NA,1099,3263,0,2,3,3268,A
6-NA,1100,0,1,3272,0,3273,G
6-NA,1101,1,2,0,3255,3258,C
6-NA,1102,3,2,3255,0,3260,G
6-NA,1103,3249,1,2,0,3252,A
6-NA,1104,0,4,3254,0,3258,G
6-NA,1105,3246,1,2,0,3249,A
6-NA,1106,3255,1,3,0,3259,A
6-NA,1107,3,0,3270,0,3273,G
6-NA,1108,0,3258,3,5,3266,T
6-NA,1109,3,0,2,3249,3254,C
6-NA,1110,3250,1,2,0,3253,A
6-NA,1111,1,1,1,3311,3314,C
6-NA,1112,1,2,3313,0,3316,G
6-NA,1113,5,1,0,3307,3313,C
6-NA,1114,0,3274,0,3,3277,T
6-NA,1115,0,3282,1,0,3283,T
6-NA,1116,3232,0,4,1,3237,A
6-NA,1117,0,2,3281,0,3283,G
6-NA,1118,2,4,3273,0,3279,G
6-NA,1119,0,1,3323,0,3324,G
6-NA,1120,0,3191,2,4,3197,T
6-NA,1121,3167,1,2,0,3170,A
6-NA,1122,2,3152,2,5,3161,T
6-NA,1123,2,0,3161,1,3164,G
6-NA,1124,3157,1,3,0,3161,A
6-NA,1125,3154,0,2,0,3156,A
6-NA,1126,3077,0,3,1,3081,A
6-NA,1127,1,2,0,3003,3006,C
6-NA,1128,3,0,0,2752,2755,C
6-NA,1129,1,2196,2,0,2199,T
6-NA,1130,1,2186,0,3,2190,T
6-NA,1131,5,3,0,2184,2192,C
6-NA,1132,2184,0,1,1,2186,A
6-NA,1133,2192,0,0,0,2192,A
6-NA,1134,2186,1,4,0,2191,A
6-NA,1135,0,1,2196,0,2197,G
6-NA,1136,2,2157,0,1,2160,T
6-NA,1137,4,2,0,2150,2156,C
6-NA,1138,2166,1,3,0,2170,A
6-NA,1139,0,2159,0,2,2161,T
6-NA,1140,1,2168,0,0,2169,T
6-NA,1141,0,1,2175,0,2176,G
6-NA,1142,2163,2,1,0,2166,A
6-NA,1143,2160,1,2,0,2163,A
6-NA,1144,0,2,2172,1,2175,G
6-NA,1145,0,1,2167,0,2168,G
6-NA,1146,0,0,0,2166,2166,C
6-NA,1147,0,2101,0,3,2104,T
6-NA,1148,0,1,2122,0,2123,G
6-NA,1149,0,0,2156,0,2156,G
6-NA,1150,1,2154,0,5,2160,T
6-NA,1151,2,1,2,2145,2150,C
6-NA,1152,1,1,0,2148,2150,C
6-NA,1153,2138,0,1,0,2139,A
6-NA,1154,2151,0,1,0,2152,A
6-NA,1155,1,0,0,2150,2151,C
6-NA,1156,1,2,0,2087,2090,C
6-NA,1157,1,0,0,2073,2074,C
6-NA,1158,1,1961,0,1,1963,T
6-NA,1159,1969,0,0,1,1970,A
6-NA,1160,1968,0,3,1,1972,A
6-NA,1161,0,0,1980,0,1980,G
6-NA,1162,0,1965,0,4,1969,T
6-NA,1163,6,1,0,1950,1957,C
6-NA,1164,3,3,0,1928,1934,C
6-NA,1165,1934,0,1,0,1935,A
6-NA,1166,1933,0,0,0,1933,A
6-NA,1167,1936,0,0,0,1936,A
6-NA,1168,1,1928,1,1,1931,T
6-NA,1169,0,1926,0,0,1926,T
6-NA,1170,0,0,1917,0,1917,G
6-NA,1171,2,0,1,1912,1915,C
6-NA,1172,1912,0,2,0,1914,A
6-NA,1173,1,2,1913,1,1917,G
6-NA,1174,1908,1,1,1,1911,A
6-NA,1175,0,1945,0,0,1945,T
6-NA,1176,1945,0,0,0,1945,A
6-NA,1177,1938,0,1,0,1939,A
6-NA,1178,1938,1,3,0,1942,A
6-NA,1179,0,1925,0,2,1927,T
6-NA,1180,1932,0,2,0,1934,A
6-NA,1181,1,0,1929,0,1930,G
6-NA,1182,1,0,1914,0,1915,G
6-NA,1183,2,0,0,1898,1900,C
6-NA,1184,1846,0,1,1,1848,A
6-NA,1185,1858,0,2,0,1860,A
6-NA,1186,0,1,1871,0,1872,G
6-NA,1187,1,1865,1,0,1867,T
6-NA,1188,4,0,0,1866,1870,C
6-NA,1189,1868,7,1,0,1876,A
6-NA,1190,0,1871,0,1,1872,T
6-NA,1191,1873,1,2,0,1876,A
6-NA,1192,1,1,1879,0,1881,G
6-NA,1193,1,1872,0,1,1874,T
6-NA,1194,0,1815,0,1,1816,T
6-NA,1195,1,2,1793,1,1797,G
6-NA,1196,1784,0,3,0,1787,A
6-NA,1197,0,2,0,1779,1781,C
6-NA,1198,1756,0,1,0,1757,A
6-NA,1199,0,3,1769,0,1772,G
6-NA,1200,1752,0,1,0,1753,A
6-NA,1201,0,0,1817,0,1817,G
6-NA,1202,0,0,1824,0,1824,G
6-NA,1203,0,1811,0,2,1813,T
6-NA,1204,1811,0,1,1,1813,A
6-NA,1205,1811,0,1,0,1812,A
6-NA,1206,0,1810,0,0,1810,T
6-NA,1207,1811,1,2,0,1814,A
6-NA,1208,1,3,1790,0,1794,G
6-NA,1209,2,1,1754,0,1757,G
6-NA,1210,0,1593,0,1,1594,T
6-NA,1211,4,1,0,1572,1577,C
6-NA,1212,1,1471,0,68,1540,T
6-NA,1213,0,2,1562,0,1564,G
6-NA,1214,0,0,1570,0,1570,G
6-NA,1215,0,1568,0,0,1568,T
6-NA,1216,0,1567,0,0,1567,T
6-NA,1217,1498,0,0,0,1498,A
6-NA,1218,0,1467,0,0,1467,T
6-NA,1219,0,1463,0,1,1464,T
6-NA,1220,1,0,0,1472,1473,C
6-NA,1221,0,1426,0,0,1426,T
6-NA,1222,0,3,1411,0,1414,G
6-NA,1223,0,0,1416,0,1416,G
6-NA,1224,1,1413,0,0,1414,T
6-NA,1225,1415,0,1,0,1416,A
6-NA,1226,0,1394,1,2,1397,T
6-NA,1227,0,1397,0,4,1401,T
6-NA,1228,1,1397,0,2,1400,T
6-NA,1229,0,1399,0,3,1402,T
6-NA,1230,2,0,0,1397,1399,C
6-NA,1231,0,1377,0,0,1377,T
6-NA,1232,2,0,0,1381,1383,C
6-NA,1233,0,1373,2,2,1377,T
6-NA,1234,0,0,1387,0,1387,G
6-NA,1235,2,1377,1,2,1382,T
6-NA,1236,0,1376,1,2,1379,T
6-NA,1237,0,1,1380,0,1381,G
6-NA,1238,1366,0,0,0,1366,A
6-NA,1239,1363,0,1,1,1365,A
6-NA,1240,2,0,1375,0,1377,G
6-NA,1241,0,1,1368,0,1369,G
6-NA,1242,0,1,0,1371,1372,C
6-NA,1243,1344,0,2,0,1346,A
6-NA,1244,1352,0,0,0,1352,A
6-NA,1245,1353,0,1,0,1354,A
6-NA,1246,1349,3,6,0,1358,A
6-NA,1247,0,0,1358,0,1358,G
6-NA,1248,1,0,0,1353,1354,C
6-NA,1249,0,1334,0,0,1334,T
6-NA,1250,1,0,1338,0,1339,G
6-NA,1251,1,0,0,1339,1340,C
6-NA,1252,1344,0,2,0,1346,A
6-NA,1253,0,1337,0,2,1339,T
6-NA,1254,0,0,0,1337,1337,C
6-NA,1255,1336,0,0,0,1336,A
6-NA,1256,1331,0,0,0,1331,A
6-NA,1257,1,1327,0,0,1328,T
6-NA,1258,1,0,0,1331,1332,C
6-NA,1259,0,1,1315,0,1316,G
6-NA,1260,0,0,1332,0,1332,G
6-NA,1261,0,1328,1,2,1331,T
6-NA,1262,0,0,1331,0,1331,G
6-NA,1263,1,0,0,1331,1332,C
6-NA,1264,0,1316,0,9,1325,T
6-NA,1265,0,1344,0,0,1344,T
6-NA,1266,0,1341,0,0,1341,T
6-NA,1267,0,1344,1,1,1346,T
6-NA,1268,1352,0,1,0,1353,A
6-NA,1269,1,1302,0,1,1304,T
6-NA,1270,1,0,1307,0,1308,G
6-NA,1271,0,1279,0,0,1279,T
6-NA,1272,0,0,1267,0,1267,G
6-NA,1273,0,2,1286,0,1288,G
6-NA,1274,1263,0,1,0,1264,A
6-NA,1275,0,0,1282,0,1282,G
6-NA,1276,2,1270,0,0,1272,T
6-NA,1277,0,1257,0,2,1259,T
6-NA,1278,1,0,1263,0,1264,G
6-NA,1279,1265,0,1,0,1266,A
6-NA,1280,0,1265,0,0,1265,T
6-NA,1281,1264,0,0,0,1264,A
6-NA,1282,1222,0,4,0,1226,A
6-NA,1283,0,1,1242,0,1243,G
6-NA,1284,0,5,1217,0,1222,G
6-NA,1285,0,1,1213,0,1214,G
6-NA,1286,2,3,1205,0,1210,G
6-NA,1287,1198,0,0,0,1198,A
6-NA,1288,1194,0,3,0,1197,A
6-NA,1289,0,0,1200,0,1200,G
6-NA,1290,1196,0,0,0,1196,A
6-NA,1291,1191,0,0,0,1191,A
6-NA,1292,1181,0,0,0,1181,A
6-NA,1293,1158,1,2,0,1161,A
6-NA,1294,0,1,1159,0,1160,G
6-NA,1295,1149,0,1,0,1150,A
6-NA,1296,1,0,1148,0,1149,G
6-NA,1297,0,0,1153,0,1153,G
6-NA,1298,1139,0,1,0,1140,A
6-NA,1299,1133,0,1,0,1134,A
6-NA,1300,1136,0,1,0,1137,A
6-NA,1301,0,2,0,1137,1139,C
6-NA,1302,0,1135,1,0,1136,T
6-NA,1303,0,2,1135,0,1137,G
6-NA,1304,1130,0,0,0,1130,A
6-NA,1305,1126,0,2,0,1128,A
6-NA,1306,0,0,1134,0,1134,G
6-NA,1307,0,1116,0,2,1118,T
6-NA,1308,1,0,0,1124,1125,C
6-NA,1309,0,1118,0,2,1120,T
6-NA,1310,0,1106,0,2,1108,T
6-NA,1311,1,0,1109,0,1110,G
6-NA,1312,0,1098,1,1,1100,T
6-NA,1313,0,0,1101,1,1102,G
6-NA,1314,2,1,1100,0,1103,G
6-NA,1315,1090,0,1,0,1091,A
6-NA,1316,1,0,0,1091,1092,C
6-NA,1317,2,1,0,1068,1071,C
6-NA,1318,0,1062,1,0,1063,T
6-NA,1319,1,2,0,1064,1067,C
6-NA,1320,1070,0,0,0,1070,A
6-NA,1321,1070,0,0,0,1070,A
6-NA,1322,1068,0,0,1,1069,A
6-NA,1323,0,0,0,1079,1079,C
6-NA,1324,1054,0,0,0,1054,A
6-NA,1325,0,0,1066,0,1066,G
6-NA,1326,1,1053,0,0,1054,T
6-NA,1327,1053,0,0,0,1053,A
6-NA,1328,0,1047,0,0,1047,T
6-NA,1329,0,1026,0,2,1028,T
6-NA,1330,0,0,1036,0,1036,G
6-NA,1331,0,1028,0,1,1029,T
6-NA,1332,0,970,0,1,971,T
6-NA,1333,1,0,971,0,972,G
6-NA,1334,0,896,0,3,899,T
6-NA,1335,0,0,900,0,900,G
6-NA,1336,0,894,0,0,894,T
6-NA,1337,0,884,0,0,884,T
6-NA,1338,0,884,0,0,884,T
6-NA,1339,0,861,0,0,861,T
6-NA,1340,1,0,861,0,862,G
6-NA,1341,0,857,0,2,859,T
6-NA,1342,0,1,851,0,852,G
6-NA,1343,0,0,852,0,852,G
6-NA,1344,0,0,0,838,838,C
6-NA,1345,838,0,1,0,839,A
6-NA,1346,0,1,0,844,845,C
6-NA,1347,1,0,0,843,844,C
6-NA,1348,0,839,0,1,840,T
6-NA,1349,3,0,0,837,840,C
6-NA,1350,831,1,4,0,836,A
6-NA,1351,0,1,839,1,841,G
6-NA,1352,1,0,839,0,840,G
6-NA,1353,0,836,0,2,838,T
6-NA,1354,825,0,2,0,827,A
6-NA,1355,0,0,0,785,785,C
6-NA,1356,778,0,0,0,778,A
6-NA,1357,0,776,0,0,776,T
6-NA,1358,753,0,1,0,754,A
6-NA,1359,0,752,0,0,752,T
6-NA,1360,0,0,697,0,697,G
6-NA,1361,0,0,694,0,694,G
6-NA,1362,691,0,0,0,691,A
6-NA,1363,686,0,1,0,687,A
6-NA,1364,1,0,0,684,685,C
6-NA,1365,590,0,0,0,590,A
6-NA,1366,0,0,589,0,589,G
6-NA,1367,0,0,591,0,591,G
6-NA,1368,0,0,0,590,590,C
6-NA,1369,2,587,0,0,589,T
6-NA,1370,0,0,0,560,560,C
6-NA,1371,555,0,0,0,555,A
6-NA,1372,0,555,0,0,555,T
6-NA,1373,0,0,553,0,553,G
6-NA,1374,0,0,555,0,555,G
6-NA,1375,0,0,0,533,533,C
6-NA,1376,0,1,0,528,529,C
6-NA,1377,0,509,0,0,509,T
6-NA,1378,0,1,509,0,510,G
6-NA,1379,510,0,0,0,510,A
6-NA,1380,0,508,1,0,509,T
6-NA,1381,0,0,503,0,503,G
6-NA,1382,0,2,495,0,497,G
6-NA,1383,1,0,472,0,473,G
6-NA,1384,1,0,471,0,472,G
6-NA,1385,0,0,0,465,465,C
6-NA,1386,0,2,461,0,463,G
6-NA,1387,0,0,462,0,462,G
6-NA,1388,452,0,1,0,453,A
6-NA,1389,1,0,0,451,452,C
6-NA,1390,453,0,0,0,453,A
6-NA,1391,0,447,0,0,447,T
6-NA,1392,0,0,0,445,445,C
6-NA,1393,438,0,0,0,438,A
6-NA,1394,436,0,0,0,436,A
6-NA,1395,0,436,0,0,436,T
6-NA,1396,0,0,0,427,427,C
6-NA,1397,0,412,0,0,412,T
6-NA,1398,0,0,0,353,353,C
6-NA,1399,351,0,0,0,351,A
6-NA,1400,0,350,0,0,350,T
6-NA,1401,0,0,350,0,350,G
6-NA,1402,0,3,0,344,347,C
6-NA,1403,0,0,0,333,333,C
6-NA,1404,1,292,0,1,294,T
6-NA,1405,290,0,0,0,290,A
6-NA,1406,0,289,0,0,289,T
6-NA,1407,281,0,0,0,281,A
6-NA,1408,0,279,0,0,279,T
6-NA,1409,261,0,0,0,261,A
6-NA,1410,243,0,0,0,243,A
7-M,1,88,0,0,0,88,A
7-M,2,0,88,0,0,88,T
7-M,3,0,0,86,0,86,G
7-M,4,92,0,0,0,92,A
7-M,5,0,0,102,0,102,G
7-M,6,0,0,0,105,105,C
7-M,7,0,0,0,111,111,C
7-M,8,0,125,0,0,125,T
7-M,9,0,125,0,0,125,T
7-M,10,0,0,0,125,125,C
7-M,11,0,125,0,0,125,T
7-M,12,126,0,0,0,126,A
7-M,13,124,0,0,1,125,A
7-M,14,0,0,0,126,126,C
7-M,15,1,0,0,126,127,C
7-M,16,0,0,127,0,127,G
7-M,17,125,0,0,0,125,A
7-M,18,0,0,128,0,128,G
7-M,19,0,0,132,0,132,G
7-M,20,0,132,0,0,132,T
7-M,21,0,1,0,132,133,C
7-M,22,0,0,134,0,134,G
7-M,23,139,0,0,0,139,A
7-M,24,147,0,0,0,147,A
7-M,25,147,0,0,0,147,A
7-M,26,0,0,0,168,168,C
7-M,27,0,0,168,0,168,G
7-M,28,0,168,0,0,168,T
7-M,29,168,0,0,0,168,A
7-M,30,0,169,0,0,169,T
7-M,31,0,0,171,0,171,G
7-M,32,0,174,0,0,174,T
7-M,33,0,184,0,0,184,T
7-M,34,0,0,0,192,192,C
7-M,35,0,195,0,0,195,T
7-M,36,0,0,0,205,205,C
7-M,37,0,203,0,1,204,T
7-M,38,0,0,0,219,219,C
7-M,39,0,219,0,1,220,T
7-M,40,220,0,0,0,220,A
7-M,41,0,220,0,0,220,T
7-M,42,0,0,0,222,222,C
7-M,43,3,0,219,0,222,G
7-M,44,0,223,0,0,223,T
7-M,45,0,223,0,0,223,T
7-M,46,0,0,0,224,224,C
7-M,47,0,0,0,227,227,C
7-M,48,232,0,0,0,232,A
7-M,49,1,230,0,0,231,T
7-M,50,0,0,0,233,233,C
7-M,51,231,0,2,0,233,A
7-M,52,1,1,233,0,235,G
7-M,53,0,0,236,0,236,G
7-M,54,0,0,0,236,236,C
7-M,55,0,0,0,234,234,C
7-M,56,0,0,0,232,232,C
7-M,57,0,0,1,241,242,C
7-M,58,0,0,0,244,244,C
7-M,59,0,242,0,1,243,T
7-M,60,1,0,0,243,244,C
7-M,61,246,0,0,0,246,A
7-M,62,244,0,2,0,246,A
7-M,63,252,0,0,0,252,A
7-M,64,1,0,253,0,254,G
7-M,65,0,0,0,255,255,C
7-M,66,0,0,0,251,251,C
7-M,67,0,0,248,4,252,G
7-M,68,253,0,0,0,253,A
7-M,69,0,1,251,0,252,G
7-M,70,252,0,0,0,252,A
7-M,71,0,252,0,0,252,T
7-M,72,0,0,0,247,247,C
7-M,73,0,0,250,0,250,G
7-M,74,0,1,0,249,250,C
7-M,75,0,0,250,0,250,G
7-M,76,0,0,0,248,248,C
7-M,77,251,0,0,0,251,A
7-M,78,0,1,253,0,254,G
7-M,79,251,0,1,0,252,A
7-M,80,0,1,280,0,281,G
7-M,81,283,0,0,0,283,A
7-M,82,0,0,0,284,284,C
7-M,83,0,284,0,1,285,T
7-M,84,0,286,0,0,286,T
7-M,85,0,1,286,0,287,G
7-M,86,289,0,0,0,289,A
7-M,87,288,0,1,0,289,A
7-M,88,0,0,286,0,286,G
7-M,89,288,0,0,0,288,A
7-M,90,0,293,0,0,293,T
7-M,91,0,0,296,0,296,G
7-M,92,0,295,0,0,295,T
7-M,93,1,0,0,294,295,C
7-M,94,0,295,0,0,295,T
7-M,95,0,297,0,0,297,T
7-M,96,0,297,0,0,297,T
7-M,97,0,0,297,0,297,G
7-M,98,0,0,0,298,298,C
7-M,99,0,298,0,0,298,T
7-M,100,0,0,298,0,298,G
7-M,101,1,0,301,0,302,G
7-M,102,0,0,306,0,306,G
7-M,103,305,0,0,0,305,A
7-M,104,304,1,0,0,305,A
7-M,105,302,0,1,0,303,A
7-M,106,303,0,1,0,304,A
7-M,107,305,0,0,2,307,A
7-M,108,0,0,0,314,314,C
7-M,109,313,1,0,0,314,A
7-M,110,0,0,0,314,314,C
7-M,111,311,0,0,0,311,A
7-M,112,0,1,321,0,322,G
7-M,113,325,0,0,0,325,A
7-M,114,0,329,0,0,329,T
7-M,115,0,0,0,333,333,C
7-M,116,0,331,0,0,331,T
7-M,117,0,330,0,0,330,T
7-M,118,0,0,331,0,331,G
7-M,119,327,0,0,0,327,A
7-M,120,0,1,330,0,331,G
7-M,121,0,0,331,0,331,G
7-M,122,0,0,0,335,335,C
7-M,123,0,333,0,0,333,T
7-M,124,0,0,0,357,357,C
7-M,125,0,359,0,0,359,T
7-M,126,0,0,0,360,360,C
7-M,127,358,0,0,0,358,A
7-M,128,0,358,0,1,359,T
7-M,129,0,1,359,0,360,G
7-M,130,0,1,357,0,358,G
7-M,131,357,0,0,0,357,A
7-M,132,358,0,0,0,358,A
7-M,133,0,349,0,0,349,T
7-M,134,0,0,364,0,364,G
7-M,135,0,0,383,0,383,G
7-M,136,1,0,0,383,384,C
7-M,137,0,383,0,0,383,T
7-M,138,382,0,1,0,383,A
7-M,139,382,0,0,0,382,A
7-M,140,383,0,0,0,383,A
7-M,141,0,0,383,0,383,G
7-M,142,388,0,0,0,388,A
7-M,143,0,1,0,384,385,C
7-M,144,382,0,0,1,383,A
7-M,145,381,0,1,0,382,A
7-M,146,0,0,395,0,395,G
7-M,147,395,0,0,0,395,A
7-M,148,0,1,0,391,392,C
7-M,149,1,0,0,392,393,C
7-M,150,391,0,0,0,391,A
7-M,151,395,0,0,0,395,A
7-M,152,0,398,0,0,398,T
7-M,153,0,397,0,0,397,T
7-M,154,1,0,0,398,399,C
7-M,155,0,397,0,0,397,T
7-M,156,0,0,398,0,398,G
7-M,157,0,398,0,0,398,T
7-M,158,2,0,0,395,397,C
7-M,159,398,0,0,0,398,A
7-M,160,0,0,0,409,409,C
7-M,161,0,0,0,407,407,C
7-M,162,0,403,0,2,405,T
7-M,163,1,0,0,407,408,C
7-M,164,0,408,0,0,408,T
7-M,165,0,0,434,0,434,G
7-M,166,433,0,0,0,433,A
7-M,167,0,0,0,485,485,C
7-M,168,0,485,0,0,485,T
7-M,169,480,0,0,0,480,A
7-M,170,478,0,1,0,479,A
7-M,171,135,0,345,0,480,G
7-M,172,0,1,479,0,480,G
7-M,173,0,1,481,0,482,G
7-M,174,1,0,484,0,485,G
7-M,175,486,0,0,0,486,A
7-M,176,0,470,0,1,471,T
7-M,177,0,467,0,0,467,T
7-M,178,0,464,0,0,464,T
7-M,179,0,465,0,0,465,T
7-M,180,1,0,463,0,464,G
7-M,181,1,0,470,0,471,G
7-M,182,0,2,465,0,467,G
7-M,183,0,0,470,0,470,G
7-M,184,0,464,0,0,464,T
7-M,185,0,465,0,0,465,T
7-M,186,0,464,0,0,464,T
7-M,187,0,0,473,0,473,G
7-M,188,0,474,0,1,475,T
7-M,189,0,0,478,0,478,G
7-M,190,0,476,0,1,477,T
7-M,191,0,476,0,0,476,T
7-M,192,0,1,0,478,479,C
7-M,193,479,0,0,0,479,A
7-M,194,1,0,0,487,488,C
7-M,195,0,0,489,0,489,G
7-M,196,0,2,0,485,487,C
7-M,197,1,483,0,0,484,T
7-M,198,1,0,0,487,488,C
7-M,199,488,0,0,0,488,A
7-M,200,0,0,0,492,492,C
7-M,201,2,1,0,489,492,C
7-M,202,0,0,494,0,494,G
7-M,203,0,497,1,0,498,T
7-M,204,0,0,501,0,501,G
7-M,205,0,0,0,500,500,C
7-M,206,2,0,0,500,502,C
7-M,207,0,0,0,503,503,C
7-M,208,498,0,1,0,499,A
7-M,209,0,0,507,0,507,G
7-M,210,0,503,0,0,503,T
7-M,211,0,1,505,0,506,G
7-M,212,504,0,0,0,504,A
7-M,213,0,0,507,0,507,G
7-M,214,0,1,0,506,507,C
7-M,215,0,3,501,0,504,G
7-M,216,0,0,502,0,502,G
7-M,217,0,1,515,0,516,G
7-M,218,0,1,515,0,516,G
7-M,219,515,0,1,0,516,A
7-M,220,0,0,0,524,524,C
7-M,221,0,523,0,0,523,T
7-M,222,0,0,525,0,525,G
7-M,223,0,1,0,523,524,C
7-M,224,524,0,1,0,525,A
7-M,225,0,0,531,0,531,G
7-M,226,0,0,0,532,532,C
7-M,227,0,0,535,0,535,G
7-M,228,1,534,0,0,535,T
7-M,229,533,0,0,0,533,A
7-M,230,0,0,532,0,532,G
7-M,231,532,0,1,0,533,A
7-M,232,0,0,0,531,531,C
7-M,233,0,0,533,0,533,G
7-M,234,0,0,0,532,532,C
7-M,235,0,511,0,1,512,T
7-M,236,0,513,0,0,513,T
7-M,237,0,513,0,0,513,T
7-M,238,0,0,528,0,528,G
7-M,239,1,527,0,0,528,T
7-M,240,1,0,0,529,530,C
7-M,241,0,1,0,525,526,C
7-M,242,527,0,0,0,527,A
7-M,243,527,0,1,0,528,A
7-M,244,528,0,0,0,528,A
7-M,245,526,1,0,0,527,A
7-M,246,0,528,0,0,528,T
7-M,247,0,0,526,0,526,G
7-M,248,0,0,0,517,517,C
7-M,249,0,0,0,514,514,C
7-M,250,1,0,0,526,527,C
7-M,251,0,523,0,2,525,T
7-M,252,0,0,0,536,536,C
7-M,253,537,0,0,0,537,A
7-M,254,534,0,0,2,536,A
7-M,255,0,538,0,0,538,T
7-M,256,0,1,542,0,543,G
7-M,257,0,0,549,0,549,G
7-M,258,1,1,548,0,550,G
7-M,259,549,1,0,0,550,A
7-M,260,548,0,0,0,548,A
7-M,261,0,539,0,1,540,T
7-M,262,1,0,538,0,539,G
7-M,263,0,2,534,0,536,G
7-M,264,533,0,1,0,534,A
7-M,265,0,3,534,0,537,G
7-M,266,530,0,0,0,530,A
7-M,267,0,0,0,523,523,C
7-M,268,0,0,0,531,531,C
7-M,269,1,0,0,535,536,C
7-M,270,540,0,0,0,540,A
7-M,271,538,1,0,0,539,A
7-M,272,540,0,0,0,540,A
7-M,273,0,546,0,0,546,T
7-M,274,560,0,0,0,560,A
7-M,275,560,0,1,0,561,A
7-M,276,1,0,0,546,547,C
7-M,277,543,0,2,0,545,A
7-M,278,1,546,0,0,547,T
7-M,279,1,2,547,0,550,G
7-M,280,0,0,551,0,551,G
7-M,281,551,0,0,0,551,A
7-M,282,0,0,0,550,550,C
7-M,283,540,0,0,0,540,A
7-M,284,543,0,0,0,543,A
7-M,285,543,0,1,0,544,A
7-M,286,0,1,546,0,547,G
7-M,287,0,0,0,567,567,C
7-M,288,561,0,0,0,561,A
7-M,289,0,1,567,0,568,G
7-M,290,0,566,0,1,567,T
7-M,291,0,568,0,0,568,T
7-M,292,568,0,0,0,568,A
7-M,293,568,0,0,0,568,A
7-M,294,567,0,0,0,567,A
7-M,295,0,0,0,582,582,C
7-M,296,0,559,0,0,559,T
7-M,297,0,0,609,0,609,G
7-M,298,0,604,0,0,604,T
7-M,299,610,0,0,0,610,A
7-M,300,0,610,0,0,610,T
7-M,301,606,0,0,0,606,A
7-M,302,0,1,605,0,606,G
7-M,303,0,0,603,0,603,G
7-M,304,596,0,0,0,596,A
7-M,305,598,0,0,0,598,A
7-M,306,565,0,0,0,565,A
7-M,307,0,0,0,564,564,C
7-M,308,1,564,0,0,565,T
7-M,309,0,567,0,0,567,T
7-M,310,565,0,0,0,565,A
7-M,311,565,0,0,0,565,A
7-M,312,0,1,563,0,564,G
7-M,313,561,1,0,0,562,A
7-M,314,0,1,561,0,562,G
7-M,315,548,0,0,0,548,A
7-M,316,0,0,549,0,549,G
7-M,317,549,0,0,0,549,A
7-M,318,549,0,0,0,549,A
7-M,319,571,0,2,0,573,A
7-M,320,0,572,0,0,572,T
7-M,321,573,0,0,0,573,A
7-M,322,576,0,1,0,577,A
7-M,323,0,0,0,578,578,C
7-M,324,1,0,578,0,579,G
7-M,325,0,571,0,1,572,T
7-M,326,0,571,0,0,571,T
7-M,327,0,0,1,574,575,C
7-M,328,0,0,0,572,572,C
7-M,329,575,0,0,0,575,A
7-M,330,0,573,0,0,573,T
7-M,331,0,0,568,0,568,G
7-M,332,0,0,577,0,577,G
7-M,333,0,0,575,0,575,G
7-M,334,0,1,573,0,574,G
7-M,335,0,1,0,574,575,C
7-M,336,0,0,0,578,578,C
7-M,337,582,0,0,0,582,A
7-M,338,583,0,0,0,583,A
7-M,339,582,0,0,0,582,A
7-M,340,0,1,592,0,593,G
7-M,341,596,0,0,0,596,A
7-M,342,592,0,0,0,592,A
7-M,343,591,0,1,0,592,A
7-M,344,0,596,0,0,596,T
7-M,345,592,0,2,0,594,A
7-M,346,0,0,598,0,598,G
7-M,347,0,0,0,592,592,C
7-M,348,0,594,0,0,594,T
7-M,349,1,0,0,592,593,C
7-M,350,0,588,0,0,588,T
7-M,351,0,0,0,609,609,C
7-M,352,609,0,0,0,609,A
7-M,353,0,0,611,0,611,G
7-M,354,0,603,0,0,603,T
7-M,355,0,607,0,1,608,T
7-M,356,609,0,0,0,609,A
7-M,357,0,609,0,0,609,T
7-M,358,0,605,0,0,605,T
7-M,359,0,0,0,611,611,C
7-M,360,0,593,0,0,593,T
7-M,361,1,0,598,0,599,G
7-M,362,0,0,0,601,601,C
7-M,363,0,599,0,0,599,T
7-M,364,0,1,597,0,598,G
7-M,365,0,0,599,0,599,G
7-M,366,0,599,0,1,600,T
7-M,367,0,0,597,0,597,G
7-M,368,0,0,0,601,601,C
7-M,369,603,0,0,0,603,A
7-M,370,0,0,0,603,603,C
7-M,371,0,596,0,0,596,T
7-M,372,0,600,0,0,600,T
7-M,373,1,0,599,0,600,G
7-M,374,0,1,1,598,600,C
7-M,375,0,0,0,598,598,C
7-M,376,598,0,0,0,598,A
7-M,377,0,0,597,0,597,G
7-M,378,0,597,0,1,598,T
7-M,379,0,594,0,2,596,T
7-M,380,0,0,606,0,606,G
7-M,381,1,0,0,594,595,C
7-M,382,598,0,0,0,598,A
7-M,383,0,596,0,2,598,T
7-M,384,0,1,595,0,596,G
7-M,385,1,1,596,0,598,G
7-M,386,0,0,602,0,602,G
7-M,387,0,1,0,603,604,C
7-M,388,0,0,0,620,620,C
7-M,389,0,615,0,0,615,T
7-M,390,2,0,0,614,616,C
7-M,391,642,1,0,0,643,A
7-M,392,0,646,0,0,646,T
7-M,393,665,0,0,0,665,A
7-M,394,0,660,0,0,660,T
7-M,395,646,0,0,0,646,A
7-M,396,0,0,0,677,677,C
7-M,397,654,0,0,0,654,A
7-M,398,657,0,0,0,657,A
7-M,399,0,653,0,1,654,T
7-M,400,637,0,0,0,637,A
7-M,401,0,1,641,0,642,G
7-M,402,0,0,635,0,635,G
7-M,403,632,0,0,0,632,A
7-M,404,0,630,0,1,631,T
7-M,405,0,0,581,0,581,G
7-M,406,0,0,581,0,581,G
7-M,407,0,1,583,0,584,G
7-M,408,0,0,584,0,584,G
7-M,409,0,0,588,0,588,G
7-M,410,0,0,0,582,582,C
7-M,411,0,578,0,1,579,T
7-M,412,1,0,577,0,578,G
7-M,413,0,581,0,0,581,T
7-M,414,581,0,0,0,581,A
7-M,415,580,0,0,0,580,A
7-M,416,0,0,0,582,582,C
7-M,417,0,1,0,572,573,C
7-M,418,569,0,0,0,569,A
7-M,419,0,0,0,574,574,C
7-M,420,0,575,0,0,575,T
7-M,421,0,0,582,0,582,G
7-M,422,584,0,0,0,584,A
7-M,423,578,0,1,0,579,A
7-M,424,0,0,582,0,582,G
7-M,425,0,573,0,0,573,T
7-M,426,0,0,574,0,574,G
7-M,427,2,0,575,0,577,G
7-M,428,1,0,0,576,577,C
7-M,429,574,0,0,0,574,A
7-M,430,0,571,0,0,571,T
7-M,431,0,572,0,0,572,T
7-M,432,0,573,0,0,573,T
7-M,433,0,0,579,0,579,G
7-M,434,0,0,581,0,581,G
7-M,435,0,0,0,579,579,C
7-M,436,0,0,0,581,581,C
7-M,437,0,578,0,0,578,T
7-M,438,1,0,599,0,600,G
7-M,439,0,0,602,0,602,G
7-M,440,0,603,0,0,603,T
7-M,441,604,1,0,0,605,A
7-M,442,0,585,1,0,586,T
7-M,443,0,0,594,0,594,G
7-M,444,0,596,0,1,597,T
7-M,445,0,0,594,0,594,G
7-M,446,1,2,0,596,599,C
7-M,447,583,0,0,0,583,A
7-M,448,578,1,1,0,580,A
7-M,449,0,0,0,589,589,C
7-M,450,594,0,0,0,594,A
7-M,451,0,597,0,0,597,T
7-M,452,0,0,591,0,591,G
7-M,453,0,582,0,0,582,T
7-M,454,0,1,579,0,580,G
7-M,455,578,1,0,0,579,A
7-M,456,0,0,583,0,583,G
7-M,457,0,0,0,583,583,C
7-M,458,573,0,1,0,574,A
7-M,459,0,0,575,0,575,G
7-M,460,574,0,0,0,574,A
7-M,461,0,572,0,0,572,T
7-M,462,0,572,0,0,572,T
7-M,463,1,0,572,0,573,G
7-M,464,0,0,0,572,572,C
7-M,465,0,570,0,0,570,T
7-M,466,0,1,568,0,569,G
7-M,467,568,0,0,0,568,A
7-M,468,1,0,0,581,582,C
7-M,469,0,582,0,1,583,T
7-M,470,0,0,0,585,585,C
7-M,471,2,0,0,576,578,C
7-M,472,1,0,0,585,586,C
7-M,473,583,0,0,0,583,A
7-M,474,0,0,586,0,586,G
7-M,475,0,0,0,584,584,C
7-M,476,587,0,0,0,587,A
7-M,477,1,0,0,582,583,C
7-M,478,560,0,0,0,560,A
7-M,479,0,0,571,0,571,G
7-M,480,0,0,573,0,573,G
7-M,481,1,572,0,0,573,T
7-M,482,1,0,0,580,581,C
7-M,483,0,574,0,1,575,T
7-M,484,0,0,0,579,579,C
7-M,485,578,0,0,0,578,A
7-M,486,1,576,0,1,578,T
7-M,487,576,0,0,0,576,A
7-M,488,1,1,569,0,571,G
7-M,489,1,1,566,0,568,G
7-M,490,1,0,0,567,568,C
7-M,491,552,0,0,0,552,A
7-M,492,0,0,544,0,544,G
7-M,493,555,0,0,0,555,A
7-M,494,0,555,0,0,555,T
7-M,495,1,2,551,0,554,G
7-M,496,0,1,555,0,556,G
7-M,497,0,548,0,1,549,T
7-M,498,0,0,558,0,558,G
7-M,499,0,0,557,0,557,G
7-M,500,0,0,0,559,559,C
7-M,501,552,0,0,0,552,A
7-M,502,551,0,0,0,551,A
7-M,503,2,0,0,549,551,C
7-M,504,552,0,0,0,552,A
7-M,505,555,0,0,0,555,A
7-M,506,0,0,0,555,555,C
7-M,507,0,0,0,552,552,C
7-M,508,549,0,0,0,549,A
7-M,509,546,0,1,0,547,A
7-M,510,0,550,0,0,550,T
7-M,511,2,0,0,551,553,C
7-M,512,1,0,0,544,545,C
7-M,513,539,0,0,0,539,A
7-M,514,0,537,0,2,539,T
7-M,515,0,535,0,0,535,T
7-M,516,536,0,0,0,536,A
7-M,517,530,0,0,1,531,A
7-M,518,0,536,0,0,536,T
7-M,519,534,0,0,0,534,A
7-M,520,535,0,0,0,535,A
7-M,521,528,1,0,0,529,A
7-M,522,531,0,0,0,531,A
7-M,523,0,0,0,546,546,C
7-M,524,545,0,0,0,545,A
7-M,525,0,543,0,1,544,T
7-M,526,0,0,544,0,544,G
7-M,527,541,0,1,0,542,A
7-M,528,1,0,547,0,548,G
7-M,529,546,0,0,0,546,A
7-M,530,546,0,0,0,546,A
7-M,531,0,0,0,553,553,C
7-M,532,538,0,0,0,538,A
7-M,533,0,0,543,0,543,G
7-M,534,542,0,0,0,542,A
7-M,535,541,0,0,0,541,A
7-M,536,0,540,0,0,540,T
7-M,537,0,0,534,0,534,G
7-M,538,0,1,535,0,536,G
7-M,539,0,533,0,1,534,T
7-M,540,0,519,0,0,519,T
7-M,541,0,528,0,0,528,T
7-M,542,1,530,0,0,531,T
7-M,543,0,0,532,0,532,G
7-M,544,1,1,530,0,532,G
7-M,545,0,0,0,531,531,C
7-M,546,0,2,0,527,529,C
7-M,547,517,0,0,0,517,A
7-M,548,0,0,523,0,523,G
7-M,549,0,0,0,524,524,C
7-M,550,529,0,0,0,529,A
7-M,551,0,0,0,535,535,C
7-M,552,0,527,0,0,527,T
7-M,553,526,1,0,0,527,A
7-M,554,1,0,0,528,529,C
7-M,555,533,0,4,0,537,A
7-M,556,0,0,545,0,545,G
7-M,557,0,0,0,536,536,C
7-M,558,1,525,0,0,526,T
7-M,559,525,0,0,0,525,A
7-M,560,515,0,0,0,515,A
7-M,561,0,1,521,0,522,G
7-M,562,0,0,526,0,526,G
7-M,563,0,0,0,525,525,C
7-M,564,0,499,0,2,501,T
7-M,565,494,0,0,0,494,A
7-M,566,0,492,0,0,492,T
7-M,567,0,1,493,0,494,G
7-M,568,0,1,494,0,495,G
7-M,569,486,0,1,0,487,A
7-M,570,0,1,488,0,489,G
7-M,571,0,0,0,481,481,C
7-M,572,479,0,1,0,480,A
7-M,573,478,0,0,0,478,A
7-M,574,477,0,1,0,478,A
7-M,575,0,480,0,0,480,T
7-M,576,0,2,481,0,483,G
7-M,577,0,0,479,0,479,G
7-M,578,0,1,0,474,475,C
7-M,579,0,470,0,0,470,T
7-M,580,0,1,472,0,473,G
7-M,581,0,0,478,0,478,G
7-M,582,478,0,0,0,478,A
7-M,583,0,478,0,0,478,T
7-M,584,0,0,0,474,474,C
7-M,585,468,0,2,0,470,A
7-M,586,472,0,0,0,472,A
7-M,587,1,0,472,0,473,G
7-M,588,0,470,0,1,471,T
7-M,589,1,0,468,0,469,G
7-M,590,461,0,0,0,461,A
7-M,591,460,0,0,0,460,A
7-M,592,0,0,0,464,464,C
7-M,593,461,1,0,0,462,A
7-M,594,0,1,468,0,469,G
7-M,595,0,0,460,1,461,G
7-M,596,0,0,0,459,459,C
7-M,597,452,0,2,0,454,A
7-M,598,0,0,461,0,461,G
7-M,599,1,1,0,457,459,C
7-M,600,0,0,460,0,460,G
7-M,601,0,0,459,0,459,G
7-M,602,456,1,1,0,458,A
7-M,603,0,0,461,0,461,G
7-M,604,0,0,467,0,467,G
7-M,605,0,0,0,469,469,C
7-M,606,1,0,0,468,469,C
7-M,607,466,0,0,0,466,A
7-M,608,0,467,0,0,467,T
7-M,609,0,1,469,0,470,G
7-M,610,0,0,471,0,471,G
7-M,611,469,0,1,0,470,A
7-M,612,0,0,472,0,472,G
7-M,613,460,0,0,0,460,A
7-M,614,0,469,0,0,469,T
7-M,615,0,470,0,0,470,T
7-M,616,0,0,467,0,467,G
7-M,617,0,1,0,469,470,C
7-M,618,0,468,0,2,470,T
7-M,619,475,0,0,0,475,A
7-M,620,1,0,474,0,475,G
7-M,621,0,473,0,0,473,T
7-M,622,0,1,0,473,474,C
7-M,623,461,0,1,0,462,A
7-M,624,0,0,466,0,466,G
7-M,625,0,1,465,0,466,G
7-M,626,0,0,0,464,464,C
7-M,627,0,0,0,466,466,C
7-M,628,460,0,0,0,460,A
7-M,629,0,0,469,0,469,G
7-M,630,0,0,469,0,469,G
7-M,631,0,0,0,470,470,C
7-M,632,468,0,1,0,469,A
7-M,633,0,0,463,0,463,G
7-M,634,464,0,0,0,464,A
7-M,635,0,460,0,1,461,T
7-M,636,0,0,464,0,464,G
7-M,637,1,0,473,0,474,G
7-M,638,0,463,0,0,463,T
7-M,639,0,0,464,0,464,G
7-M,640,0,1,0,462,463,C
7-M,641,460,0,0,0,460,A
7-M,642,3,1,458,0,462,G
7-M,643,1,0,459,0,460,G
7-M,644,0,0,0,460,460,C
7-M,645,456,1,0,0,457,A
7-M,646,446,0,0,0,446,A
7-M,647,0,446,0,0,446,T
7-M,648,0,1,445,0,446,G
7-M,649,440,0,0,0,440,A
7-M,650,1,0,441,1,443,G
7-M,651,432,0,0,0,432,A
7-M,652,0,0,435,0,435,G
7-M,653,0,0,0,440,440,C
7-M,654,1,0,0,439,440,C
7-M,655,444,0,0,0,444,A
7-M,656,0,441,0,0,441,T
7-M,657,0,442,0,0,442,T
7-M,658,0,2,437,0,439,G
7-M,659,0,1,437,0,438,G
7-M,660,0,0,439,0,439,G
7-M,661,438,0,0,0,438,A
7-M,662,0,0,0,441,441,C
7-M,663,0,420,0,0,420,T
7-M,664,1,0,0,426,427,C
7-M,665,427,1,0,0,428,A
7-M,666,0,438,0,2,440,T
7-M,667,0,1,0,443,444,C
7-M,668,1,0,1,440,442,C
7-M,669,0,439,0,1,440,T
7-M,670,441,0,0,0,441,A
7-M,671,1,0,442,0,443,G
7-M,672,0,452,0,0,452,T
7-M,673,0,450,0,0,450,T
7-M,674,0,0,0,444,444,C
7-M,675,1,0,0,432,433,C
7-M,676,430,0,2,0,432,A
7-M,677,0,0,439,0,439,G
7-M,678,0,438,0,0,438,T
7-M,679,436,0,1,0,437,A
7-M,680,0,1,0,437,438,C
7-M,681,0,415,0,1,416,T
7-M,682,0,0,433,0,433,G
7-M,683,0,0,434,0,434,G
7-M,684,0,432,0,0,432,T
7-M,685,0,426,0,1,427,T
7-M,686,0,428,0,0,428,T
7-M,687,429,0,0,0,429,A
7-M,688,428,0,1,0,429,A
7-M,689,0,0,430,0,430,G
7-M,690,424,0,0,0,424,A
7-M,691,0,0,416,0,416,G
7-M,692,397,0,2,0,399,A
7-M,693,0,398,0,0,398,T
7-M,694,0,2,397,0,399,G
7-M,695,398,0,0,0,398,A
7-M,696,0,397,0,0,397,T
7-M,697,2,0,0,397,399,C
7-M,698,0,395,0,0,395,T
7-M,699,0,396,1,0,397,T
7-M,700,1,0,0,399,400,C
7-M,701,0,396,0,1,397,T
7-M,702,0,397,0,0,397,T
7-M,703,0,1,395,0,396,G
7-M,704,398,0,0,0,398,A
7-M,705,396,0,1,0,397,A
7-M,706,395,0,0,0,395,A
7-M,707,396,0,1,0,397,A
7-M,708,0,393,0,0,393,T
7-M,709,0,397,0,0,397,T
7-M,710,0,398,0,0,398,T
7-M,711,0,0,397,1,398,G
7-M,712,0,0,0,398,398,C
7-M,713,398,0,0,0,398,A
7-M,714,0,1,400,0,401,G
7-M,715,398,0,1,0,399,A
7-M,716,0,0,0,408,408,C
7-M,717,0,0,0,400,400,C
7-M,718,0,396,0,1,397,T
7-M,719,402,0,0,0,402,A
7-M,720,1,400,0,2,403,T
7-M,721,1,0,0,403,404,C
7-M,722,404,0,0,0,404,A
7-M,723,0,0,409,0,409,G
7-M,724,408,0,0,0,408,A
7-M,725,401,0,0,0,401,A
7-M,726,402,0,1,0,403,A
7-M,727,0,0,0,398,398,C
7-M,728,0,0,400,0,400,G
7-M,729,395,0,1,0,396,A
7-M,730,395,0,0,1,396,A
7-M,731,0,398,0,0,398,T
7-M,732,0,0,398,0,398,G
7-M,733,0,1,399,0,400,G
7-M,734,0,1,403,0,404,G
7-M,735,0,0,400,0,400,G
7-M,736,0,0,405,0,405,G
7-M,737,0,400,0,0,400,T
7-M,738,0,0,401,0,401,G
7-M,739,0,1,0,399,400,C
7-M,740,399,0,0,0,399,A
7-M,741,0,1,403,0,404,G
7-M,742,402,0,0,1,403,A
7-M,743,0,402,0,2,404,T
7-M,744,0,0,402,0,402,G
7-M,745,0,0,0,398,398,C
7-M,746,398,0,0,0,398,A
7-M,747,401,0,0,0,401,A
7-M,748,0,0,0,402,402,C
7-M,749,0,0,407,0,407,G
7-M,750,409,0,0,0,409,A
7-M,751,0,407,0,0,407,T
7-M,752,0,407,0,0,407,T
7-M,753,0,0,0,407,407,C
7-M,754,395,0,0,0,395,A
7-M,755,397,0,0,0,397,A
7-M,756,0,0,398,0,398,G
7-M,757,0,391,0,0,391,T
7-M,758,0,0,389,0,389,G
7-M,759,387,0,0,0,387,A
7-M,760,0,0,0,388,388,C
7-M,761,0,0,0,384,384,C
7-M,762,1,0,0,385,386,C
7-M,763,0,0,389,0,389,G
7-M,764,0,0,0,387,387,C
7-M,765,0,387,0,1,388,T
7-M,766,0,389,0,0,389,T
7-M,767,0,0,390,0,390,G
7-M,768,0,392,0,0,392,T
7-M,769,0,392,0,0,392,T
7-M,770,1,0,391,0,392,G
7-M,771,0,387,0,0,387,T
7-M,772,0,379,0,2,381,T
7-M,773,0,0,383,0,383,G
7-M,774,0,0,0,380,380,C
7-M,775,0,1,0,378,379,C
7-M,776,0,0,382,0,382,G
7-M,777,0,0,0,385,385,C
7-M,778,0,2,381,0,383,G
7-M,779,385,0,0,0,385,A
7-M,780,383,0,0,0,383,A
7-M,781,0,302,0,86,388,T
7-M,782,386,0,0,0,386,A
7-M,783,0,392,0,0,392,T
7-M,784,0,0,0,395,395,C
7-M,785,381,0,0,0,381,A
7-M,786,0,374,0,1,375,T
7-M,787,0,374,0,0,374,T
7-M,788,0,0,371,0,371,G
7-M,789,0,0,372,0,372,G
7-M,790,0,0,369,0,369,G
7-M,791,369,0,0,0,369,A
7-M,792,0,362,0,0,362,T
7-M,793,0,0,0,357,357,C
7-M,794,1,355,0,1,357,T
7-M,795,0,358,0,0,358,T
7-M,796,0,0,360,0,360,G
7-M,797,0,0,0,360,360,C
7-M,798,362,0,0,0,362,A
7-M,799,0,0,0,362,362,C
7-M,800,0,356,0,1,357,T
7-M,801,0,357,0,1,358,T
7-M,802,0,1,356,0,357,G
7-M,803,363,0,0,1,364,A
7-M,804,0,366,0,0,366,T
7-M,805,353,0,0,0,353,A
7-M,806,0,351,0,1,352,T
7-M,807,0,347,0,0,347,T
7-M,808,0,0,345,0,345,G
7-M,809,0,344,0,0,344,T
7-M,810,0,0,338,0,338,G
7-M,811,0,0,340,0,340,G
7-M,812,335,0,2,0,337,A
7-M,813,0,337,0,0,337,T
7-M,814,0,337,0,0,337,T
7-M,815,0,0,0,337,337,C
7-M,816,0,334,0,2,336,T
7-M,817,0,333,0,1,334,T
7-M,818,0,0,333,0,333,G
7-M,819,332,0,1,0,333,A
7-M,820,0,330,0,0,330,T
7-M,821,0,0,0,327,327,C
7-M,822,0,0,327,0,327,G
7-M,823,0,327,0,1,328,T
7-M,824,1,0,0,327,328,C
7-M,825,0,325,0,0,325,T
7-M,826,0,330,0,0,330,T
7-M,827,0,330,0,0,330,T
7-M,828,0,331,0,0,331,T
7-M,829,0,329,1,0,330,T
7-M,830,0,332,0,0,332,T
7-M,831,0,332,0,0,332,T
7-M,832,1,0,0,334,335,C
7-M,833,334,0,0,0,334,A
7-M,834,330,0,0,0,330,A
7-M,835,335,0,0,0,335,A
7-M,836,0,333,0,1,334,T
7-M,837,0,0,335,0,335,G
7-M,838,0,0,0,334,334,C
7-M,839,1,0,332,0,333,G
7-M,840,0,337,0,0,337,T
7-M,841,0,0,0,335,335,C
7-M,842,0,335,0,0,335,T
7-M,843,336,0,0,0,336,A
7-M,844,0,335,0,1,336,T
7-M,845,0,0,0,334,334,C
7-M,846,0,1,331,0,332,G
7-M,847,331,0,1,0,332,A
7-M,848,0,0,0,333,333,C
7-M,849,0,322,0,0,322,T
7-M,850,0,0,0,325,325,C
7-M,851,0,323,0,0,323,T
7-M,852,0,324,0,0,324,T
7-M,853,0,0,0,324,324,C
7-M,854,323,0,0,0,323,A
7-M,855,324,0,0,0,324,A
7-M,856,323,0,0,0,323,A
7-M,857,0,0,0,323,323,C
7-M,858,320,0,1,0,321,A
7-M,859,0,0,0,307,307,C
7-M,860,0,0,300,1,301,G
7-M,861,0,0,310,0,310,G
7-M,862,0,1,0,309,310,C
7-M,863,0,0,0,308,308,C
7-M,864,0,308,0,1,309,T
7-M,865,0,312,0,0,312,T
7-M,866,311,0,1,0,312,A
7-M,867,313,0,0,0,313,A
7-M,868,312,0,0,1,313,A
7-M,869,309,0,0,0,309,A
7-M,870,0,1,307,0,308,G
7-M,871,255,0,1,0,256,A
7-M,872,0,0,254,0,254,G
7-M,873,1,0,254,0,255,G
7-M,874,0,0,0,252,252,C
7-M,875,0,0,0,257,257,C
7-M,876,0,0,0,253,253,C
7-M,877,0,251,0,1,252,T
7-M,878,1,251,0,1,253,T
7-M,879,0,0,0,252,252,C
7-M,880,0,255,0,0,255,T
7-M,881,255,0,0,0,255,A
7-M,882,0,1,0,254,255,C
7-M,883,0,0,248,0,248,G
7-M,884,0,0,248,0,248,G
7-M,885,244,0,0,0,244,A
7-M,886,243,0,1,0,244,A
7-M,887,0,0,244,0,244,G
7-M,888,0,1,239,0,240,G
7-M,889,238,0,2,0,240,A
7-M,890,0,0,241,0,241,G
7-M,891,0,238,0,0,238,T
7-M,892,242,0,0,0,242,A
7-M,893,0,1,0,240,241,C
7-M,894,0,0,0,241,241,C
7-M,895,0,233,0,0,233,T
7-M,896,0,0,234,0,234,G
7-M,897,224,0,0,0,224,A
7-M,898,0,0,224,0,224,G
7-M,899,1,219,0,0,220,T
7-M,900,0,0,0,220,220,C
7-M,901,0,212,0,0,212,T
7-M,902,211,0,0,0,211,A
7-M,903,0,211,0,1,212,T
7-M,904,0,1,211,0,212,G
7-M,905,205,0,0,0,205,A
7-M,906,1,1,204,0,206,G
7-M,907,0,1,186,0,187,G
7-M,908,0,0,188,0,188,G
7-M,909,185,0,0,0,185,A
7-M,910,183,0,1,0,184,A
7-M,911,0,0,184,0,184,G
7-M,912,182,0,0,0,182,A
7-M,913,183,0,0,0,183,A
7-M,914,0,182,0,0,182,T
7-M,915,174,0,1,0,175,A
7-M,916,0,174,0,1,175,T
7-M,917,0,3,0,171,174,C
7-M,918,0,0,175,0,175,G
7-M,919,175,0,0,0,175,A
7-M,920,173,0,1,0,174,A
7-M,921,174,0,0,0,174,A
7-M,922,0,0,172,0,172,G
7-M,923,0,0,172,0,172,G
7-M,924,172,0,0,0,172,A
7-M,925,172,1,0,0,173,A
7-M,926,0,0,0,174,174,C
7-M,927,172,0,0,0,172,A
7-M,928,0,0,173,0,173,G
7-M,929,0,0,0,173,173,C
7-M,930,173,0,0,0,173,A
7-M,931,0,0,173,0,173,G
7-M,932,159,0,1,0,160,A
7-M,933,162,0,0,0,162,A
7-M,934,0,162,0,0,162,T
7-M,935,0,0,156,0,156,G
7-M,936,0,0,0,156,156,C
7-M,937,0,142,0,1,143,T
7-M,938,0,0,143,0,143,G
7-M,939,0,142,0,0,142,T
7-M,940,0,0,141,0,141,G
7-M,941,0,0,140,0,140,G
7-M,942,135,0,0,0,135,A
7-M,943,0,135,0,0,135,T
7-M,944,0,0,133,0,133,G
7-M,945,0,1,0,132,133,C
7-M,946,0,124,0,0,124,T
7-M,947,0,0,123,0,123,G
7-M,948,122,0,1,0,123,A
7-M,949,0,0,0,124,124,C
7-M,950,0,0,124,0,124,G
7-M,951,123,0,0,0,123,A
7-M,952,0,0,0,123,123,C
7-M,953,117,0,0,0,117,A
7-M,954,0,0,117,0,117,G
7-M,955,0,117,0,0,117,T
7-M,956,0,0,0,116,116,C
7-M,957,116,0,0,0,116,A
7-M,958,1,113,0,0,114,T
7-M,959,0,114,0,0,114,T
7-M,960,0,114,0,0,114,T
7-M,961,0,112,0,0,112,T
7-M,962,0,0,112,0,112,G
7-M,963,0,104,0,0,104,T
7-M,964,0,0,0,103,103,C
7-M,965,100,0,0,0,100,A
7-M,966,0,0,100,0,100,G
7-M,967,0,0,0,100,100,C
7-M,968,99,0,0,0,99,A
7-M,969,0,100,0,0,100,T
7-M,970,95,0,0,0,95,A
7-M,971,0,0,95,0,95,G
7-M,972,93,0,1,0,94,A
7-M,973,0,0,93,0,93,G
7-M,974,0,94,0,0,94,T
7-M,975,0,65,0,0,65,T
7-M,976,0,0,64,0,64,G
7-M,977,0,0,64,0,64,G
7-M,978,63,0,0,0,63,A
7-M,979,0,0,63,0,63,G
7-M,980,0,50,0,0,50,T
7-M,981,47,0,0,0,47,A
7-M,982,46,0,0,0,46,A
8-NS,1,108,0,0,0,108,A
8-NS,2,0,109,0,0,109,T
8-NS,3,0,0,115,0,115,G
8-NS,4,0,0,122,0,122,G
8-NS,5,128,0,0,0,128,A
8-NS,6,0,203,0,0,203,T
8-NS,7,0,203,0,0,203,T
8-NS,8,0,0,0,215,215,C
8-NS,9,0,0,0,216,216,C
8-NS,10,217,0,0,0,217,A
8-NS,11,218,0,0,0,218,A
8-NS,12,0,0,0,217,217,C
8-NS,13,219,0,0,0,219,A
8-NS,14,0,0,0,223,223,C
8-NS,15,0,223,0,0,223,T
8-NS,16,0,0,248,0,248,G
8-NS,17,0,247,0,1,248,T
8-NS,18,0,0,249,0,249,G
8-NS,19,0,250,0,0,250,T
8-NS,20,0,0,0,250,250,C
8-NS,21,250,0,0,0,250,A
8-NS,22,251,0,0,0,251,A
8-NS,23,0,0,254,0,254,G
8-NS,24,0,258,0,0,258,T
8-NS,25,1,258,0,0,259,T
8-NS,26,0,263,0,1,264,T
8-NS,27,0,0,0,263,263,C
8-NS,28,0,0,0,263,263,C
8-NS,29,265,0,0,0,265,A
8-NS,30,0,0,267,0,267,G
8-NS,31,0,0,272,0,272,G
8-NS,32,0,273,0,0,273,T
8-NS,33,273,0,0,0,273,A
8-NS,34,1,0,276,0,277,G
8-NS,35,279,0,0,0,279,A
8-NS,36,0,279,0,0,279,T
8-NS,37,0,278,0,1,279,T
8-NS,38,0,0,288,0,288,G
8-NS,39,0,0,0,289,289,C
8-NS,40,0,287,0,0,287,T
8-NS,41,0,289,0,0,289,T
8-NS,42,1,290,0,0,291,T
8-NS,43,0,0,0,298,298,C
8-NS,44,0,297,0,1,298,T
8-NS,45,0,298,0,0,298,T
8-NS,46,0,298,0,0,298,T
8-NS,47,0,0,301,0,301,G
8-NS,48,0,0,301,0,301,G
8-NS,49,0,0,0,302,302,C
8-NS,50,300,0,1,0,301,A
8-NS,51,0,299,0,0,299,T
8-NS,52,304,0,0,0,304,A
8-NS,53,0,311,0,0,311,T
8-NS,54,0,0,0,315,315,C
8-NS,55,0,0,0,315,315,C
8-NS,56,1,0,315,0,316,G
8-NS,57,0,0,318,0,318,G
8-NS,58,317,0,0,0,317,A
8-NS,59,317,1,0,0,318,A
8-NS,60,319,0,0,0,319,A
8-NS,61,0,0,0,329,329,C
8-NS,62,332,0,0,0,332,A
8-NS,63,332,0,0,0,332,A
8-NS,64,0,1,342,0,343,G
8-NS,65,0,343,0,0,343,T
8-NS,66,0,342,0,1,343,T
8-NS,67,0,0,343,0,343,G
8-NS,68,0,343,0,0,343,T
8-NS,69,341,0,0,0,341,A
8-NS,70,0,1,342,0,343,G
8-NS,71,366,0,0,0,366,A
8-NS,72,0,0,0,373,373,C
8-NS,73,0,0,0,372,372,C
8-NS,74,372,0,0,0,372,A
8-NS,75,372,0,0,1,373,A
8-NS,76,1,1,386,0,388,G
8-NS,77,387,0,1,0,388,A
8-NS,78,392,0,0,0,392,A
8-NS,79,0,0,0,393,393,C
8-NS,80,0,389,0,1,390,T
8-NS,81,0,0,395,1,396,G
8-NS,82,395,0,0,0,395,A
8-NS,83,0,0,399,0,399,G
8-NS,84,0,400,0,0,400,T
8-NS,85,0,0,397,0,397,G
8-NS,86,398,0,1,0,399,A
8-NS,87,0,400,0,0,400,T
8-NS,88,0,0,407,0,407,G
8-NS,89,0,1,0,416,417,C
8-NS,90,1,1,0,416,418,C
8-NS,91,1,0,0,418,419,C
8-NS,92,1,0,0,420,421,C
8-NS,93,421,0,0,0,421,A
8-NS,94,0,429,0,1,430,T
8-NS,95,0,433,0,0,433,T
8-NS,96,0,0,0,432,432,C
8-NS,97,0,1,0,431,432,C
8-NS,98,1,426,0,1,428,T
8-NS,99,0,429,0,0,429,T
8-NS,100,0,0,427,0,427,G
8-NS,101,427,0,0,0,427,A
8-NS,102,0,430,0,0,430,T
8-NS,103,2,0,0,428,430,C
8-NS,104,0,0,429,0,429,G
8-NS,105,0,0,431,0,431,G
8-NS,106,0,0,0,433,433,C
8-NS,107,0,432,0,0,432,T
8-NS,108,0,433,0,0,433,T
8-NS,109,0,0,0,432,432,C
8-NS,110,4,0,430,0,434,G
8-NS,111,0,0,0,435,435,C
8-NS,112,0,1,1,433,435,C
8-NS,113,0,0,435,0,435,G
8-NS,114,433,0,0,0,433,A
8-NS,115,0,1,449,0,450,G
8-NS,116,449,0,0,0,449,A
8-NS,117,0,453,0,0,453,T
8-NS,118,0,0,0,452,452,C
8-NS,119,452,0,0,1,453,A
8-NS,120,0,1,453,0,454,G
8-NS,121,451,0,0,0,451,A
8-NS,122,0,0,456,0,456,G
8-NS,123,1,0,469,0,470,G
8-NS,124,0,467,0,0,467,T
8-NS,125,2,0,0,485,487,C
8-NS,126,0,0,0,489,489,C
8-NS,127,1,0,0,488,489,C
8-NS,128,0,491,0,1,492,T
8-NS,129,495,0,0,0,495,A
8-NS,130,494,0,1,0,495,A
8-NS,131,0,0,494,0,494,G
8-NS,132,477,0,1,0,478,A
8-NS,133,0,1,497,0,498,G
8-NS,134,0,1,498,0,499,G
8-NS,135,498,0,0,0,498,A
8-NS,136,500,1,0,0,501,A
8-NS,137,0,1,505,0,506,G
8-NS,138,523,0,1,0,524,A
8-NS,139,0,0,533,0,533,G
8-NS,140,1,0,532,0,533,G
8-NS,141,0,1,0,533,534,C
8-NS,142,535,0,0,0,535,A
8-NS,143,538,0,2,0,540,A
8-NS,144,0,541,0,0,541,T
8-NS,145,542,0,0,0,542,A
8-NS,146,0,0,0,545,545,C
8-NS,147,0,540,0,1,541,T
8-NS,148,0,0,0,541,541,C
8-NS,149,0,537,0,0,537,T
8-NS,150,0,0,0,540,540,C
8-NS,151,0,1,547,0,548,G
8-NS,152,0,0,571,0,571,G
8-NS,153,0,571,0,0,571,T
8-NS,154,1,0,0,572,573,C
8-NS,155,0,574,0,0,574,T
8-NS,156,575,0,0,0,575,A
8-NS,157,1,0,575,0,576,G
8-NS,158,575,0,2,0,577,A
8-NS,159,0,0,0,591,591,C
8-NS,160,586,0,0,0,586,A
8-NS,161,0,582,0,0,582,T
8-NS,162,0,0,0,581,581,C
8-NS,163,580,0,2,0,582,A
8-NS,164,583,0,0,0,583,A
8-NS,165,575,0,0,0,575,A
8-NS,166,0,0,580,0,580,G
8-NS,167,0,0,0,581,581,C
8-NS,168,572,0,1,0,573,A
8-NS,169,0,0,577,0,577,G
8-NS,170,0,0,0,573,573,C
8-NS,171,0,2,0,578,580,C
8-NS,172,581,0,0,0,581,A
8-NS,173,0,0,0,597,597,C
8-NS,174,0,0,0,594,594,C
8-NS,175,1,0,0,595,596,C
8-NS,176,599,1,1,0,601,A
8-NS,177,1,601,0,1,603,T
8-NS,178,0,0,605,0,605,G
8-NS,179,0,603,0,0,603,T
8-NS,180,0,604,0,0,604,T
8-NS,181,0,0,598,2,600,G
8-NS,182,0,0,597,0,597,G
8-NS,183,594,0,0,0,594,A
8-NS,184,593,2,0,0,595,A
8-NS,185,592,0,0,0,592,A
8-NS,186,1,0,596,0,597,G
8-NS,187,0,0,0,595,595,C
8-NS,188,600,0,0,0,600,A
8-NS,189,597,1,0,0,598,A
8-NS,190,592,0,1,0,593,A
8-NS,191,0,603,0,1,604,T
8-NS,192,0,604,0,0,604,T
8-NS,193,0,0,620,0,620,G
8-NS,194,0,620,0,0,620,T
8-NS,195,619,0,1,0,620,A
8-NS,196,0,1,619,0,620,G
8-NS,197,617,0,1,0,618,A
8-NS,198,616,0,0,0,616,A
8-NS,199,618,0,0,0,618,A
8-NS,200,616,0,0,0,616,A
8-NS,201,0,2,616,0,618,G
8-NS,202,604,0,1,0,605,A
8-NS,203,0,607,0,0,607,T
8-NS,204,0,604,0,1,605,T
8-NS,205,1,0,0,605,606,C
8-NS,206,0,605,0,1,606,T
8-NS,207,1,0,605,0,606,G
8-NS,208,604,0,0,0,604,A
8-NS,209,604,0,0,1,605,A
8-NS,210,605,0,0,0,605,A
8-NS,211,1,0,604,0,605,G
8-NS,212,605,0,0,0,605,A
8-NS,213,605,0,0,0,605,A
8-NS,214,0,0,606,0,606,G
8-NS,215,607,0,1,0,608,A
8-NS,216,605,1,3,0,609,A
8-NS,217,0,605,0,0,605,T
8-NS,218,0,1,0,608,609,C
8-NS,219,0,608,1,0,609,T
8-NS,220,0,1,615,0,616,G
8-NS,221,616,0,1,0,617,A
8-NS,222,1,616,0,0,617,T
8-NS,223,0,1,614,0,615,G
8-NS,224,611,0,1,0,612,A
8-NS,225,0,1,610,0,611,G
8-NS,226,0,0,610,0,610,G
8-NS,227,0,0,0,611,611,C
8-NS,228,611,0,0,0,611,A
8-NS,229,0,0,0,623,623,C
8-NS,230,0,622,0,0,622,T
8-NS,231,0,624,0,0,624,T
8-NS,232,626,0,0,0,626,A
8-NS,233,626,0,0,0,626,A
8-NS,234,625,1,1,0,627,A
8-NS,235,623,1,0,0,624,A
8-NS,236,0,628,0,0,628,T
8-NS,237,0,1,633,0,634,G
8-NS,238,635,0,2,0,637,A
8-NS,239,0,1,0,638,639,C
8-NS,240,1,0,0,639,640,C
8-NS,241,641,1,1,0,643,A
8-NS,242,0,643,0,0,643,T
8-NS,243,0,0,651,0,651,G
8-NS,244,0,1,653,0,654,G
8-NS,245,0,620,0,36,656,T
8-NS,246,2,0,0,688,690,C
8-NS,247,0,688,0,1,689,T
8-NS,248,0,0,0,698,698,C
8-NS,249,0,1,0,698,699,C
8-NS,250,698,0,1,0,699,A
8-NS,251,0,0,0,703,703,C
8-NS,252,696,0,0,0,696,A
8-NS,253,1,0,0,713,714,C
8-NS,254,2,0,0,707,709,C
8-NS,255,0,695,0,1,696,T
8-NS,256,0,0,695,0,695,G
8-NS,257,0,0,0,686,686,C
8-NS,258,0,684,0,0,684,T
8-NS,259,1,688,0,0,689,T
8-NS,260,2,2,0,682,686,C
8-NS,261,0,1,686,0,687,G
8-NS,262,0,0,0,683,683,C
8-NS,263,1,3,681,0,685,G
8-NS,264,722,0,0,0,722,A
8-NS,265,0,721,0,0,721,T
8-NS,266,736,0,0,0,736,A
8-NS,267,1,0,1,735,737,C
8-NS,268,734,0,1,0,735,A
8-NS,269,0,757,0,1,758,T
8-NS,270,754,0,1,0,755,A
8-NS,271,754,0,0,0,754,A
8-NS,272,0,0,0,757,757,C
8-NS,273,0,745,0,0,745,T
8-NS,274,0,1,752,0,753,G
8-NS,275,749,0,0,0,749,A
8-NS,276,1,0,0,750,751,C
8-NS,277,751,0,0,0,751,A
8-NS,278,0,741,0,0,741,T
8-NS,279,0,3,741,0,744,G
8-NS,280,738,0,2,0,740,A
8-NS,281,0,0,0,766,766,C
8-NS,282,0,765,0,0,765,T
8-NS,283,769,0,0,0,769,A
8-NS,284,0,768,0,0,768,T
8-NS,285,1,762,0,1,764,T
8-NS,286,1,1,760,0,762,G
8-NS,287,755,1,2,0,758,A
8-NS,288,0,0,763,0,763,G
8-NS,289,0,0,757,0,757,G
8-NS,290,743,0,0,0,743,A
8-NS,291,742,0,0,0,742,A
8-NS,292,0,734,0,0,734,T
8-NS,293,0,735,0,0,735,T
8-NS,294,0,0,747,0,747,G
8-NS,295,0,743,0,2,745,T
8-NS,296,0,0,0,743,743,C
8-NS,297,744,0,0,0,744,A
8-NS,298,742,0,0,0,742,A
8-NS,299,0,2,741,0,743,G
8-NS,300,746,0,0,0,746,A
8-NS,301,750,0,1,0,751,A
8-NS,302,748,1,1,0,750,A
8-NS,303,0,0,0,747,747,C
8-NS,304,0,739,0,0,739,T
8-NS,305,0,2,743,0,745,G
8-NS,306,0,0,752,0,752,G
8-NS,307,0,754,0,0,754,T
8-NS,308,0,749,0,2,751,T
8-NS,309,0,1,0,748,749,C
8-NS,310,750,1,0,0,751,A
8-NS,311,1,758,1,1,761,T
8-NS,312,1,0,765,0,766,G
8-NS,313,0,0,0,770,770,C
8-NS,314,0,762,0,3,765,T
8-NS,315,760,1,1,0,762,A
8-NS,316,770,0,1,0,771,A
8-NS,317,0,776,0,0,776,T
8-NS,318,0,0,778,0,778,G
8-NS,319,0,0,0,777,777,C
8-NS,320,0,1,0,761,762,C
8-NS,321,1,2,0,763,766,C
8-NS,322,767,0,1,0,768,A
8-NS,323,766,1,0,0,767,A
8-NS,324,0,1,773,0,774,G
8-NS,325,0,0,0,775,775,C
8-NS,326,771,0,0,0,771,A
8-NS,327,0,0,775,0,775,G
8-NS,328,774,0,1,0,775,A
8-NS,329,772,0,0,0,772,A
8-NS,330,773,1,1,0,775,A
8-NS,331,762,0,2,0,764,A
8-NS,332,0,771,0,0,771,T
8-NS,333,0,0,773,0,773,G
8-NS,334,0,0,771,0,771,G
8-NS,335,769,0,1,0,770,A
8-NS,336,765,0,0,1,766,A
8-NS,337,0,1,766,0,767,G
8-NS,338,1,0,767,0,768,G
8-NS,339,770,0,0,0,770,A
8-NS,340,1,0,0,765,766,C
8-NS,341,1,0,0,763,764,C
8-NS,342,0,771,0,1,772,T
8-NS,343,1,0,0,778,779,C
8-NS,344,0,777,0,2,779,T
8-NS,345,0,782,0,1,783,T
8-NS,346,0,779,0,1,780,T
8-NS,347,0,1,783,0,784,G
8-NS,348,0,0,0,790,790,C
8-NS,349,785,0,1,0,786,A
8-NS,350,0,788,0,0,788,T
8-NS,351,1,0,0,788,789,C
8-NS,352,802,0,0,0,802,A
8-NS,353,0,1,812,0,813,G
8-NS,354,812,0,0,0,812,A
8-NS,355,815,0,0,0,815,A
8-NS,356,0,811,0,0,811,T
8-NS,357,1,0,805,0,806,G
8-NS,358,1,2,807,0,810,G
8-NS,359,809,0,0,0,809,A
8-NS,360,0,0,0,802,802,C
8-NS,361,0,1,0,794,795,C
8-NS,362,778,0,1,0,779,A
8-NS,363,0,1,786,0,787,G
8-NS,364,1,0,784,0,785,G
8-NS,365,0,1,0,784,785,C
8-NS,366,780,0,0,0,780,A
8-NS,367,780,1,0,0,781,A
8-NS,368,0,781,1,0,782,T
8-NS,369,0,0,0,780,780,C
8-NS,370,785,0,0,0,785,A
8-NS,371,0,778,0,2,780,T
8-NS,372,1,0,773,0,774,G
8-NS,373,0,1,781,0,782,G
8-NS,374,778,0,2,0,780,A
8-NS,375,0,1,783,0,784,G
8-NS,376,777,0,1,0,778,A
8-NS,377,777,0,1,0,778,A
8-NS,378,777,0,1,0,778,A
8-NS,379,774,0,2,0,776,A
8-NS,380,789,0,1,0,790,A
8-NS,381,1,0,0,789,790,C
8-NS,382,785,0,0,0,785,A
8-NS,383,0,781,0,1,782,T
8-NS,384,1,0,0,767,768,C
8-NS,385,769,0,1,0,770,A
8-NS,386,1,769,0,2,772,T
8-NS,387,1,0,769,0,770,G
8-NS,388,1,1,0,763,765,C
8-NS,389,0,766,0,2,768,T
8-NS,390,1,0,768,0,769,G
8-NS,391,768,0,0,0,768,A
8-NS,392,761,0,1,0,762,A
8-NS,393,762,1,0,0,763,A
8-NS,394,0,0,768,0,768,G
8-NS,395,0,0,0,756,756,C
8-NS,396,0,0,755,0,755,G
8-NS,397,757,0,1,0,758,A
8-NS,398,760,0,1,0,761,A
8-NS,399,1,754,0,1,756,T
8-NS,400,0,763,0,0,763,T
8-NS,401,0,761,0,1,762,T
8-NS,402,2,0,0,760,762,C
8-NS,403,753,0,1,0,754,A
8-NS,404,0,0,758,0,758,G
8-NS,405,0,752,0,2,754,T
8-NS,406,0,1,753,0,754,G
8-NS,407,0,755,0,1,756,T
8-NS,408,0,1,754,0,755,G
8-NS,409,760,0,0,0,760,A
8-NS,410,0,762,0,1,763,T
8-NS,411,0,761,0,0,761,T
8-NS,412,0,757,1,0,758,T
8-NS,413,0,753,0,0,753,T
8-NS,414,0,752,0,1,753,T
8-NS,415,0,2,752,0,754,G
8-NS,416,752,0,1,0,753,A
8-NS,417,0,0,0,753,753,C
8-NS,418,3,1,0,738,742,C
8-NS,419,1,1,741,0,743,G
8-NS,420,777,0,0,0,777,A
8-NS,421,0,0,0,795,795,C
8-NS,422,0,794,0,0,794,T
8-NS,423,799,0,0,0,799,A
8-NS,424,0,0,801,0,801,G
8-NS,425,798,0,2,0,800,A
8-NS,426,1,2,802,0,805,G
8-NS,427,803,0,2,0,805,A
8-NS,428,1,0,0,824,825,C
8-NS,429,2,0,0,801,803,C
8-NS,430,780,0,2,0,782,A
8-NS,431,0,810,0,0,810,T
8-NS,432,803,0,1,0,804,A
8-NS,433,1,0,853,0,854,G
8-NS,434,0,849,0,1,850,T
8-NS,435,836,0,1,0,837,A
8-NS,436,0,832,0,0,832,T
8-NS,437,0,807,0,1,808,T
8-NS,438,829,0,0,0,829,A
8-NS,439,1,0,0,829,830,C
8-NS,440,0,795,0,0,795,T
8-NS,441,792,0,0,0,792,A
8-NS,442,725,0,0,0,725,A
8-NS,443,2,0,729,0,731,G
8-NS,444,0,0,728,0,728,G
8-NS,445,0,0,731,0,731,G
8-NS,446,0,0,0,722,722,C
8-NS,447,0,706,0,1,707,T
8-NS,448,0,700,0,1,701,T
8-NS,449,1,710,0,0,711,T
8-NS,450,1,0,0,711,712,C
8-NS,451,716,0,0,0,716,A
8-NS,452,1,1,0,710,712,C
8-NS,453,0,1,0,704,705,C
8-NS,454,0,0,705,0,705,G
8-NS,455,707,0,0,0,707,A
8-NS,456,708,0,0,0,708,A
8-NS,457,0,1,706,0,707,G
8-NS,458,698,0,2,0,700,A
8-NS,459,0,0,703,0,703,G
8-NS,460,0,0,689,0,689,G
8-NS,461,1,1,689,0,691,G
8-NS,462,688,1,2,0,691,A
8-NS,463,0,1,690,0,691,G
8-NS,464,0,1,0,689,690,C
8-NS,465,688,1,0,0,689,A
8-NS,466,687,0,2,0,689,A
8-NS,467,0,687,0,0,687,T
8-NS,468,0,684,0,0,684,T
8-NS,469,0,0,684,0,684,G
8-NS,470,1,674,0,0,675,T
8-NS,471,0,676,0,0,676,T
8-NS,472,1,0,669,0,670,G
8-NS,473,0,1,674,0,675,G
8-NS,474,0,1,0,670,671,C
8-NS,475,0,0,676,0,676,G
8-NS,476,675,0,0,0,675,A
8-NS,477,679,0,1,0,680,A
8-NS,478,682,0,0,0,682,A
8-NS,479,0,685,0,0,685,T
8-NS,480,0,1,0,680,681,C
8-NS,481,0,684,0,0,684,T
8-NS,482,0,0,0,689,689,C
8-NS,483,691,0,1,0,692,A
8-NS,484,1,0,0,692,693,C
8-NS,485,1,0,0,687,688,C
8-NS,486,688,0,0,0,688,A
8-NS,487,0,681,0,1,682,T
8-NS,488,0,678,0,0,678,T
8-NS,489,0,1,674,0,675,G
8-NS,490,0,0,0,676,676,C
8-NS,491,0,1,0,672,673,C
8-NS,492,0,677,0,0,677,T
8-NS,493,1,673,0,0,674,T
8-NS,494,0,1,0,674,675,C
8-NS,495,0,674,0,2,676,T
8-NS,496,0,678,0,0,678,T
8-NS,497,0,685,0,0,685,T
8-NS,498,1,683,0,0,684,T
8-NS,499,0,0,0,683,683,C
8-NS,500,0,0,0,682,682,C
8-NS,501,680,1,0,0,681,A
8-NS,502,0,2,688,1,691,G
8-NS,503,0,0,684,0,684,G
8-NS,504,699,0,1,0,700,A
8-NS,505,0,0,0,699,699,C
8-NS,506,706,0,1,0,707,A
8-NS,507,0,709,0,1,710,T
8-NS,508,708,0,1,1,710,A
8-NS,509,0,0,0,749,749,C
8-NS,510,0,743,0,1,744,T
8-NS,511,741,0,0,0,741,A
8-NS,512,0,737,0,1,738,T
8-NS,513,0,717,0,0,717,T
8-NS,514,0,0,716,0,716,G
8-NS,515,688,1,4,0,693,A
8-NS,516,0,1,689,0,690,G
8-NS,517,0,0,686,0,686,G
8-NS,518,629,0,0,0,629,A
8-NS,519,0,632,0,0,632,T
8-NS,520,0,0,633,0,633,G
8-NS,521,0,626,0,0,626,T
8-NS,522,1,0,0,625,626,C
8-NS,523,627,0,0,0,627,A
8-NS,524,630,0,0,0,630,A
8-NS,525,628,0,0,0,628,A
8-NS,526,624,0,0,0,624,A
8-NS,527,627,0,0,1,628,A
8-NS,528,0,624,0,0,624,T
8-NS,529,1,0,627,0,628,G
8-NS,530,1,0,0,631,632,C
8-NS,531,632,0,0,0,632,A
8-NS,532,636,0,0,0,636,A
8-NS,533,0,635,0,1,636,T
8-NS,534,0,636,0,1,637,T
8-NS,535,0,1,631,0,632,G
8-NS,536,0,2,627,0,629,G
8-NS,537,1,3,623,0,627,G
8-NS,538,0,0,632,0,632,G
8-NS,539,1,610,0,2,613,T
8-NS,540,0,0,0,620,620,C
8-NS,541,1,0,0,616,617,C
8-NS,542,0,615,1,1,617,T
8-NS,543,1,0,0,621,622,C
8-NS,544,622,1,0,0,623,A
8-NS,545,0,623,0,0,623,T
8-NS,546,0,0,0,618,618,C
8-NS,547,4,0,609,0,613,G
8-NS,548,0,1,611,0,612,G
8-NS,549,607,0,0,0,607,A
8-NS,550,1,0,604,0,605,G
8-NS,551,2,2,608,0,612,G
8-NS,552,605,0,1,0,606,A
8-NS,553,0,0,0,610,610,C
8-NS,554,0,606,0,1,607,T
8-NS,555,0,608,0,0,608,T
8-NS,556,0,1,609,0,610,G
8-NS,557,611,0,0,0,611,A
8-NS,558,605,0,3,0,608,A
8-NS,559,0,609,0,0,609,T
8-NS,560,0,0,590,0,590,G
8-NS,561,0,2,591,0,593,G
8-NS,562,589,1,1,0,591,A
8-NS,563,592,0,0,0,592,A
8-NS,564,0,612,0,0,612,T
8-NS,565,0,1,609,0,610,G
8-NS,566,613,0,0,0,613,A
8-NS,567,0,614,0,0,614,T
8-NS,568,611,0,2,0,613,A
8-NS,569,611,1,1,0,613,A
8-NS,570,1,1,0,608,610,C
8-NS,571,604,0,0,0,604,A
8-NS,572,0,0,0,608,608,C
8-NS,573,572,0,0,0,572,A
8-NS,574,0,0,575,0,575,G
8-NS,575,1,570,0,3,574,T
8-NS,576,0,571,0,1,572,T
8-NS,577,1,0,0,573,574,C
8-NS,578,1,2,570,0,573,G
8-NS,579,569,0,0,0,569,A
8-NS,580,0,0,569,0,569,G
8-NS,581,1,562,0,0,563,T
8-NS,582,3,0,0,561,564,C
8-NS,583,0,550,0,0,550,T
8-NS,584,0,0,0,550,550,C
8-NS,585,0,552,0,1,553,T
8-NS,586,552,0,0,0,552,A
8-NS,587,554,0,1,0,555,A
8-NS,588,554,0,1,0,555,A
8-NS,589,557,0,0,0,557,A
8-NS,590,561,0,0,0,561,A
8-NS,591,0,551,0,0,551,T
8-NS,592,0,0,0,553,553,C
8-NS,593,0,543,0,4,547,T
8-NS,594,552,1,0,0,553,A
8-NS,595,1,0,0,552,553,C
8-NS,596,552,0,1,0,553,A
8-NS,597,0,0,554,0,554,G
8-NS,598,542,0,0,0,542,A
8-NS,599,0,0,550,0,550,G
8-NS,600,556,0,0,0,556,A
8-NS,601,0,542,0,1,543,T
8-NS,602,0,543,0,1,544,T
8-NS,603,2,1,0,541,544,C
8-NS,604,0,0,544,0,544,G
8-NS,605,1,0,0,540,541,C
8-NS,606,0,543,0,0,543,T
8-NS,607,0,542,0,1,543,T
8-NS,608,0,1,542,0,543,G
8-NS,609,0,1,545,0,546,G
8-NS,610,545,0,0,0,545,A
8-NS,611,0,0,546,0,546,G
8-NS,612,542,0,2,0,544,A
8-NS,613,541,0,0,0,541,A
8-NS,614,0,0,550,0,550,G
8-NS,615,0,0,0,551,551,C
8-NS,616,552,1,0,0,553,A
8-NS,617,0,0,557,0,557,G
8-NS,618,0,554,0,1,555,T
8-NS,619,559,0,0,0,559,A
8-NS,620,556,0,0,0,556,A
8-NS,621,0,556,0,1,557,T
8-NS,622,1,1,557,0,559,G
8-NS,623,540,0,0,1,541,A
8-NS,624,0,0,546,0,546,G
8-NS,625,539,0,0,0,539,A
8-NS,626,517,0,0,0,517,A
8-NS,627,0,517,0,0,517,T
8-NS,628,0,2,510,0,512,G
8-NS,629,0,1,512,0,513,G
8-NS,630,0,2,509,0,511,G
8-NS,631,0,0,511,0,511,G
8-NS,632,0,0,509,0,509,G
8-NS,633,493,0,1,0,494,A
8-NS,634,0,454,0,0,454,T
8-NS,635,0,0,0,467,467,C
8-NS,636,0,463,0,0,463,T
8-NS,637,0,0,0,465,465,C
8-NS,638,0,0,0,467,467,C
8-NS,639,464,1,1,0,466,A
8-NS,640,1,0,0,465,466,C
8-NS,641,0,455,0,0,455,T
8-NS,642,0,457,0,0,457,T
8-NS,643,456,0,1,0,457,A
8-NS,644,0,0,0,457,457,C
8-NS,645,0,458,0,1,459,T
8-NS,646,0,2,0,448,450,C
8-NS,647,0,0,0,447,447,C
8-NS,648,446,0,0,0,446,A
8-NS,649,450,1,0,0,451,A
8-NS,650,452,0,0,0,452,A
8-NS,651,453,0,0,0,453,A
8-NS,652,0,0,0,455,455,C
8-NS,653,448,0,1,0,449,A
8-NS,654,0,0,449,0,449,G
8-NS,655,441,0,2,0,443,A
8-NS,656,446,0,0,0,446,A
8-NS,657,444,0,1,0,445,A
8-NS,658,0,0,0,445,445,C
8-NS,659,0,0,445,0,445,G
8-NS,660,0,1,441,0,442,G
8-NS,661,0,0,445,0,445,G
8-NS,662,446,0,0,0,446,A
8-NS,663,443,0,0,0,443,A
8-NS,664,443,0,0,0,443,A
8-NS,665,0,442,0,0,442,T
8-NS,666,0,1,442,0,443,G
8-NS,667,0,0,443,0,443,G
8-NS,668,1,0,0,438,439,C
8-NS,669,0,0,436,0,436,G
8-NS,670,434,1,0,0,435,A
8-NS,671,0,1,434,0,435,G
8-NS,672,437,0,0,0,437,A
8-NS,673,437,0,0,0,437,A
8-NS,674,0,2,0,435,437,C
8-NS,675,428,0,1,0,429,A
8-NS,676,0,0,434,0,434,G
8-NS,677,0,0,0,432,432,C
8-NS,678,0,434,0,0,434,T
8-NS,679,434,0,0,0,434,A
8-NS,680,0,1,428,0,429,G
8-NS,681,1,0,429,0,430,G
8-NS,682,0,427,0,2,429,T
8-NS,683,1,0,0,424,425,C
8-NS,684,428,0,0,0,428,A
8-NS,685,428,0,0,0,428,A
8-NS,686,428,0,0,0,428,A
8-NS,687,427,0,0,0,427,A
8-NS,688,0,0,429,0,429,G
8-NS,689,0,420,0,0,420,T
8-NS,690,0,416,0,1,417,T
8-NS,691,0,417,0,0,417,T
8-NS,692,2,0,416,0,418,G
8-NS,693,419,0,0,0,419,A
8-NS,694,418,0,0,0,418,A
8-NS,695,0,1,421,0,422,G
8-NS,696,405,0,0,0,405,A
8-NS,697,0,1,406,0,407,G
8-NS,698,406,0,0,0,406,A
8-NS,699,0,405,0,0,405,T
8-NS,700,404,0,0,0,404,A
8-NS,701,405,0,0,0,405,A
8-NS,702,0,0,405,0,405,G
8-NS,703,386,0,0,0,386,A
8-NS,704,0,386,0,0,386,T
8-NS,705,0,0,385,0,385,G
8-NS,706,1,0,385,0,386,G
8-NS,707,0,0,0,383,383,C
8-NS,708,0,381,0,0,381,T
8-NS,709,384,0,0,0,384,A
8-NS,710,384,0,1,0,385,A
8-NS,711,0,386,0,0,386,T
8-NS,712,0,386,0,0,386,T
8-NS,713,0,0,386,0,386,G
8-NS,714,381,0,0,0,381,A
8-NS,715,379,0,0,0,379,A
8-NS,716,0,0,380,0,380,G
8-NS,717,379,0,0,0,379,A
8-NS,718,375,0,1,0,376,A
8-NS,719,0,0,380,0,380,G
8-NS,720,0,373,0,0,373,T
8-NS,721,1,1,373,0,375,G
8-NS,722,370,0,1,0,371,A
8-NS,723,0,0,372,0,372,G
8-NS,724,371,0,1,0,372,A
8-NS,725,0,0,0,371,371,C
8-NS,726,369,0,0,0,369,A
8-NS,727,0,0,0,369,369,C
8-NS,728,348,0,0,0,348,A
8-NS,729,0,0,351,0,351,G
8-NS,730,347,0,0,0,347,A
8-NS,731,0,346,0,0,346,T
8-NS,732,0,347,0,0,347,T
8-NS,733,348,0,0,0,348,A
8-NS,734,347,1,0,0,348,A
8-NS,735,347,0,0,0,347,A
8-NS,736,348,0,0,0,348,A
8-NS,737,347,1,0,0,348,A
8-NS,738,0,0,0,335,335,C
8-NS,739,318,0,0,0,318,A
8-NS,740,320,0,0,0,320,A
8-NS,741,1,0,0,319,320,C
8-NS,742,0,320,0,0,320,T
8-NS,743,0,0,321,0,321,G
8-NS,744,319,0,0,0,319,A
8-NS,745,319,0,0,0,319,A
8-NS,746,318,0,1,0,319,A
8-NS,747,308,0,1,0,309,A
8-NS,748,0,311,0,0,311,T
8-NS,749,301,0,0,0,301,A
8-NS,750,0,0,302,0,302,G
8-NS,751,1,0,0,301,302,C
8-NS,752,0,295,0,0,295,T
8-NS,753,0,295,0,0,295,T
8-NS,754,0,292,0,0,292,T
8-NS,755,0,2,293,0,295,G
8-NS,756,295,0,0,0,295,A
8-NS,757,295,0,0,0,295,A
8-NS,758,0,0,0,295,295,C
8-NS,759,280,0,0,0,280,A
8-NS,760,281,0,0,0,281,A
8-NS,761,281,0,0,0,281,A
8-NS,762,0,281,0,0,281,T
8-NS,763,280,0,0,0,280,A
8-NS,764,276,1,1,0,278,A
8-NS,765,0,0,0,279,279,C
8-NS,766,279,0,0,0,279,A
8-NS,767,0,277,0,0,277,T
8-NS,768,0,273,0,0,273,T
8-NS,769,1,0,0,267,268,C
8-NS,770,266,0,0,0,266,A
8-NS,771,0,265,0,0,265,T
8-NS,772,0,0,266,0,266,G
8-NS,773,0,0,0,261,261,C
8-NS,774,258,0,0,0,258,A
8-NS,775,254,0,0,0,254,A
8-NS,776,0,0,255,0,255,G
8-NS,777,0,1,0,256,257,C
8-NS,778,252,0,0,0,252,A
8-NS,779,0,254,0,0,254,T
8-NS,780,0,254,0,0,254,T
8-NS,781,253,0,0,0,253,A
8-NS,782,0,0,0,252,252,C
8-NS,783,251,0,0,0,251,A
8-NS,784,249,0,0,0,249,A
8-NS,785,1,0,0,248,249,C
8-NS,786,0,213,0,1,214,T
8-NS,787,0,0,214,0,214,G
8-NS,788,0,0,0,211,211,C
8-NS,789,0,198,0,0,198,T
8-NS,790,0,0,198,0,198,G
8-NS,791,0,194,0,0,194,T
8-NS,792,1,193,0,0,194,T
8-NS,793,0,194,0,0,194,T
8-NS,794,0,0,191,0,191,G
8-NS,795,191,0,0,0,191,A
8-NS,796,189,0,0,0,189,A
8-NS,797,0,0,189,0,189,G
8-NS,798,0,189,0,0,189,T
8-NS,799,0,0,181,0,181,G
8-NS,800,0,0,183,0,183,G
8-NS,801,180,0,3,0,183,A
8-NS,802,183,0,0,0,183,A
8-NS,803,0,1,0,181,182,C
8-NS,804,180,0,0,0,180,A
8-NS,805,1,0,179,0,180,G
8-NS,806,0,0,178,0,178,G
8-NS,807,173,0,1,0,174,A
8-NS,808,0,0,174,0,174,G
8-NS,809,146,0,0,0,146,A
8-NS,810,0,145,0,0,145,T
8-NS,811,142,0,2,0,144,A
8-NS,812,145,0,0,0,145,A
8-NS,813,0,0,145,0,145,G
8-NS,814,130,0,0,0,130,A
8-NS,815,130,0,0,0,130,A
8-NS,816,0,0,0,126,126,C
8-NS,817,0,95,0,0,95,T
8-NS,818,0,93,0,0,93,T
8-NS,819,0,93,0,1,94,T
8-NS,820,0,0,0,94,94,C
8-NS,821,0,83,0,0,83,T
8-NS,822,0,0,0,81,81,C
8-NS,823,78,0,0,0,78,A
8-NS,824,0,78,0,0,78,T
8-NS,825,0,77,0,0,77,T
8-NS,826,0,77,0,0,77,T
8-NS,827,0,0,0,77,77,C
8-NS,828,72,0,0,0,72,A
8-NS,829,0,0,72,0,72,G
8-NS,830,0,0,0,71,71,C
8-NS,831,0,69,0,0,69,T
8-NS,832,0,68,0,0,68,T
8-NS,833,68,0,0,0,68,A
8-NS,834,0,67,0,0,67,T
8-NS,835,0,67,1,0,68,T
8-NS,836,0,67,0,0,67,T
8-NS,837,63,0,0,0,63,A
8-NS,838,61,0,0,0,61,A
8-NS,839,0,61,0,0,61,T
8-NS,840,0,0,60,0,60,G
8-NS,841,59,0,0,0,59,A
8-NS,842,0,53,0,0,53,T
8-NS,843,52,0,0,0,52,A
8-NS,844,52,0,0,0,52,A
8-NS,845,52,0,0,0,52,A
8-NS,846,52,0,0,0,52,A
8-NS,847,52,0,0,0,52,A
8-NS,848,52,0,0,0,52,A
8-NS,849,0,0,0,52,52,C
8-NS,850,39,0,0,0,39,A
8-NS,851,0,0,0,37,37,C
8-NS,852,0,0,0,37,37,C
8-NS,853,1,0,0,33,34,C
8-NS,854,0,31,0,0,31,T
8-NS,855,0,30,0,0,30,T
8-NS,856,0,0,30,0,30,G
8-NS,857,0,28,0,0,28,T
8-NS,858,0,27,0,0,27,T
8-NS,859,0,27,0,0,27,T
8-NS,860,0,0,0,9,9,C
8-NS,861,0,8,0,0,8,T
8-NS,862,7,0,0,0,7,A
8-NS,863,0,0,0,7,7,C
