Gene,Position,A,T,G,C,Coverage,Consensus
1-PB2,1,413,0,0,0,413,A
1-PB2,2,0,421,0,0,421,T
1-PB2,3,0,0,434,0,434,G
1-PB2,4,0,0,431,0,431,G
1-PB2,5,432,0,0,0,432,A
1-PB2,6,430,0,0,0,430,A
1-PB2,7,431,0,0,0,431,A
1-PB2,8,0,1,463,0,464,G
1-PB2,9,461,0,1,0,462,A
1-PB2,10,470,0,0,0,470,A
1-PB2,11,0,477,0,0,477,T
1-PB2,12,481,0,0,0,481,A
1-PB2,13,480,0,0,0,480,A
1-PB2,14,484,0,0,0,484,A
1-PB2,15,483,0,1,0,484,A
1-PB2,16,0,2,501,0,503,G
1-PB2,17,506,0,0,0,506,A
1-PB2,18,505,0,0,0,505,A
1-PB2,19,0,0,0,518,518,C
1-PB2,20,0,519,0,0,519,T
1-PB2,21,533,0,0,0,533,A
1-PB2,22,2,0,0,531,533,C
1-PB2,23,0,1,532,0,533,G
1-PB2,24,0,2,532,0,534,G
1-PB2,25,533,0,0,0,533,A
1-PB2,26,559,0,0,0,559,A
1-PB2,27,0,563,0,0,563,T
1-PB2,28,0,0,0,567,567,C
1-PB2,29,0,571,0,0,571,T
1-PB2,30,0,1,573,0,574,G
1-PB2,31,575,0,0,0,575,A
1-PB2,32,0,584,0,0,584,T
1-PB2,33,0,0,589,0,589,G
1-PB2,34,0,601,0,0,601,T
1-PB2,35,0,0,0,600,600,C
1-PB2,36,0,0,597,0,597,G
1-PB2,37,0,1,0,601,602,C
1-PB2,38,601,0,0,0,601,A
1-PB2,39,0,0,630,0,630,G
1-PB2,40,0,631,0,0,631,T
1-PB2,41,0,0,0,638,638,C
1-PB2,42,0,633,0,1,634,T
1-PB2,43,0,0,0,635,635,C
1-PB2,44,0,0,634,0,634,G
1-PB2,45,0,0,1,632,633,C
1-PB2,46,630,0,0,0,630,A
1-PB2,47,0,0,0,649,649,C
1-PB2,48,0,644,0,0,644,T
1-PB2,49,1,0,0,668,669,C
1-PB2,50,0,0,676,0,676,G
1-PB2,51,0,2,0,673,675,C
1-PB2,52,0,1,672,0,673,G
1-PB2,53,678,0,0,0,678,A
1-PB2,54,0,0,681,0,681,G
1-PB2,55,704,0,0,0,704,A
1-PB2,56,0,699,0,0,699,T
1-PB2,57,702,1,0,0,703,A
1-PB2,58,0,0,0,701,701,C
1-PB2,59,0,695,0,0,695,T
1-PB2,60,1,1,704,0,706,G
1-PB2,61,705,1,0,0,706,A
1-PB2,62,0,0,0,714,714,C
1-PB2,63,716,0,0,0,716,A
1-PB2,64,713,0,0,0,713,A
1-PB2,65,723,0,0,0,723,A
1-PB2,66,742,0,0,0,742,A
1-PB2,67,744,0,0,0,744,A
1-PB2,68,0,0,0,753,753,C
1-PB2,69,3,0,0,752,755,C
1-PB2,70,782,0,0,0,782,A
1-PB2,71,0,0,0,792,792,C
1-PB2,72,789,0,0,0,789,A
1-PB2,73,1,0,811,0,812,G
1-PB2,74,0,810,0,0,810,T
1-PB2,75,0,3,838,0,841,G
1-PB2,76,0,6,836,0,842,G
1-PB2,77,841,0,2,0,843,A
1-PB2,78,0,0,0,879,879,C
1-PB2,79,5,0,0,866,871,C
1-PB2,80,880,0,0,0,880,A
1-PB2,81,0,875,0,1,876,T
1-PB2,82,875,0,1,0,876,A
1-PB2,83,0,876,0,0,876,T
1-PB2,84,0,0,874,0,874,G
1-PB2,85,0,0,874,0,874,G
1-PB2,86,0,0,0,873,873,C
1-PB2,87,3,0,0,859,862,C
1-PB2,88,863,0,0,0,863,A
1-PB2,89,0,925,0,0,925,T
1-PB2,90,925,0,1,0,926,A
1-PB2,91,958,0,0,0,958,A
1-PB2,92,0,965,0,0,965,T
1-PB2,93,0,957,0,0,957,T
1-PB2,94,972,0,0,0,972,A
1-PB2,95,969,0,0,0,969,A
1-PB2,96,0,1,1002,0,1003,G
1-PB2,97,1003,0,0,0,1003,A
1-PB2,98,995,0,0,0,995,A
1-PB2,99,0,0,1045,0,1045,G
1-PB2,100,0,1025,0,0,1025,T
1-PB2,101,1042,0,1,0,1043,A
1-PB2,102,0,0,0,1044,1044,C
1-PB2,103,1044,0,1,0,1045,A
1-PB2,104,0,0,0,1075,1075,C
1-PB2,105,1060,0,0,0,1060,A
1-PB2,106,0,1068,0,1,1069,T
1-PB2,107,1,0,0,1073,1074,C
1-PB2,108,0,4,1064,0,1068,G
1-PB2,109,0,1,1072,0,1073,G
1-PB2,110,0,1,1063,0,1064,G
1-PB2,111,0,3,1065,0,1068,G
1-PB2,112,1068,0,1,0,1069,A
1-PB2,113,1,2,1063,0,1066,G
1-PB2,114,1070,0,1,0,1071,A
1-PB2,115,0,0,0,1082,1082,C
1-PB2,116,1081,0,1,0,1082,A
1-PB2,117,0,0,1104,0,1104,G
1-PB2,118,0,3,1118,0,1121,G
1-PB2,119,1115,0,1,0,1116,A
1-PB2,120,1126,0,1,0,1127,A
1-PB2,121,1127,0,1,0,1128,A
1-PB2,122,1125,0,1,0,1126,A
1-PB2,123,0,3,1124,0,1127,G
1-PB2,124,1122,0,1,0,1123,A
1-PB2,125,1124,0,1,0,1125,A
1-PB2,126,0,1,0,1121,1122,C
1-PB2,127,1,0,0,1121,1122,C
1-PB2,128,2,0,0,1126,1128,C
1-PB2,129,1,0,1130,0,1131,G
1-PB2,130,0,1120,0,2,1122,T
1-PB2,131,5,0,0,1127,1132,C
1-PB2,132,1137,0,0,0,1137,A
1-PB2,133,1,0,0,1152,1153,C
1-PB2,134,0,1156,0,0,1156,T
1-PB2,135,0,1157,0,0,1157,T
1-PB2,136,1156,0,0,0,1156,A
1-PB2,137,0,0,1169,0,1169,G
1-PB2,138,0,1,1165,0,1166,G
1-PB2,139,1161,0,1,0,1162,A
1-PB2,140,0,1158,0,0,1158,T
1-PB2,141,0,2,1179,0,1181,G
1-PB2,142,1200,0,1,0,1201,A
1-PB2,143,1201,0,0,0,1201,A
1-PB2,144,1203,0,0,1,1204,A
1-PB2,145,0,1203,0,0,1203,T
1-PB2,146,0,1,1206,0,1207,G
1-PB2,147,0,0,1209,0,1209,G
1-PB2,148,1209,0,1,1,1211,A
1-PB2,149,0,1215,0,2,1217,T
1-PB2,150,0,0,1202,0,1202,G
1-PB2,151,1192,1,1,0,1194,A
1-PB2,152,0,1202,0,0,1202,T
1-PB2,153,0,1,1197,0,1198,G
1-PB2,154,0,0,1198,0,1198,G
1-PB2,155,0,0,0,1211,1211,C
1-PB2,156,1204,0,0,0,1204,A
1-PB2,157,1216,0,1,0,1217,A
1-PB2,158,0,1220,0,0,1220,T
1-PB2,159,0,2,1260,0,1262,G
1-PB2,160,1258,1,0,0,1259,A
1-PB2,161,1253,0,0,0,1253,A
1-PB2,162,1250,0,0,0,1250,A
1-PB2,163,2,1255,0,0,1257,T
1-PB2,164,1268,0,0,0,1268,A
1-PB2,165,0,1,0,1295,1296,C
1-PB2,166,1,0,0,1276,1277,C
1-PB2,167,4,0,0,1284,1288,C
1-PB2,168,1286,0,1,0,1287,A
1-PB2,169,1284,0,0,0,1284,A
1-PB2,170,1,1283,0,1,1285,T
1-PB2,171,3,0,0,1284,1287,C
1-PB2,172,1273,0,0,0,1273,A
1-PB2,173,0,0,0,1307,1307,C
1-PB2,174,0,1292,0,0,1292,T
1-PB2,175,0,0,1300,0,1300,G
1-PB2,176,0,0,0,1300,1300,C
1-PB2,177,0,1296,0,3,1299,T
1-PB2,178,1,1,1308,0,1310,G
1-PB2,179,1308,0,1,0,1309,A
1-PB2,180,0,0,0,1318,1318,C
1-PB2,181,1319,0,0,0,1319,A
1-PB2,182,1291,0,0,0,1291,A
1-PB2,183,1292,0,0,0,1292,A
1-PB2,184,1294,0,1,0,1295,A
1-PB2,185,0,4,1309,0,1313,G
1-PB2,186,1,3,1307,0,1311,G
1-PB2,187,1302,1,1,0,1304,A
1-PB2,188,0,1309,0,0,1309,T
1-PB2,189,1303,0,1,0,1304,A
1-PB2,190,1307,0,0,0,1307,A
1-PB2,191,0,0,0,1325,1325,C
1-PB2,192,1323,0,0,0,1323,A
1-PB2,193,0,0,1329,0,1329,G
1-PB2,194,1299,0,0,0,1299,A
1-PB2,195,1306,0,1,0,1307,A
1-PB2,196,1302,0,0,0,1302,A
1-PB2,197,1,1302,0,0,1303,T
1-PB2,198,0,1,1299,0,1300,G
1-PB2,199,0,0,1318,0,1318,G
1-PB2,200,0,1307,0,0,1307,T
1-PB2,201,0,1306,0,0,1306,T
1-PB2,202,7,1,0,1301,1309,C
1-PB2,203,0,1,0,1293,1294,C
1-PB2,204,0,1,1308,0,1309,G
1-PB2,205,0,0,1306,0,1306,G
1-PB2,206,1307,0,1,0,1308,A
1-PB2,207,1,0,1312,0,1313,G
1-PB2,208,1293,0,0,0,1293,A
1-PB2,209,1,2,1302,0,1305,G
1-PB2,210,1307,1,1,0,1309,A
1-PB2,211,1313,0,1,0,1314,A
1-PB2,212,1312,0,1,1,1314,A
1-PB2,213,0,1307,0,0,1307,T
1-PB2,214,0,8,1317,0,1325,G
1-PB2,215,1328,0,0,0,1328,A
1-PB2,216,1322,1,1,0,1324,A
1-PB2,217,0,0,0,1322,1322,C
1-PB2,218,1309,1,3,0,1313,A
1-PB2,219,1322,0,0,0,1322,A
1-PB2,220,0,3,1343,0,1346,G
1-PB2,221,0,4,1344,0,1348,G
1-PB2,222,1348,0,1,0,1349,A
1-PB2,223,1,0,0,1347,1348,C
1-PB2,224,1341,0,1,0,1342,A
1-PB2,225,1339,0,1,0,1340,A
1-PB2,226,1385,0,1,0,1386,A
1-PB2,227,0,0,0,1399,1399,C
1-PB2,228,0,1375,0,1,1376,T
1-PB2,229,2,0,0,1392,1394,C
1-PB2,230,0,1371,0,0,1371,T
1-PB2,231,1370,0,0,0,1370,A
1-PB2,232,0,1372,0,1,1373,T
1-PB2,233,0,3,1371,1,1375,G
1-PB2,234,0,2,1412,0,1414,G
1-PB2,235,1340,0,0,0,1340,A
1-PB2,236,0,0,1355,0,1355,G
1-PB2,237,0,1350,0,0,1350,T
1-PB2,238,1332,0,0,0,1332,A
1-PB2,239,1333,0,0,1,1334,A
1-PB2,240,1339,0,0,0,1339,A
1-PB2,241,1334,0,2,0,1336,A
1-PB2,242,0,1334,0,0,1334,T
1-PB2,243,0,1,1335,0,1336,G
1-PB2,244,1311,0,1,0,1312,A
1-PB2,245,2,0,1317,0,1319,G
1-PB2,246,0,1300,0,1,1301,T
1-PB2,247,1,3,1304,0,1308,G
1-PB2,248,1341,0,1,0,1342,A
1-PB2,249,0,1345,0,1,1346,T
1-PB2,250,0,0,1347,0,1347,G
1-PB2,251,0,2,0,1335,1337,C
1-PB2,252,0,1344,0,0,1344,T
1-PB2,253,0,4,1384,0,1388,G
1-PB2,254,0,1,1386,0,1387,G
1-PB2,255,1400,0,0,0,1400,A
1-PB2,256,0,1396,0,0,1396,T
1-PB2,257,2,0,0,1381,1383,C
1-PB2,258,1393,0,1,0,1394,A
1-PB2,259,3,0,1426,0,1429,G
1-PB2,260,1431,0,0,0,1431,A
1-PB2,261,1,1426,0,0,1427,T
1-PB2,262,1382,0,2,0,1384,A
1-PB2,263,1,3,1418,0,1422,G
1-PB2,264,1400,0,3,0,1403,A
1-PB2,265,0,0,1420,0,1420,G
1-PB2,266,0,1399,0,0,1399,T
1-PB2,267,1,3,1391,0,1395,G
1-PB2,268,1377,1,0,0,1378,A
1-PB2,269,0,1380,0,0,1380,T
1-PB2,270,0,4,1413,0,1417,G
1-PB2,271,1,0,1439,0,1440,G
1-PB2,272,0,1412,0,1,1413,T
1-PB2,273,1417,0,0,0,1417,A
1-PB2,274,0,1397,0,2,1399,T
1-PB2,275,4,1,0,1388,1393,C
1-PB2,276,1413,0,0,0,1413,A
1-PB2,277,0,0,0,1451,1451,C
1-PB2,278,2,0,0,1447,1449,C
1-PB2,279,1,1410,0,1,1412,T
1-PB2,280,0,1410,0,0,1410,T
1-PB2,281,0,1412,0,0,1412,T
1-PB2,282,0,0,1426,0,1426,G
1-PB2,283,1,0,1424,0,1425,G
1-PB2,284,0,0,0,1437,1437,C
1-PB2,285,0,1413,0,0,1413,T
1-PB2,286,0,0,1428,0,1428,G
1-PB2,287,0,1425,0,1,1426,T
1-PB2,288,1433,0,0,0,1433,A
1-PB2,289,1447,0,1,0,1448,A
1-PB2,290,2,0,0,1437,1439,C
1-PB2,291,1415,0,0,0,1415,A
1-PB2,292,0,1418,0,0,1418,T
1-PB2,293,0,4,1396,1,1401,G
1-PB2,294,0,0,1417,0,1417,G
1-PB2,295,0,1397,0,1,1398,T
1-PB2,296,0,7,1392,0,1399,G
1-PB2,297,0,3,1420,1,1424,G
1-PB2,298,1427,0,0,0,1427,A
1-PB2,299,1438,1,0,0,1439,A
1-PB2,300,0,1437,0,0,1437,T
1-PB2,301,1435,0,0,0,1435,A
1-PB2,302,0,1,1452,0,1453,G
1-PB2,303,1443,0,1,1,1445,A
1-PB2,304,1441,0,0,1,1442,A
1-PB2,305,1436,0,2,0,1438,A
1-PB2,306,0,1385,0,0,1385,T
1-PB2,307,0,2,1386,0,1388,G
1-PB2,308,0,3,1376,0,1379,G
1-PB2,309,1387,0,0,0,1387,A
1-PB2,310,1,0,0,1389,1390,C
1-PB2,311,3,0,0,1368,1371,C
1-PB2,312,5,0,0,1379,1384,C
1-PB2,313,5,0,1392,0,1397,G
1-PB2,314,0,1399,0,0,1399,T
1-PB2,315,0,2,1437,0,1439,G
1-PB2,316,1437,0,3,1,1441,A
1-PB2,317,1,0,0,1454,1455,C
1-PB2,318,1452,0,3,1,1456,A
1-PB2,319,1443,0,2,2,1447,A
1-PB2,320,0,0,1488,0,1488,G
1-PB2,321,0,1478,0,1,1479,T
1-PB2,322,1479,0,0,0,1479,A
1-PB2,323,1,0,0,1462,1463,C
1-PB2,324,0,5,1428,0,1433,G
1-PB2,325,1,0,1474,0,1475,G
1-PB2,326,0,1464,0,5,1469,T
1-PB2,327,5,1,0,1472,1478,C
1-PB2,328,5,0,0,1468,1473,C
1-PB2,329,1454,0,0,0,1454,A
1-PB2,330,0,1470,0,1,1471,T
1-PB2,331,0,1472,0,0,1472,T
1-PB2,332,1532,0,0,0,1532,A
1-PB2,333,3,1,0,1530,1534,C
1-PB2,334,1,1,0,1493,1495,C
1-PB2,335,7,0,0,1493,1500,C
1-PB2,336,1494,0,0,1,1495,A
1-PB2,337,1506,0,0,0,1506,A
1-PB2,338,1503,0,0,0,1503,A
1-PB2,339,1493,0,2,0,1495,A
1-PB2,340,0,1,1507,0,1508,G
1-PB2,341,0,1445,0,0,1445,T
1-PB2,342,1,0,1485,0,1486,G
1-PB2,343,0,1485,0,0,1485,T
1-PB2,344,1486,0,1,0,1487,A
1-PB2,345,1,0,0,1487,1488,C
1-PB2,346,1479,0,0,0,1479,A
1-PB2,347,1481,0,1,0,1482,A
1-PB2,348,2,5,1495,0,1502,G
1-PB2,349,1472,0,3,0,1475,A
1-PB2,350,1,0,0,1494,1495,C
1-PB2,351,0,1455,0,1,1456,T
1-PB2,352,0,1471,0,0,1471,T
1-PB2,353,1469,0,1,0,1470,A
1-PB2,354,0,1469,0,0,1469,T
1-PB2,355,0,1474,0,0,1474,T
1-PB2,356,0,1464,0,1,1465,T
1-PB2,357,1,0,0,1460,1461,C
1-PB2,358,1,3,1455,0,1459,G
1-PB2,359,1446,0,3,0,1449,A
1-PB2,360,0,0,0,1460,1460,C
1-PB2,361,1450,0,0,0,1450,A
1-PB2,362,1445,0,0,0,1445,A
1-PB2,363,1439,0,0,0,1439,A
1-PB2,364,3,0,1460,0,1463,G
1-PB2,365,0,1439,0,0,1439,T
1-PB2,366,3,0,0,1451,1454,C
1-PB2,367,0,3,1459,0,1462,G
1-PB2,368,1448,0,2,0,1450,A
1-PB2,369,1448,1,1,0,1450,A
1-PB2,370,1447,0,2,0,1449,A
1-PB2,371,0,2,1492,0,1494,G
1-PB2,372,0,0,1501,0,1501,G
1-PB2,373,0,1500,0,0,1500,T
1-PB2,374,0,1503,0,0,1503,T
1-PB2,375,1504,1,0,0,1505,A
1-PB2,376,1504,0,0,0,1504,A
1-PB2,377,1502,0,0,0,1502,A
1-PB2,378,1514,0,0,0,1514,A
1-PB2,379,0,0,0,1522,1522,C
1-PB2,380,1477,0,0,0,1477,A
1-PB2,381,0,1462,0,1,1463,T
1-PB2,382,0,7,1452,0,1459,G
1-PB2,383,0,2,1457,0,1459,G
1-PB2,384,1463,0,0,0,1463,A
1-PB2,385,1465,0,0,0,1465,A
1-PB2,386,1,0,0,1499,1500,C
1-PB2,387,2,0,1,1522,1525,C
1-PB2,388,0,1508,0,1,1509,T
1-PB2,389,0,1506,0,2,1508,T
1-PB2,390,0,1514,1,0,1515,T
1-PB2,391,0,4,1504,0,1508,G
1-PB2,392,0,2,1498,0,1500,G
1-PB2,393,1,0,0,1502,1503,C
1-PB2,394,1,0,0,1497,1498,C
1-PB2,395,4,0,0,1487,1491,C
1-PB2,396,0,1439,0,2,1441,T
1-PB2,397,0,0,1450,0,1450,G
1-PB2,398,0,1452,0,0,1452,T
1-PB2,399,1,1450,0,0,1451,T
1-PB2,400,2,0,0,1454,1456,C
1-PB2,401,1439,0,0,0,1439,A
1-PB2,402,0,1444,0,0,1444,T
1-PB2,403,0,1442,2,0,1444,T
1-PB2,404,0,1447,0,0,1447,T
1-PB2,405,0,1447,0,0,1447,T
1-PB2,406,1430,0,0,0,1430,A
1-PB2,407,0,1,1425,0,1426,G
1-PB2,408,1420,0,0,0,1420,A
1-PB2,409,1431,0,0,0,1431,A
1-PB2,410,1428,0,1,0,1429,A
1-PB2,411,0,1422,0,0,1422,T
1-PB2,412,5,0,0,1427,1432,C
1-PB2,413,1428,0,1,0,1429,A
1-PB2,414,1439,0,4,0,1443,A
1-PB2,415,0,1,1446,0,1447,G
1-PB2,416,0,1443,0,0,1443,T
1-PB2,417,2,0,0,1454,1456,C
1-PB2,418,1459,0,2,0,1461,A
1-PB2,419,1457,0,1,0,1458,A
1-PB2,420,2,1,1459,0,1462,G
1-PB2,421,1462,0,1,0,1463,A
1-PB2,422,0,1455,0,0,1455,T
1-PB2,423,1479,0,1,0,1480,A
1-PB2,424,1,0,0,1474,1475,C
1-PB2,425,0,0,1473,0,1473,G
1-PB2,426,0,1,0,1481,1482,C
1-PB2,427,1480,0,0,1,1481,A
1-PB2,428,0,1,1494,0,1495,G
1-PB2,429,1490,0,0,0,1490,A
1-PB2,430,1474,0,2,0,1476,A
1-PB2,431,0,3,1502,0,1505,G
1-PB2,432,1465,0,2,0,1467,A
1-PB2,433,0,0,1482,0,1482,G
1-PB2,434,0,1474,0,0,1474,T
1-PB2,435,1471,0,1,0,1472,A
1-PB2,436,1,1,1485,0,1487,G
1-PB2,437,1482,1,3,0,1486,A
1-PB2,438,0,0,0,1537,1537,C
1-PB2,439,1513,0,0,0,1513,A
1-PB2,440,0,1482,0,0,1482,T
1-PB2,441,1479,0,0,0,1479,A
1-PB2,442,1475,0,1,0,1476,A
1-PB2,443,1476,0,0,0,1476,A
1-PB2,444,0,0,0,1488,1488,C
1-PB2,445,1,1,0,1476,1478,C
1-PB2,446,7,1,0,1461,1469,C
1-PB2,447,0,1395,0,2,1397,T
1-PB2,448,0,4,1402,0,1406,G
1-PB2,449,0,1,1422,0,1423,G
1-PB2,450,0,1417,0,2,1419,T
1-PB2,451,6,0,0,1408,1414,C
1-PB2,452,1415,0,0,0,1415,A
1-PB2,453,0,1404,0,0,1404,T
1-PB2,454,0,0,1416,0,1416,G
1-PB2,455,3,0,0,1409,1412,C
1-PB2,456,1405,0,3,0,1408,A
1-PB2,457,0,3,1422,1,1426,G
1-PB2,458,1382,0,1,0,1383,A
1-PB2,459,1,0,0,1398,1399,C
1-PB2,460,1,0,0,1403,1404,C
1-PB2,461,0,1366,0,0,1366,T
1-PB2,462,1,0,0,1375,1376,C
1-PB2,463,1358,0,0,0,1358,A
1-PB2,464,0,0,1392,0,1392,G
1-PB2,465,0,1385,0,2,1387,T
1-PB2,466,0,1,1385,0,1386,G
1-PB2,467,2,2,0,1370,1374,C
1-PB2,468,2,1,0,1372,1375,C
1-PB2,469,1373,0,0,0,1373,A
1-PB2,470,1372,0,0,0,1372,A
1-PB2,471,1360,0,0,0,1360,A
1-PB2,472,0,7,1355,0,1362,G
1-PB2,473,1322,0,1,0,1323,A
1-PB2,474,0,3,1334,0,1337,G
1-PB2,475,2,0,1324,0,1326,G
1-PB2,476,0,0,0,1328,1328,C
1-PB2,477,1327,0,1,0,1328,A
1-PB2,478,0,0,0,1340,1340,C
1-PB2,479,1331,0,1,0,1332,A
1-PB2,480,1373,0,0,0,1373,A
1-PB2,481,2,2,1380,0,1384,G
1-PB2,482,1393,1,3,0,1397,A
1-PB2,483,0,1397,1,0,1398,T
1-PB2,484,0,0,1397,0,1397,G
1-PB2,485,1,1391,0,0,1392,T
1-PB2,486,1400,0,0,0,1400,A
1-PB2,487,1400,0,0,0,1400,A
1-PB2,488,0,1395,0,0,1395,T
1-PB2,489,0,1339,0,0,1339,T
1-PB2,490,1330,1,0,0,1331,A
1-PB2,491,0,1301,0,1,1302,T
1-PB2,492,0,6,1297,0,1303,G
1-PB2,493,1,2,1291,0,1294,G
1-PB2,494,1277,0,0,0,1277,A
1-PB2,495,1270,0,1,0,1271,A
1-PB2,496,0,1,1283,0,1284,G
1-PB2,497,0,1277,0,0,1277,T
1-PB2,498,0,1279,0,0,1279,T
1-PB2,499,0,0,1282,0,1282,G
1-PB2,500,0,1275,0,0,1275,T
1-PB2,501,0,1275,0,0,1275,T
1-PB2,502,0,1275,0,0,1275,T
1-PB2,503,0,1268,0,0,1268,T
1-PB2,504,0,1269,0,0,1269,T
1-PB2,505,2,1,0,1268,1271,C
1-PB2,506,2,0,0,1278,1280,C
1-PB2,507,3,0,0,1289,1292,C
1-PB2,508,1280,0,1,0,1281,A
1-PB2,509,1284,0,0,0,1284,A
1-PB2,510,1,1289,0,0,1290,T
1-PB2,511,0,2,1302,0,1304,G
1-PB2,512,1300,0,0,0,1300,A
1-PB2,513,1295,0,0,0,1295,A
1-PB2,514,0,0,1306,0,1306,G
1-PB2,515,0,1294,0,0,1294,T
1-PB2,516,0,2,1296,0,1298,G
1-PB2,517,1,1,1289,0,1291,G
1-PB2,518,0,3,1279,0,1282,G
1-PB2,519,1286,0,4,0,1290,A
1-PB2,520,1,0,1288,0,1289,G
1-PB2,521,0,0,0,1275,1275,C
1-PB2,522,3,0,0,1282,1285,C
1-PB2,523,1284,1,2,0,1287,A
1-PB2,524,0,0,1322,0,1322,G
1-PB2,525,0,1,1327,0,1328,G
1-PB2,526,1336,0,0,0,1336,A
1-PB2,527,0,1329,0,0,1329,T
1-PB2,528,1327,0,0,0,1327,A
1-PB2,529,0,1,0,1328,1329,C
1-PB2,530,0,1331,0,0,1331,T
1-PB2,531,1331,0,1,0,1332,A
1-PB2,532,1316,0,3,0,1319,A
1-PB2,533,0,0,0,1331,1331,C
1-PB2,534,1290,0,0,0,1290,A
1-PB2,535,0,1265,0,0,1265,T
1-PB2,536,3,1,1,1266,1271,C
1-PB2,537,1255,0,0,0,1255,A
1-PB2,538,0,1,1264,0,1265,G
1-PB2,539,1263,0,0,0,1263,A
1-PB2,540,1256,0,0,0,1256,A
1-PB2,541,0,1253,0,0,1253,T
1-PB2,542,5,1,0,1228,1234,C
1-PB2,543,1239,0,2,0,1241,A
1-PB2,544,1,0,0,1262,1263,C
1-PB2,545,1267,0,0,0,1267,A
1-PB2,546,1272,1,0,0,1273,A
1-PB2,547,0,1254,0,0,1254,T
1-PB2,548,0,1261,0,1,1262,T
1-PB2,549,1264,0,0,0,1264,A
1-PB2,550,1273,0,1,0,1274,A
1-PB2,551,1,1,0,1291,1293,C
1-PB2,552,1279,0,1,0,1280,A
1-PB2,553,1260,0,0,0,1260,A
1-PB2,554,0,1261,0,0,1261,T
1-PB2,555,1261,0,0,0,1261,A
1-PB2,556,1262,0,0,0,1262,A
1-PB2,557,1,0,0,1269,1270,C
1-PB2,558,0,1262,0,1,1263,T
1-PB2,559,1259,0,0,0,1259,A
1-PB2,560,1256,0,1,0,1257,A
1-PB2,561,1250,0,1,0,1251,A
1-PB2,562,0,3,1252,0,1255,G
1-PB2,563,1221,0,1,0,1222,A
1-PB2,564,1,3,1235,0,1239,G
1-PB2,565,1229,0,2,0,1231,A
1-PB2,566,1236,0,0,0,1236,A
1-PB2,567,1238,0,0,0,1238,A
1-PB2,568,1236,0,0,0,1236,A
1-PB2,569,1241,0,0,0,1241,A
1-PB2,570,1237,0,0,0,1237,A
1-PB2,571,0,1,1232,0,1233,G
1-PB2,572,1235,0,0,0,1235,A
1-PB2,573,1229,0,1,0,1230,A
1-PB2,574,0,3,1233,0,1236,G
1-PB2,575,1237,2,0,0,1239,A
1-PB2,576,1233,0,0,0,1233,A
1-PB2,577,1,0,0,1246,1247,C
1-PB2,578,0,1215,0,0,1215,T
1-PB2,579,5,3,0,1228,1236,C
1-PB2,580,2,0,0,1227,1229,C
1-PB2,581,1,3,1233,1,1238,G
1-PB2,582,1238,0,0,0,1238,A
1-PB2,583,0,0,1234,0,1234,G
1-PB2,584,1226,0,0,0,1226,A
1-PB2,585,0,1216,0,0,1216,T
1-PB2,586,0,1215,0,0,1215,T
1-PB2,587,0,0,1200,0,1200,G
1-PB2,588,0,0,0,1208,1208,C
1-PB2,589,1216,0,0,0,1216,A
1-PB2,590,1211,0,0,0,1211,A
1-PB2,591,1209,0,1,0,1210,A
1-PB2,592,1218,0,0,0,1218,A
1-PB2,593,0,1210,0,1,1211,T
1-PB2,594,0,1210,0,0,1210,T
1-PB2,595,0,1205,0,0,1205,T
1-PB2,596,0,0,0,1206,1206,C
1-PB2,597,0,1174,0,2,1176,T
1-PB2,598,1,0,0,1275,1276,C
1-PB2,599,1,0,0,1283,1284,C
1-PB2,600,12,0,0,1392,1404,C
1-PB2,601,0,1386,0,0,1386,T
1-PB2,602,0,1412,0,0,1412,T
1-PB2,603,0,2,1430,0,1432,G
1-PB2,604,1429,1,2,0,1432,A
1-PB2,605,0,1459,0,0,1459,T
1-PB2,606,1,2,1495,0,1498,G
1-PB2,607,0,0,1724,0,1724,G
1-PB2,608,2,1751,0,1,1754,T
1-PB2,609,0,1775,0,1,1776,T
1-PB2,610,0,0,1934,0,1934,G
1-PB2,611,1,0,0,1941,1942,C
1-PB2,612,1997,0,0,0,1997,A
1-PB2,613,0,1994,0,0,1994,T
1-PB2,614,2025,0,0,1,2026,A
1-PB2,615,0,0,0,2128,2128,C
1-PB2,616,2363,0,0,5,2368,A
1-PB2,617,0,2436,0,1,2437,T
1-PB2,618,3,1,2539,0,2543,G
1-PB2,619,0,2535,0,2,2537,T
1-PB2,620,0,2531,0,1,2532,T
1-PB2,621,2544,0,0,0,2544,A
1-PB2,622,0,8,2522,0,2530,G
1-PB2,623,2568,0,0,1,2569,A
1-PB2,624,1,5,2572,0,2578,G
1-PB2,625,2500,0,3,0,2503,A
1-PB2,626,1,3,2500,0,2504,G
1-PB2,627,2497,0,2,0,2499,A
1-PB2,628,0,6,2501,0,2507,G
1-PB2,629,2506,1,3,0,2510,A
1-PB2,630,2516,0,0,0,2516,A
1-PB2,631,0,0,0,2547,2547,C
1-PB2,632,0,2533,0,0,2533,T
1-PB2,633,0,2523,0,0,2523,T
1-PB2,634,0,0,2523,0,2523,G
1-PB2,635,0,2526,0,1,2527,T
1-PB2,636,2533,0,0,0,2533,A
1-PB2,637,0,2,0,2522,2524,C
1-PB2,638,2,6,2520,0,2528,G
1-PB2,639,2528,0,0,0,2528,A
1-PB2,640,2518,0,1,0,2519,A
1-PB2,641,2569,0,0,0,2569,A
1-PB2,642,2568,0,0,0,2568,A
1-PB2,643,2584,0,0,1,2585,A
1-PB2,644,0,1,0,2605,2606,C
1-PB2,645,2602,0,1,0,2603,A
1-PB2,646,2618,0,1,1,2620,A
1-PB2,647,0,1,2626,0,2627,G
1-PB2,648,2632,1,1,0,2634,A
1-PB2,649,0,2640,0,0,2640,T
1-PB2,650,0,2626,1,1,2628,T
1-PB2,651,2,2,0,2599,2603,C
1-PB2,652,2,1,0,2656,2659,C
1-PB2,653,0,2691,0,1,2692,T
1-PB2,654,2,0,0,2693,2695,C
1-PB2,655,1,1,0,2687,2689,C
1-PB2,656,8,0,0,2704,2712,C
1-PB2,657,2702,0,0,0,2702,A
1-PB2,658,0,3,2729,0,2732,G
1-PB2,659,0,2725,0,1,2726,T
1-PB2,660,0,2733,0,2,2735,T
1-PB2,661,2,0,2729,0,2731,G
1-PB2,662,1,2,0,2722,2725,C
1-PB2,663,0,2719,0,0,2719,T
1-PB2,664,1,3,2731,1,2736,G
1-PB2,665,0,2,2716,0,2718,G
1-PB2,666,0,2,0,2730,2732,C
1-PB2,667,1,5,2729,0,2735,G
1-PB2,668,2,4,2758,0,2764,G
1-PB2,669,2771,0,1,0,2772,A
1-PB2,670,2769,0,4,0,2773,A
1-PB2,671,0,0,0,2788,2788,C
1-PB2,672,2800,0,0,0,2800,A
1-PB2,673,2789,0,3,0,2792,A
1-PB2,674,0,0,2932,0,2932,G
1-PB2,675,1,1,0,2985,2987,C
1-PB2,676,3003,0,3,0,3006,A
1-PB2,677,0,1,3692,0,3693,G
1-PB2,678,0,3681,0,0,3681,T
1-PB2,679,3701,0,6,0,3707,A
1-PB2,680,0,3713,0,0,3713,T
1-PB2,681,3723,0,2,0,3725,A
1-PB2,682,0,3726,0,0,3726,T
1-PB2,683,3676,1,1,0,3678,A
1-PB2,684,1,1,0,3713,3715,C
1-PB2,685,3581,0,0,0,3581,A
1-PB2,686,0,3423,0,0,3423,T
1-PB2,687,0,3307,0,0,3307,T
1-PB2,688,0,4,3285,0,3289,G
1-PB2,689,3279,0,1,0,3280,A
1-PB2,690,3282,0,0,1,3283,A
1-PB2,691,0,0,3324,0,3324,G
1-PB2,692,0,3300,2,1,3303,T
1-PB2,693,0,3284,0,1,3285,T
1-PB2,694,0,3288,0,2,3290,T
1-PB2,695,0,3296,0,0,3296,T
1-PB2,696,3298,2,4,0,3304,A
1-PB2,697,0,2,0,3327,3329,C
1-PB2,698,3319,0,0,0,3319,A
1-PB2,699,1,3313,0,1,3315,T
1-PB2,700,0,3284,0,0,3284,T
1-PB2,701,0,3292,0,2,3294,T
1-PB2,702,1,17,3305,0,3323,G
1-PB2,703,3324,0,2,0,3326,A
1-PB2,704,1,1,0,3367,3369,C
1-PB2,705,0,3338,0,2,3340,T
1-PB2,706,3,0,0,3349,3352,C
1-PB2,707,3332,0,3,0,3335,A
1-PB2,708,0,14,3303,0,3317,G
1-PB2,709,0,6,3406,0,3412,G
1-PB2,710,1,4,3417,0,3422,G
1-PB2,711,3421,0,2,0,3423,A
1-PB2,712,3433,0,4,0,3437,A
1-PB2,713,2,0,1,3426,3429,C
1-PB2,714,2,0,3464,0,3466,G
1-PB2,715,1,3443,0,0,3444,T
1-PB2,716,3,1,3485,0,3489,G
1-PB2,717,0,3452,0,2,3454,T
1-PB2,718,0,3456,0,1,3457,T
1-PB2,719,1,8,3455,0,3464,G
1-PB2,720,1,4,3452,0,3457,G
1-PB2,721,1,10,3481,0,3492,G
1-PB2,722,3470,1,3,0,3474,A
1-PB2,723,3468,1,1,0,3470,A
1-PB2,724,1,2,0,3558,3561,C
1-PB2,725,3557,0,0,0,3557,A
1-PB2,726,3654,0,1,0,3655,A
1-PB2,727,3668,1,1,0,3670,A
1-PB2,728,1,3692,0,0,3693,T
1-PB2,729,2,1,3745,0,3748,G
1-PB2,730,0,3713,0,2,3715,T
1-PB2,731,3724,0,2,0,3726,A
1-PB2,732,2,1,0,3740,3743,C
1-PB2,733,3658,0,2,0,3660,A
1-PB2,734,1,0,0,3667,3668,C
1-PB2,735,0,3551,0,3,3554,T
1-PB2,736,5,3,0,3856,3864,C
1-PB2,737,2,1,0,3878,3881,C
1-PB2,738,3900,3,6,1,3910,A
1-PB2,739,1,7,3956,0,3964,G
1-PB2,740,1,4,4042,0,4047,G
1-PB2,741,0,4005,0,3,4008,T
1-PB2,742,2,4,4034,0,4040,G
1-PB2,743,0,5,3918,0,3923,G
1-PB2,744,3866,0,6,0,3872,A
1-PB2,745,1,7,3897,0,3905,G
1-PB2,746,0,12,3897,0,3909,G
1-PB2,747,3853,1,1,0,3855,A
1-PB2,748,0,0,3918,1,3919,G
1-PB2,749,0,3821,0,1,3822,T
1-PB2,750,0,9,3857,1,3867,G
1-PB2,751,3842,0,5,0,3847,A
1-PB2,752,4,6,3867,0,3877,G
1-PB2,753,1,6,3898,0,3905,G
1-PB2,754,3881,0,1,0,3882,A
1-PB2,755,3880,0,2,0,3882,A
1-PB2,756,0,3889,0,2,3891,T
1-PB2,757,1,7,3863,0,3871,G
1-PB2,758,3864,1,4,0,3869,A
1-PB2,759,1,0,0,3857,3858,C
1-PB2,760,2,8,3849,0,3859,G
1-PB2,761,3901,0,0,0,3901,A
1-PB2,762,0,3891,0,0,3891,T
1-PB2,763,0,0,3925,0,3925,G
1-PB2,764,0,3910,0,3,3913,T
1-PB2,765,1,3876,0,1,3878,T
1-PB2,766,2,10,3897,0,3909,G
1-PB2,767,3893,0,3,0,3896,A
1-PB2,768,0,0,0,3900,3900,C
1-PB2,769,11,4,0,3879,3894,C
1-PB2,770,3868,0,0,0,3868,A
1-PB2,771,3868,0,0,0,3868,A
1-PB2,772,3867,0,3,0,3870,A
1-PB2,773,1,0,3978,0,3979,G
1-PB2,774,3,0,0,3962,3965,C
1-PB2,775,7,1,0,3968,3976,C
1-PB2,776,0,3995,0,3,3998,T
1-PB2,777,4003,0,1,0,4004,A
1-PB2,778,4000,1,0,0,4001,A
1-PB2,779,0,4005,0,1,4006,T
1-PB2,780,0,4001,0,0,4001,T
1-PB2,781,3964,0,0,0,3964,A
1-PB2,782,0,3883,0,1,3884,T
1-PB2,783,0,3854,0,0,3854,T
1-PB2,784,0,1,3842,0,3843,G
1-PB2,785,1,1,0,3818,3820,C
1-PB2,786,2,8,3808,0,3818,G
1-PB2,787,1,0,3877,0,3878,G
1-PB2,788,0,0,0,3867,3867,C
1-PB2,789,3,0,0,3891,3894,C
1-PB2,790,3897,0,2,0,3899,A
1-PB2,791,0,7,3945,0,3952,G
1-PB2,792,1,5,3971,2,3979,G
1-PB2,793,3964,0,3,0,3967,A
1-PB2,794,3992,0,4,0,3996,A
1-PB2,795,0,2,0,4032,4034,C
1-PB2,796,3965,0,1,0,3966,A
1-PB2,797,1,4017,0,2,4020,T
1-PB2,798,4070,1,2,0,4073,A
1-PB2,799,0,3,4099,0,4102,G
1-PB2,800,0,4030,0,1,4031,T
1-PB2,801,4014,0,0,0,4014,A
1-PB2,802,4000,0,1,0,4001,A
1-PB2,803,1,2,4000,0,4003,G
1-PB2,804,3957,0,3,0,3960,A
1-PB2,805,3909,0,1,0,3910,A
1-PB2,806,1,3,3897,0,3901,G
1-PB2,807,3779,0,6,1,3786,A
1-PB2,808,4,0,3774,0,3778,G
1-PB2,809,1,1,0,3768,3770,C
1-PB2,810,6,2,0,3778,3786,C
1-PB2,811,0,0,3786,0,3786,G
1-PB2,812,1,2,0,3814,3817,C
1-PB2,813,3837,0,2,0,3839,A
1-PB2,814,1,0,4167,0,4168,G
1-PB2,815,0,4132,0,0,4132,T
1-PB2,816,4152,0,3,0,4155,A
1-PB2,817,0,4136,0,2,4138,T
1-PB2,818,6,0,0,4179,4185,C
1-PB2,819,4174,0,1,0,4175,A
1-PB2,820,0,0,4171,0,4171,G
1-PB2,821,1,0,0,4164,4165,C
1-PB2,822,3988,0,2,0,3990,A
1-PB2,823,0,5,3906,0,3911,G
1-PB2,824,3934,0,0,0,3934,A
1-PB2,825,0,3924,0,0,3924,T
1-PB2,826,8,1,1,3926,3936,C
1-PB2,827,12,2,0,3938,3952,C
1-PB2,828,3944,0,3,0,3947,A
1-PB2,829,1,2,0,3974,3977,C
1-PB2,830,0,3955,0,4,3959,T
1-PB2,831,3964,0,1,0,3965,A
1-PB2,832,1,1,3954,0,3956,G
1-PB2,833,1,1,0,3906,3908,C
1-PB2,834,3903,0,2,0,3905,A
1-PB2,835,0,3907,0,0,3907,T
1-PB2,836,2,1,0,3931,3934,C
1-PB2,837,0,3918,0,6,3924,T
1-PB2,838,0,4012,0,0,4012,T
1-PB2,839,0,4031,0,0,4031,T
1-PB2,840,4027,0,0,0,4027,A
1-PB2,841,0,4014,0,1,4015,T
1-PB2,842,0,4012,0,0,4012,T
1-PB2,843,0,4,4009,0,4013,G
1-PB2,844,0,6,3983,0,3989,G
1-PB2,845,3926,0,1,0,3927,A
1-PB2,846,0,2,3929,0,3931,G
1-PB2,847,3875,0,1,0,3876,A
1-PB2,848,0,3854,0,1,3855,T
1-PB2,849,0,3,3940,0,3943,G
1-PB2,850,0,3928,0,1,3929,T
1-PB2,851,0,0,3939,0,3939,G
1-PB2,852,1,2,0,3923,3926,C
1-PB2,853,7,1,0,3923,3931,C
1-PB2,854,3908,1,5,0,3914,A
1-PB2,855,1,2,0,3933,3936,C
1-PB2,856,3859,1,3,0,3863,A
1-PB2,857,1,2,3907,0,3910,G
1-PB2,858,2,0,0,3770,3772,C
1-PB2,859,3752,1,6,0,3759,A
1-PB2,860,0,0,0,3772,3772,C
1-PB2,861,3763,0,3,0,3766,A
1-PB2,862,1,0,0,3779,3780,C
1-PB2,863,3763,0,0,0,3763,A
1-PB2,864,3768,0,0,0,3768,A
1-PB2,865,3758,0,2,0,3760,A
1-PB2,866,0,3620,0,0,3620,T
1-PB2,867,0,3650,0,0,3650,T
1-PB2,868,0,2,3639,0,3641,G
1-PB2,869,1,3,3604,0,3608,G
1-PB2,870,0,8,0,3611,3619,C
1-PB2,871,1,10,3586,0,3597,G
1-PB2,872,0,8,3653,0,3661,G
1-PB2,873,4,6,3652,0,3662,G
1-PB2,874,3582,0,0,0,3582,A
1-PB2,875,0,0,0,3639,3639,C
1-PB2,876,3633,0,0,0,3633,A
1-PB2,877,3670,0,3,0,3673,A
1-PB2,878,1,10,3632,1,3644,G
1-PB2,879,0,3,3709,0,3712,G
1-PB2,880,3590,0,2,0,3592,A
1-PB2,881,0,3521,0,2,3523,T
1-PB2,882,2,9,3454,0,3465,G
1-PB2,883,0,0,3513,0,3513,G
1-PB2,884,0,3332,0,0,3332,T
1-PB2,885,0,9,3473,0,3482,G
1-PB2,886,0,5,3472,0,3477,G
1-PB2,887,3318,1,3,0,3322,A
1-PB2,888,0,1,0,3380,3381,C
1-PB2,889,3355,0,0,0,3355,A
1-PB2,890,0,3846,0,0,3846,T
1-PB2,891,0,3843,0,1,3844,T
1-PB2,892,4,3,0,3786,3793,C
1-PB2,893,1,3787,0,5,3793,T
1-PB2,894,0,3820,0,0,3820,T
1-PB2,895,3775,0,0,0,3775,A
1-PB2,896,2,5,3792,0,3799,G
1-PB2,897,3786,0,1,0,3787,A
1-PB2,898,1,1,0,3793,3795,C
1-PB2,899,3120,0,0,0,3120,A
1-PB2,900,2,7,3156,0,3165,G
1-PB2,901,3117,0,5,0,3122,A
1-PB2,902,3164,0,3,0,3167,A
1-PB2,903,2,0,0,3088,3090,C
1-PB2,904,11,1,0,3173,3185,C
1-PB2,905,9,5,0,3195,3209,C
1-PB2,906,0,11,3139,0,3150,G
1-PB2,907,3132,0,4,0,3136,A
1-PB2,908,0,4,0,3182,3186,C
1-PB2,909,0,3151,1,2,3154,T
1-PB2,910,0,1,3176,0,3177,G
1-PB2,911,3129,0,3,0,3132,A
1-PB2,912,3196,0,6,0,3202,A
1-PB2,913,2,12,3173,0,3187,G
1-PB2,914,3172,0,0,0,3172,A
1-PB2,915,3198,0,1,0,3199,A
1-PB2,916,3,1,0,3156,3160,C
1-PB2,917,3172,1,1,0,3174,A
1-PB2,918,3213,0,2,0,3215,A
1-PB2,919,0,0,3191,0,3191,G
1-PB2,920,1,3,0,3215,3219,C
1-PB2,921,0,3225,1,2,3228,T
1-PB2,922,0,2,3299,0,3301,G
1-PB2,923,0,3260,0,0,3260,T
1-PB2,924,2,12,3361,1,3376,G
1-PB2,925,0,3,3490,0,3493,G
1-PB2,926,3410,1,3,0,3414,A
1-PB2,927,0,3456,0,2,3458,T
1-PB2,928,3472,0,0,0,3472,A
1-PB2,929,0,3422,0,0,3422,T
1-PB2,930,3580,0,0,0,3580,A
1-PB2,931,1,3521,0,2,3524,T
1-PB2,932,1,1,3503,0,3505,G
1-PB2,933,1,1,1,3462,3465,C
1-PB2,934,3332,0,2,0,3334,A
1-PB2,935,3346,0,5,0,3351,A
1-PB2,936,0,7,3311,0,3318,G
1-PB2,937,0,1,3361,0,3362,G
1-PB2,938,4,1,0,3329,3334,C
1-PB2,939,2,3275,0,4,3281,T
1-PB2,940,2,0,3306,0,3308,G
1-PB2,941,1,0,0,3317,3318,C
1-PB2,942,3329,0,0,0,3329,A
1-PB2,943,3343,0,2,0,3345,A
1-PB2,944,0,3300,0,0,3300,T
1-PB2,945,0,9,3292,0,3301,G
1-PB2,946,2,11,3305,0,3318,G
1-PB2,947,2,4,3318,0,3324,G
1-PB2,948,3239,1,4,0,3244,A
1-PB2,949,0,3280,0,0,3280,T
1-PB2,950,0,3295,0,5,3300,T
1-PB2,951,0,13,3279,0,3292,G
1-PB2,952,3257,0,7,0,3264,A
1-PB2,953,2,1,3313,0,3316,G
1-PB2,954,3293,0,2,0,3295,A
1-PB2,955,3279,0,2,0,3281,A
1-PB2,956,0,3199,0,0,3199,T
1-PB2,957,4,1,0,3241,3246,C
1-PB2,958,3238,0,4,0,3242,A
1-PB2,959,1,2,3254,0,3257,G
1-PB2,960,1,1,0,3261,3263,C
1-PB2,961,0,3210,1,4,3215,T
1-PB2,962,14,0,0,3243,3257,C
1-PB2,963,3247,0,1,0,3248,A
1-PB2,964,0,3308,0,2,3310,T
1-PB2,965,8,0,0,3317,3325,C
1-PB2,966,3,0,0,3372,3375,C
1-PB2,967,0,3337,1,6,3344,T
1-PB2,968,0,3312,0,4,3316,T
1-PB2,969,3,3,0,3314,3320,C
1-PB2,970,3328,0,2,0,3330,A
1-PB2,971,1,0,3377,0,3378,G
1-PB2,972,0,0,0,3356,3356,C
1-PB2,973,0,3289,1,6,3296,T
1-PB2,974,0,3341,0,0,3341,T
1-PB2,975,0,3313,0,1,3314,T
1-PB2,976,2,5,3297,0,3304,G
1-PB2,977,1,0,3304,0,3305,G
1-PB2,978,0,3238,0,1,3239,T
1-PB2,979,0,14,3304,0,3318,G
1-PB2,980,0,6,3337,0,3343,G
1-PB2,981,0,1,3358,0,3359,G
1-PB2,982,0,3292,0,1,3293,T
1-PB2,983,0,3337,0,5,3342,T
1-PB2,984,0,3357,0,0,3357,T
1-PB2,985,3347,0,4,0,3351,A
1-PB2,986,0,1,0,3388,3389,C
1-PB2,987,3376,1,1,0,3378,A
1-PB2,988,0,3356,1,0,3357,T
1-PB2,989,1,3299,1,1,3302,T
1-PB2,990,0,3303,0,1,3304,T
1-PB2,991,3291,2,0,0,3293,A
1-PB2,992,3302,0,0,0,3302,A
1-PB2,993,3309,0,1,0,3310,A
1-PB2,994,3292,1,4,1,3298,A
1-PB2,995,1,6,3306,0,3313,G
1-PB2,996,3296,0,1,0,3297,A
1-PB2,997,3297,0,0,0,3297,A
1-PB2,998,1,3,0,3301,3305,C
1-PB2,999,3303,0,0,0,3303,A
1-PB2,1000,3292,1,4,2,3299,A
1-PB2,1001,0,1,3288,0,3289,G
1-PB2,1002,0,3,0,3288,3291,C
1-PB2,1003,4,9,3278,1,3292,G
1-PB2,1004,1,7,3272,0,3280,G
1-PB2,1005,0,2,3276,0,3278,G
1-PB2,1006,2,3241,0,6,3249,T
1-PB2,1007,7,0,0,3269,3276,C
1-PB2,1008,3288,0,1,0,3289,A
1-PB2,1009,0,3235,0,2,3237,T
1-PB2,1010,1,1,0,3275,3277,C
1-PB2,1011,3275,0,2,0,3277,A
1-PB2,1012,1,6,3334,0,3341,G
1-PB2,1013,0,3270,0,2,3272,T
1-PB2,1014,9,0,0,3297,3306,C
1-PB2,1015,3308,0,0,0,3308,A
1-PB2,1016,3322,0,0,0,3322,A
1-PB2,1017,3322,0,1,0,3323,A
1-PB2,1018,3316,0,0,1,3317,A
1-PB2,1019,3326,0,0,0,3326,A
1-PB2,1020,3317,0,11,0,3328,A
1-PB2,1021,2,7,3327,0,3336,G
1-PB2,1022,3316,0,1,0,3317,A
1-PB2,1023,3317,0,3,0,3320,A
1-PB2,1024,0,4,3316,0,3320,G
1-PB2,1025,3305,0,0,0,3305,A
1-PB2,1026,3231,0,1,0,3232,A
1-PB2,1027,0,6,3219,0,3225,G
1-PB2,1028,3227,0,3,0,3230,A
1-PB2,1029,0,8,3212,0,3220,G
1-PB2,1030,0,2,3273,1,3276,G
1-PB2,1031,1,3234,0,0,3235,T
1-PB2,1032,0,1,3328,0,3329,G
1-PB2,1033,2,0,0,3378,3380,C
1-PB2,1034,1,3371,1,0,3373,T
1-PB2,1035,1,3412,0,2,3415,T
1-PB2,1036,3408,0,2,0,3410,A
1-PB2,1037,0,2,0,3405,3407,C
1-PB2,1038,3369,0,5,0,3374,A
1-PB2,1039,1,8,3350,1,3360,G
1-PB2,1040,4,1,3342,0,3347,G
1-PB2,1041,4,1,0,3273,3278,C
1-PB2,1042,3245,0,0,0,3245,A
1-PB2,1043,3244,1,2,0,3247,A
1-PB2,1044,0,3285,0,6,3291,T
1-PB2,1045,5,0,0,3330,3335,C
1-PB2,1046,1,3308,0,5,3314,T
1-PB2,1047,7,0,0,3318,3325,C
1-PB2,1048,4,0,0,3325,3329,C
1-PB2,1049,3345,0,1,0,3346,A
1-PB2,1050,3342,0,3,0,3345,A
1-PB2,1051,3341,0,1,0,3342,A
1-PB2,1052,1,1,0,3354,3356,C
1-PB2,1053,3260,0,2,0,3262,A
1-PB2,1054,0,3217,0,3,3220,T
1-PB2,1055,0,3196,0,0,3196,T
1-PB2,1056,1,5,3237,0,3243,G
1-PB2,1057,3244,0,0,1,3245,A
1-PB2,1058,3292,0,3,2,3297,A
1-PB2,1059,3300,0,0,1,3301,A
1-PB2,1060,3299,0,0,2,3301,A
1-PB2,1061,0,3301,0,2,3303,T
1-PB2,1062,3308,0,2,1,3311,A
1-PB2,1063,3305,0,2,2,3309,A
1-PB2,1064,0,7,3362,0,3369,G
1-PB2,1065,3303,0,5,0,3308,A
1-PB2,1066,1,0,3395,0,3396,G
1-PB2,1067,0,3332,0,1,3333,T
1-PB2,1068,3376,0,3,0,3379,A
1-PB2,1069,3,0,0,3424,3427,C
1-PB2,1070,3408,0,2,0,3410,A
1-PB2,1071,1,3395,1,3,3400,T
1-PB2,1072,0,6,3404,0,3410,G
1-PB2,1073,3337,0,3,0,3340,A
1-PB2,1074,0,8,3358,0,3366,G
1-PB2,1075,0,10,3337,0,3347,G
1-PB2,1076,0,15,3470,0,3485,G
1-PB2,1077,2,2,3504,0,3508,G
1-PB2,1078,0,3415,0,2,3417,T
1-PB2,1079,3483,0,2,1,3486,A
1-PB2,1080,1,3454,0,0,3455,T
1-PB2,1081,0,8,3471,0,3479,G
1-PB2,1082,3477,0,2,1,3480,A
1-PB2,1083,0,7,3440,0,3447,G
1-PB2,1084,0,8,3387,0,3395,G
1-PB2,1085,3219,0,4,0,3223,A
1-PB2,1086,2,4,3257,0,3263,G
1-PB2,1087,0,3300,1,1,3302,T
1-PB2,1088,0,3390,1,1,3392,T
1-PB2,1089,7,0,0,3411,3418,C
1-PB2,1090,3402,0,3,0,3405,A
1-PB2,1091,1,3,0,3436,3440,C
1-PB2,1092,3424,0,0,0,3424,A
1-PB2,1093,3432,1,5,0,3438,A
1-PB2,1094,0,3424,1,2,3427,T
1-PB2,1095,0,7,3340,0,3347,G
1-PB2,1096,0,3,3388,0,3391,G
1-PB2,1097,0,3276,0,1,3277,T
1-PB2,1098,0,12,3297,0,3309,G
1-PB2,1099,5,2,3298,0,3305,G
1-PB2,1100,0,7,3299,1,3307,G
1-PB2,1101,6,2,3343,0,3351,G
1-PB2,1102,3322,0,1,1,3324,A
1-PB2,1103,3345,0,0,0,3345,A
1-PB2,1104,3318,0,1,0,3319,A
1-PB2,1105,3244,0,7,0,3251,A
1-PB2,1106,19,4,3258,0,3281,G
1-PB2,1107,3246,0,6,0,3252,A
1-PB2,1108,1,0,3260,1,3262,G
1-PB2,1109,2,1,0,3230,3233,C
1-PB2,1110,3252,1,4,0,3257,A
1-PB2,1111,3261,1,2,0,3264,A
1-PB2,1112,1,1,0,3362,3364,C
1-PB2,1113,3357,0,1,0,3358,A
1-PB2,1114,3,1,3404,0,3408,G
1-PB2,1115,0,0,0,3362,3362,C
1-PB2,1116,0,3372,0,3,3375,T
1-PB2,1117,3468,0,1,0,3469,A
1-PB2,1118,0,3469,0,0,3469,T
1-PB2,1119,3469,1,1,0,3471,A
1-PB2,1120,1,0,0,3478,3479,C
1-PB2,1121,0,3291,0,3,3294,T
1-PB2,1122,3313,0,1,0,3314,A
1-PB2,1123,3238,0,4,0,3242,A
1-PB2,1124,0,6,3232,0,3238,G
1-PB2,1125,3234,0,0,0,3234,A
1-PB2,1126,3146,0,0,1,3147,A
1-PB2,1127,3125,0,3,0,3128,A
1-PB2,1128,3104,0,1,0,3105,A
1-PB2,1129,2,1,3108,0,3111,G
1-PB2,1130,0,0,0,3098,3098,C
1-PB2,1131,3113,1,1,0,3115,A
1-PB2,1132,3104,0,2,0,3106,A
1-PB2,1133,0,1,0,3123,3124,C
1-PB2,1134,3,1,0,3116,3120,C
1-PB2,1135,3137,0,1,0,3138,A
1-PB2,1136,0,2,3145,0,3147,G
1-PB2,1137,3137,0,1,0,3138,A
1-PB2,1138,3119,0,2,0,3121,A
1-PB2,1139,0,3,3172,0,3175,G
1-PB2,1140,3137,0,0,0,3137,A
1-PB2,1141,1,3134,0,0,3135,T
1-PB2,1142,1,3108,0,1,3110,T
1-PB2,1143,0,8,3121,0,3129,G
1-PB2,1144,3,0,3178,0,3181,G
1-PB2,1145,0,3154,0,4,3158,T
1-PB2,1146,1,3133,0,2,3136,T
1-PB2,1147,4,0,0,3172,3176,C
1-PB2,1148,3233,0,1,0,3234,A
1-PB2,1149,2,0,3358,0,3360,G
1-PB2,1150,2,1,0,3378,3381,C
1-PB2,1151,0,3368,1,3,3372,T
1-PB2,1152,7,0,0,3383,3390,C
1-PB2,1153,3363,0,1,0,3364,A
1-PB2,1154,0,3385,0,0,3385,T
1-PB2,1155,3388,1,0,0,3389,A
1-PB2,1156,0,0,3412,1,3413,G
1-PB2,1157,0,3191,0,1,3192,T
1-PB2,1158,1,14,3222,0,3237,G
1-PB2,1159,3139,0,1,0,3140,A
1-PB2,1160,2,4,3181,0,3187,G
1-PB2,1161,0,3155,0,1,3156,T
1-PB2,1162,2,7,3156,0,3165,G
1-PB2,1163,1,2,3201,0,3204,G
1-PB2,1164,3189,0,1,0,3190,A
1-PB2,1165,3184,0,8,1,3193,A
1-PB2,1166,0,7,3188,0,3195,G
1-PB2,1167,3147,0,3,0,3150,A
1-PB2,1168,1,5,3163,0,3169,G
1-PB2,1169,3124,0,2,0,3126,A
1-PB2,1170,0,0,0,3129,3129,C
1-PB2,1171,0,10,3139,0,3149,G
1-PB2,1172,3113,0,0,0,3113,A
1-PB2,1173,3111,0,2,0,3113,A
1-PB2,1174,0,0,0,3128,3128,C
1-PB2,1175,3113,0,1,0,3114,A
1-PB2,1176,0,0,3271,0,3271,G
1-PB2,1177,0,3222,0,4,3226,T
1-PB2,1178,8,0,0,3235,3243,C
1-PB2,1179,3258,0,2,0,3260,A
1-PB2,1180,3241,2,0,0,3243,A
1-PB2,1181,3,3223,0,1,3227,T
1-PB2,1182,3230,0,0,0,3230,A
1-PB2,1183,0,2,3222,0,3224,G
1-PB2,1184,0,1,0,3207,3208,C
1-PB2,1185,2,0,0,3112,3114,C
1-PB2,1186,1,2,3108,0,3111,G
1-PB2,1187,3095,0,0,1,3096,A
1-PB2,1188,3112,0,2,0,3114,A
1-PB2,1189,2,1,3130,0,3133,G
1-PB2,1190,2,0,0,3205,3207,C
1-PB2,1191,3215,0,1,0,3216,A
1-PB2,1192,3219,0,0,0,3219,A
1-PB2,1193,0,3217,0,1,3218,T
1-PB2,1194,3236,0,1,0,3237,A
1-PB2,1195,3264,0,0,0,3264,A
1-PB2,1196,0,3249,0,3,3252,T
1-PB2,1197,5,0,0,3247,3252,C
1-PB2,1198,1,2,3230,0,3233,G
1-PB2,1199,0,3153,0,2,3155,T
1-PB2,1200,1,2,3148,0,3151,G
1-PB2,1201,0,1,3176,0,3177,G
1-PB2,1202,1,0,0,3161,3162,C
1-PB2,1203,1,2,0,3186,3189,C
1-PB2,1204,3135,0,2,1,3138,A
1-PB2,1205,0,3139,0,2,3141,T
1-PB2,1206,0,7,3147,0,3154,G
1-PB2,1207,0,1,3200,0,3201,G
1-PB2,1208,0,3112,2,2,3116,T
1-PB2,1209,1,1,3217,0,3219,G
1-PB2,1210,0,3118,1,1,3120,T
1-PB2,1211,0,3173,0,2,3175,T
1-PB2,1212,0,3188,0,1,3189,T
1-PB2,1213,0,3191,0,2,3193,T
1-PB2,1214,5,5,1,3272,3283,C
1-PB2,1215,3285,0,1,0,3286,A
1-PB2,1216,1,1,0,3577,3579,C
1-PB2,1217,3526,0,2,2,3530,A
1-PB2,1218,3615,0,0,0,3615,A
1-PB2,1219,1,1,3652,0,3654,G
1-PB2,1220,3572,1,2,0,3575,A
1-PB2,1221,293,7,3358,0,3658,G
1-PB2,1222,1,5,3711,0,3717,G
1-PB2,1223,3689,1,0,0,3690,A
1-PB2,1224,0,3714,0,2,3716,T
1-PB2,1225,0,3710,0,0,3710,T
1-PB2,1226,0,1,3712,0,3713,G
1-PB2,1227,0,1,0,3644,3645,C
1-PB2,1228,3677,0,2,0,3679,A
1-PB2,1229,0,3725,0,2,3727,T
1-PB2,1230,1,3,3888,0,3892,G
1-PB2,1231,3916,0,2,0,3918,A
1-PB2,1232,0,3958,0,0,3958,T
1-PB2,1233,3948,0,0,0,3948,A
1-PB2,1234,3938,0,0,0,3938,A
1-PB2,1235,3934,0,0,0,3934,A
1-PB2,1236,3920,0,21,0,3941,A
1-PB2,1237,0,3,3940,0,3943,G
1-PB2,1238,1,0,0,4040,4041,C
1-PB2,1239,4105,0,1,0,4106,A
1-PB2,1240,0,1,4259,0,4260,G
1-PB2,1241,0,4244,0,3,4247,T
1-PB2,1242,0,4259,0,0,4259,T
1-PB2,1243,4265,0,1,0,4266,A
1-PB2,1244,0,6,4287,0,4293,G
1-PB2,1245,4261,0,5,0,4266,A
1-PB2,1246,0,13,4252,0,4265,G
1-PB2,1247,2,1,4219,0,4222,G
1-PB2,1248,0,4009,1,2,4012,T
1-PB2,1249,1,12,4098,0,4111,G
1-PB2,1250,4130,0,5,0,4135,A
1-PB2,1251,1,0,0,4173,4174,C
1-PB2,1252,6,1,1,4200,4208,C
1-PB2,1253,0,4132,0,6,4138,T
1-PB2,1254,1,11,4164,0,4176,G
1-PB2,1255,4154,1,0,0,4155,A
1-PB2,1256,4167,0,0,0,4167,A
1-PB2,1257,0,4176,0,0,4176,T
1-PB2,1258,1,4247,1,1,4250,T
1-PB2,1259,0,4254,0,0,4254,T
1-PB2,1260,8,3,0,4257,4268,C
1-PB2,1261,0,1,4266,0,4267,G
1-PB2,1262,0,4250,0,1,4251,T
1-PB2,1263,9,0,0,4267,4276,C
1-PB2,1264,4278,0,0,0,4278,A
1-PB2,1265,4270,0,1,0,4271,A
1-PB2,1266,1,0,0,4276,4277,C
1-PB2,1267,4217,0,0,0,4217,A
1-PB2,1268,0,7,4298,0,4305,G
1-PB2,1269,4263,1,2,0,4266,A
1-PB2,1270,2,2,4294,0,4298,G
1-PB2,1271,2,0,0,4291,4293,C
1-PB2,1272,4301,2,0,0,4303,A
1-PB2,1273,4381,0,1,0,4382,A
1-PB2,1274,4372,0,1,0,4373,A
1-PB2,1275,0,4345,0,1,4346,T
1-PB2,1276,6,0,0,4374,4380,C
1-PB2,1277,4353,0,2,0,4355,A
1-PB2,1278,0,3,4336,0,4339,G
1-PB2,1279,4,3,0,4344,4351,C
1-PB2,1280,2,7,4372,0,4381,G
1-PB2,1281,5,1,4615,0,4621,G
1-PB2,1282,0,4568,0,6,4574,T
1-PB2,1283,0,4605,0,1,4606,T
1-PB2,1284,0,16,4594,0,4610,G
1-PB2,1285,4597,1,3,0,4601,A
1-PB2,1286,4644,0,3,0,4647,A
1-PB2,1287,1,1,1,4675,4678,C
1-PB2,1288,11,5,0,4651,4667,C
1-PB2,1289,10,1,0,4699,4710,C
1-PB2,1290,17,0,1,4569,4587,C
1-PB2,1291,4594,0,4,0,4598,A
1-PB2,1292,1,4635,0,2,4638,T
1-PB2,1293,0,1,4658,0,4659,G
1-PB2,1294,1,0,0,4699,4700,C
1-PB2,1295,4642,0,1,0,4643,A
1-PB2,1296,0,4620,0,2,4622,T
1-PB2,1297,7,2,0,4624,4633,C
1-PB2,1298,4594,0,4,0,4598,A
1-PB2,1299,4,1,4654,0,4659,G
1-PB2,1300,0,0,1,4668,4669,C
1-PB2,1301,0,4669,1,5,4675,T
1-PB2,1302,0,4677,0,2,4679,T
1-PB2,1303,0,4666,0,0,4666,T
1-PB2,1304,0,4662,0,1,4663,T
1-PB2,1305,4669,0,0,0,4669,A
1-PB2,1306,4669,0,2,0,4671,A
1-PB2,1307,1,5,4657,0,4663,G
1-PB2,1308,0,4,4617,0,4621,G
1-PB2,1309,2,1,0,4586,4589,C
1-PB2,1310,4575,0,0,0,4575,A
1-PB2,1311,0,4594,0,0,4594,T
1-PB2,1312,1,4639,0,0,4640,T
1-PB2,1313,0,4635,0,0,4635,T
1-PB2,1314,0,4650,1,1,4652,T
1-PB2,1315,6,0,0,4652,4658,C
1-PB2,1316,4658,0,4,0,4662,A
1-PB2,1317,1,3,4659,0,4663,G
1-PB2,1318,4642,1,2,0,4645,A
1-PB2,1319,4650,0,1,0,4651,A
1-PB2,1320,4626,0,5,0,4631,A
1-PB2,1321,1,10,4631,0,4642,G
1-PB2,1322,4671,0,1,0,4672,A
1-PB2,1323,0,4658,0,2,4660,T
1-PB2,1324,1,1,4677,0,4679,G
1-PB2,1325,1,2,0,4643,4646,C
1-PB2,1326,2,3,4691,0,4696,G
1-PB2,1327,4662,2,0,0,4664,A
1-PB2,1328,4666,1,1,0,4668,A
1-PB2,1329,4676,0,0,0,4676,A
1-PB2,1330,0,2,4693,0,4695,G
1-PB2,1331,0,4608,0,3,4611,T
1-PB2,1332,2,3,4632,0,4637,G
1-PB2,1333,0,1,0,4614,4615,C
1-PB2,1334,0,4627,0,6,4633,T
1-PB2,1335,1,4624,0,2,4627,T
1-PB2,1336,1,4645,1,1,4648,T
1-PB2,1337,0,4645,0,0,4645,T
1-PB2,1338,0,4638,0,3,4641,T
1-PB2,1339,4,1,0,4645,4650,C
1-PB2,1340,4649,0,1,0,4650,A
1-PB2,1341,4667,0,5,0,4672,A
1-PB2,1342,4657,0,0,0,4657,A
1-PB2,1343,4658,1,1,0,4660,A
1-PB2,1344,0,4663,0,1,4664,T
1-PB2,1345,0,4667,0,0,4667,T
1-PB2,1346,1,16,4653,0,4670,G
1-PB2,1347,1,8,4658,0,4667,G
1-PB2,1348,2,11,4669,0,4682,G
1-PB2,1349,0,5,4732,0,4737,G
1-PB2,1350,4713,0,4,0,4717,A
1-PB2,1351,3,2,4778,0,4783,G
1-PB2,1352,0,4766,0,0,4766,T
1-PB2,1353,0,4771,0,1,4772,T
1-PB2,1354,0,16,4782,0,4798,G
1-PB2,1355,4781,1,2,0,4784,A
1-PB2,1356,4797,0,7,0,4804,A
1-PB2,1357,4,2,0,4949,4955,C
1-PB2,1358,4858,1,1,0,4860,A
1-PB2,1359,0,0,0,5006,5006,C
1-PB2,1360,4914,0,1,0,4915,A
1-PB2,1361,0,4906,0,0,4906,T
1-PB2,1362,9,2,0,4940,4951,C
1-PB2,1363,0,19,4924,0,4943,G
1-PB2,1364,4959,0,4,0,4963,A
1-PB2,1365,1,3,0,4956,4960,C
1-PB2,1366,4804,0,0,0,4804,A
1-PB2,1367,2,1,4986,0,4989,G
1-PB2,1368,0,4848,0,5,4853,T
1-PB2,1369,0,0,4958,0,4958,G
1-PB2,1370,1,4901,0,3,4905,T
1-PB2,1371,2,3,4945,0,4950,G
1-PB2,1372,4938,0,3,0,4941,A
1-PB2,1373,0,4910,1,2,4913,T
1-PB2,1374,2,16,4906,0,4924,G
1-PB2,1375,1,9,4917,1,4928,G
1-PB2,1376,0,10,4831,1,4842,G
1-PB2,1377,4815,0,0,0,4815,A
1-PB2,1378,4792,0,2,0,4794,A
1-PB2,1379,0,4786,0,1,4787,T
1-PB2,1380,3,6,4825,0,4834,G
1-PB2,1381,4833,0,1,0,4834,A
1-PB2,1382,0,4840,0,1,4841,T
1-PB2,1383,0,4826,1,0,4827,T
1-PB2,1384,3,7,4783,0,4793,G
1-PB2,1385,1,12,4892,0,4905,G
1-PB2,1386,4879,1,2,0,4882,A
1-PB2,1387,0,1,4958,1,4960,G
1-PB2,1388,0,4908,0,3,4911,T
1-PB2,1389,4907,0,6,0,4913,A
1-PB2,1390,0,4961,0,1,4962,T
1-PB2,1391,0,5010,0,0,5010,T
1-PB2,1392,5042,0,2,0,5044,A
1-PB2,1393,2,1,0,5057,5060,C
1-PB2,1394,19,2,0,4960,4981,C
1-PB2,1395,4933,0,7,1,4941,A
1-PB2,1396,1,5,4961,0,4967,G
1-PB2,1397,5062,0,3,0,5065,A
1-PB2,1398,0,5029,1,2,5032,T
1-PB2,1399,4982,1,1,0,4984,A
1-PB2,1400,0,4926,0,6,4932,T
1-PB2,1401,1,17,4905,0,4923,G
1-PB2,1402,4903,0,6,0,4909,A
1-PB2,1403,3,1,0,4943,4947,C
1-PB2,1404,0,4904,0,6,4910,T
1-PB2,1405,14,0,0,4888,4902,C
1-PB2,1406,13,1,0,4871,4885,C
1-PB2,1407,4903,1,3,0,4907,A
1-PB2,1408,4921,0,3,0,4924,A
1-PB2,1409,0,5,5038,0,5043,G
1-PB2,1410,2,1,0,5022,5025,C
1-PB2,1411,5003,2,1,0,5006,A
1-PB2,1412,0,1,0,5026,5027,C
1-PB2,1413,4977,0,2,1,4980,A
1-PB2,1414,2,6,5002,0,5010,G
1-PB2,1415,4987,0,1,0,4988,A
1-PB2,1416,3,3,5011,0,5017,G
1-PB2,1417,5009,0,4,0,5013,A
1-PB2,1418,2,4858,0,2,4862,T
1-PB2,1419,3,2,4936,0,4941,G
1-PB2,1420,2,4892,0,6,4900,T
1-PB2,1421,10,3,1,4897,4911,C
1-PB2,1422,4924,0,9,0,4933,A
1-PB2,1423,4915,0,2,0,4917,A
1-PB2,1424,1,4909,0,0,4910,T
1-PB2,1425,4,9,4896,0,4909,G
1-PB2,1426,4843,1,3,0,4847,A
1-PB2,1427,2,13,4857,1,4873,G
1-PB2,1428,4793,0,9,0,4802,A
1-PB2,1429,3,11,4786,0,4800,G
1-PB2,1430,1,8,5009,1,5019,G
1-PB2,1431,5020,0,7,0,5027,A
1-PB2,1432,5036,0,0,0,5036,A
1-PB2,1433,1,5030,1,2,5034,T
1-PB2,1434,5049,0,0,0,5049,A
1-PB2,1435,5034,0,3,0,5037,A
1-PB2,1436,0,8,5036,1,5045,G
1-PB2,1437,4989,0,13,0,5002,A
1-PB2,1438,1,4,5013,0,5018,G
1-PB2,1439,0,4728,0,0,4728,T
1-PB2,1440,11,1,0,4742,4754,C
1-PB2,1441,4770,0,2,0,4772,A
1-PB2,1442,2,0,4787,0,4789,G
1-PB2,1443,0,2,0,4799,4801,C
1-PB2,1444,4825,0,0,0,4825,A
1-PB2,1445,4832,0,0,0,4832,A
1-PB2,1446,4814,0,2,0,4816,A
1-PB2,1447,4804,0,1,0,4805,A
1-PB2,1448,0,4809,0,1,4810,T
1-PB2,1449,9,16,4800,0,4825,G
1-PB2,1450,1,8,4825,0,4834,G
1-PB2,1451,1,0,4855,0,4856,G
1-PB2,1452,0,4778,0,3,4781,T
1-PB2,1453,1,1,4816,0,4818,G
1-PB2,1454,0,4766,0,4,4770,T
1-PB2,1455,7,10,4782,1,4800,G
1-PB2,1456,0,6,4880,0,4886,G
1-PB2,1457,4881,0,4,0,4885,A
1-PB2,1458,0,4869,0,0,4869,T
1-PB2,1459,1,7,4918,0,4926,G
1-PB2,1460,4882,1,3,0,4886,A
1-PB2,1461,4924,0,4,0,4928,A
1-PB2,1462,0,4901,0,0,4901,T
1-PB2,1463,4834,0,3,0,4837,A
1-PB2,1464,3,0,0,5162,5165,C
1-PB2,1465,0,5060,0,5,5065,T
1-PB2,1466,13,1,0,5128,5142,C
1-PB2,1467,8,2,1,5146,5157,C
1-PB2,1468,5153,0,1,0,5154,A
1-PB2,1469,3,2,5354,0,5359,G
1-PB2,1470,1,5311,0,2,5314,T
1-PB2,1471,5355,1,1,0,5357,A
1-PB2,1472,0,4,0,5396,5400,C
1-PB2,1473,4927,2,3,0,4932,A
1-PB2,1474,1,5,4963,0,4969,G
1-PB2,1475,4840,0,3,0,4843,A
1-PB2,1476,1,4,4880,0,4885,G
1-PB2,1477,4745,0,4,0,4749,A
1-PB2,1478,1,14,4610,0,4625,G
1-PB2,1479,2,12,4613,1,4628,G
1-PB2,1480,0,4,4635,0,4639,G
1-PB2,1481,0,4518,0,2,4520,T
1-PB2,1482,1,11,4560,0,4572,G
1-PB2,1483,0,0,4586,0,4586,G
1-PB2,1484,0,4530,1,2,4533,T
1-PB2,1485,0,10,4677,0,4687,G
1-PB2,1486,1,2,4666,0,4669,G
1-PB2,1487,0,4590,0,0,4590,T
1-PB2,1488,0,4587,0,2,4589,T
1-PB2,1489,4526,0,2,1,4529,A
1-PB2,1490,3,0,4555,0,4558,G
1-PB2,1491,2,0,0,4542,4544,C
1-PB2,1492,4524,0,1,0,4525,A
1-PB2,1493,0,4522,0,1,4523,T
1-PB2,1494,0,4312,0,0,4312,T
1-PB2,1495,0,9,4300,0,4309,G
1-PB2,1496,4283,1,0,0,4284,A
1-PB2,1497,1,4277,1,1,4280,T
1-PB2,1498,15,0,1,4296,4312,C
1-PB2,1499,1,5,4281,0,4287,G
1-PB2,1500,1,1,4370,0,4372,G
1-PB2,1501,0,4351,0,1,4352,T
1-PB2,1502,0,4331,1,4,4336,T
1-PB2,1503,0,4353,0,1,4354,T
1-PB2,1504,0,4342,1,4,4347,T
1-PB2,1505,0,4347,0,0,4347,T
1-PB2,1506,2,9,4356,0,4367,G
1-PB2,1507,4337,2,5,0,4344,A
1-PB2,1508,0,9,4353,0,4362,G
1-PB2,1509,4222,0,1,0,4223,A
1-PB2,1510,2,1,4255,0,4258,G
1-PB2,1511,0,4238,0,4,4242,T
1-PB2,1512,0,4208,1,1,4210,T
1-PB2,1513,13,1,0,4232,4246,C
1-PB2,1514,1,14,4249,0,4264,G
1-PB2,1515,4249,0,15,0,4264,A
1-PB2,1516,0,11,4253,0,4264,G
1-PB2,1517,4243,0,4,1,4248,A
1-PB2,1518,0,0,0,4236,4236,C
1-PB2,1519,10,1,0,4204,4215,C
1-PB2,1520,4198,0,4,0,4202,A
1-PB2,1521,4260,1,1,2,4264,A
1-PB2,1522,0,5,0,4281,4286,C
1-PB2,1523,2,1,4306,0,4309,G
1-PB2,1524,0,4267,0,2,4269,T
1-PB2,1525,1,12,4262,0,4275,G
1-PB2,1526,2,5,4281,0,4288,G
1-PB2,1527,0,5,4304,0,4309,G
1-PB2,1528,4240,0,1,0,4241,A
1-PB2,1529,4254,0,0,0,4254,A
1-PB2,1530,0,4111,0,1,4112,T
1-PB2,1531,0,2,4284,0,4286,G
1-PB2,1532,0,4261,0,2,4263,T
1-PB2,1533,4271,2,0,0,4273,A
1-PB2,1534,0,4275,0,1,4276,T
1-PB2,1535,0,4235,1,0,4236,T
1-PB2,1536,4304,1,0,0,4305,A
1-PB2,1537,1,4260,0,0,4261,T
1-PB2,1538,0,4235,0,2,4237,T
1-PB2,1539,4226,0,1,0,4227,A
1-PB2,1540,0,3840,0,3,3843,T
1-PB2,1541,5,0,1,4000,4006,C
1-PB2,1542,0,3925,1,4,3930,T
1-PB2,1543,9,0,0,3973,3982,C
1-PB2,1544,3,1,0,3977,3981,C
1-PB2,1545,0,3908,0,2,3910,T
1-PB2,1546,0,5,3913,0,3918,G
1-PB2,1547,3892,0,2,0,3894,A
1-PB2,1548,0,2,3886,0,3888,G
1-PB2,1549,1,5,3872,0,3878,G
1-PB2,1550,3547,0,7,0,3554,A
1-PB2,1551,0,7,3591,0,3598,G
1-PB2,1552,0,1,3598,1,3600,G
1-PB2,1553,0,3467,0,2,3469,T
1-PB2,1554,13,0,0,3457,3470,C
1-PB2,1555,3452,0,3,0,3455,A
1-PB2,1556,2,2,3507,0,3511,G
1-PB2,1557,0,3507,0,2,3509,T
1-PB2,1558,0,6,3507,0,3513,G
1-PB2,1559,3493,0,4,0,3497,A
1-PB2,1560,3379,0,2,0,3381,A
1-PB2,1561,3406,0,4,1,3411,A
1-PB2,1562,2,0,0,3378,3380,C
1-PB2,1563,3354,1,2,0,3357,A
1-PB2,1564,1,1,0,3371,3373,C
1-PB2,1565,3268,0,2,0,3270,A
1-PB2,1566,3,3,3296,0,3302,G
1-PB2,1567,0,4,3261,0,3265,G
1-PB2,1568,0,8,3315,0,3323,G
1-PB2,1569,3301,0,0,0,3301,A
1-PB2,1570,3284,0,2,0,3286,A
1-PB2,1571,1,4,0,3310,3315,C
1-PB2,1572,0,3276,0,0,3276,T
1-PB2,1573,0,2,3279,0,3281,G
1-PB2,1574,3228,0,1,0,3229,A
1-PB2,1575,0,8,3248,0,3256,G
1-PB2,1576,3181,0,1,0,3182,A
1-PB2,1577,0,6,3066,0,3072,G
1-PB2,1578,3064,1,1,0,3066,A
1-PB2,1579,4,1,0,3057,3062,C
1-PB2,1580,0,2977,0,3,2980,T
1-PB2,1581,0,7,3024,0,3031,G
1-PB2,1582,3010,0,4,0,3014,A
1-PB2,1583,2,1,0,3055,3058,C
1-PB2,1584,3046,0,2,0,3048,A
1-PB2,1585,3032,0,0,0,3032,A
1-PB2,1586,0,3048,0,1,3049,T
1-PB2,1587,3040,0,0,0,3040,A
1-PB2,1588,3024,0,1,0,3025,A
1-PB2,1589,1,0,0,3066,3067,C
1-PB2,1590,0,2919,0,0,2919,T
1-PB2,1591,0,2887,0,0,2887,T
1-PB2,1592,2864,0,0,0,2864,A
1-PB2,1593,1,2864,0,1,2866,T
1-PB2,1594,0,2860,0,1,2861,T
1-PB2,1595,7,0,2,2832,2841,C
1-PB2,1596,2714,0,2,0,2716,A
1-PB2,1597,0,2707,0,1,2708,T
1-PB2,1598,3,0,0,2635,2638,C
1-PB2,1599,3,2,2636,0,2641,G
1-PB2,1600,0,2658,0,4,2662,T
1-PB2,1601,5,0,0,2628,2633,C
1-PB2,1602,1,1,2636,0,2638,G
1-PB2,1603,2631,0,3,0,2634,A
1-PB2,1604,0,2636,0,0,2636,T
1-PB2,1605,1,3,2632,0,2636,G
1-PB2,1606,2665,0,3,0,2668,A
1-PB2,1607,0,2668,0,0,2668,T
1-PB2,1608,1,1,2672,0,2674,G
1-PB2,1609,0,2573,0,2,2575,T
1-PB2,1610,0,6,2572,0,2578,G
1-PB2,1611,0,5,2565,0,2570,G
1-PB2,1612,0,5,2561,0,2566,G
1-PB2,1613,2499,0,4,0,2503,A
1-PB2,1614,0,2,2511,0,2513,G
1-PB2,1615,2386,0,0,0,2386,A
1-PB2,1616,1,2329,0,0,2330,T
1-PB2,1617,0,2309,0,0,2309,T
1-PB2,1618,2301,0,0,0,2301,A
1-PB2,1619,2289,0,1,0,2290,A
1-PB2,1620,0,2,0,2277,2279,C
1-PB2,1621,1,2,2189,0,2192,G
1-PB2,1622,1,1,2210,0,2212,G
1-PB2,1623,1,2091,0,0,2092,T
1-PB2,1624,3,0,0,2078,2081,C
1-PB2,1625,2,0,0,2073,2075,C
1-PB2,1626,1,2018,0,3,2022,T
1-PB2,1627,0,1,2033,0,2034,G
1-PB2,1628,2024,1,1,0,2026,A
1-PB2,1629,1,0,2037,0,2038,G
1-PB2,1630,0,2029,0,0,2029,T
1-PB2,1631,7,1,0,1957,1965,C
1-PB2,1632,0,3,1951,0,1954,G
1-PB2,1633,0,1,1993,0,1994,G
1-PB2,1634,0,1968,0,0,1968,T
1-PB2,1635,0,1976,0,1,1977,T
1-PB2,1636,0,1980,0,1,1981,T
1-PB2,1637,0,1974,0,0,1974,T
1-PB2,1638,0,4,2021,0,2025,G
1-PB2,1639,1,1,2049,0,2051,G
1-PB2,1640,0,2027,1,1,2029,T
1-PB2,1641,10,0,0,2042,2052,C
1-PB2,1642,2006,0,1,0,2007,A
1-PB2,1643,2088,0,0,0,2088,A
1-PB2,1644,0,2109,0,0,2109,T
1-PB2,1645,2101,0,0,0,2101,A
1-PB2,1646,0,1,1,2167,2169,C
1-PB2,1647,3,0,0,2098,2101,C
1-PB2,1648,0,2105,0,2,2107,T
1-PB2,1649,2136,0,0,0,2136,A
1-PB2,1650,0,2136,0,2,2138,T
1-PB2,1651,3,0,0,2136,2139,C
1-PB2,1652,2085,0,0,0,2085,A
1-PB2,1653,2087,0,1,0,2088,A
1-PB2,1654,0,2077,0,0,2077,T
1-PB2,1655,0,4,2005,0,2009,G
1-PB2,1656,2,2,2013,1,2018,G
1-PB2,1657,1988,1,0,0,1989,A
1-PB2,1658,0,1967,0,0,1967,T
1-PB2,1659,4,0,0,1970,1974,C
1-PB2,1660,1983,1,0,0,1984,A
1-PB2,1661,0,1985,0,1,1986,T
1-PB2,1662,3,1,0,1991,1995,C
1-PB2,1663,1998,0,0,0,1998,A
1-PB2,1664,1,2,2006,0,2009,G
1-PB2,1665,2008,0,0,0,2008,A
1-PB2,1666,2004,0,0,0,2004,A
1-PB2,1667,2018,0,0,0,2018,A
1-PB2,1668,0,2006,0,0,2006,T
1-PB2,1669,0,1997,0,1,1998,T
1-PB2,1670,4,10,1973,0,1987,G
1-PB2,1671,0,2,1981,0,1983,G
1-PB2,1672,2,3,1966,0,1971,G
1-PB2,1673,1972,0,2,0,1974,A
1-PB2,1674,1969,0,2,0,1971,A
1-PB2,1675,0,4,1955,0,1959,G
1-PB2,1676,0,1,0,1964,1965,C
1-PB2,1677,0,1965,0,1,1966,T
1-PB2,1678,0,0,1990,0,1990,G
1-PB2,1679,0,1984,0,0,1984,T
1-PB2,1680,5,0,0,1979,1984,C
1-PB2,1681,1998,0,0,0,1998,A
1-PB2,1682,2007,0,0,0,2007,A
1-PB2,1683,2004,0,0,0,2004,A
1-PB2,1684,2010,0,0,0,2010,A
1-PB2,1685,0,2013,0,0,2013,T
1-PB2,1686,0,2003,0,0,2003,T
1-PB2,1687,5,2,0,1992,1999,C
1-PB2,1688,1985,0,1,0,1986,A
1-PB2,1689,1981,1,0,0,1982,A
1-PB2,1690,0,1980,0,0,1980,T
1-PB2,1691,0,5,1985,0,1990,G
1-PB2,1692,0,1,2012,0,2013,G
1-PB2,1693,0,2055,0,0,2055,T
1-PB2,1694,2,0,0,2068,2070,C
1-PB2,1695,0,2070,0,0,2070,T
1-PB2,1696,4,1,0,2069,2074,C
1-PB2,1697,2080,1,1,0,2082,A
1-PB2,1698,0,0,2082,1,2083,G
1-PB2,1699,2078,0,1,0,2079,A
1-PB2,1700,2097,0,4,0,2101,A
1-PB2,1701,0,2075,0,0,2075,T
1-PB2,1702,3,0,0,2021,2024,C
1-PB2,1703,3,0,0,2019,2022,C
1-PB2,1704,0,2025,0,0,2025,T
1-PB2,1705,2,1,2020,0,2023,G
1-PB2,1706,0,0,0,2029,2029,C
1-PB2,1707,2032,0,0,0,2032,A
1-PB2,1708,2060,1,0,0,2061,A
1-PB2,1709,0,2029,0,2,2031,T
1-PB2,1710,0,3,2073,0,2076,G
1-PB2,1711,0,2079,0,2,2081,T
1-PB2,1712,0,2031,0,0,2031,T
1-PB2,1713,0,0,2051,0,2051,G
1-PB2,1714,0,2045,0,3,2048,T
1-PB2,1715,2049,0,0,0,2049,A
1-PB2,1716,1,1,1,2053,2056,C
1-PB2,1717,2012,0,0,0,2012,A
1-PB2,1718,2014,1,2,0,2017,A
1-PB2,1719,1,0,0,1997,1998,C
1-PB2,1720,1963,3,0,0,1966,A
1-PB2,1721,1967,0,2,0,1969,A
1-PB2,1722,1926,0,1,0,1927,A
1-PB2,1723,1931,1,1,0,1933,A
1-PB2,1724,2,1925,0,0,1927,T
1-PB2,1725,1,4,1920,0,1925,G
1-PB2,1726,0,5,1923,0,1928,G
1-PB2,1727,1921,0,1,0,1922,A
1-PB2,1728,1934,0,0,0,1934,A
1-PB2,1729,0,1925,0,1,1926,T
1-PB2,1730,0,1935,0,0,1935,T
1-PB2,1731,0,1931,0,0,1931,T
1-PB2,1732,0,8,1913,0,1921,G
1-PB2,1733,1936,0,1,0,1937,A
1-PB2,1734,1924,0,2,0,1926,A
1-PB2,1735,0,1,0,1922,1923,C
1-PB2,1736,6,1,0,1855,1862,C
1-PB2,1737,1883,0,2,1,1886,A
1-PB2,1738,0,1909,0,1,1910,T
1-PB2,1739,0,1910,0,1,1911,T
1-PB2,1740,0,1908,0,0,1908,T
1-PB2,1741,1,1,0,1904,1906,C
1-PB2,1742,1912,0,1,0,1913,A
1-PB2,1743,1911,0,0,0,1911,A
1-PB2,1744,0,1908,0,0,1908,T
1-PB2,1745,0,0,0,1931,1931,C
1-PB2,1746,0,1896,0,0,1896,T
1-PB2,1747,0,1911,0,0,1911,T
1-PB2,1748,0,1912,0,0,1912,T
1-PB2,1749,1913,0,0,0,1913,A
1-PB2,1750,0,1,1914,0,1915,G
1-PB2,1751,0,1903,0,2,1905,T
1-PB2,1752,6,1,0,1945,1952,C
1-PB2,1753,5,0,0,1946,1951,C
1-PB2,1754,3,0,0,1919,1922,C
1-PB2,1755,2,0,1,1917,1920,C
1-PB2,1756,1931,0,0,0,1931,A
1-PB2,1757,1936,0,1,0,1937,A
1-PB2,1758,0,0,1957,0,1957,G
1-PB2,1759,0,2,1947,0,1949,G
1-PB2,1760,0,1,0,1961,1962,C
1-PB2,1761,2,0,1,1932,1935,C
1-PB2,1762,1939,0,2,0,1941,A
1-PB2,1763,0,1953,0,0,1953,T
1-PB2,1764,0,1954,0,1,1955,T
1-PB2,1765,1968,0,0,0,1968,A
1-PB2,1766,0,1,1957,0,1958,G
1-PB2,1767,1925,1,1,0,1927,A
1-PB2,1768,1973,0,3,1,1977,A
1-PB2,1769,0,0,1999,0,1999,G
1-PB2,1770,0,0,0,1980,1980,C
1-PB2,1771,5,0,0,1989,1994,C
1-PB2,1772,1977,0,0,0,1977,A
1-PB2,1773,1989,1,4,1,1995,A
1-PB2,1774,0,2019,0,0,2019,T
1-PB2,1775,2026,0,1,0,2027,A
1-PB2,1776,1,0,1,2040,2042,C
1-PB2,1777,1887,0,1,0,1888,A
1-PB2,1778,0,0,1886,0,1886,G
1-PB2,1779,0,1822,0,1,1823,T
1-PB2,1780,1,12,1852,0,1865,G
1-PB2,1781,0,1,1857,1,1859,G
1-PB2,1782,0,0,1861,0,1861,G
1-PB2,1783,0,1828,0,2,1830,T
1-PB2,1784,0,1816,0,0,1816,T
1-PB2,1785,0,1830,0,1,1831,T
1-PB2,1786,1,0,1858,0,1859,G
1-PB2,1787,0,1844,0,1,1845,T
1-PB2,1788,4,0,1,1847,1852,C
1-PB2,1789,1842,0,0,1,1843,A
1-PB2,1790,0,0,1838,0,1838,G
1-PB2,1791,1833,0,0,0,1833,A
1-PB2,1792,1837,1,0,0,1838,A
1-PB2,1793,2,0,0,1826,1828,C
1-PB2,1794,0,1776,0,2,1778,T
1-PB2,1795,4,0,0,1830,1834,C
1-PB2,1796,0,1841,0,0,1841,T
1-PB2,1797,1851,0,1,0,1852,A
1-PB2,1798,0,1849,0,0,1849,T
1-PB2,1799,0,1835,0,0,1835,T
1-PB2,1800,2,1,0,1836,1839,C
1-PB2,1801,4,1,0,1840,1845,C
1-PB2,1802,1845,0,0,0,1845,A
1-PB2,1803,1847,0,1,0,1848,A
1-PB2,1804,0,0,0,1838,1838,C
1-PB2,1805,1839,0,1,0,1840,A
1-PB2,1806,1835,0,0,0,1835,A
1-PB2,1807,1840,0,2,0,1842,A
1-PB2,1808,0,1842,0,0,1842,T
1-PB2,1809,0,1,1849,0,1850,G
1-PB2,1810,1830,0,2,0,1832,A
1-PB2,1811,1,2,1850,0,1853,G
1-PB2,1812,1822,1,2,0,1825,A
1-PB2,1813,0,2,1835,0,1837,G
1-PB2,1814,1840,0,4,0,1844,A
1-PB2,1815,0,0,0,1845,1845,C
1-PB2,1816,1,1,1863,0,1865,G
1-PB2,1817,0,1875,1,1,1877,T
1-PB2,1818,1902,0,0,0,1902,A
1-PB2,1819,0,0,0,1914,1914,C
1-PB2,1820,0,1891,0,1,1892,T
1-PB2,1821,0,1900,0,1,1901,T
1-PB2,1822,0,4,1878,1,1883,G
1-PB2,1823,0,4,1888,0,1892,G
1-PB2,1824,0,7,1885,1,1893,G
1-PB2,1825,1864,0,0,0,1864,A
1-PB2,1826,1,1,0,1887,1889,C
1-PB2,1827,1902,0,1,0,1903,A
1-PB2,1828,0,1905,0,1,1906,T
1-PB2,1829,0,1901,0,0,1901,T
1-PB2,1830,0,1919,0,0,1919,T
1-PB2,1831,1,4,1913,0,1918,G
1-PB2,1832,1920,0,3,0,1923,A
1-PB2,1833,0,0,0,1924,1924,C
1-PB2,1834,1913,0,1,0,1914,A
1-PB2,1835,1,1,0,1915,1917,C
1-PB2,1836,4,0,0,1889,1893,C
1-PB2,1837,1902,0,4,0,1906,A
1-PB2,1838,2,0,0,1917,1919,C
1-PB2,1839,5,1,0,1915,1921,C
1-PB2,1840,8,1,0,1925,1934,C
1-PB2,1841,1934,0,0,0,1934,A
1-PB2,1842,2,3,1966,0,1971,G
1-PB2,1843,1977,0,1,0,1978,A
1-PB2,1844,0,2035,0,0,2035,T
1-PB2,1845,2026,0,0,0,2026,A
1-PB2,1846,2001,1,2,0,2004,A
1-PB2,1847,0,1996,0,0,1996,T
1-PB2,1848,1995,0,1,0,1996,A
1-PB2,1849,1988,0,0,0,1988,A
1-PB2,1850,1957,1,1,0,1959,A
1-PB2,1851,1,2,1963,0,1966,G
1-PB2,1852,0,0,0,1937,1937,C
1-PB2,1853,0,1882,0,1,1883,T
1-PB2,1854,0,1881,0,0,1881,T
1-PB2,1855,2,2,0,1883,1887,C
1-PB2,1856,0,1876,0,1,1877,T
1-PB2,1857,3,1,0,1899,1903,C
1-PB2,1858,5,1,0,1895,1901,C
1-PB2,1859,3,0,0,1911,1914,C
1-PB2,1860,0,1920,0,3,1923,T
1-PB2,1861,0,1915,0,0,1915,T
1-PB2,1862,0,1912,0,0,1912,T
1-PB2,1863,0,1916,0,0,1916,T
1-PB2,1864,0,0,1917,0,1917,G
1-PB2,1865,0,1,0,1916,1917,C
1-PB2,1866,1903,0,2,0,1905,A
1-PB2,1867,0,0,1900,0,1900,G
1-PB2,1868,0,2,0,1891,1893,C
1-PB2,1869,0,1882,0,2,1884,T
1-PB2,1870,0,0,1898,0,1898,G
1-PB2,1871,2,0,1,1894,1897,C
1-PB2,1872,0,1875,1,1,1877,T
1-PB2,1873,4,0,0,1912,1916,C
1-PB2,1874,3,1,0,1922,1926,C
1-PB2,1875,1933,0,1,0,1934,A
1-PB2,1876,0,0,0,1949,1949,C
1-PB2,1877,6,1,0,1951,1958,C
1-PB2,1878,1951,0,0,0,1951,A
1-PB2,1879,1957,0,0,0,1957,A
1-PB2,1880,1950,0,2,0,1952,A
1-PB2,1881,1,0,1953,0,1954,G
1-PB2,1882,2,0,0,1929,1931,C
1-PB2,1883,1922,0,0,0,1922,A
1-PB2,1884,1922,0,1,0,1923,A
1-PB2,1885,1926,0,1,0,1927,A
1-PB2,1886,1,0,1942,0,1943,G
1-PB2,1887,1,0,0,1935,1936,C
1-PB2,1888,1926,1,1,0,1928,A
1-PB2,1889,0,5,1939,0,1944,G
1-PB2,1890,1941,0,0,0,1941,A
1-PB2,1891,1964,0,0,0,1964,A
1-PB2,1892,0,1964,0,0,1964,T
1-PB2,1893,1,1,1962,0,1964,G
1-PB2,1894,1,0,0,1967,1968,C
1-PB2,1895,1935,0,1,0,1936,A
1-PB2,1896,1,0,1969,0,1970,G
1-PB2,1897,1,1956,0,0,1957,T
1-PB2,1898,0,2006,0,3,2009,T
1-PB2,1899,6,0,0,2023,2029,C
1-PB2,1900,0,2017,0,1,2018,T
1-PB2,1901,4,1,0,2044,2049,C
1-PB2,1902,0,2046,0,1,2047,T
1-PB2,1903,0,2041,0,0,2041,T
1-PB2,1904,3,0,0,2037,2040,C
1-PB2,1905,2028,0,0,0,2028,A
1-PB2,1906,0,0,0,2038,2038,C
1-PB2,1907,1,1952,0,0,1953,T
1-PB2,1908,0,7,1994,0,2001,G
1-PB2,1909,1975,0,0,0,1975,A
1-PB2,1910,2,0,0,2023,2025,C
1-PB2,1911,0,1998,0,1,1999,T
1-PB2,1912,0,0,2007,0,2007,G
1-PB2,1913,0,1986,0,1,1987,T
1-PB2,1914,0,2,2018,1,2021,G
1-PB2,1915,2013,0,4,0,2017,A
1-PB2,1916,2018,0,0,0,2018,A
1-PB2,1917,0,1977,0,1,1978,T
1-PB2,1918,0,1,1976,0,1977,G
1-PB2,1919,0,1908,0,0,1908,T
1-PB2,1920,0,2,1926,0,1928,G
1-PB2,1921,1898,0,4,0,1902,A
1-PB2,1922,0,10,1884,0,1894,G
1-PB2,1923,0,5,1888,0,1893,G
1-PB2,1924,1,6,1873,0,1880,G
1-PB2,1925,0,6,1964,0,1970,G
1-PB2,1926,1953,0,1,0,1954,A
1-PB2,1927,1,1934,0,0,1935,T
1-PB2,1928,0,0,1,1960,1961,C
1-PB2,1929,1952,0,1,0,1953,A
1-PB2,1930,1,10,1996,0,2007,G
1-PB2,1931,1,1,1994,0,1996,G
1-PB2,1932,0,0,2007,0,2007,G
1-PB2,1933,1997,0,1,0,1998,A
1-PB2,1934,0,1913,1,0,1914,T
1-PB2,1935,0,5,1914,0,1919,G
1-PB2,1936,1907,0,3,0,1910,A
1-PB2,1937,1,3,2029,0,2033,G
1-PB2,1938,2031,0,1,0,2032,A
1-PB2,1939,2004,0,0,0,2004,A
1-PB2,1940,0,2061,0,0,2061,T
1-PB2,1941,2055,0,0,0,2055,A
1-PB2,1942,0,0,0,2105,2105,C
1-PB2,1943,0,2086,0,1,2087,T
1-PB2,1944,0,2098,0,1,2099,T
1-PB2,1945,0,0,2109,0,2109,G
1-PB2,1946,1,2057,0,2,2060,T
1-PB2,1947,2060,0,0,0,2060,A
1-PB2,1948,2045,0,1,0,2046,A
1-PB2,1949,1,6,2008,0,2015,G
1-PB2,1950,0,8,2010,0,2018,G
1-PB2,1951,1,2,1995,0,1998,G
1-PB2,1952,0,0,1989,0,1989,G
1-PB2,1953,0,0,0,2013,2013,C
1-PB2,1954,2004,1,1,0,2006,A
1-PB2,1955,2043,0,0,0,2043,A
1-PB2,1956,0,2055,0,1,2056,T
1-PB2,1957,0,2045,0,1,2046,T
1-PB2,1958,2,0,0,2095,2097,C
1-PB2,1959,0,2065,0,3,2068,T
1-PB2,1960,2,2,0,2121,2125,C
1-PB2,1961,5,0,0,2125,2130,C
1-PB2,1962,0,2111,0,2,2113,T
1-PB2,1963,0,0,2179,0,2179,G
1-PB2,1964,3,2120,0,1,2124,T
1-PB2,1965,2149,0,0,1,2150,A
1-PB2,1966,0,2153,1,1,2155,T
1-PB2,1967,0,2133,0,0,2133,T
1-PB2,1968,1,0,0,2160,2161,C
1-PB2,1969,2136,0,0,1,2137,A
1-PB2,1970,2170,0,1,0,2171,A
1-PB2,1971,1,0,0,2180,2181,C
1-PB2,1972,0,2154,0,1,2155,T
1-PB2,1973,2167,0,1,0,2168,A
1-PB2,1974,0,0,0,2246,2246,C
1-PB2,1975,2258,0,0,0,2258,A
1-PB2,1976,2239,0,1,0,2240,A
1-PB2,1977,0,1,0,2244,2245,C
1-PB2,1978,2237,0,0,0,2237,A
1-PB2,1979,2209,0,0,0,2209,A
1-PB2,1980,1,7,2210,0,2218,G
1-PB2,1981,2210,0,5,0,2215,A
1-PB2,1982,1,0,0,2229,2230,C
1-PB2,1983,4,0,0,2198,2202,C
1-PB2,1984,2210,0,1,0,2211,A
1-PB2,1985,0,0,1,2309,2310,C
1-PB2,1986,0,2298,0,2,2300,T
1-PB2,1987,2300,0,0,0,2300,A
1-PB2,1988,2290,0,0,1,2291,A
1-PB2,1989,2286,0,1,0,2287,A
1-PB2,1990,2280,0,2,0,2282,A
1-PB2,1991,0,1,2301,0,2302,G
1-PB2,1992,2279,1,12,0,2292,A
1-PB2,1993,0,0,0,2312,2312,C
1-PB2,1994,0,2257,0,1,2258,T
1-PB2,1995,2268,0,0,0,2268,A
1-PB2,1996,2247,0,4,1,2252,A
1-PB2,1997,0,1,0,2268,2269,C
1-PB2,1998,2261,0,1,0,2262,A
1-PB2,1999,2255,0,0,0,2255,A
1-PB2,2000,0,2232,0,1,2233,T
1-PB2,2001,0,2224,0,1,2225,T
1-PB2,2002,4,0,0,2246,2250,C
1-PB2,2003,0,2226,0,0,2226,T
1-PB2,2004,3,0,0,2256,2259,C
1-PB2,2005,1,3,2253,0,2257,G
1-PB2,2006,0,4,2246,0,2250,G
1-PB2,2007,2248,0,2,0,2250,A
1-PB2,2008,2248,0,0,0,2248,A
1-PB2,2009,2256,0,0,0,2256,A
1-PB2,2010,2247,0,1,0,2248,A
1-PB2,2011,0,3,2252,0,2255,G
1-PB2,2012,2234,0,1,0,2235,A
1-PB2,2013,0,2247,0,0,2247,T
1-PB2,2014,0,0,2237,0,2237,G
1-PB2,2015,0,0,0,2222,2222,C
1-PB2,2016,3,1,0,2230,2234,C
1-PB2,2017,3,2,2232,0,2237,G
1-PB2,2018,0,1,2228,0,2229,G
1-PB2,2019,0,0,0,2233,2233,C
1-PB2,2020,2229,0,1,0,2230,A
1-PB2,2021,0,1,0,2281,2282,C
1-PB2,2022,0,2276,0,0,2276,T
1-PB2,2023,0,2273,0,2,2275,T
1-PB2,2024,1,2279,0,0,2280,T
1-PB2,2025,2279,0,0,0,2279,A
1-PB2,2026,2286,0,0,0,2286,A
1-PB2,2027,0,2286,0,2,2288,T
1-PB2,2028,1,2283,0,1,2285,T
1-PB2,2029,0,4,2286,0,2290,G
1-PB2,2030,2232,1,1,0,2234,A
1-PB2,2031,2233,1,3,1,2238,A
1-PB2,2032,1,9,2228,0,2238,G
1-PB2,2033,2233,0,0,0,2233,A
1-PB2,2034,0,3,0,2259,2262,C
1-PB2,2035,3,0,0,2242,2245,C
1-PB2,2036,5,1,0,2249,2255,C
1-PB2,2037,2264,0,0,0,2264,A
1-PB2,2038,1,1,2283,0,2285,G
1-PB2,2039,2285,0,0,0,2285,A
1-PB2,2040,1,2287,0,1,2289,T
1-PB2,2041,0,2,2288,0,2290,G
1-PB2,2042,2241,0,0,0,2241,A
1-PB2,2043,2241,0,0,0,2241,A
1-PB2,2044,2259,0,0,0,2259,A
1-PB2,2045,0,1,2239,0,2240,G
1-PB2,2046,0,0,0,2256,2256,C
1-PB2,2047,2214,0,0,0,2214,A
1-PB2,2048,0,0,0,2248,2248,C
1-PB2,2049,2249,0,0,1,2250,A
1-PB2,2050,0,2215,0,1,2216,T
1-PB2,2051,3,1,0,2259,2263,C
1-PB2,2052,4,2,0,2244,2250,C
1-PB2,2053,1,5,2262,0,2268,G
1-PB2,2054,1,0,2271,1,2273,G
1-PB2,2055,2241,2,0,0,2243,A
1-PB2,2056,1,0,2266,0,2267,G
1-PB2,2057,0,2204,0,2,2206,T
1-PB2,2058,0,4,2212,0,2216,G
1-PB2,2059,0,2,2213,0,2215,G
1-PB2,2060,2184,0,0,0,2184,A
1-PB2,2061,5,0,2199,0,2204,G
1-PB2,2062,1,2154,0,2,2157,T
1-PB2,2063,3,1,0,2145,2149,C
1-PB2,2064,4,2,0,2146,2152,C
1-PB2,2065,1,0,2153,0,2154,G
1-PB2,2066,0,0,0,2139,2139,C
1-PB2,2067,3,1,0,2143,2147,C
1-PB2,2068,1,0,2176,0,2177,G
1-PB2,2069,0,2152,0,3,2155,T
1-PB2,2070,3,0,0,2193,2196,C
1-PB2,2071,0,2181,1,1,2183,T
1-PB2,2072,0,2199,0,1,2200,T
1-PB2,2073,0,7,2193,0,2200,G
1-PB2,2074,2178,0,0,0,2178,A
1-PB2,2075,0,1,2198,0,2199,G
1-PB2,2076,2177,0,0,0,2177,A
1-PB2,2077,0,3,2120,0,2123,G
1-PB2,2078,0,2,2131,0,2133,G
1-PB2,2079,0,2,2117,0,2119,G
1-PB2,2080,0,2106,0,1,2107,T
1-PB2,2081,0,2107,0,1,2108,T
1-PB2,2082,0,2121,0,1,2122,T
1-PB2,2083,2,1,0,2123,2126,C
1-PB2,2084,0,2124,0,3,2127,T
1-PB2,2085,2,0,0,2172,2174,C
1-PB2,2086,2162,0,0,0,2162,A
1-PB2,2087,0,2141,0,2,2143,T
1-PB2,2088,4,1,0,2071,2076,C
1-PB2,2089,2104,0,0,0,2104,A
1-PB2,2090,0,2122,0,0,2122,T
1-PB2,2091,2132,0,1,0,2133,A
1-PB2,2092,0,2,2159,1,2162,G
1-PB2,2093,0,2,2165,0,2167,G
1-PB2,2094,0,2107,0,0,2107,T
1-PB2,2095,2113,0,0,0,2113,A
1-PB2,2096,2089,0,2,0,2091,A
1-PB2,2097,0,4,2094,0,2098,G
1-PB2,2098,0,1,2098,0,2099,G
1-PB2,2099,2076,0,0,0,2076,A
1-PB2,2100,2065,0,4,0,2069,A
1-PB2,2101,0,2,2061,0,2063,G
1-PB2,2102,2022,0,3,0,2025,A
1-PB2,2103,2,0,0,2027,2029,C
1-PB2,2104,2011,0,1,0,2012,A
1-PB2,2105,0,0,2026,0,2026,G
1-PB2,2106,2018,0,1,0,2019,A
1-PB2,2107,2006,0,1,0,2007,A
1-PB2,2108,0,1,2022,0,2023,G
1-PB2,2109,2011,0,3,0,2014,A
1-PB2,2110,0,1996,0,0,1996,T
1-PB2,2111,1993,0,1,0,1994,A
1-PB2,2112,0,1,0,1984,1985,C
1-PB2,2113,1,6,1975,0,1982,G
1-PB2,2114,0,5,2005,0,2010,G
1-PB2,2115,1986,0,0,0,1986,A
1-PB2,2116,0,1,0,1951,1952,C
1-PB2,2117,14,0,0,1954,1968,C
1-PB2,2118,1937,0,2,0,1939,A
1-PB2,2119,0,0,2012,0,2012,G
1-PB2,2120,0,0,0,2011,2011,C
1-PB2,2121,2017,0,0,0,2017,A
1-PB2,2122,0,2004,0,0,2004,T
1-PB2,2123,1,1943,0,0,1944,T
1-PB2,2124,1944,2,1,0,1947,A
1-PB2,2125,1939,0,1,0,1940,A
1-PB2,2126,1,1,1940,0,1942,G
1-PB2,2127,0,0,0,1928,1928,C
1-PB2,2128,1788,1,2,0,1791,A
1-PB2,2129,0,1822,0,0,1822,T
1-PB2,2130,1,1,0,1825,1827,C
1-PB2,2131,1842,0,0,0,1842,A
1-PB2,2132,1842,0,0,0,1842,A
1-PB2,2133,1,1835,0,0,1836,T
1-PB2,2134,1,7,1838,0,1846,G
1-PB2,2135,1832,0,0,0,1832,A
1-PB2,2136,1829,0,1,0,1830,A
1-PB2,2137,0,0,0,1840,1840,C
1-PB2,2138,0,1732,0,0,1732,T
1-PB2,2139,0,10,1787,0,1797,G
1-PB2,2140,1782,0,1,0,1783,A
1-PB2,2141,0,1,1776,0,1777,G
1-PB2,2142,1,1768,0,4,1773,T
1-PB2,2143,1756,0,0,0,1756,A
1-PB2,2144,1744,0,1,0,1745,A
1-PB2,2145,0,1,0,1758,1759,C
1-PB2,2146,1,2,0,1728,1731,C
1-PB2,2147,0,1710,0,2,1712,T
1-PB2,2148,1,1650,0,2,1653,T
1-PB2,2149,0,1,1652,0,1653,G
1-PB2,2150,0,0,0,1644,1644,C
1-PB2,2151,1648,0,2,0,1650,A
1-PB2,2152,1644,0,0,0,1644,A
1-PB2,2153,1605,0,0,0,1605,A
1-PB2,2154,1582,0,0,0,1582,A
1-PB2,2155,0,6,1577,0,1583,G
1-PB2,2156,0,2,1573,0,1575,G
1-PB2,2157,0,1,1573,0,1574,G
1-PB2,2158,0,0,1583,0,1583,G
1-PB2,2159,1590,0,0,0,1590,A
1-PB2,2160,1587,0,0,0,1587,A
1-PB2,2161,1591,0,1,0,1592,A
1-PB2,2162,1589,0,3,0,1592,A
1-PB2,2163,1,1,1591,1,1594,G
1-PB2,2164,0,0,1589,0,1589,G
1-PB2,2165,0,0,0,1581,1581,C
1-PB2,2166,0,1590,0,0,1590,T
1-PB2,2167,1591,0,0,0,1591,A
1-PB2,2168,1581,0,1,0,1582,A
1-PB2,2169,0,1582,1,0,1583,T
1-PB2,2170,1,0,1619,0,1620,G
1-PB2,2171,1,1559,0,1,1561,T
1-PB2,2172,0,1,1553,0,1554,G
1-PB2,2173,0,0,0,1546,1546,C
1-PB2,2174,0,1541,0,0,1541,T
1-PB2,2175,1562,0,0,0,1562,A
1-PB2,2176,1540,0,1,0,1541,A
1-PB2,2177,1,1527,0,1,1529,T
1-PB2,2178,1,0,0,1527,1528,C
1-PB2,2179,1,4,1466,1,1472,G
1-PB2,2180,0,2,1481,0,1483,G
1-PB2,2181,1,0,1479,0,1480,G
1-PB2,2182,0,0,0,1482,1482,C
1-PB2,2183,1480,0,0,0,1480,A
1-PB2,2184,1465,0,4,0,1469,A
1-PB2,2185,2,3,1471,0,1476,G
1-PB2,2186,0,1,1476,0,1477,G
1-PB2,2187,1461,0,1,0,1462,A
1-PB2,2188,0,2,1480,0,1482,G
1-PB2,2189,1436,1,0,0,1437,A
1-PB2,2190,0,0,0,1430,1430,C
1-PB2,2191,0,0,1451,0,1451,G
1-PB2,2192,0,1433,2,1,1436,T
1-PB2,2193,0,1,1431,0,1432,G
1-PB2,2194,0,0,1453,0,1453,G
1-PB2,2195,0,1406,1,0,1407,T
1-PB2,2196,0,0,1425,0,1425,G
1-PB2,2197,0,1374,1,0,1375,T
1-PB2,2198,0,1365,0,0,1365,T
1-PB2,2199,0,2,1367,0,1369,G
1-PB2,2200,0,0,1357,0,1357,G
1-PB2,2201,1,1349,1,2,1353,T
1-PB2,2202,1327,0,0,0,1327,A
1-PB2,2203,1284,0,0,0,1284,A
1-PB2,2204,0,1247,1,0,1248,T
1-PB2,2205,0,1,1241,0,1242,G
1-PB2,2206,1240,0,0,0,1240,A
1-PB2,2207,1218,0,0,0,1218,A
1-PB2,2208,1216,0,0,0,1216,A
1-PB2,2209,1,1,0,1209,1211,C
1-PB2,2210,0,2,1206,0,1208,G
1-PB2,2211,1206,0,0,0,1206,A
1-PB2,2212,1210,0,0,0,1210,A
1-PB2,2213,1207,0,1,0,1208,A
1-PB2,2214,1204,0,0,0,1204,A
1-PB2,2215,1,2,0,1207,1210,C
1-PB2,2216,1,2,1192,0,1195,G
1-PB2,2217,0,2,1183,0,1185,G
1-PB2,2218,0,2,1187,0,1189,G
1-PB2,2219,1181,0,0,0,1181,A
1-PB2,2220,0,0,0,1194,1194,C
1-PB2,2221,0,1164,0,2,1166,T
1-PB2,2222,4,0,0,1198,1202,C
1-PB2,2223,0,1207,0,0,1207,T
1-PB2,2224,1204,0,0,0,1204,A
1-PB2,2225,0,0,1205,0,1205,G
1-PB2,2226,1,0,0,1181,1182,C
1-PB2,2227,1186,0,0,0,1186,A
1-PB2,2228,0,1173,0,0,1173,T
1-PB2,2229,1115,0,0,0,1115,A
1-PB2,2230,0,0,0,1133,1133,C
1-PB2,2231,0,977,1,0,978,T
1-PB2,2232,0,984,0,0,984,T
1-PB2,2233,961,0,0,0,961,A
1-PB2,2234,1,0,0,958,959,C
1-PB2,2235,0,944,0,0,944,T
1-PB2,2236,0,3,942,0,945,G
1-PB2,2237,920,0,0,0,920,A
1-PB2,2238,2,0,0,917,919,C
1-PB2,2239,842,0,0,0,842,A
1-PB2,2240,0,0,847,0,847,G
1-PB2,2241,0,0,0,832,832,C
1-PB2,2242,1,0,0,837,838,C
1-PB2,2243,836,0,0,0,836,A
1-PB2,2244,0,0,834,0,834,G
1-PB2,2245,831,1,0,0,832,A
1-PB2,2246,0,0,0,829,829,C
1-PB2,2247,779,0,0,0,779,A
1-PB2,2248,0,0,771,0,771,G
1-PB2,2249,0,1,0,716,717,C
1-PB2,2250,0,3,713,0,716,G
1-PB2,2251,703,0,1,0,704,A
1-PB2,2252,0,0,0,708,708,C
1-PB2,2253,3,1,0,697,701,C
1-PB2,2254,709,0,0,0,709,A
1-PB2,2255,710,0,0,0,710,A
1-PB2,2256,711,0,0,0,711,A
1-PB2,2257,706,0,0,0,706,A
1-PB2,2258,0,2,705,0,707,G
1-PB2,2259,688,0,1,0,689,A
1-PB2,2260,688,0,0,0,688,A
1-PB2,2261,0,680,0,0,680,T
1-PB2,2262,0,677,0,0,677,T
1-PB2,2263,1,1,0,679,681,C
1-PB2,2264,1,0,666,0,667,G
1-PB2,2265,0,0,665,0,665,G
1-PB2,2266,660,0,0,0,660,A
1-PB2,2267,1,624,0,0,625,T
1-PB2,2268,0,0,623,0,623,G
1-PB2,2269,0,0,623,0,623,G
1-PB2,2270,0,0,0,602,602,C
1-PB2,2271,1,0,0,610,611,C
1-PB2,2272,615,0,0,0,615,A
1-PB2,2273,1,614,0,1,616,T
1-PB2,2274,1,0,0,613,614,C
1-PB2,2275,616,0,0,0,616,A
1-PB2,2276,617,0,1,0,618,A
1-PB2,2277,0,602,0,1,603,T
1-PB2,2278,0,545,0,0,545,T
1-PB2,2279,529,0,0,0,529,A
1-PB2,2280,522,0,0,0,522,A
2-PB1,1,122,0,0,0,122,A
2-PB1,2,0,124,0,0,124,T
2-PB1,3,0,0,123,0,123,G
2-PB1,4,0,0,137,0,137,G
2-PB1,5,159,0,1,0,160,A
2-PB1,6,0,182,0,0,182,T
2-PB1,7,0,0,185,0,185,G
2-PB1,8,0,186,0,0,186,T
2-PB1,9,0,1,0,201,202,C
2-PB1,10,202,0,0,0,202,A
2-PB1,11,213,0,0,0,213,A
2-PB1,12,0,213,0,0,213,T
2-PB1,13,0,0,0,218,218,C
2-PB1,14,0,0,0,233,233,C
2-PB1,15,0,3,229,0,232,G
2-PB1,16,263,0,0,0,263,A
2-PB1,17,0,0,0,271,271,C
2-PB1,18,0,268,0,0,268,T
2-PB1,19,0,0,0,311,311,C
2-PB1,20,0,310,0,0,310,T
2-PB1,21,320,0,0,0,320,A
2-PB1,22,0,0,0,320,320,C
2-PB1,23,0,322,0,0,322,T
2-PB1,24,0,0,355,0,355,G
2-PB1,25,0,354,0,0,354,T
2-PB1,26,0,354,0,0,354,T
2-PB1,27,1,0,0,354,355,C
2-PB1,28,0,0,0,355,355,C
2-PB1,29,0,405,0,0,405,T
2-PB1,30,411,0,0,0,411,A
2-PB1,31,409,0,0,0,409,A
2-PB1,32,407,0,0,0,407,A
2-PB1,33,0,2,406,0,408,G
2-PB1,34,0,0,413,0,413,G
2-PB1,35,0,402,0,0,402,T
2-PB1,36,0,407,0,0,407,T
2-PB1,37,0,0,0,412,412,C
2-PB1,38,0,0,0,412,412,C
2-PB1,39,415,0,0,0,415,A
2-PB1,40,1,0,416,0,417,G
2-PB1,41,0,0,0,420,420,C
2-PB1,42,0,0,423,0,423,G
2-PB1,43,0,0,0,422,422,C
2-PB1,44,425,0,0,0,425,A
2-PB1,45,425,0,0,0,425,A
2-PB1,46,428,0,0,0,428,A
2-PB1,47,427,0,0,0,427,A
2-PB1,48,0,429,0,0,429,T
2-PB1,49,0,0,458,0,458,G
2-PB1,50,0,0,0,460,460,C
2-PB1,51,0,0,0,463,463,C
2-PB1,52,459,0,0,0,459,A
2-PB1,53,0,463,0,1,464,T
2-PB1,54,503,0,0,0,503,A
2-PB1,55,505,0,0,0,505,A
2-PB1,56,0,1,518,0,519,G
2-PB1,57,0,0,0,520,520,C
2-PB1,58,523,0,0,0,523,A
2-PB1,59,1,0,1,537,539,C
2-PB1,60,539,0,1,0,540,A
2-PB1,61,565,0,0,0,565,A
2-PB1,62,0,0,0,566,566,C
2-PB1,63,565,0,0,0,565,A
2-PB1,64,0,568,0,0,568,T
2-PB1,65,0,569,0,0,569,T
2-PB1,66,0,0,0,681,681,C
2-PB1,67,0,0,0,685,685,C
2-PB1,68,2,0,0,688,690,C
2-PB1,69,0,687,0,0,687,T
2-PB1,70,0,693,0,0,693,T
2-PB1,71,749,0,0,0,749,A
2-PB1,72,0,749,0,0,749,T
2-PB1,73,760,0,0,0,760,A
2-PB1,74,0,0,1,763,764,C
2-PB1,75,1,740,0,0,741,T
2-PB1,76,0,0,748,0,748,G
2-PB1,77,0,1,747,0,748,G
2-PB1,78,748,0,1,0,749,A
2-PB1,79,0,2,752,0,754,G
2-PB1,80,747,0,0,0,747,A
2-PB1,81,0,750,0,0,750,T
2-PB1,82,1,0,0,817,818,C
2-PB1,83,2,1,0,819,822,C
2-PB1,84,0,821,0,1,822,T
2-PB1,85,2,0,0,867,869,C
2-PB1,86,2,0,0,874,876,C
2-PB1,87,878,0,0,0,878,A
2-PB1,88,0,880,0,0,880,T
2-PB1,89,878,0,0,0,878,A
2-PB1,90,0,0,0,883,883,C
2-PB1,91,868,0,0,0,868,A
2-PB1,92,0,0,908,0,908,G
2-PB1,93,0,0,0,915,915,C
2-PB1,94,1,0,0,921,922,C
2-PB1,95,916,0,0,0,916,A
2-PB1,96,1,916,0,1,918,T
2-PB1,97,0,5,911,0,916,G
2-PB1,98,0,7,954,0,961,G
2-PB1,99,966,0,1,0,967,A
2-PB1,100,973,0,2,0,975,A
2-PB1,101,0,0,0,978,978,C
2-PB1,102,963,0,1,0,964,A
2-PB1,103,0,0,982,0,982,G
2-PB1,104,0,1,998,0,999,G
2-PB1,105,996,0,0,0,996,A
2-PB1,106,1006,1,0,0,1007,A
2-PB1,107,1,0,0,1007,1008,C
2-PB1,108,1011,0,0,0,1011,A
2-PB1,109,0,1,1122,0,1123,G
2-PB1,110,0,1,1122,0,1123,G
2-PB1,111,0,1,1143,0,1144,G
2-PB1,112,0,1143,0,0,1143,T
2-PB1,113,1157,0,0,0,1157,A
2-PB1,114,0,0,0,1167,1167,C
2-PB1,115,1215,1,1,0,1217,A
2-PB1,116,0,0,0,1266,1266,C
2-PB1,117,2,0,0,1263,1265,C
2-PB1,118,1231,0,0,1,1232,A
2-PB1,119,0,1239,0,0,1239,T
2-PB1,120,0,3,1237,0,1240,G
2-PB1,121,1,5,1222,0,1228,G
2-PB1,122,1234,0,0,0,1234,A
2-PB1,123,0,0,0,1242,1242,C
2-PB1,124,1219,0,0,0,1219,A
2-PB1,125,0,1,0,1236,1237,C
2-PB1,126,1236,0,1,0,1237,A
2-PB1,127,0,0,1260,1,1261,G
2-PB1,128,0,1263,0,0,1263,T
2-PB1,129,4,0,0,1300,1304,C
2-PB1,130,1300,0,0,0,1300,A
2-PB1,131,1311,0,0,1,1312,A
2-PB1,132,0,0,0,1318,1318,C
2-PB1,133,1317,0,1,1,1319,A
2-PB1,134,0,1,1336,0,1337,G
2-PB1,135,1311,0,0,0,1311,A
2-PB1,136,1315,0,0,0,1315,A
2-PB1,137,0,0,0,1314,1314,C
2-PB1,138,1295,0,0,0,1295,A
2-PB1,139,0,0,0,1336,1336,C
2-PB1,140,1330,0,0,0,1330,A
2-PB1,141,2,0,0,1384,1386,C
2-PB1,142,0,0,0,1390,1390,C
2-PB1,143,1381,0,0,0,1381,A
2-PB1,144,1390,0,0,0,1390,A
2-PB1,145,0,1417,0,0,1417,T
2-PB1,146,1458,0,0,0,1458,A
2-PB1,147,1,1458,0,1,1460,T
2-PB1,148,0,1428,0,0,1428,T
2-PB1,149,3,0,0,1435,1438,C
2-PB1,150,1408,0,1,0,1409,A
2-PB1,151,0,2,1411,0,1413,G
2-PB1,152,1395,0,1,0,1396,A
2-PB1,153,0,3,1403,0,1406,G
2-PB1,154,1355,0,0,0,1355,A
2-PB1,155,3,4,1345,0,1352,G
2-PB1,156,0,4,1343,0,1347,G
2-PB1,157,0,5,1400,0,1405,G
2-PB1,158,0,0,1404,0,1404,G
2-PB1,159,0,2,1421,0,1423,G
2-PB1,160,1415,0,1,0,1416,A
2-PB1,161,1425,0,0,0,1425,A
2-PB1,162,1,0,1434,0,1435,G
2-PB1,163,0,1403,0,1,1404,T
2-PB1,164,0,2,1418,0,1420,G
2-PB1,165,0,0,1408,0,1408,G
2-PB1,166,1417,0,2,0,1419,A
2-PB1,167,1,0,0,1422,1423,C
2-PB1,168,0,4,1428,0,1432,G
2-PB1,169,1438,0,1,0,1439,A
2-PB1,170,0,0,0,1453,1453,C
2-PB1,171,1451,0,0,0,1451,A
2-PB1,172,1450,1,0,0,1451,A
2-PB1,173,1454,0,0,0,1454,A
2-PB1,174,0,1482,0,0,1482,T
2-PB1,175,1485,0,1,0,1486,A
2-PB1,176,0,0,0,1488,1488,C
2-PB1,177,1465,0,1,0,1466,A
2-PB1,178,0,2,1463,0,1465,G
2-PB1,179,1469,0,0,0,1469,A
2-PB1,180,1472,0,0,0,1472,A
2-PB1,181,1476,0,0,0,1476,A
2-PB1,182,1,0,0,1482,1483,C
2-PB1,183,0,1448,0,0,1448,T
2-PB1,184,0,6,1453,0,1459,G
2-PB1,185,0,0,1443,1,1444,G
2-PB1,186,1,4,1432,0,1437,G
2-PB1,187,1,0,1440,0,1441,G
2-PB1,188,0,1,0,1458,1459,C
2-PB1,189,1458,0,0,0,1458,A
2-PB1,190,1,0,0,1497,1498,C
2-PB1,191,5,0,0,1500,1505,C
2-PB1,192,6,1,1,1494,1502,C
2-PB1,193,1,0,0,1504,1505,C
2-PB1,194,1514,0,0,0,1514,A
2-PB1,195,1528,0,0,0,1528,A
2-PB1,196,0,0,0,1536,1536,C
2-PB1,197,1,1526,0,1,1528,T
2-PB1,198,2,0,0,1529,1531,C
2-PB1,199,1493,0,2,0,1495,A
2-PB1,200,1513,0,1,0,1514,A
2-PB1,201,0,1,0,1517,1518,C
2-PB1,202,0,0,0,1509,1509,C
2-PB1,203,8,0,0,1500,1508,C
2-PB1,204,1499,0,0,0,1499,A
2-PB1,205,1498,0,0,0,1498,A
2-PB1,206,0,1500,0,1,1501,T
2-PB1,207,0,1507,0,0,1507,T
2-PB1,208,0,1,1510,0,1511,G
2-PB1,209,1505,0,0,0,1505,A
2-PB1,210,0,1497,0,0,1497,T
2-PB1,211,0,3,1500,0,1503,G
2-PB1,212,0,7,1504,0,1511,G
2-PB1,213,1530,0,1,0,1531,A
2-PB1,214,1,0,0,1536,1537,C
2-PB1,215,6,0,0,1519,1525,C
2-PB1,216,1509,0,1,1,1511,A
2-PB1,217,1,2,0,1557,1560,C
2-PB1,218,0,1551,0,2,1553,T
2-PB1,219,1570,0,1,0,1571,A
2-PB1,220,1,0,0,1592,1593,C
2-PB1,221,4,0,0,1568,1572,C
2-PB1,222,1,1552,0,0,1553,T
2-PB1,223,0,2,1549,0,1551,G
2-PB1,224,1542,0,0,0,1542,A
2-PB1,225,1,3,1553,0,1557,G
2-PB1,226,0,1,1534,0,1535,G
2-PB1,227,1526,0,0,0,1526,A
2-PB1,228,0,1508,0,0,1508,T
2-PB1,229,1496,0,1,0,1497,A
2-PB1,230,1491,0,1,0,1492,A
2-PB1,231,0,1491,0,0,1491,T
2-PB1,232,0,3,1493,0,1496,G
2-PB1,233,1502,0,0,0,1502,A
2-PB1,234,1490,0,1,0,1491,A
2-PB1,235,0,0,0,1499,1499,C
2-PB1,236,3,0,0,1476,1479,C
2-PB1,237,1470,0,1,1,1472,A
2-PB1,238,1478,0,0,0,1478,A
2-PB1,239,0,1,1485,0,1486,G
2-PB1,240,0,1468,0,0,1468,T
2-PB1,241,0,3,1459,0,1462,G
2-PB1,242,0,1,1500,0,1501,G
2-PB1,243,1496,1,0,0,1497,A
2-PB1,244,0,1481,0,2,1483,T
2-PB1,245,1494,0,0,0,1494,A
2-PB1,246,0,1514,0,0,1514,T
2-PB1,247,2,0,1522,0,1524,G
2-PB1,248,1,0,0,1519,1520,C
2-PB1,249,1518,0,1,0,1519,A
2-PB1,250,1,2,0,1563,1566,C
2-PB1,251,1553,0,0,0,1553,A
2-PB1,252,1574,0,0,0,1574,A
2-PB1,253,1570,0,0,0,1570,A
2-PB1,254,0,0,0,1573,1573,C
2-PB1,255,1539,0,0,0,1539,A
2-PB1,256,0,3,1546,0,1549,G
2-PB1,257,1544,0,0,0,1544,A
2-PB1,258,0,0,0,1552,1552,C
2-PB1,259,0,1503,0,0,1503,T
2-PB1,260,0,0,1539,0,1539,G
2-PB1,261,0,1507,0,1,1508,T
2-PB1,262,0,0,1554,0,1554,G
2-PB1,263,0,1560,0,0,1560,T
2-PB1,264,4,0,0,1551,1555,C
2-PB1,265,2,1,0,1550,1553,C
2-PB1,266,0,1559,0,0,1559,T
2-PB1,267,0,5,1544,0,1549,G
2-PB1,268,0,1,1550,0,1551,G
2-PB1,269,1520,0,1,0,1521,A
2-PB1,270,0,0,1542,0,1542,G
2-PB1,271,0,0,1487,0,1487,G
2-PB1,272,0,0,0,1496,1496,C
2-PB1,273,0,1490,0,1,1491,T
2-PB1,274,1495,0,0,0,1495,A
2-PB1,275,0,1484,1,0,1485,T
2-PB1,276,1,2,1497,0,1500,G
2-PB1,277,2,2,1473,0,1477,G
2-PB1,278,0,0,0,1475,1475,C
2-PB1,279,3,1,0,1451,1455,C
2-PB1,280,0,1446,0,2,1448,T
2-PB1,281,0,1531,0,0,1531,T
2-PB1,282,2,0,0,1530,1532,C
2-PB1,283,3,0,0,1533,1536,C
2-PB1,284,1,1542,0,0,1543,T
2-PB1,285,0,1547,0,0,1547,T
2-PB1,286,0,0,1548,0,1548,G
2-PB1,287,1542,0,0,0,1542,A
2-PB1,288,1545,0,0,0,1545,A
2-PB1,289,0,2,1548,0,1550,G
2-PB1,290,1481,0,0,0,1481,A
2-PB1,291,1482,0,0,0,1482,A
2-PB1,292,0,1472,0,0,1472,T
2-PB1,293,1,0,0,1484,1485,C
2-PB1,294,2,0,0,1480,1482,C
2-PB1,295,5,0,0,1456,1461,C
2-PB1,296,1461,1,0,0,1462,A
2-PB1,297,0,0,0,1480,1480,C
2-PB1,298,1,0,0,1474,1475,C
2-PB1,299,5,0,0,1478,1483,C
2-PB1,300,1464,0,0,0,1464,A
2-PB1,301,0,1,1481,0,1482,G
2-PB1,302,0,1,1483,0,1484,G
2-PB1,303,0,1454,0,0,1454,T
2-PB1,304,1495,0,0,0,1495,A
2-PB1,305,0,1475,0,0,1475,T
2-PB1,306,4,0,0,1469,1473,C
2-PB1,307,0,1478,0,1,1479,T
2-PB1,308,0,1483,0,0,1483,T
2-PB1,309,0,1479,0,0,1479,T
2-PB1,310,0,1,1477,0,1478,G
2-PB1,311,1461,0,0,0,1461,A
2-PB1,312,1,3,1461,0,1465,G
2-PB1,313,1438,0,0,0,1438,A
2-PB1,314,1452,0,0,0,1452,A
2-PB1,315,0,0,0,1455,1455,C
2-PB1,316,0,1423,0,0,1423,T
2-PB1,317,2,1,0,1440,1443,C
2-PB1,318,1442,0,0,0,1442,A
2-PB1,319,0,1436,0,1,1437,T
2-PB1,320,1,0,1448,0,1449,G
2-PB1,321,0,1,0,1469,1470,C
2-PB1,322,1,0,0,1472,1473,C
2-PB1,323,0,1456,0,1,1457,T
2-PB1,324,0,1448,0,0,1448,T
2-PB1,325,0,6,1452,0,1458,G
2-PB1,326,1461,0,0,2,1463,A
2-PB1,327,1463,0,0,0,1463,A
2-PB1,328,1460,0,1,0,1461,A
2-PB1,329,0,0,0,1486,1486,C
2-PB1,330,1450,0,0,0,1450,A
2-PB1,331,1464,0,0,0,1464,A
2-PB1,332,0,1455,0,0,1455,T
2-PB1,333,1,1,1452,0,1454,G
2-PB1,334,0,0,1457,0,1457,G
2-PB1,335,1427,0,1,0,1428,A
2-PB1,336,1423,0,5,0,1428,A
2-PB1,337,0,1,1420,0,1421,G
2-PB1,338,0,0,0,1420,1420,C
2-PB1,339,5,2,0,1415,1422,C
2-PB1,340,1,0,1437,0,1438,G
2-PB1,341,0,1428,0,0,1428,T
2-PB1,342,0,1429,1,0,1430,T
2-PB1,343,4,0,0,1447,1451,C
2-PB1,344,1454,0,1,0,1455,A
2-PB1,345,1467,0,2,0,1469,A
2-PB1,346,0,0,0,1469,1469,C
2-PB1,347,1467,0,0,0,1467,A
2-PB1,348,0,1,1471,0,1472,G
2-PB1,349,1444,0,1,0,1445,A
2-PB1,350,1,0,0,1450,1451,C
2-PB1,351,1455,0,0,0,1455,A
2-PB1,352,1448,0,1,0,1449,A
2-PB1,353,1,5,1463,0,1469,G
2-PB1,354,1,4,1436,0,1441,G
2-PB1,355,1,2,1440,0,1443,G
2-PB1,356,0,1400,0,2,1402,T
2-PB1,357,0,1,1415,0,1416,G
2-PB1,358,1,1,1411,1,1414,G
2-PB1,359,1406,1,4,0,1411,A
2-PB1,360,0,2,0,1418,1420,C
2-PB1,361,1378,0,0,0,1378,A
2-PB1,362,1408,0,0,0,1408,A
2-PB1,363,1405,0,0,0,1405,A
2-PB1,364,0,1,0,1413,1414,C
2-PB1,365,0,1393,0,0,1393,T
2-PB1,366,1398,0,0,0,1398,A
2-PB1,367,1401,0,0,0,1401,A
2-PB1,368,0,1,0,1411,1412,C
2-PB1,369,2,0,0,1404,1406,C
2-PB1,370,6,0,0,1409,1415,C
2-PB1,371,1360,0,1,0,1361,A
2-PB1,372,1361,0,1,0,1362,A
2-PB1,373,0,2,1350,0,1352,G
2-PB1,374,0,1,1356,0,1357,G
2-PB1,375,0,1349,0,1,1350,T
2-PB1,376,4,0,0,1354,1358,C
2-PB1,377,2,0,1344,0,1346,G
2-PB1,378,2,1,0,1336,1339,C
2-PB1,379,1,2,0,1357,1360,C
2-PB1,380,1354,0,0,0,1354,A
2-PB1,381,0,4,1376,0,1380,G
2-PB1,382,1394,0,2,0,1396,A
2-PB1,383,0,0,0,1404,1404,C
2-PB1,384,0,1390,0,0,1390,T
2-PB1,385,0,1392,0,0,1392,T
2-PB1,386,1388,0,0,0,1388,A
2-PB1,387,1,1394,0,0,1395,T
2-PB1,388,1,3,1386,0,1390,G
2-PB1,389,1398,0,0,0,1398,A
2-PB1,390,0,1358,0,1,1359,T
2-PB1,391,0,1319,0,0,1319,T
2-PB1,392,0,1,1323,0,1324,G
2-PB1,393,0,1,1313,0,1314,G
2-PB1,394,1336,0,3,0,1339,A
2-PB1,395,0,1,0,1346,1347,C
2-PB1,396,1332,0,1,0,1333,A
2-PB1,397,0,1318,0,0,1318,T
2-PB1,398,0,1325,0,0,1325,T
2-PB1,399,1336,0,0,0,1336,A
2-PB1,400,1335,0,0,0,1335,A
2-PB1,401,1331,0,0,0,1331,A
2-PB1,402,1,0,0,1329,1330,C
2-PB1,403,1320,0,1,0,1321,A
2-PB1,404,0,0,1322,0,1322,G
2-PB1,405,1305,0,1,0,1306,A
2-PB1,406,1316,0,0,0,1316,A
2-PB1,407,1308,0,0,0,1308,A
2-PB1,408,0,1293,0,1,1294,T
2-PB1,409,2,1,0,1311,1314,C
2-PB1,410,1308,0,0,0,1308,A
2-PB1,411,1307,0,0,0,1307,A
2-PB1,412,0,0,0,1305,1305,C
2-PB1,413,4,0,0,1286,1290,C
2-PB1,414,0,1,1285,0,1286,G
2-PB1,415,0,0,1276,0,1276,G
2-PB1,416,0,0,0,1296,1296,C
2-PB1,417,1291,0,0,0,1291,A
2-PB1,418,0,0,1304,0,1304,G
2-PB1,419,0,0,0,1307,1307,C
2-PB1,420,1309,0,0,0,1309,A
2-PB1,421,1313,0,1,0,1314,A
2-PB1,422,2,1,0,1310,1313,C
2-PB1,423,0,1291,0,0,1291,T
2-PB1,424,0,1,1353,0,1354,G
2-PB1,425,1,0,0,1360,1361,C
2-PB1,426,1353,0,0,0,1353,A
2-PB1,427,0,1345,0,0,1345,T
2-PB1,428,0,1331,0,1,1332,T
2-PB1,429,1413,0,1,0,1414,A
2-PB1,430,0,0,1411,0,1411,G
2-PB1,431,0,0,0,1403,1403,C
2-PB1,432,3,0,0,1404,1407,C
2-PB1,433,1361,0,0,0,1361,A
2-PB1,434,1354,0,0,0,1354,A
2-PB1,435,0,0,0,1373,1373,C
2-PB1,436,1370,0,0,0,1370,A
2-PB1,437,0,0,0,1409,1409,C
2-PB1,438,3,0,0,1296,1299,C
2-PB1,439,1293,0,2,0,1295,A
2-PB1,440,0,1292,0,1,1293,T
2-PB1,441,1300,0,0,0,1300,A
2-PB1,442,0,4,1291,0,1295,G
2-PB1,443,1280,0,0,0,1280,A
2-PB1,444,1260,0,0,0,1260,A
2-PB1,445,0,0,1265,0,1265,G
2-PB1,446,0,1217,0,0,1217,T
2-PB1,447,0,1221,0,0,1221,T
2-PB1,448,0,1218,1,0,1219,T
2-PB1,449,0,1228,0,0,1228,T
2-PB1,450,0,1231,0,0,1231,T
2-PB1,451,1232,0,0,0,1232,A
2-PB1,452,0,0,1231,0,1231,G
2-PB1,453,1224,0,0,0,1224,A
2-PB1,454,0,1209,0,0,1209,T
2-PB1,455,0,0,0,1206,1206,C
2-PB1,456,0,3,1209,0,1212,G
2-PB1,457,1209,0,0,0,1209,A
2-PB1,458,1205,0,1,0,1206,A
2-PB1,459,0,0,0,1216,1216,C
2-PB1,460,0,4,1208,0,1212,G
2-PB1,461,0,0,1250,0,1250,G
2-PB1,462,1244,0,0,0,1244,A
2-PB1,463,0,1245,0,0,1245,T
2-PB1,464,0,1248,0,0,1248,T
2-PB1,465,1248,0,1,0,1249,A
2-PB1,466,1244,0,2,0,1246,A
2-PB1,467,1,0,0,1249,1250,C
2-PB1,468,1239,0,1,0,1240,A
2-PB1,469,0,0,1242,0,1242,G
2-PB1,470,1,0,0,1185,1186,C
2-PB1,471,0,1196,0,1,1197,T
2-PB1,472,1197,0,0,0,1197,A
2-PB1,473,1198,0,0,0,1198,A
2-PB1,474,0,1192,0,0,1192,T
2-PB1,475,0,4,1204,0,1208,G
2-PB1,476,1206,0,0,0,1206,A
2-PB1,477,1212,0,0,0,1212,A
2-PB1,478,0,1181,0,0,1181,T
2-PB1,479,3,0,0,1184,1187,C
2-PB1,480,1186,0,0,0,1186,A
2-PB1,481,1,2,1179,0,1182,G
2-PB1,482,0,1,1174,0,1175,G
2-PB1,483,1177,0,2,0,1179,A
2-PB1,484,1167,0,1,0,1168,A
2-PB1,485,0,3,1212,1,1216,G
2-PB1,486,0,0,1207,0,1207,G
2-PB1,487,1,0,0,1202,1203,C
2-PB1,488,0,1211,0,0,1211,T
2-PB1,489,1211,0,0,0,1211,A
2-PB1,490,1216,0,0,0,1216,A
2-PB1,491,0,1218,0,0,1218,T
2-PB1,492,1220,0,0,0,1220,A
2-PB1,493,1,3,1213,0,1217,G
2-PB1,494,1150,0,0,0,1150,A
2-PB1,495,0,1134,0,0,1134,T
2-PB1,496,0,1138,0,0,1138,T
2-PB1,497,0,1126,1,0,1127,T
2-PB1,498,2,0,0,1152,1154,C
2-PB1,499,6,0,0,1145,1151,C
2-PB1,500,0,1154,0,1,1155,T
2-PB1,501,1,0,0,1164,1165,C
2-PB1,502,1163,0,1,0,1164,A
2-PB1,503,1164,0,0,0,1164,A
2-PB1,504,0,0,1163,0,1163,G
2-PB1,505,0,2,1176,0,1178,G
2-PB1,506,1176,0,1,0,1177,A
2-PB1,507,0,1125,0,0,1125,T
2-PB1,508,1,0,1140,0,1141,G
2-PB1,509,0,1132,0,0,1132,T
2-PB1,510,6,0,1147,0,1153,G
2-PB1,511,1153,0,1,0,1154,A
2-PB1,512,0,1156,0,0,1156,T
2-PB1,513,0,0,1158,0,1158,G
2-PB1,514,0,3,1160,0,1163,G
2-PB1,515,1154,1,2,0,1157,A
2-PB1,516,1161,0,1,0,1162,A
2-PB1,517,0,1129,0,0,1129,T
2-PB1,518,1,0,0,1145,1146,C
2-PB1,519,1132,0,0,0,1132,A
2-PB1,520,1129,0,1,0,1130,A
2-PB1,521,1,1138,0,0,1139,T
2-PB1,522,0,1,1147,0,1148,G
2-PB1,523,0,3,1159,0,1162,G
2-PB1,524,1154,0,0,0,1154,A
2-PB1,525,0,1156,0,0,1156,T
2-PB1,526,1160,0,0,0,1160,A
2-PB1,527,1154,0,0,0,1154,A
2-PB1,528,1157,0,1,0,1158,A
2-PB1,529,0,2,1165,0,1167,G
2-PB1,530,1161,0,1,0,1162,A
2-PB1,531,1,1,1150,0,1152,G
2-PB1,532,0,0,1152,0,1152,G
2-PB1,533,1144,0,1,0,1145,A
2-PB1,534,1151,0,0,0,1151,A
2-PB1,535,1157,1,1,0,1159,A
2-PB1,536,0,1151,0,0,1151,T
2-PB1,537,0,2,1182,0,1184,G
2-PB1,538,0,1,1169,0,1170,G
2-PB1,539,1168,0,0,0,1168,A
2-PB1,540,0,0,1177,0,1177,G
2-PB1,541,1162,0,1,0,1163,A
2-PB1,542,0,1189,0,0,1189,T
2-PB1,543,1193,0,0,0,1193,A
2-PB1,544,1205,0,0,0,1205,A
2-PB1,545,0,0,0,1209,1209,C
2-PB1,546,1185,0,0,0,1185,A
2-PB1,547,1190,0,0,0,1190,A
2-PB1,548,0,1,0,1189,1190,C
2-PB1,549,1177,0,0,0,1177,A
2-PB1,550,0,0,0,1183,1183,C
2-PB1,551,1152,0,0,0,1152,A
2-PB1,552,0,0,0,1165,1165,C
2-PB1,553,0,1143,0,0,1143,T
2-PB1,554,0,1145,0,1,1146,T
2-PB1,555,0,1142,0,2,1144,T
2-PB1,556,1,0,0,1152,1153,C
2-PB1,557,1152,0,0,0,1152,A
2-PB1,558,1155,0,1,0,1156,A
2-PB1,559,1156,0,2,0,1158,A
2-PB1,560,0,0,1162,0,1162,G
2-PB1,561,1147,0,2,0,1149,A
2-PB1,562,1160,1,0,0,1161,A
2-PB1,563,1160,0,0,0,1160,A
2-PB1,564,1166,0,0,0,1166,A
2-PB1,565,1164,0,0,0,1164,A
2-PB1,566,0,2,1165,0,1167,G
2-PB1,567,0,5,1158,0,1163,G
2-PB1,568,1156,0,2,0,1158,A
2-PB1,569,0,5,1175,0,1180,G
2-PB1,570,1173,0,1,0,1174,A
2-PB1,571,0,0,1215,0,1215,G
2-PB1,572,0,1200,0,0,1200,T
2-PB1,573,1214,0,0,0,1214,A
2-PB1,574,1218,0,0,0,1218,A
2-PB1,575,0,2,1218,0,1220,G
2-PB1,576,0,1,1217,0,1218,G
2-PB1,577,1,4,1221,0,1226,G
2-PB1,578,1204,0,2,0,1206,A
2-PB1,579,1,1,0,1216,1218,C
2-PB1,580,1194,0,0,0,1194,A
2-PB1,581,1201,0,0,0,1201,A
2-PB1,582,1,0,0,1202,1203,C
2-PB1,583,1202,0,0,0,1202,A
2-PB1,584,0,1185,0,0,1185,T
2-PB1,585,0,6,1179,0,1185,G
2-PB1,586,1194,0,0,0,1194,A
2-PB1,587,0,0,0,1167,1167,C
2-PB1,588,0,0,0,1167,1167,C
2-PB1,589,1180,0,0,0,1180,A
2-PB1,590,1180,0,2,0,1182,A
2-PB1,591,0,0,1186,0,1186,G
2-PB1,592,1188,0,0,0,1188,A
2-PB1,593,1187,0,0,0,1187,A
2-PB1,594,1182,0,0,0,1182,A
2-PB1,595,1179,0,1,0,1180,A
2-PB1,596,0,1176,0,0,1176,T
2-PB1,597,0,4,1180,0,1184,G
2-PB1,598,0,0,1175,0,1175,G
2-PB1,599,0,1151,0,0,1151,T
2-PB1,600,5,0,0,1142,1147,C
2-PB1,601,1156,0,0,0,1156,A
2-PB1,602,0,1,0,1265,1266,C
2-PB1,603,1304,0,0,0,1304,A
2-PB1,604,0,0,0,1329,1329,C
2-PB1,605,1327,0,1,0,1328,A
2-PB1,606,1391,0,0,0,1391,A
2-PB1,607,1379,0,1,0,1380,A
2-PB1,608,0,6,1511,0,1517,G
2-PB1,609,1514,0,0,0,1514,A
2-PB1,610,1532,0,1,0,1533,A
2-PB1,611,0,0,0,1581,1581,C
2-PB1,612,1540,0,0,0,1540,A
2-PB1,613,1553,0,0,0,1553,A
2-PB1,614,1,1551,0,0,1552,T
2-PB1,615,1555,0,2,0,1557,A
2-PB1,616,1,8,1545,0,1554,G
2-PB1,617,0,4,1522,0,1526,G
2-PB1,618,0,1,1532,0,1533,G
2-PB1,619,1519,0,0,0,1519,A
2-PB1,620,1511,0,1,0,1512,A
2-PB1,621,0,3,1517,0,1520,G
2-PB1,622,1528,0,0,0,1528,A
2-PB1,623,1527,0,0,0,1527,A
2-PB1,624,1536,0,1,0,1537,A
2-PB1,625,1545,0,0,0,1545,A
2-PB1,626,1586,0,0,0,1586,A
2-PB1,627,1585,0,0,0,1585,A
2-PB1,628,1,0,0,1587,1588,C
2-PB1,629,1585,1,0,0,1586,A
2-PB1,630,1581,0,0,1,1582,A
2-PB1,631,1581,0,2,0,1583,A
2-PB1,632,0,4,1625,1,1630,G
2-PB1,633,1638,0,1,1,1640,A
2-PB1,634,0,1,1706,0,1707,G
2-PB1,635,0,1675,0,0,1675,T
2-PB1,636,1,10,1974,0,1985,G
2-PB1,637,1992,0,2,0,1994,A
2-PB1,638,1993,0,4,0,1997,A
2-PB1,639,1,2038,0,0,2039,T
2-PB1,640,2057,1,0,0,2058,A
2-PB1,641,2074,0,2,1,2077,A
2-PB1,642,0,4,2071,0,2075,G
2-PB1,643,2033,0,3,0,2036,A
2-PB1,644,2,3,2050,0,2055,G
2-PB1,645,1969,0,2,0,1971,A
2-PB1,646,0,3,1981,0,1984,G
2-PB1,647,1,0,1976,0,1977,G
2-PB1,648,1,0,0,2000,2001,C
2-PB1,649,0,1996,0,0,1996,T
2-PB1,650,2073,0,0,0,2073,A
2-PB1,651,1,1,0,2192,2194,C
2-PB1,652,4,0,0,2196,2200,C
2-PB1,653,0,2225,0,0,2225,T
2-PB1,654,2320,0,0,1,2321,A
2-PB1,655,2307,0,0,0,2307,A
2-PB1,656,0,2314,0,0,2314,T
2-PB1,657,2313,0,0,1,2314,A
2-PB1,658,2307,0,2,0,2309,A
2-PB1,659,0,8,2299,0,2307,G
2-PB1,660,2250,0,0,0,2250,A
2-PB1,661,1,2,2267,0,2270,G
2-PB1,662,1,0,0,2282,2283,C
2-PB1,663,0,2259,0,1,2260,T
2-PB1,664,0,2277,0,0,2277,T
2-PB1,665,1,2282,0,0,2283,T
2-PB1,666,0,11,2268,0,2279,G
2-PB1,667,2319,0,0,0,2319,A
2-PB1,668,0,0,0,2329,2329,C
2-PB1,669,2336,0,0,0,2336,A
2-PB1,670,0,2324,1,1,2326,T
2-PB1,671,0,2327,1,0,2328,T
2-PB1,672,0,7,2352,0,2359,G
2-PB1,673,2360,0,3,1,2364,A
2-PB1,674,2364,0,2,1,2367,A
2-PB1,675,1,0,0,2381,2382,C
2-PB1,676,2376,0,0,0,2376,A
2-PB1,677,0,1,0,2386,2387,C
2-PB1,678,0,6,2381,0,2387,G
2-PB1,679,2390,0,0,0,2390,A
2-PB1,680,0,2393,0,1,2394,T
2-PB1,681,0,10,2418,0,2428,G
2-PB1,682,2445,0,1,0,2446,A
2-PB1,683,1,2,0,2461,2464,C
2-PB1,684,9,1,0,2447,2457,C
2-PB1,685,2475,0,1,0,2476,A
2-PB1,686,2502,0,1,0,2503,A
2-PB1,687,2491,1,2,0,2494,A
2-PB1,688,0,3,2560,0,2563,G
2-PB1,689,2574,0,0,0,2574,A
2-PB1,690,0,2552,0,0,2552,T
2-PB1,691,0,0,2567,0,2567,G
2-PB1,692,1,0,0,2544,2545,C
2-PB1,693,2548,1,5,0,2554,A
2-PB1,694,0,4,2578,0,2582,G
2-PB1,695,2539,0,4,0,2543,A
2-PB1,696,2,5,2548,0,2555,G
2-PB1,697,2498,0,0,0,2498,A
2-PB1,698,0,2,2490,0,2492,G
2-PB1,699,2462,1,3,0,2466,A
2-PB1,700,0,2,2463,0,2465,G
2-PB1,701,1,1,2449,0,2451,G
2-PB1,702,1,0,0,2464,2465,C
2-PB1,703,2457,0,0,0,2457,A
2-PB1,704,2465,0,0,0,2465,A
2-PB1,705,2482,0,1,0,2483,A
2-PB1,706,0,2482,0,0,2482,T
2-PB1,707,0,2483,0,0,2483,T
2-PB1,708,2491,0,1,0,2492,A
2-PB1,709,2485,0,0,0,2485,A
2-PB1,710,2488,0,0,0,2488,A
2-PB1,711,2493,0,0,0,2493,A
2-PB1,712,2481,0,0,0,2481,A
2-PB1,713,0,2,2490,0,2492,G
2-PB1,714,2474,0,0,0,2474,A
2-PB1,715,2464,0,1,0,2465,A
2-PB1,716,1,8,2492,0,2501,G
2-PB1,717,1,3,2543,0,2547,G
2-PB1,718,0,1,2530,0,2531,G
2-PB1,719,0,0,0,2567,2567,C
2-PB1,720,0,2572,0,0,2572,T
2-PB1,721,2614,0,0,0,2614,A
2-PB1,722,0,2673,0,1,2674,T
2-PB1,723,0,2672,0,1,2673,T
2-PB1,724,0,1,2687,0,2688,G
2-PB1,725,1,1,0,2670,2672,C
2-PB1,726,2620,0,0,1,2621,A
2-PB1,727,2615,0,1,0,2616,A
2-PB1,728,0,0,0,2625,2625,C
2-PB1,729,2621,0,1,0,2622,A
2-PB1,730,0,0,0,2636,2636,C
2-PB1,731,3,0,0,2566,2569,C
2-PB1,732,3,1,1,2567,2572,C
2-PB1,733,2,8,2534,0,2544,G
2-PB1,734,0,2,2575,0,2577,G
2-PB1,735,0,3,2575,0,2578,G
2-PB1,736,2580,0,2,0,2582,A
2-PB1,737,0,2576,0,1,2577,T
2-PB1,738,0,0,2589,0,2589,G
2-PB1,739,0,1,1,2582,2584,C
2-PB1,740,2610,0,0,0,2610,A
2-PB1,741,2647,0,0,0,2647,A
2-PB1,742,2681,0,2,0,2683,A
2-PB1,743,0,2685,0,1,2686,T
2-PB1,744,1,2686,0,0,2687,T
2-PB1,745,2649,0,1,0,2650,A
2-PB1,746,0,4,2649,0,2653,G
2-PB1,747,2623,0,1,0,2624,A
2-PB1,748,0,14,2632,0,2646,G
2-PB1,749,0,7,2582,0,2589,G
2-PB1,750,3,1,2652,0,2656,G
2-PB1,751,0,2625,0,1,2626,T
2-PB1,752,0,2661,0,0,2661,T
2-PB1,753,6,6,0,2665,2677,C
2-PB1,754,0,0,2713,0,2713,G
2-PB1,755,0,2706,0,3,2709,T
2-PB1,756,1,2,2714,0,2717,G
2-PB1,757,0,2706,0,0,2706,T
2-PB1,758,2692,0,2,0,2694,A
2-PB1,759,1,0,0,2692,2693,C
2-PB1,760,0,2581,0,3,2584,T
2-PB1,761,1,2589,0,0,2590,T
2-PB1,762,2,1,0,2582,2585,C
2-PB1,763,1,0,2574,0,2575,G
2-PB1,764,0,2570,0,0,2570,T
2-PB1,765,0,2575,0,2,2577,T
2-PB1,766,1,5,2568,0,2574,G
2-PB1,767,2568,0,0,0,2568,A
2-PB1,768,2568,0,3,0,2571,A
2-PB1,769,2578,1,0,0,2579,A
2-PB1,770,0,0,0,2600,2600,C
2-PB1,771,0,2581,0,0,2581,T
2-PB1,772,0,2572,0,0,2572,T
2-PB1,773,0,2575,0,0,2575,T
2-PB1,774,2618,1,5,0,2624,A
2-PB1,775,0,0,2631,0,2631,G
2-PB1,776,0,0,0,2634,2634,C
2-PB1,777,0,2635,0,0,2635,T
2-PB1,778,2610,0,1,0,2611,A
2-PB1,779,1,6,2600,0,2607,G
2-PB1,780,2601,0,0,0,2601,A
2-PB1,781,2592,1,1,0,2594,A
2-PB1,782,0,0,2615,0,2615,G
2-PB1,783,1,1,0,2572,2574,C
2-PB1,784,2565,0,1,0,2566,A
2-PB1,785,0,2568,0,0,2568,T
2-PB1,786,0,2565,0,0,2565,T
2-PB1,787,0,2569,0,0,2569,T
2-PB1,788,0,0,2569,0,2569,G
2-PB1,789,0,0,1,2561,2562,C
2-PB1,790,0,4,2564,0,2568,G
2-PB1,791,2557,1,1,0,2559,A
2-PB1,792,2546,0,0,0,2546,A
2-PB1,793,2559,0,1,0,2560,A
2-PB1,794,2638,0,0,0,2638,A
2-PB1,795,0,0,2671,0,2671,G
2-PB1,796,0,0,0,2679,2679,C
2-PB1,797,0,2683,0,4,2687,T
2-PB1,798,1,2691,0,1,2693,T
2-PB1,799,0,7,2689,0,2696,G
2-PB1,800,2686,0,4,0,2690,A
2-PB1,801,2682,0,3,0,2685,A
2-PB1,802,0,1,1,2701,2703,C
2-PB1,803,2655,0,1,0,2656,A
2-PB1,804,0,0,2882,0,2882,G
2-PB1,805,0,2866,0,0,2866,T
2-PB1,806,10,2,0,2853,2865,C
2-PB1,807,0,2869,0,7,2876,T
2-PB1,808,1,3,2857,0,2861,G
2-PB1,809,0,7,2866,0,2873,G
2-PB1,810,2857,0,2,0,2859,A
2-PB1,811,0,0,0,2893,2893,C
2-PB1,812,0,2806,0,4,2810,T
2-PB1,813,0,2647,0,3,2650,T
2-PB1,814,3,1,0,2631,2635,C
2-PB1,815,5,0,0,2624,2629,C
2-PB1,816,2611,0,2,0,2613,A
2-PB1,817,1,0,2662,0,2663,G
2-PB1,818,0,2652,0,0,2652,T
2-PB1,819,0,2667,0,0,2667,T
2-PB1,820,0,9,2638,0,2647,G
2-PB1,821,0,11,2622,1,2634,G
2-PB1,822,1,6,2637,0,2644,G
2-PB1,823,3,7,2639,0,2649,G
2-PB1,824,0,2,2662,0,2664,G
2-PB1,825,0,2636,0,1,2637,T
2-PB1,826,2624,0,3,0,2627,A
2-PB1,827,2648,1,2,0,2651,A
2-PB1,828,0,2665,0,0,2665,T
2-PB1,829,1,7,2664,0,2672,G
2-PB1,830,2643,0,1,0,2644,A
2-PB1,831,2648,0,2,0,2650,A
2-PB1,832,2650,0,0,0,2650,A
2-PB1,833,2646,0,0,0,2646,A
2-PB1,834,0,0,2636,0,2636,G
2-PB1,835,2600,0,1,0,2601,A
2-PB1,836,2595,0,5,0,2600,A
2-PB1,837,0,6,2598,0,2604,G
2-PB1,838,1,1,2579,0,2581,G
2-PB1,839,1,1,0,2589,2591,C
2-PB1,840,3,0,0,2590,2593,C
2-PB1,841,2602,0,2,0,2604,A
2-PB1,842,2606,0,1,0,2607,A
2-PB1,843,2602,0,0,0,2602,A
2-PB1,844,2,0,0,2610,2612,C
2-PB1,845,0,2604,0,0,2604,T
2-PB1,846,2,4,2643,0,2649,G
2-PB1,847,0,2,2626,0,2628,G
2-PB1,848,2,0,0,2639,2641,C
2-PB1,849,2648,0,0,0,2648,A
2-PB1,850,2641,0,2,0,2643,A
2-PB1,851,2644,0,0,0,2644,A
2-PB1,852,0,2654,0,0,2654,T
2-PB1,853,0,0,2658,0,2658,G
2-PB1,854,0,2634,0,3,2637,T
2-PB1,855,0,2598,0,0,2598,T
2-PB1,856,0,1,2596,0,2597,G
2-PB1,857,0,2571,0,1,2572,T
2-PB1,858,1,10,2588,0,2599,G
2-PB1,859,2591,0,4,1,2596,A
2-PB1,860,0,3,2607,0,2610,G
2-PB1,861,2599,0,1,0,2600,A
2-PB1,862,2595,0,0,0,2595,A
2-PB1,863,2593,0,0,0,2593,A
2-PB1,864,2592,0,1,0,2593,A
2-PB1,865,2611,0,1,0,2612,A
2-PB1,866,0,2605,0,0,2605,T
2-PB1,867,1,3,2610,1,2615,G
2-PB1,868,2599,1,0,0,2600,A
2-PB1,869,0,2584,0,0,2584,T
2-PB1,870,1,6,2607,1,2615,G
2-PB1,871,2596,1,7,0,2604,A
2-PB1,872,1,1,0,2635,2637,C
2-PB1,873,0,2620,0,0,2620,T
2-PB1,874,2633,0,0,0,2633,A
2-PB1,875,2650,0,0,0,2650,A
2-PB1,876,0,2625,0,0,2625,T
2-PB1,877,0,2661,1,0,2662,T
2-PB1,878,8,0,0,2676,2684,C
2-PB1,879,2679,0,1,2,2682,A
2-PB1,880,0,0,0,2704,2704,C
2-PB1,881,2665,0,0,0,2665,A
2-PB1,882,2660,0,2,0,2662,A
2-PB1,883,0,5,2650,0,2655,G
2-PB1,884,2676,0,1,0,2677,A
2-PB1,885,0,1,0,2688,2689,C
2-PB1,886,2653,1,1,0,2655,A
2-PB1,887,3,4,0,2640,2647,C
2-PB1,888,2633,0,5,0,2638,A
2-PB1,889,3,6,2640,0,2649,G
2-PB1,890,2623,0,4,0,2627,A
2-PB1,891,0,1,2618,0,2619,G
2-PB1,892,2,1,0,2613,2616,C
2-PB1,893,2,2567,0,1,2570,T
2-PB1,894,0,2594,0,1,2595,T
2-PB1,895,0,2588,1,1,2590,T
2-PB1,896,2,0,0,2608,2610,C
2-PB1,897,0,2605,0,1,2606,T
2-PB1,898,0,2589,0,3,2592,T
2-PB1,899,0,2592,0,2,2594,T
2-PB1,900,6,0,0,2599,2605,C
2-PB1,901,2588,0,0,0,2588,A
2-PB1,902,0,0,0,2613,2613,C
2-PB1,903,2579,0,1,0,2580,A
2-PB1,904,2570,0,1,0,2571,A
2-PB1,905,0,2605,0,0,2605,T
2-PB1,906,5,0,0,2654,2659,C
2-PB1,907,2657,0,1,0,2658,A
2-PB1,908,2,0,0,2700,2702,C
2-PB1,909,0,2677,0,3,2680,T
2-PB1,910,0,5,2695,0,2700,G
2-PB1,911,0,6,2665,0,2671,G
2-PB1,912,0,7,2739,0,2746,G
2-PB1,913,0,3,2723,0,2726,G
2-PB1,914,2697,1,4,0,2702,A
2-PB1,915,2,1,1,2577,2581,C
2-PB1,916,2612,0,2,0,2614,A
2-PB1,917,2773,1,6,0,2780,A
2-PB1,918,0,0,0,2814,2814,C
2-PB1,919,2780,1,2,0,2783,A
2-PB1,920,1,0,0,2791,2792,C
2-PB1,921,0,2680,0,5,2685,T
2-PB1,922,2716,0,1,0,2717,A
2-PB1,923,2697,0,1,1,2699,A
2-PB1,924,0,0,2728,0,2728,G
2-PB1,925,0,2689,0,2,2691,T
2-PB1,926,2,8,2523,0,2533,G
2-PB1,927,1,2,2510,0,2513,G
2-PB1,928,2499,0,2,0,2501,A
2-PB1,929,2513,0,1,1,2515,A
2-PB1,930,0,2511,0,0,2511,T
2-PB1,931,0,3,2514,0,2517,G
2-PB1,932,2508,0,0,0,2508,A
2-PB1,933,2482,0,2,0,2484,A
2-PB1,934,2509,0,0,0,2509,A
2-PB1,935,2518,0,2,1,2521,A
2-PB1,936,0,2495,0,0,2495,T
2-PB1,937,6,1,0,2508,2515,C
2-PB1,938,2515,1,2,0,2518,A
2-PB1,939,2506,0,0,0,2506,A
2-PB1,940,2506,1,0,0,2507,A
2-PB1,941,2490,0,2,0,2492,A
2-PB1,942,1,1,0,2509,2511,C
2-PB1,943,2,1,0,2505,2508,C
2-PB1,944,8,0,0,2477,2485,C
2-PB1,945,0,2476,0,0,2476,T
2-PB1,946,1,0,0,2487,2488,C
2-PB1,947,1,3,2479,0,2483,G
2-PB1,948,2488,0,3,0,2491,A
2-PB1,949,2481,0,0,0,2481,A
2-PB1,950,0,2487,0,0,2487,T
2-PB1,951,0,0,2496,0,2496,G
2-PB1,952,0,2475,1,3,2479,T
2-PB1,953,0,2462,0,1,2463,T
2-PB1,954,0,2472,1,2,2475,T
2-PB1,955,1,2475,0,0,2476,T
2-PB1,956,0,2485,0,1,2486,T
2-PB1,957,1,2,2474,0,2477,G
2-PB1,958,1,1,2453,0,2455,G
2-PB1,959,3,1,0,2449,2453,C
2-PB1,960,1,2,2413,0,2416,G
2-PB1,961,2409,0,0,0,2409,A
2-PB1,962,0,2485,0,0,2485,T
2-PB1,963,0,2,2554,0,2556,G
2-PB1,964,2688,1,3,0,2692,A
2-PB1,965,0,2696,0,3,2699,T
2-PB1,966,1,2705,1,1,2708,T
2-PB1,967,2723,0,3,0,2726,A
2-PB1,968,0,0,0,2726,2726,C
2-PB1,969,2734,0,4,0,2738,A
2-PB1,970,0,2738,0,1,2739,T
2-PB1,971,2578,0,1,0,2579,A
2-PB1,972,1,0,0,2624,2625,C
2-PB1,973,2356,0,0,0,2356,A
2-PB1,974,0,2362,0,2,2364,T
2-PB1,975,6,0,0,2352,2358,C
2-PB1,976,2351,0,2,0,2353,A
2-PB1,977,0,0,0,2362,2362,C
2-PB1,978,2370,1,1,1,2373,A
2-PB1,979,2374,0,0,0,2374,A
2-PB1,980,2362,0,0,0,2362,A
2-PB1,981,1,5,2276,0,2282,G
2-PB1,982,2380,1,0,0,2381,A
2-PB1,983,2377,0,2,0,2379,A
2-PB1,984,1,2369,0,1,2371,T
2-PB1,985,5,0,0,2372,2377,C
2-PB1,986,2391,0,3,0,2394,A
2-PB1,987,2395,0,1,0,2396,A
2-PB1,988,1,1,0,2404,2406,C
2-PB1,989,3,0,0,2411,2414,C
2-PB1,990,0,2311,0,4,2315,T
2-PB1,991,1,3,2325,0,2329,G
2-PB1,992,2323,0,1,0,2324,A
2-PB1,993,0,0,2317,0,2317,G
2-PB1,994,0,2307,1,1,2309,T
2-PB1,995,0,6,2271,0,2277,G
2-PB1,996,0,0,2408,0,2408,G
2-PB1,997,0,2386,0,0,2386,T
2-PB1,998,2,2403,0,2,2407,T
2-PB1,999,5,1,0,2395,2401,C
2-PB1,1000,2380,0,4,0,2384,A
2-PB1,1001,0,3,2415,0,2418,G
2-PB1,1002,2407,0,4,0,2411,A
2-PB1,1003,2410,0,2,0,2412,A
2-PB1,1004,2378,0,0,0,2378,A
2-PB1,1005,0,2,0,2208,2210,C
2-PB1,1006,2230,0,0,0,2230,A
2-PB1,1007,0,2203,0,2,2205,T
2-PB1,1008,2,0,0,2268,2270,C
2-PB1,1009,4,0,0,2271,2275,C
2-PB1,1010,0,2222,0,0,2222,T
2-PB1,1011,0,5,2207,0,2212,G
2-PB1,1012,2203,0,2,0,2205,A
2-PB1,1013,2,2,2225,0,2229,G
2-PB1,1014,0,0,0,2206,2206,C
2-PB1,1015,2141,0,1,0,2142,A
2-PB1,1016,0,2149,0,0,2149,T
2-PB1,1017,1,2,0,2125,2128,C
2-PB1,1018,1,1,2123,0,2125,G
2-PB1,1019,1,1,1,2197,2200,C
2-PB1,1020,2204,0,0,0,2204,A
2-PB1,1021,1,0,0,2275,2276,C
2-PB1,1022,4,1,0,2285,2290,C
2-PB1,1023,2292,0,1,0,2293,A
2-PB1,1024,2308,0,1,0,2309,A
2-PB1,1025,0,2309,0,0,2309,T
2-PB1,1026,2320,0,0,0,2320,A
2-PB1,1027,2310,1,2,0,2313,A
2-PB1,1028,0,2232,0,1,2233,T
2-PB1,1029,1,0,2249,0,2250,G
2-PB1,1030,0,2201,0,0,2201,T
2-PB1,1031,0,2180,0,2,2182,T
2-PB1,1032,8,0,0,2180,2188,C
2-PB1,1033,0,2159,0,0,2159,T
2-PB1,1034,6,0,0,2169,2175,C
2-PB1,1035,2184,0,1,0,2185,A
2-PB1,1036,2182,0,0,0,2182,A
2-PB1,1037,2185,0,0,0,2185,A
2-PB1,1038,0,1,0,2197,2198,C
2-PB1,1039,2205,0,0,0,2205,A
2-PB1,1040,2200,0,0,0,2200,A
2-PB1,1041,2195,0,1,0,2196,A
2-PB1,1042,2199,0,2,0,2201,A
2-PB1,1043,0,2225,0,1,2226,T
2-PB1,1044,1,4,2231,0,2236,G
2-PB1,1045,0,1,2213,0,2214,G
2-PB1,1046,0,1,0,2226,2227,C
2-PB1,1047,2220,0,4,0,2224,A
2-PB1,1048,2227,0,1,1,2229,A
2-PB1,1049,0,3,2240,0,2243,G
2-PB1,1050,2242,0,4,0,2246,A
2-PB1,1051,0,1,0,2261,2262,C
2-PB1,1052,0,2244,0,0,2244,T
2-PB1,1053,2,4,2277,0,2283,G
2-PB1,1054,0,4,2266,0,2270,G
2-PB1,1055,1,1,2284,0,2286,G
2-PB1,1056,2294,0,1,0,2295,A
2-PB1,1057,2296,0,1,0,2297,A
2-PB1,1058,2278,0,3,1,2282,A
2-PB1,1059,2249,0,9,0,2258,A
2-PB1,1060,0,6,2319,0,2325,G
2-PB1,1061,0,2,2308,0,2310,G
2-PB1,1062,2296,0,4,0,2300,A
2-PB1,1063,0,2296,0,1,2297,T
2-PB1,1064,2281,1,4,0,2286,A
2-PB1,1065,0,0,0,2301,2301,C
2-PB1,1066,2327,1,0,0,2328,A
2-PB1,1067,0,2307,0,0,2307,T
2-PB1,1068,2,4,2329,0,2335,G
2-PB1,1069,1,2276,0,1,2278,T
2-PB1,1070,0,2290,0,1,2291,T
2-PB1,1071,7,1,0,2292,2300,C
2-PB1,1072,0,8,2286,0,2294,G
2-PB1,1073,2285,0,1,0,2286,A
2-PB1,1074,0,7,2351,0,2358,G
2-PB1,1075,2319,1,1,0,2321,A
2-PB1,1076,0,0,2353,0,2353,G
2-PB1,1077,0,2329,0,0,2329,T
2-PB1,1078,2329,0,2,0,2331,A
2-PB1,1079,2339,0,2,0,2341,A
2-PB1,1080,0,4,2340,0,2344,G
2-PB1,1081,2346,0,3,0,2349,A
2-PB1,1082,0,1,2373,0,2374,G
2-PB1,1083,2323,0,0,0,2323,A
2-PB1,1084,2343,1,0,0,2344,A
2-PB1,1085,0,2327,0,0,2327,T
2-PB1,1086,0,1,2317,0,2318,G
2-PB1,1087,2314,0,2,0,2316,A
2-PB1,1088,2297,1,1,0,2299,A
2-PB1,1089,0,1,2300,0,2301,G
2-PB1,1090,0,0,0,2294,2294,C
2-PB1,1091,0,2258,0,1,2259,T
2-PB1,1092,1,0,0,2286,2287,C
2-PB1,1093,7,0,0,2281,2288,C
2-PB1,1094,4,2,2299,0,2305,G
2-PB1,1095,2,7,2296,0,2305,G
2-PB1,1096,2314,0,2,0,2316,A
2-PB1,1097,1,0,0,2348,2349,C
2-PB1,1098,2349,0,2,0,2351,A
2-PB1,1099,1,0,0,2380,2381,C
2-PB1,1100,2376,0,0,0,2376,A
2-PB1,1101,2377,0,1,0,2378,A
2-PB1,1102,2377,0,0,0,2377,A
2-PB1,1103,0,2361,0,0,2361,T
2-PB1,1104,2354,0,1,0,2355,A
2-PB1,1105,1,0,0,2356,2357,C
2-PB1,1106,5,0,0,2348,2353,C
2-PB1,1107,0,2329,0,2,2331,T
2-PB1,1108,2,1,2335,0,2338,G
2-PB1,1109,0,0,0,2347,2347,C
2-PB1,1110,2353,0,0,0,2353,A
2-PB1,1111,0,1,2349,0,2350,G
2-PB1,1112,2340,0,0,0,2340,A
2-PB1,1113,2333,0,1,0,2334,A
2-PB1,1114,2335,0,0,0,2335,A
2-PB1,1115,0,2326,0,1,2327,T
2-PB1,1116,0,0,2340,1,2341,G
2-PB1,1117,0,0,0,2325,2325,C
2-PB1,1118,0,2340,0,0,2340,T
2-PB1,1119,2378,0,4,0,2382,A
2-PB1,1120,1,2,2376,0,2379,G
2-PB1,1121,1,0,0,2365,2366,C
2-PB1,1122,2390,0,0,0,2390,A
2-PB1,1123,2371,0,1,0,2372,A
2-PB1,1124,1,1,2356,0,2358,G
2-PB1,1125,0,0,0,2351,2351,C
2-PB1,1126,2317,2,0,0,2319,A
2-PB1,1127,0,2370,0,0,2370,T
2-PB1,1128,0,2378,0,0,2378,T
2-PB1,1129,0,12,2424,0,2436,G
2-PB1,1130,2462,1,0,0,2463,A
2-PB1,1131,1,1,1,2446,2449,C
2-PB1,1132,7,0,0,2450,2457,C
2-PB1,1133,1,2434,0,3,2438,T
2-PB1,1134,0,2,2483,1,2486,G
2-PB1,1135,2480,1,2,0,2483,A
2-PB1,1136,2490,0,1,0,2491,A
2-PB1,1137,2,1,2522,0,2525,G
2-PB1,1138,0,2455,0,0,2455,T
2-PB1,1139,2465,0,1,0,2466,A
2-PB1,1140,0,2461,0,0,2461,T
2-PB1,1141,0,2457,0,0,2457,T
2-PB1,1142,0,2452,0,0,2452,T
2-PB1,1143,0,1,0,2429,2430,C
2-PB1,1144,2424,0,2,0,2426,A
2-PB1,1145,2433,1,1,0,2435,A
2-PB1,1146,0,2398,0,2,2400,T
2-PB1,1147,0,6,2413,0,2419,G
2-PB1,1148,2408,0,0,0,2408,A
2-PB1,1149,2409,0,2,0,2411,A
2-PB1,1150,0,2402,0,3,2405,T
2-PB1,1151,4,1,0,2420,2425,C
2-PB1,1152,2431,1,0,0,2432,A
2-PB1,1153,2422,0,0,0,2422,A
2-PB1,1154,0,0,0,2422,2422,C
2-PB1,1155,2423,0,0,0,2423,A
2-PB1,1156,2408,0,0,0,2408,A
2-PB1,1157,0,2,2406,0,2408,G
2-PB1,1158,0,2,2407,0,2409,G
2-PB1,1159,2409,0,0,0,2409,A
2-PB1,1160,2401,0,5,0,2406,A
2-PB1,1161,0,4,2406,0,2410,G
2-PB1,1162,2389,0,1,0,2390,A
2-PB1,1163,2405,0,0,0,2405,A
2-PB1,1164,2407,0,2,1,2410,A
2-PB1,1165,2402,0,1,0,2403,A
2-PB1,1166,0,2390,0,0,2390,T
2-PB1,1167,0,2376,0,0,2376,T
2-PB1,1168,1,2,2384,0,2387,G
2-PB1,1169,2370,0,2,0,2372,A
2-PB1,1170,2,2,2383,0,2387,G
2-PB1,1171,2383,0,1,0,2384,A
2-PB1,1172,2396,0,1,0,2397,A
2-PB1,1173,2425,0,0,0,2425,A
2-PB1,1174,2434,0,0,1,2435,A
2-PB1,1175,0,2429,0,0,2429,T
2-PB1,1176,2430,1,0,0,2431,A
2-PB1,1177,2432,0,5,0,2437,A
2-PB1,1178,6,3,2424,0,2433,G
2-PB1,1179,0,1,2424,0,2425,G
2-PB1,1180,1,0,2,2409,2412,C
2-PB1,1181,0,0,0,2413,2413,C
2-PB1,1182,0,2382,0,3,2385,T
2-PB1,1183,11,1,0,2642,2654,C
2-PB1,1184,0,2695,0,3,2698,T
2-PB1,1185,0,2714,0,1,2715,T
2-PB1,1186,0,1,0,2776,2777,C
2-PB1,1187,0,2762,0,1,2763,T
2-PB1,1188,2778,0,0,0,2778,A
2-PB1,1189,2776,0,0,0,2776,A
2-PB1,1190,0,2773,0,4,2777,T
2-PB1,1191,2810,0,2,0,2812,A
2-PB1,1192,0,5,2726,0,2731,G
2-PB1,1193,2507,0,2,0,2509,A
2-PB1,1194,1,2495,0,2,2498,T
2-PB1,1195,0,8,2449,0,2457,G
2-PB1,1196,1,1,2484,0,2486,G
2-PB1,1197,2,0,0,2491,2493,C
2-PB1,1198,2488,0,2,0,2490,A
2-PB1,1199,0,0,0,2506,2506,C
2-PB1,1200,2459,0,2,0,2461,A
2-PB1,1201,0,1,2550,0,2551,G
2-PB1,1202,1,1,0,2533,2535,C
2-PB1,1203,2546,0,0,0,2546,A
2-PB1,1204,0,2582,0,2,2584,T
2-PB1,1205,0,0,0,2579,2579,C
2-PB1,1206,2599,0,1,0,2600,A
2-PB1,1207,0,2593,0,1,2594,T
2-PB1,1208,0,2587,0,0,2587,T
2-PB1,1209,0,3,2575,0,2578,G
2-PB1,1210,2484,0,2,1,2487,A
2-PB1,1211,0,2,2562,0,2564,G
2-PB1,1212,1,0,0,2545,2546,C
2-PB1,1213,8,0,0,2513,2521,C
2-PB1,1214,7,0,0,2598,2605,C
2-PB1,1215,0,2592,0,2,2594,T
2-PB1,1216,0,1,3094,0,3095,G
2-PB1,1217,0,1,3192,0,3193,G
2-PB1,1218,3173,0,7,0,3180,A
2-PB1,1219,3448,0,0,0,3448,A
2-PB1,1220,0,3374,0,0,3374,T
2-PB1,1221,0,8,3554,0,3562,G
2-PB1,1222,3687,1,1,0,3689,A
2-PB1,1223,0,3768,0,3,3771,T
2-PB1,1224,1,7,3786,0,3794,G
2-PB1,1225,3756,1,2,0,3759,A
2-PB1,1226,0,3734,0,0,3734,T
2-PB1,1227,1,13,3731,3,3748,G
2-PB1,1228,0,5,3830,0,3835,G
2-PB1,1229,2,0,3830,4,3836,G
2-PB1,1230,3,0,0,3851,3854,C
2-PB1,1231,3882,0,1,0,3883,A
2-PB1,1232,1,3935,0,1,3937,T
2-PB1,1233,0,1,4137,0,4138,G
2-PB1,1234,0,4124,0,3,4127,T
2-PB1,1235,0,4157,0,1,4158,T
2-PB1,1236,7,2,0,4178,4187,C
2-PB1,1237,4186,0,0,1,4187,A
2-PB1,1238,4190,2,4,0,4196,A
2-PB1,1239,2,3,0,4201,4206,C
2-PB1,1240,4243,5,1,0,4249,A
2-PB1,1241,0,4263,0,2,4265,T
2-PB1,1242,1,1,4356,0,4358,G
2-PB1,1243,0,0,0,4358,4358,C
2-PB1,1244,0,4368,0,0,4368,T
2-PB1,1245,4420,0,4,0,4424,A
2-PB1,1246,4412,0,1,0,4413,A
2-PB1,1247,1,2,4530,0,4533,G
2-PB1,1248,1,4509,0,0,4510,T
2-PB1,1249,4511,0,1,0,4512,A
2-PB1,1250,1,5,0,4549,4555,C
2-PB1,1251,2,18,4563,1,4584,G
2-PB1,1252,2,1,4943,0,4946,G
2-PB1,1253,0,4896,0,1,4897,T
2-PB1,1254,0,4933,0,0,4933,T
2-PB1,1255,0,4940,0,1,4941,T
2-PB1,1256,0,4931,0,0,4931,T
2-PB1,1257,4942,0,2,0,4944,A
2-PB1,1258,4,9,4910,0,4923,G
2-PB1,1259,0,8,4884,0,4892,G
2-PB1,1260,4838,0,4,0,4842,A
2-PB1,1261,0,1,4841,0,4842,G
2-PB1,1262,0,4949,0,1,4950,T
2-PB1,1263,10,1,0,4972,4983,C
2-PB1,1264,0,4996,0,1,4997,T
2-PB1,1265,14,0,0,5010,5024,C
2-PB1,1266,0,6,5027,0,5033,G
2-PB1,1267,5209,0,1,0,5210,A
2-PB1,1268,0,5245,1,0,5246,T
2-PB1,1269,5276,0,3,1,5280,A
2-PB1,1270,3,0,0,5286,5289,C
2-PB1,1271,0,5229,0,7,5236,T
2-PB1,1272,4,12,5241,0,5257,G
2-PB1,1273,5246,0,0,1,5247,A
2-PB1,1274,5323,0,0,0,5323,A
2-PB1,1275,0,5329,1,1,5331,T
2-PB1,1276,6,0,0,5236,5242,C
2-PB1,1277,0,5243,0,1,5244,T
2-PB1,1278,0,5217,0,2,5219,T
2-PB1,1279,2,12,5240,0,5254,G
2-PB1,1280,2,5,5221,1,5229,G
2-PB1,1281,5211,0,6,0,5217,A
2-PB1,1282,2,1,0,5257,5260,C
2-PB1,1283,5208,0,1,0,5209,A
2-PB1,1284,5251,0,0,0,5251,A
2-PB1,1285,5257,0,2,0,5259,A
2-PB1,1286,5269,1,10,0,5280,A
2-PB1,1287,1,10,5398,0,5409,G
2-PB1,1288,5423,1,2,0,5426,A
2-PB1,1289,5433,1,0,0,5434,A
2-PB1,1290,5439,1,5,0,5445,A
2-PB1,1291,0,5435,0,0,5435,T
2-PB1,1292,5448,0,0,0,5448,A
2-PB1,1293,0,0,0,5652,5652,C
2-PB1,1294,5595,0,3,1,5599,A
2-PB1,1295,2,2,0,5645,5649,C
2-PB1,1296,10,1,0,5601,5612,C
2-PB1,1297,5595,0,2,0,5597,A
2-PB1,1298,5676,2,4,0,5682,A
2-PB1,1299,1,10,5849,0,5860,G
2-PB1,1300,5906,1,3,0,5910,A
2-PB1,1301,4,2,0,5995,6001,C
2-PB1,1302,5903,0,5,0,5908,A
2-PB1,1303,6098,0,4,0,6102,A
2-PB1,1304,5,2,0,6140,6147,C
2-PB1,1305,6276,0,0,0,6276,A
2-PB1,1306,0,6297,0,0,6297,T
2-PB1,1307,6254,0,5,0,6259,A
2-PB1,1308,2,1,0,6399,6402,C
2-PB1,1309,0,6272,0,3,6275,T
2-PB1,1310,1,13,6407,0,6421,G
2-PB1,1311,0,1,6391,0,6392,G
2-PB1,1312,0,6253,0,4,6257,T
2-PB1,1313,0,27,6269,0,6296,G
2-PB1,1314,0,13,6201,0,6214,G
2-PB1,1315,0,7,6245,1,6253,G
2-PB1,1316,6234,0,5,0,6239,A
2-PB1,1317,0,6122,0,2,6124,T
2-PB1,1318,2,17,6117,0,6136,G
2-PB1,1319,1,6,6111,0,6118,G
2-PB1,1320,4,1,6137,0,6142,G
2-PB1,1321,1,3,0,6262,6266,C
2-PB1,1322,0,6257,0,6,6263,T
2-PB1,1323,7,2,0,6310,6319,C
2-PB1,1324,16,1,0,6302,6319,C
2-PB1,1325,6331,0,5,0,6336,A
2-PB1,1326,6307,2,0,0,6309,A
2-PB1,1327,2,6291,0,2,6295,T
2-PB1,1328,8,1,2,6255,6266,C
2-PB1,1329,14,1,1,6219,6235,C
2-PB1,1330,0,6190,0,8,6198,T
2-PB1,1331,4,1,0,6190,6195,C
2-PB1,1332,7,3,1,6153,6164,C
2-PB1,1333,2,6,6176,0,6184,G
2-PB1,1334,6166,0,0,0,6166,A
2-PB1,1335,2,1,0,6179,6182,C
2-PB1,1336,3,13,6193,0,6209,G
2-PB1,1337,6202,1,2,0,6205,A
2-PB1,1338,1,6226,0,1,6228,T
2-PB1,1339,0,6233,0,0,6233,T
2-PB1,1340,1,6238,0,2,6241,T
2-PB1,1341,0,6246,0,4,6250,T
2-PB1,1342,2,0,6243,0,6245,G
2-PB1,1343,2,9,0,6270,6281,C
2-PB1,1344,12,0,0,6264,6276,C
2-PB1,1345,29,3,0,6513,6545,C
2-PB1,1346,0,6483,0,5,6488,T
2-PB1,1347,12,2,0,6784,6798,C
2-PB1,1348,6850,0,1,0,6851,A
2-PB1,1349,0,6884,0,1,6885,T
2-PB1,1350,6887,1,3,1,6892,A
2-PB1,1351,0,5,6959,0,6964,G
2-PB1,1352,2,6846,0,2,6850,T
2-PB1,1353,2,9,6906,0,6917,G
2-PB1,1354,6737,0,1,1,6739,A
2-PB1,1355,6731,0,2,0,6733,A
2-PB1,1356,0,6450,0,1,6451,T
2-PB1,1357,1,4,6420,1,6426,G
2-PB1,1358,1,3,0,6485,6489,C
2-PB1,1359,6472,0,2,0,6474,A
2-PB1,1360,0,1,0,6510,6511,C
2-PB1,1361,22,0,0,6454,6476,C
2-PB1,1362,6451,0,0,1,6452,A
2-PB1,1363,6446,0,0,0,6446,A
2-PB1,1364,6413,0,1,0,6414,A
2-PB1,1365,0,6296,0,1,6297,T
2-PB1,1366,18,4,1,6509,6532,C
2-PB1,1367,6512,0,2,0,6514,A
2-PB1,1368,0,6539,0,0,6539,T
2-PB1,1369,0,9,6536,0,6545,G
2-PB1,1370,6527,0,15,0,6542,A
2-PB1,1371,2,16,6578,0,6596,G
2-PB1,1372,1,18,6572,0,6591,G
2-PB1,1373,1,10,6620,0,6631,G
2-PB1,1374,6586,0,4,0,6590,A
2-PB1,1375,6740,0,3,0,6743,A
2-PB1,1376,1,6763,1,4,6769,T
2-PB1,1377,6782,0,6,0,6788,A
2-PB1,1378,1,0,0,6812,6813,C
2-PB1,1379,6845,0,3,0,6848,A
2-PB1,1380,6803,1,20,2,6826,A
2-PB1,1381,3,0,6783,1,6787,G
2-PB1,1382,1,2,0,6743,6746,C
2-PB1,1383,6712,1,5,0,6718,A
2-PB1,1384,0,8,6788,0,6796,G
2-PB1,1385,1,7,6761,0,6769,G
2-PB1,1386,6702,0,3,0,6705,A
2-PB1,1387,0,4,6781,0,6785,G
2-PB1,1388,0,6646,0,1,6647,T
2-PB1,1389,4,12,6792,0,6808,G
2-PB1,1390,2,8,6837,0,6847,G
2-PB1,1391,6822,0,8,0,6830,A
2-PB1,1392,1,6817,0,0,6818,T
2-PB1,1393,6784,0,1,0,6785,A
2-PB1,1394,1,8,6855,0,6864,G
2-PB1,1395,6922,0,1,0,6923,A
2-PB1,1396,1,6946,0,0,6947,T
2-PB1,1397,2,6917,1,0,6920,T
2-PB1,1398,15,1,0,7147,7163,C
2-PB1,1399,0,7156,0,2,7158,T
2-PB1,1400,7162,0,2,0,7164,A
2-PB1,1401,1,4,0,7153,7158,C
2-PB1,1402,7039,1,3,2,7045,A
2-PB1,1403,3,15,7006,0,7024,G
2-PB1,1404,9,13,6846,0,6868,G
2-PB1,1405,6941,0,7,0,6948,A
2-PB1,1406,2,2,0,6950,6954,C
2-PB1,1407,14,0,0,6803,6817,C
2-PB1,1408,5,6760,2,9,6776,T
2-PB1,1409,0,2,6807,0,6809,G
2-PB1,1410,2,0,1,6828,6831,C
2-PB1,1411,6814,0,4,0,6818,A
2-PB1,1412,6900,2,5,0,6907,A
2-PB1,1413,1,1,6942,0,6944,G
2-PB1,1414,0,6789,0,2,6791,T
2-PB1,1415,0,6816,0,0,6816,T
2-PB1,1416,6760,0,2,0,6762,A
2-PB1,1417,1,4,6783,0,6788,G
2-PB1,1418,2,6712,0,2,6716,T
2-PB1,1419,0,16,6718,0,6734,G
2-PB1,1420,1,16,6700,0,6717,G
2-PB1,1421,3,9,6750,0,6762,G
2-PB1,1422,6714,2,5,0,6721,A
2-PB1,1423,6779,0,1,0,6780,A
2-PB1,1424,1,6767,0,1,6769,T
2-PB1,1425,7,1,0,6787,6795,C
2-PB1,1426,6805,0,6,0,6811,A
2-PB1,1427,6835,0,2,0,6837,A
2-PB1,1428,3,4,0,6799,6806,C
2-PB1,1429,6798,1,1,0,6800,A
2-PB1,1430,0,6691,0,0,6691,T
2-PB1,1431,0,13,6704,0,6717,G
2-PB1,1432,6675,0,9,1,6685,A
2-PB1,1433,0,2,6737,0,6739,G
2-PB1,1434,4,1,0,6705,6710,C
2-PB1,1435,6714,0,5,0,6719,A
2-PB1,1436,6750,0,2,0,6752,A
2-PB1,1437,6756,0,0,0,6756,A
2-PB1,1438,6800,0,2,2,6804,A
2-PB1,1439,6807,0,7,0,6814,A
2-PB1,1440,2,8,6774,0,6784,G
2-PB1,1441,6732,2,4,0,6738,A
2-PB1,1442,6683,0,8,0,6691,A
2-PB1,1443,5,3,6905,0,6913,G
2-PB1,1444,1,6865,0,3,6869,T
2-PB1,1445,10,1,0,6921,6932,C
2-PB1,1446,13,2,0,6948,6963,C
2-PB1,1447,1,6954,0,10,6965,T
2-PB1,1448,7099,1,5,0,7105,A
2-PB1,1449,0,7092,0,0,7092,T
2-PB1,1450,7099,0,1,0,7100,A
2-PB1,1451,1,7081,0,1,7083,T
2-PB1,1452,6986,0,0,0,6986,A
2-PB1,1453,6992,1,1,0,6994,A
2-PB1,1454,6957,0,0,0,6957,A
2-PB1,1455,2,6971,0,0,6973,T
2-PB1,1456,6907,0,0,0,6907,A
2-PB1,1457,6916,0,2,0,6918,A
2-PB1,1458,6948,0,2,0,6950,A
2-PB1,1459,6936,0,5,2,6943,A
2-PB1,1460,0,3,0,6961,6964,C
2-PB1,1461,6706,0,7,0,6713,A
2-PB1,1462,0,14,6706,0,6720,G
2-PB1,1463,1,15,6694,0,6710,G
2-PB1,1464,0,11,6696,0,6707,G
2-PB1,1465,6688,2,7,0,6697,A
2-PB1,1466,2,1,0,6761,6764,C
2-PB1,1467,6737,0,3,0,6740,A
2-PB1,1468,0,6805,1,0,6806,T
2-PB1,1469,0,6795,0,0,6795,T
2-PB1,1470,0,6815,0,3,6818,T
2-PB1,1471,2,8,6795,0,6805,G
2-PB1,1472,6729,1,4,0,6734,A
2-PB1,1473,6785,0,3,0,6788,A
2-PB1,1474,1,6784,2,0,6787,T
2-PB1,1475,1,6658,1,1,6661,T
2-PB1,1476,13,1,0,6681,6695,C
2-PB1,1477,6622,0,0,1,6623,A
2-PB1,1478,1,1,0,6645,6647,C
2-PB1,1479,0,6672,0,3,6675,T
2-PB1,1480,6699,0,2,1,6702,A
2-PB1,1481,1,1,6658,0,6660,G
2-PB1,1482,4,1,0,6667,6672,C
2-PB1,1483,0,6612,0,7,6619,T
2-PB1,1484,0,6710,0,1,6711,T
2-PB1,1485,0,6682,0,4,6686,T
2-PB1,1486,1,6691,0,0,6692,T
2-PB1,1487,0,6687,0,0,6687,T
2-PB1,1488,1,6695,0,0,6696,T
2-PB1,1489,0,6676,0,0,6676,T
2-PB1,1490,6641,1,1,0,6643,A
2-PB1,1491,1,6601,0,0,6602,T
2-PB1,1492,10,4,0,6634,6648,C
2-PB1,1493,1,7,6679,0,6687,G
2-PB1,1494,6912,1,0,0,6913,A
2-PB1,1495,0,6932,0,0,6932,T
2-PB1,1496,6922,0,0,0,6922,A
2-PB1,1497,1,6994,0,2,6997,T
2-PB1,1498,1,10,6967,0,6978,G
2-PB1,1499,2,6,7009,0,7017,G
2-PB1,1500,7005,0,6,0,7011,A
2-PB1,1501,0,6936,1,3,6940,T
2-PB1,1502,0,6917,0,1,6918,T
2-PB1,1503,0,6720,0,0,6720,T
2-PB1,1504,0,1,6742,0,6743,G
2-PB1,1505,0,6688,1,4,6693,T
2-PB1,1506,2,9,6676,0,6687,G
2-PB1,1507,5,0,6663,0,6668,G
2-PB1,1508,2,3,0,6577,6582,C
2-PB1,1509,1,6673,0,2,6676,T
2-PB1,1510,6702,0,0,0,6702,A
2-PB1,1511,6758,0,1,0,6759,A
2-PB1,1512,0,6813,1,0,6814,T
2-PB1,1513,0,6823,0,1,6824,T
2-PB1,1514,0,6806,0,0,6806,T
2-PB1,1515,0,6821,0,0,6821,T
2-PB1,1516,6837,0,4,0,6841,A
2-PB1,1517,2,1,6857,0,6860,G
2-PB1,1518,1,8,0,6856,6865,C
2-PB1,1519,6843,0,2,0,6845,A
2-PB1,1520,0,6803,0,1,6804,T
2-PB1,1521,0,9,6704,0,6713,G
2-PB1,1522,0,22,6808,0,6830,G
2-PB1,1523,6794,0,6,0,6800,A
2-PB1,1524,1,1,6786,0,6788,G
2-PB1,1525,1,1,0,6739,6741,C
2-PB1,1526,0,6719,0,2,6721,T
2-PB1,1527,3,3,6773,0,6779,G
2-PB1,1528,1,1,0,6721,6723,C
2-PB1,1529,15,1,0,6690,6706,C
2-PB1,1530,15,2,0,6787,6804,C
2-PB1,1531,6626,1,4,0,6631,A
2-PB1,1532,2,1,7034,0,7037,G
2-PB1,1533,0,7029,1,0,7030,T
2-PB1,1534,1,7040,0,1,7042,T
2-PB1,1535,0,7039,0,0,7039,T
2-PB1,1536,0,6988,0,2,6990,T
2-PB1,1537,0,10,6957,0,6967,G
2-PB1,1538,0,18,6944,0,6962,G
2-PB1,1539,6927,0,13,1,6941,A
2-PB1,1540,1,1,6969,0,6971,G
2-PB1,1541,0,6463,0,2,6465,T
2-PB1,1542,28,0,6795,0,6823,G
2-PB1,1543,0,6786,0,3,6789,T
2-PB1,1544,15,3,1,6816,6835,C
2-PB1,1545,0,6838,0,5,6843,T
2-PB1,1546,0,8,6849,0,6857,G
2-PB1,1547,2,7,6906,0,6915,G
2-PB1,1548,6952,1,4,0,6957,A
2-PB1,1549,6975,0,3,0,6978,A
2-PB1,1550,0,6955,0,0,6955,T
2-PB1,1551,6493,0,1,0,6494,A
2-PB1,1552,6485,0,2,0,6487,A
2-PB1,1553,6464,0,5,0,6469,A
2-PB1,1554,0,2,0,6480,6482,C
2-PB1,1555,0,18,6412,1,6431,G
2-PB1,1556,6359,0,1,0,6360,A
2-PB1,1557,3,2,6347,0,6352,G
2-PB1,1558,0,6335,0,0,6335,T
2-PB1,1559,24,1,0,6351,6376,C
2-PB1,1560,6386,0,11,1,6398,A
2-PB1,1561,4,1,6472,0,6477,G
2-PB1,1562,2,1,0,6471,6474,C
2-PB1,1563,0,6471,0,7,6478,T
2-PB1,1564,2,6,6729,2,6739,G
2-PB1,1565,6662,0,6,0,6668,A
2-PB1,1566,0,6698,0,0,6698,T
2-PB1,1567,6694,0,6,2,6702,A
2-PB1,1568,0,6605,1,4,6610,T
2-PB1,1569,2,20,6639,0,6661,G
2-PB1,1570,6451,0,3,0,6454,A
2-PB1,1571,4,2,6587,0,6593,G
2-PB1,1572,0,0,0,6587,6587,C
2-PB1,1573,6330,0,1,0,6331,A
2-PB1,1574,0,6341,0,0,6341,T
2-PB1,1575,1,6341,1,3,6346,T
2-PB1,1576,3,1,6409,0,6413,G
2-PB1,1577,0,10,6639,0,6649,G
2-PB1,1578,6607,2,7,0,6616,A
2-PB1,1579,6,2,6637,0,6645,G
2-PB1,1580,0,6506,1,3,6510,T
2-PB1,1581,6535,0,1,1,6537,A
2-PB1,1582,6534,0,3,0,6537,A
2-PB1,1583,1,1,0,6594,6596,C
2-PB1,1584,6564,1,2,0,6567,A
2-PB1,1585,1,2,6693,0,6696,G
2-PB1,1586,0,6190,1,4,6195,T
2-PB1,1587,0,10,6268,0,6278,G
2-PB1,1588,6335,0,6,0,6341,A
2-PB1,1589,1,6335,1,0,6337,T
2-PB1,1590,6350,0,1,0,6351,A
2-PB1,1591,6327,0,1,1,6329,A
2-PB1,1592,6224,0,10,0,6234,A
2-PB1,1593,1,21,6312,0,6334,G
2-PB1,1594,6142,2,1,0,6145,A
2-PB1,1595,6127,1,3,0,6131,A
2-PB1,1596,9,0,0,6157,6166,C
2-PB1,1597,6042,0,4,0,6046,A
2-PB1,1598,6102,0,10,0,6112,A
2-PB1,1599,2,2,0,6137,6141,C
2-PB1,1600,6210,0,2,0,6212,A
2-PB1,1601,0,6192,1,2,6195,T
2-PB1,1602,0,8,6188,1,6197,G
2-PB1,1603,6183,0,11,0,6194,A
2-PB1,1604,0,6184,3,5,6192,T
2-PB1,1605,6173,1,0,0,6174,A
2-PB1,1606,6196,0,1,0,6197,A
2-PB1,1607,6165,2,3,0,6170,A
2-PB1,1608,3,0,0,6211,6214,C
2-PB1,1609,6037,0,0,0,6037,A
2-PB1,1610,6038,0,5,0,6043,A
2-PB1,1611,0,5944,0,0,5944,T
2-PB1,1612,2,14,5944,0,5960,G
2-PB1,1613,6075,0,3,1,6079,A
2-PB1,1614,3,2,0,6154,6159,C
2-PB1,1615,8,2,0,6096,6106,C
2-PB1,1616,0,5972,0,3,5975,T
2-PB1,1617,0,5866,0,0,5866,T
2-PB1,1618,0,18,5874,0,5892,G
2-PB1,1619,1,15,5932,0,5948,G
2-PB1,1620,5986,1,9,2,5998,A
2-PB1,1621,2,0,0,5968,5970,C
2-PB1,1622,14,1,2,5892,5909,C
2-PB1,1623,5852,1,4,0,5857,A
2-PB1,1624,1,0,5889,0,5890,G
2-PB1,1625,0,3,0,5902,5905,C
2-PB1,1626,5921,0,2,0,5923,A
2-PB1,1627,5911,1,3,0,5915,A
2-PB1,1628,3,3,3,5862,5871,C
2-PB1,1629,5814,0,3,0,5817,A
2-PB1,1630,0,3,5896,0,5899,G
2-PB1,1631,3,1,0,5849,5853,C
2-PB1,1632,6,1,0,5903,5910,C
2-PB1,1633,15,0,0,5892,5907,C
2-PB1,1634,5926,1,4,0,5931,A
2-PB1,1635,5923,0,1,0,5924,A
2-PB1,1636,5920,1,1,0,5922,A
2-PB1,1637,0,5882,0,3,5885,T
2-PB1,1638,0,14,5858,0,5872,G
2-PB1,1639,0,2,5743,0,5745,G
2-PB1,1640,3,2,0,5778,5783,C
2-PB1,1641,1,5749,0,4,5754,T
2-PB1,1642,8,1,0,5918,5927,C
2-PB1,1643,0,5886,1,11,5898,T
2-PB1,1644,8,0,0,5949,5957,C
2-PB1,1645,10,2,0,5990,6002,C
2-PB1,1646,6017,0,1,0,6018,A
2-PB1,1647,6013,0,2,0,6015,A
2-PB1,1648,1,5943,4,1,5949,T
2-PB1,1649,1,5919,0,4,5924,T
2-PB1,1650,0,0,5943,0,5943,G
2-PB1,1651,1,5780,0,3,5784,T
2-PB1,1652,1,5771,0,6,5778,T
2-PB1,1653,10,3,0,5800,5813,C
2-PB1,1654,5805,0,1,0,5806,A
2-PB1,1655,0,5773,0,2,5775,T
2-PB1,1656,9,0,0,5796,5805,C
2-PB1,1657,5829,0,2,0,5831,A
2-PB1,1658,5818,0,0,1,5819,A
2-PB1,1659,5800,0,3,0,5803,A
2-PB1,1660,1,6,5925,0,5932,G
2-PB1,1661,5915,0,1,0,5916,A
2-PB1,1662,2,5919,1,0,5922,T
2-PB1,1663,0,5949,1,1,5951,T
2-PB1,1664,5957,2,7,0,5966,A
2-PB1,1665,0,1,0,6072,6073,C
2-PB1,1666,6049,1,6,0,6056,A
2-PB1,1667,2,6,6125,0,6133,G
2-PB1,1668,6101,0,5,0,6106,A
2-PB1,1669,0,6249,0,1,6250,T
2-PB1,1670,6275,1,2,0,6278,A
2-PB1,1671,4,3,0,6645,6652,C
2-PB1,1672,6736,1,9,1,6747,A
2-PB1,1673,0,1,0,7147,7148,C
2-PB1,1674,7065,0,0,1,7066,A
2-PB1,1675,0,7095,0,3,7098,T
2-PB1,1676,7058,0,2,0,7060,A
2-PB1,1677,1,7007,0,1,7009,T
2-PB1,1678,6855,5,2,0,6862,A
2-PB1,1679,1,14,6829,1,6845,G
2-PB1,1680,1,0,6715,1,6717,G
2-PB1,1681,0,6380,0,3,6383,T
2-PB1,1682,3,2,6356,0,6361,G
2-PB1,1683,2,1,1,6573,6577,C
2-PB1,1684,12,2,2,6613,6629,C
2-PB1,1685,6730,0,4,0,6734,A
2-PB1,1686,0,6740,0,1,6741,T
2-PB1,1687,6757,0,4,0,6761,A
2-PB1,1688,0,15,6771,1,6787,G
2-PB1,1689,6634,1,8,1,6644,A
2-PB1,1690,0,14,6679,0,6693,G
2-PB1,1691,1,15,6642,0,6658,G
2-PB1,1692,6440,1,9,0,6450,A
2-PB1,1693,1,15,6469,0,6485,G
2-PB1,1694,6423,0,8,0,6431,A
2-PB1,1695,1,1,0,6457,6459,C
2-PB1,1696,6449,2,7,0,6458,A
2-PB1,1697,2,0,0,6536,6538,C
2-PB1,1698,6520,1,8,0,6529,A
2-PB1,1699,2,0,1,6550,6553,C
2-PB1,1700,6533,1,1,0,6535,A
2-PB1,1701,6567,0,0,0,6567,A
2-PB1,1702,6602,0,0,0,6602,A
2-PB1,1703,1,6565,0,2,6568,T
2-PB1,1704,7,4,0,6574,6585,C
2-PB1,1705,17,3,0,6576,6596,C
2-PB1,1706,6538,0,4,1,6543,A
2-PB1,1707,0,10,6562,0,6572,G
2-PB1,1708,6556,1,5,0,6562,A
2-PB1,1709,1,0,0,6614,6615,C
2-PB1,1710,2,19,6596,0,6617,G
2-PB1,1711,6526,0,3,1,6530,A
2-PB1,1712,0,13,6568,0,6581,G
2-PB1,1713,6569,3,4,0,6576,A
2-PB1,1714,6590,0,2,0,6592,A
2-PB1,1715,2,4,6606,0,6612,G
2-PB1,1716,6574,0,5,0,6579,A
2-PB1,1717,0,6576,0,2,6578,T
2-PB1,1718,6,0,0,6549,6555,C
2-PB1,1719,6595,0,1,1,6597,A
2-PB1,1720,0,6550,0,2,6552,T
2-PB1,1721,0,6532,0,1,6533,T
2-PB1,1722,5,2,1,6567,6575,C
2-PB1,1723,1,10,6554,0,6565,G
2-PB1,1724,6502,3,3,1,6509,A
2-PB1,1725,3,6,6532,0,6541,G
2-PB1,1726,6487,0,3,1,6491,A
2-PB1,1727,0,6711,0,2,6713,T
2-PB1,1728,6728,0,3,0,6731,A
2-PB1,1729,6755,0,2,0,6757,A
2-PB1,1730,6736,0,7,0,6743,A
2-PB1,1731,5,6,6741,0,6752,G
2-PB1,1732,6755,0,7,0,6762,A
2-PB1,1733,6560,1,3,0,6564,A
2-PB1,1734,2,1,6561,0,6564,G
2-PB1,1735,2,12,0,6558,6572,C
2-PB1,1736,1,6506,1,8,6516,T
2-PB1,1737,4,3,6566,0,6573,G
2-PB1,1738,0,6500,0,4,6504,T
2-PB1,1739,2,18,6508,0,6528,G
2-PB1,1740,3,20,6500,0,6523,G
2-PB1,1741,2,18,6538,0,6558,G
2-PB1,1742,6591,0,6,0,6597,A
2-PB1,1743,0,6525,0,1,6526,T
2-PB1,1744,16,0,0,6492,6508,C
2-PB1,1745,6524,0,0,1,6525,A
2-PB1,1746,6555,0,4,0,6559,A
2-PB1,1747,6572,2,1,0,6575,A
2-PB1,1748,2,0,0,6601,6603,C
2-PB1,1749,9,0,1,6548,6558,C
2-PB1,1750,21,4,0,6518,6543,C
2-PB1,1751,6572,0,3,0,6575,A
2-PB1,1752,6684,0,1,0,6685,A
2-PB1,1753,1,6632,0,1,6634,T
2-PB1,1754,11,0,0,6645,6656,C
2-PB1,1755,6603,2,3,0,6608,A
2-PB1,1756,6558,0,8,0,6566,A
2-PB1,1757,1,20,6625,0,6646,G
2-PB1,1758,0,11,6591,1,6603,G
2-PB1,1759,2,2,6594,0,6598,G
2-PB1,1760,8,2,0,6609,6619,C
2-PB1,1761,6500,1,9,0,6510,A
2-PB1,1762,0,5,6695,0,6700,G
2-PB1,1763,0,10,6738,1,6749,G
2-PB1,1764,6758,0,5,0,6763,A
2-PB1,1765,1,0,0,6868,6869,C
2-PB1,1766,0,6770,0,0,6770,T
2-PB1,1767,7010,1,0,0,7011,A
2-PB1,1768,1,6956,0,2,6959,T
2-PB1,1769,0,6989,0,0,6989,T
2-PB1,1770,2,16,7013,1,7032,G
2-PB1,1771,3,1,7089,0,7093,G
2-PB1,1772,0,6994,0,2,6996,T
2-PB1,1773,7055,0,6,0,7061,A
2-PB1,1774,1,6978,1,2,6982,T
2-PB1,1775,6,2,0,6974,6982,C
2-PB1,1776,6862,0,2,0,6864,A
2-PB1,1777,1,3,6936,0,6940,G
2-PB1,1778,6923,1,0,0,6924,A
2-PB1,1779,0,6904,1,0,6905,T
2-PB1,1780,1,24,6625,1,6651,G
2-PB1,1781,0,16,6609,1,6626,G
2-PB1,1782,3,18,6595,0,6616,G
2-PB1,1783,0,14,6637,0,6651,G
2-PB1,1784,2,19,6623,0,6644,G
2-PB1,1785,6601,1,6,0,6608,A
2-PB1,1786,1,1,0,6612,6614,C
2-PB1,1787,13,1,1,6552,6567,C
2-PB1,1788,6593,1,1,0,6595,A
2-PB1,1789,7064,0,0,0,7064,A
2-PB1,1790,7105,0,2,0,7107,A
2-PB1,1791,4,0,0,7305,7309,C
2-PB1,1792,0,7247,0,1,7248,T
2-PB1,1793,0,7239,0,0,7239,T
2-PB1,1794,7281,0,1,0,7282,A
2-PB1,1795,0,7282,0,0,7282,T
2-PB1,1796,7285,0,4,0,7289,A
2-PB1,1797,3,5,0,7298,7306,C
2-PB1,1798,6821,1,1,0,6823,A
2-PB1,1799,6835,1,3,0,6839,A
2-PB1,1800,0,6692,0,2,6694,T
2-PB1,1801,6822,1,4,0,6827,A
2-PB1,1802,0,6812,0,1,6813,T
2-PB1,1803,3,0,0,6799,6802,C
2-PB1,1804,15,5,0,6781,6801,C
2-PB1,1805,3,9,6782,0,6794,G
2-PB1,1806,1,8,6811,1,6821,G
2-PB1,1807,6825,0,0,0,6825,A
2-PB1,1808,6822,0,1,0,6823,A
2-PB1,1809,0,6816,0,4,6820,T
2-PB1,1810,5,1,0,6848,6854,C
2-PB1,1811,0,6832,1,5,6838,T
2-PB1,1812,0,6866,0,6,6872,T
2-PB1,1813,6,1,0,6857,6864,C
2-PB1,1814,6846,0,7,0,6853,A
2-PB1,1815,3,1,0,6896,6900,C
2-PB1,1816,6881,0,1,0,6882,A
2-PB1,1817,0,7379,0,2,7381,T
2-PB1,1818,7,2,0,7367,7376,C
2-PB1,1819,14,3,1,7338,7356,C
2-PB1,1820,19,2,0,7405,7426,C
2-PB1,1821,1,7417,0,14,7432,T
2-PB1,1822,2,8,7440,0,7450,G
2-PB1,1823,7410,1,0,0,7411,A
2-PB1,1824,7374,0,1,0,7375,A
2-PB1,1825,1,3,7429,0,7433,G
2-PB1,1826,0,6984,0,3,6987,T
2-PB1,1827,5,1,0,7022,7028,C
2-PB1,1828,1,6962,0,3,6966,T
2-PB1,1829,1,3,7139,0,7143,G
2-PB1,1830,3,1,0,7124,7128,C
2-PB1,1831,1,7145,1,8,7155,T
2-PB1,1832,1,7156,0,2,7159,T
2-PB1,1833,7163,1,0,0,7164,A
2-PB1,1834,7159,0,0,0,7159,A
2-PB1,1835,7172,0,3,0,7175,A
2-PB1,1836,0,0,7215,0,7215,G
2-PB1,1837,1,7102,0,2,7105,T
2-PB1,1838,2,17,7005,0,7024,G
2-PB1,1839,7,7,6979,0,6993,G
2-PB1,1840,1,7,7032,0,7040,G
2-PB1,1841,6993,0,6,0,6999,A
2-PB1,1842,3,2,7053,0,7058,G
2-PB1,1843,7,1,0,7030,7038,C
2-PB1,1844,0,7054,0,5,7059,T
2-PB1,1845,1,3,7085,0,7089,G
2-PB1,1846,7046,1,4,0,7051,A
2-PB1,1847,1,7067,0,1,7069,T
2-PB1,1848,1,15,7096,1,7113,G
2-PB1,1849,1,5,7085,0,7091,G
2-PB1,1850,7071,1,6,0,7078,A
2-PB1,1851,0,7053,1,8,7062,T
2-PB1,1852,0,12,7051,0,7063,G
2-PB1,1853,6993,0,2,1,6996,A
2-PB1,1854,0,9,7096,0,7105,G
2-PB1,1855,7103,0,3,0,7106,A
2-PB1,1856,7118,0,2,0,7120,A
2-PB1,1857,1,7096,0,0,7097,T
2-PB1,1858,0,7057,0,0,7057,T
2-PB1,1859,7071,0,0,0,7071,A
2-PB1,1860,0,7035,0,1,7036,T
2-PB1,1861,14,2,0,7070,7086,C
2-PB1,1862,5,20,7063,0,7088,G
2-PB1,1863,1,17,7013,0,7031,G
2-PB1,1864,1,7,7003,0,7011,G
2-PB1,1865,4,3,6979,0,6986,G
2-PB1,1866,6970,0,16,0,6986,A
2-PB1,1867,6989,0,7,0,6996,A
2-PB1,1868,0,6,7042,0,7048,G
2-PB1,1869,7038,0,3,0,7041,A
2-PB1,1870,1,1,1,7133,7136,C
2-PB1,1871,0,7067,1,2,7070,T
2-PB1,1872,1,7208,5,1,7215,T
2-PB1,1873,0,7240,0,0,7240,T
2-PB1,1874,1,1,7267,0,7269,G
2-PB1,1875,0,7276,1,3,7280,T
2-PB1,1876,7252,1,1,0,7254,A
2-PB1,1877,7223,1,1,0,7225,A
2-PB1,1878,1,7080,0,3,7084,T
2-PB1,1879,9,1,1,7136,7147,C
2-PB1,1880,8,0,0,7119,7127,C
2-PB1,1881,25,2,0,7065,7092,C
2-PB1,1882,15,1,2,7138,7156,C
2-PB1,1883,0,7121,0,6,7127,T
2-PB1,1884,7,13,7127,1,7148,G
2-PB1,1885,7106,0,0,0,7106,A
2-PB1,1886,7120,0,1,0,7121,A
2-PB1,1887,0,7129,0,9,7138,T
2-PB1,1888,10,1,0,7085,7096,C
2-PB1,1889,12,1,0,7030,7043,C
2-PB1,1890,12,2,0,6992,7006,C
2-PB1,1891,0,7022,1,8,7031,T
2-PB1,1892,0,7074,0,2,7076,T
2-PB1,1893,0,7033,0,1,7034,T
2-PB1,1894,1,1,7053,0,7055,G
2-PB1,1895,1,6976,0,15,6992,T
2-PB1,1896,16,25,1,6950,6992,C
2-PB1,1897,6947,0,7,1,6955,A
2-PB1,1898,3,1,7031,1,7036,G
2-PB1,1899,0,2,0,6980,6982,C
2-PB1,1900,11,1,0,7014,7026,C
2-PB1,1901,7051,1,1,0,7053,A
2-PB1,1902,0,7075,0,0,7075,T
2-PB1,1903,7056,0,0,0,7056,A
2-PB1,1904,7071,0,2,0,7073,A
2-PB1,1905,7080,2,1,0,7083,A
2-PB1,1906,3,7,7161,0,7171,G
2-PB1,1907,7001,0,2,0,7003,A
2-PB1,1908,7013,0,0,1,7014,A
2-PB1,1909,7008,0,5,0,7013,A
2-PB1,1910,1,6960,0,0,6961,T
2-PB1,1911,0,6967,0,4,6971,T
2-PB1,1912,2,18,6982,0,7002,G
2-PB1,1913,6931,0,3,0,6934,A
2-PB1,1914,3,2,7006,0,7011,G
2-PB1,1915,1,6982,0,2,6985,T
2-PB1,1916,18,1,1,7052,7072,C
2-PB1,1917,1,7047,0,4,7052,T
2-PB1,1918,2,2,7165,0,7169,G
2-PB1,1919,0,7162,0,2,7164,T
2-PB1,1920,7286,0,1,0,7287,A
2-PB1,1921,7258,0,7,0,7265,A
2-PB1,1922,7257,1,3,0,7261,A
2-PB1,1923,1,5,0,7288,7294,C
2-PB1,1924,7073,0,0,0,7073,A
2-PB1,1925,7218,0,2,0,7220,A
2-PB1,1926,0,7173,1,4,7178,T
2-PB1,1927,1,2,7170,0,7173,G
2-PB1,1928,6,8,0,7225,7239,C
2-PB1,1929,1,7182,0,3,7186,T
2-PB1,1930,2,1,7398,0,7401,G
2-PB1,1931,1,7367,0,3,7371,T
2-PB1,1932,7487,0,2,0,7489,A
2-PB1,1933,3,6,7480,0,7489,G
2-PB1,1934,0,7274,0,1,7275,T
2-PB1,1935,7251,0,0,0,7251,A
2-PB1,1936,7166,0,0,0,7166,A
2-PB1,1937,0,7098,0,2,7100,T
2-PB1,1938,0,3,7096,0,7099,G
2-PB1,1939,2,4,0,6958,6964,C
2-PB1,1940,6,1,0,6904,6911,C
2-PB1,1941,6810,0,5,0,6815,A
2-PB1,1942,2,0,6845,0,6847,G
2-PB1,1943,1,2,0,6964,6967,C
2-PB1,1944,13,2,1,6954,6970,C
2-PB1,1945,14,3,0,6956,6973,C
2-PB1,1946,6938,0,3,0,6941,A
2-PB1,1947,0,6951,0,4,6955,T
2-PB1,1948,0,13,6915,0,6928,G
2-PB1,1949,0,1,6945,0,6946,G
2-PB1,1950,0,6897,0,7,6904,T
2-PB1,1951,12,0,0,6858,6870,C
2-PB1,1952,13,2,2,6658,6675,C
2-PB1,1953,20,9,6724,0,6753,G
2-PB1,1954,2,0,6735,1,6738,G
2-PB1,1955,3,1,0,6685,6689,C
2-PB1,1956,15,0,0,6734,6749,C
2-PB1,1957,6744,0,1,0,6745,A
2-PB1,1958,6768,0,1,0,6769,A
2-PB1,1959,6772,0,1,0,6773,A
2-PB1,1960,6805,0,2,1,6808,A
2-PB1,1961,3,2,6920,0,6925,G
2-PB1,1962,0,6713,1,0,6714,T
2-PB1,1963,6796,1,4,0,6801,A
2-PB1,1964,1,6767,0,1,6769,T
2-PB1,1965,4,15,6769,0,6788,G
2-PB1,1966,0,4,6913,0,6917,G
2-PB1,1967,6873,0,3,0,6876,A
2-PB1,1968,6949,1,3,0,6953,A
2-PB1,1969,0,6918,0,1,6919,T
2-PB1,1970,6824,0,9,0,6833,A
2-PB1,1971,1,6811,0,4,6816,T
2-PB1,1972,6,15,6747,0,6768,G
2-PB1,1973,6777,0,7,0,6784,A
2-PB1,1974,0,6733,0,4,6737,T
2-PB1,1975,2,2,6547,0,6551,G
2-PB1,1976,4,3,2,6536,6545,C
2-PB1,1977,13,1,0,6481,6495,C
2-PB1,1978,1,2,6520,0,6523,G
2-PB1,1979,0,6487,0,2,6489,T
2-PB1,1980,0,6500,0,6,6506,T
2-PB1,1981,3,3,6511,0,6517,G
2-PB1,1982,5,0,0,6631,6636,C
2-PB1,1983,6638,0,4,0,6642,A
2-PB1,1984,6753,0,4,0,6757,A
2-PB1,1985,2,1,0,6786,6789,C
2-PB1,1986,0,6707,0,5,6712,T
2-PB1,1987,6747,1,3,1,6752,A
2-PB1,1988,3,8,0,6732,6743,C
2-PB1,1989,6724,1,4,0,6729,A
2-PB1,1990,1,1,0,6763,6765,C
2-PB1,1991,6506,0,1,0,6507,A
2-PB1,1992,3,1,0,7122,7126,C
2-PB1,1993,0,6923,0,6,6929,T
2-PB1,1994,21,0,0,6984,7005,C
2-PB1,1995,17,0,0,7017,7034,C
2-PB1,1996,1,6927,0,7,6935,T
2-PB1,1997,0,8,6976,0,6984,G
2-PB1,1998,2,10,6960,0,6972,G
2-PB1,1999,6953,0,0,0,6953,A
2-PB1,2000,0,6956,0,2,6958,T
2-PB1,2001,1,6228,0,1,6230,T
2-PB1,2002,9,1,0,6313,6323,C
2-PB1,2003,11,1,0,6282,6294,C
2-PB1,2004,6,0,0,6356,6362,C
2-PB1,2005,6387,1,0,0,6388,A
2-PB1,2006,6374,1,0,0,6375,A
2-PB1,2007,27,11,6347,0,6385,G
2-PB1,2008,6335,0,4,0,6339,A
2-PB1,2009,1,6,6332,0,6339,G
2-PB1,2010,0,12,6321,0,6333,G
2-PB1,2011,6235,0,5,1,6241,A
2-PB1,2012,6231,1,6,1,6239,A
2-PB1,2013,2,2,0,6226,6230,C
2-PB1,2014,7,2,0,6165,6174,C
2-PB1,2015,4,2,6255,0,6261,G
2-PB1,2016,3,0,1,6261,6265,C
2-PB1,2017,0,6250,0,4,6254,T
2-PB1,2018,15,2,0,6270,6287,C
2-PB1,2019,0,6254,0,1,6255,T
2-PB1,2020,6686,0,0,0,6686,A
2-PB1,2021,0,6680,0,4,6684,T
2-PB1,2022,0,6650,0,5,6655,T
2-PB1,2023,7,0,0,6717,6724,C
2-PB1,2024,1,6528,0,1,6530,T
2-PB1,2025,6554,0,1,0,6555,A
2-PB1,2026,6540,0,0,0,6540,A
2-PB1,2027,6536,0,3,0,6539,A
2-PB1,2028,3,0,0,6558,6561,C
2-PB1,2029,6072,0,1,0,6073,A
2-PB1,2030,0,3,0,6108,6111,C
2-PB1,2031,6015,1,4,1,6021,A
2-PB1,2032,6067,0,6,0,6073,A
2-PB1,2033,1,0,6087,0,6088,G
2-PB1,2034,1,2,1,6054,6058,C
2-PB1,2035,5,2,1,6091,6099,C
2-PB1,2036,6055,0,0,4,6059,A
2-PB1,2037,6027,0,6,0,6033,A
2-PB1,2038,6042,0,3,0,6045,A
2-PB1,2039,1,19,6105,1,6126,G
2-PB1,2040,0,19,6090,1,6110,G
2-PB1,2041,1,8,5992,0,6001,G
2-PB1,2042,1,7,6037,0,6045,G
2-PB1,2043,6013,1,2,0,6016,A
2-PB1,2044,6037,0,3,0,6040,A
2-PB1,2045,0,6041,0,1,6042,T
2-PB1,2046,0,6043,0,2,6045,T
2-PB1,2047,12,0,0,6064,6076,C
2-PB1,2048,0,6039,1,3,6043,T
2-PB1,2049,0,6052,2,1,6055,T
2-PB1,2050,2,5,6053,0,6060,G
2-PB1,2051,6063,2,6,0,6071,A
2-PB1,2052,2,8,6071,0,6081,G
2-PB1,2053,6,7,6053,0,6066,G
2-PB1,2054,6061,0,1,0,6062,A
2-PB1,2055,0,6030,1,2,6033,T
2-PB1,2056,1,18,6022,1,6042,G
2-PB1,2057,6034,0,6,0,6040,A
2-PB1,2058,6048,0,4,0,6052,A
2-PB1,2059,3,0,0,6073,6076,C
2-PB1,2060,6018,0,0,0,6018,A
2-PB1,2061,1,2,6134,0,6137,G
2-PB1,2062,6075,0,7,0,6082,A
2-PB1,2063,0,6072,0,4,6076,T
2-PB1,2064,0,1,6102,0,6103,G
2-PB1,2065,0,6201,0,4,6205,T
2-PB1,2066,6216,0,1,0,6217,A
2-PB1,2067,1,3,0,6225,6229,C
2-PB1,2068,18,0,1,6185,6204,C
2-PB1,2069,6159,1,0,0,6160,A
2-PB1,2070,0,5,6066,0,6071,G
2-PB1,2071,5998,2,2,0,6002,A
2-PB1,2072,5988,0,5,0,5993,A
2-PB1,2073,0,2,6028,0,6030,G
2-PB1,2074,0,5647,1,1,5649,T
2-PB1,2075,4,3,5678,0,5685,G
2-PB1,2076,1,0,0,5690,5691,C
2-PB1,2077,2,5665,0,10,5677,T
2-PB1,2078,1,1,5675,0,5677,G
2-PB1,2079,2,2,0,5657,5661,C
2-PB1,2080,5676,1,0,0,5677,A
2-PB1,2081,5663,0,1,0,5664,A
2-PB1,2082,0,0,0,5584,5584,C
2-PB1,2083,0,5582,0,3,5585,T
2-PB1,2084,0,5512,0,2,5514,T
2-PB1,2085,0,1,5508,0,5509,G
2-PB1,2086,0,5483,0,0,5483,T
2-PB1,2087,0,5477,0,0,5477,T
2-PB1,2088,10,1,0,5469,5480,C
2-PB1,2089,0,17,5483,0,5500,G
2-PB1,2090,5487,2,0,0,5489,A
2-PB1,2091,1,8,5483,0,5492,G
2-PB1,2092,5479,0,1,0,5480,A
2-PB1,2093,5483,1,0,0,5484,A
2-PB1,2094,5481,0,0,3,5484,A
2-PB1,2095,0,5461,0,0,5461,T
2-PB1,2096,0,5471,1,2,5474,T
2-PB1,2097,0,5475,0,1,5476,T
2-PB1,2098,0,5478,0,0,5478,T
2-PB1,2099,0,5451,0,2,5453,T
2-PB1,2100,11,2,0,5455,5468,C
2-PB1,2101,15,0,0,5451,5466,C
2-PB1,2102,15,0,0,5493,5508,C
2-PB1,2103,0,5502,1,3,5506,T
2-PB1,2104,5514,0,0,0,5514,A
2-PB1,2105,0,3,5536,0,5539,G
2-PB1,2106,1,5515,1,0,5517,T
2-PB1,2107,5571,1,3,0,5575,A
2-PB1,2108,0,2,5601,2,5605,G
2-PB1,2109,0,5546,0,3,5549,T
2-PB1,2110,0,5710,0,3,5713,T
2-PB1,2111,18,1,0,5727,5746,C
2-PB1,2112,5835,0,2,0,5837,A
2-PB1,2113,1,5828,0,0,5829,T
2-PB1,2114,5851,0,1,0,5852,A
2-PB1,2115,0,5849,0,0,5849,T
2-PB1,2116,5663,0,0,0,5663,A
2-PB1,2117,0,9,5607,0,5616,G
2-PB1,2118,0,2,5596,1,5599,G
2-PB1,2119,5035,0,9,0,5044,A
2-PB1,2120,0,12,5044,0,5056,G
2-PB1,2121,4736,0,1,0,4737,A
2-PB1,2122,0,0,0,4729,4729,C
2-PB1,2123,10,2,0,4520,4532,C
2-PB1,2124,2,1,4527,1,4531,G
2-PB1,2125,4496,0,2,0,4498,A
2-PB1,2126,1,4474,0,1,4476,T
2-PB1,2127,0,4495,0,1,4496,T
2-PB1,2128,0,6,4487,0,4493,G
2-PB1,2129,1,1,4500,0,4502,G
2-PB1,2130,4509,0,1,0,4510,A
2-PB1,2131,4514,0,2,0,4516,A
2-PB1,2132,0,4473,0,0,4473,T
2-PB1,2133,0,4523,0,0,4523,T
2-PB1,2134,0,4498,0,0,4498,T
2-PB1,2135,10,0,0,4528,4538,C
2-PB1,2136,2,4553,0,2,4557,T
2-PB1,2137,4537,0,1,0,4538,A
2-PB1,2138,0,0,4531,0,4531,G
2-PB1,2139,0,4280,0,2,4282,T
2-PB1,2140,4384,0,0,0,4384,A
2-PB1,2141,0,4385,0,0,4385,T
2-PB1,2142,0,10,4405,0,4415,G
2-PB1,2143,2,1,4478,0,4481,G
2-PB1,2144,1,4402,1,1,4405,T
2-PB1,2145,1,10,4390,0,4401,G
2-PB1,2146,2,3,4374,0,4379,G
2-PB1,2147,4280,0,11,0,4291,A
2-PB1,2148,0,5,4309,0,4314,G
2-PB1,2149,1,1,4267,0,4269,G
2-PB1,2150,3,3,0,4168,4174,C
2-PB1,2151,10,0,0,4198,4208,C
2-PB1,2152,4058,0,1,0,4059,A
2-PB1,2153,2,4035,0,3,4040,T
2-PB1,2154,0,10,4062,0,4072,G
2-PB1,2155,3,4,4093,0,4100,G
2-PB1,2156,0,3983,0,2,3985,T
2-PB1,2157,1,1,4064,0,4066,G
2-PB1,2158,2,3947,0,2,3951,T
2-PB1,2159,5,0,0,3913,3918,C
2-PB1,2160,0,3944,0,3,3947,T
2-PB1,2161,3917,0,0,0,3917,A
2-PB1,2162,0,4,3895,0,3899,G
2-PB1,2163,1,4,3803,0,3808,G
2-PB1,2164,4,1,3749,0,3754,G
2-PB1,2165,1,0,0,3610,3611,C
2-PB1,2166,3,1,0,3452,3456,C
2-PB1,2167,11,2,0,3421,3434,C
2-PB1,2168,2,3,3464,0,3469,G
2-PB1,2169,0,1,3485,0,3486,G
2-PB1,2170,3482,0,1,0,3483,A
2-PB1,2171,0,3449,0,1,3450,T
2-PB1,2172,0,3348,0,1,3349,T
2-PB1,2173,0,6,3330,0,3336,G
2-PB1,2174,3324,1,2,0,3327,A
2-PB1,2175,0,3336,0,1,3337,T
2-PB1,2176,2,1,3328,1,3332,G
2-PB1,2177,2,1,0,3271,3274,C
2-PB1,2178,2,0,1,3292,3295,C
2-PB1,2179,3286,1,2,0,3289,A
2-PB1,2180,0,5,3283,0,3288,G
2-PB1,2181,3293,1,0,0,3294,A
2-PB1,2182,3306,0,0,0,3306,A
2-PB1,2183,0,3267,0,2,3269,T
2-PB1,2184,0,3203,1,2,3206,T
2-PB1,2185,4,12,3200,0,3216,G
2-PB1,2186,3180,0,2,0,3182,A
2-PB1,2187,0,0,0,3176,3176,C
2-PB1,2188,1,3165,0,3,3169,T
2-PB1,2189,0,3120,0,0,3120,T
2-PB1,2190,3,0,0,3140,3143,C
2-PB1,2191,0,8,3130,0,3138,G
2-PB1,2192,3129,0,2,0,3131,A
2-PB1,2193,5,2,3085,0,3092,G
2-PB1,2194,0,3095,0,3,3098,T
2-PB1,2195,1,0,0,3117,3118,C
2-PB1,2196,2,3134,0,1,3137,T
2-PB1,2197,0,2,3126,0,3128,G
2-PB1,2198,1,1,3134,0,3136,G
2-PB1,2199,3134,0,0,0,3134,A
2-PB1,2200,2893,1,7,0,2901,A
2-PB1,2201,0,4,2911,0,2915,G
2-PB1,2202,1,5,2941,0,2947,G
2-PB1,2203,2946,0,2,0,2948,A
2-PB1,2204,0,2915,0,1,2916,T
2-PB1,2205,0,2933,0,0,2933,T
2-PB1,2206,2920,1,2,0,2923,A
2-PB1,2207,2914,0,2,0,2916,A
2-PB1,2208,0,1,2912,0,2913,G
2-PB1,2209,2902,0,2,0,2904,A
2-PB1,2210,2774,0,1,0,2775,A
2-PB1,2211,2,4,2595,0,2601,G
2-PB1,2212,0,1,2596,0,2597,G
2-PB1,2213,2590,0,0,0,2590,A
2-PB1,2214,2581,0,1,0,2582,A
2-PB1,2215,1,1,2584,0,2586,G
2-PB1,2216,2438,0,1,0,2439,A
2-PB1,2217,0,0,2444,0,2444,G
2-PB1,2218,0,2312,0,3,2315,T
2-PB1,2219,0,2303,0,1,2304,T
2-PB1,2220,5,0,0,2334,2339,C
2-PB1,2221,0,2257,1,2,2260,T
2-PB1,2222,3,1,1,2282,2287,C
2-PB1,2223,0,2271,0,0,2271,T
2-PB1,2224,0,8,2261,0,2269,G
2-PB1,2225,2205,0,0,0,2205,A
2-PB1,2226,0,2,2178,0,2180,G
2-PB1,2227,2157,1,0,0,2158,A
2-PB1,2228,0,2090,0,0,2090,T
2-PB1,2229,7,0,0,1959,1966,C
2-PB1,2230,1985,0,0,1,1986,A
2-PB1,2231,0,1972,0,2,1974,T
2-PB1,2232,5,2,1971,0,1978,G
2-PB1,2233,1973,0,3,0,1976,A
2-PB1,2234,1962,0,1,0,1963,A
2-PB1,2235,0,2,1929,0,1931,G
2-PB1,2236,1906,0,0,0,1906,A
2-PB1,2237,0,1870,0,2,1872,T
2-PB1,2238,4,0,0,1864,1868,C
2-PB1,2239,1,1750,0,0,1751,T
2-PB1,2240,1,2,1751,0,1754,G
2-PB1,2241,0,1750,0,1,1751,T
2-PB1,2242,0,1737,0,0,1737,T
2-PB1,2243,8,0,0,1707,1715,C
2-PB1,2244,3,1,1,1665,1670,C
2-PB1,2245,1649,0,1,0,1650,A
2-PB1,2246,0,0,0,1660,1660,C
2-PB1,2247,3,2,0,1584,1589,C
2-PB1,2248,1576,0,0,0,1576,A
2-PB1,2249,0,1462,0,0,1462,T
2-PB1,2250,0,1414,0,0,1414,T
2-PB1,2251,0,0,1411,0,1411,G
2-PB1,2252,1397,0,0,0,1397,A
2-PB1,2253,1382,0,3,0,1385,A
2-PB1,2254,1,1,1379,0,1381,G
2-PB1,2255,1204,0,1,0,1205,A
2-PB1,2256,1195,0,0,0,1195,A
2-PB1,2257,0,0,0,1183,1183,C
2-PB1,2258,1,1140,0,0,1141,T
2-PB1,2259,0,0,0,1142,1142,C
2-PB1,2260,1104,0,1,0,1105,A
2-PB1,2261,0,1,1104,0,1105,G
2-PB1,2262,1093,0,0,0,1093,A
2-PB1,2263,1,1,0,1059,1061,C
2-PB1,2264,1,4,1034,0,1039,G
2-PB1,2265,0,0,1022,0,1022,G
2-PB1,2266,1,1,0,1009,1011,C
2-PB1,2267,1017,0,1,0,1018,A
2-PB1,2268,1009,0,2,0,1011,A
2-PB1,2269,1006,0,0,0,1006,A
2-PB1,2270,1001,0,0,0,1001,A
2-PB1,2271,1001,0,0,0,1001,A
2-PB1,2272,0,977,0,0,977,T
2-PB1,2273,957,0,0,0,957,A
2-PB1,2274,953,0,0,0,953,A
3-PA,1,111,0,0,0,111,A
3-PA,2,0,115,0,0,115,T
3-PA,3,0,0,123,0,123,G
3-PA,4,0,0,124,0,124,G
3-PA,5,122,0,0,0,122,A
3-PA,6,120,0,0,0,120,A
3-PA,7,0,0,126,0,126,G
3-PA,8,132,0,0,0,132,A
3-PA,9,0,132,0,0,132,T
3-PA,10,0,133,0,0,133,T
3-PA,11,0,133,0,0,133,T
3-PA,12,0,132,0,0,132,T
3-PA,13,0,0,138,0,138,G
3-PA,14,0,134,0,0,134,T
3-PA,15,0,0,137,0,137,G
3-PA,16,0,0,0,143,143,C
3-PA,17,0,1,142,0,143,G
3-PA,18,149,0,1,0,150,A
3-PA,19,1,0,0,157,158,C
3-PA,20,157,0,0,0,157,A
3-PA,21,161,0,0,0,161,A
3-PA,22,0,167,0,0,167,T
3-PA,23,0,0,186,0,186,G
3-PA,24,0,0,0,189,189,C
3-PA,25,0,187,0,0,187,T
3-PA,26,0,192,0,0,192,T
3-PA,27,0,0,0,191,191,C
3-PA,28,199,0,0,0,199,A
3-PA,29,200,0,0,0,200,A
3-PA,30,0,0,0,206,206,C
3-PA,31,0,0,0,207,207,C
3-PA,32,2,0,0,206,208,C
3-PA,33,0,0,212,0,212,G
3-PA,34,208,0,0,0,208,A
3-PA,35,0,214,0,0,214,T
3-PA,36,0,1,211,0,212,G
3-PA,37,210,0,0,0,210,A
3-PA,38,0,217,0,0,217,T
3-PA,39,0,220,0,0,220,T
3-PA,40,0,0,219,0,219,G
3-PA,41,0,220,0,0,220,T
3-PA,42,0,0,0,219,219,C
3-PA,43,0,2,217,0,219,G
3-PA,44,218,0,0,0,218,A
3-PA,45,219,0,0,0,219,A
3-PA,46,0,0,0,224,224,C
3-PA,47,0,222,0,0,222,T
3-PA,48,0,227,0,0,227,T
3-PA,49,0,0,228,0,228,G
3-PA,50,0,0,0,229,229,C
3-PA,51,230,0,0,0,230,A
3-PA,52,0,0,230,0,230,G
3-PA,53,230,0,0,0,230,A
3-PA,54,230,0,0,0,230,A
3-PA,55,230,0,0,0,230,A
3-PA,56,230,0,0,0,230,A
3-PA,57,231,0,0,0,231,A
3-PA,58,0,0,231,0,231,G
3-PA,59,0,0,0,245,245,C
3-PA,60,248,0,0,0,248,A
3-PA,61,271,0,0,0,271,A
3-PA,62,0,272,0,0,272,T
3-PA,63,0,3,274,0,277,G
3-PA,64,281,0,0,0,281,A
3-PA,65,281,0,0,0,281,A
3-PA,66,279,0,2,0,281,A
3-PA,67,0,0,289,0,289,G
3-PA,68,303,0,0,0,303,A
3-PA,69,0,0,350,0,350,G
3-PA,70,0,345,0,0,345,T
3-PA,71,352,0,0,0,352,A
3-PA,72,0,350,0,1,351,T
3-PA,73,0,1,352,1,354,G
3-PA,74,1,1,353,0,355,G
3-PA,75,0,0,352,0,352,G
3-PA,76,0,1,347,0,348,G
3-PA,77,349,0,0,0,349,A
3-PA,78,0,2,348,0,350,G
3-PA,79,0,2,354,0,356,G
3-PA,80,355,0,0,0,355,A
3-PA,81,0,363,0,0,363,T
3-PA,82,0,1,0,364,365,C
3-PA,83,0,364,0,0,364,T
3-PA,84,1,0,367,0,368,G
3-PA,85,365,0,0,0,365,A
3-PA,86,369,0,0,0,369,A
3-PA,87,369,0,0,0,369,A
3-PA,88,368,0,0,0,368,A
3-PA,89,0,366,0,0,366,T
3-PA,90,0,368,0,0,368,T
3-PA,91,0,2,365,0,367,G
3-PA,92,366,0,1,0,367,A
3-PA,93,365,0,2,0,367,A
3-PA,94,365,1,0,0,366,A
3-PA,95,0,0,0,368,368,C
3-PA,96,366,0,0,0,366,A
3-PA,97,365,0,0,0,365,A
3-PA,98,369,0,0,0,369,A
3-PA,99,0,0,0,373,373,C
3-PA,100,370,0,0,0,370,A
3-PA,101,375,0,0,0,375,A
3-PA,102,376,0,1,0,377,A
3-PA,103,0,378,0,0,378,T
3-PA,104,0,378,0,0,378,T
3-PA,105,0,377,0,0,377,T
3-PA,106,0,0,379,0,379,G
3-PA,107,0,0,1,380,381,C
3-PA,108,381,0,0,0,381,A
3-PA,109,0,0,398,0,398,G
3-PA,110,0,0,0,396,396,C
3-PA,111,418,0,0,0,418,A
3-PA,112,421,0,0,0,421,A
3-PA,113,0,425,0,0,425,T
3-PA,114,432,0,0,0,432,A
3-PA,115,0,433,0,0,433,T
3-PA,116,0,0,440,0,440,G
3-PA,117,0,1,0,439,440,C
3-PA,118,431,0,0,0,431,A
3-PA,119,0,0,0,436,436,C
3-PA,120,0,430,0,0,430,T
3-PA,121,0,0,0,491,491,C
3-PA,122,505,0,1,0,506,A
3-PA,123,0,0,0,509,509,C
3-PA,124,0,507,0,0,507,T
3-PA,125,0,502,0,1,503,T
3-PA,126,0,0,508,0,508,G
3-PA,127,0,1,507,0,508,G
3-PA,128,502,0,1,0,503,A
3-PA,129,0,1,511,0,512,G
3-PA,130,0,1,507,0,508,G
3-PA,131,0,476,0,0,476,T
3-PA,132,0,0,504,0,504,G
3-PA,133,0,500,0,0,500,T
3-PA,134,1,0,515,0,516,G
3-PA,135,0,516,0,0,516,T
3-PA,136,0,513,0,0,513,T
3-PA,137,0,516,0,1,517,T
3-PA,138,0,0,0,518,518,C
3-PA,139,521,0,0,0,521,A
3-PA,140,0,520,0,0,520,T
3-PA,141,0,0,533,0,533,G
3-PA,142,0,527,0,0,527,T
3-PA,143,529,0,1,0,530,A
3-PA,144,0,532,0,0,532,T
3-PA,145,0,532,0,0,532,T
3-PA,146,1,0,0,529,530,C
3-PA,147,528,0,0,0,528,A
3-PA,148,0,1,539,1,541,G
3-PA,149,537,0,0,0,537,A
3-PA,150,0,537,0,0,537,T
3-PA,151,0,534,0,0,534,T
3-PA,152,0,537,0,0,537,T
3-PA,153,1,0,0,529,530,C
3-PA,154,0,0,0,535,535,C
3-PA,155,539,0,1,0,540,A
3-PA,156,0,544,0,0,544,T
3-PA,157,0,536,0,0,536,T
3-PA,158,0,536,0,0,536,T
3-PA,159,1,1,0,535,537,C
3-PA,160,538,1,0,0,539,A
3-PA,161,0,564,0,0,564,T
3-PA,162,2,0,0,564,566,C
3-PA,163,564,0,0,0,564,A
3-PA,164,569,0,0,0,569,A
3-PA,165,0,569,0,0,569,T
3-PA,166,0,2,582,0,584,G
3-PA,167,587,0,0,0,587,A
3-PA,168,585,0,0,0,585,A
3-PA,169,0,0,0,586,586,C
3-PA,170,582,0,1,0,583,A
3-PA,171,586,0,0,0,586,A
3-PA,172,0,1,589,0,590,G
3-PA,173,0,0,594,0,594,G
3-PA,174,0,0,0,592,592,C
3-PA,175,1,5,579,0,585,G
3-PA,176,612,0,0,0,612,A
3-PA,177,620,0,1,0,621,A
3-PA,178,0,623,0,0,623,T
3-PA,179,0,0,0,632,632,C
3-PA,180,634,0,0,0,634,A
3-PA,181,635,0,0,0,635,A
3-PA,182,0,639,0,0,639,T
3-PA,183,635,0,0,0,635,A
3-PA,184,1,0,652,0,653,G
3-PA,185,1,655,0,0,656,T
3-PA,186,0,3,654,0,657,G
3-PA,187,3,1,656,0,660,G
3-PA,188,0,652,0,0,652,T
3-PA,189,656,0,1,0,657,A
3-PA,190,1,4,666,0,671,G
3-PA,191,670,0,1,0,671,A
3-PA,192,668,0,0,1,669,A
3-PA,193,0,0,0,674,674,C
3-PA,194,0,661,0,0,661,T
3-PA,195,0,660,0,0,660,T
3-PA,196,0,1,660,0,661,G
3-PA,197,652,0,1,0,653,A
3-PA,198,0,0,0,658,658,C
3-PA,199,0,1,657,0,658,G
3-PA,200,673,0,0,0,673,A
3-PA,201,0,681,0,0,681,T
3-PA,202,2,0,0,692,694,C
3-PA,203,4,0,0,701,705,C
3-PA,204,705,0,0,0,705,A
3-PA,205,704,0,1,0,705,A
3-PA,206,708,0,0,0,708,A
3-PA,207,0,709,0,0,709,T
3-PA,208,1,1,708,0,710,G
3-PA,209,0,0,0,700,700,C
3-PA,210,700,0,0,0,700,A
3-PA,211,2,0,0,713,715,C
3-PA,212,0,700,0,0,700,T
3-PA,213,0,0,817,0,817,G
3-PA,214,0,815,0,0,815,T
3-PA,215,0,814,0,0,814,T
3-PA,216,818,0,0,0,818,A
3-PA,217,815,0,0,0,815,A
3-PA,218,815,0,1,0,816,A
3-PA,219,0,1,813,0,814,G
3-PA,220,0,0,0,799,799,C
3-PA,221,783,0,0,0,783,A
3-PA,222,0,1,0,791,792,C
3-PA,223,740,0,0,0,740,A
3-PA,224,0,0,765,0,765,G
3-PA,225,759,0,0,0,759,A
3-PA,226,0,764,0,0,764,T
3-PA,227,1,765,1,0,767,T
3-PA,228,0,763,0,0,763,T
3-PA,229,0,1,762,0,763,G
3-PA,230,762,0,1,0,763,A
3-PA,231,763,0,0,0,763,A
3-PA,232,761,0,0,0,761,A
3-PA,233,0,749,0,2,751,T
3-PA,234,753,0,0,0,753,A
3-PA,235,757,0,1,0,758,A
3-PA,236,0,760,0,0,760,T
3-PA,237,0,0,0,758,758,C
3-PA,238,0,1,759,0,760,G
3-PA,239,753,0,0,0,753,A
3-PA,240,0,3,761,0,764,G
3-PA,241,0,2,767,0,769,G
3-PA,242,0,1,767,0,768,G
3-PA,243,0,1,766,0,767,G
3-PA,244,758,1,1,0,760,A
3-PA,245,0,1,762,0,763,G
3-PA,246,784,0,1,0,785,A
3-PA,247,0,0,789,0,789,G
3-PA,248,790,0,2,0,792,A
3-PA,249,0,0,0,796,796,C
3-PA,250,781,0,0,0,781,A
3-PA,251,0,2,787,0,789,G
3-PA,252,786,0,2,0,788,A
3-PA,253,799,0,0,0,799,A
3-PA,254,1,0,0,796,797,C
3-PA,255,774,0,0,0,774,A
3-PA,256,774,0,0,0,774,A
3-PA,257,0,772,0,0,772,T
3-PA,258,0,1,784,0,785,G
3-PA,259,2,0,790,0,792,G
3-PA,260,0,0,0,784,784,C
3-PA,261,0,0,0,786,786,C
3-PA,262,0,785,0,0,785,T
3-PA,263,0,1,813,0,814,G
3-PA,264,0,0,813,0,813,G
3-PA,265,807,0,0,0,807,A
3-PA,266,0,0,0,819,819,C
3-PA,267,784,1,0,0,785,A
3-PA,268,0,0,889,0,889,G
3-PA,269,0,882,0,0,882,T
3-PA,270,894,0,0,0,894,A
3-PA,271,0,0,900,0,900,G
3-PA,272,0,877,0,0,877,T
3-PA,273,884,0,1,0,885,A
3-PA,274,883,0,0,0,883,A
3-PA,275,879,0,0,0,879,A
3-PA,276,0,0,0,895,895,C
3-PA,277,842,0,0,0,842,A
3-PA,278,1,0,866,0,867,G
3-PA,279,0,859,0,0,859,T
3-PA,280,873,0,0,0,873,A
3-PA,281,0,866,0,1,867,T
3-PA,282,1,0,0,876,877,C
3-PA,283,0,878,0,0,878,T
3-PA,284,0,0,876,0,876,G
3-PA,285,0,0,0,874,874,C
3-PA,286,876,0,0,0,876,A
3-PA,287,875,0,1,0,876,A
3-PA,288,0,0,0,875,875,C
3-PA,289,868,0,0,0,868,A
3-PA,290,0,0,0,908,908,C
3-PA,291,0,887,0,1,888,T
3-PA,292,901,0,0,0,901,A
3-PA,293,0,0,0,903,903,C
3-PA,294,0,892,0,0,892,T
3-PA,295,0,0,897,0,897,G
3-PA,296,0,1,896,0,897,G
3-PA,297,884,0,1,0,885,A
3-PA,298,0,1,884,0,885,G
3-PA,299,0,0,0,865,865,C
3-PA,300,0,865,0,2,867,T
3-PA,301,0,1,866,0,867,G
3-PA,302,0,1,863,0,864,G
3-PA,303,864,0,0,0,864,A
3-PA,304,867,0,0,0,867,A
3-PA,305,869,0,0,0,869,A
3-PA,306,867,0,0,0,867,A
3-PA,307,0,0,0,865,865,C
3-PA,308,5,0,0,861,866,C
3-PA,309,1,0,864,0,865,G
3-PA,310,854,0,0,0,854,A
3-PA,311,862,0,0,0,862,A
3-PA,312,0,0,865,0,865,G
3-PA,313,0,863,0,0,863,T
3-PA,314,0,865,0,0,865,T
3-PA,315,0,867,0,0,867,T
3-PA,316,0,0,0,872,872,C
3-PA,317,0,874,0,0,874,T
3-PA,318,872,0,0,0,872,A
3-PA,319,0,0,0,877,877,C
3-PA,320,0,1,0,872,873,C
3-PA,321,865,0,0,0,865,A
3-PA,322,0,0,878,0,878,G
3-PA,323,876,1,0,0,877,A
3-PA,324,0,876,0,1,877,T
3-PA,325,0,876,0,0,876,T
3-PA,326,0,872,0,1,873,T
3-PA,327,0,0,873,0,873,G
3-PA,328,0,871,0,0,871,T
3-PA,329,870,0,0,0,870,A
3-PA,330,0,876,0,0,876,T
3-PA,331,1,1,860,0,862,G
3-PA,332,899,0,0,0,899,A
3-PA,333,0,901,0,0,901,T
3-PA,334,0,903,0,1,904,T
3-PA,335,903,0,0,0,903,A
3-PA,336,0,0,1,908,909,C
3-PA,337,905,0,0,0,905,A
3-PA,338,910,0,0,0,910,A
3-PA,339,0,1,909,0,910,G
3-PA,340,0,3,921,0,924,G
3-PA,341,887,0,0,0,887,A
3-PA,342,0,1,898,0,899,G
3-PA,343,899,0,1,0,900,A
3-PA,344,896,0,0,0,896,A
3-PA,345,1,0,0,895,896,C
3-PA,346,884,0,0,0,884,A
3-PA,347,0,2,885,0,887,G
3-PA,348,882,0,1,0,883,A
3-PA,349,0,878,0,0,878,T
3-PA,350,0,874,0,0,874,T
3-PA,351,1,0,0,866,867,C
3-PA,352,862,0,0,0,862,A
3-PA,353,0,864,0,0,864,T
3-PA,354,1,0,0,869,870,C
3-PA,355,0,0,868,0,868,G
3-PA,356,864,1,0,0,865,A
3-PA,357,873,0,0,0,873,A
3-PA,358,872,0,0,0,872,A
3-PA,359,0,871,0,0,871,T
3-PA,360,0,870,0,0,870,T
3-PA,361,0,1,868,0,869,G
3-PA,362,0,0,867,0,867,G
3-PA,363,0,0,871,0,871,G
3-PA,364,0,1,870,0,871,G
3-PA,365,0,860,0,0,860,T
3-PA,366,0,3,869,0,872,G
3-PA,367,879,0,1,0,880,A
3-PA,368,0,0,0,886,886,C
3-PA,369,891,0,2,0,893,A
3-PA,370,888,0,0,0,888,A
3-PA,371,2,1,896,0,899,G
3-PA,372,0,3,898,0,901,G
3-PA,373,884,0,2,0,886,A
3-PA,374,0,1,892,0,893,G
3-PA,375,877,0,0,0,877,A
3-PA,376,0,0,880,0,880,G
3-PA,377,873,0,0,0,873,A
3-PA,378,870,0,3,0,873,A
3-PA,379,0,0,908,0,908,G
3-PA,380,0,890,0,0,890,T
3-PA,381,1,0,0,899,900,C
3-PA,382,4,1,0,905,910,C
3-PA,383,908,0,1,0,909,A
3-PA,384,0,0,0,926,926,C
3-PA,385,945,0,0,0,945,A
3-PA,386,0,964,0,4,968,T
3-PA,387,981,0,0,0,981,A
3-PA,388,0,966,0,0,966,T
3-PA,389,964,0,0,0,964,A
3-PA,390,0,948,0,2,950,T
3-PA,391,0,949,0,0,949,T
3-PA,392,970,0,0,0,970,A
3-PA,393,0,0,0,972,972,C
3-PA,394,1,0,0,952,953,C
3-PA,395,0,933,0,2,935,T
3-PA,396,0,912,0,0,912,T
3-PA,397,0,1,911,0,912,G
3-PA,398,915,0,0,0,915,A
3-PA,399,917,0,0,0,917,A
3-PA,400,916,0,1,0,917,A
3-PA,401,879,0,3,0,882,A
3-PA,402,0,2,883,0,885,G
3-PA,403,0,0,889,0,889,G
3-PA,404,0,0,0,890,890,C
3-PA,405,2,0,0,886,888,C
3-PA,406,890,0,0,0,890,A
3-PA,407,889,0,0,0,889,A
3-PA,408,0,889,0,0,889,T
3-PA,409,887,0,0,0,887,A
3-PA,410,883,0,0,0,883,A
3-PA,411,4,0,888,0,892,G
3-PA,412,891,0,0,0,891,A
3-PA,413,0,886,0,0,886,T
3-PA,414,0,884,0,0,884,T
3-PA,415,886,0,0,0,886,A
3-PA,416,889,0,0,0,889,A
3-PA,417,893,0,0,0,893,A
3-PA,418,0,894,0,0,894,T
3-PA,419,3,0,0,897,900,C
3-PA,420,0,879,1,0,880,T
3-PA,421,0,2,889,0,891,G
3-PA,422,889,0,1,0,890,A
3-PA,423,0,2,900,0,902,G
3-PA,424,898,0,0,0,898,A
3-PA,425,903,0,0,0,903,A
3-PA,426,0,0,0,907,907,C
3-PA,427,904,0,0,0,904,A
3-PA,428,0,0,0,909,909,C
3-PA,429,905,0,1,0,906,A
3-PA,430,0,0,0,919,919,C
3-PA,431,912,0,1,0,913,A
3-PA,432,0,0,0,935,935,C
3-PA,433,930,0,0,0,930,A
3-PA,434,0,923,0,0,923,T
3-PA,435,0,916,1,1,918,T
3-PA,436,4,1,1,921,927,C
3-PA,437,906,0,0,0,906,A
3-PA,438,0,0,0,923,923,C
3-PA,439,918,0,0,0,918,A
3-PA,440,0,913,0,0,913,T
3-PA,441,0,900,0,0,900,T
3-PA,442,0,917,0,0,917,T
3-PA,443,0,918,1,0,919,T
3-PA,444,3,0,0,923,926,C
3-PA,445,0,920,0,2,922,T
3-PA,446,4,1,0,928,933,C
3-PA,447,932,0,0,0,932,A
3-PA,448,0,934,0,1,935,T
3-PA,449,0,938,0,3,941,T
3-PA,450,3,0,0,941,944,C
3-PA,451,937,0,0,0,937,A
3-PA,452,0,0,0,952,952,C
3-PA,453,0,936,0,0,936,T
3-PA,454,0,0,965,0,965,G
3-PA,455,1,2,960,0,963,G
3-PA,456,0,1,963,0,964,G
3-PA,457,0,0,960,0,960,G
3-PA,458,956,0,2,0,958,A
3-PA,459,0,0,966,0,966,G
3-PA,460,1,0,964,0,965,G
3-PA,461,950,0,0,0,950,A
3-PA,462,960,0,0,0,960,A
3-PA,463,939,0,0,0,939,A
3-PA,464,0,925,0,0,925,T
3-PA,465,0,1,919,0,920,G
3-PA,466,0,1,913,0,914,G
3-PA,467,1,0,0,920,921,C
3-PA,468,0,0,0,923,923,C
3-PA,469,923,0,0,0,923,A
3-PA,470,1,0,0,924,925,C
3-PA,471,933,0,0,0,933,A
3-PA,472,935,0,1,0,936,A
3-PA,473,935,0,0,0,935,A
3-PA,474,0,1,934,0,935,G
3-PA,475,0,0,931,0,931,G
3-PA,476,3,0,0,927,930,C
3-PA,477,923,0,1,0,924,A
3-PA,478,0,0,942,0,942,G
3-PA,479,936,0,0,0,936,A
3-PA,480,0,0,0,954,954,C
3-PA,481,0,943,0,0,943,T
3-PA,482,950,0,0,0,950,A
3-PA,483,0,1,0,946,947,C
3-PA,484,929,0,0,0,929,A
3-PA,485,0,1,0,942,943,C
3-PA,486,1,907,0,0,908,T
3-PA,487,0,2,0,919,921,C
3-PA,488,0,897,0,0,897,T
3-PA,489,2,0,0,900,902,C
3-PA,490,0,2,893,0,895,G
3-PA,491,897,0,0,0,897,A
3-PA,492,0,0,0,894,894,C
3-PA,493,0,1,908,0,909,G
3-PA,494,899,0,1,0,900,A
3-PA,495,0,1,904,0,905,G
3-PA,496,0,1,898,0,899,G
3-PA,497,901,0,0,0,901,A
3-PA,498,897,0,0,0,897,A
3-PA,499,901,0,0,0,901,A
3-PA,500,0,1,898,1,900,G
3-PA,501,0,0,0,895,895,C
3-PA,502,888,1,1,0,890,A
3-PA,503,0,2,911,0,913,G
3-PA,504,0,1,916,0,917,G
3-PA,505,0,0,915,0,915,G
3-PA,506,0,0,0,922,922,C
3-PA,507,0,915,0,0,915,T
3-PA,508,915,0,3,0,918,A
3-PA,509,0,0,924,0,924,G
3-PA,510,0,3,952,0,955,G
3-PA,511,954,1,0,0,955,A
3-PA,512,0,934,0,0,934,T
3-PA,513,0,921,0,0,921,T
3-PA,514,921,0,0,0,921,A
3-PA,515,933,1,0,0,934,A
3-PA,516,0,2,940,0,942,G
3-PA,517,933,0,1,0,934,A
3-PA,518,1,0,0,929,930,C
3-PA,519,1,1,0,876,878,C
3-PA,520,880,0,1,0,881,A
3-PA,521,0,0,878,0,878,G
3-PA,522,0,2,879,0,881,G
3-PA,523,1,0,0,879,880,C
3-PA,524,0,834,0,0,834,T
3-PA,525,0,0,850,0,850,G
3-PA,526,0,845,0,2,847,T
3-PA,527,0,843,0,1,844,T
3-PA,528,7,0,0,818,825,C
3-PA,529,830,0,0,0,830,A
3-PA,530,0,0,0,842,842,C
3-PA,531,2,0,0,850,852,C
3-PA,532,849,0,0,0,849,A
3-PA,533,0,845,0,0,845,T
3-PA,534,824,0,0,0,824,A
3-PA,535,822,0,1,0,823,A
3-PA,536,0,0,830,0,830,G
3-PA,537,818,0,1,0,819,A
3-PA,538,1,1,0,829,831,C
3-PA,539,793,0,0,0,793,A
3-PA,540,795,0,0,0,795,A
3-PA,541,0,1,798,0,799,G
3-PA,542,792,0,2,0,794,A
3-PA,543,792,0,0,0,792,A
3-PA,544,790,0,0,0,790,A
3-PA,545,0,776,0,0,776,T
3-PA,546,0,1,794,0,795,G
3-PA,547,0,0,792,0,792,G
3-PA,548,0,0,0,791,791,C
3-PA,549,0,785,0,0,785,T
3-PA,550,793,0,0,0,793,A
3-PA,551,806,0,0,0,806,A
3-PA,552,0,0,0,807,807,C
3-PA,553,811,0,0,0,811,A
3-PA,554,0,0,799,0,799,G
3-PA,555,777,0,1,0,778,A
3-PA,556,0,0,772,0,772,G
3-PA,557,0,0,779,0,779,G
3-PA,558,0,0,0,783,783,C
3-PA,559,2,0,0,778,780,C
3-PA,560,0,778,0,1,779,T
3-PA,561,1,0,0,794,795,C
3-PA,562,0,795,0,0,795,T
3-PA,563,0,0,795,0,795,G
3-PA,564,0,0,796,0,796,G
3-PA,565,0,1,792,0,793,G
3-PA,566,781,0,0,0,781,A
3-PA,567,0,758,0,1,759,T
3-PA,568,0,738,1,1,740,T
3-PA,569,1,0,0,922,923,C
3-PA,570,0,0,0,921,921,C
3-PA,571,0,919,0,3,922,T
3-PA,572,0,919,0,1,920,T
3-PA,573,0,924,0,0,924,T
3-PA,574,1,0,0,940,941,C
3-PA,575,0,0,942,1,943,G
3-PA,576,0,936,0,0,936,T
3-PA,577,0,0,0,943,943,C
3-PA,578,925,0,0,0,925,A
3-PA,579,0,1,1185,0,1186,G
3-PA,580,0,1180,0,0,1180,T
3-PA,581,1,0,0,1184,1185,C
3-PA,582,3,0,0,1200,1203,C
3-PA,583,2,1,1208,4,1215,G
3-PA,584,1206,0,1,1,1208,A
3-PA,585,1215,0,0,0,1215,A
3-PA,586,1214,0,0,1,1215,A
3-PA,587,0,0,1264,0,1264,G
3-PA,588,1233,0,1,0,1234,A
3-PA,589,0,3,1264,0,1267,G
3-PA,590,0,1,1265,0,1266,G
3-PA,591,1,0,0,1267,1268,C
3-PA,592,0,0,1276,0,1276,G
3-PA,593,1281,0,0,0,1281,A
3-PA,594,1288,0,1,0,1289,A
3-PA,595,0,3,1289,0,1292,G
3-PA,596,1312,0,0,0,1312,A
3-PA,597,1305,0,2,0,1307,A
3-PA,598,1301,0,1,0,1302,A
3-PA,599,0,0,0,1330,1330,C
3-PA,600,1323,0,0,0,1323,A
3-PA,601,1328,0,0,0,1328,A
3-PA,602,0,1335,0,1,1336,T
3-PA,603,0,1334,0,1,1335,T
3-PA,604,0,3,1335,0,1338,G
3-PA,605,1327,0,0,0,1327,A
3-PA,606,1333,1,2,0,1336,A
3-PA,607,0,2,1336,0,1338,G
3-PA,608,1333,0,0,0,1333,A
3-PA,609,1338,0,0,0,1338,A
3-PA,610,1336,0,0,0,1336,A
3-PA,611,1334,0,0,0,1334,A
3-PA,612,1340,0,1,0,1341,A
3-PA,613,0,1346,1,0,1347,T
3-PA,614,0,1346,0,0,1346,T
3-PA,615,0,1345,0,0,1345,T
3-PA,616,0,1,1348,0,1349,G
3-PA,617,1339,0,2,1,1342,A
3-PA,618,1353,0,0,0,1353,A
3-PA,619,1358,0,0,0,1358,A
3-PA,620,0,1394,0,0,1394,T
3-PA,621,2,1,0,1564,1567,C
3-PA,622,1560,1,0,0,1561,A
3-PA,623,2,1,0,1603,1606,C
3-PA,624,1596,0,2,1,1599,A
3-PA,625,0,1,1637,0,1638,G
3-PA,626,1,8,1704,0,1713,G
3-PA,627,1735,0,18,0,1753,A
3-PA,628,1786,0,0,1,1787,A
3-PA,629,0,0,0,1818,1818,C
3-PA,630,0,1768,1,1,1770,T
3-PA,631,1989,0,0,0,1989,A
3-PA,632,0,2028,0,1,2029,T
3-PA,633,2,1,2138,0,2141,G
3-PA,634,0,2,0,2131,2133,C
3-PA,635,0,0,2119,0,2119,G
3-PA,636,0,2110,0,1,2111,T
3-PA,637,2110,0,0,0,2110,A
3-PA,638,1,5,2135,0,2141,G
3-PA,639,2,0,2114,0,2116,G
3-PA,640,0,1,0,2097,2098,C
3-PA,641,0,2073,0,1,2074,T
3-PA,642,0,2056,1,3,2060,T
3-PA,643,1,1,2054,0,2056,G
3-PA,644,0,1,0,2067,2068,C
3-PA,645,5,2,1,2063,2071,C
3-PA,646,0,5,2100,0,2105,G
3-PA,647,2105,0,4,0,2109,A
3-PA,648,3,0,0,2118,2121,C
3-PA,649,4,0,0,2117,2121,C
3-PA,650,2137,0,0,0,2137,A
3-PA,651,2142,0,0,0,2142,A
3-PA,652,2141,0,0,0,2141,A
3-PA,653,0,0,2197,0,2197,G
3-PA,654,0,2176,0,0,2176,T
3-PA,655,0,0,0,2199,2199,C
3-PA,656,0,2195,0,1,2196,T
3-PA,657,9,1,5,2205,2220,C
3-PA,658,1,0,0,2243,2244,C
3-PA,659,4,0,0,2256,2260,C
3-PA,660,2252,0,0,0,2252,A
3-PA,661,0,1,0,2279,2280,C
3-PA,662,1,5,0,2257,2263,C
3-PA,663,1,9,2273,0,2283,G
3-PA,664,2298,0,0,0,2298,A
3-PA,665,2297,0,0,0,2297,A
3-PA,666,0,0,0,2331,2331,C
3-PA,667,0,2318,0,0,2318,T
3-PA,668,0,2357,0,0,2357,T
3-PA,669,1,1,0,2401,2403,C
3-PA,670,0,2386,0,0,2386,T
3-PA,671,8,0,0,2393,2401,C
3-PA,672,4,0,0,2401,2405,C
3-PA,673,0,2389,0,3,2392,T
3-PA,674,0,1,2407,0,2408,G
3-PA,675,1,0,0,2397,2398,C
3-PA,676,6,0,0,2420,2426,C
3-PA,677,0,2411,0,0,2411,T
3-PA,678,0,2407,0,3,2410,T
3-PA,679,1,1,2414,1,2417,G
3-PA,680,2403,1,1,0,2405,A
3-PA,681,8,5,2433,0,2446,G
3-PA,682,2438,0,1,0,2439,A
3-PA,683,2470,0,0,0,2470,A
3-PA,684,0,2537,1,0,2538,T
3-PA,685,0,2559,1,0,2560,T
3-PA,686,0,2548,0,0,2548,T
3-PA,687,0,2564,0,0,2564,T
3-PA,688,2546,0,2,0,2548,A
3-PA,689,0,4,2537,0,2541,G
3-PA,690,2518,0,2,1,2521,A
3-PA,691,0,0,2616,0,2616,G
3-PA,692,1,1,0,2612,2614,C
3-PA,693,3,1,0,2623,2627,C
3-PA,694,0,2703,0,0,2703,T
3-PA,695,2820,0,0,0,2820,A
3-PA,696,1,2834,0,1,2836,T
3-PA,697,0,0,2851,0,2851,G
3-PA,698,1,2838,0,2,2841,T
3-PA,699,1,10,2856,0,2867,G
3-PA,700,1,1,2845,0,2847,G
3-PA,701,2830,0,2,0,2832,A
3-PA,702,0,2797,0,1,2798,T
3-PA,703,0,8,2751,0,2759,G
3-PA,704,0,1,2839,0,2840,G
3-PA,705,2844,0,2,0,2846,A
3-PA,706,0,2847,0,2,2849,T
3-PA,707,0,2849,0,0,2849,T
3-PA,708,6,0,0,2832,2838,C
3-PA,709,11,9,2841,0,2861,G
3-PA,710,2868,0,2,0,2870,A
3-PA,711,2880,0,0,0,2880,A
3-PA,712,3,2,2,2888,2895,C
3-PA,713,2,4,1,2823,2830,C
3-PA,714,10,7,2822,0,2839,G
3-PA,715,2818,0,0,0,2818,A
3-PA,716,2833,1,1,0,2835,A
3-PA,717,0,1,0,2875,2876,C
3-PA,718,1,9,2843,0,2853,G
3-PA,719,2,0,2946,0,2948,G
3-PA,720,4,1,0,2967,2972,C
3-PA,721,0,2952,0,4,2956,T
3-PA,722,0,2,3059,0,3061,G
3-PA,723,1,2,0,3065,3068,C
3-PA,724,3099,0,1,0,3100,A
3-PA,725,0,3092,0,0,3092,T
3-PA,726,0,3061,0,0,3061,T
3-PA,727,0,1,3065,0,3066,G
3-PA,728,2972,1,3,0,2976,A
3-PA,729,0,11,3014,1,3026,G
3-PA,730,0,6,3036,0,3042,G
3-PA,731,4,1,3001,0,3006,G
3-PA,732,1,0,0,3000,3001,C
3-PA,733,3000,0,0,0,3000,A
3-PA,734,3001,0,1,0,3002,A
3-PA,735,0,2,3025,0,3027,G
3-PA,736,0,1,0,3028,3029,C
3-PA,737,0,3042,0,1,3043,T
3-PA,738,1,3054,0,0,3055,T
3-PA,739,0,3056,0,0,3056,T
3-PA,740,4,0,0,3061,3065,C
3-PA,741,1,3062,0,6,3069,T
3-PA,742,7,3,0,3077,3087,C
3-PA,743,3073,0,5,0,3078,A
3-PA,744,3054,0,1,0,3055,A
3-PA,745,3043,0,0,0,3043,A
3-PA,746,0,3043,0,0,3043,T
3-PA,747,0,1,3146,0,3147,G
3-PA,748,1,3119,0,3,3123,T
3-PA,749,3,1,0,3108,3112,C
3-PA,750,1,2,0,3123,3126,C
3-PA,751,3123,0,0,0,3123,A
3-PA,752,3132,0,0,0,3132,A
3-PA,753,3141,0,1,0,3142,A
3-PA,754,0,5,3187,0,3192,G
3-PA,755,3175,1,0,0,3176,A
3-PA,756,3105,0,5,0,3110,A
3-PA,757,0,0,3129,0,3129,G
3-PA,758,0,3076,0,2,3078,T
3-PA,759,1,12,3093,0,3106,G
3-PA,760,3087,0,3,0,3090,A
3-PA,761,3091,0,2,0,3093,A
3-PA,762,0,3103,0,1,3104,T
3-PA,763,0,3,3105,0,3108,G
3-PA,764,1,1,0,3111,3113,C
3-PA,765,8,0,0,3123,3131,C
3-PA,766,11,0,0,3105,3116,C
3-PA,767,3138,0,0,0,3138,A
3-PA,768,3167,0,0,0,3167,A
3-PA,769,3185,0,0,0,3185,A
3-PA,770,0,3189,0,0,3189,T
3-PA,771,0,3181,0,1,3182,T
3-PA,772,3,10,3160,0,3173,G
3-PA,773,3149,0,1,0,3150,A
3-PA,774,3141,0,1,0,3142,A
3-PA,775,1,1,0,3156,3158,C
3-PA,776,6,1,0,3154,3161,C
3-PA,777,1,3111,0,1,3113,T
3-PA,778,0,3216,0,4,3220,T
3-PA,779,0,3226,0,1,3227,T
3-PA,780,0,3312,0,0,3312,T
3-PA,781,4,0,1,3314,3319,C
3-PA,782,0,3305,0,4,3309,T
3-PA,783,0,1,3319,0,3320,G
3-PA,784,3308,0,0,0,3308,A
3-PA,785,3360,0,1,0,3361,A
3-PA,786,1,4,3363,0,3368,G
3-PA,787,3331,0,2,0,3333,A
3-PA,788,1,0,0,3350,3351,C
3-PA,789,3304,0,2,0,3306,A
3-PA,790,3317,0,7,0,3324,A
3-PA,791,3,0,0,3701,3704,C
3-PA,792,3684,0,1,0,3685,A
3-PA,793,0,1,0,3693,3694,C
3-PA,794,9,1,1,3654,3665,C
3-PA,795,3658,0,4,0,3662,A
3-PA,796,3648,0,3,0,3651,A
3-PA,797,2,11,3646,0,3659,G
3-PA,798,3647,0,5,0,3652,A
3-PA,799,3,0,0,3639,3642,C
3-PA,800,13,1,0,3362,3376,C
3-PA,801,3371,0,1,0,3372,A
3-PA,802,3359,0,1,0,3360,A
3-PA,803,0,3372,1,1,3374,T
3-PA,804,7,0,0,3378,3385,C
3-PA,805,3368,0,0,0,3368,A
3-PA,806,3354,0,2,0,3356,A
3-PA,807,3346,0,2,0,3348,A
3-PA,808,0,0,0,3407,3407,C
3-PA,809,0,3367,0,0,3367,T
3-PA,810,0,3398,0,1,3399,T
3-PA,811,4,0,0,3418,3422,C
3-PA,812,7,2,0,3420,3429,C
3-PA,813,3,11,3441,0,3455,G
3-PA,814,3453,0,2,0,3455,A
3-PA,815,3458,0,0,0,3458,A
3-PA,816,0,3443,0,0,3443,T
3-PA,817,0,7,3407,0,3414,G
3-PA,818,0,9,3396,1,3406,G
3-PA,819,3432,0,6,0,3438,A
3-PA,820,2,1,0,3445,3448,C
3-PA,821,5,0,0,3451,3456,C
3-PA,822,0,3553,0,1,3554,T
3-PA,823,9,0,0,3624,3633,C
3-PA,824,5,1,0,3644,3650,C
3-PA,825,1,3649,0,5,3655,T
3-PA,826,1,3676,0,1,3678,T
3-PA,827,1,0,3804,0,3805,G
3-PA,828,0,3770,0,4,3774,T
3-PA,829,0,3776,0,1,3777,T
3-PA,830,3764,1,0,0,3765,A
3-PA,831,1,3612,0,3,3616,T
3-PA,832,7,1,0,3593,3601,C
3-PA,833,3537,0,2,0,3539,A
3-PA,834,0,1,3531,0,3532,G
3-PA,835,2,1,0,3518,3521,C
3-PA,836,3,10,3410,0,3423,G
3-PA,837,1,1,3514,0,3516,G
3-PA,838,0,3491,0,5,3496,T
3-PA,839,9,1,0,3527,3537,C
3-PA,840,9,0,0,3538,3547,C
3-PA,841,3566,0,1,0,3567,A
3-PA,842,3583,0,1,0,3584,A
3-PA,843,3569,0,0,0,3569,A
3-PA,844,0,3568,2,0,3570,T
3-PA,845,0,3554,0,1,3555,T
3-PA,846,8,0,0,3556,3564,C
3-PA,847,7,0,0,3512,3519,C
3-PA,848,0,3517,0,0,3517,T
3-PA,849,5,0,0,3547,3552,C
3-PA,850,3,0,1,3554,3558,C
3-PA,851,0,3539,0,3,3542,T
3-PA,852,0,2,3572,0,3574,G
3-PA,853,3547,2,2,0,3551,A
3-PA,854,0,3572,0,0,3572,T
3-PA,855,2,11,3526,0,3539,G
3-PA,856,1,5,3491,0,3497,G
3-PA,857,3475,0,1,1,3477,A
3-PA,858,0,3459,0,0,3459,T
3-PA,859,3,0,3455,0,3458,G
3-PA,860,0,0,0,3612,3612,C
3-PA,861,0,3591,0,5,3596,T
3-PA,862,0,3604,0,1,3605,T
3-PA,863,0,3619,0,1,3620,T
3-PA,864,3615,0,0,0,3615,A
3-PA,865,3621,0,0,1,3622,A
3-PA,866,3619,0,0,0,3619,A
3-PA,867,3636,0,0,0,3636,A
3-PA,868,0,3623,0,0,3623,T
3-PA,869,0,3359,0,0,3359,T
3-PA,870,0,10,3351,0,3361,G
3-PA,871,3332,0,5,2,3339,A
3-PA,872,0,0,3358,0,3358,G
3-PA,873,0,0,0,3376,3376,C
3-PA,874,3358,0,1,0,3359,A
3-PA,875,0,3445,0,0,3445,T
3-PA,876,0,3436,0,2,3438,T
3-PA,877,1,6,3406,0,3413,G
3-PA,878,3421,0,3,1,3425,A
3-PA,879,3398,0,6,0,3404,A
3-PA,880,1,10,3384,0,3395,G
3-PA,881,3354,0,2,1,3357,A
3-PA,882,1,0,0,3386,3387,C
3-PA,883,4,0,0,3355,3359,C
3-PA,884,7,0,0,3311,3318,C
3-PA,885,3289,0,0,1,3290,A
3-PA,886,3305,0,4,0,3309,A
3-PA,887,3,0,3325,0,3328,G
3-PA,888,1,3311,0,2,3314,T
3-PA,889,8,3,0,3325,3336,C
3-PA,890,3322,0,3,0,3325,A
3-PA,891,0,5,0,3327,3332,C
3-PA,892,1,3,3330,0,3334,G
3-PA,893,3361,0,1,0,3362,A
3-PA,894,3350,0,5,0,3355,A
3-PA,895,0,7,3476,0,3483,G
3-PA,896,0,10,3458,0,3468,G
3-PA,897,3423,0,2,0,3425,A
3-PA,898,1,2,3474,0,3477,G
3-PA,899,3458,0,7,0,3465,A
3-PA,900,3475,0,9,0,3484,A
3-PA,901,2,5,3471,0,3478,G
3-PA,902,0,8,3406,0,3414,G
3-PA,903,1,4,3433,0,3438,G
3-PA,904,3335,0,4,1,3340,A
3-PA,905,1,3367,0,1,3369,T
3-PA,906,4,1,0,3383,3388,C
3-PA,907,5,2,0,3615,3622,C
3-PA,908,9,1,0,3652,3662,C
3-PA,909,3698,0,1,0,3699,A
3-PA,910,0,3723,0,0,3723,T
3-PA,911,0,3738,1,0,3739,T
3-PA,912,3819,1,0,1,3821,A
3-PA,913,0,3809,0,1,3810,T
3-PA,914,3808,0,5,0,3813,A
3-PA,915,0,3780,0,3,3783,T
3-PA,916,0,10,3429,0,3439,G
3-PA,917,3435,0,2,0,3437,A
3-PA,918,0,3404,0,0,3404,T
3-PA,919,0,1,3429,0,3430,G
3-PA,920,0,2,0,3390,3392,C
3-PA,921,2,9,3388,0,3399,G
3-PA,922,3422,1,1,0,3424,A
3-PA,923,1,3405,0,2,3408,T
3-PA,924,5,0,0,3433,3438,C
3-PA,925,3426,0,0,0,3426,A
3-PA,926,3401,0,6,0,3407,A
3-PA,927,0,2,3426,0,3428,G
3-PA,928,0,3387,0,2,3389,T
3-PA,929,4,3,3411,0,3418,G
3-PA,930,3,3,0,3426,3432,C
3-PA,931,3414,1,4,0,3419,A
3-PA,932,0,3435,0,1,3436,T
3-PA,933,3435,0,0,0,3435,A
3-PA,934,3462,0,0,0,3462,A
3-PA,935,3458,0,0,0,3458,A
3-PA,936,3439,0,1,0,3440,A
3-PA,937,3434,0,1,2,3437,A
3-PA,938,1,0,0,3457,3458,C
3-PA,939,3423,0,0,0,3423,A
3-PA,940,0,3415,0,0,3415,T
3-PA,941,0,3438,0,0,3438,T
3-PA,942,3,0,1,3450,3454,C
3-PA,943,0,3421,2,0,3423,T
3-PA,944,0,3426,0,0,3426,T
3-PA,945,0,3407,1,3,3411,T
3-PA,946,0,9,3405,1,3415,G
3-PA,947,3,2,3413,1,3419,G
3-PA,948,3422,0,1,0,3423,A
3-PA,949,0,3412,0,1,3413,T
3-PA,950,1,9,3447,0,3457,G
3-PA,951,0,10,3480,0,3490,G
3-PA,952,3487,0,1,0,3488,A
3-PA,953,3492,0,1,0,3493,A
3-PA,954,3508,0,3,2,3513,A
3-PA,955,1,4,3530,1,3536,G
3-PA,956,3531,0,1,0,3532,A
3-PA,957,3835,1,2,0,3838,A
3-PA,958,0,1,0,3908,3909,C
3-PA,959,6,1,0,3916,3923,C
3-PA,960,0,3889,0,1,3890,T
3-PA,961,0,3958,0,0,3958,T
3-PA,962,3977,0,1,0,3978,A
3-PA,963,0,3970,0,2,3972,T
3-PA,964,3962,0,2,0,3964,A
3-PA,965,0,4003,0,1,4004,T
3-PA,966,3761,0,0,0,3761,A
3-PA,967,1,2,3798,1,3802,G
3-PA,968,0,3757,0,4,3761,T
3-PA,969,5,0,0,3753,3758,C
3-PA,970,3719,1,1,0,3721,A
3-PA,971,3720,0,0,0,3720,A
3-PA,972,3728,0,3,0,3731,A
3-PA,973,0,0,0,3732,3732,C
3-PA,974,6,0,0,3698,3704,C
3-PA,975,3662,0,3,0,3665,A
3-PA,976,1,1,0,3702,3704,C
3-PA,977,3696,0,6,0,3702,A
3-PA,978,0,3,0,3726,3729,C
3-PA,979,1,14,3715,0,3730,G
3-PA,980,3693,0,0,0,3693,A
3-PA,981,3709,0,0,0,3709,A
3-PA,982,3700,0,2,0,3702,A
3-PA,983,3700,1,4,0,3705,A
3-PA,984,2,10,3708,0,3720,G
3-PA,985,0,5,3675,0,3680,G
3-PA,986,2,5,3696,0,3703,G
3-PA,987,3721,0,4,0,3725,A
3-PA,988,3731,0,2,0,3733,A
3-PA,989,0,3726,0,0,3726,T
3-PA,990,3730,0,0,0,3730,A
3-PA,991,3732,0,0,0,3732,A
3-PA,992,3740,0,0,0,3740,A
3-PA,993,0,3738,0,0,3738,T
3-PA,994,2,3717,0,0,3719,T
3-PA,995,11,0,1,3719,3731,C
3-PA,996,3733,0,2,0,3735,A
3-PA,997,3756,2,0,0,3758,A
3-PA,998,3759,0,0,0,3759,A
3-PA,999,0,3745,0,0,3745,T
3-PA,1000,0,3762,0,0,3762,T
3-PA,1001,3774,0,4,1,3779,A
3-PA,1002,2,1,0,3779,3782,C
3-PA,1003,3,0,0,3786,3789,C
3-PA,1004,1,3715,0,3,3719,T
3-PA,1005,1,1,3749,1,3752,G
3-PA,1006,2,0,0,3742,3744,C
3-PA,1007,0,3761,0,0,3761,T
3-PA,1008,1,1,3828,0,3830,G
3-PA,1009,0,3830,0,0,3830,T
3-PA,1010,7,0,0,3843,3850,C
3-PA,1011,3859,0,0,0,3859,A
3-PA,1012,1,3852,0,0,3853,T
3-PA,1013,1,10,3844,0,3855,G
3-PA,1014,0,8,3823,0,3831,G
3-PA,1015,3849,0,0,0,3849,A
3-PA,1016,3940,0,2,0,3942,A
3-PA,1017,0,3,3897,0,3900,G
3-PA,1018,1,0,0,3910,3911,C
3-PA,1019,3900,0,1,1,3902,A
3-PA,1020,3906,0,4,0,3910,A
3-PA,1021,0,1,3929,0,3930,G
3-PA,1022,0,3917,0,1,3918,T
3-PA,1023,3928,1,7,0,3936,A
3-PA,1024,0,1,0,3948,3949,C
3-PA,1025,0,3845,0,4,3849,T
3-PA,1026,0,2,3879,0,3881,G
3-PA,1027,2,3859,0,4,3865,T
3-PA,1028,9,0,0,3870,3879,C
3-PA,1029,3882,0,3,0,3885,A
3-PA,1030,1,9,3902,1,3913,G
3-PA,1031,3902,0,0,0,3902,A
3-PA,1032,3890,0,8,1,3899,A
3-PA,1033,0,3977,0,0,3977,T
3-PA,1034,0,3961,0,1,3962,T
3-PA,1035,3,1,3953,0,3957,G
3-PA,1036,0,3,0,3938,3941,C
3-PA,1037,3927,3,11,0,3941,A
3-PA,1038,4,9,3946,0,3959,G
3-PA,1039,0,13,3904,0,3917,G
3-PA,1040,3916,1,5,0,3922,A
3-PA,1041,2,2,0,3960,3964,C
3-PA,1042,3891,0,2,0,3893,A
3-PA,1043,1,3922,0,3,3926,T
3-PA,1044,0,3944,0,2,3946,T
3-PA,1045,3,4,3958,0,3965,G
3-PA,1046,3962,2,2,0,3966,A
3-PA,1047,3961,0,1,0,3962,A
3-PA,1048,3948,1,0,0,3949,A
3-PA,1049,3944,0,0,0,3944,A
3-PA,1050,1,3902,0,0,3903,T
3-PA,1051,0,7,3930,0,3937,G
3-PA,1052,3893,0,7,0,3900,A
3-PA,1053,0,3,3928,0,3931,G
3-PA,1054,2,11,3914,0,3927,G
3-PA,1055,3895,0,3,0,3898,A
3-PA,1056,1,1,3928,1,3931,G
3-PA,1057,3934,0,1,0,3935,A
3-PA,1058,3940,0,5,0,3945,A
3-PA,1059,1,5,3962,0,3968,G
3-PA,1060,3948,0,3,0,3951,A
3-PA,1061,0,3943,0,2,3945,T
3-PA,1062,0,3918,0,4,3922,T
3-PA,1063,4,0,0,3947,3951,C
3-PA,1064,9,1,0,3952,3962,C
3-PA,1065,3953,0,2,0,3955,A
3-PA,1066,3935,0,3,0,3938,A
3-PA,1067,0,8,3947,0,3955,G
3-PA,1068,0,6,4004,0,4010,G
3-PA,1069,3966,0,2,0,3968,A
3-PA,1070,1,1,0,3990,3992,C
3-PA,1071,0,4001,0,1,4002,T
3-PA,1072,4001,0,0,0,4001,A
3-PA,1073,4005,0,1,0,4006,A
3-PA,1074,4006,0,2,0,4008,A
3-PA,1075,4016,0,2,0,4018,A
3-PA,1076,3983,0,3,5,3991,A
3-PA,1077,0,1,0,3978,3979,C
3-PA,1078,3960,0,1,0,3961,A
3-PA,1079,0,3939,1,0,3940,T
3-PA,1080,2,3,3973,0,3978,G
3-PA,1081,3959,0,6,0,3965,A
3-PA,1082,3966,0,2,0,3968,A
3-PA,1083,0,8,3985,0,3993,G
3-PA,1084,3981,0,0,0,3981,A
3-PA,1085,3982,0,0,0,3982,A
3-PA,1086,3963,0,3,0,3966,A
3-PA,1087,3959,0,7,0,3966,A
3-PA,1088,1,3,0,3975,3979,C
3-PA,1089,3,10,3952,1,3966,G
3-PA,1090,3965,0,6,0,3971,A
3-PA,1091,0,1,3978,0,3979,G
3-PA,1092,2,3934,0,2,3938,T
3-PA,1093,13,1,0,4039,4053,C
3-PA,1094,4083,0,2,0,4085,A
3-PA,1095,4126,0,2,0,4128,A
3-PA,1096,4,0,0,4124,4128,C
3-PA,1097,0,4117,0,3,4120,T
3-PA,1098,0,4,4168,0,4172,G
3-PA,1099,4129,1,8,0,4138,A
3-PA,1100,4156,0,3,0,4159,A
3-PA,1101,0,1,4187,0,4188,G
3-PA,1102,0,4059,0,5,4064,T
3-PA,1103,0,9,4078,1,4088,G
3-PA,1104,0,6,4058,0,4064,G
3-PA,1105,1,0,4084,0,4085,G
3-PA,1106,0,0,0,4084,4084,C
3-PA,1107,0,4040,0,5,4045,T
3-PA,1108,8,0,0,4083,4091,C
3-PA,1109,0,4073,0,0,4073,T
3-PA,1110,0,4066,0,1,4067,T
3-PA,1111,0,15,4156,1,4172,G
3-PA,1112,0,4,4171,0,4175,G
3-PA,1113,0,4121,0,4,4125,T
3-PA,1114,2,14,4128,0,4144,G
3-PA,1115,4119,0,0,0,4119,A
3-PA,1116,4137,0,1,0,4138,A
3-PA,1117,4121,0,3,0,4124,A
3-PA,1118,4148,0,2,3,4153,A
3-PA,1119,0,3,0,4159,4162,C
3-PA,1120,4090,0,3,0,4093,A
3-PA,1121,0,4067,1,5,4073,T
3-PA,1122,0,6,4071,0,4077,G
3-PA,1123,1,1,4129,0,4131,G
3-PA,1124,1,0,0,4138,4139,C
3-PA,1125,4125,3,4,0,4132,A
3-PA,1126,1,0,0,4150,4151,C
3-PA,1127,4,2,0,4166,4172,C
3-PA,1128,4234,1,2,0,4237,A
3-PA,1129,0,7,4265,0,4272,G
3-PA,1130,4237,0,0,0,4237,A
3-PA,1131,8,2,4294,0,4304,G
3-PA,1132,4288,0,2,1,4291,A
3-PA,1133,4272,0,2,1,4275,A
3-PA,1134,1,6,4306,0,4313,G
3-PA,1135,0,0,4288,0,4288,G
3-PA,1136,0,4199,1,1,4201,T
3-PA,1137,4225,0,2,0,4227,A
3-PA,1138,2,7,4201,0,4210,G
3-PA,1139,4189,0,0,0,4189,A
3-PA,1140,1,0,0,4219,4220,C
3-PA,1141,0,4162,1,2,4165,T
3-PA,1142,0,4140,0,2,4142,T
3-PA,1143,0,4150,0,4,4154,T
3-PA,1144,1,3,4155,0,4159,G
3-PA,1145,4143,0,2,0,4145,A
3-PA,1146,4149,0,1,0,4150,A
3-PA,1147,4141,0,1,1,4143,A
3-PA,1148,4103,0,1,0,4104,A
3-PA,1149,2,0,0,4217,4219,C
3-PA,1150,1,4177,1,0,4179,T
3-PA,1151,3,0,4251,0,4254,G
3-PA,1152,0,1,1,4254,4256,C
3-PA,1153,4262,3,2,0,4267,A
3-PA,1154,0,4,4254,0,4258,G
3-PA,1155,4245,1,7,0,4253,A
3-PA,1156,0,4,4426,0,4430,G
3-PA,1157,4430,1,3,0,4434,A
3-PA,1158,3,1,0,4346,4350,C
3-PA,1159,4339,0,2,1,4342,A
3-PA,1160,0,4293,1,0,4294,T
3-PA,1161,4297,0,5,0,4302,A
3-PA,1162,1,9,4123,0,4133,G
3-PA,1163,1,0,4127,0,4128,G
3-PA,1164,1,2,0,4145,4148,C
3-PA,1165,2,12,4167,0,4181,G
3-PA,1166,4239,4,2,1,4246,A
3-PA,1167,0,4230,1,1,4232,T
3-PA,1168,0,4232,0,2,4234,T
3-PA,1169,0,4242,1,0,4243,T
3-PA,1170,9,3,4245,0,4257,G
3-PA,1171,4249,0,2,0,4251,A
3-PA,1172,4255,0,5,2,4262,A
3-PA,1173,1,2,4266,0,4269,G
3-PA,1174,1,2,0,4362,4365,C
3-PA,1175,4302,1,0,1,4304,A
3-PA,1176,4582,0,2,1,4585,A
3-PA,1177,0,4587,1,2,4590,T
3-PA,1178,4623,2,1,0,4626,A
3-PA,1179,0,4633,0,1,4634,T
3-PA,1180,0,5,4646,0,4651,G
3-PA,1181,4684,0,9,0,4693,A
3-PA,1182,1,4686,2,2,4691,T
3-PA,1183,4555,0,1,0,4556,A
3-PA,1184,1,1,4565,0,4567,G
3-PA,1185,1,4363,0,1,4365,T
3-PA,1186,1,10,4361,0,4372,G
3-PA,1187,4357,0,5,1,4363,A
3-PA,1188,1,29,0,4297,4327,C
3-PA,1189,1,20,4284,0,4305,G
3-PA,1190,4319,0,0,0,4319,A
3-PA,1191,4312,0,6,0,4318,A
3-PA,1192,3,0,0,4351,4354,C
3-PA,1193,10,0,0,4357,4367,C
3-PA,1194,0,4327,2,13,4342,T
3-PA,1195,0,10,4444,0,4454,G
3-PA,1196,4414,0,0,0,4414,A
3-PA,1197,4454,0,1,0,4455,A
3-PA,1198,1,4427,0,1,4429,T
3-PA,1199,0,4392,0,0,4392,T
3-PA,1200,4382,1,0,0,4383,A
3-PA,1201,4351,0,6,0,4357,A
3-PA,1202,0,12,4362,0,4374,G
3-PA,1203,10,2,4350,0,4362,G
3-PA,1204,0,4263,0,8,4271,T
3-PA,1205,7,0,0,4265,4272,C
3-PA,1206,4269,0,1,0,4270,A
3-PA,1207,1,1,0,4411,4413,C
3-PA,1208,0,4412,0,3,4415,T
3-PA,1209,2,4410,0,2,4414,T
3-PA,1210,0,4426,1,2,4429,T
3-PA,1211,6,1,1,4406,4414,C
3-PA,1212,4419,0,4,0,4423,A
3-PA,1213,4428,0,0,0,4428,A
3-PA,1214,0,3,4484,0,4487,G
3-PA,1215,1,0,0,4465,4466,C
3-PA,1216,0,4409,0,6,4415,T
3-PA,1217,0,12,4522,0,4534,G
3-PA,1218,1,5,4545,0,4551,G
3-PA,1219,4624,0,3,0,4627,A
3-PA,1220,0,4675,1,0,4676,T
3-PA,1221,4652,0,6,0,4658,A
3-PA,1222,1,3,0,4685,4689,C
3-PA,1223,4619,0,2,0,4621,A
3-PA,1224,3,6,4653,0,4662,G
3-PA,1225,4659,0,3,0,4662,A
3-PA,1226,4575,0,1,0,4576,A
3-PA,1227,1,4500,0,1,4502,T
3-PA,1228,0,18,4541,1,4560,G
3-PA,1229,4517,0,4,0,4521,A
3-PA,1230,0,0,4592,0,4592,G
3-PA,1231,1,4543,1,2,4547,T
3-PA,1232,0,4530,1,0,4531,T
3-PA,1233,11,2,0,4559,4572,C
3-PA,1234,4621,0,0,1,4622,A
3-PA,1235,4607,0,4,0,4611,A
3-PA,1236,2,0,0,4600,4602,C
3-PA,1237,4547,0,2,0,4549,A
3-PA,1238,4558,0,4,0,4562,A
3-PA,1239,0,3,4515,0,4518,G
3-PA,1240,0,0,4543,1,4544,G
3-PA,1241,2,0,0,4536,4538,C
3-PA,1242,5,0,1,4560,4566,C
3-PA,1243,0,4519,0,9,4528,T
3-PA,1244,0,3,4591,0,4594,G
3-PA,1245,0,4557,2,1,4560,T
3-PA,1246,2,10,4620,0,4632,G
3-PA,1247,4633,0,11,0,4644,A
3-PA,1248,1,0,4621,0,4622,G
3-PA,1249,2,1,0,4569,4572,C
3-PA,1250,0,4554,0,1,4555,T
3-PA,1251,4615,0,6,1,4622,A
3-PA,1252,4615,0,2,0,4617,A
3-PA,1253,3,0,0,4640,4643,C
3-PA,1254,0,4603,1,1,4605,T
3-PA,1255,1,9,4591,0,4601,G
3-PA,1256,4568,1,0,0,4569,A
3-PA,1257,0,4557,0,1,4558,T
3-PA,1258,0,4578,0,0,4578,T
3-PA,1259,8,0,0,4566,4574,C
3-PA,1260,4689,0,2,0,4691,A
3-PA,1261,4,2,4783,1,4790,G
3-PA,1262,0,4741,2,1,4744,T
3-PA,1263,8,0,0,4772,4780,C
3-PA,1264,0,4747,0,6,4753,T
3-PA,1265,2,14,4895,0,4911,G
3-PA,1266,1,9,4905,0,4915,G
3-PA,1267,4914,1,1,0,4916,A
3-PA,1268,0,4914,0,3,4917,T
3-PA,1269,4670,0,3,0,4673,A
3-PA,1270,0,5,4650,0,4655,G
3-PA,1271,4565,0,4,0,4569,A
3-PA,1272,6,1,4582,0,4589,G
3-PA,1273,2,0,0,4542,4544,C
3-PA,1274,0,4481,0,1,4482,T
3-PA,1275,12,2,1,4499,4514,C
3-PA,1276,0,4,4547,0,4551,G
3-PA,1277,4552,0,0,0,4552,A
3-PA,1278,1,4537,0,1,4539,T
3-PA,1279,1,7,4533,0,4541,G
3-PA,1280,4584,1,2,0,4587,A
3-PA,1281,4589,0,2,0,4591,A
3-PA,1282,4605,0,2,0,4607,A
3-PA,1283,5,4566,0,0,4571,T
3-PA,1284,0,4547,0,0,4547,T
3-PA,1285,2,10,4531,1,4544,G
3-PA,1286,17,18,4475,0,4510,G
3-PA,1287,7,8,4423,0,4438,G
3-PA,1288,0,6,4495,0,4501,G
3-PA,1289,4505,0,2,0,4507,A
3-PA,1290,0,8,4513,0,4521,G
3-PA,1291,0,9,4530,0,4539,G
3-PA,1292,4592,0,1,0,4593,A
3-PA,1293,0,3,0,4617,4620,C
3-PA,1294,3,0,4581,0,4584,G
3-PA,1295,0,4586,1,0,4587,T
3-PA,1296,4616,0,2,0,4618,A
3-PA,1297,0,2,4624,0,4626,G
3-PA,1298,4,3,0,4643,4650,C
3-PA,1299,9,1,0,4570,4580,C
3-PA,1300,17,2,0,4556,4575,C
3-PA,1301,11,0,0,4577,4588,C
3-PA,1302,4611,0,0,0,4611,A
3-PA,1303,4761,0,0,0,4761,A
3-PA,1304,0,4737,0,2,4739,T
3-PA,1305,0,4678,0,0,4678,T
3-PA,1306,2,9,4662,0,4673,G
3-PA,1307,4599,1,3,0,4603,A
3-PA,1308,5,1,4609,0,4615,G
3-PA,1309,1,1,1,4616,4619,C
3-PA,1310,4588,0,3,0,4591,A
3-PA,1311,2,0,0,4686,4688,C
3-PA,1312,4547,0,0,0,4547,A
3-PA,1313,0,4671,0,2,4673,T
3-PA,1314,0,4663,0,2,4665,T
3-PA,1315,1,2,4680,0,4683,G
3-PA,1316,0,1,0,4647,4648,C
3-PA,1317,4651,1,1,0,4653,A
3-PA,1318,4643,0,5,0,4648,A
3-PA,1319,2,0,4677,0,4679,G
3-PA,1320,1,0,0,4597,4598,C
3-PA,1321,4579,0,0,0,4579,A
3-PA,1322,0,4475,1,1,4477,T
3-PA,1323,1,15,4463,1,4480,G
3-PA,1324,4459,0,3,2,4464,A
3-PA,1325,2,5,4481,0,4488,G
3-PA,1326,4484,0,1,0,4485,A
3-PA,1327,4490,0,1,0,4491,A
3-PA,1328,0,4,4453,0,4457,G
3-PA,1329,1,9,4433,1,4444,G
3-PA,1330,4446,0,4,0,4450,A
3-PA,1331,4448,0,2,1,4451,A
3-PA,1332,0,4451,0,0,4451,T
3-PA,1333,0,4468,0,0,4468,T
3-PA,1334,4484,0,1,0,4485,A
3-PA,1335,1,4473,0,0,4474,T
3-PA,1336,0,4471,0,1,4472,T
3-PA,1337,0,4485,0,0,4485,T
3-PA,1338,8,0,0,4433,4441,C
3-PA,1339,4418,0,2,1,4421,A
3-PA,1340,1,0,0,4510,4511,C
3-PA,1341,4492,0,1,0,4493,A
3-PA,1342,1,2,4533,0,4536,G
3-PA,1343,2,0,0,4519,4521,C
3-PA,1344,4500,0,1,0,4501,A
3-PA,1345,1,7,4522,0,4530,G
3-PA,1346,4495,0,5,0,4500,A
3-PA,1347,0,9,4516,0,4525,G
3-PA,1348,1,2,4531,0,4534,G
3-PA,1349,0,4388,0,7,4395,T
3-PA,1350,1,0,4484,0,4485,G
3-PA,1351,0,4451,0,4,4455,T
3-PA,1352,16,2,1,4422,4441,C
3-PA,1353,10,0,0,4494,4504,C
3-PA,1354,19,0,0,4468,4487,C
3-PA,1355,4529,0,0,0,4529,A
3-PA,1356,2,4569,1,0,4572,T
3-PA,1357,1,4549,1,1,4552,T
3-PA,1358,0,1,4566,0,4567,G
3-PA,1359,0,4440,1,18,4459,T
3-PA,1360,4394,0,3,0,4397,A
3-PA,1361,1,3,4383,0,4387,G
3-PA,1362,4252,0,8,0,4260,A
3-PA,1363,0,11,4257,0,4268,G
3-PA,1364,1,3,0,4181,4185,C
3-PA,1365,12,0,0,4109,4121,C
3-PA,1366,4160,0,2,0,4162,A
3-PA,1367,3,1,0,4171,4175,C
3-PA,1368,0,4139,1,1,4141,T
3-PA,1369,0,6,4145,0,4151,G
3-PA,1370,4146,0,1,0,4147,A
3-PA,1371,4066,0,4,0,4070,A
3-PA,1372,1,4164,1,0,4166,T
3-PA,1373,4214,0,3,0,4217,A
3-PA,1374,3,3,0,4253,4259,C
3-PA,1375,4162,0,1,0,4163,A
3-PA,1376,0,4178,0,4,4182,T
3-PA,1377,4166,0,1,0,4167,A
3-PA,1378,4149,0,0,1,4150,A
3-PA,1379,1,4126,1,2,4130,T
3-PA,1380,1,5,4078,0,4084,G
3-PA,1381,4060,1,0,0,4061,A
3-PA,1382,3971,0,0,0,3971,A
3-PA,1383,0,9,3948,0,3957,G
3-PA,1384,0,12,3905,0,3917,G
3-PA,1385,2,13,3939,0,3954,G
3-PA,1386,0,9,3951,0,3960,G
3-PA,1387,0,0,3995,0,3995,G
3-PA,1388,0,3949,2,2,3953,T
3-PA,1389,3979,0,0,1,3980,A
3-PA,1390,0,4005,1,1,4007,T
3-PA,1391,4072,0,0,0,4072,A
3-PA,1392,1,0,0,4416,4417,C
3-PA,1393,4285,0,0,0,4285,A
3-PA,1394,0,4195,1,3,4199,T
3-PA,1395,0,4180,1,0,4181,T
3-PA,1396,4120,0,0,0,4120,A
3-PA,1397,4207,0,1,0,4208,A
3-PA,1398,2,0,0,4208,4210,C
3-PA,1399,4125,0,2,0,4127,A
3-PA,1400,1,2,0,4125,4128,C
3-PA,1401,0,3678,0,3,3681,T
3-PA,1402,1,1,3804,0,3806,G
3-PA,1403,1,2,0,3779,3782,C
3-PA,1404,11,0,0,3769,3780,C
3-PA,1405,9,1,0,3802,3812,C
3-PA,1406,0,3695,0,1,3696,T
3-PA,1407,3,0,3810,0,3813,G
3-PA,1408,1,0,0,3804,3805,C
3-PA,1409,0,3800,0,0,3800,T
3-PA,1410,10,1,0,3922,3933,C
3-PA,1411,3793,0,1,0,3794,A
3-PA,1412,3822,0,1,0,3823,A
3-PA,1413,0,3824,2,2,3828,T
3-PA,1414,1,0,3817,0,3818,G
3-PA,1415,0,1,0,3787,3788,C
3-PA,1416,3753,0,0,0,3753,A
3-PA,1417,1,3756,0,5,3762,T
3-PA,1418,8,0,0,3727,3735,C
3-PA,1419,3,1,0,3785,3789,C
3-PA,1420,1,3629,0,5,3635,T
3-PA,1421,0,0,3729,0,3729,G
3-PA,1422,0,3705,0,4,3709,T
3-PA,1423,0,0,3693,0,3693,G
3-PA,1424,0,0,0,3699,3699,C
3-PA,1425,3625,0,5,0,3630,A
3-PA,1426,1,0,3670,0,3671,G
3-PA,1427,2,1,0,3651,3654,C
3-PA,1428,3610,1,0,0,3611,A
3-PA,1429,3597,0,1,0,3598,A
3-PA,1430,0,3451,0,1,3452,T
3-PA,1431,0,6,3448,0,3454,G
3-PA,1432,0,4,3448,0,3452,G
3-PA,1433,3458,0,4,0,3462,A
3-PA,1434,2,3,0,3480,3485,C
3-PA,1435,0,5,3463,0,3468,G
3-PA,1436,3513,0,0,0,3513,A
3-PA,1437,0,3515,0,0,3515,T
3-PA,1438,0,3508,0,4,3512,T
3-PA,1439,0,3504,0,0,3504,T
3-PA,1440,1,3484,0,3,3488,T
3-PA,1441,7,4,0,3495,3506,C
3-PA,1442,3513,0,0,0,3513,A
3-PA,1443,3525,1,2,0,3528,A
3-PA,1444,0,1,0,3519,3520,C
3-PA,1445,0,3503,1,1,3505,T
3-PA,1446,3504,0,0,0,3504,A
3-PA,1447,3493,1,2,0,3496,A
3-PA,1448,0,3490,0,3,3493,T
3-PA,1449,0,3492,0,2,3494,T
3-PA,1450,5,0,0,3504,3509,C
3-PA,1451,10,1,0,3493,3504,C
3-PA,1452,18,2,0,3490,3510,C
3-PA,1453,3511,0,0,0,3511,A
3-PA,1454,0,3586,0,4,3590,T
3-PA,1455,0,4,3594,0,3598,G
3-PA,1456,3595,0,2,0,3597,A
3-PA,1457,0,3585,0,1,3586,T
3-PA,1458,3575,0,2,0,3577,A
3-PA,1459,3569,0,5,0,3574,A
3-PA,1460,0,0,3586,0,3586,G
3-PA,1461,0,1,0,3572,3573,C
3-PA,1462,3566,0,0,0,3566,A
3-PA,1463,3448,0,2,0,3450,A
3-PA,1464,3,1,3510,1,3515,G
3-PA,1465,0,3478,0,1,3479,T
3-PA,1466,0,1,3469,0,3470,G
3-PA,1467,3,1,0,3473,3477,C
3-PA,1468,3443,1,3,1,3448,A
3-PA,1469,0,4,3494,0,3498,G
3-PA,1470,3487,0,0,0,3487,A
3-PA,1471,3519,0,6,0,3525,A
3-PA,1472,1,1,0,3533,3535,C
3-PA,1473,0,3461,0,0,3461,T
3-PA,1474,3487,0,0,0,3487,A
3-PA,1475,3481,0,4,0,3485,A
3-PA,1476,3473,0,2,0,3475,A
3-PA,1477,0,3,3481,0,3484,G
3-PA,1478,3333,0,0,0,3333,A
3-PA,1479,1,12,3315,0,3328,G
3-PA,1480,0,7,3231,0,3238,G
3-PA,1481,0,2,3249,0,3251,G
3-PA,1482,3219,1,2,0,3222,A
3-PA,1483,3159,0,3,0,3162,A
3-PA,1484,0,2,3154,0,3156,G
3-PA,1485,0,1,3142,0,3143,G
3-PA,1486,1,2,0,3142,3145,C
3-PA,1487,0,9,3146,0,3155,G
3-PA,1488,3145,0,1,0,3146,A
3-PA,1489,3155,0,3,1,3159,A
3-PA,1490,3151,0,0,1,3152,A
3-PA,1491,3157,1,0,0,3158,A
3-PA,1492,3151,0,3,0,3154,A
3-PA,1493,0,0,0,3153,3153,C
3-PA,1494,6,1,0,3133,3140,C
3-PA,1495,3152,0,0,1,3153,A
3-PA,1496,3184,0,0,0,3184,A
3-PA,1497,0,3173,0,0,3173,T
3-PA,1498,0,3181,0,1,3182,T
3-PA,1499,1,3188,0,0,3189,T
3-PA,1500,3203,0,0,0,3203,A
3-PA,1501,0,3193,0,1,3194,T
3-PA,1502,3190,0,3,0,3193,A
3-PA,1503,0,3178,0,1,3179,T
3-PA,1504,0,9,3142,0,3151,G
3-PA,1505,1,0,3124,0,3125,G
3-PA,1506,3106,1,0,0,3107,A
3-PA,1507,0,3082,0,1,3083,T
3-PA,1508,0,3056,0,0,3056,T
3-PA,1509,5,0,2,3040,3047,C
3-PA,1510,3056,1,0,0,3057,A
3-PA,1511,0,3077,0,3,3080,T
3-PA,1512,3,1,0,3093,3097,C
3-PA,1513,3110,0,3,0,3113,A
3-PA,1514,0,3083,0,0,3083,T
3-PA,1515,3060,0,1,0,3061,A
3-PA,1516,3063,0,1,0,3064,A
3-PA,1517,3057,0,0,0,3057,A
3-PA,1518,0,6,3034,0,3040,G
3-PA,1519,2,8,2985,0,2995,G
3-PA,1520,0,1,2968,0,2969,G
3-PA,1521,2939,1,1,0,2941,A
3-PA,1522,2901,0,4,0,2905,A
3-PA,1523,1,1,2904,0,2906,G
3-PA,1524,2884,1,1,0,2886,A
3-PA,1525,1,2866,0,3,2870,T
3-PA,1526,5,0,0,2866,2871,C
3-PA,1527,0,2806,0,3,2809,T
3-PA,1528,11,0,0,2867,2878,C
3-PA,1529,2878,0,0,0,2878,A
3-PA,1530,0,2872,0,0,2872,T
3-PA,1531,1,2878,0,1,2880,T
3-PA,1532,0,2835,0,0,2835,T
3-PA,1533,2819,0,0,0,2819,A
3-PA,1534,2819,0,3,0,2822,A
3-PA,1535,1,7,2812,0,2820,G
3-PA,1536,0,1,2849,0,2850,G
3-PA,1537,2729,0,0,0,2729,A
3-PA,1538,2718,1,1,0,2720,A
3-PA,1539,0,2710,0,2,2712,T
3-PA,1540,1,4,2717,1,2723,G
3-PA,1541,2777,2,3,0,2782,A
3-PA,1542,1,0,0,2777,2778,C
3-PA,1543,2750,0,2,0,2752,A
3-PA,1544,0,0,0,2751,2751,C
3-PA,1545,2665,0,1,1,2667,A
3-PA,1546,0,3,2684,0,2687,G
3-PA,1547,2664,0,3,0,2667,A
3-PA,1548,0,1,0,2610,2611,C
3-PA,1549,0,1,2576,0,2577,G
3-PA,1550,0,2358,0,1,2359,T
3-PA,1551,0,7,2345,0,2352,G
3-PA,1552,2,0,2363,0,2365,G
3-PA,1553,0,2365,0,0,2365,T
3-PA,1554,2367,0,1,0,2368,A
3-PA,1555,2315,0,2,0,2317,A
3-PA,1556,2313,0,2,0,2315,A
3-PA,1557,0,2302,0,1,2303,T
3-PA,1558,0,2268,0,0,2268,T
3-PA,1559,0,2263,0,0,2263,T
3-PA,1560,0,2232,0,0,2232,T
3-PA,1561,0,0,2227,0,2227,G
3-PA,1562,0,2190,0,1,2191,T
3-PA,1563,0,3,2199,0,2202,G
3-PA,1564,2188,0,7,0,2195,A
3-PA,1565,0,0,2189,0,2189,G
3-PA,1566,0,0,1,2166,2167,C
3-PA,1567,2176,0,0,0,2176,A
3-PA,1568,0,2166,0,3,2169,T
3-PA,1569,0,4,2178,0,2182,G
3-PA,1570,1,6,2177,0,2184,G
3-PA,1571,2170,0,0,0,2170,A
3-PA,1572,1,1,2183,0,2185,G
3-PA,1573,0,2147,3,1,2151,T
3-PA,1574,0,2107,0,2,2109,T
3-PA,1575,0,2109,0,1,2110,T
3-PA,1576,1,2102,0,3,2106,T
3-PA,1577,2,0,0,2105,2107,C
3-PA,1578,0,2079,1,5,2085,T
3-PA,1579,1,0,0,2083,2084,C
3-PA,1580,0,2006,0,1,2007,T
3-PA,1581,5,0,0,1983,1988,C
3-PA,1582,1982,0,0,0,1982,A
3-PA,1583,0,0,0,1983,1983,C
3-PA,1584,0,1892,0,1,1893,T
3-PA,1585,0,4,1884,0,1888,G
3-PA,1586,1869,0,1,0,1870,A
3-PA,1587,3,0,0,1882,1885,C
3-PA,1588,3,0,0,1840,1843,C
3-PA,1589,7,4,0,1818,1829,C
3-PA,1590,0,4,1816,0,1820,G
3-PA,1591,1804,0,3,0,1807,A
3-PA,1592,0,2,1802,0,1804,G
3-PA,1593,1796,0,3,0,1799,A
3-PA,1594,1,2,0,1742,1745,C
3-PA,1595,0,1707,0,0,1707,T
3-PA,1596,0,1588,0,1,1589,T
3-PA,1597,0,2,1585,0,1587,G
3-PA,1598,1568,0,2,0,1570,A
3-PA,1599,0,0,1574,0,1574,G
3-PA,1600,1,0,0,1563,1564,C
3-PA,1601,3,0,0,1488,1491,C
3-PA,1602,1459,0,2,0,1461,A
3-PA,1603,0,0,0,1450,1450,C
3-PA,1604,1454,0,2,0,1456,A
3-PA,1605,0,1456,0,0,1456,T
3-PA,1606,1434,0,0,0,1434,A
3-PA,1607,1426,0,0,0,1426,A
3-PA,1608,1401,0,0,0,1401,A
3-PA,1609,0,1370,0,0,1370,T
3-PA,1610,0,3,1370,0,1373,G
3-PA,1611,2,0,1201,0,1203,G
3-PA,1612,0,1,1173,0,1174,G
3-PA,1613,1133,0,1,0,1134,A
3-PA,1614,0,0,1129,0,1129,G
3-PA,1615,1096,0,0,0,1096,A
3-PA,1616,1060,0,1,0,1061,A
3-PA,1617,1061,0,0,0,1061,A
3-PA,1618,0,1038,0,0,1038,T
3-PA,1619,1011,0,0,0,1011,A
3-PA,1620,5,0,0,1007,1012,C
3-PA,1621,0,460,0,0,460,T
3-PA,1622,1,0,450,0,451,G
3-PA,1623,0,227,0,0,227,T
3-PA,1624,0,0,218,0,218,G
3-PA,1625,0,185,0,0,185,T
3-PA,1626,0,0,0,57,57,C
3-PA,1627,0,0,0,41,41,C
3-PA,1628,0,30,0,0,30,T
3-PA,1629,0,30,0,0,30,T
3-PA,1630,0,0,30,0,30,G
3-PA,1631,29,0,0,0,29,A
3-PA,1632,0,0,29,0,29,G
3-PA,1633,27,0,0,0,27,A
3-PA,1634,0,27,0,0,27,T
3-PA,1635,26,0,0,0,26,A
3-PA,1636,0,0,27,0,27,G
3-PA,1637,0,0,27,0,27,G
3-PA,1638,26,0,0,0,26,A
3-PA,1639,0,0,26,0,26,G
3-PA,1640,25,0,0,0,25,A
3-PA,1641,0,26,0,0,26,T
3-PA,1642,27,0,0,0,27,A
3-PA,1643,0,27,0,0,27,T
3-PA,1644,0,0,26,0,26,G
3-PA,1645,0,28,0,0,28,T
3-PA,1646,0,27,0,0,27,T
3-PA,1647,27,0,0,0,27,A
3-PA,1648,0,0,0,28,28,C
3-PA,1649,0,26,0,0,26,T
3-PA,1650,27,0,0,0,27,A
3-PA,1651,27,0,0,0,27,A
3-PA,1652,0,0,27,0,27,G
3-PA,1653,27,0,0,0,27,A
3-PA,1654,26,0,0,0,26,A
3-PA,1655,0,0,24,0,24,G
3-PA,1656,0,24,0,0,24,T
3-PA,1657,1,0,24,0,25,G
3-PA,1658,0,0,0,25,25,C
3-PA,1659,0,0,0,25,25,C
3-PA,1660,26,0,0,0,26,A
3-PA,1661,0,24,0,0,24,T
3-PA,1662,23,0,0,0,23,A
3-PA,1663,0,0,24,0,24,G
3-PA,1664,0,0,24,0,24,G
3-PA,1665,0,0,0,23,23,C
3-PA,1666,0,0,0,23,23,C
3-PA,1667,24,0,0,0,24,A
3-PA,1668,24,0,0,0,24,A
3-PA,1669,25,0,0,0,25,A
3-PA,1670,0,25,0,0,25,T
3-PA,1671,0,24,0,0,24,T
3-PA,1672,0,24,0,0,24,T
3-PA,1673,0,0,0,25,25,C
3-PA,1674,25,0,0,0,25,A
3-PA,1675,25,0,0,0,25,A
3-PA,1676,0,0,25,0,25,G
3-PA,1677,0,0,26,0,26,G
3-PA,1678,0,0,0,24,24,C
3-PA,1679,0,0,0,25,25,C
3-PA,1680,0,25,0,0,25,T
3-PA,1681,32,0,0,0,32,A
3-PA,1682,0,32,0,0,32,T
3-PA,1683,0,0,33,0,33,G
3-PA,1684,0,33,0,0,33,T
3-PA,1685,0,33,0,0,33,T
3-PA,1686,0,0,0,32,32,C
3-PA,1687,0,33,0,0,33,T
3-PA,1688,0,32,0,0,32,T
3-PA,1689,0,0,32,0,32,G
3-PA,1690,0,32,0,0,32,T
3-PA,1691,32,0,0,0,32,A
3-PA,1692,0,32,0,0,32,T
3-PA,1693,0,0,32,0,32,G
3-PA,1694,0,32,0,0,32,T
3-PA,1695,0,0,33,0,33,G
3-PA,1696,33,0,0,0,33,A
3-PA,1697,0,0,33,0,33,G
3-PA,1698,0,0,33,0,33,G
3-PA,1699,33,0,0,0,33,A
3-PA,1700,0,0,0,33,33,C
3-PA,1701,33,0,0,0,33,A
3-PA,1702,33,0,0,0,33,A
3-PA,1703,33,0,0,0,33,A
3-PA,1704,0,0,0,33,33,C
3-PA,1705,0,0,33,0,33,G
3-PA,1706,0,0,33,0,33,G
3-PA,1707,32,0,0,0,32,A
3-PA,1708,33,0,0,0,33,A
3-PA,1709,0,0,0,33,33,C
3-PA,1710,35,0,0,0,35,A
3-PA,1711,0,34,0,0,34,T
3-PA,1712,0,0,0,35,35,C
3-PA,1713,35,0,0,0,35,A
3-PA,1714,34,0,0,0,34,A
3-PA,1715,34,0,0,0,34,A
3-PA,1716,0,1,32,0,33,G
3-PA,1717,0,0,34,0,34,G
3-PA,1718,0,32,0,0,32,T
3-PA,1719,0,0,0,32,32,C
3-PA,1720,31,0,0,0,31,A
3-PA,1721,33,0,0,0,33,A
3-PA,1722,33,0,0,0,33,A
3-PA,1723,32,0,0,0,32,A
3-PA,1724,0,33,0,0,33,T
3-PA,1725,0,0,33,0,33,G
3-PA,1726,33,0,0,0,33,A
3-PA,1727,33,0,0,0,33,A
3-PA,1728,32,0,0,0,32,A
3-PA,1729,0,34,0,0,34,T
3-PA,1730,0,0,35,0,35,G
3-PA,1731,0,0,35,0,35,G
3-PA,1732,0,0,35,0,35,G
3-PA,1733,0,0,35,0,35,G
3-PA,1734,34,0,0,0,34,A
3-PA,1735,33,0,0,0,33,A
3-PA,1736,0,34,0,0,34,T
3-PA,1737,0,0,36,0,36,G
3-PA,1738,0,0,38,0,38,G
3-PA,1739,39,0,0,0,39,A
3-PA,1740,0,0,39,0,39,G
3-PA,1741,38,0,0,0,38,A
3-PA,1742,0,38,0,0,38,T
3-PA,1743,0,0,38,0,38,G
3-PA,1744,39,0,0,0,39,A
3-PA,1745,0,0,39,0,39,G
3-PA,1746,39,0,0,0,39,A
3-PA,1747,0,0,0,39,39,C
3-PA,1748,0,0,39,0,39,G
3-PA,1749,0,39,0,0,39,T
3-PA,1750,0,39,0,0,39,T
3-PA,1751,0,0,40,0,40,G
3-PA,1752,0,0,0,40,40,C
3-PA,1753,0,0,0,39,39,C
3-PA,1754,0,39,0,0,39,T
3-PA,1755,0,0,0,40,40,C
3-PA,1756,1,0,0,38,39,C
3-PA,1757,0,39,0,0,39,T
3-PA,1758,0,42,0,0,42,T
3-PA,1759,0,0,0,42,42,C
3-PA,1760,42,0,0,0,42,A
3-PA,1761,0,0,42,0,42,G
3-PA,1762,0,42,0,0,42,T
3-PA,1763,0,0,0,43,43,C
3-PA,1764,43,0,0,0,43,A
3-PA,1765,0,0,0,43,43,C
3-PA,1766,0,42,0,0,42,T
3-PA,1767,0,0,0,43,43,C
3-PA,1768,0,0,0,42,42,C
3-PA,1769,42,0,0,0,42,A
3-PA,1770,0,0,42,0,42,G
3-PA,1771,0,0,0,42,42,C
3-PA,1772,42,0,0,0,42,A
3-PA,1773,0,1,41,0,42,G
3-PA,1774,42,0,0,0,42,A
3-PA,1775,0,42,0,0,42,T
3-PA,1776,0,0,0,42,42,C
3-PA,1777,0,0,42,0,42,G
3-PA,1778,42,0,0,0,42,A
3-PA,1779,0,0,42,0,42,G
3-PA,1780,42,0,0,0,42,A
3-PA,1781,0,0,42,0,42,G
3-PA,1782,0,0,0,42,42,C
3-PA,1783,42,0,0,0,42,A
3-PA,1784,0,42,0,0,42,T
3-PA,1785,0,0,42,0,42,G
3-PA,1786,42,0,0,0,42,A
3-PA,1787,0,41,0,0,41,T
3-PA,1788,0,41,0,0,41,T
3-PA,1789,0,0,41,0,41,G
3-PA,1790,41,0,0,0,41,A
3-PA,1791,41,0,0,0,41,A
3-PA,1792,0,0,40,0,40,G
3-PA,1793,0,0,0,39,39,C
3-PA,1794,0,0,0,39,39,C
3-PA,1795,0,0,39,0,39,G
3-PA,1796,39,0,0,0,39,A
3-PA,1797,0,0,39,0,39,G
3-PA,1798,0,38,0,0,38,T
3-PA,1799,0,0,0,37,37,C
3-PA,1800,0,0,0,37,37,C
3-PA,1801,0,37,0,0,37,T
3-PA,1802,0,0,0,38,38,C
3-PA,1803,0,0,38,0,38,G
3-PA,1804,0,0,40,0,40,G
3-PA,1805,0,40,0,0,40,T
3-PA,1806,0,40,0,0,40,T
3-PA,1807,40,0,0,0,40,A
3-PA,1808,40,0,0,0,40,A
3-PA,1809,40,0,0,0,40,A
3-PA,1810,0,0,41,0,41,G
3-PA,1811,40,0,0,0,40,A
3-PA,1812,0,0,40,0,40,G
3-PA,1813,40,0,0,0,40,A
3-PA,1814,39,0,0,0,39,A
3-PA,1815,40,0,0,0,40,A
3-PA,1816,0,0,40,0,40,G
3-PA,1817,40,0,0,0,40,A
3-PA,1818,0,0,0,41,41,C
3-PA,1819,39,0,1,0,40,A
3-PA,1820,0,39,0,0,39,T
3-PA,1821,0,0,40,0,40,G
3-PA,1822,40,0,0,0,40,A
3-PA,1823,0,0,0,40,40,C
3-PA,1824,0,0,0,40,40,C
3-PA,1825,40,0,0,0,40,A
3-PA,1826,40,0,0,0,40,A
3-PA,1827,40,0,0,0,40,A
3-PA,1828,0,0,40,0,40,G
3-PA,1829,40,0,0,0,40,A
3-PA,1830,0,0,40,0,40,G
3-PA,1831,0,39,0,0,39,T
3-PA,1832,0,40,0,0,40,T
3-PA,1833,0,38,0,0,38,T
3-PA,1834,0,39,0,0,39,T
3-PA,1835,0,40,0,0,40,T
3-PA,1836,0,40,0,0,40,T
3-PA,1837,0,0,40,0,40,G
3-PA,1838,40,0,0,0,40,A
3-PA,1839,0,0,42,0,42,G
3-PA,1840,41,0,0,0,41,A
3-PA,1841,42,0,0,0,42,A
3-PA,1842,0,42,0,0,42,T
3-PA,1843,42,0,0,0,42,A
3-PA,1844,42,0,0,0,42,A
3-PA,1845,43,0,0,0,43,A
3-PA,1846,0,43,0,0,43,T
3-PA,1847,0,0,0,43,43,C
3-PA,1848,43,0,0,0,43,A
3-PA,1849,0,0,43,0,43,G
3-PA,1850,43,0,0,0,43,A
3-PA,1851,43,0,0,0,43,A
3-PA,1852,0,0,43,0,43,G
3-PA,1853,1,0,0,40,41,C
3-PA,1854,41,0,0,0,41,A
3-PA,1855,0,41,0,0,41,T
3-PA,1856,0,0,41,0,41,G
3-PA,1857,0,0,41,0,41,G
3-PA,1858,0,0,0,41,41,C
3-PA,1859,0,0,0,40,40,C
3-PA,1860,1,0,0,40,41,C
3-PA,1861,41,0,0,0,41,A
3-PA,1862,0,41,0,0,41,T
3-PA,1863,0,41,0,0,41,T
3-PA,1864,0,0,40,0,40,G
3-PA,1865,0,0,41,0,41,G
3-PA,1866,0,0,41,0,41,G
3-PA,1867,0,0,41,0,41,G
3-PA,1868,39,0,0,0,39,A
3-PA,1869,0,0,40,0,40,G
3-PA,1870,0,41,0,0,41,T
3-PA,1871,0,0,0,41,41,C
3-PA,1872,0,0,0,44,44,C
3-PA,1873,0,0,0,44,44,C
3-PA,1874,0,0,0,44,44,C
3-PA,1875,0,0,0,45,45,C
3-PA,1876,44,0,0,0,44,A
3-PA,1877,42,0,0,0,42,A
3-PA,1878,0,0,44,0,44,G
3-PA,1879,0,0,42,0,42,G
3-PA,1880,0,0,43,0,43,G
3-PA,1881,40,0,0,0,40,A
3-PA,1882,0,0,40,0,40,G
3-PA,1883,0,39,0,0,39,T
3-PA,1884,0,0,41,0,41,G
3-PA,1885,0,0,40,0,40,G
3-PA,1886,41,0,0,0,41,A
3-PA,1887,41,0,0,0,41,A
3-PA,1888,0,0,40,0,40,G
3-PA,1889,41,0,0,0,41,A
3-PA,1890,41,0,0,0,41,A
3-PA,1891,0,0,40,0,40,G
3-PA,1892,0,0,40,0,40,G
3-PA,1893,0,40,0,1,41,T
3-PA,1894,0,39,0,0,39,T
3-PA,1895,0,0,0,41,41,C
3-PA,1896,0,0,0,40,40,C
3-PA,1897,41,0,0,0,41,A
3-PA,1898,0,40,0,0,40,T
3-PA,1899,0,41,0,0,41,T
3-PA,1900,0,0,39,0,39,G
3-PA,1901,0,0,39,0,39,G
3-PA,1902,0,0,39,0,39,G
3-PA,1903,40,0,0,0,40,A
3-PA,1904,39,0,0,0,39,A
3-PA,1905,38,0,0,0,38,A
3-PA,1906,0,0,40,0,40,G
3-PA,1907,0,41,0,0,41,T
3-PA,1908,1,0,0,41,42,C
3-PA,1909,0,42,0,0,42,T
3-PA,1910,0,0,42,0,42,G
3-PA,1911,0,42,0,0,42,T
3-PA,1912,41,0,0,0,41,A
3-PA,1913,0,0,42,0,42,G
3-PA,1914,0,0,42,0,42,G
3-PA,1915,40,0,0,0,40,A
3-PA,1916,0,0,0,40,40,C
3-PA,1917,0,39,0,0,39,T
3-PA,1918,0,0,0,40,40,C
3-PA,1919,0,41,0,0,41,T
3-PA,1920,40,0,0,0,40,A
3-PA,1921,0,41,0,0,41,T
3-PA,1922,0,39,0,0,39,T
3-PA,1923,0,0,40,0,40,G
3-PA,1924,0,0,40,0,40,G
3-PA,1925,0,0,0,38,38,C
3-PA,1926,0,39,0,0,39,T
3-PA,1927,37,0,0,0,37,A
3-PA,1928,36,0,0,0,36,A
3-PA,1929,0,0,36,0,36,G
3-PA,1930,0,37,0,0,37,T
3-PA,1931,0,0,0,37,37,C
3-PA,1932,36,0,0,0,36,A
3-PA,1933,0,0,39,0,39,G
3-PA,1934,0,39,0,0,39,T
3-PA,1935,38,0,0,0,38,A
3-PA,1936,0,40,0,0,40,T
3-PA,1937,0,39,0,0,39,T
3-PA,1938,0,0,0,39,39,C
3-PA,1939,38,0,0,0,38,A
3-PA,1940,39,0,0,0,39,A
3-PA,1941,0,39,0,0,39,T
3-PA,1942,38,0,0,0,38,A
3-PA,1943,0,0,38,0,38,G
3-PA,1944,0,0,0,38,38,C
3-PA,1945,0,0,0,39,39,C
3-PA,1946,0,39,0,0,39,T
3-PA,1947,0,0,39,0,39,G
3-PA,1948,0,37,0,0,37,T
3-PA,1949,39,0,0,0,39,A
3-PA,1950,0,39,0,0,39,T
3-PA,1951,0,0,38,0,38,G
3-PA,1952,0,0,0,39,39,C
3-PA,1953,37,0,0,0,37,A
3-PA,1954,0,37,0,0,37,T
3-PA,1955,0,0,0,36,36,C
3-PA,1956,37,0,0,0,37,A
3-PA,1957,0,0,0,36,36,C
3-PA,1958,0,0,0,36,36,C
3-PA,1959,36,0,0,0,36,A
3-PA,1960,0,0,0,38,38,C
3-PA,1961,38,0,0,0,38,A
3-PA,1962,38,0,0,0,38,A
3-PA,1963,0,37,0,0,37,T
3-PA,1964,0,35,0,0,35,T
3-PA,1965,0,0,37,0,37,G
3-PA,1966,0,0,35,0,35,G
3-PA,1967,33,0,0,0,33,A
3-PA,1968,35,0,0,0,35,A
3-PA,1969,0,0,34,0,34,G
3-PA,1970,0,1,34,0,35,G
3-PA,1971,36,0,0,0,36,A
3-PA,1972,0,35,0,0,35,T
3-PA,1973,0,36,0,0,36,T
3-PA,1974,0,37,0,0,37,T
3-PA,1975,0,34,0,0,34,T
3-PA,1976,0,0,0,37,37,C
3-PA,1977,36,0,0,0,36,A
3-PA,1978,0,0,36,0,36,G
3-PA,1979,0,0,0,35,35,C
3-PA,1980,0,0,36,0,36,G
3-PA,1981,0,0,36,0,36,G
3-PA,1982,35,0,0,0,35,A
3-PA,1983,0,0,37,0,37,G
3-PA,1984,0,37,0,0,37,T
3-PA,1985,1,0,0,36,37,C
3-PA,1986,37,0,0,0,37,A
3-PA,1987,37,0,0,0,37,A
3-PA,1988,0,0,36,0,36,G
3-PA,1989,36,0,0,0,36,A
3-PA,1990,36,0,0,0,36,A
3-PA,1991,36,0,0,0,36,A
3-PA,1992,34,0,0,0,34,A
3-PA,1993,0,0,0,35,35,C
3-PA,1994,0,33,0,0,33,T
3-PA,1995,0,0,33,0,33,G
3-PA,1996,0,0,0,33,33,C
3-PA,1997,0,32,0,0,32,T
3-PA,1998,1,0,0,31,32,C
3-PA,1999,0,0,0,34,34,C
3-PA,2000,0,34,0,0,34,T
3-PA,2001,0,32,0,0,32,T
3-PA,2002,0,0,34,0,34,G
3-PA,2003,0,34,0,0,34,T
3-PA,2004,0,33,0,0,33,T
3-PA,2005,0,0,35,0,35,G
3-PA,2006,0,36,0,0,36,T
3-PA,2007,0,34,0,0,34,T
3-PA,2008,0,0,0,35,35,C
3-PA,2009,35,0,0,0,35,A
3-PA,2010,0,0,35,0,35,G
3-PA,2011,0,0,35,0,35,G
3-PA,2012,0,0,0,35,35,C
3-PA,2013,0,34,0,0,34,T
3-PA,2014,0,0,0,37,37,C
3-PA,2015,0,38,0,0,38,T
3-PA,2016,0,38,0,0,38,T
3-PA,2017,37,0,1,0,38,A
3-PA,2018,0,0,38,0,38,G
3-PA,2019,0,0,37,0,37,G
3-PA,2020,0,0,37,0,37,G
3-PA,2021,33,0,1,0,34,A
3-PA,2022,0,0,0,34,34,C
3-PA,2023,34,0,0,0,34,A
3-PA,2024,35,0,0,0,35,A
3-PA,2025,0,0,0,34,34,C
3-PA,2026,0,0,0,33,33,C
3-PA,2027,0,34,0,0,34,T
3-PA,2028,0,0,0,33,33,C
3-PA,2029,0,0,33,0,33,G
3-PA,2030,34,0,0,0,34,A
3-PA,2031,34,0,0,0,34,A
3-PA,2032,0,0,0,32,32,C
3-PA,2033,0,0,0,32,32,C
3-PA,2034,0,32,0,0,32,T
3-PA,2035,0,0,32,0,32,G
3-PA,2036,0,0,30,0,30,G
3-PA,2037,0,0,32,0,32,G
3-PA,2038,30,0,0,0,30,A
3-PA,2039,0,0,0,30,30,C
3-PA,2040,0,0,0,28,28,C
3-PA,2041,0,28,0,0,28,T
3-PA,2042,0,28,0,0,28,T
3-PA,2043,0,28,0,0,28,T
3-PA,2044,0,0,28,0,28,G
3-PA,2045,30,0,0,0,30,A
3-PA,2046,0,28,0,0,28,T
3-PA,2047,0,0,0,28,28,C
3-PA,2048,0,29,0,0,29,T
3-PA,2049,0,30,0,0,30,T
3-PA,2050,0,0,30,0,30,G
3-PA,2051,0,0,30,0,30,G
3-PA,2052,0,0,30,0,30,G
3-PA,2053,0,1,30,0,31,G
3-PA,2054,0,0,25,0,25,G
3-PA,2055,0,0,29,0,29,G
3-PA,2056,0,0,0,26,26,C
3-PA,2057,0,29,0,0,29,T
3-PA,2058,30,0,0,0,30,A
3-PA,2059,0,28,0,0,28,T
3-PA,2060,30,0,0,0,30,A
3-PA,2061,0,29,0,0,29,T
3-PA,2062,0,0,28,0,28,G
3-PA,2063,29,0,0,0,29,A
3-PA,2064,27,0,0,0,27,A
3-PA,2065,0,0,26,0,26,G
3-PA,2066,0,0,0,28,28,C
3-PA,2067,24,0,0,0,24,A
3-PA,2068,24,0,0,0,24,A
3-PA,2069,0,23,0,0,23,T
3-PA,2070,0,23,0,1,24,T
3-PA,2071,0,0,25,0,25,G
3-PA,2072,23,0,0,0,23,A
3-PA,2073,0,0,25,0,25,G
3-PA,2074,0,1,24,0,25,G
3-PA,2075,23,0,0,0,23,A
3-PA,2076,0,0,24,0,24,G
3-PA,2077,0,22,0,0,22,T
3-PA,2078,0,0,22,0,22,G
3-PA,2079,0,0,0,21,21,C
3-PA,2080,0,0,0,21,21,C
3-PA,2081,0,22,0,0,22,T
3-PA,2082,0,0,21,0,21,G
3-PA,2083,21,0,0,0,21,A
3-PA,2084,0,22,0,0,22,T
3-PA,2085,0,19,0,0,19,T
3-PA,2086,19,0,0,0,19,A
3-PA,2087,19,0,0,0,19,A
3-PA,2088,0,20,0,0,20,T
3-PA,2089,0,0,19,0,19,G
3-PA,2090,18,0,0,0,18,A
3-PA,2091,0,17,0,0,17,T
3-PA,2092,0,0,0,17,17,C
3-PA,2093,0,0,0,17,17,C
3-PA,2094,0,0,0,17,17,C
3-PA,2095,0,16,0,0,16,T
3-PA,2096,0,0,17,0,17,G
3-PA,2097,0,0,18,0,18,G
3-PA,2098,0,0,16,0,16,G
3-PA,2099,0,15,0,0,15,T
3-PA,2100,0,15,0,0,15,T
3-PA,2101,0,17,0,0,17,T
3-PA,2102,0,16,0,0,16,T
3-PA,2103,0,0,17,0,17,G
3-PA,2104,0,0,0,16,16,C
3-PA,2105,0,17,0,0,17,T
3-PA,2106,0,0,0,17,17,C
3-PA,2107,17,0,0,0,17,A
3-PA,2108,17,0,0,0,17,A
3-PA,2109,0,17,0,0,17,T
3-PA,2110,0,0,17,0,17,G
3-PA,2111,0,0,0,16,16,C
3-PA,2112,0,0,17,0,17,G
3-PA,2113,0,17,0,0,17,T
3-PA,2114,0,0,0,15,15,C
3-PA,2115,0,16,0,0,16,T
3-PA,2116,0,17,0,0,17,T
3-PA,2117,0,0,16,0,16,G
3-PA,2118,0,0,16,0,16,G
3-PA,2119,0,15,0,0,15,T
3-PA,2120,0,15,0,0,15,T
3-PA,2121,0,0,0,14,14,C
3-PA,2122,15,0,0,0,15,A
3-PA,2123,14,0,0,0,14,A
3-PA,2124,0,0,0,14,14,C
3-PA,2125,0,13,0,0,13,T
3-PA,2126,0,0,0,14,14,C
3-PA,2127,0,0,0,15,15,C
3-PA,2128,0,14,0,0,14,T
3-PA,2129,0,14,0,0,14,T
3-PA,2130,0,0,0,14,14,C
3-PA,2131,0,0,0,14,14,C
3-PA,2132,0,12,0,0,12,T
3-PA,2133,0,0,13,0,13,G
3-PA,2134,13,0,0,0,13,A
3-PA,2135,0,0,0,12,12,C
3-PA,2136,10,0,0,0,10,A
3-PA,2137,0,0,0,9,9,C
3-PA,2138,8,0,0,0,8,A
3-PA,2139,0,7,0,0,7,T
3-PA,2140,0,0,7,0,7,G
3-PA,2141,0,0,0,8,8,C
3-PA,2142,6,0,0,0,6,A
3-PA,2143,0,6,0,0,6,T
3-PA,2144,0,7,0,0,7,T
3-PA,2145,7,0,0,0,7,A
3-PA,2146,7,0,0,0,7,A
3-PA,2147,6,0,0,0,6,A
3-PA,2148,7,0,0,0,7,A
3-PA,2149,0,6,0,0,6,T
3-PA,2150,5,0,0,0,5,A
3-PA,2151,0,0,5,0,5,G
4-HA,1,154,0,0,0,154,A
4-HA,2,0,156,0,0,156,T
4-HA,3,0,0,163,0,163,G
4-HA,4,162,0,0,0,162,A
4-HA,5,163,0,0,0,163,A
4-HA,6,0,1,183,0,184,G
4-HA,7,182,0,0,0,182,A
4-HA,8,0,0,0,203,203,C
4-HA,9,0,207,0,0,207,T
4-HA,10,212,0,0,0,212,A
4-HA,11,0,224,0,0,224,T
4-HA,12,0,0,0,227,227,C
4-HA,13,225,0,0,0,225,A
4-HA,14,0,227,0,0,227,T
4-HA,15,0,228,0,0,228,T
4-HA,16,0,0,253,0,253,G
4-HA,17,0,0,0,253,253,C
4-HA,18,0,252,0,0,252,T
4-HA,19,0,254,0,0,254,T
4-HA,20,0,255,0,0,255,T
4-HA,21,0,0,265,0,265,G
4-HA,22,266,0,0,0,266,A
4-HA,23,0,0,274,0,274,G
4-HA,24,0,0,0,273,273,C
4-HA,25,0,276,0,0,276,T
4-HA,26,294,0,0,0,294,A
4-HA,27,0,0,0,300,300,C
4-HA,28,308,0,0,0,308,A
4-HA,29,0,328,0,1,329,T
4-HA,30,0,326,0,0,326,T
4-HA,31,0,0,0,328,328,C
4-HA,32,0,330,0,0,330,T
4-HA,33,333,0,0,0,333,A
4-HA,34,0,336,0,0,336,T
4-HA,35,1,1,328,0,330,G
4-HA,36,0,328,0,0,328,T
4-HA,37,0,0,0,330,330,C
4-HA,38,0,325,0,0,325,T
4-HA,39,0,2,325,0,327,G
4-HA,40,0,0,331,0,331,G
4-HA,41,0,328,0,0,328,T
4-HA,42,0,332,0,0,332,T
4-HA,43,0,328,0,0,328,T
4-HA,44,0,328,0,0,328,T
4-HA,45,0,0,0,328,328,C
4-HA,46,0,1,327,0,328,G
4-HA,47,0,1,0,329,330,C
4-HA,48,0,327,0,2,329,T
4-HA,49,1,0,0,332,333,C
4-HA,50,332,0,0,0,332,A
4-HA,51,332,0,0,0,332,A
4-HA,52,332,0,0,0,332,A
4-HA,53,335,0,0,0,335,A
4-HA,54,333,0,1,0,334,A
4-HA,55,0,0,0,337,337,C
4-HA,56,0,337,0,0,337,T
4-HA,57,0,339,0,0,339,T
4-HA,58,0,0,0,340,340,C
4-HA,59,0,1,0,340,341,C
4-HA,60,0,341,0,1,342,T
4-HA,61,0,0,342,0,342,G
4-HA,62,0,0,343,0,343,G
4-HA,63,343,0,0,0,343,A
4-HA,64,349,0,0,0,349,A
4-HA,65,349,0,0,0,349,A
4-HA,66,0,355,0,0,355,T
4-HA,67,1,0,354,0,355,G
4-HA,68,353,0,0,0,353,A
4-HA,69,0,0,0,355,355,C
4-HA,70,357,0,0,0,357,A
4-HA,71,356,0,0,0,356,A
4-HA,72,1,1,0,365,367,C
4-HA,73,364,0,0,0,364,A
4-HA,74,0,0,369,0,369,G
4-HA,75,0,1,0,368,369,C
4-HA,76,369,0,0,0,369,A
4-HA,77,0,0,0,377,377,C
4-HA,78,1,0,373,0,374,G
4-HA,79,0,0,378,0,378,G
4-HA,80,0,0,0,385,385,C
4-HA,81,378,0,0,0,378,A
4-HA,82,381,0,0,0,381,A
4-HA,83,0,0,0,386,386,C
4-HA,84,0,1,389,0,390,G
4-HA,85,0,0,0,391,391,C
4-HA,86,0,387,0,1,388,T
4-HA,87,0,0,399,0,399,G
4-HA,88,0,396,0,0,396,T
4-HA,89,0,0,402,0,402,G
4-HA,90,0,1,0,412,413,C
4-HA,91,0,0,0,423,423,C
4-HA,92,0,423,0,0,423,T
4-HA,93,0,421,0,0,421,T
4-HA,94,0,1,422,0,423,G
4-HA,95,0,3,417,0,420,G
4-HA,96,0,1,429,0,430,G
4-HA,97,0,0,0,430,430,C
4-HA,98,430,0,0,0,430,A
4-HA,99,0,0,0,440,440,C
4-HA,100,0,1,0,429,430,C
4-HA,101,476,0,0,0,476,A
4-HA,102,0,475,0,0,475,T
4-HA,103,0,0,471,0,471,G
4-HA,104,0,0,0,468,468,C
4-HA,105,468,0,1,0,469,A
4-HA,106,0,0,511,0,511,G
4-HA,107,0,505,0,0,505,T
4-HA,108,513,0,0,0,513,A
4-HA,109,0,0,0,513,513,C
4-HA,110,1,1,0,492,494,C
4-HA,111,505,0,1,0,506,A
4-HA,112,503,0,1,0,504,A
4-HA,113,502,0,0,0,502,A
4-HA,114,0,0,0,512,512,C
4-HA,115,1,0,499,0,500,G
4-HA,116,0,0,520,0,520,G
4-HA,117,518,0,0,0,518,A
4-HA,118,517,0,0,0,517,A
4-HA,119,1,0,0,518,519,C
4-HA,120,514,0,0,0,514,A
4-HA,121,522,0,0,6,528,A
4-HA,122,0,529,0,0,529,T
4-HA,123,541,0,2,0,543,A
4-HA,124,0,0,546,0,546,G
4-HA,125,0,532,0,0,532,T
4-HA,126,0,2,534,0,536,G
4-HA,127,532,0,0,0,532,A
4-HA,128,532,0,0,0,532,A
4-HA,129,536,0,0,0,536,A
4-HA,130,533,0,0,0,533,A
4-HA,131,0,0,0,540,540,C
4-HA,132,541,0,0,0,541,A
4-HA,133,544,0,0,0,544,A
4-HA,134,0,545,0,0,545,T
4-HA,135,0,1,0,542,543,C
4-HA,136,542,0,1,0,543,A
4-HA,137,0,0,0,544,544,C
4-HA,138,0,0,548,0,548,G
4-HA,139,542,0,0,0,542,A
4-HA,140,540,0,0,0,540,A
4-HA,141,0,544,0,1,545,T
4-HA,142,0,3,539,0,542,G
4-HA,143,544,0,1,0,545,A
4-HA,144,0,0,0,540,540,C
4-HA,145,3,0,0,540,543,C
4-HA,146,548,0,0,0,548,A
4-HA,147,555,0,0,0,555,A
4-HA,148,556,0,0,0,556,A
4-HA,149,0,556,0,0,556,T
4-HA,150,0,560,0,0,560,T
4-HA,151,0,1,560,0,561,G
4-HA,152,558,0,0,0,558,A
4-HA,153,558,0,1,0,559,A
4-HA,154,1,0,562,0,563,G
4-HA,155,0,558,0,0,558,T
4-HA,156,0,579,0,0,579,T
4-HA,157,578,0,0,0,578,A
4-HA,158,0,0,0,583,583,C
4-HA,159,1,585,0,1,587,T
4-HA,160,586,0,0,0,586,A
4-HA,161,597,0,0,0,597,A
4-HA,162,0,596,0,0,596,T
4-HA,163,0,0,597,0,597,G
4-HA,164,0,0,0,610,610,C
4-HA,165,0,609,0,1,610,T
4-HA,166,611,0,1,0,612,A
4-HA,167,0,0,0,610,610,C
4-HA,168,0,607,0,0,607,T
4-HA,169,0,2,605,0,607,G
4-HA,170,601,0,0,0,601,A
4-HA,171,0,0,602,0,602,G
4-HA,172,1,0,0,600,601,C
4-HA,173,0,587,0,0,587,T
4-HA,174,1,1,598,0,600,G
4-HA,175,0,0,607,0,607,G
4-HA,176,0,607,0,0,607,T
4-HA,177,0,609,0,0,609,T
4-HA,178,1,0,0,614,615,C
4-HA,179,611,0,1,0,612,A
4-HA,180,0,2,612,0,614,G
4-HA,181,612,0,0,0,612,A
4-HA,182,0,0,630,0,630,G
4-HA,183,0,629,0,1,630,T
4-HA,184,0,622,0,0,622,T
4-HA,185,2,0,0,627,629,C
4-HA,186,1,0,0,628,629,C
4-HA,187,0,626,0,1,627,T
4-HA,188,0,0,0,631,631,C
4-HA,189,628,0,0,0,628,A
4-HA,190,626,0,0,0,626,A
4-HA,191,0,0,0,637,637,C
4-HA,192,622,0,0,0,622,A
4-HA,193,0,2,628,0,630,G
4-HA,194,0,0,624,0,624,G
4-HA,195,0,621,0,0,621,T
4-HA,196,0,2,627,0,629,G
4-HA,197,623,0,1,0,624,A
4-HA,198,630,0,1,0,631,A
4-HA,199,653,0,1,0,654,A
4-HA,200,0,650,0,0,650,T
4-HA,201,658,0,1,0,659,A
4-HA,202,0,648,0,1,649,T
4-HA,203,0,0,649,0,649,G
4-HA,204,0,2,0,641,643,C
4-HA,205,2,3,635,0,640,G
4-HA,206,634,0,0,0,634,A
4-HA,207,0,0,0,636,636,C
4-HA,208,615,0,0,0,615,A
4-HA,209,0,0,657,0,657,G
4-HA,210,0,654,0,1,655,T
4-HA,211,3,0,0,657,660,C
4-HA,212,2,0,0,652,654,C
4-HA,213,0,650,0,1,651,T
4-HA,214,3,0,0,662,665,C
4-HA,215,663,0,1,0,664,A
4-HA,216,0,662,0,0,662,T
4-HA,217,2,0,0,666,668,C
4-HA,218,643,0,0,0,643,A
4-HA,219,0,1,644,0,645,G
4-HA,220,637,0,0,0,637,A
4-HA,221,0,634,0,0,634,T
4-HA,222,1,1,0,639,641,C
4-HA,223,1,0,0,634,635,C
4-HA,224,0,626,0,1,627,T
4-HA,225,0,630,0,0,630,T
4-HA,226,0,2,627,0,629,G
4-HA,227,629,0,0,0,629,A
4-HA,228,0,625,0,0,625,T
4-HA,229,0,3,626,0,629,G
4-HA,230,0,2,623,0,625,G
4-HA,231,617,0,1,0,618,A
4-HA,232,0,0,623,0,623,G
4-HA,233,618,0,0,0,618,A
4-HA,234,623,0,0,0,623,A
4-HA,235,629,0,0,0,629,A
4-HA,236,627,0,2,0,629,A
4-HA,237,0,0,0,635,635,C
4-HA,238,0,624,1,1,626,T
4-HA,239,0,0,635,0,635,G
4-HA,240,0,0,0,630,630,C
4-HA,241,633,0,1,0,634,A
4-HA,242,0,0,0,650,650,C
4-HA,243,643,0,0,0,643,A
4-HA,244,1,0,0,710,711,C
4-HA,245,0,703,1,0,704,T
4-HA,246,710,0,0,0,710,A
4-HA,247,711,0,0,0,711,A
4-HA,248,0,707,1,0,708,T
4-HA,249,702,0,1,0,703,A
4-HA,250,0,2,704,0,706,G
4-HA,251,693,0,0,0,693,A
4-HA,252,0,679,0,0,679,T
4-HA,253,0,0,653,0,653,G
4-HA,254,0,0,0,652,652,C
4-HA,255,0,655,0,1,656,T
4-HA,256,1,0,0,694,695,C
4-HA,257,1,691,0,0,692,T
4-HA,258,705,0,0,0,705,A
4-HA,259,0,712,0,0,712,T
4-HA,260,0,705,0,2,707,T
4-HA,261,0,3,730,0,733,G
4-HA,262,0,3,734,0,737,G
4-HA,263,0,0,751,0,751,G
4-HA,264,748,0,1,0,749,A
4-HA,265,0,2,745,0,747,G
4-HA,266,721,0,1,0,722,A
4-HA,267,0,0,1,936,937,C
4-HA,268,1,0,0,981,982,C
4-HA,269,2,0,0,982,984,C
4-HA,270,0,983,9,1,993,T
4-HA,271,0,0,0,1037,1037,C
4-HA,272,1031,0,0,0,1031,A
4-HA,273,0,0,1168,0,1168,G
4-HA,274,0,1156,0,1,1157,T
4-HA,275,1,1,1185,0,1187,G
4-HA,276,0,1157,0,3,1160,T
4-HA,277,1,2,1159,0,1162,G
4-HA,278,1158,1,1,0,1160,A
4-HA,279,0,1153,0,0,1153,T
4-HA,280,2,6,1133,0,1141,G
4-HA,281,0,1,1137,0,1138,G
4-HA,282,0,0,0,1148,1148,C
4-HA,283,0,1144,0,0,1144,T
4-HA,284,0,1139,1,0,1140,T
4-HA,285,0,0,0,1153,1153,C
4-HA,286,1,0,1,1146,1148,C
4-HA,287,1148,0,0,0,1148,A
4-HA,288,1159,0,0,0,1159,A
4-HA,289,1162,0,0,0,1162,A
4-HA,290,1170,0,0,0,1170,A
4-HA,291,0,1178,0,0,1178,T
4-HA,292,1173,0,0,0,1173,A
4-HA,293,1179,1,1,0,1181,A
4-HA,294,0,2,1187,0,1189,G
4-HA,295,1192,0,0,1,1193,A
4-HA,296,1198,0,0,0,1198,A
4-HA,297,1201,1,0,0,1202,A
4-HA,298,0,1205,0,0,1205,T
4-HA,299,0,1,1200,0,1201,G
4-HA,300,1,4,1188,0,1193,G
4-HA,301,0,3,1194,0,1197,G
4-HA,302,1177,0,1,0,1178,A
4-HA,303,2,0,0,1214,1216,C
4-HA,304,2,0,0,1215,1217,C
4-HA,305,0,1242,0,0,1242,T
4-HA,306,0,1247,0,0,1247,T
4-HA,307,0,1244,0,0,1244,T
4-HA,308,0,1261,0,0,1261,T
4-HA,309,0,1263,0,0,1263,T
4-HA,310,0,1,1268,0,1269,G
4-HA,311,0,1262,0,2,1264,T
4-HA,312,0,1268,0,0,1268,T
4-HA,313,1,2,1277,0,1280,G
4-HA,314,1268,0,1,0,1269,A
4-HA,315,1280,0,0,0,1280,A
4-HA,316,0,0,0,1289,1289,C
4-HA,317,1,0,1277,0,1278,G
4-HA,318,0,0,0,1315,1315,C
4-HA,319,1306,0,1,0,1307,A
4-HA,320,1,0,1309,0,1310,G
4-HA,321,0,0,0,1317,1317,C
4-HA,322,1324,0,0,0,1324,A
4-HA,323,1315,0,0,0,1315,A
4-HA,324,1315,0,2,0,1317,A
4-HA,325,0,0,1392,0,1392,G
4-HA,326,0,0,0,1395,1395,C
4-HA,327,1,2,0,1400,1403,C
4-HA,328,0,1405,0,0,1405,T
4-HA,329,1402,0,1,0,1403,A
4-HA,330,0,0,0,1420,1420,C
4-HA,331,1419,0,0,0,1419,A
4-HA,332,0,1,1422,0,1423,G
4-HA,333,1,0,0,1417,1418,C
4-HA,334,1398,0,0,0,1398,A
4-HA,335,1405,0,0,0,1405,A
4-HA,336,0,0,0,1502,1502,C
4-HA,337,0,1494,0,0,1494,T
4-HA,338,0,1,1499,0,1500,G
4-HA,339,0,1488,0,1,1489,T
4-HA,340,0,1499,0,0,1499,T
4-HA,341,1499,0,0,1,1500,A
4-HA,342,0,1,0,1636,1637,C
4-HA,343,5,0,0,1649,1654,C
4-HA,344,5,0,0,1701,1706,C
4-HA,345,1,1659,0,1,1661,T
4-HA,346,0,1656,0,0,1656,T
4-HA,347,1669,0,0,0,1669,A
4-HA,348,0,1665,0,2,1667,T
4-HA,349,0,2,1665,0,1667,G
4-HA,350,1664,0,2,0,1666,A
4-HA,351,0,1589,0,0,1589,T
4-HA,352,0,0,1633,0,1633,G
4-HA,353,1,1616,0,0,1617,T
4-HA,354,0,1,1615,0,1616,G
4-HA,355,0,1,0,1617,1618,C
4-HA,356,2,3,0,1615,1620,C
4-HA,357,1,3,1655,0,1659,G
4-HA,358,0,1,1663,0,1664,G
4-HA,359,1669,0,0,0,1669,A
4-HA,360,0,1681,0,0,1681,T
4-HA,361,0,1660,0,0,1660,T
4-HA,362,1677,0,0,0,1677,A
4-HA,363,0,1671,0,1,1672,T
4-HA,364,1,1,1667,0,1669,G
4-HA,365,0,0,0,1679,1679,C
4-HA,366,1,0,0,1672,1673,C
4-HA,367,0,1689,0,2,1691,T
4-HA,368,5,1,0,1777,1783,C
4-HA,369,0,0,0,1806,1806,C
4-HA,370,7,0,1,1803,1811,C
4-HA,371,0,1814,0,0,1814,T
4-HA,372,0,1811,0,0,1811,T
4-HA,373,1816,0,0,0,1816,A
4-HA,374,1,4,1845,0,1850,G
4-HA,375,0,2,1852,0,1854,G
4-HA,376,0,1820,0,1,1821,T
4-HA,377,5,0,0,1798,1803,C
4-HA,378,1790,0,0,0,1790,A
4-HA,379,0,0,0,1845,1845,C
4-HA,380,0,1848,0,2,1850,T
4-HA,381,1851,0,0,0,1851,A
4-HA,382,1,1,1850,0,1852,G
4-HA,383,0,1821,0,3,1824,T
4-HA,384,0,1818,0,3,1821,T
4-HA,385,0,0,1842,0,1842,G
4-HA,386,0,0,0,1839,1839,C
4-HA,387,2,0,0,1838,1840,C
4-HA,388,0,1825,0,3,1828,T
4-HA,389,3,0,0,1841,1844,C
4-HA,390,1933,0,0,0,1933,A
4-HA,391,0,1934,0,1,1935,T
4-HA,392,0,0,0,1941,1941,C
4-HA,393,1,3,0,1936,1940,C
4-HA,394,2,7,1920,0,1929,G
4-HA,395,4,1,1929,0,1934,G
4-HA,396,1,0,5,1944,1950,C
4-HA,397,1967,0,0,0,1967,A
4-HA,398,0,2,0,1990,1992,C
4-HA,399,1948,0,1,0,1949,A
4-HA,400,0,1,0,1966,1967,C
4-HA,401,0,1956,0,1,1957,T
4-HA,402,0,2,1978,0,1980,G
4-HA,403,0,3,1999,0,2002,G
4-HA,404,1978,0,0,0,1978,A
4-HA,405,0,1,2014,0,2015,G
4-HA,406,0,1992,0,0,1992,T
4-HA,407,0,1999,0,1,2000,T
4-HA,408,0,2005,0,0,2005,T
4-HA,409,2007,0,1,0,2008,A
4-HA,410,2013,0,1,0,2014,A
4-HA,411,0,1,0,2024,2025,C
4-HA,412,1996,0,1,0,1997,A
4-HA,413,1983,0,1,0,1984,A
4-HA,414,0,1990,0,1,1991,T
4-HA,415,0,1,1989,0,1990,G
4-HA,416,1985,0,1,0,1986,A
4-HA,417,1989,0,0,0,1989,A
4-HA,418,1986,0,1,0,1987,A
4-HA,419,0,0,2002,0,2002,G
4-HA,420,1,0,0,2002,2003,C
4-HA,421,0,2005,0,0,2005,T
4-HA,422,0,2010,0,0,2010,T
4-HA,423,3,0,0,2033,2036,C
4-HA,424,2040,0,0,0,2040,A
4-HA,425,2043,0,2,0,2045,A
4-HA,426,0,2047,0,1,2048,T
4-HA,427,0,2041,0,0,2041,T
4-HA,428,0,5,2074,0,2079,G
4-HA,429,0,6,2100,0,2106,G
4-HA,430,2098,0,4,0,2102,A
4-HA,431,0,0,0,2113,2113,C
4-HA,432,0,2089,0,0,2089,T
4-HA,433,0,4,2090,0,2094,G
4-HA,434,3,4,2097,0,2104,G
4-HA,435,2080,0,2,0,2082,A
4-HA,436,0,0,2100,0,2100,G
4-HA,437,0,2065,0,0,2065,T
4-HA,438,4,0,0,2041,2045,C
4-HA,439,2052,0,2,0,2054,A
4-HA,440,0,0,0,2066,2066,C
4-HA,441,0,2059,0,1,2060,T
4-HA,442,4,0,0,2068,2072,C
4-HA,443,2056,0,2,0,2058,A
4-HA,444,2080,0,0,0,2080,A
4-HA,445,2088,0,1,0,2089,A
4-HA,446,2069,0,1,0,2070,A
4-HA,447,1,2059,0,0,2060,T
4-HA,448,1,2,2060,0,2063,G
4-HA,449,0,2,2064,1,2067,G
4-HA,450,2068,0,1,0,2069,A
4-HA,451,2063,0,1,0,2064,A
4-HA,452,0,0,0,2077,2077,C
4-HA,453,2068,0,2,0,2070,A
4-HA,454,2081,0,0,0,2081,A
4-HA,455,0,1,2086,0,2087,G
4-HA,456,0,0,0,2090,2090,C
4-HA,457,0,2059,0,3,2062,T
4-HA,458,5,0,0,2086,2091,C
4-HA,459,0,2080,0,0,2080,T
4-HA,460,1,2,2086,0,2089,G
4-HA,461,0,0,0,2098,2098,C
4-HA,462,0,2093,0,0,2093,T
4-HA,463,0,2137,0,1,2138,T
4-HA,464,0,0,2183,0,2183,G
4-HA,465,2,0,0,2194,2196,C
4-HA,466,2198,0,0,0,2198,A
4-HA,467,1,2186,0,0,2187,T
4-HA,468,2184,0,1,0,2185,A
4-HA,469,2175,0,1,0,2176,A
4-HA,470,3,4,2163,0,2170,G
4-HA,471,1,4,2172,0,2177,G
4-HA,472,2098,0,0,0,2098,A
4-HA,473,1,2,2104,0,2107,G
4-HA,474,2080,0,4,0,2084,A
4-HA,475,0,2159,0,0,2159,T
4-HA,476,2,0,0,2180,2182,C
4-HA,477,1,2185,0,5,2191,T
4-HA,478,2190,0,0,0,2190,A
4-HA,479,2181,0,0,0,2181,A
4-HA,480,0,2183,0,4,2187,T
4-HA,481,2189,0,0,0,2189,A
4-HA,482,2165,0,2,0,2167,A
4-HA,483,0,0,0,2180,2180,C
4-HA,484,2107,0,1,0,2108,A
4-HA,485,2,0,2129,0,2131,G
4-HA,486,0,2100,0,2,2102,T
4-HA,487,0,2142,0,1,2143,T
4-HA,488,0,2150,0,0,2150,T
4-HA,489,2,0,0,2194,2196,C
4-HA,490,0,2194,0,0,2194,T
4-HA,491,0,2199,0,0,2199,T
4-HA,492,0,2200,0,0,2200,T
4-HA,493,2186,0,0,0,2186,A
4-HA,494,1,0,2190,0,2191,G
4-HA,495,0,2177,0,1,2178,T
4-HA,496,2191,0,1,0,2192,A
4-HA,497,0,3,2192,0,2195,G
4-HA,498,2167,0,0,0,2167,A
4-HA,499,0,2169,0,1,2170,T
4-HA,500,0,2171,0,0,2171,T
4-HA,501,2166,0,1,0,2167,A
4-HA,502,2185,0,0,0,2185,A
4-HA,503,2186,0,1,0,2187,A
4-HA,504,0,2187,1,0,2188,T
4-HA,505,0,2170,0,0,2170,T
4-HA,506,2,6,2172,0,2180,G
4-HA,507,0,2,2164,0,2166,G
4-HA,508,0,2168,0,4,2172,T
4-HA,509,0,2179,0,0,2179,T
4-HA,510,3,6,2138,1,2148,G
4-HA,511,2153,1,1,0,2155,A
4-HA,512,1,0,0,2147,2148,C
4-HA,513,2,0,0,2144,2146,C
4-HA,514,6,1,0,2139,2146,C
4-HA,515,2153,0,1,0,2154,A
4-HA,516,2,0,0,2168,2170,C
4-HA,517,0,2157,0,1,2158,T
4-HA,518,0,2172,0,0,2172,T
4-HA,519,2174,0,0,0,2174,A
4-HA,520,2164,0,0,0,2164,A
4-HA,521,2161,0,0,0,2161,A
4-HA,522,2177,0,0,0,2177,A
4-HA,523,0,2203,0,1,2204,T
4-HA,524,0,2188,0,1,2189,T
4-HA,525,7,1,0,2185,2193,C
4-HA,526,2189,0,1,0,2190,A
4-HA,527,2194,0,0,0,2194,A
4-HA,528,2187,0,0,0,2187,A
4-HA,529,0,2197,0,0,2197,T
4-HA,530,2224,0,0,0,2224,A
4-HA,531,0,0,0,2250,2250,C
4-HA,532,6,0,0,2192,2198,C
4-HA,533,2,3,1,2201,2207,C
4-HA,534,2202,0,2,0,2204,A
4-HA,535,0,2,2299,0,2301,G
4-HA,536,1,0,0,2307,2308,C
4-HA,537,2310,0,1,0,2311,A
4-HA,538,0,2300,0,2,2302,T
4-HA,539,0,2240,0,0,2240,T
4-HA,540,0,9,2297,0,2306,G
4-HA,541,2318,0,1,0,2319,A
4-HA,542,2309,0,4,0,2313,A
4-HA,543,0,1,0,2318,2319,C
4-HA,544,2,0,2265,0,2267,G
4-HA,545,0,2280,0,1,2281,T
4-HA,546,0,8,2280,0,2288,G
4-HA,547,2265,0,1,0,2266,A
4-HA,548,0,1,0,2278,2279,C
4-HA,549,0,2239,0,1,2240,T
4-HA,550,2285,0,0,0,2285,A
4-HA,551,0,2281,0,1,2282,T
4-HA,552,1,0,2297,0,2298,G
4-HA,553,0,0,0,2293,2293,C
4-HA,554,2,0,0,2276,2278,C
4-HA,555,2278,0,0,0,2278,A
4-HA,556,2272,0,0,0,2272,A
4-HA,557,2314,0,1,1,2316,A
4-HA,558,3,1,0,2326,2330,C
4-HA,559,2257,0,1,0,2258,A
4-HA,560,2251,0,0,0,2251,A
4-HA,561,0,2225,0,0,2225,T
4-HA,562,0,9,2229,0,2238,G
4-HA,563,2236,1,0,0,2237,A
4-HA,564,2229,0,0,0,2229,A
4-HA,565,0,0,1,2183,2184,C
4-HA,566,2194,0,1,0,2195,A
4-HA,567,2213,0,0,0,2213,A
4-HA,568,0,2213,0,0,2213,T
4-HA,569,0,2210,0,0,2210,T
4-HA,570,0,2205,0,4,2209,T
4-HA,571,0,10,2198,0,2208,G
4-HA,572,2212,0,1,0,2213,A
4-HA,573,1,0,0,2214,2215,C
4-HA,574,2223,0,1,0,2224,A
4-HA,575,2217,0,0,1,2218,A
4-HA,576,2240,0,0,0,2240,A
4-HA,577,0,2249,0,0,2249,T
4-HA,578,0,2222,0,2,2224,T
4-HA,579,0,0,2235,0,2235,G
4-HA,580,0,2222,0,1,2223,T
4-HA,581,2227,1,2,0,2230,A
4-HA,582,0,0,0,2276,2276,C
4-HA,583,2272,0,1,0,2273,A
4-HA,584,0,2308,0,0,2308,T
4-HA,585,0,2271,0,1,2272,T
4-HA,586,0,2266,0,0,2266,T
4-HA,587,0,2,2257,1,2260,G
4-HA,588,1,6,2228,1,2236,G
4-HA,589,0,13,2218,0,2231,G
4-HA,590,0,7,2230,0,2237,G
4-HA,591,1,7,2209,0,2217,G
4-HA,592,0,1,2271,0,2272,G
4-HA,593,0,2255,0,0,2255,T
4-HA,594,2,2261,0,0,2263,T
4-HA,595,2,0,0,2273,2275,C
4-HA,596,2262,0,3,0,2265,A
4-HA,597,0,1,0,2281,2282,C
4-HA,598,2,1,0,2278,2281,C
4-HA,599,2281,1,2,0,2284,A
4-HA,600,1,0,1,2312,2314,C
4-HA,601,2,0,1,2263,2266,C
4-HA,602,3,0,0,2260,2263,C
4-HA,603,0,7,2260,0,2267,G
4-HA,604,0,3,2351,0,2354,G
4-HA,605,2,1,2370,0,2373,G
4-HA,606,0,2328,0,1,2329,T
4-HA,607,2369,0,1,0,2370,A
4-HA,608,2,1,0,2353,2356,C
4-HA,609,2,3,2326,0,2331,G
4-HA,610,1,6,2346,0,2353,G
4-HA,611,2351,0,0,0,2351,A
4-HA,612,1,2,0,2352,2355,C
4-HA,613,2234,0,0,0,2234,A
4-HA,614,2224,0,0,1,2225,A
4-HA,615,0,2211,0,1,2212,T
4-HA,616,0,10,2237,0,2247,G
4-HA,617,2248,0,1,0,2249,A
4-HA,618,0,2,0,2235,2237,C
4-HA,619,4,2,0,2212,2218,C
4-HA,620,2228,0,0,0,2228,A
4-HA,621,2218,0,0,1,2219,A
4-HA,622,2257,0,0,0,2257,A
4-HA,623,2,2229,0,0,2231,T
4-HA,624,1,0,0,2267,2268,C
4-HA,625,0,2174,0,1,2175,T
4-HA,626,0,2145,0,1,2146,T
4-HA,627,2,0,0,2179,2181,C
4-HA,628,4,0,0,2198,2202,C
4-HA,629,0,2192,0,0,2192,T
4-HA,630,0,2,2211,0,2213,G
4-HA,631,1,2165,0,0,2166,T
4-HA,632,2187,0,0,0,2187,A
4-HA,633,0,2176,0,1,2177,T
4-HA,634,0,1,2191,0,2192,G
4-HA,635,1,1,0,2205,2207,C
4-HA,636,0,2176,0,4,2180,T
4-HA,637,3,4,0,2177,2184,C
4-HA,638,2184,0,3,0,2187,A
4-HA,639,2182,0,1,0,2183,A
4-HA,640,1,0,2185,0,2186,G
4-HA,641,1,0,0,2205,2206,C
4-HA,642,2221,0,0,0,2221,A
4-HA,643,0,2180,0,1,2181,T
4-HA,644,1,0,0,2180,2181,C
4-HA,645,2175,0,7,0,2182,A
4-HA,646,0,3,2198,0,2201,G
4-HA,647,0,5,2206,0,2211,G
4-HA,648,2217,0,1,0,2218,A
4-HA,649,2192,0,1,0,2193,A
4-HA,650,1,6,2224,0,2231,G
4-HA,651,2245,0,2,0,2247,A
4-HA,652,2266,0,0,0,2266,A
4-HA,653,1,2282,0,2,2285,T
4-HA,654,4,0,0,2287,2291,C
4-HA,655,2278,0,3,0,2281,A
4-HA,656,1,0,0,2285,2286,C
4-HA,657,2282,0,1,0,2283,A
4-HA,658,0,2,2324,0,2326,G
4-HA,659,0,2264,0,0,2264,T
4-HA,660,3,0,0,2297,2300,C
4-HA,661,0,2271,0,0,2271,T
4-HA,662,2,1,0,2316,2319,C
4-HA,663,1,2317,0,0,2318,T
4-HA,664,2330,0,0,0,2330,A
4-HA,665,1,0,0,2324,2325,C
4-HA,666,1,0,0,2332,2333,C
4-HA,667,2293,0,0,0,2293,A
4-HA,668,2294,0,0,0,2294,A
4-HA,669,2288,0,0,0,2288,A
4-HA,670,2288,0,0,0,2288,A
4-HA,671,2,4,2269,0,2275,G
4-HA,672,2230,0,3,0,2233,A
4-HA,673,2216,0,2,0,2218,A
4-HA,674,2,2,2221,0,2225,G
4-HA,675,1,2,0,2214,2217,C
4-HA,676,5,1,0,2224,2230,C
4-HA,677,2228,0,0,0,2228,A
4-HA,678,2226,0,4,1,2231,A
4-HA,679,0,1,0,2241,2242,C
4-HA,680,2246,0,0,0,2246,A
4-HA,681,2244,0,0,0,2244,A
4-HA,682,2246,0,0,0,2246,A
4-HA,683,1,3,0,2289,2293,C
4-HA,684,0,2272,0,1,2273,T
4-HA,685,0,0,2289,0,2289,G
4-HA,686,0,2265,0,2,2267,T
4-HA,687,2279,0,0,0,2279,A
4-HA,688,2285,0,0,0,2285,A
4-HA,689,0,2251,0,0,2251,T
4-HA,690,1,0,0,2277,2278,C
4-HA,691,4,3,0,2268,2275,C
4-HA,692,7,0,0,2240,2247,C
4-HA,693,1,0,2253,0,2254,G
4-HA,694,2242,0,0,0,2242,A
4-HA,695,2253,0,0,0,2253,A
4-HA,696,0,2246,0,0,2246,T
4-HA,697,2252,0,0,0,2252,A
4-HA,698,0,2225,0,0,2225,T
4-HA,699,1,1,0,2230,2232,C
4-HA,700,3,2,2223,0,2228,G
4-HA,701,0,1,2283,0,2284,G
4-HA,702,2290,0,0,0,2290,A
4-HA,703,0,2310,0,1,2311,T
4-HA,704,2,0,0,2315,2317,C
4-HA,705,0,2315,0,1,2316,T
4-HA,706,2310,1,1,0,2312,A
4-HA,707,0,9,2305,0,2314,G
4-HA,708,2319,0,2,0,2321,A
4-HA,709,2,1,0,2315,2318,C
4-HA,710,1,1,0,2234,2236,C
4-HA,711,8,0,0,2242,2250,C
4-HA,712,2234,0,0,0,2234,A
4-HA,713,0,1,2359,0,2360,G
4-HA,714,2359,0,0,0,2359,A
4-HA,715,1,0,2391,0,2392,G
4-HA,716,0,2363,0,0,2363,T
4-HA,717,2350,0,0,0,2350,A
4-HA,718,2356,1,3,0,2360,A
4-HA,719,1,7,2382,0,2390,G
4-HA,720,2,4,2391,0,2397,G
4-HA,721,2374,0,0,0,2374,A
4-HA,722,2237,0,1,0,2238,A
4-HA,723,0,2222,0,0,2222,T
4-HA,724,2225,0,0,0,2225,A
4-HA,725,0,2214,0,0,2214,T
4-HA,726,7,0,0,2238,2245,C
4-HA,727,4,0,0,2228,2232,C
4-HA,728,9,1,0,2199,2209,C
4-HA,729,1,2198,0,0,2199,T
4-HA,730,2213,0,0,0,2213,A
4-HA,731,0,0,2203,0,2203,G
4-HA,732,0,0,0,2210,2210,C
4-HA,733,2174,0,0,0,2174,A
4-HA,734,0,2,2234,0,2236,G
4-HA,735,2184,0,1,0,2185,A
4-HA,736,2204,0,0,0,2204,A
4-HA,737,0,2194,0,0,2194,T
4-HA,738,2196,0,0,0,2196,A
4-HA,739,2208,0,2,0,2210,A
4-HA,740,1,0,2190,0,2191,G
4-HA,741,0,0,0,2204,2204,C
4-HA,742,2204,0,1,0,2205,A
4-HA,743,0,2151,0,0,2151,T
4-HA,744,1,0,0,2273,2274,C
4-HA,745,0,2262,0,0,2262,T
4-HA,746,2285,2,0,0,2287,A
4-HA,747,0,2287,0,0,2287,T
4-HA,748,0,2275,0,0,2275,T
4-HA,749,0,3,2282,0,2285,G
4-HA,750,0,6,2262,0,2268,G
4-HA,751,2270,0,3,0,2273,A
4-HA,752,0,0,0,2288,2288,C
4-HA,753,2180,0,0,0,2180,A
4-HA,754,2233,0,0,0,2233,A
4-HA,755,0,2342,0,2,2344,T
4-HA,756,2362,0,1,0,2363,A
4-HA,757,1,1,2390,1,2393,G
4-HA,758,0,2359,0,1,2360,T
4-HA,759,2372,0,0,0,2372,A
4-HA,760,2376,0,0,0,2376,A
4-HA,761,2404,0,0,0,2404,A
4-HA,762,2411,1,4,1,2417,A
4-HA,763,2,0,0,2442,2444,C
4-HA,764,8,1,0,2344,2353,C
4-HA,765,0,5,2332,0,2337,G
4-HA,766,1,2,2340,0,2343,G
4-HA,767,0,6,2371,0,2377,G
4-HA,768,2377,0,0,0,2377,A
4-HA,769,0,5,2406,0,2411,G
4-HA,770,2435,0,3,1,2439,A
4-HA,771,0,1,0,2454,2455,C
4-HA,772,2444,1,3,3,2451,A
4-HA,773,1,2453,0,0,2454,T
4-HA,774,2452,0,1,0,2453,A
4-HA,775,2,0,0,2525,2527,C
4-HA,776,0,2490,0,1,2491,T
4-HA,777,0,2517,0,1,2518,T
4-HA,778,0,2536,0,0,2536,T
4-HA,779,0,2526,1,0,2527,T
4-HA,780,0,5,2564,0,2569,G
4-HA,781,2572,0,0,0,2572,A
4-HA,782,0,2568,0,1,2569,T
4-HA,783,0,2623,0,2,2625,T
4-HA,784,2605,2,0,0,2607,A
4-HA,785,2624,0,2,0,2626,A
4-HA,786,0,1,0,2663,2664,C
4-HA,787,2636,3,2,0,2641,A
4-HA,788,0,1,2739,0,2740,G
4-HA,789,1,0,0,2727,2728,C
4-HA,790,2731,0,0,1,2732,A
4-HA,791,1,0,0,2751,2752,C
4-HA,792,2738,0,2,0,2740,A
4-HA,793,0,6,2768,0,2774,G
4-HA,794,1,8,2743,0,2752,G
4-HA,795,3,5,2872,0,2880,G
4-HA,796,2856,0,2,0,2858,A
4-HA,797,2869,1,2,1,2873,A
4-HA,798,0,2878,0,1,2879,T
4-HA,799,2,0,1,2868,2871,C
4-HA,800,0,2899,1,0,2900,T
4-HA,801,2911,0,0,0,2911,A
4-HA,802,2903,1,0,0,2904,A
4-HA,803,0,2902,0,0,2902,T
4-HA,804,0,2824,0,3,2827,T
4-HA,805,0,2,2868,0,2870,G
4-HA,806,3,1,0,2941,2945,C
4-HA,807,0,3022,0,3,3025,T
4-HA,808,9,0,0,3103,3112,C
4-HA,809,5,0,0,3115,3120,C
4-HA,810,0,3129,0,2,3131,T
4-HA,811,3123,0,0,0,3123,A
4-HA,812,0,6,3141,0,3147,G
4-HA,813,2,13,3144,1,3160,G
4-HA,814,0,8,3141,0,3149,G
4-HA,815,1,3,3121,0,3125,G
4-HA,816,0,3061,1,0,3062,T
4-HA,817,0,3049,0,2,3051,T
4-HA,818,3048,0,3,0,3051,A
4-HA,819,0,0,0,3102,3102,C
4-HA,820,0,3098,0,1,3099,T
4-HA,821,1,3121,0,0,3122,T
4-HA,822,6,0,0,3115,3121,C
4-HA,823,3099,0,2,0,3101,A
4-HA,824,3109,0,0,0,3109,A
4-HA,825,3111,1,0,0,3112,A
4-HA,826,3146,1,1,0,3148,A
4-HA,827,0,3148,0,1,3149,T
4-HA,828,3109,0,2,0,3111,A
4-HA,829,1,2,0,3110,3113,C
4-HA,830,61,0,3053,1,3115,G
4-HA,831,3106,0,1,0,3107,A
4-HA,832,3116,0,0,0,3116,A
4-HA,833,3,5,3144,0,3152,G
4-HA,834,0,3134,0,0,3134,T
4-HA,835,2,14,3138,0,3154,G
4-HA,836,1,3,3165,0,3169,G
4-HA,837,0,3,3166,0,3169,G
4-HA,838,3178,0,4,0,3182,A
4-HA,839,3184,0,2,0,3186,A
4-HA,840,3190,0,0,0,3190,A
4-HA,841,3168,0,6,1,3175,A
4-HA,842,0,1,3212,0,3213,G
4-HA,843,0,0,0,3216,3216,C
4-HA,844,0,3195,0,1,3196,T
4-HA,845,8,1,0,3249,3258,C
4-HA,846,3261,0,1,0,3262,A
4-HA,847,3295,0,0,0,3295,A
4-HA,848,0,3294,0,2,3296,T
4-HA,849,3332,0,0,0,3332,A
4-HA,850,3330,0,0,0,3330,A
4-HA,851,0,3269,0,0,3269,T
4-HA,852,3,3,3280,0,3286,G
4-HA,853,3265,1,2,0,3268,A
4-HA,854,2,6,3349,0,3357,G
4-HA,855,3365,1,1,0,3367,A
4-HA,856,0,3329,0,1,3330,T
4-HA,857,6,0,0,3396,3402,C
4-HA,858,3384,0,0,1,3385,A
4-HA,859,1,1,3439,0,3441,G
4-HA,860,3453,0,1,0,3454,A
4-HA,861,0,3439,0,0,3439,T
4-HA,862,0,0,3430,0,3430,G
4-HA,863,1,1,0,3381,3383,C
4-HA,864,3384,1,2,0,3387,A
4-HA,865,0,1,0,3455,3456,C
4-HA,866,6,0,1,3415,3422,C
4-HA,867,4,1,0,3426,3431,C
4-HA,868,3373,0,1,0,3374,A
4-HA,869,0,3369,0,3,3372,T
4-HA,870,0,3375,0,1,3376,T
4-HA,871,0,7,3397,0,3404,G
4-HA,872,3,0,3380,1,3384,G
4-HA,873,2,0,1,3400,3403,C
4-HA,874,3352,0,0,0,3352,A
4-HA,875,3337,0,2,0,3339,A
4-HA,876,3405,0,1,0,3406,A
4-HA,877,0,3410,0,0,3410,T
4-HA,878,1,0,3405,0,3406,G
4-HA,879,0,1,0,3421,3422,C
4-HA,880,3389,0,2,0,3391,A
4-HA,881,3480,0,3,2,3485,A
4-HA,882,1,3476,0,0,3477,T
4-HA,883,0,3505,1,0,3506,T
4-HA,884,7,1,0,3514,3522,C
4-HA,885,0,3454,0,3,3457,T
4-HA,886,10,2,3502,0,3514,G
4-HA,887,3500,0,2,0,3502,A
4-HA,888,3513,0,0,0,3513,A
4-HA,889,0,3518,0,3,3521,T
4-HA,890,1,1,3428,0,3430,G
4-HA,891,0,2,0,3463,3465,C
4-HA,892,3454,0,0,0,3454,A
4-HA,893,1,3443,0,0,3444,T
4-HA,894,4,0,0,3436,3440,C
4-HA,895,3406,0,1,0,3407,A
4-HA,896,2,0,0,3561,3563,C
4-HA,897,0,3535,0,6,3541,T
4-HA,898,9,0,0,3560,3569,C
4-HA,899,2,2,1,3534,3539,C
4-HA,900,3591,0,0,0,3591,A
4-HA,901,3587,0,0,1,3588,A
4-HA,902,3572,0,2,0,3574,A
4-HA,903,0,3465,0,0,3465,T
4-HA,904,0,8,3483,1,3492,G
4-HA,905,0,4,3487,0,3491,G
4-HA,906,3490,0,4,0,3494,A
4-HA,907,3490,1,2,0,3493,A
4-HA,908,0,1,3501,0,3502,G
4-HA,909,1,0,0,3477,3478,C
4-HA,910,3452,1,1,0,3454,A
4-HA,911,0,3443,0,1,3444,T
4-HA,912,0,3436,0,1,3437,T
4-HA,913,6,1,0,3519,3526,C
4-HA,914,7,0,0,3483,3490,C
4-HA,915,3,5,0,3508,3516,C
4-HA,916,3515,0,2,0,3517,A
4-HA,917,3562,0,0,1,3563,A
4-HA,918,1,3603,0,1,3605,T
4-HA,919,2,11,3596,0,3609,G
4-HA,920,3600,0,2,0,3602,A
4-HA,921,1,0,0,3606,3607,C
4-HA,922,3533,1,1,0,3535,A
4-HA,923,3536,0,2,0,3538,A
4-HA,924,3516,0,0,0,3516,A
4-HA,925,0,0,0,3536,3536,C
4-HA,926,8,0,0,3478,3486,C
4-HA,927,3447,0,0,0,3447,A
4-HA,928,0,3446,0,1,3447,T
4-HA,929,0,3421,0,2,3423,T
4-HA,930,6,1,0,3439,3446,C
4-HA,931,7,1,0,3453,3461,C
4-HA,932,3474,0,1,0,3475,A
4-HA,933,3462,0,0,0,3462,A
4-HA,934,3474,0,0,1,3475,A
4-HA,935,3598,0,0,0,3598,A
4-HA,936,0,3571,1,0,3572,T
4-HA,937,0,0,3587,0,3587,G
4-HA,938,0,3564,1,1,3566,T
4-HA,939,3336,1,265,0,3602,A
4-HA,940,3604,0,1,0,3605,A
4-HA,941,3603,0,2,1,3606,A
4-HA,942,0,0,0,3621,3621,C
4-HA,943,3564,0,0,0,3564,A
4-HA,944,0,8,3551,0,3559,G
4-HA,945,0,9,3540,0,3549,G
4-HA,946,3637,0,2,0,3639,A
4-HA,947,0,3608,1,2,3611,T
4-HA,948,6,0,1,3662,3669,C
4-HA,949,3677,0,5,1,3683,A
4-HA,950,2,0,0,3794,3796,C
4-HA,951,3808,0,0,1,3809,A
4-HA,952,0,3902,1,1,3904,T
4-HA,953,3804,0,3,0,3807,A
4-HA,954,1,1,0,3785,3787,C
4-HA,955,0,4,3657,0,3661,G
4-HA,956,0,8,3656,1,3665,G
4-HA,957,3,7,3605,0,3615,G
4-HA,958,1,0,3633,2,3636,G
4-HA,959,2,1,0,3538,3541,C
4-HA,960,3,0,0,3568,3571,C
4-HA,961,0,3494,1,3,3498,T
4-HA,962,0,2,3860,0,3862,G
4-HA,963,0,3839,1,6,3846,T
4-HA,964,7,0,0,3866,3873,C
4-HA,965,7,1,0,3869,3877,C
4-HA,966,6,0,0,3871,3877,C
4-HA,967,3877,0,1,1,3879,A
4-HA,968,1,3,3910,0,3914,G
4-HA,969,3898,0,0,0,3898,A
4-HA,970,0,3880,2,1,3883,T
4-HA,971,3566,0,0,0,3566,A
4-HA,972,0,3505,1,0,3506,T
4-HA,973,0,1,3535,0,3536,G
4-HA,974,0,3527,1,1,3529,T
4-HA,975,0,3470,0,0,3470,T
4-HA,976,3500,1,1,0,3502,A
4-HA,977,3469,0,2,0,3471,A
4-HA,978,2,7,3471,0,3480,G
4-HA,979,0,0,0,3488,3488,C
4-HA,980,3446,0,1,0,3447,A
4-HA,981,3446,0,2,0,3448,A
4-HA,982,3425,0,0,0,3425,A
4-HA,983,3418,0,4,0,3422,A
4-HA,984,3,0,0,3411,3414,C
4-HA,985,3385,0,1,0,3386,A
4-HA,986,0,1,0,3434,3435,C
4-HA,987,0,3367,0,0,3367,T
4-HA,988,5,0,1,3389,3395,C
4-HA,989,0,3393,0,2,3395,T
4-HA,990,4,6,3424,0,3434,G
4-HA,991,3410,1,0,0,3411,A
4-HA,992,3419,0,0,0,3419,A
4-HA,993,3421,0,0,0,3421,A
4-HA,994,0,3390,0,0,3390,T
4-HA,995,0,3360,0,1,3361,T
4-HA,996,1,10,3392,0,3403,G
4-HA,997,1,0,3386,0,3387,G
4-HA,998,0,1,0,3408,3409,C
4-HA,999,3398,0,1,0,3399,A
4-HA,1000,3404,1,0,0,3405,A
4-HA,1001,0,0,0,3415,3415,C
4-HA,1002,3406,0,3,0,3409,A
4-HA,1003,0,13,3439,1,3453,G
4-HA,1004,0,3,3430,0,3433,G
4-HA,1005,1,2,3402,0,3405,G
4-HA,1006,3405,0,6,0,3411,A
4-HA,1007,0,3400,0,0,3400,T
4-HA,1008,0,1,3413,0,3414,G
4-HA,1009,1,3,0,3405,3409,C
4-HA,1010,1,8,3435,0,3444,G
4-HA,1011,3487,0,0,0,3487,A
4-HA,1012,3392,1,1,0,3394,A
4-HA,1013,3435,0,0,0,3435,A
4-HA,1014,0,3387,0,0,3387,T
4-HA,1015,0,40,3407,0,3447,G
4-HA,1016,0,3435,0,1,3436,T
4-HA,1017,3431,0,2,0,3433,A
4-HA,1018,4,1,0,3437,3442,C
4-HA,1019,14,1,0,3419,3434,C
4-HA,1020,3359,0,4,0,3363,A
4-HA,1021,0,6,3364,0,3370,G
4-HA,1022,3315,0,0,0,3315,A
4-HA,1023,2,5,3341,0,3348,G
4-HA,1024,3302,0,1,0,3303,A
4-HA,1025,3298,0,2,0,3300,A
4-HA,1026,3284,0,4,0,3288,A
4-HA,1027,2,1,0,3293,3296,C
4-HA,1028,3301,0,0,0,3301,A
4-HA,1029,3336,0,2,1,3339,A
4-HA,1030,3308,1,2,0,3311,A
4-HA,1031,1,1,0,3356,3358,C
4-HA,1032,0,3301,0,13,3314,T
4-HA,1033,3302,0,1,0,3303,A
4-HA,1034,0,3,3317,0,3320,G
4-HA,1035,3283,0,5,0,3288,A
4-HA,1036,0,2,3358,0,3360,G
4-HA,1037,0,2,3342,0,3344,G
4-HA,1038,2,1,0,3271,3274,C
4-HA,1039,3285,0,3,0,3288,A
4-HA,1040,0,3311,0,0,3311,T
4-HA,1041,3349,0,0,0,3349,A
4-HA,1042,0,3334,0,1,3335,T
4-HA,1043,0,3318,0,0,3318,T
4-HA,1044,0,3316,0,1,3317,T
4-HA,1045,2,11,3223,0,3236,G
4-HA,1046,1,2,3228,0,3231,G
4-HA,1047,0,2,0,3202,3204,C
4-HA,1048,2,0,3230,0,3232,G
4-HA,1049,0,0,0,3199,3199,C
4-HA,1050,3172,0,0,0,3172,A
4-HA,1051,3192,0,1,0,3193,A
4-HA,1052,0,3189,0,1,3190,T
4-HA,1053,4,0,0,3210,3214,C
4-HA,1054,0,0,3211,0,3211,G
4-HA,1055,2,1,0,3201,3204,C
4-HA,1056,5,10,3211,0,3226,G
4-HA,1057,2,4,3236,0,3242,G
4-HA,1058,1,0,3264,0,3265,G
4-HA,1059,0,3235,0,2,3237,T
4-HA,1060,0,3202,0,0,3202,T
4-HA,1061,0,3211,0,0,3211,T
4-HA,1062,6,1,0,3210,3217,C
4-HA,1063,3237,0,0,0,3237,A
4-HA,1064,0,3239,0,0,3239,T
4-HA,1065,3244,0,1,0,3245,A
4-HA,1066,0,3,3269,0,3272,G
4-HA,1067,3183,0,0,0,3183,A
4-HA,1068,3207,1,1,0,3209,A
4-HA,1069,3207,0,0,0,3207,A
4-HA,1070,3196,0,1,0,3197,A
4-HA,1071,0,3193,0,5,3198,T
4-HA,1072,0,11,3209,0,3220,G
4-HA,1073,2,0,3236,0,3238,G
4-HA,1074,0,3199,0,1,3200,T
4-HA,1075,0,3159,0,1,3160,T
4-HA,1076,1,10,3147,0,3158,G
4-HA,1077,0,5,3174,0,3179,G
4-HA,1078,2,4,3183,0,3189,G
4-HA,1079,3140,0,6,0,3146,A
4-HA,1080,0,11,3165,0,3176,G
4-HA,1081,2,9,3108,0,3119,G
4-HA,1082,0,3,3165,0,3168,G
4-HA,1083,3140,0,4,0,3144,A
4-HA,1084,3176,0,0,1,3177,A
4-HA,1085,0,3189,0,0,3189,T
4-HA,1086,0,10,3173,0,3183,G
4-HA,1087,0,0,3245,0,3245,G
4-HA,1088,0,3194,0,0,3194,T
4-HA,1089,1,9,3213,0,3223,G
4-HA,1090,3,3,3202,0,3208,G
4-HA,1091,3107,0,4,0,3111,A
4-HA,1092,0,3154,0,0,3154,T
4-HA,1093,1,10,3193,0,3204,G
4-HA,1094,0,0,3238,0,3238,G
4-HA,1095,0,3167,1,1,3169,T
4-HA,1096,0,3108,0,1,3109,T
4-HA,1097,0,2,3110,0,3112,G
4-HA,1098,3,0,3146,0,3149,G
4-HA,1099,1,3111,0,1,3113,T
4-HA,1100,3137,0,1,0,3138,A
4-HA,1101,0,5,0,2985,2990,C
4-HA,1102,0,4,3007,0,3011,G
4-HA,1103,0,0,3105,0,3105,G
4-HA,1104,0,3095,0,2,3097,T
4-HA,1105,0,3104,0,0,3104,T
4-HA,1106,0,3096,0,0,3096,T
4-HA,1107,7,1,0,3048,3056,C
4-HA,1108,3059,0,4,0,3063,A
4-HA,1109,0,3,3045,0,3048,G
4-HA,1110,0,0,3022,0,3022,G
4-HA,1111,2,1,0,3025,3028,C
4-HA,1112,2927,0,0,0,2927,A
4-HA,1113,0,2936,0,6,2942,T
4-HA,1114,3,0,0,2961,2964,C
4-HA,1115,2968,0,2,0,2970,A
4-HA,1116,2963,0,1,0,2964,A
4-HA,1117,2959,0,0,0,2959,A
4-HA,1118,2980,0,1,0,2981,A
4-HA,1119,0,2969,0,1,2970,T
4-HA,1120,0,2964,0,0,2964,T
4-HA,1121,6,2,0,2968,2976,C
4-HA,1122,0,2958,0,0,2958,T
4-HA,1123,1,3,2950,0,2954,G
4-HA,1124,2927,1,4,0,2932,A
4-HA,1125,0,11,2952,0,2963,G
4-HA,1126,2,8,2954,0,2964,G
4-HA,1127,0,2,2988,0,2990,G
4-HA,1128,2970,0,3,1,2974,A
4-HA,1129,2974,0,2,0,2976,A
4-HA,1130,0,4,2972,0,2976,G
4-HA,1131,2997,0,0,0,2997,A
4-HA,1132,1,4,3009,0,3014,G
4-HA,1133,3,4,3002,0,3009,G
4-HA,1134,2999,0,1,0,3000,A
4-HA,1135,0,0,0,2981,2981,C
4-HA,1136,2971,0,2,0,2973,A
4-HA,1137,2968,1,2,0,2971,A
4-HA,1138,1,2,2969,0,2972,G
4-HA,1139,2,1,0,2954,2957,C
4-HA,1140,2921,1,2,0,2924,A
4-HA,1141,0,0,2928,0,2928,G
4-HA,1142,0,0,0,2908,2908,C
4-HA,1143,2909,0,0,0,2909,A
4-HA,1144,3,0,2931,0,2934,G
4-HA,1145,2910,0,0,0,2910,A
4-HA,1146,0,2966,0,0,2966,T
4-HA,1147,5,0,0,2969,2974,C
4-HA,1148,0,2941,1,3,2945,T
4-HA,1149,5,0,0,2979,2984,C
4-HA,1150,2970,0,0,0,2970,A
4-HA,1151,2970,0,0,0,2970,A
4-HA,1152,2966,0,1,0,2967,A
4-HA,1153,2903,0,6,0,2909,A
4-HA,1154,0,2,2907,0,2909,G
4-HA,1155,1,0,0,2828,2829,C
4-HA,1156,2814,1,1,0,2816,A
4-HA,1157,0,0,0,2853,2853,C
4-HA,1158,0,2832,0,2,2834,T
4-HA,1159,6,0,0,2839,2845,C
4-HA,1160,2851,0,3,0,2854,A
4-HA,1161,2900,1,3,0,2904,A
4-HA,1162,1,1,2893,0,2895,G
4-HA,1163,1,1,0,2885,2887,C
4-HA,1164,2877,0,2,0,2879,A
4-HA,1165,0,0,2869,0,2869,G
4-HA,1166,1,1,1,2819,2822,C
4-HA,1167,2811,0,0,0,2811,A
4-HA,1168,2806,0,0,0,2806,A
4-HA,1169,0,2760,0,0,2760,T
4-HA,1170,6,0,0,2707,2713,C
4-HA,1171,2,5,2718,0,2725,G
4-HA,1172,2714,0,0,0,2714,A
4-HA,1173,1,2694,0,3,2698,T
4-HA,1174,9,0,0,2689,2698,C
4-HA,1175,2696,0,0,0,2696,A
4-HA,1176,2738,1,2,0,2741,A
4-HA,1177,2737,0,0,0,2737,A
4-HA,1178,0,2716,0,1,2717,T
4-HA,1179,7,0,0,2734,2741,C
4-HA,1180,2714,0,0,0,2714,A
4-HA,1181,2720,0,3,0,2723,A
4-HA,1182,1,2729,0,0,2730,T
4-HA,1183,0,9,2717,0,2726,G
4-HA,1184,1,3,2698,0,2702,G
4-HA,1185,1,2,2685,0,2688,G
4-HA,1186,2677,1,1,0,2679,A
4-HA,1187,2672,0,1,0,2673,A
4-HA,1188,0,2,2714,0,2716,G
4-HA,1189,0,1,0,2715,2716,C
4-HA,1190,0,2681,0,5,2686,T
4-HA,1191,4,5,2792,0,2801,G
4-HA,1192,2787,0,1,0,2788,A
4-HA,1193,2790,0,3,0,2793,A
4-HA,1194,0,2791,0,0,2791,T
4-HA,1195,2733,0,0,0,2733,A
4-HA,1196,0,1,2719,1,2721,G
4-HA,1197,2491,0,2,0,2493,A
4-HA,1198,1,2483,0,0,2484,T
4-HA,1199,1,2499,0,1,2501,T
4-HA,1200,2,2,2500,0,2504,G
4-HA,1201,2495,1,0,0,2496,A
4-HA,1202,0,2478,0,0,2478,T
4-HA,1203,6,0,0,2493,2499,C
4-HA,1204,0,3,2491,0,2494,G
4-HA,1205,0,4,2455,0,2459,G
4-HA,1206,4,4,2470,0,2478,G
4-HA,1207,2479,0,0,0,2479,A
4-HA,1208,2478,0,1,0,2479,A
4-HA,1209,2444,0,0,0,2444,A
4-HA,1210,2429,0,8,2,2439,A
4-HA,1211,0,2,0,2453,2455,C
4-HA,1212,5,0,0,2457,2462,C
4-HA,1213,2436,0,0,0,2436,A
4-HA,1214,2432,0,0,0,2432,A
4-HA,1215,2,3,0,2424,2429,C
4-HA,1216,0,4,2439,0,2443,G
4-HA,1217,2436,0,1,0,2437,A
4-HA,1218,0,2,2438,0,2440,G
4-HA,1219,2431,1,1,0,2433,A
4-HA,1220,2436,1,0,0,2437,A
4-HA,1221,2427,0,3,0,2430,A
4-HA,1222,0,2432,0,0,2432,T
4-HA,1223,0,2412,0,3,2415,T
4-HA,1224,5,1,1,2414,2421,C
4-HA,1225,6,2,0,2425,2433,C
4-HA,1226,2443,0,0,0,2443,A
4-HA,1227,0,2419,0,0,2419,T
4-HA,1228,6,0,0,2426,2432,C
4-HA,1229,2422,0,0,0,2422,A
4-HA,1230,13,3,2422,0,2438,G
4-HA,1231,2403,0,1,0,2404,A
4-HA,1232,0,2402,1,1,2404,T
4-HA,1233,1,2386,0,0,2387,T
4-HA,1234,0,5,2387,0,2392,G
4-HA,1235,2395,0,1,0,2396,A
4-HA,1236,2396,0,0,0,2396,A
4-HA,1237,2382,0,4,0,2386,A
4-HA,1238,2392,0,1,0,2393,A
4-HA,1239,2362,0,2,0,2364,A
4-HA,1240,0,3,2358,1,2362,G
4-HA,1241,2346,0,3,0,2349,A
4-HA,1242,2345,0,0,0,2345,A
4-HA,1243,0,2284,0,0,2284,T
4-HA,1244,1,2296,0,0,2297,T
4-HA,1245,6,3,0,2291,2300,C
4-HA,1246,1,2305,0,1,2307,T
4-HA,1247,1,0,1,2298,2300,C
4-HA,1248,2296,0,3,0,2299,A
4-HA,1249,0,1,2298,0,2299,G
4-HA,1250,2289,0,0,0,2289,A
4-HA,1251,2262,0,2,0,2264,A
4-HA,1252,0,0,2288,0,2288,G
4-HA,1253,0,2228,0,0,2228,T
4-HA,1254,6,1,0,2257,2264,C
4-HA,1255,2,0,2267,1,2270,G
4-HA,1256,2260,0,4,0,2264,A
4-HA,1257,2262,0,4,0,2266,A
4-HA,1258,1,7,2260,0,2268,G
4-HA,1259,0,4,2283,0,2287,G
4-HA,1260,1,4,2278,0,2283,G
4-HA,1261,2220,1,2,0,2223,A
4-HA,1262,0,1,2234,0,2235,G
4-HA,1263,2216,0,5,0,2221,A
4-HA,1264,2323,0,1,1,2325,A
4-HA,1265,0,2327,0,0,2327,T
4-HA,1266,0,2322,0,1,2323,T
4-HA,1267,5,1,0,2308,2314,C
4-HA,1268,2260,0,1,0,2261,A
4-HA,1269,0,3,2259,0,2262,G
4-HA,1270,3,3,2252,0,2258,G
4-HA,1271,2222,2,1,0,2225,A
4-HA,1272,1,0,0,2222,2223,C
4-HA,1273,7,1,0,2002,2010,C
4-HA,1274,0,1982,2,2,1986,T
4-HA,1275,0,1902,0,88,1990,T
4-HA,1276,0,3,2006,0,2009,G
4-HA,1277,2002,0,0,0,2002,A
4-HA,1278,0,1,2021,0,2022,G
4-HA,1279,2001,0,0,0,2001,A
4-HA,1280,1706,0,1,0,1707,A
4-HA,1281,1689,0,4,0,1693,A
4-HA,1282,0,1644,0,0,1644,T
4-HA,1283,1680,0,2,0,1682,A
4-HA,1284,0,1666,0,2,1668,T
4-HA,1285,0,0,1673,0,1673,G
4-HA,1286,0,1657,0,2,1659,T
4-HA,1287,0,1616,0,1,1617,T
4-HA,1288,0,2,1614,0,1616,G
4-HA,1289,1591,0,1,0,1592,A
4-HA,1290,2,3,1588,1,1594,G
4-HA,1291,2,2,1576,0,1580,G
4-HA,1292,1554,1,0,0,1555,A
4-HA,1293,0,3,0,1586,1589,C
4-HA,1294,1554,1,3,0,1558,A
4-HA,1295,1,1,0,1592,1594,C
4-HA,1296,1,2,0,1600,1603,C
4-HA,1297,1603,1,0,0,1604,A
4-HA,1298,1643,0,0,0,1643,A
4-HA,1299,1629,0,0,0,1629,A
4-HA,1300,1655,0,1,0,1656,A
4-HA,1301,0,1651,0,0,1651,T
4-HA,1302,1613,0,0,0,1613,A
4-HA,1303,0,4,1604,0,1608,G
4-HA,1304,1578,0,3,0,1581,A
4-HA,1305,0,1572,0,0,1572,T
4-HA,1306,2,0,0,1590,1592,C
4-HA,1307,0,1564,0,0,1564,T
4-HA,1308,2,1,0,1604,1607,C
4-HA,1309,0,1612,0,1,1613,T
4-HA,1310,0,3,1658,0,1661,G
4-HA,1311,1,1,1711,0,1713,G
4-HA,1312,0,1706,0,1,1707,T
4-HA,1313,6,1,0,1701,1708,C
4-HA,1314,1721,0,0,0,1721,A
4-HA,1315,0,1728,0,4,1732,T
4-HA,1316,1720,0,0,0,1720,A
4-HA,1317,0,2,0,1726,1728,C
4-HA,1318,1680,0,1,0,1681,A
4-HA,1319,1682,0,4,0,1686,A
4-HA,1320,0,1,0,1629,1630,C
4-HA,1321,0,0,1631,0,1631,G
4-HA,1322,2,1,0,1628,1631,C
4-HA,1323,3,5,1618,0,1626,G
4-HA,1324,0,2,1632,0,1634,G
4-HA,1325,1625,0,1,0,1626,A
4-HA,1326,0,1,1646,0,1647,G
4-HA,1327,0,0,0,1639,1639,C
4-HA,1328,0,1645,0,2,1647,T
4-HA,1329,0,1646,0,2,1648,T
4-HA,1330,2,0,0,1649,1651,C
4-HA,1331,0,1667,0,0,1667,T
4-HA,1332,0,1654,0,2,1656,T
4-HA,1333,1,0,1661,0,1662,G
4-HA,1334,0,1647,2,1,1650,T
4-HA,1335,1,1625,0,0,1626,T
4-HA,1336,0,1,1666,0,1667,G
4-HA,1337,0,0,0,1657,1657,C
4-HA,1338,1,0,0,1659,1660,C
4-HA,1339,4,1,0,1674,1679,C
4-HA,1340,0,1668,1,0,1669,T
4-HA,1341,4,2,1697,0,1703,G
4-HA,1342,0,5,1689,0,1694,G
4-HA,1343,1698,0,1,0,1699,A
4-HA,1344,1,2,1700,1,1704,G
4-HA,1345,1671,0,1,0,1672,A
4-HA,1346,1661,0,0,0,1661,A
4-HA,1347,2,2,0,1683,1687,C
4-HA,1348,3,1,0,1691,1695,C
4-HA,1349,1697,0,2,0,1699,A
4-HA,1350,1765,0,4,0,1769,A
4-HA,1351,1,0,0,1780,1781,C
4-HA,1352,1793,0,1,0,1794,A
4-HA,1353,0,1784,0,3,1787,T
4-HA,1354,1775,0,1,0,1776,A
4-HA,1355,0,2,0,1806,1808,C
4-HA,1356,1792,0,0,0,1792,A
4-HA,1357,1790,0,0,0,1790,A
4-HA,1358,0,1770,0,0,1770,T
4-HA,1359,0,1701,0,0,1701,T
4-HA,1360,2,4,1734,0,1740,G
4-HA,1361,1752,0,1,0,1753,A
4-HA,1362,0,1740,0,2,1742,T
4-HA,1363,1,0,1,1758,1760,C
4-HA,1364,1,1724,1,2,1728,T
4-HA,1365,1754,0,1,0,1755,A
4-HA,1366,1749,1,1,0,1751,A
4-HA,1367,1,2,0,1747,1750,C
4-HA,1368,0,1740,0,1,1741,T
4-HA,1369,0,4,1728,0,1732,G
4-HA,1370,1723,0,0,0,1723,A
4-HA,1371,0,1,0,1726,1727,C
4-HA,1372,1,1715,1,1,1718,T
4-HA,1373,3,0,0,1735,1738,C
4-HA,1374,1728,0,1,0,1729,A
4-HA,1375,0,3,1763,0,1766,G
4-HA,1376,1767,0,1,0,1768,A
4-HA,1377,1762,0,0,0,1762,A
4-HA,1378,1763,1,0,0,1764,A
4-HA,1379,0,1743,0,0,1743,T
4-HA,1380,0,6,1753,0,1759,G
4-HA,1381,1754,0,2,0,1756,A
4-HA,1382,1751,0,2,0,1753,A
4-HA,1383,1,0,0,1757,1758,C
4-HA,1384,1736,0,0,0,1736,A
4-HA,1385,1734,0,0,0,1734,A
4-HA,1386,1725,0,1,0,1726,A
4-HA,1387,0,0,0,1739,1739,C
4-HA,1388,0,1713,0,0,1713,T
4-HA,1389,0,3,1732,0,1735,G
4-HA,1390,0,1713,0,0,1713,T
4-HA,1391,0,1715,0,1,1716,T
4-HA,1392,0,1725,0,0,1725,T
4-HA,1393,1,1,1719,0,1721,G
4-HA,1394,1717,0,1,0,1718,A
4-HA,1395,1721,0,0,0,1721,A
4-HA,1396,1716,0,0,0,1716,A
4-HA,1397,1711,0,0,0,1711,A
4-HA,1398,1709,0,0,0,1709,A
4-HA,1399,1722,0,0,0,1722,A
4-HA,1400,1,1,0,1723,1725,C
4-HA,1401,1726,0,3,0,1729,A
4-HA,1402,1726,1,0,0,1727,A
4-HA,1403,1719,0,0,0,1719,A
4-HA,1404,0,5,1725,0,1730,G
4-HA,1405,1734,0,0,0,1734,A
4-HA,1406,1723,1,2,0,1726,A
4-HA,1407,0,1,1726,0,1727,G
4-HA,1408,0,0,0,1723,1723,C
4-HA,1409,1725,0,1,0,1726,A
4-HA,1410,1731,1,2,0,1734,A
4-HA,1411,1,0,0,1725,1726,C
4-HA,1412,0,1715,0,0,1715,T
4-HA,1413,2,5,1735,0,1742,G
4-HA,1414,1721,0,1,0,1722,A
4-HA,1415,0,6,1727,0,1733,G
4-HA,1416,0,3,1743,0,1746,G
4-HA,1417,0,4,1744,0,1748,G
4-HA,1418,1757,0,0,0,1757,A
4-HA,1419,1743,0,1,1,1745,A
4-HA,1420,1735,0,1,0,1736,A
4-HA,1421,1757,0,1,0,1758,A
4-HA,1422,0,1751,0,0,1751,T
4-HA,1423,0,0,1754,0,1754,G
4-HA,1424,0,0,0,1758,1758,C
4-HA,1425,0,1747,1,0,1748,T
4-HA,1426,0,1,1747,0,1748,G
4-HA,1427,1736,0,1,0,1737,A
4-HA,1428,1,2,1789,0,1792,G
4-HA,1429,0,2,1818,0,1820,G
4-HA,1430,1799,0,0,0,1799,A
4-HA,1431,0,1784,0,1,1785,T
4-HA,1432,1776,0,1,0,1777,A
4-HA,1433,0,1773,0,0,1773,T
4-HA,1434,0,5,1779,1,1785,G
4-HA,1435,1,2,1800,0,1803,G
4-HA,1436,2,0,1794,0,1796,G
4-HA,1437,0,0,0,1707,1707,C
4-HA,1438,1669,0,0,0,1669,A
4-HA,1439,1675,0,0,0,1675,A
4-HA,1440,0,1662,0,0,1662,T
4-HA,1441,1,2,1661,0,1664,G
4-HA,1442,0,0,1665,0,1665,G
4-HA,1443,0,1630,0,2,1632,T
4-HA,1444,0,1598,0,0,1598,T
4-HA,1445,2,0,1601,0,1603,G
4-HA,1446,0,1619,0,1,1620,T
4-HA,1447,0,1615,0,1,1616,T
4-HA,1448,0,1612,0,0,1612,T
4-HA,1449,4,0,0,1616,1620,C
4-HA,1450,1614,0,0,0,1614,A
4-HA,1451,1615,0,0,0,1615,A
4-HA,1452,1613,0,0,0,1613,A
4-HA,1453,1627,0,1,0,1628,A
4-HA,1454,0,1619,0,0,1619,T
4-HA,1455,1606,0,0,1,1607,A
4-HA,1456,0,1605,0,1,1606,T
4-HA,1457,1593,0,2,0,1595,A
4-HA,1458,0,0,0,1617,1617,C
4-HA,1459,6,0,0,1610,1616,C
4-HA,1460,1608,0,0,1,1609,A
4-HA,1461,0,1,0,1614,1615,C
4-HA,1462,1615,0,1,0,1616,A
4-HA,1463,1624,0,1,0,1625,A
4-HA,1464,1623,0,0,0,1623,A
4-HA,1465,0,1621,0,0,1621,T
4-HA,1466,0,0,1623,0,1623,G
4-HA,1467,0,1607,0,1,1608,T
4-HA,1468,0,9,1617,0,1626,G
4-HA,1469,1636,0,1,0,1637,A
4-HA,1470,1,0,0,1629,1630,C
4-HA,1471,1610,0,1,0,1611,A
4-HA,1472,1605,0,1,0,1606,A
4-HA,1473,0,1621,0,1,1622,T
4-HA,1474,0,0,1649,0,1649,G
4-HA,1475,0,2,0,1621,1623,C
4-HA,1476,2,0,0,1642,1644,C
4-HA,1477,1,1635,0,1,1637,T
4-HA,1478,2,1,1705,0,1708,G
4-HA,1479,0,0,0,1715,1715,C
4-HA,1480,1718,0,0,0,1718,A
4-HA,1481,0,1714,0,0,1714,T
4-HA,1482,1635,0,0,0,1635,A
4-HA,1483,4,2,1629,0,1635,G
4-HA,1484,0,3,1616,0,1619,G
4-HA,1485,1614,0,1,0,1615,A
4-HA,1486,0,1595,0,0,1595,T
4-HA,1487,5,0,0,1504,1509,C
4-HA,1488,1515,0,0,0,1515,A
4-HA,1489,1510,0,1,0,1511,A
4-HA,1490,1,1511,0,0,1512,T
4-HA,1491,2,0,0,1518,1520,C
4-HA,1492,1485,0,0,0,1485,A
4-HA,1493,0,1,1495,0,1496,G
4-HA,1494,1496,1,0,0,1497,A
4-HA,1495,1501,0,0,0,1501,A
4-HA,1496,1496,0,2,0,1498,A
4-HA,1497,0,1479,0,0,1479,T
4-HA,1498,0,3,1482,0,1485,G
4-HA,1499,0,3,1480,0,1483,G
4-HA,1500,1483,1,0,0,1484,A
4-HA,1501,1487,0,1,0,1488,A
4-HA,1502,0,0,0,1489,1489,C
4-HA,1503,0,1464,0,1,1465,T
4-HA,1504,0,1486,0,1,1487,T
4-HA,1505,1488,0,0,0,1488,A
4-HA,1506,0,1482,0,1,1483,T
4-HA,1507,0,5,1480,0,1485,G
4-HA,1508,1486,0,1,0,1487,A
4-HA,1509,1,0,0,1486,1487,C
4-HA,1510,6,1,0,1467,1474,C
4-HA,1511,1478,0,0,0,1478,A
4-HA,1512,0,0,0,1506,1506,C
4-HA,1513,1,0,1540,0,1541,G
4-HA,1514,1573,0,1,0,1574,A
4-HA,1515,0,1590,0,0,1590,T
4-HA,1516,1,0,1671,0,1672,G
4-HA,1517,0,1641,0,0,1641,T
4-HA,1518,1735,0,0,1,1736,A
4-HA,1519,0,1732,0,2,1734,T
4-HA,1520,1728,0,0,0,1728,A
4-HA,1521,0,0,0,1727,1727,C
4-HA,1522,1569,0,1,0,1570,A
4-HA,1523,1,3,1587,0,1591,G
4-HA,1524,1482,0,0,0,1482,A
4-HA,1525,0,2,1450,0,1452,G
4-HA,1526,1439,0,2,0,1441,A
4-HA,1527,0,1340,0,0,1340,T
4-HA,1528,1,4,1332,0,1337,G
4-HA,1529,1332,0,0,0,1332,A
4-HA,1530,1329,0,1,0,1330,A
4-HA,1531,0,1,1355,0,1356,G
4-HA,1532,1,0,0,1320,1321,C
4-HA,1533,1323,0,0,0,1323,A
4-HA,1534,0,1321,0,0,1321,T
4-HA,1535,0,1310,0,1,1311,T
4-HA,1536,1325,1,0,0,1326,A
4-HA,1537,1323,0,0,0,1323,A
4-HA,1538,1320,0,0,0,1320,A
4-HA,1539,0,0,0,1327,1327,C
4-HA,1540,1284,0,1,0,1285,A
4-HA,1541,1280,0,0,0,1280,A
4-HA,1542,0,0,0,1287,1287,C
4-HA,1543,3,3,0,1271,1277,C
4-HA,1544,0,3,1270,0,1273,G
4-HA,1545,0,0,1309,0,1309,G
4-HA,1546,0,1307,0,3,1310,T
4-HA,1547,0,1308,0,0,1308,T
4-HA,1548,3,0,0,1299,1302,C
4-HA,1549,1,2,0,1299,1302,C
4-HA,1550,1296,0,2,0,1298,A
4-HA,1551,0,2,1314,0,1316,G
4-HA,1552,1314,0,0,0,1314,A
4-HA,1553,0,1302,0,0,1302,T
4-HA,1554,2,0,0,1248,1250,C
4-HA,1555,1247,0,0,0,1247,A
4-HA,1556,1250,0,0,0,1250,A
4-HA,1557,0,5,1254,0,1259,G
4-HA,1558,0,3,1251,0,1254,G
4-HA,1559,0,2,1246,0,1248,G
4-HA,1560,1190,0,1,1,1192,A
4-HA,1561,0,0,1215,0,1215,G
4-HA,1562,0,1209,0,1,1210,T
4-HA,1563,0,1209,0,0,1209,T
4-HA,1564,0,2,1219,0,1221,G
4-HA,1565,1198,0,1,1,1200,A
4-HA,1566,0,0,1216,0,1216,G
4-HA,1567,0,1,0,1208,1209,C
4-HA,1568,1,1204,0,0,1205,T
4-HA,1569,2,2,1198,0,1202,G
4-HA,1570,1198,0,0,0,1198,A
4-HA,1571,1201,0,2,0,1203,A
4-HA,1572,1,0,1205,0,1206,G
4-HA,1573,0,1179,0,0,1179,T
4-HA,1574,3,0,0,1182,1185,C
4-HA,1575,1168,0,0,0,1168,A
4-HA,1576,1,4,1162,0,1167,G
4-HA,1577,0,2,1161,0,1163,G
4-HA,1578,1,1,1131,0,1133,G
4-HA,1579,0,1175,0,2,1177,T
4-HA,1580,1187,0,0,0,1187,A
4-HA,1581,1,1,0,1192,1194,C
4-HA,1582,1186,0,1,0,1187,A
4-HA,1583,1184,0,0,0,1184,A
4-HA,1584,1183,0,0,0,1183,A
4-HA,1585,0,1,1189,0,1190,G
4-HA,1586,1155,0,0,0,1155,A
4-HA,1587,0,1112,0,10,1122,T
4-HA,1588,0,1122,0,0,1122,T
4-HA,1589,0,3,1121,0,1124,G
4-HA,1590,0,0,1126,0,1126,G
4-HA,1591,1125,0,0,0,1125,A
4-HA,1592,0,1118,0,0,1118,T
4-HA,1593,1,0,0,1116,1117,C
4-HA,1594,2,0,0,1099,1101,C
4-HA,1595,0,1102,0,0,1102,T
4-HA,1596,1110,0,0,0,1110,A
4-HA,1597,0,1114,0,0,1114,T
4-HA,1598,1,4,1105,0,1110,G
4-HA,1599,0,2,1112,0,1114,G
4-HA,1600,1083,0,0,0,1083,A
4-HA,1601,0,1082,0,1,1083,T
4-HA,1602,0,1075,0,0,1075,T
4-HA,1603,0,1065,0,1,1066,T
4-HA,1604,0,0,0,1063,1063,C
4-HA,1605,4,1,0,1054,1059,C
4-HA,1606,0,1042,0,0,1042,T
4-HA,1607,0,1044,0,1,1045,T
4-HA,1608,0,1034,0,0,1034,T
4-HA,1609,0,1,1046,0,1047,G
4-HA,1610,0,0,0,1044,1044,C
4-HA,1611,2,0,0,1045,1047,C
4-HA,1612,1021,0,1,0,1022,A
4-HA,1613,0,1020,0,1,1021,T
4-HA,1614,1037,0,0,0,1037,A
4-HA,1615,0,1038,0,1,1039,T
4-HA,1616,1,0,0,1027,1028,C
4-HA,1617,1034,0,0,0,1034,A
4-HA,1618,0,1026,0,2,1028,T
4-HA,1619,0,0,1027,0,1027,G
4-HA,1620,0,1017,1,0,1018,T
4-HA,1621,0,1012,0,0,1012,T
4-HA,1622,0,1013,0,1,1014,T
4-HA,1623,0,986,0,0,986,T
4-HA,1624,0,989,0,0,989,T
4-HA,1625,0,991,0,0,991,T
4-HA,1626,0,0,991,0,991,G
4-HA,1627,0,0,0,984,984,C
4-HA,1628,0,963,0,1,964,T
4-HA,1629,0,970,0,0,970,T
4-HA,1630,0,968,0,0,968,T
4-HA,1631,0,0,982,0,982,G
4-HA,1632,1,979,0,0,980,T
4-HA,1633,1,0,975,0,976,G
4-HA,1634,0,979,0,1,980,T
4-HA,1635,0,959,0,0,959,T
4-HA,1636,0,0,966,0,966,G
4-HA,1637,0,0,0,956,956,C
4-HA,1638,0,957,0,2,959,T
4-HA,1639,0,966,0,0,966,T
4-HA,1640,0,913,0,0,913,T
4-HA,1641,0,0,919,0,919,G
4-HA,1642,1,912,0,0,913,T
4-HA,1643,0,911,0,0,911,T
4-HA,1644,0,1,914,0,915,G
4-HA,1645,0,1,889,0,890,G
4-HA,1646,0,4,881,0,885,G
4-HA,1647,0,1,884,0,885,G
4-HA,1648,0,853,0,0,853,T
4-HA,1649,0,843,0,3,846,T
4-HA,1650,7,0,0,823,830,C
4-HA,1651,813,0,0,0,813,A
4-HA,1652,0,803,0,4,807,T
4-HA,1653,1,0,0,815,816,C
4-HA,1654,819,0,0,0,819,A
4-HA,1655,0,792,0,0,792,T
4-HA,1656,0,0,789,0,789,G
4-HA,1657,1,763,0,0,764,T
4-HA,1658,0,1,758,0,759,G
4-HA,1659,0,1,734,0,735,G
4-HA,1660,1,1,724,0,726,G
4-HA,1661,0,0,0,705,705,C
4-HA,1662,0,0,0,693,693,C
4-HA,1663,0,651,1,1,653,T
4-HA,1664,1,0,657,0,658,G
4-HA,1665,0,1,0,652,653,C
4-HA,1666,3,0,0,657,660,C
4-HA,1667,651,0,1,0,652,A
4-HA,1668,651,0,0,0,651,A
4-HA,1669,650,0,0,0,650,A
4-HA,1670,648,0,0,0,648,A
4-HA,1671,654,0,0,0,654,A
4-HA,1672,0,1,651,0,652,G
4-HA,1673,0,0,627,0,627,G
4-HA,1674,1,1,0,622,624,C
4-HA,1675,618,0,0,0,618,A
4-HA,1676,625,0,0,0,625,A
4-HA,1677,0,0,0,624,624,C
4-HA,1678,626,0,0,0,626,A
4-HA,1679,0,622,0,1,623,T
4-HA,1680,0,615,0,0,615,T
4-HA,1681,598,0,1,0,599,A
4-HA,1682,0,1,592,0,593,G
4-HA,1683,0,0,594,0,594,G
4-HA,1684,0,571,0,1,572,T
4-HA,1685,0,0,537,0,537,G
4-HA,1686,0,1,0,501,502,C
4-HA,1687,500,0,0,0,500,A
4-HA,1688,495,0,1,0,496,A
4-HA,1689,1,0,0,498,499,C
4-HA,1690,495,0,0,0,495,A
4-HA,1691,0,480,0,0,480,T
4-HA,1692,0,451,0,0,451,T
4-HA,1693,0,447,0,0,447,T
4-HA,1694,1,0,451,0,452,G
4-HA,1695,0,0,0,445,445,C
4-HA,1696,444,0,0,0,444,A
4-HA,1697,0,415,0,1,416,T
4-HA,1698,1,404,0,0,405,T
4-HA,1699,0,384,0,0,384,T
4-HA,1700,0,0,386,0,386,G
4-HA,1701,365,0,0,0,365,A
5-NP,1,146,0,0,0,146,A
5-NP,2,0,147,0,0,147,T
5-NP,3,0,0,147,0,147,G
5-NP,4,0,0,146,0,146,G
5-NP,5,0,0,0,146,146,C
5-NP,6,0,0,156,0,156,G
5-NP,7,0,170,0,0,170,T
5-NP,8,0,0,0,173,173,C
5-NP,9,0,0,0,174,174,C
5-NP,10,1,0,0,177,178,C
5-NP,11,178,0,0,0,178,A
5-NP,12,176,0,0,0,176,A
5-NP,13,0,0,180,0,180,G
5-NP,14,1,0,181,0,182,G
5-NP,15,0,0,0,183,183,C
5-NP,16,184,0,0,0,184,A
5-NP,17,1,1,0,182,184,C
5-NP,18,1,0,0,186,187,C
5-NP,19,188,0,0,0,188,A
5-NP,20,187,0,0,0,187,A
5-NP,21,187,0,0,0,187,A
5-NP,22,0,1,0,189,190,C
5-NP,23,0,1,190,0,191,G
5-NP,24,0,0,210,0,210,G
5-NP,25,0,206,0,0,206,T
5-NP,26,0,0,0,226,226,C
5-NP,27,0,224,0,0,224,T
5-NP,28,0,230,0,0,230,T
5-NP,29,229,0,0,0,229,A
5-NP,30,0,230,0,0,230,T
5-NP,31,0,2,232,0,234,G
5-NP,32,231,0,0,0,231,A
5-NP,33,233,0,0,0,233,A
5-NP,34,0,0,0,235,235,C
5-NP,35,234,0,0,0,234,A
5-NP,36,0,0,248,0,248,G
5-NP,37,243,0,1,0,244,A
5-NP,38,0,245,0,0,245,T
5-NP,39,0,1,243,0,244,G
5-NP,40,0,0,244,0,244,G
5-NP,41,243,0,0,0,243,A
5-NP,42,247,0,0,0,247,A
5-NP,43,248,0,0,0,248,A
5-NP,44,0,0,0,256,256,C
5-NP,45,0,256,0,0,256,T
5-NP,46,0,0,259,0,259,G
5-NP,47,254,0,0,0,254,A
5-NP,48,0,258,0,0,258,T
5-NP,49,0,1,257,0,258,G
5-NP,50,0,1,261,0,262,G
5-NP,51,2,0,260,0,262,G
5-NP,52,0,1,261,0,262,G
5-NP,53,262,0,0,0,262,A
5-NP,54,0,260,0,0,260,T
5-NP,55,2,0,0,259,261,C
5-NP,56,0,0,260,0,260,G
5-NP,57,0,0,0,269,269,C
5-NP,58,0,0,0,268,268,C
5-NP,59,269,0,0,0,269,A
5-NP,60,0,1,273,0,274,G
5-NP,61,271,0,0,0,271,A
5-NP,62,277,0,0,0,277,A
5-NP,63,0,277,1,0,278,T
5-NP,64,0,0,278,0,278,G
5-NP,65,0,1,0,279,280,C
5-NP,66,280,0,0,0,280,A
5-NP,67,285,0,0,0,285,A
5-NP,68,0,0,0,285,285,C
5-NP,69,0,284,0,0,284,T
5-NP,70,0,0,287,0,287,G
5-NP,71,289,0,0,0,289,A
5-NP,72,0,1,310,0,311,G
5-NP,73,306,0,0,0,306,A
5-NP,74,0,302,0,0,302,T
5-NP,75,0,302,0,0,302,T
5-NP,76,302,0,0,0,302,A
5-NP,77,0,1,301,0,302,G
5-NP,78,0,2,298,0,300,G
5-NP,79,0,0,300,0,300,G
5-NP,80,0,0,0,295,295,C
5-NP,81,294,0,0,0,294,A
5-NP,82,0,299,0,0,299,T
5-NP,83,0,0,0,304,304,C
5-NP,84,3,0,0,296,299,C
5-NP,85,1,1,302,0,304,G
5-NP,86,0,307,0,0,307,T
5-NP,87,1,0,0,306,307,C
5-NP,88,0,1,304,0,305,G
5-NP,89,0,0,304,0,304,G
5-NP,90,0,0,308,0,308,G
5-NP,91,306,0,0,0,306,A
5-NP,92,307,0,0,0,307,A
5-NP,93,0,0,311,0,311,G
5-NP,94,309,0,0,0,309,A
5-NP,95,0,305,0,1,306,T
5-NP,96,0,1,307,1,309,G
5-NP,97,309,0,0,0,309,A
5-NP,98,0,307,0,0,307,T
5-NP,99,0,307,0,0,307,T
5-NP,100,0,0,305,0,305,G
5-NP,101,305,0,0,0,305,A
5-NP,102,0,304,0,0,304,T
5-NP,103,0,1,304,0,305,G
5-NP,104,0,1,311,0,312,G
5-NP,105,311,0,0,0,311,A
5-NP,106,311,0,0,0,311,A
5-NP,107,0,307,0,0,307,T
5-NP,108,0,312,0,0,312,T
5-NP,109,0,2,306,0,308,G
5-NP,110,0,0,307,0,307,G
5-NP,111,1,2,305,0,308,G
5-NP,112,308,0,0,0,308,A
5-NP,113,0,0,306,0,306,G
5-NP,114,306,0,0,0,306,A
5-NP,115,0,311,0,0,311,T
5-NP,116,0,315,0,0,315,T
5-NP,117,0,0,0,313,313,C
5-NP,118,0,315,0,1,316,T
5-NP,119,319,0,0,0,319,A
5-NP,120,0,0,0,321,321,C
5-NP,121,330,0,0,0,330,A
5-NP,122,0,330,0,0,330,T
5-NP,123,0,0,0,330,330,C
5-NP,124,0,0,0,334,334,C
5-NP,125,332,0,0,0,332,A
5-NP,126,342,1,0,0,343,A
5-NP,127,343,1,0,0,344,A
5-NP,128,0,343,0,0,343,T
5-NP,129,0,0,341,0,341,G
5-NP,130,0,335,0,0,335,T
5-NP,131,0,1,333,0,334,G
5-NP,132,0,0,0,335,335,C
5-NP,133,332,0,0,0,332,A
5-NP,134,0,0,0,333,333,C
5-NP,135,0,327,0,0,327,T
5-NP,136,0,0,337,0,337,G
5-NP,137,338,1,0,0,339,A
5-NP,138,341,1,0,0,342,A
5-NP,139,0,1,0,349,350,C
5-NP,140,0,347,0,1,348,T
5-NP,141,0,348,0,0,348,T
5-NP,142,346,0,0,0,346,A
5-NP,143,344,0,0,0,344,A
5-NP,144,349,0,0,0,349,A
5-NP,145,0,0,0,348,348,C
5-NP,146,0,339,0,0,339,T
5-NP,147,1,1,0,341,343,C
5-NP,148,339,0,0,0,339,A
5-NP,149,0,0,344,0,344,G
5-NP,150,0,343,0,0,343,T
5-NP,151,0,2,345,0,347,G
5-NP,152,355,0,0,0,355,A
5-NP,153,0,355,0,0,355,T
5-NP,154,0,1,0,354,355,C
5-NP,155,356,0,0,0,356,A
5-NP,156,0,357,0,0,357,T
5-NP,157,0,1,354,0,355,G
5-NP,158,353,0,0,0,353,A
5-NP,159,351,0,0,0,351,A
5-NP,160,0,1,352,0,353,G
5-NP,161,0,0,348,0,348,G
5-NP,162,0,0,346,0,346,G
5-NP,163,0,0,0,339,339,C
5-NP,164,0,1,343,0,344,G
5-NP,165,0,0,345,0,345,G
5-NP,166,0,347,0,0,347,T
5-NP,167,0,343,0,0,343,T
5-NP,168,0,1,344,0,345,G
5-NP,169,383,0,0,0,383,A
5-NP,170,0,384,0,0,384,T
5-NP,171,0,0,0,382,382,C
5-NP,172,0,1,0,381,382,C
5-NP,173,380,0,0,0,380,A
5-NP,174,0,1,383,0,384,G
5-NP,175,381,0,0,0,381,A
5-NP,176,383,0,0,0,383,A
5-NP,177,0,0,0,381,381,C
5-NP,178,361,0,1,0,362,A
5-NP,179,1,0,364,0,365,G
5-NP,180,0,0,0,359,359,C
5-NP,181,0,366,0,1,367,T
5-NP,182,0,367,0,0,367,T
5-NP,183,0,2,365,0,367,G
5-NP,184,363,0,1,0,364,A
5-NP,185,0,0,0,367,367,C
5-NP,186,362,0,0,0,362,A
5-NP,187,366,0,0,0,366,A
5-NP,188,0,368,0,0,368,T
5-NP,189,365,0,0,0,365,A
5-NP,190,0,2,367,0,369,G
5-NP,191,365,0,0,0,365,A
5-NP,192,0,0,369,0,369,G
5-NP,193,366,0,0,0,366,A
5-NP,194,376,0,0,0,376,A
5-NP,195,375,0,0,0,375,A
5-NP,196,375,0,0,0,375,A
5-NP,197,0,380,0,0,380,T
5-NP,198,0,0,380,0,380,G
5-NP,199,0,0,378,0,378,G
5-NP,200,0,374,0,0,374,T
5-NP,201,370,0,2,0,372,A
5-NP,202,0,0,0,380,380,C
5-NP,203,0,383,0,0,383,T
5-NP,204,0,0,0,385,385,C
5-NP,205,0,377,0,0,377,T
5-NP,206,1,0,0,379,380,C
5-NP,207,0,378,0,0,378,T
5-NP,208,0,0,381,0,381,G
5-NP,209,0,0,0,381,381,C
5-NP,210,0,381,0,0,381,T
5-NP,211,0,377,0,0,377,T
5-NP,212,0,379,0,0,379,T
5-NP,213,0,373,0,0,373,T
5-NP,214,0,0,377,0,377,G
5-NP,215,370,0,0,0,370,A
5-NP,216,0,373,0,1,374,T
5-NP,217,0,0,375,0,375,G
5-NP,218,370,0,0,0,370,A
5-NP,219,371,0,0,0,371,A
5-NP,220,370,0,0,0,370,A
5-NP,221,0,0,373,0,373,G
5-NP,222,369,0,1,0,370,A
5-NP,223,367,0,0,0,367,A
5-NP,224,0,0,371,0,371,G
5-NP,225,0,0,383,0,383,G
5-NP,226,386,0,0,0,386,A
5-NP,227,388,0,1,0,389,A
5-NP,228,0,386,0,0,386,T
5-NP,229,389,0,1,0,390,A
5-NP,230,390,0,0,0,390,A
5-NP,231,391,0,0,0,391,A
5-NP,232,0,388,0,0,388,T
5-NP,233,387,0,0,0,387,A
5-NP,234,0,0,0,391,391,C
5-NP,235,1,0,0,381,382,C
5-NP,236,0,387,0,0,387,T
5-NP,237,0,0,384,0,384,G
5-NP,238,0,0,393,0,393,G
5-NP,239,388,0,0,0,388,A
5-NP,240,389,0,0,0,389,A
5-NP,241,0,0,396,0,396,G
5-NP,242,390,0,0,0,390,A
5-NP,243,388,0,0,0,388,A
5-NP,244,0,0,0,392,392,C
5-NP,245,388,0,0,0,388,A
5-NP,246,1,0,0,398,399,C
5-NP,247,0,0,0,393,393,C
5-NP,248,0,0,0,390,390,C
5-NP,249,1,1,0,392,394,C
5-NP,250,391,0,0,0,391,A
5-NP,251,0,0,392,0,392,G
5-NP,252,0,0,0,387,387,C
5-NP,253,0,0,386,0,386,G
5-NP,254,1,0,0,385,386,C
5-NP,255,0,3,379,0,382,G
5-NP,256,0,1,391,0,392,G
5-NP,257,1,1,389,0,391,G
5-NP,258,1,0,393,0,394,G
5-NP,259,391,0,0,0,391,A
5-NP,260,392,0,0,0,392,A
5-NP,261,388,0,1,0,389,A
5-NP,262,0,1,390,0,391,G
5-NP,263,391,0,0,0,391,A
5-NP,264,0,385,0,0,385,T
5-NP,265,2,0,0,387,389,C
5-NP,266,1,0,0,381,382,C
5-NP,267,1,0,0,388,389,C
5-NP,268,392,0,0,0,392,A
5-NP,269,390,0,0,0,390,A
5-NP,270,0,0,394,0,394,G
5-NP,271,392,0,2,0,394,A
5-NP,272,395,0,0,0,395,A
5-NP,273,395,0,0,0,395,A
5-NP,274,395,0,0,0,395,A
5-NP,275,0,0,0,398,398,C
5-NP,276,0,389,0,0,389,T
5-NP,277,1,0,387,0,388,G
5-NP,278,0,1,387,0,388,G
5-NP,279,0,1,391,0,392,G
5-NP,280,1,1,389,0,391,G
5-NP,281,0,0,392,0,392,G
5-NP,282,0,0,398,0,398,G
5-NP,283,0,1,0,428,429,C
5-NP,284,1,1,0,433,435,C
5-NP,285,0,0,0,433,433,C
5-NP,286,482,0,0,0,482,A
5-NP,287,0,484,0,0,484,T
5-NP,288,510,0,0,0,510,A
5-NP,289,0,512,0,1,513,T
5-NP,290,509,0,0,0,509,A
5-NP,291,0,1,0,506,507,C
5-NP,292,472,0,0,0,472,A
5-NP,293,0,2,482,0,484,G
5-NP,294,0,1,484,0,485,G
5-NP,295,444,0,0,0,444,A
5-NP,296,0,0,455,0,455,G
5-NP,297,433,0,1,0,434,A
5-NP,298,0,0,447,0,447,G
5-NP,299,0,438,0,0,438,T
5-NP,300,443,0,0,0,443,A
5-NP,301,1,0,442,0,443,G
5-NP,302,438,0,2,0,440,A
5-NP,303,0,442,0,0,442,T
5-NP,304,0,0,441,0,441,G
5-NP,305,0,0,447,0,447,G
5-NP,306,441,0,0,0,441,A
5-NP,307,445,0,0,0,445,A
5-NP,308,441,0,0,0,441,A
5-NP,309,443,0,0,0,443,A
5-NP,310,0,444,0,0,444,T
5-NP,311,0,4,448,0,452,G
5-NP,312,0,0,449,0,449,G
5-NP,313,447,0,0,0,447,A
5-NP,314,0,447,0,0,447,T
5-NP,315,0,0,451,0,451,G
5-NP,316,447,0,0,0,447,A
5-NP,317,0,1,453,0,454,G
5-NP,318,0,2,446,0,448,G
5-NP,319,0,0,450,0,450,G
5-NP,320,482,0,0,0,482,A
5-NP,321,481,0,0,0,481,A
5-NP,322,0,1,0,503,504,C
5-NP,323,0,504,0,0,504,T
5-NP,324,3,0,0,512,515,C
5-NP,325,0,0,534,0,534,G
5-NP,326,0,539,0,1,540,T
5-NP,327,3,0,0,559,562,C
5-NP,328,0,0,0,687,687,C
5-NP,329,0,683,0,1,684,T
5-NP,330,0,692,0,0,692,T
5-NP,331,0,692,0,0,692,T
5-NP,332,699,0,0,0,699,A
5-NP,333,0,702,0,0,702,T
5-NP,334,0,2,700,0,702,G
5-NP,335,710,0,1,0,711,A
5-NP,336,0,0,0,714,714,C
5-NP,337,706,0,0,0,706,A
5-NP,338,705,0,1,0,706,A
5-NP,339,717,0,1,0,718,A
5-NP,340,0,2,792,0,794,G
5-NP,341,790,0,0,0,790,A
5-NP,342,787,0,1,0,788,A
5-NP,343,0,0,859,1,860,G
5-NP,344,862,0,0,0,862,A
5-NP,345,881,0,0,0,881,A
5-NP,346,872,0,1,0,873,A
5-NP,347,0,876,0,1,877,T
5-NP,348,877,0,0,0,877,A
5-NP,349,874,0,1,0,875,A
5-NP,350,0,0,882,0,882,G
5-NP,351,0,0,877,0,877,G
5-NP,352,0,0,0,882,882,C
5-NP,353,1,1,885,0,887,G
5-NP,354,893,0,0,0,893,A
5-NP,355,913,0,0,0,913,A
5-NP,356,0,916,0,0,916,T
5-NP,357,1,1,1,925,928,C
5-NP,358,0,924,1,0,925,T
5-NP,359,1,2,924,0,927,G
5-NP,360,1,0,920,0,921,G
5-NP,361,1,0,0,927,928,C
5-NP,362,0,2,923,0,925,G
5-NP,363,0,2,0,925,927,C
5-NP,364,2,0,0,930,932,C
5-NP,365,938,0,0,0,938,A
5-NP,366,967,0,1,0,968,A
5-NP,367,1,0,1008,0,1009,G
5-NP,368,0,0,0,1009,1009,C
5-NP,369,1,0,0,1025,1026,C
5-NP,370,1034,0,0,0,1034,A
5-NP,371,1051,0,1,0,1052,A
5-NP,372,0,0,0,1078,1078,C
5-NP,373,1074,0,0,1,1075,A
5-NP,374,1107,0,0,0,1107,A
5-NP,375,0,1113,0,0,1113,T
5-NP,376,1,3,1158,0,1162,G
5-NP,377,0,0,1168,0,1168,G
5-NP,378,1,1149,0,0,1150,T
5-NP,379,0,1,1162,0,1163,G
5-NP,380,1154,0,0,0,1154,A
5-NP,381,0,4,1193,0,1197,G
5-NP,382,1,0,1188,0,1189,G
5-NP,383,1204,0,0,0,1204,A
5-NP,384,0,1335,0,0,1335,T
5-NP,385,0,0,1356,0,1356,G
5-NP,386,0,1,0,1369,1370,C
5-NP,387,0,1377,0,0,1377,T
5-NP,388,1396,0,1,0,1397,A
5-NP,389,0,0,0,1431,1431,C
5-NP,390,1423,0,0,0,1423,A
5-NP,391,0,1418,1,0,1419,T
5-NP,392,1,0,0,1415,1416,C
5-NP,393,0,1366,0,1,1367,T
5-NP,394,0,6,1417,0,1423,G
5-NP,395,0,0,1449,0,1449,G
5-NP,396,0,1445,0,1,1446,T
5-NP,397,5,0,0,1450,1455,C
5-NP,398,0,1456,0,0,1456,T
5-NP,399,1484,0,0,0,1484,A
5-NP,400,1483,0,0,0,1483,A
5-NP,401,0,0,0,1504,1504,C
5-NP,402,0,1500,0,0,1500,T
5-NP,403,1,0,0,1529,1530,C
5-NP,404,1525,0,0,0,1525,A
5-NP,405,0,0,0,1606,1606,C
5-NP,406,1607,0,0,0,1607,A
5-NP,407,0,1607,0,1,1608,T
5-NP,408,1601,0,1,0,1602,A
5-NP,409,1599,0,0,0,1599,A
5-NP,410,0,1608,0,0,1608,T
5-NP,411,0,3,1631,0,1634,G
5-NP,412,1630,0,0,0,1630,A
5-NP,413,0,1624,0,0,1624,T
5-NP,414,0,1603,0,0,1603,T
5-NP,415,0,1611,0,2,1613,T
5-NP,416,0,0,1604,2,1606,G
5-NP,417,2,0,1601,0,1603,G
5-NP,418,0,1,0,1613,1614,C
5-NP,419,1614,0,0,0,1614,A
5-NP,420,0,1621,0,1,1622,T
5-NP,421,0,1619,0,1,1620,T
5-NP,422,1,0,0,1629,1630,C
5-NP,423,2,0,0,1630,1632,C
5-NP,424,1671,0,1,0,1672,A
5-NP,425,1672,1,0,1,1674,A
5-NP,426,0,1677,0,1,1678,T
5-NP,427,0,1680,0,0,1680,T
5-NP,428,0,1677,0,1,1678,T
5-NP,429,0,4,1695,0,1699,G
5-NP,430,1690,0,1,0,1691,A
5-NP,431,1690,0,0,1,1691,A
5-NP,432,1,1710,0,0,1711,T
5-NP,433,0,4,1693,0,1697,G
5-NP,434,1757,1,0,0,1758,A
5-NP,435,1,1764,0,2,1767,T
5-NP,436,0,1,1772,0,1773,G
5-NP,437,0,0,0,1823,1823,C
5-NP,438,1810,1,2,0,1813,A
5-NP,439,1892,0,2,0,1894,A
5-NP,440,0,0,0,1894,1894,C
5-NP,441,1931,0,0,0,1931,A
5-NP,442,0,1991,0,2,1993,T
5-NP,443,1959,0,1,0,1960,A
5-NP,444,0,0,0,1993,1993,C
5-NP,445,3,0,0,1998,2001,C
5-NP,446,1971,0,2,0,1973,A
5-NP,447,0,2,1986,1,1989,G
5-NP,448,1953,0,0,0,1953,A
5-NP,449,0,4,1986,0,1990,G
5-NP,450,0,3,1973,0,1976,G
5-NP,451,1960,0,1,0,1961,A
5-NP,452,0,1,0,1990,1991,C
5-NP,453,1969,0,0,0,1969,A
5-NP,454,1975,0,2,0,1977,A
5-NP,455,0,4,1977,0,1981,G
5-NP,456,1954,0,2,0,1956,A
5-NP,457,1,0,1971,0,1972,G
5-NP,458,1,0,0,1960,1961,C
5-NP,459,0,1936,0,1,1937,T
5-NP,460,2,0,0,1961,1963,C
5-NP,461,0,1951,0,0,1951,T
5-NP,462,0,1963,0,2,1965,T
5-NP,463,0,0,1972,0,1972,G
5-NP,464,0,1964,0,0,1964,T
5-NP,465,0,1964,0,3,1967,T
5-NP,466,13,1,0,1957,1971,C
5-NP,467,0,7,1960,0,1967,G
5-NP,468,2005,0,1,0,2006,A
5-NP,469,2009,0,0,1,2010,A
5-NP,470,0,2,0,2024,2026,C
5-NP,471,0,2028,0,0,2028,T
5-NP,472,0,0,2057,0,2057,G
5-NP,473,0,1,2052,0,2053,G
5-NP,474,2057,0,0,0,2057,A
5-NP,475,2062,0,0,0,2062,A
5-NP,476,0,2056,0,0,2056,T
5-NP,477,0,2,2040,0,2042,G
5-NP,478,1,1,2046,0,2048,G
5-NP,479,2079,0,1,0,2080,A
5-NP,480,0,2109,0,2,2111,T
5-NP,481,4,0,0,2110,2114,C
5-NP,482,2,0,0,2125,2127,C
5-NP,483,8,3,0,2132,2143,C
5-NP,484,2192,0,0,0,2192,A
5-NP,485,0,0,2238,0,2238,G
5-NP,486,2251,0,0,0,2251,A
5-NP,487,2244,0,2,0,2246,A
5-NP,488,0,2226,0,0,2226,T
5-NP,489,2,3,2276,0,2281,G
5-NP,490,2,2256,0,0,2258,T
5-NP,491,0,1,2277,0,2278,G
5-NP,492,0,1,0,2281,2282,C
5-NP,493,0,2268,0,3,2271,T
5-NP,494,7,0,0,2453,2460,C
5-NP,495,0,2457,0,0,2457,T
5-NP,496,4,1,0,2605,2610,C
5-NP,497,1,2598,0,3,2602,T
5-NP,498,1,5,2623,0,2629,G
5-NP,499,2638,1,2,0,2641,A
5-NP,500,0,2650,0,0,2650,T
5-NP,501,0,0,2640,0,2640,G
5-NP,502,0,0,0,2644,2644,C
5-NP,503,2575,0,2,0,2577,A
5-NP,504,0,4,2651,0,2655,G
5-NP,505,0,5,2595,0,2600,G
5-NP,506,0,0,2623,0,2623,G
5-NP,507,2,0,0,2625,2627,C
5-NP,508,0,2608,0,0,2608,T
5-NP,509,4,2,0,2641,2647,C
5-NP,510,0,2,2635,0,2637,G
5-NP,511,2683,0,0,0,2683,A
5-NP,512,0,0,0,2688,2688,C
5-NP,513,0,2651,0,0,2651,T
5-NP,514,3,0,0,2828,2831,C
5-NP,515,0,2812,0,0,2812,T
5-NP,516,3,0,0,3274,3277,C
5-NP,517,9,0,0,3290,3299,C
5-NP,518,10,2,0,3299,3311,C
5-NP,519,0,3298,0,0,3298,T
5-NP,520,3289,0,3,0,3292,A
5-NP,521,1,5,3274,1,3281,G
5-NP,522,3272,0,1,0,3273,A
5-NP,523,3195,0,2,2,3199,A
5-NP,524,0,10,3194,0,3204,G
5-NP,525,0,1,3178,0,3179,G
5-NP,526,0,3135,0,2,3137,T
5-NP,527,4,0,0,3172,3176,C
5-NP,528,5,2,0,3160,3167,C
5-NP,529,0,6,3170,0,3176,G
5-NP,530,0,6,3197,0,3203,G
5-NP,531,3193,0,3,0,3196,A
5-NP,532,1,0,3253,0,3254,G
5-NP,533,0,0,0,3267,3267,C
5-NP,534,0,3244,0,1,3245,T
5-NP,535,2,0,3264,0,3266,G
5-NP,536,1,0,0,3279,3280,C
5-NP,537,3256,0,6,0,3262,A
5-NP,538,0,2,3289,0,3291,G
5-NP,539,2,0,3275,1,3278,G
5-NP,540,0,3235,0,0,3235,T
5-NP,541,1,1,3254,0,3256,G
5-NP,542,0,2,0,3253,3255,C
5-NP,543,0,3272,0,2,3274,T
5-NP,544,7,1,3275,0,3283,G
5-NP,545,0,2,0,3278,3280,C
5-NP,546,3309,0,0,0,3309,A
5-NP,547,1,0,3396,0,3397,G
5-NP,548,0,3339,0,0,3339,T
5-NP,549,9,0,0,3356,3365,C
5-NP,550,3356,0,1,0,3357,A
5-NP,551,3370,0,2,0,3372,A
5-NP,552,3363,0,6,0,3369,A
5-NP,553,0,8,3381,0,3389,G
5-NP,554,0,11,3381,0,3392,G
5-NP,555,3387,0,1,0,3388,A
5-NP,556,3377,0,0,0,3377,A
5-NP,557,0,3365,0,0,3365,T
5-NP,558,3,1,0,3383,3387,C
5-NP,559,1,14,3371,0,3386,G
5-NP,560,0,4,3458,0,3462,G
5-NP,561,1,6,3453,0,3460,G
5-NP,562,3430,1,3,0,3434,A
5-NP,563,0,2,0,3483,3485,C
5-NP,564,3444,0,0,0,3444,A
5-NP,565,3537,1,3,0,3541,A
5-NP,566,0,3568,0,3,3571,T
5-NP,567,0,7,3584,2,3593,G
5-NP,568,0,2,3688,0,3690,G
5-NP,569,1,3661,0,0,3662,T
5-NP,570,1,5,3715,0,3721,G
5-NP,571,3703,1,1,0,3705,A
5-NP,572,0,3706,0,1,3707,T
5-NP,573,2,6,3710,0,3718,G
5-NP,574,0,10,3731,0,3741,G
5-NP,575,3710,0,1,0,3711,A
5-NP,576,3726,0,1,0,3727,A
5-NP,577,0,1,0,3708,3709,C
5-NP,578,1,3633,0,0,3634,T
5-NP,579,0,7,3843,0,3850,G
5-NP,580,3792,0,2,0,3794,A
5-NP,581,0,3824,0,0,3824,T
5-NP,582,8,0,1,3831,3840,C
5-NP,583,3777,0,3,0,3780,A
5-NP,584,1,2,3918,0,3921,G
5-NP,585,3861,0,1,0,3862,A
5-NP,586,3895,0,0,0,3895,A
5-NP,587,0,3912,0,1,3913,T
5-NP,588,0,10,3841,0,3851,G
5-NP,589,1,3,3893,0,3897,G
5-NP,590,1,3875,0,4,3880,T
5-NP,591,16,2,0,3883,3901,C
5-NP,592,3904,0,0,0,3904,A
5-NP,593,3860,0,1,0,3861,A
5-NP,594,3879,0,0,0,3879,A
5-NP,595,0,2,0,3884,3886,C
5-NP,596,0,7,3854,2,3863,G
5-NP,597,1,13,3868,0,3882,G
5-NP,598,1,15,3822,1,3839,G
5-NP,599,0,5,3864,0,3869,G
5-NP,600,0,7,3873,0,3880,G
5-NP,601,3877,0,3,0,3880,A
5-NP,602,0,3854,0,4,3858,T
5-NP,603,9,1,0,3874,3884,C
5-NP,604,3902,0,1,0,3903,A
5-NP,605,3893,0,1,0,3894,A
5-NP,606,1,7,0,3864,3872,C
5-NP,607,0,5,3853,0,3858,G
5-NP,608,3831,1,0,0,3832,A
5-NP,609,1,3812,0,3,3816,T
5-NP,610,8,1,0,3830,3839,C
5-NP,611,1,5,3845,0,3851,G
5-NP,612,3804,0,1,0,3805,A
5-NP,613,3830,0,1,1,3832,A
5-NP,614,3835,0,0,1,3836,A
5-NP,615,0,3892,0,1,3893,T
5-NP,616,0,3905,0,0,3905,T
5-NP,617,0,3900,0,0,3900,T
5-NP,618,0,3913,0,1,3914,T
5-NP,619,0,3919,0,0,3919,T
5-NP,620,1,6,3917,0,3924,G
5-NP,621,2,3,3910,0,3915,G
5-NP,622,3864,0,4,0,3868,A
5-NP,623,0,4,3924,0,3928,G
5-NP,624,3847,1,3,0,3851,A
5-NP,625,0,3,4062,0,4065,G
5-NP,626,1,2,4073,0,4076,G
5-NP,627,0,4005,0,3,4008,T
5-NP,628,0,8,4072,0,4080,G
5-NP,629,4062,0,7,0,4069,A
5-NP,630,1,7,4104,0,4112,G
5-NP,631,4094,0,4,0,4098,A
5-NP,632,4102,0,1,0,4103,A
5-NP,633,0,4087,0,4,4091,T
5-NP,634,0,11,3949,0,3960,G
5-NP,635,0,4,3903,0,3907,G
5-NP,636,0,3,3900,0,3903,G
5-NP,637,1,3,0,3876,3880,C
5-NP,638,3,7,3913,0,3923,G
5-NP,639,0,3,3961,0,3964,G
5-NP,640,3934,0,2,0,3936,A
5-NP,641,3955,0,5,0,3960,A
5-NP,642,4035,0,1,0,4036,A
5-NP,643,4033,0,6,0,4039,A
5-NP,644,1,2,0,4051,4054,C
5-NP,645,4064,0,1,0,4065,A
5-NP,646,4040,0,1,0,4041,A
5-NP,647,0,4,4041,1,4046,G
5-NP,648,3934,0,1,0,3935,A
5-NP,649,3945,0,0,0,3945,A
5-NP,650,0,1,4039,0,4040,G
5-NP,651,0,4001,0,0,4001,T
5-NP,652,0,0,4232,0,4232,G
5-NP,653,2,0,0,4216,4218,C
5-NP,654,0,4220,2,2,4224,T
5-NP,655,0,4243,0,1,4244,T
5-NP,656,4308,0,0,0,4308,A
5-NP,657,1,4318,1,0,4320,T
5-NP,658,0,9,4335,0,4344,G
5-NP,659,4260,0,2,0,4262,A
5-NP,660,0,11,4278,0,4289,G
5-NP,661,4080,0,2,0,4082,A
5-NP,662,0,10,4101,0,4111,G
5-NP,663,4101,0,5,0,4106,A
5-NP,664,4156,0,0,0,4156,A
5-NP,665,0,4113,0,0,4113,T
5-NP,666,1,5,4161,0,4167,G
5-NP,667,0,4116,0,3,4119,T
5-NP,668,2,2,4145,0,4149,G
5-NP,669,1,5,0,4136,4142,C
5-NP,670,4138,1,0,0,4139,A
5-NP,671,4131,1,2,0,4134,A
5-NP,672,0,0,1,4119,4120,C
5-NP,673,4073,0,0,0,4073,A
5-NP,674,0,4085,0,2,4087,T
5-NP,675,0,4050,0,1,4051,T
5-NP,676,13,0,0,4054,4067,C
5-NP,677,0,4064,0,0,4064,T
5-NP,678,0,4070,0,1,4071,T
5-NP,679,4065,1,0,0,4066,A
5-NP,680,4036,0,3,0,4039,A
5-NP,681,4040,0,4,0,4044,A
5-NP,682,2,11,4034,0,4047,G
5-NP,683,2,8,4023,0,4033,G
5-NP,684,4009,0,2,0,4011,A
5-NP,685,4023,0,0,0,4023,A
5-NP,686,4017,0,0,0,4017,A
5-NP,687,4074,0,1,0,4075,A
5-NP,688,0,4065,0,2,4067,T
5-NP,689,0,4060,0,0,4060,T
5-NP,690,0,4062,0,3,4065,T
5-NP,691,5,0,0,4077,4082,C
5-NP,692,4085,0,0,0,4085,A
5-NP,693,4073,0,3,0,4076,A
5-NP,694,4085,1,1,0,4087,A
5-NP,695,1,0,0,4127,4128,C
5-NP,696,4084,0,0,0,4084,A
5-NP,697,0,1,4147,0,4148,G
5-NP,698,0,2,0,4159,4161,C
5-NP,699,0,4141,0,1,4142,T
5-NP,700,1,3,4250,1,4255,G
5-NP,701,3,1,0,4235,4239,C
5-NP,702,4276,0,7,0,4283,A
5-NP,703,2,1,0,4291,4294,C
5-NP,704,4276,1,0,0,4277,A
5-NP,705,4269,0,3,0,4272,A
5-NP,706,4172,0,1,0,4173,A
5-NP,707,0,7,4335,0,4342,G
5-NP,708,4317,2,3,0,4322,A
5-NP,709,1,0,4392,0,4393,G
5-NP,710,1,1,0,4404,4406,C
5-NP,711,4390,1,2,0,4393,A
5-NP,712,4522,0,3,3,4528,A
5-NP,713,0,4523,0,3,4526,T
5-NP,714,0,7,4551,0,4558,G
5-NP,715,1,1,4554,0,4556,G
5-NP,716,0,4425,1,4,4430,T
5-NP,717,2,8,4447,0,4457,G
5-NP,718,0,7,4462,0,4469,G
5-NP,719,4471,0,3,0,4474,A
5-NP,720,2,4466,0,3,4471,T
5-NP,721,11,0,0,4358,4369,C
5-NP,722,4389,0,0,0,4389,A
5-NP,723,4424,0,1,0,4425,A
5-NP,724,1,2,4458,0,4461,G
5-NP,725,0,4416,0,0,4416,T
5-NP,726,0,11,4408,0,4419,G
5-NP,727,4372,0,5,0,4377,A
5-NP,728,1,7,4367,0,4375,G
5-NP,729,4368,0,5,0,4373,A
5-NP,730,1,11,4366,0,4378,G
5-NP,731,4357,0,0,0,4357,A
5-NP,732,4280,0,1,0,4281,A
5-NP,733,4292,0,3,0,4295,A
5-NP,734,1,1,4299,0,4301,G
5-NP,735,0,4254,0,1,4255,T
5-NP,736,16,1,0,4261,4278,C
5-NP,737,3,7,4259,0,4269,G
5-NP,738,2,9,4256,0,4267,G
5-NP,739,4287,0,0,0,4287,A
5-NP,740,4289,0,1,0,4290,A
5-NP,741,1,1,0,4321,4323,C
5-NP,742,9,0,0,4290,4299,C
5-NP,743,9,1,0,4330,4340,C
5-NP,744,4314,0,1,2,4317,A
5-NP,745,0,10,4331,0,4341,G
5-NP,746,5,9,4318,0,4332,G
5-NP,747,4317,0,2,0,4319,A
5-NP,748,4328,0,0,0,4328,A
5-NP,749,4299,0,1,0,4300,A
5-NP,750,2,3,0,4309,4314,C
5-NP,751,3,0,4288,0,4291,G
5-NP,752,0,1,1,4293,4295,C
5-NP,753,0,4271,0,6,4277,T
5-NP,754,1,8,4305,0,4314,G
5-NP,755,4267,2,0,1,4270,A
5-NP,756,0,7,4340,0,4347,G
5-NP,757,4350,1,3,0,4354,A
5-NP,758,0,4323,0,0,4323,T
5-NP,759,11,2,0,4294,4307,C
5-NP,760,14,0,4315,3,4332,G
5-NP,761,4301,1,1,0,4303,A
5-NP,762,4302,0,1,0,4303,A
5-NP,763,0,7,4301,0,4308,G
5-NP,764,4307,0,0,0,4307,A
5-NP,765,0,4285,0,1,4286,T
5-NP,766,6,1,0,4304,4311,C
5-NP,767,1,4327,0,3,4331,T
5-NP,768,10,1,1,4350,4362,C
5-NP,769,4382,0,1,0,4383,A
5-NP,770,0,4381,0,0,4381,T
5-NP,771,4402,0,1,0,4403,A
5-NP,772,0,4387,1,0,4388,T
5-NP,773,0,4352,0,0,4352,T
5-NP,774,0,4337,1,1,4339,T
5-NP,775,0,4280,0,2,4282,T
5-NP,776,0,4284,0,0,4284,T
5-NP,777,4294,0,0,0,4294,A
5-NP,778,0,1,4267,0,4268,G
5-NP,779,2,0,0,4277,4279,C
5-NP,780,4271,0,1,0,4272,A
5-NP,781,4238,0,2,0,4240,A
5-NP,782,0,7,4376,0,4383,G
5-NP,783,4361,0,0,0,4361,A
5-NP,784,0,4356,0,0,4356,T
5-NP,785,4,1,0,4415,4420,C
5-NP,786,0,4393,1,4,4398,T
5-NP,787,0,2,4522,0,4524,G
5-NP,788,4,2,0,4540,4546,C
5-NP,789,4544,0,0,0,4544,A
5-NP,790,0,4588,0,2,4590,T
5-NP,791,0,4451,1,2,4454,T
5-NP,792,0,8,4692,0,4700,G
5-NP,793,4784,0,5,1,4790,A
5-NP,794,0,4804,0,0,4804,T
5-NP,795,4811,1,2,1,4815,A
5-NP,796,1,4705,0,0,4706,T
5-NP,797,0,4681,0,1,4682,T
5-NP,798,2,8,4700,0,4710,G
5-NP,799,4648,0,3,0,4651,A
5-NP,800,0,8,4690,0,4698,G
5-NP,801,4439,1,1,0,4441,A
5-NP,802,1,6,4379,0,4386,G
5-NP,803,0,6,4423,0,4429,G
5-NP,804,4403,0,0,2,4405,A
5-NP,805,0,4349,0,4,4353,T
5-NP,806,5,0,0,4416,4421,C
5-NP,807,4402,0,1,1,4404,A
5-NP,808,0,1,4440,0,4441,G
5-NP,809,0,4413,0,0,4413,T
5-NP,810,0,4387,0,1,4388,T
5-NP,811,1,3,4380,0,4384,G
5-NP,812,1,0,0,4333,4334,C
5-NP,813,0,4325,0,5,4330,T
5-NP,814,10,0,0,4360,4370,C
5-NP,815,4370,1,1,1,4373,A
5-NP,816,2,0,1,4388,4391,C
5-NP,817,4387,0,0,1,4388,A
5-NP,818,4413,0,0,1,4414,A
5-NP,819,4373,1,3,1,4378,A
5-NP,820,0,4363,0,0,4363,T
5-NP,821,5,1,0,4384,4390,C
5-NP,822,0,4379,0,0,4379,T
5-NP,823,0,4371,0,2,4373,T
5-NP,824,0,0,4396,0,4396,G
5-NP,825,0,1,0,4384,4385,C
5-NP,826,6,1,0,4432,4439,C
5-NP,827,1,4467,0,1,4469,T
5-NP,828,4449,1,0,0,4450,A
5-NP,829,0,4,1,4491,4496,C
5-NP,830,9,5,1,4488,4503,C
5-NP,831,1,4472,1,6,4480,T
5-NP,832,1,2,4541,0,4544,G
5-NP,833,0,2,0,4493,4495,C
5-NP,834,5,2,1,4539,4547,C
5-NP,835,1,4465,0,3,4469,T
5-NP,836,0,3,4526,0,4529,G
5-NP,837,2,4454,2,3,4461,T
5-NP,838,0,1,4548,0,4549,G
5-NP,839,0,5,0,4556,4561,C
5-NP,840,4,1,4639,0,4644,G
5-NP,841,0,4574,0,2,4576,T
5-NP,842,4563,0,0,1,4564,A
5-NP,843,1,4567,0,0,4568,T
5-NP,844,1,13,4560,1,4575,G
5-NP,845,1,12,4742,0,4755,G
5-NP,846,4721,0,2,1,4724,A
5-NP,847,3,1,0,4673,4677,C
5-NP,848,7,1,0,4696,4704,C
5-NP,849,2,4641,0,2,4645,T
5-NP,850,1,1,4869,0,4871,G
5-NP,851,0,0,0,4881,4881,C
5-NP,852,4894,0,6,1,4901,A
5-NP,853,2,2,4969,0,4973,G
5-NP,854,0,4774,0,0,4774,T
5-NP,855,4981,0,1,1,4983,A
5-NP,856,1,4932,0,1,4934,T
5-NP,857,7,0,0,4936,4943,C
5-NP,858,5,1,1,4960,4967,C
5-NP,859,4778,3,0,1,4782,A
5-NP,860,2,0,4820,0,4822,G
5-NP,861,0,4773,0,1,4774,T
5-NP,862,1,12,4854,0,4867,G
5-NP,863,0,9,4814,0,4823,G
5-NP,864,2,2,4778,0,4782,G
5-NP,865,0,4750,0,4,4754,T
5-NP,866,4780,0,2,1,4783,A
5-NP,867,2,4,0,4767,4773,C
5-NP,868,2,12,4736,0,4750,G
5-NP,869,4716,0,2,1,4719,A
5-NP,870,1,1,0,4719,4721,C
5-NP,871,0,4612,0,5,4617,T
5-NP,872,0,4613,0,0,4613,T
5-NP,873,6,1,0,4629,4636,C
5-NP,874,2,11,4628,0,4641,G
5-NP,875,4614,1,0,0,4615,A
5-NP,876,4641,0,3,0,4644,A
5-NP,877,4658,0,1,0,4659,A
5-NP,878,4650,0,0,0,4650,A
5-NP,879,4638,0,4,0,4642,A
5-NP,880,0,7,4674,0,4681,G
5-NP,881,4651,0,2,0,4653,A
5-NP,882,3,11,4658,0,4672,G
5-NP,883,0,16,4707,0,4723,G
5-NP,884,0,4,4718,1,4723,G
5-NP,885,4728,1,6,0,4735,A
5-NP,886,1,4730,0,5,4736,T
5-NP,887,4797,0,1,0,4798,A
5-NP,888,0,4802,0,4,4806,T
5-NP,889,0,4779,0,0,4779,T
5-NP,890,11,0,0,4852,4863,C
5-NP,891,5,0,0,4844,4849,C
5-NP,892,0,4803,1,0,4804,T
5-NP,893,0,4818,0,1,4819,T
5-NP,894,0,5,4906,1,4912,G
5-NP,895,0,0,4935,0,4935,G
5-NP,896,0,4845,0,4,4849,T
5-NP,897,0,18,4848,0,4866,G
5-NP,898,0,12,4785,0,4797,G
5-NP,899,3,5,4743,0,4751,G
5-NP,900,3,8,4630,0,4641,G
5-NP,901,4925,0,2,0,4927,A
5-NP,902,0,4936,0,0,4936,T
5-NP,903,4933,0,11,0,4944,A
5-NP,904,1,7,4941,0,4949,G
5-NP,905,4891,0,5,0,4896,A
5-NP,906,3,2,0,4880,4885,C
5-NP,907,7,0,0,4787,4794,C
5-NP,908,14,1,0,4735,4750,C
5-NP,909,1,4799,3,7,4810,T
5-NP,910,0,4802,1,0,4803,T
5-NP,911,0,4820,0,3,4823,T
5-NP,912,7,2,0,4808,4817,C
5-NP,913,4814,2,0,0,4816,A
5-NP,914,4804,1,2,0,4807,A
5-NP,915,4805,1,0,0,4806,A
5-NP,916,1,0,0,4800,4801,C
5-NP,917,0,4694,0,0,4694,T
5-NP,918,4677,1,5,0,4683,A
5-NP,919,1,1,0,4751,4753,C
5-NP,920,0,4728,0,4,4732,T
5-NP,921,0,4711,0,0,4711,T
5-NP,922,7,0,0,4758,4765,C
5-NP,923,4751,0,1,1,4753,A
5-NP,924,4749,0,2,0,4751,A
5-NP,925,4728,0,1,0,4729,A
5-NP,926,4721,1,1,0,4723,A
5-NP,927,0,4697,0,0,4697,T
5-NP,928,4639,0,2,0,4641,A
5-NP,929,5,0,4662,1,4668,G
5-NP,930,1,0,0,4681,4682,C
5-NP,931,12,1,1,4732,4746,C
5-NP,932,4764,0,1,0,4765,A
5-NP,933,4770,1,0,1,4772,A
5-NP,934,4917,0,3,0,4920,A
5-NP,935,0,4949,0,0,4949,T
5-NP,936,4970,1,0,0,4971,A
5-NP,937,0,4969,0,1,4970,T
5-NP,938,4873,0,3,0,4876,A
5-NP,939,1,2,0,4894,4897,C
5-NP,940,4781,0,5,1,4787,A
5-NP,941,0,1,4897,0,4898,G
5-NP,942,0,0,0,4871,4871,C
5-NP,943,0,4741,0,2,4743,T
5-NP,944,0,4813,1,1,4815,T
5-NP,945,4821,0,1,0,4822,A
5-NP,946,4830,0,1,0,4831,A
5-NP,947,0,4807,0,0,4807,T
5-NP,948,12,2,0,4808,4822,C
5-NP,949,4707,0,0,0,4707,A
5-NP,950,1,11,4729,0,4741,G
5-NP,951,4696,0,3,0,4699,A
5-NP,952,2,0,0,4771,4773,C
5-NP,953,3,0,0,4736,4739,C
5-NP,954,0,4705,0,4,4709,T
5-NP,955,4771,0,0,0,4771,A
5-NP,956,4758,0,0,0,4758,A
5-NP,957,1,3,0,4787,4791,C
5-NP,958,0,9,4790,1,4800,G
5-NP,959,4712,1,3,0,4716,A
5-NP,960,1,5,4715,0,4721,G
5-NP,961,4691,2,0,0,4693,A
5-NP,962,4751,0,1,0,4752,A
5-NP,963,0,4729,1,0,4730,T
5-NP,964,5,0,0,4675,4680,C
5-NP,965,4,0,0,4693,4697,C
5-NP,966,4629,1,5,1,4636,A
5-NP,967,0,1,4655,0,4656,G
5-NP,968,1,0,0,4660,4661,C
5-NP,969,4665,0,4,0,4669,A
5-NP,970,0,1,0,4729,4730,C
5-NP,971,4660,0,1,1,4662,A
5-NP,972,1,2,0,4670,4673,C
5-NP,973,4673,0,0,1,4674,A
5-NP,974,4683,0,1,0,4684,A
5-NP,975,0,8,4682,0,4690,G
5-NP,976,4643,0,2,0,4645,A
5-NP,977,0,0,4650,0,4650,G
5-NP,978,0,4537,1,0,4538,T
5-NP,979,11,1,1,4524,4537,C
5-NP,980,4544,0,6,0,4550,A
5-NP,981,0,0,4538,0,4538,G
5-NP,982,4,1,0,4523,4528,C
5-NP,983,0,4511,1,1,4513,T
5-NP,984,0,8,4588,0,4596,G
5-NP,985,0,1,4608,0,4609,G
5-NP,986,0,4556,1,2,4559,T
5-NP,987,11,1,4602,0,4614,G
5-NP,988,0,4561,0,0,4561,T
5-NP,989,0,12,4560,0,4572,G
5-NP,990,0,5,4547,0,4552,G
5-NP,991,4523,0,3,0,4526,A
5-NP,992,0,4527,1,3,4531,T
5-NP,993,1,10,4329,0,4340,G
5-NP,994,2,1,4332,0,4335,G
5-NP,995,4,1,0,4336,4341,C
5-NP,996,4297,0,0,0,4297,A
5-NP,997,0,4293,1,1,4295,T
5-NP,998,0,0,4267,1,4268,G
5-NP,999,1,1,0,4280,4282,C
5-NP,1000,5,1,0,4295,4301,C
5-NP,1001,4333,0,1,0,4334,A
5-NP,1002,0,4310,1,1,4312,T
5-NP,1003,0,4257,1,0,4258,T
5-NP,1004,4,0,0,4258,4262,C
5-NP,1005,1,4227,1,0,4229,T
5-NP,1006,1,2,4222,0,4225,G
5-NP,1007,1,0,0,4206,4207,C
5-NP,1008,0,4103,1,5,4109,T
5-NP,1009,1,2,4132,0,4135,G
5-NP,1010,0,1,0,4080,4081,C
5-NP,1011,4099,0,1,0,4100,A
5-NP,1012,0,4093,1,1,4095,T
5-NP,1013,0,4083,1,1,4085,T
5-NP,1014,0,4083,2,0,4085,T
5-NP,1015,0,7,4080,0,4087,G
5-NP,1016,4061,0,3,0,4064,A
5-NP,1017,4080,0,3,0,4083,A
5-NP,1018,1,3,4113,0,4117,G
5-NP,1019,4094,0,0,0,4094,A
5-NP,1020,0,4078,1,1,4080,T
5-NP,1021,0,4073,2,7,4082,T
5-NP,1022,0,4092,1,2,4095,T
5-NP,1023,4087,0,0,0,4087,A
5-NP,1024,4086,1,1,0,4088,A
5-NP,1025,1,4,4080,0,4085,G
5-NP,1026,4074,0,1,0,4075,A
5-NP,1027,0,4065,0,0,4065,T
5-NP,1028,1,4001,0,0,4002,T
5-NP,1029,0,2,4039,0,4041,G
5-NP,1030,0,4041,0,1,4042,T
5-NP,1031,0,4037,0,2,4039,T
5-NP,1032,4048,0,2,0,4050,A
5-NP,1033,4030,0,0,0,4030,A
5-NP,1034,0,2,4048,0,4050,G
5-NP,1035,0,0,0,4054,4054,C
5-NP,1036,0,3987,0,3,3990,T
5-NP,1037,0,3988,0,1,3989,T
5-NP,1038,6,3,0,4000,4009,C
5-NP,1039,4019,0,3,0,4022,A
5-NP,1040,0,3986,0,0,3986,T
5-NP,1041,6,1,0,4003,4010,C
5-NP,1042,3971,0,0,0,3971,A
5-NP,1043,0,2,3946,0,3948,G
5-NP,1044,3892,0,8,0,3900,A
5-NP,1045,5,11,3893,0,3909,G
5-NP,1046,0,3,3885,0,3888,G
5-NP,1047,1,7,3863,0,3871,G
5-NP,1048,3874,1,7,0,3882,A
5-NP,1049,2,0,5,3885,3892,C
5-NP,1050,3893,0,0,0,3893,A
5-NP,1051,3914,0,1,0,3915,A
5-NP,1052,3910,0,1,0,3911,A
5-NP,1053,3921,0,4,0,3925,A
5-NP,1054,0,0,3957,0,3957,G
5-NP,1055,0,3851,0,1,3852,T
5-NP,1056,3839,0,0,0,3839,A
5-NP,1057,0,3810,0,2,3812,T
5-NP,1058,4,125,0,3689,3818,C
5-NP,1059,6,3739,0,2,3747,T
5-NP,1060,6,0,0,3773,3779,C
5-NP,1061,5,0,0,3767,3772,C
5-NP,1062,0,3715,0,0,3715,T
5-NP,1063,9,0,0,3697,3706,C
5-NP,1064,0,10,3665,0,3675,G
5-NP,1065,1,14,3672,0,3687,G
5-NP,1066,0,10,3675,0,3685,G
5-NP,1067,0,2,3670,0,3672,G
5-NP,1068,2,6,3657,0,3665,G
5-NP,1069,3610,0,4,0,3614,A
5-NP,1070,3608,0,1,2,3611,A
5-NP,1071,3605,1,0,0,3606,A
5-NP,1072,2,1,0,3630,3633,C
5-NP,1073,1,3623,0,1,3625,T
5-NP,1074,1,1,3633,0,3635,G
5-NP,1075,2,3606,0,4,3612,T
5-NP,1076,10,0,0,3606,3616,C
5-NP,1077,3666,0,3,3,3672,A
5-NP,1078,3676,0,0,0,3676,A
5-NP,1079,1,0,0,3703,3704,C
5-NP,1080,0,3685,0,2,3687,T
5-NP,1081,3610,1,1,0,3612,A
5-NP,1082,0,8,3619,0,3627,G
5-NP,1083,3536,0,2,0,3538,A
5-NP,1084,0,5,3548,0,3553,G
5-NP,1085,1,11,3556,0,3568,G
5-NP,1086,3421,0,5,1,3427,A
5-NP,1087,0,1,3516,0,3517,G
5-NP,1088,1,3474,0,1,3476,T
5-NP,1089,3470,1,3,0,3474,A
5-NP,1090,0,3,0,3475,3478,C
5-NP,1091,3433,1,1,0,3435,A
5-NP,1092,3421,0,6,0,3427,A
5-NP,1093,3397,0,0,0,3397,A
5-NP,1094,0,3346,1,0,3347,T
5-NP,1095,0,3334,1,1,3336,T
5-NP,1096,0,0,3251,0,3251,G
5-NP,1097,2,0,0,3247,3249,C
5-NP,1098,0,3233,0,3,3236,T
5-NP,1099,0,3227,0,1,3228,T
5-NP,1100,7,0,0,3239,3246,C
5-NP,1101,3248,0,1,0,3249,A
5-NP,1102,3265,0,0,0,3265,A
5-NP,1103,3259,1,1,0,3261,A
5-NP,1104,0,3259,1,1,3261,T
5-NP,1105,1,3,3271,1,3276,G
5-NP,1106,3212,0,1,0,3213,A
5-NP,1107,1,11,3231,0,3243,G
5-NP,1108,3242,0,6,0,3248,A
5-NP,1109,3243,0,2,0,3245,A
5-NP,1110,0,0,0,3253,3253,C
5-NP,1111,3222,0,1,0,3223,A
5-NP,1112,0,3217,0,2,3219,T
5-NP,1113,1,5,3259,0,3265,G
5-NP,1114,0,4,3278,0,3282,G
5-NP,1115,3264,1,0,0,3265,A
5-NP,1116,0,3227,0,0,3227,T
5-NP,1117,3202,0,2,0,3204,A
5-NP,1118,3419,0,0,0,3419,A
5-NP,1119,0,3365,0,0,3365,T
5-NP,1120,3347,0,3,0,3350,A
5-NP,1121,0,3323,1,1,3325,T
5-NP,1122,0,4,3137,0,3141,G
5-NP,1123,5,6,3092,1,3104,G
5-NP,1124,0,5,3075,0,3080,G
5-NP,1125,3076,0,2,0,3078,A
5-NP,1126,0,3062,0,2,3064,T
5-NP,1127,8,0,0,2534,2542,C
5-NP,1128,1,9,2534,0,2544,G
5-NP,1129,2537,1,2,0,2540,A
5-NP,1130,1,2,2544,0,2547,G
5-NP,1131,1,0,0,2538,2539,C
5-NP,1132,2508,0,0,0,2508,A
5-NP,1133,0,0,0,2646,2646,C
5-NP,1134,1,2599,1,1,2602,T
5-NP,1135,6,0,0,2626,2632,C
5-NP,1136,0,2624,0,3,2627,T
5-NP,1137,0,2600,0,1,2601,T
5-NP,1138,0,5,2601,0,2606,G
5-NP,1139,2591,0,1,0,2592,A
5-NP,1140,2603,0,1,0,2604,A
5-NP,1141,2,1,0,2603,2606,C
5-NP,1142,1,2226,0,1,2228,T
5-NP,1143,1,2,2246,0,2249,G
5-NP,1144,2177,0,0,0,2177,A
5-NP,1145,0,0,2210,0,2210,G
5-NP,1146,2236,1,0,0,2237,A
5-NP,1147,2261,0,2,0,2263,A
5-NP,1148,0,0,2266,0,2266,G
5-NP,1149,0,0,0,2241,2241,C
5-NP,1150,276,2,1955,0,2233,G
5-NP,1151,0,3,2266,0,2269,G
5-NP,1152,1,4,2274,0,2279,G
5-NP,1153,0,2250,0,2,2252,T
5-NP,1154,2201,0,2,0,2203,A
5-NP,1155,1,1,0,2223,2225,C
5-NP,1156,0,1904,0,0,1904,T
5-NP,1157,0,5,1915,0,1920,G
5-NP,1158,0,3,1886,0,1889,G
5-NP,1159,0,1,1900,0,1901,G
5-NP,1160,0,0,0,1876,1876,C
5-NP,1161,2,0,0,1822,1824,C
5-NP,1162,1837,0,0,0,1837,A
5-NP,1163,0,1836,0,3,1839,T
5-NP,1164,1840,0,0,0,1840,A
5-NP,1165,1841,0,2,0,1843,A
5-NP,1166,1,0,1815,0,1816,G
5-NP,1167,0,0,1861,0,1861,G
5-NP,1168,1809,0,0,0,1809,A
5-NP,1169,2,0,0,1817,1819,C
5-NP,1170,3,2,0,1826,1831,C
5-NP,1171,1819,0,1,0,1820,A
5-NP,1172,0,2,1869,0,1871,G
5-NP,1173,0,7,1867,0,1874,G
5-NP,1174,1866,0,0,0,1866,A
5-NP,1175,1,0,1879,0,1880,G
5-NP,1176,0,1804,0,0,1804,T
5-NP,1177,1,0,1819,0,1820,G
5-NP,1178,1,3,1833,0,1837,G
5-NP,1179,1804,0,3,0,1807,A
5-NP,1180,0,3,1848,0,1851,G
5-NP,1181,1,3,1803,0,1807,G
5-NP,1182,1804,0,1,0,1805,A
5-NP,1183,1804,1,2,0,1807,A
5-NP,1184,1792,0,4,0,1796,A
5-NP,1185,0,1,0,1806,1807,C
5-NP,1186,1790,0,0,0,1790,A
5-NP,1187,0,0,0,1835,1835,C
5-NP,1188,0,1807,0,1,1808,T
5-NP,1189,1870,0,0,0,1870,A
5-NP,1190,1870,0,1,0,1871,A
5-NP,1191,0,1867,0,0,1867,T
5-NP,1192,4,0,0,1888,1892,C
5-NP,1193,1883,0,0,0,1883,A
5-NP,1194,1900,0,0,0,1900,A
5-NP,1195,0,1,0,1894,1895,C
5-NP,1196,1853,0,0,0,1853,A
5-NP,1197,0,3,1844,0,1847,G
5-NP,1198,1805,0,0,0,1805,A
5-NP,1199,0,3,1808,0,1811,G
5-NP,1200,1,3,1806,0,1810,G
5-NP,1201,0,2,1794,0,1796,G
5-NP,1202,1,0,1,1779,1781,C
5-NP,1203,0,1,0,1787,1788,C
5-NP,1204,0,1751,0,5,1756,T
5-NP,1205,1,0,0,1775,1776,C
5-NP,1206,5,1,0,1786,1792,C
5-NP,1207,2,0,1785,0,1787,G
5-NP,1208,2,2,0,1785,1789,C
5-NP,1209,1764,0,0,0,1764,A
5-NP,1210,0,3,1820,0,1823,G
5-NP,1211,0,0,1818,0,1818,G
5-NP,1212,0,1,0,1827,1828,C
5-NP,1213,3,0,0,1827,1830,C
5-NP,1214,1806,0,0,1,1807,A
5-NP,1215,1815,0,1,0,1816,A
5-NP,1216,1820,0,0,0,1820,A
5-NP,1217,0,0,0,1827,1827,C
5-NP,1218,4,1,0,1827,1832,C
5-NP,1219,1712,0,0,0,1712,A
5-NP,1220,0,1,1765,0,1766,G
5-NP,1221,0,1749,0,0,1749,T
5-NP,1222,1,0,1773,0,1774,G
5-NP,1223,0,1748,0,1,1749,T
5-NP,1224,1,0,1759,0,1760,G
5-NP,1225,0,2,0,1752,1754,C
5-NP,1226,1754,0,0,0,1754,A
5-NP,1227,1766,0,6,0,1772,A
5-NP,1228,1,1,0,1766,1768,C
5-NP,1229,2,1,0,1772,1775,C
5-NP,1230,0,1754,0,3,1757,T
5-NP,1231,1740,0,1,0,1741,A
5-NP,1232,0,0,0,1742,1742,C
5-NP,1233,0,0,1756,0,1756,G
5-NP,1234,0,1739,1,1,1741,T
5-NP,1235,0,1759,0,0,1759,T
5-NP,1236,0,1732,0,1,1733,T
5-NP,1237,0,1724,0,1,1725,T
5-NP,1238,3,0,0,1722,1725,C
5-NP,1239,0,1705,0,0,1705,T
5-NP,1240,1,0,1744,0,1745,G
5-NP,1241,0,1730,0,0,1730,T
5-NP,1242,1745,0,0,1,1746,A
5-NP,1243,0,2,0,1758,1760,C
5-NP,1244,1731,0,0,0,1731,A
5-NP,1245,1736,0,0,0,1736,A
5-NP,1246,1732,0,1,2,1735,A
5-NP,1247,0,1,1740,0,1741,G
5-NP,1248,1729,0,0,0,1729,A
5-NP,1249,1690,0,0,0,1690,A
5-NP,1250,1680,0,1,0,1681,A
5-NP,1251,1,0,0,1696,1697,C
5-NP,1252,1,0,0,1680,1681,C
5-NP,1253,0,1658,0,1,1659,T
5-NP,1254,2,1,0,1678,1681,C
5-NP,1255,2,0,0,1671,1673,C
5-NP,1256,6,0,0,1676,1682,C
5-NP,1257,1682,0,0,0,1682,A
5-NP,1258,0,1687,0,1,1688,T
5-NP,1259,0,1687,0,0,1687,T
5-NP,1260,0,1691,0,0,1691,T
5-NP,1261,1,1,1693,0,1695,G
5-NP,1262,1686,0,3,0,1689,A
5-NP,1263,1694,0,0,0,1694,A
5-NP,1264,1692,0,0,0,1692,A
5-NP,1265,1684,0,0,0,1684,A
5-NP,1266,1,1,1698,0,1700,G
5-NP,1267,0,1675,0,0,1675,T
5-NP,1268,4,0,0,1688,1692,C
5-NP,1269,1696,0,1,0,1697,A
5-NP,1270,1695,0,1,0,1696,A
5-NP,1271,0,1,0,1696,1697,C
5-NP,1272,3,0,0,1717,1720,C
5-NP,1273,1718,1,0,0,1719,A
5-NP,1274,1,1720,0,0,1721,T
5-NP,1275,1,1,0,1720,1722,C
5-NP,1276,1710,0,3,0,1713,A
5-NP,1277,0,1713,1,0,1714,T
5-NP,1278,1,3,1714,0,1718,G
5-NP,1279,0,1,1721,1,1723,G
5-NP,1280,2,0,0,1719,1721,C
5-NP,1281,1672,0,2,0,1674,A
5-NP,1282,0,0,1678,0,1678,G
5-NP,1283,1,0,0,1659,1660,C
5-NP,1284,1666,0,0,0,1666,A
5-NP,1285,0,1657,0,0,1657,T
5-NP,1286,0,1633,0,0,1633,T
5-NP,1287,9,0,0,1640,1649,C
5-NP,1288,1641,0,1,0,1642,A
5-NP,1289,0,0,0,1660,1660,C
5-NP,1290,0,1652,0,1,1653,T
5-NP,1291,2,4,1667,0,1673,G
5-NP,1292,0,4,1691,0,1695,G
5-NP,1293,1684,0,0,0,1684,A
5-NP,1294,1687,0,1,0,1688,A
5-NP,1295,1689,0,0,0,1689,A
5-NP,1296,0,1662,0,0,1662,T
5-NP,1297,1666,0,0,0,1666,A
5-NP,1298,0,1,0,1661,1662,C
5-NP,1299,4,3,1639,0,1646,G
5-NP,1300,0,1,1657,0,1658,G
5-NP,1301,1615,0,1,0,1616,A
5-NP,1302,0,8,1612,0,1620,G
5-NP,1303,0,4,1616,0,1620,G
5-NP,1304,1,3,1618,0,1622,G
5-NP,1305,1625,0,1,0,1626,A
5-NP,1306,1624,0,2,0,1626,A
5-NP,1307,0,1,1625,0,1626,G
5-NP,1308,1624,0,1,0,1625,A
5-NP,1309,1618,0,0,0,1618,A
5-NP,1310,0,0,0,1634,1634,C
5-NP,1311,0,1598,1,1,1600,T
5-NP,1312,0,1616,0,0,1616,T
5-NP,1313,2,0,0,1621,1623,C
5-NP,1314,1625,0,1,0,1626,A
5-NP,1315,0,7,1619,0,1626,G
5-NP,1316,1622,0,0,0,1622,A
5-NP,1317,1,0,0,1628,1629,C
5-NP,1318,1607,0,2,0,1609,A
5-NP,1319,0,1576,0,1,1577,T
5-NP,1320,0,2,1585,0,1587,G
5-NP,1321,1553,0,2,0,1555,A
5-NP,1322,0,5,1571,0,1576,G
5-NP,1323,0,4,1566,0,1570,G
5-NP,1324,1,0,1556,0,1557,G
5-NP,1325,2,1,0,1563,1566,C
5-NP,1326,1558,0,1,0,1559,A
5-NP,1327,0,1,1563,0,1564,G
5-NP,1328,1563,0,0,0,1563,A
5-NP,1329,1577,0,0,0,1577,A
5-NP,1330,1574,0,0,0,1574,A
5-NP,1331,0,1547,0,1,1548,T
5-NP,1332,2,1,0,1558,1561,C
5-NP,1333,1555,0,0,1,1556,A
5-NP,1334,0,1550,0,1,1551,T
5-NP,1335,1560,0,1,0,1561,A
5-NP,1336,1554,0,0,0,1554,A
5-NP,1337,0,0,1578,1,1579,G
5-NP,1338,1553,0,0,0,1553,A
5-NP,1339,1571,1,2,0,1574,A
5-NP,1340,0,1538,0,0,1538,T
5-NP,1341,0,1,1544,0,1545,G
5-NP,1342,1540,0,4,0,1544,A
5-NP,1343,0,1543,0,0,1543,T
5-NP,1344,1,4,1545,0,1550,G
5-NP,1345,0,1,1546,0,1547,G
5-NP,1346,1511,0,0,0,1511,A
5-NP,1347,1505,0,0,0,1505,A
5-NP,1348,2,5,1455,0,1462,G
5-NP,1349,0,1,1494,0,1495,G
5-NP,1350,0,1463,0,1,1464,T
5-NP,1351,1,0,1476,1,1478,G
5-NP,1352,0,0,0,1460,1460,C
5-NP,1353,1468,0,0,0,1468,A
5-NP,1354,1472,0,0,0,1472,A
5-NP,1355,1474,0,1,0,1475,A
5-NP,1356,1478,0,0,1,1479,A
5-NP,1357,1,0,0,1479,1480,C
5-NP,1358,1,0,0,1462,1463,C
5-NP,1359,1442,0,1,0,1443,A
5-NP,1360,1,0,1459,0,1460,G
5-NP,1361,1451,0,1,0,1452,A
5-NP,1362,1454,0,0,0,1454,A
5-NP,1363,0,2,1448,0,1450,G
5-NP,1364,1437,0,1,0,1438,A
5-NP,1365,1413,0,1,0,1414,A
5-NP,1366,0,2,1431,0,1433,G
5-NP,1367,0,1412,0,1,1413,T
5-NP,1368,0,0,1429,1,1430,G
5-NP,1369,0,1400,0,1,1401,T
5-NP,1370,2,0,0,1415,1417,C
5-NP,1371,1412,0,1,0,1413,A
5-NP,1372,0,1416,0,2,1418,T
5-NP,1373,1,1430,0,0,1431,T
5-NP,1374,3,0,0,1431,1434,C
5-NP,1375,4,0,0,1407,1411,C
5-NP,1376,2,2,1404,0,1408,G
5-NP,1377,1386,0,1,0,1387,A
5-NP,1378,0,3,1387,0,1390,G
5-NP,1379,0,0,1395,0,1395,G
5-NP,1380,0,0,1393,0,1393,G
5-NP,1381,1328,0,2,0,1330,A
5-NP,1382,0,3,1330,0,1333,G
5-NP,1383,0,3,1337,0,1340,G
5-NP,1384,0,0,1331,0,1331,G
5-NP,1385,0,2,1332,0,1334,G
5-NP,1386,1315,0,0,0,1315,A
5-NP,1387,11,0,1308,0,1319,G
5-NP,1388,0,1296,0,0,1296,T
5-NP,1389,0,1304,0,2,1306,T
5-NP,1390,0,1308,0,1,1309,T
5-NP,1391,0,1297,0,0,1297,T
5-NP,1392,3,0,0,1298,1301,C
5-NP,1393,0,1,1305,0,1306,G
5-NP,1394,1297,0,0,0,1297,A
5-NP,1395,0,0,1347,0,1347,G
5-NP,1396,0,0,0,1322,1322,C
5-NP,1397,0,1324,0,1,1325,T
5-NP,1398,2,0,0,1337,1339,C
5-NP,1399,0,1331,1,1,1333,T
5-NP,1400,0,0,0,1342,1342,C
5-NP,1401,1341,0,1,0,1342,A
5-NP,1402,0,0,1364,0,1364,G
5-NP,1403,1365,0,0,0,1365,A
5-NP,1404,0,0,0,1351,1351,C
5-NP,1405,0,4,1340,0,1344,G
5-NP,1406,1314,0,1,1,1316,A
5-NP,1407,0,2,1325,0,1327,G
5-NP,1408,1318,0,1,0,1319,A
5-NP,1409,1308,0,1,0,1309,A
5-NP,1410,0,4,1303,0,1307,G
5-NP,1411,2,0,1288,0,1290,G
5-NP,1412,0,0,0,1282,1282,C
5-NP,1413,1278,0,1,0,1279,A
5-NP,1414,1266,0,0,0,1266,A
5-NP,1415,1,0,0,1272,1273,C
5-NP,1416,0,1,1272,0,1273,G
5-NP,1417,1276,1,1,0,1278,A
5-NP,1418,1263,0,2,0,1265,A
5-NP,1419,1,0,0,1275,1276,C
5-NP,1420,2,0,0,1264,1266,C
5-NP,1421,8,1,0,1244,1253,C
5-NP,1422,0,1,1260,0,1261,G
5-NP,1423,1255,0,1,0,1256,A
5-NP,1424,0,1256,0,0,1256,T
5-NP,1425,2,0,0,1234,1236,C
5-NP,1426,0,2,1243,0,1245,G
5-NP,1427,0,1239,0,0,1239,T
5-NP,1428,1,0,1227,0,1228,G
5-NP,1429,0,0,0,1219,1219,C
5-NP,1430,2,1,0,1201,1204,C
5-NP,1431,7,0,0,1218,1225,C
5-NP,1432,0,1200,0,4,1204,T
5-NP,1433,2,0,0,1266,1268,C
5-NP,1434,1,1265,0,1,1267,T
5-NP,1435,0,1271,0,0,1271,T
5-NP,1436,0,1276,0,0,1276,T
5-NP,1437,0,1266,0,0,1266,T
5-NP,1438,4,0,1271,0,1275,G
5-NP,1439,1271,0,1,0,1272,A
5-NP,1440,0,1262,0,0,1262,T
5-NP,1441,1258,0,0,0,1258,A
5-NP,1442,0,1105,1,0,1106,T
5-NP,1443,0,1,1118,0,1119,G
5-NP,1444,1108,0,0,0,1108,A
5-NP,1445,0,0,1121,0,1121,G
5-NP,1446,1,1110,0,0,1111,T
5-NP,1447,1089,0,0,0,1089,A
5-NP,1448,1089,0,1,1,1091,A
5-NP,1449,0,1078,0,0,1078,T
5-NP,1450,0,1,1080,0,1081,G
5-NP,1451,1084,0,0,0,1084,A
5-NP,1452,962,0,0,0,962,A
5-NP,1453,1,0,953,0,954,G
5-NP,1454,0,1,895,0,896,G
5-NP,1455,899,0,0,0,899,A
5-NP,1456,0,896,0,1,897,T
5-NP,1457,2,0,0,888,890,C
5-NP,1458,0,883,0,2,885,T
5-NP,1459,0,885,0,0,885,T
5-NP,1460,884,0,0,0,884,A
5-NP,1461,0,878,0,0,878,T
5-NP,1462,0,869,0,0,869,T
5-NP,1463,0,861,0,0,861,T
5-NP,1464,1,0,0,845,846,C
5-NP,1465,0,825,0,0,825,T
5-NP,1466,0,818,0,1,819,T
5-NP,1467,1,0,0,823,824,C
5-NP,1468,0,0,823,0,823,G
5-NP,1469,0,1,822,0,823,G
5-NP,1470,808,0,1,0,809,A
5-NP,1471,0,1,811,0,812,G
5-NP,1472,814,0,0,0,814,A
5-NP,1473,0,0,0,797,797,C
5-NP,1474,744,0,0,1,745,A
5-NP,1475,747,0,0,0,747,A
5-NP,1476,0,739,0,0,739,T
5-NP,1477,0,0,744,0,744,G
5-NP,1478,1,0,0,737,738,C
5-NP,1479,717,0,1,0,718,A
5-NP,1480,2,1,718,0,721,G
5-NP,1481,713,0,0,0,713,A
5-NP,1482,667,0,1,0,668,A
5-NP,1483,0,1,660,1,662,G
5-NP,1484,445,1,1,0,447,A
5-NP,1485,0,0,446,0,446,G
5-NP,1486,0,413,0,0,413,T
5-NP,1487,412,0,0,0,412,A
5-NP,1488,1,1,0,409,411,C
5-NP,1489,0,0,381,0,381,G
5-NP,1490,381,0,1,0,382,A
5-NP,1491,0,0,0,381,381,C
5-NP,1492,273,0,0,0,273,A
5-NP,1493,271,0,0,0,271,A
5-NP,1494,0,222,0,0,222,T
5-NP,1495,0,214,0,0,214,T
5-NP,1496,214,0,0,0,214,A
5-NP,1497,200,0,0,0,200,A
6-NA,1,3,0,0,0,3,A
6-NA,2,0,3,0,0,3,T
6-NA,3,0,0,3,0,3,G
6-NA,4,2,0,0,0,2,A
6-NA,5,2,0,0,0,2,A
6-NA,6,0,3,0,0,3,T
6-NA,7,0,0,0,3,3,C
6-NA,8,0,0,0,3,3,C
6-NA,9,3,0,0,0,3,A
6-NA,10,4,0,0,0,4,A
6-NA,11,3,0,0,0,3,A
6-NA,12,0,4,0,0,4,T
6-NA,13,0,0,0,4,4,C
6-NA,14,4,0,0,0,4,A
6-NA,15,4,0,0,0,4,A
6-NA,16,4,0,0,0,4,A
6-NA,17,4,0,0,0,4,A
6-NA,18,0,0,4,0,4,G
6-NA,19,4,0,0,0,4,A
6-NA,20,0,4,0,0,4,T
6-NA,21,4,0,0,0,4,A
6-NA,22,4,0,0,0,4,A
6-NA,23,0,4,0,0,4,T
6-NA,24,4,0,0,0,4,A
6-NA,25,4,0,0,0,4,A
6-NA,26,0,0,0,4,4,C
6-NA,27,0,0,4,0,4,G
6-NA,28,4,0,0,0,4,A
6-NA,29,0,4,0,0,4,T
6-NA,30,0,4,0,0,4,T
6-NA,31,0,0,4,0,4,G
6-NA,32,0,0,5,0,5,G
6-NA,33,0,0,0,6,6,C
6-NA,34,0,6,0,0,6,T
6-NA,35,0,0,0,8,8,C
6-NA,36,0,8,0,0,8,T
6-NA,37,0,0,8,0,8,G
6-NA,38,0,8,0,0,8,T
6-NA,39,0,8,0,0,8,T
6-NA,40,0,8,0,0,8,T
6-NA,41,0,0,0,8,8,C
6-NA,42,0,8,0,0,8,T
6-NA,43,0,0,0,8,8,C
6-NA,44,0,8,0,0,8,T
6-NA,45,0,0,0,8,8,C
6-NA,46,8,0,0,0,8,A
6-NA,47,0,0,0,9,9,C
6-NA,48,0,0,0,9,9,C
6-NA,49,9,0,0,0,9,A
6-NA,50,0,10,0,0,10,T
6-NA,51,0,12,0,0,12,T
6-NA,52,0,12,0,0,12,T
6-NA,53,0,0,0,12,12,C
6-NA,54,0,0,0,12,12,C
6-NA,55,12,0,0,0,12,A
6-NA,56,0,0,0,12,12,C
6-NA,57,12,0,0,0,12,A
6-NA,58,12,0,0,0,12,A
6-NA,59,0,14,0,0,14,T
6-NA,60,15,0,0,0,15,A
6-NA,61,0,15,0,0,15,T
6-NA,62,0,0,15,0,15,G
6-NA,63,0,0,0,15,15,C
6-NA,64,0,15,0,0,15,T
6-NA,65,0,14,0,0,14,T
6-NA,66,0,0,0,15,15,C
6-NA,67,0,15,0,0,15,T
6-NA,68,0,15,0,0,15,T
6-NA,69,0,0,0,15,15,C
6-NA,70,15,0,0,0,15,A
6-NA,71,0,15,0,0,15,T
6-NA,72,0,0,15,0,15,G
6-NA,73,0,0,0,16,16,C
6-NA,74,16,0,0,0,16,A
6-NA,75,16,0,0,0,16,A
6-NA,76,16,0,0,0,16,A
6-NA,77,0,16,0,0,16,T
6-NA,78,0,16,0,0,16,T
6-NA,79,0,0,17,0,17,G
6-NA,80,0,0,0,17,17,C
6-NA,81,0,0,0,17,17,C
6-NA,82,18,0,0,0,18,A
6-NA,83,0,18,0,0,18,T
6-NA,84,0,0,0,19,19,C
6-NA,85,0,18,0,0,18,T
6-NA,86,0,19,0,0,19,T
6-NA,87,0,0,21,0,21,G
6-NA,88,21,0,0,0,21,A
6-NA,89,0,21,0,0,21,T
6-NA,90,21,0,0,0,21,A
6-NA,91,22,0,0,0,22,A
6-NA,92,0,0,0,26,26,C
6-NA,93,0,29,0,0,29,T
6-NA,94,29,0,0,0,29,A
6-NA,95,0,0,0,32,32,C
6-NA,96,0,32,0,0,32,T
6-NA,97,1,0,32,0,33,G
6-NA,98,0,33,0,0,33,T
6-NA,99,33,0,0,0,33,A
6-NA,100,33,0,0,0,33,A
6-NA,101,0,0,0,31,31,C
6-NA,102,32,0,0,0,32,A
6-NA,103,0,31,0,0,31,T
6-NA,104,0,32,0,0,32,T
6-NA,105,0,0,33,0,33,G
6-NA,106,0,0,0,32,32,C
6-NA,107,35,0,0,0,35,A
6-NA,108,0,35,0,0,35,T
6-NA,109,0,35,0,0,35,T
6-NA,110,0,35,0,0,35,T
6-NA,111,0,0,0,35,35,C
6-NA,112,36,0,0,0,36,A
6-NA,113,36,0,0,0,36,A
6-NA,114,0,0,36,0,36,G
6-NA,115,0,0,0,35,35,C
6-NA,116,36,0,0,0,36,A
6-NA,117,37,0,0,0,37,A
6-NA,118,0,37,0,0,37,T
6-NA,119,37,0,0,0,37,A
6-NA,120,0,37,0,0,37,T
6-NA,121,0,0,37,0,37,G
6-NA,122,37,0,0,0,37,A
6-NA,123,38,0,0,0,38,A
6-NA,124,0,38,0,0,38,T
6-NA,125,0,39,0,0,39,T
6-NA,126,0,0,0,39,39,C
6-NA,127,38,0,0,0,38,A
6-NA,128,40,0,0,0,40,A
6-NA,129,0,0,0,40,40,C
6-NA,130,0,40,0,0,40,T
6-NA,131,0,0,0,39,39,C
6-NA,132,0,0,0,40,40,C
6-NA,133,0,0,0,40,40,C
6-NA,134,0,0,0,40,40,C
6-NA,135,0,0,0,42,42,C
6-NA,136,1,0,0,41,42,C
6-NA,137,0,0,0,42,42,C
6-NA,138,42,0,0,0,42,A
6-NA,139,42,0,0,0,42,A
6-NA,140,42,0,0,0,42,A
6-NA,141,0,0,0,45,45,C
6-NA,142,46,0,0,0,46,A
6-NA,143,46,0,0,0,46,A
6-NA,144,0,0,0,45,45,C
6-NA,145,0,0,0,46,46,C
6-NA,146,46,0,0,0,46,A
6-NA,147,46,0,0,0,46,A
6-NA,148,0,0,45,0,45,G
6-NA,149,0,46,0,0,46,T
6-NA,150,0,0,47,0,47,G
6-NA,151,49,0,0,0,49,A
6-NA,152,0,50,0,0,50,T
6-NA,153,0,0,51,0,51,G
6-NA,154,0,0,0,51,51,C
6-NA,155,0,50,0,0,50,T
6-NA,156,0,0,55,0,55,G
6-NA,157,0,52,0,0,52,T
6-NA,158,0,0,51,0,51,G
6-NA,159,0,51,0,0,51,T
6-NA,160,0,1,50,0,51,G
6-NA,161,52,0,0,0,52,A
6-NA,162,53,0,0,0,53,A
6-NA,163,0,0,0,53,53,C
6-NA,164,0,0,0,53,53,C
6-NA,165,53,0,0,0,53,A
6-NA,166,54,0,0,0,54,A
6-NA,167,0,0,0,55,55,C
6-NA,168,55,0,0,0,55,A
6-NA,169,54,0,0,0,54,A
6-NA,170,0,55,0,0,55,T
6-NA,171,55,0,0,0,55,A
6-NA,172,55,0,0,0,55,A
6-NA,173,0,55,0,0,55,T
6-NA,174,55,0,0,0,55,A
6-NA,175,0,0,55,0,55,G
6-NA,176,55,0,0,0,55,A
6-NA,177,55,0,0,0,55,A
6-NA,178,54,0,0,0,54,A
6-NA,179,0,0,55,0,55,G
6-NA,180,56,0,0,0,56,A
6-NA,181,56,0,0,0,56,A
6-NA,182,57,0,0,0,57,A
6-NA,183,0,0,0,58,58,C
6-NA,184,58,0,0,0,58,A
6-NA,185,0,57,0,0,57,T
6-NA,186,59,0,0,0,59,A
6-NA,187,59,0,0,0,59,A
6-NA,188,0,0,0,58,58,C
6-NA,189,59,0,0,0,59,A
6-NA,190,0,0,59,0,59,G
6-NA,191,60,0,0,0,60,A
6-NA,192,0,0,59,0,59,G
6-NA,193,58,0,1,0,59,A
6-NA,194,0,59,0,0,59,T
6-NA,195,60,0,0,0,60,A
6-NA,196,0,0,60,0,60,G
6-NA,197,0,58,0,0,58,T
6-NA,198,0,0,62,0,62,G
6-NA,199,0,61,0,0,61,T
6-NA,200,59,0,0,0,59,A
6-NA,201,0,60,0,0,60,T
6-NA,202,0,0,0,60,60,C
6-NA,203,0,60,0,0,60,T
6-NA,204,0,0,61,0,61,G
6-NA,205,60,0,0,0,60,A
6-NA,206,0,0,0,60,60,C
6-NA,207,0,0,0,59,59,C
6-NA,208,58,0,0,0,58,A
6-NA,209,57,0,0,0,57,A
6-NA,210,0,0,0,60,60,C
6-NA,211,58,0,0,0,58,A
6-NA,212,0,0,0,61,61,C
6-NA,213,0,0,0,59,59,C
6-NA,214,58,0,0,0,58,A
6-NA,215,0,0,0,65,65,C
6-NA,216,0,0,0,66,66,C
6-NA,217,65,0,0,0,65,A
6-NA,218,0,66,0,0,66,T
6-NA,219,66,0,0,0,66,A
6-NA,220,0,0,66,0,66,G
6-NA,221,65,0,0,0,65,A
6-NA,222,0,1,66,0,67,G
6-NA,223,65,0,1,0,66,A
6-NA,224,63,0,0,0,63,A
6-NA,225,0,0,64,0,64,G
6-NA,226,0,0,66,0,66,G
6-NA,227,66,0,0,0,66,A
6-NA,228,67,0,0,0,67,A
6-NA,229,67,0,0,0,67,A
6-NA,230,0,67,0,0,67,T
6-NA,231,67,0,0,0,67,A
6-NA,232,0,67,0,0,67,T
6-NA,233,0,0,66,0,66,G
6-NA,234,0,0,0,69,69,C
6-NA,235,0,0,0,70,70,C
6-NA,236,0,0,0,70,70,C
6-NA,237,0,0,0,68,68,C
6-NA,238,71,0,0,0,71,A
6-NA,239,73,0,0,0,73,A
6-NA,240,73,0,0,0,73,A
6-NA,241,0,0,0,73,73,C
6-NA,242,0,73,0,0,73,T
6-NA,243,71,0,0,0,71,A
6-NA,244,0,0,72,0,72,G
6-NA,245,0,0,0,70,70,C
6-NA,246,72,0,0,0,72,A
6-NA,247,0,0,72,0,72,G
6-NA,248,71,0,0,0,71,A
6-NA,249,74,0,0,0,74,A
6-NA,250,0,74,0,0,74,T
6-NA,251,74,0,0,0,74,A
6-NA,252,0,0,0,74,74,C
6-NA,253,71,0,0,1,72,A
6-NA,254,0,0,73,0,73,G
6-NA,255,74,0,0,0,74,A
6-NA,256,72,0,0,0,72,A
6-NA,257,72,0,0,0,72,A
6-NA,258,0,70,0,0,70,T
6-NA,259,0,70,0,0,70,T
6-NA,260,0,0,71,0,71,G
6-NA,261,0,0,69,0,69,G
6-NA,262,0,70,0,0,70,T
6-NA,263,1,0,0,69,70,C
6-NA,264,70,0,0,0,70,A
6-NA,265,69,0,0,0,69,A
6-NA,266,70,0,0,0,70,A
6-NA,267,0,0,69,0,69,G
6-NA,268,0,0,0,70,70,C
6-NA,269,0,0,0,70,70,C
6-NA,270,0,0,67,0,67,G
6-NA,271,0,0,0,70,70,C
6-NA,272,69,0,0,0,69,A
6-NA,273,71,0,0,0,71,A
6-NA,274,0,71,0,0,71,T
6-NA,275,0,0,73,0,73,G
6-NA,276,0,71,0,0,71,T
6-NA,277,0,0,73,0,73,G
6-NA,278,74,0,0,0,74,A
6-NA,279,0,0,0,76,76,C
6-NA,280,74,0,0,0,74,A
6-NA,281,0,76,0,0,76,T
6-NA,282,0,77,0,0,77,T
6-NA,283,77,0,0,0,77,A
6-NA,284,0,0,0,75,75,C
6-NA,285,77,0,0,0,77,A
6-NA,286,0,1,76,0,77,G
6-NA,287,0,0,76,0,76,G
6-NA,288,76,0,0,0,76,A
6-NA,289,0,75,0,1,76,T
6-NA,290,0,75,0,0,75,T
6-NA,291,0,75,0,0,75,T
6-NA,292,0,0,76,0,76,G
6-NA,293,0,0,0,74,74,C
6-NA,294,75,0,0,0,75,A
6-NA,295,0,0,0,74,74,C
6-NA,296,0,0,0,74,74,C
6-NA,297,0,73,0,0,73,T
6-NA,298,0,71,0,0,71,T
6-NA,299,0,74,0,0,74,T
6-NA,300,0,73,0,0,73,T
6-NA,301,0,75,0,0,75,T
6-NA,302,0,0,0,76,76,C
6-NA,303,0,76,0,0,76,T
6-NA,304,76,0,0,0,76,A
6-NA,305,76,0,0,0,76,A
6-NA,306,0,0,77,0,77,G
6-NA,307,0,1,75,0,76,G
6-NA,308,77,0,0,0,77,A
6-NA,309,0,0,0,76,76,C
6-NA,310,76,0,0,0,76,A
6-NA,311,76,0,0,0,76,A
6-NA,312,0,75,0,0,75,T
6-NA,313,0,77,0,0,77,T
6-NA,314,0,0,0,78,78,C
6-NA,315,0,1,76,0,77,G
6-NA,316,78,0,0,0,78,A
6-NA,317,0,78,0,0,78,T
6-NA,318,0,78,0,0,78,T
6-NA,319,75,0,1,0,76,A
6-NA,320,0,0,78,0,78,G
6-NA,321,0,0,78,0,78,G
6-NA,322,0,0,0,78,78,C
6-NA,323,0,79,0,0,79,T
6-NA,324,0,79,0,0,79,T
6-NA,325,0,79,0,0,79,T
6-NA,326,0,0,0,79,79,C
6-NA,327,0,0,0,77,77,C
6-NA,328,0,0,79,0,79,G
6-NA,329,0,0,0,79,79,C
6-NA,330,0,79,0,0,79,T
6-NA,331,0,0,80,0,80,G
6-NA,332,0,0,80,0,80,G
6-NA,333,0,79,0,0,79,T
6-NA,334,0,0,80,0,80,G
6-NA,335,0,0,80,0,80,G
6-NA,336,0,0,81,0,81,G
6-NA,337,0,0,81,0,81,G
6-NA,338,79,0,0,0,79,A
6-NA,339,0,0,0,84,84,C
6-NA,340,79,0,0,0,79,A
6-NA,341,0,79,0,0,79,T
6-NA,342,0,0,0,80,80,C
6-NA,343,0,80,0,0,80,T
6-NA,344,0,0,81,0,81,G
6-NA,345,0,0,81,0,81,G
6-NA,346,0,0,82,0,82,G
6-NA,347,1,81,0,0,82,T
6-NA,348,0,0,82,0,82,G
6-NA,349,81,0,0,0,81,A
6-NA,350,0,0,0,91,91,C
6-NA,351,91,0,1,0,92,A
6-NA,352,121,0,0,0,121,A
6-NA,353,0,0,136,0,136,G
6-NA,354,139,0,0,0,139,A
6-NA,355,0,0,170,0,170,G
6-NA,356,185,0,0,0,185,A
6-NA,357,227,0,0,0,227,A
6-NA,358,0,0,0,397,397,C
6-NA,359,0,0,0,452,452,C
6-NA,360,0,460,0,0,460,T
6-NA,361,0,473,0,0,473,T
6-NA,362,471,0,0,0,471,A
6-NA,363,0,478,0,0,478,T
6-NA,364,0,1,530,0,531,G
6-NA,365,0,539,0,0,539,T
6-NA,366,0,0,588,0,588,G
6-NA,367,0,594,0,0,594,T
6-NA,368,4,0,0,589,593,C
6-NA,369,608,2,0,3,613,A
6-NA,370,0,611,0,1,612,T
6-NA,371,0,0,617,0,617,G
6-NA,372,0,0,0,617,617,C
6-NA,373,0,3,618,0,621,G
6-NA,374,801,0,0,0,801,A
6-NA,375,0,808,0,0,808,T
6-NA,376,0,0,0,833,833,C
6-NA,377,0,0,0,841,841,C
6-NA,378,0,863,0,2,865,T
6-NA,379,0,3,885,0,888,G
6-NA,380,889,0,1,0,890,A
6-NA,381,1,0,0,889,890,C
6-NA,382,896,0,0,0,896,A
6-NA,383,899,0,0,0,899,A
6-NA,384,1,1,960,0,962,G
6-NA,385,0,964,0,0,964,T
6-NA,386,0,0,990,0,990,G
6-NA,387,0,996,0,0,996,T
6-NA,388,0,999,0,0,999,T
6-NA,389,997,0,0,0,997,A
6-NA,390,0,1004,0,0,1004,T
6-NA,391,2,0,0,1026,1028,C
6-NA,392,1026,0,1,0,1027,A
6-NA,393,1021,1,0,0,1022,A
6-NA,394,0,1028,0,0,1028,T
6-NA,395,0,1031,0,0,1031,T
6-NA,396,0,1029,0,1,1030,T
6-NA,397,0,2,1026,0,1028,G
6-NA,398,0,0,0,1121,1121,C
6-NA,399,0,0,0,1121,1121,C
6-NA,400,2,0,0,1131,1133,C
6-NA,401,0,1134,0,0,1134,T
6-NA,402,0,1133,0,0,1133,T
6-NA,403,0,8,1150,0,1158,G
6-NA,404,0,4,1153,0,1157,G
6-NA,405,1177,0,2,0,1179,A
6-NA,406,0,0,0,1186,1186,C
6-NA,407,1166,0,1,1,1168,A
6-NA,408,1,1,1203,1,1206,G
6-NA,409,0,0,1198,0,1198,G
6-NA,410,1,2,1244,0,1247,G
6-NA,411,1245,0,1,0,1246,A
6-NA,412,1256,0,2,0,1258,A
6-NA,413,0,0,0,1265,1265,C
6-NA,414,1260,0,1,0,1261,A
6-NA,415,1408,0,0,0,1408,A
6-NA,416,0,0,0,1432,1432,C
6-NA,417,1427,0,0,0,1427,A
6-NA,418,0,1,0,1451,1452,C
6-NA,419,0,1437,0,0,1437,T
6-NA,420,1468,0,0,0,1468,A
6-NA,421,1464,0,1,0,1465,A
6-NA,422,1465,0,1,0,1466,A
6-NA,423,0,1,3,1469,1473,C
6-NA,424,1425,0,0,0,1425,A
6-NA,425,1426,0,0,0,1426,A
6-NA,426,0,2,0,1419,1421,C
6-NA,427,0,2,1427,0,1429,G
6-NA,428,0,1417,0,3,1420,T
6-NA,429,0,0,1429,0,1429,G
6-NA,430,0,0,0,1432,1432,C
6-NA,431,1439,0,2,0,1441,A
6-NA,432,0,1450,0,0,1450,T
6-NA,433,0,1458,0,1,1459,T
6-NA,434,3,0,0,1484,1487,C
6-NA,435,1515,0,1,0,1516,A
6-NA,436,1520,1,0,0,1521,A
6-NA,437,1531,1,0,0,1532,A
6-NA,438,0,1534,0,0,1534,T
6-NA,439,2,10,1526,0,1538,G
6-NA,440,1543,2,3,1,1549,A
6-NA,441,0,0,0,1564,1564,C
6-NA,442,1551,0,4,0,1555,A
6-NA,443,1,0,0,1581,1582,C
6-NA,444,1565,0,3,0,1568,A
6-NA,445,1,1,2004,0,2006,G
6-NA,446,0,2002,0,0,2002,T
6-NA,447,2043,0,0,0,2043,A
6-NA,448,0,0,0,2059,2059,C
6-NA,449,0,1,2049,0,2050,G
6-NA,450,0,2103,0,0,2103,T
6-NA,451,0,5,2120,0,2125,G
6-NA,452,2114,0,0,0,2114,A
6-NA,453,0,2130,0,0,2130,T
6-NA,454,1970,0,3,0,1973,A
6-NA,455,1,5,1957,0,1963,G
6-NA,456,1,10,1926,0,1937,G
6-NA,457,1954,0,0,0,1954,A
6-NA,458,1,0,0,1987,1988,C
6-NA,459,2,0,0,1930,1932,C
6-NA,460,5,1,0,1968,1974,C
6-NA,461,6,0,0,1972,1978,C
6-NA,462,0,2002,0,3,2005,T
6-NA,463,0,2046,0,1,2047,T
6-NA,464,2061,0,0,0,2061,A
6-NA,465,3,2062,0,0,2065,T
6-NA,466,3,1,1,2069,2074,C
6-NA,467,2,4,2045,1,2052,G
6-NA,468,1,10,2025,0,2036,G
6-NA,469,2038,0,2,0,2040,A
6-NA,470,0,0,0,2066,2066,C
6-NA,471,4,0,0,2049,2053,C
6-NA,472,5,0,0,2173,2178,C
6-NA,473,0,2170,0,1,2171,T
6-NA,474,2213,0,0,0,2213,A
6-NA,475,0,2220,0,0,2220,T
6-NA,476,0,2224,0,0,2224,T
6-NA,477,0,3,2230,0,2233,G
6-NA,478,2221,0,1,1,2223,A
6-NA,479,0,2236,0,3,2239,T
6-NA,480,0,3,2244,0,2247,G
6-NA,481,2187,1,2,1,2191,A
6-NA,482,2198,0,3,0,2201,A
6-NA,483,0,2208,0,1,2209,T
6-NA,484,1,5,2228,0,2234,G
6-NA,485,2245,1,1,0,2247,A
6-NA,486,1,0,2299,0,2300,G
6-NA,487,1,2288,0,0,2289,T
6-NA,488,0,2302,0,0,2302,T
6-NA,489,2297,0,4,0,2301,A
6-NA,490,1,2,2297,0,2300,G
6-NA,491,0,2,2314,0,2316,G
6-NA,492,1,2296,0,1,2298,T
6-NA,493,0,0,2304,0,2304,G
6-NA,494,0,2307,0,1,2308,T
6-NA,495,0,2297,0,3,2300,T
6-NA,496,3,0,0,2333,2336,C
6-NA,497,0,0,0,2355,2355,C
6-NA,498,0,2354,0,0,2354,T
6-NA,499,0,2355,0,2,2357,T
6-NA,500,0,2350,0,3,2353,T
6-NA,501,1,2349,0,0,2350,T
6-NA,502,5,0,1,2361,2367,C
6-NA,503,2360,0,0,1,2361,A
6-NA,504,0,2443,0,0,2443,T
6-NA,505,1,1,0,2431,2433,C
6-NA,506,0,2420,0,1,2421,T
6-NA,507,0,11,2402,1,2414,G
6-NA,508,2,7,2384,0,2393,G
6-NA,509,0,9,2372,0,2381,G
6-NA,510,0,9,2432,0,2441,G
6-NA,511,2429,0,3,1,2433,A
6-NA,512,2,0,0,2477,2479,C
6-NA,513,5,1,0,2452,2458,C
6-NA,514,2491,0,2,1,2494,A
6-NA,515,2509,0,1,2,2512,A
6-NA,516,0,1,2500,0,2501,G
6-NA,517,0,0,0,2534,2534,C
6-NA,518,2522,0,0,0,2522,A
6-NA,519,2489,0,43,0,2532,A
6-NA,520,1,5,2546,0,2552,G
6-NA,521,0,2532,0,0,2532,T
6-NA,522,0,1,2610,1,2612,G
6-NA,523,0,2579,0,5,2584,T
6-NA,524,0,2,2684,0,2686,G
6-NA,525,0,0,0,2688,2688,C
6-NA,526,2693,0,0,1,2694,A
6-NA,527,0,2726,0,0,2726,T
6-NA,528,2679,0,0,1,2680,A
6-NA,529,1,1,2746,0,2748,G
6-NA,530,0,0,0,2730,2730,C
6-NA,531,2693,0,1,0,2694,A
6-NA,532,0,2683,0,0,2683,T
6-NA,533,1,5,2645,0,2651,G
6-NA,534,1,1,2878,0,2880,G
6-NA,535,0,2885,0,8,2893,T
6-NA,536,4,0,0,2866,2870,C
6-NA,537,3,0,0,2914,2917,C
6-NA,538,2975,0,2,1,2978,A
6-NA,539,0,1,3140,0,3141,G
6-NA,540,0,1,0,3140,3141,C
6-NA,541,0,3159,0,2,3161,T
6-NA,542,9,2,0,3152,3163,C
6-NA,543,3101,0,0,0,3101,A
6-NA,544,3187,0,0,0,3187,A
6-NA,545,1,3,3189,0,3193,G
6-NA,546,1,3206,0,2,3209,T
6-NA,547,0,3222,0,1,3223,T
6-NA,548,0,1,3213,0,3214,G
6-NA,549,2,3213,0,1,3216,T
6-NA,550,6,0,0,3210,3216,C
6-NA,551,3235,0,2,0,3237,A
6-NA,552,0,2,0,3283,3285,C
6-NA,553,0,7,3278,0,3285,G
6-NA,554,3336,0,1,0,3337,A
6-NA,555,0,3376,0,1,3377,T
6-NA,556,1,1,3456,0,3458,G
6-NA,557,0,7,3458,0,3465,G
6-NA,558,3465,0,1,0,3466,A
6-NA,559,3484,0,0,0,3484,A
6-NA,560,3540,0,2,1,3543,A
6-NA,561,3535,0,9,1,3545,A
6-NA,562,0,1,3595,0,3596,G
6-NA,563,1,1,0,3590,3592,C
6-NA,564,3576,0,4,0,3580,A
6-NA,565,1,3607,0,1,3609,T
6-NA,566,2,12,3655,0,3669,G
6-NA,567,2,2,3676,0,3680,G
6-NA,568,0,1,0,3741,3742,C
6-NA,569,0,3722,0,6,3728,T
6-NA,570,2,3,3762,1,3768,G
6-NA,571,0,2,0,3763,3765,C
6-NA,572,3771,1,0,0,3772,A
6-NA,573,0,3983,0,1,3984,T
6-NA,574,1,2,3996,0,3999,G
6-NA,575,1,4110,0,0,4111,T
6-NA,576,0,4241,0,3,4244,T
6-NA,577,1,4225,0,2,4228,T
6-NA,578,0,0,4549,0,4549,G
6-NA,579,0,4516,0,3,4519,T
6-NA,580,4556,0,2,1,4559,A
6-NA,581,0,4597,1,3,4601,T
6-NA,582,4562,0,1,4,4567,A
6-NA,583,4604,0,3,0,4607,A
6-NA,584,1,2,0,4567,4570,C
6-NA,585,1,17,4537,0,4555,G
6-NA,586,1,17,4544,0,4562,G
6-NA,587,1,19,4474,1,4495,G
6-NA,588,0,10,4508,0,4518,G
6-NA,589,0,3,4530,0,4533,G
6-NA,590,4487,0,5,0,4492,A
6-NA,591,0,4554,1,2,4557,T
6-NA,592,2,11,4551,0,4564,G
6-NA,593,4585,0,7,1,4593,A
6-NA,594,0,4634,0,2,4636,T
6-NA,595,4637,0,2,0,4639,A
6-NA,596,4712,0,1,0,4713,A
6-NA,597,4745,0,1,0,4746,A
6-NA,598,4756,1,0,0,4757,A
6-NA,599,4770,0,1,0,4771,A
6-NA,600,0,4770,0,1,4771,T
6-NA,601,0,2,4767,0,4769,G
6-NA,602,1,0,0,4774,4775,C
6-NA,603,4774,0,2,1,4777,A
6-NA,604,4791,0,1,0,4792,A
6-NA,605,2,2,0,4868,4872,C
6-NA,606,0,4863,0,0,4863,T
6-NA,607,3,0,4880,0,4883,G
6-NA,608,1,0,0,4878,4879,C
6-NA,609,0,4895,0,1,4896,T
6-NA,610,4901,0,3,0,4904,A
6-NA,611,2,1,4902,1,4906,G
6-NA,612,3,6,0,4946,4955,C
6-NA,613,0,4943,0,6,4949,T
6-NA,614,0,4946,1,0,4947,T
6-NA,615,8,1,0,5014,5023,C
6-NA,616,5042,0,1,1,5044,A
6-NA,617,0,5064,0,0,5064,T
6-NA,618,0,5080,0,1,5081,T
6-NA,619,0,5135,0,1,5136,T
6-NA,620,5159,0,1,0,5160,A
6-NA,621,1,1,0,5209,5211,C
6-NA,622,5177,1,3,0,5181,A
6-NA,623,5231,0,3,0,5234,A
6-NA,624,0,5220,0,1,5221,T
6-NA,625,2,21,5170,0,5193,G
6-NA,626,6,12,5161,0,5179,G
6-NA,627,2,4,5168,1,5175,G
6-NA,628,5120,2,13,0,5135,A
6-NA,629,1,9,5314,0,5324,G
6-NA,630,3,2,5341,0,5346,G
6-NA,631,1,0,0,5833,5834,C
6-NA,632,0,5896,0,6,5902,T
6-NA,633,1,5975,0,1,5977,T
6-NA,634,2,1,6048,0,6051,G
6-NA,635,4,6010,0,1,6015,T
6-NA,636,6138,1,5,0,6144,A
6-NA,637,0,6,6180,0,6186,G
6-NA,638,6095,1,3,0,6099,A
6-NA,639,0,6116,0,0,6116,T
6-NA,640,5729,0,1,0,5730,A
6-NA,641,1,2,5743,0,5746,G
6-NA,642,2,5679,1,5,5687,T
6-NA,643,3,2,5612,0,5617,G
6-NA,644,0,5865,0,2,5867,T
6-NA,645,0,5874,0,0,5874,T
6-NA,646,1,2,5965,0,5968,G
6-NA,647,0,5927,0,6,5933,T
6-NA,648,0,5945,0,2,5947,T
6-NA,649,0,5966,0,2,5968,T
6-NA,650,13,0,0,5912,5925,C
6-NA,651,5906,0,3,0,5909,A
6-NA,652,0,5862,0,0,5862,T
6-NA,653,0,24,5831,0,5855,G
6-NA,654,0,2,6257,0,6259,G
6-NA,655,1,6192,0,4,6197,T
6-NA,656,15,2,0,6175,6192,C
6-NA,657,14,0,0,6196,6210,C
6-NA,658,6226,1,1,0,6228,A
6-NA,659,6269,0,2,0,6271,A
6-NA,660,6285,0,3,0,6288,A
6-NA,661,1,9,6296,0,6306,G
6-NA,662,6278,0,2,0,6280,A
6-NA,663,6082,0,2,1,6085,A
6-NA,664,6082,0,3,0,6085,A
6-NA,665,0,6092,0,1,6093,T
6-NA,666,4,0,0,6266,6270,C
6-NA,667,6,0,0,6269,6275,C
6-NA,668,0,6285,0,0,6285,T
6-NA,669,12,3,0,6269,6284,C
6-NA,670,6279,0,2,0,6281,A
6-NA,671,1,7,6294,0,6302,G
6-NA,672,1,11,6252,0,6264,G
6-NA,673,6469,0,6,0,6475,A
6-NA,674,2,1,2,6489,6494,C
6-NA,675,8,3,2,6380,6393,C
6-NA,676,17,1,1,6398,6417,C
6-NA,677,6407,0,7,0,6414,A
6-NA,678,2,7,6444,0,6453,G
6-NA,679,0,7,6457,2,6466,G
6-NA,680,6429,0,6,0,6435,A
6-NA,681,1,3,6539,0,6543,G
6-NA,682,0,6407,0,2,6409,T
6-NA,683,14,3,0,6428,6445,C
6-NA,684,6441,0,5,0,6446,A
6-NA,685,0,12,6494,0,6506,G
6-NA,686,6447,0,6,0,6453,A
6-NA,687,6450,0,0,0,6450,A
6-NA,688,0,6448,0,0,6448,T
6-NA,689,0,3,6469,0,6472,G
6-NA,690,2,1,0,6453,6456,C
6-NA,691,0,1,6525,0,6526,G
6-NA,692,0,6478,0,4,6482,T
6-NA,693,1,6509,0,4,6514,T
6-NA,694,0,6494,1,1,6496,T
6-NA,695,0,1,6535,0,6536,G
6-NA,696,0,6550,0,9,6559,T
6-NA,697,6562,0,0,0,6562,A
6-NA,698,0,6536,0,1,6537,T
6-NA,699,15,0,0,6546,6561,C
6-NA,700,6540,0,2,0,6542,A
6-NA,701,6549,0,4,1,6554,A
6-NA,702,3,6562,0,4,6569,T
6-NA,703,1,12,6539,1,6553,G
6-NA,704,0,20,6530,1,6551,G
6-NA,705,6659,0,4,0,6663,A
6-NA,706,6681,0,6,0,6687,A
6-NA,707,2,0,0,6771,6773,C
6-NA,708,1,6827,0,3,6831,T
6-NA,709,1,6828,0,3,6832,T
6-NA,710,4,5,7043,0,7052,G
6-NA,711,2,7023,0,1,7026,T
6-NA,712,7039,0,2,0,7041,A
6-NA,713,2,0,0,7154,7156,C
6-NA,714,6993,0,4,1,6998,A
6-NA,715,1,5,7485,0,7491,G
6-NA,716,0,7408,1,2,7411,T
6-NA,717,7708,0,2,0,7710,A
6-NA,718,3,6,7747,0,7756,G
6-NA,719,0,7638,0,0,7638,T
6-NA,720,7648,0,0,0,7648,A
6-NA,721,7630,0,2,2,7634,A
6-NA,722,1,7604,0,0,7605,T
6-NA,723,9,17,7613,0,7639,G
6-NA,724,7486,2,3,0,7491,A
6-NA,725,3,0,1,7592,7596,C
6-NA,726,0,7427,0,3,7430,T
6-NA,727,1,11,7449,0,7461,G
6-NA,728,7377,0,6,0,7383,A
6-NA,729,1,7440,0,5,7446,T
6-NA,730,0,32,7428,0,7460,G
6-NA,731,0,12,7365,0,7377,G
6-NA,732,2,15,7395,0,7412,G
6-NA,733,7290,1,4,0,7295,A
6-NA,734,4,1,7335,0,7340,G
6-NA,735,1,7316,1,1,7319,T
6-NA,736,4,3,7360,0,7367,G
6-NA,737,1,1,0,7836,7838,C
6-NA,738,0,7845,1,8,7854,T
6-NA,739,0,7869,0,3,7872,T
6-NA,740,5,5,0,7841,7851,C
6-NA,741,7816,5,5,2,7828,A
6-NA,742,2,10,7892,0,7904,G
6-NA,743,1,23,7850,1,7875,G
6-NA,744,7825,0,4,1,7830,A
6-NA,745,2,4,7497,0,7503,G
6-NA,746,7506,1,1,0,7508,A
6-NA,747,7567,0,4,3,7574,A
6-NA,748,0,3,7609,0,7612,G
6-NA,749,3,2,0,7616,7621,C
6-NA,750,0,7639,0,2,7641,T
6-NA,751,4,12,7604,0,7620,G
6-NA,752,7562,2,4,0,7568,A
6-NA,753,0,7685,1,0,7686,T
6-NA,754,7678,1,3,1,7683,A
6-NA,755,2,1,1,8002,8006,C
6-NA,756,0,7979,1,7,7987,T
6-NA,757,7975,0,3,0,7978,A
6-NA,758,7987,0,0,0,7987,A
6-NA,759,7970,0,4,0,7974,A
6-NA,760,8184,2,1,0,8187,A
6-NA,761,0,8208,1,1,8210,T
6-NA,762,8159,0,0,0,8159,A
6-NA,763,4,1,0,8226,8231,C
6-NA,764,0,8040,0,5,8045,T
6-NA,765,8163,0,1,0,8164,A
6-NA,766,0,8112,1,6,8119,T
6-NA,767,2,8410,1,1,8414,T
6-NA,768,18,2,0,8426,8446,C
6-NA,769,8316,0,1,0,8317,A
6-NA,770,0,8335,2,4,8341,T
6-NA,771,0,8340,1,0,8341,T
6-NA,772,5,8,8352,0,8365,G
6-NA,773,8260,0,8,2,8270,A
6-NA,774,18,17,8258,0,8293,G
6-NA,775,1,23,8257,1,8282,G
6-NA,776,7989,1,5,1,7996,A
6-NA,777,0,25,8156,0,8181,G
6-NA,778,3,28,8120,4,8155,G
6-NA,779,2,10,8147,1,8160,G
6-NA,780,3,10,8177,0,8190,G
6-NA,781,8141,1,9,0,8151,A
6-NA,782,8201,0,4,0,8205,A
6-NA,783,8185,0,2,0,8187,A
6-NA,784,8113,1,54,0,8168,A
6-NA,785,0,8148,1,1,8150,T
6-NA,786,9,0,0,8146,8155,C
6-NA,787,41,2,8193,0,8236,G
6-NA,788,1,8179,1,2,8183,T
6-NA,789,0,8171,1,14,8186,T
6-NA,790,29,4,1,8170,8204,C
6-NA,791,8215,0,1,1,8217,A
6-NA,792,0,8757,2,2,8761,T
6-NA,793,8708,0,7,0,8715,A
6-NA,794,2,1,0,8819,8822,C
6-NA,795,0,8780,0,5,8785,T
6-NA,796,8772,0,2,0,8774,A
6-NA,797,0,2,8742,0,8744,G
6-NA,798,2,0,0,8771,8773,C
6-NA,799,8739,1,1,0,8741,A
6-NA,800,0,1,0,8774,8775,C
6-NA,801,8446,0,1,0,8447,A
6-NA,802,0,8599,1,1,8601,T
6-NA,803,0,8559,1,0,8560,T
6-NA,804,1,2,9021,1,9025,G
6-NA,805,0,8973,0,3,8976,T
6-NA,806,24,7,0,8944,8975,C
6-NA,807,8984,0,14,0,8998,A
6-NA,808,1,11,9009,0,9021,G
6-NA,809,10,17,9002,0,9029,G
6-NA,810,8968,0,3,0,8971,A
6-NA,811,8849,0,9,0,8858,A
6-NA,812,3,3,8949,1,8956,G
6-NA,813,0,8471,1,2,8474,T
6-NA,814,0,1,8523,0,8524,G
6-NA,815,6,9,0,8494,8509,C
6-NA,816,1,8540,0,2,8543,T
6-NA,817,21,2,2,8566,8591,C
6-NA,818,8559,0,2,2,8563,A
6-NA,819,2,2,8599,0,8603,G
6-NA,820,8,0,0,8599,8607,C
6-NA,821,8624,1,5,1,8631,A
6-NA,822,0,8648,1,0,8649,T
6-NA,823,2,1,8931,0,8934,G
6-NA,824,1,8898,2,1,8902,T
6-NA,825,21,1,0,8900,8922,C
6-NA,826,5,11,8907,0,8923,G
6-NA,827,8835,0,3,1,8839,A
6-NA,828,0,15,8855,0,8870,G
6-NA,829,1,13,8843,0,8857,G
6-NA,830,8772,0,5,1,8778,A
6-NA,831,0,5,8889,0,8894,G
6-NA,832,0,8649,0,3,8652,T
6-NA,833,2,1,8678,1,8682,G
6-NA,834,0,0,0,8794,8794,C
6-NA,835,0,8799,0,8,8807,T
6-NA,836,28,3,0,8812,8843,C
6-NA,837,13,6,0,8859,8878,C
6-NA,838,0,8907,1,6,8914,T
6-NA,839,2,1,8895,0,8898,G
6-NA,840,1,3,0,8778,8782,C
6-NA,841,0,8773,0,8,8781,T
6-NA,842,8806,0,1,0,8807,A
6-NA,843,0,8653,0,4,8657,T
6-NA,844,8,1,1,8693,8703,C
6-NA,845,17,2,0,8695,8714,C
6-NA,846,1,8675,2,5,8683,T
6-NA,847,12,2,0,8787,8801,C
6-NA,848,2,14,8770,0,8786,G
6-NA,849,8828,4,0,2,8834,A
6-NA,850,0,8837,0,6,8843,T
6-NA,851,8852,0,1,1,8854,A
6-NA,852,0,8853,0,1,8854,T
6-NA,853,14,0,1,8845,8860,C
6-NA,854,15,2,1,8846,8864,C
6-NA,855,0,8812,0,5,8817,T
6-NA,856,1,15,8802,0,8818,G
6-NA,857,1,2,8818,0,8821,G
6-NA,858,0,8944,0,8,8952,T
6-NA,859,4,3,8976,0,8983,G
6-NA,860,0,8943,0,3,8946,T
6-NA,861,24,2,0,8937,8963,C
6-NA,862,8955,0,4,1,8960,A
6-NA,863,0,8,8951,1,8960,G
6-NA,864,8938,1,4,0,8943,A
6-NA,865,0,8860,2,5,8867,T
6-NA,866,1,3,8876,0,8880,G
6-NA,867,1,8767,0,2,8770,T
6-NA,868,2,5,8799,0,8806,G
6-NA,869,1,8787,0,12,8800,T
6-NA,870,14,1,0,8827,8842,C
6-NA,871,0,8826,0,5,8831,T
6-NA,872,4,0,8831,0,8835,G
6-NA,873,2,3,0,8843,8848,C
6-NA,874,8842,0,4,1,8847,A
6-NA,875,2,17,8850,0,8869,G
6-NA,876,8647,1,9,1,8658,A
6-NA,877,1,4,8684,0,8689,G
6-NA,878,8659,0,6,0,8665,A
6-NA,879,1,0,0,8725,8726,C
6-NA,880,8729,0,3,0,8732,A
6-NA,881,8761,0,0,0,8761,A
6-NA,882,4,2,0,8800,8806,C
6-NA,883,0,8796,1,6,8803,T
6-NA,884,5,7,8770,0,8782,G
6-NA,885,3,7,8748,0,8758,G
6-NA,886,8740,0,3,0,8743,A
6-NA,887,8714,1,3,0,8718,A
6-NA,888,8521,0,12,0,8533,A
6-NA,889,0,12,8634,0,8646,G
6-NA,890,2,2,8577,0,8581,G
6-NA,891,7,4,0,8537,8548,C
6-NA,892,1,8475,0,8,8484,T
6-NA,893,13,2,0,8671,8686,C
6-NA,894,13,1,1,8742,8757,C
6-NA,895,8808,0,2,0,8810,A
6-NA,896,8795,1,1,1,8798,A
6-NA,897,0,8792,1,3,8796,T
6-NA,898,8503,1,2,0,8506,A
6-NA,899,1,10,8423,0,8434,G
6-NA,900,4,3,8390,0,8397,G
6-NA,901,2,1,1,8392,8396,C
6-NA,902,9,0,0,8234,8243,C
6-NA,903,16,3,0,8164,8183,C
6-NA,904,8285,0,2,1,8288,A
6-NA,905,0,8344,0,6,8350,T
6-NA,906,6,1,1,8408,8416,C
6-NA,907,7,3,8448,1,8459,G
6-NA,908,0,8409,0,1,8410,T
6-NA,909,8241,1,0,0,8242,A
6-NA,910,1,3,8444,0,8448,G
6-NA,911,8424,0,2,0,8426,A
6-NA,912,0,8466,0,6,8472,T
6-NA,913,8286,0,6,1,8293,A
6-NA,914,0,8185,0,1,8186,T
6-NA,915,8170,0,5,1,8176,A
6-NA,916,8148,0,3,1,8152,A
6-NA,917,8286,0,9,1,8296,A
6-NA,918,4,2,1,8476,8483,C
6-NA,919,8267,0,1,1,8269,A
6-NA,920,1,8251,0,0,8252,T
6-NA,921,8193,0,2,0,8195,A
6-NA,922,8206,0,2,0,8208,A
6-NA,923,8173,0,9,3,8185,A
6-NA,924,1,20,8241,0,8262,G
6-NA,925,1,16,8305,0,8322,G
6-NA,926,8065,0,2,1,8068,A
6-NA,927,0,8039,0,6,8045,T
6-NA,928,16,1,0,8074,8091,C
6-NA,929,8145,0,7,1,8153,A
6-NA,930,0,8152,1,4,8157,T
6-NA,931,8150,2,3,0,8155,A
6-NA,932,1,4,8167,0,8172,G
6-NA,933,5,2,0,8064,8071,C
6-NA,934,7948,0,10,0,7958,A
6-NA,935,0,7748,2,5,7755,T
6-NA,936,1,7797,1,0,7799,T
6-NA,937,5,4,8021,0,8030,G
6-NA,938,0,8008,0,2,8010,T
6-NA,939,0,8158,1,3,8162,T
6-NA,940,1,8126,0,3,8130,T
6-NA,941,13,0,1,8104,8118,C
6-NA,942,15,1,0,8149,8165,C
6-NA,943,8250,0,5,0,8255,A
6-NA,944,1,2,8348,0,8351,G
6-NA,945,0,8333,0,2,8335,T
6-NA,946,0,8122,0,3,8125,T
6-NA,947,8141,0,0,0,8141,A
6-NA,948,1,7971,0,4,7976,T
6-NA,949,4,3,7986,0,7993,G
6-NA,950,1,7889,0,7,7897,T
6-NA,951,5,0,7960,0,7965,G
6-NA,952,1,7725,0,5,7731,T
6-NA,953,1,5,7921,0,7927,G
6-NA,954,0,7895,0,8,7903,T
6-NA,955,1,7880,0,1,7882,T
6-NA,956,13,0,0,7892,7905,C
6-NA,957,7838,1,13,1,7853,A
6-NA,958,0,11,7895,1,7907,G
6-NA,959,0,17,7860,0,7877,G
6-NA,960,7789,1,4,1,7795,A
6-NA,961,2,1,0,7851,7854,C
6-NA,962,0,7661,0,0,7661,T
6-NA,963,0,7683,0,5,7688,T
6-NA,964,0,1,7968,0,7969,G
6-NA,965,0,7947,0,7,7954,T
6-NA,966,0,7955,0,5,7960,T
6-NA,967,2,6,7916,0,7924,G
6-NA,968,2,24,7882,0,7908,G
6-NA,969,7850,1,15,0,7866,A
6-NA,970,1,18,7883,0,7902,G
6-NA,971,7878,1,7,0,7886,A
6-NA,972,0,2,0,7834,7836,C
6-NA,973,7524,0,9,0,7533,A
6-NA,974,2,0,1,7524,7527,C
6-NA,975,7535,0,8,2,7545,A
6-NA,976,2,4,0,7582,7588,C
6-NA,977,15,0,0,7496,7511,C
6-NA,978,22,6,0,7525,7553,C
6-NA,979,7559,0,2,1,7562,A
6-NA,980,1,9,7572,0,7582,G
6-NA,981,7564,0,2,0,7566,A
6-NA,982,7620,0,1,0,7621,A
6-NA,983,7584,0,0,0,7584,A
6-NA,984,7565,0,2,0,7567,A
6-NA,985,7507,0,0,0,7507,A
6-NA,986,7502,0,1,5,7508,A
6-NA,987,0,8,0,7539,7547,C
6-NA,988,3,27,7506,1,7537,G
6-NA,989,7503,0,3,0,7506,A
6-NA,990,0,0,5,7503,7508,C
6-NA,991,7494,1,4,0,7499,A
6-NA,992,1,1,7572,1,7575,G
6-NA,993,6,0,0,7815,7821,C
6-NA,994,0,7745,0,7,7752,T
6-NA,995,47,0,0,7778,7825,C
6-NA,996,9,0,0,7879,7888,C
6-NA,997,7895,0,11,0,7906,A
6-NA,998,1,2,7967,0,7970,G
6-NA,999,1,4,0,7978,7983,C
6-NA,1000,7949,0,2,1,7952,A
6-NA,1001,2,4,7941,0,7947,G
6-NA,1002,1,7583,0,2,7586,T
6-NA,1003,7597,0,6,0,7603,A
6-NA,1004,1,2,7588,0,7591,G
6-NA,1005,1,3,0,7540,7544,C
6-NA,1006,19,5,0,7586,7610,C
6-NA,1007,7528,0,1,0,7529,A
6-NA,1008,0,7518,0,1,7519,T
6-NA,1009,0,7540,0,0,7540,T
6-NA,1010,2,1,7707,0,7710,G
6-NA,1011,0,7651,0,3,7654,T
6-NA,1012,0,7643,0,3,7646,T
6-NA,1013,6,7615,0,1,7622,T
6-NA,1014,1,13,7566,0,7580,G
6-NA,1015,0,10,7641,0,7651,G
6-NA,1016,7595,1,3,0,7599,A
6-NA,1017,0,7593,0,16,7609,T
6-NA,1018,9,1,0,7611,7621,C
6-NA,1019,10,6,1,7463,7480,C
6-NA,1020,5,7510,1,5,7521,T
6-NA,1021,7530,1,3,0,7534,A
6-NA,1022,7553,0,4,0,7557,A
6-NA,1023,2,2,0,7666,7670,C
6-NA,1024,7485,0,0,0,7485,A
6-NA,1025,7585,0,4,0,7589,A
6-NA,1026,0,7587,0,3,7590,T
6-NA,1027,3,14,7652,0,7669,G
6-NA,1028,7605,1,10,0,7616,A
6-NA,1029,7553,3,10,0,7566,A
6-NA,1030,6,5,7617,0,7628,G
6-NA,1031,7558,0,4,0,7562,A
6-NA,1032,7361,0,5,0,7366,A
6-NA,1033,0,9,7428,0,7437,G
6-NA,1034,1,5,7426,0,7432,G
6-NA,1035,0,7249,0,2,7251,T
6-NA,1036,1,13,7290,0,7304,G
6-NA,1037,10,3,7519,0,7532,G
6-NA,1038,0,7461,0,5,7466,T
6-NA,1039,30,2,0,7422,7454,C
6-NA,1040,7453,0,0,0,7453,A
6-NA,1041,1,7472,0,5,7478,T
6-NA,1042,0,15,7484,0,7499,G
6-NA,1043,1,13,7548,0,7562,G
6-NA,1044,7458,1,7,0,7466,A
6-NA,1045,9,1,7733,0,7743,G
6-NA,1046,0,7396,1,2,7399,T
6-NA,1047,1,13,7418,1,7433,G
6-NA,1048,7388,1,3,0,7392,A
6-NA,1049,7397,0,3,0,7400,A
6-NA,1050,7400,0,19,0,7419,A
6-NA,1051,0,10,7445,0,7455,G
6-NA,1052,0,1,7351,0,7352,G
6-NA,1053,2,2,0,7344,7348,C
6-NA,1054,0,7168,0,2,7170,T
6-NA,1055,3,14,7168,0,7185,G
6-NA,1056,2,7,7155,0,7164,G
6-NA,1057,3,3,7234,1,7241,G
6-NA,1058,4,4,1,7208,7217,C
6-NA,1059,4,0,0,7242,7246,C
6-NA,1060,3,7121,3,17,7144,T
6-NA,1061,0,7171,0,4,7175,T
6-NA,1062,0,7201,0,0,7201,T
6-NA,1063,0,2,7224,0,7226,G
6-NA,1064,7203,0,2,0,7205,A
6-NA,1065,1,7151,0,2,7154,T
6-NA,1066,1,9,7069,0,7079,G
6-NA,1067,6999,1,4,0,7004,A
6-NA,1068,1,7025,0,1,7027,T
6-NA,1069,0,5,7032,0,7037,G
6-NA,1070,1,6,7104,0,7111,G
6-NA,1071,7093,0,3,0,7096,A
6-NA,1072,7081,1,5,0,7087,A
6-NA,1073,7071,0,3,1,7075,A
6-NA,1074,1,7046,1,2,7050,T
6-NA,1075,0,13,7071,0,7084,G
6-NA,1076,7042,0,7,1,7050,A
6-NA,1077,0,2,0,7055,7057,C
6-NA,1078,6,1,7131,0,7138,G
6-NA,1079,0,6950,0,3,6953,T
6-NA,1080,0,0,7028,0,7028,G
6-NA,1081,0,6988,2,2,6992,T
6-NA,1082,1,14,6996,0,7011,G
6-NA,1083,5,9,7047,0,7061,G
6-NA,1084,6977,1,7,0,6985,A
6-NA,1085,1,6995,2,0,6998,T
6-NA,1086,2,24,6975,0,7001,G
6-NA,1087,2,22,6956,1,6981,G
6-NA,1088,0,10,6991,0,7001,G
6-NA,1089,6922,0,6,0,6928,A
6-NA,1090,6921,0,5,0,6926,A
6-NA,1091,2,6,6919,1,6928,G
6-NA,1092,6820,0,5,0,6825,A
6-NA,1093,6829,0,2,0,6831,A
6-NA,1094,3,1,1,6776,6781,C
6-NA,1095,2,17,6737,1,6757,G
6-NA,1096,6744,0,3,0,6747,A
6-NA,1097,0,6633,1,1,6635,T
6-NA,1098,16,0,0,6672,6688,C
6-NA,1099,6663,0,4,0,6667,A
6-NA,1100,2,2,6679,0,6683,G
6-NA,1101,2,4,0,6652,6658,C
6-NA,1102,3,15,6656,0,6674,G
6-NA,1103,6618,0,3,1,6622,A
6-NA,1104,0,4,6662,0,6666,G
6-NA,1105,6632,0,2,1,6635,A
6-NA,1106,6645,1,1,0,6647,A
6-NA,1107,0,1,6701,0,6702,G
6-NA,1108,0,6607,1,3,6611,T
6-NA,1109,18,1,0,6575,6594,C
6-NA,1110,6558,0,5,1,6564,A
6-NA,1111,2,1,0,6765,6768,C
6-NA,1112,2,3,6766,0,6771,G
6-NA,1113,1,0,0,6766,6767,C
6-NA,1114,0,6734,0,1,6735,T
6-NA,1115,0,6768,0,0,6768,T
6-NA,1116,6648,0,5,0,6653,A
6-NA,1117,3,13,6817,1,6834,G
6-NA,1118,0,16,6802,0,6818,G
6-NA,1119,2,4,6948,0,6954,G
6-NA,1120,1,6496,1,2,6500,T
6-NA,1121,6556,0,1,0,6557,A
6-NA,1122,1,6517,0,1,6519,T
6-NA,1123,2,14,6510,1,6527,G
6-NA,1124,6519,0,4,0,6523,A
6-NA,1125,6501,0,1,2,6504,A
6-NA,1126,6133,1,4,0,6138,A
6-NA,1127,2,1,0,6158,6161,C
6-NA,1128,4,1,0,5979,5984,C
6-NA,1129,1,5815,1,6,5823,T
6-NA,1130,2,5837,0,4,5843,T
6-NA,1131,12,1,1,5825,5839,C
6-NA,1132,5862,2,2,0,5866,A
6-NA,1133,5858,0,0,0,5858,A
6-NA,1134,5853,1,3,0,5857,A
6-NA,1135,1,2,5889,0,5892,G
6-NA,1136,1,5756,0,3,5760,T
6-NA,1137,19,3,0,5794,5816,C
6-NA,1138,5956,1,0,0,5957,A
6-NA,1139,0,5955,0,4,5959,T
6-NA,1140,1,5961,0,0,5962,T
6-NA,1141,0,7,5961,0,5968,G
6-NA,1142,5932,0,2,0,5934,A
6-NA,1143,5951,0,2,3,5956,A
6-NA,1144,1,9,6027,0,6037,G
6-NA,1145,0,0,6012,0,6012,G
6-NA,1146,2,2,0,6004,6008,C
6-NA,1147,1,5832,0,4,5837,T
6-NA,1148,1,4,5873,0,5878,G
6-NA,1149,0,2,6010,0,6012,G
6-NA,1150,2,5977,1,7,5987,T
6-NA,1151,18,7,1,5944,5970,C
6-NA,1152,11,1,0,5938,5950,C
6-NA,1153,5950,0,5,0,5955,A
6-NA,1154,5949,0,5,1,5955,A
6-NA,1155,1,2,0,5997,6000,C
6-NA,1156,12,9,0,5949,5970,C
6-NA,1157,21,1,0,5959,5981,C
6-NA,1158,0,5741,0,0,5741,T
6-NA,1159,5750,0,0,0,5750,A
6-NA,1160,5740,0,2,0,5742,A
6-NA,1161,1,1,5792,0,5794,G
6-NA,1162,2,5709,0,4,5715,T
6-NA,1163,11,2,0,5696,5709,C
6-NA,1164,21,1,0,5601,5623,C
6-NA,1165,5641,0,1,0,5642,A
6-NA,1166,5626,0,1,0,5627,A
6-NA,1167,5643,0,0,0,5643,A
6-NA,1168,0,5621,0,0,5621,T
6-NA,1169,0,5617,0,1,5618,T
6-NA,1170,0,2,5597,0,5599,G
6-NA,1171,2,0,0,5575,5577,C
6-NA,1172,5583,0,3,0,5586,A
6-NA,1173,0,7,5588,0,5595,G
6-NA,1174,5585,0,0,0,5585,A
6-NA,1175,0,5688,0,10,5698,T
6-NA,1176,5704,0,1,0,5705,A
6-NA,1177,5693,0,1,0,5694,A
6-NA,1178,5694,0,4,0,5698,A
6-NA,1179,0,5665,0,0,5665,T
6-NA,1180,5631,0,3,0,5634,A
6-NA,1181,0,14,5616,0,5630,G
6-NA,1182,4,3,5555,0,5562,G
6-NA,1183,3,2,0,5562,5567,C
6-NA,1184,5402,0,4,0,5406,A
6-NA,1185,5439,1,3,0,5443,A
6-NA,1186,1,1,5494,1,5497,G
6-NA,1187,0,5471,0,3,5474,T
6-NA,1188,25,1,0,5454,5480,C
6-NA,1189,5503,0,3,0,5506,A
6-NA,1190,0,5495,0,0,5495,T
6-NA,1191,5515,0,4,0,5519,A
6-NA,1192,2,1,5534,1,5538,G
6-NA,1193,0,5530,0,0,5530,T
6-NA,1194,1,5338,0,3,5342,T
6-NA,1195,1,7,5266,0,5274,G
6-NA,1196,5224,1,5,0,5230,A
6-NA,1197,2,1,0,5209,5212,C
6-NA,1198,5141,0,4,0,5145,A
6-NA,1199,0,12,5184,0,5196,G
6-NA,1200,5124,0,10,0,5134,A
6-NA,1201,2,6,5289,1,5298,G
6-NA,1202,8,4,5294,0,5306,G
6-NA,1203,0,5263,0,4,5267,T
6-NA,1204,5281,1,3,0,5285,A
6-NA,1205,5281,0,3,0,5284,A
6-NA,1206,0,5251,0,0,5251,T
6-NA,1207,5256,0,1,0,5257,A
6-NA,1208,1,4,5130,0,5135,G
6-NA,1209,0,2,5011,0,5013,G
6-NA,1210,0,4568,0,5,4573,T
6-NA,1211,9,1,0,4531,4541,C
6-NA,1212,12,3,0,4501,4516,C
6-NA,1213,4,6,4524,0,4534,G
6-NA,1214,1,3,4533,0,4537,G
6-NA,1215,1,4531,0,2,4534,T
6-NA,1216,0,4524,0,0,4524,T
6-NA,1217,4472,0,1,0,4473,A
6-NA,1218,0,4384,0,0,4384,T
6-NA,1219,0,4397,0,2,4399,T
6-NA,1220,5,0,0,4392,4397,C
6-NA,1221,0,4245,2,4,4251,T
6-NA,1222,1,10,4227,1,4239,G
6-NA,1223,0,3,4255,0,4258,G
6-NA,1224,0,4238,0,3,4241,T
6-NA,1225,4256,0,0,0,4256,A
6-NA,1226,0,4168,0,2,4170,T
6-NA,1227,0,4187,0,5,4192,T
6-NA,1228,0,4192,0,3,4195,T
6-NA,1229,0,4206,0,5,4211,T
6-NA,1230,5,2,0,4204,4211,C
6-NA,1231,0,4139,2,6,4147,T
6-NA,1232,7,0,2,4187,4196,C
6-NA,1233,0,4171,0,3,4174,T
6-NA,1234,0,2,4263,0,4265,G
6-NA,1235,0,4263,0,1,4264,T
6-NA,1236,0,4224,0,0,4224,T
6-NA,1237,3,2,4225,0,4230,G
6-NA,1238,4172,0,2,1,4175,A
6-NA,1239,4171,0,10,0,4181,A
6-NA,1240,0,8,4197,0,4205,G
6-NA,1241,2,1,4175,0,4178,G
6-NA,1242,2,0,1,4176,4179,C
6-NA,1243,4122,0,2,0,4124,A
6-NA,1244,4117,0,3,0,4120,A
6-NA,1245,4129,0,2,1,4132,A
6-NA,1246,4135,0,9,0,4144,A
6-NA,1247,1,2,4129,0,4132,G
6-NA,1248,1,0,0,4125,4126,C
6-NA,1249,0,4057,1,0,4058,T
6-NA,1250,0,0,4130,0,4130,G
6-NA,1251,0,0,0,4121,4121,C
6-NA,1252,4131,0,5,0,4136,A
6-NA,1253,1,4106,0,4,4111,T
6-NA,1254,8,0,0,4079,4087,C
6-NA,1255,4092,0,0,0,4092,A
6-NA,1256,4090,0,3,0,4093,A
6-NA,1257,0,4065,0,1,4066,T
6-NA,1258,11,5,0,4069,4085,C
6-NA,1259,2,5,4030,0,4037,G
6-NA,1260,0,1,4104,0,4105,G
6-NA,1261,0,4096,0,1,4097,T
6-NA,1262,1,2,4100,0,4103,G
6-NA,1263,0,4,0,4120,4124,C
6-NA,1264,1,4099,0,11,4111,T
6-NA,1265,0,4156,0,3,4159,T
6-NA,1266,0,4159,0,1,4160,T
6-NA,1267,0,4173,0,0,4173,T
6-NA,1268,4206,0,1,0,4207,A
6-NA,1269,1,4041,0,0,4042,T
6-NA,1270,1,2,4044,0,4047,G
6-NA,1271,0,3993,0,3,3996,T
6-NA,1272,2,10,3944,0,3956,G
6-NA,1273,0,8,4028,0,4036,G
6-NA,1274,3927,0,1,0,3928,A
6-NA,1275,1,1,3983,0,3985,G
6-NA,1276,1,3956,0,2,3959,T
6-NA,1277,0,3919,0,5,3924,T
6-NA,1278,0,8,3948,0,3956,G
6-NA,1279,3938,0,5,0,3943,A
6-NA,1280,0,3934,0,7,3941,T
6-NA,1281,3924,0,1,0,3925,A
6-NA,1282,3779,0,4,0,3783,A
6-NA,1283,0,12,3797,0,3809,G
6-NA,1284,0,9,3750,0,3759,G
6-NA,1285,1,1,3725,0,3727,G
6-NA,1286,2,5,3713,0,3720,G
6-NA,1287,3672,0,0,0,3672,A
6-NA,1288,3652,2,5,0,3659,A
6-NA,1289,3,6,3675,0,3684,G
6-NA,1290,3677,0,0,0,3677,A
6-NA,1291,3682,0,0,0,3682,A
6-NA,1292,3638,0,0,0,3638,A
6-NA,1293,3571,0,2,0,3573,A
6-NA,1294,0,4,3567,0,3571,G
6-NA,1295,3512,0,7,0,3519,A
6-NA,1296,1,4,3507,0,3512,G
6-NA,1297,1,6,3518,0,3525,G
6-NA,1298,3469,0,1,1,3471,A
6-NA,1299,3472,0,4,1,3477,A
6-NA,1300,3440,1,5,0,3446,A
6-NA,1301,0,0,0,3495,3495,C
6-NA,1302,0,3472,0,1,3473,T
6-NA,1303,1,5,3497,0,3503,G
6-NA,1304,3486,0,4,0,3490,A
6-NA,1305,3470,0,3,1,3474,A
6-NA,1306,0,1,3475,0,3476,G
6-NA,1307,0,3427,0,3,3430,T
6-NA,1308,7,1,0,3473,3481,C
6-NA,1309,0,3467,0,5,3472,T
6-NA,1310,1,3431,0,2,3434,T
6-NA,1311,7,0,3438,0,3445,G
6-NA,1312,0,3414,0,4,3418,T
6-NA,1313,3,10,3405,0,3418,G
6-NA,1314,0,8,3388,0,3396,G
6-NA,1315,3348,0,3,0,3351,A
6-NA,1316,1,0,0,3339,3340,C
6-NA,1317,5,1,0,3294,3300,C
6-NA,1318,0,3295,1,5,3301,T
6-NA,1319,6,2,0,3308,3316,C
6-NA,1320,3334,0,5,0,3339,A
6-NA,1321,3327,0,0,0,3327,A
6-NA,1322,3330,0,1,0,3331,A
6-NA,1323,3,2,0,3379,3384,C
6-NA,1324,3294,0,0,0,3294,A
6-NA,1325,0,0,3335,0,3335,G
6-NA,1326,0,3283,0,3,3286,T
6-NA,1327,3294,1,0,0,3295,A
6-NA,1328,0,3287,0,1,3288,T
6-NA,1329,0,3204,0,1,3205,T
6-NA,1330,0,0,3239,1,3240,G
6-NA,1331,0,3219,0,3,3222,T
6-NA,1332,0,3095,0,4,3099,T
6-NA,1333,0,0,3110,0,3110,G
6-NA,1334,0,2921,0,2,2923,T
6-NA,1335,3,0,2941,0,2944,G
6-NA,1336,0,2918,0,1,2919,T
6-NA,1337,0,2874,0,1,2875,T
6-NA,1338,0,2883,0,1,2884,T
6-NA,1339,0,2791,0,3,2794,T
6-NA,1340,1,1,2803,0,2805,G
6-NA,1341,0,2798,1,2,2801,T
6-NA,1342,0,4,2786,0,2790,G
6-NA,1343,0,0,2774,0,2774,G
6-NA,1344,6,1,0,2712,2719,C
6-NA,1345,2701,0,0,0,2701,A
6-NA,1346,1,1,0,2740,2742,C
6-NA,1347,4,0,0,2735,2739,C
6-NA,1348,0,2730,0,0,2730,T
6-NA,1349,5,0,0,2750,2755,C
6-NA,1350,2752,0,2,0,2754,A
6-NA,1351,1,4,2763,1,2769,G
6-NA,1352,0,0,2767,0,2767,G
6-NA,1353,0,2740,0,1,2741,T
6-NA,1354,2730,0,0,0,2730,A
6-NA,1355,1,0,0,2593,2594,C
6-NA,1356,2587,0,0,0,2587,A
6-NA,1357,0,2584,0,0,2584,T
6-NA,1358,2499,0,3,0,2502,A
6-NA,1359,1,2490,0,0,2491,T
6-NA,1360,3,4,2365,0,2372,G
6-NA,1361,0,2,2362,0,2364,G
6-NA,1362,2346,0,2,0,2348,A
6-NA,1363,2326,0,1,0,2327,A
6-NA,1364,1,0,0,2294,2295,C
6-NA,1365,1901,0,0,0,1901,A
6-NA,1366,0,1,1904,0,1905,G
6-NA,1367,0,0,1879,0,1879,G
6-NA,1368,1,0,0,1866,1867,C
6-NA,1369,0,1884,0,2,1886,T
6-NA,1370,1,0,0,1754,1755,C
6-NA,1371,1751,0,2,0,1753,A
6-NA,1372,0,1755,0,1,1756,T
6-NA,1373,0,0,1757,0,1757,G
6-NA,1374,0,0,1756,0,1756,G
6-NA,1375,0,0,0,1696,1696,C
6-NA,1376,2,0,0,1690,1692,C
6-NA,1377,0,1603,0,3,1606,T
6-NA,1378,1,0,1610,0,1611,G
6-NA,1379,1603,0,3,0,1606,A
6-NA,1380,0,1604,0,0,1604,T
6-NA,1381,0,5,1578,0,1583,G
6-NA,1382,1,4,1538,0,1543,G
6-NA,1383,0,2,1464,0,1466,G
6-NA,1384,0,0,1470,0,1470,G
6-NA,1385,2,2,0,1405,1409,C
6-NA,1386,2,0,1411,0,1413,G
6-NA,1387,1,1,1410,0,1412,G
6-NA,1388,1390,0,2,0,1392,A
6-NA,1389,0,10,0,1369,1379,C
6-NA,1390,1390,0,0,0,1390,A
6-NA,1391,0,1350,0,2,1352,T
6-NA,1392,1,1,0,1332,1334,C
6-NA,1393,1320,0,0,0,1320,A
6-NA,1394,1317,0,1,0,1318,A
6-NA,1395,0,1308,0,0,1308,T
6-NA,1396,1,0,0,1267,1268,C
6-NA,1397,0,1234,0,1,1235,T
6-NA,1398,0,0,0,1092,1092,C
6-NA,1399,1092,0,1,0,1093,A
6-NA,1400,0,1082,0,0,1082,T
6-NA,1401,0,1,1081,0,1082,G
6-NA,1402,0,1,0,1061,1062,C
6-NA,1403,5,2,0,1029,1036,C
6-NA,1404,0,929,0,3,932,T
6-NA,1405,918,0,0,0,918,A
6-NA,1406,0,918,0,0,918,T
6-NA,1407,898,0,0,0,898,A
6-NA,1408,0,898,0,0,898,T
6-NA,1409,830,0,0,0,830,A
6-NA,1410,796,0,0,0,796,A
7-M,1,240,0,0,0,240,A
7-M,2,0,246,0,0,246,T
7-M,3,0,0,240,0,240,G
7-M,4,248,0,0,0,248,A
7-M,5,0,0,273,0,273,G
7-M,6,0,1,0,293,294,C
7-M,7,0,0,0,310,310,C
7-M,8,0,394,0,0,394,T
7-M,9,0,394,0,0,394,T
7-M,10,0,0,0,400,400,C
7-M,11,0,403,0,0,403,T
7-M,12,410,0,2,0,412,A
7-M,13,409,0,1,0,410,A
7-M,14,0,0,0,410,410,C
7-M,15,0,0,0,413,413,C
7-M,16,0,1,411,0,412,G
7-M,17,407,0,0,0,407,A
7-M,18,0,0,424,0,424,G
7-M,19,0,0,433,0,433,G
7-M,20,0,431,0,0,431,T
7-M,21,2,1,0,441,444,C
7-M,22,2,2,441,0,445,G
7-M,23,460,0,0,0,460,A
7-M,24,465,0,0,1,466,A
7-M,25,466,0,1,1,468,A
7-M,26,0,0,0,504,504,C
7-M,27,0,1,513,0,514,G
7-M,28,0,515,0,0,515,T
7-M,29,522,0,0,0,522,A
7-M,30,0,523,0,0,523,T
7-M,31,0,1,536,0,537,G
7-M,32,0,540,0,0,540,T
7-M,33,0,606,0,0,606,T
7-M,34,0,0,0,632,632,C
7-M,35,0,632,0,0,632,T
7-M,36,0,0,0,674,674,C
7-M,37,0,671,0,0,671,T
7-M,38,3,0,0,699,702,C
7-M,39,0,705,0,0,705,T
7-M,40,707,0,0,0,707,A
7-M,41,0,712,0,0,712,T
7-M,42,1,1,0,720,722,C
7-M,43,1,1,726,0,728,G
7-M,44,0,736,0,1,737,T
7-M,45,0,736,0,0,736,T
7-M,46,3,0,0,755,758,C
7-M,47,0,0,0,784,784,C
7-M,48,789,0,1,0,790,A
7-M,49,0,788,0,1,789,T
7-M,50,0,0,0,796,796,C
7-M,51,792,0,1,0,793,A
7-M,52,0,1,797,0,798,G
7-M,53,0,0,795,0,795,G
7-M,54,0,0,0,797,797,C
7-M,55,0,0,0,804,804,C
7-M,56,1,0,0,809,810,C
7-M,57,1,0,0,825,826,C
7-M,58,5,0,0,836,841,C
7-M,59,0,835,0,1,836,T
7-M,60,1,0,0,844,845,C
7-M,61,842,0,0,0,842,A
7-M,62,839,0,0,0,839,A
7-M,63,863,0,0,0,863,A
7-M,64,0,2,874,0,876,G
7-M,65,0,0,0,883,883,C
7-M,66,3,0,0,875,878,C
7-M,67,1,2,873,0,876,G
7-M,68,865,0,3,0,868,A
7-M,69,0,1,881,0,882,G
7-M,70,880,0,0,0,880,A
7-M,71,0,885,0,0,885,T
7-M,72,4,0,0,876,880,C
7-M,73,1,1,886,0,888,G
7-M,74,0,1,0,892,893,C
7-M,75,0,0,895,1,896,G
7-M,76,1,0,0,898,899,C
7-M,77,896,0,0,0,896,A
7-M,78,0,1,902,0,903,G
7-M,79,890,0,1,0,891,A
7-M,80,0,5,952,0,957,G
7-M,81,960,1,0,0,961,A
7-M,82,0,0,0,977,977,C
7-M,83,0,978,0,0,978,T
7-M,84,0,981,0,0,981,T
7-M,85,0,1,985,0,986,G
7-M,86,981,0,0,0,981,A
7-M,87,990,0,1,0,991,A
7-M,88,0,0,994,0,994,G
7-M,89,983,0,0,0,983,A
7-M,90,0,999,0,0,999,T
7-M,91,2,0,1005,0,1007,G
7-M,92,0,1004,0,0,1004,T
7-M,93,82,0,0,924,1006,C
7-M,94,0,1005,0,2,1007,T
7-M,95,0,1009,0,0,1009,T
7-M,96,0,1010,0,0,1010,T
7-M,97,0,0,1007,0,1007,G
7-M,98,0,0,0,1005,1005,C
7-M,99,0,997,0,0,997,T
7-M,100,1,5,988,0,994,G
7-M,101,0,2,983,0,985,G
7-M,102,0,1,1008,0,1009,G
7-M,103,996,0,1,0,997,A
7-M,104,1005,0,0,0,1005,A
7-M,105,1009,0,0,0,1009,A
7-M,106,1006,0,2,0,1008,A
7-M,107,1024,0,4,0,1028,A
7-M,108,0,1,0,1035,1036,C
7-M,109,1036,0,0,0,1036,A
7-M,110,0,0,0,1041,1041,C
7-M,111,1029,0,0,0,1029,A
7-M,112,0,1,1046,0,1047,G
7-M,113,1038,0,0,0,1038,A
7-M,114,0,1074,0,0,1074,T
7-M,115,1,0,0,1085,1086,C
7-M,116,0,1076,0,2,1078,T
7-M,117,0,1069,0,0,1069,T
7-M,118,0,1,1079,0,1080,G
7-M,119,1076,1,2,0,1079,A
7-M,120,0,2,1064,0,1066,G
7-M,121,0,0,1070,0,1070,G
7-M,122,0,0,0,1074,1074,C
7-M,123,0,1062,0,3,1065,T
7-M,124,1,0,0,1180,1181,C
7-M,125,0,1179,0,2,1181,T
7-M,126,4,0,0,1181,1185,C
7-M,127,1187,0,0,0,1187,A
7-M,128,0,1187,0,0,1187,T
7-M,129,0,1,1186,0,1187,G
7-M,130,0,1,1190,0,1191,G
7-M,131,1177,0,0,0,1177,A
7-M,132,1165,0,1,0,1166,A
7-M,133,0,1123,0,0,1123,T
7-M,134,0,4,1180,0,1184,G
7-M,135,0,0,1216,0,1216,G
7-M,136,0,0,0,1219,1219,C
7-M,137,0,1228,0,1,1229,T
7-M,138,1229,0,1,0,1230,A
7-M,139,1220,0,0,0,1220,A
7-M,140,1230,0,2,0,1232,A
7-M,141,0,3,1241,0,1244,G
7-M,142,1239,0,1,0,1240,A
7-M,143,0,0,0,1246,1246,C
7-M,144,1199,0,0,0,1199,A
7-M,145,1189,0,2,1,1192,A
7-M,146,0,3,1216,0,1219,G
7-M,147,1219,1,2,0,1222,A
7-M,148,1,0,0,1226,1227,C
7-M,149,2,1,1,1212,1216,C
7-M,150,1221,0,0,0,1221,A
7-M,151,1234,0,1,0,1235,A
7-M,152,0,1240,0,1,1241,T
7-M,153,1,1239,0,0,1240,T
7-M,154,2,0,0,1262,1264,C
7-M,155,0,1254,0,0,1254,T
7-M,156,1,0,1271,0,1272,G
7-M,157,0,1260,0,1,1261,T
7-M,158,2,1,0,1266,1269,C
7-M,159,1264,0,1,0,1265,A
7-M,160,2,0,0,1314,1316,C
7-M,161,3,1,0,1323,1327,C
7-M,162,0,1307,0,0,1307,T
7-M,163,2,0,0,1321,1323,C
7-M,164,0,1314,0,1,1315,T
7-M,165,1,3,1347,0,1351,G
7-M,166,1353,0,0,0,1353,A
7-M,167,0,0,0,1363,1363,C
7-M,168,0,1364,0,0,1364,T
7-M,169,1336,0,0,0,1336,A
7-M,170,1322,0,1,0,1323,A
7-M,171,0,8,1323,0,1331,G
7-M,172,0,3,1319,0,1322,G
7-M,173,0,2,1326,0,1328,G
7-M,174,0,3,1316,0,1319,G
7-M,175,1324,0,0,0,1324,A
7-M,176,0,1345,1,0,1346,T
7-M,177,0,1348,0,0,1348,T
7-M,178,0,1351,0,0,1351,T
7-M,179,0,1349,0,0,1349,T
7-M,180,0,2,1343,0,1345,G
7-M,181,1,5,1335,0,1341,G
7-M,182,1,2,1341,0,1344,G
7-M,183,2,0,1347,0,1349,G
7-M,184,0,1319,0,1,1320,T
7-M,185,0,1335,0,1,1336,T
7-M,186,0,1338,0,0,1338,T
7-M,187,0,0,1372,0,1372,G
7-M,188,0,1358,0,0,1358,T
7-M,189,0,1,1379,1,1381,G
7-M,190,0,1381,0,0,1381,T
7-M,191,0,1380,0,0,1380,T
7-M,192,3,0,0,1395,1398,C
7-M,193,1405,0,1,0,1406,A
7-M,194,0,0,0,1444,1444,C
7-M,195,0,0,1426,0,1426,G
7-M,196,2,0,0,1432,1434,C
7-M,197,0,1408,0,3,1411,T
7-M,198,3,0,0,1454,1457,C
7-M,199,1452,0,0,0,1452,A
7-M,200,0,1,0,1471,1472,C
7-M,201,2,2,0,1460,1464,C
7-M,202,1,0,1470,1,1472,G
7-M,203,0,1477,2,0,1479,T
7-M,204,1,0,1480,0,1481,G
7-M,205,0,0,0,1477,1477,C
7-M,206,5,0,0,1474,1479,C
7-M,207,2,0,1,1487,1490,C
7-M,208,1474,0,2,0,1476,A
7-M,209,0,1,1481,0,1482,G
7-M,210,0,1473,0,0,1473,T
7-M,211,0,8,1474,0,1482,G
7-M,212,1492,0,2,0,1494,A
7-M,213,0,0,1495,1,1496,G
7-M,214,0,0,0,1491,1491,C
7-M,215,0,1,1497,0,1498,G
7-M,216,1482,0,0,0,1482,A
7-M,217,0,5,1499,0,1504,G
7-M,218,0,3,1502,0,1505,G
7-M,219,1498,0,0,0,1498,A
7-M,220,0,2,0,1516,1518,C
7-M,221,0,1503,0,1,1504,T
7-M,222,0,2,1505,0,1507,G
7-M,223,0,0,0,1510,1510,C
7-M,224,1507,0,2,1,1510,A
7-M,225,1,0,1546,0,1547,G
7-M,226,0,1,0,1534,1535,C
7-M,227,0,0,1551,0,1551,G
7-M,228,0,1552,0,2,1554,T
7-M,229,1542,0,0,0,1542,A
7-M,230,0,1,1545,0,1546,G
7-M,231,1535,0,0,0,1535,A
7-M,232,0,0,0,1543,1543,C
7-M,233,0,1,1537,0,1538,G
7-M,234,1,0,0,1523,1524,C
7-M,235,1,1497,0,1,1499,T
7-M,236,0,1489,0,0,1489,T
7-M,237,0,1481,0,1,1482,T
7-M,238,1,1,1526,0,1528,G
7-M,239,0,1518,0,1,1519,T
7-M,240,2,1,0,1518,1521,C
7-M,241,6,0,0,1518,1524,C
7-M,242,1528,0,0,0,1528,A
7-M,243,1526,0,0,0,1526,A
7-M,244,1529,0,0,0,1529,A
7-M,245,1520,0,2,0,1522,A
7-M,246,0,1519,0,1,1520,T
7-M,247,0,1,1496,0,1497,G
7-M,248,0,1,0,1488,1489,C
7-M,249,4,0,0,1480,1484,C
7-M,250,3,3,0,1495,1501,C
7-M,251,0,1504,0,0,1504,T
7-M,252,1,1,0,1546,1548,C
7-M,253,1562,0,0,0,1562,A
7-M,254,1559,0,1,0,1560,A
7-M,255,0,1564,0,1,1565,T
7-M,256,0,5,1572,0,1577,G
7-M,257,0,0,1577,1,1578,G
7-M,258,1,2,1589,0,1592,G
7-M,259,1583,0,2,0,1585,A
7-M,260,1589,0,0,0,1589,A
7-M,261,0,1537,0,0,1537,T
7-M,262,1,1,1539,0,1541,G
7-M,263,0,3,1534,0,1537,G
7-M,264,1521,0,2,0,1523,A
7-M,265,0,6,1507,0,1513,G
7-M,266,1491,0,1,0,1492,A
7-M,267,1,4,0,1472,1477,C
7-M,268,3,1,0,1540,1544,C
7-M,269,3,0,0,1560,1563,C
7-M,270,1580,0,0,0,1580,A
7-M,271,1583,0,0,0,1583,A
7-M,272,1578,0,2,0,1580,A
7-M,273,0,1589,0,0,1589,T
7-M,274,1615,0,1,0,1616,A
7-M,275,1619,0,0,0,1619,A
7-M,276,0,0,0,1597,1597,C
7-M,277,1587,0,1,0,1588,A
7-M,278,0,1582,0,1,1583,T
7-M,279,0,3,1606,0,1609,G
7-M,280,0,2,1605,0,1607,G
7-M,281,1600,0,2,0,1602,A
7-M,282,0,1,0,1612,1613,C
7-M,283,1578,0,0,0,1578,A
7-M,284,1578,0,0,0,1578,A
7-M,285,1570,0,1,0,1571,A
7-M,286,1,0,1586,0,1587,G
7-M,287,0,2,0,1604,1606,C
7-M,288,1585,0,0,0,1585,A
7-M,289,0,0,1602,0,1602,G
7-M,290,0,1598,0,2,1600,T
7-M,291,0,1598,0,0,1598,T
7-M,292,1613,0,0,0,1613,A
7-M,293,1604,0,2,0,1606,A
7-M,294,1613,0,1,0,1614,A
7-M,295,2,0,0,1622,1624,C
7-M,296,0,1594,0,0,1594,T
7-M,297,0,0,1765,0,1765,G
7-M,298,0,1738,0,1,1739,T
7-M,299,1751,0,0,0,1751,A
7-M,300,0,1755,0,0,1755,T
7-M,301,1733,0,1,0,1734,A
7-M,302,0,1,1734,0,1735,G
7-M,303,0,5,1712,0,1717,G
7-M,304,1722,0,0,0,1722,A
7-M,305,1723,0,1,0,1724,A
7-M,306,1639,0,0,0,1639,A
7-M,307,0,0,0,1684,1684,C
7-M,308,0,1678,0,0,1678,T
7-M,309,1,1681,0,1,1683,T
7-M,310,1679,0,1,0,1680,A
7-M,311,1673,0,0,0,1673,A
7-M,312,0,3,1670,0,1673,G
7-M,313,1661,0,2,0,1663,A
7-M,314,0,4,1673,0,1677,G
7-M,315,0,3,1670,0,1673,G
7-M,316,0,3,1673,0,1676,G
7-M,317,1668,0,0,0,1668,A
7-M,318,0,2,1673,0,1675,G
7-M,319,1675,0,1,0,1676,A
7-M,320,0,1680,0,2,1682,T
7-M,321,1691,0,0,0,1691,A
7-M,322,1689,0,0,0,1689,A
7-M,323,0,0,0,1703,1703,C
7-M,324,1,0,1698,0,1699,G
7-M,325,0,1699,0,2,1701,T
7-M,326,0,1680,0,1,1681,T
7-M,327,3,0,0,1688,1691,C
7-M,328,3,2,0,1685,1690,C
7-M,329,1696,0,1,0,1697,A
7-M,330,0,1699,0,0,1699,T
7-M,331,0,5,1674,0,1679,G
7-M,332,0,3,1674,0,1677,G
7-M,333,0,3,1674,0,1677,G
7-M,334,0,0,1674,0,1674,G
7-M,335,1,2,0,1648,1651,C
7-M,336,1,0,0,1677,1678,C
7-M,337,1689,1,0,0,1690,A
7-M,338,1701,0,1,0,1702,A
7-M,339,1704,0,0,0,1704,A
7-M,340,0,3,1710,0,1713,G
7-M,341,1721,0,0,0,1721,A
7-M,342,1711,0,2,0,1713,A
7-M,343,1705,0,1,0,1706,A
7-M,344,0,1705,0,1,1706,T
7-M,345,1704,0,1,0,1705,A
7-M,346,0,0,1701,0,1701,G
7-M,347,1,0,0,1688,1689,C
7-M,348,0,1663,0,3,1666,T
7-M,349,3,0,0,1667,1670,C
7-M,350,1,1654,0,1,1656,T
7-M,351,2,2,0,1723,1727,C
7-M,352,1728,0,1,0,1729,A
7-M,353,0,0,1732,0,1732,G
7-M,354,0,1705,0,0,1705,T
7-M,355,0,1741,0,0,1741,T
7-M,356,1746,0,0,0,1746,A
7-M,357,0,1733,0,0,1733,T
7-M,358,0,1725,0,0,1725,T
7-M,359,2,0,0,1747,1749,C
7-M,360,0,1644,1,0,1645,T
7-M,361,0,0,1669,0,1669,G
7-M,362,0,0,0,1660,1660,C
7-M,363,0,1664,0,1,1665,T
7-M,364,0,4,1658,0,1662,G
7-M,365,1,2,1644,0,1647,G
7-M,366,0,1650,0,1,1651,T
7-M,367,1,2,1650,0,1653,G
7-M,368,1,0,0,1643,1644,C
7-M,369,1647,1,0,0,1648,A
7-M,370,0,0,1,1655,1656,C
7-M,371,1,1632,0,0,1633,T
7-M,372,0,1655,0,1,1656,T
7-M,373,1,0,1661,0,1662,G
7-M,374,0,1,0,1640,1641,C
7-M,375,2,1,0,1642,1645,C
7-M,376,1644,0,0,0,1644,A
7-M,377,0,2,1650,0,1652,G
7-M,378,0,1647,0,1,1648,T
7-M,379,0,1643,0,2,1645,T
7-M,380,0,0,1658,0,1658,G
7-M,381,1,1,0,1620,1622,C
7-M,382,1620,1,4,0,1625,A
7-M,383,0,1627,0,1,1628,T
7-M,384,0,1,1624,0,1625,G
7-M,385,0,2,1650,0,1652,G
7-M,386,0,0,1653,0,1653,G
7-M,387,1,0,0,1632,1633,C
7-M,388,0,1,0,1687,1688,C
7-M,389,0,1698,0,1,1699,T
7-M,390,3,1,0,1713,1717,C
7-M,391,1806,0,1,0,1807,A
7-M,392,0,1806,0,0,1806,T
7-M,393,1862,0,0,0,1862,A
7-M,394,0,1844,0,1,1845,T
7-M,395,1801,0,2,0,1803,A
7-M,396,1,1,0,1875,1877,C
7-M,397,1815,0,0,0,1815,A
7-M,398,1826,0,1,0,1827,A
7-M,399,0,1812,0,1,1813,T
7-M,400,1740,0,0,0,1740,A
7-M,401,1,2,1750,1,1754,G
7-M,402,0,1,1721,0,1722,G
7-M,403,1694,0,0,0,1694,A
7-M,404,0,1719,0,1,1720,T
7-M,405,0,4,1612,0,1616,G
7-M,406,0,4,1610,0,1614,G
7-M,407,0,5,1601,0,1606,G
7-M,408,0,1,1618,0,1619,G
7-M,409,1,0,1644,0,1645,G
7-M,410,1,0,0,1623,1624,C
7-M,411,0,1579,0,5,1584,T
7-M,412,2,0,1599,0,1601,G
7-M,413,0,1604,0,0,1604,T
7-M,414,1611,0,0,0,1611,A
7-M,415,1604,0,0,0,1604,A
7-M,416,3,0,0,1607,1610,C
7-M,417,5,0,0,1585,1590,C
7-M,418,1573,0,0,0,1573,A
7-M,419,0,0,0,1578,1578,C
7-M,420,0,1572,0,0,1572,T
7-M,421,1,4,1578,0,1583,G
7-M,422,1568,0,0,0,1568,A
7-M,423,1563,0,1,0,1564,A
7-M,424,0,1,1572,0,1573,G
7-M,425,0,1541,0,0,1541,T
7-M,426,0,5,1543,0,1548,G
7-M,427,1,2,1549,0,1552,G
7-M,428,0,0,1,1559,1560,C
7-M,429,1564,0,0,0,1564,A
7-M,430,0,1550,0,0,1550,T
7-M,431,0,1549,0,2,1551,T
7-M,432,0,1549,0,0,1549,T
7-M,433,0,1,1590,0,1591,G
7-M,434,1,0,1581,0,1582,G
7-M,435,1,1,0,1569,1571,C
7-M,436,6,0,0,1576,1582,C
7-M,437,0,1584,0,3,1587,T
7-M,438,1,2,1654,0,1657,G
7-M,439,0,0,1661,0,1661,G
7-M,440,0,1665,0,0,1665,T
7-M,441,1677,0,3,0,1680,A
7-M,442,0,1609,0,0,1609,T
7-M,443,0,0,1649,0,1649,G
7-M,444,0,1650,0,2,1652,T
7-M,445,0,0,1655,0,1655,G
7-M,446,0,2,0,1659,1661,C
7-M,447,1586,0,0,0,1586,A
7-M,448,1581,0,0,0,1581,A
7-M,449,1,1,0,1599,1601,C
7-M,450,1596,0,0,0,1596,A
7-M,451,0,1602,0,0,1602,T
7-M,452,1,1,1589,0,1591,G
7-M,453,0,1551,0,1,1552,T
7-M,454,0,8,1546,0,1554,G
7-M,455,1541,0,4,1,1546,A
7-M,456,0,0,1553,0,1553,G
7-M,457,1,0,0,1543,1544,C
7-M,458,1501,1,0,0,1502,A
7-M,459,0,1,1522,0,1523,G
7-M,460,1514,0,0,0,1514,A
7-M,461,1,1499,0,0,1500,T
7-M,462,0,1513,0,0,1513,T
7-M,463,1,0,1512,0,1513,G
7-M,464,1,0,0,1506,1507,C
7-M,465,1,1511,0,1,1513,T
7-M,466,0,7,1505,0,1512,G
7-M,467,1514,1,1,0,1516,A
7-M,468,1,0,0,1600,1601,C
7-M,469,0,1614,0,1,1615,T
7-M,470,4,0,0,1611,1615,C
7-M,471,2,0,0,1618,1620,C
7-M,472,3,0,0,1629,1632,C
7-M,473,1625,0,2,0,1627,A
7-M,474,0,1,1645,0,1646,G
7-M,475,0,0,0,1640,1640,C
7-M,476,1644,0,0,0,1644,A
7-M,477,0,0,0,1645,1645,C
7-M,478,1533,0,1,0,1534,A
7-M,479,1,1,1567,0,1569,G
7-M,480,0,1,1581,0,1582,G
7-M,481,0,1560,0,4,1564,T
7-M,482,3,0,0,1573,1576,C
7-M,483,0,1574,0,4,1578,T
7-M,484,6,0,0,1569,1575,C
7-M,485,1572,0,0,1,1573,A
7-M,486,0,1578,0,0,1578,T
7-M,487,1579,1,3,0,1583,A
7-M,488,0,3,1568,0,1571,G
7-M,489,1,1,1547,0,1549,G
7-M,490,0,0,0,1553,1553,C
7-M,491,1533,1,2,0,1536,A
7-M,492,1541,0,3,0,1544,A
7-M,493,1547,0,1,0,1548,A
7-M,494,0,1548,0,0,1548,T
7-M,495,0,2,1554,0,1556,G
7-M,496,0,0,1545,0,1545,G
7-M,497,0,1515,0,6,1521,T
7-M,498,0,3,1544,0,1547,G
7-M,499,0,1,1546,0,1547,G
7-M,500,1,0,0,1550,1551,C
7-M,501,1562,0,2,0,1564,A
7-M,502,1556,0,0,0,1556,A
7-M,503,0,0,0,1577,1577,C
7-M,504,1575,0,0,0,1575,A
7-M,505,1574,0,0,0,1574,A
7-M,506,1,0,0,1574,1575,C
7-M,507,2,0,0,1561,1563,C
7-M,508,1546,0,1,0,1547,A
7-M,509,1549,0,0,0,1549,A
7-M,510,0,1547,0,1,1548,T
7-M,511,4,0,0,1557,1561,C
7-M,512,3,2,0,1556,1561,C
7-M,513,1539,0,0,0,1539,A
7-M,514,0,1537,0,0,1537,T
7-M,515,0,1541,0,0,1541,T
7-M,516,1552,0,0,0,1552,A
7-M,517,1556,0,0,0,1556,A
7-M,518,0,1558,0,0,1558,T
7-M,519,1554,0,0,0,1554,A
7-M,520,1556,0,0,0,1556,A
7-M,521,1510,0,28,0,1538,A
7-M,522,1547,0,1,1,1549,A
7-M,523,0,1,0,1574,1575,C
7-M,524,1567,0,0,0,1567,A
7-M,525,0,1559,0,0,1559,T
7-M,526,1,3,1556,0,1560,G
7-M,527,1535,0,2,0,1537,A
7-M,528,1,3,1547,0,1551,G
7-M,529,1542,0,5,0,1547,A
7-M,530,1557,0,2,0,1559,A
7-M,531,0,0,0,1562,1562,C
7-M,532,1524,1,0,0,1525,A
7-M,533,1,4,1540,0,1545,G
7-M,534,1529,0,2,0,1531,A
7-M,535,1537,0,1,0,1538,A
7-M,536,0,1530,0,1,1531,T
7-M,537,0,0,1517,0,1517,G
7-M,538,0,0,1518,0,1518,G
7-M,539,0,1495,0,2,1497,T
7-M,540,0,1465,0,0,1465,T
7-M,541,0,1494,0,0,1494,T
7-M,542,0,1501,0,0,1501,T
7-M,543,0,5,1508,0,1513,G
7-M,544,2,0,1506,0,1508,G
7-M,545,0,1,0,1497,1498,C
7-M,546,1,0,0,1508,1509,C
7-M,547,1489,0,2,0,1491,A
7-M,548,0,0,1545,0,1545,G
7-M,549,0,0,0,1536,1536,C
7-M,550,1558,0,0,0,1558,A
7-M,551,1,0,0,1583,1584,C
7-M,552,0,1573,0,0,1573,T
7-M,553,1565,0,4,0,1569,A
7-M,554,0,0,0,1591,1591,C
7-M,555,1617,0,1,0,1618,A
7-M,556,1,0,1636,0,1637,G
7-M,557,0,0,0,1594,1594,C
7-M,558,0,1585,1,1,1587,T
7-M,559,1585,0,0,0,1585,A
7-M,560,1561,0,4,0,1565,A
7-M,561,0,1,1597,0,1598,G
7-M,562,0,0,1589,0,1589,G
7-M,563,1,0,0,1581,1582,C
7-M,564,0,1523,0,1,1524,T
7-M,565,1510,0,0,0,1510,A
7-M,566,0,1510,0,0,1510,T
7-M,567,0,1,1517,0,1518,G
7-M,568,0,1,1525,0,1526,G
7-M,569,1497,0,1,0,1498,A
7-M,570,0,0,1508,0,1508,G
7-M,571,1,0,0,1470,1471,C
7-M,572,1472,0,0,0,1472,A
7-M,573,1462,0,0,0,1462,A
7-M,574,1454,0,0,0,1454,A
7-M,575,0,1480,0,0,1480,T
7-M,576,0,2,1479,0,1481,G
7-M,577,1,0,1457,0,1458,G
7-M,578,0,0,0,1460,1460,C
7-M,579,0,1454,0,1,1455,T
7-M,580,3,2,1452,0,1457,G
7-M,581,1,3,1471,0,1475,G
7-M,582,1470,0,3,0,1473,A
7-M,583,0,1469,0,0,1469,T
7-M,584,2,0,0,1446,1448,C
7-M,585,1457,0,0,1,1458,A
7-M,586,1479,0,0,0,1479,A
7-M,587,0,0,1488,0,1488,G
7-M,588,0,1467,0,2,1469,T
7-M,589,1,5,1484,0,1490,G
7-M,590,1446,1,1,0,1448,A
7-M,591,1,0,1453,0,1454,G
7-M,592,1,0,0,1453,1454,C
7-M,593,1445,0,0,0,1445,A
7-M,594,0,2,1456,0,1458,G
7-M,595,0,0,1438,0,1438,G
7-M,596,2,1,0,1453,1456,C
7-M,597,1447,0,0,0,1447,A
7-M,598,2,0,1456,0,1458,G
7-M,599,2,1,0,1451,1454,C
7-M,600,0,1,1457,0,1458,G
7-M,601,0,0,1445,0,1445,G
7-M,602,1441,1,0,0,1442,A
7-M,603,0,2,1445,0,1447,G
7-M,604,1,0,1460,0,1461,G
7-M,605,0,0,0,1460,1460,C
7-M,606,3,0,0,1459,1462,C
7-M,607,1462,0,2,0,1464,A
7-M,608,0,1465,0,0,1465,T
7-M,609,0,1,1468,0,1469,G
7-M,610,1,2,1462,0,1465,G
7-M,611,1458,0,1,0,1459,A
7-M,612,0,1,1466,0,1467,G
7-M,613,1432,0,0,0,1432,A
7-M,614,0,1450,0,0,1450,T
7-M,615,1,1462,0,0,1463,T
7-M,616,0,0,1464,0,1464,G
7-M,617,0,1,0,1464,1465,C
7-M,618,0,1457,0,5,1462,T
7-M,619,1462,0,0,0,1462,A
7-M,620,1,3,1455,0,1459,G
7-M,621,0,1452,0,1,1453,T
7-M,622,2,0,0,1460,1462,C
7-M,623,1432,0,1,0,1433,A
7-M,624,0,1,1455,0,1456,G
7-M,625,0,0,1448,0,1448,G
7-M,626,0,0,0,1451,1451,C
7-M,627,3,0,0,1448,1451,C
7-M,628,1444,0,0,0,1444,A
7-M,629,0,3,1453,2,1458,G
7-M,630,1,0,1446,0,1447,G
7-M,631,0,1,0,1449,1450,C
7-M,632,1456,0,2,0,1458,A
7-M,633,0,1,1455,0,1456,G
7-M,634,1436,0,0,0,1436,A
7-M,635,1,1439,0,1,1441,T
7-M,636,0,3,1453,0,1456,G
7-M,637,2,0,1493,0,1495,G
7-M,638,1,1461,0,0,1462,T
7-M,639,1,2,1463,0,1466,G
7-M,640,1,1,0,1445,1447,C
7-M,641,1461,0,2,0,1463,A
7-M,642,1,0,1481,0,1482,G
7-M,643,2,3,1477,0,1482,G
7-M,644,0,0,0,1484,1484,C
7-M,645,1481,0,0,0,1481,A
7-M,646,1435,0,1,1,1437,A
7-M,647,0,1414,0,0,1414,T
7-M,648,0,3,1420,0,1423,G
7-M,649,1416,0,0,1,1417,A
7-M,650,0,0,1422,0,1422,G
7-M,651,1375,0,1,0,1376,A
7-M,652,1,0,1384,1,1386,G
7-M,653,0,0,0,1399,1399,C
7-M,654,2,0,0,1422,1424,C
7-M,655,1415,0,0,0,1415,A
7-M,656,1,1432,0,1,1434,T
7-M,657,0,1436,0,0,1436,T
7-M,658,2,3,1424,0,1429,G
7-M,659,1,2,1421,0,1424,G
7-M,660,1,1,1419,0,1421,G
7-M,661,1424,1,0,0,1425,A
7-M,662,0,0,1,1404,1405,C
7-M,663,0,1348,0,1,1349,T
7-M,664,4,0,0,1357,1361,C
7-M,665,1368,0,0,0,1368,A
7-M,666,0,1411,0,1,1412,T
7-M,667,1,0,0,1406,1407,C
7-M,668,2,0,0,1405,1407,C
7-M,669,0,1393,0,1,1394,T
7-M,670,1406,0,0,0,1406,A
7-M,671,0,1,1412,0,1413,G
7-M,672,0,1550,0,2,1552,T
7-M,673,0,1526,0,0,1526,T
7-M,674,4,0,0,1535,1539,C
7-M,675,4,0,0,1511,1515,C
7-M,676,1504,0,0,0,1504,A
7-M,677,0,0,1517,0,1517,G
7-M,678,0,1518,0,0,1518,T
7-M,679,1508,0,0,0,1508,A
7-M,680,0,1,0,1506,1507,C
7-M,681,0,1303,0,2,1305,T
7-M,682,0,2,1339,0,1341,G
7-M,683,0,1,1373,0,1374,G
7-M,684,0,1378,0,0,1378,T
7-M,685,2,0,0,1381,1383,C
7-M,686,0,1359,1,1,1361,T
7-M,687,1356,0,0,0,1356,A
7-M,688,1357,0,0,1,1358,A
7-M,689,0,4,1366,0,1370,G
7-M,690,1360,0,0,0,1360,A
7-M,691,0,1,1340,0,1341,G
7-M,692,1266,0,1,0,1267,A
7-M,693,0,1256,0,1,1257,T
7-M,694,0,2,1264,0,1266,G
7-M,695,1259,0,0,0,1259,A
7-M,696,0,1254,0,0,1254,T
7-M,697,2,0,0,1259,1261,C
7-M,698,0,1246,0,0,1246,T
7-M,699,0,1247,0,1,1248,T
7-M,700,1,0,0,1246,1247,C
7-M,701,0,1252,0,2,1254,T
7-M,702,0,1254,0,1,1255,T
7-M,703,0,3,1249,0,1252,G
7-M,704,1247,0,0,0,1247,A
7-M,705,1242,0,2,0,1244,A
7-M,706,1231,0,0,0,1231,A
7-M,707,1242,0,0,0,1242,A
7-M,708,0,1247,0,0,1247,T
7-M,709,0,1258,0,0,1258,T
7-M,710,0,1258,0,1,1259,T
7-M,711,0,0,1254,1,1255,G
7-M,712,0,1,0,1258,1259,C
7-M,713,1260,0,1,0,1261,A
7-M,714,0,0,1254,0,1254,G
7-M,715,1243,0,1,0,1244,A
7-M,716,0,1,0,1286,1287,C
7-M,717,1,2,0,1285,1288,C
7-M,718,0,1283,0,1,1284,T
7-M,719,1302,0,0,0,1302,A
7-M,720,0,1307,0,0,1307,T
7-M,721,2,0,0,1308,1310,C
7-M,722,1311,0,1,0,1312,A
7-M,723,0,1,1313,0,1314,G
7-M,724,1299,0,0,0,1299,A
7-M,725,1258,0,2,0,1260,A
7-M,726,1253,0,1,1,1255,A
7-M,727,0,0,0,1257,1257,C
7-M,728,0,3,1250,0,1253,G
7-M,729,1240,0,1,0,1241,A
7-M,730,1244,0,0,0,1244,A
7-M,731,0,1247,0,0,1247,T
7-M,732,0,3,1239,0,1242,G
7-M,733,0,3,1253,0,1256,G
7-M,734,0,1,1259,0,1260,G
7-M,735,0,0,1258,0,1258,G
7-M,736,0,0,1266,0,1266,G
7-M,737,0,1232,0,0,1232,T
7-M,738,0,0,1238,0,1238,G
7-M,739,0,0,0,1235,1235,C
7-M,740,1228,1,0,0,1229,A
7-M,741,1,0,1250,0,1251,G
7-M,742,1233,0,0,0,1233,A
7-M,743,0,1232,0,1,1233,T
7-M,744,0,0,1223,0,1223,G
7-M,745,2,1,0,1208,1211,C
7-M,746,1206,0,1,0,1207,A
7-M,747,1201,0,3,0,1204,A
7-M,748,0,1,0,1219,1220,C
7-M,749,0,4,1215,0,1219,G
7-M,750,1219,0,1,0,1220,A
7-M,751,0,1205,0,1,1206,T
7-M,752,0,1208,0,0,1208,T
7-M,753,3,0,0,1218,1221,C
7-M,754,1211,0,0,0,1211,A
7-M,755,1209,0,1,0,1210,A
7-M,756,1,0,1207,0,1208,G
7-M,757,0,1175,0,0,1175,T
7-M,758,0,3,1171,0,1174,G
7-M,759,1170,0,0,0,1170,A
7-M,760,0,1,0,1166,1167,C
7-M,761,0,0,0,1163,1163,C
7-M,762,3,0,1,1158,1162,C
7-M,763,2,0,1164,0,1166,G
7-M,764,1,0,0,1167,1168,C
7-M,765,0,1176,0,1,1177,T
7-M,766,0,1172,0,0,1172,T
7-M,767,0,0,1170,0,1170,G
7-M,768,0,1165,0,1,1166,T
7-M,769,0,1166,0,0,1166,T
7-M,770,0,0,1166,0,1166,G
7-M,771,0,1142,0,0,1142,T
7-M,772,0,1137,0,0,1137,T
7-M,773,0,0,1138,0,1138,G
7-M,774,0,1,0,1126,1127,C
7-M,775,4,0,0,1122,1126,C
7-M,776,0,0,1138,0,1138,G
7-M,777,0,1,0,1115,1116,C
7-M,778,0,0,1140,0,1140,G
7-M,779,1129,0,0,0,1129,A
7-M,780,1138,0,0,0,1138,A
7-M,781,0,1153,0,0,1153,T
7-M,782,1144,0,2,0,1146,A
7-M,783,0,1166,0,1,1167,T
7-M,784,2,0,0,1174,1176,C
7-M,785,1184,0,1,0,1185,A
7-M,786,0,1184,0,0,1184,T
7-M,787,0,1175,0,0,1175,T
7-M,788,0,3,1169,0,1172,G
7-M,789,0,1,1163,0,1164,G
7-M,790,0,1,1180,0,1181,G
7-M,791,1184,0,4,0,1188,A
7-M,792,0,1168,0,0,1168,T
7-M,793,0,0,0,1133,1133,C
7-M,794,0,1132,0,3,1135,T
7-M,795,0,1139,0,1,1140,T
7-M,796,0,0,1146,0,1146,G
7-M,797,0,0,0,1149,1149,C
7-M,798,1162,0,1,0,1163,A
7-M,799,2,0,0,1164,1166,C
7-M,800,0,1145,0,3,1148,T
7-M,801,0,1155,0,1,1156,T
7-M,802,0,2,1156,0,1158,G
7-M,803,1157,0,1,0,1158,A
7-M,804,0,1167,0,0,1167,T
7-M,805,1154,0,0,0,1154,A
7-M,806,0,1151,0,1,1152,T
7-M,807,0,1141,0,1,1142,T
7-M,808,0,0,1145,0,1145,G
7-M,809,0,1136,0,0,1136,T
7-M,810,0,5,1130,0,1135,G
7-M,811,0,0,1127,0,1127,G
7-M,812,1110,0,0,0,1110,A
7-M,813,0,1108,0,0,1108,T
7-M,814,0,1107,0,1,1108,T
7-M,815,2,0,0,1097,1099,C
7-M,816,0,1093,0,3,1096,T
7-M,817,0,1091,0,0,1091,T
7-M,818,0,0,1094,0,1094,G
7-M,819,1076,0,0,0,1076,A
7-M,820,0,1083,0,0,1083,T
7-M,821,1,0,0,1063,1064,C
7-M,822,0,0,1064,0,1064,G
7-M,823,0,1065,0,0,1065,T
7-M,824,1,0,0,1053,1054,C
7-M,825,0,1053,0,3,1056,T
7-M,826,0,1063,0,0,1063,T
7-M,827,0,1062,0,1,1063,T
7-M,828,0,1061,0,0,1061,T
7-M,829,0,1067,0,0,1067,T
7-M,830,0,1059,0,0,1059,T
7-M,831,0,1057,0,0,1057,T
7-M,832,1,0,0,1066,1067,C
7-M,833,1066,0,0,0,1066,A
7-M,834,1058,0,2,0,1060,A
7-M,835,1062,0,1,0,1063,A
7-M,836,0,1066,0,0,1066,T
7-M,837,0,1,1061,0,1062,G
7-M,838,1,1,0,1059,1061,C
7-M,839,0,0,1058,0,1058,G
7-M,840,0,1072,0,4,1076,T
7-M,841,1,0,0,1073,1074,C
7-M,842,0,1075,0,0,1075,T
7-M,843,1080,0,0,0,1080,A
7-M,844,0,1069,0,0,1069,T
7-M,845,3,1,0,1067,1071,C
7-M,846,1,6,1064,0,1071,G
7-M,847,1062,0,0,0,1062,A
7-M,848,0,0,0,1062,1062,C
7-M,849,0,1028,0,1,1029,T
7-M,850,1,0,0,1067,1068,C
7-M,851,0,1055,0,0,1055,T
7-M,852,0,1057,0,1,1058,T
7-M,853,0,0,0,1066,1066,C
7-M,854,1063,0,0,0,1063,A
7-M,855,1063,0,1,0,1064,A
7-M,856,1060,0,1,0,1061,A
7-M,857,0,0,0,1062,1062,C
7-M,858,1055,0,0,0,1055,A
7-M,859,0,0,0,995,995,C
7-M,860,0,1,967,0,968,G
7-M,861,0,0,1012,0,1012,G
7-M,862,1,0,0,987,988,C
7-M,863,1,0,0,1009,1010,C
7-M,864,0,1006,0,2,1008,T
7-M,865,0,1021,0,0,1021,T
7-M,866,1016,0,1,0,1017,A
7-M,867,1029,0,0,0,1029,A
7-M,868,1026,0,2,0,1028,A
7-M,869,1021,0,2,0,1023,A
7-M,870,0,1,1008,0,1009,G
7-M,871,887,0,1,0,888,A
7-M,872,0,1,879,0,880,G
7-M,873,0,0,873,0,873,G
7-M,874,0,0,0,863,863,C
7-M,875,0,0,0,849,849,C
7-M,876,3,1,0,855,859,C
7-M,877,0,863,0,0,863,T
7-M,878,0,865,0,0,865,T
7-M,879,1,0,0,875,876,C
7-M,880,0,875,0,0,875,T
7-M,881,881,0,0,0,881,A
7-M,882,1,1,0,878,880,C
7-M,883,0,1,862,0,863,G
7-M,884,2,0,872,0,874,G
7-M,885,841,0,0,0,841,A
7-M,886,830,0,0,0,830,A
7-M,887,0,2,822,0,824,G
7-M,888,0,2,813,0,815,G
7-M,889,797,0,1,0,798,A
7-M,890,0,0,796,0,796,G
7-M,891,0,790,0,0,790,T
7-M,892,781,0,0,0,781,A
7-M,893,0,0,0,779,779,C
7-M,894,3,0,0,772,775,C
7-M,895,0,763,0,0,763,T
7-M,896,0,2,770,0,772,G
7-M,897,735,0,1,0,736,A
7-M,898,0,0,752,0,752,G
7-M,899,0,722,0,0,722,T
7-M,900,1,0,0,724,725,C
7-M,901,0,707,0,0,707,T
7-M,902,696,0,0,0,696,A
7-M,903,0,703,0,0,703,T
7-M,904,0,0,701,0,701,G
7-M,905,688,0,1,0,689,A
7-M,906,0,1,683,0,684,G
7-M,907,0,1,624,0,625,G
7-M,908,0,1,628,0,629,G
7-M,909,626,0,0,0,626,A
7-M,910,622,0,0,0,622,A
7-M,911,0,1,620,0,621,G
7-M,912,604,0,0,0,604,A
7-M,913,610,0,0,0,610,A
7-M,914,0,598,0,1,599,T
7-M,915,592,0,1,0,593,A
7-M,916,0,590,0,0,590,T
7-M,917,0,7,0,574,581,C
7-M,918,0,1,583,0,584,G
7-M,919,583,0,0,0,583,A
7-M,920,575,0,1,0,576,A
7-M,921,575,0,0,0,575,A
7-M,922,0,0,567,0,567,G
7-M,923,0,1,573,0,574,G
7-M,924,561,0,0,0,561,A
7-M,925,560,1,0,0,561,A
7-M,926,0,0,0,569,569,C
7-M,927,555,0,0,0,555,A
7-M,928,0,0,557,0,557,G
7-M,929,1,0,0,561,562,C
7-M,930,560,1,0,0,561,A
7-M,931,0,0,560,0,560,G
7-M,932,514,0,0,0,514,A
7-M,933,518,0,0,0,518,A
7-M,934,0,514,0,0,514,T
7-M,935,0,0,504,0,504,G
7-M,936,0,0,0,499,499,C
7-M,937,0,488,0,0,488,T
7-M,938,0,0,489,0,489,G
7-M,939,0,481,0,0,481,T
7-M,940,0,0,478,0,478,G
7-M,941,0,0,475,0,475,G
7-M,942,462,0,0,0,462,A
7-M,943,0,463,0,0,463,T
7-M,944,0,0,438,0,438,G
7-M,945,0,0,0,425,425,C
7-M,946,0,414,0,0,414,T
7-M,947,0,0,408,0,408,G
7-M,948,410,0,0,0,410,A
7-M,949,0,0,0,401,401,C
7-M,950,0,1,405,0,406,G
7-M,951,400,0,0,0,400,A
7-M,952,0,0,0,399,399,C
7-M,953,388,0,0,0,388,A
7-M,954,0,0,387,0,387,G
7-M,955,0,384,0,0,384,T
7-M,956,0,0,0,384,384,C
7-M,957,385,0,0,0,385,A
7-M,958,0,378,0,0,378,T
7-M,959,0,379,0,0,379,T
7-M,960,0,372,0,0,372,T
7-M,961,0,371,0,0,371,T
7-M,962,1,0,372,0,373,G
7-M,963,0,354,0,0,354,T
7-M,964,0,0,0,353,353,C
7-M,965,340,0,0,0,340,A
7-M,966,0,0,342,0,342,G
7-M,967,0,0,0,341,341,C
7-M,968,339,0,0,0,339,A
7-M,969,0,337,0,0,337,T
7-M,970,317,0,1,0,318,A
7-M,971,0,1,317,0,318,G
7-M,972,311,0,0,0,311,A
7-M,973,0,0,312,0,312,G
7-M,974,0,306,0,0,306,T
7-M,975,0,201,0,0,201,T
7-M,976,1,0,201,0,202,G
7-M,977,0,0,203,0,203,G
7-M,978,200,0,0,0,200,A
7-M,979,0,0,200,0,200,G
7-M,980,0,130,0,0,130,T
7-M,981,125,0,0,0,125,A
7-M,982,123,0,0,0,123,A
8-NS,1,50,0,0,0,50,A
8-NS,2,0,52,0,0,52,T
8-NS,3,0,0,54,0,54,G
8-NS,4,0,0,62,0,62,G
8-NS,5,63,0,0,0,63,A
8-NS,6,0,131,0,0,131,T
8-NS,7,0,132,0,0,132,T
8-NS,8,0,0,0,135,135,C
8-NS,9,0,0,0,135,135,C
8-NS,10,135,0,0,0,135,A
8-NS,11,136,0,0,0,136,A
8-NS,12,0,1,0,134,135,C
8-NS,13,133,0,0,0,133,A
8-NS,14,0,0,0,134,134,C
8-NS,15,0,133,0,0,133,T
8-NS,16,0,0,153,0,153,G
8-NS,17,0,156,0,0,156,T
8-NS,18,1,0,156,0,157,G
8-NS,19,0,158,0,0,158,T
8-NS,20,0,0,0,156,156,C
8-NS,21,157,0,0,0,157,A
8-NS,22,155,0,0,0,155,A
8-NS,23,0,0,161,0,161,G
8-NS,24,0,169,0,0,169,T
8-NS,25,0,165,0,1,166,T
8-NS,26,0,169,0,0,169,T
8-NS,27,0,0,0,168,168,C
8-NS,28,0,0,0,168,168,C
8-NS,29,169,0,0,0,169,A
8-NS,30,0,0,169,0,169,G
8-NS,31,1,0,169,0,170,G
8-NS,32,0,168,0,0,168,T
8-NS,33,171,0,0,0,171,A
8-NS,34,0,0,174,0,174,G
8-NS,35,171,0,0,0,171,A
8-NS,36,0,173,0,0,173,T
8-NS,37,0,174,0,0,174,T
8-NS,38,0,0,176,0,176,G
8-NS,39,0,0,0,172,172,C
8-NS,40,0,178,0,0,178,T
8-NS,41,1,177,0,0,178,T
8-NS,42,0,180,0,0,180,T
8-NS,43,0,0,0,185,185,C
8-NS,44,0,181,0,1,182,T
8-NS,45,0,182,0,0,182,T
8-NS,46,0,182,0,0,182,T
8-NS,47,0,0,183,0,183,G
8-NS,48,0,0,181,0,181,G
8-NS,49,0,0,0,183,183,C
8-NS,50,183,0,0,0,183,A
8-NS,51,0,183,0,0,183,T
8-NS,52,177,0,0,1,178,A
8-NS,53,0,185,0,0,185,T
8-NS,54,0,0,0,185,185,C
8-NS,55,0,0,0,184,184,C
8-NS,56,0,0,183,0,183,G
8-NS,57,0,1,185,0,186,G
8-NS,58,184,0,0,0,184,A
8-NS,59,186,0,0,0,186,A
8-NS,60,188,0,0,0,188,A
8-NS,61,0,0,0,191,191,C
8-NS,62,191,0,0,0,191,A
8-NS,63,192,0,0,0,192,A
8-NS,64,0,0,197,0,197,G
8-NS,65,0,194,0,0,194,T
8-NS,66,0,196,0,0,196,T
8-NS,67,0,0,198,0,198,G
8-NS,68,0,195,0,0,195,T
8-NS,69,197,0,0,0,197,A
8-NS,70,0,1,196,0,197,G
8-NS,71,209,0,0,0,209,A
8-NS,72,0,0,0,218,218,C
8-NS,73,1,0,0,215,216,C
8-NS,74,213,0,0,0,213,A
8-NS,75,213,0,0,0,213,A
8-NS,76,0,2,247,0,249,G
8-NS,77,248,0,0,0,248,A
8-NS,78,249,0,0,0,249,A
8-NS,79,0,0,0,253,253,C
8-NS,80,0,251,0,0,251,T
8-NS,81,0,1,252,0,253,G
8-NS,82,242,0,3,0,245,A
8-NS,83,0,0,251,0,251,G
8-NS,84,0,254,0,0,254,T
8-NS,85,0,2,246,0,248,G
8-NS,86,250,0,0,0,250,A
8-NS,87,0,251,0,0,251,T
8-NS,88,0,1,250,0,251,G
8-NS,89,0,0,0,253,253,C
8-NS,90,0,1,0,254,255,C
8-NS,91,0,0,0,254,254,C
8-NS,92,0,0,0,254,254,C
8-NS,93,255,0,0,0,255,A
8-NS,94,0,261,0,0,261,T
8-NS,95,0,268,0,0,268,T
8-NS,96,1,0,0,266,267,C
8-NS,97,0,1,0,264,265,C
8-NS,98,0,265,0,1,266,T
8-NS,99,0,261,0,0,261,T
8-NS,100,0,0,259,0,259,G
8-NS,101,255,0,0,0,255,A
8-NS,102,0,261,0,0,261,T
8-NS,103,0,0,0,257,257,C
8-NS,104,0,0,256,0,256,G
8-NS,105,0,0,256,0,256,G
8-NS,106,0,0,0,257,257,C
8-NS,107,0,257,0,0,257,T
8-NS,108,0,259,0,0,259,T
8-NS,109,0,0,0,255,255,C
8-NS,110,0,0,255,0,255,G
8-NS,111,0,1,0,255,256,C
8-NS,112,1,0,0,256,257,C
8-NS,113,0,1,256,0,257,G
8-NS,114,250,0,0,0,250,A
8-NS,115,0,2,261,0,263,G
8-NS,116,265,0,0,0,265,A
8-NS,117,0,263,0,0,263,T
8-NS,118,2,0,0,262,264,C
8-NS,119,265,0,0,0,265,A
8-NS,120,0,1,267,0,268,G
8-NS,121,264,0,0,0,264,A
8-NS,122,0,0,269,0,269,G
8-NS,123,0,0,270,0,270,G
8-NS,124,0,268,0,0,268,T
8-NS,125,0,0,0,286,286,C
8-NS,126,0,0,0,290,290,C
8-NS,127,1,0,0,294,295,C
8-NS,128,0,300,0,0,300,T
8-NS,129,297,0,0,0,297,A
8-NS,130,296,0,0,0,296,A
8-NS,131,0,1,305,0,306,G
8-NS,132,0,0,301,0,301,G
8-NS,133,0,1,299,0,300,G
8-NS,134,0,0,298,0,298,G
8-NS,135,295,0,0,0,295,A
8-NS,136,295,0,0,0,295,A
8-NS,137,0,0,298,0,298,G
8-NS,138,297,0,0,0,297,A
8-NS,139,0,0,301,0,301,G
8-NS,140,0,1,293,0,294,G
8-NS,141,0,0,0,303,303,C
8-NS,142,301,0,0,0,301,A
8-NS,143,299,0,0,0,299,A
8-NS,144,0,303,0,0,303,T
8-NS,145,307,0,0,0,307,A
8-NS,146,0,0,0,315,315,C
8-NS,147,0,304,0,0,304,T
8-NS,148,1,0,0,307,308,C
8-NS,149,0,304,0,0,304,T
8-NS,150,0,1,0,310,311,C
8-NS,151,0,1,313,0,314,G
8-NS,152,0,0,322,0,322,G
8-NS,153,0,324,0,0,324,T
8-NS,154,0,0,0,327,327,C
8-NS,155,0,321,0,0,321,T
8-NS,156,330,0,0,0,330,A
8-NS,157,0,0,329,0,329,G
8-NS,158,329,0,0,0,329,A
8-NS,159,0,0,0,332,332,C
8-NS,160,329,0,0,0,329,A
8-NS,161,0,321,0,0,321,T
8-NS,162,0,0,0,319,319,C
8-NS,163,321,0,0,0,321,A
8-NS,164,319,0,0,0,319,A
8-NS,165,314,0,0,0,314,A
8-NS,166,310,0,0,0,310,A
8-NS,167,0,0,0,314,314,C
8-NS,168,312,0,0,0,312,A
8-NS,169,0,0,317,0,317,G
8-NS,170,0,0,0,311,311,C
8-NS,171,0,0,0,313,313,C
8-NS,172,317,0,0,0,317,A
8-NS,173,0,1,0,320,321,C
8-NS,174,0,0,0,323,323,C
8-NS,175,0,0,0,322,322,C
8-NS,176,325,3,0,0,328,A
8-NS,177,0,327,0,0,327,T
8-NS,178,0,0,329,0,329,G
8-NS,179,0,327,0,0,327,T
8-NS,180,0,330,0,0,330,T
8-NS,181,1,1,327,0,329,G
8-NS,182,0,0,324,0,324,G
8-NS,183,319,0,0,0,319,A
8-NS,184,320,0,0,0,320,A
8-NS,185,322,0,0,0,322,A
8-NS,186,0,1,319,0,320,G
8-NS,187,0,0,0,324,324,C
8-NS,188,321,0,0,0,321,A
8-NS,189,324,0,0,0,324,A
8-NS,190,321,0,0,0,321,A
8-NS,191,0,321,0,0,321,T
8-NS,192,0,319,0,0,319,T
8-NS,193,0,0,324,0,324,G
8-NS,194,0,325,0,0,325,T
8-NS,195,326,0,0,0,326,A
8-NS,196,0,0,324,0,324,G
8-NS,197,323,0,0,0,323,A
8-NS,198,323,0,0,0,323,A
8-NS,199,323,0,0,0,323,A
8-NS,200,322,0,0,0,322,A
8-NS,201,0,2,320,0,322,G
8-NS,202,320,0,0,0,320,A
8-NS,203,0,320,0,0,320,T
8-NS,204,0,320,0,0,320,T
8-NS,205,0,0,0,318,318,C
8-NS,206,0,319,0,0,319,T
8-NS,207,0,0,319,0,319,G
8-NS,208,319,0,0,0,319,A
8-NS,209,316,0,0,0,316,A
8-NS,210,320,0,1,0,321,A
8-NS,211,0,0,320,0,320,G
8-NS,212,319,0,0,0,319,A
8-NS,213,324,0,0,0,324,A
8-NS,214,0,2,319,0,321,G
8-NS,215,322,0,0,0,322,A
8-NS,216,322,0,0,0,322,A
8-NS,217,0,323,0,0,323,T
8-NS,218,2,0,0,322,324,C
8-NS,219,0,324,0,0,324,T
8-NS,220,0,0,322,0,322,G
8-NS,221,321,0,0,0,321,A
8-NS,222,0,321,0,0,321,T
8-NS,223,0,1,315,0,316,G
8-NS,224,314,0,1,0,315,A
8-NS,225,0,2,311,0,313,G
8-NS,226,0,1,313,0,314,G
8-NS,227,0,0,0,313,313,C
8-NS,228,311,0,0,0,311,A
8-NS,229,0,0,0,325,325,C
8-NS,230,0,322,0,0,322,T
8-NS,231,0,322,0,0,322,T
8-NS,232,328,0,0,0,328,A
8-NS,233,328,0,0,0,328,A
8-NS,234,324,1,0,0,325,A
8-NS,235,327,0,0,0,327,A
8-NS,236,0,324,0,0,324,T
8-NS,237,0,1,323,0,324,G
8-NS,238,321,0,0,0,321,A
8-NS,239,0,0,0,325,325,C
8-NS,240,1,0,0,323,324,C
8-NS,241,320,0,0,0,320,A
8-NS,242,0,325,0,0,325,T
8-NS,243,0,1,329,0,330,G
8-NS,244,0,0,332,0,332,G
8-NS,245,0,327,0,0,327,T
8-NS,246,0,0,0,346,346,C
8-NS,247,0,341,0,0,341,T
8-NS,248,0,0,0,344,344,C
8-NS,249,1,0,0,348,349,C
8-NS,250,348,0,0,0,348,A
8-NS,251,0,0,0,353,353,C
8-NS,252,339,0,0,0,339,A
8-NS,253,0,0,0,344,344,C
8-NS,254,0,0,0,342,342,C
8-NS,255,0,328,0,1,329,T
8-NS,256,0,0,327,0,327,G
8-NS,257,0,0,0,325,325,C
8-NS,258,0,322,0,0,322,T
8-NS,259,0,323,0,0,323,T
8-NS,260,0,0,0,326,326,C
8-NS,261,1,0,322,0,323,G
8-NS,262,0,0,0,325,325,C
8-NS,263,0,0,322,0,322,G
8-NS,264,337,0,0,0,337,A
8-NS,265,0,338,0,0,338,T
8-NS,266,342,0,0,0,342,A
8-NS,267,0,0,0,346,346,C
8-NS,268,345,0,0,0,345,A
8-NS,269,0,357,0,0,357,T
8-NS,270,353,0,1,0,354,A
8-NS,271,353,0,1,0,354,A
8-NS,272,0,0,0,354,354,C
8-NS,273,0,347,0,0,347,T
8-NS,274,0,0,350,0,350,G
8-NS,275,337,0,0,0,337,A
8-NS,276,0,0,0,339,339,C
8-NS,277,338,0,1,0,339,A
8-NS,278,0,340,0,0,340,T
8-NS,279,0,2,340,0,342,G
8-NS,280,340,0,0,0,340,A
8-NS,281,0,0,0,346,346,C
8-NS,282,0,342,0,0,342,T
8-NS,283,353,0,0,0,353,A
8-NS,284,0,351,0,0,351,T
8-NS,285,0,350,0,0,350,T
8-NS,286,0,0,348,0,348,G
8-NS,287,346,0,0,0,346,A
8-NS,288,0,4,339,0,343,G
8-NS,289,1,0,344,0,345,G
8-NS,290,335,0,0,0,335,A
8-NS,291,336,0,0,0,336,A
8-NS,292,0,327,0,1,328,T
8-NS,293,1,334,0,0,335,T
8-NS,294,0,0,341,0,341,G
8-NS,295,0,337,0,0,337,T
8-NS,296,1,0,0,341,342,C
8-NS,297,340,0,1,0,341,A
8-NS,298,343,0,0,0,343,A
8-NS,299,0,0,340,0,340,G
8-NS,300,340,1,0,0,341,A
8-NS,301,337,0,0,1,338,A
8-NS,302,342,1,0,0,343,A
8-NS,303,0,0,0,342,342,C
8-NS,304,0,336,0,0,336,T
8-NS,305,0,3,336,0,339,G
8-NS,306,0,0,343,0,343,G
8-NS,307,0,345,0,0,345,T
8-NS,308,0,342,0,0,342,T
8-NS,309,3,0,0,340,343,C
8-NS,310,347,0,0,0,347,A
8-NS,311,0,352,0,0,352,T
8-NS,312,0,1,355,0,356,G
8-NS,313,0,0,0,362,362,C
8-NS,314,0,360,0,0,360,T
8-NS,315,358,0,2,0,360,A
8-NS,316,379,0,0,0,379,A
8-NS,317,0,386,0,0,386,T
8-NS,318,0,0,390,0,390,G
8-NS,319,0,0,0,381,381,C
8-NS,320,0,0,0,381,381,C
8-NS,321,0,1,0,378,379,C
8-NS,322,379,0,0,0,379,A
8-NS,323,384,0,1,0,385,A
8-NS,324,0,0,389,0,389,G
8-NS,325,0,0,0,388,388,C
8-NS,326,390,0,0,0,390,A
8-NS,327,0,0,394,0,394,G
8-NS,328,390,0,0,0,390,A
8-NS,329,391,0,0,0,391,A
8-NS,330,394,0,0,0,394,A
8-NS,331,1,0,399,0,400,G
8-NS,332,0,386,0,0,386,T
8-NS,333,0,0,389,0,389,G
8-NS,334,1,1,388,0,390,G
8-NS,335,391,0,0,0,391,A
8-NS,336,386,0,0,0,386,A
8-NS,337,0,1,388,0,389,G
8-NS,338,0,2,386,0,388,G
8-NS,339,390,0,0,0,390,A
8-NS,340,0,0,0,387,387,C
8-NS,341,0,0,0,388,388,C
8-NS,342,0,390,0,0,390,T
8-NS,343,1,0,0,393,394,C
8-NS,344,0,395,0,0,395,T
8-NS,345,0,398,0,0,398,T
8-NS,346,0,398,0,0,398,T
8-NS,347,0,1,393,0,394,G
8-NS,348,0,0,0,398,398,C
8-NS,349,398,0,0,0,398,A
8-NS,350,0,399,0,0,399,T
8-NS,351,0,0,0,397,397,C
8-NS,352,402,0,0,0,402,A
8-NS,353,0,2,413,0,415,G
8-NS,354,409,0,0,0,409,A
8-NS,355,415,0,0,0,415,A
8-NS,356,0,418,0,0,418,T
8-NS,357,0,1,403,0,404,G
8-NS,358,6,1,399,0,406,G
8-NS,359,403,0,0,0,403,A
8-NS,360,0,0,0,409,409,C
8-NS,361,2,0,0,402,404,C
8-NS,362,402,0,0,0,402,A
8-NS,363,0,1,409,0,410,G
8-NS,364,1,0,408,0,409,G
8-NS,365,1,0,0,410,411,C
8-NS,366,412,0,0,0,412,A
8-NS,367,412,0,0,0,412,A
8-NS,368,0,416,0,0,416,T
8-NS,369,0,0,0,409,409,C
8-NS,370,416,0,0,0,416,A
8-NS,371,0,415,0,0,415,T
8-NS,372,0,0,407,0,407,G
8-NS,373,0,1,413,0,414,G
8-NS,374,411,0,0,0,411,A
8-NS,375,0,0,413,0,413,G
8-NS,376,405,0,0,0,405,A
8-NS,377,406,0,0,0,406,A
8-NS,378,408,0,0,0,408,A
8-NS,379,404,0,0,0,404,A
8-NS,380,408,0,0,0,408,A
8-NS,381,0,0,0,410,410,C
8-NS,382,407,0,1,0,408,A
8-NS,383,0,406,0,0,406,T
8-NS,384,1,0,0,406,407,C
8-NS,385,404,0,0,0,404,A
8-NS,386,0,410,0,0,410,T
8-NS,387,0,0,406,0,406,G
8-NS,388,0,410,0,0,410,T
8-NS,389,0,407,0,0,407,T
8-NS,390,0,0,403,0,403,G
8-NS,391,403,0,0,0,403,A
8-NS,392,405,0,0,0,405,A
8-NS,393,405,0,0,0,405,A
8-NS,394,0,0,403,0,403,G
8-NS,395,0,0,0,399,399,C
8-NS,396,1,0,397,0,398,G
8-NS,397,396,0,0,0,396,A
8-NS,398,396,0,0,0,396,A
8-NS,399,0,397,0,0,397,T
8-NS,400,0,394,0,2,396,T
8-NS,401,0,397,0,0,397,T
8-NS,402,0,0,0,396,396,C
8-NS,403,393,0,0,0,393,A
8-NS,404,0,0,393,0,393,G
8-NS,405,0,395,0,0,395,T
8-NS,406,0,2,396,0,398,G
8-NS,407,0,394,0,0,394,T
8-NS,408,0,1,395,0,396,G
8-NS,409,393,0,0,0,393,A
8-NS,410,0,396,0,0,396,T
8-NS,411,0,395,0,0,395,T
8-NS,412,0,393,0,0,393,T
8-NS,413,0,393,0,0,393,T
8-NS,414,1,392,0,0,393,T
8-NS,415,0,1,392,0,393,G
8-NS,416,388,0,0,0,388,A
8-NS,417,0,0,0,389,389,C
8-NS,418,0,1,0,385,386,C
8-NS,419,0,0,391,1,392,G
8-NS,420,407,0,0,0,407,A
8-NS,421,0,0,0,414,414,C
8-NS,422,0,418,0,0,418,T
8-NS,423,423,0,0,0,423,A
8-NS,424,0,2,421,0,423,G
8-NS,425,423,0,0,0,423,A
8-NS,426,0,1,426,0,427,G
8-NS,427,423,0,1,0,424,A
8-NS,428,0,0,0,426,426,C
8-NS,429,1,0,0,399,400,C
8-NS,430,387,0,0,0,387,A
8-NS,431,0,405,0,0,405,T
8-NS,432,396,0,0,0,396,A
8-NS,433,0,0,421,0,421,G
8-NS,434,0,413,0,0,413,T
8-NS,435,415,0,0,0,415,A
8-NS,436,0,418,0,0,418,T
8-NS,437,0,405,1,0,406,T
8-NS,438,428,0,0,0,428,A
8-NS,439,0,0,0,430,430,C
8-NS,440,0,416,0,0,416,T
8-NS,441,417,0,1,0,418,A
8-NS,442,383,0,0,0,383,A
8-NS,443,0,0,374,0,374,G
8-NS,444,0,0,379,0,379,G
8-NS,445,0,0,380,0,380,G
8-NS,446,0,0,0,371,371,C
8-NS,447,0,369,0,1,370,T
8-NS,448,0,377,0,0,377,T
8-NS,449,0,382,0,0,382,T
8-NS,450,0,0,0,385,385,C
8-NS,451,387,0,0,0,387,A
8-NS,452,0,0,0,391,391,C
8-NS,453,0,0,0,387,387,C
8-NS,454,0,0,385,0,385,G
8-NS,455,378,0,0,0,378,A
8-NS,456,383,2,0,0,385,A
8-NS,457,0,1,384,0,385,G
8-NS,458,377,0,0,0,377,A
8-NS,459,0,0,378,0,378,G
8-NS,460,0,0,370,0,370,G
8-NS,461,0,1,367,0,368,G
8-NS,462,368,0,1,0,369,A
8-NS,463,0,0,366,0,366,G
8-NS,464,0,0,0,364,364,C
8-NS,465,369,0,0,0,369,A
8-NS,466,363,0,0,0,363,A
8-NS,467,0,370,0,0,370,T
8-NS,468,0,365,0,0,365,T
8-NS,469,0,0,370,0,370,G
8-NS,470,0,362,0,0,362,T
8-NS,471,1,359,0,1,361,T
8-NS,472,0,0,366,0,366,G
8-NS,473,0,0,361,0,361,G
8-NS,474,1,0,0,360,361,C
8-NS,475,0,1,364,0,365,G
8-NS,476,366,0,0,0,366,A
8-NS,477,373,0,0,0,373,A
8-NS,478,373,0,0,0,373,A
8-NS,479,0,376,0,0,376,T
8-NS,480,1,0,0,374,375,C
8-NS,481,0,371,0,0,371,T
8-NS,482,2,0,0,372,374,C
8-NS,483,374,0,0,0,374,A
8-NS,484,1,0,0,374,375,C
8-NS,485,1,0,0,371,372,C
8-NS,486,369,0,0,0,369,A
8-NS,487,0,368,0,0,368,T
8-NS,488,0,358,0,0,358,T
8-NS,489,0,0,356,0,356,G
8-NS,490,0,0,0,352,352,C
8-NS,491,0,0,0,354,354,C
8-NS,492,0,354,0,0,354,T
8-NS,493,0,349,0,0,349,T
8-NS,494,0,0,0,351,351,C
8-NS,495,0,350,0,0,350,T
8-NS,496,0,353,0,0,353,T
8-NS,497,0,362,0,0,362,T
8-NS,498,0,359,0,0,359,T
8-NS,499,0,0,0,360,360,C
8-NS,500,0,0,0,361,361,C
8-NS,501,360,0,0,0,360,A
8-NS,502,0,0,364,0,364,G
8-NS,503,0,1,360,0,361,G
8-NS,504,367,0,0,0,367,A
8-NS,505,0,1,0,364,365,C
8-NS,506,368,0,0,0,368,A
8-NS,507,0,371,0,0,371,T
8-NS,508,371,0,0,0,371,A
8-NS,509,0,0,0,389,389,C
8-NS,510,0,388,0,0,388,T
8-NS,511,387,0,0,0,387,A
8-NS,512,0,381,0,0,381,T
8-NS,513,0,373,0,0,373,T
8-NS,514,0,1,371,0,372,G
8-NS,515,359,0,0,0,359,A
8-NS,516,0,1,360,0,361,G
8-NS,517,0,0,362,0,362,G
8-NS,518,335,0,0,0,335,A
8-NS,519,0,338,0,0,338,T
8-NS,520,0,0,335,0,335,G
8-NS,521,0,333,0,1,334,T
8-NS,522,0,1,0,336,337,C
8-NS,523,336,0,0,0,336,A
8-NS,524,335,0,0,0,335,A
8-NS,525,333,0,0,0,333,A
8-NS,526,335,0,0,0,335,A
8-NS,527,335,0,0,0,335,A
8-NS,528,0,333,0,0,333,T
8-NS,529,0,0,335,0,335,G
8-NS,530,0,0,0,336,336,C
8-NS,531,339,0,0,0,339,A
8-NS,532,339,0,0,0,339,A
8-NS,533,0,341,0,0,341,T
8-NS,534,0,340,0,0,340,T
8-NS,535,0,2,337,0,339,G
8-NS,536,0,0,336,0,336,G
8-NS,537,0,0,336,0,336,G
8-NS,538,0,0,338,0,338,G
8-NS,539,0,333,0,0,333,T
8-NS,540,1,0,0,332,333,C
8-NS,541,0,0,1,334,335,C
8-NS,542,0,342,0,1,343,T
8-NS,543,1,0,0,342,343,C
8-NS,544,347,0,0,0,347,A
8-NS,545,0,337,0,0,337,T
8-NS,546,1,0,0,342,343,C
8-NS,547,0,1,344,0,345,G
8-NS,548,0,0,342,0,342,G
8-NS,549,331,0,0,0,331,A
8-NS,550,0,0,333,0,333,G
8-NS,551,0,0,329,0,329,G
8-NS,552,324,0,1,0,325,A
8-NS,553,0,0,0,342,342,C
8-NS,554,0,339,0,0,339,T
8-NS,555,0,337,0,1,338,T
8-NS,556,0,0,342,0,342,G
8-NS,557,342,0,0,0,342,A
8-NS,558,340,0,0,1,341,A
8-NS,559,0,339,0,0,339,T
8-NS,560,0,0,334,0,334,G
8-NS,561,0,1,342,0,343,G
8-NS,562,335,0,0,0,335,A
8-NS,563,340,0,0,0,340,A
8-NS,564,0,348,0,1,349,T
8-NS,565,0,1,350,0,351,G
8-NS,566,354,0,0,0,354,A
8-NS,567,0,356,0,0,356,T
8-NS,568,354,0,0,0,354,A
8-NS,569,355,0,1,0,356,A
8-NS,570,0,0,0,354,354,C
8-NS,571,345,0,0,0,345,A
8-NS,572,0,0,0,347,347,C
8-NS,573,325,0,0,0,325,A
8-NS,574,1,0,327,0,328,G
8-NS,575,0,323,0,0,323,T
8-NS,576,0,325,0,0,325,T
8-NS,577,0,0,0,325,325,C
8-NS,578,1,1,319,0,321,G
8-NS,579,316,0,1,0,317,A
8-NS,580,0,0,326,0,326,G
8-NS,581,0,316,0,0,316,T
8-NS,582,0,0,0,323,323,C
8-NS,583,0,316,0,0,316,T
8-NS,584,0,0,0,313,313,C
8-NS,585,0,320,0,0,320,T
8-NS,586,321,0,0,0,321,A
8-NS,587,321,0,0,0,321,A
8-NS,588,321,0,0,0,321,A
8-NS,589,323,0,0,0,323,A
8-NS,590,319,1,0,0,320,A
8-NS,591,0,317,1,0,318,T
8-NS,592,1,0,0,329,330,C
8-NS,593,0,328,0,0,328,T
8-NS,594,323,0,0,0,323,A
8-NS,595,0,0,0,326,326,C
8-NS,596,327,0,0,0,327,A
8-NS,597,0,0,325,0,325,G
8-NS,598,322,0,0,0,322,A
8-NS,599,0,0,319,0,319,G
8-NS,600,322,0,0,0,322,A
8-NS,601,0,311,0,0,311,T
8-NS,602,0,312,0,0,312,T
8-NS,603,0,0,0,313,313,C
8-NS,604,0,0,315,0,315,G
8-NS,605,0,0,0,317,317,C
8-NS,606,0,315,0,0,315,T
8-NS,607,0,319,0,0,319,T
8-NS,608,0,1,316,0,317,G
8-NS,609,0,2,316,0,318,G
8-NS,610,314,1,0,0,315,A
8-NS,611,0,1,314,0,315,G
8-NS,612,315,0,0,0,315,A
8-NS,613,313,0,0,0,313,A
8-NS,614,0,1,314,0,315,G
8-NS,615,0,0,0,316,316,C
8-NS,616,312,0,0,0,312,A
8-NS,617,0,0,312,0,312,G
8-NS,618,0,313,0,0,313,T
8-NS,619,315,0,0,0,315,A
8-NS,620,316,0,0,0,316,A
8-NS,621,0,317,0,0,317,T
8-NS,622,0,0,316,0,316,G
8-NS,623,306,0,0,0,306,A
8-NS,624,0,1,315,0,316,G
8-NS,625,314,0,0,0,314,A
8-NS,626,292,0,0,0,292,A
8-NS,627,0,294,0,0,294,T
8-NS,628,0,0,293,0,293,G
8-NS,629,0,1,296,0,297,G
8-NS,630,0,2,291,0,293,G
8-NS,631,0,1,293,0,294,G
8-NS,632,0,1,297,0,298,G
8-NS,633,291,0,0,0,291,A
8-NS,634,0,1,0,289,290,C
8-NS,635,1,1,0,297,299,C
8-NS,636,0,276,0,0,276,T
8-NS,637,1,0,0,279,280,C
8-NS,638,0,0,0,281,281,C
8-NS,639,278,0,0,0,278,A
8-NS,640,0,0,0,283,283,C
8-NS,641,0,278,0,0,278,T
8-NS,642,0,277,0,0,277,T
8-NS,643,263,0,0,0,263,A
8-NS,644,0,0,0,266,266,C
8-NS,645,0,264,0,1,265,T
8-NS,646,1,0,0,267,268,C
8-NS,647,0,0,0,263,263,C
8-NS,648,260,0,1,0,261,A
8-NS,649,260,0,1,0,261,A
8-NS,650,262,0,0,0,262,A
8-NS,651,259,1,0,0,260,A
8-NS,652,0,0,0,260,260,C
8-NS,653,250,0,0,0,250,A
8-NS,654,0,0,248,0,248,G
8-NS,655,246,0,0,0,246,A
8-NS,656,246,0,0,0,246,A
8-NS,657,248,0,0,0,248,A
8-NS,658,0,0,0,245,245,C
8-NS,659,2,0,249,0,251,G
8-NS,660,0,0,252,0,252,G
8-NS,661,0,0,256,0,256,G
8-NS,662,255,0,0,0,255,A
8-NS,663,256,0,0,0,256,A
8-NS,664,256,0,0,0,256,A
8-NS,665,0,254,0,0,254,T
8-NS,666,0,0,254,0,254,G
8-NS,667,0,1,253,0,254,G
8-NS,668,0,3,0,248,251,C
8-NS,669,0,0,252,0,252,G
8-NS,670,252,0,0,0,252,A
8-NS,671,0,0,253,0,253,G
8-NS,672,252,0,0,0,252,A
8-NS,673,252,0,0,0,252,A
8-NS,674,0,0,0,253,253,C
8-NS,675,247,0,0,0,247,A
8-NS,676,0,0,245,0,245,G
8-NS,677,0,0,0,245,245,C
8-NS,678,0,243,0,0,243,T
8-NS,679,246,0,0,0,246,A
8-NS,680,0,1,243,0,244,G
8-NS,681,0,0,244,0,244,G
8-NS,682,0,242,0,0,242,T
8-NS,683,4,0,0,240,244,C
8-NS,684,243,0,0,0,243,A
8-NS,685,243,0,0,0,243,A
8-NS,686,244,0,0,0,244,A
8-NS,687,243,0,1,0,244,A
8-NS,688,0,0,244,0,244,G
8-NS,689,0,242,0,0,242,T
8-NS,690,0,240,0,0,240,T
8-NS,691,0,239,0,0,239,T
8-NS,692,0,0,241,0,241,G
8-NS,693,240,0,0,0,240,A
8-NS,694,241,0,0,0,241,A
8-NS,695,0,0,245,0,245,G
8-NS,696,238,0,0,0,238,A
8-NS,697,0,0,240,0,240,G
8-NS,698,240,0,0,0,240,A
8-NS,699,0,241,0,0,241,T
8-NS,700,243,0,0,0,243,A
8-NS,701,241,0,0,0,241,A
8-NS,702,0,0,241,0,241,G
8-NS,703,226,0,0,0,226,A
8-NS,704,0,223,0,0,223,T
8-NS,705,0,2,226,0,228,G
8-NS,706,0,0,227,0,227,G
8-NS,707,0,0,0,226,226,C
8-NS,708,0,224,0,0,224,T
8-NS,709,223,0,0,0,223,A
8-NS,710,222,0,0,0,222,A
8-NS,711,0,224,0,0,224,T
8-NS,712,0,222,0,0,222,T
8-NS,713,0,1,222,0,223,G
8-NS,714,222,0,0,0,222,A
8-NS,715,220,0,0,0,220,A
8-NS,716,0,0,217,0,217,G
8-NS,717,221,0,0,0,221,A
8-NS,718,220,0,0,0,220,A
8-NS,719,0,0,224,0,224,G
8-NS,720,0,217,0,0,217,T
8-NS,721,0,1,219,0,220,G
8-NS,722,219,0,0,0,219,A
8-NS,723,0,1,218,0,219,G
8-NS,724,219,0,0,0,219,A
8-NS,725,0,1,0,217,218,C
8-NS,726,213,0,0,0,213,A
8-NS,727,0,0,0,215,215,C
8-NS,728,193,0,0,0,193,A
8-NS,729,1,1,203,0,205,G
8-NS,730,206,0,0,0,206,A
8-NS,731,0,204,0,0,204,T
8-NS,732,0,203,0,0,203,T
8-NS,733,203,0,0,0,203,A
8-NS,734,203,0,0,0,203,A
8-NS,735,204,0,0,0,204,A
8-NS,736,201,0,2,0,203,A
8-NS,737,202,0,0,0,202,A
8-NS,738,0,0,0,193,193,C
8-NS,739,183,0,0,0,183,A
8-NS,740,183,0,0,0,183,A
8-NS,741,0,0,0,182,182,C
8-NS,742,0,181,0,0,181,T
8-NS,743,0,1,180,0,181,G
8-NS,744,179,0,0,0,179,A
8-NS,745,180,0,0,0,180,A
8-NS,746,181,0,0,0,181,A
8-NS,747,179,0,0,0,179,A
8-NS,748,0,179,0,0,179,T
8-NS,749,174,0,0,0,174,A
8-NS,750,0,0,177,0,177,G
8-NS,751,0,0,0,176,176,C
8-NS,752,0,174,0,0,174,T
8-NS,753,0,175,0,0,175,T
8-NS,754,0,173,0,0,173,T
8-NS,755,0,0,174,0,174,G
8-NS,756,174,0,0,0,174,A
8-NS,757,172,0,0,0,172,A
8-NS,758,0,0,0,174,174,C
8-NS,759,169,0,0,0,169,A
8-NS,760,166,0,0,0,166,A
8-NS,761,169,0,0,0,169,A
8-NS,762,0,168,0,0,168,T
8-NS,763,170,0,0,0,170,A
8-NS,764,169,0,0,0,169,A
8-NS,765,0,0,0,171,171,C
8-NS,766,172,0,0,0,172,A
8-NS,767,0,166,0,0,166,T
8-NS,768,0,162,0,1,163,T
8-NS,769,1,0,0,160,161,C
8-NS,770,160,0,0,0,160,A
8-NS,771,0,160,0,0,160,T
8-NS,772,0,0,159,0,159,G
8-NS,773,0,0,0,160,160,C
8-NS,774,159,0,0,0,159,A
8-NS,775,161,0,0,0,161,A
8-NS,776,0,0,159,0,159,G
8-NS,777,0,0,0,162,162,C
8-NS,778,160,0,0,0,160,A
8-NS,779,0,158,0,0,158,T
8-NS,780,0,157,0,0,157,T
8-NS,781,158,0,0,0,158,A
8-NS,782,0,1,0,157,158,C
8-NS,783,156,0,0,0,156,A
8-NS,784,154,0,0,0,154,A
8-NS,785,0,0,0,154,154,C
8-NS,786,0,134,0,0,134,T
8-NS,787,1,0,133,0,134,G
8-NS,788,0,0,0,131,131,C
8-NS,789,0,126,0,0,126,T
8-NS,790,0,0,125,0,125,G
8-NS,791,0,124,0,0,124,T
8-NS,792,0,123,0,0,123,T
8-NS,793,0,124,0,0,124,T
8-NS,794,0,0,123,0,123,G
8-NS,795,124,0,0,0,124,A
8-NS,796,121,0,0,0,121,A
8-NS,797,0,0,120,0,120,G
8-NS,798,0,118,0,0,118,T
8-NS,799,0,0,115,0,115,G
8-NS,800,0,0,116,0,116,G
8-NS,801,116,0,0,0,116,A
8-NS,802,116,0,0,0,116,A
8-NS,803,0,0,0,114,114,C
8-NS,804,113,0,0,0,113,A
8-NS,805,0,0,111,0,111,G
8-NS,806,0,0,110,0,110,G
8-NS,807,110,0,0,0,110,A
8-NS,808,0,0,108,0,108,G
8-NS,809,95,0,0,0,95,A
8-NS,810,0,95,0,0,95,T
8-NS,811,93,0,0,0,93,A
8-NS,812,90,0,0,0,90,A
8-NS,813,0,0,93,0,93,G
8-NS,814,84,0,0,0,84,A
8-NS,815,82,0,0,0,82,A
8-NS,816,0,0,0,83,83,C
8-NS,817,0,71,0,0,71,T
8-NS,818,0,69,0,0,69,T
8-NS,819,0,67,0,0,67,T
8-NS,820,0,0,0,68,68,C
8-NS,821,0,68,0,0,68,T
8-NS,822,0,0,0,66,66,C
8-NS,823,63,0,0,0,63,A
8-NS,824,0,63,0,0,63,T
8-NS,825,0,61,0,0,61,T
8-NS,826,0,60,0,0,60,T
8-NS,827,0,0,0,60,60,C
8-NS,828,61,0,0,0,61,A
8-NS,829,0,0,60,0,60,G
8-NS,830,0,0,0,60,60,C
8-NS,831,0,55,0,0,55,T
8-NS,832,0,54,0,0,54,T
8-NS,833,54,0,0,0,54,A
8-NS,834,0,53,0,0,53,T
8-NS,835,0,55,0,0,55,T
8-NS,836,0,54,0,0,54,T
8-NS,837,50,0,0,0,50,A
8-NS,838,50,0,0,0,50,A
8-NS,839,1,48,0,0,49,T
8-NS,840,0,0,49,0,49,G
8-NS,841,46,0,0,0,46,A
8-NS,842,0,40,0,0,40,T
8-NS,843,39,0,0,0,39,A
8-NS,844,38,0,0,0,38,A
8-NS,845,39,0,0,0,39,A
8-NS,846,38,0,0,0,38,A
8-NS,847,36,0,0,0,36,A
8-NS,848,35,0,0,0,35,A
8-NS,849,0,0,0,35,35,C
8-NS,850,25,0,0,0,25,A
8-NS,851,0,0,0,25,25,C
8-NS,852,0,0,0,25,25,C
8-NS,853,0,0,0,23,23,C
8-NS,854,0,22,0,0,22,T
8-NS,855,0,18,0,0,18,T
8-NS,856,0,0,19,0,19,G
8-NS,857,0,16,0,0,16,T
8-NS,858,0,18,0,0,18,T
8-NS,859,0,18,0,0,18,T
8-NS,860,0,0,0,6,6,C
8-NS,861,0,4,0,0,4,T
8-NS,862,4,0,0,0,4,A
8-NS,863,0,0,0,4,4,C
