Gene,Position,A,T,G,C,Coverage,Consensus
1-PB2,1,616,0,0,0,616,A
1-PB2,2,0,615,0,0,615,T
1-PB2,3,0,0,634,0,634,G
1-PB2,4,0,1,635,0,636,G
1-PB2,5,628,0,1,0,629,A
1-PB2,6,629,0,2,0,631,A
1-PB2,7,635,0,1,0,636,A
1-PB2,8,0,4,720,0,724,G
1-PB2,9,722,0,0,0,722,A
1-PB2,10,732,0,1,0,733,A
1-PB2,11,0,750,0,0,750,T
1-PB2,12,750,0,0,0,750,A
1-PB2,13,749,0,2,0,751,A
1-PB2,14,752,0,0,0,752,A
1-PB2,15,752,0,2,0,754,A
1-PB2,16,0,2,780,0,782,G
1-PB2,17,777,0,1,0,778,A
1-PB2,18,780,2,0,0,782,A
1-PB2,19,0,0,0,799,799,C
1-PB2,20,1,802,0,0,803,T
1-PB2,21,821,0,0,0,821,A
1-PB2,22,0,0,0,825,825,C
1-PB2,23,2,0,819,0,821,G
1-PB2,24,0,1,840,0,841,G
1-PB2,25,843,0,0,0,843,A
1-PB2,26,868,0,0,0,868,A
1-PB2,27,0,866,0,0,866,T
1-PB2,28,1,0,0,874,875,C
1-PB2,29,0,872,0,1,873,T
1-PB2,30,1,4,880,0,885,G
1-PB2,31,882,1,0,0,883,A
1-PB2,32,0,885,0,0,885,T
1-PB2,33,0,0,886,0,886,G
1-PB2,34,0,892,0,2,894,T
1-PB2,35,3,1,0,887,891,C
1-PB2,36,2,0,886,0,888,G
1-PB2,37,0,0,0,895,895,C
1-PB2,38,892,0,1,0,893,A
1-PB2,39,0,0,957,0,957,G
1-PB2,40,0,950,0,2,952,T
1-PB2,41,5,0,0,954,959,C
1-PB2,42,0,938,0,2,940,T
1-PB2,43,1,0,0,957,958,C
1-PB2,44,0,0,952,0,952,G
1-PB2,45,0,1,1,951,953,C
1-PB2,46,952,0,1,0,953,A
1-PB2,47,0,0,0,965,965,C
1-PB2,48,0,946,0,0,946,T
1-PB2,49,1,2,0,966,969,C
1-PB2,50,0,2,966,0,968,G
1-PB2,51,0,0,1,971,972,C
1-PB2,52,0,4,969,0,973,G
1-PB2,53,959,0,3,0,962,A
1-PB2,54,0,2,969,0,971,G
1-PB2,55,992,0,1,0,993,A
1-PB2,56,0,992,0,1,993,T
1-PB2,57,994,0,3,0,997,A
1-PB2,58,0,0,0,994,994,C
1-PB2,59,0,972,0,2,974,T
1-PB2,60,0,5,988,0,993,G
1-PB2,61,998,1,1,0,1000,A
1-PB2,62,0,0,0,999,999,C
1-PB2,63,1006,0,0,0,1006,A
1-PB2,64,991,0,1,0,992,A
1-PB2,65,1001,0,2,0,1003,A
1-PB2,66,1005,0,2,0,1007,A
1-PB2,67,1010,0,1,0,1011,A
1-PB2,68,0,0,0,1026,1026,C
1-PB2,69,3,0,0,1020,1023,C
1-PB2,70,1047,0,0,0,1047,A
1-PB2,71,0,0,0,1059,1059,C
1-PB2,72,1056,0,0,0,1056,A
1-PB2,73,0,0,1076,0,1076,G
1-PB2,74,1,1074,0,0,1075,T
1-PB2,75,0,2,1101,0,1103,G
1-PB2,76,2,2,1102,0,1106,G
1-PB2,77,1111,0,1,0,1112,A
1-PB2,78,0,0,0,1164,1164,C
1-PB2,79,4,0,0,1143,1147,C
1-PB2,80,1159,0,1,0,1160,A
1-PB2,81,0,1156,0,1,1157,T
1-PB2,82,1127,0,6,0,1133,A
1-PB2,83,0,1128,0,1,1129,T
1-PB2,84,0,3,1132,0,1135,G
1-PB2,85,1,1,1131,0,1133,G
1-PB2,86,0,0,0,1130,1130,C
1-PB2,87,1,0,0,1100,1101,C
1-PB2,88,1091,1,3,0,1095,A
1-PB2,89,0,1174,0,0,1174,T
1-PB2,90,1182,0,0,0,1182,A
1-PB2,91,1230,0,1,0,1231,A
1-PB2,92,0,1226,0,0,1226,T
1-PB2,93,0,1212,0,0,1212,T
1-PB2,94,1223,0,0,0,1223,A
1-PB2,95,1219,0,0,0,1219,A
1-PB2,96,0,0,1263,0,1263,G
1-PB2,97,1250,0,1,1,1252,A
1-PB2,98,1211,0,2,0,1213,A
1-PB2,99,2,1,1267,0,1270,G
1-PB2,100,0,1250,0,2,1252,T
1-PB2,101,1260,0,2,0,1262,A
1-PB2,102,0,1,0,1260,1261,C
1-PB2,103,1257,0,2,0,1259,A
1-PB2,104,1,1,0,1289,1291,C
1-PB2,105,1283,0,1,0,1284,A
1-PB2,106,0,1274,0,0,1274,T
1-PB2,107,5,0,0,1292,1297,C
1-PB2,108,2,4,1256,0,1262,G
1-PB2,109,1,4,1258,0,1263,G
1-PB2,110,0,1,1259,0,1260,G
1-PB2,111,2,3,1251,0,1256,G
1-PB2,112,1251,0,1,0,1252,A
1-PB2,113,0,2,1253,0,1255,G
1-PB2,114,1243,1,0,0,1244,A
1-PB2,115,1,1,0,1248,1250,C
1-PB2,116,1256,0,0,0,1256,A
1-PB2,117,0,1,1276,0,1277,G
1-PB2,118,0,2,1314,0,1316,G
1-PB2,119,1308,1,1,0,1310,A
1-PB2,120,1310,0,4,0,1314,A
1-PB2,121,1315,0,1,0,1316,A
1-PB2,122,1312,0,2,0,1314,A
1-PB2,123,0,1,1319,0,1320,G
1-PB2,124,1298,1,0,0,1299,A
1-PB2,125,1317,0,0,0,1317,A
1-PB2,126,1,0,0,1310,1311,C
1-PB2,127,1,1,0,1305,1307,C
1-PB2,128,4,1,0,1295,1300,C
1-PB2,129,0,0,1308,0,1308,G
1-PB2,130,0,1295,0,2,1297,T
1-PB2,131,3,0,0,1303,1306,C
1-PB2,132,1317,0,0,0,1317,A
1-PB2,133,0,0,0,1338,1338,C
1-PB2,134,0,1327,0,2,1329,T
1-PB2,135,0,1337,0,0,1337,T
1-PB2,136,1326,0,3,0,1329,A
1-PB2,137,0,2,1368,0,1370,G
1-PB2,138,1,0,1362,0,1363,G
1-PB2,139,1355,0,1,1,1357,A
1-PB2,140,0,1358,0,0,1358,T
1-PB2,141,0,4,1378,0,1382,G
1-PB2,142,1396,0,3,0,1399,A
1-PB2,143,1388,0,2,0,1390,A
1-PB2,144,1397,0,1,1,1399,A
1-PB2,145,0,1404,0,1,1405,T
1-PB2,146,0,1,1398,0,1399,G
1-PB2,147,2,2,1406,0,1410,G
1-PB2,148,1404,0,3,0,1407,A
1-PB2,149,0,1402,0,0,1402,T
1-PB2,150,0,4,1392,0,1396,G
1-PB2,151,1382,0,0,0,1382,A
1-PB2,152,0,1379,0,1,1380,T
1-PB2,153,0,6,1380,0,1386,G
1-PB2,154,0,1,1397,0,1398,G
1-PB2,155,2,0,1,1392,1395,C
1-PB2,156,1383,0,1,0,1384,A
1-PB2,157,1390,0,4,0,1394,A
1-PB2,158,0,1395,0,0,1395,T
1-PB2,159,2,2,1454,0,1458,G
1-PB2,160,1453,0,1,0,1454,A
1-PB2,161,1449,0,0,0,1449,A
1-PB2,162,1462,0,0,0,1462,A
1-PB2,163,0,1457,0,0,1457,T
1-PB2,164,1439,0,1,0,1440,A
1-PB2,165,0,1418,0,0,1418,T
1-PB2,166,4,0,1,1477,1482,C
1-PB2,167,4,0,0,1480,1484,C
1-PB2,168,1496,0,0,0,1496,A
1-PB2,169,1491,0,2,0,1493,A
1-PB2,170,0,1492,0,2,1494,T
1-PB2,171,2,1,0,1495,1498,C
1-PB2,172,1492,1,0,0,1493,A
1-PB2,173,0,0,0,1517,1517,C
1-PB2,174,0,1495,0,0,1495,T
1-PB2,175,0,0,1507,0,1507,G
1-PB2,176,0,1,0,1503,1504,C
1-PB2,177,0,1495,0,0,1495,T
1-PB2,178,1,7,1510,0,1518,G
1-PB2,179,1514,0,0,0,1514,A
1-PB2,180,0,0,0,1530,1530,C
1-PB2,181,1530,0,0,0,1530,A
1-PB2,182,1492,0,2,0,1494,A
1-PB2,183,1495,0,2,1,1498,A
1-PB2,184,1488,0,1,0,1489,A
1-PB2,185,0,2,1522,0,1524,G
1-PB2,186,0,0,1523,0,1523,G
1-PB2,187,1513,0,1,0,1514,A
1-PB2,188,0,1524,0,2,1526,T
1-PB2,189,1503,0,4,1,1508,A
1-PB2,190,1520,0,4,0,1524,A
1-PB2,191,1,2,0,1549,1552,C
1-PB2,192,1539,0,2,0,1541,A
1-PB2,193,0,1,1542,0,1543,G
1-PB2,194,1521,0,0,0,1521,A
1-PB2,195,1511,1,3,0,1515,A
1-PB2,196,1520,0,0,0,1520,A
1-PB2,197,0,1514,0,0,1514,T
1-PB2,198,3,3,1509,0,1515,G
1-PB2,199,0,0,1527,0,1527,G
1-PB2,200,1,1510,0,2,1513,T
1-PB2,201,1,1498,0,1,1500,T
1-PB2,202,2,0,0,1501,1503,C
1-PB2,203,3,2,0,1500,1505,C
1-PB2,204,0,1,1507,0,1508,G
1-PB2,205,3,3,1505,0,1511,G
1-PB2,206,1509,0,4,0,1513,A
1-PB2,207,0,3,1518,0,1521,G
1-PB2,208,1485,0,3,1,1489,A
1-PB2,209,0,3,1532,0,1535,G
1-PB2,210,1522,1,3,0,1526,A
1-PB2,211,1527,0,1,0,1528,A
1-PB2,212,1529,0,6,0,1535,A
1-PB2,213,2,1526,0,1,1529,T
1-PB2,214,1,7,1532,0,1540,G
1-PB2,215,1536,0,1,0,1537,A
1-PB2,216,1532,1,1,0,1534,A
1-PB2,217,0,0,0,1535,1535,C
1-PB2,218,1509,0,0,0,1509,A
1-PB2,219,1514,1,3,0,1518,A
1-PB2,220,0,2,1547,0,1549,G
1-PB2,221,0,3,1563,0,1566,G
1-PB2,222,1568,0,1,1,1570,A
1-PB2,223,0,0,0,1572,1572,C
1-PB2,224,1557,0,1,0,1558,A
1-PB2,225,1561,0,1,0,1562,A
1-PB2,226,1651,0,4,0,1655,A
1-PB2,227,0,0,0,1674,1674,C
1-PB2,228,0,1619,1,2,1622,T
1-PB2,229,5,0,0,1668,1673,C
1-PB2,230,0,1627,0,1,1628,T
1-PB2,231,1648,1,0,0,1649,A
1-PB2,232,0,1647,0,0,1647,T
1-PB2,233,0,1,1657,0,1658,G
1-PB2,234,0,3,1701,0,1704,G
1-PB2,235,1616,0,2,0,1618,A
1-PB2,236,2,0,1632,1,1635,G
1-PB2,237,0,1627,0,0,1627,T
1-PB2,238,1609,0,1,0,1610,A
1-PB2,239,1616,0,1,0,1617,A
1-PB2,240,1615,0,1,0,1616,A
1-PB2,241,1616,0,2,0,1618,A
1-PB2,242,0,1610,0,0,1610,T
1-PB2,243,0,9,1584,0,1593,G
1-PB2,244,1550,0,4,0,1554,A
1-PB2,245,1,0,1564,0,1565,G
1-PB2,246,1,1542,1,2,1546,T
1-PB2,247,1,3,1541,0,1545,G
1-PB2,248,1576,0,4,0,1580,A
1-PB2,249,0,1585,0,2,1587,T
1-PB2,250,2,0,1585,0,1587,G
1-PB2,251,0,0,0,1586,1586,C
1-PB2,252,0,1577,0,2,1579,T
1-PB2,253,1,2,1646,0,1649,G
1-PB2,254,1,2,1647,0,1650,G
1-PB2,255,1672,1,3,0,1676,A
1-PB2,256,1,1666,0,3,1670,T
1-PB2,257,6,0,0,1671,1677,C
1-PB2,258,1689,0,2,0,1691,A
1-PB2,259,0,4,1747,0,1751,G
1-PB2,260,1753,0,3,0,1756,A
1-PB2,261,0,1748,0,1,1749,T
1-PB2,262,1691,0,0,1,1692,A
1-PB2,263,0,6,1743,0,1749,G
1-PB2,264,1727,1,2,0,1730,A
1-PB2,265,0,0,1764,0,1764,G
1-PB2,266,1,1742,0,2,1745,T
1-PB2,267,1,3,1722,0,1726,G
1-PB2,268,1689,0,2,0,1691,A
1-PB2,269,0,1715,0,1,1716,T
1-PB2,270,2,1,1749,0,1752,G
1-PB2,271,1,0,1777,0,1778,G
1-PB2,272,0,1758,0,1,1759,T
1-PB2,273,1760,0,0,0,1760,A
1-PB2,274,0,1724,0,7,1731,T
1-PB2,275,4,0,1,1737,1742,C
1-PB2,276,1781,0,1,0,1782,A
1-PB2,277,0,0,0,1817,1817,C
1-PB2,278,3,0,0,1814,1817,C
1-PB2,279,0,1767,0,2,1769,T
1-PB2,280,0,1753,0,3,1756,T
1-PB2,281,0,1757,0,3,1760,T
1-PB2,282,1,4,1785,0,1790,G
1-PB2,283,0,1,1795,0,1796,G
1-PB2,284,0,2,0,1813,1815,C
1-PB2,285,0,1772,0,1,1773,T
1-PB2,286,1,1,1772,0,1774,G
1-PB2,287,0,1781,0,0,1781,T
1-PB2,288,1785,0,0,0,1785,A
1-PB2,289,1794,0,5,0,1799,A
1-PB2,290,0,0,0,1794,1794,C
1-PB2,291,1765,0,0,0,1765,A
1-PB2,292,0,1763,0,0,1763,T
1-PB2,293,0,4,1732,0,1736,G
1-PB2,294,0,0,1773,0,1773,G
1-PB2,295,1,1740,0,0,1741,T
1-PB2,296,1,4,1731,1,1737,G
1-PB2,297,1,2,1773,0,1776,G
1-PB2,298,1766,0,1,0,1767,A
1-PB2,299,1771,0,3,1,1775,A
1-PB2,300,1,1779,0,0,1780,T
1-PB2,301,1770,1,2,0,1773,A
1-PB2,302,1,1,1797,0,1799,G
1-PB2,303,1745,0,1,0,1746,A
1-PB2,304,1750,0,2,0,1752,A
1-PB2,305,1753,1,1,0,1755,A
1-PB2,306,0,1710,0,1,1711,T
1-PB2,307,1,4,1700,0,1705,G
1-PB2,308,0,4,1691,0,1695,G
1-PB2,309,1698,0,6,0,1704,A
1-PB2,310,1,0,0,1702,1703,C
1-PB2,311,2,0,0,1667,1669,C
1-PB2,312,0,0,0,1663,1663,C
1-PB2,313,2,1,1674,0,1677,G
1-PB2,314,1,1684,0,1,1686,T
1-PB2,315,0,7,1707,0,1714,G
1-PB2,316,1716,0,2,0,1718,A
1-PB2,317,2,1,0,1715,1718,C
1-PB2,318,1714,0,2,0,1716,A
1-PB2,319,1704,0,1,0,1705,A
1-PB2,320,1,0,1749,0,1750,G
1-PB2,321,0,1744,1,1,1746,T
1-PB2,322,1743,0,2,0,1745,A
1-PB2,323,0,0,0,1731,1731,C
1-PB2,324,1,1,1681,0,1683,G
1-PB2,325,0,0,1747,0,1747,G
1-PB2,326,0,1740,0,1,1741,T
1-PB2,327,3,1,0,1750,1754,C
1-PB2,328,1,0,0,1757,1758,C
1-PB2,329,1724,0,1,0,1725,A
1-PB2,330,0,1726,0,2,1728,T
1-PB2,331,1,1728,0,0,1729,T
1-PB2,332,1844,0,0,0,1844,A
1-PB2,333,1,1,1,1821,1824,C
1-PB2,334,2,1,1,1798,1802,C
1-PB2,335,5,0,0,1780,1785,C
1-PB2,336,1759,1,2,1,1763,A
1-PB2,337,1766,0,0,0,1766,A
1-PB2,338,1768,0,0,0,1768,A
1-PB2,339,1772,0,1,0,1773,A
1-PB2,340,0,1,1783,0,1784,G
1-PB2,341,0,1660,0,0,1660,T
1-PB2,342,1,0,1691,0,1692,G
1-PB2,343,0,1695,0,0,1695,T
1-PB2,344,1696,1,1,0,1698,A
1-PB2,345,0,0,0,1695,1695,C
1-PB2,346,1692,0,0,0,1692,A
1-PB2,347,1688,1,0,0,1689,A
1-PB2,348,1645,0,1,0,1646,A
1-PB2,349,1670,0,1,0,1671,A
1-PB2,350,0,0,0,1666,1666,C
1-PB2,351,0,1660,0,0,1660,T
1-PB2,352,0,1669,0,1,1670,T
1-PB2,353,1670,0,0,0,1670,A
1-PB2,354,0,1666,0,0,1666,T
1-PB2,355,0,1663,0,2,1665,T
1-PB2,356,0,1662,0,0,1662,T
1-PB2,357,2,3,0,1649,1654,C
1-PB2,358,0,6,1647,0,1653,G
1-PB2,359,1648,0,2,1,1651,A
1-PB2,360,0,0,0,1652,1652,C
1-PB2,361,1642,0,0,0,1642,A
1-PB2,362,1639,0,0,0,1639,A
1-PB2,363,1643,0,2,0,1645,A
1-PB2,364,0,2,1672,0,1674,G
1-PB2,365,0,1674,0,1,1675,T
1-PB2,366,7,1,1,1672,1681,C
1-PB2,367,0,0,1681,0,1681,G
1-PB2,368,1657,0,2,0,1659,A
1-PB2,369,1673,0,1,0,1674,A
1-PB2,370,1669,0,0,0,1669,A
1-PB2,371,0,3,1731,0,1734,G
1-PB2,372,0,0,1749,0,1749,G
1-PB2,373,0,1713,0,0,1713,T
1-PB2,374,0,1712,0,1,1713,T
1-PB2,375,1707,0,1,0,1708,A
1-PB2,376,1706,0,3,0,1709,A
1-PB2,377,1712,0,2,0,1714,A
1-PB2,378,1731,0,1,0,1732,A
1-PB2,379,0,0,0,1742,1742,C
1-PB2,380,1630,0,4,0,1634,A
1-PB2,381,0,1623,0,1,1624,T
1-PB2,382,1,3,1617,0,1621,G
1-PB2,383,1,2,1606,0,1609,G
1-PB2,384,1617,0,2,0,1619,A
1-PB2,385,1626,0,0,0,1626,A
1-PB2,386,0,0,0,1672,1672,C
1-PB2,387,5,0,0,1684,1689,C
1-PB2,388,0,1656,0,1,1657,T
1-PB2,389,0,1650,0,1,1651,T
1-PB2,390,0,1657,0,1,1658,T
1-PB2,391,0,7,1637,0,1644,G
1-PB2,392,1,4,1640,1,1646,G
1-PB2,393,1,2,0,1650,1653,C
1-PB2,394,3,0,0,1632,1635,C
1-PB2,395,0,4,0,1628,1632,C
1-PB2,396,0,1550,0,5,1555,T
1-PB2,397,0,0,1585,1,1586,G
1-PB2,398,0,1575,1,1,1577,T
1-PB2,399,0,1579,0,0,1579,T
1-PB2,400,9,1,0,1579,1589,C
1-PB2,401,1557,1,0,0,1558,A
1-PB2,402,0,1557,0,0,1557,T
1-PB2,403,0,1546,0,3,1549,T
1-PB2,404,0,1542,0,0,1542,T
1-PB2,405,0,1548,0,0,1548,T
1-PB2,406,1520,0,0,0,1520,A
1-PB2,407,0,1,1520,0,1521,G
1-PB2,408,1507,0,1,0,1508,A
1-PB2,409,1511,0,0,0,1511,A
1-PB2,410,1519,0,0,0,1519,A
1-PB2,411,0,1504,0,0,1504,T
1-PB2,412,3,0,0,1518,1521,C
1-PB2,413,1507,0,0,1,1508,A
1-PB2,414,1529,0,3,0,1532,A
1-PB2,415,0,0,1543,0,1543,G
1-PB2,416,0,1538,0,0,1538,T
1-PB2,417,6,0,0,1526,1532,C
1-PB2,418,1535,0,3,0,1538,A
1-PB2,419,1539,1,1,0,1541,A
1-PB2,420,0,0,1550,0,1550,G
1-PB2,421,1540,0,1,0,1541,A
1-PB2,422,0,1551,0,0,1551,T
1-PB2,423,1577,0,2,0,1579,A
1-PB2,424,0,0,0,1567,1567,C
1-PB2,425,0,0,1569,0,1569,G
1-PB2,426,0,0,0,1599,1599,C
1-PB2,427,1582,0,0,0,1582,A
1-PB2,428,0,0,1612,0,1612,G
1-PB2,429,1604,0,0,0,1604,A
1-PB2,430,1611,0,4,0,1615,A
1-PB2,431,0,5,1639,0,1644,G
1-PB2,432,1596,0,2,0,1598,A
1-PB2,433,0,0,1611,0,1611,G
1-PB2,434,0,1603,0,0,1603,T
1-PB2,435,1578,2,0,0,1580,A
1-PB2,436,0,3,1612,0,1615,G
1-PB2,437,1625,0,0,0,1625,A
1-PB2,438,0,0,0,1704,1704,C
1-PB2,439,1677,0,0,0,1677,A
1-PB2,440,0,1651,0,0,1651,T
1-PB2,441,1648,0,0,0,1648,A
1-PB2,442,1646,1,1,1,1649,A
1-PB2,443,1647,0,1,0,1648,A
1-PB2,444,1,0,0,1655,1656,C
1-PB2,445,0,0,0,1629,1629,C
1-PB2,446,1,1,0,1613,1615,C
1-PB2,447,1,1492,0,3,1496,T
1-PB2,448,0,1,1512,0,1513,G
1-PB2,449,1,0,1544,0,1545,G
1-PB2,450,1,1547,0,0,1548,T
1-PB2,451,11,1,1,1526,1539,C
1-PB2,452,1548,1,1,0,1550,A
1-PB2,453,0,1534,0,3,1537,T
1-PB2,454,0,0,1551,0,1551,G
1-PB2,455,0,0,0,1548,1548,C
1-PB2,456,1531,0,0,0,1531,A
1-PB2,457,0,5,1540,0,1545,G
1-PB2,458,1500,0,1,0,1501,A
1-PB2,459,0,0,0,1525,1525,C
1-PB2,460,2,0,0,1512,1514,C
1-PB2,461,1,1478,0,1,1480,T
1-PB2,462,3,1,0,1476,1480,C
1-PB2,463,1457,0,2,0,1459,A
1-PB2,464,2,1,1495,0,1498,G
1-PB2,465,0,1494,0,1,1495,T
1-PB2,466,0,0,1491,0,1491,G
1-PB2,467,0,1,0,1485,1486,C
1-PB2,468,5,2,0,1453,1460,C
1-PB2,469,1461,0,0,0,1461,A
1-PB2,470,1463,0,0,0,1463,A
1-PB2,471,1453,0,0,0,1453,A
1-PB2,472,1,2,1453,0,1456,G
1-PB2,473,1411,1,2,0,1414,A
1-PB2,474,0,0,1429,0,1429,G
1-PB2,475,0,0,1426,0,1426,G
1-PB2,476,0,0,0,1427,1427,C
1-PB2,477,1428,0,1,0,1429,A
1-PB2,478,1,0,0,1431,1432,C
1-PB2,479,1434,0,2,0,1436,A
1-PB2,480,1481,0,0,0,1481,A
1-PB2,481,1,0,1488,0,1489,G
1-PB2,482,1503,0,1,0,1504,A
1-PB2,483,0,1486,0,0,1486,T
1-PB2,484,2,0,1480,0,1482,G
1-PB2,485,0,1481,0,1,1482,T
1-PB2,486,1480,0,0,0,1480,A
1-PB2,487,1479,0,0,0,1479,A
1-PB2,488,0,1482,0,1,1483,T
1-PB2,489,1,1401,0,1,1403,T
1-PB2,490,1394,0,3,0,1397,A
1-PB2,491,0,1337,0,0,1337,T
1-PB2,492,1,2,1338,0,1341,G
1-PB2,493,0,0,1339,0,1339,G
1-PB2,494,1316,0,0,0,1316,A
1-PB2,495,1304,0,2,0,1306,A
1-PB2,496,1,0,1312,0,1313,G
1-PB2,497,0,1301,0,0,1301,T
1-PB2,498,0,1299,0,2,1301,T
1-PB2,499,0,0,1313,0,1313,G
1-PB2,500,0,1294,0,1,1295,T
1-PB2,501,1,1297,0,1,1299,T
1-PB2,502,0,1297,0,0,1297,T
1-PB2,503,0,1291,0,1,1292,T
1-PB2,504,0,1294,0,2,1296,T
1-PB2,505,2,0,0,1299,1301,C
1-PB2,506,1,1,0,1302,1304,C
1-PB2,507,4,0,0,1298,1302,C
1-PB2,508,1297,0,0,0,1297,A
1-PB2,509,1302,0,0,0,1302,A
1-PB2,510,0,1300,0,1,1301,T
1-PB2,511,1,2,1309,0,1312,G
1-PB2,512,1312,0,0,0,1312,A
1-PB2,513,1301,0,4,0,1305,A
1-PB2,514,1,0,1320,0,1321,G
1-PB2,515,1,1310,0,1,1312,T
1-PB2,516,1,1,1300,0,1302,G
1-PB2,517,1,0,1301,0,1302,G
1-PB2,518,0,2,1295,0,1297,G
1-PB2,519,1298,0,3,0,1301,A
1-PB2,520,0,1,1320,0,1321,G
1-PB2,521,1,2,0,1311,1314,C
1-PB2,522,2,1,0,1305,1308,C
1-PB2,523,1308,0,0,0,1308,A
1-PB2,524,0,1,1348,0,1349,G
1-PB2,525,0,3,1353,0,1356,G
1-PB2,526,1361,0,0,0,1361,A
1-PB2,527,0,1354,0,1,1355,T
1-PB2,528,1359,0,0,0,1359,A
1-PB2,529,0,0,0,1356,1356,C
1-PB2,530,0,1345,0,0,1345,T
1-PB2,531,1344,1,0,0,1345,A
1-PB2,532,1338,1,1,0,1340,A
1-PB2,533,1,0,0,1360,1361,C
1-PB2,534,1330,0,0,0,1330,A
1-PB2,535,0,1309,0,1,1310,T
1-PB2,536,0,0,0,1313,1313,C
1-PB2,537,1298,0,1,0,1299,A
1-PB2,538,0,2,1315,0,1317,G
1-PB2,539,1315,0,0,0,1315,A
1-PB2,540,1312,1,0,0,1313,A
1-PB2,541,0,1300,0,4,1304,T
1-PB2,542,4,0,0,1283,1287,C
1-PB2,543,1286,0,3,0,1289,A
1-PB2,544,0,3,0,1317,1320,C
1-PB2,545,1319,1,0,1,1321,A
1-PB2,546,1337,0,0,0,1337,A
1-PB2,547,0,1314,0,1,1315,T
1-PB2,548,1,1316,0,1,1318,T
1-PB2,549,1323,0,2,0,1325,A
1-PB2,550,1327,1,6,0,1334,A
1-PB2,551,0,0,0,1342,1342,C
1-PB2,552,1324,0,0,0,1324,A
1-PB2,553,1309,0,2,0,1311,A
1-PB2,554,0,1332,0,0,1332,T
1-PB2,555,1330,0,0,0,1330,A
1-PB2,556,1338,0,1,0,1339,A
1-PB2,557,0,0,0,1341,1341,C
1-PB2,558,0,1322,0,0,1322,T
1-PB2,559,1320,0,1,0,1321,A
1-PB2,560,1294,0,0,0,1294,A
1-PB2,561,1300,0,1,0,1301,A
1-PB2,562,2,2,1302,0,1306,G
1-PB2,563,1265,0,1,0,1266,A
1-PB2,564,1,1,1288,0,1290,G
1-PB2,565,1281,0,0,0,1281,A
1-PB2,566,1287,0,1,1,1289,A
1-PB2,567,1291,0,0,0,1291,A
1-PB2,568,1293,1,1,0,1295,A
1-PB2,569,1301,0,2,0,1303,A
1-PB2,570,1305,0,0,0,1305,A
1-PB2,571,1,2,1308,0,1311,G
1-PB2,572,1305,1,2,0,1308,A
1-PB2,573,1297,0,1,0,1298,A
1-PB2,574,0,1,1297,0,1298,G
1-PB2,575,1294,1,0,0,1295,A
1-PB2,576,1303,0,1,0,1304,A
1-PB2,577,1,0,0,1310,1311,C
1-PB2,578,0,1286,0,3,1289,T
1-PB2,579,2,0,0,1303,1305,C
1-PB2,580,1,2,0,1296,1299,C
1-PB2,581,1,0,1298,0,1299,G
1-PB2,582,1295,1,0,0,1296,A
1-PB2,583,0,2,1302,1,1305,G
1-PB2,584,1292,0,1,0,1293,A
1-PB2,585,0,1293,0,1,1294,T
1-PB2,586,0,1285,0,0,1285,T
1-PB2,587,0,0,1282,0,1282,G
1-PB2,588,0,0,0,1282,1282,C
1-PB2,589,1289,1,0,0,1290,A
1-PB2,590,1291,0,0,0,1291,A
1-PB2,591,1288,0,0,0,1288,A
1-PB2,592,1294,1,0,0,1295,A
1-PB2,593,0,1295,0,0,1295,T
1-PB2,594,0,1282,0,0,1282,T
1-PB2,595,0,1271,0,2,1273,T
1-PB2,596,2,1,0,1275,1278,C
1-PB2,597,1,1245,1,3,1250,T
1-PB2,598,5,0,0,1366,1371,C
1-PB2,599,3,0,0,1370,1373,C
1-PB2,600,3,1,0,1477,1481,C
1-PB2,601,0,1474,1,3,1478,T
1-PB2,602,0,1501,0,0,1501,T
1-PB2,603,1,2,1502,0,1505,G
1-PB2,604,1500,0,1,1,1502,A
1-PB2,605,0,1531,0,1,1532,T
1-PB2,606,1,3,1554,0,1558,G
1-PB2,607,1,0,1767,1,1769,G
1-PB2,608,0,1806,0,1,1807,T
1-PB2,609,0,1792,0,2,1794,T
1-PB2,610,1,0,1943,0,1944,G
1-PB2,611,1,0,0,1963,1964,C
1-PB2,612,2016,0,3,0,2019,A
1-PB2,613,0,2014,0,0,2014,T
1-PB2,614,2051,0,1,2,2054,A
1-PB2,615,1,3,0,2186,2190,C
1-PB2,616,2464,0,1,6,2471,A
1-PB2,617,0,2545,0,2,2547,T
1-PB2,618,1,0,2711,0,2712,G
1-PB2,619,0,2704,0,2,2706,T
1-PB2,620,0,2704,0,1,2705,T
1-PB2,621,2686,0,4,0,2690,A
1-PB2,622,0,11,2689,0,2700,G
1-PB2,623,2733,0,5,0,2738,A
1-PB2,624,0,7,2771,0,2778,G
1-PB2,625,2686,1,4,0,2691,A
1-PB2,626,0,8,2697,0,2705,G
1-PB2,627,2651,3,2,0,2656,A
1-PB2,628,1,4,2688,0,2693,G
1-PB2,629,2687,0,8,0,2695,A
1-PB2,630,2710,0,2,0,2712,A
1-PB2,631,1,1,0,2722,2724,C
1-PB2,632,0,2704,0,4,2708,T
1-PB2,633,0,2700,0,0,2700,T
1-PB2,634,0,1,2697,0,2698,G
1-PB2,635,0,2703,0,0,2703,T
1-PB2,636,2708,0,2,1,2711,A
1-PB2,637,2,2,0,2695,2699,C
1-PB2,638,1,3,2693,1,2698,G
1-PB2,639,2696,0,1,0,2697,A
1-PB2,640,2685,1,0,0,2686,A
1-PB2,641,2736,0,4,0,2740,A
1-PB2,642,2737,1,1,1,2740,A
1-PB2,643,2737,1,4,0,2742,A
1-PB2,644,0,1,0,2755,2756,C
1-PB2,645,2755,0,1,0,2756,A
1-PB2,646,2759,0,0,0,2759,A
1-PB2,647,1,8,2755,0,2764,G
1-PB2,648,2765,0,2,0,2767,A
1-PB2,649,0,2768,0,3,2771,T
1-PB2,650,0,2755,0,1,2756,T
1-PB2,651,1,2762,0,1,2764,T
1-PB2,652,7,0,0,2770,2777,C
1-PB2,653,0,2770,0,7,2777,T
1-PB2,654,3,0,0,2803,2806,C
1-PB2,655,3,2,0,2784,2789,C
1-PB2,656,3,1,0,2801,2805,C
1-PB2,657,2805,0,1,0,2806,A
1-PB2,658,2,1,2828,0,2831,G
1-PB2,659,0,2831,0,3,2834,T
1-PB2,660,0,2812,1,2,2815,T
1-PB2,661,1,0,2828,0,2829,G
1-PB2,662,1,1,0,2823,2825,C
1-PB2,663,0,2807,0,4,2811,T
1-PB2,664,2,1,2817,0,2820,G
1-PB2,665,1,0,2819,0,2820,G
1-PB2,666,2,0,1,2814,2817,C
1-PB2,667,2,2,2818,0,2822,G
1-PB2,668,0,7,2842,0,2849,G
1-PB2,669,2858,1,1,0,2860,A
1-PB2,670,2871,0,4,0,2875,A
1-PB2,671,0,2,0,2877,2879,C
1-PB2,672,2905,0,2,0,2907,A
1-PB2,673,2904,2,3,0,2909,A
1-PB2,674,0,0,3083,0,3083,G
1-PB2,675,0,2,0,3141,3143,C
1-PB2,676,3155,0,1,0,3156,A
1-PB2,677,2,1,3988,0,3991,G
1-PB2,678,0,3983,1,2,3986,T
1-PB2,679,3996,0,5,0,4001,A
1-PB2,680,0,4007,0,7,4014,T
1-PB2,681,4025,0,1,1,4027,A
1-PB2,682,0,4020,0,1,4021,T
1-PB2,683,3947,0,3,1,3951,A
1-PB2,684,0,1,0,3999,4000,C
1-PB2,685,3773,1,0,1,3775,A
1-PB2,686,0,3563,0,1,3564,T
1-PB2,687,0,3420,0,0,3420,T
1-PB2,688,0,2,3420,0,3422,G
1-PB2,689,3411,2,0,1,3414,A
1-PB2,690,3405,1,1,0,3407,A
1-PB2,691,2,0,3471,0,3473,G
1-PB2,692,0,3436,0,2,3438,T
1-PB2,693,0,3379,0,1,3380,T
1-PB2,694,1,3383,0,2,3386,T
1-PB2,695,0,3394,1,0,3395,T
1-PB2,696,3432,0,5,0,3437,A
1-PB2,697,0,0,0,3464,3464,C
1-PB2,698,3456,0,0,1,3457,A
1-PB2,699,1,3429,1,6,3437,T
1-PB2,700,1,3401,0,1,3403,T
1-PB2,701,2,3402,1,0,3405,T
1-PB2,702,0,18,3425,0,3443,G
1-PB2,703,3453,2,5,1,3461,A
1-PB2,704,0,0,1,3488,3489,C
1-PB2,705,0,3440,0,2,3442,T
1-PB2,706,3,1,0,3457,3461,C
1-PB2,707,3444,2,3,0,3449,A
1-PB2,708,11,5,3424,0,3440,G
1-PB2,709,2,5,3509,0,3516,G
1-PB2,710,1,6,3535,0,3542,G
1-PB2,711,3527,2,5,0,3534,A
1-PB2,712,3523,0,7,12,3542,A
1-PB2,713,0,2,0,3546,3548,C
1-PB2,714,4,0,3567,0,3571,G
1-PB2,715,0,3561,1,3,3565,T
1-PB2,716,0,1,3583,0,3584,G
1-PB2,717,1,3534,0,1,3536,T
1-PB2,718,1,3530,0,0,3531,T
1-PB2,719,2,11,3533,0,3546,G
1-PB2,720,0,6,3528,0,3534,G
1-PB2,721,2,10,3566,0,3578,G
1-PB2,722,3533,0,3,0,3536,A
1-PB2,723,3544,1,4,0,3549,A
1-PB2,724,0,0,0,3654,3654,C
1-PB2,725,3641,0,3,0,3644,A
1-PB2,726,3762,0,3,0,3765,A
1-PB2,727,3784,1,3,0,3788,A
1-PB2,728,0,3819,0,1,3820,T
1-PB2,729,0,0,3887,0,3887,G
1-PB2,730,0,3849,0,2,3851,T
1-PB2,731,3844,0,5,0,3849,A
1-PB2,732,1,1,0,3855,3857,C
1-PB2,733,3766,0,0,0,3766,A
1-PB2,734,1,2,0,3753,3756,C
1-PB2,735,0,3596,0,7,3603,T
1-PB2,736,8,1,0,3924,3933,C
1-PB2,737,3,0,0,3944,3947,C
1-PB2,738,4013,0,11,0,4024,A
1-PB2,739,3,8,4040,0,4051,G
1-PB2,740,1,1,4162,0,4164,G
1-PB2,741,1,4143,0,2,4146,T
1-PB2,742,5,6,4121,0,4132,G
1-PB2,743,0,3,4010,1,4014,G
1-PB2,744,3938,3,10,0,3951,A
1-PB2,745,1,5,3983,0,3989,G
1-PB2,746,2,10,3977,0,3989,G
1-PB2,747,3894,3,4,0,3901,A
1-PB2,748,0,2,3955,0,3957,G
1-PB2,749,1,3795,1,0,3797,T
1-PB2,750,0,12,3800,0,3812,G
1-PB2,751,3785,0,7,0,3792,A
1-PB2,752,0,4,3831,0,3835,G
1-PB2,753,1,5,3861,0,3867,G
1-PB2,754,3810,1,4,0,3815,A
1-PB2,755,3831,0,4,0,3835,A
1-PB2,756,0,3826,0,4,3830,T
1-PB2,757,1,11,3804,0,3816,G
1-PB2,758,3811,0,7,0,3818,A
1-PB2,759,1,1,0,3808,3810,C
1-PB2,760,1,7,3800,0,3808,G
1-PB2,761,3834,0,2,0,3836,A
1-PB2,762,1,3825,0,2,3828,T
1-PB2,763,4,1,3842,0,3847,G
1-PB2,764,1,3824,0,6,3831,T
1-PB2,765,0,3792,0,3,3795,T
1-PB2,766,1,22,3794,0,3817,G
1-PB2,767,3826,0,8,0,3834,A
1-PB2,768,1,2,0,3821,3824,C
1-PB2,769,9,0,0,3813,3822,C
1-PB2,770,3767,0,2,0,3769,A
1-PB2,771,3765,0,2,0,3767,A
1-PB2,772,3765,0,9,0,3774,A
1-PB2,773,0,0,3915,0,3915,G
1-PB2,774,4,0,0,3909,3913,C
1-PB2,775,2,2,0,3903,3907,C
1-PB2,776,0,3912,0,0,3912,T
1-PB2,777,3924,0,1,0,3925,A
1-PB2,778,3937,0,2,0,3939,A
1-PB2,779,0,3928,0,1,3929,T
1-PB2,780,0,3922,0,2,3924,T
1-PB2,781,3864,0,3,0,3867,A
1-PB2,782,0,3751,1,2,3754,T
1-PB2,783,1,3739,0,0,3740,T
1-PB2,784,1,0,3711,0,3712,G
1-PB2,785,0,1,0,3700,3701,C
1-PB2,786,1,4,3692,0,3697,G
1-PB2,787,1,0,3768,0,3769,G
1-PB2,788,0,1,0,3740,3741,C
1-PB2,789,6,0,0,3772,3778,C
1-PB2,790,3782,1,4,0,3787,A
1-PB2,791,1,5,3843,0,3849,G
1-PB2,792,0,8,3884,0,3892,G
1-PB2,793,3892,0,4,0,3896,A
1-PB2,794,3909,0,9,0,3918,A
1-PB2,795,1,0,0,3942,3943,C
1-PB2,796,3880,0,2,0,3882,A
1-PB2,797,0,3944,0,2,3946,T
1-PB2,798,3998,0,6,0,4004,A
1-PB2,799,1,1,4044,0,4046,G
1-PB2,800,1,3966,0,3,3970,T
1-PB2,801,3921,0,1,1,3923,A
1-PB2,802,3907,1,8,0,3916,A
1-PB2,803,0,2,3928,0,3930,G
1-PB2,804,3877,1,3,1,3882,A
1-PB2,805,3817,1,5,0,3823,A
1-PB2,806,1,2,3816,0,3819,G
1-PB2,807,3625,1,3,1,3630,A
1-PB2,808,0,0,3651,0,3651,G
1-PB2,809,2,0,0,3648,3650,C
1-PB2,810,3,2,0,3637,3642,C
1-PB2,811,1,2,3643,0,3646,G
1-PB2,812,1,0,0,3661,3662,C
1-PB2,813,3681,1,4,0,3686,A
1-PB2,814,1,0,3978,0,3979,G
1-PB2,815,0,3957,0,1,3958,T
1-PB2,816,3970,0,2,0,3972,A
1-PB2,817,0,3936,0,2,3938,T
1-PB2,818,7,2,0,3968,3977,C
1-PB2,819,3969,1,3,0,3973,A
1-PB2,820,1,0,3982,0,3983,G
1-PB2,821,0,1,0,3974,3975,C
1-PB2,822,3810,1,1,0,3812,A
1-PB2,823,0,3,3742,0,3745,G
1-PB2,824,3757,0,3,0,3760,A
1-PB2,825,1,3755,1,2,3759,T
1-PB2,826,11,0,0,3776,3787,C
1-PB2,827,11,1,0,3760,3772,C
1-PB2,828,3764,0,6,0,3770,A
1-PB2,829,1,2,0,3781,3784,C
1-PB2,830,2,3767,0,2,3771,T
1-PB2,831,3780,0,3,0,3783,A
1-PB2,832,1,1,3781,0,3783,G
1-PB2,833,1,2,0,3719,3722,C
1-PB2,834,3708,1,2,0,3711,A
1-PB2,835,1,3699,1,2,3703,T
1-PB2,836,5,2,0,3751,3758,C
1-PB2,837,0,3725,1,2,3728,T
1-PB2,838,1,3816,0,3,3820,T
1-PB2,839,0,3835,1,0,3836,T
1-PB2,840,3833,1,1,0,3835,A
1-PB2,841,1,3813,1,1,3816,T
1-PB2,842,0,3808,0,1,3809,T
1-PB2,843,4,9,3780,0,3793,G
1-PB2,844,1,6,3790,0,3797,G
1-PB2,845,3670,0,2,0,3672,A
1-PB2,846,1,2,3703,0,3706,G
1-PB2,847,3599,0,2,0,3601,A
1-PB2,848,0,3563,1,1,3565,T
1-PB2,849,3,2,3631,0,3636,G
1-PB2,850,0,3624,1,8,3633,T
1-PB2,851,3,1,3610,0,3614,G
1-PB2,852,1,1,0,3629,3631,C
1-PB2,853,4,1,0,3600,3605,C
1-PB2,854,3600,0,2,0,3602,A
1-PB2,855,1,1,0,3595,3597,C
1-PB2,856,3518,0,3,0,3521,A
1-PB2,857,6,3,3602,0,3611,G
1-PB2,858,1,1,1,3497,3500,C
1-PB2,859,3509,0,3,0,3512,A
1-PB2,860,1,0,0,3510,3511,C
1-PB2,861,3490,0,4,0,3494,A
1-PB2,862,0,2,0,3511,3513,C
1-PB2,863,3501,0,2,0,3503,A
1-PB2,864,3492,0,3,0,3495,A
1-PB2,865,3505,0,2,0,3507,A
1-PB2,866,0,3367,0,2,3369,T
1-PB2,867,0,3362,0,1,3363,T
1-PB2,868,0,3,3326,0,3329,G
1-PB2,869,2,0,3324,0,3326,G
1-PB2,870,2,5,0,3314,3321,C
1-PB2,871,1,8,3254,0,3263,G
1-PB2,872,1,3,3315,0,3319,G
1-PB2,873,3,8,3322,0,3333,G
1-PB2,874,3341,0,3,0,3344,A
1-PB2,875,1,1,0,3340,3342,C
1-PB2,876,3352,0,1,0,3353,A
1-PB2,877,3344,0,0,0,3344,A
1-PB2,878,3123,0,15,0,3138,A
1-PB2,879,1,1,3179,0,3181,G
1-PB2,880,3181,0,8,0,3189,A
1-PB2,881,0,3200,0,1,3201,T
1-PB2,882,0,6,3135,0,3141,G
1-PB2,883,3,0,3150,0,3153,G
1-PB2,884,0,3108,1,1,3110,T
1-PB2,885,0,6,3090,0,3096,G
1-PB2,886,1,2,3084,0,3087,G
1-PB2,887,3083,0,3,0,3086,A
1-PB2,888,0,0,0,3089,3089,C
1-PB2,889,3017,0,1,0,3018,A
1-PB2,890,0,3546,0,2,3548,T
1-PB2,891,0,3530,0,6,3536,T
1-PB2,892,12,2,0,3532,3546,C
1-PB2,893,0,3491,1,3,3495,T
1-PB2,894,0,3496,0,0,3496,T
1-PB2,895,3483,0,3,0,3486,A
1-PB2,896,2,6,3510,0,3518,G
1-PB2,897,3491,0,3,0,3494,A
1-PB2,898,0,0,0,3503,3503,C
1-PB2,899,2551,0,3,1,2555,A
1-PB2,900,0,5,2596,0,2601,G
1-PB2,901,2588,1,1,0,2590,A
1-PB2,902,2590,0,6,0,2596,A
1-PB2,903,0,4,0,2589,2593,C
1-PB2,904,2,1,0,2579,2582,C
1-PB2,905,7,2,1,2551,2561,C
1-PB2,906,0,12,2558,0,2570,G
1-PB2,907,2575,0,3,0,2578,A
1-PB2,908,1,0,0,2585,2586,C
1-PB2,909,1,2537,0,2,2540,T
1-PB2,910,1,3,2560,0,2564,G
1-PB2,911,2548,0,2,1,2551,A
1-PB2,912,2556,0,5,0,2561,A
1-PB2,913,0,7,2572,0,2579,G
1-PB2,914,2556,0,1,0,2557,A
1-PB2,915,2560,0,2,0,2562,A
1-PB2,916,1,1,0,2548,2550,C
1-PB2,917,2539,1,2,0,2542,A
1-PB2,918,2564,0,0,0,2564,A
1-PB2,919,0,0,2605,0,2605,G
1-PB2,920,0,0,0,2621,2621,C
1-PB2,921,0,2591,0,4,2595,T
1-PB2,922,1,0,2653,0,2654,G
1-PB2,923,0,2629,0,4,2633,T
1-PB2,924,3,2,2693,0,2698,G
1-PB2,925,2,3,2792,0,2797,G
1-PB2,926,2786,0,4,0,2790,A
1-PB2,927,0,2792,1,0,2793,T
1-PB2,928,2738,0,2,0,2740,A
1-PB2,929,0,2698,0,1,2699,T
1-PB2,930,2798,0,0,2,2800,A
1-PB2,931,0,2723,0,2,2725,T
1-PB2,932,1,1,2713,1,2716,G
1-PB2,933,0,0,0,2670,2670,C
1-PB2,934,2534,0,5,0,2539,A
1-PB2,935,2529,0,6,2,2537,A
1-PB2,936,1,1,2538,0,2540,G
1-PB2,937,0,0,2547,0,2547,G
1-PB2,938,2,1,0,2548,2551,C
1-PB2,939,0,2477,1,5,2483,T
1-PB2,940,1,0,2501,1,2503,G
1-PB2,941,3,2,0,2493,2498,C
1-PB2,942,2501,0,1,1,2503,A
1-PB2,943,2507,0,5,0,2512,A
1-PB2,944,0,2493,0,1,2494,T
1-PB2,945,0,7,2510,0,2517,G
1-PB2,946,1,1,2484,1,2487,G
1-PB2,947,3,5,2477,0,2485,G
1-PB2,948,2481,1,6,0,2488,A
1-PB2,949,0,2472,1,2,2475,T
1-PB2,950,1,2446,1,1,2449,T
1-PB2,951,1,8,2457,1,2467,G
1-PB2,952,2444,1,6,0,2451,A
1-PB2,953,0,6,2481,0,2487,G
1-PB2,954,2442,1,2,0,2445,A
1-PB2,955,2416,0,3,0,2419,A
1-PB2,956,0,2390,0,3,2393,T
1-PB2,957,8,1,0,2381,2390,C
1-PB2,958,2399,0,0,0,2399,A
1-PB2,959,2,3,2417,0,2422,G
1-PB2,960,0,2,0,2408,2410,C
1-PB2,961,0,2380,1,2,2383,T
1-PB2,962,7,1,0,2375,2383,C
1-PB2,963,2389,0,1,0,2390,A
1-PB2,964,1,2419,1,2,2423,T
1-PB2,965,4,0,0,2437,2441,C
1-PB2,966,2,0,0,2456,2458,C
1-PB2,967,1,2422,1,8,2432,T
1-PB2,968,2,2408,0,3,2413,T
1-PB2,969,5,1,0,2422,2428,C
1-PB2,970,2417,0,1,0,2418,A
1-PB2,971,1,0,2460,0,2461,G
1-PB2,972,1,1,0,2457,2459,C
1-PB2,973,0,2372,0,9,2381,T
1-PB2,974,0,2384,0,0,2384,T
1-PB2,975,0,2367,0,4,2371,T
1-PB2,976,0,6,2368,0,2374,G
1-PB2,977,3,2,2371,0,2376,G
1-PB2,978,0,2364,0,2,2366,T
1-PB2,979,0,6,2385,0,2391,G
1-PB2,980,0,3,2350,0,2353,G
1-PB2,981,2,0,2369,0,2371,G
1-PB2,982,0,2353,1,6,2360,T
1-PB2,983,0,2347,0,2,2349,T
1-PB2,984,0,2355,0,0,2355,T
1-PB2,985,2369,0,2,0,2371,A
1-PB2,986,0,1,1,2383,2385,C
1-PB2,987,2385,0,0,0,2385,A
1-PB2,988,0,2369,0,1,2370,T
1-PB2,989,0,2318,0,0,2318,T
1-PB2,990,1,2318,0,0,2319,T
1-PB2,991,2326,1,0,0,2327,A
1-PB2,992,2317,1,1,0,2319,A
1-PB2,993,2317,0,1,0,2318,A
1-PB2,994,2289,0,7,0,2296,A
1-PB2,995,1,8,2323,0,2332,G
1-PB2,996,2315,0,1,0,2316,A
1-PB2,997,2309,0,1,0,2310,A
1-PB2,998,2,0,0,2311,2313,C
1-PB2,999,2291,0,0,0,2291,A
1-PB2,1000,2288,1,3,0,2292,A
1-PB2,1001,0,1,2300,0,2301,G
1-PB2,1002,1,2,1,2297,2301,C
1-PB2,1003,1,11,2286,0,2298,G
1-PB2,1004,2,7,2300,0,2309,G
1-PB2,1005,2,0,2312,0,2314,G
1-PB2,1006,0,2294,0,6,2300,T
1-PB2,1007,9,1,0,2282,2292,C
1-PB2,1008,2300,0,5,0,2305,A
1-PB2,1009,0,2285,0,2,2287,T
1-PB2,1010,3,0,0,2304,2307,C
1-PB2,1011,2298,0,1,0,2299,A
1-PB2,1012,1,2,2359,0,2362,G
1-PB2,1013,0,2317,0,1,2318,T
1-PB2,1014,8,0,0,2317,2325,C
1-PB2,1015,2341,0,3,0,2344,A
1-PB2,1016,2356,0,1,1,2358,A
1-PB2,1017,2351,0,0,0,2351,A
1-PB2,1018,2348,0,2,2,2352,A
1-PB2,1019,2353,0,1,0,2354,A
1-PB2,1020,2341,0,18,0,2359,A
1-PB2,1021,0,3,2377,0,2380,G
1-PB2,1022,2372,1,0,0,2373,A
1-PB2,1023,2370,0,2,0,2372,A
1-PB2,1024,2,2,2368,1,2373,G
1-PB2,1025,2348,2,2,0,2352,A
1-PB2,1026,2299,0,7,0,2306,A
1-PB2,1027,2,3,2288,0,2293,G
1-PB2,1028,2274,0,4,0,2278,A
1-PB2,1029,1,4,2286,0,2291,G
1-PB2,1030,0,1,2351,0,2352,G
1-PB2,1031,1,2348,0,1,2350,T
1-PB2,1032,4,1,2392,0,2397,G
1-PB2,1033,2,3,0,2411,2416,C
1-PB2,1034,1,2396,0,4,2401,T
1-PB2,1035,0,2409,0,2,2411,T
1-PB2,1036,2417,0,1,0,2418,A
1-PB2,1037,0,3,0,2417,2420,C
1-PB2,1038,2385,0,1,0,2386,A
1-PB2,1039,1,2,2387,0,2390,G
1-PB2,1040,0,1,2379,0,2380,G
1-PB2,1041,0,2,1,2333,2336,C
1-PB2,1042,2308,1,0,0,2309,A
1-PB2,1043,2329,0,3,0,2332,A
1-PB2,1044,0,2371,0,3,2374,T
1-PB2,1045,2,0,0,2404,2406,C
1-PB2,1046,0,2379,0,6,2385,T
1-PB2,1047,3,0,0,2405,2408,C
1-PB2,1048,3,0,0,2389,2392,C
1-PB2,1049,2405,0,0,0,2405,A
1-PB2,1050,2400,0,1,0,2401,A
1-PB2,1051,2397,0,2,0,2399,A
1-PB2,1052,0,0,0,2423,2423,C
1-PB2,1053,2318,1,0,0,2319,A
1-PB2,1054,0,2287,2,0,2289,T
1-PB2,1055,0,2269,0,2,2271,T
1-PB2,1056,0,2,2320,0,2322,G
1-PB2,1057,2301,1,3,1,2306,A
1-PB2,1058,2354,0,4,0,2358,A
1-PB2,1059,2358,0,1,0,2359,A
1-PB2,1060,2365,0,2,0,2367,A
1-PB2,1061,0,2372,0,0,2372,T
1-PB2,1062,2376,0,1,0,2377,A
1-PB2,1063,2381,0,2,0,2383,A
1-PB2,1064,0,3,2451,0,2454,G
1-PB2,1065,2388,0,2,0,2390,A
1-PB2,1066,2,0,2508,0,2510,G
1-PB2,1067,1,2457,0,0,2458,T
1-PB2,1068,2479,0,0,0,2479,A
1-PB2,1069,1,1,0,2529,2531,C
1-PB2,1070,2511,2,5,0,2518,A
1-PB2,1071,0,2509,0,1,2510,T
1-PB2,1072,0,4,2508,0,2512,G
1-PB2,1073,2418,2,6,0,2426,A
1-PB2,1074,0,9,2467,1,2477,G
1-PB2,1075,2,4,2453,0,2459,G
1-PB2,1076,0,4,2597,0,2601,G
1-PB2,1077,3,0,2619,0,2622,G
1-PB2,1078,0,2567,0,2,2569,T
1-PB2,1079,2588,0,3,0,2591,A
1-PB2,1080,2,2559,0,4,2565,T
1-PB2,1081,0,3,2587,0,2590,G
1-PB2,1082,2563,1,5,0,2569,A
1-PB2,1083,0,6,2571,0,2577,G
1-PB2,1084,1,7,2517,0,2525,G
1-PB2,1085,2328,0,5,0,2333,A
1-PB2,1086,2,0,2392,0,2394,G
1-PB2,1087,1,2409,0,0,2410,T
1-PB2,1088,1,2481,0,2,2484,T
1-PB2,1089,7,2,0,2509,2518,C
1-PB2,1090,2529,1,5,0,2535,A
1-PB2,1091,0,0,0,2538,2538,C
1-PB2,1092,2526,0,0,0,2526,A
1-PB2,1093,2537,2,3,0,2542,A
1-PB2,1094,0,2533,0,0,2533,T
1-PB2,1095,1,4,2482,0,2487,G
1-PB2,1096,0,0,2492,0,2492,G
1-PB2,1097,0,2420,0,2,2422,T
1-PB2,1098,0,4,2419,0,2423,G
1-PB2,1099,2,5,2426,0,2433,G
1-PB2,1100,1,4,2427,0,2432,G
1-PB2,1101,2,2,2470,1,2475,G
1-PB2,1102,2456,0,2,0,2458,A
1-PB2,1103,2465,0,1,0,2466,A
1-PB2,1104,2454,0,4,0,2458,A
1-PB2,1105,2423,0,3,0,2426,A
1-PB2,1106,0,10,2450,0,2460,G
1-PB2,1107,2400,1,8,0,2409,A
1-PB2,1108,2,0,2443,0,2445,G
1-PB2,1109,3,1,0,2432,2436,C
1-PB2,1110,2421,1,1,0,2423,A
1-PB2,1111,2424,1,2,0,2427,A
1-PB2,1112,0,2,0,2510,2512,C
1-PB2,1113,2515,0,2,1,2518,A
1-PB2,1114,0,1,2566,0,2567,G
1-PB2,1115,0,1,0,2539,2540,C
1-PB2,1116,0,2520,0,2,2522,T
1-PB2,1117,2610,0,1,0,2611,A
1-PB2,1118,0,2611,0,0,2611,T
1-PB2,1119,2616,0,5,0,2621,A
1-PB2,1120,1,0,0,2621,2622,C
1-PB2,1121,0,2440,0,0,2440,T
1-PB2,1122,2468,0,0,0,2468,A
1-PB2,1123,2415,0,1,0,2416,A
1-PB2,1124,0,5,2419,0,2424,G
1-PB2,1125,2419,0,0,0,2419,A
1-PB2,1126,2328,1,0,1,2330,A
1-PB2,1127,2326,0,0,0,2326,A
1-PB2,1128,2319,0,2,0,2321,A
1-PB2,1129,0,1,2336,0,2337,G
1-PB2,1130,0,0,0,2317,2317,C
1-PB2,1131,2328,0,0,1,2329,A
1-PB2,1132,2329,0,3,1,2333,A
1-PB2,1133,0,1,0,2346,2347,C
1-PB2,1134,0,0,0,2356,2356,C
1-PB2,1135,2353,0,0,0,2353,A
1-PB2,1136,0,3,2371,0,2374,G
1-PB2,1137,2364,0,2,0,2366,A
1-PB2,1138,2369,0,1,0,2370,A
1-PB2,1139,1,3,2404,0,2408,G
1-PB2,1140,2377,1,2,0,2380,A
1-PB2,1141,0,2385,0,1,2386,T
1-PB2,1142,0,2375,0,0,2375,T
1-PB2,1143,1,4,2390,0,2395,G
1-PB2,1144,0,1,2437,0,2438,G
1-PB2,1145,0,2427,0,2,2429,T
1-PB2,1146,0,2419,0,1,2420,T
1-PB2,1147,1,1,0,2429,2431,C
1-PB2,1148,2469,0,3,0,2472,A
1-PB2,1149,1,3,2570,0,2574,G
1-PB2,1150,1,0,0,2593,2594,C
1-PB2,1151,0,2557,0,5,2562,T
1-PB2,1152,9,0,0,2595,2604,C
1-PB2,1153,2567,0,0,0,2567,A
1-PB2,1154,0,2577,0,2,2579,T
1-PB2,1155,2577,1,3,0,2581,A
1-PB2,1156,1,2,2595,0,2598,G
1-PB2,1157,0,2445,0,2,2447,T
1-PB2,1158,1,11,2440,0,2452,G
1-PB2,1159,2353,0,1,0,2354,A
1-PB2,1160,2,1,2402,0,2405,G
1-PB2,1161,0,2380,0,1,2381,T
1-PB2,1162,0,6,2371,0,2377,G
1-PB2,1163,0,2,2408,0,2410,G
1-PB2,1164,2401,0,0,0,2401,A
1-PB2,1165,2381,1,7,0,2389,A
1-PB2,1166,3,10,2400,0,2413,G
1-PB2,1167,2358,0,3,1,2362,A
1-PB2,1168,0,4,2385,0,2389,G
1-PB2,1169,2360,0,6,0,2366,A
1-PB2,1170,0,2,0,2373,2375,C
1-PB2,1171,1,8,2364,0,2373,G
1-PB2,1172,2366,0,2,0,2368,A
1-PB2,1173,2370,1,3,0,2374,A
1-PB2,1174,0,0,0,2391,2391,C
1-PB2,1175,2370,0,4,0,2374,A
1-PB2,1176,1,0,2550,0,2551,G
1-PB2,1177,0,2511,0,4,2515,T
1-PB2,1178,5,0,0,2515,2520,C
1-PB2,1179,2528,0,3,1,2532,A
1-PB2,1180,2510,0,4,0,2514,A
1-PB2,1181,0,2508,0,6,2514,T
1-PB2,1182,2507,0,2,1,2510,A
1-PB2,1183,4,1,2508,0,2513,G
1-PB2,1184,0,1,0,2499,2500,C
1-PB2,1185,2,3,0,2387,2392,C
1-PB2,1186,1,5,2382,0,2388,G
1-PB2,1187,2387,0,0,0,2387,A
1-PB2,1188,2392,2,2,0,2396,A
1-PB2,1189,0,1,2429,0,2430,G
1-PB2,1190,0,14,0,2454,2468,C
1-PB2,1191,2488,1,1,0,2490,A
1-PB2,1192,2488,0,3,0,2491,A
1-PB2,1193,2,2495,0,0,2497,T
1-PB2,1194,2511,0,0,0,2511,A
1-PB2,1195,2530,1,1,0,2532,A
1-PB2,1196,0,2522,1,1,2524,T
1-PB2,1197,7,2,0,2502,2511,C
1-PB2,1198,0,0,2498,0,2498,G
1-PB2,1199,1,2423,0,3,2427,T
1-PB2,1200,2,4,2413,0,2419,G
1-PB2,1201,1,2,2458,0,2461,G
1-PB2,1202,0,1,0,2457,2458,C
1-PB2,1203,2,1,0,2449,2452,C
1-PB2,1204,2435,0,1,0,2436,A
1-PB2,1205,0,2430,0,2,2432,T
1-PB2,1206,1,2,2441,0,2444,G
1-PB2,1207,0,0,2493,0,2493,G
1-PB2,1208,0,2478,0,2,2480,T
1-PB2,1209,0,0,2487,0,2487,G
1-PB2,1210,0,2424,0,2,2426,T
1-PB2,1211,0,2436,0,5,2441,T
1-PB2,1212,2,2441,0,3,2446,T
1-PB2,1213,1,2447,0,5,2453,T
1-PB2,1214,3,5,0,2521,2529,C
1-PB2,1215,2534,0,5,0,2539,A
1-PB2,1216,0,1,0,2830,2831,C
1-PB2,1217,2776,0,3,3,2782,A
1-PB2,1218,2838,0,3,1,2842,A
1-PB2,1219,0,1,2863,0,2864,G
1-PB2,1220,2816,0,2,0,2818,A
1-PB2,1221,288,6,2591,0,2885,G
1-PB2,1222,1,3,2924,0,2928,G
1-PB2,1223,2890,0,3,1,2894,A
1-PB2,1224,0,2899,0,2,2901,T
1-PB2,1225,1,2847,0,1,2849,T
1-PB2,1226,1,0,2842,0,2843,G
1-PB2,1227,2,2,0,2779,2783,C
1-PB2,1228,2808,1,2,0,2811,A
1-PB2,1229,1,2857,0,2,2860,T
1-PB2,1230,0,3,3023,0,3026,G
1-PB2,1231,3045,0,6,0,3051,A
1-PB2,1232,0,3075,0,2,3077,T
1-PB2,1233,3062,0,1,0,3063,A
1-PB2,1234,3043,1,0,0,3044,A
1-PB2,1235,3057,0,0,1,3058,A
1-PB2,1236,3069,0,3,0,3072,A
1-PB2,1237,1,0,3080,0,3081,G
1-PB2,1238,0,0,0,3168,3168,C
1-PB2,1239,3230,0,0,0,3230,A
1-PB2,1240,2,0,3369,0,3371,G
1-PB2,1241,0,3354,0,3,3357,T
1-PB2,1242,0,3350,0,1,3351,T
1-PB2,1243,3348,1,3,0,3352,A
1-PB2,1244,0,2,3390,1,3393,G
1-PB2,1245,3332,2,3,0,3337,A
1-PB2,1246,3,2,3370,0,3375,G
1-PB2,1247,0,3,3369,0,3372,G
1-PB2,1248,0,3232,0,2,3234,T
1-PB2,1249,2,25,3225,2,3254,G
1-PB2,1250,3273,0,7,0,3280,A
1-PB2,1251,0,0,0,3295,3295,C
1-PB2,1252,3,0,0,3303,3306,C
1-PB2,1253,0,3242,0,8,3250,T
1-PB2,1254,0,7,3279,0,3286,G
1-PB2,1255,3278,0,0,0,3278,A
1-PB2,1256,3271,0,0,0,3271,A
1-PB2,1257,1,3271,1,3,3276,T
1-PB2,1258,1,3291,0,1,3293,T
1-PB2,1259,0,3303,1,0,3304,T
1-PB2,1260,4,1,0,3333,3338,C
1-PB2,1261,4,0,3331,0,3335,G
1-PB2,1262,0,3313,0,12,3325,T
1-PB2,1263,9,1,0,3322,3332,C
1-PB2,1264,3330,1,2,0,3333,A
1-PB2,1265,3340,1,1,0,3342,A
1-PB2,1266,1,1,0,3344,3346,C
1-PB2,1267,3303,0,0,0,3303,A
1-PB2,1268,0,8,3368,1,3377,G
1-PB2,1269,3328,0,8,1,3337,A
1-PB2,1270,0,0,3365,0,3365,G
1-PB2,1271,1,0,0,3364,3365,C
1-PB2,1272,3355,0,2,0,3357,A
1-PB2,1273,3424,0,4,0,3428,A
1-PB2,1274,3419,1,2,0,3422,A
1-PB2,1275,0,3409,1,0,3410,T
1-PB2,1276,6,1,0,3421,3428,C
1-PB2,1277,3366,0,4,1,3371,A
1-PB2,1278,0,2,3379,0,3381,G
1-PB2,1279,0,2,1,3396,3399,C
1-PB2,1280,0,5,3400,0,3405,G
1-PB2,1281,1,0,3685,0,3686,G
1-PB2,1282,1,3662,0,3,3666,T
1-PB2,1283,0,3667,0,3,3670,T
1-PB2,1284,3,10,3653,0,3666,G
1-PB2,1285,3666,0,4,0,3670,A
1-PB2,1286,3716,0,3,0,3719,A
1-PB2,1287,0,2,0,3739,3741,C
1-PB2,1288,7,2,0,3733,3742,C
1-PB2,1289,10,0,0,3762,3772,C
1-PB2,1290,9,1,0,3577,3587,C
1-PB2,1291,3607,0,2,1,3610,A
1-PB2,1292,0,3634,0,5,3639,T
1-PB2,1293,1,0,3662,0,3663,G
1-PB2,1294,2,0,0,3670,3672,C
1-PB2,1295,3651,0,1,0,3652,A
1-PB2,1296,0,3620,0,8,3628,T
1-PB2,1297,3,1,0,3615,3619,C
1-PB2,1298,3578,0,5,0,3583,A
1-PB2,1299,0,2,3686,0,3688,G
1-PB2,1300,1,0,0,3710,3711,C
1-PB2,1301,0,3671,0,8,3679,T
1-PB2,1302,0,3673,2,1,3676,T
1-PB2,1303,1,3657,0,2,3660,T
1-PB2,1304,0,3687,0,0,3687,T
1-PB2,1305,3681,0,1,0,3682,A
1-PB2,1306,3665,0,3,2,3670,A
1-PB2,1307,1,5,3679,0,3685,G
1-PB2,1308,1,1,3626,0,3628,G
1-PB2,1309,2,1,0,3594,3597,C
1-PB2,1310,3570,0,1,1,3572,A
1-PB2,1311,1,3571,1,1,3574,T
1-PB2,1312,0,3597,1,1,3599,T
1-PB2,1313,0,3585,1,2,3588,T
1-PB2,1314,0,3608,0,4,3612,T
1-PB2,1315,5,2,0,3612,3619,C
1-PB2,1316,3604,1,5,0,3610,A
1-PB2,1317,0,3,3602,0,3605,G
1-PB2,1318,3588,0,2,0,3590,A
1-PB2,1319,3593,0,2,1,3596,A
1-PB2,1320,3577,0,2,0,3579,A
1-PB2,1321,1,2,3601,0,3604,G
1-PB2,1322,3655,0,4,0,3659,A
1-PB2,1323,0,3666,0,3,3669,T
1-PB2,1324,1,2,3663,0,3666,G
1-PB2,1325,1,5,0,3677,3683,C
1-PB2,1326,4,8,3685,0,3697,G
1-PB2,1327,3687,1,4,0,3692,A
1-PB2,1328,3688,0,1,0,3689,A
1-PB2,1329,3682,1,4,0,3687,A
1-PB2,1330,0,0,3693,1,3694,G
1-PB2,1331,0,3638,0,5,3643,T
1-PB2,1332,1,2,3643,0,3646,G
1-PB2,1333,1,2,0,3629,3632,C
1-PB2,1334,0,3626,0,7,3633,T
1-PB2,1335,0,3628,0,1,3629,T
1-PB2,1336,0,3649,0,3,3652,T
1-PB2,1337,0,3636,0,2,3638,T
1-PB2,1338,0,3642,0,3,3645,T
1-PB2,1339,7,1,0,3638,3646,C
1-PB2,1340,3650,0,3,0,3653,A
1-PB2,1341,3671,0,1,1,3673,A
1-PB2,1342,3656,0,2,1,3659,A
1-PB2,1343,3680,0,1,0,3681,A
1-PB2,1344,0,3669,1,1,3671,T
1-PB2,1345,1,3668,1,2,3672,T
1-PB2,1346,1,9,3691,0,3701,G
1-PB2,1347,4,9,3665,0,3678,G
1-PB2,1348,1,4,3677,0,3682,G
1-PB2,1349,0,9,3785,0,3794,G
1-PB2,1350,3762,3,5,1,3771,A
1-PB2,1351,1,1,3911,0,3913,G
1-PB2,1352,0,3909,0,3,3912,T
1-PB2,1353,0,3894,0,5,3899,T
1-PB2,1354,0,12,3907,0,3919,G
1-PB2,1355,3921,1,5,0,3927,A
1-PB2,1356,3928,0,12,0,3940,A
1-PB2,1357,2,1,0,4109,4112,C
1-PB2,1358,4065,1,1,0,4067,A
1-PB2,1359,1,2,0,4238,4241,C
1-PB2,1360,4167,0,3,0,4170,A
1-PB2,1361,3,4162,1,5,4171,T
1-PB2,1362,5,8,0,4200,4213,C
1-PB2,1363,3,11,4204,0,4218,G
1-PB2,1364,4239,2,7,1,4249,A
1-PB2,1365,0,2,0,4225,4227,C
1-PB2,1366,4058,1,4,0,4063,A
1-PB2,1367,0,0,4228,0,4228,G
1-PB2,1368,1,4082,1,3,4087,T
1-PB2,1369,2,0,4160,0,4162,G
1-PB2,1370,1,4134,0,5,4140,T
1-PB2,1371,1,5,4157,0,4163,G
1-PB2,1372,4150,0,2,0,4152,A
1-PB2,1373,1,4123,0,6,4130,T
1-PB2,1374,1,4,4154,0,4159,G
1-PB2,1375,4,4,4146,0,4154,G
1-PB2,1376,2,9,4086,1,4098,G
1-PB2,1377,4059,1,2,0,4062,A
1-PB2,1378,4037,0,4,1,4042,A
1-PB2,1379,1,4064,0,0,4065,T
1-PB2,1380,2,12,4107,0,4121,G
1-PB2,1381,4124,0,1,0,4125,A
1-PB2,1382,0,4133,0,2,4135,T
1-PB2,1383,0,4112,0,0,4112,T
1-PB2,1384,0,4,4086,1,4091,G
1-PB2,1385,0,10,4248,1,4259,G
1-PB2,1386,4204,2,5,0,4211,A
1-PB2,1387,2,0,4302,0,4304,G
1-PB2,1388,0,4249,0,2,4251,T
1-PB2,1389,4244,0,1,0,4245,A
1-PB2,1390,0,4272,0,0,4272,T
1-PB2,1391,0,4328,0,1,4329,T
1-PB2,1392,4376,0,4,0,4380,A
1-PB2,1393,1,3,0,4378,4382,C
1-PB2,1394,6,2,0,4300,4308,C
1-PB2,1395,4267,1,4,0,4272,A
1-PB2,1396,1,4,4309,0,4314,G
1-PB2,1397,4444,0,6,0,4450,A
1-PB2,1398,0,4414,0,4,4418,T
1-PB2,1399,4404,1,6,0,4411,A
1-PB2,1400,0,4340,0,4,4344,T
1-PB2,1401,2,20,4314,0,4336,G
1-PB2,1402,4340,1,2,0,4343,A
1-PB2,1403,0,3,1,4398,4402,C
1-PB2,1404,0,4342,0,10,4352,T
1-PB2,1405,6,0,0,4356,4362,C
1-PB2,1406,5,2,0,4286,4293,C
1-PB2,1407,4327,0,3,0,4330,A
1-PB2,1408,4341,0,2,1,4344,A
1-PB2,1409,2,1,4480,0,4483,G
1-PB2,1410,4,0,0,4454,4458,C
1-PB2,1411,4476,1,2,0,4479,A
1-PB2,1412,1,1,0,4475,4477,C
1-PB2,1413,4449,3,5,0,4457,A
1-PB2,1414,2,8,4474,0,4484,G
1-PB2,1415,4437,0,5,1,4443,A
1-PB2,1416,4,2,4531,0,4537,G
1-PB2,1417,4562,0,5,1,4568,A
1-PB2,1418,0,4466,0,2,4468,T
1-PB2,1419,1,0,4571,0,4572,G
1-PB2,1420,0,4547,0,6,4553,T
1-PB2,1421,16,0,0,4541,4557,C
1-PB2,1422,4566,1,7,0,4574,A
1-PB2,1423,4554,1,1,0,4556,A
1-PB2,1424,0,4556,0,2,4558,T
1-PB2,1425,0,15,4544,0,4559,G
1-PB2,1426,4461,2,7,0,4470,A
1-PB2,1427,0,6,4517,0,4523,G
1-PB2,1428,4414,1,11,1,4427,A
1-PB2,1429,4,5,4463,1,4473,G
1-PB2,1430,2,12,4760,0,4774,G
1-PB2,1431,4776,1,3,0,4780,A
1-PB2,1432,4806,0,7,0,4813,A
1-PB2,1433,0,4803,0,5,4808,T
1-PB2,1434,4791,0,6,0,4797,A
1-PB2,1435,4793,0,6,1,4800,A
1-PB2,1436,3,7,4790,1,4801,G
1-PB2,1437,4732,1,9,0,4742,A
1-PB2,1438,2,1,4782,0,4785,G
1-PB2,1439,2,4446,0,3,4451,T
1-PB2,1440,13,3,0,4455,4471,C
1-PB2,1441,4483,1,6,0,4490,A
1-PB2,1442,2,1,4538,0,4541,G
1-PB2,1443,1,2,0,4561,4564,C
1-PB2,1444,4566,0,1,0,4567,A
1-PB2,1445,4591,0,3,1,4595,A
1-PB2,1446,4554,0,4,0,4558,A
1-PB2,1447,4571,0,8,0,4579,A
1-PB2,1448,0,4577,0,0,4577,T
1-PB2,1449,3,19,4577,0,4599,G
1-PB2,1450,1,7,4579,0,4587,G
1-PB2,1451,3,0,4639,0,4642,G
1-PB2,1452,1,4581,0,1,4583,T
1-PB2,1453,1,0,4601,0,4602,G
1-PB2,1454,0,4576,0,0,4576,T
1-PB2,1455,0,11,4584,0,4595,G
1-PB2,1456,0,3,4678,0,4681,G
1-PB2,1457,4681,1,1,0,4683,A
1-PB2,1458,0,4660,0,1,4661,T
1-PB2,1459,1,9,4712,0,4722,G
1-PB2,1460,4680,1,3,2,4686,A
1-PB2,1461,4732,0,9,0,4741,A
1-PB2,1462,2,4731,0,1,4734,T
1-PB2,1463,4706,0,3,0,4709,A
1-PB2,1464,2,1,0,5182,5185,C
1-PB2,1465,3,5016,0,5,5024,T
1-PB2,1466,15,2,0,5144,5161,C
1-PB2,1467,8,4,0,5142,5154,C
1-PB2,1468,5141,0,7,0,5148,A
1-PB2,1469,8,1,5399,0,5408,G
1-PB2,1470,2,5373,0,0,5375,T
1-PB2,1471,5429,1,3,0,5433,A
1-PB2,1472,1,4,0,5433,5438,C
1-PB2,1473,4942,0,3,0,4945,A
1-PB2,1474,0,8,4962,0,4970,G
1-PB2,1475,4797,0,7,2,4806,A
1-PB2,1476,3,4,4862,0,4869,G
1-PB2,1477,4713,1,4,2,4720,A
1-PB2,1478,3,8,4572,0,4583,G
1-PB2,1479,2,8,4563,0,4573,G
1-PB2,1480,2,0,4609,0,4611,G
1-PB2,1481,3,4521,2,4,4530,T
1-PB2,1482,5,3,4528,0,4536,G
1-PB2,1483,1,0,4558,1,4560,G
1-PB2,1484,0,4504,1,2,4507,T
1-PB2,1485,4,10,4687,1,4702,G
1-PB2,1486,2,1,4711,0,4714,G
1-PB2,1487,0,4596,0,4,4600,T
1-PB2,1488,1,4597,0,5,4603,T
1-PB2,1489,4544,0,2,0,4546,A
1-PB2,1490,0,1,4593,0,4594,G
1-PB2,1491,0,2,0,4573,4575,C
1-PB2,1492,4558,0,1,0,4559,A
1-PB2,1493,0,4554,0,2,4556,T
1-PB2,1494,1,4316,0,4,4321,T
1-PB2,1495,4,8,4312,3,4327,G
1-PB2,1496,4294,1,3,0,4298,A
1-PB2,1497,0,4297,0,5,4302,T
1-PB2,1498,11,2,0,4311,4324,C
1-PB2,1499,2,3,4273,0,4278,G
1-PB2,1500,2,0,4419,0,4421,G
1-PB2,1501,0,4383,0,7,4390,T
1-PB2,1502,0,4383,0,5,4388,T
1-PB2,1503,1,4386,0,3,4390,T
1-PB2,1504,0,4393,1,2,4396,T
1-PB2,1505,1,4394,1,2,4398,T
1-PB2,1506,5,11,4398,0,4414,G
1-PB2,1507,4349,1,6,1,4357,A
1-PB2,1508,1,7,4412,0,4420,G
1-PB2,1509,4220,0,3,0,4223,A
1-PB2,1510,0,0,4288,0,4288,G
1-PB2,1511,0,4289,0,4,4293,T
1-PB2,1512,1,4261,0,3,4265,T
1-PB2,1513,27,1,0,4254,4282,C
1-PB2,1514,0,7,4278,0,4285,G
1-PB2,1515,4277,2,12,0,4291,A
1-PB2,1516,1,8,4275,0,4284,G
1-PB2,1517,4290,0,5,1,4296,A
1-PB2,1518,0,2,0,4290,4292,C
1-PB2,1519,10,3,0,4242,4255,C
1-PB2,1520,4213,1,2,0,4216,A
1-PB2,1521,4291,1,4,0,4296,A
1-PB2,1522,1,4,0,4294,4299,C
1-PB2,1523,4,0,4320,0,4324,G
1-PB2,1524,0,4275,1,1,4277,T
1-PB2,1525,1,6,4265,0,4272,G
1-PB2,1526,0,5,4287,0,4292,G
1-PB2,1527,2,9,4271,0,4282,G
1-PB2,1528,4230,2,6,0,4238,A
1-PB2,1529,4276,0,1,0,4277,A
1-PB2,1530,0,4184,0,0,4184,T
1-PB2,1531,2,2,4454,0,4458,G
1-PB2,1532,0,4441,0,3,4444,T
1-PB2,1533,4452,0,1,0,4453,A
1-PB2,1534,0,4462,0,3,4465,T
1-PB2,1535,0,4397,0,1,4398,T
1-PB2,1536,4553,2,2,0,4557,A
1-PB2,1537,0,4518,1,3,4522,T
1-PB2,1538,0,4474,0,3,4477,T
1-PB2,1539,4121,0,327,0,4448,A
1-PB2,1540,0,3894,1,4,3899,T
1-PB2,1541,2,0,0,4081,4083,C
1-PB2,1542,1,4009,0,5,4015,T
1-PB2,1543,5,0,0,4058,4063,C
1-PB2,1544,2,1,0,4061,4064,C
1-PB2,1545,0,3830,0,6,3836,T
1-PB2,1546,3,2,3834,0,3839,G
1-PB2,1547,3813,0,3,1,3817,A
1-PB2,1548,1,4,3830,0,3835,G
1-PB2,1549,0,2,3820,0,3822,G
1-PB2,1550,3452,1,9,0,3462,A
1-PB2,1551,0,3,3486,0,3489,G
1-PB2,1552,1,2,3473,0,3476,G
1-PB2,1553,0,3363,0,3,3366,T
1-PB2,1554,5,3,0,3368,3376,C
1-PB2,1555,3345,0,4,0,3349,A
1-PB2,1556,1,1,3429,0,3431,G
1-PB2,1557,1,3409,0,2,3412,T
1-PB2,1558,2,8,3403,0,3413,G
1-PB2,1559,3398,2,7,0,3407,A
1-PB2,1560,3289,0,8,0,3297,A
1-PB2,1561,3311,1,3,1,3316,A
1-PB2,1562,0,3,0,3317,3320,C
1-PB2,1563,3304,1,1,1,3307,A
1-PB2,1564,0,1,0,3307,3308,C
1-PB2,1565,3178,0,3,0,3181,A
1-PB2,1566,1,6,3199,0,3206,G
1-PB2,1567,2,2,3198,0,3202,G
1-PB2,1568,0,7,3217,0,3224,G
1-PB2,1569,3209,0,1,1,3211,A
1-PB2,1570,3190,0,5,0,3195,A
1-PB2,1571,1,3,0,3225,3229,C
1-PB2,1572,0,3191,0,1,3192,T
1-PB2,1573,0,5,3181,0,3186,G
1-PB2,1574,3150,1,5,0,3156,A
1-PB2,1575,0,3,3174,0,3177,G
1-PB2,1576,3078,0,9,1,3088,A
1-PB2,1577,0,4,2945,0,2949,G
1-PB2,1578,2939,2,5,0,2946,A
1-PB2,1579,0,1,0,2942,2943,C
1-PB2,1580,1,2835,1,2,2839,T
1-PB2,1581,0,11,2890,1,2902,G
1-PB2,1582,2888,1,7,0,2896,A
1-PB2,1583,1,0,1,2909,2911,C
1-PB2,1584,2892,0,3,0,2895,A
1-PB2,1585,2893,1,0,0,2894,A
1-PB2,1586,0,2892,0,0,2892,T
1-PB2,1587,2916,0,0,0,2916,A
1-PB2,1588,2924,0,2,0,2926,A
1-PB2,1589,0,0,0,2955,2955,C
1-PB2,1590,0,2786,0,5,2791,T
1-PB2,1591,0,2767,0,0,2767,T
1-PB2,1592,2728,1,2,0,2731,A
1-PB2,1593,1,2723,0,3,2727,T
1-PB2,1594,0,2708,0,4,2712,T
1-PB2,1595,5,0,0,2703,2708,C
1-PB2,1596,2552,0,2,1,2555,A
1-PB2,1597,0,2553,0,1,2554,T
1-PB2,1598,5,1,0,2438,2444,C
1-PB2,1599,0,1,2437,0,2438,G
1-PB2,1600,0,2466,0,4,2470,T
1-PB2,1601,5,0,0,2422,2427,C
1-PB2,1602,5,2,2427,0,2434,G
1-PB2,1603,2442,0,2,0,2444,A
1-PB2,1604,0,2438,0,1,2439,T
1-PB2,1605,0,0,2450,0,2450,G
1-PB2,1606,2451,0,0,0,2451,A
1-PB2,1607,1,2442,0,0,2443,T
1-PB2,1608,0,0,2455,0,2455,G
1-PB2,1609,1,2362,1,1,2365,T
1-PB2,1610,0,4,2352,0,2356,G
1-PB2,1611,0,1,2364,0,2365,G
1-PB2,1612,0,1,2358,0,2359,G
1-PB2,1613,2305,0,2,0,2307,A
1-PB2,1614,2,3,2332,0,2337,G
1-PB2,1615,2213,0,1,0,2214,A
1-PB2,1616,0,2186,0,0,2186,T
1-PB2,1617,0,2132,1,1,2134,T
1-PB2,1618,2135,0,2,0,2137,A
1-PB2,1619,2134,0,1,1,2136,A
1-PB2,1620,0,0,0,2127,2127,C
1-PB2,1621,1,3,2039,0,2043,G
1-PB2,1622,0,0,2089,0,2089,G
1-PB2,1623,0,1920,0,1,1921,T
1-PB2,1624,8,1,0,1885,1894,C
1-PB2,1625,1,0,0,1901,1902,C
1-PB2,1626,1,1819,1,3,1824,T
1-PB2,1627,0,5,1845,0,1850,G
1-PB2,1628,1847,0,0,0,1847,A
1-PB2,1629,0,2,1861,0,1863,G
1-PB2,1630,0,1856,0,2,1858,T
1-PB2,1631,11,0,0,1759,1770,C
1-PB2,1632,1,2,1769,0,1772,G
1-PB2,1633,0,0,1814,0,1814,G
1-PB2,1634,1,1798,0,3,1802,T
1-PB2,1635,1,1800,0,0,1801,T
1-PB2,1636,0,1797,0,0,1797,T
1-PB2,1637,0,1806,0,0,1806,T
1-PB2,1638,2,3,1852,0,1857,G
1-PB2,1639,0,0,1878,0,1878,G
1-PB2,1640,0,1876,0,1,1877,T
1-PB2,1641,4,0,1,1869,1874,C
1-PB2,1642,1816,0,1,0,1817,A
1-PB2,1643,1897,0,0,0,1897,A
1-PB2,1644,0,1904,0,0,1904,T
1-PB2,1645,1913,1,2,0,1916,A
1-PB2,1646,1,1,0,1955,1957,C
1-PB2,1647,1,1,0,1859,1861,C
1-PB2,1648,0,1855,4,2,1861,T
1-PB2,1649,1880,0,2,0,1882,A
1-PB2,1650,0,1876,1,1,1878,T
1-PB2,1651,1,0,0,1881,1882,C
1-PB2,1652,1818,0,1,0,1819,A
1-PB2,1653,1813,0,1,0,1814,A
1-PB2,1654,0,1803,0,0,1803,T
1-PB2,1655,1,4,1741,0,1746,G
1-PB2,1656,0,2,1741,0,1743,G
1-PB2,1657,1735,0,3,0,1738,A
1-PB2,1658,0,1695,0,2,1697,T
1-PB2,1659,3,0,0,1695,1698,C
1-PB2,1660,1702,0,3,0,1705,A
1-PB2,1661,0,1702,0,3,1705,T
1-PB2,1662,1,1,0,1708,1710,C
1-PB2,1663,1712,0,3,0,1715,A
1-PB2,1664,0,0,1727,0,1727,G
1-PB2,1665,1713,0,2,0,1715,A
1-PB2,1666,1714,0,1,0,1715,A
1-PB2,1667,1724,0,0,0,1724,A
1-PB2,1668,0,1729,1,2,1732,T
1-PB2,1669,1,1710,0,0,1711,T
1-PB2,1670,0,4,1698,0,1702,G
1-PB2,1671,1,0,1689,0,1690,G
1-PB2,1672,1,1,1700,0,1702,G
1-PB2,1673,1683,0,2,0,1685,A
1-PB2,1674,1677,0,2,1,1680,A
1-PB2,1675,0,0,1703,0,1703,G
1-PB2,1676,1,1,1,1678,1681,C
1-PB2,1677,1,1679,0,2,1682,T
1-PB2,1678,1685,0,0,0,1685,A
1-PB2,1679,0,1698,0,0,1698,T
1-PB2,1680,1,0,0,1703,1704,C
1-PB2,1681,1701,0,0,0,1701,A
1-PB2,1682,1713,0,0,0,1713,A
1-PB2,1683,1709,0,0,0,1709,A
1-PB2,1684,1711,0,1,0,1712,A
1-PB2,1685,0,1703,0,1,1704,T
1-PB2,1686,0,1698,1,1,1700,T
1-PB2,1687,5,0,0,1691,1696,C
1-PB2,1688,1697,0,2,0,1699,A
1-PB2,1689,1694,0,1,1,1696,A
1-PB2,1690,0,1692,0,1,1693,T
1-PB2,1691,1,2,1689,0,1692,G
1-PB2,1692,0,1,1713,0,1714,G
1-PB2,1693,2,1738,0,3,1743,T
1-PB2,1694,3,0,0,1745,1748,C
1-PB2,1695,0,1743,0,4,1747,T
1-PB2,1696,3,1,0,1748,1752,C
1-PB2,1697,1756,1,2,0,1759,A
1-PB2,1698,1,4,1757,0,1762,G
1-PB2,1699,1752,0,2,0,1754,A
1-PB2,1700,1773,0,1,0,1774,A
1-PB2,1701,0,1746,0,0,1746,T
1-PB2,1702,3,0,0,1710,1713,C
1-PB2,1703,1,1,0,1725,1727,C
1-PB2,1704,1,1718,1,3,1723,T
1-PB2,1705,0,0,1713,0,1713,G
1-PB2,1706,0,0,0,1717,1717,C
1-PB2,1707,1711,0,0,0,1711,A
1-PB2,1708,1740,0,1,0,1741,A
1-PB2,1709,0,1710,0,0,1710,T
1-PB2,1710,1,0,1744,0,1745,G
1-PB2,1711,0,1746,2,1,1749,T
1-PB2,1712,0,1694,0,0,1694,T
1-PB2,1713,0,1,1717,0,1718,G
1-PB2,1714,0,1706,0,1,1707,T
1-PB2,1715,1710,0,3,0,1713,A
1-PB2,1716,0,1,0,1711,1712,C
1-PB2,1717,1665,0,2,0,1667,A
1-PB2,1718,1684,0,0,0,1684,A
1-PB2,1719,0,2,1,1654,1657,C
1-PB2,1720,1623,0,1,0,1624,A
1-PB2,1721,1628,0,0,0,1628,A
1-PB2,1722,1582,0,0,0,1582,A
1-PB2,1723,1584,0,0,0,1584,A
1-PB2,1724,0,1580,0,1,1581,T
1-PB2,1725,0,3,1573,0,1576,G
1-PB2,1726,0,7,1574,0,1581,G
1-PB2,1727,1573,0,2,0,1575,A
1-PB2,1728,1580,0,4,0,1584,A
1-PB2,1729,0,1578,0,0,1578,T
1-PB2,1730,1,1576,0,0,1577,T
1-PB2,1731,0,1578,0,0,1578,T
1-PB2,1732,0,7,1558,0,1565,G
1-PB2,1733,1580,0,2,0,1582,A
1-PB2,1734,1581,0,2,0,1583,A
1-PB2,1735,2,1,0,1577,1580,C
1-PB2,1736,5,0,0,1516,1521,C
1-PB2,1737,1557,0,0,0,1557,A
1-PB2,1738,0,1582,0,2,1584,T
1-PB2,1739,1,1580,0,1,1582,T
1-PB2,1740,0,1580,0,1,1581,T
1-PB2,1741,7,0,0,1568,1575,C
1-PB2,1742,1574,0,1,0,1575,A
1-PB2,1743,1583,0,1,0,1584,A
1-PB2,1744,1,1573,0,0,1574,T
1-PB2,1745,4,0,1,1602,1607,C
1-PB2,1746,0,1564,1,5,1570,T
1-PB2,1747,0,1566,0,0,1566,T
1-PB2,1748,0,1571,0,0,1571,T
1-PB2,1749,1569,2,1,0,1572,A
1-PB2,1750,0,0,1580,0,1580,G
1-PB2,1751,1,1571,0,1,1573,T
1-PB2,1752,2,3,0,1613,1618,C
1-PB2,1753,1,0,0,1621,1622,C
1-PB2,1754,1,1,0,1607,1609,C
1-PB2,1755,2,0,0,1599,1601,C
1-PB2,1756,1595,1,2,0,1598,A
1-PB2,1757,1601,0,1,0,1602,A
1-PB2,1758,1,1,1632,0,1634,G
1-PB2,1759,3,0,1636,0,1639,G
1-PB2,1760,1,0,0,1640,1641,C
1-PB2,1761,2,1,0,1612,1615,C
1-PB2,1762,1608,1,1,0,1610,A
1-PB2,1763,0,1653,0,1,1654,T
1-PB2,1764,0,1653,0,0,1653,T
1-PB2,1765,1655,0,1,0,1656,A
1-PB2,1766,0,2,1656,0,1658,G
1-PB2,1767,1605,0,2,0,1607,A
1-PB2,1768,1668,0,3,0,1671,A
1-PB2,1769,1,0,1693,0,1694,G
1-PB2,1770,0,2,0,1689,1691,C
1-PB2,1771,1,1,0,1692,1694,C
1-PB2,1772,1661,0,1,0,1662,A
1-PB2,1773,1690,0,3,1,1694,A
1-PB2,1774,0,1697,0,1,1698,T
1-PB2,1775,1709,0,2,0,1711,A
1-PB2,1776,0,0,0,1712,1712,C
1-PB2,1777,1569,1,1,0,1571,A
1-PB2,1778,0,1,1580,0,1581,G
1-PB2,1779,1,1530,0,0,1531,T
1-PB2,1780,0,5,1547,0,1552,G
1-PB2,1781,0,2,1545,1,1548,G
1-PB2,1782,1,0,1555,0,1556,G
1-PB2,1783,0,1535,0,3,1538,T
1-PB2,1784,1,1526,0,1,1528,T
1-PB2,1785,0,1541,0,0,1541,T
1-PB2,1786,0,1,1564,0,1565,G
1-PB2,1787,0,1563,0,1,1564,T
1-PB2,1788,8,2,1,1541,1552,C
1-PB2,1789,1529,0,0,0,1529,A
1-PB2,1790,0,1,1527,0,1528,G
1-PB2,1791,1504,0,0,0,1504,A
1-PB2,1792,1516,0,0,0,1516,A
1-PB2,1793,0,0,0,1518,1518,C
1-PB2,1794,0,1480,0,2,1482,T
1-PB2,1795,2,1,0,1551,1554,C
1-PB2,1796,0,1560,1,1,1562,T
1-PB2,1797,1572,0,0,0,1572,A
1-PB2,1798,0,1567,0,0,1567,T
1-PB2,1799,1,1547,0,2,1550,T
1-PB2,1800,2,0,0,1547,1549,C
1-PB2,1801,3,0,0,1547,1550,C
1-PB2,1802,1539,0,1,0,1540,A
1-PB2,1803,1545,0,1,0,1546,A
1-PB2,1804,0,0,0,1543,1543,C
1-PB2,1805,1525,0,0,0,1525,A
1-PB2,1806,1528,0,0,0,1528,A
1-PB2,1807,1528,0,0,0,1528,A
1-PB2,1808,0,1537,0,1,1538,T
1-PB2,1809,0,2,1535,0,1537,G
1-PB2,1810,1511,0,4,0,1515,A
1-PB2,1811,0,1,1540,0,1541,G
1-PB2,1812,1524,0,6,0,1530,A
1-PB2,1813,0,3,1538,0,1541,G
1-PB2,1814,1544,0,4,0,1548,A
1-PB2,1815,0,2,0,1541,1543,C
1-PB2,1816,1,0,1571,0,1572,G
1-PB2,1817,1,1569,0,0,1570,T
1-PB2,1818,1596,0,1,0,1597,A
1-PB2,1819,0,1,0,1598,1599,C
1-PB2,1820,0,1583,0,0,1583,T
1-PB2,1821,0,1579,0,2,1581,T
1-PB2,1822,0,2,1569,0,1571,G
1-PB2,1823,2,2,1570,0,1574,G
1-PB2,1824,1,1,1583,0,1585,G
1-PB2,1825,1571,0,0,0,1571,A
1-PB2,1826,2,1,0,1576,1579,C
1-PB2,1827,1587,0,0,0,1587,A
1-PB2,1828,0,1590,0,3,1593,T
1-PB2,1829,0,1582,0,3,1585,T
1-PB2,1830,0,1597,0,1,1598,T
1-PB2,1831,1,7,1586,0,1594,G
1-PB2,1832,1588,0,1,1,1590,A
1-PB2,1833,1,1,0,1590,1592,C
1-PB2,1834,1587,0,1,0,1588,A
1-PB2,1835,1,2,0,1584,1587,C
1-PB2,1836,4,0,0,1549,1553,C
1-PB2,1837,1568,0,1,0,1569,A
1-PB2,1838,1,1,1,1582,1585,C
1-PB2,1839,3,2,0,1578,1583,C
1-PB2,1840,2,1,0,1581,1584,C
1-PB2,1841,1576,0,0,0,1576,A
1-PB2,1842,0,0,1619,0,1619,G
1-PB2,1843,1610,0,2,0,1612,A
1-PB2,1844,0,1699,0,1,1700,T
1-PB2,1845,1679,0,1,0,1680,A
1-PB2,1846,1671,0,1,0,1672,A
1-PB2,1847,0,1655,0,0,1655,T
1-PB2,1848,1655,0,2,0,1657,A
1-PB2,1849,1651,0,0,0,1651,A
1-PB2,1850,1655,0,0,0,1655,A
1-PB2,1851,0,0,1655,0,1655,G
1-PB2,1852,0,1,0,1653,1654,C
1-PB2,1853,0,1557,0,4,1561,T
1-PB2,1854,0,1558,0,2,1560,T
1-PB2,1855,0,0,0,1554,1554,C
1-PB2,1856,0,1528,0,3,1531,T
1-PB2,1857,1,0,0,1592,1593,C
1-PB2,1858,2,0,0,1595,1597,C
1-PB2,1859,3,0,0,1616,1619,C
1-PB2,1860,0,1597,0,4,1601,T
1-PB2,1861,0,1588,1,2,1591,T
1-PB2,1862,1,1589,0,1,1591,T
1-PB2,1863,0,1588,0,0,1588,T
1-PB2,1864,0,1,1586,0,1587,G
1-PB2,1865,0,1,0,1594,1595,C
1-PB2,1866,1554,0,4,1,1559,A
1-PB2,1867,1,0,1557,0,1558,G
1-PB2,1868,1,0,0,1557,1558,C
1-PB2,1869,0,1552,0,1,1553,T
1-PB2,1870,0,0,1555,0,1555,G
1-PB2,1871,0,0,0,1564,1564,C
1-PB2,1872,1,1531,0,3,1535,T
1-PB2,1873,3,0,0,1574,1577,C
1-PB2,1874,0,0,0,1579,1579,C
1-PB2,1875,1586,0,1,0,1587,A
1-PB2,1876,0,0,0,1586,1586,C
1-PB2,1877,8,2,0,1570,1580,C
1-PB2,1878,1575,0,2,0,1577,A
1-PB2,1879,1596,0,0,0,1596,A
1-PB2,1880,1593,1,5,0,1599,A
1-PB2,1881,0,2,1611,0,1613,G
1-PB2,1882,0,0,1,1616,1617,C
1-PB2,1883,1588,0,1,2,1591,A
1-PB2,1884,1594,0,1,0,1595,A
1-PB2,1885,1586,0,2,0,1588,A
1-PB2,1886,0,0,1625,0,1625,G
1-PB2,1887,1,0,0,1624,1625,C
1-PB2,1888,1610,1,1,0,1612,A
1-PB2,1889,1,0,1622,0,1623,G
1-PB2,1890,1593,0,3,0,1596,A
1-PB2,1891,1636,0,2,0,1638,A
1-PB2,1892,0,1636,0,0,1636,T
1-PB2,1893,0,0,1635,0,1635,G
1-PB2,1894,0,1,0,1628,1629,C
1-PB2,1895,1598,0,1,0,1599,A
1-PB2,1896,0,1,1633,0,1634,G
1-PB2,1897,0,1628,0,1,1629,T
1-PB2,1898,0,1659,0,4,1663,T
1-PB2,1899,2,0,0,1671,1673,C
1-PB2,1900,0,1635,0,2,1637,T
1-PB2,1901,3,0,0,1655,1658,C
1-PB2,1902,0,1653,0,5,1658,T
1-PB2,1903,0,1653,0,3,1656,T
1-PB2,1904,4,2,0,1662,1668,C
1-PB2,1905,1640,0,3,0,1643,A
1-PB2,1906,1,2,0,1647,1650,C
1-PB2,1907,0,1564,0,0,1564,T
1-PB2,1908,2,5,1581,0,1588,G
1-PB2,1909,1578,0,3,0,1581,A
1-PB2,1910,1,0,0,1652,1653,C
1-PB2,1911,0,1616,0,0,1616,T
1-PB2,1912,2,0,1652,0,1654,G
1-PB2,1913,0,1641,0,1,1642,T
1-PB2,1914,2,3,1652,0,1657,G
1-PB2,1915,1645,0,2,0,1647,A
1-PB2,1916,1659,0,0,0,1659,A
1-PB2,1917,1,1629,0,1,1631,T
1-PB2,1918,1,0,1630,0,1631,G
1-PB2,1919,0,1561,0,0,1561,T
1-PB2,1920,0,3,1563,0,1566,G
1-PB2,1921,1509,0,2,0,1511,A
1-PB2,1922,0,1,1530,0,1531,G
1-PB2,1923,0,7,1510,0,1517,G
1-PB2,1924,0,2,1512,0,1514,G
1-PB2,1925,2,3,1561,0,1566,G
1-PB2,1926,1553,0,3,0,1556,A
1-PB2,1927,1,1555,0,0,1556,T
1-PB2,1928,2,0,0,1560,1562,C
1-PB2,1929,1547,0,4,0,1551,A
1-PB2,1930,1,1,1602,0,1604,G
1-PB2,1931,1,5,1587,0,1593,G
1-PB2,1932,1,1,1602,0,1604,G
1-PB2,1933,1600,0,0,0,1600,A
1-PB2,1934,1,1503,0,1,1505,T
1-PB2,1935,2,3,1503,0,1508,G
1-PB2,1936,1484,1,2,0,1487,A
1-PB2,1937,0,2,1552,0,1554,G
1-PB2,1938,1537,1,4,0,1542,A
1-PB2,1939,1512,1,0,0,1513,A
1-PB2,1940,0,1531,0,1,1532,T
1-PB2,1941,1525,0,1,0,1526,A
1-PB2,1942,0,1,0,1556,1557,C
1-PB2,1943,0,1538,0,1,1539,T
1-PB2,1944,0,1537,0,1,1538,T
1-PB2,1945,2,1,1542,0,1545,G
1-PB2,1946,0,1496,0,1,1497,T
1-PB2,1947,1493,0,0,0,1493,A
1-PB2,1948,1478,0,3,0,1481,A
1-PB2,1949,0,6,1453,0,1459,G
1-PB2,1950,1,4,1462,0,1467,G
1-PB2,1951,0,2,1432,0,1434,G
1-PB2,1952,2,0,1437,0,1439,G
1-PB2,1953,3,1,0,1450,1454,C
1-PB2,1954,1449,0,1,0,1450,A
1-PB2,1955,1484,0,0,0,1484,A
1-PB2,1956,0,1480,0,1,1481,T
1-PB2,1957,0,1477,0,0,1477,T
1-PB2,1958,2,0,0,1515,1517,C
1-PB2,1959,0,1487,0,1,1488,T
1-PB2,1960,3,2,0,1525,1530,C
1-PB2,1961,3,0,0,1524,1527,C
1-PB2,1962,0,1513,0,2,1515,T
1-PB2,1963,0,0,1559,0,1559,G
1-PB2,1964,0,1506,1,6,1513,T
1-PB2,1965,1522,1,0,1,1524,A
1-PB2,1966,1,1514,1,1,1517,T
1-PB2,1967,0,1479,0,3,1482,T
1-PB2,1968,3,1,0,1485,1489,C
1-PB2,1969,1478,0,1,0,1479,A
1-PB2,1970,1511,0,2,0,1513,A
1-PB2,1971,0,0,0,1511,1511,C
1-PB2,1972,1,1463,0,2,1466,T
1-PB2,1973,1478,0,0,0,1478,A
1-PB2,1974,1,0,0,1529,1530,C
1-PB2,1975,1527,3,1,0,1531,A
1-PB2,1976,1532,0,2,0,1534,A
1-PB2,1977,0,1,0,1524,1525,C
1-PB2,1978,1497,0,0,0,1497,A
1-PB2,1979,1487,0,1,0,1488,A
1-PB2,1980,0,3,1482,0,1485,G
1-PB2,1981,1491,0,0,0,1491,A
1-PB2,1982,1,0,0,1499,1500,C
1-PB2,1983,4,0,0,1452,1456,C
1-PB2,1984,1465,0,1,0,1466,A
1-PB2,1985,1,1,0,1556,1558,C
1-PB2,1986,0,1552,0,1,1553,T
1-PB2,1987,1551,0,1,0,1552,A
1-PB2,1988,1542,0,0,0,1542,A
1-PB2,1989,1540,0,2,0,1542,A
1-PB2,1990,1535,0,5,0,1540,A
1-PB2,1991,0,5,1568,0,1573,G
1-PB2,1992,1552,0,3,0,1555,A
1-PB2,1993,0,0,0,1553,1553,C
1-PB2,1994,0,1486,0,2,1488,T
1-PB2,1995,1494,1,1,0,1496,A
1-PB2,1996,1498,0,1,0,1499,A
1-PB2,1997,0,0,0,1497,1497,C
1-PB2,1998,1491,0,1,0,1492,A
1-PB2,1999,1499,0,1,0,1500,A
1-PB2,2000,0,1463,0,0,1463,T
1-PB2,2001,0,1440,0,0,1440,T
1-PB2,2002,2,0,0,1458,1460,C
1-PB2,2003,1,1430,0,3,1434,T
1-PB2,2004,2,2,1,1457,1462,C
1-PB2,2005,0,1,1465,0,1466,G
1-PB2,2006,0,2,1464,0,1466,G
1-PB2,2007,1462,0,2,0,1464,A
1-PB2,2008,1469,0,1,1,1471,A
1-PB2,2009,1463,0,0,0,1463,A
1-PB2,2010,1462,0,3,0,1465,A
1-PB2,2011,1,0,1466,0,1467,G
1-PB2,2012,1457,0,3,0,1460,A
1-PB2,2013,0,1468,0,0,1468,T
1-PB2,2014,0,0,1467,0,1467,G
1-PB2,2015,1,1,0,1453,1455,C
1-PB2,2016,1,0,1,1461,1463,C
1-PB2,2017,2,2,1454,0,1458,G
1-PB2,2018,0,1,1454,0,1455,G
1-PB2,2019,0,0,0,1460,1460,C
1-PB2,2020,1466,0,1,0,1467,A
1-PB2,2021,1,0,0,1506,1507,C
1-PB2,2022,0,1498,1,2,1501,T
1-PB2,2023,1,1498,0,0,1499,T
1-PB2,2024,0,1504,0,0,1504,T
1-PB2,2025,1504,0,0,0,1504,A
1-PB2,2026,1510,0,0,1,1511,A
1-PB2,2027,0,1512,0,2,1514,T
1-PB2,2028,0,1507,0,1,1508,T
1-PB2,2029,0,2,1505,0,1507,G
1-PB2,2030,1445,0,1,0,1446,A
1-PB2,2031,1445,0,3,0,1448,A
1-PB2,2032,0,2,1454,0,1456,G
1-PB2,2033,1466,0,5,0,1471,A
1-PB2,2034,0,2,0,1472,1474,C
1-PB2,2035,3,0,0,1449,1452,C
1-PB2,2036,3,1,0,1460,1464,C
1-PB2,2037,1452,0,2,0,1454,A
1-PB2,2038,0,2,1502,0,1504,G
1-PB2,2039,1486,1,2,2,1491,A
1-PB2,2040,0,1499,1,0,1500,T
1-PB2,2041,2,4,1490,0,1496,G
1-PB2,2042,1456,0,1,0,1457,A
1-PB2,2043,1448,0,2,1,1451,A
1-PB2,2044,1460,0,3,1,1464,A
1-PB2,2045,0,0,1471,0,1471,G
1-PB2,2046,1,1,0,1473,1475,C
1-PB2,2047,1450,0,0,0,1450,A
1-PB2,2048,0,0,0,1470,1470,C
1-PB2,2049,1470,0,1,0,1471,A
1-PB2,2050,0,1463,0,1,1464,T
1-PB2,2051,1,0,0,1492,1493,C
1-PB2,2052,0,3,0,1479,1482,C
1-PB2,2053,0,2,1493,0,1495,G
1-PB2,2054,0,2,1496,0,1498,G
1-PB2,2055,1477,0,2,0,1479,A
1-PB2,2056,1,0,1496,0,1497,G
1-PB2,2057,0,1463,0,0,1463,T
1-PB2,2058,2,1,1465,0,1468,G
1-PB2,2059,0,2,1472,0,1474,G
1-PB2,2060,1446,1,0,0,1447,A
1-PB2,2061,1,0,1453,0,1454,G
1-PB2,2062,0,1417,0,2,1419,T
1-PB2,2063,3,0,0,1419,1422,C
1-PB2,2064,4,0,0,1414,1418,C
1-PB2,2065,2,0,1418,0,1420,G
1-PB2,2066,0,0,0,1416,1416,C
1-PB2,2067,3,0,0,1412,1415,C
1-PB2,2068,3,0,1476,0,1479,G
1-PB2,2069,0,1478,0,4,1482,T
1-PB2,2070,1,0,0,1504,1505,C
1-PB2,2071,0,1496,0,2,1498,T
1-PB2,2072,0,1503,0,0,1503,T
1-PB2,2073,0,4,1499,0,1503,G
1-PB2,2074,1477,1,0,1,1479,A
1-PB2,2075,0,0,1498,0,1498,G
1-PB2,2076,1472,0,4,0,1476,A
1-PB2,2077,0,9,1427,0,1436,G
1-PB2,2078,0,3,1425,0,1428,G
1-PB2,2079,0,1,1437,0,1438,G
1-PB2,2080,0,1421,0,0,1421,T
1-PB2,2081,0,1410,0,3,1413,T
1-PB2,2082,0,1431,1,3,1435,T
1-PB2,2083,2,1,0,1444,1447,C
1-PB2,2084,1,1434,0,0,1435,T
1-PB2,2085,5,0,0,1494,1499,C
1-PB2,2086,1494,0,0,0,1494,A
1-PB2,2087,0,1474,0,4,1478,T
1-PB2,2088,0,1473,0,0,1473,T
1-PB2,2089,1472,1,0,0,1473,A
1-PB2,2090,0,1481,0,0,1481,T
1-PB2,2091,1462,0,0,0,1462,A
1-PB2,2092,0,2,1489,0,1491,G
1-PB2,2093,0,0,1509,0,1509,G
1-PB2,2094,0,1399,0,1,1400,T
1-PB2,2095,1395,0,0,0,1395,A
1-PB2,2096,1387,0,0,0,1387,A
1-PB2,2097,0,1,1403,0,1404,G
1-PB2,2098,0,3,1404,0,1407,G
1-PB2,2099,1388,0,1,0,1389,A
1-PB2,2100,1382,0,2,0,1384,A
1-PB2,2101,1,5,1379,0,1385,G
1-PB2,2102,1354,0,3,0,1357,A
1-PB2,2103,0,1,0,1373,1374,C
1-PB2,2104,1360,0,1,0,1361,A
1-PB2,2105,0,1,1367,0,1368,G
1-PB2,2106,1353,0,0,0,1353,A
1-PB2,2107,1345,0,2,0,1347,A
1-PB2,2108,1,1,1352,0,1354,G
1-PB2,2109,1356,1,4,0,1361,A
1-PB2,2110,0,1356,0,0,1356,T
1-PB2,2111,1352,0,1,0,1353,A
1-PB2,2112,0,2,0,1350,1352,C
1-PB2,2113,1,3,1330,0,1334,G
1-PB2,2114,0,5,1367,0,1372,G
1-PB2,2115,1371,0,1,0,1372,A
1-PB2,2116,0,1,0,1362,1363,C
1-PB2,2117,0,0,0,1354,1354,C
1-PB2,2118,1315,0,1,0,1316,A
1-PB2,2119,0,0,1394,0,1394,G
1-PB2,2120,0,0,0,1397,1397,C
1-PB2,2121,1402,0,0,0,1402,A
1-PB2,2122,0,1392,1,0,1393,T
1-PB2,2123,0,1325,0,1,1326,T
1-PB2,2124,1338,0,1,0,1339,A
1-PB2,2125,1329,0,3,0,1332,A
1-PB2,2126,0,0,1336,0,1336,G
1-PB2,2127,0,0,0,1333,1333,C
1-PB2,2128,1244,0,0,0,1244,A
1-PB2,2129,0,1311,0,1,1312,T
1-PB2,2130,0,1,0,1303,1304,C
1-PB2,2131,1305,0,1,0,1306,A
1-PB2,2132,1310,0,0,0,1310,A
1-PB2,2133,0,1311,0,1,1312,T
1-PB2,2134,0,3,1314,1,1318,G
1-PB2,2135,1304,0,2,0,1306,A
1-PB2,2136,1310,0,0,0,1310,A
1-PB2,2137,1,1,0,1328,1330,C
1-PB2,2138,0,1214,0,0,1214,T
1-PB2,2139,1,5,1231,0,1237,G
1-PB2,2140,1209,1,2,0,1212,A
1-PB2,2141,0,0,1226,0,1226,G
1-PB2,2142,1,0,0,1214,1215,C
1-PB2,2143,1219,0,0,0,1219,A
1-PB2,2144,1260,1,0,0,1261,A
1-PB2,2145,0,0,0,1253,1253,C
1-PB2,2146,5,0,0,1218,1223,C
1-PB2,2147,0,1222,0,1,1223,T
1-PB2,2148,0,1207,0,2,1209,T
1-PB2,2149,1,0,1216,0,1217,G
1-PB2,2150,1,2,0,1212,1215,C
1-PB2,2151,1220,0,0,0,1220,A
1-PB2,2152,1215,0,0,0,1215,A
1-PB2,2153,1157,0,1,0,1158,A
1-PB2,2154,1139,0,3,0,1142,A
1-PB2,2155,0,2,1145,0,1147,G
1-PB2,2156,0,3,1154,0,1157,G
1-PB2,2157,0,2,1155,0,1157,G
1-PB2,2158,0,3,1160,1,1164,G
1-PB2,2159,1161,0,0,0,1161,A
1-PB2,2160,1155,0,1,0,1156,A
1-PB2,2161,1158,0,1,0,1159,A
1-PB2,2162,1171,0,1,1,1173,A
1-PB2,2163,0,2,1190,0,1192,G
1-PB2,2164,1,0,1190,0,1191,G
1-PB2,2165,0,0,0,1177,1177,C
1-PB2,2166,1,1173,0,0,1174,T
1-PB2,2167,1170,1,0,0,1171,A
1-PB2,2168,1172,0,0,0,1172,A
1-PB2,2169,0,1173,0,0,1173,T
1-PB2,2170,0,2,1201,0,1203,G
1-PB2,2171,0,1149,0,2,1151,T
1-PB2,2172,0,0,1139,0,1139,G
1-PB2,2173,0,0,0,1136,1136,C
1-PB2,2174,0,1131,0,1,1132,T
1-PB2,2175,1133,0,2,0,1135,A
1-PB2,2176,1128,0,1,0,1129,A
1-PB2,2177,1,1121,0,1,1123,T
1-PB2,2178,6,1,0,1113,1120,C
1-PB2,2179,1,3,1088,0,1092,G
1-PB2,2180,0,0,1102,0,1102,G
1-PB2,2181,0,0,1107,0,1107,G
1-PB2,2182,0,1,0,1102,1103,C
1-PB2,2183,1107,1,0,0,1108,A
1-PB2,2184,1104,1,1,0,1106,A
1-PB2,2185,0,1,1110,0,1111,G
1-PB2,2186,0,1,1114,0,1115,G
1-PB2,2187,1106,0,1,0,1107,A
1-PB2,2188,0,2,1112,0,1114,G
1-PB2,2189,1074,0,3,0,1077,A
1-PB2,2190,0,0,0,1077,1077,C
1-PB2,2191,0,0,1083,0,1083,G
1-PB2,2192,0,1073,0,0,1073,T
1-PB2,2193,0,0,1076,0,1076,G
1-PB2,2194,1,0,1092,0,1093,G
1-PB2,2195,0,1069,0,1,1070,T
1-PB2,2196,0,0,1072,0,1072,G
1-PB2,2197,0,1040,0,1,1041,T
1-PB2,2198,0,1037,0,0,1037,T
1-PB2,2199,0,0,1040,0,1040,G
1-PB2,2200,0,0,1038,0,1038,G
1-PB2,2201,0,1041,0,0,1041,T
1-PB2,2202,1007,0,1,0,1008,A
1-PB2,2203,988,0,2,0,990,A
1-PB2,2204,1,970,0,0,971,T
1-PB2,2205,0,1,960,0,961,G
1-PB2,2206,956,1,0,0,957,A
1-PB2,2207,945,0,1,0,946,A
1-PB2,2208,941,0,3,0,944,A
1-PB2,2209,1,1,0,936,938,C
1-PB2,2210,0,1,934,0,935,G
1-PB2,2211,926,0,0,0,926,A
1-PB2,2212,929,0,1,0,930,A
1-PB2,2213,929,0,0,0,929,A
1-PB2,2214,931,0,0,1,932,A
1-PB2,2215,0,1,0,933,934,C
1-PB2,2216,1,4,926,0,931,G
1-PB2,2217,1,0,932,0,933,G
1-PB2,2218,0,1,935,0,936,G
1-PB2,2219,933,0,3,0,936,A
1-PB2,2220,1,2,0,934,937,C
1-PB2,2221,0,928,0,1,929,T
1-PB2,2222,2,0,0,968,970,C
1-PB2,2223,0,970,0,2,972,T
1-PB2,2224,975,0,0,0,975,A
1-PB2,2225,1,0,972,0,973,G
1-PB2,2226,1,0,0,952,953,C
1-PB2,2227,954,0,0,0,954,A
1-PB2,2228,0,954,0,0,954,T
1-PB2,2229,922,0,0,0,922,A
1-PB2,2230,1,0,0,930,931,C
1-PB2,2231,0,802,1,1,804,T
1-PB2,2232,0,801,0,0,801,T
1-PB2,2233,792,0,0,0,792,A
1-PB2,2234,0,0,0,795,795,C
1-PB2,2235,0,783,0,0,783,T
1-PB2,2236,0,3,778,0,781,G
1-PB2,2237,755,0,0,0,755,A
1-PB2,2238,0,2,0,761,763,C
1-PB2,2239,673,0,0,0,673,A
1-PB2,2240,0,0,686,0,686,G
1-PB2,2241,0,0,0,682,682,C
1-PB2,2242,1,0,0,683,684,C
1-PB2,2243,674,0,1,0,675,A
1-PB2,2244,0,1,672,0,673,G
1-PB2,2245,673,0,0,0,673,A
1-PB2,2246,1,0,0,668,669,C
1-PB2,2247,621,0,3,0,624,A
1-PB2,2248,0,0,622,0,622,G
1-PB2,2249,0,0,0,587,587,C
1-PB2,2250,1,3,583,1,588,G
1-PB2,2251,586,1,1,0,588,A
1-PB2,2252,0,0,0,580,580,C
1-PB2,2253,2,0,1,579,582,C
1-PB2,2254,580,0,0,0,580,A
1-PB2,2255,579,0,1,0,580,A
1-PB2,2256,571,0,1,0,572,A
1-PB2,2257,578,1,0,0,579,A
1-PB2,2258,0,0,576,0,576,G
1-PB2,2259,556,0,0,0,556,A
1-PB2,2260,556,0,0,0,556,A
1-PB2,2261,0,550,0,0,550,T
1-PB2,2262,0,549,0,0,549,T
1-PB2,2263,2,0,0,549,551,C
1-PB2,2264,0,1,537,0,538,G
1-PB2,2265,0,0,538,0,538,G
1-PB2,2266,535,0,0,0,535,A
1-PB2,2267,0,517,0,1,518,T
1-PB2,2268,2,0,516,0,518,G
1-PB2,2269,0,0,518,0,518,G
1-PB2,2270,0,0,0,512,512,C
1-PB2,2271,1,0,0,513,514,C
1-PB2,2272,515,0,1,0,516,A
1-PB2,2273,0,512,0,0,512,T
1-PB2,2274,0,0,0,516,516,C
1-PB2,2275,516,0,0,0,516,A
1-PB2,2276,515,0,0,0,515,A
1-PB2,2277,0,501,0,2,503,T
1-PB2,2278,0,457,0,0,457,T
1-PB2,2279,440,0,0,0,440,A
1-PB2,2280,438,0,0,0,438,A
2-PB1,1,408,0,0,0,408,A
2-PB1,2,0,410,0,0,410,T
2-PB1,3,0,0,418,0,418,G
2-PB1,4,0,2,444,0,446,G
2-PB1,5,498,0,0,0,498,A
2-PB1,6,0,525,0,0,525,T
2-PB1,7,0,0,530,0,530,G
2-PB1,8,0,534,0,1,535,T
2-PB1,9,0,0,0,586,586,C
2-PB1,10,586,0,0,0,586,A
2-PB1,11,602,0,0,0,602,A
2-PB1,12,0,606,0,0,606,T
2-PB1,13,0,1,0,612,613,C
2-PB1,14,0,0,0,642,642,C
2-PB1,15,0,8,651,0,659,G
2-PB1,16,729,0,0,0,729,A
2-PB1,17,0,0,0,745,745,C
2-PB1,18,0,736,0,2,738,T
2-PB1,19,1,0,0,867,868,C
2-PB1,20,0,867,0,3,870,T
2-PB1,21,871,0,0,0,871,A
2-PB1,22,0,0,0,872,872,C
2-PB1,23,0,875,0,1,876,T
2-PB1,24,0,0,976,0,976,G
2-PB1,25,0,982,0,1,983,T
2-PB1,26,0,983,0,0,983,T
2-PB1,27,5,1,0,972,978,C
2-PB1,28,0,0,0,979,979,C
2-PB1,29,0,1158,0,2,1160,T
2-PB1,30,1175,0,0,0,1175,A
2-PB1,31,1171,0,1,0,1172,A
2-PB1,32,1176,0,0,0,1176,A
2-PB1,33,0,2,1185,0,1187,G
2-PB1,34,1,2,1189,0,1192,G
2-PB1,35,0,1201,0,1,1202,T
2-PB1,36,0,1197,0,1,1198,T
2-PB1,37,2,0,0,1199,1201,C
2-PB1,38,1,0,0,1197,1198,C
2-PB1,39,1201,0,2,0,1203,A
2-PB1,40,0,0,1227,0,1227,G
2-PB1,41,0,0,0,1226,1226,C
2-PB1,42,1,0,1228,0,1229,G
2-PB1,43,0,1,1,1232,1234,C
2-PB1,44,1232,0,1,0,1233,A
2-PB1,45,1234,0,2,0,1236,A
2-PB1,46,1237,0,1,0,1238,A
2-PB1,47,1248,0,0,0,1248,A
2-PB1,48,0,1263,0,0,1263,T
2-PB1,49,1,0,1319,0,1320,G
2-PB1,50,0,0,0,1324,1324,C
2-PB1,51,6,0,0,1317,1323,C
2-PB1,52,1324,0,2,1,1327,A
2-PB1,53,1,1330,0,0,1331,T
2-PB1,54,1405,0,1,0,1406,A
2-PB1,55,1407,0,0,0,1407,A
2-PB1,56,0,1,1460,0,1461,G
2-PB1,57,0,0,0,1458,1458,C
2-PB1,58,1456,0,0,0,1456,A
2-PB1,59,1,1,0,1503,1505,C
2-PB1,60,1506,0,2,0,1508,A
2-PB1,61,1589,0,1,0,1590,A
2-PB1,62,1,0,0,1598,1599,C
2-PB1,63,1588,0,0,1,1589,A
2-PB1,64,0,1592,0,3,1595,T
2-PB1,65,1,1573,0,1,1575,T
2-PB1,66,2,0,0,2177,2179,C
2-PB1,67,1,0,1,2180,2182,C
2-PB1,68,1,0,0,2202,2203,C
2-PB1,69,0,2197,0,10,2207,T
2-PB1,70,0,2193,0,0,2193,T
2-PB1,71,2353,0,0,0,2353,A
2-PB1,72,0,2363,0,0,2363,T
2-PB1,73,2424,0,0,0,2424,A
2-PB1,74,0,3,0,2443,2446,C
2-PB1,75,0,2326,0,5,2331,T
2-PB1,76,0,4,2336,0,2340,G
2-PB1,77,0,4,2331,0,2335,G
2-PB1,78,2327,0,3,0,2330,A
2-PB1,79,0,1,2328,0,2329,G
2-PB1,80,2303,1,5,0,2309,A
2-PB1,81,0,1,0,2283,2284,C
2-PB1,82,2,0,0,2428,2430,C
2-PB1,83,5,0,0,2443,2448,C
2-PB1,84,1,2438,0,3,2442,T
2-PB1,85,4,0,0,2654,2658,C
2-PB1,86,5,0,0,2656,2661,C
2-PB1,87,2689,0,2,0,2691,A
2-PB1,88,0,2689,0,1,2690,T
2-PB1,89,2682,0,6,0,2688,A
2-PB1,90,2,0,0,2690,2692,C
2-PB1,91,2641,1,4,0,2646,A
2-PB1,92,1,0,2743,0,2744,G
2-PB1,93,0,0,0,2758,2758,C
2-PB1,94,3,0,0,2731,2734,C
2-PB1,95,2742,1,0,0,2743,A
2-PB1,96,0,2731,0,1,2732,T
2-PB1,97,0,3,2749,0,2752,G
2-PB1,98,0,10,2868,0,2878,G
2-PB1,99,2893,1,2,1,2897,A
2-PB1,100,2909,0,6,0,2915,A
2-PB1,101,0,1,0,2918,2919,C
2-PB1,102,2884,1,6,0,2891,A
2-PB1,103,2,3,2973,0,2978,G
2-PB1,104,3,4,2997,0,3004,G
2-PB1,105,3007,2,3,0,3012,A
2-PB1,106,3025,0,7,0,3032,A
2-PB1,107,0,0,0,3046,3046,C
2-PB1,108,3002,0,4,0,3006,A
2-PB1,109,0,6,3414,0,3420,G
2-PB1,110,0,2,3407,0,3409,G
2-PB1,111,1,1,3470,0,3472,G
2-PB1,112,0,3451,0,3,3454,T
2-PB1,113,3449,1,4,0,3454,A
2-PB1,114,1,2,0,3466,3469,C
2-PB1,115,3583,1,2,1,3587,A
2-PB1,116,0,0,0,3678,3678,C
2-PB1,117,5,0,0,3644,3649,C
2-PB1,118,3511,1,2,0,3514,A
2-PB1,119,0,3508,0,3,3511,T
2-PB1,120,1,6,3471,1,3479,G
2-PB1,121,0,8,3487,0,3495,G
2-PB1,122,3487,0,10,0,3497,A
2-PB1,123,2,1,0,3488,3491,C
2-PB1,124,3414,0,1,0,3415,A
2-PB1,125,1,2,0,3483,3486,C
2-PB1,126,3457,0,7,1,3465,A
2-PB1,127,3,0,3536,0,3539,G
2-PB1,128,0,3515,0,2,3517,T
2-PB1,129,9,0,0,3637,3646,C
2-PB1,130,3649,0,4,0,3653,A
2-PB1,131,3682,0,5,0,3687,A
2-PB1,132,0,0,0,3681,3681,C
2-PB1,133,3655,0,0,1,3656,A
2-PB1,134,1,8,3701,0,3710,G
2-PB1,135,3637,0,3,0,3640,A
2-PB1,136,3629,2,8,0,3639,A
2-PB1,137,0,0,0,3630,3630,C
2-PB1,138,3552,1,3,0,3556,A
2-PB1,139,0,1,0,3693,3694,C
2-PB1,140,3670,2,1,0,3673,A
2-PB1,141,0,2,0,3846,3848,C
2-PB1,142,5,0,0,3843,3848,C
2-PB1,143,3808,1,4,1,3814,A
2-PB1,144,3868,1,1,0,3870,A
2-PB1,145,1,3936,0,1,3938,T
2-PB1,146,4052,0,0,0,4052,A
2-PB1,147,0,4040,0,1,4041,T
2-PB1,148,0,3942,0,4,3946,T
2-PB1,149,4,1,1,3945,3951,C
2-PB1,150,3816,1,3,0,3820,A
2-PB1,151,3,2,3829,0,3834,G
2-PB1,152,3763,0,3,2,3768,A
2-PB1,153,1,7,3809,0,3817,G
2-PB1,154,3684,1,3,0,3688,A
2-PB1,155,2,4,3607,0,3613,G
2-PB1,156,0,8,3592,0,3600,G
2-PB1,157,1,9,3691,0,3701,G
2-PB1,158,0,3,3712,0,3715,G
2-PB1,159,1,2,3736,1,3740,G
2-PB1,160,3745,0,3,0,3748,A
2-PB1,161,3747,0,3,0,3750,A
2-PB1,162,2,1,3777,0,3780,G
2-PB1,163,0,3754,0,2,3756,T
2-PB1,164,2,10,3710,0,3722,G
2-PB1,165,0,4,3706,0,3710,G
2-PB1,166,3704,0,9,0,3713,A
2-PB1,167,0,4,0,3735,3739,C
2-PB1,168,4,18,3729,0,3751,G
2-PB1,169,3766,3,7,0,3776,A
2-PB1,170,0,0,0,3807,3807,C
2-PB1,171,3788,0,0,0,3788,A
2-PB1,172,3796,0,1,0,3797,A
2-PB1,173,3826,1,3,0,3830,A
2-PB1,174,0,3877,0,2,3879,T
2-PB1,175,3900,0,0,0,3900,A
2-PB1,176,0,0,0,3909,3909,C
2-PB1,177,3842,0,7,1,3850,A
2-PB1,178,1,5,3871,0,3877,G
2-PB1,179,3828,0,1,0,3829,A
2-PB1,180,3870,0,1,1,3872,A
2-PB1,181,3877,0,1,0,3878,A
2-PB1,182,0,0,0,3893,3893,C
2-PB1,183,0,3808,0,2,3810,T
2-PB1,184,0,7,3802,1,3810,G
2-PB1,185,3,5,3758,0,3766,G
2-PB1,186,1,8,3760,0,3769,G
2-PB1,187,2,1,3774,0,3777,G
2-PB1,188,0,2,0,3780,3782,C
2-PB1,189,3777,0,4,1,3782,A
2-PB1,190,3,0,0,3906,3909,C
2-PB1,191,9,4,0,3876,3889,C
2-PB1,192,7,1,0,3884,3892,C
2-PB1,193,11,2,0,3892,3905,C
2-PB1,194,3930,1,2,1,3934,A
2-PB1,195,3981,0,1,0,3982,A
2-PB1,196,0,0,0,3977,3977,C
2-PB1,197,1,3947,0,4,3952,T
2-PB1,198,10,1,0,3958,3969,C
2-PB1,199,3810,0,4,0,3814,A
2-PB1,200,3906,0,2,0,3908,A
2-PB1,201,0,3,1,3887,3891,C
2-PB1,202,7,1,0,3865,3873,C
2-PB1,203,13,0,0,3853,3866,C
2-PB1,204,3820,0,2,0,3822,A
2-PB1,205,3828,1,4,0,3833,A
2-PB1,206,1,3838,1,0,3840,T
2-PB1,207,0,3835,0,0,3835,T
2-PB1,208,1,8,3835,0,3844,G
2-PB1,209,3782,0,2,0,3784,A
2-PB1,210,0,3786,0,7,3793,T
2-PB1,211,3,6,3775,0,3784,G
2-PB1,212,1,7,3832,0,3840,G
2-PB1,213,3853,1,10,1,3865,A
2-PB1,214,3,0,0,3899,3902,C
2-PB1,215,10,3,0,3859,3872,C
2-PB1,216,3862,0,4,0,3866,A
2-PB1,217,1,1,0,3962,3964,C
2-PB1,218,0,3945,0,0,3945,T
2-PB1,219,4011,0,5,0,4016,A
2-PB1,220,1,3,0,4039,4043,C
2-PB1,221,7,0,0,3992,3999,C
2-PB1,222,0,3922,1,3,3926,T
2-PB1,223,3,3,3936,0,3942,G
2-PB1,224,3909,0,3,0,3912,A
2-PB1,225,1,5,3953,0,3959,G
2-PB1,226,1,2,3907,0,3910,G
2-PB1,227,3910,1,3,0,3914,A
2-PB1,228,0,3878,0,5,3883,T
2-PB1,229,3797,0,0,0,3797,A
2-PB1,230,3793,0,7,0,3800,A
2-PB1,231,1,3791,0,2,3794,T
2-PB1,232,1,15,3771,0,3787,G
2-PB1,233,3772,0,3,0,3775,A
2-PB1,234,3735,0,4,0,3739,A
2-PB1,235,0,3,0,3740,3743,C
2-PB1,236,10,1,0,3662,3673,C
2-PB1,237,3672,0,0,0,3672,A
2-PB1,238,3668,0,4,0,3672,A
2-PB1,239,3,0,3716,0,3719,G
2-PB1,240,1,3708,0,1,3710,T
2-PB1,241,4,5,3674,0,3683,G
2-PB1,242,1,4,3732,0,3737,G
2-PB1,243,3718,1,4,0,3723,A
2-PB1,244,0,3710,0,1,3711,T
2-PB1,245,3727,0,4,0,3731,A
2-PB1,246,0,3793,0,0,3793,T
2-PB1,247,3,1,3802,0,3806,G
2-PB1,248,2,2,1,3800,3805,C
2-PB1,249,3796,0,2,0,3798,A
2-PB1,250,1,3,0,3928,3932,C
2-PB1,251,3842,1,1,0,3844,A
2-PB1,252,3912,1,2,0,3915,A
2-PB1,253,3910,0,8,0,3918,A
2-PB1,254,0,0,0,3922,3922,C
2-PB1,255,3774,1,0,1,3776,A
2-PB1,256,2,10,3822,0,3834,G
2-PB1,257,3786,0,4,1,3791,A
2-PB1,258,2,2,0,3822,3826,C
2-PB1,259,0,3658,0,5,3663,T
2-PB1,260,0,0,3739,0,3739,G
2-PB1,261,0,3671,0,4,3675,T
2-PB1,262,0,1,3848,0,3849,G
2-PB1,263,0,3841,0,1,3842,T
2-PB1,264,10,1,0,3850,3861,C
2-PB1,265,5,1,0,3845,3851,C
2-PB1,266,0,3796,0,2,3798,T
2-PB1,267,1,5,3787,0,3793,G
2-PB1,268,0,3,3783,0,3786,G
2-PB1,269,3662,1,9,0,3672,A
2-PB1,270,0,2,3740,0,3742,G
2-PB1,271,1,2,3569,0,3572,G
2-PB1,272,3,0,0,3586,3589,C
2-PB1,273,1,3552,0,4,3557,T
2-PB1,274,3573,0,1,0,3574,A
2-PB1,275,1,3567,0,6,3574,T
2-PB1,276,0,6,3559,1,3566,G
2-PB1,277,1,2,3563,0,3566,G
2-PB1,278,1,1,0,3537,3539,C
2-PB1,279,8,0,0,3457,3465,C
2-PB1,280,0,3404,0,5,3409,T
2-PB1,281,2,3613,0,2,3617,T
2-PB1,282,3,1,0,3635,3639,C
2-PB1,283,4,1,0,3638,3643,C
2-PB1,284,0,3645,2,5,3652,T
2-PB1,285,0,3629,0,4,3633,T
2-PB1,286,0,10,3638,0,3648,G
2-PB1,287,3642,0,1,1,3644,A
2-PB1,288,3656,1,1,0,3658,A
2-PB1,289,1,8,3646,0,3655,G
2-PB1,290,3431,0,0,0,3431,A
2-PB1,291,3459,0,2,0,3461,A
2-PB1,292,2,3446,0,0,3448,T
2-PB1,293,8,2,0,3451,3461,C
2-PB1,294,6,0,1,3431,3438,C
2-PB1,295,8,0,0,3409,3417,C
2-PB1,296,3423,0,2,0,3425,A
2-PB1,297,0,0,1,3430,3431,C
2-PB1,298,2,0,0,3422,3424,C
2-PB1,299,5,1,0,3437,3443,C
2-PB1,300,3384,0,6,0,3390,A
2-PB1,301,2,3,3427,0,3432,G
2-PB1,302,4,2,3434,0,3440,G
2-PB1,303,0,3438,0,2,3440,T
2-PB1,304,3455,0,2,0,3457,A
2-PB1,305,0,3425,0,1,3426,T
2-PB1,306,1,0,0,3432,3433,C
2-PB1,307,0,3445,0,2,3447,T
2-PB1,308,0,3433,0,1,3434,T
2-PB1,309,0,3419,0,2,3421,T
2-PB1,310,0,7,3389,0,3396,G
2-PB1,311,3347,0,7,0,3354,A
2-PB1,312,1,7,3365,0,3373,G
2-PB1,313,3299,1,2,0,3302,A
2-PB1,314,3327,0,1,0,3328,A
2-PB1,315,0,0,0,3352,3352,C
2-PB1,316,0,3306,0,0,3306,T
2-PB1,317,7,0,0,3307,3314,C
2-PB1,318,3308,0,3,1,3312,A
2-PB1,319,0,3310,0,1,3311,T
2-PB1,320,0,0,3310,0,3310,G
2-PB1,321,1,1,0,3384,3386,C
2-PB1,322,5,0,0,3394,3399,C
2-PB1,323,0,3373,0,4,3377,T
2-PB1,324,1,3319,0,3,3323,T
2-PB1,325,1,7,3322,0,3330,G
2-PB1,326,3349,1,1,0,3351,A
2-PB1,327,3357,1,8,1,3367,A
2-PB1,328,3347,1,7,0,3355,A
2-PB1,329,1,0,0,3374,3375,C
2-PB1,330,3239,0,0,0,3239,A
2-PB1,331,3264,2,1,0,3267,A
2-PB1,332,0,3262,0,0,3262,T
2-PB1,333,0,6,3256,0,3262,G
2-PB1,334,1,5,3242,0,3248,G
2-PB1,335,3202,0,4,0,3206,A
2-PB1,336,3188,0,6,0,3194,A
2-PB1,337,0,0,3198,0,3198,G
2-PB1,338,3,1,0,3196,3200,C
2-PB1,339,7,1,0,3146,3154,C
2-PB1,340,5,1,3218,0,3224,G
2-PB1,341,0,3195,1,5,3201,T
2-PB1,342,0,3193,1,6,3200,T
2-PB1,343,10,1,0,3247,3258,C
2-PB1,344,3262,0,5,0,3267,A
2-PB1,345,3303,0,5,0,3308,A
2-PB1,346,0,1,0,3315,3316,C
2-PB1,347,3290,0,0,0,3290,A
2-PB1,348,0,6,3307,1,3314,G
2-PB1,349,3232,0,5,0,3237,A
2-PB1,350,1,0,0,3239,3240,C
2-PB1,351,3234,1,3,0,3238,A
2-PB1,352,3264,0,7,0,3271,A
2-PB1,353,3,7,3291,0,3301,G
2-PB1,354,0,1,3241,0,3242,G
2-PB1,355,3,2,3254,0,3259,G
2-PB1,356,2,3169,1,2,3174,T
2-PB1,357,2,10,3150,0,3162,G
2-PB1,358,1,7,3164,0,3172,G
2-PB1,359,3167,1,8,0,3176,A
2-PB1,360,1,1,0,3175,3177,C
2-PB1,361,3102,0,0,0,3102,A
2-PB1,362,3151,0,0,0,3151,A
2-PB1,363,3158,0,2,2,3162,A
2-PB1,364,1,2,0,3156,3159,C
2-PB1,365,0,3128,0,2,3130,T
2-PB1,366,3131,0,1,2,3134,A
2-PB1,367,3160,0,1,0,3161,A
2-PB1,368,1,0,0,3144,3145,C
2-PB1,369,8,0,0,3133,3141,C
2-PB1,370,9,0,0,3122,3131,C
2-PB1,371,2986,1,1,0,2988,A
2-PB1,372,2983,1,1,0,2985,A
2-PB1,373,0,7,2976,0,2983,G
2-PB1,374,1,0,3001,1,3003,G
2-PB1,375,1,2976,0,6,2983,T
2-PB1,376,16,2,0,2959,2977,C
2-PB1,377,4,1,2972,0,2977,G
2-PB1,378,4,1,0,2958,2963,C
2-PB1,379,3,0,0,2976,2979,C
2-PB1,380,2977,1,5,0,2983,A
2-PB1,381,0,7,3034,1,3042,G
2-PB1,382,3108,0,6,1,3115,A
2-PB1,383,1,0,0,3142,3143,C
2-PB1,384,0,3095,2,3,3100,T
2-PB1,385,0,3087,0,2,3089,T
2-PB1,386,3083,0,2,0,3085,A
2-PB1,387,0,3108,1,1,3110,T
2-PB1,388,1,7,3118,0,3126,G
2-PB1,389,3087,0,3,0,3090,A
2-PB1,390,1,3017,1,1,3020,T
2-PB1,391,0,2888,1,1,2890,T
2-PB1,392,1,5,2847,0,2853,G
2-PB1,393,0,3,2863,0,2866,G
2-PB1,394,2897,0,6,0,2903,A
2-PB1,395,0,3,0,2891,2894,C
2-PB1,396,2861,0,0,0,2861,A
2-PB1,397,0,2836,0,0,2836,T
2-PB1,398,1,2877,0,0,2878,T
2-PB1,399,2896,1,1,0,2898,A
2-PB1,400,2883,0,1,1,2885,A
2-PB1,401,2900,1,0,0,2901,A
2-PB1,402,0,2,0,2892,2894,C
2-PB1,403,2810,0,2,0,2812,A
2-PB1,404,0,2,2849,0,2851,G
2-PB1,405,2819,0,6,0,2825,A
2-PB1,406,2808,0,5,0,2813,A
2-PB1,407,2831,3,0,2,2836,A
2-PB1,408,2,2788,0,4,2794,T
2-PB1,409,9,0,0,2798,2807,C
2-PB1,410,2791,1,2,0,2794,A
2-PB1,411,2796,1,2,0,2799,A
2-PB1,412,3,1,0,2795,2799,C
2-PB1,413,1,2,0,2773,2776,C
2-PB1,414,1,4,2758,0,2763,G
2-PB1,415,1,2,2774,0,2777,G
2-PB1,416,0,1,1,2776,2778,C
2-PB1,417,2769,1,4,0,2774,A
2-PB1,418,2,0,2785,0,2787,G
2-PB1,419,0,0,0,2816,2816,C
2-PB1,420,2805,0,1,0,2806,A
2-PB1,421,2813,0,6,0,2819,A
2-PB1,422,0,0,0,2828,2828,C
2-PB1,423,0,2806,0,4,2810,T
2-PB1,424,2,1,2949,0,2952,G
2-PB1,425,0,4,0,2941,2945,C
2-PB1,426,2950,2,0,0,2952,A
2-PB1,427,0,2947,1,5,2953,T
2-PB1,428,1,2890,0,2,2893,T
2-PB1,429,3055,2,1,0,3058,A
2-PB1,430,0,0,3066,0,3066,G
2-PB1,431,1,2,0,3042,3045,C
2-PB1,432,5,0,0,3040,3045,C
2-PB1,433,2893,0,3,0,2896,A
2-PB1,434,2903,0,4,0,2907,A
2-PB1,435,0,0,0,2921,2921,C
2-PB1,436,2933,0,0,0,2933,A
2-PB1,437,1,1,0,3047,3049,C
2-PB1,438,7,0,0,2829,2836,C
2-PB1,439,2825,0,4,1,2830,A
2-PB1,440,0,2815,0,0,2815,T
2-PB1,441,2836,0,0,0,2836,A
2-PB1,442,1,2,2845,0,2848,G
2-PB1,443,2791,0,1,0,2792,A
2-PB1,444,2757,2,3,0,2762,A
2-PB1,445,0,0,2808,0,2808,G
2-PB1,446,0,2690,1,0,2691,T
2-PB1,447,0,2691,0,1,2692,T
2-PB1,448,0,2689,1,1,2691,T
2-PB1,449,1,2689,1,2,2693,T
2-PB1,450,0,2711,0,1,2712,T
2-PB1,451,2686,0,2,0,2688,A
2-PB1,452,0,3,2698,0,2701,G
2-PB1,453,2678,0,1,0,2679,A
2-PB1,454,1,2677,0,0,2678,T
2-PB1,455,8,0,0,2621,2629,C
2-PB1,456,1,11,2615,0,2627,G
2-PB1,457,2619,2,2,0,2623,A
2-PB1,458,2630,1,1,0,2632,A
2-PB1,459,0,2,0,2647,2649,C
2-PB1,460,1,6,2647,0,2654,G
2-PB1,461,0,3,2763,0,2766,G
2-PB1,462,2748,0,3,0,2751,A
2-PB1,463,1,2744,0,0,2745,T
2-PB1,464,0,2759,0,2,2761,T
2-PB1,465,2778,1,6,1,2786,A
2-PB1,466,2780,0,6,1,2787,A
2-PB1,467,0,0,0,2804,2804,C
2-PB1,468,2773,1,2,0,2776,A
2-PB1,469,157,0,2625,0,2782,G
2-PB1,470,1,2,0,2647,2650,C
2-PB1,471,0,2637,0,1,2638,T
2-PB1,472,2649,1,1,0,2651,A
2-PB1,473,2647,0,1,1,2649,A
2-PB1,474,0,2612,0,0,2612,T
2-PB1,475,0,9,2636,0,2645,G
2-PB1,476,2627,0,0,0,2627,A
2-PB1,477,2623,0,2,0,2625,A
2-PB1,478,1,2556,0,0,2557,T
2-PB1,479,5,0,0,2589,2594,C
2-PB1,480,2570,0,4,1,2575,A
2-PB1,481,0,2,2560,0,2562,G
2-PB1,482,0,4,2576,0,2580,G
2-PB1,483,2568,1,2,0,2571,A
2-PB1,484,2521,1,1,0,2523,A
2-PB1,485,1,1,2703,1,2706,G
2-PB1,486,0,0,2713,0,2713,G
2-PB1,487,0,0,0,2715,2715,C
2-PB1,488,1,2697,0,5,2703,T
2-PB1,489,2712,0,1,0,2713,A
2-PB1,490,2713,0,2,1,2716,A
2-PB1,491,0,2710,0,3,2713,T
2-PB1,492,2717,1,0,0,2718,A
2-PB1,493,2,3,2733,0,2738,G
2-PB1,494,2533,0,1,0,2534,A
2-PB1,495,0,2506,1,1,2508,T
2-PB1,496,0,2483,0,3,2486,T
2-PB1,497,0,2481,1,2,2484,T
2-PB1,498,2,0,0,2557,2559,C
2-PB1,499,3,1,0,2577,2581,C
2-PB1,500,1,2547,0,3,2551,T
2-PB1,501,6,0,0,2572,2578,C
2-PB1,502,2578,0,1,0,2579,A
2-PB1,503,2589,0,1,0,2590,A
2-PB1,504,2,6,2594,1,2603,G
2-PB1,505,0,3,2630,0,2633,G
2-PB1,506,2632,0,0,0,2632,A
2-PB1,507,0,2520,0,0,2520,T
2-PB1,508,0,0,2551,0,2551,G
2-PB1,509,2,2533,0,2,2537,T
2-PB1,510,1,3,2569,0,2573,G
2-PB1,511,2553,1,5,0,2559,A
2-PB1,512,0,2567,0,1,2568,T
2-PB1,513,0,5,2554,0,2559,G
2-PB1,514,1,4,2544,0,2549,G
2-PB1,515,2562,0,1,0,2563,A
2-PB1,516,2560,0,4,0,2564,A
2-PB1,517,0,2516,0,1,2517,T
2-PB1,518,4,0,0,2534,2538,C
2-PB1,519,2513,0,1,0,2514,A
2-PB1,520,2510,1,1,0,2512,A
2-PB1,521,0,2508,0,1,2509,T
2-PB1,522,1,9,2547,0,2557,G
2-PB1,523,1,1,2566,0,2568,G
2-PB1,524,2564,0,0,0,2564,A
2-PB1,525,1,2560,0,0,2561,T
2-PB1,526,2557,0,0,0,2557,A
2-PB1,527,2552,0,1,0,2553,A
2-PB1,528,2532,0,3,0,2535,A
2-PB1,529,0,0,2584,0,2584,G
2-PB1,530,2540,0,3,0,2543,A
2-PB1,531,2,3,2549,1,2555,G
2-PB1,532,1,2,2548,1,2552,G
2-PB1,533,2531,0,3,0,2534,A
2-PB1,534,2541,1,0,1,2543,A
2-PB1,535,2561,0,3,0,2564,A
2-PB1,536,0,2558,0,0,2558,T
2-PB1,537,1,1,2651,0,2653,G
2-PB1,538,0,2,2638,0,2640,G
2-PB1,539,2597,2,7,0,2606,A
2-PB1,540,1,3,2617,0,2621,G
2-PB1,541,2592,0,3,0,2595,A
2-PB1,542,0,2638,0,1,2639,T
2-PB1,543,2636,0,3,0,2639,A
2-PB1,544,2657,0,1,0,2658,A
2-PB1,545,0,1,0,2647,2648,C
2-PB1,546,2543,0,0,0,2543,A
2-PB1,547,3,2,2525,0,2530,G
2-PB1,548,0,1,0,2556,2557,C
2-PB1,549,2568,0,0,0,2568,A
2-PB1,550,0,0,0,2568,2568,C
2-PB1,551,2527,0,1,0,2528,A
2-PB1,552,0,1,0,2574,2575,C
2-PB1,553,0,2549,1,3,2553,T
2-PB1,554,0,2546,1,1,2548,T
2-PB1,555,0,2543,1,3,2547,T
2-PB1,556,4,1,0,2538,2543,C
2-PB1,557,2552,0,2,0,2554,A
2-PB1,558,2554,0,1,1,2556,A
2-PB1,559,2550,0,2,1,2553,A
2-PB1,560,0,1,2608,0,2609,G
2-PB1,561,2536,1,2,0,2539,A
2-PB1,562,2550,0,0,0,2550,A
2-PB1,563,2545,0,0,0,2545,A
2-PB1,564,2547,0,3,2,2552,A
2-PB1,565,2545,0,11,0,2556,A
2-PB1,566,0,2,2580,0,2582,G
2-PB1,567,1,6,2568,0,2575,G
2-PB1,568,2521,0,7,0,2528,A
2-PB1,569,0,7,2608,0,2615,G
2-PB1,570,2570,0,3,1,2574,A
2-PB1,571,1,0,2715,0,2716,G
2-PB1,572,0,2693,0,1,2694,T
2-PB1,573,2685,0,11,0,2696,A
2-PB1,574,2686,1,6,0,2693,A
2-PB1,575,1,3,2693,0,2697,G
2-PB1,576,1,7,2689,0,2697,G
2-PB1,577,1,5,2707,0,2713,G
2-PB1,578,2657,0,3,0,2660,A
2-PB1,579,1,1,0,2682,2684,C
2-PB1,580,2592,0,6,0,2598,A
2-PB1,581,2614,0,4,0,2618,A
2-PB1,582,3,0,0,2606,2609,C
2-PB1,583,2600,1,3,0,2604,A
2-PB1,584,0,2555,0,2,2557,T
2-PB1,585,0,14,2514,0,2528,G
2-PB1,586,2532,1,4,0,2537,A
2-PB1,587,2,0,0,2536,2538,C
2-PB1,588,10,0,0,2486,2496,C
2-PB1,589,2502,0,2,0,2504,A
2-PB1,590,2519,0,0,0,2519,A
2-PB1,591,0,3,2537,0,2540,G
2-PB1,592,2541,1,1,0,2543,A
2-PB1,593,2533,0,3,0,2536,A
2-PB1,594,2508,1,1,0,2510,A
2-PB1,595,2512,1,5,0,2518,A
2-PB1,596,1,2508,0,1,2510,T
2-PB1,597,0,3,2508,0,2511,G
2-PB1,598,0,1,2527,1,2529,G
2-PB1,599,3,2496,0,2,2501,T
2-PB1,600,17,0,1,2478,2496,C
2-PB1,601,2503,0,5,0,2508,A
2-PB1,602,0,1,0,2650,2651,C
2-PB1,603,2703,3,0,0,2706,A
2-PB1,604,1,0,0,2717,2718,C
2-PB1,605,2714,0,0,0,2714,A
2-PB1,606,2794,1,1,0,2796,A
2-PB1,607,2773,0,5,0,2778,A
2-PB1,608,0,6,3015,0,3021,G
2-PB1,609,2997,1,3,2,3003,A
2-PB1,610,3031,0,3,2,3036,A
2-PB1,611,0,1,0,3116,3117,C
2-PB1,612,3040,0,2,0,3042,A
2-PB1,613,3059,0,5,1,3065,A
2-PB1,614,1,3051,0,2,3054,T
2-PB1,615,3015,0,2,0,3017,A
2-PB1,616,1,8,3012,0,3021,G
2-PB1,617,0,4,2911,0,2915,G
2-PB1,618,2,2,2920,0,2924,G
2-PB1,619,2903,0,2,0,2905,A
2-PB1,620,2879,0,3,0,2882,A
2-PB1,621,1,7,2910,0,2918,G
2-PB1,622,2892,0,2,0,2894,A
2-PB1,623,2916,0,0,0,2916,A
2-PB1,624,2921,1,2,0,2924,A
2-PB1,625,2939,0,0,1,2940,A
2-PB1,626,3005,0,4,0,3009,A
2-PB1,627,3016,0,3,0,3019,A
2-PB1,628,0,0,0,3025,3025,C
2-PB1,629,3013,1,1,0,3015,A
2-PB1,630,3015,0,3,0,3018,A
2-PB1,631,3009,0,1,1,3011,A
2-PB1,632,0,1,3072,0,3073,G
2-PB1,633,3072,0,5,0,3077,A
2-PB1,634,1,2,3205,0,3208,G
2-PB1,635,3,3162,0,1,3166,T
2-PB1,636,0,5,3643,0,3648,G
2-PB1,637,3648,1,4,0,3653,A
2-PB1,638,3653,0,5,1,3659,A
2-PB1,639,0,3723,0,2,3725,T
2-PB1,640,3713,0,4,0,3717,A
2-PB1,641,3693,0,5,0,3698,A
2-PB1,642,1,9,3703,0,3713,G
2-PB1,643,3540,0,10,1,3551,A
2-PB1,644,0,3,3616,0,3619,G
2-PB1,645,3393,1,4,0,3398,A
2-PB1,646,0,4,3419,0,3423,G
2-PB1,647,1,1,3410,0,3412,G
2-PB1,648,1,1,0,3424,3426,C
2-PB1,649,0,3387,1,2,3390,T
2-PB1,650,3512,0,2,0,3514,A
2-PB1,651,1,0,0,3727,3728,C
2-PB1,652,7,6,0,3731,3744,C
2-PB1,653,1,3753,1,3,3758,T
2-PB1,654,3912,0,1,0,3913,A
2-PB1,655,3893,0,3,0,3896,A
2-PB1,656,0,3906,0,0,3906,T
2-PB1,657,3883,1,2,0,3886,A
2-PB1,658,3874,0,3,1,3878,A
2-PB1,659,0,10,3896,0,3906,G
2-PB1,660,3737,1,5,1,3744,A
2-PB1,661,0,0,3819,0,3819,G
2-PB1,662,1,0,0,3836,3837,C
2-PB1,663,0,3710,3,9,3722,T
2-PB1,664,0,3738,0,3,3741,T
2-PB1,665,1,3728,0,4,3733,T
2-PB1,666,1,10,3728,0,3739,G
2-PB1,667,3827,0,4,0,3831,A
2-PB1,668,0,1,1,3850,3852,C
2-PB1,669,3835,1,3,0,3839,A
2-PB1,670,0,3824,0,7,3831,T
2-PB1,671,0,3796,0,1,3797,T
2-PB1,672,1,24,3839,0,3864,G
2-PB1,673,3861,1,6,0,3868,A
2-PB1,674,3869,1,4,1,3875,A
2-PB1,675,0,3,0,3894,3897,C
2-PB1,676,3864,0,3,0,3867,A
2-PB1,677,1,3,0,3853,3857,C
2-PB1,678,0,6,3850,0,3856,G
2-PB1,679,3852,0,6,0,3858,A
2-PB1,680,0,3873,0,1,3874,T
2-PB1,681,2,20,3956,0,3978,G
2-PB1,682,3981,2,3,0,3986,A
2-PB1,683,1,1,0,3997,3999,C
2-PB1,684,9,1,0,3992,4002,C
2-PB1,685,4014,0,5,0,4019,A
2-PB1,686,4059,2,4,1,4066,A
2-PB1,687,4053,1,10,1,4065,A
2-PB1,688,1,4,4200,0,4205,G
2-PB1,689,4238,0,5,0,4243,A
2-PB1,690,1,4161,0,4,4166,T
2-PB1,691,2,3,4186,0,4191,G
2-PB1,692,2,4,0,4156,4162,C
2-PB1,693,4140,0,5,0,4145,A
2-PB1,694,0,9,4167,0,4176,G
2-PB1,695,4072,0,7,1,4080,A
2-PB1,696,2,5,4113,0,4120,G
2-PB1,697,3933,2,8,0,3943,A
2-PB1,698,0,5,3974,0,3979,G
2-PB1,699,3889,3,12,0,3904,A
2-PB1,700,0,10,3916,0,3926,G
2-PB1,701,3,0,3915,0,3918,G
2-PB1,702,4,2,0,3922,3928,C
2-PB1,703,3885,0,2,1,3888,A
2-PB1,704,3905,0,5,0,3910,A
2-PB1,705,3918,0,2,1,3921,A
2-PB1,706,0,3917,1,3,3921,T
2-PB1,707,0,3911,1,0,3912,T
2-PB1,708,3946,0,3,0,3949,A
2-PB1,709,3944,0,0,3,3947,A
2-PB1,710,3938,0,6,1,3945,A
2-PB1,711,3966,0,2,0,3968,A
2-PB1,712,3980,0,2,0,3982,A
2-PB1,713,0,4,3980,1,3985,G
2-PB1,714,3933,1,2,0,3936,A
2-PB1,715,3919,1,2,0,3922,A
2-PB1,716,2,13,3992,0,4007,G
2-PB1,717,2,7,4070,0,4079,G
2-PB1,718,1,1,4081,0,4083,G
2-PB1,719,4,2,0,4116,4122,C
2-PB1,720,0,4111,0,1,4112,T
2-PB1,721,4154,0,1,0,4155,A
2-PB1,722,1,4195,0,10,4206,T
2-PB1,723,0,4199,1,3,4203,T
2-PB1,724,0,3,4225,0,4228,G
2-PB1,725,1,0,1,4178,4180,C
2-PB1,726,4042,0,8,1,4051,A
2-PB1,727,4043,0,10,1,4054,A
2-PB1,728,0,4,0,4028,4032,C
2-PB1,729,4030,0,1,0,4031,A
2-PB1,730,1,1,0,4029,4031,C
2-PB1,731,5,1,0,3896,3902,C
2-PB1,732,10,3,0,3903,3916,C
2-PB1,733,2,15,3875,0,3892,G
2-PB1,734,0,3,3891,0,3894,G
2-PB1,735,3,7,3893,0,3903,G
2-PB1,736,3911,0,0,0,3911,A
2-PB1,737,0,3904,1,4,3909,T
2-PB1,738,3,2,3913,0,3918,G
2-PB1,739,2,1,0,3899,3902,C
2-PB1,740,3947,0,4,0,3951,A
2-PB1,741,4060,0,6,0,4066,A
2-PB1,742,4112,0,0,0,4112,A
2-PB1,743,0,4105,0,0,4105,T
2-PB1,744,0,4111,0,0,4111,T
2-PB1,745,4074,0,3,0,4077,A
2-PB1,746,0,5,4075,0,4080,G
2-PB1,747,4012,1,6,1,4020,A
2-PB1,748,1,12,4045,0,4058,G
2-PB1,749,1,7,3973,0,3981,G
2-PB1,750,1,2,4110,0,4113,G
2-PB1,751,0,4086,0,2,4088,T
2-PB1,752,1,4066,0,3,4070,T
2-PB1,753,17,1,0,4064,4082,C
2-PB1,754,4,0,4147,0,4151,G
2-PB1,755,0,4140,0,3,4143,T
2-PB1,756,1,0,4145,0,4146,G
2-PB1,757,1,4134,0,2,4137,T
2-PB1,758,4096,0,1,0,4097,A
2-PB1,759,3,3,0,4082,4088,C
2-PB1,760,0,3825,0,4,3829,T
2-PB1,761,0,3851,0,1,3852,T
2-PB1,762,6,2,0,3843,3851,C
2-PB1,763,3,1,3794,1,3799,G
2-PB1,764,1,3785,0,3,3789,T
2-PB1,765,0,3780,1,5,3786,T
2-PB1,766,0,5,3778,0,3783,G
2-PB1,767,3764,0,1,0,3765,A
2-PB1,768,3766,1,3,0,3770,A
2-PB1,769,3809,1,3,1,3814,A
2-PB1,770,1,1,0,3838,3840,C
2-PB1,771,0,3788,2,1,3791,T
2-PB1,772,1,3762,0,2,3765,T
2-PB1,773,0,3786,0,2,3788,T
2-PB1,774,3843,0,4,0,3847,A
2-PB1,775,0,0,3854,0,3854,G
2-PB1,776,0,0,0,3872,3872,C
2-PB1,777,0,3879,0,1,3880,T
2-PB1,778,3822,1,1,0,3824,A
2-PB1,779,0,5,3818,1,3824,G
2-PB1,780,3806,0,3,0,3809,A
2-PB1,781,3805,0,6,1,3812,A
2-PB1,782,1,2,3828,0,3831,G
2-PB1,783,1,0,0,3751,3752,C
2-PB1,784,3750,1,0,0,3751,A
2-PB1,785,1,3730,1,1,3733,T
2-PB1,786,0,3726,0,2,3728,T
2-PB1,787,0,3735,0,2,3737,T
2-PB1,788,1,3,3736,0,3740,G
2-PB1,789,1,1,0,3724,3726,C
2-PB1,790,1,4,3735,0,3740,G
2-PB1,791,3724,2,1,0,3727,A
2-PB1,792,3717,0,0,0,3717,A
2-PB1,793,3719,1,1,0,3721,A
2-PB1,794,3848,0,4,0,3852,A
2-PB1,795,0,1,3920,0,3921,G
2-PB1,796,0,1,0,3928,3929,C
2-PB1,797,0,3926,0,9,3935,T
2-PB1,798,0,3920,0,1,3921,T
2-PB1,799,8,18,3901,0,3927,G
2-PB1,800,3916,0,4,0,3920,A
2-PB1,801,3916,1,2,1,3920,A
2-PB1,802,1,1,0,3941,3943,C
2-PB1,803,3730,0,4,0,3734,A
2-PB1,804,0,1,4057,0,4058,G
2-PB1,805,1,3986,0,2,3989,T
2-PB1,806,10,0,0,3989,3999,C
2-PB1,807,0,4006,0,4,4010,T
2-PB1,808,3,9,3994,0,4006,G
2-PB1,809,0,8,4011,0,4019,G
2-PB1,810,4004,3,5,0,4012,A
2-PB1,811,1,0,0,4034,4035,C
2-PB1,812,2,3848,2,4,3856,T
2-PB1,813,0,3567,0,2,3569,T
2-PB1,814,3,1,0,3563,3567,C
2-PB1,815,3,1,0,3561,3565,C
2-PB1,816,3,4,3585,1,3593,G
2-PB1,817,1,0,3620,0,3621,G
2-PB1,818,0,3566,0,4,3570,T
2-PB1,819,0,3561,0,1,3562,T
2-PB1,820,3,6,3548,0,3557,G
2-PB1,821,0,8,3583,0,3591,G
2-PB1,822,0,6,3625,0,3631,G
2-PB1,823,0,4,3634,0,3638,G
2-PB1,824,0,0,3654,0,3654,G
2-PB1,825,0,3608,0,2,3610,T
2-PB1,826,3596,0,3,1,3600,A
2-PB1,827,3629,0,7,0,3636,A
2-PB1,828,0,3635,0,0,3635,T
2-PB1,829,0,7,3644,0,3651,G
2-PB1,830,3579,0,3,0,3582,A
2-PB1,831,3518,0,3,0,3521,A
2-PB1,832,3529,1,4,0,3534,A
2-PB1,833,3529,0,6,0,3535,A
2-PB1,834,1,5,3523,0,3529,G
2-PB1,835,3476,1,4,0,3481,A
2-PB1,836,3461,0,3,0,3464,A
2-PB1,837,1,3,3481,0,3485,G
2-PB1,838,1,1,3457,0,3459,G
2-PB1,839,0,3,0,3453,3456,C
2-PB1,840,6,1,0,3445,3452,C
2-PB1,841,3475,0,3,1,3479,A
2-PB1,842,3468,0,5,0,3473,A
2-PB1,843,3466,1,4,0,3471,A
2-PB1,844,0,0,0,3477,3477,C
2-PB1,845,0,3457,1,5,3463,T
2-PB1,846,1,6,3544,0,3551,G
2-PB1,847,1,1,3540,0,3542,G
2-PB1,848,3,2,0,3541,3546,C
2-PB1,849,3558,0,2,1,3561,A
2-PB1,850,3544,1,3,0,3548,A
2-PB1,851,3560,0,2,0,3562,A
2-PB1,852,0,3565,1,2,3568,T
2-PB1,853,3,0,3577,0,3580,G
2-PB1,854,0,3539,1,6,3546,T
2-PB1,855,1,3426,0,1,3428,T
2-PB1,856,1,0,3443,1,3445,G
2-PB1,857,1,3422,0,1,3424,T
2-PB1,858,0,7,3426,0,3433,G
2-PB1,859,3431,0,6,0,3437,A
2-PB1,860,1,5,3456,0,3462,G
2-PB1,861,3460,0,1,0,3461,A
2-PB1,862,3433,0,1,0,3434,A
2-PB1,863,3423,1,3,0,3427,A
2-PB1,864,3455,0,1,0,3456,A
2-PB1,865,3473,1,5,0,3479,A
2-PB1,866,0,3466,1,2,3469,T
2-PB1,867,0,3,3470,0,3473,G
2-PB1,868,3458,0,4,0,3462,A
2-PB1,869,0,3416,2,2,3420,T
2-PB1,870,1,10,3437,0,3448,G
2-PB1,871,3442,2,3,0,3447,A
2-PB1,872,2,0,1,3503,3506,C
2-PB1,873,0,3488,1,1,3490,T
2-PB1,874,3486,0,1,0,3487,A
2-PB1,875,3514,0,6,0,3520,A
2-PB1,876,1,3519,0,0,3520,T
2-PB1,877,0,3569,1,5,3575,T
2-PB1,878,11,1,0,3597,3609,C
2-PB1,879,3576,0,11,0,3587,A
2-PB1,880,1,0,0,3597,3598,C
2-PB1,881,3533,0,2,0,3535,A
2-PB1,882,3540,0,10,0,3550,A
2-PB1,883,0,7,3551,0,3558,G
2-PB1,884,3633,0,6,0,3639,A
2-PB1,885,1,1,0,3634,3636,C
2-PB1,886,3603,1,5,0,3609,A
2-PB1,887,1,2,0,3593,3596,C
2-PB1,888,3563,0,0,2,3565,A
2-PB1,889,1,4,3583,0,3588,G
2-PB1,890,3546,0,8,1,3555,A
2-PB1,891,0,0,3599,0,3599,G
2-PB1,892,1,0,0,3581,3582,C
2-PB1,893,0,3462,0,10,3472,T
2-PB1,894,1,3532,0,0,3533,T
2-PB1,895,3,3518,0,2,3523,T
2-PB1,896,7,0,0,3525,3532,C
2-PB1,897,0,3521,1,6,3528,T
2-PB1,898,1,3481,2,4,3488,T
2-PB1,899,1,3488,1,8,3498,T
2-PB1,900,6,0,0,3481,3487,C
2-PB1,901,3488,3,3,0,3494,A
2-PB1,902,0,0,0,3516,3516,C
2-PB1,903,3444,1,2,0,3447,A
2-PB1,904,3467,0,2,0,3469,A
2-PB1,905,0,3485,0,2,3487,T
2-PB1,906,10,1,0,3554,3565,C
2-PB1,907,3564,0,1,0,3565,A
2-PB1,908,2,1,0,3589,3592,C
2-PB1,909,0,3559,2,1,3562,T
2-PB1,910,1,3,3599,0,3603,G
2-PB1,911,0,13,3558,0,3571,G
2-PB1,912,1,8,3700,0,3709,G
2-PB1,913,2,6,3715,0,3723,G
2-PB1,914,3642,0,3,0,3645,A
2-PB1,915,2,0,0,3496,3498,C
2-PB1,916,3569,0,4,0,3573,A
2-PB1,917,3838,0,3,0,3841,A
2-PB1,918,0,0,0,3877,3877,C
2-PB1,919,3862,0,4,0,3866,A
2-PB1,920,2,1,0,3861,3864,C
2-PB1,921,1,3634,1,1,3637,T
2-PB1,922,3674,0,0,0,3674,A
2-PB1,923,3655,2,7,0,3664,A
2-PB1,924,0,2,3689,0,3691,G
2-PB1,925,0,3663,2,3,3668,T
2-PB1,926,1,8,3374,0,3383,G
2-PB1,927,4,8,3326,0,3338,G
2-PB1,928,3326,1,3,0,3330,A
2-PB1,929,3331,0,3,0,3334,A
2-PB1,930,0,3331,0,2,3333,T
2-PB1,931,2,5,3334,0,3341,G
2-PB1,932,3337,1,1,0,3339,A
2-PB1,933,3272,0,1,0,3273,A
2-PB1,934,3287,0,4,0,3291,A
2-PB1,935,3325,0,3,0,3328,A
2-PB1,936,0,3309,0,0,3309,T
2-PB1,937,11,0,0,3308,3319,C
2-PB1,938,3312,1,2,0,3315,A
2-PB1,939,3308,0,4,0,3312,A
2-PB1,940,3288,0,7,0,3295,A
2-PB1,941,3300,0,1,0,3301,A
2-PB1,942,1,2,0,3327,3330,C
2-PB1,943,4,0,0,3295,3299,C
2-PB1,944,16,2,0,3268,3286,C
2-PB1,945,1,3259,0,7,3267,T
2-PB1,946,5,3,0,3285,3293,C
2-PB1,947,3,14,3271,0,3288,G
2-PB1,948,3292,0,2,0,3294,A
2-PB1,949,3294,0,4,0,3298,A
2-PB1,950,1,3297,0,2,3300,T
2-PB1,951,2,1,3299,0,3302,G
2-PB1,952,0,3267,0,2,3269,T
2-PB1,953,0,3255,0,2,3257,T
2-PB1,954,0,3259,0,1,3260,T
2-PB1,955,0,3249,0,1,3250,T
2-PB1,956,0,3257,1,1,3259,T
2-PB1,957,1,2,3254,0,3257,G
2-PB1,958,0,1,3240,0,3241,G
2-PB1,959,1,3,0,3242,3246,C
2-PB1,960,2,4,3175,0,3181,G
2-PB1,961,3193,0,2,0,3195,A
2-PB1,962,0,3291,0,2,3293,T
2-PB1,963,1,5,3411,0,3417,G
2-PB1,964,3552,1,1,0,3554,A
2-PB1,965,0,3578,0,6,3584,T
2-PB1,966,0,3583,0,0,3583,T
2-PB1,967,3604,0,3,0,3607,A
2-PB1,968,0,2,0,3614,3616,C
2-PB1,969,3611,0,3,1,3615,A
2-PB1,970,1,3602,1,3,3607,T
2-PB1,971,3403,2,0,0,3405,A
2-PB1,972,2,1,0,3399,3402,C
2-PB1,973,3023,0,5,0,3028,A
2-PB1,974,1,3002,0,2,3005,T
2-PB1,975,5,1,0,2993,2999,C
2-PB1,976,2996,0,4,0,3000,A
2-PB1,977,1,0,0,2991,2992,C
2-PB1,978,2964,0,0,1,2965,A
2-PB1,979,2970,0,1,0,2971,A
2-PB1,980,2960,0,4,0,2964,A
2-PB1,981,1,4,2814,0,2819,G
2-PB1,982,2987,1,0,0,2988,A
2-PB1,983,3004,0,3,0,3007,A
2-PB1,984,0,2990,0,1,2991,T
2-PB1,985,11,1,1,2995,3008,C
2-PB1,986,3005,0,5,1,3011,A
2-PB1,987,3026,0,3,0,3029,A
2-PB1,988,1,1,0,3023,3025,C
2-PB1,989,1,1,0,3011,3013,C
2-PB1,990,0,2772,0,4,2776,T
2-PB1,991,1,5,2798,0,2804,G
2-PB1,992,2762,0,3,0,2765,A
2-PB1,993,0,0,2788,0,2788,G
2-PB1,994,0,2777,0,1,2778,T
2-PB1,995,3,5,2697,0,2705,G
2-PB1,996,0,0,2850,0,2850,G
2-PB1,997,0,2841,0,2,2843,T
2-PB1,998,0,2838,1,2,2841,T
2-PB1,999,7,0,0,2844,2851,C
2-PB1,1000,2786,0,2,0,2788,A
2-PB1,1001,1,5,2858,0,2864,G
2-PB1,1002,2844,0,1,0,2845,A
2-PB1,1003,2853,0,2,0,2855,A
2-PB1,1004,2835,0,3,0,2838,A
2-PB1,1005,0,0,0,2549,2549,C
2-PB1,1006,2547,1,2,0,2550,A
2-PB1,1007,0,2526,1,1,2528,T
2-PB1,1008,2,0,1,2572,2575,C
2-PB1,1009,0,1,0,2567,2568,C
2-PB1,1010,0,2436,0,2,2438,T
2-PB1,1011,1,6,2442,0,2449,G
2-PB1,1012,2409,1,4,1,2415,A
2-PB1,1013,0,1,2441,0,2442,G
2-PB1,1014,0,2,0,2407,2409,C
2-PB1,1015,2307,0,0,0,2307,A
2-PB1,1016,0,2303,0,0,2303,T
2-PB1,1017,6,0,0,2278,2284,C
2-PB1,1018,0,1,2285,0,2286,G
2-PB1,1019,0,1,0,2403,2404,C
2-PB1,1020,2415,1,5,0,2421,A
2-PB1,1021,0,2,0,2528,2530,C
2-PB1,1022,3,1,0,2531,2535,C
2-PB1,1023,2539,0,1,0,2540,A
2-PB1,1024,2576,0,0,0,2576,A
2-PB1,1025,0,2577,0,2,2579,T
2-PB1,1026,2568,0,1,1,2570,A
2-PB1,1027,2572,0,2,1,2575,A
2-PB1,1028,0,2475,0,1,2476,T
2-PB1,1029,0,2,2487,0,2489,G
2-PB1,1030,0,2412,0,2,2414,T
2-PB1,1031,0,2393,0,3,2396,T
2-PB1,1032,5,1,0,2391,2397,C
2-PB1,1033,0,2381,0,0,2381,T
2-PB1,1034,8,0,0,2371,2379,C
2-PB1,1035,2383,0,0,0,2383,A
2-PB1,1036,2382,2,3,0,2387,A
2-PB1,1037,2393,0,2,0,2395,A
2-PB1,1038,0,0,0,2393,2393,C
2-PB1,1039,2386,0,0,0,2386,A
2-PB1,1040,2391,0,0,0,2391,A
2-PB1,1041,2372,0,1,2,2375,A
2-PB1,1042,2389,0,2,0,2391,A
2-PB1,1043,0,2414,0,0,2414,T
2-PB1,1044,1,6,2422,0,2429,G
2-PB1,1045,0,0,2418,0,2418,G
2-PB1,1046,2,2,0,2408,2412,C
2-PB1,1047,2402,1,2,1,2406,A
2-PB1,1048,2411,0,3,0,2414,A
2-PB1,1049,0,5,2431,0,2436,G
2-PB1,1050,2427,2,6,0,2435,A
2-PB1,1051,1,1,0,2454,2456,C
2-PB1,1052,0,2403,1,4,2408,T
2-PB1,1053,1,4,2473,0,2478,G
2-PB1,1054,0,2,2476,0,2478,G
2-PB1,1055,3,3,2505,0,2511,G
2-PB1,1056,2503,1,3,0,2507,A
2-PB1,1057,2515,0,1,0,2516,A
2-PB1,1058,2500,1,5,0,2506,A
2-PB1,1059,2499,0,5,0,2504,A
2-PB1,1060,0,8,2616,0,2624,G
2-PB1,1061,2,5,2608,1,2616,G
2-PB1,1062,2596,1,2,0,2599,A
2-PB1,1063,1,2583,0,0,2584,T
2-PB1,1064,2592,0,1,0,2593,A
2-PB1,1065,0,1,0,2595,2596,C
2-PB1,1066,2627,0,3,0,2630,A
2-PB1,1067,0,2613,0,0,2613,T
2-PB1,1068,0,0,2632,0,2632,G
2-PB1,1069,0,2573,0,8,2581,T
2-PB1,1070,1,2577,0,0,2578,T
2-PB1,1071,3,0,0,2555,2558,C
2-PB1,1072,0,5,2573,0,2578,G
2-PB1,1073,2555,3,5,0,2563,A
2-PB1,1074,0,4,2636,0,2640,G
2-PB1,1075,2586,1,2,0,2589,A
2-PB1,1076,2,1,2632,1,2636,G
2-PB1,1077,0,2616,1,1,2618,T
2-PB1,1078,2606,0,3,0,2609,A
2-PB1,1079,2613,0,3,1,2617,A
2-PB1,1080,2,6,2626,0,2634,G
2-PB1,1081,2608,0,6,0,2614,A
2-PB1,1082,1,4,2659,0,2664,G
2-PB1,1083,2577,0,3,0,2580,A
2-PB1,1084,2584,1,3,0,2588,A
2-PB1,1085,1,2579,1,2,2583,T
2-PB1,1086,1,5,2572,0,2578,G
2-PB1,1087,2574,0,5,0,2579,A
2-PB1,1088,2550,0,5,0,2555,A
2-PB1,1089,0,0,2563,0,2563,G
2-PB1,1090,1,1,0,2553,2555,C
2-PB1,1091,0,2490,0,0,2490,T
2-PB1,1092,4,1,0,2533,2538,C
2-PB1,1093,2,2,0,2538,2542,C
2-PB1,1094,5,2,2532,0,2539,G
2-PB1,1095,0,7,2544,0,2551,G
2-PB1,1096,2561,0,2,0,2563,A
2-PB1,1097,0,0,0,2602,2602,C
2-PB1,1098,2606,2,2,0,2610,A
2-PB1,1099,0,1,0,2653,2654,C
2-PB1,1100,2648,0,0,1,2649,A
2-PB1,1101,2646,0,5,0,2651,A
2-PB1,1102,2641,0,1,2,2644,A
2-PB1,1103,0,2663,0,1,2664,T
2-PB1,1104,2662,0,0,0,2662,A
2-PB1,1105,1,1,0,2657,2659,C
2-PB1,1106,3,1,0,2621,2625,C
2-PB1,1107,0,2572,1,3,2576,T
2-PB1,1108,1,1,2610,0,2612,G
2-PB1,1109,1,2,0,2607,2610,C
2-PB1,1110,2608,2,1,0,2611,A
2-PB1,1111,1,3,2606,0,2610,G
2-PB1,1112,2589,0,0,0,2589,A
2-PB1,1113,2580,0,1,0,2581,A
2-PB1,1114,2593,1,1,0,2595,A
2-PB1,1115,0,2592,1,0,2593,T
2-PB1,1116,1,4,2589,0,2594,G
2-PB1,1117,0,2,0,2570,2572,C
2-PB1,1118,1,2576,0,2,2579,T
2-PB1,1119,2617,0,0,0,2617,A
2-PB1,1120,1,1,2615,0,2617,G
2-PB1,1121,0,2,0,2609,2611,C
2-PB1,1122,2607,0,0,0,2607,A
2-PB1,1123,2610,1,0,0,2611,A
2-PB1,1124,0,0,2602,0,2602,G
2-PB1,1125,0,0,0,2597,2597,C
2-PB1,1126,2565,0,0,0,2565,A
2-PB1,1127,0,2664,0,0,2664,T
2-PB1,1128,0,2655,0,0,2655,T
2-PB1,1129,2,5,2804,0,2811,G
2-PB1,1130,2841,1,2,0,2844,A
2-PB1,1131,0,281,0,2528,2809,C
2-PB1,1132,1,0,0,2837,2838,C
2-PB1,1133,0,2733,0,5,2738,T
2-PB1,1134,0,2,2817,0,2819,G
2-PB1,1135,2823,1,1,0,2825,A
2-PB1,1136,2821,0,4,0,2825,A
2-PB1,1137,0,0,2875,0,2875,G
2-PB1,1138,0,2743,0,2,2745,T
2-PB1,1139,2779,0,0,0,2779,A
2-PB1,1140,0,2756,0,2,2758,T
2-PB1,1141,0,2763,0,2,2765,T
2-PB1,1142,0,2752,0,2,2754,T
2-PB1,1143,5,1,0,2707,2713,C
2-PB1,1144,2716,0,2,0,2718,A
2-PB1,1145,2714,0,1,0,2715,A
2-PB1,1146,0,2665,0,0,2665,T
2-PB1,1147,2,9,2689,0,2700,G
2-PB1,1148,2650,1,2,1,2654,A
2-PB1,1149,2674,2,2,0,2678,A
2-PB1,1150,1,2665,0,0,2666,T
2-PB1,1151,5,1,0,2677,2683,C
2-PB1,1152,2686,0,4,0,2690,A
2-PB1,1153,2702,0,4,0,2706,A
2-PB1,1154,0,0,0,2699,2699,C
2-PB1,1155,2695,0,1,0,2696,A
2-PB1,1156,2688,0,2,0,2690,A
2-PB1,1157,2,7,2675,0,2684,G
2-PB1,1158,1,3,2704,0,2708,G
2-PB1,1159,2687,0,1,0,2688,A
2-PB1,1160,2694,2,3,0,2699,A
2-PB1,1161,0,2,2705,0,2707,G
2-PB1,1162,2684,0,3,0,2687,A
2-PB1,1163,2696,2,1,0,2699,A
2-PB1,1164,2683,0,2,0,2685,A
2-PB1,1165,2686,0,3,0,2689,A
2-PB1,1166,0,2672,1,1,2674,T
2-PB1,1167,1,2636,0,0,2637,T
2-PB1,1168,0,6,2643,0,2649,G
2-PB1,1169,2627,0,5,0,2632,A
2-PB1,1170,0,4,2653,0,2657,G
2-PB1,1171,2644,0,0,0,2644,A
2-PB1,1172,2683,1,0,0,2684,A
2-PB1,1173,2710,0,1,0,2711,A
2-PB1,1174,2722,0,1,0,2723,A
2-PB1,1175,0,2721,1,1,2723,T
2-PB1,1176,2724,0,2,0,2726,A
2-PB1,1177,2720,0,3,1,2724,A
2-PB1,1178,1,4,2719,0,2724,G
2-PB1,1179,1,0,2718,0,2719,G
2-PB1,1180,1,1,0,2708,2710,C
2-PB1,1181,5,2,0,2701,2708,C
2-PB1,1182,0,2663,0,4,2667,T
2-PB1,1183,3,2,0,3079,3084,C
2-PB1,1184,0,3114,0,4,3118,T
2-PB1,1185,1,3121,0,1,3123,T
2-PB1,1186,5,0,0,3203,3208,C
2-PB1,1187,0,3174,0,11,3185,T
2-PB1,1188,3198,0,0,0,3198,A
2-PB1,1189,3205,0,6,1,3212,A
2-PB1,1190,0,3211,0,2,3213,T
2-PB1,1191,3220,0,3,0,3223,A
2-PB1,1192,0,2,3147,0,3149,G
2-PB1,1193,2811,1,3,0,2815,A
2-PB1,1194,1,2815,0,5,2821,T
2-PB1,1195,1,9,2751,0,2761,G
2-PB1,1196,3,2,2816,0,2821,G
2-PB1,1197,3,2,0,2804,2809,C
2-PB1,1198,2820,0,4,0,2824,A
2-PB1,1199,0,2,0,2837,2839,C
2-PB1,1200,2792,0,1,0,2793,A
2-PB1,1201,0,0,2921,0,2921,G
2-PB1,1202,1,1,0,2904,2906,C
2-PB1,1203,2919,0,3,1,2923,A
2-PB1,1204,0,3019,0,6,3025,T
2-PB1,1205,4,0,0,2999,3003,C
2-PB1,1206,3024,0,3,0,3027,A
2-PB1,1207,0,3022,0,5,3027,T
2-PB1,1208,0,3004,1,0,3005,T
2-PB1,1209,2,6,2989,0,2997,G
2-PB1,1210,2864,2,8,1,2875,A
2-PB1,1211,0,0,2967,0,2967,G
2-PB1,1212,2,0,0,2957,2959,C
2-PB1,1213,6,0,0,2920,2926,C
2-PB1,1214,8,1,0,2959,2968,C
2-PB1,1215,1,2939,1,3,2944,T
2-PB1,1216,1,4,3281,0,3286,G
2-PB1,1217,0,7,3378,0,3385,G
2-PB1,1218,3379,0,5,1,3385,A
2-PB1,1219,3525,0,3,0,3528,A
2-PB1,1220,0,3409,1,4,3414,T
2-PB1,1221,0,4,3562,0,3566,G
2-PB1,1222,3606,3,2,0,3611,A
2-PB1,1223,1,3652,0,3,3656,T
2-PB1,1224,0,8,3660,0,3668,G
2-PB1,1225,3610,0,4,0,3614,A
2-PB1,1226,2,3586,0,0,3588,T
2-PB1,1227,1,10,3582,0,3593,G
2-PB1,1228,1,8,3637,0,3646,G
2-PB1,1229,1,4,3662,0,3667,G
2-PB1,1230,1,2,0,3637,3640,C
2-PB1,1231,3652,0,3,1,3656,A
2-PB1,1232,0,3677,0,1,3678,T
2-PB1,1233,3,0,3813,0,3816,G
2-PB1,1234,0,3802,0,13,3815,T
2-PB1,1235,1,3831,0,3,3835,T
2-PB1,1236,13,1,0,3825,3839,C
2-PB1,1237,3832,0,5,1,3838,A
2-PB1,1238,3840,0,4,0,3844,A
2-PB1,1239,0,2,0,3852,3854,C
2-PB1,1240,3878,0,3,0,3881,A
2-PB1,1241,0,3881,0,1,3882,T
2-PB1,1242,4,0,3933,0,3937,G
2-PB1,1243,3,5,0,3935,3943,C
2-PB1,1244,0,3953,0,5,3958,T
2-PB1,1245,4014,0,3,0,4017,A
2-PB1,1246,3994,0,1,1,3996,A
2-PB1,1247,3,0,4106,0,4109,G
2-PB1,1248,0,4096,0,2,4098,T
2-PB1,1249,4064,0,2,0,4066,A
2-PB1,1250,2,4,0,4107,4113,C
2-PB1,1251,2,8,4118,0,4128,G
2-PB1,1252,0,0,4487,0,4487,G
2-PB1,1253,0,4449,0,8,4457,T
2-PB1,1254,0,4431,3,2,4436,T
2-PB1,1255,0,4439,0,1,4440,T
2-PB1,1256,0,4433,0,2,4435,T
2-PB1,1257,4450,1,1,0,4452,A
2-PB1,1258,4,2,4436,0,4442,G
2-PB1,1259,1,4,4419,0,4424,G
2-PB1,1260,4288,0,3,0,4291,A
2-PB1,1261,3,0,4277,0,4280,G
2-PB1,1262,0,4312,0,6,4318,T
2-PB1,1263,7,1,0,4319,4327,C
2-PB1,1264,2,4313,0,4,4319,T
2-PB1,1265,10,4,1,4328,4343,C
2-PB1,1266,7,9,4332,0,4348,G
2-PB1,1267,4523,0,0,0,4523,A
2-PB1,1268,1,4543,0,2,4546,T
2-PB1,1269,4584,0,2,0,4586,A
2-PB1,1270,1,5,0,4588,4594,C
2-PB1,1271,2,4497,0,4,4503,T
2-PB1,1272,4,7,4500,0,4511,G
2-PB1,1273,4504,0,0,0,4504,A
2-PB1,1274,4578,0,3,0,4581,A
2-PB1,1275,0,4573,0,7,4580,T
2-PB1,1276,10,0,0,4449,4459,C
2-PB1,1277,0,4406,0,3,4409,T
2-PB1,1278,1,4396,0,4,4401,T
2-PB1,1279,2,14,4416,1,4433,G
2-PB1,1280,4,8,4429,0,4441,G
2-PB1,1281,4418,0,8,0,4426,A
2-PB1,1282,1,1,0,4440,4442,C
2-PB1,1283,4363,0,0,0,4363,A
2-PB1,1284,4401,1,4,0,4406,A
2-PB1,1285,4417,0,3,1,4421,A
2-PB1,1286,4438,0,9,1,4448,A
2-PB1,1287,1,10,4539,0,4550,G
2-PB1,1288,4546,3,6,0,4555,A
2-PB1,1289,4552,0,4,1,4557,A
2-PB1,1290,4554,0,9,2,4565,A
2-PB1,1291,0,4549,1,0,4550,T
2-PB1,1292,4582,0,3,0,4585,A
2-PB1,1293,2,1,0,4759,4762,C
2-PB1,1294,4732,0,6,0,4738,A
2-PB1,1295,1,1,0,4751,4753,C
2-PB1,1296,6,3,0,4672,4681,C
2-PB1,1297,4654,0,1,0,4655,A
2-PB1,1298,4735,1,8,0,4744,A
2-PB1,1299,0,15,4932,0,4947,G
2-PB1,1300,5027,1,6,0,5034,A
2-PB1,1301,1,1,0,5090,5092,C
2-PB1,1302,4949,0,6,0,4955,A
2-PB1,1303,5122,0,11,1,5134,A
2-PB1,1304,0,3,0,5169,5172,C
2-PB1,1305,5226,0,4,0,5230,A
2-PB1,1306,0,5262,1,2,5265,T
2-PB1,1307,5227,0,6,0,5233,A
2-PB1,1308,0,2,0,5343,5345,C
2-PB1,1309,0,5123,0,4,5127,T
2-PB1,1310,1,8,5211,0,5220,G
2-PB1,1311,1,1,5222,0,5224,G
2-PB1,1312,0,5079,1,7,5087,T
2-PB1,1313,1,15,5065,0,5081,G
2-PB1,1314,1,7,4998,0,5006,G
2-PB1,1315,3,8,5034,0,5045,G
2-PB1,1316,5010,0,8,1,5019,A
2-PB1,1317,2,4928,1,2,4933,T
2-PB1,1318,3,17,4916,0,4936,G
2-PB1,1319,2,4,4894,2,4902,G
2-PB1,1320,2,3,4934,0,4939,G
2-PB1,1321,3,2,0,5027,5032,C
2-PB1,1322,3,4986,0,8,4997,T
2-PB1,1323,8,1,0,5047,5056,C
2-PB1,1324,7,0,0,5038,5045,C
2-PB1,1325,5053,0,1,0,5054,A
2-PB1,1326,5042,0,1,1,5044,A
2-PB1,1327,2,5011,0,2,5015,T
2-PB1,1328,11,0,2,5005,5018,C
2-PB1,1329,2,2,0,4983,4987,C
2-PB1,1330,1,4927,1,5,4934,T
2-PB1,1331,4,2,0,4942,4948,C
2-PB1,1332,1,3,0,4910,4914,C
2-PB1,1333,4,7,4914,0,4925,G
2-PB1,1334,4912,1,2,0,4915,A
2-PB1,1335,1,8,0,4898,4907,C
2-PB1,1336,3,8,4916,0,4927,G
2-PB1,1337,4971,0,1,0,4972,A
2-PB1,1338,0,4960,0,4,4964,T
2-PB1,1339,0,4949,0,6,4955,T
2-PB1,1340,0,4943,0,5,4948,T
2-PB1,1341,0,4960,0,1,4961,T
2-PB1,1342,3,1,4966,0,4970,G
2-PB1,1343,3,4,1,5011,5019,C
2-PB1,1344,4,4,0,5000,5008,C
2-PB1,1345,18,0,0,5168,5186,C
2-PB1,1346,0,5082,1,7,5090,T
2-PB1,1347,13,1,0,5350,5364,C
2-PB1,1348,5408,1,2,0,5411,A
2-PB1,1349,0,5435,0,2,5437,T
2-PB1,1350,5408,0,3,1,5412,A
2-PB1,1351,1,1,5467,0,5469,G
2-PB1,1352,2,5371,1,3,5377,T
2-PB1,1353,1,22,5381,0,5404,G
2-PB1,1354,5178,2,3,0,5183,A
2-PB1,1355,5199,0,8,0,5207,A
2-PB1,1356,0,4943,0,5,4948,T
2-PB1,1357,5,0,4930,0,4935,G
2-PB1,1358,0,4,0,4970,4974,C
2-PB1,1359,4990,2,9,0,5001,A
2-PB1,1360,2,3,0,5016,5021,C
2-PB1,1361,10,4,0,4941,4955,C
2-PB1,1362,4926,0,4,1,4931,A
2-PB1,1363,4918,1,0,0,4919,A
2-PB1,1364,4900,0,3,0,4903,A
2-PB1,1365,0,4742,0,4,4746,T
2-PB1,1366,6,1,0,4975,4982,C
2-PB1,1367,4973,2,3,0,4978,A
2-PB1,1368,1,4963,1,1,4966,T
2-PB1,1369,4,8,4980,0,4992,G
2-PB1,1370,4975,0,10,0,4985,A
2-PB1,1371,1,8,5066,0,5075,G
2-PB1,1372,2,11,5053,0,5066,G
2-PB1,1373,2,12,5088,0,5102,G
2-PB1,1374,5048,0,10,1,5059,A
2-PB1,1375,5152,0,5,0,5157,A
2-PB1,1376,0,5148,0,1,5149,T
2-PB1,1377,5175,3,3,0,5181,A
2-PB1,1378,0,2,0,5191,5193,C
2-PB1,1379,5202,1,5,0,5208,A
2-PB1,1380,5193,0,10,0,5203,A
2-PB1,1381,3,1,5166,0,5170,G
2-PB1,1382,4,1,0,5124,5129,C
2-PB1,1383,5101,0,3,0,5104,A
2-PB1,1384,1,1,5181,0,5183,G
2-PB1,1385,2,18,5158,1,5179,G
2-PB1,1386,5112,0,8,3,5123,A
2-PB1,1387,0,2,5203,0,5205,G
2-PB1,1388,1,5110,0,1,5112,T
2-PB1,1389,8,8,5150,0,5166,G
2-PB1,1390,2,4,5189,0,5195,G
2-PB1,1391,5165,0,7,0,5172,A
2-PB1,1392,2,5186,0,1,5189,T
2-PB1,1393,5025,0,5,0,5030,A
2-PB1,1394,1,7,5081,0,5089,G
2-PB1,1395,5136,1,4,0,5141,A
2-PB1,1396,0,5147,1,3,5151,T
2-PB1,1397,1,5101,1,4,5107,T
2-PB1,1398,4,0,0,5304,5308,C
2-PB1,1399,0,5274,0,2,5276,T
2-PB1,1400,5273,0,1,0,5274,A
2-PB1,1401,2,1,0,5277,5280,C
2-PB1,1402,5172,3,9,0,5184,A
2-PB1,1403,0,4,5170,0,5174,G
2-PB1,1404,5,12,5024,0,5041,G
2-PB1,1405,5104,0,5,0,5109,A
2-PB1,1406,1,5,1,5098,5105,C
2-PB1,1407,3,2,0,4957,4962,C
2-PB1,1408,5,4889,1,12,4907,T
2-PB1,1409,2,0,4921,0,4923,G
2-PB1,1410,1,0,0,4916,4917,C
2-PB1,1411,4923,2,3,0,4928,A
2-PB1,1412,4979,0,5,2,4986,A
2-PB1,1413,0,0,4999,2,5001,G
2-PB1,1414,0,4878,1,0,4879,T
2-PB1,1415,0,4877,1,0,4878,T
2-PB1,1416,4801,0,6,0,4807,A
2-PB1,1417,3,0,4832,0,4835,G
2-PB1,1418,1,4797,0,3,4801,T
2-PB1,1419,1,9,4778,2,4790,G
2-PB1,1420,2,3,4765,0,4770,G
2-PB1,1421,1,16,4789,0,4806,G
2-PB1,1422,4758,1,4,0,4763,A
2-PB1,1423,4795,0,2,1,4798,A
2-PB1,1424,0,4769,0,8,4777,T
2-PB1,1425,9,1,0,4794,4804,C
2-PB1,1426,4800,0,5,0,4805,A
2-PB1,1427,4818,0,5,0,4823,A
2-PB1,1428,0,3,0,4798,4801,C
2-PB1,1429,4794,0,3,0,4797,A
2-PB1,1430,1,4665,1,0,4667,T
2-PB1,1431,1,13,4656,0,4670,G
2-PB1,1432,4653,0,4,0,4657,A
2-PB1,1433,2,2,4718,0,4722,G
2-PB1,1434,0,1,0,4713,4714,C
2-PB1,1435,4692,0,2,0,4694,A
2-PB1,1436,4699,1,8,0,4708,A
2-PB1,1437,4699,0,6,0,4705,A
2-PB1,1438,4749,0,2,1,4752,A
2-PB1,1439,4753,0,6,1,4760,A
2-PB1,1440,2,1,4750,0,4753,G
2-PB1,1441,4679,0,2,0,4681,A
2-PB1,1442,4590,0,10,2,4602,A
2-PB1,1443,2,1,4860,0,4863,G
2-PB1,1444,0,4830,1,5,4836,T
2-PB1,1445,16,0,0,4830,4846,C
2-PB1,1446,13,1,0,4843,4857,C
2-PB1,1447,0,4831,0,3,4834,T
2-PB1,1448,4941,2,2,0,4945,A
2-PB1,1449,0,4931,1,3,4935,T
2-PB1,1450,4931,0,3,0,4934,A
2-PB1,1451,0,4942,2,4,4948,T
2-PB1,1452,4789,0,2,1,4792,A
2-PB1,1453,4788,0,7,1,4796,A
2-PB1,1454,4791,0,1,1,4793,A
2-PB1,1455,1,4787,0,2,4790,T
2-PB1,1456,4727,0,1,2,4730,A
2-PB1,1457,4715,0,5,0,4720,A
2-PB1,1458,4717,0,3,0,4720,A
2-PB1,1459,4740,0,5,0,4745,A
2-PB1,1460,2,2,0,4762,4766,C
2-PB1,1461,4493,1,3,0,4497,A
2-PB1,1462,0,14,4482,1,4497,G
2-PB1,1463,1,9,4476,0,4486,G
2-PB1,1464,2,6,4479,0,4487,G
2-PB1,1465,4482,0,9,0,4491,A
2-PB1,1466,2,1,0,4534,4537,C
2-PB1,1467,4518,1,0,0,4519,A
2-PB1,1468,1,4560,0,4,4565,T
2-PB1,1469,0,4553,0,3,4556,T
2-PB1,1470,0,4560,0,3,4563,T
2-PB1,1471,3,15,4545,0,4563,G
2-PB1,1472,4511,2,3,1,4517,A
2-PB1,1473,4532,1,4,0,4537,A
2-PB1,1474,1,4534,0,1,4536,T
2-PB1,1475,0,4443,0,2,4445,T
2-PB1,1476,8,2,1,4481,4492,C
2-PB1,1477,4440,0,1,0,4441,A
2-PB1,1478,0,2,0,4458,4460,C
2-PB1,1479,0,4443,1,1,4445,T
2-PB1,1480,4473,0,3,0,4476,A
2-PB1,1481,2,2,4455,0,4459,G
2-PB1,1482,0,0,0,4472,4472,C
2-PB1,1483,0,4415,0,3,4418,T
2-PB1,1484,0,4467,0,2,4469,T
2-PB1,1485,0,4468,0,3,4471,T
2-PB1,1486,0,4481,0,2,4483,T
2-PB1,1487,0,4460,1,4,4465,T
2-PB1,1488,1,4461,1,2,4465,T
2-PB1,1489,0,4452,0,0,4452,T
2-PB1,1490,4442,0,2,0,4444,A
2-PB1,1491,2,4390,1,5,4398,T
2-PB1,1492,8,2,0,4436,4446,C
2-PB1,1493,1,11,4472,0,4484,G
2-PB1,1494,4624,3,5,0,4632,A
2-PB1,1495,0,4656,0,0,4656,T
2-PB1,1496,4648,0,2,0,4650,A
2-PB1,1497,1,4724,0,4,4729,T
2-PB1,1498,3,7,4710,0,4720,G
2-PB1,1499,1,6,4763,1,4771,G
2-PB1,1500,4742,1,4,0,4747,A
2-PB1,1501,0,4701,0,5,4706,T
2-PB1,1502,0,4664,0,1,4665,T
2-PB1,1503,0,4517,0,2,4519,T
2-PB1,1504,1,0,4539,0,4540,G
2-PB1,1505,0,4524,2,1,4527,T
2-PB1,1506,2,9,4506,0,4517,G
2-PB1,1507,2,2,4515,1,4520,G
2-PB1,1508,2,3,0,4446,4451,C
2-PB1,1509,0,4464,1,6,4471,T
2-PB1,1510,4507,0,1,0,4508,A
2-PB1,1511,4554,0,1,0,4555,A
2-PB1,1512,0,4574,0,0,4574,T
2-PB1,1513,0,4573,1,2,4576,T
2-PB1,1514,2,4571,1,1,4575,T
2-PB1,1515,0,4582,0,2,4584,T
2-PB1,1516,4565,0,5,0,4570,A
2-PB1,1517,3,1,4609,0,4613,G
2-PB1,1518,1,2,0,4611,4614,C
2-PB1,1519,4603,0,4,0,4607,A
2-PB1,1520,1,4557,1,4,4563,T
2-PB1,1521,5,6,4486,0,4497,G
2-PB1,1522,1,8,4565,0,4574,G
2-PB1,1523,4528,0,4,1,4533,A
2-PB1,1524,2,3,4564,1,4570,G
2-PB1,1525,0,0,1,4543,4544,C
2-PB1,1526,0,4491,0,5,4496,T
2-PB1,1527,1,2,4531,0,4534,G
2-PB1,1528,4,0,0,4499,4503,C
2-PB1,1529,11,1,0,4490,4502,C
2-PB1,1530,11,1,0,4533,4545,C
2-PB1,1531,4437,0,0,1,4438,A
2-PB1,1532,1,3,4849,0,4853,G
2-PB1,1533,1,4820,0,6,4827,T
2-PB1,1534,0,4804,1,6,4811,T
2-PB1,1535,0,4836,0,6,4842,T
2-PB1,1536,0,4771,0,3,4774,T
2-PB1,1537,1,2,4731,0,4734,G
2-PB1,1538,2,6,4757,0,4765,G
2-PB1,1539,4694,0,2,0,4696,A
2-PB1,1540,1,0,4738,0,4739,G
2-PB1,1541,1,4205,0,2,4208,T
2-PB1,1542,3,2,4427,0,4432,G
2-PB1,1543,0,4418,0,9,4427,T
2-PB1,1544,13,1,0,4412,4426,C
2-PB1,1545,3,4429,0,2,4434,T
2-PB1,1546,0,6,4451,0,4457,G
2-PB1,1547,2,11,4520,0,4533,G
2-PB1,1548,4535,0,2,0,4537,A
2-PB1,1549,4546,0,8,0,4554,A
2-PB1,1550,1,4537,1,1,4540,T
2-PB1,1551,4222,0,1,0,4223,A
2-PB1,1552,4216,1,4,1,4222,A
2-PB1,1553,4219,1,6,0,4226,A
2-PB1,1554,0,4,1,4230,4235,C
2-PB1,1555,2,15,4163,0,4180,G
2-PB1,1556,4106,1,6,0,4113,A
2-PB1,1557,0,0,4113,0,4113,G
2-PB1,1558,1,4100,1,5,4107,T
2-PB1,1559,15,2,0,4119,4136,C
2-PB1,1560,4121,0,3,1,4125,A
2-PB1,1561,1,1,4200,0,4202,G
2-PB1,1562,2,1,0,4188,4191,C
2-PB1,1563,0,4187,0,2,4189,T
2-PB1,1564,1,9,4342,0,4352,G
2-PB1,1565,4305,0,1,1,4307,A
2-PB1,1566,1,4324,0,2,4327,T
2-PB1,1567,4324,2,5,0,4331,A
2-PB1,1568,1,4254,0,5,4260,T
2-PB1,1569,0,19,4271,0,4290,G
2-PB1,1570,4097,0,9,0,4106,A
2-PB1,1571,0,1,4206,0,4207,G
2-PB1,1572,1,1,0,4209,4211,C
2-PB1,1573,3945,0,1,1,3947,A
2-PB1,1574,0,3949,0,2,3951,T
2-PB1,1575,0,3940,0,4,3944,T
2-PB1,1576,0,6,3993,0,3999,G
2-PB1,1577,0,7,4140,0,4147,G
2-PB1,1578,4051,1,6,0,4058,A
2-PB1,1579,1,0,4082,0,4083,G
2-PB1,1580,0,3927,1,3,3931,T
2-PB1,1581,3920,2,3,0,3925,A
2-PB1,1582,3917,0,2,0,3919,A
2-PB1,1583,1,2,0,3954,3957,C
2-PB1,1584,3930,0,3,0,3933,A
2-PB1,1585,1,0,4044,0,4045,G
2-PB1,1586,0,3581,0,0,3581,T
2-PB1,1587,0,6,3622,0,3628,G
2-PB1,1588,3663,0,7,0,3670,A
2-PB1,1589,0,3666,0,2,3668,T
2-PB1,1590,3657,1,3,0,3661,A
2-PB1,1591,3667,0,0,1,3668,A
2-PB1,1592,3564,0,11,1,3576,A
2-PB1,1593,0,13,3611,0,3624,G
2-PB1,1594,3441,1,1,0,3443,A
2-PB1,1595,3451,0,3,0,3454,A
2-PB1,1596,1,1,0,3457,3459,C
2-PB1,1597,3330,0,4,0,3334,A
2-PB1,1598,3376,0,5,0,3381,A
2-PB1,1599,0,2,0,3402,3404,C
2-PB1,1600,3451,1,4,1,3457,A
2-PB1,1601,0,3433,13,1,3447,T
2-PB1,1602,1,11,3376,0,3388,G
2-PB1,1603,3382,1,3,0,3386,A
2-PB1,1604,1,3373,1,1,3376,T
2-PB1,1605,3335,0,2,0,3337,A
2-PB1,1606,3360,0,3,0,3363,A
2-PB1,1607,3357,0,1,0,3358,A
2-PB1,1608,2,1,0,3397,3400,C
2-PB1,1609,3231,0,0,0,3231,A
2-PB1,1610,3227,0,3,0,3230,A
2-PB1,1611,0,3174,1,5,3180,T
2-PB1,1612,0,14,3162,0,3176,G
2-PB1,1613,3251,0,2,0,3253,A
2-PB1,1614,0,1,0,3282,3283,C
2-PB1,1615,8,0,0,3232,3240,C
2-PB1,1616,0,3125,0,4,3129,T
2-PB1,1617,0,3030,0,3,3033,T
2-PB1,1618,2,6,3042,0,3050,G
2-PB1,1619,2,8,3055,0,3065,G
2-PB1,1620,3102,2,1,0,3105,A
2-PB1,1621,0,2,0,3105,3107,C
2-PB1,1622,1,0,0,3048,3049,C
2-PB1,1623,3020,1,3,0,3024,A
2-PB1,1624,3,1,3066,1,3071,G
2-PB1,1625,1,1,0,3078,3080,C
2-PB1,1626,3073,0,3,0,3076,A
2-PB1,1627,3076,1,2,0,3079,A
2-PB1,1628,0,0,0,3065,3065,C
2-PB1,1629,3032,1,2,0,3035,A
2-PB1,1630,0,0,3110,1,3111,G
2-PB1,1631,1,2,0,3095,3098,C
2-PB1,1632,8,1,0,3078,3087,C
2-PB1,1633,14,2,0,3076,3092,C
2-PB1,1634,3101,0,0,0,3101,A
2-PB1,1635,3086,1,2,0,3089,A
2-PB1,1636,3105,0,1,0,3106,A
2-PB1,1637,0,3094,0,1,3095,T
2-PB1,1638,3,4,3074,0,3081,G
2-PB1,1639,2,1,3017,0,3020,G
2-PB1,1640,0,0,0,3010,3010,C
2-PB1,1641,0,2949,0,6,2955,T
2-PB1,1642,6,0,0,3062,3068,C
2-PB1,1643,1,3035,2,5,3043,T
2-PB1,1644,6,0,0,3078,3084,C
2-PB1,1645,2,0,0,3091,3093,C
2-PB1,1646,3102,1,3,0,3106,A
2-PB1,1647,3108,0,3,0,3111,A
2-PB1,1648,0,3087,0,3,3090,T
2-PB1,1649,0,3055,0,1,3056,T
2-PB1,1650,0,0,3068,2,3070,G
2-PB1,1651,0,2969,0,2,2971,T
2-PB1,1652,0,2947,0,2,2949,T
2-PB1,1653,12,3,0,2944,2959,C
2-PB1,1654,2946,0,0,0,2946,A
2-PB1,1655,0,2940,0,3,2943,T
2-PB1,1656,7,0,0,2938,2945,C
2-PB1,1657,2947,0,2,0,2949,A
2-PB1,1658,2949,1,1,0,2951,A
2-PB1,1659,2929,0,3,1,2933,A
2-PB1,1660,0,5,3023,0,3028,G
2-PB1,1661,3017,1,3,0,3021,A
2-PB1,1662,1,3017,1,2,3021,T
2-PB1,1663,0,3027,0,1,3028,T
2-PB1,1664,3052,0,4,1,3057,A
2-PB1,1665,0,0,0,3138,3138,C
2-PB1,1666,3128,1,2,0,3131,A
2-PB1,1667,1,0,3179,0,3180,G
2-PB1,1668,3143,0,4,0,3147,A
2-PB1,1669,1,3193,1,2,3197,T
2-PB1,1670,3213,0,0,0,3213,A
2-PB1,1671,0,0,0,3418,3418,C
2-PB1,1672,3487,1,2,1,3491,A
2-PB1,1673,0,1,0,3705,3706,C
2-PB1,1674,3654,0,5,0,3659,A
2-PB1,1675,0,3673,0,10,3683,T
2-PB1,1676,3644,1,2,0,3647,A
2-PB1,1677,2,3629,0,1,3632,T
2-PB1,1678,3545,0,0,0,3545,A
2-PB1,1679,0,4,3548,0,3552,G
2-PB1,1680,2,1,3518,0,3521,G
2-PB1,1681,0,3294,0,6,3300,T
2-PB1,1682,1,0,3230,0,3231,G
2-PB1,1683,2,1,0,3351,3354,C
2-PB1,1684,6,1,0,3350,3357,C
2-PB1,1685,3401,0,2,1,3404,A
2-PB1,1686,0,3401,0,1,3402,T
2-PB1,1687,3410,0,0,0,3410,A
2-PB1,1688,0,3,3429,0,3432,G
2-PB1,1689,3314,0,5,0,3319,A
2-PB1,1690,2,3,3353,0,3358,G
2-PB1,1691,0,7,3345,0,3352,G
2-PB1,1692,3152,2,8,0,3162,A
2-PB1,1693,2,6,3191,0,3199,G
2-PB1,1694,3154,1,5,1,3161,A
2-PB1,1695,1,1,0,3175,3177,C
2-PB1,1696,3174,0,6,0,3180,A
2-PB1,1697,0,0,0,3245,3245,C
2-PB1,1698,3242,0,4,0,3246,A
2-PB1,1699,0,1,0,3241,3242,C
2-PB1,1700,3208,0,2,0,3210,A
2-PB1,1701,3233,0,4,0,3237,A
2-PB1,1702,3235,0,2,0,3237,A
2-PB1,1703,1,3232,1,1,3235,T
2-PB1,1704,3,1,0,3243,3247,C
2-PB1,1705,1,1,0,3242,3244,C
2-PB1,1706,3186,0,1,0,3187,A
2-PB1,1707,1,7,3190,0,3198,G
2-PB1,1708,3188,0,2,0,3190,A
2-PB1,1709,0,3,0,3221,3224,C
2-PB1,1710,1,7,3208,0,3216,G
2-PB1,1711,3171,0,2,0,3173,A
2-PB1,1712,0,3,3192,0,3195,G
2-PB1,1713,3189,1,7,0,3197,A
2-PB1,1714,3193,0,6,0,3199,A
2-PB1,1715,3,2,3228,0,3233,G
2-PB1,1716,3206,0,1,0,3207,A
2-PB1,1717,0,3188,1,4,3193,T
2-PB1,1718,11,1,0,3172,3184,C
2-PB1,1719,3188,0,2,2,3192,A
2-PB1,1720,0,3169,1,4,3174,T
2-PB1,1721,0,3161,0,1,3162,T
2-PB1,1722,5,1,1,3163,3170,C
2-PB1,1723,0,4,3177,0,3181,G
2-PB1,1724,3129,1,4,1,3135,A
2-PB1,1725,0,5,3149,0,3154,G
2-PB1,1726,3136,1,2,0,3139,A
2-PB1,1727,0,3232,0,1,3233,T
2-PB1,1728,3250,1,3,0,3254,A
2-PB1,1729,3261,0,0,0,3261,A
2-PB1,1730,3248,0,2,0,3250,A
2-PB1,1731,3193,1,4,2,3200,A
2-PB1,1732,3230,0,1,0,3231,A
2-PB1,1733,3227,0,8,0,3235,A
2-PB1,1734,1,0,3247,0,3248,G
2-PB1,1735,0,3,0,3253,3256,C
2-PB1,1736,0,3186,0,1,3187,T
2-PB1,1737,3,0,3194,0,3197,G
2-PB1,1738,1,3180,0,4,3185,T
2-PB1,1739,1,9,3146,0,3156,G
2-PB1,1740,0,3,3190,0,3193,G
2-PB1,1741,0,7,3216,1,3224,G
2-PB1,1742,3218,0,8,0,3226,A
2-PB1,1743,0,3185,0,2,3187,T
2-PB1,1744,7,1,0,3205,3213,C
2-PB1,1745,3223,0,3,0,3226,A
2-PB1,1746,3248,0,6,0,3254,A
2-PB1,1747,3274,0,4,0,3278,A
2-PB1,1748,2,1,0,3260,3263,C
2-PB1,1749,7,1,0,3242,3250,C
2-PB1,1750,12,0,0,3237,3249,C
2-PB1,1751,3245,0,3,0,3248,A
2-PB1,1752,3321,0,2,0,3323,A
2-PB1,1753,0,3312,0,2,3314,T
2-PB1,1754,6,1,0,3311,3318,C
2-PB1,1755,3276,1,2,0,3279,A
2-PB1,1756,3265,0,2,0,3267,A
2-PB1,1757,1,6,3322,0,3329,G
2-PB1,1758,1,4,3295,0,3300,G
2-PB1,1759,0,1,3303,0,3304,G
2-PB1,1760,1,0,0,3305,3306,C
2-PB1,1761,3225,1,9,0,3235,A
2-PB1,1762,2,4,3342,1,3349,G
2-PB1,1763,1,6,3374,1,3382,G
2-PB1,1764,3386,0,7,0,3393,A
2-PB1,1765,0,4,0,3417,3421,C
2-PB1,1766,0,3345,0,2,3347,T
2-PB1,1767,3425,2,2,0,3429,A
2-PB1,1768,2,3417,0,2,3421,T
2-PB1,1769,0,3423,0,1,3424,T
2-PB1,1770,4,12,3403,1,3420,G
2-PB1,1771,2,0,3453,0,3455,G
2-PB1,1772,0,3417,0,3,3420,T
2-PB1,1773,3422,0,0,0,3422,A
2-PB1,1774,1,3349,0,8,3358,T
2-PB1,1775,6,2,2,3357,3367,C
2-PB1,1776,3306,0,3,0,3309,A
2-PB1,1777,1,0,3338,0,3339,G
2-PB1,1778,3339,0,4,0,3343,A
2-PB1,1779,0,3308,0,1,3309,T
2-PB1,1780,1,1,3156,0,3158,G
2-PB1,1781,1,13,3131,0,3145,G
2-PB1,1782,0,11,3140,0,3151,G
2-PB1,1783,2,6,3139,0,3147,G
2-PB1,1784,3,6,3140,0,3149,G
2-PB1,1785,3143,0,7,0,3150,A
2-PB1,1786,2,1,0,3133,3136,C
2-PB1,1787,4,1,1,3114,3120,C
2-PB1,1788,3125,0,0,1,3126,A
2-PB1,1789,3414,0,2,1,3417,A
2-PB1,1790,3442,0,2,0,3444,A
2-PB1,1791,0,1,0,3536,3537,C
2-PB1,1792,0,3486,0,3,3489,T
2-PB1,1793,0,3481,0,0,3481,T
2-PB1,1794,3509,0,1,0,3510,A
2-PB1,1795,0,3510,0,1,3511,T
2-PB1,1796,3516,0,2,0,3518,A
2-PB1,1797,0,0,0,3521,3521,C
2-PB1,1798,3154,1,0,0,3155,A
2-PB1,1799,3169,1,2,0,3172,A
2-PB1,1800,1,3045,0,0,3046,T
2-PB1,1801,3116,0,0,0,3116,A
2-PB1,1802,0,3105,2,0,3107,T
2-PB1,1803,3,0,1,3090,3094,C
2-PB1,1804,4,2,0,3099,3105,C
2-PB1,1805,0,8,3097,0,3105,G
2-PB1,1806,0,5,3105,0,3110,G
2-PB1,1807,3103,0,0,0,3103,A
2-PB1,1808,3101,0,2,0,3103,A
2-PB1,1809,0,3104,0,1,3105,T
2-PB1,1810,1,1,0,3146,3148,C
2-PB1,1811,0,3125,0,10,3135,T
2-PB1,1812,1,3152,0,5,3158,T
2-PB1,1813,4,1,0,3145,3150,C
2-PB1,1814,3148,1,3,1,3153,A
2-PB1,1815,0,2,0,3171,3173,C
2-PB1,1816,3144,0,1,0,3145,A
2-PB1,1817,0,3430,1,5,3436,T
2-PB1,1818,5,1,0,3435,3441,C
2-PB1,1819,2,3,0,3443,3448,C
2-PB1,1820,9,2,0,3465,3476,C
2-PB1,1821,0,3456,2,8,3466,T
2-PB1,1822,2,2,3455,0,3459,G
2-PB1,1823,3456,0,0,0,3456,A
2-PB1,1824,3438,0,1,0,3439,A
2-PB1,1825,0,0,3454,0,3454,G
2-PB1,1826,0,3169,0,4,3173,T
2-PB1,1827,11,2,0,3172,3185,C
2-PB1,1828,0,3136,0,4,3140,T
2-PB1,1829,0,0,3256,0,3256,G
2-PB1,1830,0,2,1,3260,3263,C
2-PB1,1831,0,3240,1,1,3242,T
2-PB1,1832,0,3244,0,1,3245,T
2-PB1,1833,3248,0,1,0,3249,A
2-PB1,1834,3259,0,2,0,3261,A
2-PB1,1835,3263,0,6,0,3269,A
2-PB1,1836,3,0,3283,0,3286,G
2-PB1,1837,0,3213,0,3,3216,T
2-PB1,1838,0,6,3128,0,3134,G
2-PB1,1839,0,1,3128,0,3129,G
2-PB1,1840,0,4,3148,0,3152,G
2-PB1,1841,3113,2,4,0,3119,A
2-PB1,1842,3,0,3149,0,3152,G
2-PB1,1843,5,0,1,3138,3144,C
2-PB1,1844,0,3122,0,0,3122,T
2-PB1,1845,0,5,3115,0,3120,G
2-PB1,1846,3118,0,3,0,3121,A
2-PB1,1847,0,3115,0,3,3118,T
2-PB1,1848,0,6,3132,0,3138,G
2-PB1,1849,0,1,3141,0,3142,G
2-PB1,1850,3127,0,2,0,3129,A
2-PB1,1851,1,3137,0,1,3139,T
2-PB1,1852,1,12,3114,0,3127,G
2-PB1,1853,3097,3,2,0,3102,A
2-PB1,1854,1,8,3171,0,3180,G
2-PB1,1855,3155,2,4,0,3161,A
2-PB1,1856,3167,0,2,0,3169,A
2-PB1,1857,1,3165,1,2,3169,T
2-PB1,1858,0,3128,0,2,3130,T
2-PB1,1859,3140,0,1,0,3141,A
2-PB1,1860,0,3138,1,1,3140,T
2-PB1,1861,5,3,0,3133,3141,C
2-PB1,1862,3,7,3184,0,3194,G
2-PB1,1863,2,7,3142,0,3151,G
2-PB1,1864,1,4,3097,0,3102,G
2-PB1,1865,0,1,3102,0,3103,G
2-PB1,1866,3096,1,1,0,3098,A
2-PB1,1867,3097,1,6,0,3104,A
2-PB1,1868,0,5,3135,1,3141,G
2-PB1,1869,3171,0,4,0,3175,A
2-PB1,1870,0,1,0,3219,3220,C
2-PB1,1871,0,3177,0,3,3180,T
2-PB1,1872,0,3260,2,2,3264,T
2-PB1,1873,0,3261,0,3,3264,T
2-PB1,1874,2,1,3321,0,3324,G
2-PB1,1875,0,3322,0,2,3324,T
2-PB1,1876,3295,0,0,0,3295,A
2-PB1,1877,3283,0,2,1,3286,A
2-PB1,1878,0,3196,0,3,3199,T
2-PB1,1879,10,3,0,3223,3236,C
2-PB1,1880,6,0,0,3220,3226,C
2-PB1,1881,10,0,1,3176,3187,C
2-PB1,1882,8,2,0,3202,3212,C
2-PB1,1883,0,3186,0,6,3192,T
2-PB1,1884,2,3,3194,0,3199,G
2-PB1,1885,3190,1,4,0,3195,A
2-PB1,1886,3207,0,3,0,3210,A
2-PB1,1887,0,3210,0,5,3215,T
2-PB1,1888,2,0,0,3209,3211,C
2-PB1,1889,9,1,0,3162,3172,C
2-PB1,1890,6,0,0,3147,3153,C
2-PB1,1891,1,3120,0,7,3128,T
2-PB1,1892,1,3138,0,4,3143,T
2-PB1,1893,0,3130,0,2,3132,T
2-PB1,1894,0,0,3126,0,3126,G
2-PB1,1895,0,3122,0,1,3123,T
2-PB1,1896,11,0,0,3095,3106,C
2-PB1,1897,3070,0,4,0,3074,A
2-PB1,1898,2,4,3142,0,3148,G
2-PB1,1899,1,2,0,3138,3141,C
2-PB1,1900,6,0,0,3131,3137,C
2-PB1,1901,3146,0,2,1,3149,A
2-PB1,1902,0,3167,0,2,3169,T
2-PB1,1903,3166,0,3,0,3169,A
2-PB1,1904,3187,0,3,0,3190,A
2-PB1,1905,3180,0,5,1,3186,A
2-PB1,1906,1,4,3258,0,3263,G
2-PB1,1907,3163,4,0,0,3167,A
2-PB1,1908,3156,1,4,0,3161,A
2-PB1,1909,3172,0,4,0,3176,A
2-PB1,1910,1,3169,0,1,3171,T
2-PB1,1911,0,3143,1,2,3146,T
2-PB1,1912,1,7,3153,1,3162,G
2-PB1,1913,3114,0,6,0,3120,A
2-PB1,1914,1,0,3213,0,3214,G
2-PB1,1915,1,3203,0,3,3207,T
2-PB1,1916,7,0,0,3238,3245,C
2-PB1,1917,0,3230,0,3,3233,T
2-PB1,1918,1,1,3316,0,3318,G
2-PB1,1919,1,3313,0,5,3319,T
2-PB1,1920,3374,0,1,0,3375,A
2-PB1,1921,3368,0,3,0,3371,A
2-PB1,1922,3372,0,2,1,3375,A
2-PB1,1923,0,1,1,3392,3394,C
2-PB1,1924,3295,0,0,0,3295,A
2-PB1,1925,3394,0,1,0,3395,A
2-PB1,1926,0,3398,0,0,3398,T
2-PB1,1927,1,0,3373,1,3375,G
2-PB1,1928,0,1,1,3402,3404,C
2-PB1,1929,0,3365,0,2,3367,T
2-PB1,1930,4,1,3524,0,3529,G
2-PB1,1931,1,3514,0,3,3518,T
2-PB1,1932,3575,1,3,0,3579,A
2-PB1,1933,0,1,3583,0,3584,G
2-PB1,1934,0,3474,0,3,3477,T
2-PB1,1935,3455,0,0,0,3455,A
2-PB1,1936,3433,0,5,0,3438,A
2-PB1,1937,0,3410,0,1,3411,T
2-PB1,1938,0,1,3404,1,3406,G
2-PB1,1939,2,0,0,3342,3344,C
2-PB1,1940,3,1,0,3280,3284,C
2-PB1,1941,3228,0,4,0,3232,A
2-PB1,1942,3,1,3270,0,3274,G
2-PB1,1943,4,0,0,3358,3362,C
2-PB1,1944,4,1,0,3351,3356,C
2-PB1,1945,10,2,2,3346,3360,C
2-PB1,1946,3341,1,3,0,3345,A
2-PB1,1947,0,3340,1,7,3348,T
2-PB1,1948,2,6,3346,0,3354,G
2-PB1,1949,4,0,3347,0,3351,G
2-PB1,1950,0,3332,0,6,3338,T
2-PB1,1951,15,0,0,3291,3306,C
2-PB1,1952,2,1,0,3177,3180,C
2-PB1,1953,2,5,3236,0,3243,G
2-PB1,1954,2,3,3244,0,3249,G
2-PB1,1955,1,0,0,3233,3234,C
2-PB1,1956,5,1,0,3256,3262,C
2-PB1,1957,3264,2,0,1,3267,A
2-PB1,1958,3281,0,1,1,3283,A
2-PB1,1959,3283,0,1,0,3284,A
2-PB1,1960,3317,0,1,0,3318,A
2-PB1,1961,1,0,3400,1,3402,G
2-PB1,1962,0,3287,0,2,3289,T
2-PB1,1963,3316,0,2,0,3318,A
2-PB1,1964,3,3310,0,3,3316,T
2-PB1,1965,2,4,3312,0,3318,G
2-PB1,1966,1,2,3409,0,3412,G
2-PB1,1967,3380,0,4,1,3385,A
2-PB1,1968,3432,0,6,0,3438,A
2-PB1,1969,0,3400,1,1,3402,T
2-PB1,1970,3352,0,0,1,3353,A
2-PB1,1971,0,3350,0,2,3352,T
2-PB1,1972,1,7,3308,0,3316,G
2-PB1,1973,3312,0,6,2,3320,A
2-PB1,1974,0,3304,0,4,3308,T
2-PB1,1975,0,2,3167,0,3169,G
2-PB1,1976,0,1,1,3177,3179,C
2-PB1,1977,4,0,0,3150,3154,C
2-PB1,1978,1,1,3169,1,3172,G
2-PB1,1979,0,3161,0,2,3163,T
2-PB1,1980,0,3153,0,2,3155,T
2-PB1,1981,0,2,3169,0,3171,G
2-PB1,1982,0,1,0,3262,3263,C
2-PB1,1983,3264,0,1,2,3267,A
2-PB1,1984,3326,0,4,1,3331,A
2-PB1,1985,1,0,0,3352,3353,C
2-PB1,1986,0,3324,0,3,3327,T
2-PB1,1987,3345,1,0,0,3346,A
2-PB1,1988,0,2,0,3329,3331,C
2-PB1,1989,3332,0,4,0,3336,A
2-PB1,1990,1,2,0,3342,3345,C
2-PB1,1991,3200,0,3,0,3203,A
2-PB1,1992,0,0,0,3543,3543,C
2-PB1,1993,0,3432,1,6,3439,T
2-PB1,1994,7,1,0,3472,3480,C
2-PB1,1995,4,2,0,3487,3493,C
2-PB1,1996,3,3461,0,3,3467,T
2-PB1,1997,1,2,3455,0,3458,G
2-PB1,1998,2,2,3456,0,3460,G
2-PB1,1999,3440,0,0,0,3440,A
2-PB1,2000,0,3436,0,3,3439,T
2-PB1,2001,1,3034,0,3,3038,T
2-PB1,2002,4,1,0,3104,3109,C
2-PB1,2003,4,5,0,3082,3091,C
2-PB1,2004,2,2,0,3099,3103,C
2-PB1,2005,3125,0,1,0,3126,A
2-PB1,2006,3109,0,1,0,3110,A
2-PB1,2007,0,6,3123,0,3129,G
2-PB1,2008,3099,0,3,0,3102,A
2-PB1,2009,2,0,3093,0,3095,G
2-PB1,2010,0,5,3093,0,3098,G
2-PB1,2011,3045,0,5,0,3050,A
2-PB1,2012,3048,0,5,0,3053,A
2-PB1,2013,0,0,0,3055,3055,C
2-PB1,2014,4,1,0,3030,3035,C
2-PB1,2015,1,0,3110,0,3111,G
2-PB1,2016,2,0,2,3090,3094,C
2-PB1,2017,2,3060,0,4,3066,T
2-PB1,2018,7,1,0,3108,3116,C
2-PB1,2019,1,3081,0,6,3088,T
2-PB1,2020,3403,1,1,0,3405,A
2-PB1,2021,0,3396,0,4,3400,T
2-PB1,2022,0,3401,0,4,3405,T
2-PB1,2023,5,1,0,3421,3427,C
2-PB1,2024,0,3282,0,4,3286,T
2-PB1,2025,3303,1,2,0,3306,A
2-PB1,2026,3297,1,1,1,3300,A
2-PB1,2027,3310,0,3,0,3313,A
2-PB1,2028,0,2,0,3313,3315,C
2-PB1,2029,2998,2,0,1,3001,A
2-PB1,2030,0,2,0,2994,2996,C
2-PB1,2031,2941,0,6,0,2947,A
2-PB1,2032,2997,0,4,0,3001,A
2-PB1,2033,1,0,3022,0,3023,G
2-PB1,2034,1,3,0,3014,3018,C
2-PB1,2035,4,0,0,3011,3015,C
2-PB1,2036,3000,0,3,0,3003,A
2-PB1,2037,3006,0,4,0,3010,A
2-PB1,2038,2993,0,10,0,3003,A
2-PB1,2039,1,5,3046,0,3052,G
2-PB1,2040,0,7,3036,0,3043,G
2-PB1,2041,0,4,2975,1,2980,G
2-PB1,2042,3,5,2994,0,3002,G
2-PB1,2043,2967,0,3,0,2970,A
2-PB1,2044,3000,1,1,0,3002,A
2-PB1,2045,0,3003,0,1,3004,T
2-PB1,2046,0,3000,0,3,3003,T
2-PB1,2047,8,0,0,3023,3031,C
2-PB1,2048,1,2982,0,3,2986,T
2-PB1,2049,0,2976,1,2,2979,T
2-PB1,2050,2,3,2970,0,2975,G
2-PB1,2051,2962,0,8,0,2970,A
2-PB1,2052,0,4,2995,0,2999,G
2-PB1,2053,0,1,2988,0,2989,G
2-PB1,2054,2967,1,3,0,2971,A
2-PB1,2055,0,2973,0,2,2975,T
2-PB1,2056,0,9,3009,0,3018,G
2-PB1,2057,3005,1,3,0,3009,A
2-PB1,2058,3015,0,6,0,3021,A
2-PB1,2059,0,0,0,3041,3041,C
2-PB1,2060,2987,0,1,0,2988,A
2-PB1,2061,3,4,3044,0,3051,G
2-PB1,2062,3017,0,8,0,3025,A
2-PB1,2063,1,3028,0,1,3030,T
2-PB1,2064,0,0,3035,0,3035,G
2-PB1,2065,0,3142,0,2,3144,T
2-PB1,2066,3151,0,1,0,3152,A
2-PB1,2067,2,1,0,3143,3146,C
2-PB1,2068,9,4,0,3100,3113,C
2-PB1,2069,3085,1,2,0,3088,A
2-PB1,2070,1,5,3063,0,3069,G
2-PB1,2071,3027,1,1,0,3029,A
2-PB1,2072,3020,0,1,2,3023,A
2-PB1,2073,1,0,3050,0,3051,G
2-PB1,2074,0,2836,1,3,2840,T
2-PB1,2075,0,0,2846,0,2846,G
2-PB1,2076,0,1,1,2840,2842,C
2-PB1,2077,0,2836,0,6,2842,T
2-PB1,2078,1,1,2829,0,2831,G
2-PB1,2079,1,2,0,2814,2817,C
2-PB1,2080,2811,0,0,0,2811,A
2-PB1,2081,2831,0,1,0,2832,A
2-PB1,2082,0,1,0,2779,2780,C
2-PB1,2083,0,2769,0,6,2775,T
2-PB1,2084,0,2724,0,2,2726,T
2-PB1,2085,1,0,2724,0,2725,G
2-PB1,2086,0,2718,0,1,2719,T
2-PB1,2087,0,2706,0,1,2707,T
2-PB1,2088,10,2,0,2698,2710,C
2-PB1,2089,0,8,2702,0,2710,G
2-PB1,2090,2700,0,0,0,2700,A
2-PB1,2091,1,1,2696,0,2698,G
2-PB1,2092,2693,1,0,0,2694,A
2-PB1,2093,2706,0,0,0,2706,A
2-PB1,2094,2704,0,1,0,2705,A
2-PB1,2095,1,2698,0,0,2699,T
2-PB1,2096,0,2688,0,0,2688,T
2-PB1,2097,0,2695,0,2,2697,T
2-PB1,2098,1,2715,0,0,2716,T
2-PB1,2099,0,2707,0,4,2711,T
2-PB1,2100,4,0,0,2724,2728,C
2-PB1,2101,6,4,0,2710,2720,C
2-PB1,2102,9,1,0,2716,2726,C
2-PB1,2103,0,2715,1,3,2719,T
2-PB1,2104,2718,1,0,0,2719,A
2-PB1,2105,1,0,2751,0,2752,G
2-PB1,2106,0,2745,0,0,2745,T
2-PB1,2107,2787,1,2,0,2790,A
2-PB1,2108,0,0,2817,0,2817,G
2-PB1,2109,1,2779,0,2,2782,T
2-PB1,2110,0,2872,0,6,2878,T
2-PB1,2111,13,3,0,2906,2922,C
2-PB1,2112,2986,0,2,0,2988,A
2-PB1,2113,0,2986,0,3,2989,T
2-PB1,2114,2996,0,3,0,2999,A
2-PB1,2115,0,3011,0,1,3012,T
2-PB1,2116,2908,0,2,0,2910,A
2-PB1,2117,1,3,2902,1,2907,G
2-PB1,2118,0,5,2872,0,2877,G
2-PB1,2119,2552,2,8,0,2562,A
2-PB1,2120,1,9,2555,0,2565,G
2-PB1,2121,2377,1,4,2,2384,A
2-PB1,2122,0,2,0,2378,2380,C
2-PB1,2123,4,0,0,2295,2299,C
2-PB1,2124,1,1,2313,0,2315,G
2-PB1,2125,2293,0,3,0,2296,A
2-PB1,2126,1,2269,0,1,2271,T
2-PB1,2127,0,2275,0,1,2276,T
2-PB1,2128,1,1,2269,0,2271,G
2-PB1,2129,0,1,2278,0,2279,G
2-PB1,2130,2286,0,0,0,2286,A
2-PB1,2131,2286,0,1,0,2287,A
2-PB1,2132,1,2287,0,0,2288,T
2-PB1,2133,0,2297,0,1,2298,T
2-PB1,2134,0,2291,0,0,2291,T
2-PB1,2135,2,1,0,2301,2304,C
2-PB1,2136,0,2301,0,3,2304,T
2-PB1,2137,2287,1,1,0,2289,A
2-PB1,2138,1,0,2313,0,2314,G
2-PB1,2139,0,1,0,2299,2300,C
2-PB1,2140,2296,0,1,0,2297,A
2-PB1,2141,0,2298,0,2,2300,T
2-PB1,2142,0,3,2269,0,2272,G
2-PB1,2143,0,0,2365,0,2365,G
2-PB1,2144,1,2346,0,2,2349,T
2-PB1,2145,6,3,2340,0,2349,G
2-PB1,2146,1,2,2344,0,2347,G
2-PB1,2147,2317,1,10,1,2329,A
2-PB1,2148,0,1,2335,0,2336,G
2-PB1,2149,1,0,2324,0,2325,G
2-PB1,2150,1,0,0,2313,2314,C
2-PB1,2151,3,0,0,2293,2296,C
2-PB1,2152,2154,0,6,0,2160,A
2-PB1,2153,0,2154,0,3,2157,T
2-PB1,2154,1,2,2182,0,2185,G
2-PB1,2155,1,1,2211,0,2213,G
2-PB1,2156,0,2152,0,3,2155,T
2-PB1,2157,0,0,2214,0,2214,G
2-PB1,2158,0,2150,0,3,2153,T
2-PB1,2159,5,1,0,2132,2138,C
2-PB1,2160,0,2138,0,1,2139,T
2-PB1,2161,2101,0,2,0,2103,A
2-PB1,2162,1,2,2105,0,2108,G
2-PB1,2163,0,1,2050,0,2051,G
2-PB1,2164,2,0,2033,0,2035,G
2-PB1,2165,1,1,0,1988,1990,C
2-PB1,2166,3,0,0,1887,1890,C
2-PB1,2167,6,2,0,1850,1858,C
2-PB1,2168,2,3,1844,0,1849,G
2-PB1,2169,1,2,1854,0,1857,G
2-PB1,2170,1859,0,0,0,1859,A
2-PB1,2171,0,1854,0,0,1854,T
2-PB1,2172,0,1777,0,0,1777,T
2-PB1,2173,0,3,1758,0,1761,G
2-PB1,2174,1749,0,3,0,1752,A
2-PB1,2175,0,1765,0,0,1765,T
2-PB1,2176,1,2,1765,0,1768,G
2-PB1,2177,0,0,0,1750,1750,C
2-PB1,2178,6,0,1,1743,1750,C
2-PB1,2179,1732,0,2,0,1734,A
2-PB1,2180,0,3,1738,0,1741,G
2-PB1,2181,1736,0,2,0,1738,A
2-PB1,2182,1739,0,0,0,1739,A
2-PB1,2183,1,1735,0,2,1738,T
2-PB1,2184,1,1695,0,1,1697,T
2-PB1,2185,1,11,1684,0,1696,G
2-PB1,2186,1696,0,2,0,1698,A
2-PB1,2187,0,1,0,1700,1701,C
2-PB1,2188,0,1679,0,3,1682,T
2-PB1,2189,1,1668,0,1,1670,T
2-PB1,2190,2,1,0,1673,1676,C
2-PB1,2191,0,0,1671,0,1671,G
2-PB1,2192,1663,0,1,0,1664,A
2-PB1,2193,0,0,1637,0,1637,G
2-PB1,2194,1,1648,0,2,1651,T
2-PB1,2195,5,0,0,1655,1660,C
2-PB1,2196,0,1657,0,3,1660,T
2-PB1,2197,0,1,1660,0,1661,G
2-PB1,2198,0,0,1663,0,1663,G
2-PB1,2199,1655,1,1,0,1657,A
2-PB1,2200,1577,0,2,0,1579,A
2-PB1,2201,0,1,1590,0,1591,G
2-PB1,2202,7,3,1608,0,1618,G
2-PB1,2203,1614,1,1,0,1616,A
2-PB1,2204,0,1599,0,2,1601,T
2-PB1,2205,0,1609,0,0,1609,T
2-PB1,2206,1596,0,1,0,1597,A
2-PB1,2207,1583,0,3,1,1587,A
2-PB1,2208,1,1,1588,0,1590,G
2-PB1,2209,1578,0,0,1,1579,A
2-PB1,2210,1492,0,2,0,1494,A
2-PB1,2211,1,0,1399,0,1400,G
2-PB1,2212,1,0,1383,0,1384,G
2-PB1,2213,1388,1,0,0,1389,A
2-PB1,2214,1386,0,0,0,1386,A
2-PB1,2215,0,1,1390,0,1391,G
2-PB1,2216,1324,0,2,0,1326,A
2-PB1,2217,1,0,1336,0,1337,G
2-PB1,2218,0,1279,0,1,1280,T
2-PB1,2219,0,1264,0,0,1264,T
2-PB1,2220,3,0,0,1275,1278,C
2-PB1,2221,1,1238,0,2,1241,T
2-PB1,2222,5,0,1,1238,1244,C
2-PB1,2223,0,1243,0,0,1243,T
2-PB1,2224,2,0,1242,0,1244,G
2-PB1,2225,1217,0,0,0,1217,A
2-PB1,2226,2,1,1207,0,1210,G
2-PB1,2227,1187,0,1,0,1188,A
2-PB1,2228,0,1151,0,2,1153,T
2-PB1,2229,7,0,0,1094,1101,C
2-PB1,2230,1097,0,3,0,1100,A
2-PB1,2231,1,1090,0,0,1091,T
2-PB1,2232,0,1,1088,0,1089,G
2-PB1,2233,1075,0,1,0,1076,A
2-PB1,2234,1,3,994,0,998,G
2-PB1,2235,0,0,1004,0,1004,G
2-PB1,2236,999,0,2,0,1001,A
2-PB1,2237,0,1003,0,0,1003,T
2-PB1,2238,1,0,0,993,994,C
2-PB1,2239,0,948,0,0,948,T
2-PB1,2240,3,0,951,0,954,G
2-PB1,2241,0,948,0,0,948,T
2-PB1,2242,0,941,0,0,941,T
2-PB1,2243,4,0,0,929,933,C
2-PB1,2244,2,0,0,887,889,C
2-PB1,2245,886,0,1,0,887,A
2-PB1,2246,2,1,0,884,887,C
2-PB1,2247,1,0,0,831,832,C
2-PB1,2248,814,0,0,0,814,A
2-PB1,2249,0,743,0,2,745,T
2-PB1,2250,0,719,0,0,719,T
2-PB1,2251,0,2,715,0,717,G
2-PB1,2252,712,0,0,0,712,A
2-PB1,2253,708,0,4,0,712,A
2-PB1,2254,0,2,712,0,714,G
2-PB1,2255,602,0,2,0,604,A
2-PB1,2256,602,0,0,0,602,A
2-PB1,2257,0,0,0,597,597,C
2-PB1,2258,0,573,0,0,573,T
2-PB1,2259,3,0,0,573,576,C
2-PB1,2260,544,0,2,0,546,A
2-PB1,2261,0,0,547,0,547,G
2-PB1,2262,542,0,0,1,543,A
2-PB1,2263,0,1,0,527,528,C
2-PB1,2264,1,0,518,0,519,G
2-PB1,2265,1,0,493,0,494,G
2-PB1,2266,0,0,0,489,489,C
2-PB1,2267,491,0,1,0,492,A
2-PB1,2268,493,0,0,0,493,A
2-PB1,2269,488,0,0,0,488,A
2-PB1,2270,482,0,2,0,484,A
2-PB1,2271,481,0,0,0,481,A
2-PB1,2272,0,470,0,0,470,T
2-PB1,2273,452,0,0,0,452,A
2-PB1,2274,450,0,0,0,450,A
3-PA,1,237,0,0,0,237,A
3-PA,2,0,239,0,0,239,T
3-PA,3,0,0,267,0,267,G
3-PA,4,1,3,264,0,268,G
3-PA,5,268,0,0,0,268,A
3-PA,6,269,0,0,0,269,A
3-PA,7,0,1,278,1,280,G
3-PA,8,286,0,0,0,286,A
3-PA,9,0,290,0,0,290,T
3-PA,10,0,288,0,0,288,T
3-PA,11,0,295,0,1,296,T
3-PA,12,0,297,0,0,297,T
3-PA,13,0,0,305,0,305,G
3-PA,14,0,309,0,0,309,T
3-PA,15,1,2,303,0,306,G
3-PA,16,0,0,0,317,317,C
3-PA,17,0,2,315,0,317,G
3-PA,18,346,1,0,0,347,A
3-PA,19,0,0,0,352,352,C
3-PA,20,352,0,0,0,352,A
3-PA,21,358,0,0,0,358,A
3-PA,22,0,366,0,0,366,T
3-PA,23,0,1,454,0,455,G
3-PA,24,0,0,0,460,460,C
3-PA,25,0,457,0,1,458,T
3-PA,26,0,459,0,3,462,T
3-PA,27,1,0,0,457,458,C
3-PA,28,475,0,0,0,475,A
3-PA,29,489,0,0,0,489,A
3-PA,30,0,1,0,502,503,C
3-PA,31,1,0,0,504,505,C
3-PA,32,0,0,0,503,503,C
3-PA,33,0,1,513,0,514,G
3-PA,34,509,0,1,0,510,A
3-PA,35,0,515,0,1,516,T
3-PA,36,0,2,518,0,520,G
3-PA,37,517,0,0,0,517,A
3-PA,38,0,536,0,1,537,T
3-PA,39,0,535,0,1,536,T
3-PA,40,0,0,543,0,543,G
3-PA,41,0,540,0,1,541,T
3-PA,42,1,0,0,542,543,C
3-PA,43,1,5,532,0,538,G
3-PA,44,546,0,0,0,546,A
3-PA,45,547,1,0,0,548,A
3-PA,46,0,0,0,547,547,C
3-PA,47,0,547,0,0,547,T
3-PA,48,0,549,0,0,549,T
3-PA,49,0,0,551,0,551,G
3-PA,50,0,1,0,555,556,C
3-PA,51,553,0,1,0,554,A
3-PA,52,1,1,562,0,564,G
3-PA,53,561,0,0,0,561,A
3-PA,54,560,0,0,0,560,A
3-PA,55,560,0,0,0,560,A
3-PA,56,568,0,1,0,569,A
3-PA,57,572,0,4,0,576,A
3-PA,58,0,0,590,0,590,G
3-PA,59,0,0,0,621,621,C
3-PA,60,618,0,0,0,618,A
3-PA,61,675,0,1,0,676,A
3-PA,62,0,676,0,1,677,T
3-PA,63,0,3,690,0,693,G
3-PA,64,704,0,1,0,705,A
3-PA,65,701,0,0,1,702,A
3-PA,66,701,0,1,0,702,A
3-PA,67,0,2,759,0,761,G
3-PA,68,819,0,2,0,821,A
3-PA,69,0,0,965,0,965,G
3-PA,70,0,957,0,0,957,T
3-PA,71,960,0,1,0,961,A
3-PA,72,0,961,0,0,961,T
3-PA,73,0,4,967,0,971,G
3-PA,74,0,3,974,0,977,G
3-PA,75,1,1,975,0,977,G
3-PA,76,1,2,968,0,971,G
3-PA,77,950,0,0,0,950,A
3-PA,78,0,2,935,0,937,G
3-PA,79,0,2,950,0,952,G
3-PA,80,946,0,1,0,947,A
3-PA,81,0,962,0,1,963,T
3-PA,82,1,0,0,963,964,C
3-PA,83,0,957,0,0,957,T
3-PA,84,1,2,959,0,962,G
3-PA,85,957,0,0,0,957,A
3-PA,86,960,0,0,0,960,A
3-PA,87,961,0,2,0,963,A
3-PA,88,964,0,0,0,964,A
3-PA,89,0,971,0,0,971,T
3-PA,90,0,963,0,0,963,T
3-PA,91,0,1,957,0,958,G
3-PA,92,956,0,1,0,957,A
3-PA,93,958,0,1,0,959,A
3-PA,94,961,0,0,0,961,A
3-PA,95,0,0,0,961,961,C
3-PA,96,1,1,0,959,961,C
3-PA,97,969,0,0,0,969,A
3-PA,98,968,0,0,0,968,A
3-PA,99,0,1,0,971,972,C
3-PA,100,973,0,1,0,974,A
3-PA,101,977,0,0,0,977,A
3-PA,102,986,0,0,0,986,A
3-PA,103,0,990,0,0,990,T
3-PA,104,0,997,0,0,997,T
3-PA,105,0,993,0,0,993,T
3-PA,106,0,0,996,0,996,G
3-PA,107,1,0,0,997,998,C
3-PA,108,1001,0,0,0,1001,A
3-PA,109,0,1,1030,0,1031,G
3-PA,110,1,1,0,1038,1040,C
3-PA,111,1096,0,0,0,1096,A
3-PA,112,1113,0,0,0,1113,A
3-PA,113,0,1126,0,0,1126,T
3-PA,114,1144,0,2,0,1146,A
3-PA,115,0,1146,0,0,1146,T
3-PA,116,1,0,1151,0,1152,G
3-PA,117,1,2,0,1154,1157,C
3-PA,118,1138,1,4,0,1143,A
3-PA,119,0,0,0,1160,1160,C
3-PA,120,0,1146,0,0,1146,T
3-PA,121,7,1,0,1441,1449,C
3-PA,122,1501,0,0,0,1501,A
3-PA,123,0,0,0,1546,1546,C
3-PA,124,0,1536,0,1,1537,T
3-PA,125,0,1538,0,0,1538,T
3-PA,126,3,2,1535,0,1540,G
3-PA,127,2,5,1552,0,1559,G
3-PA,128,1541,0,2,0,1543,A
3-PA,129,0,5,1569,0,1574,G
3-PA,130,1,0,1554,0,1555,G
3-PA,131,1,1462,0,1,1464,T
3-PA,132,0,0,1481,0,1481,G
3-PA,133,1,1478,0,2,1481,T
3-PA,134,2,0,1474,0,1476,G
3-PA,135,0,2,0,1451,1453,C
3-PA,136,0,1514,0,4,1518,T
3-PA,137,1,1525,0,0,1526,T
3-PA,138,2,0,0,1558,1560,C
3-PA,139,1559,0,1,1,1561,A
3-PA,140,1,1570,0,1,1572,T
3-PA,141,0,0,1608,0,1608,G
3-PA,142,0,1590,0,1,1591,T
3-PA,143,1599,0,0,0,1599,A
3-PA,144,0,1594,0,1,1595,T
3-PA,145,1,1598,0,1,1600,T
3-PA,146,4,0,1,1599,1604,C
3-PA,147,1598,0,0,0,1598,A
3-PA,148,0,2,1616,0,1618,G
3-PA,149,1612,0,2,0,1614,A
3-PA,150,0,1598,0,1,1599,T
3-PA,151,0,1598,0,1,1599,T
3-PA,152,0,1598,0,2,1600,T
3-PA,153,1,2,0,1593,1596,C
3-PA,154,1,1,0,1623,1625,C
3-PA,155,1632,0,0,1,1633,A
3-PA,156,0,1637,0,0,1637,T
3-PA,157,0,1632,0,1,1633,T
3-PA,158,0,1634,0,2,1636,T
3-PA,159,2,1,0,1632,1635,C
3-PA,160,1646,0,4,0,1650,A
3-PA,161,0,1709,0,3,1712,T
3-PA,162,2,0,0,1712,1714,C
3-PA,163,1718,0,1,0,1719,A
3-PA,164,1720,0,2,0,1722,A
3-PA,165,1,1725,0,1,1727,T
3-PA,166,2,6,1773,0,1781,G
3-PA,167,1784,0,0,0,1784,A
3-PA,168,1778,1,1,0,1780,A
3-PA,169,1,2,0,1776,1779,C
3-PA,170,1761,1,1,0,1763,A
3-PA,171,1778,0,1,0,1779,A
3-PA,172,0,0,1783,0,1783,G
3-PA,173,1,1,1790,0,1792,G
3-PA,174,0,0,0,1784,1784,C
3-PA,175,2,6,1766,0,1774,G
3-PA,176,1891,0,1,0,1892,A
3-PA,177,1888,0,8,1,1897,A
3-PA,178,0,1900,0,0,1900,T
3-PA,179,5,1,0,1922,1928,C
3-PA,180,1922,0,1,0,1923,A
3-PA,181,1934,0,1,0,1935,A
3-PA,182,0,1939,0,0,1939,T
3-PA,183,1934,0,0,0,1934,A
3-PA,184,2,0,1971,0,1973,G
3-PA,185,0,1939,0,0,1939,T
3-PA,186,0,5,1953,0,1958,G
3-PA,187,1,1,1948,0,1950,G
3-PA,188,1,1930,0,2,1933,T
3-PA,189,1927,0,1,0,1928,A
3-PA,190,0,3,1959,0,1962,G
3-PA,191,1944,1,5,0,1950,A
3-PA,192,1963,0,1,0,1964,A
3-PA,193,0,1,0,1963,1964,C
3-PA,194,0,1931,0,1,1932,T
3-PA,195,0,1921,0,0,1921,T
3-PA,196,0,3,1924,0,1927,G
3-PA,197,1929,0,2,0,1931,A
3-PA,198,1,6,0,1921,1928,C
3-PA,199,3,5,1904,0,1912,G
3-PA,200,1960,1,0,1,1962,A
3-PA,201,0,1974,0,1,1975,T
3-PA,202,2,0,0,1992,1994,C
3-PA,203,5,1,0,2008,2014,C
3-PA,204,2009,0,0,0,2009,A
3-PA,205,2011,0,0,0,2011,A
3-PA,206,2013,0,0,1,2014,A
3-PA,207,0,2020,0,2,2022,T
3-PA,208,1,1,2019,1,2022,G
3-PA,209,0,0,0,2000,2000,C
3-PA,210,1987,1,0,0,1988,A
3-PA,211,0,0,0,2052,2052,C
3-PA,212,0,2009,0,3,2012,T
3-PA,213,0,0,2294,0,2294,G
3-PA,214,0,2291,0,1,2292,T
3-PA,215,0,2281,0,2,2283,T
3-PA,216,2290,0,0,0,2290,A
3-PA,217,2288,0,1,0,2289,A
3-PA,218,2281,0,5,0,2286,A
3-PA,219,0,1,2284,0,2285,G
3-PA,220,0,1,0,2241,2242,C
3-PA,221,2213,0,2,0,2215,A
3-PA,222,0,0,0,2207,2207,C
3-PA,223,2041,1,0,0,2042,A
3-PA,224,0,2,2137,0,2139,G
3-PA,225,2123,0,0,0,2123,A
3-PA,226,1,2121,0,0,2122,T
3-PA,227,0,2117,0,0,2117,T
3-PA,228,0,2103,0,2,2105,T
3-PA,229,2,6,2105,0,2113,G
3-PA,230,2122,0,2,0,2124,A
3-PA,231,2125,0,3,0,2128,A
3-PA,232,2130,0,1,0,2131,A
3-PA,233,0,2059,0,1,2060,T
3-PA,234,2062,0,0,0,2062,A
3-PA,235,2101,0,1,0,2102,A
3-PA,236,0,2087,0,0,2087,T
3-PA,237,3,0,0,2097,2100,C
3-PA,238,0,9,2085,0,2094,G
3-PA,239,2086,0,3,0,2089,A
3-PA,240,1,6,2103,0,2110,G
3-PA,241,0,8,2146,0,2154,G
3-PA,242,1,7,2140,0,2148,G
3-PA,243,1,4,2145,0,2150,G
3-PA,244,2111,0,3,0,2114,A
3-PA,245,0,1,2141,0,2142,G
3-PA,246,2186,0,2,0,2188,A
3-PA,247,1,2,2208,0,2211,G
3-PA,248,2212,1,4,0,2217,A
3-PA,249,0,0,0,2215,2215,C
3-PA,250,2181,0,4,0,2185,A
3-PA,251,0,8,2197,0,2205,G
3-PA,252,2205,0,3,0,2208,A
3-PA,253,2261,1,1,0,2263,A
3-PA,254,1,0,0,2256,2257,C
3-PA,255,2182,1,1,0,2184,A
3-PA,256,2178,0,2,0,2180,A
3-PA,257,0,2167,0,2,2169,T
3-PA,258,0,3,2243,0,2246,G
3-PA,259,3,0,2256,0,2259,G
3-PA,260,2,2,0,2241,2245,C
3-PA,261,1,1,0,2244,2246,C
3-PA,262,2,2208,1,1,2212,T
3-PA,263,1,4,2295,0,2300,G
3-PA,264,0,2,2287,0,2289,G
3-PA,265,2287,0,4,0,2291,A
3-PA,266,0,0,0,2318,2318,C
3-PA,267,2219,0,1,0,2220,A
3-PA,268,1,0,2549,0,2550,G
3-PA,269,0,2535,0,3,2538,T
3-PA,270,2578,0,0,0,2578,A
3-PA,271,1,0,2571,0,2572,G
3-PA,272,1,2487,0,1,2489,T
3-PA,273,2502,0,1,0,2503,A
3-PA,274,2504,0,0,0,2504,A
3-PA,275,2483,0,0,0,2483,A
3-PA,276,0,1,0,2517,2518,C
3-PA,277,2245,0,2,0,2247,A
3-PA,278,0,0,2324,0,2324,G
3-PA,279,0,2296,0,2,2298,T
3-PA,280,2346,0,0,0,2346,A
3-PA,281,0,2328,0,2,2330,T
3-PA,282,1,0,0,2383,2384,C
3-PA,283,1,2378,1,1,2381,T
3-PA,284,1,1,2376,0,2378,G
3-PA,285,1,1,0,2381,2383,C
3-PA,286,2359,0,2,0,2361,A
3-PA,287,2355,0,2,0,2357,A
3-PA,288,0,2,0,2367,2369,C
3-PA,289,2346,1,1,1,2349,A
3-PA,290,0,0,0,2477,2477,C
3-PA,291,0,2439,0,5,2444,T
3-PA,292,2459,0,2,0,2461,A
3-PA,293,0,0,0,2452,2452,C
3-PA,294,1,2434,0,2,2437,T
3-PA,295,0,2,2427,0,2429,G
3-PA,296,1,5,2416,1,2423,G
3-PA,297,2390,1,2,0,2393,A
3-PA,298,0,1,2402,0,2403,G
3-PA,299,0,1,0,2331,2332,C
3-PA,300,0,2330,0,4,2334,T
3-PA,301,0,4,2321,0,2325,G
3-PA,302,2,1,2328,0,2331,G
3-PA,303,2325,0,1,0,2326,A
3-PA,304,2323,0,1,0,2324,A
3-PA,305,2317,0,3,0,2320,A
3-PA,306,2331,1,2,1,2335,A
3-PA,307,0,1,0,2330,2331,C
3-PA,308,7,0,0,2325,2332,C
3-PA,309,0,0,2333,0,2333,G
3-PA,310,2322,0,0,0,2322,A
3-PA,311,2315,0,3,0,2318,A
3-PA,312,2,0,2334,0,2336,G
3-PA,313,0,2338,0,1,2339,T
3-PA,314,0,2329,0,1,2330,T
3-PA,315,0,2329,0,3,2332,T
3-PA,316,4,2,0,2344,2350,C
3-PA,317,0,2354,0,1,2355,T
3-PA,318,2368,0,1,0,2369,A
3-PA,319,0,2,0,2357,2359,C
3-PA,320,2,0,0,2367,2369,C
3-PA,321,2335,0,0,0,2335,A
3-PA,322,0,1,2378,0,2379,G
3-PA,323,2385,0,0,0,2385,A
3-PA,324,0,2376,0,1,2377,T
3-PA,325,0,2372,0,0,2372,T
3-PA,326,0,2376,0,0,2376,T
3-PA,327,1,2,2394,0,2397,G
3-PA,328,1,2396,1,4,2402,T
3-PA,329,2400,0,2,0,2402,A
3-PA,330,1,2389,0,2,2392,T
3-PA,331,1,5,2340,0,2346,G
3-PA,332,2469,1,2,1,2473,A
3-PA,333,0,2458,0,4,2462,T
3-PA,334,1,2469,0,2,2472,T
3-PA,335,2474,1,2,0,2477,A
3-PA,336,1,2,0,2470,2473,C
3-PA,337,2480,0,2,0,2482,A
3-PA,338,2478,0,4,0,2482,A
3-PA,339,1,2,2491,0,2494,G
3-PA,340,1,1,2511,0,2513,G
3-PA,341,2324,0,7,0,2331,A
3-PA,342,0,8,2375,0,2383,G
3-PA,343,2365,1,5,0,2371,A
3-PA,344,2371,0,5,0,2376,A
3-PA,345,1,0,0,2370,2371,C
3-PA,346,2335,0,0,0,2335,A
3-PA,347,3,3,2344,0,2350,G
3-PA,348,2327,0,3,0,2330,A
3-PA,349,0,2287,0,1,2288,T
3-PA,350,0,2283,0,1,2284,T
3-PA,351,3,1,0,2247,2251,C
3-PA,352,2257,0,0,0,2257,A
3-PA,353,0,2248,0,3,2251,T
3-PA,354,2,2,0,2252,2256,C
3-PA,355,1,2,2262,0,2265,G
3-PA,356,2266,1,0,0,2267,A
3-PA,357,2261,0,1,0,2262,A
3-PA,358,2269,0,0,0,2269,A
3-PA,359,0,2260,1,0,2261,T
3-PA,360,0,2258,0,3,2261,T
3-PA,361,0,1,2260,0,2261,G
3-PA,362,0,4,2249,0,2253,G
3-PA,363,2200,2,3,0,2205,A
3-PA,364,1,0,2247,0,2248,G
3-PA,365,0,2245,0,0,2245,T
3-PA,366,0,8,2289,2,2299,G
3-PA,367,2296,1,0,0,2297,A
3-PA,368,1,0,0,2309,2310,C
3-PA,369,2306,0,5,0,2311,A
3-PA,370,2307,0,3,0,2310,A
3-PA,371,0,3,2348,0,2351,G
3-PA,372,0,4,2354,0,2358,G
3-PA,373,2309,0,5,0,2314,A
3-PA,374,2,2,2329,1,2334,G
3-PA,375,2261,0,4,0,2265,A
3-PA,376,0,1,2284,0,2285,G
3-PA,377,2251,0,3,0,2254,A
3-PA,378,2256,0,3,0,2259,A
3-PA,379,0,0,2314,0,2314,G
3-PA,380,0,2211,0,9,2220,T
3-PA,381,6,1,0,2259,2266,C
3-PA,382,8,1,0,2264,2273,C
3-PA,383,2294,1,3,0,2298,A
3-PA,384,1,0,0,2354,2355,C
3-PA,385,2404,0,4,0,2408,A
3-PA,386,0,2460,0,1,2461,T
3-PA,387,2512,0,1,0,2513,A
3-PA,388,0,2410,0,0,2410,T
3-PA,389,2396,0,3,0,2399,A
3-PA,390,0,2356,0,1,2357,T
3-PA,391,0,2341,0,1,2342,T
3-PA,392,2409,1,1,0,2411,A
3-PA,393,2,0,0,2390,2392,C
3-PA,394,1,0,0,2301,2302,C
3-PA,395,0,2233,4,3,2240,T
3-PA,396,0,2192,0,6,2198,T
3-PA,397,1,3,2220,0,2224,G
3-PA,398,2229,0,0,0,2229,A
3-PA,399,2231,0,0,0,2231,A
3-PA,400,2226,0,0,0,2226,A
3-PA,401,2107,0,8,0,2115,A
3-PA,402,3,2,2129,0,2134,G
3-PA,403,0,1,2134,0,2135,G
3-PA,404,1,0,0,2140,2141,C
3-PA,405,10,1,0,2128,2139,C
3-PA,406,2133,0,2,0,2135,A
3-PA,407,2142,2,1,0,2145,A
3-PA,408,0,2141,0,0,2141,T
3-PA,409,2140,0,1,0,2141,A
3-PA,410,2146,0,0,0,2146,A
3-PA,411,0,6,2170,0,2176,G
3-PA,412,2146,1,3,0,2150,A
3-PA,413,0,2158,0,1,2159,T
3-PA,414,0,2149,0,0,2149,T
3-PA,415,2156,0,0,0,2156,A
3-PA,416,2156,0,0,0,2156,A
3-PA,417,2158,0,0,0,2158,A
3-PA,418,0,2174,0,1,2175,T
3-PA,419,1,0,0,2175,2176,C
3-PA,420,0,2090,0,1,2091,T
3-PA,421,0,7,2111,0,2118,G
3-PA,422,2105,0,4,0,2109,A
3-PA,423,2,4,2130,0,2136,G
3-PA,424,2119,0,4,0,2123,A
3-PA,425,2137,0,1,0,2138,A
3-PA,426,0,0,0,2142,2142,C
3-PA,427,2125,0,1,1,2127,A
3-PA,428,0,0,0,2150,2150,C
3-PA,429,2137,1,3,0,2141,A
3-PA,430,0,0,0,2178,2178,C
3-PA,431,2148,1,1,1,2151,A
3-PA,432,0,1,0,2237,2238,C
3-PA,433,2223,0,0,0,2223,A
3-PA,434,0,2211,0,3,2214,T
3-PA,435,0,2208,0,4,2212,T
3-PA,436,7,2,0,2220,2229,C
3-PA,437,2213,0,2,0,2215,A
3-PA,438,0,1,0,2236,2237,C
3-PA,439,2210,1,0,0,2211,A
3-PA,440,0,2199,0,4,2203,T
3-PA,441,0,2094,0,2,2096,T
3-PA,442,0,2130,0,1,2131,T
3-PA,443,0,2120,0,8,2128,T
3-PA,444,1,0,0,2171,2172,C
3-PA,445,0,2143,0,7,2150,T
3-PA,446,6,0,0,2159,2165,C
3-PA,447,2157,1,0,0,2158,A
3-PA,448,0,2152,0,7,2159,T
3-PA,449,1,2159,0,2,2162,T
3-PA,450,4,0,0,2178,2182,C
3-PA,451,2147,0,1,0,2148,A
3-PA,452,0,1,0,2177,2178,C
3-PA,453,1,2136,0,1,2138,T
3-PA,454,0,6,2196,0,2202,G
3-PA,455,1,7,2193,0,2201,G
3-PA,456,1,3,2200,0,2204,G
3-PA,457,0,2,2202,0,2204,G
3-PA,458,2168,0,1,1,2170,A
3-PA,459,0,3,2186,0,2189,G
3-PA,460,0,0,2208,0,2208,G
3-PA,461,2189,0,0,1,2190,A
3-PA,462,2188,0,5,0,2193,A
3-PA,463,2172,0,1,0,2173,A
3-PA,464,0,2131,0,1,2132,T
3-PA,465,1,4,2124,0,2129,G
3-PA,466,2,0,2124,0,2126,G
3-PA,467,1,1,0,2135,2137,C
3-PA,468,1,1,0,2129,2131,C
3-PA,469,2126,0,1,1,2128,A
3-PA,470,0,1,0,2128,2129,C
3-PA,471,2129,0,0,0,2129,A
3-PA,472,2143,0,1,0,2144,A
3-PA,473,2139,1,6,0,2146,A
3-PA,474,4,6,2165,0,2175,G
3-PA,475,0,1,2181,0,2182,G
3-PA,476,0,0,0,2173,2173,C
3-PA,477,2177,1,1,0,2179,A
3-PA,478,2,5,2210,0,2217,G
3-PA,479,2214,1,0,0,2215,A
3-PA,480,1,0,0,2256,2257,C
3-PA,481,0,2239,0,1,2240,T
3-PA,482,2249,0,3,0,2252,A
3-PA,483,1,0,0,2230,2231,C
3-PA,484,2220,1,4,0,2225,A
3-PA,485,0,1,0,2242,2243,C
3-PA,486,1,2147,1,1,2150,T
3-PA,487,5,0,0,2180,2185,C
3-PA,488,0,2134,1,3,2138,T
3-PA,489,6,2,0,2104,2112,C
3-PA,490,3,7,2104,0,2114,G
3-PA,491,2096,0,2,0,2098,A
3-PA,492,1,2,0,2089,2092,C
3-PA,493,3,2,2109,1,2115,G
3-PA,494,2100,1,1,0,2102,A
3-PA,495,0,1,2108,0,2109,G
3-PA,496,0,4,2102,0,2106,G
3-PA,497,2096,0,2,0,2098,A
3-PA,498,2096,0,7,1,2104,A
3-PA,499,2104,0,4,0,2108,A
3-PA,500,1,0,2103,0,2104,G
3-PA,501,2,1,0,2095,2098,C
3-PA,502,2058,0,1,0,2059,A
3-PA,503,0,1,2101,1,2103,G
3-PA,504,2,6,2103,0,2111,G
3-PA,505,0,2,2121,0,2123,G
3-PA,506,1,0,0,2116,2117,C
3-PA,507,0,2094,0,1,2095,T
3-PA,508,2112,0,0,0,2112,A
3-PA,509,0,2,2160,0,2162,G
3-PA,510,1,4,2300,0,2305,G
3-PA,511,2317,0,2,0,2319,A
3-PA,512,0,2251,0,0,2251,T
3-PA,513,0,2203,1,3,2207,T
3-PA,514,2203,0,2,0,2205,A
3-PA,515,2215,0,4,0,2219,A
3-PA,516,2,14,2218,0,2234,G
3-PA,517,2231,0,1,1,2233,A
3-PA,518,0,0,0,2218,2218,C
3-PA,519,6,1,0,2010,2017,C
3-PA,520,1982,0,4,0,1986,A
3-PA,521,0,2,2008,1,2011,G
3-PA,522,0,1,1997,0,1998,G
3-PA,523,1,1,0,2023,2025,C
3-PA,524,0,1975,0,0,1975,T
3-PA,525,0,0,2031,0,2031,G
3-PA,526,0,2007,0,7,2014,T
3-PA,527,0,2016,0,0,2016,T
3-PA,528,0,2026,0,0,2026,T
3-PA,529,2023,0,1,0,2024,A
3-PA,530,1,3,0,2072,2076,C
3-PA,531,8,1,0,2016,2025,C
3-PA,532,2009,0,1,0,2010,A
3-PA,533,0,2009,0,1,2010,T
3-PA,534,1919,0,0,0,1919,A
3-PA,535,1931,0,2,0,1933,A
3-PA,536,0,4,1957,0,1961,G
3-PA,537,1958,0,1,0,1959,A
3-PA,538,0,1,0,1959,1960,C
3-PA,539,1897,0,1,0,1898,A
3-PA,540,1899,0,3,0,1902,A
3-PA,541,0,1,1918,0,1919,G
3-PA,542,1908,0,1,0,1909,A
3-PA,543,1905,0,1,1,1907,A
3-PA,544,1907,1,2,0,1910,A
3-PA,545,1,1842,0,1,1844,T
3-PA,546,1,2,1884,0,1887,G
3-PA,547,1,1,1888,0,1890,G
3-PA,548,1,1,0,1876,1878,C
3-PA,549,4,0,0,1875,1879,C
3-PA,550,1875,0,1,0,1876,A
3-PA,551,1909,0,1,0,1910,A
3-PA,552,1,0,0,1909,1910,C
3-PA,553,1908,0,0,0,1908,A
3-PA,554,1,0,1906,0,1907,G
3-PA,555,1841,0,8,1,1850,A
3-PA,556,1,1,1872,0,1874,G
3-PA,557,1,0,1864,0,1865,G
3-PA,558,0,0,0,1860,1860,C
3-PA,559,2,1,0,1881,1884,C
3-PA,560,1,1813,1,1,1816,T
3-PA,561,3,0,0,1828,1831,C
3-PA,562,0,1836,0,2,1838,T
3-PA,563,1,6,1846,0,1853,G
3-PA,564,0,2,1845,0,1847,G
3-PA,565,1,2,1824,0,1827,G
3-PA,566,1807,1,2,0,1810,A
3-PA,567,0,1735,0,2,1737,T
3-PA,568,1,1710,0,1,1712,T
3-PA,569,3,0,0,1871,1874,C
3-PA,570,2,0,0,1853,1855,C
3-PA,571,0,1775,0,3,1778,T
3-PA,572,0,1758,0,3,1761,T
3-PA,573,1,1767,0,1,1769,T
3-PA,574,3,0,0,1773,1776,C
3-PA,575,1,0,1781,0,1782,G
3-PA,576,0,1773,0,1,1774,T
3-PA,577,3,1,0,1774,1778,C
3-PA,578,1718,0,2,0,1720,A
3-PA,579,0,0,1887,0,1887,G
3-PA,580,0,1886,0,0,1886,T
3-PA,581,6,0,1,1879,1886,C
3-PA,582,5,1,0,1885,1891,C
3-PA,583,4,3,1890,0,1897,G
3-PA,584,1896,0,1,1,1898,A
3-PA,585,1901,0,0,0,1901,A
3-PA,586,1900,0,3,1,1904,A
3-PA,587,1,4,1924,0,1929,G
3-PA,588,1809,0,4,0,1813,A
3-PA,589,1,1,1835,0,1837,G
3-PA,590,2,0,1840,0,1842,G
3-PA,591,0,0,0,1848,1848,C
3-PA,592,0,1,1850,0,1851,G
3-PA,593,1844,0,0,0,1844,A
3-PA,594,1850,1,4,0,1855,A
3-PA,595,1,5,1856,0,1862,G
3-PA,596,1854,1,1,0,1856,A
3-PA,597,1852,0,4,0,1856,A
3-PA,598,1846,0,3,0,1849,A
3-PA,599,0,1,0,1863,1864,C
3-PA,600,1856,0,0,0,1856,A
3-PA,601,1863,0,1,0,1864,A
3-PA,602,0,1860,0,0,1860,T
3-PA,603,0,1850,0,0,1850,T
3-PA,604,0,1,1850,0,1851,G
3-PA,605,1834,0,1,0,1835,A
3-PA,606,1834,0,4,0,1838,A
3-PA,607,1,1,1846,0,1848,G
3-PA,608,1834,0,1,1,1836,A
3-PA,609,1837,0,0,0,1837,A
3-PA,610,1833,0,1,0,1834,A
3-PA,611,1843,0,2,1,1846,A
3-PA,612,1850,0,1,0,1851,A
3-PA,613,0,1839,0,0,1839,T
3-PA,614,0,1841,0,0,1841,T
3-PA,615,0,1848,0,1,1849,T
3-PA,616,0,3,1847,1,1851,G
3-PA,617,1839,0,1,0,1840,A
3-PA,618,1843,0,2,0,1845,A
3-PA,619,1851,0,0,0,1851,A
3-PA,620,0,1876,0,0,1876,T
3-PA,621,3,1,0,2065,2069,C
3-PA,622,2063,0,2,0,2065,A
3-PA,623,0,0,0,2108,2108,C
3-PA,624,2097,0,4,0,2101,A
3-PA,625,1,1,2148,0,2150,G
3-PA,626,2,9,2209,1,2221,G
3-PA,627,2236,0,6,0,2242,A
3-PA,628,2271,1,0,0,2272,A
3-PA,629,1,0,0,2304,2305,C
3-PA,630,0,2190,0,3,2193,T
3-PA,631,2397,0,1,0,2398,A
3-PA,632,0,2419,0,2,2421,T
3-PA,633,0,0,2494,0,2494,G
3-PA,634,0,1,0,2474,2475,C
3-PA,635,2,2,2433,0,2437,G
3-PA,636,0,2431,0,3,2434,T
3-PA,637,2407,0,1,0,2408,A
3-PA,638,0,8,2415,0,2423,G
3-PA,639,1,0,2405,0,2406,G
3-PA,640,3,1,0,2336,2340,C
3-PA,641,0,2294,0,2,2296,T
3-PA,642,1,2264,1,0,2266,T
3-PA,643,4,0,2268,0,2272,G
3-PA,644,0,1,0,2260,2261,C
3-PA,645,5,4,0,2261,2270,C
3-PA,646,2,11,2289,0,2302,G
3-PA,647,2297,0,1,0,2298,A
3-PA,648,3,0,0,2300,2303,C
3-PA,649,7,1,0,2299,2307,C
3-PA,650,2312,0,2,0,2314,A
3-PA,651,2319,0,0,0,2319,A
3-PA,652,2315,0,1,1,2317,A
3-PA,653,0,0,2370,0,2370,G
3-PA,654,1,2352,0,3,2356,T
3-PA,655,2,0,0,2355,2357,C
3-PA,656,0,2335,1,2,2338,T
3-PA,657,3,2,0,2353,2358,C
3-PA,658,4,1,0,2360,2365,C
3-PA,659,8,0,0,2369,2377,C
3-PA,660,2382,1,1,0,2384,A
3-PA,661,0,0,0,2394,2394,C
3-PA,662,2,0,0,2365,2367,C
3-PA,663,2,6,2369,0,2377,G
3-PA,664,2406,0,0,1,2407,A
3-PA,665,2414,2,2,0,2418,A
3-PA,666,1,2,0,2455,2458,C
3-PA,667,0,2397,1,7,2405,T
3-PA,668,0,2441,0,4,2445,T
3-PA,669,3,1,0,2482,2486,C
3-PA,670,4,2449,0,1,2454,T
3-PA,671,10,0,0,2472,2482,C
3-PA,672,3,2,0,2469,2474,C
3-PA,673,0,2446,0,1,2447,T
3-PA,674,1,0,2485,0,2486,G
3-PA,675,2,0,0,2471,2473,C
3-PA,676,5,0,0,2478,2483,C
3-PA,677,0,2443,0,5,2448,T
3-PA,678,1,2431,0,5,2437,T
3-PA,679,2,8,2430,0,2440,G
3-PA,680,2434,0,1,0,2435,A
3-PA,681,0,9,2479,0,2488,G
3-PA,682,2477,1,1,0,2479,A
3-PA,683,2485,0,0,0,2485,A
3-PA,684,1,2550,1,2,2554,T
3-PA,685,0,2559,0,2,2561,T
3-PA,686,0,2568,0,1,2569,T
3-PA,687,0,2566,0,3,2569,T
3-PA,688,2558,0,6,0,2564,A
3-PA,689,1,2,2558,0,2561,G
3-PA,690,2517,0,2,0,2519,A
3-PA,691,0,0,2617,0,2617,G
3-PA,692,1,2,0,2608,2611,C
3-PA,693,3,0,0,2622,2625,C
3-PA,694,0,2650,0,4,2654,T
3-PA,695,2767,1,1,0,2769,A
3-PA,696,0,2771,0,2,2773,T
3-PA,697,0,1,2797,0,2798,G
3-PA,698,0,2784,0,5,2789,T
3-PA,699,1,9,2781,0,2791,G
3-PA,700,1,6,2739,0,2746,G
3-PA,701,2716,1,5,0,2722,A
3-PA,702,2,2712,0,1,2715,T
3-PA,703,2,8,2652,0,2662,G
3-PA,704,0,2,2742,0,2744,G
3-PA,705,2734,1,2,0,2737,A
3-PA,706,0,2716,0,0,2716,T
3-PA,707,0,2722,0,2,2724,T
3-PA,708,8,2,0,2689,2699,C
3-PA,709,3,6,2709,0,2718,G
3-PA,710,2718,1,3,0,2722,A
3-PA,711,2724,0,2,0,2726,A
3-PA,712,1,0,0,2743,2744,C
3-PA,713,10,4,0,2620,2634,C
3-PA,714,3,4,2639,0,2646,G
3-PA,715,2636,0,0,0,2636,A
3-PA,716,2636,0,6,0,2642,A
3-PA,717,0,2,0,2674,2676,C
3-PA,718,0,8,2651,1,2660,G
3-PA,719,0,0,2734,0,2734,G
3-PA,720,0,0,0,2736,2736,C
3-PA,721,1,2713,0,2,2716,T
3-PA,722,3,2,2787,0,2792,G
3-PA,723,0,0,0,2808,2808,C
3-PA,724,2823,0,2,0,2825,A
3-PA,725,0,2822,1,1,2824,T
3-PA,726,0,2793,0,2,2795,T
3-PA,727,0,6,2792,0,2798,G
3-PA,728,2683,0,6,0,2689,A
3-PA,729,1,4,2737,0,2742,G
3-PA,730,0,3,2724,0,2727,G
3-PA,731,1,0,2688,0,2689,G
3-PA,732,1,2,0,2676,2679,C
3-PA,733,2650,1,1,0,2652,A
3-PA,734,2667,0,4,0,2671,A
3-PA,735,0,1,2677,0,2678,G
3-PA,736,0,1,0,2676,2677,C
3-PA,737,0,2664,0,6,2670,T
3-PA,738,0,2647,0,0,2647,T
3-PA,739,0,2666,0,4,2670,T
3-PA,740,3,2,0,2671,2676,C
3-PA,741,1,2666,0,5,2672,T
3-PA,742,10,1,0,2683,2694,C
3-PA,743,2683,0,3,0,2686,A
3-PA,744,2672,0,2,0,2674,A
3-PA,745,2673,0,0,0,2673,A
3-PA,746,0,2673,0,2,2675,T
3-PA,747,1,2,2788,1,2792,G
3-PA,748,0,2776,1,1,2778,T
3-PA,749,2,3,0,2807,2812,C
3-PA,750,8,1,0,2807,2816,C
3-PA,751,2813,0,2,1,2816,A
3-PA,752,2819,0,3,2,2824,A
3-PA,753,2817,0,3,1,2821,A
3-PA,754,1,2,2876,0,2879,G
3-PA,755,2833,1,3,0,2837,A
3-PA,756,2706,0,4,0,2710,A
3-PA,757,1,0,2735,0,2736,G
3-PA,758,0,2679,0,5,2684,T
3-PA,759,1,13,2667,0,2681,G
3-PA,760,2668,1,1,0,2670,A
3-PA,761,2675,0,1,0,2676,A
3-PA,762,0,2683,0,1,2684,T
3-PA,763,0,0,2659,0,2659,G
3-PA,764,1,0,0,2661,2662,C
3-PA,765,5,0,0,2660,2665,C
3-PA,766,6,2,0,2648,2656,C
3-PA,767,2665,2,0,1,2668,A
3-PA,768,2710,0,0,0,2710,A
3-PA,769,2730,0,0,0,2730,A
3-PA,770,0,2729,0,1,2730,T
3-PA,771,0,2716,0,1,2717,T
3-PA,772,1,12,2700,0,2713,G
3-PA,773,2695,0,3,0,2698,A
3-PA,774,2684,1,2,0,2687,A
3-PA,775,1,0,0,2710,2711,C
3-PA,776,2,1,0,2689,2692,C
3-PA,777,0,2626,0,4,2630,T
3-PA,778,2,2745,0,2,2749,T
3-PA,779,0,2750,0,0,2750,T
3-PA,780,0,2812,0,1,2813,T
3-PA,781,3,1,0,2822,2826,C
3-PA,782,0,2803,1,5,2809,T
3-PA,783,3,0,2816,1,2820,G
3-PA,784,2790,0,1,0,2791,A
3-PA,785,2840,1,6,0,2847,A
3-PA,786,0,7,2866,0,2873,G
3-PA,787,2807,1,4,0,2812,A
3-PA,788,0,1,0,2815,2816,C
3-PA,789,2777,0,4,0,2781,A
3-PA,790,2797,0,4,0,2801,A
3-PA,791,1,2,0,3142,3145,C
3-PA,792,3172,0,2,0,3174,A
3-PA,793,0,0,0,3169,3169,C
3-PA,794,8,0,0,3110,3118,C
3-PA,795,3098,0,7,0,3105,A
3-PA,796,3097,0,7,0,3104,A
3-PA,797,1,8,3115,0,3124,G
3-PA,798,3119,1,2,0,3122,A
3-PA,799,1,2,0,3112,3115,C
3-PA,800,9,3,0,2823,2835,C
3-PA,801,2823,0,0,0,2823,A
3-PA,802,2827,0,1,1,2829,A
3-PA,803,1,2819,0,1,2821,T
3-PA,804,6,2,0,2829,2837,C
3-PA,805,2816,0,0,0,2816,A
3-PA,806,2795,0,0,0,2795,A
3-PA,807,2809,0,3,0,2812,A
3-PA,808,0,0,0,2852,2852,C
3-PA,809,0,2769,0,3,2772,T
3-PA,810,0,2779,1,2,2782,T
3-PA,811,3,3,0,2802,2808,C
3-PA,812,1,0,0,2812,2813,C
3-PA,813,0,4,2839,0,2843,G
3-PA,814,2824,0,1,0,2825,A
3-PA,815,2838,0,0,0,2838,A
3-PA,816,0,2849,0,0,2849,T
3-PA,817,2,4,2800,0,2806,G
3-PA,818,0,3,2803,0,2806,G
3-PA,819,2811,2,6,0,2819,A
3-PA,820,0,1,0,2839,2840,C
3-PA,821,5,0,0,2817,2822,C
3-PA,822,0,2867,0,4,2871,T
3-PA,823,4,0,1,2944,2949,C
3-PA,824,2,0,0,2960,2962,C
3-PA,825,0,2949,0,3,2952,T
3-PA,826,0,2970,0,1,2971,T
3-PA,827,1,1,3083,0,3085,G
3-PA,828,1,3031,1,5,3038,T
3-PA,829,0,3039,0,3,3042,T
3-PA,830,3026,1,2,0,3029,A
3-PA,831,0,2913,0,1,2914,T
3-PA,832,4,1,0,2891,2896,C
3-PA,833,2832,0,1,0,2833,A
3-PA,834,0,2,2831,0,2833,G
3-PA,835,0,0,0,2822,2822,C
3-PA,836,1,2,2697,0,2700,G
3-PA,837,1,1,2805,0,2807,G
3-PA,838,1,2809,0,4,2814,T
3-PA,839,5,1,0,2807,2813,C
3-PA,840,11,1,1,2808,2821,C
3-PA,841,2836,1,1,0,2838,A
3-PA,842,2848,0,2,0,2850,A
3-PA,843,2842,1,1,0,2844,A
3-PA,844,0,2848,0,2,2850,T
3-PA,845,0,2825,0,2,2827,T
3-PA,846,9,1,0,2770,2780,C
3-PA,847,6,1,0,2716,2723,C
3-PA,848,0,2694,0,5,2699,T
3-PA,849,7,1,1,2730,2739,C
3-PA,850,5,1,0,2731,2737,C
3-PA,851,0,2709,0,3,2712,T
3-PA,852,3,0,2734,0,2737,G
3-PA,853,2721,0,1,0,2722,A
3-PA,854,0,2728,0,0,2728,T
3-PA,855,1,3,2692,0,2696,G
3-PA,856,4,3,2657,0,2664,G
3-PA,857,2639,1,4,0,2644,A
3-PA,858,0,2616,1,0,2617,T
3-PA,859,2,0,2616,0,2618,G
3-PA,860,0,0,0,2762,2762,C
3-PA,861,1,2720,1,2,2724,T
3-PA,862,0,2731,0,2,2733,T
3-PA,863,1,2746,0,2,2749,T
3-PA,864,2751,0,1,0,2752,A
3-PA,865,2752,0,1,0,2753,A
3-PA,866,2756,0,0,0,2756,A
3-PA,867,2763,0,2,1,2766,A
3-PA,868,0,2753,0,0,2753,T
3-PA,869,1,2408,0,0,2409,T
3-PA,870,1,7,2407,0,2415,G
3-PA,871,2383,1,9,0,2393,A
3-PA,872,0,1,2440,0,2441,G
3-PA,873,1,0,1,2437,2439,C
3-PA,874,2425,0,0,0,2425,A
3-PA,875,0,2474,0,4,2478,T
3-PA,876,1,2472,0,0,2473,T
3-PA,877,2,2,2464,0,2468,G
3-PA,878,2470,0,2,0,2472,A
3-PA,879,2453,0,12,0,2465,A
3-PA,880,0,5,2459,0,2464,G
3-PA,881,2404,0,3,0,2407,A
3-PA,882,1,0,0,2409,2410,C
3-PA,883,4,0,0,2393,2397,C
3-PA,884,6,0,0,2325,2331,C
3-PA,885,2294,0,1,0,2295,A
3-PA,886,2299,0,3,3,2305,A
3-PA,887,4,0,2312,0,2316,G
3-PA,888,0,2310,1,2,2313,T
3-PA,889,14,2,0,2287,2303,C
3-PA,890,2311,0,1,0,2312,A
3-PA,891,0,1,0,2298,2299,C
3-PA,892,2,1,2302,0,2305,G
3-PA,893,2327,0,2,0,2329,A
3-PA,894,2325,0,3,1,2329,A
3-PA,895,0,5,2416,0,2421,G
3-PA,896,1,3,2415,0,2419,G
3-PA,897,2380,2,6,0,2388,A
3-PA,898,1,4,2427,0,2432,G
3-PA,899,2414,1,11,0,2426,A
3-PA,900,2428,0,4,2,2434,A
3-PA,901,1,8,2412,0,2421,G
3-PA,902,0,5,2392,0,2397,G
3-PA,903,0,3,2398,0,2401,G
3-PA,904,2296,1,3,0,2300,A
3-PA,905,0,2306,0,3,2309,T
3-PA,906,2,4,0,2322,2328,C
3-PA,907,5,0,0,2481,2486,C
3-PA,908,9,0,0,2535,2544,C
3-PA,909,2569,0,2,0,2571,A
3-PA,910,0,2574,0,2,2576,T
3-PA,911,1,2577,0,2,2580,T
3-PA,912,2604,0,4,0,2608,A
3-PA,913,0,2603,0,1,2604,T
3-PA,914,2602,0,2,0,2604,A
3-PA,915,0,2597,0,2,2599,T
3-PA,916,0,4,2284,0,2288,G
3-PA,917,2281,1,4,0,2286,A
3-PA,918,0,2252,0,0,2252,T
3-PA,919,0,1,2267,0,2268,G
3-PA,920,3,1,0,2234,2238,C
3-PA,921,1,2,2220,0,2223,G
3-PA,922,2246,0,2,0,2248,A
3-PA,923,2,2228,0,4,2234,T
3-PA,924,5,1,0,2237,2243,C
3-PA,925,2245,0,0,0,2245,A
3-PA,926,2230,0,2,0,2232,A
3-PA,927,1,0,2242,0,2243,G
3-PA,928,0,2215,0,2,2217,T
3-PA,929,0,0,2226,1,2227,G
3-PA,930,1,2,0,2219,2222,C
3-PA,931,2219,0,5,0,2224,A
3-PA,932,0,2228,0,1,2229,T
3-PA,933,2227,0,1,0,2228,A
3-PA,934,2250,1,1,1,2253,A
3-PA,935,2249,0,0,0,2249,A
3-PA,936,2234,0,4,0,2238,A
3-PA,937,2234,0,1,1,2236,A
3-PA,938,0,0,0,2235,2235,C
3-PA,939,2209,0,1,0,2210,A
3-PA,940,0,2193,0,1,2194,T
3-PA,941,0,2194,0,0,2194,T
3-PA,942,2,0,0,2195,2197,C
3-PA,943,1,2171,0,1,2173,T
3-PA,944,0,2159,1,0,2160,T
3-PA,945,0,2168,0,0,2168,T
3-PA,946,0,4,2172,0,2176,G
3-PA,947,0,5,2167,1,2173,G
3-PA,948,2168,0,2,1,2171,A
3-PA,949,1,2172,0,0,2173,T
3-PA,950,1,3,2173,1,2178,G
3-PA,951,1,3,2213,0,2217,G
3-PA,952,2207,1,3,0,2211,A
3-PA,953,2216,0,3,1,2220,A
3-PA,954,2219,0,3,0,2222,A
3-PA,955,1,1,2243,0,2245,G
3-PA,956,2232,0,2,0,2234,A
3-PA,957,2468,1,2,0,2471,A
3-PA,958,0,3,1,2488,2492,C
3-PA,959,5,2,0,2489,2496,C
3-PA,960,0,2451,0,4,2455,T
3-PA,961,0,2495,1,1,2497,T
3-PA,962,2506,0,2,0,2508,A
3-PA,963,0,2502,0,0,2502,T
3-PA,964,2491,0,0,0,2491,A
3-PA,965,0,2503,0,1,2504,T
3-PA,966,2220,0,0,0,2220,A
3-PA,967,3,0,2228,0,2231,G
3-PA,968,0,2197,0,3,2200,T
3-PA,969,3,0,0,2194,2197,C
3-PA,970,2165,0,3,0,2168,A
3-PA,971,2173,1,1,0,2175,A
3-PA,972,2179,1,0,0,2180,A
3-PA,973,0,0,2,2175,2177,C
3-PA,974,2,0,0,2149,2151,C
3-PA,975,2098,0,5,0,2103,A
3-PA,976,0,0,0,2119,2119,C
3-PA,977,2127,1,1,0,2129,A
3-PA,978,0,1,0,2139,2140,C
3-PA,979,0,4,2138,0,2142,G
3-PA,980,2120,0,0,1,2121,A
3-PA,981,2127,0,0,0,2127,A
3-PA,982,2108,0,1,0,2109,A
3-PA,983,2112,0,4,0,2116,A
3-PA,984,2,6,2126,0,2134,G
3-PA,985,1,2,2106,0,2109,G
3-PA,986,0,8,2116,1,2125,G
3-PA,987,2103,0,6,0,2109,A
3-PA,988,2117,0,0,0,2117,A
3-PA,989,0,2114,0,0,2114,T
3-PA,990,2120,0,0,0,2120,A
3-PA,991,2116,0,1,0,2117,A
3-PA,992,2124,0,0,0,2124,A
3-PA,993,0,2112,0,0,2112,T
3-PA,994,0,2098,0,0,2098,T
3-PA,995,13,0,0,2098,2111,C
3-PA,996,2111,0,0,0,2111,A
3-PA,997,2120,0,2,0,2122,A
3-PA,998,2121,0,1,0,2122,A
3-PA,999,1,2112,0,1,2114,T
3-PA,1000,0,2121,0,1,2122,T
3-PA,1001,2130,0,1,0,2131,A
3-PA,1002,2,2,0,2129,2133,C
3-PA,1003,1,0,0,2131,2132,C
3-PA,1004,1,2044,0,2,2047,T
3-PA,1005,1,1,2076,1,2079,G
3-PA,1006,0,1,0,2071,2072,C
3-PA,1007,0,2061,0,6,2067,T
3-PA,1008,0,0,2110,0,2110,G
3-PA,1009,0,2089,0,2,2091,T
3-PA,1010,9,0,0,2094,2103,C
3-PA,1011,2099,0,2,0,2101,A
3-PA,1012,0,2098,0,2,2100,T
3-PA,1013,1,2,2096,0,2099,G
3-PA,1014,1,3,2087,0,2091,G
3-PA,1015,2092,0,1,0,2093,A
3-PA,1016,2148,0,3,0,2151,A
3-PA,1017,0,0,2131,0,2131,G
3-PA,1018,0,1,0,2122,2123,C
3-PA,1019,2102,1,1,0,2104,A
3-PA,1020,2117,1,4,0,2122,A
3-PA,1021,0,1,2139,0,2140,G
3-PA,1022,1,2140,0,1,2142,T
3-PA,1023,2132,0,0,0,2132,A
3-PA,1024,1,1,0,2130,2132,C
3-PA,1025,0,2075,1,2,2078,T
3-PA,1026,2,0,2101,0,2103,G
3-PA,1027,1,2076,0,3,2080,T
3-PA,1028,12,0,0,2079,2091,C
3-PA,1029,2075,1,3,0,2079,A
3-PA,1030,0,4,2101,0,2105,G
3-PA,1031,2096,1,1,0,2098,A
3-PA,1032,2106,0,0,1,2107,A
3-PA,1033,0,2157,0,1,2158,T
3-PA,1034,0,2123,0,0,2123,T
3-PA,1035,0,1,2113,0,2114,G
3-PA,1036,0,1,0,2109,2110,C
3-PA,1037,2100,0,2,0,2102,A
3-PA,1038,0,3,2116,0,2119,G
3-PA,1039,0,7,2091,0,2098,G
3-PA,1040,2109,1,2,0,2112,A
3-PA,1041,0,1,0,2141,2142,C
3-PA,1042,2074,0,2,0,2076,A
3-PA,1043,0,2100,0,0,2100,T
3-PA,1044,0,2101,1,3,2105,T
3-PA,1045,1,3,2115,0,2119,G
3-PA,1046,2127,0,1,0,2128,A
3-PA,1047,2119,0,2,1,2122,A
3-PA,1048,2110,0,3,0,2113,A
3-PA,1049,2113,0,2,1,2116,A
3-PA,1050,0,2083,0,0,2083,T
3-PA,1051,0,2,2122,0,2124,G
3-PA,1052,2080,1,2,0,2083,A
3-PA,1053,2,2,2102,0,2106,G
3-PA,1054,1,6,2106,0,2113,G
3-PA,1055,2080,1,1,0,2082,A
3-PA,1056,4,1,2106,0,2111,G
3-PA,1057,2103,0,1,0,2104,A
3-PA,1058,2097,0,1,1,2099,A
3-PA,1059,0,1,2116,0,2117,G
3-PA,1060,2089,0,1,0,2090,A
3-PA,1061,0,2091,0,1,2092,T
3-PA,1062,0,2069,0,2,2071,T
3-PA,1063,4,1,0,2079,2084,C
3-PA,1064,1,0,0,2090,2091,C
3-PA,1065,2087,0,0,0,2087,A
3-PA,1066,2076,0,0,0,2076,A
3-PA,1067,0,5,2069,0,2074,G
3-PA,1068,2008,0,1,0,2009,A
3-PA,1069,2082,0,1,0,2083,A
3-PA,1070,1,1,1,2107,2110,C
3-PA,1071,0,2106,0,0,2106,T
3-PA,1072,2113,0,0,0,2113,A
3-PA,1073,2108,0,2,2,2112,A
3-PA,1074,2109,0,2,0,2111,A
3-PA,1075,2111,0,2,0,2113,A
3-PA,1076,2093,1,2,1,2097,A
3-PA,1077,1,0,0,2103,2104,C
3-PA,1078,2082,0,4,0,2086,A
3-PA,1079,0,2070,0,1,2071,T
3-PA,1080,2,4,2096,1,2103,G
3-PA,1081,2101,0,3,0,2104,A
3-PA,1082,2106,0,5,1,2112,A
3-PA,1083,0,3,2137,0,2140,G
3-PA,1084,2133,0,0,0,2133,A
3-PA,1085,2127,0,4,0,2131,A
3-PA,1086,2108,0,0,0,2108,A
3-PA,1087,2099,0,3,0,2102,A
3-PA,1088,0,2,0,2117,2119,C
3-PA,1089,0,8,2101,0,2109,G
3-PA,1090,2100,2,3,0,2105,A
3-PA,1091,3,0,2120,0,2123,G
3-PA,1092,1,2089,0,3,2093,T
3-PA,1093,13,1,0,2144,2158,C
3-PA,1094,2154,1,3,0,2158,A
3-PA,1095,2197,0,6,0,2203,A
3-PA,1096,1,1,0,2201,2203,C
3-PA,1097,0,2195,0,1,2196,T
3-PA,1098,2,1,2241,0,2244,G
3-PA,1099,2221,0,3,0,2224,A
3-PA,1100,2231,0,1,0,2232,A
3-PA,1101,1,1,2228,0,2230,G
3-PA,1102,0,2160,0,2,2162,T
3-PA,1103,2,11,2140,0,2153,G
3-PA,1104,0,0,2142,0,2142,G
3-PA,1105,2,1,2145,0,2148,G
3-PA,1106,0,0,0,2160,2160,C
3-PA,1107,0,2120,0,2,2122,T
3-PA,1108,3,0,0,2142,2145,C
3-PA,1109,0,2138,0,2,2140,T
3-PA,1110,0,2149,0,3,2152,T
3-PA,1111,1,2,2282,0,2285,G
3-PA,1112,1,0,2335,0,2336,G
3-PA,1113,1,2313,0,1,2315,T
3-PA,1114,0,3,2316,0,2319,G
3-PA,1115,2300,0,0,0,2300,A
3-PA,1116,2359,0,2,0,2361,A
3-PA,1117,2354,0,3,0,2357,A
3-PA,1118,2403,0,1,0,2404,A
3-PA,1119,0,2,0,2435,2437,C
3-PA,1120,2391,0,1,1,2393,A
3-PA,1121,0,2403,0,2,2405,T
3-PA,1122,2,10,2385,0,2397,G
3-PA,1123,1,0,2489,0,2490,G
3-PA,1124,2,3,0,2507,2512,C
3-PA,1125,2528,0,4,4,2536,A
3-PA,1126,2,1,0,2545,2548,C
3-PA,1127,2,1,0,2549,2552,C
3-PA,1128,2630,0,4,0,2634,A
3-PA,1129,1,6,2693,0,2700,G
3-PA,1130,2679,0,0,0,2679,A
3-PA,1131,1,1,2760,0,2762,G
3-PA,1132,2793,1,1,0,2795,A
3-PA,1133,2809,0,4,0,2813,A
3-PA,1134,0,5,2842,0,2847,G
3-PA,1135,2,0,2826,0,2828,G
3-PA,1136,0,2822,0,7,2829,T
3-PA,1137,2802,0,2,0,2804,A
3-PA,1138,0,10,2791,0,2801,G
3-PA,1139,2807,1,4,1,2813,A
3-PA,1140,0,0,0,2869,2869,C
3-PA,1141,1,2842,2,2,2847,T
3-PA,1142,1,2838,0,1,2840,T
3-PA,1143,0,2834,0,4,2838,T
3-PA,1144,1,4,2839,0,2844,G
3-PA,1145,2833,0,8,2,2843,A
3-PA,1146,2836,0,2,0,2838,A
3-PA,1147,2838,0,4,0,2842,A
3-PA,1148,2840,1,1,1,2843,A
3-PA,1149,1,1,0,2967,2969,C
3-PA,1150,0,2944,0,1,2945,T
3-PA,1151,1,0,3017,1,3019,G
3-PA,1152,0,0,1,3014,3015,C
3-PA,1153,3010,0,5,0,3015,A
3-PA,1154,1,1,3018,1,3021,G
3-PA,1155,2987,2,4,0,2993,A
3-PA,1156,1,5,3208,0,3214,G
3-PA,1157,3210,0,1,0,3211,A
3-PA,1158,0,2,1,3223,3226,C
3-PA,1159,3193,1,5,0,3199,A
3-PA,1160,1,3186,0,2,3189,T
3-PA,1161,3174,0,2,1,3177,A
3-PA,1162,3173,0,9,0,3182,A
3-PA,1163,0,0,3185,0,3185,G
3-PA,1164,1,1,0,3179,3181,C
3-PA,1165,1,15,3116,0,3132,G
3-PA,1166,3263,1,0,0,3264,A
3-PA,1167,0,3228,0,2,3230,T
3-PA,1168,0,3246,0,0,3246,T
3-PA,1169,0,3251,0,1,3252,T
3-PA,1170,2,2,3261,0,3265,G
3-PA,1171,3283,0,3,0,3286,A
3-PA,1172,3284,0,9,1,3294,A
3-PA,1173,2,2,3305,0,3309,G
3-PA,1174,1,2,0,3450,3453,C
3-PA,1175,3401,0,4,0,3405,A
3-PA,1176,3762,0,4,0,3766,A
3-PA,1177,0,3764,1,1,3766,T
3-PA,1178,3787,0,3,0,3790,A
3-PA,1179,1,3810,0,4,3815,T
3-PA,1180,2,8,3819,0,3829,G
3-PA,1181,3878,0,5,1,3884,A
3-PA,1182,0,3867,0,3,3870,T
3-PA,1183,3769,0,4,0,3773,A
3-PA,1184,2,2,3776,0,3780,G
3-PA,1185,0,3637,0,3,3640,T
3-PA,1186,0,11,3617,0,3628,G
3-PA,1187,3636,0,8,0,3644,A
3-PA,1188,0,3,0,3618,3621,C
3-PA,1189,2,6,3604,0,3612,G
3-PA,1190,3639,0,4,0,3643,A
3-PA,1191,3658,0,4,0,3662,A
3-PA,1192,1,2,0,3732,3735,C
3-PA,1193,6,3,0,3726,3735,C
3-PA,1194,0,3694,0,5,3699,T
3-PA,1195,0,9,3886,0,3895,G
3-PA,1196,3850,3,5,0,3858,A
3-PA,1197,3901,1,4,0,3906,A
3-PA,1198,0,3886,0,3,3889,T
3-PA,1199,0,3851,0,1,3852,T
3-PA,1200,3862,0,2,1,3865,A
3-PA,1201,3818,0,4,0,3822,A
3-PA,1202,1,6,3847,0,3854,G
3-PA,1203,4,4,3837,0,3845,G
3-PA,1204,0,3748,0,7,3755,T
3-PA,1205,12,1,0,3740,3753,C
3-PA,1206,3763,0,2,0,3765,A
3-PA,1207,0,0,0,4011,4011,C
3-PA,1208,0,4007,0,3,4010,T
3-PA,1209,0,4027,0,0,4027,T
3-PA,1210,0,4017,0,5,4022,T
3-PA,1211,8,1,0,4004,4013,C
3-PA,1212,4017,0,1,0,4018,A
3-PA,1213,4008,0,5,1,4014,A
3-PA,1214,1,1,4093,0,4095,G
3-PA,1215,1,0,0,4096,4097,C
3-PA,1216,0,4012,0,1,4013,T
3-PA,1217,6,4,4136,0,4146,G
3-PA,1218,2,3,4162,0,4167,G
3-PA,1219,4240,1,3,0,4244,A
3-PA,1220,0,4321,0,1,4322,T
3-PA,1221,4322,2,3,0,4327,A
3-PA,1222,2,0,0,4365,4367,C
3-PA,1223,4295,0,3,0,4298,A
3-PA,1224,0,12,4361,0,4373,G
3-PA,1225,4316,0,4,0,4320,A
3-PA,1226,4263,1,2,0,4266,A
3-PA,1227,0,4234,2,0,4236,T
3-PA,1228,1,14,4350,0,4365,G
3-PA,1229,4314,0,7,0,4321,A
3-PA,1230,0,0,4424,0,4424,G
3-PA,1231,0,4382,0,4,4386,T
3-PA,1232,0,4367,1,3,4371,T
3-PA,1233,17,1,1,4449,4468,C
3-PA,1234,4500,0,8,0,4508,A
3-PA,1235,4513,1,4,0,4518,A
3-PA,1236,0,1,0,4506,4507,C
3-PA,1237,4452,0,1,0,4453,A
3-PA,1238,4456,0,5,1,4462,A
3-PA,1239,3,3,4441,0,4447,G
3-PA,1240,3,3,4472,1,4479,G
3-PA,1241,1,1,0,4526,4528,C
3-PA,1242,3,0,0,4512,4515,C
3-PA,1243,1,4471,0,10,4482,T
3-PA,1244,0,0,4525,0,4525,G
3-PA,1245,2,4514,0,4,4520,T
3-PA,1246,1,9,4542,0,4552,G
3-PA,1247,4542,1,7,1,4551,A
3-PA,1248,1,1,4547,0,4549,G
3-PA,1249,1,1,0,4536,4538,C
3-PA,1250,0,4495,0,4,4499,T
3-PA,1251,4630,0,3,1,4634,A
3-PA,1252,4645,0,6,0,4651,A
3-PA,1253,0,1,0,4670,4671,C
3-PA,1254,1,4627,0,7,4635,T
3-PA,1255,2,18,4623,1,4644,G
3-PA,1256,4624,0,5,0,4629,A
3-PA,1257,1,4631,0,5,4637,T
3-PA,1258,0,4622,0,1,4623,T
3-PA,1259,11,2,1,4648,4662,C
3-PA,1260,4776,0,5,0,4781,A
3-PA,1261,1,0,4932,0,4933,G
3-PA,1262,0,4895,0,6,4901,T
3-PA,1263,8,2,0,4900,4910,C
3-PA,1264,0,4869,0,6,4875,T
3-PA,1265,2,10,5133,0,5145,G
3-PA,1266,1,6,5132,1,5140,G
3-PA,1267,5152,1,3,0,5156,A
3-PA,1268,1,5147,0,2,5150,T
3-PA,1269,4917,1,2,0,4920,A
3-PA,1270,1,9,4886,0,4896,G
3-PA,1271,4825,1,12,0,4838,A
3-PA,1272,0,1,4914,0,4915,G
3-PA,1273,1,2,1,4879,4883,C
3-PA,1274,0,4746,0,3,4749,T
3-PA,1275,13,3,0,4790,4806,C
3-PA,1276,1,8,4817,0,4826,G
3-PA,1277,4816,0,5,1,4822,A
3-PA,1278,1,4833,0,2,4836,T
3-PA,1279,1,9,4823,0,4833,G
3-PA,1280,4928,0,3,0,4931,A
3-PA,1281,4922,0,3,0,4925,A
3-PA,1282,4961,0,5,0,4966,A
3-PA,1283,0,4961,1,2,4964,T
3-PA,1284,2,4912,0,6,4920,T
3-PA,1285,3,10,4991,0,5004,G
3-PA,1286,4,13,4994,0,5011,G
3-PA,1287,4963,0,11,0,4974,A
3-PA,1288,0,7,4999,0,5006,G
3-PA,1289,4911,1,3,0,4915,A
3-PA,1290,1,10,4982,0,4993,G
3-PA,1291,3,10,5022,0,5035,G
3-PA,1292,5094,1,6,0,5101,A
3-PA,1293,0,3,0,5112,5115,C
3-PA,1294,4,2,5073,0,5079,G
3-PA,1295,0,5088,0,2,5090,T
3-PA,1296,5122,0,4,0,5126,A
3-PA,1297,1,0,5174,0,5175,G
3-PA,1298,1,2,0,5242,5245,C
3-PA,1299,6,1,0,5170,5177,C
3-PA,1300,6,7,0,5132,5145,C
3-PA,1301,8,0,0,5130,5138,C
3-PA,1302,5164,0,0,0,5164,A
3-PA,1303,5430,0,2,0,5432,A
3-PA,1304,0,5427,0,2,5429,T
3-PA,1305,0,5394,0,1,5395,T
3-PA,1306,0,25,5371,0,5396,G
3-PA,1307,5273,1,4,1,5279,A
3-PA,1308,5,1,5299,1,5306,G
3-PA,1309,2,3,0,5286,5291,C
3-PA,1310,5273,0,4,1,5278,A
3-PA,1311,0,3,0,5422,5425,C
3-PA,1312,5288,0,1,0,5289,A
3-PA,1313,0,5479,0,6,5485,T
3-PA,1314,0,5470,0,4,5474,T
3-PA,1315,1,3,5491,0,5495,G
3-PA,1316,0,3,0,5495,5498,C
3-PA,1317,5487,0,10,0,5497,A
3-PA,1318,5485,1,10,0,5496,A
3-PA,1319,1,1,5496,0,5498,G
3-PA,1320,2,1,0,5466,5469,C
3-PA,1321,5478,0,2,1,5481,A
3-PA,1322,0,5320,0,3,5323,T
3-PA,1323,0,21,5325,0,5346,G
3-PA,1324,5294,0,11,0,5305,A
3-PA,1325,3,2,5356,0,5361,G
3-PA,1326,5346,1,10,0,5357,A
3-PA,1327,5377,0,3,0,5380,A
3-PA,1328,0,11,5341,0,5352,G
3-PA,1329,0,5,5367,1,5373,G
3-PA,1330,5373,0,8,0,5381,A
3-PA,1331,5380,0,4,0,5384,A
3-PA,1332,1,5387,0,2,5390,T
3-PA,1333,0,5398,0,6,5404,T
3-PA,1334,5464,0,1,0,5465,A
3-PA,1335,1,5502,0,4,5507,T
3-PA,1336,0,5471,1,3,5475,T
3-PA,1337,0,5491,0,6,5497,T
3-PA,1338,9,0,0,5436,5445,C
3-PA,1339,5435,1,4,0,5440,A
3-PA,1340,0,0,0,5604,5604,C
3-PA,1341,5570,0,5,0,5575,A
3-PA,1342,1,1,5668,1,5671,G
3-PA,1343,2,1,0,5655,5658,C
3-PA,1344,5639,1,4,1,5645,A
3-PA,1345,0,3,5690,0,5693,G
3-PA,1346,5620,1,12,1,5634,A
3-PA,1347,3,4,5680,0,5687,G
3-PA,1348,0,0,5716,0,5716,G
3-PA,1349,1,5555,0,5,5561,T
3-PA,1350,1,0,5650,0,5651,G
3-PA,1351,1,5593,0,7,5601,T
3-PA,1352,7,4,0,5598,5609,C
3-PA,1353,13,4,0,5665,5682,C
3-PA,1354,14,0,1,5653,5668,C
3-PA,1355,5742,0,5,0,5747,A
3-PA,1356,0,5815,0,8,5823,T
3-PA,1357,1,5778,0,6,5785,T
3-PA,1358,0,3,5819,0,5822,G
3-PA,1359,1,5742,0,3,5746,T
3-PA,1360,5673,0,6,1,5680,A
3-PA,1361,2,2,5663,0,5667,G
3-PA,1362,5477,1,10,0,5488,A
3-PA,1363,3,1,5563,0,5567,G
3-PA,1364,4,1,0,5485,5490,C
3-PA,1365,13,0,0,5389,5402,C
3-PA,1366,5514,0,5,0,5519,A
3-PA,1367,0,2,0,5516,5518,C
3-PA,1368,1,5469,0,2,5472,T
3-PA,1369,0,12,5467,0,5479,G
3-PA,1370,5443,0,4,0,5447,A
3-PA,1371,5341,0,7,0,5348,A
3-PA,1372,0,5543,0,1,5544,T
3-PA,1373,5601,0,3,0,5604,A
3-PA,1374,1,8,0,5679,5688,C
3-PA,1375,5552,1,3,0,5556,A
3-PA,1376,0,5597,0,3,5600,T
3-PA,1377,5559,1,1,1,5562,A
3-PA,1378,5573,0,5,2,5580,A
3-PA,1379,0,5568,1,4,5573,T
3-PA,1380,1,12,5496,0,5509,G
3-PA,1381,5465,1,2,0,5468,A
3-PA,1382,5389,0,7,0,5396,A
3-PA,1383,3,10,5408,0,5421,G
3-PA,1384,1,14,5397,0,5412,G
3-PA,1385,0,11,5521,0,5532,G
3-PA,1386,2,6,5531,0,5539,G
3-PA,1387,1,2,5614,0,5617,G
3-PA,1388,1,5515,0,4,5520,T
3-PA,1389,5567,0,1,1,5569,A
3-PA,1390,1,5588,0,8,5597,T
3-PA,1391,5740,1,3,0,5744,A
3-PA,1392,2,2,0,6362,6366,C
3-PA,1393,6150,1,1,0,6152,A
3-PA,1394,0,6003,0,2,6005,T
3-PA,1395,0,5954,0,2,5956,T
3-PA,1396,5910,4,4,0,5918,A
3-PA,1397,6031,0,10,0,6041,A
3-PA,1398,0,2,0,6043,6045,C
3-PA,1399,5948,1,1,0,5950,A
3-PA,1400,1,2,0,5952,5955,C
3-PA,1401,1,5254,2,2,5259,T
3-PA,1402,3,1,5479,0,5483,G
3-PA,1403,1,0,0,5475,5476,C
3-PA,1404,5,1,0,5450,5456,C
3-PA,1405,15,1,0,5489,5505,C
3-PA,1406,0,5342,0,5,5347,T
3-PA,1407,1,1,5587,0,5589,G
3-PA,1408,0,2,0,5596,5598,C
3-PA,1409,0,5538,0,4,5542,T
3-PA,1410,20,1,1,5715,5737,C
3-PA,1411,5551,1,1,1,5554,A
3-PA,1412,5624,1,8,0,5633,A
3-PA,1413,0,5643,0,2,5645,T
3-PA,1414,2,0,5627,0,5629,G
3-PA,1415,1,0,0,5624,5625,C
3-PA,1416,5512,0,4,0,5516,A
3-PA,1417,1,5479,0,7,5487,T
3-PA,1418,5,4,0,5468,5477,C
3-PA,1419,5,1,0,5539,5545,C
3-PA,1420,1,5287,0,2,5290,T
3-PA,1421,2,1,5466,1,5470,G
3-PA,1422,0,5417,0,9,5426,T
3-PA,1423,3,0,5397,0,5400,G
3-PA,1424,2,1,1,5410,5414,C
3-PA,1425,5333,0,16,0,5349,A
3-PA,1426,1,1,5392,0,5394,G
3-PA,1427,1,1,0,5372,5374,C
3-PA,1428,5278,0,0,0,5278,A
3-PA,1429,5291,0,2,0,5293,A
3-PA,1430,2,5107,0,0,5109,T
3-PA,1431,1,11,5111,0,5123,G
3-PA,1432,2,8,5095,1,5106,G
3-PA,1433,5122,0,5,0,5127,A
3-PA,1434,1,4,0,5109,5114,C
3-PA,1435,4,8,5040,0,5052,G
3-PA,1436,5132,0,1,0,5133,A
3-PA,1437,1,5115,2,3,5121,T
3-PA,1438,1,5107,0,4,5112,T
3-PA,1439,1,5078,0,6,5085,T
3-PA,1440,0,5080,0,7,5087,T
3-PA,1441,7,2,0,5085,5094,C
3-PA,1442,5088,1,6,0,5095,A
3-PA,1443,5124,0,2,0,5126,A
3-PA,1444,1,1,0,5120,5122,C
3-PA,1445,0,4989,1,1,4991,T
3-PA,1446,4977,0,4,1,4982,A
3-PA,1447,4977,1,1,1,4980,A
3-PA,1448,0,4981,1,1,4983,T
3-PA,1449,0,4988,0,2,4990,T
3-PA,1450,13,3,1,4989,5006,C
3-PA,1451,3,1,1,4984,4989,C
3-PA,1452,5,4,0,4966,4975,C
3-PA,1453,4967,1,4,0,4972,A
3-PA,1454,0,5075,1,5,5081,T
3-PA,1455,1,3,5092,0,5096,G
3-PA,1456,5077,1,5,0,5083,A
3-PA,1457,1,5069,0,5,5075,T
3-PA,1458,5053,0,5,0,5058,A
3-PA,1459,5048,1,14,1,5064,A
3-PA,1460,1,2,5071,0,5074,G
3-PA,1461,0,2,0,5061,5063,C
3-PA,1462,5025,1,3,0,5029,A
3-PA,1463,4872,0,6,1,4879,A
3-PA,1464,1,0,4980,0,4981,G
3-PA,1465,1,4942,0,4,4947,T
3-PA,1466,4,2,4921,0,4927,G
3-PA,1467,0,2,0,4914,4916,C
3-PA,1468,4902,0,8,2,4912,A
3-PA,1469,2,10,5042,1,5055,G
3-PA,1470,5020,0,5,0,5025,A
3-PA,1471,5123,0,7,0,5130,A
3-PA,1472,1,3,1,5125,5130,C
3-PA,1473,1,4956,0,5,4962,T
3-PA,1474,5004,1,1,0,5006,A
3-PA,1475,4973,0,4,1,4978,A
3-PA,1476,4965,0,13,1,4979,A
3-PA,1477,1,6,4999,1,5007,G
3-PA,1478,4701,1,8,0,4710,A
3-PA,1479,2,5,4716,0,4723,G
3-PA,1480,1,7,4576,1,4585,G
3-PA,1481,0,4,4576,0,4580,G
3-PA,1482,4524,1,9,1,4535,A
3-PA,1483,4434,0,8,0,4442,A
3-PA,1484,0,5,4439,0,4444,G
3-PA,1485,3,2,4420,1,4426,G
3-PA,1486,0,0,0,4430,4430,C
3-PA,1487,3,12,4422,0,4437,G
3-PA,1488,4408,0,4,0,4412,A
3-PA,1489,4418,1,1,0,4420,A
3-PA,1490,4410,2,4,1,4417,A
3-PA,1491,4419,0,5,1,4425,A
3-PA,1492,4446,1,3,0,4450,A
3-PA,1493,1,0,1,4434,4436,C
3-PA,1494,10,0,0,4406,4416,C
3-PA,1495,4424,0,2,1,4427,A
3-PA,1496,4487,0,3,0,4490,A
3-PA,1497,0,4474,1,1,4476,T
3-PA,1498,1,4472,3,2,4478,T
3-PA,1499,1,4508,0,1,4510,T
3-PA,1500,4530,0,3,0,4533,A
3-PA,1501,0,4532,0,2,4534,T
3-PA,1502,4522,0,3,0,4525,A
3-PA,1503,0,4500,1,3,4504,T
3-PA,1504,2,1,4457,0,4460,G
3-PA,1505,3,8,4385,0,4396,G
3-PA,1506,4362,0,1,2,4365,A
3-PA,1507,0,4345,0,7,4352,T
3-PA,1508,0,4282,2,2,4286,T
3-PA,1509,15,0,1,4288,4304,C
3-PA,1510,4329,0,4,0,4333,A
3-PA,1511,0,4371,0,5,4376,T
3-PA,1512,6,1,0,4388,4395,C
3-PA,1513,4390,0,6,0,4396,A
3-PA,1514,2,4343,0,3,4348,T
3-PA,1515,4315,0,1,1,4317,A
3-PA,1516,4315,0,0,0,4315,A
3-PA,1517,4314,0,7,0,4321,A
3-PA,1518,0,16,4324,0,4340,G
3-PA,1519,0,4,4242,0,4246,G
3-PA,1520,1,9,4200,0,4210,G
3-PA,1521,4167,0,2,0,4169,A
3-PA,1522,4134,0,6,0,4140,A
3-PA,1523,10,8,4163,0,4181,G
3-PA,1524,4135,1,6,0,4142,A
3-PA,1525,0,4125,0,10,4135,T
3-PA,1526,1,2,0,4143,4146,C
3-PA,1527,2,4015,0,9,4026,T
3-PA,1528,12,0,0,4200,4212,C
3-PA,1529,4192,0,3,0,4195,A
3-PA,1530,0,4187,1,0,4188,T
3-PA,1531,2,4183,1,4,4190,T
3-PA,1532,0,4139,0,0,4139,T
3-PA,1533,4115,0,1,0,4116,A
3-PA,1534,4125,1,11,0,4137,A
3-PA,1535,0,7,4126,0,4133,G
3-PA,1536,1,8,4206,0,4215,G
3-PA,1537,3937,0,4,0,3941,A
3-PA,1538,3954,1,5,0,3960,A
3-PA,1539,0,3964,2,1,3967,T
3-PA,1540,0,14,4000,0,4014,G
3-PA,1541,4132,0,9,0,4141,A
3-PA,1542,2,0,0,4136,4138,C
3-PA,1543,4098,2,9,1,4110,A
3-PA,1544,1,1,0,4118,4120,C
3-PA,1545,4006,2,4,1,4013,A
3-PA,1546,2,6,4041,0,4049,G
3-PA,1547,4034,0,6,0,4040,A
3-PA,1548,1,0,0,3998,3999,C
3-PA,1549,3,1,3955,0,3959,G
3-PA,1550,0,3698,0,5,3703,T
3-PA,1551,1,5,3708,0,3714,G
3-PA,1552,2,0,3729,0,3731,G
3-PA,1553,1,3747,0,2,3750,T
3-PA,1554,3738,0,2,0,3740,A
3-PA,1555,3668,0,3,0,3671,A
3-PA,1556,3689,1,0,0,3690,A
3-PA,1557,0,3687,0,1,3688,T
3-PA,1558,0,3602,0,2,3604,T
3-PA,1559,1,3608,0,1,3610,T
3-PA,1560,2,3559,0,2,3563,T
3-PA,1561,0,1,3561,1,3563,G
3-PA,1562,0,3514,0,2,3516,T
3-PA,1563,0,8,3507,0,3515,G
3-PA,1564,3493,1,3,1,3498,A
3-PA,1565,1,1,3521,0,3523,G
3-PA,1566,4,0,0,3473,3477,C
3-PA,1567,3497,0,4,0,3501,A
3-PA,1568,1,3490,0,4,3495,T
3-PA,1569,0,3,3502,0,3505,G
3-PA,1570,2,5,3520,0,3527,G
3-PA,1571,3530,0,2,0,3532,A
3-PA,1572,0,1,3552,0,3553,G
3-PA,1573,0,3487,1,3,3491,T
3-PA,1574,0,3425,0,4,3429,T
3-PA,1575,0,3460,1,6,3467,T
3-PA,1576,0,3458,0,11,3469,T
3-PA,1577,3,1,1,3474,3479,C
3-PA,1578,1,3439,0,11,3451,T
3-PA,1579,6,0,1,3462,3469,C
3-PA,1580,0,3370,0,2,3372,T
3-PA,1581,10,0,0,3363,3373,C
3-PA,1582,3380,0,2,0,3382,A
3-PA,1583,0,0,0,3380,3380,C
3-PA,1584,0,3296,0,2,3298,T
3-PA,1585,2,13,3295,0,3310,G
3-PA,1586,3315,0,2,0,3317,A
3-PA,1587,3,2,0,3347,3352,C
3-PA,1588,2,2,0,3317,3321,C
3-PA,1589,16,6,0,3277,3299,C
3-PA,1590,2,7,3274,0,3283,G
3-PA,1591,3258,1,4,0,3263,A
3-PA,1592,0,5,3292,0,3297,G
3-PA,1593,3283,0,6,0,3289,A
3-PA,1594,0,0,0,3239,3239,C
3-PA,1595,1,3203,0,4,3208,T
3-PA,1596,0,3082,0,1,3083,T
3-PA,1597,2,8,3064,0,3074,G
3-PA,1598,3046,1,10,0,3057,A
3-PA,1599,0,0,3097,0,3097,G
3-PA,1600,2,0,0,3078,3080,C
3-PA,1601,7,0,0,2996,3003,C
3-PA,1602,3058,0,4,0,3062,A
3-PA,1603,2,2,0,3059,3063,C
3-PA,1604,3071,0,4,0,3075,A
3-PA,1605,0,3064,0,2,3066,T
3-PA,1606,3055,0,2,0,3057,A
3-PA,1607,3031,0,1,0,3032,A
3-PA,1608,3040,2,2,0,3044,A
3-PA,1609,0,3026,1,1,3028,T
3-PA,1610,1,4,3021,0,3026,G
3-PA,1611,2,1,2858,0,2861,G
3-PA,1612,3,5,2879,0,2887,G
3-PA,1613,2821,1,5,1,2828,A
3-PA,1614,1,5,2884,0,2890,G
3-PA,1615,2857,0,4,0,2861,A
3-PA,1616,2834,2,0,0,2836,A
3-PA,1617,2858,0,4,1,2863,A
3-PA,1618,0,2865,0,0,2865,T
3-PA,1619,2867,0,1,0,2868,A
3-PA,1620,5,1,1,2863,2870,C
3-PA,1621,0,2248,0,3,2251,T
3-PA,1622,0,1,2253,0,2254,G
3-PA,1623,0,1999,0,1,2000,T
3-PA,1624,2,0,2094,0,2096,G
3-PA,1625,0,2070,0,1,2071,T
3-PA,1626,8,0,0,1944,1952,C
3-PA,1627,2,0,0,1949,1951,C
3-PA,1628,0,1930,0,4,1934,T
3-PA,1629,0,1934,1,2,1937,T
3-PA,1630,2,9,1935,0,1946,G
3-PA,1631,1933,2,3,0,1938,A
3-PA,1632,0,1,1987,0,1988,G
3-PA,1633,1862,0,3,0,1865,A
3-PA,1634,1,1864,0,1,1866,T
3-PA,1635,1840,0,1,1,1842,A
3-PA,1636,1,0,1899,0,1900,G
3-PA,1637,1,5,1910,0,1916,G
3-PA,1638,1898,0,2,0,1900,A
3-PA,1639,0,1,1905,0,1906,G
3-PA,1640,1893,0,3,0,1896,A
3-PA,1641,0,1891,0,1,1892,T
3-PA,1642,1904,0,0,0,1904,A
3-PA,1643,1,1908,0,0,1909,T
3-PA,1644,1,0,1944,0,1945,G
3-PA,1645,0,1916,0,2,1918,T
3-PA,1646,0,1907,0,1,1908,T
3-PA,1647,1949,1,1,0,1951,A
3-PA,1648,1,0,0,1944,1945,C
3-PA,1649,0,1933,0,1,1934,T
3-PA,1650,1946,0,0,0,1946,A
3-PA,1651,1914,0,4,0,1918,A
3-PA,1652,0,1,1944,0,1945,G
3-PA,1653,1911,0,0,0,1911,A
3-PA,1654,1874,0,3,0,1877,A
3-PA,1655,0,0,1843,0,1843,G
3-PA,1656,0,1863,0,2,1865,T
3-PA,1657,0,1,1892,0,1893,G
3-PA,1658,1,1,0,1885,1887,C
3-PA,1659,2,0,0,1891,1893,C
3-PA,1660,1901,0,0,0,1901,A
3-PA,1661,0,1889,0,0,1889,T
3-PA,1662,1885,0,1,0,1886,A
3-PA,1663,0,0,1903,0,1903,G
3-PA,1664,0,0,1895,0,1895,G
3-PA,1665,0,0,0,1880,1880,C
3-PA,1666,1,0,0,1874,1875,C
3-PA,1667,1872,0,1,0,1873,A
3-PA,1668,1874,0,0,0,1874,A
3-PA,1669,1870,0,1,0,1871,A
3-PA,1670,0,1899,1,0,1900,T
3-PA,1671,0,1898,0,0,1898,T
3-PA,1672,0,1879,0,1,1880,T
3-PA,1673,5,1,0,1881,1887,C
3-PA,1674,1853,0,3,0,1856,A
3-PA,1675,1876,0,6,0,1882,A
3-PA,1676,1,1,1886,0,1888,G
3-PA,1677,0,0,1889,0,1889,G
3-PA,1678,0,0,0,1890,1890,C
3-PA,1679,1,0,0,1866,1867,C
3-PA,1680,2,1,1862,0,1865,G
3-PA,1681,1992,0,0,0,1992,A
3-PA,1682,0,2001,0,1,2002,T
3-PA,1683,0,2,1993,0,1995,G
3-PA,1684,0,1998,0,0,1998,T
3-PA,1685,1957,0,2,0,1959,A
3-PA,1686,0,0,0,2126,2126,C
3-PA,1687,0,2130,1,1,2132,T
3-PA,1688,0,2145,0,1,2146,T
3-PA,1689,1,0,2168,1,2170,G
3-PA,1690,0,2079,0,0,2079,T
3-PA,1691,2079,0,1,0,2080,A
3-PA,1692,0,2018,0,2,2020,T
3-PA,1693,0,0,2021,0,2021,G
3-PA,1694,0,1940,0,1,1941,T
3-PA,1695,2,7,1915,0,1924,G
3-PA,1696,1892,1,4,0,1897,A
3-PA,1697,0,2,1909,0,1911,G
3-PA,1698,1,5,1891,0,1897,G
3-PA,1699,1905,0,0,0,1905,A
3-PA,1700,0,0,0,1909,1909,C
3-PA,1701,1895,0,3,0,1898,A
3-PA,1702,1884,0,3,1,1888,A
3-PA,1703,1904,0,1,0,1905,A
3-PA,1704,0,1,0,1900,1901,C
3-PA,1705,1,5,1883,0,1889,G
3-PA,1706,1,8,1894,0,1903,G
3-PA,1707,1877,0,5,0,1882,A
3-PA,1708,1885,0,0,0,1885,A
3-PA,1709,1,0,0,1909,1910,C
3-PA,1710,1899,0,2,0,1901,A
3-PA,1711,1,1904,0,0,1905,T
3-PA,1712,1,0,0,1898,1899,C
3-PA,1713,1893,0,1,0,1894,A
3-PA,1714,1893,0,1,0,1894,A
3-PA,1715,1859,0,5,0,1864,A
3-PA,1716,0,3,1904,0,1907,G
3-PA,1717,0,1,1912,0,1913,G
3-PA,1718,0,1890,0,1,1891,T
3-PA,1719,7,0,0,1873,1880,C
3-PA,1720,1890,1,0,0,1891,A
3-PA,1721,1904,0,0,0,1904,A
3-PA,1722,1909,0,1,0,1910,A
3-PA,1723,1917,0,0,1,1918,A
3-PA,1724,0,1919,0,0,1919,T
3-PA,1725,0,5,1937,0,1942,G
3-PA,1726,1910,0,1,0,1911,A
3-PA,1727,1916,0,1,0,1917,A
3-PA,1728,1925,1,1,1,1928,A
3-PA,1729,0,1933,0,0,1933,T
3-PA,1730,1,4,1951,0,1956,G
3-PA,1731,0,8,1959,0,1967,G
3-PA,1732,1,0,1962,0,1963,G
3-PA,1733,0,3,1999,0,2002,G
3-PA,1734,1970,1,1,0,1972,A
3-PA,1735,1993,0,3,1,1997,A
3-PA,1736,0,1999,0,0,1999,T
3-PA,1737,0,5,2011,0,2016,G
3-PA,1738,0,3,2051,0,2054,G
3-PA,1739,2022,2,4,0,2028,A
3-PA,1740,0,1,2075,0,2076,G
3-PA,1741,2054,2,2,0,2058,A
3-PA,1742,0,2039,0,1,2040,T
3-PA,1743,1,7,2030,0,2038,G
3-PA,1744,2016,2,4,0,2022,A
3-PA,1745,0,3,2042,0,2045,G
3-PA,1746,2043,0,5,0,2048,A
3-PA,1747,0,1,0,2014,2015,C
3-PA,1748,1,0,2015,0,2016,G
3-PA,1749,0,1983,0,1,1984,T
3-PA,1750,0,1977,0,2,1979,T
3-PA,1751,2,0,1995,0,1997,G
3-PA,1752,2,1,0,1989,1992,C
3-PA,1753,6,0,0,1995,2001,C
3-PA,1754,0,1979,0,3,1982,T
3-PA,1755,1,1,0,2070,2072,C
3-PA,1756,1,2,0,2067,2070,C
3-PA,1757,1,2063,1,2,2067,T
3-PA,1758,0,2073,0,0,2073,T
3-PA,1759,3,0,0,2074,2077,C
3-PA,1760,2065,0,0,0,2065,A
3-PA,1761,0,0,2080,0,2080,G
3-PA,1762,0,2063,0,5,2068,T
3-PA,1763,9,0,0,2085,2094,C
3-PA,1764,2039,1,1,0,2041,A
3-PA,1765,0,1,0,2171,2172,C
3-PA,1766,0,2155,0,1,2156,T
3-PA,1767,4,0,0,2168,2172,C
3-PA,1768,4,0,0,2168,2172,C
3-PA,1769,2175,1,3,0,2179,A
3-PA,1770,1,0,2182,0,2183,G
3-PA,1771,0,0,0,2180,2180,C
3-PA,1772,2162,2,4,0,2168,A
3-PA,1773,1,2,2197,0,2200,G
3-PA,1774,2103,0,5,0,2108,A
3-PA,1775,1,2091,1,2,2095,T
3-PA,1776,3,1,0,2099,2103,C
3-PA,1777,2,3,2096,1,2102,G
3-PA,1778,2083,0,2,0,2085,A
3-PA,1779,0,4,2113,0,2117,G
3-PA,1780,2078,1,4,1,2084,A
3-PA,1781,0,0,2131,0,2131,G
3-PA,1782,1,0,0,2109,2110,C
3-PA,1783,2102,1,1,1,2105,A
3-PA,1784,1,2114,0,0,2115,T
3-PA,1785,1,11,2156,0,2168,G
3-PA,1786,2187,0,4,0,2191,A
3-PA,1787,1,2181,0,2,2184,T
3-PA,1788,1,2176,0,0,2177,T
3-PA,1789,1,3,2180,0,2184,G
3-PA,1790,2162,1,2,1,2166,A
3-PA,1791,2155,0,1,0,2156,A
3-PA,1792,0,0,2176,0,2176,G
3-PA,1793,0,2,0,2167,2169,C
3-PA,1794,3,1,0,2124,2128,C
3-PA,1795,0,5,2116,0,2121,G
3-PA,1796,2110,0,1,0,2111,A
3-PA,1797,0,0,2128,0,2128,G
3-PA,1798,1,2130,0,0,2131,T
3-PA,1799,5,0,0,2119,2124,C
3-PA,1800,1,0,0,2117,2118,C
3-PA,1801,0,2109,0,5,2114,T
3-PA,1802,2,1,0,2164,2167,C
3-PA,1803,2,2,2163,0,2167,G
3-PA,1804,3,0,2291,0,2294,G
3-PA,1805,0,2283,0,2,2285,T
3-PA,1806,0,2247,0,0,2247,T
3-PA,1807,2261,2,0,1,2264,A
3-PA,1808,2266,0,1,0,2267,A
3-PA,1809,2264,0,5,1,2270,A
3-PA,1810,0,7,2348,0,2355,G
3-PA,1811,2311,0,1,0,2312,A
3-PA,1812,0,1,2336,0,2337,G
3-PA,1813,2234,0,1,0,2235,A
3-PA,1814,2235,1,3,0,2239,A
3-PA,1815,2253,0,2,0,2255,A
3-PA,1816,2,2,2275,0,2279,G
3-PA,1817,2263,0,3,0,2266,A
3-PA,1818,1,0,1,2263,2265,C
3-PA,1819,2219,0,1,0,2220,A
3-PA,1820,0,2218,0,4,2222,T
3-PA,1821,0,10,2216,0,2226,G
3-PA,1822,2258,0,1,0,2259,A
3-PA,1823,1,1,0,2257,2259,C
3-PA,1824,10,0,0,2253,2263,C
3-PA,1825,2243,0,2,0,2245,A
3-PA,1826,2239,0,1,0,2240,A
3-PA,1827,2235,0,2,0,2237,A
3-PA,1828,0,5,2258,0,2263,G
3-PA,1829,2241,0,1,1,2243,A
3-PA,1830,0,0,2262,0,2262,G
3-PA,1831,1,2199,0,6,2206,T
3-PA,1832,0,2191,1,1,2193,T
3-PA,1833,0,2191,0,2,2193,T
3-PA,1834,1,2206,0,2,2209,T
3-PA,1835,0,2199,0,0,2199,T
3-PA,1836,0,2221,0,0,2221,T
3-PA,1837,1,5,2213,0,2219,G
3-PA,1838,2179,1,7,0,2187,A
3-PA,1839,0,6,2222,0,2228,G
3-PA,1840,2204,0,0,1,2205,A
3-PA,1841,2210,0,0,0,2210,A
3-PA,1842,0,2215,0,0,2215,T
3-PA,1843,2218,0,0,1,2219,A
3-PA,1844,2298,0,3,0,2301,A
3-PA,1845,2322,0,1,0,2323,A
3-PA,1846,0,2307,1,1,2309,T
3-PA,1847,6,5,0,2328,2339,C
3-PA,1848,2305,0,2,0,2307,A
3-PA,1849,0,1,2306,0,2307,G
3-PA,1850,2305,0,1,0,2306,A
3-PA,1851,2314,0,3,0,2317,A
3-PA,1852,0,0,2350,0,2350,G
3-PA,1853,0,2,0,2291,2293,C
3-PA,1854,2282,1,3,1,2287,A
3-PA,1855,0,2281,0,2,2283,T
3-PA,1856,0,7,2276,0,2283,G
3-PA,1857,1,0,2327,0,2328,G
3-PA,1858,2,0,0,2316,2318,C
3-PA,1859,2,0,0,2414,2416,C
3-PA,1860,3,0,1,2425,2429,C
3-PA,1861,2484,0,1,0,2485,A
3-PA,1862,1,2482,0,0,2483,T
3-PA,1863,1,2488,0,1,2490,T
3-PA,1864,0,5,2488,0,2493,G
3-PA,1865,0,4,2499,0,2503,G
3-PA,1866,2,2,2466,0,2470,G
3-PA,1867,1,4,2478,0,2483,G
3-PA,1868,2343,0,4,0,2347,A
3-PA,1869,0,0,2383,1,2384,G
3-PA,1870,0,2349,0,6,2355,T
3-PA,1871,3,0,0,2422,2425,C
3-PA,1872,8,1,0,2562,2571,C
3-PA,1873,10,1,0,2569,2580,C
3-PA,1874,6,0,0,2568,2574,C
3-PA,1875,6,2,0,2575,2583,C
3-PA,1876,2588,2,0,0,2590,A
3-PA,1877,2597,0,1,0,2598,A
3-PA,1878,0,6,2585,0,2591,G
3-PA,1879,0,2,2558,0,2560,G
3-PA,1880,1,6,2555,0,2562,G
3-PA,1881,2281,0,4,1,2286,A
3-PA,1882,0,2,2339,0,2341,G
3-PA,1883,0,2333,1,0,2334,T
3-PA,1884,0,2,2332,0,2334,G
3-PA,1885,0,7,2345,1,2353,G
3-PA,1886,2348,0,4,1,2353,A
3-PA,1887,2350,2,1,1,2354,A
3-PA,1888,0,2,2351,0,2353,G
3-PA,1889,2324,0,1,0,2325,A
3-PA,1890,2335,0,1,1,2337,A
3-PA,1891,0,4,2319,0,2323,G
3-PA,1892,0,0,2319,0,2319,G
3-PA,1893,0,2318,0,3,2321,T
3-PA,1894,0,2284,0,2,2286,T
3-PA,1895,3,1,0,2297,2301,C
3-PA,1896,1,0,0,2307,2308,C
3-PA,1897,2310,0,0,0,2310,A
3-PA,1898,1,2309,1,0,2311,T
3-PA,1899,0,2294,0,1,2295,T
3-PA,1900,0,4,2320,0,2324,G
3-PA,1901,1,5,2296,0,2302,G
3-PA,1902,0,5,2314,0,2319,G
3-PA,1903,2313,1,1,0,2315,A
3-PA,1904,2314,0,0,0,2314,A
3-PA,1905,2315,0,2,0,2317,A
3-PA,1906,1,0,2406,0,2407,G
3-PA,1907,0,2395,0,1,2396,T
3-PA,1908,2,0,0,2454,2456,C
3-PA,1909,0,2440,0,1,2441,T
3-PA,1910,0,0,2457,0,2457,G
3-PA,1911,0,2460,1,1,2462,T
3-PA,1912,2449,0,5,1,2455,A
3-PA,1913,0,4,2470,0,2474,G
3-PA,1914,0,8,2425,0,2433,G
3-PA,1915,2357,0,1,0,2358,A
3-PA,1916,0,0,0,2377,2377,C
3-PA,1917,1,2300,0,4,2305,T
3-PA,1918,4,0,0,2473,2477,C
3-PA,1919,1,2447,0,2,2450,T
3-PA,1920,2465,0,0,0,2465,A
3-PA,1921,0,2454,0,3,2457,T
3-PA,1922,0,2449,0,0,2449,T
3-PA,1923,0,4,2488,0,2492,G
3-PA,1924,2,1,2471,0,2474,G
3-PA,1925,1,1,0,2477,2479,C
3-PA,1926,0,2470,0,0,2470,T
3-PA,1927,2287,0,0,0,2287,A
3-PA,1928,2317,0,2,1,2320,A
3-PA,1929,0,1,2346,0,2347,G
3-PA,1930,1,2345,0,3,2349,T
3-PA,1931,17,0,0,2332,2349,C
3-PA,1932,2293,0,2,0,2295,A
3-PA,1933,0,0,2431,0,2431,G
3-PA,1934,0,2425,0,1,2426,T
3-PA,1935,2536,0,0,0,2536,A
3-PA,1936,0,2533,0,3,2536,T
3-PA,1937,0,2558,0,2,2560,T
3-PA,1938,5,1,0,2564,2570,C
3-PA,1939,2547,0,1,0,2548,A
3-PA,1940,2550,0,3,0,2553,A
3-PA,1941,1,2550,2,1,2554,T
3-PA,1942,2484,0,1,0,2485,A
3-PA,1943,0,1,2515,0,2516,G
3-PA,1944,3,2,0,2479,2484,C
3-PA,1945,3,2,0,2509,2514,C
3-PA,1946,2,2446,0,2,2450,T
3-PA,1947,1,2,2537,0,2540,G
3-PA,1948,0,2539,0,1,2540,T
3-PA,1949,2550,0,1,0,2551,A
3-PA,1950,0,2545,0,1,2546,T
3-PA,1951,0,0,2493,0,2493,G
3-PA,1952,0,3,0,2502,2505,C
3-PA,1953,2464,0,1,0,2465,A
3-PA,1954,1,2448,0,2,2451,T
3-PA,1955,2,0,0,2448,2450,C
3-PA,1956,2386,1,5,0,2392,A
3-PA,1957,0,0,0,2432,2432,C
3-PA,1958,6,0,0,2417,2423,C
3-PA,1959,2428,0,3,0,2431,A
3-PA,1960,0,0,0,2466,2466,C
3-PA,1961,2420,0,0,0,2420,A
3-PA,1962,2428,0,1,0,2429,A
3-PA,1963,0,2428,0,1,2429,T
3-PA,1964,0,2435,0,1,2436,T
3-PA,1965,4,2,2416,0,2422,G
3-PA,1966,0,2,2391,1,2394,G
3-PA,1967,2379,0,1,1,2381,A
3-PA,1968,2393,0,1,0,2394,A
3-PA,1969,0,3,2370,0,2373,G
3-PA,1970,0,3,2394,0,2397,G
3-PA,1971,2378,0,1,0,2379,A
3-PA,1972,0,2379,0,2,2381,T
3-PA,1973,0,2383,0,1,2384,T
3-PA,1974,1,2380,0,0,2381,T
3-PA,1975,0,2378,0,0,2378,T
3-PA,1976,2,0,0,2389,2391,C
3-PA,1977,2382,0,3,0,2385,A
3-PA,1978,1,2,2383,0,2386,G
3-PA,1979,0,0,0,2368,2368,C
3-PA,1980,2,7,2353,0,2362,G
3-PA,1981,0,5,2366,0,2371,G
3-PA,1982,2354,0,2,0,2356,A
3-PA,1983,0,0,2407,0,2407,G
3-PA,1984,1,2405,0,1,2407,T
3-PA,1985,5,0,0,2449,2454,C
3-PA,1986,2457,0,2,0,2459,A
3-PA,1987,2450,2,5,0,2457,A
3-PA,1988,0,5,2459,0,2464,G
3-PA,1989,2460,1,0,0,2461,A
3-PA,1990,2451,0,1,0,2452,A
3-PA,1991,2442,0,2,0,2444,A
3-PA,1992,2395,1,2,0,2398,A
3-PA,1993,1,3,0,2403,2407,C
3-PA,1994,0,2348,0,0,2348,T
3-PA,1995,2,1,2355,0,2358,G
3-PA,1996,2,1,0,2339,2342,C
3-PA,1997,1,2322,0,5,2328,T
3-PA,1998,9,0,0,2343,2352,C
3-PA,1999,4,0,0,2342,2346,C
3-PA,2000,0,2366,0,1,2367,T
3-PA,2001,0,2364,1,3,2368,T
3-PA,2002,0,1,2370,0,2371,G
3-PA,2003,1,2375,0,0,2376,T
3-PA,2004,0,2335,0,1,2336,T
3-PA,2005,0,2,2357,0,2359,G
3-PA,2006,0,2335,0,1,2336,T
3-PA,2007,0,2318,0,3,2321,T
3-PA,2008,12,0,0,2308,2320,C
3-PA,2009,2263,0,6,0,2269,A
3-PA,2010,1,4,2288,0,2293,G
3-PA,2011,0,0,2278,0,2278,G
3-PA,2012,1,0,0,2314,2315,C
3-PA,2013,0,2276,1,9,2286,T
3-PA,2014,3,0,0,2361,2364,C
3-PA,2015,0,2355,0,0,2355,T
3-PA,2016,0,2363,0,1,2364,T
3-PA,2017,2359,0,2,0,2361,A
3-PA,2018,1,5,2362,0,2368,G
3-PA,2019,0,2,2329,0,2331,G
3-PA,2020,0,7,2320,0,2327,G
3-PA,2021,2264,0,2,0,2266,A
3-PA,2022,4,1,0,2261,2266,C
3-PA,2023,2138,0,2,0,2140,A
3-PA,2024,2197,0,1,0,2198,A
3-PA,2025,3,0,0,2418,2421,C
3-PA,2026,2,0,1,2411,2414,C
3-PA,2027,0,2400,0,1,2401,T
3-PA,2028,3,0,0,2405,2408,C
3-PA,2029,636,1,1769,0,2406,G
3-PA,2030,2409,0,0,0,2409,A
3-PA,2031,2426,0,0,0,2426,A
3-PA,2032,1,0,0,2421,2422,C
3-PA,2033,4,0,0,2335,2339,C
3-PA,2034,2,1915,1,3,1921,T
3-PA,2035,0,5,1913,1,1919,G
3-PA,2036,2,0,1922,0,1924,G
3-PA,2037,0,5,1910,0,1915,G
3-PA,2038,1912,0,3,0,1915,A
3-PA,2039,4,1,0,1909,1914,C
3-PA,2040,4,1,0,1911,1916,C
3-PA,2041,0,1885,1,4,1890,T
3-PA,2042,0,1901,0,2,1903,T
3-PA,2043,0,1899,0,0,1899,T
3-PA,2044,2,3,1891,0,1896,G
3-PA,2045,1889,0,1,0,1890,A
3-PA,2046,2,1892,0,1,1895,T
3-PA,2047,1,0,0,1909,1910,C
3-PA,2048,0,1853,0,3,1856,T
3-PA,2049,0,1864,0,1,1865,T
3-PA,2050,2,8,1860,0,1870,G
3-PA,2051,0,2,1856,0,1858,G
3-PA,2052,1,2,1852,0,1855,G
3-PA,2053,0,2,1878,0,1880,G
3-PA,2054,0,0,1843,0,1843,G
3-PA,2055,0,0,1870,0,1870,G
3-PA,2056,1,0,0,1860,1861,C
3-PA,2057,0,1859,0,3,1862,T
3-PA,2058,1947,0,0,0,1947,A
3-PA,2059,1,1951,0,0,1952,T
3-PA,2060,1948,0,0,0,1948,A
3-PA,2061,0,1950,0,1,1951,T
3-PA,2062,0,1,1880,0,1881,G
3-PA,2063,1874,0,3,0,1877,A
3-PA,2064,1845,0,4,0,1849,A
3-PA,2065,0,0,1863,0,1863,G
3-PA,2066,0,0,0,1888,1888,C
3-PA,2067,1777,0,0,0,1777,A
3-PA,2068,1869,1,1,0,1871,A
3-PA,2069,0,1860,0,0,1860,T
3-PA,2070,0,1860,0,0,1860,T
3-PA,2071,0,3,1866,0,1869,G
3-PA,2072,1844,0,3,0,1847,A
3-PA,2073,1,1,1849,0,1851,G
3-PA,2074,0,4,1845,0,1849,G
3-PA,2075,1742,0,1,0,1743,A
3-PA,2076,0,0,1773,0,1773,G
3-PA,2077,0,1612,0,3,1615,T
3-PA,2078,0,0,1611,0,1611,G
3-PA,2079,2,1,0,1602,1605,C
3-PA,2080,1,0,0,1612,1613,C
3-PA,2081,1,1607,1,1,1610,T
3-PA,2082,1,4,1622,0,1627,G
3-PA,2083,1626,0,0,0,1626,A
3-PA,2084,0,1639,0,1,1640,T
3-PA,2085,0,1576,0,0,1576,T
3-PA,2086,1564,0,0,0,1564,A
3-PA,2087,1553,0,1,0,1554,A
3-PA,2088,0,1548,0,3,1551,T
3-PA,2089,1,5,1541,0,1547,G
3-PA,2090,1522,0,0,0,1522,A
3-PA,2091,0,1492,0,0,1492,T
3-PA,2092,4,0,0,1486,1490,C
3-PA,2093,7,1,0,1473,1481,C
3-PA,2094,3,0,0,1479,1482,C
3-PA,2095,0,1471,0,2,1473,T
3-PA,2096,0,0,1473,0,1473,G
3-PA,2097,0,0,1489,0,1489,G
3-PA,2098,0,1,1496,0,1497,G
3-PA,2099,0,1484,0,2,1486,T
3-PA,2100,0,1415,0,0,1415,T
3-PA,2101,0,1409,0,2,1411,T
3-PA,2102,0,1408,0,0,1408,T
3-PA,2103,1,1,1413,0,1415,G
3-PA,2104,1,1,0,1410,1412,C
3-PA,2105,1,1400,0,2,1403,T
3-PA,2106,9,0,0,1387,1396,C
3-PA,2107,1327,0,1,0,1328,A
3-PA,2108,1333,1,1,0,1335,A
3-PA,2109,0,1332,0,2,1334,T
3-PA,2110,1,1,1335,0,1337,G
3-PA,2111,2,1,0,1329,1332,C
3-PA,2112,1,0,1294,0,1295,G
3-PA,2113,0,1291,0,5,1296,T
3-PA,2114,2,0,0,1297,1299,C
3-PA,2115,0,1280,1,1,1282,T
3-PA,2116,0,1283,0,0,1283,T
3-PA,2117,0,3,1274,0,1277,G
3-PA,2118,0,0,1275,0,1275,G
3-PA,2119,0,1275,0,0,1275,T
3-PA,2120,0,1266,0,0,1266,T
3-PA,2121,4,0,0,1228,1232,C
3-PA,2122,1205,0,0,0,1205,A
3-PA,2123,1212,1,0,0,1213,A
3-PA,2124,1,0,0,1206,1207,C
3-PA,2125,0,1179,0,2,1181,T
3-PA,2126,3,0,0,1182,1185,C
3-PA,2127,2,1,0,1108,1111,C
3-PA,2128,0,1105,0,3,1108,T
3-PA,2129,1,1099,0,1,1101,T
3-PA,2130,0,0,0,1112,1112,C
3-PA,2131,3,0,0,1099,1102,C
3-PA,2132,1,1070,1,0,1072,T
3-PA,2133,0,2,1066,0,1068,G
3-PA,2134,1066,0,0,0,1066,A
3-PA,2135,0,0,0,1047,1047,C
3-PA,2136,993,0,0,0,993,A
3-PA,2137,0,0,0,945,945,C
3-PA,2138,931,0,0,0,931,A
3-PA,2139,0,917,0,1,918,T
3-PA,2140,0,0,918,0,918,G
3-PA,2141,1,0,0,912,913,C
3-PA,2142,894,0,1,0,895,A
3-PA,2143,0,893,0,0,893,T
3-PA,2144,0,880,0,0,880,T
3-PA,2145,878,0,1,0,879,A
3-PA,2146,873,0,1,0,874,A
3-PA,2147,872,0,0,0,872,A
3-PA,2148,869,0,0,0,869,A
3-PA,2149,0,857,0,0,857,T
3-PA,2150,656,0,0,0,656,A
3-PA,2151,0,0,654,0,654,G
4-HA,1,1686,0,0,0,1686,A
4-HA,2,0,1698,0,0,1698,T
4-HA,3,0,0,1739,0,1739,G
4-HA,4,1739,0,3,0,1742,A
4-HA,5,1757,2,4,0,1763,A
4-HA,6,0,3,1919,0,1922,G
4-HA,7,1912,0,4,0,1916,A
4-HA,8,0,0,0,2127,2127,C
4-HA,9,0,2148,0,0,2148,T
4-HA,10,2226,1,0,1,2228,A
4-HA,11,1,2303,1,3,2308,T
4-HA,12,2,3,0,2320,2325,C
4-HA,13,2329,0,0,0,2329,A
4-HA,14,1,2334,0,2,2337,T
4-HA,15,0,2334,0,4,2338,T
4-HA,16,0,2,2550,0,2552,G
4-HA,17,0,0,0,2575,2575,C
4-HA,18,0,2582,0,1,2583,T
4-HA,19,1,2579,0,2,2582,T
4-HA,20,0,2589,0,0,2589,T
4-HA,21,3,9,2744,0,2756,G
4-HA,22,2769,0,4,0,2773,A
4-HA,23,0,0,2883,0,2883,G
4-HA,24,0,1,0,2894,2895,C
4-HA,25,0,2897,0,3,2900,T
4-HA,26,3137,0,1,0,3138,A
4-HA,27,1,1,0,3190,3192,C
4-HA,28,3241,0,2,0,3243,A
4-HA,29,1,3469,0,1,3471,T
4-HA,30,0,3439,0,4,3443,T
4-HA,31,5,1,0,3511,3517,C
4-HA,32,0,3509,1,2,3512,T
4-HA,33,3567,0,2,0,3569,A
4-HA,34,0,3577,0,6,3583,T
4-HA,35,2,1,3592,0,3595,G
4-HA,36,1,3572,0,10,3583,T
4-HA,37,7,0,0,3566,3573,C
4-HA,38,0,3557,0,4,3561,T
4-HA,39,2,5,3562,0,3569,G
4-HA,40,3,1,3570,0,3574,G
4-HA,41,0,3558,0,2,3560,T
4-HA,42,0,3545,0,3,3548,T
4-HA,43,0,3554,0,1,3555,T
4-HA,44,1,3568,0,0,3569,T
4-HA,45,6,1,0,3556,3563,C
4-HA,46,3,1,3549,0,3553,G
4-HA,47,0,0,0,3623,3623,C
4-HA,48,0,3581,1,5,3587,T
4-HA,49,12,1,1,3631,3645,C
4-HA,50,3640,0,3,0,3643,A
4-HA,51,3658,0,2,0,3660,A
4-HA,52,3665,0,1,0,3666,A
4-HA,53,3660,0,2,0,3662,A
4-HA,54,3655,0,6,1,3662,A
4-HA,55,1,0,0,3712,3713,C
4-HA,56,1,3682,0,4,3687,T
4-HA,57,0,3695,0,2,3697,T
4-HA,58,5,1,0,3699,3705,C
4-HA,59,2,1,0,3715,3718,C
4-HA,60,1,3701,0,4,3706,T
4-HA,61,1,4,3751,0,3756,G
4-HA,62,0,6,3757,0,3763,G
4-HA,63,3766,0,0,0,3766,A
4-HA,64,3841,0,4,0,3845,A
4-HA,65,3845,0,2,1,3848,A
4-HA,66,0,3895,0,1,3896,T
4-HA,67,2,17,3927,0,3946,G
4-HA,68,3936,1,4,0,3941,A
4-HA,69,0,3,0,4009,4012,C
4-HA,70,3994,0,1,0,3995,A
4-HA,71,3991,0,5,0,3996,A
4-HA,72,0,2,0,4080,4082,C
4-HA,73,4035,1,5,0,4041,A
4-HA,74,1,3,4074,0,4078,G
4-HA,75,2,4,0,4050,4056,C
4-HA,76,4064,1,2,0,4067,A
4-HA,77,1,3,0,4227,4231,C
4-HA,78,0,12,4196,1,4209,G
4-HA,79,3,2,4239,0,4244,G
4-HA,80,0,1,0,4272,4273,C
4-HA,81,4231,1,2,0,4234,A
4-HA,82,4302,0,4,0,4306,A
4-HA,83,0,0,0,4333,4333,C
4-HA,84,1,1,4389,0,4391,G
4-HA,85,1,1,0,4396,4398,C
4-HA,86,0,4324,0,5,4329,T
4-HA,87,2,1,4415,0,4418,G
4-HA,88,0,4396,0,5,4401,T
4-HA,89,2,1,4592,0,4595,G
4-HA,90,3,3,0,4655,4661,C
4-HA,91,9,1,0,4723,4733,C
4-HA,92,0,4703,1,4,4708,T
4-HA,93,0,4670,0,4,4674,T
4-HA,94,2,7,4694,0,4703,G
4-HA,95,1,13,4707,0,4721,G
4-HA,96,3,2,4784,1,4790,G
4-HA,97,3,3,0,4792,4798,C
4-HA,98,4718,0,3,0,4721,A
4-HA,99,1,1,0,4778,4780,C
4-HA,100,3,1,0,4690,4694,C
4-HA,101,5213,2,5,0,5220,A
4-HA,102,0,5228,0,5,5233,T
4-HA,103,0,1,5210,0,5211,G
4-HA,104,1,1,0,5225,5227,C
4-HA,105,5150,1,4,0,5155,A
4-HA,106,0,1,5559,1,5561,G
4-HA,107,0,5555,0,4,5559,T
4-HA,108,5591,2,7,0,5600,A
4-HA,109,1,2,0,5556,5559,C
4-HA,110,10,1,1,5347,5359,C
4-HA,111,5386,0,4,0,5390,A
4-HA,112,5379,0,3,0,5382,A
4-HA,113,5378,0,6,0,5384,A
4-HA,114,1,3,0,5411,5415,C
4-HA,115,6,5,5229,0,5240,G
4-HA,116,1,16,5319,0,5336,G
4-HA,117,5304,1,9,1,5315,A
4-HA,118,5331,1,8,1,5341,A
4-HA,119,1,2,1,5338,5342,C
4-HA,120,0,8,5333,0,5341,G
4-HA,121,5399,1,3,0,5403,A
4-HA,122,1,5416,0,3,5420,T
4-HA,123,5465,0,5,0,5470,A
4-HA,124,0,0,5503,0,5503,G
4-HA,125,0,5423,0,2,5425,T
4-HA,126,4,11,5412,1,5428,G
4-HA,127,5413,2,10,1,5426,A
4-HA,128,5434,0,7,0,5441,A
4-HA,129,5441,0,11,0,5452,A
4-HA,130,5405,0,5,0,5410,A
4-HA,131,0,1,1,5467,5469,C
4-HA,132,5421,1,3,0,5425,A
4-HA,133,5439,1,3,0,5443,A
4-HA,134,1,5397,0,2,5400,T
4-HA,135,10,0,0,5413,5423,C
4-HA,136,5437,0,2,0,5439,A
4-HA,137,0,2,0,5449,5451,C
4-HA,138,1,13,5437,2,5453,G
4-HA,139,5420,0,5,0,5425,A
4-HA,140,5391,0,4,0,5395,A
4-HA,141,0,5410,0,0,5410,T
4-HA,142,3,32,5388,0,5423,G
4-HA,143,5459,0,8,0,5467,A
4-HA,144,1,4,0,5465,5470,C
4-HA,145,7,3,0,5453,5463,C
4-HA,146,5522,2,2,0,5526,A
4-HA,147,5539,1,2,0,5542,A
4-HA,148,5545,0,4,1,5550,A
4-HA,149,0,5566,0,0,5566,T
4-HA,150,0,5536,0,2,5538,T
4-HA,151,4,7,5575,0,5586,G
4-HA,152,5540,0,2,0,5542,A
4-HA,153,5559,1,3,0,5563,A
4-HA,154,0,1,5602,0,5603,G
4-HA,155,1,5576,0,2,5579,T
4-HA,156,0,5724,0,4,5728,T
4-HA,157,5780,1,0,0,5781,A
4-HA,158,1,2,0,5799,5802,C
4-HA,159,0,5823,0,3,5826,T
4-HA,160,5792,1,5,1,5799,A
4-HA,161,5900,0,6,0,5906,A
4-HA,162,1,5912,0,1,5914,T
4-HA,163,1,0,5911,0,5912,G
4-HA,164,3,1,1,6158,6163,C
4-HA,165,1,6057,1,6,6065,T
4-HA,166,6094,1,2,0,6097,A
4-HA,167,2,1,0,6090,6093,C
4-HA,168,1,6049,1,3,6054,T
4-HA,169,1,25,6060,0,6086,G
4-HA,170,5957,0,10,0,5967,A
4-HA,171,0,3,6035,0,6038,G
4-HA,172,1,3,0,6025,6029,C
4-HA,173,0,5840,0,4,5844,T
4-HA,174,0,9,6036,0,6045,G
4-HA,175,2,0,6146,0,6148,G
4-HA,176,1,6144,0,6,6151,T
4-HA,177,2,6162,0,5,6169,T
4-HA,178,11,2,0,6128,6141,C
4-HA,179,6092,1,8,0,6101,A
4-HA,180,1,12,6127,0,6140,G
4-HA,181,6111,3,11,0,6125,A
4-HA,182,2,0,6262,0,6264,G
4-HA,183,2,6144,0,4,6150,T
4-HA,184,3,5998,0,5,6006,T
4-HA,185,17,3,0,6049,6069,C
4-HA,186,9,1,0,6076,6086,C
4-HA,187,0,5985,1,12,5998,T
4-HA,188,7,1,1,6092,6101,C
4-HA,189,6085,0,5,0,6090,A
4-HA,190,6094,1,0,0,6095,A
4-HA,191,1,1,0,6131,6133,C
4-HA,192,5946,0,9,0,5955,A
4-HA,193,1,2,6139,0,6142,G
4-HA,194,1,0,6137,0,6138,G
4-HA,195,3,6086,0,5,6094,T
4-HA,196,4,10,6104,0,6118,G
4-HA,197,6110,1,6,0,6117,A
4-HA,198,6151,0,2,0,6153,A
4-HA,199,6376,2,9,0,6387,A
4-HA,200,0,6344,0,1,6345,T
4-HA,201,6425,0,3,0,6428,A
4-HA,202,1,6283,0,0,6284,T
4-HA,203,3,1,6253,0,6257,G
4-HA,204,3,6,0,6313,6322,C
4-HA,205,6,33,6269,0,6308,G
4-HA,206,6305,0,7,0,6312,A
4-HA,207,0,1,0,6306,6307,C
4-HA,208,6115,1,2,0,6118,A
4-HA,209,2,2,6574,0,6578,G
4-HA,210,0,6500,0,9,6509,T
4-HA,211,21,5,0,6578,6604,C
4-HA,212,11,4,0,6588,6603,C
4-HA,213,1,6537,1,21,6560,T
4-HA,214,5,3,1,6713,6722,C
4-HA,215,6704,2,4,1,6711,A
4-HA,216,2,6689,1,5,6697,T
4-HA,217,7,3,0,6713,6723,C
4-HA,218,6282,1,11,2,6296,A
4-HA,219,1,4,6359,1,6365,G
4-HA,220,6288,0,2,1,6291,A
4-HA,221,0,6244,0,5,6249,T
4-HA,222,10,2,1,6294,6307,C
4-HA,223,9,2,0,6196,6207,C
4-HA,224,0,6169,0,3,6172,T
4-HA,225,2,6165,2,3,6172,T
4-HA,226,2,8,6176,0,6186,G
4-HA,227,6187,0,6,0,6193,A
4-HA,228,1,6165,1,1,6168,T
4-HA,229,0,10,6208,1,6219,G
4-HA,230,1,6,6202,0,6209,G
4-HA,231,6110,2,12,0,6124,A
4-HA,232,0,9,6179,0,6188,G
4-HA,233,6153,0,3,1,6157,A
4-HA,234,6201,0,7,1,6209,A
4-HA,235,6201,1,8,0,6210,A
4-HA,236,6200,1,5,0,6206,A
4-HA,237,0,1,0,6303,6304,C
4-HA,238,1,6206,0,3,6210,T
4-HA,239,0,1,6254,0,6255,G
4-HA,240,3,2,0,6249,6254,C
4-HA,241,6240,1,11,0,6252,A
4-HA,242,1,3,0,6460,6464,C
4-HA,243,6438,0,6,0,6444,A
4-HA,244,2,1,0,7311,7314,C
4-HA,245,0,7274,0,3,7277,T
4-HA,246,7381,1,4,0,7386,A
4-HA,247,7372,0,6,0,7378,A
4-HA,248,0,7403,1,0,7404,T
4-HA,249,7359,0,5,0,7364,A
4-HA,250,1,5,7367,0,7373,G
4-HA,251,7157,0,8,1,7166,A
4-HA,252,1,7025,0,6,7032,T
4-HA,253,2,5,6542,0,6549,G
4-HA,254,4,0,0,6611,6615,C
4-HA,255,4,6516,0,5,6525,T
4-HA,256,17,1,0,7063,7081,C
4-HA,257,0,7036,0,3,7039,T
4-HA,258,7229,1,2,0,7232,A
4-HA,259,0,7234,0,6,7240,T
4-HA,260,0,7199,0,3,7202,T
4-HA,261,1,18,7211,0,7230,G
4-HA,262,1,16,7168,0,7185,G
4-HA,263,2,13,7195,0,7210,G
4-HA,264,7024,0,14,0,7038,A
4-HA,265,2,22,6867,0,6891,G
4-HA,266,6693,0,6,1,6700,A
4-HA,267,3,4,1,7159,7167,C
4-HA,268,17,6,0,7188,7211,C
4-HA,269,15,1,0,7230,7246,C
4-HA,270,3,7136,0,19,7158,T
4-HA,271,10,1,0,7317,7328,C
4-HA,272,7273,0,12,3,7288,A
4-HA,273,2,1,7723,0,7726,G
4-HA,274,0,7700,1,15,7716,T
4-HA,275,2,0,7770,0,7772,G
4-HA,276,1,7473,1,6,7481,T
4-HA,277,3,7,7424,0,7434,G
4-HA,278,7396,0,21,0,7417,A
4-HA,279,0,7429,0,10,7439,T
4-HA,280,0,10,7325,0,7335,G
4-HA,281,3,3,7329,0,7335,G
4-HA,282,2,4,0,7166,7172,C
4-HA,283,0,7148,1,11,7160,T
4-HA,284,0,7093,1,8,7102,T
4-HA,285,9,2,1,7116,7128,C
4-HA,286,6,0,0,7133,7139,C
4-HA,287,7176,0,1,0,7177,A
4-HA,288,7174,0,5,0,7179,A
4-HA,289,7166,2,5,0,7173,A
4-HA,290,7206,0,3,0,7209,A
4-HA,291,0,7238,0,0,7238,T
4-HA,292,7223,0,3,1,7227,A
4-HA,293,7211,0,6,1,7218,A
4-HA,294,2,10,7264,0,7276,G
4-HA,295,7300,1,6,0,7307,A
4-HA,296,7302,0,3,0,7305,A
4-HA,297,7316,0,7,0,7323,A
4-HA,298,0,7321,0,2,7323,T
4-HA,299,3,27,7289,0,7319,G
4-HA,300,0,11,7271,1,7283,G
4-HA,301,4,31,7237,0,7272,G
4-HA,302,7261,1,16,1,7279,A
4-HA,303,1,3,1,7343,7348,C
4-HA,304,9,2,0,7304,7315,C
4-HA,305,0,7403,1,11,7415,T
4-HA,306,0,7395,0,10,7405,T
4-HA,307,0,7398,1,4,7403,T
4-HA,308,2,7451,1,0,7454,T
4-HA,309,0,7429,0,4,7433,T
4-HA,310,3,1,7480,0,7484,G
4-HA,311,0,7470,0,8,7478,T
4-HA,312,1,7397,0,3,7401,T
4-HA,313,12,31,7355,0,7398,G
4-HA,314,7310,1,8,0,7319,A
4-HA,315,7338,1,7,0,7346,A
4-HA,316,0,3,0,7353,7356,C
4-HA,317,1,4,7319,0,7324,G
4-HA,318,3,2,0,7456,7461,C
4-HA,319,7467,0,6,0,7473,A
4-HA,320,5,2,7478,0,7485,G
4-HA,321,2,1,0,7508,7511,C
4-HA,322,7508,1,7,2,7518,A
4-HA,323,7508,0,2,0,7510,A
4-HA,324,7501,2,11,0,7514,A
4-HA,325,3,4,7863,1,7871,G
4-HA,326,2,3,0,7854,7859,C
4-HA,327,12,3,1,7817,7833,C
4-HA,328,0,7800,0,8,7808,T
4-HA,329,7776,0,7,0,7783,A
4-HA,330,1,5,0,7855,7861,C
4-HA,331,7834,0,8,1,7843,A
4-HA,332,0,6,7842,0,7848,G
4-HA,333,3,3,0,7783,7789,C
4-HA,334,7561,0,3,1,7565,A
4-HA,335,7644,0,4,0,7648,A
4-HA,336,0,4,0,8030,8034,C
4-HA,337,0,8000,0,2,8002,T
4-HA,338,0,0,8028,0,8028,G
4-HA,339,0,7890,1,12,7903,T
4-HA,340,1,7908,0,5,7914,T
4-HA,341,7920,2,3,1,7926,A
4-HA,342,0,5,0,8497,8502,C
4-HA,343,17,2,0,8498,8517,C
4-HA,344,20,2,1,8647,8670,C
4-HA,345,2,8179,2,13,8196,T
4-HA,346,1,8195,0,5,8201,T
4-HA,347,8223,1,1,1,8226,A
4-HA,348,3,8210,0,4,8217,T
4-HA,349,0,14,8189,0,8203,G
4-HA,350,8154,0,8,0,8162,A
4-HA,351,1,7465,0,7,7473,T
4-HA,352,3,1,7529,0,7533,G
4-HA,353,0,7281,0,4,7285,T
4-HA,354,4,3,7237,0,7244,G
4-HA,355,2,2,0,7241,7245,C
4-HA,356,14,5,0,7242,7261,C
4-HA,357,4,12,7388,0,7404,G
4-HA,358,0,12,7491,1,7504,G
4-HA,359,7492,1,2,0,7495,A
4-HA,360,0,7514,1,1,7516,T
4-HA,361,1,7366,0,4,7371,T
4-HA,362,7440,1,1,0,7442,A
4-HA,363,1,7419,2,10,7432,T
4-HA,364,3,3,7445,0,7451,G
4-HA,365,2,2,0,7424,7428,C
4-HA,366,9,2,0,7339,7350,C
4-HA,367,1,7275,1,16,7293,T
4-HA,368,5,1,0,7715,7721,C
4-HA,369,3,0,0,7788,7791,C
4-HA,370,28,1,0,7789,7818,C
4-HA,371,0,7763,1,8,7772,T
4-HA,372,0,7785,1,5,7791,T
4-HA,373,7755,1,3,2,7761,A
4-HA,374,3,10,7989,1,8003,G
4-HA,375,2,0,8015,0,8017,G
4-HA,376,1,7858,0,10,7869,T
4-HA,377,29,3,0,7648,7680,C
4-HA,378,7568,1,12,1,7582,A
4-HA,379,0,1,1,7808,7810,C
4-HA,380,0,7790,0,2,7792,T
4-HA,381,7802,1,5,0,7808,A
4-HA,382,2,0,7792,0,7794,G
4-HA,383,0,7620,0,4,7624,T
4-HA,384,1,7542,1,5,7549,T
4-HA,385,2,4,7625,0,7631,G
4-HA,386,1,4,0,7618,7623,C
4-HA,387,16,1,0,7622,7639,C
4-HA,388,1,7446,2,19,7468,T
4-HA,389,8,2,0,7510,7520,C
4-HA,390,7751,0,4,1,7756,A
4-HA,391,0,7752,0,5,7757,T
4-HA,392,9,0,0,7775,7784,C
4-HA,393,8,9,0,7768,7785,C
4-HA,394,5,14,7683,0,7702,G
4-HA,395,8,7,7759,1,7775,G
4-HA,396,2,5,0,7780,7787,C
4-HA,397,7857,1,4,0,7862,A
4-HA,398,0,1,0,7987,7988,C
4-HA,399,7769,1,15,0,7785,A
4-HA,400,1,4,0,7856,7861,C
4-HA,401,0,7816,1,9,7826,T
4-HA,402,3,11,7889,1,7904,G
4-HA,403,1,18,7968,0,7987,G
4-HA,404,7891,0,14,0,7905,A
4-HA,405,1,1,8033,0,8035,G
4-HA,406,3,7913,0,6,7922,T
4-HA,407,0,7873,1,2,7876,T
4-HA,408,0,7839,0,13,7852,T
4-HA,409,7819,2,5,0,7826,A
4-HA,410,7845,0,11,0,7856,A
4-HA,411,2,0,0,7892,7894,C
4-HA,412,7732,1,0,0,7733,A
4-HA,413,7728,1,7,0,7736,A
4-HA,414,2,7666,0,1,7669,T
4-HA,415,0,12,7647,0,7659,G
4-HA,416,7623,0,8,0,7631,A
4-HA,417,7619,0,3,1,7623,A
4-HA,418,7633,3,11,2,7649,A
4-HA,419,7,4,7674,0,7685,G
4-HA,420,2,3,0,7737,7742,C
4-HA,421,1,7681,1,13,7696,T
4-HA,422,2,7679,0,4,7685,T
4-HA,423,12,3,1,7768,7784,C
4-HA,424,7799,2,4,1,7806,A
4-HA,425,7832,1,5,0,7838,A
4-HA,426,0,7818,0,9,7827,T
4-HA,427,1,7802,0,3,7806,T
4-HA,428,3,19,7948,0,7970,G
4-HA,429,0,30,7970,0,8000,G
4-HA,430,8009,1,7,0,8017,A
4-HA,431,3,2,0,8029,8034,C
4-HA,432,1,7904,0,11,7916,T
4-HA,433,3,6,7941,1,7951,G
4-HA,434,3,17,7967,1,7988,G
4-HA,435,7914,0,11,1,7926,A
4-HA,436,2,1,7976,0,7979,G
4-HA,437,2,7737,0,9,7748,T
4-HA,438,29,2,0,7601,7632,C
4-HA,439,7719,1,2,0,7722,A
4-HA,440,1,1,0,7741,7743,C
4-HA,441,2,7641,1,9,7653,T
4-HA,442,28,1,0,7697,7726,C
4-HA,443,7611,0,1,0,7612,A
4-HA,444,7675,0,3,1,7679,A
4-HA,445,7641,0,7,1,7649,A
4-HA,446,7670,0,9,0,7679,A
4-HA,447,0,6,1,7699,7706,C
4-HA,448,1,15,7540,1,7557,G
4-HA,449,2,24,7661,1,7688,G
4-HA,450,7658,3,12,0,7673,A
4-HA,451,7682,1,10,0,7693,A
4-HA,452,1,2,0,7694,7697,C
4-HA,453,7634,0,3,0,7637,A
4-HA,454,7701,0,4,1,7706,A
4-HA,455,3,1,7774,0,7778,G
4-HA,456,1,3,0,7772,7776,C
4-HA,457,0,7628,1,12,7641,T
4-HA,458,10,1,1,7722,7734,C
4-HA,459,3,7653,0,4,7660,T
4-HA,460,0,2,7674,0,7676,G
4-HA,461,1,2,0,7683,7686,C
4-HA,462,1,7668,0,13,7682,T
4-HA,463,0,7611,0,5,7616,T
4-HA,464,1,3,7703,0,7707,G
4-HA,465,2,1,0,7710,7713,C
4-HA,466,7705,0,1,0,7706,A
4-HA,467,1,7621,0,1,7623,T
4-HA,468,7578,2,3,0,7583,A
4-HA,469,7575,1,10,0,7586,A
4-HA,470,2,15,7577,0,7594,G
4-HA,471,1,13,7550,2,7566,G
4-HA,472,7505,0,1,1,7507,A
4-HA,473,7217,0,8,0,7225,A
4-HA,474,7290,2,5,0,7297,A
4-HA,475,0,7602,1,5,7608,T
4-HA,476,5,0,0,7711,7716,C
4-HA,477,0,7727,0,4,7731,T
4-HA,478,7690,1,3,0,7694,A
4-HA,479,7678,0,6,0,7684,A
4-HA,480,1,7683,0,1,7685,T
4-HA,481,7645,2,5,0,7652,A
4-HA,482,7676,0,6,1,7683,A
4-HA,483,1,0,0,7734,7735,C
4-HA,484,7303,1,7,0,7311,A
4-HA,485,3,1,7377,0,7381,G
4-HA,486,2,7247,1,10,7260,T
4-HA,487,1,7366,0,4,7371,T
4-HA,488,3,7387,0,6,7396,T
4-HA,489,2,2,0,7618,7622,C
4-HA,490,2,7619,0,9,7630,T
4-HA,491,1,7630,1,1,7633,T
4-HA,492,0,7648,0,2,7650,T
4-HA,493,7595,1,2,3,7601,A
4-HA,494,0,1,7608,0,7609,G
4-HA,495,0,7570,0,3,7573,T
4-HA,496,7526,1,6,0,7533,A
4-HA,497,2,8,7561,1,7572,G
4-HA,498,7371,0,3,1,7375,A
4-HA,499,1,7381,0,1,7383,T
4-HA,500,0,7346,0,2,7348,T
4-HA,501,1,27,7471,0,7499,G
4-HA,502,7475,1,4,1,7481,A
4-HA,503,7488,0,4,0,7492,A
4-HA,504,0,7499,1,3,7503,T
4-HA,505,1,7371,1,6,7379,T
4-HA,506,0,8,7454,2,7464,G
4-HA,507,5,3,7459,1,7468,G
4-HA,508,0,7460,0,9,7469,T
4-HA,509,2,7435,0,7,7444,T
4-HA,510,1,25,7300,0,7326,G
4-HA,511,7319,2,13,0,7334,A
4-HA,512,2,0,0,7323,7325,C
4-HA,513,14,4,1,7286,7305,C
4-HA,514,32,3,1,7259,7295,C
4-HA,515,7268,1,4,0,7273,A
4-HA,516,2,3,0,7345,7350,C
4-HA,517,0,7309,2,2,7313,T
4-HA,518,1,7339,0,0,7340,T
4-HA,519,7350,0,2,0,7352,A
4-HA,520,7324,2,1,0,7327,A
4-HA,521,7310,2,2,0,7314,A
4-HA,522,7380,1,4,0,7385,A
4-HA,523,0,7491,0,4,7495,T
4-HA,524,0,7436,0,1,7437,T
4-HA,525,22,3,0,7440,7465,C
4-HA,526,7415,2,4,0,7421,A
4-HA,527,7438,2,5,1,7446,A
4-HA,528,7441,0,5,1,7447,A
4-HA,529,0,7460,0,1,7461,T
4-HA,530,7671,1,1,0,7673,A
4-HA,531,2,1,2,7656,7661,C
4-HA,532,8,2,0,7465,7475,C
4-HA,533,20,4,0,7459,7483,C
4-HA,534,7422,1,9,0,7432,A
4-HA,535,2,2,7847,1,7852,G
4-HA,536,1,2,0,7864,7867,C
4-HA,537,7850,0,6,0,7856,A
4-HA,538,1,7805,2,12,7820,T
4-HA,539,1,7614,0,6,7621,T
4-HA,540,4,30,7876,0,7910,G
4-HA,541,7908,2,14,0,7924,A
4-HA,542,7941,0,9,0,7950,A
4-HA,543,3,7,0,7943,7953,C
4-HA,544,2,1,7666,0,7669,G
4-HA,545,0,7691,1,8,7700,T
4-HA,546,6,28,7689,1,7724,G
4-HA,547,7726,3,10,1,7740,A
4-HA,548,3,0,1,7751,7755,C
4-HA,549,0,7441,1,3,7445,T
4-HA,550,7713,1,2,0,7716,A
4-HA,551,0,7685,0,9,7694,T
4-HA,552,4,1,7776,0,7781,G
4-HA,553,2,9,0,7726,7737,C
4-HA,554,17,3,0,7634,7654,C
4-HA,555,7623,2,2,0,7627,A
4-HA,556,7614,1,7,3,7625,A
4-HA,557,7765,2,8,2,7777,A
4-HA,558,0,1,0,7804,7805,C
4-HA,559,7557,0,2,0,7559,A
4-HA,560,7595,0,4,0,7599,A
4-HA,561,2,7491,0,5,7498,T
4-HA,562,1,42,7468,0,7511,G
4-HA,563,7492,1,11,1,7505,A
4-HA,564,7496,2,12,0,7510,A
4-HA,565,2,1,0,7294,7297,C
4-HA,566,7344,0,1,0,7345,A
4-HA,567,7397,1,4,0,7402,A
4-HA,568,0,7374,1,0,7375,T
4-HA,569,1,7384,1,1,7387,T
4-HA,570,0,7402,0,1,7403,T
4-HA,571,4,36,7349,1,7390,G
4-HA,572,7417,1,8,0,7426,A
4-HA,573,0,1,0,7428,7429,C
4-HA,574,7406,0,2,0,7408,A
4-HA,575,7401,0,0,0,7401,A
4-HA,576,7477,0,4,2,7483,A
4-HA,577,1,7542,1,0,7544,T
4-HA,578,0,7439,0,2,7441,T
4-HA,579,2,2,7549,1,7554,G
4-HA,580,0,7544,0,1,7545,T
4-HA,581,7576,0,8,0,7584,A
4-HA,582,2,3,0,7761,7766,C
4-HA,583,7766,0,3,0,7769,A
4-HA,584,1,7900,0,3,7904,T
4-HA,585,2,7764,0,3,7769,T
4-HA,586,0,7726,0,2,7728,T
4-HA,587,1,16,7672,0,7689,G
4-HA,588,3,23,7603,0,7629,G
4-HA,589,2,20,7588,0,7610,G
4-HA,590,6,26,7628,0,7660,G
4-HA,591,3,16,7502,1,7522,G
4-HA,592,2,1,7763,0,7766,G
4-HA,593,1,7632,0,13,7646,T
4-HA,594,0,7657,0,5,7662,T
4-HA,595,15,3,0,7660,7678,C
4-HA,596,7716,0,10,0,7726,A
4-HA,597,2,4,0,7759,7765,C
4-HA,598,17,4,0,7732,7753,C
4-HA,599,7765,1,8,2,7776,A
4-HA,600,3,1,0,7803,7807,C
4-HA,601,9,5,0,7665,7679,C
4-HA,602,14,2,1,7617,7634,C
4-HA,603,3,12,7638,0,7653,G
4-HA,604,4,13,7986,0,8003,G
4-HA,605,0,1,8036,0,8037,G
4-HA,606,1,7974,0,2,7977,T
4-HA,607,8011,0,2,1,8014,A
4-HA,608,1,12,0,7948,7961,C
4-HA,609,4,13,7832,0,7849,G
4-HA,610,2,17,7911,0,7930,G
4-HA,611,7951,0,7,0,7958,A
4-HA,612,0,0,0,7921,7921,C
4-HA,613,7412,0,2,0,7414,A
4-HA,614,7427,0,2,0,7429,A
4-HA,615,0,7438,0,1,7439,T
4-HA,616,3,33,7527,0,7563,G
4-HA,617,7554,1,7,0,7562,A
4-HA,618,2,1,1,7523,7527,C
4-HA,619,14,1,1,7422,7438,C
4-HA,620,7456,0,3,0,7459,A
4-HA,621,7449,0,4,0,7453,A
4-HA,622,7609,1,0,1,7611,A
4-HA,623,2,7575,0,0,7577,T
4-HA,624,5,0,0,7693,7698,C
4-HA,625,0,7227,1,10,7238,T
4-HA,626,1,7166,3,8,7178,T
4-HA,627,15,1,0,7272,7288,C
4-HA,628,14,0,0,7303,7317,C
4-HA,629,1,7266,1,7,7275,T
4-HA,630,2,1,7344,0,7347,G
4-HA,631,1,7193,0,7,7201,T
4-HA,632,7267,0,1,0,7268,A
4-HA,633,1,7179,0,5,7185,T
4-HA,634,7,2,7251,0,7260,G
4-HA,635,2,2,0,7268,7272,C
4-HA,636,0,7152,0,14,7166,T
4-HA,637,24,9,0,7157,7190,C
4-HA,638,7197,1,9,0,7207,A
4-HA,639,7172,0,6,0,7178,A
4-HA,640,3,0,7217,0,7220,G
4-HA,641,1,2,0,7227,7230,C
4-HA,642,7232,1,7,0,7240,A
4-HA,643,1,7138,0,5,7144,T
4-HA,644,6,3,1,7125,7135,C
4-HA,645,7122,1,10,2,7135,A
4-HA,646,0,7,7199,0,7206,G
4-HA,647,2,6,7232,0,7240,G
4-HA,648,7202,1,3,0,7206,A
4-HA,649,7131,0,12,3,7146,A
4-HA,650,2,13,7304,0,7319,G
4-HA,651,7293,0,6,0,7299,A
4-HA,652,7411,1,6,0,7418,A
4-HA,653,1,7438,1,13,7453,T
4-HA,654,16,4,0,7453,7473,C
4-HA,655,7374,0,7,0,7381,A
4-HA,656,0,5,1,7395,7401,C
4-HA,657,7317,2,12,1,7332,A
4-HA,658,2,2,7518,0,7522,G
4-HA,659,0,7296,0,10,7306,T
4-HA,660,21,7,0,7352,7380,C
4-HA,661,3,7201,0,5,7209,T
4-HA,662,5,0,1,7494,7500,C
4-HA,663,2,7501,0,6,7509,T
4-HA,664,7604,1,3,0,7608,A
4-HA,665,5,1,0,7544,7550,C
4-HA,666,12,4,0,7546,7562,C
4-HA,667,7392,0,1,2,7395,A
4-HA,668,7400,0,1,1,7402,A
4-HA,669,7338,0,2,0,7340,A
4-HA,670,7345,1,9,0,7355,A
4-HA,671,3,4,7354,0,7361,G
4-HA,672,7131,2,3,0,7136,A
4-HA,673,7090,1,11,0,7102,A
4-HA,674,3,1,7127,0,7131,G
4-HA,675,1,3,0,7137,7141,C
4-HA,676,10,1,0,7152,7163,C
4-HA,677,7185,0,3,0,7188,A
4-HA,678,7212,5,8,1,7226,A
4-HA,679,2,3,0,7198,7203,C
4-HA,680,7195,1,4,0,7200,A
4-HA,681,7201,1,2,5,7209,A
4-HA,682,7183,0,2,0,7185,A
4-HA,683,1,0,0,7382,7383,C
4-HA,684,1,7302,0,1,7304,T
4-HA,685,2,2,7368,0,7372,G
4-HA,686,0,7329,2,4,7335,T
4-HA,687,7335,0,4,1,7340,A
4-HA,688,7350,0,8,0,7358,A
4-HA,689,1,7289,1,2,7293,T
4-HA,690,13,1,0,7403,7417,C
4-HA,691,10,4,0,7366,7380,C
4-HA,692,18,4,0,7177,7199,C
4-HA,693,5,21,7204,0,7230,G
4-HA,694,7164,1,3,1,7169,A
4-HA,695,7201,1,1,0,7203,A
4-HA,696,3,7205,0,1,7209,T
4-HA,697,7210,0,1,0,7211,A
4-HA,698,1,7166,4,4,7175,T
4-HA,699,10,3,0,7129,7142,C
4-HA,700,6,9,7097,0,7112,G
4-HA,701,2,14,7305,0,7321,G
4-HA,702,7315,1,7,1,7324,A
4-HA,703,0,7386,0,4,7390,T
4-HA,704,13,1,1,7363,7378,C
4-HA,705,1,7361,0,13,7375,T
4-HA,706,7354,0,7,0,7361,A
4-HA,707,1,20,7402,0,7423,G
4-HA,708,7469,1,8,1,7479,A
4-HA,709,5,2,0,7429,7436,C
4-HA,710,16,2,0,7147,7165,C
4-HA,711,11,5,0,7174,7190,C
4-HA,712,7127,0,5,2,7134,A
4-HA,713,1,14,7564,0,7579,G
4-HA,714,7522,2,7,1,7532,A
4-HA,715,0,4,7683,0,7687,G
4-HA,716,0,7602,0,5,7607,T
4-HA,717,7568,0,1,0,7569,A
4-HA,718,7542,6,14,0,7562,A
4-HA,719,3,7,7685,0,7695,G
4-HA,720,0,21,7751,1,7773,G
4-HA,721,7654,1,2,1,7658,A
4-HA,722,6944,2,14,1,6961,A
4-HA,723,1,6932,0,2,6935,T
4-HA,724,6939,0,2,1,6942,A
4-HA,725,2,6852,1,8,6863,T
4-HA,726,8,3,0,6992,7003,C
4-HA,727,13,1,2,6939,6955,C
4-HA,728,12,0,0,6801,6813,C
4-HA,729,1,6727,0,1,6729,T
4-HA,730,6758,1,4,0,6763,A
4-HA,731,0,1,6782,0,6783,G
4-HA,732,1,2,0,6770,6773,C
4-HA,733,6548,2,4,0,6554,A
4-HA,734,3,15,6792,0,6810,G
4-HA,735,6643,1,6,0,6650,A
4-HA,736,6689,1,2,0,6692,A
4-HA,737,1,6690,1,2,6694,T
4-HA,738,6666,1,0,0,6667,A
4-HA,739,6671,1,12,0,6684,A
4-HA,740,4,0,6698,1,6703,G
4-HA,741,0,5,0,6719,6724,C
4-HA,742,6724,0,5,0,6729,A
4-HA,743,2,6480,0,8,6490,T
4-HA,744,3,3,0,6968,6974,C
4-HA,745,1,6943,1,4,6949,T
4-HA,746,6979,2,3,0,6984,A
4-HA,747,0,6946,2,4,6952,T
4-HA,748,2,6874,0,2,6878,T
4-HA,749,4,12,6930,0,6946,G
4-HA,750,7,16,6901,0,6924,G
4-HA,751,6905,1,8,0,6914,A
4-HA,752,0,2,0,6912,6914,C
4-HA,753,6430,0,1,0,6431,A
4-HA,754,6604,0,2,0,6606,A
4-HA,755,0,6984,1,3,6988,T
4-HA,756,7043,0,5,0,7048,A
4-HA,757,3,1,7096,0,7100,G
4-HA,758,3,7016,0,2,7021,T
4-HA,759,7005,0,4,0,7009,A
4-HA,760,6979,0,5,1,6985,A
4-HA,761,7025,0,4,1,7030,A
4-HA,762,7064,1,7,1,7073,A
4-HA,763,0,1,0,7110,7111,C
4-HA,764,3,0,0,6677,6680,C
4-HA,765,3,12,6645,0,6660,G
4-HA,766,3,7,6660,0,6670,G
4-HA,767,3,9,6720,0,6732,G
4-HA,768,6688,1,6,0,6695,A
4-HA,769,0,12,6771,0,6783,G
4-HA,770,6863,0,14,1,6878,A
4-HA,771,0,2,0,6867,6869,C
4-HA,772,6868,0,8,9,6885,A
4-HA,773,0,6893,0,2,6895,T
4-HA,774,6915,1,5,1,6922,A
4-HA,775,0,0,0,7049,7049,C
4-HA,776,0,6967,1,9,6977,T
4-HA,777,2,7005,0,3,7010,T
4-HA,778,0,7034,2,11,7047,T
4-HA,779,0,6992,1,4,6997,T
4-HA,780,1,34,7003,1,7039,G
4-HA,781,7035,1,3,2,7041,A
4-HA,782,1,7029,1,4,7035,T
4-HA,783,4,7148,2,6,7160,T
4-HA,784,7088,1,2,0,7091,A
4-HA,785,7124,2,3,0,7129,A
4-HA,786,1,4,0,7195,7200,C
4-HA,787,7153,0,5,0,7158,A
4-HA,788,4,2,7384,1,7391,G
4-HA,789,0,1,0,7321,7322,C
4-HA,790,7344,1,4,0,7349,A
4-HA,791,1,1,0,7397,7399,C
4-HA,792,7275,0,15,3,7293,A
4-HA,793,2,16,7381,1,7400,G
4-HA,794,0,11,7339,0,7350,G
4-HA,795,3,15,7580,0,7598,G
4-HA,796,7497,0,6,1,7504,A
4-HA,797,7550,1,5,0,7556,A
4-HA,798,3,7549,0,5,7557,T
4-HA,799,8,4,0,7586,7598,C
4-HA,800,4,7587,2,3,7596,T
4-HA,801,7624,0,4,0,7628,A
4-HA,802,7587,0,4,0,7591,A
4-HA,803,1,7567,0,7,7575,T
4-HA,804,0,7283,0,2,7285,T
4-HA,805,2,3,7325,0,7330,G
4-HA,806,5,1,0,7382,7388,C
4-HA,807,0,7461,1,14,7476,T
4-HA,808,31,3,0,7640,7674,C
4-HA,809,3,2,0,7645,7650,C
4-HA,810,0,7634,1,5,7640,T
4-HA,811,7639,0,5,0,7644,A
4-HA,812,3,17,7629,1,7650,G
4-HA,813,4,32,7674,0,7710,G
4-HA,814,4,9,7704,0,7717,G
4-HA,815,2,6,7619,0,7627,G
4-HA,816,0,7439,0,3,7442,T
4-HA,817,0,7328,0,8,7336,T
4-HA,818,7336,0,2,0,7338,A
4-HA,819,0,7256,0,11,7267,T
4-HA,820,2,7293,1,3,7299,T
4-HA,821,2,7305,0,3,7310,T
4-HA,822,10,4,0,7311,7325,C
4-HA,823,7246,1,0,0,7247,A
4-HA,824,7266,0,4,1,7271,A
4-HA,825,7258,1,5,0,7264,A
4-HA,826,7358,0,2,0,7360,A
4-HA,827,0,7333,0,5,7338,T
4-HA,828,7344,0,7,0,7351,A
4-HA,829,3,1,0,7342,7346,C
4-HA,830,4,11,7314,1,7330,G
4-HA,831,7319,2,6,0,7327,A
4-HA,832,7307,0,9,0,7316,A
4-HA,833,1,1,7428,0,7430,G
4-HA,834,1,7402,0,4,7407,T
4-HA,835,7,16,7397,2,7422,G
4-HA,836,4,9,7424,1,7438,G
4-HA,837,2,7,7445,0,7454,G
4-HA,838,7425,2,9,2,7438,A
4-HA,839,7462,0,3,1,7466,A
4-HA,840,7468,1,11,0,7480,A
4-HA,841,7434,1,15,1,7451,A
4-HA,842,3,2,7634,0,7639,G
4-HA,843,1,3,0,7604,7608,C
4-HA,844,1,7514,2,12,7529,T
4-HA,845,24,0,0,7649,7673,C
4-HA,846,7673,0,6,0,7679,A
4-HA,847,7745,1,2,0,7748,A
4-HA,848,0,7731,0,3,7734,T
4-HA,849,7800,1,3,0,7804,A
4-HA,850,7794,1,5,0,7800,A
4-HA,851,0,7574,0,3,7577,T
4-HA,852,1,26,7569,0,7596,G
4-HA,853,7474,1,4,1,7480,A
4-HA,854,1,14,7752,0,7767,G
4-HA,855,7765,0,5,0,7770,A
4-HA,856,2,7667,4,7,7680,T
4-HA,857,24,2,0,7850,7876,C
4-HA,858,7825,1,5,0,7831,A
4-HA,859,4,6,7991,0,8001,G
4-HA,860,7989,0,4,1,7994,A
4-HA,861,2,7968,0,6,7976,T
4-HA,862,3,5,7962,1,7971,G
4-HA,863,3,2,1,7781,7787,C
4-HA,864,7794,0,11,0,7805,A
4-HA,865,2,5,0,7949,7956,C
4-HA,866,15,2,0,7798,7815,C
4-HA,867,14,2,2,7850,7868,C
4-HA,868,7698,0,2,1,7701,A
4-HA,869,2,7642,2,7,7653,T
4-HA,870,1,7657,0,10,7668,T
4-HA,871,2,15,7736,0,7753,G
4-HA,872,4,1,7730,0,7735,G
4-HA,873,1,1,0,7753,7755,C
4-HA,874,7566,0,1,0,7567,A
4-HA,875,7533,0,4,0,7537,A
4-HA,876,7715,2,3,0,7720,A
4-HA,877,1,7722,0,5,7728,T
4-HA,878,5,5,7721,0,7731,G
4-HA,879,3,1,0,7704,7708,C
4-HA,880,7600,0,1,1,7602,A
4-HA,881,7850,1,3,0,7854,A
4-HA,882,0,7826,2,6,7834,T
4-HA,883,1,7882,0,3,7886,T
4-HA,884,11,2,1,7905,7919,C
4-HA,885,1,7711,1,6,7719,T
4-HA,886,2,27,7787,1,7817,G
4-HA,887,7788,1,4,0,7793,A
4-HA,888,7825,2,6,0,7833,A
4-HA,889,0,7830,0,6,7836,T
4-HA,890,4,3,7677,0,7684,G
4-HA,891,1,2,0,7703,7706,C
4-HA,892,7692,0,4,0,7696,A
4-HA,893,1,7639,0,6,7646,T
4-HA,894,22,4,0,7640,7666,C
4-HA,895,7645,0,9,0,7654,A
4-HA,896,1,1,0,7998,8000,C
4-HA,897,1,7894,0,8,7903,T
4-HA,898,19,0,0,7959,7978,C
4-HA,899,15,1,0,7934,7950,C
4-HA,900,8003,0,7,0,8010,A
4-HA,901,7965,1,17,0,7983,A
4-HA,902,7970,1,4,0,7975,A
4-HA,903,1,7548,0,7,7556,T
4-HA,904,1,11,7584,0,7596,G
4-HA,905,3,5,7596,0,7604,G
4-HA,906,7642,1,5,0,7648,A
4-HA,907,7608,1,10,0,7619,A
4-HA,908,4,4,7629,1,7638,G
4-HA,909,0,3,0,7529,7532,C
4-HA,910,7481,1,4,1,7487,A
4-HA,911,0,7480,0,5,7485,T
4-HA,912,0,7431,2,7,7440,T
4-HA,913,16,3,0,7663,7682,C
4-HA,914,11,3,0,7644,7658,C
4-HA,915,19,4,0,7638,7661,C
4-HA,916,7654,0,6,0,7660,A
4-HA,917,7724,0,5,28,7757,A
4-HA,918,0,7843,0,10,7853,T
4-HA,919,3,24,7816,2,7845,G
4-HA,920,7831,0,13,0,7844,A
4-HA,921,1,2,0,7829,7832,C
4-HA,922,7533,0,4,0,7537,A
4-HA,923,7550,1,3,0,7554,A
4-HA,924,7526,3,7,1,7537,A
4-HA,925,0,1,0,7579,7580,C
4-HA,926,18,2,0,7422,7442,C
4-HA,927,7252,1,4,0,7257,A
4-HA,928,0,7244,2,6,7252,T
4-HA,929,5,7187,0,5,7197,T
4-HA,930,19,5,0,7266,7290,C
4-HA,931,15,4,0,7278,7297,C
4-HA,932,7286,0,1,0,7287,A
4-HA,933,7275,0,2,0,7277,A
4-HA,934,7224,0,0,0,7224,A
4-HA,935,7377,1,4,1,7383,A
4-HA,936,0,7299,0,1,7300,T
4-HA,937,1,0,7345,1,7347,G
4-HA,938,1,7302,1,6,7310,T
4-HA,939,7327,0,4,0,7331,A
4-HA,940,7320,0,3,0,7323,A
4-HA,941,7315,1,7,0,7323,A
4-HA,942,0,4,0,7371,7375,C
4-HA,943,7193,1,4,1,7199,A
4-HA,944,2,11,7265,0,7278,G
4-HA,945,1,17,7239,2,7259,G
4-HA,946,7307,2,9,0,7318,A
4-HA,947,2,7314,1,3,7320,T
4-HA,948,20,3,1,7352,7376,C
4-HA,949,7413,0,8,0,7421,A
4-HA,950,2,7,0,7616,7625,C
4-HA,951,7605,0,4,0,7609,A
4-HA,952,0,7795,0,2,7797,T
4-HA,953,7519,0,4,0,7523,A
4-HA,954,2,5,0,7435,7442,C
4-HA,955,7,21,7141,0,7169,G
4-HA,956,7,8,7176,0,7191,G
4-HA,957,5,6,7112,0,7123,G
4-HA,958,1,2,7160,1,7164,G
4-HA,959,1,1,0,6904,6906,C
4-HA,960,7,4,0,6888,6899,C
4-HA,961,0,6673,3,2,6678,T
4-HA,962,2,1,7216,0,7219,G
4-HA,963,6,7165,1,6,7178,T
4-HA,964,22,2,0,7207,7231,C
4-HA,965,9,0,1,7210,7220,C
4-HA,966,16,5,0,7182,7203,C
4-HA,967,7103,3,15,1,7122,A
4-HA,968,1,3,7182,1,7187,G
4-HA,969,7149,1,1,0,7151,A
4-HA,970,0,7129,0,3,7132,T
4-HA,971,6300,1,4,1,6306,A
4-HA,972,0,6169,1,3,6173,T
4-HA,973,3,3,6189,0,6195,G
4-HA,974,1,6158,1,3,6163,T
4-HA,975,1,6029,0,1,6031,T
4-HA,976,6087,0,2,0,6089,A
4-HA,977,5991,1,4,0,5996,A
4-HA,978,1,9,6038,0,6048,G
4-HA,979,2,0,0,6027,6029,C
4-HA,980,5874,1,1,0,5876,A
4-HA,981,5863,0,3,0,5866,A
4-HA,982,5794,0,4,1,5799,A
4-HA,983,5795,0,12,0,5807,A
4-HA,984,2,0,0,5809,5811,C
4-HA,985,5716,1,2,0,5719,A
4-HA,986,1,1,0,5774,5776,C
4-HA,987,2,5546,0,14,5562,T
4-HA,988,8,0,0,5622,5630,C
4-HA,989,1,5601,2,4,5608,T
4-HA,990,2,7,5651,0,5660,G
4-HA,991,5645,0,1,1,5647,A
4-HA,992,5625,0,2,1,5628,A
4-HA,993,5625,1,5,0,5631,A
4-HA,994,0,5565,1,1,5567,T
4-HA,995,1,5435,0,2,5438,T
4-HA,996,1,12,5476,0,5489,G
4-HA,997,2,4,5458,1,5465,G
4-HA,998,0,5,0,5461,5466,C
4-HA,999,5409,0,3,0,5412,A
4-HA,1000,5431,1,5,0,5437,A
4-HA,1001,1,1,0,5416,5418,C
4-HA,1002,5402,0,6,0,5408,A
4-HA,1003,2,12,5441,0,5455,G
4-HA,1004,1,6,5396,0,5403,G
4-HA,1005,3,7,5344,0,5354,G
4-HA,1006,5340,1,8,0,5349,A
4-HA,1007,1,5308,0,3,5312,T
4-HA,1008,1,1,5322,0,5324,G
4-HA,1009,5,5,1,5294,5305,C
4-HA,1010,3,15,5302,0,5320,G
4-HA,1011,5379,0,5,1,5385,A
4-HA,1012,5192,1,5,1,5199,A
4-HA,1013,5263,0,7,0,5270,A
4-HA,1014,0,5131,0,5,5136,T
4-HA,1015,37,2,5184,0,5223,G
4-HA,1016,1,5212,0,3,5216,T
4-HA,1017,5181,0,6,0,5187,A
4-HA,1018,1,3,1,5160,5165,C
4-HA,1019,5,1,2,5106,5114,C
4-HA,1020,4910,0,5,0,4915,A
4-HA,1021,1,16,4897,0,4914,G
4-HA,1022,4739,0,6,0,4745,A
4-HA,1023,10,4,4815,1,4830,G
4-HA,1024,4656,0,3,1,4660,A
4-HA,1025,4650,0,2,0,4652,A
4-HA,1026,4659,0,9,0,4668,A
4-HA,1027,1,4,0,4642,4647,C
4-HA,1028,4584,0,3,1,4588,A
4-HA,1029,4656,0,0,0,4656,A
4-HA,1030,4633,1,1,0,4635,A
4-HA,1031,2,3,1,4689,4695,C
4-HA,1032,0,4598,0,2,4600,T
4-HA,1033,4512,0,5,0,4517,A
4-HA,1034,1,2,4522,0,4525,G
4-HA,1035,4404,1,9,0,4414,A
4-HA,1036,1,7,4554,0,4562,G
4-HA,1037,3,2,4537,0,4542,G
4-HA,1038,4,2,0,4388,4394,C
4-HA,1039,4390,0,4,0,4394,A
4-HA,1040,1,4330,1,2,4334,T
4-HA,1041,4374,1,1,0,4376,A
4-HA,1042,0,4347,0,1,4348,T
4-HA,1043,0,4290,0,0,4290,T
4-HA,1044,0,4298,0,4,4302,T
4-HA,1045,3,11,4066,1,4081,G
4-HA,1046,0,0,4084,0,4084,G
4-HA,1047,7,4,0,4051,4062,C
4-HA,1048,1,1,4053,0,4055,G
4-HA,1049,3,3,0,3990,3996,C
4-HA,1050,3938,0,2,0,3940,A
4-HA,1051,3975,1,0,1,3977,A
4-HA,1052,1,3948,1,3,3953,T
4-HA,1053,12,3,1,3954,3970,C
4-HA,1054,3,3,3972,0,3978,G
4-HA,1055,0,5,0,3936,3941,C
4-HA,1056,3,15,3934,0,3952,G
4-HA,1057,1,5,3971,0,3977,G
4-HA,1058,0,1,4003,0,4004,G
4-HA,1059,2,3967,0,5,3974,T
4-HA,1060,0,3880,0,2,3882,T
4-HA,1061,0,3864,0,10,3874,T
4-HA,1062,9,0,0,3875,3884,C
4-HA,1063,3889,0,6,0,3895,A
4-HA,1064,0,3882,1,1,3884,T
4-HA,1065,3873,1,3,0,3877,A
4-HA,1066,2,5,3898,0,3905,G
4-HA,1067,3649,0,1,0,3650,A
4-HA,1068,3643,1,3,0,3647,A
4-HA,1069,3634,0,3,0,3637,A
4-HA,1070,3659,1,6,0,3666,A
4-HA,1071,0,3611,0,0,3611,T
4-HA,1072,2,11,3633,0,3646,G
4-HA,1073,0,0,3657,0,3657,G
4-HA,1074,0,3585,0,3,3588,T
4-HA,1075,3,3380,0,2,3385,T
4-HA,1076,1,9,3373,0,3383,G
4-HA,1077,1,2,3333,1,3337,G
4-HA,1078,1,2,3354,0,3357,G
4-HA,1079,3198,4,5,0,3207,A
4-HA,1080,1,6,3252,0,3259,G
4-HA,1081,0,4,3107,1,3112,G
4-HA,1082,0,5,3156,0,3161,G
4-HA,1083,3110,0,6,0,3116,A
4-HA,1084,3164,0,5,0,3169,A
4-HA,1085,0,3137,0,5,3142,T
4-HA,1086,1,2,3159,0,3162,G
4-HA,1087,1,0,3236,0,3237,G
4-HA,1088,2,3183,0,2,3187,T
4-HA,1089,2,6,3157,0,3165,G
4-HA,1090,3,2,3135,0,3140,G
4-HA,1091,3050,0,5,0,3055,A
4-HA,1092,1,3062,0,1,3064,T
4-HA,1093,2,4,3090,1,3097,G
4-HA,1094,0,1,3144,0,3145,G
4-HA,1095,0,3071,0,1,3072,T
4-HA,1096,0,2980,1,2,2983,T
4-HA,1097,1,4,2975,0,2980,G
4-HA,1098,0,0,3031,0,3031,G
4-HA,1099,0,3021,1,3,3025,T
4-HA,1100,3030,0,2,0,3032,A
4-HA,1101,1,1,0,2867,2869,C
4-HA,1102,2,2,2894,1,2899,G
4-HA,1103,0,2,3026,0,3028,G
4-HA,1104,0,3030,0,5,3035,T
4-HA,1105,1,3021,0,2,3024,T
4-HA,1106,0,3023,1,2,3026,T
4-HA,1107,4,1,0,2958,2963,C
4-HA,1108,2955,0,5,0,2960,A
4-HA,1109,2,4,2960,0,2966,G
4-HA,1110,2,1,2954,0,2957,G
4-HA,1111,2,0,0,2932,2934,C
4-HA,1112,2808,0,0,0,2808,A
4-HA,1113,0,2825,1,2,2828,T
4-HA,1114,3,2,0,2845,2850,C
4-HA,1115,2853,1,0,0,2854,A
4-HA,1116,2864,0,0,0,2864,A
4-HA,1117,2859,0,0,0,2859,A
4-HA,1118,2878,0,0,0,2878,A
4-HA,1119,0,2866,0,2,2868,T
4-HA,1120,0,2863,0,1,2864,T
4-HA,1121,4,0,0,2874,2878,C
4-HA,1122,1,2818,0,2,2821,T
4-HA,1123,1,4,2829,0,2834,G
4-HA,1124,2814,0,4,0,2818,A
4-HA,1125,5,7,2835,0,2847,G
4-HA,1126,0,7,2843,0,2850,G
4-HA,1127,3,6,2857,0,2866,G
4-HA,1128,2847,1,3,0,2851,A
4-HA,1129,2859,0,0,0,2859,A
4-HA,1130,3,4,2822,0,2829,G
4-HA,1131,2878,0,7,0,2885,A
4-HA,1132,2,10,2924,0,2936,G
4-HA,1133,1,2,2940,0,2943,G
4-HA,1134,2919,1,10,0,2930,A
4-HA,1135,2,0,0,2921,2923,C
4-HA,1136,2882,0,8,0,2890,A
4-HA,1137,2878,0,11,0,2889,A
4-HA,1138,1,0,2886,0,2887,G
4-HA,1139,1,2,1,2906,2910,C
4-HA,1140,2853,0,1,1,2855,A
4-HA,1141,1,0,2851,0,2852,G
4-HA,1142,5,1,0,2830,2836,C
4-HA,1143,2820,0,4,0,2824,A
4-HA,1144,0,4,2857,0,2861,G
4-HA,1145,2803,0,3,0,2806,A
4-HA,1146,0,2896,0,1,2897,T
4-HA,1147,2,2,0,2900,2904,C
4-HA,1148,1,2876,0,3,2880,T
4-HA,1149,4,1,0,2925,2930,C
4-HA,1150,2924,0,2,0,2926,A
4-HA,1151,2923,0,0,2,2925,A
4-HA,1152,2917,1,3,0,2921,A
4-HA,1153,2857,0,9,0,2866,A
4-HA,1154,1,0,2864,0,2865,G
4-HA,1155,0,2,0,2789,2791,C
4-HA,1156,2772,0,0,0,2772,A
4-HA,1157,1,1,0,2819,2821,C
4-HA,1158,0,2790,1,2,2793,T
4-HA,1159,5,2,0,2805,2812,C
4-HA,1160,2805,0,1,0,2806,A
4-HA,1161,2857,1,7,0,2865,A
4-HA,1162,2,1,2871,0,2874,G
4-HA,1163,1,1,0,2862,2864,C
4-HA,1164,2836,1,2,0,2839,A
4-HA,1165,0,0,2849,0,2849,G
4-HA,1166,2,0,0,2771,2773,C
4-HA,1167,2770,0,0,0,2770,A
4-HA,1168,2763,1,2,0,2766,A
4-HA,1169,0,2741,1,2,2744,T
4-HA,1170,3,1,0,2721,2725,C
4-HA,1171,3,7,2733,0,2743,G
4-HA,1172,2735,4,2,0,2741,A
4-HA,1173,2,2713,0,2,2717,T
4-HA,1174,5,2,1,2691,2699,C
4-HA,1175,2689,0,1,0,2690,A
4-HA,1176,2755,0,2,0,2757,A
4-HA,1177,2765,0,0,0,2765,A
4-HA,1178,0,2750,0,0,2750,T
4-HA,1179,8,1,0,2752,2761,C
4-HA,1180,2713,0,2,0,2715,A
4-HA,1181,2745,0,3,0,2748,A
4-HA,1182,0,2740,0,5,2745,T
4-HA,1183,0,9,2739,0,2748,G
4-HA,1184,1,3,2742,1,2747,G
4-HA,1185,0,3,2703,0,2706,G
4-HA,1186,2704,2,6,1,2713,A
4-HA,1187,2718,0,4,0,2722,A
4-HA,1188,0,0,2784,0,2784,G
4-HA,1189,0,2,0,2788,2790,C
4-HA,1190,0,2745,0,2,2747,T
4-HA,1191,0,4,2896,0,2900,G
4-HA,1192,2887,0,6,0,2893,A
4-HA,1193,2892,0,6,1,2899,A
4-HA,1194,1,2893,0,1,2895,T
4-HA,1195,2821,0,2,0,2823,A
4-HA,1196,0,2,2814,0,2816,G
4-HA,1197,2543,0,3,0,2546,A
4-HA,1198,1,2574,0,3,2578,T
4-HA,1199,0,2582,0,1,2583,T
4-HA,1200,0,6,2584,0,2590,G
4-HA,1201,2560,1,0,0,2561,A
4-HA,1202,1,2561,0,2,2564,T
4-HA,1203,4,1,0,2571,2576,C
4-HA,1204,6,1,2554,0,2561,G
4-HA,1205,1,4,2558,0,2563,G
4-HA,1206,0,4,2573,0,2577,G
4-HA,1207,2570,0,0,0,2570,A
4-HA,1208,2573,2,0,0,2575,A
4-HA,1209,2544,0,6,0,2550,A
4-HA,1210,2567,0,5,0,2572,A
4-HA,1211,0,1,0,2579,2580,C
4-HA,1212,2,2,0,2570,2574,C
4-HA,1213,2548,0,1,1,2550,A
4-HA,1214,2553,0,2,0,2555,A
4-HA,1215,0,3,0,2557,2560,C
4-HA,1216,0,6,2560,0,2566,G
4-HA,1217,2553,0,1,1,2555,A
4-HA,1218,0,3,2555,0,2558,G
4-HA,1219,2547,0,2,0,2549,A
4-HA,1220,2548,0,2,0,2550,A
4-HA,1221,2546,0,1,0,2547,A
4-HA,1222,0,2563,0,7,2570,T
4-HA,1223,0,2557,1,3,2561,T
4-HA,1224,3,0,0,2573,2576,C
4-HA,1225,3,0,0,2554,2557,C
4-HA,1226,2548,0,2,0,2550,A
4-HA,1227,2,2537,1,1,2541,T
4-HA,1228,2,1,0,2550,2553,C
4-HA,1229,2522,1,1,0,2524,A
4-HA,1230,0,2,2551,0,2553,G
4-HA,1231,2534,0,2,0,2536,A
4-HA,1232,0,2539,0,1,2540,T
4-HA,1233,0,2505,0,3,2508,T
4-HA,1234,0,1,2536,0,2537,G
4-HA,1235,2532,0,3,0,2535,A
4-HA,1236,2535,0,2,0,2537,A
4-HA,1237,2531,0,6,0,2537,A
4-HA,1238,2540,1,0,0,2541,A
4-HA,1239,2497,0,7,0,2504,A
4-HA,1240,0,3,2496,0,2499,G
4-HA,1241,2490,0,1,0,2491,A
4-HA,1242,2499,0,0,0,2499,A
4-HA,1243,1,2443,0,2,2446,T
4-HA,1244,0,2445,0,2,2447,T
4-HA,1245,5,1,0,2456,2462,C
4-HA,1246,0,2458,0,0,2458,T
4-HA,1247,4,2,0,2454,2460,C
4-HA,1248,2457,0,2,0,2459,A
4-HA,1249,0,0,2462,0,2462,G
4-HA,1250,2444,0,2,0,2446,A
4-HA,1251,2427,0,4,0,2431,A
4-HA,1252,1,0,2493,0,2494,G
4-HA,1253,0,2461,0,4,2465,T
4-HA,1254,7,3,0,2461,2471,C
4-HA,1255,1,2,2473,0,2476,G
4-HA,1256,2459,0,5,0,2464,A
4-HA,1257,2472,0,1,0,2473,A
4-HA,1258,2,12,2459,0,2473,G
4-HA,1259,0,3,2466,0,2469,G
4-HA,1260,0,2,2467,0,2469,G
4-HA,1261,2376,0,4,0,2380,A
4-HA,1262,0,2,2379,0,2381,G
4-HA,1263,3,5,2350,0,2358,G
4-HA,1264,2563,0,0,0,2563,A
4-HA,1265,1,2577,0,0,2578,T
4-HA,1266,0,2569,1,1,2571,T
4-HA,1267,11,0,0,2563,2574,C
4-HA,1268,2517,0,12,0,2529,A
4-HA,1269,4,3,2520,0,2527,G
4-HA,1270,1,7,2513,0,2521,G
4-HA,1271,2512,1,1,0,2514,A
4-HA,1272,0,0,0,2512,2512,C
4-HA,1273,3,2,1,2177,2183,C
4-HA,1274,0,2156,0,2,2158,T
4-HA,1275,1,2064,0,93,2158,T
4-HA,1276,2,3,2181,0,2186,G
4-HA,1277,2169,1,2,0,2172,A
4-HA,1278,1,2,2242,0,2245,G
4-HA,1279,2201,0,0,1,2202,A
4-HA,1280,1882,0,2,0,1884,A
4-HA,1281,1873,1,2,0,1876,A
4-HA,1282,0,1828,0,1,1829,T
4-HA,1283,1898,0,2,0,1900,A
4-HA,1284,1,1870,0,16,1887,T
4-HA,1285,0,0,1890,0,1890,G
4-HA,1286,0,1883,0,3,1886,T
4-HA,1287,0,1828,0,1,1829,T
4-HA,1288,1,6,1817,0,1824,G
4-HA,1289,1795,0,2,1,1798,A
4-HA,1290,0,2,1817,1,1820,G
4-HA,1291,1,5,1803,0,1809,G
4-HA,1292,1763,1,0,1,1765,A
4-HA,1293,0,2,0,1822,1824,C
4-HA,1294,1800,0,6,0,1806,A
4-HA,1295,0,0,0,1893,1893,C
4-HA,1296,6,3,0,1888,1897,C
4-HA,1297,1900,0,2,0,1902,A
4-HA,1298,1956,0,0,0,1956,A
4-HA,1299,1950,1,1,0,1952,A
4-HA,1300,1975,0,2,0,1977,A
4-HA,1301,0,1974,1,0,1975,T
4-HA,1302,1920,0,0,0,1920,A
4-HA,1303,1,2,1930,0,1933,G
4-HA,1304,1878,0,0,0,1878,A
4-HA,1305,0,1911,0,1,1912,T
4-HA,1306,0,0,0,1924,1924,C
4-HA,1307,0,1871,0,2,1873,T
4-HA,1308,4,0,0,1950,1954,C
4-HA,1309,0,1937,0,3,1940,T
4-HA,1310,0,2,1981,0,1983,G
4-HA,1311,0,2,2014,0,2016,G
4-HA,1312,0,2013,0,0,2013,T
4-HA,1313,8,3,0,1994,2005,C
4-HA,1314,2025,0,3,0,2028,A
4-HA,1315,0,2040,0,1,2041,T
4-HA,1316,2040,0,2,0,2042,A
4-HA,1317,0,1,0,2034,2035,C
4-HA,1318,1982,0,2,0,1984,A
4-HA,1319,1996,1,5,0,2002,A
4-HA,1320,0,2,0,1961,1963,C
4-HA,1321,0,0,1951,0,1951,G
4-HA,1322,2,0,0,1950,1952,C
4-HA,1323,1,2,1943,0,1946,G
4-HA,1324,0,4,1952,0,1956,G
4-HA,1325,1940,0,4,0,1944,A
4-HA,1326,0,0,1980,1,1981,G
4-HA,1327,1,0,0,1986,1987,C
4-HA,1328,0,1974,1,3,1978,T
4-HA,1329,0,2003,0,5,2008,T
4-HA,1330,2,0,0,2003,2005,C
4-HA,1331,0,2020,0,1,2021,T
4-HA,1332,0,2025,0,0,2025,T
4-HA,1333,1,0,2013,0,2014,G
4-HA,1334,0,2003,0,4,2007,T
4-HA,1335,0,1955,0,1,1956,T
4-HA,1336,0,1,1986,0,1987,G
4-HA,1337,0,1,0,1980,1981,C
4-HA,1338,4,0,0,1959,1963,C
4-HA,1339,6,3,0,1975,1984,C
4-HA,1340,0,1964,0,2,1966,T
4-HA,1341,1,0,1985,0,1986,G
4-HA,1342,0,6,1988,0,1994,G
4-HA,1343,1973,0,4,0,1977,A
4-HA,1344,0,3,2002,0,2005,G
4-HA,1345,1966,0,2,0,1968,A
4-HA,1346,1977,1,4,0,1982,A
4-HA,1347,0,4,0,2012,2016,C
4-HA,1348,3,0,0,2015,2018,C
4-HA,1349,2013,0,1,0,2014,A
4-HA,1350,2106,1,0,0,2107,A
4-HA,1351,0,4,1,2106,2111,C
4-HA,1352,2116,0,1,1,2118,A
4-HA,1353,0,2122,0,2,2124,T
4-HA,1354,2108,1,4,0,2113,A
4-HA,1355,0,1,0,2157,2158,C
4-HA,1356,2098,0,0,0,2098,A
4-HA,1357,2098,0,4,0,2102,A
4-HA,1358,0,2093,0,1,2094,T
4-HA,1359,0,2001,0,2,2003,T
4-HA,1360,0,6,2013,0,2019,G
4-HA,1361,2044,0,0,0,2044,A
4-HA,1362,1,2017,0,2,2020,T
4-HA,1363,5,1,0,2057,2063,C
4-HA,1364,0,2002,0,1,2003,T
4-HA,1365,2039,0,1,0,2040,A
4-HA,1366,2039,0,4,0,2043,A
4-HA,1367,0,0,0,2040,2040,C
4-HA,1368,0,2013,0,3,2016,T
4-HA,1369,0,9,2001,0,2010,G
4-HA,1370,2010,0,3,0,2013,A
4-HA,1371,0,0,0,2011,2011,C
4-HA,1372,1,1969,0,2,1972,T
4-HA,1373,6,0,1,2007,2014,C
4-HA,1374,2002,1,1,0,2004,A
4-HA,1375,0,1,2055,0,2056,G
4-HA,1376,2048,0,3,0,2051,A
4-HA,1377,2038,0,0,0,2038,A
4-HA,1378,2053,2,2,0,2057,A
4-HA,1379,0,2038,0,2,2040,T
4-HA,1380,0,9,2060,0,2069,G
4-HA,1381,2063,0,1,0,2064,A
4-HA,1382,2069,0,2,1,2072,A
4-HA,1383,0,0,0,2077,2077,C
4-HA,1384,2031,0,0,0,2031,A
4-HA,1385,2023,0,0,0,2023,A
4-HA,1386,2020,0,1,0,2021,A
4-HA,1387,0,0,0,2036,2036,C
4-HA,1388,0,2010,0,3,2013,T
4-HA,1389,0,0,2035,0,2035,G
4-HA,1390,1,1998,0,4,2003,T
4-HA,1391,0,1995,0,3,1998,T
4-HA,1392,1,2003,0,0,2004,T
4-HA,1393,1,3,2012,0,2016,G
4-HA,1394,2001,0,1,0,2002,A
4-HA,1395,2011,0,0,0,2011,A
4-HA,1396,1994,1,1,0,1996,A
4-HA,1397,1993,0,2,0,1995,A
4-HA,1398,1981,0,1,0,1982,A
4-HA,1399,1996,0,3,0,1999,A
4-HA,1400,0,1,0,2006,2007,C
4-HA,1401,2006,0,0,0,2006,A
4-HA,1402,2005,0,1,0,2006,A
4-HA,1403,2002,0,4,0,2006,A
4-HA,1404,0,0,2024,0,2024,G
4-HA,1405,2023,0,2,0,2025,A
4-HA,1406,2027,0,4,0,2031,A
4-HA,1407,0,0,2033,0,2033,G
4-HA,1408,1,3,0,2023,2027,C
4-HA,1409,2022,0,2,0,2024,A
4-HA,1410,2035,1,3,2,2041,A
4-HA,1411,0,0,0,2045,2045,C
4-HA,1412,0,2025,0,2,2027,T
4-HA,1413,1,1,2044,0,2046,G
4-HA,1414,1997,0,3,0,2000,A
4-HA,1415,2,4,2044,0,2050,G
4-HA,1416,1,3,2045,0,2049,G
4-HA,1417,0,4,2035,1,2040,G
4-HA,1418,2040,0,1,0,2041,A
4-HA,1419,2036,1,0,0,2037,A
4-HA,1420,2039,0,2,0,2041,A
4-HA,1421,2092,0,0,0,2092,A
4-HA,1422,0,2077,0,0,2077,T
4-HA,1423,0,1,2098,0,2099,G
4-HA,1424,0,2,0,2102,2104,C
4-HA,1425,1,2066,0,2,2069,T
4-HA,1426,1,2,2083,0,2086,G
4-HA,1427,2082,0,4,0,2086,A
4-HA,1428,0,3,2232,0,2235,G
4-HA,1429,2,0,2272,0,2274,G
4-HA,1430,2235,0,1,1,2237,A
4-HA,1431,0,2226,0,0,2226,T
4-HA,1432,2205,1,3,0,2209,A
4-HA,1433,2,2185,0,4,2191,T
4-HA,1434,2,7,2224,1,2234,G
4-HA,1435,0,4,2250,0,2254,G
4-HA,1436,2,0,2243,0,2245,G
4-HA,1437,1,0,1,2134,2136,C
4-HA,1438,2092,0,0,0,2092,A
4-HA,1439,2087,0,3,0,2090,A
4-HA,1440,0,2091,0,1,2092,T
4-HA,1441,3,1,2102,0,2106,G
4-HA,1442,0,1,2103,0,2104,G
4-HA,1443,0,2057,0,3,2060,T
4-HA,1444,0,2022,0,0,2022,T
4-HA,1445,0,0,2030,0,2030,G
4-HA,1446,0,2036,0,3,2039,T
4-HA,1447,1,2026,0,3,2030,T
4-HA,1448,0,2038,0,2,2040,T
4-HA,1449,5,1,0,2048,2054,C
4-HA,1450,2050,0,1,1,2052,A
4-HA,1451,2060,0,1,0,2061,A
4-HA,1452,2052,0,3,0,2055,A
4-HA,1453,2102,1,2,1,2106,A
4-HA,1454,0,2082,0,1,2083,T
4-HA,1455,2075,0,2,0,2077,A
4-HA,1456,0,2085,0,0,2085,T
4-HA,1457,2081,0,1,0,2082,A
4-HA,1458,0,2,0,2129,2131,C
4-HA,1459,9,0,0,2101,2110,C
4-HA,1460,2107,0,2,0,2109,A
4-HA,1461,0,1,0,2118,2119,C
4-HA,1462,2107,0,2,0,2109,A
4-HA,1463,2115,0,1,0,2116,A
4-HA,1464,2121,0,2,0,2123,A
4-HA,1465,0,2131,0,0,2131,T
4-HA,1466,0,0,2140,0,2140,G
4-HA,1467,0,2106,0,3,2109,T
4-HA,1468,1,5,2126,0,2132,G
4-HA,1469,2139,0,5,0,2144,A
4-HA,1470,1,0,0,2138,2139,C
4-HA,1471,2104,0,0,0,2104,A
4-HA,1472,2105,0,2,0,2107,A
4-HA,1473,0,2139,2,1,2142,T
4-HA,1474,5,0,2144,0,2149,G
4-HA,1475,0,0,0,2140,2140,C
4-HA,1476,1,2,0,2152,2155,C
4-HA,1477,0,2138,0,4,2142,T
4-HA,1478,1,0,2250,0,2251,G
4-HA,1479,1,0,0,2254,2255,C
4-HA,1480,2251,0,2,0,2253,A
4-HA,1481,0,2248,0,0,2248,T
4-HA,1482,2173,0,1,1,2175,A
4-HA,1483,2,3,2196,0,2201,G
4-HA,1484,1,2,2187,0,2190,G
4-HA,1485,2180,0,2,0,2182,A
4-HA,1486,0,2166,0,2,2168,T
4-HA,1487,10,1,0,2039,2050,C
4-HA,1488,2062,0,0,0,2062,A
4-HA,1489,2066,0,1,0,2067,A
4-HA,1490,0,2054,0,2,2056,T
4-HA,1491,6,2,0,2066,2074,C
4-HA,1492,2027,0,3,0,2030,A
4-HA,1493,0,4,2050,0,2054,G
4-HA,1494,2052,0,1,0,2053,A
4-HA,1495,2059,0,1,0,2060,A
4-HA,1496,2060,0,2,0,2062,A
4-HA,1497,1,2047,0,0,2048,T
4-HA,1498,1,4,2029,0,2034,G
4-HA,1499,0,3,2042,0,2045,G
4-HA,1500,2034,0,3,0,2037,A
4-HA,1501,2064,0,2,0,2066,A
4-HA,1502,0,0,0,2063,2063,C
4-HA,1503,0,2025,0,5,2030,T
4-HA,1504,0,2041,0,4,2045,T
4-HA,1505,2046,0,1,1,2048,A
4-HA,1506,0,2040,0,1,2041,T
4-HA,1507,5,8,2030,0,2043,G
4-HA,1508,2036,0,2,0,2038,A
4-HA,1509,1,2,0,2049,2052,C
4-HA,1510,4,0,0,2021,2025,C
4-HA,1511,2018,0,1,0,2019,A
4-HA,1512,0,1,0,2079,2080,C
4-HA,1513,1,3,2151,1,2156,G
4-HA,1514,2219,0,3,0,2222,A
4-HA,1515,0,2263,0,0,2263,T
4-HA,1516,0,0,2374,0,2374,G
4-HA,1517,0,2365,1,0,2366,T
4-HA,1518,2487,0,3,0,2490,A
4-HA,1519,3,2487,1,4,2495,T
4-HA,1520,2488,0,8,0,2496,A
4-HA,1521,0,0,0,2483,2483,C
4-HA,1522,2215,0,0,0,2215,A
4-HA,1523,1,4,2244,0,2249,G
4-HA,1524,2086,1,0,0,2087,A
4-HA,1525,0,5,2016,0,2021,G
4-HA,1526,2008,0,1,0,2009,A
4-HA,1527,0,1874,0,1,1875,T
4-HA,1528,0,4,1870,0,1874,G
4-HA,1529,1864,0,2,0,1866,A
4-HA,1530,1852,0,4,0,1856,A
4-HA,1531,0,0,1919,0,1919,G
4-HA,1532,1,2,0,1870,1873,C
4-HA,1533,1865,0,1,0,1866,A
4-HA,1534,0,1860,0,3,1863,T
4-HA,1535,0,1860,0,0,1860,T
4-HA,1536,1880,0,0,0,1880,A
4-HA,1537,1873,0,2,0,1875,A
4-HA,1538,1880,0,0,0,1880,A
4-HA,1539,0,0,0,1879,1879,C
4-HA,1540,1816,0,0,0,1816,A
4-HA,1541,1813,0,3,0,1816,A
4-HA,1542,0,0,0,1812,1812,C
4-HA,1543,4,1,0,1798,1803,C
4-HA,1544,0,1,1803,0,1804,G
4-HA,1545,0,0,1853,0,1853,G
4-HA,1546,1,1864,0,0,1865,T
4-HA,1547,0,1854,0,0,1854,T
4-HA,1548,2,0,0,1845,1847,C
4-HA,1549,2,2,0,1846,1850,C
4-HA,1550,1837,0,0,0,1837,A
4-HA,1551,0,1,1876,0,1877,G
4-HA,1552,1876,0,3,0,1879,A
4-HA,1553,0,1877,0,3,1880,T
4-HA,1554,1,1,0,1797,1799,C
4-HA,1555,1786,0,2,0,1788,A
4-HA,1556,1782,0,2,0,1784,A
4-HA,1557,0,6,1781,0,1787,G
4-HA,1558,0,3,1780,0,1783,G
4-HA,1559,5,8,1774,0,1787,G
4-HA,1560,1690,3,2,0,1695,A
4-HA,1561,0,1,1729,0,1730,G
4-HA,1562,0,1731,0,1,1732,T
4-HA,1563,0,1725,0,1,1726,T
4-HA,1564,2,6,1736,0,1744,G
4-HA,1565,1708,0,2,1,1711,A
4-HA,1566,0,1,1743,0,1744,G
4-HA,1567,0,3,0,1727,1730,C
4-HA,1568,0,1714,0,5,1719,T
4-HA,1569,0,2,1723,0,1725,G
4-HA,1570,1709,0,0,0,1709,A
4-HA,1571,1718,0,1,0,1719,A
4-HA,1572,0,0,1723,0,1723,G
4-HA,1573,0,1693,0,1,1694,T
4-HA,1574,6,0,0,1687,1693,C
4-HA,1575,1661,0,0,0,1661,A
4-HA,1576,0,3,1658,0,1661,G
4-HA,1577,0,2,1645,0,1647,G
4-HA,1578,0,2,1609,0,1611,G
4-HA,1579,0,1683,0,0,1683,T
4-HA,1580,1683,0,1,0,1684,A
4-HA,1581,1,3,0,1676,1680,C
4-HA,1582,1674,0,1,0,1675,A
4-HA,1583,1672,0,0,0,1672,A
4-HA,1584,1672,0,1,0,1673,A
4-HA,1585,0,4,1695,0,1699,G
4-HA,1586,1646,0,0,0,1646,A
4-HA,1587,1,1597,0,0,1598,T
4-HA,1588,0,1569,0,1,1570,T
4-HA,1589,0,5,1560,0,1565,G
4-HA,1590,0,4,1550,0,1554,G
4-HA,1591,1561,0,0,0,1561,A
4-HA,1592,1,1564,0,1,1566,T
4-HA,1593,4,0,0,1552,1556,C
4-HA,1594,0,0,0,1529,1529,C
4-HA,1595,1,1511,0,1,1513,T
4-HA,1596,1527,0,2,0,1529,A
4-HA,1597,0,1527,0,3,1530,T
4-HA,1598,0,4,1523,0,1527,G
4-HA,1599,0,2,1517,0,1519,G
4-HA,1600,1478,0,1,0,1479,A
4-HA,1601,0,1481,0,1,1482,T
4-HA,1602,0,1437,0,4,1441,T
4-HA,1603,0,1445,0,0,1445,T
4-HA,1604,1,0,0,1446,1447,C
4-HA,1605,0,0,0,1445,1445,C
4-HA,1606,0,1424,0,2,1426,T
4-HA,1607,0,1423,0,1,1424,T
4-HA,1608,0,1401,0,1,1402,T
4-HA,1609,2,0,1415,0,1417,G
4-HA,1610,0,1,0,1411,1412,C
4-HA,1611,2,1,0,1402,1405,C
4-HA,1612,1396,0,0,0,1396,A
4-HA,1613,0,1375,1,0,1376,T
4-HA,1614,1409,0,0,1,1410,A
4-HA,1615,0,1399,0,4,1403,T
4-HA,1616,7,0,0,1387,1394,C
4-HA,1617,1395,0,1,0,1396,A
4-HA,1618,1,1376,0,2,1379,T
4-HA,1619,1,0,1394,0,1395,G
4-HA,1620,0,1387,0,2,1389,T
4-HA,1621,0,1365,0,1,1366,T
4-HA,1622,0,1349,0,5,1354,T
4-HA,1623,0,1324,0,2,1326,T
4-HA,1624,0,1320,0,1,1321,T
4-HA,1625,0,1324,0,1,1325,T
4-HA,1626,0,0,1334,0,1334,G
4-HA,1627,2,1,0,1329,1332,C
4-HA,1628,0,1284,2,0,1286,T
4-HA,1629,0,1280,0,3,1283,T
4-HA,1630,0,1284,0,0,1284,T
4-HA,1631,0,0,1302,0,1302,G
4-HA,1632,0,1297,0,2,1299,T
4-HA,1633,1,0,1294,0,1295,G
4-HA,1634,0,1296,0,2,1298,T
4-HA,1635,1,1272,0,1,1274,T
4-HA,1636,1,1,1275,0,1277,G
4-HA,1637,1,0,0,1280,1281,C
4-HA,1638,0,1273,0,1,1274,T
4-HA,1639,0,1285,0,0,1285,T
4-HA,1640,0,1211,0,0,1211,T
4-HA,1641,1,0,1217,0,1218,G
4-HA,1642,0,1217,0,0,1217,T
4-HA,1643,0,1216,0,0,1216,T
4-HA,1644,3,1,1207,0,1211,G
4-HA,1645,0,4,1175,0,1179,G
4-HA,1646,0,0,1178,0,1178,G
4-HA,1647,0,0,1181,0,1181,G
4-HA,1648,0,1133,0,2,1135,T
4-HA,1649,1,1114,0,1,1116,T
4-HA,1650,3,0,0,1108,1111,C
4-HA,1651,1094,0,0,0,1094,A
4-HA,1652,0,1101,0,1,1102,T
4-HA,1653,3,2,0,1091,1096,C
4-HA,1654,1094,0,2,0,1096,A
4-HA,1655,0,1071,0,2,1073,T
4-HA,1656,0,0,1065,0,1065,G
4-HA,1657,0,1040,0,3,1043,T
4-HA,1658,1,1,1028,0,1030,G
4-HA,1659,0,1,1010,0,1011,G
4-HA,1660,0,1,1003,0,1004,G
4-HA,1661,0,1,0,973,974,C
4-HA,1662,2,1,0,946,949,C
4-HA,1663,0,899,0,0,899,T
4-HA,1664,1,0,901,0,902,G
4-HA,1665,0,1,0,891,892,C
4-HA,1666,1,0,0,896,897,C
4-HA,1667,903,1,0,0,904,A
4-HA,1668,895,0,2,0,897,A
4-HA,1669,895,0,1,0,896,A
4-HA,1670,900,0,0,0,900,A
4-HA,1671,894,0,0,0,894,A
4-HA,1672,0,1,897,0,898,G
4-HA,1673,0,0,863,0,863,G
4-HA,1674,0,0,0,850,850,C
4-HA,1675,856,0,1,0,857,A
4-HA,1676,854,0,2,0,856,A
4-HA,1677,0,0,0,860,860,C
4-HA,1678,856,1,1,0,858,A
4-HA,1679,0,855,0,0,855,T
4-HA,1680,0,849,0,0,849,T
4-HA,1681,822,0,1,0,823,A
4-HA,1682,0,0,817,0,817,G
4-HA,1683,0,0,817,0,817,G
4-HA,1684,0,780,0,0,780,T
4-HA,1685,0,0,732,0,732,G
4-HA,1686,1,0,0,696,697,C
4-HA,1687,686,0,1,0,687,A
4-HA,1688,684,0,1,0,685,A
4-HA,1689,0,1,0,687,688,C
4-HA,1690,674,0,1,0,675,A
4-HA,1691,0,658,0,1,659,T
4-HA,1692,0,612,0,0,612,T
4-HA,1693,0,609,0,1,610,T
4-HA,1694,0,0,607,0,607,G
4-HA,1695,0,0,0,599,599,C
4-HA,1696,597,0,0,0,597,A
4-HA,1697,0,552,0,0,552,T
4-HA,1698,0,532,0,1,533,T
4-HA,1699,0,508,0,0,508,T
4-HA,1700,0,0,504,0,504,G
4-HA,1701,469,0,0,0,469,A
5-NP,1,2407,0,0,0,2407,A
5-NP,2,0,2415,0,0,2415,T
5-NP,3,0,0,2397,0,2397,G
5-NP,4,1,0,2397,0,2398,G
5-NP,5,2,1,0,2430,2433,C
5-NP,6,0,0,2486,0,2486,G
5-NP,7,0,2608,0,7,2615,T
5-NP,8,1,0,0,2640,2641,C
5-NP,9,4,0,0,2640,2644,C
5-NP,10,4,0,0,2658,2662,C
5-NP,11,2667,0,5,1,2673,A
5-NP,12,2674,0,3,0,2677,A
5-NP,13,1,10,2705,0,2716,G
5-NP,14,3,1,2801,0,2805,G
5-NP,15,0,0,0,2823,2823,C
5-NP,16,2833,0,0,1,2834,A
5-NP,17,0,1,0,2873,2874,C
5-NP,18,5,3,2,2865,2875,C
5-NP,19,2901,0,1,0,2902,A
5-NP,20,2888,0,0,0,2888,A
5-NP,21,2903,0,1,0,2904,A
5-NP,22,0,2,0,2917,2919,C
5-NP,23,2,5,2930,0,2937,G
5-NP,24,0,1,3242,0,3243,G
5-NP,25,3,3220,1,8,3232,T
5-NP,26,12,0,0,3552,3564,C
5-NP,27,0,3558,0,5,3563,T
5-NP,28,0,3614,0,1,3615,T
5-NP,29,3626,0,3,0,3629,A
5-NP,30,0,3635,0,1,3636,T
5-NP,31,1,14,3666,0,3681,G
5-NP,32,3645,0,2,0,3647,A
5-NP,33,3550,1,6,0,3557,A
5-NP,34,0,0,0,3587,3587,C
5-NP,35,3446,1,1,0,3448,A
5-NP,36,0,3,3780,0,3783,G
5-NP,37,3720,0,4,0,3724,A
5-NP,38,0,3745,0,0,3745,T
5-NP,39,0,5,3748,0,3753,G
5-NP,40,3,8,3757,0,3768,G
5-NP,41,3765,1,3,0,3769,A
5-NP,42,3793,0,4,0,3797,A
5-NP,43,3788,0,8,3,3799,A
5-NP,44,1,0,0,3930,3931,C
5-NP,45,2,3843,1,3,3849,T
5-NP,46,1,7,3910,0,3918,G
5-NP,47,3858,0,5,1,3864,A
5-NP,48,0,3873,1,5,3879,T
5-NP,49,1,12,3884,0,3897,G
5-NP,50,2,14,3885,0,3901,G
5-NP,51,0,12,3892,0,3904,G
5-NP,52,2,3,3921,0,3926,G
5-NP,53,3847,0,4,0,3851,A
5-NP,54,0,3854,0,3,3857,T
5-NP,55,13,1,0,3868,3882,C
5-NP,56,1,0,3890,0,3891,G
5-NP,57,1,0,0,3955,3956,C
5-NP,58,5,1,0,3955,3961,C
5-NP,59,3954,0,4,1,3959,A
5-NP,60,0,10,4013,0,4023,G
5-NP,61,4006,1,3,2,4012,A
5-NP,62,4106,1,2,0,4109,A
5-NP,63,1,4111,0,0,4112,T
5-NP,64,2,4,4098,0,4104,G
5-NP,65,0,3,0,4155,4158,C
5-NP,66,4123,1,2,0,4126,A
5-NP,67,4209,1,8,0,4218,A
5-NP,68,1,0,0,4216,4217,C
5-NP,69,2,4177,0,1,4180,T
5-NP,70,1,10,4206,0,4217,G
5-NP,71,4187,1,13,0,4201,A
5-NP,72,1,3,4504,0,4508,G
5-NP,73,4470,1,9,0,4480,A
5-NP,74,0,4444,0,0,4444,T
5-NP,75,0,4429,0,0,4429,T
5-NP,76,4426,1,2,0,4429,A
5-NP,77,1,12,4447,0,4460,G
5-NP,78,1,11,4440,0,4452,G
5-NP,79,3,2,4436,0,4441,G
5-NP,80,0,1,0,4379,4380,C
5-NP,81,4294,0,1,0,4295,A
5-NP,82,2,4286,0,7,4295,T
5-NP,83,7,0,0,4311,4318,C
5-NP,84,8,0,1,4321,4330,C
5-NP,85,3,0,4392,0,4395,G
5-NP,86,0,4355,0,8,4363,T
5-NP,87,11,0,0,4364,4375,C
5-NP,88,3,12,4376,0,4391,G
5-NP,89,3,2,4403,0,4408,G
5-NP,90,3,5,4444,0,4452,G
5-NP,91,4395,3,2,1,4401,A
5-NP,92,4409,2,5,0,4416,A
5-NP,93,3,7,4456,0,4466,G
5-NP,94,4398,0,4,0,4402,A
5-NP,95,1,4415,0,1,4417,T
5-NP,96,0,9,4502,0,4511,G
5-NP,97,4480,0,10,0,4490,A
5-NP,98,0,4499,0,2,4501,T
5-NP,99,0,4472,0,1,4473,T
5-NP,100,77,11,4396,0,4484,G
5-NP,101,4475,1,5,0,4481,A
5-NP,102,0,4474,0,1,4475,T
5-NP,103,1,7,4477,0,4485,G
5-NP,104,4,10,4628,0,4642,G
5-NP,105,4608,0,3,0,4611,A
5-NP,106,4656,0,2,1,4659,A
5-NP,107,1,4640,0,1,4642,T
5-NP,108,0,4648,0,0,4648,T
5-NP,109,0,10,4646,0,4656,G
5-NP,110,0,8,4612,0,4620,G
5-NP,111,1,3,4628,0,4632,G
5-NP,112,4590,0,6,0,4596,A
5-NP,113,1,6,4512,0,4519,G
5-NP,114,0,0,4464,0,4464,G
5-NP,115,0,4784,0,3,4787,T
5-NP,116,1,4799,0,2,4802,T
5-NP,117,10,0,1,4808,4819,C
5-NP,118,0,4810,1,5,4816,T
5-NP,119,4924,0,9,0,4933,A
5-NP,120,1,1,0,4947,4949,C
5-NP,121,5105,0,4,0,5109,A
5-NP,122,0,5120,0,4,5124,T
5-NP,123,6,0,0,4972,4978,C
5-NP,124,7,4,0,4952,4963,C
5-NP,125,4985,1,0,0,4986,A
5-NP,126,5073,0,0,0,5073,A
5-NP,127,5054,0,3,0,5057,A
5-NP,128,0,5004,0,1,5005,T
5-NP,129,1,1,5012,0,5014,G
5-NP,130,1,4891,0,8,4900,T
5-NP,131,1,1,4918,0,4920,G
5-NP,132,3,3,0,4912,4918,C
5-NP,133,4898,0,7,0,4905,A
5-NP,134,1,1,0,4914,4916,C
5-NP,135,0,4790,0,4,4794,T
5-NP,136,1,14,5051,0,5066,G
5-NP,137,5121,0,2,0,5123,A
5-NP,138,5210,1,7,1,5219,A
5-NP,139,3,2,1,5289,5295,C
5-NP,140,1,5246,2,4,5253,T
5-NP,141,0,5265,1,2,5268,T
5-NP,142,5286,0,0,0,5286,A
5-NP,143,5265,0,6,0,5271,A
5-NP,144,5310,0,4,0,5314,A
5-NP,145,0,0,0,5344,5344,C
5-NP,146,0,5115,1,4,5120,T
5-NP,147,10,0,0,5168,5178,C
5-NP,148,5109,1,4,0,5114,A
5-NP,149,3,0,5188,0,5191,G
5-NP,150,1,5170,2,1,5174,T
5-NP,151,1,27,5212,0,5240,G
5-NP,152,5250,1,4,0,5255,A
5-NP,153,1,5293,0,5,5299,T
5-NP,154,20,2,0,5317,5339,C
5-NP,155,5371,1,7,0,5379,A
5-NP,156,0,5355,0,9,5364,T
5-NP,157,1,4,5385,0,5390,G
5-NP,158,5358,0,11,2,5371,A
5-NP,159,5348,0,11,0,5359,A
5-NP,160,2,16,5319,0,5337,G
5-NP,161,0,9,5276,1,5286,G
5-NP,162,5169,0,6,0,5175,A
5-NP,163,0,3,0,5288,5291,C
5-NP,164,3,16,5331,0,5350,G
5-NP,165,0,0,5395,0,5395,G
5-NP,166,0,5379,0,2,5381,T
5-NP,167,0,5342,0,5,5347,T
5-NP,168,0,10,5340,0,5350,G
5-NP,169,5950,2,5,0,5957,A
5-NP,170,0,5957,0,5,5962,T
5-NP,171,11,2,0,5955,5968,C
5-NP,172,5,1,0,5974,5980,C
5-NP,173,5924,0,6,1,5931,A
5-NP,174,1,15,5942,0,5958,G
5-NP,175,5932,0,3,0,5935,A
5-NP,176,5944,1,10,0,5955,A
5-NP,177,1,3,0,6002,6006,C
5-NP,178,5504,0,4,1,5509,A
5-NP,179,1,2,5565,0,5568,G
5-NP,180,1,0,0,5559,5560,C
5-NP,181,0,5536,0,4,5540,T
5-NP,182,0,5580,0,1,5581,T
5-NP,183,5,13,5557,0,5575,G
5-NP,184,5611,1,6,0,5618,A
5-NP,185,0,0,1,5666,5667,C
5-NP,186,5606,1,3,0,5610,A
5-NP,187,5639,1,1,1,5642,A
5-NP,188,0,5606,0,0,5606,T
5-NP,189,5573,1,0,0,5574,A
5-NP,190,1,13,5599,1,5614,G
5-NP,191,5531,1,7,1,5540,A
5-NP,192,0,5,5607,0,5612,G
5-NP,193,5550,2,4,0,5556,A
5-NP,194,5681,0,1,0,5682,A
5-NP,195,5691,0,4,0,5695,A
5-NP,196,5852,1,7,0,5860,A
5-NP,197,0,5872,0,1,5873,T
5-NP,198,1,14,5850,0,5865,G
5-NP,199,1,2,5855,0,5858,G
5-NP,200,2,5823,0,3,5828,T
5-NP,201,5672,0,5,0,5677,A
5-NP,202,0,0,0,5735,5735,C
5-NP,203,0,5722,1,6,5729,T
5-NP,204,10,1,0,5833,5844,C
5-NP,205,0,5672,0,12,5684,T
5-NP,206,7,4,0,5738,5749,C
5-NP,207,1,5717,0,6,5724,T
5-NP,208,4,1,5772,0,5777,G
5-NP,209,2,0,0,5763,5765,C
5-NP,210,0,5706,0,16,5722,T
5-NP,211,2,5680,0,0,5682,T
5-NP,212,2,5668,0,8,5678,T
5-NP,213,0,5609,0,0,5609,T
5-NP,214,0,13,5640,0,5653,G
5-NP,215,5592,0,2,14,5608,A
5-NP,216,2,5615,0,0,5617,T
5-NP,217,3,7,5581,0,5591,G
5-NP,218,5531,1,8,2,5542,A
5-NP,219,5556,1,5,0,5562,A
5-NP,220,5572,2,9,0,5583,A
5-NP,221,1,5,5593,0,5599,G
5-NP,222,5580,1,15,0,5596,A
5-NP,223,5580,0,6,0,5586,A
5-NP,224,2,9,5660,0,5671,G
5-NP,225,1,5,5893,0,5899,G
5-NP,226,5920,1,1,0,5922,A
5-NP,227,5971,0,5,0,5976,A
5-NP,228,1,5938,1,3,5943,T
5-NP,229,5976,0,2,0,5978,A
5-NP,230,5931,1,6,0,5938,A
5-NP,231,5970,0,3,1,5974,A
5-NP,232,0,5979,1,1,5981,T
5-NP,233,5975,0,5,1,5981,A
5-NP,234,0,3,1,5979,5983,C
5-NP,235,6,3,0,5831,5840,C
5-NP,236,1,5801,0,7,5809,T
5-NP,237,2,7,5835,0,5844,G
5-NP,238,1,8,5924,0,5933,G
5-NP,239,5934,0,1,0,5935,A
5-NP,240,5905,2,4,0,5911,A
5-NP,241,3,14,5984,0,6001,G
5-NP,242,5949,0,7,0,5956,A
5-NP,243,5947,0,9,0,5956,A
5-NP,244,1,3,0,5943,5947,C
5-NP,245,5932,0,8,0,5940,A
5-NP,246,0,2,0,6115,6117,C
5-NP,247,11,4,0,5975,5990,C
5-NP,248,16,3,0,5978,5997,C
5-NP,249,11,3,0,5991,6005,C
5-NP,250,5899,0,11,0,5910,A
5-NP,251,0,2,5927,0,5929,G
5-NP,252,0,5,0,5890,5895,C
5-NP,253,3,4,5898,0,5905,G
5-NP,254,5,1,1,5916,5923,C
5-NP,255,5,19,5798,1,5823,G
5-NP,256,5,14,5849,0,5868,G
5-NP,257,2,5,5830,0,5837,G
5-NP,258,1,8,5879,0,5888,G
5-NP,259,5882,1,4,0,5887,A
5-NP,260,5901,2,3,0,5906,A
5-NP,261,5870,2,8,1,5881,A
5-NP,262,2,8,5889,0,5899,G
5-NP,263,5843,1,5,0,5849,A
5-NP,264,3,5798,2,4,5807,T
5-NP,265,4,1,1,5796,5802,C
5-NP,266,4,8,0,5757,5769,C
5-NP,267,14,2,0,5793,5809,C
5-NP,268,5845,0,1,0,5846,A
5-NP,269,5848,0,4,0,5852,A
5-NP,270,0,3,5884,0,5887,G
5-NP,271,5846,1,1,0,5848,A
5-NP,272,5888,0,2,0,5890,A
5-NP,273,5874,0,4,0,5878,A
5-NP,274,5887,0,5,4,5896,A
5-NP,275,0,1,1,5956,5958,C
5-NP,276,1,5850,0,1,5852,T
5-NP,277,1,7,5875,0,5883,G
5-NP,278,2,8,5866,0,5876,G
5-NP,279,5744,1,15,0,5760,A
5-NP,280,6,5,5769,0,5780,G
5-NP,281,0,8,5838,0,5846,G
5-NP,282,2,4,6016,0,6022,G
5-NP,283,5,2,1,6584,6592,C
5-NP,284,3,1,0,6550,6554,C
5-NP,285,25,4,0,6578,6607,C
5-NP,286,7449,1,9,0,7459,A
5-NP,287,1,7484,0,3,7488,T
5-NP,288,7948,1,7,0,7956,A
5-NP,289,0,7980,0,3,7983,T
5-NP,290,7849,0,7,0,7856,A
5-NP,291,0,2,0,7895,7897,C
5-NP,292,7052,0,8,1,7061,A
5-NP,293,1,3,7231,1,7236,G
5-NP,294,0,10,7200,0,7210,G
5-NP,295,6457,4,7,2,6470,A
5-NP,296,0,18,6592,0,6610,G
5-NP,297,6179,0,10,1,6190,A
5-NP,298,12,1,6295,0,6308,G
5-NP,299,0,6271,0,5,6276,T
5-NP,300,6216,2,2,0,6220,A
5-NP,301,1,6,6247,0,6254,G
5-NP,302,6129,0,3,0,6132,A
5-NP,303,1,6115,0,4,6120,T
5-NP,304,4,5,6121,0,6130,G
5-NP,305,3,9,6134,0,6146,G
5-NP,306,6132,0,6,0,6138,A
5-NP,307,6094,0,5,0,6099,A
5-NP,308,6077,0,1,0,6078,A
5-NP,309,6119,0,6,0,6125,A
5-NP,310,0,6115,1,1,6117,T
5-NP,311,1,12,6206,0,6219,G
5-NP,312,1,5,6203,0,6209,G
5-NP,313,6175,0,12,1,6188,A
5-NP,314,1,6180,0,0,6181,T
5-NP,315,7,7,6183,0,6197,G
5-NP,316,6172,0,10,0,6182,A
5-NP,317,1,11,6211,0,6223,G
5-NP,318,1,9,6183,0,6193,G
5-NP,319,5,16,6169,2,6192,G
5-NP,320,6206,1,8,1,6216,A
5-NP,321,6242,1,8,1,6252,A
5-NP,322,2,0,0,6286,6288,C
5-NP,323,2,6245,0,8,6255,T
5-NP,324,21,2,1,6299,6323,C
5-NP,325,7,3,6317,0,6327,G
5-NP,326,0,6320,0,6,6326,T
5-NP,327,12,0,0,6305,6317,C
5-NP,328,12,8,0,6583,6603,C
5-NP,329,0,6534,0,9,6543,T
5-NP,330,0,6556,0,3,6559,T
5-NP,331,0,6514,0,10,6524,T
5-NP,332,6574,0,2,0,6576,A
5-NP,333,2,6533,0,3,6538,T
5-NP,334,2,17,6527,0,6546,G
5-NP,335,6543,2,10,0,6555,A
5-NP,336,0,2,1,6542,6545,C
5-NP,337,6385,0,1,0,6386,A
5-NP,338,6390,0,0,1,6391,A
5-NP,339,6391,1,6,0,6398,A
5-NP,340,1,11,6593,1,6606,G
5-NP,341,6559,3,6,0,6568,A
5-NP,342,6565,1,18,0,6584,A
5-NP,343,1,10,6806,0,6817,G
5-NP,344,6815,1,11,0,6827,A
5-NP,345,6833,0,7,0,6840,A
5-NP,346,6834,0,4,1,6839,A
5-NP,347,0,6841,1,2,6844,T
5-NP,348,6801,0,2,0,6803,A
5-NP,349,6702,0,7,1,6710,A
5-NP,350,1,8,6737,0,6746,G
5-NP,351,1,2,6733,0,6736,G
5-NP,352,0,1,0,6647,6648,C
5-NP,353,2,16,6643,0,6661,G
5-NP,354,6664,3,1,1,6669,A
5-NP,355,6723,0,1,0,6724,A
5-NP,356,1,6733,0,6,6740,T
5-NP,357,12,0,0,6735,6747,C
5-NP,358,3,6723,1,4,6731,T
5-NP,359,1,4,6707,0,6712,G
5-NP,360,4,4,6665,0,6673,G
5-NP,361,1,3,0,6700,6704,C
5-NP,362,2,3,6706,2,6713,G
5-NP,363,2,1,0,6689,6692,C
5-NP,364,12,0,0,6636,6648,C
5-NP,365,6705,0,6,0,6711,A
5-NP,366,6789,1,4,0,6794,A
5-NP,367,1,0,6900,0,6901,G
5-NP,368,6,4,0,6875,6885,C
5-NP,369,8,0,1,6936,6945,C
5-NP,370,6979,0,11,0,6990,A
5-NP,371,7066,0,6,1,7073,A
5-NP,372,2,0,0,7113,7115,C
5-NP,373,7111,0,5,0,7116,A
5-NP,374,7226,0,2,0,7228,A
5-NP,375,2,7187,0,2,7191,T
5-NP,376,4,8,7230,1,7243,G
5-NP,377,1,2,7252,0,7255,G
5-NP,378,2,7148,0,2,7152,T
5-NP,379,2,6,7142,0,7150,G
5-NP,380,7057,3,7,1,7068,A
5-NP,381,3,11,7170,0,7184,G
5-NP,382,1,5,7177,0,7183,G
5-NP,383,7174,1,5,0,7180,A
5-NP,384,1,7523,0,7,7531,T
5-NP,385,0,3,7551,0,7554,G
5-NP,386,0,1,0,7541,7542,C
5-NP,387,3,7539,0,12,7554,T
5-NP,388,7606,0,2,0,7608,A
5-NP,389,2,2,0,7675,7679,C
5-NP,390,7540,0,7,1,7548,A
5-NP,391,2,7512,1,4,7519,T
5-NP,392,7,1,0,7450,7458,C
5-NP,393,2,7016,0,10,7028,T
5-NP,394,2,7,7238,0,7247,G
5-NP,395,3,1,7418,0,7422,G
5-NP,396,1,7401,1,11,7414,T
5-NP,397,19,3,0,7383,7405,C
5-NP,398,0,7276,1,6,7283,T
5-NP,399,7392,1,0,0,7393,A
5-NP,400,7407,2,2,0,7411,A
5-NP,401,1,2,0,7447,7450,C
5-NP,402,1,7384,2,16,7403,T
5-NP,403,31,0,0,7384,7415,C
5-NP,404,7257,2,6,0,7265,A
5-NP,405,0,2,0,7492,7494,C
5-NP,406,7482,2,2,0,7486,A
5-NP,407,0,7504,0,3,7507,T
5-NP,408,7384,1,6,1,7392,A
5-NP,409,7416,0,7,0,7423,A
5-NP,410,0,7398,0,0,7398,T
5-NP,411,0,30,7439,0,7469,G
5-NP,412,7368,1,3,0,7372,A
5-NP,413,0,7279,0,2,7281,T
5-NP,414,0,7072,0,5,7077,T
5-NP,415,2,7059,0,2,7063,T
5-NP,416,4,18,6997,0,7019,G
5-NP,417,2,4,7028,1,7035,G
5-NP,418,4,3,1,7066,7074,C
5-NP,419,7013,0,1,0,7014,A
5-NP,420,2,6958,0,10,6970,T
5-NP,421,3,6936,2,10,6951,T
5-NP,422,11,1,0,6944,6956,C
5-NP,423,14,1,1,6976,6992,C
5-NP,424,7135,1,1,0,7137,A
5-NP,425,7134,0,2,0,7136,A
5-NP,426,0,7122,2,0,7124,T
5-NP,427,3,7111,0,4,7118,T
5-NP,428,1,7121,1,1,7124,T
5-NP,429,2,16,7165,0,7183,G
5-NP,430,7150,1,4,0,7155,A
5-NP,431,7170,0,9,0,7179,A
5-NP,432,0,7211,0,3,7214,T
5-NP,433,1,16,7088,0,7105,G
5-NP,434,7361,0,7,0,7368,A
5-NP,435,0,7370,0,3,7373,T
5-NP,436,3,2,7388,1,7394,G
5-NP,437,1,2,0,7564,7567,C
5-NP,438,7542,0,10,0,7552,A
5-NP,439,7889,1,9,0,7899,A
5-NP,440,0,3,0,7901,7904,C
5-NP,441,7986,0,0,1,7987,A
5-NP,442,1,8179,1,3,8184,T
5-NP,443,7974,0,2,0,7976,A
5-NP,444,3,2,0,8099,8104,C
5-NP,445,7,1,1,8073,8082,C
5-NP,446,7859,1,5,0,7865,A
5-NP,447,2,4,7943,0,7949,G
5-NP,448,7641,1,20,1,7663,A
5-NP,449,1,7,7847,0,7855,G
5-NP,450,5,17,7764,0,7786,G
5-NP,451,7708,2,10,1,7721,A
5-NP,452,2,2,0,7785,7789,C
5-NP,453,7656,0,5,0,7661,A
5-NP,454,7634,1,13,2,7650,A
5-NP,455,3,15,7652,0,7670,G
5-NP,456,7477,1,11,2,7491,A
5-NP,457,2,0,7605,0,7607,G
5-NP,458,3,2,1,7495,7501,C
5-NP,459,1,7358,4,18,7381,T
5-NP,460,14,1,0,7454,7469,C
5-NP,461,1,7424,1,8,7434,T
5-NP,462,3,7455,0,1,7459,T
5-NP,463,2,4,7476,0,7482,G
5-NP,464,1,7431,0,4,7436,T
5-NP,465,1,7401,0,31,7433,T
5-NP,466,30,3,0,7375,7408,C
5-NP,467,3,23,7346,0,7372,G
5-NP,468,7486,0,8,0,7494,A
5-NP,469,7483,0,0,0,7483,A
5-NP,470,0,0,0,7536,7536,C
5-NP,471,0,7480,1,8,7489,T
5-NP,472,2,8,7561,0,7571,G
5-NP,473,1,12,7594,0,7607,G
5-NP,474,7599,1,6,0,7606,A
5-NP,475,7617,2,14,2,7635,A
5-NP,476,2,7602,0,1,7605,T
5-NP,477,3,14,7512,1,7530,G
5-NP,478,3,12,7519,0,7534,G
5-NP,479,7512,0,8,0,7520,A
5-NP,480,3,7541,0,8,7552,T
5-NP,481,14,1,0,7505,7520,C
5-NP,482,22,1,1,7479,7503,C
5-NP,483,10,8,0,7540,7558,C
5-NP,484,7664,1,4,0,7669,A
5-NP,485,0,12,7738,0,7750,G
5-NP,486,7718,2,2,0,7722,A
5-NP,487,7732,0,3,0,7735,A
5-NP,488,0,7636,0,3,7639,T
5-NP,489,1,1,7725,0,7727,G
5-NP,490,0,7661,0,7,7668,T
5-NP,491,4,1,7677,0,7682,G
5-NP,492,6,1,0,7673,7680,C
5-NP,493,2,7580,1,14,7597,T
5-NP,494,18,1,0,8139,8158,C
5-NP,495,2,8066,2,11,8081,T
5-NP,496,18,0,0,8396,8414,C
5-NP,497,2,8359,0,20,8381,T
5-NP,498,2,13,8361,0,8376,G
5-NP,499,8443,1,13,0,8457,A
5-NP,500,1,8423,0,3,8427,T
5-NP,501,3,1,8409,0,8413,G
5-NP,502,0,1,2,8388,8391,C
5-NP,503,7953,4,11,0,7968,A
5-NP,504,3,20,8170,1,8194,G
5-NP,505,1,14,7896,0,7911,G
5-NP,506,3,5,8009,0,8017,G
5-NP,507,1,1,0,7981,7983,C
5-NP,508,3,7939,1,10,7953,T
5-NP,509,12,4,0,7972,7988,C
5-NP,510,3,32,7976,0,8011,G
5-NP,511,8115,0,8,0,8123,A
5-NP,512,1,0,0,8115,8116,C
5-NP,513,1,7865,0,16,7882,T
5-NP,514,12,2,0,8239,8253,C
5-NP,515,0,8099,0,9,8108,T
5-NP,516,22,2,1,9143,9168,C
5-NP,517,8,1,0,9162,9171,C
5-NP,518,26,5,0,9164,9195,C
5-NP,519,1,9175,0,8,9184,T
5-NP,520,9090,0,1,0,9091,A
5-NP,521,4,9,9077,0,9090,G
5-NP,522,9053,1,2,1,9057,A
5-NP,523,8716,0,7,1,8724,A
5-NP,524,2,15,8718,0,8735,G
5-NP,525,2,3,8459,0,8464,G
5-NP,526,0,8282,1,8,8291,T
5-NP,527,11,1,0,8273,8285,C
5-NP,528,11,8,0,8297,8316,C
5-NP,529,8,7,8306,0,8321,G
5-NP,530,2,16,8351,0,8369,G
5-NP,531,8301,0,14,1,8316,A
5-NP,532,0,1,8483,0,8484,G
5-NP,533,0,2,0,8501,8503,C
5-NP,534,1,8298,0,11,8310,T
5-NP,535,0,2,8311,1,8314,G
5-NP,536,4,4,0,8314,8322,C
5-NP,537,8313,5,14,1,8333,A
5-NP,538,1,9,8357,0,8367,G
5-NP,539,0,2,8355,0,8357,G
5-NP,540,0,8308,0,7,8315,T
5-NP,541,2,4,8171,0,8177,G
5-NP,542,3,3,0,8240,8246,C
5-NP,543,1,8209,0,14,8224,T
5-NP,544,1,0,8258,0,8259,G
5-NP,545,0,2,0,8229,8231,C
5-NP,546,8323,3,7,0,8333,A
5-NP,547,8,2,8516,0,8526,G
5-NP,548,1,8385,1,3,8390,T
5-NP,549,19,0,0,8408,8427,C
5-NP,550,8412,0,4,1,8417,A
5-NP,551,8429,0,9,1,8439,A
5-NP,552,8408,2,15,3,8428,A
5-NP,553,0,7,8476,0,8483,G
5-NP,554,3,19,8489,2,8513,G
5-NP,555,8408,1,7,0,8416,A
5-NP,556,8368,0,5,1,8374,A
5-NP,557,0,8338,0,1,8339,T
5-NP,558,19,12,0,8322,8353,C
5-NP,559,4,17,8340,0,8361,G
5-NP,560,3,20,8624,1,8648,G
5-NP,561,3,17,8663,0,8683,G
5-NP,562,8625,3,11,0,8639,A
5-NP,563,2,0,1,8645,8648,C
5-NP,564,8530,0,5,0,8535,A
5-NP,565,8766,1,7,1,8775,A
5-NP,566,0,8765,1,2,8768,T
5-NP,567,5,7,8823,1,8836,G
5-NP,568,1,5,9038,0,9044,G
5-NP,569,0,8812,0,12,8824,T
5-NP,570,1,12,8835,0,8848,G
5-NP,571,8807,0,12,1,8820,A
5-NP,572,0,8808,1,3,8812,T
5-NP,573,2,20,8799,0,8821,G
5-NP,574,0,32,8901,3,8936,G
5-NP,575,8870,3,10,1,8884,A
5-NP,576,8885,0,3,0,8888,A
5-NP,577,5,2,0,8885,8892,C
5-NP,578,0,8488,0,6,8494,T
5-NP,579,1,23,8948,1,8973,G
5-NP,580,8923,1,6,0,8930,A
5-NP,581,0,8912,0,4,8916,T
5-NP,582,27,3,0,8954,8984,C
5-NP,583,8746,1,5,1,8753,A
5-NP,584,2,19,8985,1,9007,G
5-NP,585,8922,1,5,1,8929,A
5-NP,586,8933,0,7,1,8941,A
5-NP,587,0,8960,0,0,8960,T
5-NP,588,3,18,8639,0,8660,G
5-NP,589,5,0,8823,2,8830,G
5-NP,590,2,8775,0,14,8791,T
5-NP,591,38,2,0,8754,8794,C
5-NP,592,8815,0,6,0,8821,A
5-NP,593,8716,0,7,1,8724,A
5-NP,594,8734,1,5,1,8741,A
5-NP,595,1,7,0,8740,8748,C
5-NP,596,6,20,8691,1,8718,G
5-NP,597,4,19,8666,1,8690,G
5-NP,598,7,16,8542,0,8565,G
5-NP,599,2,16,8600,0,8618,G
5-NP,600,2,12,8619,0,8633,G
5-NP,601,8607,2,14,1,8624,A
5-NP,602,0,8508,2,15,8525,T
5-NP,603,17,1,0,8537,8555,C
5-NP,604,8592,0,9,0,8601,A
5-NP,605,8611,0,7,1,8619,A
5-NP,606,1,2,1,8504,8508,C
5-NP,607,5,19,8405,0,8429,G
5-NP,608,8374,1,8,1,8384,A
5-NP,609,0,8363,0,2,8365,T
5-NP,610,30,2,0,8374,8406,C
5-NP,611,1,11,8404,1,8417,G
5-NP,612,8404,0,2,0,8406,A
5-NP,613,8397,1,2,0,8400,A
5-NP,614,8391,0,3,0,8394,A
5-NP,615,0,8500,1,1,8502,T
5-NP,616,2,8468,4,1,8475,T
5-NP,617,1,8471,2,4,8478,T
5-NP,618,2,8480,1,3,8486,T
5-NP,619,0,8525,1,3,8529,T
5-NP,620,4,15,8507,1,8527,G
5-NP,621,1,22,8502,0,8525,G
5-NP,622,8381,1,10,1,8393,A
5-NP,623,4,13,8521,0,8538,G
5-NP,624,8231,2,7,0,8240,A
5-NP,625,1,4,8622,2,8629,G
5-NP,626,1,1,8686,0,8688,G
5-NP,627,2,8652,1,14,8669,T
5-NP,628,4,19,8644,0,8667,G
5-NP,629,8661,3,8,0,8672,A
5-NP,630,8580,0,11,0,8591,A
5-NP,631,8598,1,5,0,8604,A
5-NP,632,8619,0,5,0,8624,A
5-NP,633,2,8623,0,1,8626,T
5-NP,634,2,25,8390,0,8417,G
5-NP,635,1,9,8202,1,8213,G
5-NP,636,5,5,8190,1,8201,G
5-NP,637,1,7,0,8185,8193,C
5-NP,638,3,19,8187,0,8209,G
5-NP,639,0,4,8306,0,8310,G
5-NP,640,8301,0,1,0,8302,A
5-NP,641,8306,0,3,0,8309,A
5-NP,642,8479,0,4,1,8484,A
5-NP,643,8516,1,18,0,8535,A
5-NP,644,1,0,0,8628,8629,C
5-NP,645,8608,3,8,0,8619,A
5-NP,646,8603,2,5,0,8610,A
5-NP,647,1,10,8603,1,8615,G
5-NP,648,8262,1,10,0,8273,A
5-NP,649,8342,1,6,0,8349,A
5-NP,650,1,3,8692,0,8696,G
5-NP,651,0,8647,2,6,8655,T
5-NP,652,0,4,9280,0,9284,G
5-NP,653,5,2,0,9215,9222,C
5-NP,654,0,9174,2,21,9197,T
5-NP,655,1,9238,0,3,9242,T
5-NP,656,9366,0,4,1,9371,A
5-NP,657,1,9366,0,4,9371,T
5-NP,658,2,19,9393,0,9414,G
5-NP,659,9091,0,19,0,9110,A
5-NP,660,4,26,9136,0,9166,G
5-NP,661,8529,0,11,1,8541,A
5-NP,662,2,15,8619,0,8636,G
5-NP,663,8538,0,9,0,8547,A
5-NP,664,8677,1,10,1,8689,A
5-NP,665,0,8607,0,3,8610,T
5-NP,666,1,0,8773,0,8774,G
5-NP,667,1,8687,0,15,8703,T
5-NP,668,7,4,8727,0,8738,G
5-NP,669,3,6,3,8685,8697,C
5-NP,670,8690,1,5,1,8697,A
5-NP,671,8728,0,14,0,8742,A
5-NP,672,0,1,0,8708,8709,C
5-NP,673,8595,2,1,0,8598,A
5-NP,674,0,8617,1,5,8623,T
5-NP,675,0,8483,0,16,8499,T
5-NP,676,9,1,0,8528,8538,C
5-NP,677,1,8476,0,7,8484,T
5-NP,678,2,8479,1,1,8483,T
5-NP,679,8505,4,3,1,8513,A
5-NP,680,8455,0,0,0,8455,A
5-NP,681,8452,0,6,0,8458,A
5-NP,682,2,10,8457,0,8469,G
5-NP,683,2,10,8457,1,8470,G
5-NP,684,8416,0,3,0,8419,A
5-NP,685,8381,0,4,1,8386,A
5-NP,686,8376,0,4,0,8380,A
5-NP,687,8588,2,0,0,8590,A
5-NP,688,2,8583,0,3,8588,T
5-NP,689,0,8572,0,0,8572,T
5-NP,690,2,8607,1,5,8615,T
5-NP,691,15,1,2,8600,8618,C
5-NP,692,8616,0,6,1,8623,A
5-NP,693,8619,0,2,1,8622,A
5-NP,694,8611,1,9,2,8623,A
5-NP,695,3,1,0,8759,8763,C
5-NP,696,8627,0,12,0,8639,A
5-NP,697,2,3,8798,1,8804,G
5-NP,698,0,2,1,8813,8816,C
5-NP,699,2,8778,0,8,8788,T
5-NP,700,2,3,8990,1,8996,G
5-NP,701,5,6,1,8965,8977,C
5-NP,702,9056,4,6,0,9066,A
5-NP,703,3,2,0,9069,9074,C
5-NP,704,8999,0,0,0,8999,A
5-NP,705,9011,2,11,0,9024,A
5-NP,706,8781,0,9,0,8790,A
5-NP,707,0,27,9298,0,9325,G
5-NP,708,9192,4,19,2,9217,A
5-NP,709,6,1,9299,1,9307,G
5-NP,710,1,1,0,9281,9283,C
5-NP,711,9269,4,3,0,9276,A
5-NP,712,9576,1,14,4,9595,A
5-NP,713,0,9600,0,3,9603,T
5-NP,714,4,16,9633,0,9653,G
5-NP,715,4,1,9700,0,9705,G
5-NP,716,0,9317,0,16,9333,T
5-NP,717,2,17,9337,1,9357,G
5-NP,718,3,33,9393,0,9429,G
5-NP,719,9438,0,10,0,9448,A
5-NP,720,4,9383,0,12,9399,T
5-NP,721,27,1,1,9106,9135,C
5-NP,722,9205,1,3,1,9210,A
5-NP,723,9303,6,11,0,9320,A
5-NP,724,3,1,9369,0,9373,G
5-NP,725,0,9273,2,5,9280,T
5-NP,726,5,26,9256,1,9288,G
5-NP,727,9142,0,15,1,9158,A
5-NP,728,0,30,9200,0,9230,G
5-NP,729,9145,1,13,1,9160,A
5-NP,730,4,11,9211,0,9226,G
5-NP,731,9143,0,9,1,9153,A
5-NP,732,8973,1,2,0,8976,A
5-NP,733,9020,0,13,1,9034,A
5-NP,734,1,1,9101,0,9103,G
5-NP,735,1,9052,0,1,9054,T
5-NP,736,29,3,0,9015,9047,C
5-NP,737,4,18,8981,0,9003,G
5-NP,738,3,13,9009,0,9025,G
5-NP,739,9046,1,5,0,9052,A
5-NP,740,9098,3,4,0,9105,A
5-NP,741,1,3,1,9153,9158,C
5-NP,742,16,1,0,9038,9055,C
5-NP,743,22,0,0,9079,9101,C
5-NP,744,9034,1,9,0,9044,A
5-NP,745,2,7,9063,0,9072,G
5-NP,746,3,8,9077,1,9089,G
5-NP,747,9061,1,5,0,9067,A
5-NP,748,9042,2,3,1,9048,A
5-NP,749,9034,0,6,2,9042,A
5-NP,750,2,2,0,9093,9097,C
5-NP,751,3,3,9081,0,9087,G
5-NP,752,1,3,0,9075,9079,C
5-NP,753,0,9024,0,9,9033,T
5-NP,754,2,20,9030,0,9052,G
5-NP,755,8976,0,8,1,8985,A
5-NP,756,2,9,9153,0,9164,G
5-NP,757,9150,2,7,0,9159,A
5-NP,758,1,9148,1,3,9153,T
5-NP,759,22,2,0,9020,9044,C
5-NP,760,7,11,9058,0,9076,G
5-NP,761,9060,0,6,1,9067,A
5-NP,762,9041,0,8,1,9050,A
5-NP,763,0,6,9078,0,9084,G
5-NP,764,9079,1,7,1,9088,A
5-NP,765,2,8987,0,8,8997,T
5-NP,766,6,1,2,9118,9127,C
5-NP,767,1,9065,0,10,9076,T
5-NP,768,23,2,1,9209,9235,C
5-NP,769,9258,5,4,0,9267,A
5-NP,770,3,9243,3,6,9255,T
5-NP,771,9280,1,0,0,9281,A
5-NP,772,3,9227,1,2,9233,T
5-NP,773,2,9178,0,2,9182,T
5-NP,774,1,9115,1,2,9119,T
5-NP,775,0,8985,2,0,8987,T
5-NP,776,0,9006,0,3,9009,T
5-NP,777,9016,0,6,0,9022,A
5-NP,778,4,2,9009,0,9015,G
5-NP,779,4,0,0,9013,9017,C
5-NP,780,8974,0,3,0,8977,A
5-NP,781,8914,1,5,0,8920,A
5-NP,782,1,14,9302,0,9317,G
5-NP,783,9264,1,10,0,9275,A
5-NP,784,1,9278,0,8,9287,T
5-NP,785,4,3,0,9376,9383,C
5-NP,786,2,9327,1,13,9343,T
5-NP,787,6,1,9633,1,9641,G
5-NP,788,4,4,0,9673,9681,C
5-NP,789,9695,0,7,1,9703,A
5-NP,790,0,9794,1,2,9797,T
5-NP,791,1,9429,0,2,9432,T
5-NP,792,11,11,10207,0,10229,G
5-NP,793,10352,0,12,0,10364,A
5-NP,794,0,10366,2,4,10372,T
5-NP,795,10406,1,3,0,10410,A
5-NP,796,2,10167,0,5,10174,T
5-NP,797,0,10038,0,4,10042,T
5-NP,798,2,23,10073,0,10098,G
5-NP,799,9891,1,8,0,9900,A
5-NP,800,0,12,10024,0,10036,G
5-NP,801,9335,1,13,2,9351,A
5-NP,802,2,13,9226,0,9241,G
5-NP,803,7,24,9356,0,9387,G
5-NP,804,9327,1,11,0,9339,A
5-NP,805,1,9317,1,8,9327,T
5-NP,806,19,4,1,9379,9403,C
5-NP,807,9331,2,6,1,9340,A
5-NP,808,1,0,9383,0,9384,G
5-NP,809,1,9336,0,7,9344,T
5-NP,810,0,9262,0,2,9264,T
5-NP,811,3,7,9241,0,9251,G
5-NP,812,2,6,1,9156,9165,C
5-NP,813,2,9115,1,14,9132,T
5-NP,814,44,0,0,9190,9234,C
5-NP,815,9280,0,8,0,9288,A
5-NP,816,1,3,0,9265,9269,C
5-NP,817,9262,2,2,0,9266,A
5-NP,818,9327,1,1,0,9329,A
5-NP,819,9327,0,2,0,9329,A
5-NP,820,1,9281,0,5,9287,T
5-NP,821,11,1,1,9308,9321,C
5-NP,822,0,9272,0,10,9282,T
5-NP,823,0,9236,0,2,9238,T
5-NP,824,4,5,9265,0,9274,G
5-NP,825,4,8,0,9262,9274,C
5-NP,826,12,2,0,9452,9466,C
5-NP,827,1,9437,2,7,9447,T
5-NP,828,9528,5,2,0,9535,A
5-NP,829,1,3,0,9500,9504,C
5-NP,830,12,3,0,9485,9500,C
5-NP,831,1,9439,1,11,9452,T
5-NP,832,3,3,9600,0,9606,G
5-NP,833,2,2,1,9556,9561,C
5-NP,834,14,4,0,9581,9599,C
5-NP,835,0,9421,0,11,9432,T
5-NP,836,5,3,9560,0,9568,G
5-NP,837,0,9454,1,4,9459,T
5-NP,838,6,1,9553,0,9560,G
5-NP,839,8,3,0,9641,9652,C
5-NP,840,5,1,9797,0,9803,G
5-NP,841,0,9607,1,4,9612,T
5-NP,842,9585,0,5,0,9590,A
5-NP,843,0,9575,0,7,9582,T
5-NP,844,4,28,9547,0,9579,G
5-NP,845,4,12,10025,1,10042,G
5-NP,846,10005,0,10,0,10015,A
5-NP,847,4,3,0,9860,9867,C
5-NP,848,7,2,1,9853,9863,C
5-NP,849,2,9664,2,19,9687,T
5-NP,850,3,3,10211,1,10218,G
5-NP,851,0,5,1,10231,10237,C
5-NP,852,10256,2,17,1,10276,A
5-NP,853,2,1,10531,1,10535,G
5-NP,854,2,9903,0,4,9909,T
5-NP,855,10350,0,6,0,10356,A
5-NP,856,2,10267,1,8,10278,T
5-NP,857,10,3,0,10265,10278,C
5-NP,858,13,5,0,10275,10293,C
5-NP,859,9754,0,6,0,9760,A
5-NP,860,6,4,9788,0,9798,G
5-NP,861,0,9711,3,10,9724,T
5-NP,862,6,21,9841,1,9869,G
5-NP,863,5,13,9828,0,9846,G
5-NP,864,0,4,9598,0,9602,G
5-NP,865,0,9591,0,6,9597,T
5-NP,866,9582,1,2,0,9585,A
5-NP,867,1,5,0,9582,9588,C
5-NP,868,3,28,9514,0,9545,G
5-NP,869,9481,1,10,2,9494,A
5-NP,870,1,2,0,9490,9493,C
5-NP,871,1,9166,0,6,9173,T
5-NP,872,0,9191,1,7,9199,T
5-NP,873,10,3,0,9148,9161,C
5-NP,874,3,13,9177,0,9193,G
5-NP,875,9170,1,5,1,9177,A
5-NP,876,9165,2,0,1,9168,A
5-NP,877,9192,1,1,0,9194,A
5-NP,878,9196,1,3,0,9200,A
5-NP,879,9173,1,10,0,9184,A
5-NP,880,1,11,9206,0,9218,G
5-NP,881,9152,2,18,0,9172,A
5-NP,882,1,13,9282,0,9296,G
5-NP,883,2,22,9333,1,9358,G
5-NP,884,3,15,9375,1,9394,G
5-NP,885,9387,2,11,2,9402,A
5-NP,886,2,9399,0,7,9408,T
5-NP,887,9468,0,4,0,9472,A
5-NP,888,1,9429,2,7,9439,T
5-NP,889,5,9402,2,8,9417,T
5-NP,890,15,2,0,9534,9551,C
5-NP,891,10,2,0,9430,9442,C
5-NP,892,0,9282,0,5,9287,T
5-NP,893,0,9280,0,3,9283,T
5-NP,894,1,18,9369,0,9388,G
5-NP,895,1,1,9434,0,9436,G
5-NP,896,1,9359,0,11,9371,T
5-NP,897,3,15,9299,0,9317,G
5-NP,898,4,11,9225,0,9240,G
5-NP,899,3,12,9660,0,9675,G
5-NP,900,9655,4,11,1,9671,A
5-NP,901,9689,0,5,0,9694,A
5-NP,902,0,9693,1,3,9697,T
5-NP,903,9468,1,10,1,9480,A
5-NP,904,2,24,9448,1,9475,G
5-NP,905,9366,1,18,0,9385,A
5-NP,906,1,4,0,9323,9328,C
5-NP,907,18,1,0,9216,9235,C
5-NP,908,27,5,0,8824,8856,C
5-NP,909,1,8899,1,22,8923,T
5-NP,910,3,8921,0,5,8929,T
5-NP,911,1,8907,0,12,8920,T
5-NP,912,21,1,0,8935,8957,C
5-NP,913,8919,2,2,1,8924,A
5-NP,914,8914,1,6,1,8922,A
5-NP,915,8879,0,9,1,8889,A
5-NP,916,4,2,0,8934,8940,C
5-NP,917,1,8560,0,6,8567,T
5-NP,918,8511,0,5,0,8516,A
5-NP,919,0,1,1,8645,8647,C
5-NP,920,2,8540,0,13,8555,T
5-NP,921,4,8501,1,7,8513,T
5-NP,922,8,1,1,8603,8613,C
5-NP,923,8582,0,2,1,8585,A
5-NP,924,8577,1,1,0,8579,A
5-NP,925,8498,0,3,0,8501,A
5-NP,926,8530,2,2,0,8534,A
5-NP,927,0,8444,1,3,8448,T
5-NP,928,8252,1,7,0,8260,A
5-NP,929,1,1,8383,0,8385,G
5-NP,930,1,3,1,8387,8392,C
5-NP,931,12,1,1,8514,8528,C
5-NP,932,8532,0,2,0,8534,A
5-NP,933,8525,1,5,0,8531,A
5-NP,934,8864,2,6,0,8872,A
5-NP,935,0,8892,0,3,8895,T
5-NP,936,8959,1,2,0,8962,A
5-NP,937,0,8927,0,8,8935,T
5-NP,938,8732,1,3,0,8736,A
5-NP,939,0,3,1,8771,8775,C
5-NP,940,8441,0,6,1,8448,A
5-NP,941,3,1,8719,0,8723,G
5-NP,942,3,4,0,8661,8668,C
5-NP,943,1,8281,0,17,8299,T
5-NP,944,0,8399,0,1,8400,T
5-NP,945,8470,1,0,0,8471,A
5-NP,946,8470,0,4,0,8474,A
5-NP,947,0,8444,0,3,8447,T
5-NP,948,20,2,0,8445,8467,C
5-NP,949,8072,1,9,0,8082,A
5-NP,950,2,23,8161,1,8187,G
5-NP,951,8147,1,10,0,8158,A
5-NP,952,3,4,0,8220,8227,C
5-NP,953,11,1,0,8129,8141,C
5-NP,954,2,7998,0,17,8017,T
5-NP,955,8089,0,2,0,8091,A
5-NP,956,8088,0,7,2,8097,A
5-NP,957,1,4,0,8162,8167,C
5-NP,958,1,12,8146,0,8159,G
5-NP,959,7888,0,8,0,7896,A
5-NP,960,2,20,7948,0,7970,G
5-NP,961,7808,1,15,0,7824,A
5-NP,962,7910,1,5,1,7917,A
5-NP,963,1,7900,4,5,7910,T
5-NP,964,12,1,0,7812,7825,C
5-NP,965,5,2,0,7825,7832,C
5-NP,966,7573,1,8,1,7583,A
5-NP,967,2,2,7636,0,7640,G
5-NP,968,2,5,0,7624,7631,C
5-NP,969,7736,0,5,0,7741,A
5-NP,970,2,4,1,7760,7767,C
5-NP,971,7618,1,9,0,7628,A
5-NP,972,4,0,0,7651,7655,C
5-NP,973,7634,0,6,1,7641,A
5-NP,974,7666,0,12,0,7678,A
5-NP,975,1,15,7685,0,7701,G
5-NP,976,7491,4,18,1,7514,A
5-NP,977,2,1,7594,0,7597,G
5-NP,978,1,7377,0,11,7389,T
5-NP,979,28,0,0,7338,7366,C
5-NP,980,7317,0,13,2,7332,A
5-NP,981,1,4,7328,1,7334,G
5-NP,982,0,2,0,7299,7301,C
5-NP,983,1,7236,0,2,7239,T
5-NP,984,2,5,7313,0,7320,G
5-NP,985,5,1,7333,1,7340,G
5-NP,986,0,7255,0,2,7257,T
5-NP,987,9,1,7315,0,7325,G
5-NP,988,1,7199,1,8,7209,T
5-NP,989,4,14,7154,0,7172,G
5-NP,990,1,5,7148,0,7154,G
5-NP,991,7066,1,9,1,7077,A
5-NP,992,2,7113,0,6,7121,T
5-NP,993,2,8,6620,1,6631,G
5-NP,994,0,2,6525,1,6528,G
5-NP,995,5,3,0,6501,6509,C
5-NP,996,6388,0,3,0,6391,A
5-NP,997,0,6360,14,6,6380,T
5-NP,998,2,1,6327,0,6330,G
5-NP,999,1,2,1,6365,6369,C
5-NP,1000,13,3,0,6354,6370,C
5-NP,1001,6357,0,5,0,6362,A
5-NP,1002,1,6309,0,11,6321,T
5-NP,1003,0,6137,0,5,6142,T
5-NP,1004,9,3,0,6158,6170,C
5-NP,1005,1,6033,0,3,6037,T
5-NP,1006,1,4,6003,0,6008,G
5-NP,1007,1,1,1,5992,5995,C
5-NP,1008,0,5538,2,9,5549,T
5-NP,1009,2,1,5590,1,5594,G
5-NP,1010,3,3,1,5354,5361,C
5-NP,1011,5360,1,2,1,5364,A
5-NP,1012,0,5359,2,1,5362,T
5-NP,1013,1,5240,0,1,5242,T
5-NP,1014,0,5247,0,0,5247,T
5-NP,1015,0,5,5246,0,5251,G
5-NP,1016,5227,2,2,0,5231,A
5-NP,1017,5228,1,13,1,5243,A
5-NP,1018,0,6,5329,0,5335,G
5-NP,1019,5332,0,3,1,5336,A
5-NP,1020,0,5316,0,1,5317,T
5-NP,1021,0,5307,0,2,5309,T
5-NP,1022,0,5304,0,2,5306,T
5-NP,1023,5336,0,1,1,5338,A
5-NP,1024,5307,0,4,0,5311,A
5-NP,1025,2,9,5311,0,5322,G
5-NP,1026,5297,1,2,0,5300,A
5-NP,1027,0,5313,0,1,5314,T
5-NP,1028,2,5166,0,4,5172,T
5-NP,1029,0,0,5208,0,5208,G
5-NP,1030,0,5198,0,8,5206,T
5-NP,1031,1,5183,0,3,5187,T
5-NP,1032,5188,1,5,1,5195,A
5-NP,1033,5205,0,4,0,5209,A
5-NP,1034,2,0,5242,0,5244,G
5-NP,1035,0,0,0,5248,5248,C
5-NP,1036,0,5118,0,5,5123,T
5-NP,1037,0,5148,0,2,5150,T
5-NP,1038,5,2,0,5162,5169,C
5-NP,1039,5143,0,9,0,5152,A
5-NP,1040,0,5159,1,2,5162,T
5-NP,1041,8,3,0,5171,5182,C
5-NP,1042,5122,0,2,0,5124,A
5-NP,1043,1,3,5142,0,5146,G
5-NP,1044,5047,1,8,1,5057,A
5-NP,1045,0,15,5106,0,5121,G
5-NP,1046,1,9,5235,0,5245,G
5-NP,1047,1,12,5218,1,5232,G
5-NP,1048,5223,2,9,0,5234,A
5-NP,1049,0,3,0,5238,5241,C
5-NP,1050,5255,1,3,0,5259,A
5-NP,1051,5235,0,3,0,5238,A
5-NP,1052,2,6,4876,0,4884,G
5-NP,1053,4994,1,7,0,5002,A
5-NP,1054,3,2,5096,0,5101,G
5-NP,1055,0,5103,0,4,5107,T
5-NP,1056,5066,0,4,0,5070,A
5-NP,1057,1,5025,0,10,5036,T
5-NP,1058,12,1,0,5113,5126,C
5-NP,1059,1,5049,0,11,5061,T
5-NP,1060,12,2,1,5134,5149,C
5-NP,1061,4,2,0,4995,5001,C
5-NP,1062,2,4372,1,452,4827,T
5-NP,1063,9,3,1,4839,4852,C
5-NP,1064,3,11,4826,0,4840,G
5-NP,1065,4,9,4855,1,4869,G
5-NP,1066,0,12,4851,0,4863,G
5-NP,1067,2,8,4719,0,4729,G
5-NP,1068,1,9,4725,0,4735,G
5-NP,1069,4632,0,3,1,4636,A
5-NP,1070,4638,0,5,1,4644,A
5-NP,1071,4655,1,3,0,4659,A
5-NP,1072,2,1,0,4740,4743,C
5-NP,1073,0,4715,0,6,4721,T
5-NP,1074,2,1,4757,0,4760,G
5-NP,1075,0,4719,0,4,4723,T
5-NP,1076,16,1,0,4700,4717,C
5-NP,1077,4789,1,4,1,4795,A
5-NP,1078,4806,0,0,1,4807,A
5-NP,1079,3,1,0,4761,4765,C
5-NP,1080,5,1,1,4601,4608,C
5-NP,1081,4650,0,1,0,4651,A
5-NP,1082,0,5,4694,0,4699,G
5-NP,1083,4665,0,5,0,4670,A
5-NP,1084,1,7,4687,0,4695,G
5-NP,1085,4,6,4707,0,4717,G
5-NP,1086,4584,0,14,0,4598,A
5-NP,1087,0,0,4756,0,4756,G
5-NP,1088,0,4711,0,7,4718,T
5-NP,1089,4725,0,7,0,4732,A
5-NP,1090,2,3,0,4718,4723,C
5-NP,1091,4640,1,1,0,4642,A
5-NP,1092,4643,0,6,0,4649,A
5-NP,1093,4590,1,2,0,4593,A
5-NP,1094,0,4548,0,0,4548,T
5-NP,1095,0,4506,0,1,4507,T
5-NP,1096,3,4,4399,0,4406,G
5-NP,1097,2,1,0,4365,4368,C
5-NP,1098,0,4336,0,4,4340,T
5-NP,1099,0,4315,0,4,4319,T
5-NP,1100,7,2,0,4326,4335,C
5-NP,1101,4353,0,3,1,4357,A
5-NP,1102,4374,0,1,0,4375,A
5-NP,1103,4385,0,2,0,4387,A
5-NP,1104,1,4376,0,1,4378,T
5-NP,1105,0,11,4382,0,4393,G
5-NP,1106,4294,0,7,0,4301,A
5-NP,1107,3,14,4325,0,4342,G
5-NP,1108,4345,1,10,0,4356,A
5-NP,1109,4350,0,4,1,4355,A
5-NP,1110,0,1,0,4356,4357,C
5-NP,1111,4311,0,2,0,4313,A
5-NP,1112,1,4300,2,2,4305,T
5-NP,1113,3,5,4399,0,4407,G
5-NP,1114,2,4,4445,0,4451,G
5-NP,1115,4434,1,3,1,4439,A
5-NP,1116,1,4391,1,1,4394,T
5-NP,1117,4356,0,1,0,4357,A
5-NP,1118,4718,0,1,0,4719,A
5-NP,1119,0,4643,0,1,4644,T
5-NP,1120,4627,0,3,0,4630,A
5-NP,1121,0,4624,0,2,4626,T
5-NP,1122,2,12,4336,0,4350,G
5-NP,1123,12,4,4269,1,4286,G
5-NP,1124,1,2,4284,0,4287,G
5-NP,1125,4269,0,1,0,4270,A
5-NP,1126,2,4255,0,2,4259,T
5-NP,1127,10,6,0,3525,3541,C
5-NP,1128,2,8,3540,1,3551,G
5-NP,1129,3540,0,3,0,3543,A
5-NP,1130,6,0,3545,0,3551,G
5-NP,1131,2,0,0,3529,3531,C
5-NP,1132,3513,0,3,0,3516,A
5-NP,1133,0,1,0,3761,3762,C
5-NP,1134,0,3700,0,4,3704,T
5-NP,1135,11,2,0,3717,3730,C
5-NP,1136,1,3706,0,5,3712,T
5-NP,1137,0,3679,0,2,3681,T
5-NP,1138,1,15,3673,2,3691,G
5-NP,1139,3663,2,4,0,3669,A
5-NP,1140,3690,0,8,0,3698,A
5-NP,1141,2,0,0,3702,3704,C
5-NP,1142,2,3137,0,1,3140,T
5-NP,1143,2,10,3141,1,3154,G
5-NP,1144,3061,0,3,0,3064,A
5-NP,1145,0,1,3094,0,3095,G
5-NP,1146,3094,0,0,0,3094,A
5-NP,1147,3095,0,0,0,3095,A
5-NP,1148,2,0,3115,0,3117,G
5-NP,1149,4,3,0,3060,3067,C
5-NP,1150,59,4,3013,0,3076,G
5-NP,1151,0,2,3090,0,3092,G
5-NP,1152,0,1,3119,0,3120,G
5-NP,1153,0,3123,0,0,3123,T
5-NP,1154,3090,1,1,0,3092,A
5-NP,1155,0,1,0,3086,3087,C
5-NP,1156,0,2861,1,2,2864,T
5-NP,1157,1,5,2888,0,2894,G
5-NP,1158,1,3,2854,0,2858,G
5-NP,1159,2,0,2879,1,2882,G
5-NP,1160,0,0,0,2870,2870,C
5-NP,1161,7,0,0,2730,2737,C
5-NP,1162,2765,0,2,0,2767,A
5-NP,1163,0,2762,0,1,2763,T
5-NP,1164,2759,0,0,0,2759,A
5-NP,1165,2761,0,2,0,2763,A
5-NP,1166,1,6,2723,0,2730,G
5-NP,1167,1,6,2789,0,2796,G
5-NP,1168,2749,0,3,0,2752,A
5-NP,1169,1,2,1,2732,2736,C
5-NP,1170,1,0,0,2751,2752,C
5-NP,1171,2740,0,0,0,2740,A
5-NP,1172,2,1,2730,0,2733,G
5-NP,1173,2597,0,4,0,2601,A
5-NP,1174,2688,1,1,0,2690,A
5-NP,1175,0,0,2708,0,2708,G
5-NP,1176,0,2691,2,1,2694,T
5-NP,1177,4,4,2681,0,2689,G
5-NP,1178,1,4,2726,0,2731,G
5-NP,1179,2708,0,5,1,2714,A
5-NP,1180,1,3,2726,1,2731,G
5-NP,1181,0,5,2665,0,2670,G
5-NP,1182,2649,1,0,0,2650,A
5-NP,1183,2648,0,6,0,2654,A
5-NP,1184,2661,1,3,0,2665,A
5-NP,1185,0,3,0,2681,2684,C
5-NP,1186,2677,0,2,0,2679,A
5-NP,1187,0,1,1,2767,2769,C
5-NP,1188,0,2721,1,4,2726,T
5-NP,1189,2788,0,2,1,2791,A
5-NP,1190,2790,0,1,0,2791,A
5-NP,1191,1,2780,0,0,2781,T
5-NP,1192,9,2,0,2792,2803,C
5-NP,1193,2764,0,2,0,2766,A
5-NP,1194,2776,1,3,0,2780,A
5-NP,1195,1,0,0,2792,2793,C
5-NP,1196,2680,0,3,2,2685,A
5-NP,1197,1,2,2689,0,2692,G
5-NP,1198,2561,0,3,0,2564,A
5-NP,1199,2,1,2587,1,2591,G
5-NP,1200,1,2,2572,0,2575,G
5-NP,1201,1,1,2572,0,2574,G
5-NP,1202,1,3,0,2568,2572,C
5-NP,1203,4,1,0,2567,2572,C
5-NP,1204,0,2511,0,1,2512,T
5-NP,1205,2,1,0,2547,2550,C
5-NP,1206,5,1,0,2547,2553,C
5-NP,1207,3,1,2556,0,2560,G
5-NP,1208,1,0,0,2537,2538,C
5-NP,1209,2502,0,5,1,2508,A
5-NP,1210,0,0,2617,0,2617,G
5-NP,1211,0,1,2624,0,2625,G
5-NP,1212,2,0,0,2635,2637,C
5-NP,1213,2,0,0,2644,2646,C
5-NP,1214,2608,1,0,0,2609,A
5-NP,1215,2633,0,1,0,2634,A
5-NP,1216,2643,0,0,0,2643,A
5-NP,1217,0,1,0,2654,2655,C
5-NP,1218,1,1,0,2658,2660,C
5-NP,1219,2418,0,0,0,2418,A
5-NP,1220,2,4,2468,0,2474,G
5-NP,1221,0,2420,0,1,2421,T
5-NP,1222,0,0,2439,0,2439,G
5-NP,1223,0,2428,0,1,2429,T
5-NP,1224,0,1,2411,0,2412,G
5-NP,1225,1,1,0,2420,2422,C
5-NP,1226,2384,0,0,0,2384,A
5-NP,1227,2434,0,4,0,2438,A
5-NP,1228,0,2,0,2418,2420,C
5-NP,1229,2,0,0,2396,2398,C
5-NP,1230,0,2357,0,2,2359,T
5-NP,1231,2351,1,5,0,2357,A
5-NP,1232,0,0,0,2355,2355,C
5-NP,1233,2,1,2355,0,2358,G
5-NP,1234,0,2330,1,3,2334,T
5-NP,1235,0,2348,0,1,2349,T
5-NP,1236,0,2314,0,1,2315,T
5-NP,1237,1,2294,0,0,2295,T
5-NP,1238,1,0,0,2296,2297,C
5-NP,1239,0,2247,0,8,2255,T
5-NP,1240,0,0,2326,0,2326,G
5-NP,1241,0,2309,0,3,2312,T
5-NP,1242,2330,0,4,0,2334,A
5-NP,1243,1,0,0,2347,2348,C
5-NP,1244,2290,1,0,1,2292,A
5-NP,1245,2306,0,0,0,2306,A
5-NP,1246,2294,0,0,1,2295,A
5-NP,1247,0,2,2308,0,2310,G
5-NP,1248,2278,0,1,1,2280,A
5-NP,1249,2179,0,0,0,2179,A
5-NP,1250,2164,0,5,0,2169,A
5-NP,1251,0,2,0,2177,2179,C
5-NP,1252,0,1,1,2144,2146,C
5-NP,1253,0,2127,0,2,2129,T
5-NP,1254,4,0,0,2129,2133,C
5-NP,1255,2,2,1,2137,2142,C
5-NP,1256,3,0,0,2129,2132,C
5-NP,1257,2132,0,1,0,2133,A
5-NP,1258,1,2130,0,2,2133,T
5-NP,1259,0,2137,0,3,2140,T
5-NP,1260,0,2131,0,1,2132,T
5-NP,1261,0,2,2132,0,2134,G
5-NP,1262,2131,0,3,0,2134,A
5-NP,1263,2124,0,2,0,2126,A
5-NP,1264,2126,0,2,1,2129,A
5-NP,1265,2122,1,1,0,2124,A
5-NP,1266,0,0,2169,0,2169,G
5-NP,1267,0,2143,0,2,2145,T
5-NP,1268,12,1,0,2132,2145,C
5-NP,1269,2150,0,2,1,2153,A
5-NP,1270,2168,0,6,0,2174,A
5-NP,1271,0,0,0,2167,2167,C
5-NP,1272,1,0,1,2209,2211,C
5-NP,1273,2211,0,1,0,2212,A
5-NP,1274,1,2207,0,4,2212,T
5-NP,1275,9,1,0,2185,2195,C
5-NP,1276,2162,0,1,0,2163,A
5-NP,1277,0,2179,0,1,2180,T
5-NP,1278,1,3,2176,0,2180,G
5-NP,1279,1,4,2175,0,2180,G
5-NP,1280,1,1,0,2166,2168,C
5-NP,1281,2122,0,0,0,2122,A
5-NP,1282,2,0,2122,0,2124,G
5-NP,1283,3,0,0,2098,2101,C
5-NP,1284,2119,0,0,0,2119,A
5-NP,1285,1,2111,0,2,2114,T
5-NP,1286,0,2081,0,2,2083,T
5-NP,1287,3,2,0,2085,2090,C
5-NP,1288,2068,0,2,0,2070,A
5-NP,1289,1,0,0,2089,2090,C
5-NP,1290,0,2067,0,2,2069,T
5-NP,1291,2,1,2079,0,2082,G
5-NP,1292,0,3,2076,0,2079,G
5-NP,1293,2062,0,0,0,2062,A
5-NP,1294,2060,0,3,0,2063,A
5-NP,1295,2075,0,0,0,2075,A
5-NP,1296,0,2061,0,0,2061,T
5-NP,1297,2066,0,0,0,2066,A
5-NP,1298,1,0,0,2052,2053,C
5-NP,1299,0,2,2004,0,2006,G
5-NP,1300,0,4,1999,0,2003,G
5-NP,1301,1959,0,1,0,1960,A
5-NP,1302,1947,0,1,0,1948,A
5-NP,1303,0,3,1968,1,1972,G
5-NP,1304,0,3,1985,0,1988,G
5-NP,1305,1989,1,0,0,1990,A
5-NP,1306,1978,0,2,0,1980,A
5-NP,1307,0,6,1984,0,1990,G
5-NP,1308,1986,0,3,0,1989,A
5-NP,1309,1994,0,0,0,1994,A
5-NP,1310,0,0,0,2042,2042,C
5-NP,1311,0,2008,0,3,2011,T
5-NP,1312,0,2017,0,2,2019,T
5-NP,1313,2,0,0,2025,2027,C
5-NP,1314,2026,1,4,0,2031,A
5-NP,1315,1,3,2027,0,2031,G
5-NP,1316,2018,1,3,0,2022,A
5-NP,1317,0,0,0,2030,2030,C
5-NP,1318,1998,0,1,0,1999,A
5-NP,1319,0,1929,0,0,1929,T
5-NP,1320,0,4,1928,0,1932,G
5-NP,1321,1880,0,4,0,1884,A
5-NP,1322,2,6,1913,1,1922,G
5-NP,1323,0,3,1923,0,1926,G
5-NP,1324,2,0,1917,1,1920,G
5-NP,1325,0,1,0,1928,1929,C
5-NP,1326,1910,0,4,0,1914,A
5-NP,1327,0,4,1918,0,1922,G
5-NP,1328,1898,1,2,0,1901,A
5-NP,1329,1923,0,2,0,1925,A
5-NP,1330,1934,0,0,0,1934,A
5-NP,1331,0,1918,0,3,1921,T
5-NP,1332,3,0,0,1937,1940,C
5-NP,1333,1926,1,1,0,1928,A
5-NP,1334,0,1927,0,0,1927,T
5-NP,1335,1932,0,1,0,1933,A
5-NP,1336,1911,0,1,0,1912,A
5-NP,1337,0,4,1957,0,1961,G
5-NP,1338,1906,1,2,0,1909,A
5-NP,1339,1947,0,0,0,1947,A
5-NP,1340,0,1899,0,0,1899,T
5-NP,1341,2,0,1921,0,1923,G
5-NP,1342,1907,1,3,0,1911,A
5-NP,1343,1,1898,0,2,1901,T
5-NP,1344,0,2,1912,0,1914,G
5-NP,1345,1,0,1914,0,1915,G
5-NP,1346,1842,0,2,0,1844,A
5-NP,1347,1832,0,1,1,1834,A
5-NP,1348,0,2,1798,0,1800,G
5-NP,1349,1,1,1855,0,1857,G
5-NP,1350,0,1830,0,4,1834,T
5-NP,1351,0,0,1833,0,1833,G
5-NP,1352,0,0,0,1829,1829,C
5-NP,1353,1828,1,0,0,1829,A
5-NP,1354,1836,0,2,1,1839,A
5-NP,1355,1836,0,0,0,1836,A
5-NP,1356,1863,0,3,0,1866,A
5-NP,1357,0,0,0,1874,1874,C
5-NP,1358,3,1,0,1828,1832,C
5-NP,1359,1793,0,4,0,1797,A
5-NP,1360,0,1,1809,0,1810,G
5-NP,1361,1800,0,3,0,1803,A
5-NP,1362,1801,0,0,0,1801,A
5-NP,1363,0,0,1812,0,1812,G
5-NP,1364,1784,2,0,0,1786,A
5-NP,1365,1720,0,2,0,1722,A
5-NP,1366,0,1,1775,0,1776,G
5-NP,1367,0,1749,0,5,1754,T
5-NP,1368,1,0,1762,0,1763,G
5-NP,1369,0,1750,0,0,1750,T
5-NP,1370,4,0,0,1756,1760,C
5-NP,1371,1759,0,1,0,1760,A
5-NP,1372,0,1797,0,0,1797,T
5-NP,1373,0,1775,0,0,1775,T
5-NP,1374,1,0,0,1789,1790,C
5-NP,1375,3,0,0,1740,1743,C
5-NP,1376,3,4,1736,1,1744,G
5-NP,1377,0,6,1745,0,1751,G
5-NP,1378,2,1,1746,0,1749,G
5-NP,1379,0,2,1758,1,1761,G
5-NP,1380,0,2,1745,0,1747,G
5-NP,1381,1669,1,3,0,1673,A
5-NP,1382,0,4,1683,0,1687,G
5-NP,1383,1,6,1674,0,1681,G
5-NP,1384,1,0,1677,0,1678,G
5-NP,1385,0,5,1684,0,1689,G
5-NP,1386,1672,0,3,0,1675,A
5-NP,1387,0,0,1687,0,1687,G
5-NP,1388,0,1659,2,0,1661,T
5-NP,1389,0,1648,0,0,1648,T
5-NP,1390,0,1655,0,1,1656,T
5-NP,1391,0,1646,0,1,1647,T
5-NP,1392,3,0,0,1651,1654,C
5-NP,1393,0,5,1652,0,1657,G
5-NP,1394,1638,0,2,0,1640,A
5-NP,1395,0,0,1670,0,1670,G
5-NP,1396,0,1,0,1652,1653,C
5-NP,1397,0,1649,0,4,1653,T
5-NP,1398,0,0,0,1676,1676,C
5-NP,1399,1,1669,0,2,1672,T
5-NP,1400,1,1,0,1690,1692,C
5-NP,1401,1697,0,0,1,1698,A
5-NP,1402,0,0,1706,0,1706,G
5-NP,1403,1703,0,1,0,1704,A
5-NP,1404,0,1,0,1706,1707,C
5-NP,1405,0,7,1692,0,1699,G
5-NP,1406,1655,1,1,0,1657,A
5-NP,1407,1,0,1669,0,1670,G
5-NP,1408,1644,0,4,0,1648,A
5-NP,1409,1642,1,2,0,1645,A
5-NP,1410,0,1,1653,0,1654,G
5-NP,1411,2,1,1632,0,1635,G
5-NP,1412,0,0,0,1622,1622,C
5-NP,1413,1630,0,3,0,1633,A
5-NP,1414,1629,0,2,0,1631,A
5-NP,1415,1,1,0,1621,1623,C
5-NP,1416,0,4,1625,0,1629,G
5-NP,1417,1638,0,0,0,1638,A
5-NP,1418,1634,0,3,0,1637,A
5-NP,1419,0,0,0,1618,1618,C
5-NP,1420,0,2,0,1608,1610,C
5-NP,1421,4,1,0,1596,1601,C
5-NP,1422,1,3,1598,0,1602,G
5-NP,1423,1607,0,1,0,1608,A
5-NP,1424,0,1602,0,0,1602,T
5-NP,1425,5,2,0,1575,1582,C
5-NP,1426,2,0,1585,0,1587,G
5-NP,1427,0,1564,0,0,1564,T
5-NP,1428,2,1,1569,0,1572,G
5-NP,1429,1,0,0,1557,1558,C
5-NP,1430,3,4,0,1552,1559,C
5-NP,1431,7,1,0,1550,1558,C
5-NP,1432,0,1534,0,5,1539,T
5-NP,1433,1,0,0,1628,1629,C
5-NP,1434,0,1628,1,3,1632,T
5-NP,1435,0,1621,0,1,1622,T
5-NP,1436,0,1630,0,0,1630,T
5-NP,1437,1,1613,0,1,1615,T
5-NP,1438,0,3,1627,0,1630,G
5-NP,1439,1616,0,0,0,1616,A
5-NP,1440,0,1605,0,2,1607,T
5-NP,1441,1597,0,0,0,1597,A
5-NP,1442,0,1296,0,0,1296,T
5-NP,1443,0,6,1309,0,1315,G
5-NP,1444,1298,0,1,0,1299,A
5-NP,1445,0,0,1331,0,1331,G
5-NP,1446,0,1321,0,1,1322,T
5-NP,1447,1277,0,0,0,1277,A
5-NP,1448,1277,0,2,1,1280,A
5-NP,1449,0,1282,0,0,1282,T
5-NP,1450,0,0,1273,0,1273,G
5-NP,1451,1273,0,1,0,1274,A
5-NP,1452,1133,0,3,0,1136,A
5-NP,1453,0,1,1137,0,1138,G
5-NP,1454,0,4,1057,0,1061,G
5-NP,1455,1043,0,1,0,1044,A
5-NP,1456,0,1044,0,1,1045,T
5-NP,1457,1,0,0,1042,1043,C
5-NP,1458,0,1028,0,2,1030,T
5-NP,1459,0,1031,0,1,1032,T
5-NP,1460,1038,1,0,0,1039,A
5-NP,1461,0,1029,0,4,1033,T
5-NP,1462,1,1026,0,0,1027,T
5-NP,1463,0,1002,0,2,1004,T
5-NP,1464,3,2,1,970,976,C
5-NP,1465,1,922,0,0,923,T
5-NP,1466,0,919,0,1,920,T
5-NP,1467,1,0,0,919,920,C
5-NP,1468,1,1,908,0,910,G
5-NP,1469,0,1,913,0,914,G
5-NP,1470,897,0,2,0,899,A
5-NP,1471,0,2,907,0,909,G
5-NP,1472,911,0,0,0,911,A
5-NP,1473,0,0,0,899,899,C
5-NP,1474,871,0,1,0,872,A
5-NP,1475,868,0,2,0,870,A
5-NP,1476,0,873,0,0,873,T
5-NP,1477,0,0,872,0,872,G
5-NP,1478,0,1,0,870,871,C
5-NP,1479,834,1,7,1,843,A
5-NP,1480,0,0,843,0,843,G
5-NP,1481,837,0,0,1,838,A
5-NP,1482,795,1,1,0,797,A
5-NP,1483,0,1,793,0,794,G
5-NP,1484,533,0,2,0,535,A
5-NP,1485,0,0,539,0,539,G
5-NP,1486,0,484,0,0,484,T
5-NP,1487,481,0,1,0,482,A
5-NP,1488,0,0,0,481,481,C
5-NP,1489,1,0,442,0,443,G
5-NP,1490,443,0,1,0,444,A
5-NP,1491,0,0,0,439,439,C
5-NP,1492,314,0,1,0,315,A
5-NP,1493,316,0,0,0,316,A
5-NP,1494,0,264,0,0,264,T
5-NP,1495,0,251,0,0,251,T
5-NP,1496,251,0,0,0,251,A
5-NP,1497,241,0,0,0,241,A
6-NA,1,148,0,0,0,148,A
6-NA,2,0,153,0,0,153,T
6-NA,3,0,0,155,0,155,G
6-NA,4,155,0,2,0,157,A
6-NA,5,166,0,0,0,166,A
6-NA,6,0,163,0,1,164,T
6-NA,7,2,1,0,163,166,C
6-NA,8,0,0,0,166,166,C
6-NA,9,167,0,0,0,167,A
6-NA,10,176,1,0,0,177,A
6-NA,11,178,0,0,0,178,A
6-NA,12,0,185,0,0,185,T
6-NA,13,1,0,0,184,185,C
6-NA,14,186,0,0,0,186,A
6-NA,15,187,0,0,0,187,A
6-NA,16,186,0,0,0,186,A
6-NA,17,198,0,1,0,199,A
6-NA,18,0,0,220,0,220,G
6-NA,19,225,0,0,0,225,A
6-NA,20,0,229,0,0,229,T
6-NA,21,231,0,0,0,231,A
6-NA,22,231,1,0,0,232,A
6-NA,23,0,236,0,0,236,T
6-NA,24,236,0,0,0,236,A
6-NA,25,240,0,0,0,240,A
6-NA,26,0,0,0,247,247,C
6-NA,27,1,1,247,0,249,G
6-NA,28,250,0,0,0,250,A
6-NA,29,0,251,0,0,251,T
6-NA,30,0,249,0,0,249,T
6-NA,31,0,0,250,0,250,G
6-NA,32,1,0,267,0,268,G
6-NA,33,0,0,0,276,276,C
6-NA,34,0,275,0,2,277,T
6-NA,35,0,0,0,287,287,C
6-NA,36,0,285,0,0,285,T
6-NA,37,0,0,290,0,290,G
6-NA,38,0,290,0,1,291,T
6-NA,39,0,289,0,1,290,T
6-NA,40,0,299,0,0,299,T
6-NA,41,0,0,0,303,303,C
6-NA,42,0,306,0,0,306,T
6-NA,43,2,0,0,303,305,C
6-NA,44,0,307,0,0,307,T
6-NA,45,0,0,0,313,313,C
6-NA,46,311,0,0,0,311,A
6-NA,47,0,0,0,333,333,C
6-NA,48,0,0,0,331,331,C
6-NA,49,330,0,0,0,330,A
6-NA,50,0,336,0,1,337,T
6-NA,51,0,341,0,0,341,T
6-NA,52,0,342,0,0,342,T
6-NA,53,0,0,0,353,353,C
6-NA,54,0,0,0,353,353,C
6-NA,55,358,0,0,0,358,A
6-NA,56,0,0,0,378,378,C
6-NA,57,373,0,0,0,373,A
6-NA,58,401,0,0,0,401,A
6-NA,59,0,400,0,0,400,T
6-NA,60,418,0,0,0,418,A
6-NA,61,0,420,0,0,420,T
6-NA,62,0,0,422,0,422,G
6-NA,63,0,0,0,424,424,C
6-NA,64,0,418,0,1,419,T
6-NA,65,0,424,0,0,424,T
6-NA,66,0,0,0,427,427,C
6-NA,67,0,425,0,0,425,T
6-NA,68,0,426,0,0,426,T
6-NA,69,0,0,0,423,423,C
6-NA,70,422,0,1,0,423,A
6-NA,71,0,425,0,0,425,T
6-NA,72,0,0,423,0,423,G
6-NA,73,0,0,0,428,428,C
6-NA,74,423,0,0,0,423,A
6-NA,75,427,0,0,0,427,A
6-NA,76,428,0,0,0,428,A
6-NA,77,0,435,0,0,435,T
6-NA,78,0,434,0,0,434,T
6-NA,79,0,0,433,0,433,G
6-NA,80,0,0,0,433,433,C
6-NA,81,1,1,0,432,434,C
6-NA,82,433,0,0,0,433,A
6-NA,83,0,434,0,0,434,T
6-NA,84,0,0,0,466,466,C
6-NA,85,0,466,0,0,466,T
6-NA,86,0,464,0,2,466,T
6-NA,87,0,0,475,0,475,G
6-NA,88,473,0,3,0,476,A
6-NA,89,0,480,0,0,480,T
6-NA,90,478,0,0,0,478,A
6-NA,91,479,0,0,0,479,A
6-NA,92,0,0,0,545,545,C
6-NA,93,0,530,0,0,530,T
6-NA,94,538,0,0,0,538,A
6-NA,95,0,0,0,569,569,C
6-NA,96,0,559,0,0,559,T
6-NA,97,0,0,571,0,571,G
6-NA,98,0,569,0,0,569,T
6-NA,99,564,0,2,0,566,A
6-NA,100,572,0,1,1,574,A
6-NA,101,0,0,0,551,551,C
6-NA,102,538,0,0,0,538,A
6-NA,103,0,537,1,0,538,T
6-NA,104,0,526,0,0,526,T
6-NA,105,0,1,527,0,528,G
6-NA,106,0,1,0,522,523,C
6-NA,107,532,0,0,0,532,A
6-NA,108,0,532,0,0,532,T
6-NA,109,0,527,0,1,528,T
6-NA,110,0,527,0,0,527,T
6-NA,111,2,1,0,518,521,C
6-NA,112,520,0,0,0,520,A
6-NA,113,524,0,0,0,524,A
6-NA,114,0,0,521,0,521,G
6-NA,115,0,0,0,530,530,C
6-NA,116,527,0,0,0,527,A
6-NA,117,552,0,0,0,552,A
6-NA,118,0,559,0,0,559,T
6-NA,119,562,0,0,0,562,A
6-NA,120,0,563,0,1,564,T
6-NA,121,1,0,571,0,572,G
6-NA,122,566,0,1,0,567,A
6-NA,123,584,0,0,0,584,A
6-NA,124,0,579,0,2,581,T
6-NA,125,0,575,0,0,575,T
6-NA,126,1,0,0,575,576,C
6-NA,127,573,0,1,0,574,A
6-NA,128,575,0,0,0,575,A
6-NA,129,0,0,0,575,575,C
6-NA,130,0,563,0,2,565,T
6-NA,131,1,0,0,570,571,C
6-NA,132,1,1,0,568,570,C
6-NA,133,2,1,0,585,588,C
6-NA,134,1,0,0,590,591,C
6-NA,135,1,0,0,587,588,C
6-NA,136,0,0,0,602,602,C
6-NA,137,2,0,0,602,604,C
6-NA,138,605,0,0,1,606,A
6-NA,139,603,0,0,0,603,A
6-NA,140,605,0,0,1,606,A
6-NA,141,0,1,0,620,621,C
6-NA,142,609,0,0,0,609,A
6-NA,143,622,0,1,0,623,A
6-NA,144,0,1,0,627,628,C
6-NA,145,2,0,0,624,626,C
6-NA,146,640,0,0,0,640,A
6-NA,147,638,0,1,1,640,A
6-NA,148,0,0,655,0,655,G
6-NA,149,0,650,0,1,651,T
6-NA,150,0,2,651,0,653,G
6-NA,151,664,0,0,0,664,A
6-NA,152,0,661,0,1,662,T
6-NA,153,0,0,660,0,660,G
6-NA,154,0,0,0,665,665,C
6-NA,155,0,652,0,0,652,T
6-NA,156,0,0,693,0,693,G
6-NA,157,0,683,0,1,684,T
6-NA,158,0,0,688,0,688,G
6-NA,159,0,686,0,1,687,T
6-NA,160,2,2,671,0,675,G
6-NA,161,675,0,2,0,677,A
6-NA,162,685,0,2,0,687,A
6-NA,163,2,0,0,681,683,C
6-NA,164,1,0,0,686,687,C
6-NA,165,658,0,1,0,659,A
6-NA,166,663,0,0,0,663,A
6-NA,167,1,1,0,698,700,C
6-NA,168,699,0,0,0,699,A
6-NA,169,707,0,1,0,708,A
6-NA,170,0,708,0,0,708,T
6-NA,171,711,0,0,0,711,A
6-NA,172,708,0,2,0,710,A
6-NA,173,0,707,1,1,709,T
6-NA,174,704,0,0,0,704,A
6-NA,175,0,2,710,0,712,G
6-NA,176,686,0,0,0,686,A
6-NA,177,687,0,0,0,687,A
6-NA,178,687,0,1,0,688,A
6-NA,179,0,0,700,0,700,G
6-NA,180,706,0,0,0,706,A
6-NA,181,712,0,0,0,712,A
6-NA,182,745,0,0,0,745,A
6-NA,183,0,0,0,753,753,C
6-NA,184,746,0,0,0,746,A
6-NA,185,0,758,0,1,759,T
6-NA,186,766,0,2,0,768,A
6-NA,187,773,0,1,0,774,A
6-NA,188,0,0,0,787,787,C
6-NA,189,774,0,2,0,776,A
6-NA,190,0,1,813,0,814,G
6-NA,191,794,0,2,0,796,A
6-NA,192,0,2,799,0,801,G
6-NA,193,789,0,1,0,790,A
6-NA,194,0,816,0,0,816,T
6-NA,195,819,0,0,0,819,A
6-NA,196,0,0,837,0,837,G
6-NA,197,0,815,0,0,815,T
6-NA,198,0,0,846,0,846,G
6-NA,199,0,836,0,1,837,T
6-NA,200,832,0,1,0,833,A
6-NA,201,0,829,0,0,829,T
6-NA,202,0,1,0,825,826,C
6-NA,203,0,810,0,0,810,T
6-NA,204,0,5,845,0,850,G
6-NA,205,847,0,0,0,847,A
6-NA,206,0,0,0,841,841,C
6-NA,207,1,0,0,847,848,C
6-NA,208,841,0,0,0,841,A
6-NA,209,843,0,1,0,844,A
6-NA,210,0,0,0,851,851,C
6-NA,211,853,0,0,0,853,A
6-NA,212,0,0,0,885,885,C
6-NA,213,1,0,0,875,876,C
6-NA,214,902,0,0,0,902,A
6-NA,215,0,1,0,930,931,C
6-NA,216,1,1,0,928,930,C
6-NA,217,937,0,1,0,938,A
6-NA,218,0,929,0,2,931,T
6-NA,219,914,0,0,0,914,A
6-NA,220,0,0,925,0,925,G
6-NA,221,890,0,1,0,891,A
6-NA,222,0,0,908,0,908,G
6-NA,223,883,1,0,0,884,A
6-NA,224,857,0,1,0,858,A
6-NA,225,1,1,863,1,866,G
6-NA,226,0,0,865,1,866,G
6-NA,227,865,0,2,0,867,A
6-NA,228,875,0,0,0,875,A
6-NA,229,874,0,0,0,874,A
6-NA,230,0,875,0,0,875,T
6-NA,231,869,1,0,0,870,A
6-NA,232,1,861,0,0,862,T
6-NA,233,0,0,860,0,860,G
6-NA,234,0,2,0,868,870,C
6-NA,235,0,0,0,859,859,C
6-NA,236,2,0,0,860,862,C
6-NA,237,2,0,0,869,871,C
6-NA,238,870,0,0,0,870,A
6-NA,239,896,0,0,0,896,A
6-NA,240,898,0,1,0,899,A
6-NA,241,0,0,0,899,899,C
6-NA,242,0,899,0,1,900,T
6-NA,243,887,0,0,1,888,A
6-NA,244,0,1,891,0,892,G
6-NA,245,0,0,0,898,898,C
6-NA,246,901,0,0,0,901,A
6-NA,247,0,2,912,0,914,G
6-NA,248,900,1,0,0,901,A
6-NA,249,941,0,2,0,943,A
6-NA,250,0,939,0,1,940,T
6-NA,251,942,0,2,0,944,A
6-NA,252,0,1,0,940,941,C
6-NA,253,937,0,0,0,937,A
6-NA,254,0,2,933,0,935,G
6-NA,255,940,0,0,0,940,A
6-NA,256,917,0,0,0,917,A
6-NA,257,923,0,0,0,923,A
6-NA,258,0,892,0,1,893,T
6-NA,259,0,896,0,1,897,T
6-NA,260,0,2,910,0,912,G
6-NA,261,1,0,909,0,910,G
6-NA,262,0,911,1,0,912,T
6-NA,263,4,0,0,909,913,C
6-NA,264,913,0,0,0,913,A
6-NA,265,918,1,0,0,919,A
6-NA,266,917,1,0,0,918,A
6-NA,267,2,0,924,0,926,G
6-NA,268,0,1,0,927,928,C
6-NA,269,1,0,0,924,925,C
6-NA,270,2,0,925,0,927,G
6-NA,271,1,0,0,926,927,C
6-NA,272,931,0,0,0,931,A
6-NA,273,954,0,0,0,954,A
6-NA,274,0,953,0,0,953,T
6-NA,275,1,0,959,0,960,G
6-NA,276,0,950,0,1,951,T
6-NA,277,0,2,949,0,951,G
6-NA,278,973,2,1,0,976,A
6-NA,279,0,2,0,983,985,C
6-NA,280,974,0,1,0,975,A
6-NA,281,0,986,1,0,987,T
6-NA,282,0,980,0,0,980,T
6-NA,283,981,0,1,0,982,A
6-NA,284,0,0,0,981,981,C
6-NA,285,972,0,0,0,972,A
6-NA,286,0,1,976,0,977,G
6-NA,287,0,0,976,0,976,G
6-NA,288,971,0,0,0,971,A
6-NA,289,0,973,0,0,973,T
6-NA,290,1,958,0,1,960,T
6-NA,291,0,953,0,1,954,T
6-NA,292,2,0,956,0,958,G
6-NA,293,0,0,0,961,961,C
6-NA,294,960,0,0,0,960,A
6-NA,295,0,0,0,973,973,C
6-NA,296,0,0,0,961,961,C
6-NA,297,0,952,0,1,953,T
6-NA,298,0,949,0,2,951,T
6-NA,299,0,960,0,2,962,T
6-NA,300,0,959,0,0,959,T
6-NA,301,0,973,0,0,973,T
6-NA,302,0,0,0,975,975,C
6-NA,303,0,975,0,0,975,T
6-NA,304,969,0,0,0,969,A
6-NA,305,967,0,0,0,967,A
6-NA,306,0,3,972,0,975,G
6-NA,307,0,3,966,0,969,G
6-NA,308,971,1,0,0,972,A
6-NA,309,0,1,0,972,973,C
6-NA,310,962,0,0,0,962,A
6-NA,311,968,0,0,0,968,A
6-NA,312,0,970,0,0,970,T
6-NA,313,2,967,0,0,969,T
6-NA,314,2,0,0,987,989,C
6-NA,315,0,3,986,0,989,G
6-NA,316,990,0,0,0,990,A
6-NA,317,0,992,0,0,992,T
6-NA,318,0,986,0,0,986,T
6-NA,319,987,0,0,0,987,A
6-NA,320,0,1,990,0,991,G
6-NA,321,0,0,992,0,992,G
6-NA,322,1,0,0,997,998,C
6-NA,323,0,974,1,2,977,T
6-NA,324,0,976,0,6,982,T
6-NA,325,0,985,0,1,986,T
6-NA,326,2,0,0,990,992,C
6-NA,327,1,2,0,990,993,C
6-NA,328,0,1,989,0,990,G
6-NA,329,0,0,0,992,992,C
6-NA,330,0,975,0,0,975,T
6-NA,331,1,0,1021,0,1022,G
6-NA,332,0,0,1022,0,1022,G
6-NA,333,0,1019,0,1,1020,T
6-NA,334,0,0,1017,0,1017,G
6-NA,335,0,1,1013,0,1014,G
6-NA,336,0,2,1023,0,1025,G
6-NA,337,0,3,1023,0,1026,G
6-NA,338,1020,0,1,0,1021,A
6-NA,339,0,0,0,1030,1030,C
6-NA,340,1014,0,0,0,1014,A
6-NA,341,0,1002,0,0,1002,T
6-NA,342,1,0,0,1011,1012,C
6-NA,343,1,1000,1,0,1002,T
6-NA,344,0,2,1003,0,1005,G
6-NA,345,0,2,1006,0,1008,G
6-NA,346,0,0,1016,0,1016,G
6-NA,347,0,1008,0,0,1008,T
6-NA,348,0,4,983,0,987,G
6-NA,349,985,0,0,0,985,A
6-NA,350,1,0,0,1036,1037,C
6-NA,351,1037,0,0,0,1037,A
6-NA,352,1111,0,0,0,1111,A
6-NA,353,0,3,1143,0,1146,G
6-NA,354,1128,0,1,0,1129,A
6-NA,355,0,2,1213,0,1215,G
6-NA,356,1280,0,4,0,1284,A
6-NA,357,1455,0,2,0,1457,A
6-NA,358,0,0,0,2072,2072,C
6-NA,359,0,0,0,2252,2252,C
6-NA,360,0,2257,0,1,2258,T
6-NA,361,0,2275,0,2,2277,T
6-NA,362,2280,0,1,0,2281,A
6-NA,363,0,2291,0,1,2292,T
6-NA,364,1,1,2471,0,2473,G
6-NA,365,1,2484,0,2,2487,T
6-NA,366,0,0,2578,0,2578,G
6-NA,367,1,2550,0,0,2551,T
6-NA,368,18,0,0,2519,2537,C
6-NA,369,2568,2,1,30,2601,A
6-NA,370,1,2595,0,4,2600,T
6-NA,371,1,1,2597,0,2599,G
6-NA,372,3,1,0,2596,2600,C
6-NA,373,0,4,2594,0,2598,G
6-NA,374,3087,0,2,0,3089,A
6-NA,375,1,3089,0,2,3092,T
6-NA,376,1,2,0,3185,3188,C
6-NA,377,3,1,0,3197,3201,C
6-NA,378,1,3294,1,11,3307,T
6-NA,379,0,16,3346,0,3362,G
6-NA,380,3350,0,6,0,3356,A
6-NA,381,1,1,0,3383,3385,C
6-NA,382,3374,0,2,0,3376,A
6-NA,383,3342,0,6,0,3348,A
6-NA,384,1,0,3585,0,3586,G
6-NA,385,0,3583,0,2,3585,T
6-NA,386,0,2,3645,0,3647,G
6-NA,387,0,3637,0,7,3644,T
6-NA,388,1,3643,0,1,3645,T
6-NA,389,3636,0,2,0,3638,A
6-NA,390,0,3628,0,7,3635,T
6-NA,391,4,0,1,3747,3752,C
6-NA,392,3752,0,1,0,3753,A
6-NA,393,3749,0,1,0,3750,A
6-NA,394,0,3729,0,2,3731,T
6-NA,395,1,3706,0,3,3710,T
6-NA,396,0,3713,0,4,3717,T
6-NA,397,1,3,3740,0,3744,G
6-NA,398,3,3,0,4036,4042,C
6-NA,399,8,0,0,4030,4038,C
6-NA,400,6,1,0,4077,4084,C
6-NA,401,1,4066,0,3,4070,T
6-NA,402,0,4096,0,4,4100,T
6-NA,403,0,13,4173,1,4187,G
6-NA,404,0,12,4195,0,4207,G
6-NA,405,4018,0,206,0,4224,A
6-NA,406,1,1,0,4245,4247,C
6-NA,407,4158,0,3,0,4161,A
6-NA,408,1,15,4329,0,4345,G
6-NA,409,2,5,4331,0,4338,G
6-NA,410,1,12,4558,0,4571,G
6-NA,411,4564,2,4,0,4570,A
6-NA,412,4558,0,5,0,4563,A
6-NA,413,0,2,0,4564,4566,C
6-NA,414,4538,1,7,0,4546,A
6-NA,415,5172,2,4,1,5179,A
6-NA,416,1,0,0,5239,5240,C
6-NA,417,5215,0,5,0,5220,A
6-NA,418,0,0,0,5292,5292,C
6-NA,419,1,5189,0,0,5190,T
6-NA,420,5273,0,3,0,5276,A
6-NA,421,5246,0,5,0,5251,A
6-NA,422,5278,0,8,0,5286,A
6-NA,423,1,6,0,5283,5290,C
6-NA,424,5001,3,3,0,5007,A
6-NA,425,5037,0,2,0,5039,A
6-NA,426,0,3,0,5032,5035,C
6-NA,427,5,1,5034,0,5040,G
6-NA,428,0,5019,0,5,5024,T
6-NA,429,10,2,4990,0,5002,G
6-NA,430,0,2,0,5042,5044,C
6-NA,431,5064,0,2,0,5066,A
6-NA,432,1,5071,0,3,5075,T
6-NA,433,1,5083,0,5,5089,T
6-NA,434,12,2,0,5167,5181,C
6-NA,435,5267,0,2,0,5269,A
6-NA,436,5278,0,6,0,5284,A
6-NA,437,5301,0,3,0,5304,A
6-NA,438,0,5310,2,4,5316,T
6-NA,439,1,38,5269,1,5309,G
6-NA,440,5430,1,7,1,5439,A
6-NA,441,5,1,0,5475,5481,C
6-NA,442,5455,1,4,0,5460,A
6-NA,443,2,2,0,5574,5578,C
6-NA,444,5495,0,5,1,5501,A
6-NA,445,2,2,6870,0,6874,G
6-NA,446,2,6886,0,1,6889,T
6-NA,447,6964,0,2,0,6966,A
6-NA,448,0,1,0,6961,6962,C
6-NA,449,7,3,6926,0,6936,G
6-NA,450,0,7127,0,15,7142,T
6-NA,451,2,21,7183,0,7206,G
6-NA,452,7189,2,4,0,7195,A
6-NA,453,1,7279,0,0,7280,T
6-NA,454,6417,1,4,0,6422,A
6-NA,455,0,9,6389,0,6398,G
6-NA,456,2,21,6328,0,6351,G
6-NA,457,6370,3,8,1,6382,A
6-NA,458,3,0,0,6476,6479,C
6-NA,459,6,2,0,6301,6309,C
6-NA,460,8,4,0,6378,6390,C
6-NA,461,17,2,0,6388,6407,C
6-NA,462,0,6447,0,11,6458,T
6-NA,463,0,6574,0,2,6576,T
6-NA,464,6614,0,2,1,6617,A
6-NA,465,4,6589,1,4,6598,T
6-NA,466,14,7,0,6576,6597,C
6-NA,467,2,8,6538,0,6548,G
6-NA,468,0,19,6503,0,6522,G
6-NA,469,6536,0,7,0,6543,A
6-NA,470,5,0,0,6608,6613,C
6-NA,471,11,5,0,6549,6565,C
6-NA,472,14,0,1,6929,6944,C
6-NA,473,0,6921,0,7,6928,T
6-NA,474,7047,1,2,0,7050,A
6-NA,475,0,7056,0,3,7059,T
6-NA,476,0,7059,0,3,7062,T
6-NA,477,2,9,7051,0,7062,G
6-NA,478,7041,0,2,0,7043,A
6-NA,479,1,7016,0,6,7023,T
6-NA,480,0,17,7025,0,7042,G
6-NA,481,6710,3,7,1,6721,A
6-NA,482,6725,0,12,2,6739,A
6-NA,483,2,6741,0,0,6743,T
6-NA,484,0,26,6855,0,6881,G
6-NA,485,6902,2,7,0,6911,A
6-NA,486,2,0,7058,0,7060,G
6-NA,487,1,6989,1,5,6996,T
6-NA,488,0,6999,0,3,7002,T
6-NA,489,7046,2,6,1,7055,A
6-NA,490,2,7,7055,0,7064,G
6-NA,491,1,0,7102,0,7103,G
6-NA,492,1,7079,0,9,7089,T
6-NA,493,4,5,7042,0,7051,G
6-NA,494,0,6954,0,8,6962,T
6-NA,495,1,6911,0,5,6917,T
6-NA,496,19,3,1,6998,7021,C
6-NA,497,10,1,1,7054,7066,C
6-NA,498,0,7034,1,12,7047,T
6-NA,499,1,7016,0,5,7022,T
6-NA,500,0,6998,1,4,7003,T
6-NA,501,2,7009,0,6,7017,T
6-NA,502,15,7,0,7008,7030,C
6-NA,503,7034,1,3,1,7039,A
6-NA,504,0,7163,1,6,7170,T
6-NA,505,3,0,0,7156,7159,C
6-NA,506,0,7050,1,2,7053,T
6-NA,507,1,17,7021,0,7039,G
6-NA,508,5,23,6947,0,6975,G
6-NA,509,6,2,6986,0,6994,G
6-NA,510,3,26,7059,0,7088,G
6-NA,511,7110,1,10,1,7122,A
6-NA,512,5,1,0,7189,7195,C
6-NA,513,17,1,0,7049,7067,C
6-NA,514,7212,0,6,1,7219,A
6-NA,515,7243,2,6,1,7252,A
6-NA,516,12,2,7234,0,7248,G
6-NA,517,1,0,0,7285,7286,C
6-NA,518,7273,0,7,0,7280,A
6-NA,519,7382,0,8,0,7390,A
6-NA,520,3,0,7454,0,7457,G
6-NA,521,1,7373,0,4,7378,T
6-NA,522,2,2,7595,0,7599,G
6-NA,523,1,7529,0,5,7535,T
6-NA,524,4,2,7778,0,7784,G
6-NA,525,1,6,0,7756,7763,C
6-NA,526,7745,0,5,0,7750,A
6-NA,527,2,7839,0,4,7845,T
6-NA,528,7609,1,2,1,7613,A
6-NA,529,5,1,7854,0,7860,G
6-NA,530,2,1,1,7836,7840,C
6-NA,531,7630,0,6,0,7636,A
6-NA,532,0,7608,3,2,7613,T
6-NA,533,7,20,7330,1,7358,G
6-NA,534,3,2,7725,0,7730,G
6-NA,535,1,7744,0,10,7755,T
6-NA,536,19,5,0,7650,7674,C
6-NA,537,3,5,0,7688,7696,C
6-NA,538,7522,0,5,0,7527,A
6-NA,539,5,1,7684,0,7690,G
6-NA,540,0,1,0,7706,7707,C
6-NA,541,0,7637,0,12,7649,T
6-NA,542,22,3,0,7682,7707,C
6-NA,543,7417,0,4,1,7422,A
6-NA,544,7485,0,5,2,7492,A
6-NA,545,1,3,7507,1,7512,G
6-NA,546,0,7523,0,10,7533,T
6-NA,547,0,7438,0,5,7443,T
6-NA,548,2,1,7438,0,7441,G
6-NA,549,2,7426,1,5,7434,T
6-NA,550,26,3,0,7387,7416,C
6-NA,551,7445,0,8,1,7454,A
6-NA,552,2,5,1,7493,7501,C
6-NA,553,2,15,7465,0,7482,G
6-NA,554,7562,0,2,1,7565,A
6-NA,555,1,7591,0,8,7600,T
6-NA,556,6,10,7740,0,7756,G
6-NA,557,2,10,7757,0,7769,G
6-NA,558,7746,0,21,0,7767,A
6-NA,559,7771,0,14,1,7786,A
6-NA,560,7879,0,8,0,7887,A
6-NA,561,7870,1,15,2,7888,A
6-NA,562,2,3,7964,0,7969,G
6-NA,563,6,2,0,7907,7915,C
6-NA,564,7888,0,10,1,7899,A
6-NA,565,3,7880,0,4,7887,T
6-NA,566,4,18,7915,0,7937,G
6-NA,567,4,2,7922,0,7928,G
6-NA,568,2,3,0,8016,8021,C
6-NA,569,0,7984,0,6,7990,T
6-NA,570,5,2,8014,1,8022,G
6-NA,571,2,0,0,7955,7957,C
6-NA,572,8001,1,3,0,8005,A
6-NA,573,0,8288,1,2,8291,T
6-NA,574,4,2,8305,0,8311,G
6-NA,575,3,8220,0,6,8229,T
6-NA,576,0,8370,0,10,8380,T
6-NA,577,2,8334,0,6,8342,T
6-NA,578,3,3,8805,0,8811,G
6-NA,579,1,8772,0,6,8779,T
6-NA,580,8772,1,8,1,8782,A
6-NA,581,0,8765,0,2,8767,T
6-NA,582,8495,0,4,0,8499,A
6-NA,583,8530,1,8,0,8539,A
6-NA,584,1,5,0,8455,8461,C
6-NA,585,2,18,8317,3,8340,G
6-NA,586,2,13,8332,0,8347,G
6-NA,587,5,21,8049,0,8075,G
6-NA,588,4,14,8089,0,8107,G
6-NA,589,2,7,8120,0,8129,G
6-NA,590,8061,4,6,1,8072,A
6-NA,591,0,8138,0,4,8142,T
6-NA,592,10,23,8153,0,8186,G
6-NA,593,8216,2,8,0,8226,A
6-NA,594,0,8266,0,4,8270,T
6-NA,595,8238,0,6,0,8244,A
6-NA,596,8373,0,2,1,8376,A
6-NA,597,8396,1,4,1,8402,A
6-NA,598,8377,0,2,0,8379,A
6-NA,599,8439,1,4,1,8445,A
6-NA,600,0,8424,0,2,8426,T
6-NA,601,1,1,8424,1,8427,G
6-NA,602,5,4,0,8371,8380,C
6-NA,603,8348,0,8,0,8356,A
6-NA,604,8390,0,12,0,8402,A
6-NA,605,2,0,0,8477,8479,C
6-NA,606,0,8435,2,4,8441,T
6-NA,607,3,5,8479,2,8489,G
6-NA,608,1,2,0,8463,8466,C
6-NA,609,0,8438,0,5,8443,T
6-NA,610,8448,0,9,1,8458,A
6-NA,611,5,3,8476,0,8484,G
6-NA,612,3,0,0,8536,8539,C
6-NA,613,0,8549,1,18,8568,T
6-NA,614,1,8486,1,4,8492,T
6-NA,615,9,2,0,8608,8619,C
6-NA,616,8660,1,2,0,8663,A
6-NA,617,0,8665,0,4,8669,T
6-NA,618,0,8660,1,6,8667,T
6-NA,619,0,8731,1,7,8739,T
6-NA,620,8767,2,4,0,8773,A
6-NA,621,0,4,1,8812,8817,C
6-NA,622,8714,0,3,2,8719,A
6-NA,623,8809,0,14,1,8824,A
6-NA,624,0,8713,0,6,8719,T
6-NA,625,2,31,8696,0,8729,G
6-NA,626,4,6,8687,0,8697,G
6-NA,627,0,13,8695,0,8708,G
6-NA,628,8636,0,15,0,8651,A
6-NA,629,3,10,8930,0,8943,G
6-NA,630,4,2,9022,0,9028,G
6-NA,631,1,0,2,9777,9780,C
6-NA,632,2,9760,3,16,9781,T
6-NA,633,1,9868,1,5,9875,T
6-NA,634,2,1,9992,0,9995,G
6-NA,635,4,9988,0,7,9999,T
6-NA,636,10196,1,12,0,10209,A
6-NA,637,2,11,10244,0,10257,G
6-NA,638,10004,0,14,2,10020,A
6-NA,639,2,10030,1,1,10034,T
6-NA,640,9097,1,4,0,9102,A
6-NA,641,1,3,9142,0,9146,G
6-NA,642,0,9028,2,9,9039,T
6-NA,643,4,0,8796,0,8800,G
6-NA,644,3,9282,0,6,9291,T
6-NA,645,1,9287,0,3,9291,T
6-NA,646,4,0,9442,0,9446,G
6-NA,647,1,9417,1,23,9442,T
6-NA,648,1,9371,3,11,9386,T
6-NA,649,2,9421,1,16,9440,T
6-NA,650,14,4,0,9225,9243,C
6-NA,651,9208,0,14,0,9222,A
6-NA,652,2,9171,2,7,9182,T
6-NA,653,5,20,9127,0,9152,G
6-NA,654,2,2,9821,1,9826,G
6-NA,655,5,9635,0,22,9662,T
6-NA,656,28,3,1,9615,9647,C
6-NA,657,26,7,0,9597,9630,C
6-NA,658,9690,2,6,1,9699,A
6-NA,659,9777,1,3,1,9782,A
6-NA,660,9769,0,19,4,9792,A
6-NA,661,0,10,9854,0,9864,G
6-NA,662,9785,0,4,1,9790,A
6-NA,663,9383,0,6,0,9389,A
6-NA,664,9368,1,9,4,9382,A
6-NA,665,3,9361,3,2,9369,T
6-NA,666,12,4,0,9772,9788,C
6-NA,667,14,2,1,9769,9786,C
6-NA,668,3,9701,3,10,9717,T
6-NA,669,9,0,0,9756,9765,C
6-NA,670,9705,2,17,0,9724,A
6-NA,671,5,14,9812,1,9832,G
6-NA,672,3,21,9790,0,9814,G
6-NA,673,10095,3,16,0,10114,A
6-NA,674,3,3,0,10111,10117,C
6-NA,675,17,4,0,9852,9873,C
6-NA,676,14,8,0,9895,9917,C
6-NA,677,9928,3,5,0,9936,A
6-NA,678,2,10,9926,0,9938,G
6-NA,679,0,24,9918,0,9942,G
6-NA,680,9856,7,8,0,9871,A
6-NA,681,3,2,10056,1,10062,G
6-NA,682,4,9801,0,12,9817,T
6-NA,683,34,3,0,9838,9875,C
6-NA,684,9861,1,15,1,9878,A
6-NA,685,2,14,9941,0,9957,G
6-NA,686,9847,0,12,1,9860,A
6-NA,687,9890,0,3,1,9894,A
6-NA,688,1,9832,1,3,9837,T
6-NA,689,2,7,9896,0,9905,G
6-NA,690,2,7,0,9855,9864,C
6-NA,691,9,2,9945,0,9956,G
6-NA,692,0,9860,3,13,9876,T
6-NA,693,3,9903,0,5,9911,T
6-NA,694,1,9836,0,2,9839,T
6-NA,695,4,2,9915,0,9921,G
6-NA,696,2,9942,0,6,9950,T
6-NA,697,9950,1,4,0,9955,A
6-NA,698,1,9867,0,11,9879,T
6-NA,699,30,4,0,9888,9922,C
6-NA,700,9842,0,6,0,9848,A
6-NA,701,9843,1,3,0,9847,A
6-NA,702,0,9877,0,2,9879,T
6-NA,703,3,9,9847,1,9860,G
6-NA,704,1,14,9870,0,9885,G
6-NA,705,10072,4,12,1,10089,A
6-NA,706,10112,0,15,1,10128,A
6-NA,707,1,13,1,10229,10244,C
6-NA,708,2,10256,0,20,10278,T
6-NA,709,2,10252,3,2,10259,T
6-NA,710,3,2,10688,0,10693,G
6-NA,711,2,10699,0,4,10705,T
6-NA,712,10692,1,6,0,10699,A
6-NA,713,3,6,0,10853,10862,C
6-NA,714,10474,1,8,0,10483,A
6-NA,715,7,1,11251,0,11259,G
6-NA,716,0,11178,0,5,11183,T
6-NA,717,11602,1,8,0,11611,A
6-NA,718,2,1,11675,1,11679,G
6-NA,719,0,11348,0,5,11353,T
6-NA,720,11304,1,10,0,11315,A
6-NA,721,11310,0,9,0,11319,A
6-NA,722,2,11272,1,4,11279,T
6-NA,723,2,57,11268,0,11327,G
6-NA,724,10917,2,6,0,10925,A
6-NA,725,2,1,0,11085,11088,C
6-NA,726,2,10611,1,8,10622,T
6-NA,727,6,9,10662,0,10677,G
6-NA,728,10602,4,19,1,10626,A
6-NA,729,1,10669,1,10,10681,T
6-NA,730,5,19,10642,0,10666,G
6-NA,731,3,20,10549,0,10572,G
6-NA,732,8,12,10592,0,10612,G
6-NA,733,10339,1,18,0,10358,A
6-NA,734,3,3,10406,0,10412,G
6-NA,735,1,10317,1,3,10322,T
6-NA,736,1,1,10367,0,10369,G
6-NA,737,1,1,1,10453,10456,C
6-NA,738,2,10413,1,16,10432,T
6-NA,739,1,10405,0,12,10418,T
6-NA,740,16,3,0,10421,10440,C
6-NA,741,10416,1,14,0,10431,A
6-NA,742,5,11,10478,0,10494,G
6-NA,743,3,14,10473,0,10490,G
6-NA,744,10452,0,10,0,10462,A
6-NA,745,10371,0,5,0,10376,A
6-NA,746,10273,0,8,2,10283,A
6-NA,747,10331,1,15,0,10347,A
6-NA,748,1,2,10419,2,10424,G
6-NA,749,1,2,0,10404,10407,C
6-NA,750,2,10329,0,7,10338,T
6-NA,751,4,15,10305,0,10324,G
6-NA,752,10242,2,17,1,10262,A
6-NA,753,0,10416,0,2,10418,T
6-NA,754,10483,2,4,0,10489,A
6-NA,755,2,6,2,11092,11102,C
6-NA,756,0,10980,0,7,10987,T
6-NA,757,10977,0,3,1,10981,A
6-NA,758,10965,0,4,2,10971,A
6-NA,759,10973,0,7,0,10980,A
6-NA,760,11338,1,6,1,11346,A
6-NA,761,0,11372,0,2,11374,T
6-NA,762,11340,1,2,0,11343,A
6-NA,763,3,2,0,11440,11445,C
6-NA,764,2,10797,1,14,10814,T
6-NA,765,10992,2,0,2,10996,A
6-NA,766,3,10869,1,19,10892,T
6-NA,767,1,11462,0,21,11484,T
6-NA,768,15,1,0,11569,11585,C
6-NA,769,11246,0,2,0,11248,A
6-NA,770,1,11208,1,11,11221,T
6-NA,771,1,11161,0,7,11169,T
6-NA,772,1,14,11244,0,11259,G
6-NA,773,11065,1,18,0,11084,A
6-NA,774,6,11,11099,0,11116,G
6-NA,775,2,16,11074,0,11092,G
6-NA,776,10491,3,8,1,10503,A
6-NA,777,1,31,10778,0,10810,G
6-NA,778,8,25,10772,1,10806,G
6-NA,779,4,11,10804,1,10820,G
6-NA,780,3,14,10849,0,10866,G
6-NA,781,10761,4,18,0,10783,A
6-NA,782,10825,0,10,1,10836,A
6-NA,783,10801,0,9,0,10810,A
6-NA,784,10759,1,5,0,10765,A
6-NA,785,1,10770,0,3,10774,T
6-NA,786,32,6,0,10648,10686,C
6-NA,787,2,5,10800,0,10807,G
6-NA,788,1,10761,0,6,10768,T
6-NA,789,1,10725,0,11,10737,T
6-NA,790,45,4,0,10724,10773,C
6-NA,791,10775,4,4,0,10783,A
6-NA,792,1,11574,0,7,11582,T
6-NA,793,11577,2,6,0,11585,A
6-NA,794,2,4,1,11664,11671,C
6-NA,795,0,11623,0,14,11637,T
6-NA,796,11655,1,12,1,11669,A
6-NA,797,3,7,11624,0,11634,G
6-NA,798,1,5,0,11638,11644,C
6-NA,799,11642,2,7,0,11651,A
6-NA,800,4,16,0,11680,11700,C
6-NA,801,11086,0,2,1,11089,A
6-NA,802,2,11299,0,6,11307,T
6-NA,803,1,11229,1,2,11233,T
6-NA,804,4,2,12190,1,12197,G
6-NA,805,3,12115,1,12,12131,T
6-NA,806,30,4,0,12080,12114,C
6-NA,807,12082,9,24,0,12115,A
6-NA,808,6,13,12098,0,12117,G
6-NA,809,7,18,12124,0,12149,G
6-NA,810,12100,4,3,1,12108,A
6-NA,811,11883,1,12,0,11896,A
6-NA,812,4,3,12110,0,12117,G
6-NA,813,1,11258,0,9,11268,T
6-NA,814,5,5,11321,1,11332,G
6-NA,815,2,6,1,11293,11302,C
6-NA,816,6,11223,2,15,11246,T
6-NA,817,30,5,0,11324,11359,C
6-NA,818,11300,1,13,1,11315,A
6-NA,819,4,4,11412,0,11420,G
6-NA,820,1,2,2,11406,11411,C
6-NA,821,11345,0,20,2,11367,A
6-NA,822,0,11369,1,5,11375,T
6-NA,823,4,3,11811,0,11818,G
6-NA,824,2,11768,1,18,11789,T
6-NA,825,37,7,0,11756,11800,C
6-NA,826,5,19,11767,0,11791,G
6-NA,827,11700,3,15,0,11718,A
6-NA,828,5,9,11671,0,11685,G
6-NA,829,1,22,11680,1,11704,G
6-NA,830,11506,4,8,0,11518,A
6-NA,831,8,6,11731,1,11746,G
6-NA,832,3,11211,0,14,11228,T
6-NA,833,2,4,11212,1,11219,G
6-NA,834,3,6,1,11356,11366,C
6-NA,835,3,11291,0,19,11313,T
6-NA,836,24,8,1,11389,11422,C
6-NA,837,12,8,1,11462,11483,C
6-NA,838,1,11499,1,15,11516,T
6-NA,839,8,3,11512,1,11524,G
6-NA,840,4,3,1,11405,11413,C
6-NA,841,0,11319,1,12,11332,T
6-NA,842,11493,2,5,1,11501,A
6-NA,843,2,11173,0,10,11185,T
6-NA,844,15,1,0,11295,11311,C
6-NA,845,11,2,0,11290,11303,C
6-NA,846,2,11233,2,20,11257,T
6-NA,847,11,9,0,11373,11393,C
6-NA,848,8,14,11334,0,11356,G
6-NA,849,11489,0,9,3,11501,A
6-NA,850,0,11490,2,20,11512,T
6-NA,851,11501,1,4,0,11506,A
6-NA,852,3,11458,0,6,11467,T
6-NA,853,9,2,8,11426,11445,C
6-NA,854,14,0,1,11382,11397,C
6-NA,855,1,11300,2,12,11315,T
6-NA,856,4,16,11372,0,11392,G
6-NA,857,5,2,11424,0,11431,G
6-NA,858,0,11611,0,11,11622,T
6-NA,859,4,0,11603,0,11607,G
6-NA,860,0,11483,1,18,11502,T
6-NA,861,38,4,0,11435,11477,C
6-NA,862,11483,0,8,1,11492,A
6-NA,863,6,5,11482,0,11493,G
6-NA,864,11455,6,9,2,11472,A
6-NA,865,0,11348,0,6,11354,T
6-NA,866,2,1,11369,0,11372,G
6-NA,867,1,11086,2,7,11096,T
6-NA,868,4,0,11072,5,11081,G
6-NA,869,3,11003,1,15,11022,T
6-NA,870,21,1,0,11081,11103,C
6-NA,871,5,11071,0,23,11099,T
6-NA,872,4,1,11125,1,11131,G
6-NA,873,3,4,0,11102,11109,C
6-NA,874,11092,0,12,0,11104,A
6-NA,875,42,15,11075,0,11132,G
6-NA,876,10743,0,14,2,10759,A
6-NA,877,1,17,10801,4,10823,G
6-NA,878,10812,1,7,0,10820,A
6-NA,879,2,1,0,10915,10918,C
6-NA,880,10864,0,13,2,10879,A
6-NA,881,10953,4,12,0,10969,A
6-NA,882,3,2,0,11058,11063,C
6-NA,883,1,11024,0,6,11031,T
6-NA,884,6,12,11006,0,11024,G
6-NA,885,0,11,10958,1,10970,G
6-NA,886,10926,1,6,0,10933,A
6-NA,887,10900,0,14,0,10914,A
6-NA,888,10619,0,22,0,10641,A
6-NA,889,1,14,10848,2,10865,G
6-NA,890,4,6,10763,0,10773,G
6-NA,891,2,4,1,10752,10759,C
6-NA,892,3,10608,1,22,10634,T
6-NA,893,16,6,0,10902,10924,C
6-NA,894,15,7,0,10993,11015,C
6-NA,895,11086,1,0,0,11087,A
6-NA,896,11072,0,7,1,11080,A
6-NA,897,2,11089,0,3,11094,T
6-NA,898,10614,1,7,0,10622,A
6-NA,899,2,13,10545,0,10560,G
6-NA,900,5,3,10529,0,10537,G
6-NA,901,3,5,0,10541,10549,C
6-NA,902,15,7,1,10239,10262,C
6-NA,903,36,4,1,10095,10136,C
6-NA,904,10205,2,6,0,10213,A
6-NA,905,2,10271,2,10,10285,T
6-NA,906,17,5,1,10283,10306,C
6-NA,907,6,2,10339,0,10347,G
6-NA,908,1,10294,0,1,10296,T
6-NA,909,10034,1,2,0,10037,A
6-NA,910,3,15,10331,1,10350,G
6-NA,911,10360,0,16,0,10376,A
6-NA,912,2,10407,0,4,10413,T
6-NA,913,10213,0,2,0,10215,A
6-NA,914,0,10075,0,4,10079,T
6-NA,915,10075,0,4,0,10079,A
6-NA,916,10035,1,7,0,10043,A
6-NA,917,10287,2,12,2,10303,A
6-NA,918,0,4,1,10528,10533,C
6-NA,919,10146,1,1,0,10148,A
6-NA,920,0,10121,2,1,10124,T
6-NA,921,9985,0,2,0,9987,A
6-NA,922,9981,2,9,2,9994,A
6-NA,923,9987,1,12,0,10000,A
6-NA,924,2,12,10130,1,10145,G
6-NA,925,5,15,10187,1,10208,G
6-NA,926,9735,2,4,0,9741,A
6-NA,927,1,9574,0,15,9590,T
6-NA,928,23,2,0,9651,9676,C
6-NA,929,9730,1,9,2,9742,A
6-NA,930,1,9733,0,12,9746,T
6-NA,931,9700,1,10,0,9711,A
6-NA,932,7,1,9794,0,9802,G
6-NA,933,1,5,0,9601,9607,C
6-NA,934,9364,0,5,0,9369,A
6-NA,935,0,9002,3,8,9013,T
6-NA,936,1,9057,0,6,9064,T
6-NA,937,1,2,9373,1,9377,G
6-NA,938,1,9371,1,8,9381,T
6-NA,939,1,9511,2,14,9528,T
6-NA,940,1,9485,1,13,9500,T
6-NA,941,17,3,0,9453,9473,C
6-NA,942,10,1,2,9497,9510,C
6-NA,943,9650,1,7,2,9660,A
6-NA,944,3,1,9814,0,9818,G
6-NA,945,0,9779,2,9,9790,T
6-NA,946,3,9384,0,6,9393,T
6-NA,947,9433,1,2,0,9436,A
6-NA,948,1,9287,0,6,9294,T
6-NA,949,2,4,9288,0,9294,G
6-NA,950,3,9146,0,15,9164,T
6-NA,951,4,1,9197,0,9202,G
6-NA,952,1,8929,0,6,8936,T
6-NA,953,2,1,9190,0,9193,G
6-NA,954,0,9184,0,7,9191,T
6-NA,955,1,9095,5,12,9113,T
6-NA,956,31,6,1,9081,9119,C
6-NA,957,9049,2,14,0,9065,A
6-NA,958,3,10,9146,0,9159,G
6-NA,959,0,16,9116,0,9132,G
6-NA,960,9032,1,6,0,9039,A
6-NA,961,3,2,1,9084,9090,C
6-NA,962,1,8678,0,5,8684,T
6-NA,963,0,8712,0,5,8717,T
6-NA,964,1,6,9081,0,9088,G
6-NA,965,0,9096,1,8,9105,T
6-NA,966,0,9069,1,11,9081,T
6-NA,967,2,7,9002,0,9011,G
6-NA,968,2,14,8993,1,9010,G
6-NA,969,8909,0,24,0,8933,A
6-NA,970,2,20,8986,1,9009,G
6-NA,971,8944,3,21,0,8968,A
6-NA,972,2,1,0,8981,8984,C
6-NA,973,8645,0,5,0,8650,A
6-NA,974,0,4,0,8678,8682,C
6-NA,975,8677,0,9,4,8690,A
6-NA,976,6,0,0,8691,8697,C
6-NA,977,13,2,1,8617,8633,C
6-NA,978,25,3,1,8651,8680,C
6-NA,979,8652,2,9,0,8663,A
6-NA,980,2,10,8701,0,8713,G
6-NA,981,8679,0,7,0,8686,A
6-NA,982,8745,0,2,0,8747,A
6-NA,983,8692,0,5,0,8697,A
6-NA,984,8657,2,6,1,8666,A
6-NA,985,8578,2,10,0,8590,A
6-NA,986,8604,1,7,3,8615,A
6-NA,987,1,3,0,8671,8675,C
6-NA,988,3,31,8618,1,8653,G
6-NA,989,8606,2,7,0,8615,A
6-NA,990,2,2,0,8609,8613,C
6-NA,991,8546,1,4,0,8551,A
6-NA,992,4,0,8651,0,8655,G
6-NA,993,0,3,0,8954,8957,C
6-NA,994,1,8850,2,11,8864,T
6-NA,995,23,1,0,8943,8967,C
6-NA,996,10,3,0,8984,8997,C
6-NA,997,9022,1,18,1,9042,A
6-NA,998,1,0,9134,0,9135,G
6-NA,999,3,2,0,9124,9129,C
6-NA,1000,9075,0,5,2,9082,A
6-NA,1001,1,2,9092,0,9095,G
6-NA,1002,1,8601,0,8,8610,T
6-NA,1003,8596,6,10,1,8613,A
6-NA,1004,2,3,8624,1,8630,G
6-NA,1005,3,11,0,8606,8620,C
6-NA,1006,10,4,1,8624,8639,C
6-NA,1007,8481,2,4,0,8487,A
6-NA,1008,1,8462,1,14,8478,T
6-NA,1009,3,8477,1,2,8483,T
6-NA,1010,2,2,8768,0,8772,G
6-NA,1011,1,8649,1,5,8656,T
6-NA,1012,1,8638,1,10,8650,T
6-NA,1013,2,8618,0,11,8631,T
6-NA,1014,3,17,8485,0,8505,G
6-NA,1015,4,7,8577,0,8588,G
6-NA,1016,8483,5,5,0,8493,A
6-NA,1017,1,8530,3,7,8541,T
6-NA,1018,15,3,0,8573,8591,C
6-NA,1019,9,0,2,8403,8414,C
6-NA,1020,3,8442,1,5,8451,T
6-NA,1021,8441,0,5,1,8447,A
6-NA,1022,8421,3,1,0,8425,A
6-NA,1023,1,8140,0,8,8149,T
6-NA,1024,8293,1,2,0,8296,A
6-NA,1025,8355,0,6,2,8363,A
6-NA,1026,3,8433,0,5,8441,T
6-NA,1027,3,13,8528,0,8544,G
6-NA,1028,8424,4,4,0,8432,A
6-NA,1029,8394,1,14,0,8409,A
6-NA,1030,5,4,8435,0,8444,G
6-NA,1031,8327,0,5,0,8332,A
6-NA,1032,8322,0,12,1,8335,A
6-NA,1033,2,19,8345,0,8366,G
6-NA,1034,4,1,8390,0,8395,G
6-NA,1035,1,8249,1,5,8256,T
6-NA,1036,4,19,8182,0,8205,G
6-NA,1037,1,2,8559,0,8562,G
6-NA,1038,0,8487,1,8,8496,T
6-NA,1039,31,3,2,8409,8445,C
6-NA,1040,8490,1,9,1,8501,A
6-NA,1041,0,8425,0,9,8434,T
6-NA,1042,1,9,8437,0,8447,G
6-NA,1043,2,20,8506,2,8530,G
6-NA,1044,8437,1,14,0,8452,A
6-NA,1045,1,3,8810,1,8815,G
6-NA,1046,1,8362,1,5,8369,T
6-NA,1047,4,13,8356,0,8373,G
6-NA,1048,8335,2,9,1,8347,A
6-NA,1049,8334,1,8,0,8343,A
6-NA,1050,8354,0,28,1,8383,A
6-NA,1051,1,10,8406,0,8417,G
6-NA,1052,3,3,8288,0,8294,G
6-NA,1053,0,1,0,8289,8290,C
6-NA,1054,1,7907,0,9,7917,T
6-NA,1055,4,11,7923,1,7939,G
6-NA,1056,5,10,7913,0,7928,G
6-NA,1057,2,1,8045,2,8050,G
6-NA,1058,7,0,0,8011,8018,C
6-NA,1059,8,1,1,8026,8036,C
6-NA,1060,2,7905,1,18,7926,T
6-NA,1061,1,7927,0,4,7932,T
6-NA,1062,1,7927,1,0,7929,T
6-NA,1063,1,9,7967,0,7977,G
6-NA,1064,7953,2,6,0,7961,A
6-NA,1065,1,7885,1,3,7890,T
6-NA,1066,2,16,7717,1,7736,G
6-NA,1067,7617,2,7,0,7626,A
6-NA,1068,0,7654,1,7,7662,T
6-NA,1069,4,5,7705,0,7714,G
6-NA,1070,1,10,7841,0,7852,G
6-NA,1071,7823,1,7,0,7831,A
6-NA,1072,7807,0,5,0,7812,A
6-NA,1073,7843,0,8,0,7851,A
6-NA,1074,1,7830,1,8,7840,T
6-NA,1075,0,17,7852,1,7870,G
6-NA,1076,7843,0,4,0,7847,A
6-NA,1077,3,2,0,7843,7848,C
6-NA,1078,5,1,7886,0,7892,G
6-NA,1079,0,7614,0,7,7621,T
6-NA,1080,11,0,7716,0,7727,G
6-NA,1081,0,7694,0,6,7700,T
6-NA,1082,3,10,7704,0,7717,G
6-NA,1083,3,9,7746,0,7758,G
6-NA,1084,7651,0,5,1,7657,A
6-NA,1085,1,7657,1,3,7662,T
6-NA,1086,0,24,7596,0,7620,G
6-NA,1087,6,7,7596,0,7609,G
6-NA,1088,4,3,7644,0,7651,G
6-NA,1089,7567,1,10,0,7578,A
6-NA,1090,7550,2,11,0,7563,A
6-NA,1091,3,12,7566,0,7581,G
6-NA,1092,7450,1,4,0,7455,A
6-NA,1093,7453,1,16,0,7470,A
6-NA,1094,3,3,0,7456,7462,C
6-NA,1095,4,25,7386,1,7416,G
6-NA,1096,7376,0,6,0,7382,A
6-NA,1097,0,7254,2,2,7258,T
6-NA,1098,24,2,0,7263,7289,C
6-NA,1099,7292,0,2,0,7294,A
6-NA,1100,2,2,7314,0,7318,G
6-NA,1101,2,3,0,7281,7286,C
6-NA,1102,47,13,7243,0,7303,G
6-NA,1103,7231,0,8,0,7239,A
6-NA,1104,2,5,7277,0,7284,G
6-NA,1105,7240,1,12,0,7253,A
6-NA,1106,7256,0,5,1,7262,A
6-NA,1107,2,0,7352,0,7354,G
6-NA,1108,1,7272,0,12,7285,T
6-NA,1109,27,0,0,7187,7214,C
6-NA,1110,7223,0,5,1,7229,A
6-NA,1111,1,2,0,7551,7554,C
6-NA,1112,3,2,7550,0,7555,G
6-NA,1113,2,1,0,7538,7541,C
6-NA,1114,0,7468,2,11,7481,T
6-NA,1115,2,7512,1,7,7522,T
6-NA,1116,7366,1,7,0,7374,A
6-NA,1117,0,22,7600,0,7622,G
6-NA,1118,0,13,7594,0,7607,G
6-NA,1119,0,2,7800,0,7802,G
6-NA,1120,4,7246,0,1,7251,T
6-NA,1121,7228,0,7,0,7235,A
6-NA,1122,0,7196,2,1,7199,T
6-NA,1123,1,8,7195,0,7204,G
6-NA,1124,7196,1,7,0,7204,A
6-NA,1125,7144,2,7,1,7154,A
6-NA,1126,6813,2,7,0,6822,A
6-NA,1127,1,2,0,6812,6815,C
6-NA,1128,7,2,1,6488,6498,C
6-NA,1129,0,6166,0,8,6174,T
6-NA,1130,0,6141,0,5,6146,T
6-NA,1131,6,6,1,6134,6147,C
6-NA,1132,6148,1,5,0,6154,A
6-NA,1133,6165,2,2,0,6169,A
6-NA,1134,6158,2,6,1,6167,A
6-NA,1135,11,1,6232,0,6244,G
6-NA,1136,2,6041,2,7,6052,T
6-NA,1137,29,1,0,6047,6077,C
6-NA,1138,6171,2,4,1,6178,A
6-NA,1139,0,6171,0,8,6179,T
6-NA,1140,0,6182,0,1,6183,T
6-NA,1141,1,11,6175,0,6187,G
6-NA,1142,6168,1,2,0,6171,A
6-NA,1143,6186,1,12,0,6199,A
6-NA,1144,6,6,6182,0,6194,G
6-NA,1145,1,3,6177,0,6181,G
6-NA,1146,2,2,0,6141,6145,C
6-NA,1147,2,5929,0,3,5934,T
6-NA,1148,2,4,5961,0,5967,G
6-NA,1149,1,4,6138,0,6143,G
6-NA,1150,1,6135,0,13,6149,T
6-NA,1151,24,3,0,6101,6128,C
6-NA,1152,12,3,0,6068,6083,C
6-NA,1153,6066,1,5,0,6072,A
6-NA,1154,6117,0,10,1,6128,A
6-NA,1155,4,3,0,6160,6167,C
6-NA,1156,16,1,0,6111,6128,C
6-NA,1157,18,1,0,6082,6101,C
6-NA,1158,0,5686,0,1,5687,T
6-NA,1159,5691,0,2,0,5693,A
6-NA,1160,5669,3,8,0,5680,A
6-NA,1161,4,1,5745,0,5750,G
6-NA,1162,1,5674,0,10,5685,T
6-NA,1163,11,2,0,5683,5696,C
6-NA,1164,12,3,0,5530,5545,C
6-NA,1165,5515,0,1,0,5516,A
6-NA,1166,5497,0,3,1,5501,A
6-NA,1167,5517,0,1,2,5520,A
6-NA,1168,1,5519,0,4,5524,T
6-NA,1169,0,5503,0,3,5506,T
6-NA,1170,0,0,5449,0,5449,G
6-NA,1171,3,3,0,5392,5398,C
6-NA,1172,5380,1,10,2,5393,A
6-NA,1173,1,3,5418,0,5422,G
6-NA,1174,5380,0,7,0,5387,A
6-NA,1175,0,5519,0,7,5526,T
6-NA,1176,5523,0,0,0,5523,A
6-NA,1177,5479,0,6,2,5487,A
6-NA,1178,5505,0,6,0,5511,A
6-NA,1179,0,5479,0,0,5479,T
6-NA,1180,5465,3,4,0,5472,A
6-NA,1181,1,12,5474,0,5487,G
6-NA,1182,2,1,5418,0,5421,G
6-NA,1183,1,3,0,5391,5395,C
6-NA,1184,5157,1,2,0,5160,A
6-NA,1185,5221,0,14,0,5235,A
6-NA,1186,5,0,5297,0,5302,G
6-NA,1187,0,5260,0,8,5268,T
6-NA,1188,29,0,0,5236,5265,C
6-NA,1189,5293,0,5,2,5300,A
6-NA,1190,1,5274,0,1,5276,T
6-NA,1191,5269,0,1,0,5270,A
6-NA,1192,4,0,5309,0,5313,G
6-NA,1193,1,5288,0,6,5295,T
6-NA,1194,0,5010,0,3,5013,T
6-NA,1195,0,13,4884,0,4897,G
6-NA,1196,4852,1,11,0,4864,A
6-NA,1197,2,4,0,4853,4859,C
6-NA,1198,4740,0,5,1,4746,A
6-NA,1199,0,6,4794,0,4800,G
6-NA,1200,4690,1,4,0,4695,A
6-NA,1201,3,1,4875,1,4880,G
6-NA,1202,1,1,4881,0,4883,G
6-NA,1203,0,4844,0,4,4848,T
6-NA,1204,4829,0,3,0,4832,A
6-NA,1205,4817,1,11,0,4829,A
6-NA,1206,0,4835,0,4,4839,T
6-NA,1207,4799,1,3,0,4803,A
6-NA,1208,26,2,4606,0,4634,G
6-NA,1209,0,1,4406,0,4407,G
6-NA,1210,0,3652,0,8,3660,T
6-NA,1211,13,1,1,3600,3615,C
6-NA,1212,5,1,1,3574,3581,C
6-NA,1213,5,6,3576,0,3587,G
6-NA,1214,1,0,3604,0,3605,G
6-NA,1215,2,3579,0,3,3584,T
6-NA,1216,0,3571,0,2,3573,T
6-NA,1217,3481,0,1,0,3482,A
6-NA,1218,0,3389,1,0,3390,T
6-NA,1219,0,3377,0,1,3378,T
6-NA,1220,5,1,0,3383,3389,C
6-NA,1221,0,3113,0,2,3115,T
6-NA,1222,2,2,3129,0,3133,G
6-NA,1223,0,1,3135,0,3136,G
6-NA,1224,1,3108,0,2,3111,T
6-NA,1225,3112,0,2,0,3114,A
6-NA,1226,0,3049,0,5,3054,T
6-NA,1227,0,3036,0,10,3046,T
6-NA,1228,1,3040,0,6,3047,T
6-NA,1229,2,3076,0,3,3081,T
6-NA,1230,4,1,0,3067,3072,C
6-NA,1231,2,3044,0,5,3051,T
6-NA,1232,6,0,0,3068,3074,C
6-NA,1233,0,3044,0,2,3046,T
6-NA,1234,1,0,3125,0,3126,G
6-NA,1235,0,3116,0,1,3117,T
6-NA,1236,0,3093,0,1,3094,T
6-NA,1237,0,1,3089,0,3090,G
6-NA,1238,3044,3,4,0,3051,A
6-NA,1239,3044,0,6,1,3051,A
6-NA,1240,1,5,3089,0,3095,G
6-NA,1241,3,3,3080,0,3086,G
6-NA,1242,0,2,0,3089,3091,C
6-NA,1243,3040,0,1,0,3041,A
6-NA,1244,3036,0,3,1,3040,A
6-NA,1245,3061,0,4,1,3066,A
6-NA,1246,3065,1,7,1,3074,A
6-NA,1247,0,1,3079,0,3080,G
6-NA,1248,0,1,0,3078,3079,C
6-NA,1249,1,3030,0,3,3034,T
6-NA,1250,0,0,3084,0,3084,G
6-NA,1251,2,2,0,3069,3073,C
6-NA,1252,3083,0,4,0,3087,A
6-NA,1253,0,3066,1,4,3071,T
6-NA,1254,7,0,0,3057,3064,C
6-NA,1255,3050,0,2,0,3052,A
6-NA,1256,3054,1,1,1,3057,A
6-NA,1257,0,3046,0,0,3046,T
6-NA,1258,5,2,0,3051,3058,C
6-NA,1259,2,2,3013,0,3017,G
6-NA,1260,0,1,3115,0,3116,G
6-NA,1261,1,3101,0,1,3103,T
6-NA,1262,1,0,3126,0,3127,G
6-NA,1263,3,0,0,3137,3140,C
6-NA,1264,0,3125,0,8,3133,T
6-NA,1265,0,3169,0,7,3176,T
6-NA,1266,0,3195,0,3,3198,T
6-NA,1267,0,3217,1,0,3218,T
6-NA,1268,3249,0,3,0,3252,A
6-NA,1269,1,3112,0,4,3117,T
6-NA,1270,3,2,3121,0,3126,G
6-NA,1271,0,3077,0,2,3079,T
6-NA,1272,0,2,3033,0,3035,G
6-NA,1273,0,6,3080,0,3086,G
6-NA,1274,2998,0,3,0,3001,A
6-NA,1275,2,0,3074,0,3076,G
6-NA,1276,0,3044,0,4,3048,T
6-NA,1277,0,3030,1,3,3034,T
6-NA,1278,1,5,3061,0,3067,G
6-NA,1279,3050,2,5,0,3057,A
6-NA,1280,1,3063,0,1,3065,T
6-NA,1281,3053,0,2,0,3055,A
6-NA,1282,2957,1,4,0,2962,A
6-NA,1283,2,8,2989,0,2999,G
6-NA,1284,0,7,2924,0,2931,G
6-NA,1285,1,4,2901,0,2906,G
6-NA,1286,1,3,2904,0,2908,G
6-NA,1287,2855,2,4,1,2862,A
6-NA,1288,2854,1,5,0,2860,A
6-NA,1289,0,5,2875,0,2880,G
6-NA,1290,2875,0,2,0,2877,A
6-NA,1291,2872,0,2,0,2874,A
6-NA,1292,2833,1,3,2,2839,A
6-NA,1293,2762,1,8,0,2771,A
6-NA,1294,0,5,2776,1,2782,G
6-NA,1295,2732,0,3,0,2735,A
6-NA,1296,0,5,2735,0,2740,G
6-NA,1297,0,2,2746,0,2748,G
6-NA,1298,2704,1,4,0,2709,A
6-NA,1299,2680,0,4,0,2684,A
6-NA,1300,2712,0,0,0,2712,A
6-NA,1301,1,1,0,2735,2737,C
6-NA,1302,4,2717,0,1,2722,T
6-NA,1303,1,6,2717,0,2724,G
6-NA,1304,2706,1,3,0,2710,A
6-NA,1305,2702,1,5,0,2708,A
6-NA,1306,0,0,2752,0,2752,G
6-NA,1307,1,2708,0,5,2714,T
6-NA,1308,5,0,0,2757,2762,C
6-NA,1309,0,2747,0,6,2753,T
6-NA,1310,0,2717,0,7,2724,T
6-NA,1311,2,1,2724,0,2727,G
6-NA,1312,1,2728,0,2,2731,T
6-NA,1313,0,6,2707,0,2713,G
6-NA,1314,0,5,2709,0,2714,G
6-NA,1315,2682,0,3,0,2685,A
6-NA,1316,1,0,0,2714,2715,C
6-NA,1317,4,1,0,2643,2648,C
6-NA,1318,0,2635,0,3,2638,T
6-NA,1319,3,0,0,2650,2653,C
6-NA,1320,2671,0,1,0,2672,A
6-NA,1321,2672,0,1,0,2673,A
6-NA,1322,2671,2,3,0,2676,A
6-NA,1323,0,0,0,2712,2712,C
6-NA,1324,2634,0,2,0,2636,A
6-NA,1325,2,0,2729,0,2731,G
6-NA,1326,1,2679,0,3,2683,T
6-NA,1327,2685,0,4,0,2689,A
6-NA,1328,0,2687,2,0,2689,T
6-NA,1329,0,2644,1,0,2645,T
6-NA,1330,1,0,2671,0,2672,G
6-NA,1331,0,2669,0,1,2670,T
6-NA,1332,0,2533,0,6,2539,T
6-NA,1333,1,0,2550,0,2551,G
6-NA,1334,1,2377,0,2,2380,T
6-NA,1335,2,0,2397,0,2399,G
6-NA,1336,0,2381,0,0,2381,T
6-NA,1337,0,2336,2,3,2341,T
6-NA,1338,0,2349,0,1,2350,T
6-NA,1339,0,2280,0,2,2282,T
6-NA,1340,0,0,2293,0,2293,G
6-NA,1341,0,2292,1,1,2294,T
6-NA,1342,0,10,2258,0,2268,G
6-NA,1343,0,1,2272,0,2273,G
6-NA,1344,1,0,0,2217,2218,C
6-NA,1345,2223,1,3,0,2227,A
6-NA,1346,2,1,0,2257,2260,C
6-NA,1347,3,0,0,2253,2256,C
6-NA,1348,0,2261,0,0,2261,T
6-NA,1349,3,0,0,2266,2269,C
6-NA,1350,2275,0,4,0,2279,A
6-NA,1351,0,4,2312,0,2316,G
6-NA,1352,0,0,2313,0,2313,G
6-NA,1353,0,2310,0,1,2311,T
6-NA,1354,2302,0,1,0,2303,A
6-NA,1355,1,3,0,2190,2194,C
6-NA,1356,2192,0,2,0,2194,A
6-NA,1357,1,2186,0,0,2187,T
6-NA,1358,2145,0,1,0,2146,A
6-NA,1359,0,2123,0,15,2138,T
6-NA,1360,0,4,1969,0,1973,G
6-NA,1361,0,2,1971,0,1973,G
6-NA,1362,1958,0,1,0,1959,A
6-NA,1363,1945,0,2,1,1948,A
6-NA,1364,0,1,0,1923,1924,C
6-NA,1365,1620,0,3,0,1623,A
6-NA,1366,0,0,1623,0,1623,G
6-NA,1367,0,1,1616,0,1617,G
6-NA,1368,0,2,0,1623,1625,C
6-NA,1369,0,1609,0,2,1611,T
6-NA,1370,6,2,0,1517,1525,C
6-NA,1371,1525,0,0,0,1525,A
6-NA,1372,0,1519,0,0,1519,T
6-NA,1373,0,1,1516,0,1517,G
6-NA,1374,0,1,1527,0,1528,G
6-NA,1375,1,0,1,1473,1475,C
6-NA,1376,3,1,0,1465,1469,C
6-NA,1377,0,1380,0,2,1382,T
6-NA,1378,1,1,1382,0,1384,G
6-NA,1379,1376,1,2,0,1379,A
6-NA,1380,0,1376,0,1,1377,T
6-NA,1381,1,2,1353,0,1356,G
6-NA,1382,0,2,1337,0,1339,G
6-NA,1383,0,1,1271,0,1272,G
6-NA,1384,0,0,1274,0,1274,G
6-NA,1385,1,1,0,1235,1237,C
6-NA,1386,1,1,1234,0,1236,G
6-NA,1387,0,3,1213,0,1216,G
6-NA,1388,1210,0,4,0,1214,A
6-NA,1389,1,1,0,1200,1202,C
6-NA,1390,1208,0,1,0,1209,A
6-NA,1391,1,1184,0,0,1185,T
6-NA,1392,5,0,0,1153,1158,C
6-NA,1393,1151,0,1,0,1152,A
6-NA,1394,1152,1,0,0,1153,A
6-NA,1395,0,1142,0,0,1142,T
6-NA,1396,1,0,0,1122,1123,C
6-NA,1397,0,1092,0,1,1093,T
6-NA,1398,2,0,0,914,916,C
6-NA,1399,912,0,2,0,914,A
6-NA,1400,0,904,0,0,904,T
6-NA,1401,0,0,904,0,904,G
6-NA,1402,0,1,0,895,896,C
6-NA,1403,0,0,0,864,864,C
6-NA,1404,0,771,1,1,773,T
6-NA,1405,761,0,0,0,761,A
6-NA,1406,0,760,0,0,760,T
6-NA,1407,745,0,0,0,745,A
6-NA,1408,0,740,0,0,740,T
6-NA,1409,682,0,0,0,682,A
6-NA,1410,659,0,0,0,659,A
7-M,1,295,0,0,0,295,A
7-M,2,0,301,0,0,301,T
7-M,3,0,0,298,0,298,G
7-M,4,302,0,0,0,302,A
7-M,5,1,0,325,0,326,G
7-M,6,0,0,0,343,343,C
7-M,7,0,0,0,363,363,C
7-M,8,1,459,0,1,461,T
7-M,9,0,464,0,0,464,T
7-M,10,0,0,0,470,470,C
7-M,11,0,466,0,2,468,T
7-M,12,483,0,1,0,484,A
7-M,13,487,0,0,0,487,A
7-M,14,0,0,0,488,488,C
7-M,15,0,0,0,486,486,C
7-M,16,0,1,485,0,486,G
7-M,17,482,0,0,0,482,A
7-M,18,0,0,497,0,497,G
7-M,19,0,0,522,0,522,G
7-M,20,0,522,0,1,523,T
7-M,21,2,0,0,524,526,C
7-M,22,0,0,527,0,527,G
7-M,23,545,0,0,0,545,A
7-M,24,545,0,1,0,546,A
7-M,25,556,0,1,0,557,A
7-M,26,0,0,0,615,615,C
7-M,27,1,0,624,0,625,G
7-M,28,0,629,0,0,629,T
7-M,29,629,0,0,0,629,A
7-M,30,0,634,0,1,635,T
7-M,31,0,0,646,0,646,G
7-M,32,0,645,0,1,646,T
7-M,33,0,713,0,2,715,T
7-M,34,2,0,0,738,740,C
7-M,35,0,737,0,1,738,T
7-M,36,0,0,0,792,792,C
7-M,37,0,787,0,1,788,T
7-M,38,1,0,0,839,840,C
7-M,39,0,840,0,1,841,T
7-M,40,839,0,0,0,839,A
7-M,41,0,838,0,0,838,T
7-M,42,1,0,0,847,848,C
7-M,43,1,0,855,0,856,G
7-M,44,0,859,0,1,860,T
7-M,45,0,852,0,3,855,T
7-M,46,2,0,0,863,865,C
7-M,47,1,0,0,898,899,C
7-M,48,908,0,1,0,909,A
7-M,49,0,908,0,3,911,T
7-M,50,0,1,0,910,911,C
7-M,51,912,0,0,0,912,A
7-M,52,1,1,918,0,920,G
7-M,53,0,0,915,0,915,G
7-M,54,0,0,0,919,919,C
7-M,55,1,1,0,917,919,C
7-M,56,0,0,0,916,916,C
7-M,57,2,0,0,963,965,C
7-M,58,4,0,0,968,972,C
7-M,59,0,964,0,3,967,T
7-M,60,3,1,0,972,976,C
7-M,61,963,1,2,0,966,A
7-M,62,973,0,0,0,973,A
7-M,63,998,1,0,0,999,A
7-M,64,0,0,1018,0,1018,G
7-M,65,1,0,0,1018,1019,C
7-M,66,1,0,0,1010,1011,C
7-M,67,0,3,999,0,1002,G
7-M,68,989,0,2,0,991,A
7-M,69,0,4,995,0,999,G
7-M,70,1004,0,1,0,1005,A
7-M,71,0,1009,0,0,1009,T
7-M,72,0,1,0,1002,1003,C
7-M,73,0,2,1003,0,1005,G
7-M,74,0,1,0,1014,1015,C
7-M,75,2,0,1018,0,1020,G
7-M,76,1,2,0,1014,1017,C
7-M,77,1009,0,0,0,1009,A
7-M,78,0,3,1021,0,1024,G
7-M,79,1000,1,3,0,1004,A
7-M,80,0,3,1112,0,1115,G
7-M,81,1111,0,2,0,1113,A
7-M,82,1,0,0,1137,1138,C
7-M,83,0,1135,1,0,1136,T
7-M,84,0,1128,0,0,1128,T
7-M,85,0,4,1150,0,1154,G
7-M,86,1156,0,1,0,1157,A
7-M,87,1157,0,1,0,1158,A
7-M,88,0,2,1155,0,1157,G
7-M,89,1124,0,0,0,1124,A
7-M,90,0,1139,0,0,1139,T
7-M,91,1,0,1153,0,1154,G
7-M,92,0,1158,0,1,1159,T
7-M,93,2,0,0,1152,1154,C
7-M,94,0,1144,1,3,1148,T
7-M,95,0,1159,0,1,1160,T
7-M,96,0,1159,0,0,1159,T
7-M,97,1,1,1151,0,1153,G
7-M,98,0,2,0,1159,1161,C
7-M,99,0,1145,0,0,1145,T
7-M,100,1,1,1157,0,1159,G
7-M,101,1,1,1162,0,1164,G
7-M,102,0,2,1187,0,1189,G
7-M,103,1176,0,1,1,1178,A
7-M,104,1190,0,1,0,1191,A
7-M,105,1188,0,2,1,1191,A
7-M,106,1192,0,0,0,1192,A
7-M,107,1225,0,2,1,1228,A
7-M,108,0,0,0,1240,1240,C
7-M,109,1221,0,1,0,1222,A
7-M,110,0,1,0,1230,1231,C
7-M,111,1202,0,2,0,1204,A
7-M,112,1,1,1250,0,1252,G
7-M,113,1249,0,0,0,1249,A
7-M,114,1,1281,0,0,1282,T
7-M,115,1,0,0,1292,1293,C
7-M,116,0,1287,0,2,1289,T
7-M,117,0,1283,1,3,1287,T
7-M,118,0,1,1284,0,1285,G
7-M,119,1271,0,2,0,1273,A
7-M,120,1,1,1279,0,1281,G
7-M,121,0,1,1270,0,1271,G
7-M,122,1,0,0,1283,1284,C
7-M,123,0,1256,0,3,1259,T
7-M,124,0,0,0,1431,1431,C
7-M,125,0,1420,0,1,1421,T
7-M,126,3,0,1,1435,1439,C
7-M,127,1438,0,1,0,1439,A
7-M,128,0,1442,0,2,1444,T
7-M,129,0,2,1433,0,1435,G
7-M,130,2,4,1434,0,1440,G
7-M,131,1421,0,1,0,1422,A
7-M,132,1431,0,1,0,1432,A
7-M,133,0,1369,0,0,1369,T
7-M,134,2,2,1432,0,1436,G
7-M,135,0,0,1515,0,1515,G
7-M,136,0,0,0,1530,1530,C
7-M,137,0,1522,0,3,1525,T
7-M,138,1528,0,1,1,1530,A
7-M,139,1521,0,2,0,1523,A
7-M,140,1533,0,2,0,1535,A
7-M,141,0,4,1563,0,1567,G
7-M,142,1557,0,3,0,1560,A
7-M,143,0,0,0,1553,1553,C
7-M,144,1476,0,0,0,1476,A
7-M,145,1476,0,2,0,1478,A
7-M,146,0,10,1521,0,1531,G
7-M,147,1527,2,5,0,1534,A
7-M,148,0,1,0,1540,1541,C
7-M,149,3,0,0,1524,1527,C
7-M,150,1520,0,1,0,1521,A
7-M,151,1557,0,0,0,1557,A
7-M,152,0,1555,0,0,1555,T
7-M,153,0,1567,0,1,1568,T
7-M,154,5,0,0,1573,1578,C
7-M,155,0,1557,0,0,1557,T
7-M,156,0,2,1560,0,1562,G
7-M,157,1,1558,0,2,1561,T
7-M,158,7,0,0,1548,1555,C
7-M,159,1561,0,1,0,1562,A
7-M,160,1,0,0,1628,1629,C
7-M,161,2,0,0,1629,1631,C
7-M,162,1,1609,0,2,1612,T
7-M,163,3,0,0,1627,1630,C
7-M,164,0,1610,0,0,1610,T
7-M,165,0,4,1682,0,1686,G
7-M,166,1692,0,1,1,1694,A
7-M,167,0,0,0,1709,1709,C
7-M,168,0,1706,0,0,1706,T
7-M,169,1673,0,3,0,1676,A
7-M,170,1667,0,2,0,1669,A
7-M,171,19,2,1659,0,1680,G
7-M,172,1,0,1681,0,1682,G
7-M,173,0,4,1682,0,1686,G
7-M,174,0,2,1695,0,1697,G
7-M,175,1701,1,0,0,1702,A
7-M,176,0,1699,0,1,1700,T
7-M,177,0,1690,0,0,1690,T
7-M,178,0,1698,0,0,1698,T
7-M,179,0,1711,0,0,1711,T
7-M,180,0,6,1704,0,1710,G
7-M,181,0,7,1702,0,1709,G
7-M,182,0,2,1708,0,1710,G
7-M,183,1,0,1726,0,1727,G
7-M,184,0,1681,1,1,1683,T
7-M,185,0,1678,0,2,1680,T
7-M,186,0,1687,0,0,1687,T
7-M,187,0,0,1729,0,1729,G
7-M,188,0,1733,0,0,1733,T
7-M,189,0,0,1741,0,1741,G
7-M,190,0,1738,0,2,1740,T
7-M,191,0,1738,0,3,1741,T
7-M,192,4,0,0,1745,1749,C
7-M,193,1745,0,2,0,1747,A
7-M,194,0,0,0,1797,1797,C
7-M,195,3,1,1781,0,1785,G
7-M,196,0,2,0,1783,1785,C
7-M,197,0,1749,0,4,1753,T
7-M,198,9,2,0,1810,1821,C
7-M,199,1833,0,0,0,1833,A
7-M,200,0,1,0,1849,1850,C
7-M,201,2,2,0,1836,1840,C
7-M,202,0,0,1846,0,1846,G
7-M,203,0,1845,1,1,1847,T
7-M,204,0,0,1843,0,1843,G
7-M,205,1,0,0,1851,1852,C
7-M,206,5,2,0,1832,1839,C
7-M,207,4,1,0,1852,1857,C
7-M,208,1827,0,1,1,1829,A
7-M,209,0,0,1858,0,1858,G
7-M,210,0,1842,0,1,1843,T
7-M,211,0,2,1857,0,1859,G
7-M,212,1844,0,1,0,1845,A
7-M,213,0,3,1863,0,1866,G
7-M,214,0,1,0,1863,1864,C
7-M,215,2,4,1870,0,1876,G
7-M,216,1862,1,2,0,1865,A
7-M,217,1,6,1896,0,1903,G
7-M,218,1,4,1903,0,1908,G
7-M,219,1889,0,0,0,1889,A
7-M,220,0,1,0,1935,1936,C
7-M,221,0,1907,0,1,1908,T
7-M,222,0,0,1909,0,1909,G
7-M,223,0,2,0,1899,1901,C
7-M,224,1906,0,3,0,1909,A
7-M,225,2,1,1950,0,1953,G
7-M,226,3,0,0,1932,1935,C
7-M,227,2,0,1959,0,1961,G
7-M,228,0,1961,0,0,1961,T
7-M,229,1942,0,0,0,1942,A
7-M,230,1,1,1932,1,1935,G
7-M,231,1934,0,2,0,1936,A
7-M,232,0,0,0,1944,1944,C
7-M,233,0,1,1948,0,1949,G
7-M,234,1,0,0,1907,1908,C
7-M,235,0,1870,0,1,1871,T
7-M,236,0,1871,0,0,1871,T
7-M,237,2,1860,0,0,1862,T
7-M,238,0,0,1917,0,1917,G
7-M,239,2,1912,0,3,1917,T
7-M,240,1,1,0,1914,1916,C
7-M,241,1,0,0,1922,1923,C
7-M,242,1913,0,0,0,1913,A
7-M,243,1906,0,0,0,1906,A
7-M,244,1910,1,1,0,1912,A
7-M,245,1913,0,0,0,1913,A
7-M,246,0,1914,0,0,1914,T
7-M,247,0,3,1886,1,1890,G
7-M,248,0,3,0,1873,1876,C
7-M,249,8,1,0,1878,1887,C
7-M,250,7,1,0,1903,1911,C
7-M,251,0,1881,0,5,1886,T
7-M,252,3,0,0,1997,2000,C
7-M,253,2004,0,0,0,2004,A
7-M,254,2017,0,0,0,2017,A
7-M,255,1,2021,0,2,2024,T
7-M,256,2,0,2036,0,2038,G
7-M,257,0,3,2044,0,2047,G
7-M,258,1,2,2067,0,2070,G
7-M,259,2044,1,2,0,2047,A
7-M,260,2045,0,4,0,2049,A
7-M,261,0,2005,0,0,2005,T
7-M,262,0,5,2004,0,2009,G
7-M,263,0,4,1991,0,1995,G
7-M,264,1961,0,4,0,1965,A
7-M,265,0,5,1963,0,1968,G
7-M,266,1946,0,1,0,1947,A
7-M,267,0,0,0,1916,1916,C
7-M,268,7,0,0,2005,2012,C
7-M,269,3,0,0,2025,2028,C
7-M,270,2057,0,2,0,2059,A
7-M,271,2057,0,2,0,2059,A
7-M,272,2067,0,0,0,2067,A
7-M,273,0,2073,0,0,2073,T
7-M,274,2114,0,0,0,2114,A
7-M,275,2111,1,2,0,2114,A
7-M,276,0,0,0,2068,2068,C
7-M,277,2042,0,1,1,2044,A
7-M,278,0,2033,0,1,2034,T
7-M,279,2,2,2069,0,2073,G
7-M,280,0,5,2068,0,2073,G
7-M,281,2076,0,2,1,2079,A
7-M,282,0,1,0,2075,2076,C
7-M,283,2013,0,0,0,2013,A
7-M,284,2017,0,0,0,2017,A
7-M,285,2013,0,3,0,2016,A
7-M,286,0,1,2041,0,2042,G
7-M,287,1,0,0,2097,2098,C
7-M,288,2039,1,2,0,2042,A
7-M,289,0,0,2091,0,2091,G
7-M,290,0,2073,0,3,2076,T
7-M,291,0,2072,1,2,2075,T
7-M,292,2085,1,1,1,2088,A
7-M,293,2088,0,2,0,2090,A
7-M,294,2087,0,0,0,2087,A
7-M,295,0,0,0,2128,2128,C
7-M,296,0,2042,0,2,2044,T
7-M,297,0,0,2304,0,2304,G
7-M,298,1,2266,0,2,2269,T
7-M,299,2283,1,0,0,2284,A
7-M,300,0,2281,0,1,2282,T
7-M,301,2254,0,4,0,2258,A
7-M,302,2,3,2267,0,2272,G
7-M,303,0,2,2252,0,2254,G
7-M,304,2221,0,3,0,2224,A
7-M,305,2213,0,1,0,2214,A
7-M,306,2046,0,1,0,2047,A
7-M,307,0,0,0,2130,2130,C
7-M,308,0,2103,0,3,2106,T
7-M,309,0,2116,0,1,2117,T
7-M,310,2116,0,0,0,2116,A
7-M,311,2096,0,4,0,2100,A
7-M,312,1,4,2113,0,2118,G
7-M,313,2089,0,4,0,2093,A
7-M,314,1,3,2115,0,2119,G
7-M,315,0,6,2118,0,2124,G
7-M,316,2,2,2116,0,2120,G
7-M,317,2082,0,3,0,2085,A
7-M,318,1,2,2127,0,2130,G
7-M,319,2147,1,1,0,2149,A
7-M,320,0,2141,0,1,2142,T
7-M,321,2146,0,0,0,2146,A
7-M,322,2162,0,2,1,2165,A
7-M,323,0,0,0,2193,2193,C
7-M,324,2,1,2178,0,2181,G
7-M,325,0,2175,1,1,2177,T
7-M,326,0,2150,0,1,2151,T
7-M,327,8,0,1,2163,2172,C
7-M,328,6,1,0,2167,2174,C
7-M,329,2165,0,2,0,2167,A
7-M,330,0,2176,0,1,2177,T
7-M,331,0,8,2152,0,2160,G
7-M,332,0,0,2165,0,2165,G
7-M,333,1,1,2154,0,2156,G
7-M,334,1,0,2179,0,2180,G
7-M,335,0,0,0,2172,2172,C
7-M,336,2,1,0,2175,2178,C
7-M,337,2190,0,1,0,2191,A
7-M,338,2213,0,0,0,2213,A
7-M,339,2208,1,1,0,2210,A
7-M,340,0,0,2254,0,2254,G
7-M,341,2249,0,1,0,2250,A
7-M,342,2234,0,0,0,2234,A
7-M,343,2228,0,3,0,2231,A
7-M,344,1,2233,0,0,2234,T
7-M,345,2235,0,0,0,2235,A
7-M,346,4,0,2234,0,2238,G
7-M,347,0,0,0,2224,2224,C
7-M,348,1,2181,0,4,2186,T
7-M,349,6,2,0,2204,2212,C
7-M,350,0,2186,0,0,2186,T
7-M,351,6,0,0,2287,2293,C
7-M,352,2297,0,2,0,2299,A
7-M,353,0,1,2305,0,2306,G
7-M,354,0,2280,0,1,2281,T
7-M,355,0,2310,0,1,2311,T
7-M,356,2316,1,0,0,2317,A
7-M,357,0,2329,0,1,2330,T
7-M,358,1,2299,0,2,2302,T
7-M,359,1,1,0,2335,2337,C
7-M,360,0,2222,0,2,2224,T
7-M,361,1,2,2230,0,2233,G
7-M,362,0,0,0,2227,2227,C
7-M,363,0,2211,0,3,2214,T
7-M,364,0,1,2220,0,2221,G
7-M,365,0,0,2225,0,2225,G
7-M,366,0,2220,0,4,2224,T
7-M,367,0,3,2210,0,2213,G
7-M,368,0,0,0,2213,2213,C
7-M,369,2221,0,1,0,2222,A
7-M,370,0,2,0,2228,2230,C
7-M,371,0,2198,0,1,2199,T
7-M,372,1,2233,0,3,2237,T
7-M,373,1,2,2233,0,2236,G
7-M,374,0,0,0,2215,2215,C
7-M,375,3,2,0,2228,2233,C
7-M,376,2215,1,0,0,2216,A
7-M,377,0,0,2221,0,2221,G
7-M,378,2,2222,0,1,2225,T
7-M,379,0,2209,0,3,2212,T
7-M,380,0,0,2238,0,2238,G
7-M,381,0,0,0,2195,2195,C
7-M,382,2203,0,4,0,2207,A
7-M,383,0,2207,0,2,2209,T
7-M,384,1,4,2189,0,2194,G
7-M,385,2,7,2208,0,2217,G
7-M,386,0,0,2226,0,2226,G
7-M,387,1,1,0,2231,2233,C
7-M,388,3,1,0,2293,2297,C
7-M,389,0,2292,0,3,2295,T
7-M,390,1,0,0,2343,2344,C
7-M,391,2479,1,0,2,2482,A
7-M,392,1,2476,1,2,2480,T
7-M,393,2553,2,2,0,2557,A
7-M,394,0,2522,0,0,2522,T
7-M,395,2471,0,2,0,2473,A
7-M,396,0,2,0,2646,2648,C
7-M,397,2519,0,1,0,2520,A
7-M,398,2539,0,3,0,2542,A
7-M,399,0,2500,0,0,2500,T
7-M,400,2397,0,0,0,2397,A
7-M,401,0,3,2400,0,2403,G
7-M,402,1,1,2371,0,2373,G
7-M,403,2351,1,2,0,2354,A
7-M,404,0,2348,0,1,2349,T
7-M,405,1,7,2144,0,2152,G
7-M,406,1,1,2135,0,2137,G
7-M,407,0,6,2123,0,2129,G
7-M,408,0,2,2151,0,2153,G
7-M,409,0,0,2153,0,2153,G
7-M,410,2,0,0,2143,2145,C
7-M,411,0,2081,1,5,2087,T
7-M,412,1,0,2109,0,2110,G
7-M,413,0,2112,0,2,2114,T
7-M,414,2123,0,1,0,2124,A
7-M,415,2120,1,0,0,2121,A
7-M,416,0,1,0,2122,2123,C
7-M,417,1,0,0,2095,2096,C
7-M,418,2081,1,1,0,2083,A
7-M,419,0,2,0,2079,2081,C
7-M,420,1,2077,0,4,2082,T
7-M,421,1,4,2092,1,2098,G
7-M,422,2086,0,0,1,2087,A
7-M,423,2070,1,0,0,2071,A
7-M,424,0,0,2085,0,2085,G
7-M,425,0,2052,1,3,2056,T
7-M,426,2,4,2045,0,2051,G
7-M,427,0,0,2063,0,2063,G
7-M,428,0,2,0,2062,2064,C
7-M,429,2053,0,1,0,2054,A
7-M,430,0,2046,0,0,2046,T
7-M,431,0,2045,0,1,2046,T
7-M,432,0,2046,0,1,2047,T
7-M,433,0,2,2087,0,2089,G
7-M,434,0,0,2086,0,2086,G
7-M,435,1,1,0,2072,2074,C
7-M,436,1,1,0,2077,2079,C
7-M,437,0,2058,0,1,2059,T
7-M,438,0,3,2167,1,2171,G
7-M,439,1,0,2185,0,2186,G
7-M,440,0,2199,0,0,2199,T
7-M,441,2202,0,2,0,2204,A
7-M,442,0,2107,0,2,2109,T
7-M,443,1,0,2184,0,2185,G
7-M,444,0,2176,0,4,2180,T
7-M,445,0,1,2176,0,2177,G
7-M,446,0,0,0,2179,2179,C
7-M,447,2089,0,0,0,2089,A
7-M,448,2083,1,5,0,2089,A
7-M,449,0,0,0,2124,2124,C
7-M,450,2115,0,1,0,2116,A
7-M,451,0,2123,0,2,2125,T
7-M,452,2,0,2101,0,2103,G
7-M,453,0,2031,0,3,2034,T
7-M,454,0,15,2008,0,2023,G
7-M,455,2004,0,3,0,2007,A
7-M,456,1,1,2011,0,2013,G
7-M,457,2,0,0,2014,2016,C
7-M,458,1951,1,2,0,1954,A
7-M,459,0,3,1968,0,1971,G
7-M,460,1949,0,4,0,1953,A
7-M,461,0,1953,0,0,1953,T
7-M,462,0,1951,0,0,1951,T
7-M,463,0,1,1957,0,1958,G
7-M,464,0,0,0,1963,1963,C
7-M,465,0,1958,0,3,1961,T
7-M,466,0,8,1948,0,1956,G
7-M,467,1948,0,2,0,1950,A
7-M,468,0,0,0,2077,2077,C
7-M,469,1,2061,0,1,2063,T
7-M,470,1,2,0,2060,2063,C
7-M,471,1,1,0,2046,2048,C
7-M,472,5,1,0,2059,2065,C
7-M,473,2063,0,1,0,2064,A
7-M,474,1,1,2095,0,2097,G
7-M,475,1,0,0,2072,2073,C
7-M,476,2089,1,1,0,2091,A
7-M,477,0,0,0,2087,2087,C
7-M,478,1912,0,4,0,1916,A
7-M,479,0,2,1977,0,1979,G
7-M,480,1,0,1987,0,1988,G
7-M,481,0,1988,0,5,1993,T
7-M,482,2,0,0,2059,2061,C
7-M,483,2,2032,0,4,2038,T
7-M,484,8,1,0,2045,2054,C
7-M,485,2051,0,1,0,2052,A
7-M,486,0,2055,0,0,2055,T
7-M,487,2052,0,1,0,2053,A
7-M,488,0,1,2033,0,2034,G
7-M,489,0,1,2012,0,2013,G
7-M,490,0,0,0,2019,2019,C
7-M,491,1911,0,1,0,1912,A
7-M,492,1,1,1887,0,1889,G
7-M,493,1899,1,3,1,1904,A
7-M,494,0,1910,0,0,1910,T
7-M,495,0,1,1907,0,1908,G
7-M,496,1,2,1902,0,1905,G
7-M,497,0,1892,0,0,1892,T
7-M,498,2,5,1895,0,1902,G
7-M,499,0,1,1897,0,1898,G
7-M,500,1,0,0,1901,1902,C
7-M,501,1885,0,1,0,1886,A
7-M,502,1883,1,2,0,1886,A
7-M,503,0,0,0,1917,1917,C
7-M,504,1924,0,0,0,1924,A
7-M,505,1926,0,0,0,1926,A
7-M,506,0,1,0,1926,1927,C
7-M,507,2,0,0,1899,1901,C
7-M,508,1885,0,1,0,1886,A
7-M,509,1888,1,1,0,1890,A
7-M,510,0,1893,0,2,1895,T
7-M,511,2,0,0,1902,1904,C
7-M,512,4,0,0,1866,1870,C
7-M,513,1847,0,3,0,1850,A
7-M,514,0,1848,1,1,1850,T
7-M,515,0,1846,0,0,1846,T
7-M,516,1852,0,0,0,1852,A
7-M,517,1854,1,0,0,1855,A
7-M,518,0,1863,0,1,1864,T
7-M,519,1843,0,0,0,1843,A
7-M,520,1839,0,0,0,1839,A
7-M,521,1808,0,1,0,1809,A
7-M,522,1828,0,1,0,1829,A
7-M,523,0,1,0,1884,1885,C
7-M,524,1875,0,1,0,1876,A
7-M,525,0,1870,0,0,1870,T
7-M,526,3,4,1857,0,1864,G
7-M,527,1844,0,5,0,1849,A
7-M,528,1,6,1868,0,1875,G
7-M,529,1865,0,3,0,1868,A
7-M,530,1872,0,1,0,1873,A
7-M,531,1,1,0,1885,1887,C
7-M,532,1816,0,0,0,1816,A
7-M,533,0,2,1837,0,1839,G
7-M,534,1806,1,2,0,1809,A
7-M,535,1815,1,2,0,1818,A
7-M,536,0,1809,0,2,1811,T
7-M,537,2,3,1809,0,1814,G
7-M,538,0,1,1809,0,1810,G
7-M,539,0,1805,1,3,1809,T
7-M,540,0,1744,1,1,1746,T
7-M,541,1,1798,0,0,1799,T
7-M,542,0,1802,1,0,1803,T
7-M,543,0,4,1821,0,1825,G
7-M,544,1,1,1825,0,1827,G
7-M,545,0,0,0,1819,1819,C
7-M,546,1,0,0,1814,1815,C
7-M,547,1767,0,1,0,1768,A
7-M,548,1,0,1845,0,1846,G
7-M,549,0,0,0,1845,1845,C
7-M,550,1856,0,1,1,1858,A
7-M,551,1,0,0,1894,1895,C
7-M,552,0,1871,1,1,1873,T
7-M,553,1882,0,1,0,1883,A
7-M,554,1,0,0,1904,1905,C
7-M,555,1925,0,3,0,1928,A
7-M,556,0,0,1975,0,1975,G
7-M,557,0,0,0,1901,1901,C
7-M,558,0,1882,1,2,1885,T
7-M,559,1891,0,1,0,1892,A
7-M,560,1839,0,1,0,1840,A
7-M,561,0,4,1864,0,1868,G
7-M,562,2,0,1881,0,1883,G
7-M,563,0,2,0,1878,1880,C
7-M,564,0,1746,0,2,1748,T
7-M,565,1756,0,1,0,1757,A
7-M,566,0,1750,0,3,1753,T
7-M,567,1,5,1741,0,1747,G
7-M,568,1,3,1757,1,1762,G
7-M,569,1702,1,2,0,1705,A
7-M,570,0,0,1715,0,1715,G
7-M,571,1,0,0,1670,1671,C
7-M,572,1669,1,1,0,1671,A
7-M,573,1651,1,0,1,1653,A
7-M,574,1657,0,0,0,1657,A
7-M,575,0,1671,0,0,1671,T
7-M,576,0,2,1675,0,1677,G
7-M,577,1,1,1664,0,1666,G
7-M,578,2,0,0,1655,1657,C
7-M,579,1,1626,0,1,1628,T
7-M,580,3,2,1635,0,1640,G
7-M,581,1,3,1663,0,1667,G
7-M,582,1666,0,3,0,1669,A
7-M,583,0,1660,0,0,1660,T
7-M,584,7,0,0,1641,1648,C
7-M,585,1642,0,0,0,1642,A
7-M,586,1667,0,1,0,1668,A
7-M,587,0,0,1682,0,1682,G
7-M,588,0,1672,0,2,1674,T
7-M,589,2,12,1662,0,1676,G
7-M,590,1580,0,3,0,1583,A
7-M,591,3,0,1617,0,1620,G
7-M,592,0,0,0,1614,1614,C
7-M,593,1612,0,1,0,1613,A
7-M,594,0,2,1623,0,1625,G
7-M,595,0,0,1606,0,1606,G
7-M,596,3,0,0,1609,1612,C
7-M,597,1605,0,0,1,1606,A
7-M,598,1,0,1622,0,1623,G
7-M,599,1,2,0,1614,1617,C
7-M,600,0,1,1619,0,1620,G
7-M,601,1,1,1613,0,1615,G
7-M,602,1606,0,1,0,1607,A
7-M,603,1,2,1631,0,1634,G
7-M,604,2,0,1674,0,1676,G
7-M,605,0,0,0,1669,1669,C
7-M,606,1,0,0,1677,1678,C
7-M,607,1662,0,1,0,1663,A
7-M,608,0,1665,0,1,1666,T
7-M,609,0,4,1671,0,1675,G
7-M,610,0,4,1669,0,1673,G
7-M,611,1641,2,2,0,1645,A
7-M,612,0,0,1665,0,1665,G
7-M,613,1601,1,1,0,1603,A
7-M,614,0,1657,0,1,1658,T
7-M,615,0,1649,1,1,1651,T
7-M,616,0,0,1665,0,1665,G
7-M,617,1,0,0,1656,1657,C
7-M,618,0,1648,0,0,1648,T
7-M,619,1663,1,1,0,1665,A
7-M,620,0,0,1661,0,1661,G
7-M,621,1,1648,0,3,1652,T
7-M,622,7,0,1,1644,1652,C
7-M,623,1604,0,1,0,1605,A
7-M,624,0,1,1633,0,1634,G
7-M,625,0,0,1625,0,1625,G
7-M,626,1,0,0,1615,1616,C
7-M,627,5,1,0,1621,1627,C
7-M,628,1630,0,1,1,1632,A
7-M,629,0,0,1665,0,1665,G
7-M,630,0,0,1667,0,1667,G
7-M,631,0,1,0,1670,1671,C
7-M,632,1672,0,1,0,1673,A
7-M,633,0,0,1679,0,1679,G
7-M,634,1659,0,5,0,1664,A
7-M,635,0,1655,0,3,1658,T
7-M,636,0,4,1655,0,1659,G
7-M,637,1,1,1720,0,1722,G
7-M,638,0,1682,0,1,1683,T
7-M,639,0,0,1682,0,1682,G
7-M,640,1,0,1,1687,1689,C
7-M,641,1679,3,2,0,1684,A
7-M,642,1,1,1719,0,1721,G
7-M,643,1,0,1711,1,1713,G
7-M,644,1,0,0,1717,1718,C
7-M,645,1718,0,0,0,1718,A
7-M,646,1679,0,0,0,1679,A
7-M,647,0,1664,0,1,1665,T
7-M,648,0,3,1662,1,1666,G
7-M,649,1656,0,2,0,1658,A
7-M,650,0,3,1665,0,1668,G
7-M,651,1595,1,4,0,1600,A
7-M,652,2,0,1609,0,1611,G
7-M,653,1,0,0,1619,1620,C
7-M,654,6,1,0,1640,1647,C
7-M,655,1658,0,3,0,1661,A
7-M,656,0,1651,0,1,1652,T
7-M,657,0,1660,0,0,1660,T
7-M,658,0,2,1655,0,1657,G
7-M,659,0,2,1645,0,1647,G
7-M,660,1,4,1657,0,1662,G
7-M,661,1665,0,1,0,1666,A
7-M,662,0,0,0,1651,1651,C
7-M,663,0,1588,0,1,1589,T
7-M,664,4,1,0,1595,1600,C
7-M,665,1612,0,0,0,1612,A
7-M,666,0,1677,1,2,1680,T
7-M,667,1,0,0,1679,1680,C
7-M,668,3,0,0,1670,1673,C
7-M,669,0,1669,0,1,1670,T
7-M,670,1667,0,0,0,1667,A
7-M,671,1,0,1695,1,1697,G
7-M,672,0,1876,0,1,1877,T
7-M,673,0,1852,0,2,1854,T
7-M,674,3,1,0,1841,1845,C
7-M,675,5,2,0,1793,1800,C
7-M,676,1797,0,2,0,1799,A
7-M,677,0,0,1840,0,1840,G
7-M,678,0,1839,0,0,1839,T
7-M,679,1834,0,1,0,1835,A
7-M,680,1,0,0,1829,1830,C
7-M,681,1,1568,0,4,1573,T
7-M,682,0,2,1652,0,1654,G
7-M,683,0,0,1707,1,1708,G
7-M,684,0,1710,0,2,1712,T
7-M,685,3,0,0,1711,1714,C
7-M,686,0,1681,0,1,1682,T
7-M,687,1686,0,0,0,1686,A
7-M,688,1684,1,0,0,1685,A
7-M,689,1,6,1698,2,1707,G
7-M,690,1664,2,2,0,1668,A
7-M,691,0,0,1642,0,1642,G
7-M,692,1523,0,0,0,1523,A
7-M,693,1,1526,0,3,1530,T
7-M,694,1,5,1520,0,1526,G
7-M,695,1514,0,0,0,1514,A
7-M,696,1,1515,0,1,1517,T
7-M,697,0,0,0,1525,1525,C
7-M,698,0,1505,0,1,1506,T
7-M,699,0,1513,0,0,1513,T
7-M,700,4,0,0,1513,1517,C
7-M,701,0,1511,0,0,1511,T
7-M,702,0,1512,0,1,1513,T
7-M,703,1,6,1510,0,1517,G
7-M,704,1508,1,0,0,1509,A
7-M,705,1508,0,0,0,1508,A
7-M,706,1506,0,0,0,1506,A
7-M,707,1505,0,0,0,1505,A
7-M,708,0,1516,0,1,1517,T
7-M,709,0,1521,0,1,1522,T
7-M,710,2,1526,0,1,1529,T
7-M,711,0,1,1519,0,1520,G
7-M,712,0,2,0,1519,1521,C
7-M,713,1521,1,1,0,1523,A
7-M,714,1,1,1525,0,1527,G
7-M,715,1523,0,1,0,1524,A
7-M,716,0,2,0,1559,1561,C
7-M,717,1,0,0,1544,1545,C
7-M,718,0,1539,0,3,1542,T
7-M,719,1571,0,0,0,1571,A
7-M,720,1,1562,1,2,1566,T
7-M,721,4,0,0,1571,1575,C
7-M,722,1578,0,1,0,1579,A
7-M,723,0,4,1578,0,1582,G
7-M,724,1565,0,1,0,1566,A
7-M,725,1513,0,0,0,1513,A
7-M,726,1517,0,0,0,1517,A
7-M,727,0,3,0,1521,1524,C
7-M,728,0,5,1527,0,1532,G
7-M,729,1495,0,1,0,1496,A
7-M,730,1509,0,1,0,1510,A
7-M,731,0,1514,0,0,1514,T
7-M,732,1,5,1507,0,1513,G
7-M,733,0,2,1538,0,1540,G
7-M,734,0,3,1537,0,1540,G
7-M,735,1,3,1536,0,1540,G
7-M,736,0,2,1565,0,1567,G
7-M,737,0,1522,0,1,1523,T
7-M,738,0,0,1533,0,1533,G
7-M,739,0,0,0,1536,1536,C
7-M,740,1534,0,0,1,1535,A
7-M,741,0,2,1545,0,1547,G
7-M,742,1520,0,0,0,1520,A
7-M,743,0,1517,0,2,1519,T
7-M,744,1,0,1505,0,1506,G
7-M,745,1,0,0,1491,1492,C
7-M,746,1490,0,3,0,1493,A
7-M,747,1492,0,1,0,1493,A
7-M,748,0,0,0,1508,1508,C
7-M,749,0,4,1517,0,1521,G
7-M,750,1528,0,0,0,1528,A
7-M,751,0,1522,1,3,1526,T
7-M,752,0,1518,0,0,1518,T
7-M,753,5,0,1,1525,1531,C
7-M,754,1511,0,1,0,1512,A
7-M,755,1514,0,0,1,1515,A
7-M,756,1,0,1519,0,1520,G
7-M,757,0,1493,0,0,1493,T
7-M,758,0,3,1466,1,1470,G
7-M,759,1456,0,0,0,1456,A
7-M,760,0,0,0,1456,1456,C
7-M,761,4,2,0,1437,1443,C
7-M,762,3,1,0,1449,1453,C
7-M,763,2,0,1461,0,1463,G
7-M,764,0,0,0,1460,1460,C
7-M,765,0,1453,0,2,1455,T
7-M,766,0,1465,0,0,1465,T
7-M,767,0,0,1475,0,1475,G
7-M,768,0,1475,0,1,1476,T
7-M,769,0,1474,0,1,1475,T
7-M,770,3,0,1472,0,1475,G
7-M,771,1,1448,0,0,1449,T
7-M,772,0,1426,0,1,1427,T
7-M,773,2,0,1432,0,1434,G
7-M,774,1,0,0,1427,1428,C
7-M,775,1,1,0,1430,1432,C
7-M,776,2,0,1435,0,1437,G
7-M,777,2,0,0,1420,1422,C
7-M,778,1,1,1436,0,1438,G
7-M,779,1441,0,0,0,1441,A
7-M,780,1439,0,0,0,1439,A
7-M,781,0,1463,0,1,1464,T
7-M,782,1462,0,0,0,1462,A
7-M,783,0,1478,0,1,1479,T
7-M,784,3,0,0,1499,1502,C
7-M,785,1497,0,0,0,1497,A
7-M,786,0,1502,0,1,1503,T
7-M,787,0,1486,0,1,1487,T
7-M,788,0,2,1485,0,1487,G
7-M,789,3,2,1467,0,1472,G
7-M,790,0,2,1465,0,1467,G
7-M,791,1467,0,0,0,1467,A
7-M,792,0,1459,0,2,1461,T
7-M,793,5,1,1,1418,1425,C
7-M,794,0,1420,0,4,1424,T
7-M,795,0,1422,0,0,1422,T
7-M,796,0,0,1442,0,1442,G
7-M,797,0,1,0,1436,1437,C
7-M,798,1443,0,0,0,1443,A
7-M,799,0,0,0,1454,1454,C
7-M,800,0,1410,0,3,1413,T
7-M,801,0,1421,0,2,1423,T
7-M,802,0,1,1423,0,1424,G
7-M,803,1457,1,2,1,1461,A
7-M,804,0,1472,0,1,1473,T
7-M,805,1441,0,1,0,1442,A
7-M,806,0,1440,0,3,1443,T
7-M,807,0,1406,0,0,1406,T
7-M,808,2,1,1426,0,1429,G
7-M,809,0,1420,0,0,1420,T
7-M,810,1,2,1394,0,1397,G
7-M,811,0,5,1394,0,1399,G
7-M,812,1338,0,1,0,1339,A
7-M,813,0,1353,0,1,1354,T
7-M,814,0,1351,0,0,1351,T
7-M,815,6,0,1,1340,1347,C
7-M,816,0,1345,0,3,1348,T
7-M,817,0,1328,0,1,1329,T
7-M,818,1,5,1324,0,1330,G
7-M,819,1306,0,1,0,1307,A
7-M,820,0,1310,0,0,1310,T
7-M,821,8,0,0,1295,1303,C
7-M,822,0,0,1300,0,1300,G
7-M,823,1,1297,0,2,1300,T
7-M,824,1,0,0,1291,1292,C
7-M,825,1,1279,0,7,1287,T
7-M,826,0,1298,0,1,1299,T
7-M,827,0,1291,0,3,1294,T
7-M,828,0,1289,0,3,1292,T
7-M,829,0,1300,0,2,1302,T
7-M,830,0,1302,0,1,1303,T
7-M,831,0,1294,0,0,1294,T
7-M,832,3,0,1,1295,1299,C
7-M,833,1291,0,1,0,1292,A
7-M,834,1285,0,2,0,1287,A
7-M,835,1292,0,0,0,1292,A
7-M,836,0,1292,0,1,1293,T
7-M,837,0,0,1295,0,1295,G
7-M,838,0,2,0,1299,1301,C
7-M,839,2,1,1306,0,1309,G
7-M,840,0,1346,0,2,1348,T
7-M,841,0,1,0,1348,1349,C
7-M,842,0,1350,0,1,1351,T
7-M,843,1351,0,0,0,1351,A
7-M,844,0,1339,0,1,1340,T
7-M,845,3,2,0,1341,1346,C
7-M,846,1,9,1334,0,1344,G
7-M,847,1333,1,1,0,1335,A
7-M,848,0,0,0,1337,1337,C
7-M,849,0,1284,0,1,1285,T
7-M,850,5,0,0,1336,1341,C
7-M,851,3,1319,0,3,1325,T
7-M,852,0,1322,0,3,1325,T
7-M,853,2,0,0,1332,1334,C
7-M,854,1332,0,0,1,1333,A
7-M,855,1334,0,2,0,1336,A
7-M,856,1332,1,0,0,1333,A
7-M,857,0,0,0,1335,1335,C
7-M,858,1310,0,2,0,1312,A
7-M,859,0,0,0,1250,1250,C
7-M,860,3,1,1220,0,1224,G
7-M,861,1,0,1306,0,1307,G
7-M,862,2,0,0,1309,1311,C
7-M,863,3,0,0,1321,1324,C
7-M,864,0,1327,1,0,1328,T
7-M,865,0,1331,0,1,1332,T
7-M,866,1333,0,0,0,1333,A
7-M,867,1338,0,2,1,1341,A
7-M,868,1338,0,1,0,1339,A
7-M,869,1334,0,1,0,1335,A
7-M,870,1,1,1317,0,1319,G
7-M,871,1120,0,3,0,1123,A
7-M,872,0,1,1119,0,1120,G
7-M,873,1,1,1107,0,1109,G
7-M,874,0,0,0,1125,1125,C
7-M,875,4,1,0,1109,1114,C
7-M,876,3,0,0,1120,1123,C
7-M,877,0,1126,0,0,1126,T
7-M,878,1,1137,0,0,1138,T
7-M,879,1,0,0,1132,1133,C
7-M,880,0,1140,0,0,1140,T
7-M,881,1142,0,0,1,1143,A
7-M,882,0,1,0,1139,1140,C
7-M,883,0,5,1116,0,1121,G
7-M,884,0,0,1126,0,1126,G
7-M,885,1098,0,2,0,1100,A
7-M,886,1104,0,1,0,1105,A
7-M,887,0,4,1098,0,1102,G
7-M,888,0,4,1104,0,1108,G
7-M,889,1089,0,2,0,1091,A
7-M,890,0,0,1105,0,1105,G
7-M,891,1,1094,0,3,1098,T
7-M,892,1110,0,2,0,1112,A
7-M,893,1,1,0,1091,1093,C
7-M,894,2,0,0,1096,1098,C
7-M,895,0,1078,0,2,1080,T
7-M,896,1,3,1084,0,1088,G
7-M,897,1037,0,2,0,1039,A
7-M,898,0,0,1078,0,1078,G
7-M,899,0,1026,0,0,1026,T
7-M,900,3,0,0,1026,1029,C
7-M,901,0,1008,0,0,1008,T
7-M,902,1017,0,1,0,1018,A
7-M,903,0,1013,0,0,1013,T
7-M,904,0,2,1012,0,1014,G
7-M,905,987,0,1,0,988,A
7-M,906,0,3,992,0,995,G
7-M,907,2,1,911,0,914,G
7-M,908,0,0,919,0,919,G
7-M,909,905,0,1,0,906,A
7-M,910,909,0,1,0,910,A
7-M,911,1,0,908,0,909,G
7-M,912,897,0,1,0,898,A
7-M,913,900,0,0,0,900,A
7-M,914,0,885,0,2,887,T
7-M,915,866,0,3,0,869,A
7-M,916,0,853,0,3,856,T
7-M,917,1,2,0,854,857,C
7-M,918,0,2,859,0,861,G
7-M,919,857,0,0,0,857,A
7-M,920,849,0,0,0,849,A
7-M,921,848,0,0,0,848,A
7-M,922,0,0,835,0,835,G
7-M,923,0,1,849,0,850,G
7-M,924,844,0,0,0,844,A
7-M,925,841,0,3,0,844,A
7-M,926,0,1,0,841,842,C
7-M,927,828,0,0,0,828,A
7-M,928,0,1,835,0,836,G
7-M,929,0,0,0,836,836,C
7-M,930,833,0,0,0,833,A
7-M,931,0,0,835,0,835,G
7-M,932,769,0,1,0,770,A
7-M,933,773,0,2,0,775,A
7-M,934,0,777,0,0,777,T
7-M,935,1,0,756,0,757,G
7-M,936,0,0,0,756,756,C
7-M,937,0,705,0,0,705,T
7-M,938,0,1,707,0,708,G
7-M,939,0,701,0,0,701,T
7-M,940,0,1,690,0,691,G
7-M,941,0,0,693,0,693,G
7-M,942,658,0,1,0,659,A
7-M,943,0,655,0,0,655,T
7-M,944,1,0,634,0,635,G
7-M,945,0,0,0,626,626,C
7-M,946,0,596,0,1,597,T
7-M,947,0,0,597,0,597,G
7-M,948,599,0,1,0,600,A
7-M,949,0,0,0,588,588,C
7-M,950,0,3,585,0,588,G
7-M,951,586,0,0,0,586,A
7-M,952,0,0,0,586,586,C
7-M,953,565,0,1,0,566,A
7-M,954,1,0,568,0,569,G
7-M,955,0,563,0,1,564,T
7-M,956,4,0,0,558,562,C
7-M,957,564,0,0,0,564,A
7-M,958,0,553,0,0,553,T
7-M,959,1,546,0,0,547,T
7-M,960,0,548,0,1,549,T
7-M,961,0,542,0,0,542,T
7-M,962,0,0,539,0,539,G
7-M,963,0,499,0,0,499,T
7-M,964,4,1,0,495,500,C
7-M,965,473,0,0,1,474,A
7-M,966,1,0,475,0,476,G
7-M,967,0,0,0,476,476,C
7-M,968,477,0,0,0,477,A
7-M,969,0,477,0,1,478,T
7-M,970,452,0,4,1,457,A
7-M,971,0,0,460,0,460,G
7-M,972,445,0,1,0,446,A
7-M,973,0,0,447,0,447,G
7-M,974,0,440,0,0,440,T
7-M,975,0,300,0,1,301,T
7-M,976,0,0,297,0,297,G
7-M,977,0,2,294,0,296,G
7-M,978,286,0,3,0,289,A
7-M,979,0,0,292,0,292,G
7-M,980,0,203,0,0,203,T
7-M,981,195,0,0,0,195,A
7-M,982,192,0,0,0,192,A
8-NS,1,336,0,0,0,336,A
8-NS,2,0,336,0,0,336,T
8-NS,3,0,0,361,0,361,G
8-NS,4,0,0,400,0,400,G
8-NS,5,400,0,0,0,400,A
8-NS,6,1,406,0,0,407,T
8-NS,7,0,407,0,0,407,T
8-NS,8,0,411,0,2,413,T
8-NS,9,1,0,0,732,733,C
8-NS,10,738,0,0,0,738,A
8-NS,11,755,0,0,0,755,A
8-NS,12,0,0,0,754,754,C
8-NS,13,754,1,0,0,755,A
8-NS,14,0,0,0,757,757,C
8-NS,15,0,761,0,2,763,T
8-NS,16,0,0,884,0,884,G
8-NS,17,0,882,0,2,884,T
8-NS,18,1,0,897,0,898,G
8-NS,19,0,897,0,4,901,T
8-NS,20,3,0,0,894,897,C
8-NS,21,895,0,2,0,897,A
8-NS,22,900,0,1,0,901,A
8-NS,23,0,0,909,0,909,G
8-NS,24,0,927,0,1,928,T
8-NS,25,0,934,0,0,934,T
8-NS,26,0,941,0,0,941,T
8-NS,27,1,0,0,939,940,C
8-NS,28,1,1,0,941,943,C
8-NS,29,946,0,0,0,946,A
8-NS,30,0,2,964,0,966,G
8-NS,31,0,0,967,0,967,G
8-NS,32,0,967,0,1,968,T
8-NS,33,970,1,1,0,972,A
8-NS,34,1,1,988,0,990,G
8-NS,35,977,1,2,0,980,A
8-NS,36,0,988,0,1,989,T
8-NS,37,0,988,0,0,988,T
8-NS,38,0,1,994,0,995,G
8-NS,39,0,0,0,997,997,C
8-NS,40,0,996,0,2,998,T
8-NS,41,0,1001,0,0,1001,T
8-NS,42,0,998,0,2,1000,T
8-NS,43,0,0,0,1032,1032,C
8-NS,44,0,1027,0,1,1028,T
8-NS,45,0,1030,0,0,1030,T
8-NS,46,0,1029,0,1,1030,T
8-NS,47,0,4,1040,0,1044,G
8-NS,48,1,0,1032,0,1033,G
8-NS,49,0,0,0,1038,1038,C
8-NS,50,1041,0,0,0,1041,A
8-NS,51,0,1050,0,0,1050,T
8-NS,52,1058,0,0,0,1058,A
8-NS,53,0,1080,0,0,1080,T
8-NS,54,2,0,0,1078,1080,C
8-NS,55,1,0,0,1085,1086,C
8-NS,56,3,1,1081,0,1085,G
8-NS,57,2,0,1097,0,1099,G
8-NS,58,1098,0,0,0,1098,A
8-NS,59,1101,0,2,0,1103,A
8-NS,60,1106,0,2,0,1108,A
8-NS,61,0,0,0,1122,1122,C
8-NS,62,1116,0,1,0,1117,A
8-NS,63,1116,0,2,0,1118,A
8-NS,64,0,1,1172,0,1173,G
8-NS,65,0,1175,0,1,1176,T
8-NS,66,0,1164,0,0,1164,T
8-NS,67,2,0,1172,0,1174,G
8-NS,68,0,1180,0,0,1180,T
8-NS,69,1173,0,2,0,1175,A
8-NS,70,1,4,1184,0,1189,G
8-NS,71,1275,0,1,0,1276,A
8-NS,72,0,1,0,1288,1289,C
8-NS,73,2,0,0,1270,1272,C
8-NS,74,1267,0,3,0,1270,A
8-NS,75,1276,0,3,0,1279,A
8-NS,76,1,4,1331,0,1336,G
8-NS,77,1331,0,1,1,1333,A
8-NS,78,1348,0,1,0,1349,A
8-NS,79,0,0,0,1353,1353,C
8-NS,80,0,1310,0,0,1310,T
8-NS,81,1,4,1320,0,1325,G
8-NS,82,1324,0,1,0,1325,A
8-NS,83,0,1,1361,0,1362,G
8-NS,84,0,1361,0,1,1362,T
8-NS,85,1,3,1337,0,1341,G
8-NS,86,1347,1,1,0,1349,A
8-NS,87,0,1353,0,1,1354,T
8-NS,88,0,0,1358,1,1359,G
8-NS,89,1,1,0,1398,1400,C
8-NS,90,1,1,0,1381,1383,C
8-NS,91,8,0,0,1394,1402,C
8-NS,92,0,0,0,1394,1394,C
8-NS,93,1409,0,0,0,1409,A
8-NS,94,0,1427,0,0,1427,T
8-NS,95,0,1435,1,3,1439,T
8-NS,96,2,0,0,1456,1458,C
8-NS,97,2,1,0,1454,1457,C
8-NS,98,0,1453,0,3,1456,T
8-NS,99,0,1452,1,1,1454,T
8-NS,100,1,7,1439,0,1447,G
8-NS,101,1434,0,0,0,1434,A
8-NS,102,0,1443,0,1,1444,T
8-NS,103,4,0,0,1431,1435,C
8-NS,104,1,1,1428,0,1430,G
8-NS,105,0,0,1442,0,1442,G
8-NS,106,0,0,0,1457,1457,C
8-NS,107,1,1437,0,3,1441,T
8-NS,108,0,1447,0,0,1447,T
8-NS,109,1,0,0,1445,1446,C
8-NS,110,0,2,1450,0,1452,G
8-NS,111,1,1,0,1452,1454,C
8-NS,112,5,2,0,1446,1453,C
8-NS,113,1,2,1458,0,1461,G
8-NS,114,1429,1,0,0,1430,A
8-NS,115,0,1,1539,0,1540,G
8-NS,116,1537,0,2,1,1540,A
8-NS,117,1,1548,0,0,1549,T
8-NS,118,3,1,0,1547,1551,C
8-NS,119,1538,0,1,0,1539,A
8-NS,120,0,3,1535,0,1538,G
8-NS,121,1528,1,5,0,1534,A
8-NS,122,0,3,1539,1,1543,G
8-NS,123,0,1,1564,0,1565,G
8-NS,124,0,1551,0,1,1552,T
8-NS,125,2,1,0,1660,1663,C
8-NS,126,4,0,0,1674,1678,C
8-NS,127,3,2,0,1671,1676,C
8-NS,128,0,1682,1,0,1683,T
8-NS,129,1686,0,0,0,1686,A
8-NS,130,1672,0,2,2,1676,A
8-NS,131,0,4,1724,1,1729,G
8-NS,132,2,3,1706,0,1711,G
8-NS,133,0,4,1682,0,1686,G
8-NS,134,0,1,1642,0,1643,G
8-NS,135,1627,0,1,1,1629,A
8-NS,136,1632,1,4,0,1637,A
8-NS,137,0,2,1664,0,1666,G
8-NS,138,1698,0,2,0,1700,A
8-NS,139,1,2,1727,0,1730,G
8-NS,140,1,0,1728,0,1729,G
8-NS,141,0,2,0,1708,1710,C
8-NS,142,1704,0,1,0,1705,A
8-NS,143,1705,0,3,0,1708,A
8-NS,144,0,1717,0,0,1717,T
8-NS,145,1735,0,0,0,1735,A
8-NS,146,0,0,0,1756,1756,C
8-NS,147,0,1688,0,4,1692,T
8-NS,148,5,0,0,1692,1697,C
8-NS,149,0,1658,0,5,1663,T
8-NS,150,2,0,0,1691,1693,C
8-NS,151,2,2,1716,0,1720,G
8-NS,152,1,1,1807,0,1809,G
8-NS,153,0,1816,0,0,1816,T
8-NS,154,3,0,0,1824,1827,C
8-NS,155,0,1810,0,3,1813,T
8-NS,156,1827,0,1,0,1828,A
8-NS,157,0,5,1826,0,1831,G
8-NS,158,1825,0,2,0,1827,A
8-NS,159,0,0,1,1903,1904,C
8-NS,160,1868,0,2,0,1870,A
8-NS,161,0,1823,0,0,1823,T
8-NS,162,1,2,0,1822,1825,C
8-NS,163,1823,0,1,1,1825,A
8-NS,164,1828,0,1,0,1829,A
8-NS,165,1799,1,5,0,1805,A
8-NS,166,1,1,1808,1,1811,G
8-NS,167,0,0,0,1820,1820,C
8-NS,168,1788,1,1,0,1790,A
8-NS,169,1,0,1800,0,1801,G
8-NS,170,2,3,0,1787,1792,C
8-NS,171,4,1,0,1797,1802,C
8-NS,172,1818,1,2,0,1821,A
8-NS,173,1,0,0,1854,1855,C
8-NS,174,1,2,0,1836,1839,C
8-NS,175,6,1,0,1852,1859,C
8-NS,176,1880,5,1,0,1886,A
8-NS,177,2,1881,0,1,1884,T
8-NS,178,0,0,1895,0,1895,G
8-NS,179,0,1880,0,1,1881,T
8-NS,180,0,1868,0,4,1872,T
8-NS,181,0,3,1871,0,1874,G
8-NS,182,0,7,1842,0,1849,G
8-NS,183,1843,0,1,0,1844,A
8-NS,184,1826,0,2,0,1828,A
8-NS,185,1803,0,4,0,1807,A
8-NS,186,0,0,1819,0,1819,G
8-NS,187,0,0,0,1818,1818,C
8-NS,188,1816,0,1,0,1817,A
8-NS,189,1811,2,3,1,1817,A
8-NS,190,1815,0,1,0,1816,A
8-NS,191,0,1817,0,2,1819,T
8-NS,192,1,1829,0,3,1833,T
8-NS,193,1,0,1883,0,1884,G
8-NS,194,0,1882,0,3,1885,T
8-NS,195,1874,0,3,0,1877,A
8-NS,196,0,3,1876,0,1879,G
8-NS,197,1869,0,0,0,1869,A
8-NS,198,1864,0,0,0,1864,A
8-NS,199,1870,0,0,0,1870,A
8-NS,200,1859,0,2,0,1861,A
8-NS,201,0,0,1876,0,1876,G
8-NS,202,1835,0,1,0,1836,A
8-NS,203,0,1829,0,0,1829,T
8-NS,204,0,1833,0,2,1835,T
8-NS,205,1,0,0,1839,1840,C
8-NS,206,0,1828,0,4,1832,T
8-NS,207,0,2,1829,1,1832,G
8-NS,208,1828,0,1,0,1829,A
8-NS,209,1823,0,0,0,1823,A
8-NS,210,1826,1,3,1,1831,A
8-NS,211,0,5,1831,0,1836,G
8-NS,212,1837,0,2,1,1840,A
8-NS,213,1842,0,0,0,1842,A
8-NS,214,1,6,1853,0,1860,G
8-NS,215,1873,0,2,0,1875,A
8-NS,216,1881,0,1,0,1882,A
8-NS,217,0,1874,0,1,1875,T
8-NS,218,3,0,0,1888,1891,C
8-NS,219,0,1888,0,1,1889,T
8-NS,220,0,4,1896,0,1900,G
8-NS,221,1899,0,0,0,1899,A
8-NS,222,0,1896,0,3,1899,T
8-NS,223,0,1,1889,0,1890,G
8-NS,224,1862,0,2,1,1865,A
8-NS,225,0,7,1864,0,1871,G
8-NS,226,2,1,1865,1,1869,G
8-NS,227,0,1,0,1861,1862,C
8-NS,228,1868,0,1,0,1869,A
8-NS,229,0,1,1,1930,1932,C
8-NS,230,1,1918,0,1,1920,T
8-NS,231,0,1936,0,0,1936,T
8-NS,232,1952,0,1,0,1953,A
8-NS,233,1952,0,3,0,1955,A
8-NS,234,1948,0,2,1,1951,A
8-NS,235,1946,0,5,0,1951,A
8-NS,236,0,1951,0,1,1952,T
8-NS,237,0,18,1943,0,1961,G
8-NS,238,1943,1,4,0,1948,A
8-NS,239,1,1,1,1951,1954,C
8-NS,240,2,0,1,1930,1933,C
8-NS,241,1940,1,0,0,1941,A
8-NS,242,0,1936,0,2,1938,T
8-NS,243,2,1,1996,0,1999,G
8-NS,244,1,0,2024,0,2025,G
8-NS,245,0,2039,0,3,2042,T
8-NS,246,6,0,0,2132,2138,C
8-NS,247,0,2106,0,4,2110,T
8-NS,248,4,0,0,2139,2143,C
8-NS,249,2,2,0,2141,2145,C
8-NS,250,2154,0,2,0,2156,A
8-NS,251,0,0,0,2174,2174,C
8-NS,252,2126,0,2,0,2128,A
8-NS,253,2,0,0,2118,2120,C
8-NS,254,1,2,0,2094,2097,C
8-NS,255,1,1973,0,3,1977,T
8-NS,256,0,0,1988,0,1988,G
8-NS,257,0,0,0,1963,1963,C
8-NS,258,0,1938,0,1,1939,T
8-NS,259,0,1953,0,0,1953,T
8-NS,260,1,0,0,1932,1933,C
8-NS,261,1,1,1942,0,1944,G
8-NS,262,0,0,0,1938,1938,C
8-NS,263,2,3,1939,0,1944,G
8-NS,264,2071,0,0,0,2071,A
8-NS,265,0,2066,1,2,2069,T
8-NS,266,2137,0,2,0,2139,A
8-NS,267,0,1,0,2152,2153,C
8-NS,268,2139,1,3,0,2143,A
8-NS,269,1,2205,0,1,2207,T
8-NS,270,2187,0,1,0,2188,A
8-NS,271,2188,0,5,0,2193,A
8-NS,272,0,0,0,2207,2207,C
8-NS,273,0,2107,0,4,2111,T
8-NS,274,0,7,2136,0,2143,G
8-NS,275,2091,0,3,0,2094,A
8-NS,276,0,0,0,2116,2116,C
8-NS,277,2099,0,3,1,2103,A
8-NS,278,0,2066,0,1,2067,T
8-NS,279,0,8,2057,0,2065,G
8-NS,280,2068,0,3,0,2071,A
8-NS,281,0,0,0,2147,2147,C
8-NS,282,0,2114,0,1,2115,T
8-NS,283,2166,0,0,0,2166,A
8-NS,284,0,2151,0,2,2153,T
8-NS,285,0,2139,0,0,2139,T
8-NS,286,1,5,2125,0,2131,G
8-NS,287,2120,1,1,0,2122,A
8-NS,288,0,3,2130,0,2133,G
8-NS,289,1,7,2111,2,2121,G
8-NS,290,2063,0,0,0,2063,A
8-NS,291,2071,0,4,1,2076,A
8-NS,292,0,2027,0,0,2027,T
8-NS,293,0,2016,0,0,2016,T
8-NS,294,0,1,2068,0,2069,G
8-NS,295,1,2071,0,0,2072,T
8-NS,296,5,0,0,2067,2072,C
8-NS,297,2070,0,1,0,2071,A
8-NS,298,2075,0,1,1,2077,A
8-NS,299,0,2,2079,0,2081,G
8-NS,300,2076,1,1,0,2078,A
8-NS,301,2082,0,2,1,2085,A
8-NS,302,2088,0,0,0,2088,A
8-NS,303,1,0,0,2082,2083,C
8-NS,304,0,2035,1,2,2038,T
8-NS,305,0,5,2085,0,2090,G
8-NS,306,1,0,2096,0,2097,G
8-NS,307,0,2094,0,3,2097,T
8-NS,308,0,2094,0,1,2095,T
8-NS,309,12,0,0,2068,2080,C
8-NS,310,2094,0,3,0,2097,A
8-NS,311,0,2123,0,0,2123,T
8-NS,312,2,3,2139,0,2144,G
8-NS,313,0,0,0,2156,2156,C
8-NS,314,0,2117,0,4,2121,T
8-NS,315,2108,0,3,0,2111,A
8-NS,316,2134,0,3,0,2137,A
8-NS,317,0,2161,0,0,2161,T
8-NS,318,0,2,2158,0,2160,G
8-NS,319,0,0,0,2161,2161,C
8-NS,320,2,0,0,2102,2104,C
8-NS,321,13,0,0,2102,2115,C
8-NS,322,2108,0,0,0,2108,A
8-NS,323,2115,1,1,0,2117,A
8-NS,324,1,0,2130,0,2131,G
8-NS,325,2,0,0,2131,2133,C
8-NS,326,2112,1,0,0,2113,A
8-NS,327,1,3,2133,0,2137,G
8-NS,328,2113,1,3,0,2117,A
8-NS,329,2126,0,1,0,2127,A
8-NS,330,2116,0,4,0,2120,A
8-NS,331,0,0,2186,0,2186,G
8-NS,332,0,2175,0,0,2175,T
8-NS,333,2,6,2163,0,2171,G
8-NS,334,0,3,2159,0,2162,G
8-NS,335,2153,0,2,0,2155,A
8-NS,336,2129,1,6,0,2136,A
8-NS,337,1,2,2131,0,2134,G
8-NS,338,1,7,2145,0,2153,G
8-NS,339,2157,0,3,0,2160,A
8-NS,340,2,0,0,2144,2146,C
8-NS,341,5,1,0,2111,2117,C
8-NS,342,0,2105,0,1,2106,T
8-NS,343,1,0,0,2178,2179,C
8-NS,344,0,2171,0,0,2171,T
8-NS,345,0,2175,0,1,2176,T
8-NS,346,2,2163,0,2,2167,T
8-NS,347,1,2,2163,0,2166,G
8-NS,348,2,0,0,2193,2195,C
8-NS,349,2181,0,2,0,2183,A
8-NS,350,0,2174,0,4,2178,T
8-NS,351,3,2,0,2178,2183,C
8-NS,352,2183,1,0,0,2184,A
8-NS,353,1,5,2254,0,2260,G
8-NS,354,2255,0,2,1,2258,A
8-NS,355,2252,0,3,0,2255,A
8-NS,356,0,2245,0,5,2250,T
8-NS,357,0,5,2201,0,2206,G
8-NS,358,2,6,2216,0,2224,G
8-NS,359,2223,0,2,0,2225,A
8-NS,360,1,0,0,2212,2213,C
8-NS,361,1,1,0,2155,2157,C
8-NS,362,2100,1,3,0,2104,A
8-NS,363,0,5,2122,0,2127,G
8-NS,364,3,1,2124,0,2128,G
8-NS,365,0,0,0,2135,2135,C
8-NS,366,2120,0,1,0,2121,A
8-NS,367,2134,0,5,1,2140,A
8-NS,368,0,2125,1,0,2126,T
8-NS,369,3,0,0,2125,2128,C
8-NS,370,2116,0,3,0,2119,A
8-NS,371,0,2120,0,3,2123,T
8-NS,372,1,2,2093,0,2096,G
8-NS,373,0,4,2112,0,2116,G
8-NS,374,2096,0,1,0,2097,A
8-NS,375,0,3,2124,0,2127,G
8-NS,376,2094,0,1,1,2096,A
8-NS,377,2097,0,1,0,2098,A
8-NS,378,2092,0,4,1,2097,A
8-NS,379,2095,0,1,0,2096,A
8-NS,380,2116,0,2,1,2119,A
8-NS,381,0,0,0,2137,2137,C
8-NS,382,2120,0,3,0,2123,A
8-NS,383,0,2121,0,0,2121,T
8-NS,384,4,0,0,2099,2103,C
8-NS,385,2100,0,1,0,2101,A
8-NS,386,0,2108,0,0,2108,T
8-NS,387,3,0,2105,0,2108,G
8-NS,388,0,2113,0,3,2116,T
8-NS,389,0,2098,1,0,2099,T
8-NS,390,0,1,2097,0,2098,G
8-NS,391,2084,0,1,0,2085,A
8-NS,392,2079,0,3,0,2082,A
8-NS,393,2075,0,1,0,2076,A
8-NS,394,1,0,2097,0,2098,G
8-NS,395,2,1,0,2054,2057,C
8-NS,396,2,4,2059,0,2065,G
8-NS,397,2049,0,3,0,2052,A
8-NS,398,2065,0,0,0,2065,A
8-NS,399,0,2043,0,0,2043,T
8-NS,400,0,2047,1,2,2050,T
8-NS,401,0,2052,0,2,2054,T
8-NS,402,4,0,0,2064,2068,C
8-NS,403,2054,0,0,0,2054,A
8-NS,404,0,0,2065,0,2065,G
8-NS,405,1,2046,0,3,2050,T
8-NS,406,0,1,2054,0,2055,G
8-NS,407,0,2052,0,5,2057,T
8-NS,408,0,4,2054,0,2058,G
8-NS,409,2072,0,1,0,2073,A
8-NS,410,0,2066,0,0,2066,T
8-NS,411,0,2049,0,2,2051,T
8-NS,412,0,2052,0,2,2054,T
8-NS,413,0,2051,0,2,2053,T
8-NS,414,0,2059,0,0,2059,T
8-NS,415,1,4,2043,0,2048,G
8-NS,416,0,0,2017,1,2018,G
8-NS,417,0,1,1,2016,2018,C
8-NS,418,1,4,0,2017,2022,C
8-NS,419,0,5,2047,0,2052,G
8-NS,420,2121,0,2,0,2123,A
8-NS,421,1,0,0,2162,2163,C
8-NS,422,0,2167,0,1,2168,T
8-NS,423,2176,0,1,0,2177,A
8-NS,424,1,3,2175,0,2179,G
8-NS,425,2160,1,8,0,2169,A
8-NS,426,0,3,2211,0,2214,G
8-NS,427,2209,0,3,0,2212,A
8-NS,428,0,0,0,2296,2296,C
8-NS,429,3,1,0,2228,2232,C
8-NS,430,2148,0,2,1,2151,A
8-NS,431,0,2305,0,0,2305,T
8-NS,432,2290,0,0,0,2290,A
8-NS,433,0,0,2523,0,2523,G
8-NS,434,0,2500,0,4,2504,T
8-NS,435,2483,0,0,1,2484,A
8-NS,436,1,2485,0,2,2488,T
8-NS,437,0,2382,0,5,2387,T
8-NS,438,2494,0,1,0,2495,A
8-NS,439,0,1,0,2491,2492,C
8-NS,440,0,2359,1,1,2361,T
8-NS,441,2362,0,1,0,2363,A
8-NS,442,2099,0,1,0,2100,A
8-NS,443,1,1,2128,0,2130,G
8-NS,444,1,1,2123,0,2125,G
8-NS,445,0,1,2130,0,2131,G
8-NS,446,0,0,0,2095,2095,C
8-NS,447,0,2039,1,6,2046,T
8-NS,448,0,2032,0,6,2038,T
8-NS,449,1,2079,0,2,2082,T
8-NS,450,3,1,1,2088,2093,C
8-NS,451,2116,1,2,0,2119,A
8-NS,452,0,1,0,2130,2131,C
8-NS,453,1,1,0,2097,2099,C
8-NS,454,4,4,2099,0,2107,G
8-NS,455,2099,0,0,0,2099,A
8-NS,456,2090,1,1,0,2092,A
8-NS,457,1,2,2105,0,2108,G
8-NS,458,2083,1,0,0,2084,A
8-NS,459,0,4,2102,0,2106,G
8-NS,460,0,5,2063,0,2068,G
8-NS,461,0,5,2084,0,2089,G
8-NS,462,2091,0,3,0,2094,A
8-NS,463,0,2,2092,0,2094,G
8-NS,464,1,0,0,2083,2084,C
8-NS,465,2078,0,0,0,2078,A
8-NS,466,2085,0,0,0,2085,A
8-NS,467,0,2085,0,0,2085,T
8-NS,468,0,2069,1,0,2070,T
8-NS,469,0,0,2081,0,2081,G
8-NS,470,0,2044,0,0,2044,T
8-NS,471,1,2037,0,1,2039,T
8-NS,472,0,6,2030,0,2036,G
8-NS,473,0,0,2041,0,2041,G
8-NS,474,1,1,0,2042,2044,C
8-NS,475,1,5,2035,0,2041,G
8-NS,476,2050,0,0,0,2050,A
8-NS,477,2068,0,0,0,2068,A
8-NS,478,2069,0,0,1,2070,A
8-NS,479,0,2084,0,0,2084,T
8-NS,480,0,1,1,2085,2087,C
8-NS,481,1,2055,0,1,2057,T
8-NS,482,4,0,0,2062,2066,C
8-NS,483,2071,0,6,0,2077,A
8-NS,484,2,0,0,2087,2089,C
8-NS,485,4,1,1,2074,2080,C
8-NS,486,2070,0,1,0,2071,A
8-NS,487,0,2058,0,3,2061,T
8-NS,488,0,2035,0,3,2038,T
8-NS,489,0,1,2044,0,2045,G
8-NS,490,1,2,0,2029,2032,C
8-NS,491,4,0,0,2039,2043,C
8-NS,492,0,2039,0,2,2041,T
8-NS,493,0,2029,1,2,2032,T
8-NS,494,1,0,0,2060,2061,C
8-NS,495,0,2048,0,6,2054,T
8-NS,496,0,2061,0,0,2061,T
8-NS,497,0,2098,1,4,2103,T
8-NS,498,1,2082,0,2,2085,T
8-NS,499,1,1,0,2088,2090,C
8-NS,500,1,0,1,2084,2086,C
8-NS,501,2072,0,5,0,2077,A
8-NS,502,1,2,2118,0,2121,G
8-NS,503,1,5,2094,0,2100,G
8-NS,504,2165,0,1,0,2166,A
8-NS,505,0,1,0,2166,2167,C
8-NS,506,2190,0,1,0,2191,A
8-NS,507,0,2203,0,3,2206,T
8-NS,508,2220,0,3,1,2224,A
8-NS,509,0,1,0,2439,2440,C
8-NS,510,1,2432,0,1,2434,T
8-NS,511,2406,1,1,0,2408,A
8-NS,512,0,2392,0,4,2396,T
8-NS,513,0,2301,0,4,2305,T
8-NS,514,0,1,2299,1,2301,G
8-NS,515,2191,0,4,1,2196,A
8-NS,516,1,2,2202,0,2205,G
8-NS,517,1,0,2197,0,2198,G
8-NS,518,1946,1,0,0,1947,A
8-NS,519,0,1959,0,3,1962,T
8-NS,520,1,0,1956,0,1957,G
8-NS,521,0,1940,0,1,1941,T
8-NS,522,7,1,0,1943,1951,C
8-NS,523,1961,0,3,0,1964,A
8-NS,524,1958,0,0,0,1958,A
8-NS,525,1950,0,2,0,1952,A
8-NS,526,1934,0,1,0,1935,A
8-NS,527,1958,0,0,0,1958,A
8-NS,528,0,1944,0,0,1944,T
8-NS,529,3,0,1942,0,1945,G
8-NS,530,2,1,0,1953,1956,C
8-NS,531,1957,0,0,0,1957,A
8-NS,532,1955,0,0,0,1955,A
8-NS,533,1,1958,0,2,1961,T
8-NS,534,0,1961,0,3,1964,T
8-NS,535,1,1,1949,0,1951,G
8-NS,536,1,7,1937,0,1945,G
8-NS,537,1,2,1940,0,1943,G
8-NS,538,1,3,1977,0,1981,G
8-NS,539,2,1926,0,4,1932,T
8-NS,540,2,1,0,1952,1955,C
8-NS,541,3,1,0,1952,1956,C
8-NS,542,0,1941,1,6,1948,T
8-NS,543,3,0,0,1984,1987,C
8-NS,544,1982,1,0,0,1983,A
8-NS,545,2,1973,0,2,1977,T
8-NS,546,4,2,0,1984,1990,C
8-NS,547,4,1,1965,0,1970,G
8-NS,548,1,1,1980,0,1982,G
8-NS,549,1947,0,0,0,1947,A
8-NS,550,0,6,1947,0,1953,G
8-NS,551,0,2,1961,0,1963,G
8-NS,552,1921,0,6,1,1928,A
8-NS,553,2,0,0,1945,1947,C
8-NS,554,1,1947,0,3,1951,T
8-NS,555,0,1956,0,0,1956,T
8-NS,556,2,7,1959,0,1968,G
8-NS,557,1957,0,0,0,1957,A
8-NS,558,1958,0,3,0,1961,A
8-NS,559,1,1953,0,0,1954,T
8-NS,560,1,1,1924,0,1926,G
8-NS,561,1,1,1957,0,1959,G
8-NS,562,1909,1,3,1,1914,A
8-NS,563,1938,0,0,0,1938,A
8-NS,564,0,2030,0,2,2032,T
8-NS,565,0,2,2044,0,2046,G
8-NS,566,2047,0,3,0,2050,A
8-NS,567,0,2055,0,2,2057,T
8-NS,568,2050,0,3,0,2053,A
8-NS,569,2061,0,4,0,2065,A
8-NS,570,0,1,0,2059,2060,C
8-NS,571,2007,0,1,0,2008,A
8-NS,572,0,0,0,2040,2040,C
8-NS,573,1844,0,2,0,1846,A
8-NS,574,0,1,1889,0,1890,G
8-NS,575,0,1866,0,3,1869,T
8-NS,576,0,1856,0,5,1861,T
8-NS,577,7,2,0,1861,1870,C
8-NS,578,1,5,1842,0,1848,G
8-NS,579,1837,0,3,0,1840,A
8-NS,580,0,1,1845,0,1846,G
8-NS,581,0,1810,0,3,1813,T
8-NS,582,3,1,0,1820,1824,C
8-NS,583,0,1751,0,2,1753,T
8-NS,584,1,0,0,1782,1783,C
8-NS,585,0,1788,0,0,1788,T
8-NS,586,1796,1,0,0,1797,A
8-NS,587,1794,0,1,0,1795,A
8-NS,588,1793,0,0,0,1793,A
8-NS,589,1804,0,1,0,1805,A
8-NS,590,1802,0,1,0,1803,A
8-NS,591,0,1782,0,0,1782,T
8-NS,592,1,0,0,1812,1813,C
8-NS,593,0,1789,0,2,1791,T
8-NS,594,1797,0,1,0,1798,A
8-NS,595,0,0,0,1799,1799,C
8-NS,596,1791,1,3,1,1796,A
8-NS,597,1,2,1799,1,1803,G
8-NS,598,1734,0,5,0,1739,A
8-NS,599,1,0,1764,0,1765,G
8-NS,600,1765,1,2,0,1768,A
8-NS,601,0,1741,1,2,1744,T
8-NS,602,1,1737,1,2,1741,T
8-NS,603,10,1,0,1731,1742,C
8-NS,604,1,1,1736,0,1738,G
8-NS,605,0,2,0,1742,1744,C
8-NS,606,0,1728,0,2,1730,T
8-NS,607,0,1742,0,0,1742,T
8-NS,608,1,0,1718,0,1719,G
8-NS,609,0,1,1727,0,1728,G
8-NS,610,1719,0,0,0,1719,A
8-NS,611,1,0,1722,0,1723,G
8-NS,612,1711,0,2,0,1713,A
8-NS,613,1703,0,5,0,1708,A
8-NS,614,0,1,1757,0,1758,G
8-NS,615,2,0,0,1755,1757,C
8-NS,616,1754,0,2,0,1756,A
8-NS,617,0,1,1799,0,1800,G
8-NS,618,0,1776,0,2,1778,T
8-NS,619,1793,0,1,0,1794,A
8-NS,620,1794,0,1,0,1795,A
8-NS,621,0,1787,0,1,1788,T
8-NS,622,1,4,1798,0,1803,G
8-NS,623,1698,0,8,0,1706,A
8-NS,624,0,3,1746,0,1749,G
8-NS,625,1726,1,2,0,1729,A
8-NS,626,1663,0,2,0,1665,A
8-NS,627,0,1662,0,0,1662,T
8-NS,628,1,5,1636,0,1642,G
8-NS,629,1,2,1645,0,1648,G
8-NS,630,2,3,1633,0,1638,G
8-NS,631,5,0,1628,0,1633,G
8-NS,632,0,2,1641,0,1643,G
8-NS,633,1599,0,1,0,1600,A
8-NS,634,2,1,0,1617,1620,C
8-NS,635,2,0,0,1613,1615,C
8-NS,636,1,1568,0,4,1573,T
8-NS,637,3,0,0,1587,1590,C
8-NS,638,2,2,0,1569,1573,C
8-NS,639,1592,1,1,1,1595,A
8-NS,640,0,1,0,1589,1590,C
8-NS,641,0,1552,0,2,1554,T
8-NS,642,0,1558,0,1,1559,T
8-NS,643,1520,0,0,0,1520,A
8-NS,644,0,1,0,1543,1544,C
8-NS,645,1,1530,0,3,1534,T
8-NS,646,5,2,0,1524,1531,C
8-NS,647,2,0,0,1511,1513,C
8-NS,648,1507,1,0,0,1508,A
8-NS,649,1523,0,0,0,1523,A
8-NS,650,1515,0,1,0,1516,A
8-NS,651,1521,1,1,0,1523,A
8-NS,652,0,0,0,1524,1524,C
8-NS,653,1440,1,2,0,1443,A
8-NS,654,0,1,1457,0,1458,G
8-NS,655,1435,1,3,0,1439,A
8-NS,656,1434,1,2,0,1437,A
8-NS,657,1442,1,1,0,1444,A
8-NS,658,0,0,0,1438,1438,C
8-NS,659,1,2,1440,0,1443,G
8-NS,660,0,2,1438,0,1440,G
8-NS,661,0,5,1435,0,1440,G
8-NS,662,1439,1,0,0,1440,A
8-NS,663,1431,0,1,1,1433,A
8-NS,664,1427,0,2,0,1429,A
8-NS,665,0,1430,0,0,1430,T
8-NS,666,0,1,1453,0,1454,G
8-NS,667,0,0,1452,0,1452,G
8-NS,668,1,1,0,1436,1438,C
8-NS,669,0,4,1436,0,1440,G
8-NS,670,1427,0,2,0,1429,A
8-NS,671,0,6,1438,0,1444,G
8-NS,672,1439,1,1,0,1441,A
8-NS,673,1440,0,3,1,1444,A
8-NS,674,0,0,0,1455,1455,C
8-NS,675,1417,0,1,0,1418,A
8-NS,676,0,0,1421,0,1421,G
8-NS,677,1,0,0,1407,1408,C
8-NS,678,0,1412,1,0,1413,T
8-NS,679,1416,0,1,0,1417,A
8-NS,680,2,3,1416,0,1421,G
8-NS,681,3,0,1422,0,1425,G
8-NS,682,0,1413,0,1,1414,T
8-NS,683,4,1,0,1391,1396,C
8-NS,684,1401,0,0,0,1401,A
8-NS,685,1397,0,0,0,1397,A
8-NS,686,1383,0,0,0,1383,A
8-NS,687,1403,0,1,0,1404,A
8-NS,688,1,0,1415,0,1416,G
8-NS,689,0,1362,1,3,1366,T
8-NS,690,0,1360,0,2,1362,T
8-NS,691,0,1367,0,1,1368,T
8-NS,692,0,2,1372,0,1374,G
8-NS,693,1366,0,2,0,1368,A
8-NS,694,1364,0,2,0,1366,A
8-NS,695,0,1,1378,0,1379,G
8-NS,696,1321,0,1,0,1322,A
8-NS,697,4,0,1335,0,1339,G
8-NS,698,1334,0,1,0,1335,A
8-NS,699,0,1350,0,1,1351,T
8-NS,700,1346,0,0,0,1346,A
8-NS,701,1338,1,1,0,1340,A
8-NS,702,1,0,1337,0,1338,G
8-NS,703,1250,0,2,0,1252,A
8-NS,704,0,1259,0,1,1260,T
8-NS,705,0,3,1260,0,1263,G
8-NS,706,0,1,1268,0,1269,G
8-NS,707,0,0,0,1258,1258,C
8-NS,708,0,1252,0,1,1253,T
8-NS,709,1263,0,2,0,1265,A
8-NS,710,1265,0,0,0,1265,A
8-NS,711,0,1271,0,0,1271,T
8-NS,712,0,1273,0,0,1273,T
8-NS,713,2,2,1279,0,1283,G
8-NS,714,1261,0,1,0,1262,A
8-NS,715,1255,0,2,0,1257,A
8-NS,716,0,1,1260,0,1261,G
8-NS,717,1257,0,0,0,1257,A
8-NS,718,1254,0,2,0,1256,A
8-NS,719,0,1,1265,0,1266,G
8-NS,720,0,1240,0,0,1240,T
8-NS,721,0,1,1240,0,1241,G
8-NS,722,1213,0,3,1,1217,A
8-NS,723,1,4,1229,0,1234,G
8-NS,724,1228,0,3,0,1231,A
8-NS,725,0,0,0,1229,1229,C
8-NS,726,1224,0,0,0,1224,A
8-NS,727,0,0,0,1236,1236,C
8-NS,728,1195,0,1,1,1197,A
8-NS,729,1,0,1251,0,1252,G
8-NS,730,1251,0,0,0,1251,A
8-NS,731,0,1235,0,3,1238,T
8-NS,732,0,1233,0,1,1234,T
8-NS,733,1230,1,0,0,1231,A
8-NS,734,1224,0,0,0,1224,A
8-NS,735,0,1,1076,0,1077,G
8-NS,736,1096,0,0,0,1096,A
8-NS,737,1094,0,0,0,1094,A
8-NS,738,0,0,0,1097,1097,C
8-NS,739,1053,0,2,0,1055,A
8-NS,740,1069,0,1,0,1070,A
8-NS,741,1,1,0,1071,1073,C
8-NS,742,0,1057,0,1,1058,T
8-NS,743,0,3,1069,0,1072,G
8-NS,744,1067,0,0,0,1067,A
8-NS,745,1069,0,2,0,1071,A
8-NS,746,1066,0,1,0,1067,A
8-NS,747,1060,0,0,0,1060,A
8-NS,748,0,1059,0,0,1059,T
8-NS,749,1024,0,0,0,1024,A
8-NS,750,0,0,1036,0,1036,G
8-NS,751,0,0,0,1033,1033,C
8-NS,752,0,1016,0,0,1016,T
8-NS,753,1,1010,0,1,1012,T
8-NS,754,0,1009,0,0,1009,T
8-NS,755,0,5,1010,0,1015,G
8-NS,756,1013,1,1,0,1015,A
8-NS,757,1017,1,0,0,1018,A
8-NS,758,0,2,0,1022,1024,C
8-NS,759,991,0,1,0,992,A
8-NS,760,993,0,0,0,993,A
8-NS,761,991,1,0,0,992,A
8-NS,762,0,992,0,0,992,T
8-NS,763,996,0,1,0,997,A
8-NS,764,984,0,4,0,988,A
8-NS,765,0,0,0,995,995,C
8-NS,766,993,0,0,0,993,A
8-NS,767,0,968,0,0,968,T
8-NS,768,0,951,0,3,954,T
8-NS,769,1,0,0,955,956,C
8-NS,770,948,0,1,0,949,A
8-NS,771,0,945,0,0,945,T
8-NS,772,0,0,943,0,943,G
8-NS,773,0,1,0,922,923,C
8-NS,774,910,0,1,0,911,A
8-NS,775,911,0,0,0,911,A
8-NS,776,2,0,908,0,910,G
8-NS,777,0,0,0,934,934,C
8-NS,778,925,0,1,0,926,A
8-NS,779,0,928,0,0,928,T
8-NS,780,0,928,0,1,929,T
8-NS,781,930,0,1,0,931,A
8-NS,782,0,1,0,928,929,C
8-NS,783,918,0,0,0,918,A
8-NS,784,905,0,0,0,905,A
8-NS,785,0,0,0,898,898,C
8-NS,786,0,742,0,0,742,T
8-NS,787,1,0,734,0,735,G
8-NS,788,1,1,0,723,725,C
8-NS,789,0,691,0,1,692,T
8-NS,790,0,0,694,0,694,G
8-NS,791,0,674,0,0,674,T
8-NS,792,0,675,1,1,677,T
8-NS,793,0,674,0,0,674,T
8-NS,794,0,0,665,0,665,G
8-NS,795,665,0,0,0,665,A
8-NS,796,650,1,0,0,651,A
8-NS,797,0,0,650,0,650,G
8-NS,798,0,641,0,0,641,T
8-NS,799,0,2,605,0,607,G
8-NS,800,0,1,616,0,617,G
8-NS,801,613,1,1,0,615,A
8-NS,802,611,0,1,0,612,A
8-NS,803,0,1,0,612,613,C
8-NS,804,592,0,1,0,593,A
8-NS,805,0,0,594,0,594,G
8-NS,806,0,0,577,0,577,G
8-NS,807,555,0,1,0,556,A
8-NS,808,0,1,570,0,571,G
8-NS,809,494,1,0,0,495,A
8-NS,810,0,495,0,0,495,T
8-NS,811,492,0,1,0,493,A
8-NS,812,488,0,2,0,490,A
8-NS,813,0,1,490,0,491,G
8-NS,814,430,1,1,0,432,A
8-NS,815,429,0,0,0,429,A
8-NS,816,0,0,0,426,426,C
8-NS,817,0,365,0,1,366,T
8-NS,818,0,355,0,0,355,T
8-NS,819,0,350,0,0,350,T
8-NS,820,1,0,0,352,353,C
8-NS,821,0,344,1,1,346,T
8-NS,822,0,1,0,334,335,C
8-NS,823,326,0,1,0,327,A
8-NS,824,0,322,0,1,323,T
8-NS,825,0,316,0,1,317,T
8-NS,826,0,313,0,0,313,T
8-NS,827,0,0,0,313,313,C
8-NS,828,291,0,1,0,292,A
8-NS,829,0,0,295,0,295,G
8-NS,830,0,0,0,290,290,C
8-NS,831,0,265,0,1,266,T
8-NS,832,0,262,0,0,262,T
8-NS,833,257,0,0,0,257,A
8-NS,834,0,256,0,0,256,T
8-NS,835,0,258,0,0,258,T
8-NS,836,0,253,0,0,253,T
8-NS,837,246,0,0,0,246,A
8-NS,838,240,0,1,0,241,A
8-NS,839,0,233,0,0,233,T
8-NS,840,0,1,230,0,231,G
8-NS,841,227,0,0,0,227,A
8-NS,842,0,203,0,0,203,T
8-NS,843,198,0,0,0,198,A
8-NS,844,199,0,1,0,200,A
8-NS,845,199,0,0,0,199,A
8-NS,846,200,0,0,0,200,A
8-NS,847,197,1,0,0,198,A
8-NS,848,195,0,0,0,195,A
8-NS,849,0,0,0,197,197,C
8-NS,850,172,0,0,0,172,A
8-NS,851,0,0,0,171,171,C
8-NS,852,0,0,0,167,167,C
8-NS,853,0,0,0,160,160,C
8-NS,854,0,154,0,0,154,T
8-NS,855,0,149,0,0,149,T
8-NS,856,0,0,149,0,149,G
8-NS,857,0,144,0,0,144,T
8-NS,858,0,142,0,0,142,T
8-NS,859,0,133,0,0,133,T
8-NS,860,0,0,0,57,57,C
8-NS,861,0,44,1,0,45,T
8-NS,862,37,0,0,0,37,A
8-NS,863,0,0,0,37,37,C
