Gene,Position,A,T,G,C,Coverage,Consensus
1-PB2,1,424,0,0,0,424,A
1-PB2,2,0,424,0,0,424,T
1-PB2,3,0,0,435,0,435,G
1-PB2,4,0,1,436,0,437,G
1-PB2,5,437,0,0,0,437,A
1-PB2,6,433,0,0,0,433,A
1-PB2,7,436,0,0,0,436,A
1-PB2,8,1,1,482,0,484,G
1-PB2,9,485,0,0,0,485,A
1-PB2,10,486,0,1,0,487,A
1-PB2,11,0,502,0,0,502,T
1-PB2,12,500,0,0,0,500,A
1-PB2,13,502,0,0,0,502,A
1-PB2,14,503,0,0,0,503,A
1-PB2,15,505,0,0,0,505,A
1-PB2,16,0,1,522,0,523,G
1-PB2,17,524,0,1,0,525,A
1-PB2,18,527,0,0,0,527,A
1-PB2,19,0,0,0,541,541,C
1-PB2,20,0,540,0,0,540,T
1-PB2,21,549,0,1,0,550,A
1-PB2,22,0,0,0,551,551,C
1-PB2,23,1,3,549,1,554,G
1-PB2,24,1,3,558,0,562,G
1-PB2,25,562,0,0,0,562,A
1-PB2,26,585,0,0,1,586,A
1-PB2,27,0,590,0,0,590,T
1-PB2,28,2,0,0,589,591,C
1-PB2,29,0,591,0,0,591,T
1-PB2,30,0,2,598,0,600,G
1-PB2,31,605,0,1,0,606,A
1-PB2,32,0,608,0,0,608,T
1-PB2,33,0,0,614,0,614,G
1-PB2,34,1,627,0,0,628,T
1-PB2,35,1,0,0,623,624,C
1-PB2,36,1,0,625,0,626,G
1-PB2,37,0,0,0,627,627,C
1-PB2,38,628,0,0,0,628,A
1-PB2,39,0,0,666,0,666,G
1-PB2,40,0,672,0,1,673,T
1-PB2,41,2,0,0,673,675,C
1-PB2,42,0,673,0,0,673,T
1-PB2,43,1,0,0,674,675,C
1-PB2,44,0,0,676,0,676,G
1-PB2,45,0,0,0,678,678,C
1-PB2,46,675,0,0,0,675,A
1-PB2,47,1,0,0,685,686,C
1-PB2,48,0,680,0,0,680,T
1-PB2,49,3,0,0,697,700,C
1-PB2,50,0,0,702,0,702,G
1-PB2,51,2,1,0,701,704,C
1-PB2,52,0,0,704,0,704,G
1-PB2,53,700,0,1,0,701,A
1-PB2,54,2,0,703,0,705,G
1-PB2,55,720,0,0,0,720,A
1-PB2,56,0,718,0,0,718,T
1-PB2,57,717,0,0,0,717,A
1-PB2,58,0,0,0,717,717,C
1-PB2,59,0,711,0,1,712,T
1-PB2,60,0,2,729,0,731,G
1-PB2,61,732,0,1,0,733,A
1-PB2,62,1,0,0,745,746,C
1-PB2,63,743,0,0,0,743,A
1-PB2,64,743,0,0,0,743,A
1-PB2,65,752,0,1,0,753,A
1-PB2,66,767,0,0,0,767,A
1-PB2,67,765,0,1,0,766,A
1-PB2,68,0,1,0,776,777,C
1-PB2,69,2,0,0,772,774,C
1-PB2,70,789,1,0,0,790,A
1-PB2,71,1,0,1,794,796,C
1-PB2,72,797,0,1,0,798,A
1-PB2,73,0,0,825,0,825,G
1-PB2,74,0,819,0,0,819,T
1-PB2,75,0,1,844,0,845,G
1-PB2,76,0,2,845,0,847,G
1-PB2,77,852,1,0,0,853,A
1-PB2,78,1,1,0,892,894,C
1-PB2,79,2,0,0,890,892,C
1-PB2,80,906,0,1,0,907,A
1-PB2,81,0,910,0,0,910,T
1-PB2,82,899,0,2,0,901,A
1-PB2,83,0,898,0,3,901,T
1-PB2,84,0,4,892,1,897,G
1-PB2,85,0,1,904,0,905,G
1-PB2,86,1,0,0,906,907,C
1-PB2,87,5,1,0,881,887,C
1-PB2,88,887,0,0,0,887,A
1-PB2,89,0,949,0,1,950,T
1-PB2,90,952,0,0,0,952,A
1-PB2,91,994,0,0,0,994,A
1-PB2,92,0,992,0,0,992,T
1-PB2,93,1,989,0,0,990,T
1-PB2,94,998,1,0,1,1000,A
1-PB2,95,1003,0,0,1,1004,A
1-PB2,96,0,4,1024,0,1028,G
1-PB2,97,1024,0,0,0,1024,A
1-PB2,98,1011,0,0,1,1012,A
1-PB2,99,1,2,1059,0,1062,G
1-PB2,100,0,1049,0,0,1049,T
1-PB2,101,1052,0,1,0,1053,A
1-PB2,102,0,0,0,1054,1054,C
1-PB2,103,1053,0,1,0,1054,A
1-PB2,104,0,0,0,1087,1087,C
1-PB2,105,1084,0,0,0,1084,A
1-PB2,106,0,1086,0,0,1086,T
1-PB2,107,0,0,0,1101,1101,C
1-PB2,108,6,3,1083,0,1092,G
1-PB2,109,1,4,1092,0,1097,G
1-PB2,110,0,0,1094,0,1094,G
1-PB2,111,0,3,1089,0,1092,G
1-PB2,112,1095,0,0,1,1096,A
1-PB2,113,1,3,1085,1,1090,G
1-PB2,114,1077,0,4,0,1081,A
1-PB2,115,0,0,0,1096,1096,C
1-PB2,116,1088,1,2,1,1092,A
1-PB2,117,0,4,1101,0,1105,G
1-PB2,118,0,1,1123,0,1124,G
1-PB2,119,1127,1,1,0,1129,A
1-PB2,120,1128,0,2,0,1130,A
1-PB2,121,1130,0,0,0,1130,A
1-PB2,122,1128,0,0,0,1128,A
1-PB2,123,0,5,1127,0,1132,G
1-PB2,124,1129,0,1,0,1130,A
1-PB2,125,1134,0,1,1,1136,A
1-PB2,126,1,0,0,1135,1136,C
1-PB2,127,3,0,0,1126,1129,C
1-PB2,128,2,0,0,1126,1128,C
1-PB2,129,0,1,1132,0,1133,G
1-PB2,130,0,1130,0,0,1130,T
1-PB2,131,5,0,0,1129,1134,C
1-PB2,132,1144,0,2,1,1147,A
1-PB2,133,1,0,0,1157,1158,C
1-PB2,134,0,1149,0,0,1149,T
1-PB2,135,0,1154,0,0,1154,T
1-PB2,136,1157,0,0,0,1157,A
1-PB2,137,1,3,1181,0,1185,G
1-PB2,138,0,1,1183,0,1184,G
1-PB2,139,1183,0,1,0,1184,A
1-PB2,140,0,1185,0,0,1185,T
1-PB2,141,1,3,1186,0,1190,G
1-PB2,142,1203,0,0,0,1203,A
1-PB2,143,1201,0,0,1,1202,A
1-PB2,144,1208,0,0,0,1208,A
1-PB2,145,1,1207,0,0,1208,T
1-PB2,146,0,2,1210,2,1214,G
1-PB2,147,0,2,1225,0,1227,G
1-PB2,148,1225,1,1,0,1227,A
1-PB2,149,0,1223,0,0,1223,T
1-PB2,150,1,3,1214,0,1218,G
1-PB2,151,1209,2,4,0,1215,A
1-PB2,152,0,1215,0,0,1215,T
1-PB2,153,0,1,1216,0,1217,G
1-PB2,154,0,1,1219,0,1220,G
1-PB2,155,1,0,0,1217,1218,C
1-PB2,156,1208,0,0,0,1208,A
1-PB2,157,1223,0,1,0,1224,A
1-PB2,158,0,1229,0,0,1229,T
1-PB2,159,0,3,1258,0,1261,G
1-PB2,160,1258,1,0,0,1259,A
1-PB2,161,1253,0,1,0,1254,A
1-PB2,162,1255,0,0,0,1255,A
1-PB2,163,0,1260,0,0,1260,T
1-PB2,164,1269,0,0,0,1269,A
1-PB2,165,1,0,0,1290,1291,C
1-PB2,166,1,0,0,1275,1276,C
1-PB2,167,4,1,0,1274,1279,C
1-PB2,168,1273,0,0,0,1273,A
1-PB2,169,1277,0,0,0,1277,A
1-PB2,170,0,1274,0,0,1274,T
1-PB2,171,1,0,0,1277,1278,C
1-PB2,172,1271,0,0,0,1271,A
1-PB2,173,0,0,0,1288,1288,C
1-PB2,174,1,1269,0,0,1270,T
1-PB2,175,0,0,1279,0,1279,G
1-PB2,176,0,1,0,1277,1278,C
1-PB2,177,0,1274,0,2,1276,T
1-PB2,178,1,5,1277,0,1283,G
1-PB2,179,1276,3,1,1,1281,A
1-PB2,180,2,0,0,1298,1300,C
1-PB2,181,1296,0,0,0,1296,A
1-PB2,182,1280,2,0,0,1282,A
1-PB2,183,1286,0,0,0,1286,A
1-PB2,184,1287,0,2,0,1289,A
1-PB2,185,0,0,1302,0,1302,G
1-PB2,186,0,4,1300,0,1304,G
1-PB2,187,1295,0,0,0,1295,A
1-PB2,188,1,1300,0,0,1301,T
1-PB2,189,1294,0,0,0,1294,A
1-PB2,190,1312,0,0,0,1312,A
1-PB2,191,0,0,0,1314,1314,C
1-PB2,192,1309,1,0,1,1311,A
1-PB2,193,1,4,1307,0,1312,G
1-PB2,194,1293,0,0,0,1293,A
1-PB2,195,1295,0,0,0,1295,A
1-PB2,196,1294,2,2,0,1298,A
1-PB2,197,0,1297,0,0,1297,T
1-PB2,198,2,5,1292,0,1299,G
1-PB2,199,1280,0,0,0,1280,A
1-PB2,200,0,1305,0,0,1305,T
1-PB2,201,0,1308,0,2,1310,T
1-PB2,202,4,0,0,1304,1308,C
1-PB2,203,1,1,0,1308,1310,C
1-PB2,204,1302,1,0,0,1303,A
1-PB2,205,0,5,1304,0,1309,G
1-PB2,206,1307,0,0,1,1308,A
1-PB2,207,0,1,1319,0,1320,G
1-PB2,208,1305,0,0,0,1305,A
1-PB2,209,0,1,1328,0,1329,G
1-PB2,210,1326,0,2,0,1328,A
1-PB2,211,1327,0,0,0,1327,A
1-PB2,212,1326,0,0,1,1327,A
1-PB2,213,0,1327,0,0,1327,T
1-PB2,214,0,2,1336,0,1338,G
1-PB2,215,1342,1,0,0,1343,A
1-PB2,216,1340,0,2,0,1342,A
1-PB2,217,0,0,0,1337,1337,C
1-PB2,218,1318,1,0,1,1320,A
1-PB2,219,1326,0,2,0,1328,A
1-PB2,220,0,4,1346,0,1350,G
1-PB2,221,0,4,1363,0,1367,G
1-PB2,222,1362,0,2,0,1364,A
1-PB2,223,0,1,0,1364,1365,C
1-PB2,224,1364,0,0,0,1364,A
1-PB2,225,1365,0,2,0,1367,A
1-PB2,226,1417,1,0,0,1418,A
1-PB2,227,0,0,0,1428,1428,C
1-PB2,228,0,1404,0,0,1404,T
1-PB2,229,2,0,1,1431,1434,C
1-PB2,230,0,1416,0,0,1416,T
1-PB2,231,1429,1,1,1,1432,A
1-PB2,232,1,1426,0,0,1427,T
1-PB2,233,0,1,1441,0,1442,G
1-PB2,234,0,3,1471,0,1474,G
1-PB2,235,1400,0,2,0,1402,A
1-PB2,236,0,1,1405,0,1406,G
1-PB2,237,0,1403,0,2,1405,T
1-PB2,238,1403,0,0,0,1403,A
1-PB2,239,1404,1,1,0,1406,A
1-PB2,240,1404,0,0,0,1404,A
1-PB2,241,1406,0,1,0,1407,A
1-PB2,242,0,1395,0,0,1395,T
1-PB2,243,1,5,1381,0,1387,G
1-PB2,244,1367,0,2,0,1369,A
1-PB2,245,0,0,1377,0,1377,G
1-PB2,246,0,1360,0,3,1363,T
1-PB2,247,0,5,1356,0,1361,G
1-PB2,248,1382,1,2,0,1385,A
1-PB2,249,0,1404,0,0,1404,T
1-PB2,250,1,0,1405,0,1406,G
1-PB2,251,1,1,0,1405,1407,C
1-PB2,252,0,1394,0,0,1394,T
1-PB2,253,2,0,1436,0,1438,G
1-PB2,254,0,4,1431,0,1435,G
1-PB2,255,1454,0,0,0,1454,A
1-PB2,256,2,1445,0,1,1448,T
1-PB2,257,2,0,0,1450,1452,C
1-PB2,258,1458,0,0,0,1458,A
1-PB2,259,1,0,1491,0,1492,G
1-PB2,260,1492,0,1,0,1493,A
1-PB2,261,1,1495,0,0,1496,T
1-PB2,262,1458,0,2,0,1460,A
1-PB2,263,0,1,1497,0,1498,G
1-PB2,264,1482,0,5,0,1487,A
1-PB2,265,1,1,1500,0,1502,G
1-PB2,266,0,1482,0,0,1482,T
1-PB2,267,0,5,1474,0,1479,G
1-PB2,268,1464,0,0,0,1464,A
1-PB2,269,0,1478,0,1,1479,T
1-PB2,270,1,7,1494,0,1502,G
1-PB2,271,3,1,1529,0,1533,G
1-PB2,272,2,1507,0,1,1510,T
1-PB2,273,1509,0,1,0,1510,A
1-PB2,274,0,1485,0,1,1486,T
1-PB2,275,5,1,0,1484,1490,C
1-PB2,276,1516,0,1,0,1517,A
1-PB2,277,0,0,0,1547,1547,C
1-PB2,278,2,1,0,1536,1539,C
1-PB2,279,1,1507,0,0,1508,T
1-PB2,280,0,1499,0,1,1500,T
1-PB2,281,0,1499,0,1,1500,T
1-PB2,282,0,6,1508,0,1514,G
1-PB2,283,0,1,1523,0,1524,G
1-PB2,284,0,0,0,1542,1542,C
1-PB2,285,0,1516,0,1,1517,T
1-PB2,286,1,0,1526,0,1527,G
1-PB2,287,0,1522,0,1,1523,T
1-PB2,288,1519,0,1,0,1520,A
1-PB2,289,1523,2,2,0,1527,A
1-PB2,290,0,0,0,1523,1523,C
1-PB2,291,1506,1,2,0,1509,A
1-PB2,292,0,1507,0,2,1509,T
1-PB2,293,0,2,1494,0,1496,G
1-PB2,294,0,0,1537,0,1537,G
1-PB2,295,0,1520,0,2,1522,T
1-PB2,296,0,0,1517,1,1518,G
1-PB2,297,4,2,1542,0,1548,G
1-PB2,298,1545,1,1,0,1547,A
1-PB2,299,1547,0,1,0,1548,A
1-PB2,300,0,1549,1,0,1550,T
1-PB2,301,1547,0,0,0,1547,A
1-PB2,302,0,5,1579,0,1584,G
1-PB2,303,1573,0,0,0,1573,A
1-PB2,304,1571,0,0,0,1571,A
1-PB2,305,1573,0,1,0,1574,A
1-PB2,306,1,1544,0,0,1545,T
1-PB2,307,0,4,1542,0,1546,G
1-PB2,308,1,3,1535,0,1539,G
1-PB2,309,1539,1,1,1,1542,A
1-PB2,310,1,0,0,1546,1547,C
1-PB2,311,2,0,0,1532,1534,C
1-PB2,312,3,0,0,1523,1526,C
1-PB2,313,0,1,1538,1,1540,G
1-PB2,314,0,1551,0,2,1553,T
1-PB2,315,1,12,1570,0,1583,G
1-PB2,316,1583,0,1,0,1584,A
1-PB2,317,2,0,0,1583,1585,C
1-PB2,318,1584,0,0,0,1584,A
1-PB2,319,1579,0,2,0,1581,A
1-PB2,320,1,0,1620,0,1621,G
1-PB2,321,0,1613,0,0,1613,T
1-PB2,322,1607,1,1,0,1609,A
1-PB2,323,0,1,0,1596,1597,C
1-PB2,324,0,6,1556,0,1562,G
1-PB2,325,1,2,1596,0,1599,G
1-PB2,326,2,1592,0,1,1595,T
1-PB2,327,3,0,0,1606,1609,C
1-PB2,328,2,1,0,1601,1604,C
1-PB2,329,1571,0,0,0,1571,A
1-PB2,330,0,1577,0,0,1577,T
1-PB2,331,0,1573,0,1,1574,T
1-PB2,332,1633,2,0,0,1635,A
1-PB2,333,0,0,0,1632,1632,C
1-PB2,334,2,0,0,1584,1586,C
1-PB2,335,2,1,0,1583,1586,C
1-PB2,336,1578,0,1,0,1579,A
1-PB2,337,1592,1,0,0,1593,A
1-PB2,338,1593,0,0,0,1593,A
1-PB2,339,1596,0,0,0,1596,A
1-PB2,340,0,1,1609,0,1610,G
1-PB2,341,0,1558,0,0,1558,T
1-PB2,342,0,2,1595,0,1597,G
1-PB2,343,0,1593,0,2,1595,T
1-PB2,344,1596,0,1,0,1597,A
1-PB2,345,0,0,0,1597,1597,C
1-PB2,346,1578,0,0,0,1578,A
1-PB2,347,1577,0,1,0,1578,A
1-PB2,348,0,3,1594,1,1598,G
1-PB2,349,1573,0,3,0,1576,A
1-PB2,350,0,1,0,1582,1583,C
1-PB2,351,0,1552,0,2,1554,T
1-PB2,352,0,1574,0,0,1574,T
1-PB2,353,1576,0,1,0,1577,A
1-PB2,354,0,1573,0,0,1573,T
1-PB2,355,1,1573,0,1,1575,T
1-PB2,356,0,1569,0,0,1569,T
1-PB2,357,3,1,0,1553,1557,C
1-PB2,358,0,7,1548,0,1555,G
1-PB2,359,1552,0,0,0,1552,A
1-PB2,360,0,0,1,1554,1555,C
1-PB2,361,1545,0,0,0,1545,A
1-PB2,362,1548,0,1,0,1549,A
1-PB2,363,1547,0,3,0,1550,A
1-PB2,364,0,2,1575,0,1577,G
1-PB2,365,1,1578,0,0,1579,T
1-PB2,366,5,1,0,1571,1577,C
1-PB2,367,0,4,1573,0,1577,G
1-PB2,368,1577,0,0,0,1577,A
1-PB2,369,1573,0,0,0,1573,A
1-PB2,370,1576,0,1,0,1577,A
1-PB2,371,1,1,1629,0,1631,G
1-PB2,372,0,2,1636,0,1638,G
1-PB2,373,1,1613,0,0,1614,T
1-PB2,374,1,1613,0,0,1614,T
1-PB2,375,1615,0,0,0,1615,A
1-PB2,376,1614,0,1,1,1616,A
1-PB2,377,1619,0,0,1,1620,A
1-PB2,378,1640,0,0,0,1640,A
1-PB2,379,0,1,0,1651,1652,C
1-PB2,380,1615,1,0,0,1616,A
1-PB2,381,0,1610,0,0,1610,T
1-PB2,382,1,1,1603,0,1605,G
1-PB2,383,0,6,1601,0,1607,G
1-PB2,384,1610,0,0,0,1610,A
1-PB2,385,1609,0,2,0,1611,A
1-PB2,386,2,0,0,1640,1642,C
1-PB2,387,1,0,0,1647,1648,C
1-PB2,388,0,1632,0,2,1634,T
1-PB2,389,0,1631,0,0,1631,T
1-PB2,390,0,1630,0,0,1630,T
1-PB2,391,1,3,1616,0,1620,G
1-PB2,392,1,2,1636,0,1639,G
1-PB2,393,0,1,0,1634,1635,C
1-PB2,394,1,1,0,1621,1623,C
1-PB2,395,0,1,0,1620,1621,C
1-PB2,396,0,1570,0,2,1572,T
1-PB2,397,0,0,1590,0,1590,G
1-PB2,398,1,1591,0,1,1593,T
1-PB2,399,1,1588,0,1,1590,T
1-PB2,400,14,0,0,1579,1593,C
1-PB2,401,1574,0,0,0,1574,A
1-PB2,402,0,1573,0,1,1574,T
1-PB2,403,0,1575,0,0,1575,T
1-PB2,404,0,1571,1,0,1572,T
1-PB2,405,0,1575,0,0,1575,T
1-PB2,406,1553,1,0,0,1554,A
1-PB2,407,0,3,1547,0,1550,G
1-PB2,408,1551,1,0,0,1552,A
1-PB2,409,1553,0,1,0,1554,A
1-PB2,410,1551,0,1,0,1552,A
1-PB2,411,0,1543,0,0,1543,T
1-PB2,412,6,0,1,1540,1547,C
1-PB2,413,1544,0,1,0,1545,A
1-PB2,414,1553,0,0,0,1553,A
1-PB2,415,0,1,1558,0,1559,G
1-PB2,416,0,1549,0,1,1550,T
1-PB2,417,3,0,0,1553,1556,C
1-PB2,418,1551,2,2,0,1555,A
1-PB2,419,1560,0,2,0,1562,A
1-PB2,420,0,0,1563,0,1563,G
1-PB2,421,1566,0,2,0,1568,A
1-PB2,422,0,1569,0,0,1569,T
1-PB2,423,1593,0,2,0,1595,A
1-PB2,424,1,1,0,1589,1591,C
1-PB2,425,3,0,1588,0,1591,G
1-PB2,426,2,1,0,1598,1601,C
1-PB2,427,1577,0,3,0,1580,A
1-PB2,428,0,1,1588,0,1589,G
1-PB2,429,1583,0,1,0,1584,A
1-PB2,430,1595,0,0,0,1595,A
1-PB2,431,0,6,1629,0,1635,G
1-PB2,432,1597,1,2,0,1600,A
1-PB2,433,0,0,1607,0,1607,G
1-PB2,434,0,1601,0,0,1601,T
1-PB2,435,1594,0,1,0,1595,A
1-PB2,436,2,4,1607,0,1613,G
1-PB2,437,1608,0,2,0,1610,A
1-PB2,438,0,0,0,1667,1667,C
1-PB2,439,1637,1,0,0,1638,A
1-PB2,440,0,1610,0,0,1610,T
1-PB2,441,1599,0,0,0,1599,A
1-PB2,442,1602,0,0,0,1602,A
1-PB2,443,1629,0,0,0,1629,A
1-PB2,444,1,0,0,1633,1634,C
1-PB2,445,1,0,0,1609,1610,C
1-PB2,446,2,0,0,1595,1597,C
1-PB2,447,0,1504,0,2,1506,T
1-PB2,448,0,1,1520,1,1522,G
1-PB2,449,0,0,1550,0,1550,G
1-PB2,450,1,1545,0,3,1549,T
1-PB2,451,8,1,0,1538,1547,C
1-PB2,452,1564,0,0,1,1565,A
1-PB2,453,0,1553,0,1,1554,T
1-PB2,454,1,0,1565,0,1566,G
1-PB2,455,0,1,0,1565,1566,C
1-PB2,456,1561,0,1,0,1562,A
1-PB2,457,0,4,1568,1,1573,G
1-PB2,458,1556,0,0,0,1556,A
1-PB2,459,1,1,0,1573,1575,C
1-PB2,460,2,0,0,1576,1578,C
1-PB2,461,0,1543,1,0,1544,T
1-PB2,462,2,1,0,1549,1552,C
1-PB2,463,1535,0,0,0,1535,A
1-PB2,464,0,1,1573,0,1574,G
1-PB2,465,3,1573,0,2,1578,T
1-PB2,466,1,1,1566,0,1568,G
1-PB2,467,1,0,0,1562,1563,C
1-PB2,468,3,0,0,1542,1545,C
1-PB2,469,1547,0,0,1,1548,A
1-PB2,470,1545,0,0,0,1545,A
1-PB2,471,1540,0,0,0,1540,A
1-PB2,472,0,1,1548,0,1549,G
1-PB2,473,1514,0,1,0,1515,A
1-PB2,474,1,1,1518,0,1520,G
1-PB2,475,0,3,1512,0,1515,G
1-PB2,476,0,2,1,1512,1515,C
1-PB2,477,1513,0,1,0,1514,A
1-PB2,478,3,0,0,1510,1513,C
1-PB2,479,1510,0,0,0,1510,A
1-PB2,480,1561,0,1,0,1562,A
1-PB2,481,0,3,1557,0,1560,G
1-PB2,482,1594,0,0,0,1594,A
1-PB2,483,1,1582,0,0,1583,T
1-PB2,484,1,1,1577,0,1579,G
1-PB2,485,0,1585,0,0,1585,T
1-PB2,486,1581,0,2,0,1583,A
1-PB2,487,1577,0,2,0,1579,A
1-PB2,488,1,1581,0,0,1582,T
1-PB2,489,0,1526,0,1,1527,T
1-PB2,490,1518,0,1,0,1519,A
1-PB2,491,0,1478,0,0,1478,T
1-PB2,492,0,1,1474,0,1475,G
1-PB2,493,1,2,1476,0,1479,G
1-PB2,494,1465,0,1,0,1466,A
1-PB2,495,1456,0,1,0,1457,A
1-PB2,496,0,0,1462,0,1462,G
1-PB2,497,0,1453,0,0,1453,T
1-PB2,498,1,1450,0,0,1451,T
1-PB2,499,1,0,1460,0,1461,G
1-PB2,500,1,1453,0,0,1454,T
1-PB2,501,0,1452,0,1,1453,T
1-PB2,502,0,1457,1,0,1458,T
1-PB2,503,0,1452,0,0,1452,T
1-PB2,504,4,3,0,1429,1436,C
1-PB2,505,1,0,0,1451,1452,C
1-PB2,506,2,0,0,1468,1470,C
1-PB2,507,3,0,0,1461,1464,C
1-PB2,508,1460,1,0,3,1464,A
1-PB2,509,1475,1,0,0,1476,A
1-PB2,510,0,1473,0,3,1476,T
1-PB2,511,0,0,1485,0,1485,G
1-PB2,512,1484,0,1,0,1485,A
1-PB2,513,1460,1,1,0,1462,A
1-PB2,514,1,2,1466,1,1470,G
1-PB2,515,0,1456,0,0,1456,T
1-PB2,516,0,1,1455,0,1456,G
1-PB2,517,0,2,1441,0,1443,G
1-PB2,518,1,3,1441,1,1446,G
1-PB2,519,1454,0,4,0,1458,A
1-PB2,520,0,0,1451,0,1451,G
1-PB2,521,0,0,0,1458,1458,C
1-PB2,522,3,0,0,1460,1463,C
1-PB2,523,1448,0,1,0,1449,A
1-PB2,524,2,0,1479,0,1481,G
1-PB2,525,2,1,1484,0,1487,G
1-PB2,526,1495,0,1,0,1496,A
1-PB2,527,0,1488,0,1,1489,T
1-PB2,528,1487,0,1,0,1488,A
1-PB2,529,0,0,1,1491,1492,C
1-PB2,530,3,1475,0,0,1478,T
1-PB2,531,1470,0,1,0,1471,A
1-PB2,532,1472,0,0,0,1472,A
1-PB2,533,0,3,0,1480,1483,C
1-PB2,534,1449,0,0,0,1449,A
1-PB2,535,0,1428,0,1,1429,T
1-PB2,536,1,1,0,1432,1434,C
1-PB2,537,1416,1,0,0,1417,A
1-PB2,538,1,4,1432,0,1437,G
1-PB2,539,1428,0,0,0,1428,A
1-PB2,540,1429,1,0,0,1430,A
1-PB2,541,0,1433,0,0,1433,T
1-PB2,542,6,0,0,1411,1417,C
1-PB2,543,1417,0,1,0,1418,A
1-PB2,544,0,0,1,1439,1440,C
1-PB2,545,1438,0,0,0,1438,A
1-PB2,546,1445,1,1,0,1447,A
1-PB2,547,0,1429,0,1,1430,T
1-PB2,548,0,1435,0,0,1435,T
1-PB2,549,1436,0,0,0,1436,A
1-PB2,550,1442,0,0,0,1442,A
1-PB2,551,0,1,0,1441,1442,C
1-PB2,552,1432,0,0,0,1432,A
1-PB2,553,1421,0,0,0,1421,A
1-PB2,554,0,1443,0,2,1445,T
1-PB2,555,1439,0,0,0,1439,A
1-PB2,556,1447,0,0,0,1447,A
1-PB2,557,1,0,0,1446,1447,C
1-PB2,558,1,1434,0,0,1435,T
1-PB2,559,1428,1,0,0,1429,A
1-PB2,560,1425,0,0,0,1425,A
1-PB2,561,1427,0,0,0,1427,A
1-PB2,562,2,2,1427,0,1431,G
1-PB2,563,1396,1,2,0,1399,A
1-PB2,564,0,4,1412,0,1416,G
1-PB2,565,1412,0,0,0,1412,A
1-PB2,566,1412,0,2,0,1414,A
1-PB2,567,1410,0,1,0,1411,A
1-PB2,568,1410,0,1,0,1411,A
1-PB2,569,1416,0,0,0,1416,A
1-PB2,570,1413,0,1,0,1414,A
1-PB2,571,1,1,1416,0,1418,G
1-PB2,572,1420,0,0,1,1421,A
1-PB2,573,1410,1,0,0,1411,A
1-PB2,574,1,9,1408,0,1418,G
1-PB2,575,1417,0,2,0,1419,A
1-PB2,576,1422,0,1,0,1423,A
1-PB2,577,2,1,0,1430,1433,C
1-PB2,578,0,1417,0,1,1418,T
1-PB2,579,0,1,0,1423,1424,C
1-PB2,580,0,0,0,1423,1423,C
1-PB2,581,0,5,1422,0,1427,G
1-PB2,582,1423,0,0,0,1423,A
1-PB2,583,0,2,1418,0,1420,G
1-PB2,584,1412,0,1,0,1413,A
1-PB2,585,0,1417,1,0,1418,T
1-PB2,586,0,1399,0,1,1400,T
1-PB2,587,0,0,1405,0,1405,G
1-PB2,588,2,2,0,1399,1403,C
1-PB2,589,1405,1,0,0,1406,A
1-PB2,590,1409,0,0,0,1409,A
1-PB2,591,1405,0,0,1,1406,A
1-PB2,592,1418,0,0,0,1418,A
1-PB2,593,0,1413,0,1,1414,T
1-PB2,594,0,1410,0,0,1410,T
1-PB2,595,0,1410,0,0,1410,T
1-PB2,596,2,2,0,1398,1402,C
1-PB2,597,0,1388,0,1,1389,T
1-PB2,598,4,1,0,1502,1507,C
1-PB2,599,3,1,0,1500,1504,C
1-PB2,600,0,0,0,1617,1617,C
1-PB2,601,0,1592,0,1,1593,T
1-PB2,602,0,1628,0,0,1628,T
1-PB2,603,0,5,1629,0,1634,G
1-PB2,604,1635,1,1,0,1637,A
1-PB2,605,0,1676,0,0,1676,T
1-PB2,606,0,8,1704,0,1712,G
1-PB2,607,1,1,1917,0,1919,G
1-PB2,608,0,1956,0,2,1958,T
1-PB2,609,0,1951,0,3,1954,T
1-PB2,610,0,0,2100,0,2100,G
1-PB2,611,3,2,0,2105,2110,C
1-PB2,612,2149,1,0,1,2151,A
1-PB2,613,0,2152,0,0,2152,T
1-PB2,614,2185,0,2,2,2189,A
1-PB2,615,0,3,0,2307,2310,C
1-PB2,616,2575,2,0,4,2581,A
1-PB2,617,0,2650,0,0,2650,T
1-PB2,618,5,3,2777,0,2785,G
1-PB2,619,0,2779,0,0,2779,T
1-PB2,620,0,2775,1,1,2777,T
1-PB2,621,2765,0,2,0,2767,A
1-PB2,622,1,11,2764,0,2776,G
1-PB2,623,2804,0,4,0,2808,A
1-PB2,624,1,7,2833,0,2841,G
1-PB2,625,2738,0,1,0,2739,A
1-PB2,626,0,12,2745,0,2757,G
1-PB2,627,2728,0,3,0,2731,A
1-PB2,628,1,12,2732,0,2745,G
1-PB2,629,2745,2,2,0,2749,A
1-PB2,630,2753,0,0,0,2753,A
1-PB2,631,3,0,0,2770,2773,C
1-PB2,632,0,2754,0,3,2757,T
1-PB2,633,0,2754,0,0,2754,T
1-PB2,634,1,1,2753,0,2755,G
1-PB2,635,1,2746,0,1,2748,T
1-PB2,636,2756,0,2,0,2758,A
1-PB2,637,0,1,1,2741,2743,C
1-PB2,638,3,10,2731,0,2744,G
1-PB2,639,2748,0,1,0,2749,A
1-PB2,640,2737,0,2,0,2739,A
1-PB2,641,2781,0,1,0,2782,A
1-PB2,642,2782,0,0,0,2782,A
1-PB2,643,2781,0,0,1,2782,A
1-PB2,644,1,2,0,2790,2793,C
1-PB2,645,2791,0,1,0,2792,A
1-PB2,646,2798,0,3,0,2801,A
1-PB2,647,1,3,2818,0,2822,G
1-PB2,648,2824,0,0,0,2824,A
1-PB2,649,0,2826,0,0,2826,T
1-PB2,650,0,2821,0,2,2823,T
1-PB2,651,0,2829,0,0,2829,T
1-PB2,652,5,1,0,2835,2841,C
1-PB2,653,0,2839,1,7,2847,T
1-PB2,654,6,1,0,2846,2853,C
1-PB2,655,3,2,0,2846,2851,C
1-PB2,656,3,1,0,2853,2857,C
1-PB2,657,2860,0,1,0,2861,A
1-PB2,658,0,3,2887,0,2890,G
1-PB2,659,1,2887,0,3,2891,T
1-PB2,660,1,2882,0,0,2883,T
1-PB2,661,0,2,2882,0,2884,G
1-PB2,662,1,1,0,2882,2884,C
1-PB2,663,0,2878,0,1,2879,T
1-PB2,664,1,5,2885,0,2891,G
1-PB2,665,0,6,2877,0,2883,G
1-PB2,666,2,4,4,2878,2888,C
1-PB2,667,1,1,2894,0,2896,G
1-PB2,668,1,4,2916,1,2922,G
1-PB2,669,2937,0,3,0,2940,A
1-PB2,670,2941,2,0,0,2943,A
1-PB2,671,1,2,0,2940,2943,C
1-PB2,672,2958,0,1,0,2959,A
1-PB2,673,2960,0,3,0,2963,A
1-PB2,674,2,2,3089,0,3093,G
1-PB2,675,1,3,0,3154,3158,C
1-PB2,676,3189,0,1,1,3191,A
1-PB2,677,0,2,3951,0,3953,G
1-PB2,678,0,3943,0,0,3943,T
1-PB2,679,3953,1,2,0,3956,A
1-PB2,680,0,3961,0,1,3962,T
1-PB2,681,3981,1,1,0,3983,A
1-PB2,682,0,3981,0,1,3982,T
1-PB2,683,3916,1,0,0,3917,A
1-PB2,684,0,4,0,3958,3962,C
1-PB2,685,3816,0,3,0,3819,A
1-PB2,686,0,3628,0,1,3629,T
1-PB2,687,0,3510,0,4,3514,T
1-PB2,688,0,13,3497,0,3510,G
1-PB2,689,3507,0,1,0,3508,A
1-PB2,690,3489,0,2,0,3491,A
1-PB2,691,0,1,3542,0,3543,G
1-PB2,692,0,3523,0,0,3523,T
1-PB2,693,1,3485,0,2,3488,T
1-PB2,694,0,3496,0,3,3499,T
1-PB2,695,2,3499,0,1,3502,T
1-PB2,696,3550,0,2,0,3552,A
1-PB2,697,0,0,0,3566,3566,C
1-PB2,698,3564,0,0,0,3564,A
1-PB2,699,0,3560,0,1,3561,T
1-PB2,700,0,3531,0,0,3531,T
1-PB2,701,1,3531,0,0,3532,T
1-PB2,702,0,24,3555,0,3579,G
1-PB2,703,3601,0,1,0,3602,A
1-PB2,704,1,0,0,3622,3623,C
1-PB2,705,1,3599,0,3,3603,T
1-PB2,706,6,0,0,3591,3597,C
1-PB2,707,3587,1,5,0,3593,A
1-PB2,708,2,7,3564,0,3573,G
1-PB2,709,1,7,3644,2,3654,G
1-PB2,710,1,13,3660,0,3674,G
1-PB2,711,3677,0,2,0,3679,A
1-PB2,712,3676,0,4,0,3680,A
1-PB2,713,2,1,0,3687,3690,C
1-PB2,714,1,0,3736,0,3737,G
1-PB2,715,1,3719,0,2,3722,T
1-PB2,716,0,0,3748,1,3749,G
1-PB2,717,0,3714,0,2,3716,T
1-PB2,718,0,3712,0,0,3712,T
1-PB2,719,3,7,3722,0,3732,G
1-PB2,720,1,4,3712,0,3717,G
1-PB2,721,1,13,3762,0,3776,G
1-PB2,722,3747,1,3,0,3751,A
1-PB2,723,3722,0,2,0,3724,A
1-PB2,724,2,1,0,3805,3808,C
1-PB2,725,3790,1,0,4,3795,A
1-PB2,726,3908,1,0,0,3909,A
1-PB2,727,3919,0,2,1,3922,A
1-PB2,728,0,3953,0,1,3954,T
1-PB2,729,1,1,4014,0,4016,G
1-PB2,730,0,3996,0,2,3998,T
1-PB2,731,3996,0,3,0,3999,A
1-PB2,732,1,1,0,4012,4014,C
1-PB2,733,3941,1,0,0,3942,A
1-PB2,734,1,0,0,3934,3935,C
1-PB2,735,1,3821,0,10,3832,T
1-PB2,736,6,0,0,4149,4155,C
1-PB2,737,2,1,1,4164,4168,C
1-PB2,738,4217,1,2,0,4220,A
1-PB2,739,1,5,4236,1,4243,G
1-PB2,740,4,2,4332,0,4338,G
1-PB2,741,1,4329,0,2,4332,T
1-PB2,742,0,10,4323,0,4333,G
1-PB2,743,0,5,4224,1,4230,G
1-PB2,744,4161,0,14,1,4176,A
1-PB2,745,0,5,4196,1,4202,G
1-PB2,746,0,9,4195,0,4204,G
1-PB2,747,4157,0,1,0,4158,A
1-PB2,748,1,0,4191,0,4192,G
1-PB2,749,0,4101,0,3,4104,T
1-PB2,750,1,10,4121,0,4132,G
1-PB2,751,4115,1,3,1,4120,A
1-PB2,752,1,6,4126,1,4134,G
1-PB2,753,12,15,4126,0,4153,G
1-PB2,754,4123,1,1,0,4125,A
1-PB2,755,4131,1,2,0,4134,A
1-PB2,756,0,4138,0,1,4139,T
1-PB2,757,2,15,4115,0,4132,G
1-PB2,758,4124,1,2,0,4127,A
1-PB2,759,2,13,1,4103,4119,C
1-PB2,760,0,14,4107,1,4122,G
1-PB2,761,4157,0,0,1,4158,A
1-PB2,762,2,4137,0,1,4140,T
1-PB2,763,1,1,4158,1,4161,G
1-PB2,764,0,4156,0,2,4158,T
1-PB2,765,0,4144,0,2,4146,T
1-PB2,766,2,18,4150,0,4170,G
1-PB2,767,4169,1,7,0,4177,A
1-PB2,768,0,3,0,4175,4178,C
1-PB2,769,16,0,2,4158,4176,C
1-PB2,770,4131,1,0,1,4133,A
1-PB2,771,4141,0,2,0,4143,A
1-PB2,772,4159,0,2,0,4161,A
1-PB2,773,10,1,4238,0,4249,G
1-PB2,774,1,1,0,4254,4256,C
1-PB2,775,4,0,0,4237,4241,C
1-PB2,776,0,4262,2,2,4266,T
1-PB2,777,4274,0,2,0,4276,A
1-PB2,778,4274,0,1,2,4277,A
1-PB2,779,1,4283,0,0,4284,T
1-PB2,780,0,4274,0,1,4275,T
1-PB2,781,4247,0,1,0,4248,A
1-PB2,782,0,4169,0,2,4171,T
1-PB2,783,1,4150,0,1,4152,T
1-PB2,784,0,2,4133,0,4135,G
1-PB2,785,0,3,0,4119,4122,C
1-PB2,786,5,15,4104,0,4124,G
1-PB2,787,4,1,4197,0,4202,G
1-PB2,788,3,1,0,4184,4188,C
1-PB2,789,9,0,0,4202,4211,C
1-PB2,790,4208,1,2,0,4211,A
1-PB2,791,1,4,4264,0,4269,G
1-PB2,792,0,11,4304,0,4315,G
1-PB2,793,4319,1,4,1,4325,A
1-PB2,794,4341,0,4,0,4345,A
1-PB2,795,0,4,0,4362,4366,C
1-PB2,796,4328,2,2,0,4332,A
1-PB2,797,2,4386,0,5,4393,T
1-PB2,798,4442,1,4,0,4447,A
1-PB2,799,3,2,4478,0,4483,G
1-PB2,800,0,4432,0,0,4432,T
1-PB2,801,4422,1,1,1,4425,A
1-PB2,802,4405,3,1,1,4410,A
1-PB2,803,0,5,4423,0,4428,G
1-PB2,804,4391,2,1,0,4394,A
1-PB2,805,4311,2,1,1,4315,A
1-PB2,806,3,11,4296,0,4310,G
1-PB2,807,4192,1,7,0,4200,A
1-PB2,808,1,1,4196,0,4198,G
1-PB2,809,1,0,0,4193,4194,C
1-PB2,810,3,5,0,4190,4198,C
1-PB2,811,3,4,4196,0,4203,G
1-PB2,812,1,2,0,4219,4222,C
1-PB2,813,4230,0,2,0,4232,A
1-PB2,814,2,1,4537,0,4540,G
1-PB2,815,1,4529,0,0,4530,T
1-PB2,816,4542,0,3,0,4545,A
1-PB2,817,0,4519,0,2,4521,T
1-PB2,818,9,2,0,4544,4555,C
1-PB2,819,4550,0,2,2,4554,A
1-PB2,820,3,2,4570,0,4575,G
1-PB2,821,1,3,0,4563,4567,C
1-PB2,822,4430,1,0,0,4431,A
1-PB2,823,1,6,4367,0,4374,G
1-PB2,824,4375,2,1,0,4378,A
1-PB2,825,0,4358,0,3,4361,T
1-PB2,826,8,0,0,4385,4393,C
1-PB2,827,11,2,0,4385,4398,C
1-PB2,828,4397,0,4,0,4401,A
1-PB2,829,0,0,0,4406,4406,C
1-PB2,830,1,4395,0,3,4399,T
1-PB2,831,4412,0,1,0,4413,A
1-PB2,832,2,0,4389,0,4391,G
1-PB2,833,2,1,0,4366,4369,C
1-PB2,834,4363,0,2,0,4365,A
1-PB2,835,1,4367,1,1,4370,T
1-PB2,836,9,3,0,4410,4422,C
1-PB2,837,0,4394,0,3,4397,T
1-PB2,838,0,4496,0,3,4499,T
1-PB2,839,0,4515,0,1,4516,T
1-PB2,840,4512,0,5,0,4517,A
1-PB2,841,1,4526,0,0,4527,T
1-PB2,842,0,4503,0,3,4506,T
1-PB2,843,6,7,4490,0,4503,G
1-PB2,844,1,10,4490,0,4501,G
1-PB2,845,4412,0,2,1,4415,A
1-PB2,846,0,6,4420,0,4426,G
1-PB2,847,4388,1,4,0,4393,A
1-PB2,848,3,4354,0,1,4358,T
1-PB2,849,0,1,4447,0,4448,G
1-PB2,850,0,4440,0,3,4443,T
1-PB2,851,4,0,4443,1,4448,G
1-PB2,852,3,1,0,4449,4453,C
1-PB2,853,6,1,0,4437,4444,C
1-PB2,854,4435,0,4,0,4439,A
1-PB2,855,2,0,0,4443,4445,C
1-PB2,856,4391,0,4,0,4395,A
1-PB2,857,0,3,4468,0,4471,G
1-PB2,858,2,1,0,4381,4384,C
1-PB2,859,4366,2,5,0,4373,A
1-PB2,860,1,0,0,4382,4383,C
1-PB2,861,4357,2,2,1,4362,A
1-PB2,862,1,1,0,4393,4395,C
1-PB2,863,4389,0,0,0,4389,A
1-PB2,864,4394,0,1,0,4395,A
1-PB2,865,4386,0,6,1,4393,A
1-PB2,866,1,4288,0,2,4291,T
1-PB2,867,0,4288,0,1,4289,T
1-PB2,868,1,6,4256,1,4264,G
1-PB2,869,1,4,4249,0,4254,G
1-PB2,870,1,3,0,4255,4259,C
1-PB2,871,4,11,4211,0,4226,G
1-PB2,872,0,14,4288,0,4302,G
1-PB2,873,1,16,4308,0,4325,G
1-PB2,874,4326,2,1,0,4329,A
1-PB2,875,1,0,0,4332,4333,C
1-PB2,876,4326,1,1,0,4328,A
1-PB2,877,4341,1,4,0,4346,A
1-PB2,878,0,8,4368,0,4376,G
1-PB2,879,1,9,4370,0,4380,G
1-PB2,880,4391,0,2,0,4393,A
1-PB2,881,0,4224,0,1,4225,T
1-PB2,882,2,12,4157,0,4171,G
1-PB2,883,0,1,4191,0,4192,G
1-PB2,884,0,4164,0,4,4168,T
1-PB2,885,1,14,4153,0,4168,G
1-PB2,886,14,9,4130,0,4153,G
1-PB2,887,4087,0,3,0,4090,A
1-PB2,888,2,1,0,4090,4093,C
1-PB2,889,4036,0,0,0,4036,A
1-PB2,890,2,4540,0,0,4542,T
1-PB2,891,0,4513,0,2,4515,T
1-PB2,892,8,0,0,4508,4516,C
1-PB2,893,0,4459,0,6,4465,T
1-PB2,894,0,4460,0,1,4461,T
1-PB2,895,4465,0,1,1,4467,A
1-PB2,896,0,8,4488,0,4496,G
1-PB2,897,4474,2,2,2,4480,A
1-PB2,898,0,2,0,4478,4480,C
1-PB2,899,3696,0,1,1,3698,A
1-PB2,900,1,10,3748,1,3760,G
1-PB2,901,3739,0,2,1,3742,A
1-PB2,902,3754,0,2,0,3756,A
1-PB2,903,3,0,0,3753,3756,C
1-PB2,904,5,2,0,3740,3747,C
1-PB2,905,8,2,0,3736,3746,C
1-PB2,906,0,26,3721,0,3747,G
1-PB2,907,3750,0,2,1,3753,A
1-PB2,908,4,2,0,3760,3766,C
1-PB2,909,2,3718,0,1,3721,T
1-PB2,910,0,6,3739,0,3745,G
1-PB2,911,3732,1,3,0,3736,A
1-PB2,912,3760,1,0,1,3762,A
1-PB2,913,0,14,3771,0,3785,G
1-PB2,914,3775,0,0,0,3775,A
1-PB2,915,3775,0,1,2,3778,A
1-PB2,916,1,0,0,3773,3774,C
1-PB2,917,3739,3,0,0,3742,A
1-PB2,918,3761,2,2,0,3765,A
1-PB2,919,1,3,3784,0,3788,G
1-PB2,920,1,2,0,3810,3813,C
1-PB2,921,0,3783,0,0,3783,T
1-PB2,922,1,1,3839,0,3841,G
1-PB2,923,0,3827,0,0,3827,T
1-PB2,924,3,6,3895,0,3904,G
1-PB2,925,1,9,4014,0,4024,G
1-PB2,926,4038,0,2,0,4040,A
1-PB2,927,0,4025,8,0,4033,T
1-PB2,928,4013,0,0,0,4013,A
1-PB2,929,2,3965,0,2,3969,T
1-PB2,930,4080,2,3,0,4085,A
1-PB2,931,0,4026,0,0,4026,T
1-PB2,932,1,1,4015,1,4018,G
1-PB2,933,1,1,0,3975,3977,C
1-PB2,934,3814,2,4,0,3820,A
1-PB2,935,3826,0,1,0,3827,A
1-PB2,936,1,6,3807,0,3814,G
1-PB2,937,0,2,3816,1,3819,G
1-PB2,938,1,0,0,3826,3827,C
1-PB2,939,0,3749,0,2,3751,T
1-PB2,940,1,3,3768,0,3772,G
1-PB2,941,2,1,0,3780,3783,C
1-PB2,942,3779,1,2,2,3784,A
1-PB2,943,3797,0,1,0,3798,A
1-PB2,944,1,3773,1,1,3776,T
1-PB2,945,3,6,3788,0,3797,G
1-PB2,946,2,3,3757,1,3763,G
1-PB2,947,0,6,3776,0,3782,G
1-PB2,948,3775,1,7,0,3783,A
1-PB2,949,0,3782,0,0,3782,T
1-PB2,950,1,3758,0,1,3760,T
1-PB2,951,1,19,3757,0,3777,G
1-PB2,952,3768,1,3,0,3772,A
1-PB2,953,1,6,3793,0,3800,G
1-PB2,954,3768,1,5,1,3775,A
1-PB2,955,3742,1,1,0,3744,A
1-PB2,956,1,3714,1,2,3718,T
1-PB2,957,16,1,0,3721,3738,C
1-PB2,958,3730,1,3,1,3735,A
1-PB2,959,1,0,3768,0,3769,G
1-PB2,960,1,0,0,3765,3766,C
1-PB2,961,1,3746,0,4,3751,T
1-PB2,962,18,0,2,3720,3740,C
1-PB2,963,3734,0,1,1,3736,A
1-PB2,964,0,3813,0,4,3817,T
1-PB2,965,8,2,1,3814,3825,C
1-PB2,966,4,1,0,3871,3876,C
1-PB2,967,0,3845,0,5,3850,T
1-PB2,968,1,3819,0,4,3824,T
1-PB2,969,5,3,1,3817,3826,C
1-PB2,970,3830,0,3,0,3833,A
1-PB2,971,0,1,3878,0,3879,G
1-PB2,972,1,0,0,3868,3869,C
1-PB2,973,1,3796,0,4,3801,T
1-PB2,974,2,3801,0,0,3803,T
1-PB2,975,1,3778,0,0,3779,T
1-PB2,976,0,5,3777,0,3782,G
1-PB2,977,2,2,3782,0,3786,G
1-PB2,978,0,3777,0,3,3780,T
1-PB2,979,1,9,3794,0,3804,G
1-PB2,980,2,11,3795,0,3808,G
1-PB2,981,1,2,3846,0,3849,G
1-PB2,982,2,3826,0,3,3831,T
1-PB2,983,1,3822,0,0,3823,T
1-PB2,984,0,3820,0,1,3821,T
1-PB2,985,3828,3,2,0,3833,A
1-PB2,986,5,0,0,3849,3854,C
1-PB2,987,3852,2,0,0,3854,A
1-PB2,988,1,3821,2,0,3824,T
1-PB2,989,0,3770,1,0,3771,T
1-PB2,990,0,3764,0,1,3765,T
1-PB2,991,3757,2,1,0,3760,A
1-PB2,992,3760,1,2,0,3763,A
1-PB2,993,3767,0,2,0,3769,A
1-PB2,994,3741,0,1,0,3742,A
1-PB2,995,6,16,3753,0,3775,G
1-PB2,996,3736,2,6,1,3745,A
1-PB2,997,3756,0,1,0,3757,A
1-PB2,998,0,2,0,3766,3768,C
1-PB2,999,3757,0,1,0,3758,A
1-PB2,1000,3752,0,5,4,3761,A
1-PB2,1001,2,2,3760,0,3764,G
1-PB2,1002,0,2,0,3761,3763,C
1-PB2,1003,1,5,3751,1,3758,G
1-PB2,1004,0,4,3772,0,3776,G
1-PB2,1005,4,0,3771,0,3775,G
1-PB2,1006,0,3765,1,6,3772,T
1-PB2,1007,14,1,0,3738,3753,C
1-PB2,1008,3754,0,6,0,3760,A
1-PB2,1009,2,3737,1,2,3742,T
1-PB2,1010,7,1,0,3738,3746,C
1-PB2,1011,3734,2,2,0,3738,A
1-PB2,1012,4,2,3782,0,3788,G
1-PB2,1013,1,3748,0,2,3751,T
1-PB2,1014,19,0,1,3726,3746,C
1-PB2,1015,3743,3,1,1,3748,A
1-PB2,1016,3757,0,2,1,3760,A
1-PB2,1017,3756,0,0,0,3756,A
1-PB2,1018,3755,0,1,0,3756,A
1-PB2,1019,3768,1,0,1,3770,A
1-PB2,1020,3758,0,7,1,3766,A
1-PB2,1021,1,3,3777,1,3782,G
1-PB2,1022,3762,0,3,0,3765,A
1-PB2,1023,3759,0,4,0,3763,A
1-PB2,1024,2,6,3755,0,3763,G
1-PB2,1025,3742,0,0,0,3742,A
1-PB2,1026,3635,0,1,0,3636,A
1-PB2,1027,0,3,3635,1,3639,G
1-PB2,1028,3623,0,2,1,3626,A
1-PB2,1029,1,4,3635,0,3640,G
1-PB2,1030,2,3,3688,0,3693,G
1-PB2,1031,0,3699,1,0,3700,T
1-PB2,1032,0,0,3760,0,3760,G
1-PB2,1033,1,0,0,3775,3776,C
1-PB2,1034,2,3769,1,4,3776,T
1-PB2,1035,1,3782,0,1,3784,T
1-PB2,1036,3782,0,0,0,3782,A
1-PB2,1037,0,0,0,3781,3781,C
1-PB2,1038,3744,1,5,0,3750,A
1-PB2,1039,0,7,3761,1,3769,G
1-PB2,1040,2,0,3752,0,3754,G
1-PB2,1041,0,0,0,3712,3712,C
1-PB2,1042,3642,0,2,0,3644,A
1-PB2,1043,3677,0,0,1,3678,A
1-PB2,1044,1,3736,1,2,3740,T
1-PB2,1045,7,1,0,3767,3775,C
1-PB2,1046,1,3762,0,5,3768,T
1-PB2,1047,12,0,0,3750,3762,C
1-PB2,1048,14,0,0,3746,3760,C
1-PB2,1049,3760,1,2,0,3763,A
1-PB2,1050,3748,0,6,1,3755,A
1-PB2,1051,3764,0,1,0,3765,A
1-PB2,1052,4,0,0,3774,3778,C
1-PB2,1053,3677,0,0,1,3678,A
1-PB2,1054,0,3650,1,2,3653,T
1-PB2,1055,0,3641,0,2,3643,T
1-PB2,1056,1,6,3676,0,3683,G
1-PB2,1057,3680,0,2,0,3682,A
1-PB2,1058,3712,1,0,0,3713,A
1-PB2,1059,3722,0,0,0,3722,A
1-PB2,1060,3716,1,1,0,3718,A
1-PB2,1061,2,3715,0,0,3717,T
1-PB2,1062,3718,0,2,0,3720,A
1-PB2,1063,3716,1,2,1,3720,A
1-PB2,1064,0,6,3794,0,3800,G
1-PB2,1065,3739,2,7,0,3748,A
1-PB2,1066,1,1,3850,0,3852,G
1-PB2,1067,0,3801,0,1,3802,T
1-PB2,1068,3824,1,2,0,3827,A
1-PB2,1069,2,2,0,3905,3909,C
1-PB2,1070,3864,0,2,0,3866,A
1-PB2,1071,0,3877,0,4,3881,T
1-PB2,1072,1,9,3873,1,3884,G
1-PB2,1073,3798,0,13,0,3811,A
1-PB2,1074,1,8,3826,0,3835,G
1-PB2,1075,1,8,3813,0,3822,G
1-PB2,1076,0,12,3976,0,3988,G
1-PB2,1077,0,2,4014,0,4016,G
1-PB2,1078,2,3920,1,1,3924,T
1-PB2,1079,3934,0,0,0,3934,A
1-PB2,1080,1,3918,0,1,3920,T
1-PB2,1081,1,6,3925,0,3932,G
1-PB2,1082,3911,1,5,1,3918,A
1-PB2,1083,2,3,3882,1,3888,G
1-PB2,1084,0,12,3854,0,3866,G
1-PB2,1085,3576,0,2,0,3578,A
1-PB2,1086,4,0,3681,0,3685,G
1-PB2,1087,0,3656,2,4,3662,T
1-PB2,1088,1,3785,0,5,3791,T
1-PB2,1089,27,0,0,3776,3803,C
1-PB2,1090,3788,0,2,0,3790,A
1-PB2,1091,0,3,0,3793,3796,C
1-PB2,1092,3778,0,3,0,3781,A
1-PB2,1093,3793,0,1,1,3795,A
1-PB2,1094,1,3779,0,1,3781,T
1-PB2,1095,2,11,3691,0,3704,G
1-PB2,1096,0,1,3732,0,3733,G
1-PB2,1097,1,3621,9,3,3634,T
1-PB2,1098,1,7,3649,0,3657,G
1-PB2,1099,0,9,3662,0,3671,G
1-PB2,1100,0,4,3658,1,3663,G
1-PB2,1101,2,10,3681,0,3693,G
1-PB2,1102,3673,1,0,0,3674,A
1-PB2,1103,3669,0,3,1,3673,A
1-PB2,1104,3660,1,2,0,3663,A
1-PB2,1105,3572,1,6,0,3579,A
1-PB2,1106,0,10,3623,0,3633,G
1-PB2,1107,3602,1,3,0,3606,A
1-PB2,1108,0,3,3610,1,3614,G
1-PB2,1109,1,1,0,3607,3609,C
1-PB2,1110,3595,0,0,0,3595,A
1-PB2,1111,3587,2,3,0,3592,A
1-PB2,1112,0,1,1,3714,3716,C
1-PB2,1113,3706,0,3,0,3709,A
1-PB2,1114,0,1,3778,0,3779,G
1-PB2,1115,2,1,0,3742,3745,C
1-PB2,1116,0,3732,0,2,3734,T
1-PB2,1117,3848,1,2,0,3851,A
1-PB2,1118,0,3842,0,1,3843,T
1-PB2,1119,3866,0,2,0,3868,A
1-PB2,1120,2,1,0,3870,3873,C
1-PB2,1121,0,3676,0,2,3678,T
1-PB2,1122,3696,0,0,1,3697,A
1-PB2,1123,3622,1,0,0,3623,A
1-PB2,1124,7,7,3624,0,3638,G
1-PB2,1125,3631,1,1,0,3633,A
1-PB2,1126,3529,0,1,0,3530,A
1-PB2,1127,3526,0,0,0,3526,A
1-PB2,1128,3499,0,14,0,3513,A
1-PB2,1129,0,3,3522,0,3525,G
1-PB2,1130,2,2,0,3502,3506,C
1-PB2,1131,3502,1,2,0,3505,A
1-PB2,1132,3503,0,8,0,3511,A
1-PB2,1133,2,2,0,3518,3522,C
1-PB2,1134,6,1,0,3516,3523,C
1-PB2,1135,3527,0,1,0,3528,A
1-PB2,1136,0,6,3532,0,3538,G
1-PB2,1137,3528,1,2,0,3531,A
1-PB2,1138,3536,1,1,1,3539,A
1-PB2,1139,1,5,3562,1,3569,G
1-PB2,1140,3558,0,0,0,3558,A
1-PB2,1141,0,3550,0,2,3552,T
1-PB2,1142,2,3520,0,0,3522,T
1-PB2,1143,0,13,3523,0,3536,G
1-PB2,1144,1,0,3588,0,3589,G
1-PB2,1145,0,3573,0,6,3579,T
1-PB2,1146,1,3573,0,2,3576,T
1-PB2,1147,16,0,0,3568,3584,C
1-PB2,1148,3630,0,3,0,3633,A
1-PB2,1149,1,2,3795,0,3798,G
1-PB2,1150,2,0,1,3817,3820,C
1-PB2,1151,2,3793,0,8,3803,T
1-PB2,1152,7,0,0,3820,3827,C
1-PB2,1153,3786,0,1,0,3787,A
1-PB2,1154,1,3799,1,3,3804,T
1-PB2,1155,3811,0,1,0,3812,A
1-PB2,1156,1,3,3828,0,3832,G
1-PB2,1157,1,3660,0,2,3663,T
1-PB2,1158,1,14,3665,0,3680,G
1-PB2,1159,3566,1,4,0,3571,A
1-PB2,1160,3,1,3623,0,3627,G
1-PB2,1161,0,3593,0,2,3595,T
1-PB2,1162,8,3,3580,1,3592,G
1-PB2,1163,1,3,3622,0,3626,G
1-PB2,1164,3621,0,1,1,3623,A
1-PB2,1165,3591,0,3,0,3594,A
1-PB2,1166,0,9,3603,0,3612,G
1-PB2,1167,3559,3,2,0,3564,A
1-PB2,1168,1,1,3591,0,3593,G
1-PB2,1169,3556,0,3,0,3559,A
1-PB2,1170,1,0,0,3556,3557,C
1-PB2,1171,0,18,3542,0,3560,G
1-PB2,1172,3520,0,9,0,3529,A
1-PB2,1173,3536,0,3,0,3539,A
1-PB2,1174,1,1,0,3541,3543,C
1-PB2,1175,3521,0,4,0,3525,A
1-PB2,1176,0,3,3712,0,3715,G
1-PB2,1177,1,3690,0,4,3695,T
1-PB2,1178,12,1,0,3675,3688,C
1-PB2,1179,3699,1,2,0,3702,A
1-PB2,1180,3697,0,1,0,3698,A
1-PB2,1181,0,3694,0,1,3695,T
1-PB2,1182,3678,0,4,0,3682,A
1-PB2,1183,1,1,3675,0,3677,G
1-PB2,1184,0,4,0,3661,3665,C
1-PB2,1185,6,3,0,3534,3543,C
1-PB2,1186,0,4,3523,0,3527,G
1-PB2,1187,3525,0,1,2,3528,A
1-PB2,1188,3537,0,1,0,3538,A
1-PB2,1189,0,1,3577,0,3578,G
1-PB2,1190,2,1,0,3631,3634,C
1-PB2,1191,3634,0,1,0,3635,A
1-PB2,1192,3642,0,0,0,3642,A
1-PB2,1193,0,3638,0,1,3639,T
1-PB2,1194,3657,0,0,0,3657,A
1-PB2,1195,3699,3,0,0,3702,A
1-PB2,1196,1,3696,0,0,3697,T
1-PB2,1197,10,4,0,3670,3684,C
1-PB2,1198,7,0,3655,0,3662,G
1-PB2,1199,0,3577,3,0,3580,T
1-PB2,1200,0,3,3564,0,3567,G
1-PB2,1201,0,0,3608,1,3609,G
1-PB2,1202,2,1,0,3600,3603,C
1-PB2,1203,7,0,0,3585,3592,C
1-PB2,1204,3564,2,2,0,3568,A
1-PB2,1205,0,3567,0,3,3570,T
1-PB2,1206,1,2,3566,1,3570,G
1-PB2,1207,1,1,3621,1,3624,G
1-PB2,1208,1,3606,0,0,3607,T
1-PB2,1209,1,2,3638,0,3641,G
1-PB2,1210,0,3588,1,2,3591,T
1-PB2,1211,1,3609,0,4,3614,T
1-PB2,1212,0,3620,1,0,3621,T
1-PB2,1213,1,3633,0,2,3636,T
1-PB2,1214,11,0,0,3669,3680,C
1-PB2,1215,3661,1,5,0,3667,A
1-PB2,1216,1,0,1,3767,3769,C
1-PB2,1217,3694,0,1,0,3695,A
1-PB2,1218,3719,0,1,0,3720,A
1-PB2,1219,10,4,3715,0,3729,G
1-PB2,1220,3686,0,1,0,3687,A
1-PB2,1221,120,9,3595,0,3724,G
1-PB2,1222,0,10,3732,0,3742,G
1-PB2,1223,3713,0,1,0,3714,A
1-PB2,1224,0,3728,2,0,3730,T
1-PB2,1225,0,3687,0,1,3688,T
1-PB2,1226,1,5,3677,1,3684,G
1-PB2,1227,2,1,0,3606,3609,C
1-PB2,1228,3632,1,5,0,3638,A
1-PB2,1229,0,3677,0,1,3678,T
1-PB2,1230,0,9,3762,0,3771,G
1-PB2,1231,3783,0,4,1,3788,A
1-PB2,1232,0,3808,0,1,3809,T
1-PB2,1233,3783,0,0,2,3785,A
1-PB2,1234,3779,1,1,1,3782,A
1-PB2,1235,3779,0,0,0,3779,A
1-PB2,1236,3786,0,2,1,3789,A
1-PB2,1237,2,2,3798,0,3802,G
1-PB2,1238,4,0,0,3869,3873,C
1-PB2,1239,3929,5,6,1,3941,A
1-PB2,1240,1,3,4053,0,4057,G
1-PB2,1241,2,4041,0,0,4043,T
1-PB2,1242,0,4038,0,1,4039,T
1-PB2,1243,4039,0,1,0,4040,A
1-PB2,1244,0,9,4054,0,4063,G
1-PB2,1245,4034,1,1,1,4037,A
1-PB2,1246,0,6,4040,0,4046,G
1-PB2,1247,4,0,4022,0,4026,G
1-PB2,1248,0,3850,0,1,3851,T
1-PB2,1249,1,24,3830,2,3857,G
1-PB2,1250,3865,2,3,1,3871,A
1-PB2,1251,3,1,1,3876,3881,C
1-PB2,1252,4,2,0,3887,3893,C
1-PB2,1253,0,3819,0,3,3822,T
1-PB2,1254,1,15,3833,0,3849,G
1-PB2,1255,3848,0,1,0,3849,A
1-PB2,1256,3850,1,1,0,3852,A
1-PB2,1257,1,3831,1,2,3835,T
1-PB2,1258,0,3884,1,1,3886,T
1-PB2,1259,1,3895,0,1,3897,T
1-PB2,1260,9,3,2,3884,3898,C
1-PB2,1261,3,1,3902,0,3906,G
1-PB2,1262,0,3893,0,1,3894,T
1-PB2,1263,12,2,1,3881,3896,C
1-PB2,1264,3886,2,0,0,3888,A
1-PB2,1265,3894,2,0,0,3896,A
1-PB2,1266,1,2,0,3896,3899,C
1-PB2,1267,3846,0,1,0,3847,A
1-PB2,1268,8,12,3869,1,3890,G
1-PB2,1269,3868,0,5,0,3873,A
1-PB2,1270,1,1,3877,0,3879,G
1-PB2,1271,0,0,0,3887,3887,C
1-PB2,1272,3876,0,2,0,3878,A
1-PB2,1273,3917,1,4,0,3922,A
1-PB2,1274,3932,0,1,0,3933,A
1-PB2,1275,0,3927,0,0,3927,T
1-PB2,1276,9,2,0,3928,3939,C
1-PB2,1277,3887,0,3,0,3890,A
1-PB2,1278,1,1,3888,0,3890,G
1-PB2,1279,3,2,0,3887,3892,C
1-PB2,1280,4,4,3891,1,3900,G
1-PB2,1281,2,7,4095,0,4104,G
1-PB2,1282,0,4074,0,1,4075,T
1-PB2,1283,2,4075,0,2,4079,T
1-PB2,1284,0,14,4071,0,4085,G
1-PB2,1285,4085,1,1,0,4087,A
1-PB2,1286,4088,1,7,0,4096,A
1-PB2,1287,1,1,0,4106,4108,C
1-PB2,1288,4,1,0,4078,4083,C
1-PB2,1289,7,0,3,4100,4110,C
1-PB2,1290,5,0,0,3970,3975,C
1-PB2,1291,3986,1,6,1,3994,A
1-PB2,1292,1,4010,0,3,4014,T
1-PB2,1293,3,1,4011,0,4015,G
1-PB2,1294,2,3,0,4019,4024,C
1-PB2,1295,4004,0,1,0,4005,A
1-PB2,1296,1,3969,0,4,3974,T
1-PB2,1297,13,1,0,3951,3965,C
1-PB2,1298,3939,0,1,0,3940,A
1-PB2,1299,2,2,4008,0,4012,G
1-PB2,1300,0,1,0,4016,4017,C
1-PB2,1301,0,3976,0,5,3981,T
1-PB2,1302,0,3970,0,2,3972,T
1-PB2,1303,0,3964,0,0,3964,T
1-PB2,1304,0,3967,1,2,3970,T
1-PB2,1305,3967,1,1,0,3969,A
1-PB2,1306,3963,1,1,0,3965,A
1-PB2,1307,1,8,3960,1,3970,G
1-PB2,1308,2,1,3937,0,3940,G
1-PB2,1309,2,1,0,3909,3912,C
1-PB2,1310,3891,0,1,2,3894,A
1-PB2,1311,0,3891,0,1,3892,T
1-PB2,1312,0,3909,0,3,3912,T
1-PB2,1313,1,3906,0,1,3908,T
1-PB2,1314,0,3923,0,1,3924,T
1-PB2,1315,10,1,1,3914,3926,C
1-PB2,1316,3916,1,3,0,3920,A
1-PB2,1317,0,3,3923,0,3926,G
1-PB2,1318,3914,1,0,0,3915,A
1-PB2,1319,3907,1,0,0,3908,A
1-PB2,1320,3900,0,2,0,3902,A
1-PB2,1321,0,5,3894,0,3899,G
1-PB2,1322,3918,0,2,0,3920,A
1-PB2,1323,1,3912,0,2,3915,T
1-PB2,1324,3,0,3905,0,3908,G
1-PB2,1325,2,1,0,3909,3912,C
1-PB2,1326,3,9,3902,0,3914,G
1-PB2,1327,3914,1,0,0,3915,A
1-PB2,1328,3910,0,0,0,3910,A
1-PB2,1329,3908,1,1,0,3910,A
1-PB2,1330,1,1,3919,0,3921,G
1-PB2,1331,0,3873,0,3,3876,T
1-PB2,1332,0,4,3864,0,3868,G
1-PB2,1333,5,1,0,3862,3868,C
1-PB2,1334,2,3856,0,3,3861,T
1-PB2,1335,0,3858,1,1,3860,T
1-PB2,1336,0,3861,0,0,3861,T
1-PB2,1337,0,3860,0,2,3862,T
1-PB2,1338,0,3866,0,2,3868,T
1-PB2,1339,5,3,0,3861,3869,C
1-PB2,1340,3859,2,2,0,3863,A
1-PB2,1341,3880,0,0,0,3880,A
1-PB2,1342,3872,2,0,1,3875,A
1-PB2,1343,3883,0,0,0,3883,A
1-PB2,1344,0,3879,0,2,3881,T
1-PB2,1345,1,3884,1,2,3888,T
1-PB2,1346,1,6,3876,0,3883,G
1-PB2,1347,11,8,3858,0,3877,G
1-PB2,1348,2,5,3868,2,3877,G
1-PB2,1349,11,13,3881,0,3905,G
1-PB2,1350,3886,1,0,0,3887,A
1-PB2,1351,0,1,3955,0,3956,G
1-PB2,1352,0,3949,0,1,3950,T
1-PB2,1353,0,3947,0,2,3949,T
1-PB2,1354,1,16,3938,1,3956,G
1-PB2,1355,3950,0,5,0,3955,A
1-PB2,1356,3964,0,6,0,3970,A
1-PB2,1357,2,3,0,4090,4095,C
1-PB2,1358,4062,0,2,0,4064,A
1-PB2,1359,2,4,0,4172,4178,C
1-PB2,1360,4076,2,1,0,4079,A
1-PB2,1361,0,4067,0,3,4070,T
1-PB2,1362,3,4040,0,2,4045,T
1-PB2,1363,0,15,4071,0,4086,G
1-PB2,1364,4092,0,6,0,4098,A
1-PB2,1365,0,0,0,4100,4100,C
1-PB2,1366,3941,1,2,0,3944,A
1-PB2,1367,0,3,4027,0,4030,G
1-PB2,1368,0,3909,1,1,3911,T
1-PB2,1369,0,1,3962,0,3963,G
1-PB2,1370,2,3947,0,1,3950,T
1-PB2,1371,2,9,3949,0,3960,G
1-PB2,1372,3946,0,2,0,3948,A
1-PB2,1373,0,3937,0,1,3938,T
1-PB2,1374,1,8,3939,0,3948,G
1-PB2,1375,3,5,3938,0,3946,G
1-PB2,1376,0,8,3886,0,3894,G
1-PB2,1377,3856,1,8,0,3865,A
1-PB2,1378,3830,0,2,0,3832,A
1-PB2,1379,1,3815,0,1,3817,T
1-PB2,1380,2,14,3823,2,3841,G
1-PB2,1381,3830,2,2,0,3834,A
1-PB2,1382,1,3833,0,1,3835,T
1-PB2,1383,1,3823,1,2,3827,T
1-PB2,1384,0,3,3806,0,3809,G
1-PB2,1385,1,11,3876,0,3888,G
1-PB2,1386,3864,2,5,0,3871,A
1-PB2,1387,0,0,3918,0,3918,G
1-PB2,1388,0,3891,0,0,3891,T
1-PB2,1389,3870,0,1,0,3871,A
1-PB2,1390,0,3891,0,2,3893,T
1-PB2,1391,1,3909,0,1,3911,T
1-PB2,1392,3949,0,8,0,3957,A
1-PB2,1393,3,0,0,3955,3958,C
1-PB2,1394,6,0,0,3885,3891,C
1-PB2,1395,3860,0,2,0,3862,A
1-PB2,1396,1,4,3891,0,3896,G
1-PB2,1397,3964,0,1,0,3965,A
1-PB2,1398,2,3919,0,4,3925,T
1-PB2,1399,3902,0,4,0,3906,A
1-PB2,1400,0,3871,0,1,3872,T
1-PB2,1401,0,20,3823,1,3844,G
1-PB2,1402,3850,0,6,0,3856,A
1-PB2,1403,2,1,0,3880,3883,C
1-PB2,1404,1,3856,1,4,3862,T
1-PB2,1405,9,0,0,3845,3854,C
1-PB2,1406,6,6,0,3784,3796,C
1-PB2,1407,3812,0,2,1,3815,A
1-PB2,1408,3803,0,21,1,3825,A
1-PB2,1409,2,4,3904,0,3910,G
1-PB2,1410,2,3,0,3885,3890,C
1-PB2,1411,3884,0,2,0,3886,A
1-PB2,1412,1,1,0,3882,3884,C
1-PB2,1413,3833,2,1,0,3836,A
1-PB2,1414,0,12,3840,0,3852,G
1-PB2,1415,3832,0,2,0,3834,A
1-PB2,1416,0,2,3862,0,3864,G
1-PB2,1417,3871,0,1,0,3872,A
1-PB2,1418,0,3765,0,2,3767,T
1-PB2,1419,0,1,3816,0,3817,G
1-PB2,1420,0,3773,3,6,3782,T
1-PB2,1421,20,1,0,3749,3770,C
1-PB2,1422,3786,0,2,0,3788,A
1-PB2,1423,3777,0,1,0,3778,A
1-PB2,1424,0,3781,0,1,3782,T
1-PB2,1425,1,10,3763,0,3774,G
1-PB2,1426,3712,0,1,0,3713,A
1-PB2,1427,5,5,3724,0,3734,G
1-PB2,1428,3667,0,2,0,3669,A
1-PB2,1429,2,2,3684,0,3688,G
1-PB2,1430,1,7,3835,1,3844,G
1-PB2,1431,3828,1,3,0,3832,A
1-PB2,1432,3843,0,1,0,3844,A
1-PB2,1433,1,3833,0,0,3834,T
1-PB2,1434,3836,0,1,0,3837,A
1-PB2,1435,3834,0,2,0,3836,A
1-PB2,1436,0,13,3811,1,3825,G
1-PB2,1437,3806,1,2,0,3809,A
1-PB2,1438,1,0,3821,0,3822,G
1-PB2,1439,0,3599,0,0,3599,T
1-PB2,1440,15,2,0,3594,3611,C
1-PB2,1441,3598,0,4,0,3602,A
1-PB2,1442,0,1,3627,0,3628,G
1-PB2,1443,2,0,1,3628,3631,C
1-PB2,1444,3634,0,0,0,3634,A
1-PB2,1445,3626,1,0,0,3627,A
1-PB2,1446,3620,0,0,0,3620,A
1-PB2,1447,3627,0,1,1,3629,A
1-PB2,1448,0,3618,0,0,3618,T
1-PB2,1449,0,6,3616,0,3622,G
1-PB2,1450,4,2,3608,1,3615,G
1-PB2,1451,1,2,3646,0,3649,G
1-PB2,1452,0,3602,0,2,3604,T
1-PB2,1453,3,2,3602,1,3608,G
1-PB2,1454,0,3586,0,2,3588,T
1-PB2,1455,0,7,3586,0,3593,G
1-PB2,1456,0,4,3637,0,3641,G
1-PB2,1457,3639,0,1,1,3641,A
1-PB2,1458,0,3610,0,0,3610,T
1-PB2,1459,7,8,3620,0,3635,G
1-PB2,1460,3618,0,3,0,3621,A
1-PB2,1461,3627,1,0,0,3628,A
1-PB2,1462,0,3624,0,1,3625,T
1-PB2,1463,3598,0,0,0,3598,A
1-PB2,1464,1,0,0,3790,3791,C
1-PB2,1465,2,3690,0,3,3695,T
1-PB2,1466,12,0,0,3729,3741,C
1-PB2,1467,8,1,0,3732,3741,C
1-PB2,1468,3755,0,1,0,3756,A
1-PB2,1469,1,2,3847,0,3850,G
1-PB2,1470,0,3828,1,0,3829,T
1-PB2,1471,3832,0,5,0,3837,A
1-PB2,1472,1,0,1,3839,3841,C
1-PB2,1473,3518,1,3,0,3522,A
1-PB2,1474,0,1,3528,0,3529,G
1-PB2,1475,3475,1,2,0,3478,A
1-PB2,1476,1,6,3475,1,3483,G
1-PB2,1477,3343,0,1,0,3344,A
1-PB2,1478,0,4,3268,0,3272,G
1-PB2,1479,3115,1,3,0,3119,A
1-PB2,1480,3,0,3183,0,3186,G
1-PB2,1481,0,3173,1,3,3177,T
1-PB2,1482,2,8,3181,0,3191,G
1-PB2,1483,0,4,3189,1,3194,G
1-PB2,1484,0,3140,0,3,3143,T
1-PB2,1485,0,8,3196,0,3204,G
1-PB2,1486,3,0,3213,0,3216,G
1-PB2,1487,1,3157,0,3,3161,T
1-PB2,1488,0,3156,0,3,3159,T
1-PB2,1489,3122,1,3,0,3126,A
1-PB2,1490,1,2,3128,0,3131,G
1-PB2,1491,2,2,0,3125,3129,C
1-PB2,1492,3098,1,3,0,3102,A
1-PB2,1493,0,3100,0,0,3100,T
1-PB2,1494,0,2937,0,0,2937,T
1-PB2,1495,0,11,2928,1,2940,G
1-PB2,1496,2934,2,0,0,2936,A
1-PB2,1497,1,2935,1,0,2937,T
1-PB2,1498,13,0,0,2928,2941,C
1-PB2,1499,0,3,2909,0,2912,G
1-PB2,1500,1,1,2966,0,2968,G
1-PB2,1501,2,2958,2,0,2962,T
1-PB2,1502,0,2951,0,0,2951,T
1-PB2,1503,0,2955,3,0,2958,T
1-PB2,1504,0,2955,0,0,2955,T
1-PB2,1505,0,2955,0,1,2956,T
1-PB2,1506,0,2,2955,0,2957,G
1-PB2,1507,2949,0,0,0,2949,A
1-PB2,1508,0,10,2943,0,2953,G
1-PB2,1509,2821,0,0,0,2821,A
1-PB2,1510,0,0,2840,0,2840,G
1-PB2,1511,1,2833,0,3,2837,T
1-PB2,1512,1,2828,0,2,2831,T
1-PB2,1513,23,0,0,2813,2836,C
1-PB2,1514,3,6,2826,0,2835,G
1-PB2,1515,2834,1,9,0,2844,A
1-PB2,1516,0,8,2839,0,2847,G
1-PB2,1517,2839,1,3,0,2843,A
1-PB2,1518,1,0,0,2827,2828,C
1-PB2,1519,6,1,0,2803,2810,C
1-PB2,1520,2781,0,0,0,2781,A
1-PB2,1521,2806,1,2,0,2809,A
1-PB2,1522,2,0,0,2810,2812,C
1-PB2,1523,1,0,2823,0,2824,G
1-PB2,1524,0,2801,0,1,2802,T
1-PB2,1525,1,4,2796,0,2801,G
1-PB2,1526,0,2,2802,0,2804,G
1-PB2,1527,3,2,2806,0,2811,G
1-PB2,1528,2781,1,1,0,2783,A
1-PB2,1529,2788,0,0,0,2788,A
1-PB2,1530,0,2679,0,0,2679,T
1-PB2,1531,0,0,2766,0,2766,G
1-PB2,1532,0,2757,0,0,2757,T
1-PB2,1533,2757,1,0,0,2758,A
1-PB2,1534,2,2756,0,0,2758,T
1-PB2,1535,0,2720,1,1,2722,T
1-PB2,1536,2746,1,0,0,2747,A
1-PB2,1537,0,2726,0,1,2727,T
1-PB2,1538,0,2684,0,0,2684,T
1-PB2,1539,2684,0,0,0,2684,A
1-PB2,1540,0,2353,0,2,2355,T
1-PB2,1541,7,0,0,2404,2411,C
1-PB2,1542,1,2370,1,1,2373,T
1-PB2,1543,8,0,0,2371,2379,C
1-PB2,1544,7,0,0,2371,2378,C
1-PB2,1545,0,2292,0,2,2294,T
1-PB2,1546,0,2,2296,0,2298,G
1-PB2,1547,2290,0,1,0,2291,A
1-PB2,1548,1,1,2293,0,2295,G
1-PB2,1549,0,0,2291,0,2291,G
1-PB2,1550,1998,0,1,0,1999,A
1-PB2,1551,1,3,2015,0,2019,G
1-PB2,1552,0,2,1996,0,1998,G
1-PB2,1553,1,1897,0,3,1901,T
1-PB2,1554,6,0,0,1901,1907,C
1-PB2,1555,1875,1,0,2,1878,A
1-PB2,1556,1,1,1891,0,1893,G
1-PB2,1557,0,1875,0,0,1875,T
1-PB2,1558,0,8,1863,0,1871,G
1-PB2,1559,1873,0,2,0,1875,A
1-PB2,1560,1784,0,0,0,1784,A
1-PB2,1561,1781,0,1,1,1783,A
1-PB2,1562,0,0,0,1782,1782,C
1-PB2,1563,1766,0,1,0,1767,A
1-PB2,1564,0,0,0,1764,1764,C
1-PB2,1565,1704,0,1,0,1705,A
1-PB2,1566,1695,0,0,0,1695,A
1-PB2,1567,0,4,1692,0,1696,G
1-PB2,1568,1,6,1706,0,1713,G
1-PB2,1569,1718,1,1,0,1720,A
1-PB2,1570,1685,0,0,0,1685,A
1-PB2,1571,1,0,0,1693,1694,C
1-PB2,1572,0,1646,0,1,1647,T
1-PB2,1573,1,3,1646,1,1651,G
1-PB2,1574,1641,0,0,0,1641,A
1-PB2,1575,1,2,1641,0,1644,G
1-PB2,1576,1605,1,3,0,1609,A
1-PB2,1577,0,3,1486,0,1489,G
1-PB2,1578,1485,1,2,0,1488,A
1-PB2,1579,2,1,0,1477,1480,C
1-PB2,1580,0,1429,0,1,1430,T
1-PB2,1581,0,4,1433,2,1439,G
1-PB2,1582,1426,0,2,0,1428,A
1-PB2,1583,1,1,0,1430,1432,C
1-PB2,1584,1413,2,1,0,1416,A
1-PB2,1585,1418,0,0,0,1418,A
1-PB2,1586,0,1405,0,1,1406,T
1-PB2,1587,1402,0,0,0,1402,A
1-PB2,1588,1403,0,0,0,1403,A
1-PB2,1589,1,1,0,1400,1402,C
1-PB2,1590,0,1288,1,2,1291,T
1-PB2,1591,0,1267,1,0,1268,T
1-PB2,1592,1242,0,1,1,1244,A
1-PB2,1593,0,1238,1,0,1239,T
1-PB2,1594,1,1232,0,0,1233,T
1-PB2,1595,6,1,0,1223,1230,C
1-PB2,1596,1110,0,0,0,1110,A
1-PB2,1597,0,1101,0,1,1102,T
1-PB2,1598,1,0,0,1041,1042,C
1-PB2,1599,1,2,1035,0,1038,G
1-PB2,1600,0,1042,0,0,1042,T
1-PB2,1601,1,2,0,1022,1025,C
1-PB2,1602,1,2,1019,0,1022,G
1-PB2,1603,1018,1,1,0,1020,A
1-PB2,1604,1,1013,0,0,1014,T
1-PB2,1605,1,2,1004,0,1007,G
1-PB2,1606,1008,0,0,0,1008,A
1-PB2,1607,0,1011,0,0,1011,T
1-PB2,1608,0,0,996,0,996,G
1-PB2,1609,0,934,0,0,934,T
1-PB2,1610,3,0,927,1,931,G
1-PB2,1611,0,1,930,0,931,G
1-PB2,1612,0,0,924,0,924,G
1-PB2,1613,888,0,2,0,890,A
1-PB2,1614,0,0,864,0,864,G
1-PB2,1615,734,0,1,0,735,A
1-PB2,1616,0,691,0,0,691,T
1-PB2,1617,0,657,0,0,657,T
1-PB2,1618,654,0,1,0,655,A
1-PB2,1619,651,0,0,0,651,A
1-PB2,1620,0,0,0,639,639,C
1-PB2,1621,0,0,575,0,575,G
1-PB2,1622,0,0,564,0,564,G
1-PB2,1623,0,436,0,0,436,T
1-PB2,1624,0,1,0,422,423,C
1-PB2,1625,0,0,0,418,418,C
1-PB2,1626,0,373,0,0,373,T
1-PB2,1627,0,0,372,0,372,G
1-PB2,1628,372,0,1,0,373,A
1-PB2,1629,0,0,373,0,373,G
1-PB2,1630,0,372,0,0,372,T
1-PB2,1631,0,0,0,361,361,C
1-PB2,1632,0,1,359,0,360,G
1-PB2,1633,1,1,361,0,363,G
1-PB2,1634,0,361,0,1,362,T
1-PB2,1635,0,364,0,0,364,T
1-PB2,1636,0,362,0,0,362,T
1-PB2,1637,0,361,0,0,361,T
1-PB2,1638,0,0,373,0,373,G
1-PB2,1639,0,0,374,0,374,G
1-PB2,1640,0,375,0,1,376,T
1-PB2,1641,1,0,1,374,376,C
1-PB2,1642,368,0,0,0,368,A
1-PB2,1643,378,0,0,0,378,A
1-PB2,1644,0,382,0,0,382,T
1-PB2,1645,383,1,0,0,384,A
1-PB2,1646,0,0,0,396,396,C
1-PB2,1647,1,0,0,383,384,C
1-PB2,1648,0,386,1,0,387,T
1-PB2,1649,399,0,0,0,399,A
1-PB2,1650,0,398,0,0,398,T
1-PB2,1651,1,0,0,402,403,C
1-PB2,1652,388,0,0,0,388,A
1-PB2,1653,391,0,0,0,391,A
1-PB2,1654,0,389,0,0,389,T
1-PB2,1655,1,2,371,0,374,G
1-PB2,1656,0,1,373,0,374,G
1-PB2,1657,374,0,0,0,374,A
1-PB2,1658,0,369,0,0,369,T
1-PB2,1659,2,0,0,363,365,C
1-PB2,1660,367,0,0,0,367,A
1-PB2,1661,0,367,0,0,367,T
1-PB2,1662,0,0,0,367,367,C
1-PB2,1663,366,0,0,0,366,A
1-PB2,1664,0,0,368,0,368,G
1-PB2,1665,362,0,0,0,362,A
1-PB2,1666,362,0,0,0,362,A
1-PB2,1667,364,0,0,0,364,A
1-PB2,1668,0,364,0,0,364,T
1-PB2,1669,0,364,0,0,364,T
1-PB2,1670,0,0,362,0,362,G
1-PB2,1671,0,0,364,0,364,G
1-PB2,1672,1,1,361,0,363,G
1-PB2,1673,361,0,0,0,361,A
1-PB2,1674,356,0,1,0,357,A
1-PB2,1675,0,0,359,0,359,G
1-PB2,1676,0,0,0,359,359,C
1-PB2,1677,0,360,0,0,360,T
1-PB2,1678,2,0,362,0,364,G
1-PB2,1679,0,362,0,0,362,T
1-PB2,1680,1,1,0,358,360,C
1-PB2,1681,362,0,0,0,362,A
1-PB2,1682,362,0,0,1,363,A
1-PB2,1683,363,0,0,0,363,A
1-PB2,1684,365,0,0,0,365,A
1-PB2,1685,0,365,0,0,365,T
1-PB2,1686,0,366,0,0,366,T
1-PB2,1687,1,0,0,361,362,C
1-PB2,1688,358,0,0,0,358,A
1-PB2,1689,356,0,0,0,356,A
1-PB2,1690,0,358,0,0,358,T
1-PB2,1691,0,0,359,0,359,G
1-PB2,1692,0,0,366,0,366,G
1-PB2,1693,0,373,0,0,373,T
1-PB2,1694,0,1,0,373,374,C
1-PB2,1695,0,372,0,2,374,T
1-PB2,1696,2,0,0,372,374,C
1-PB2,1697,371,0,0,0,371,A
1-PB2,1698,0,1,370,0,371,G
1-PB2,1699,373,0,0,0,373,A
1-PB2,1700,373,0,0,0,373,A
1-PB2,1701,0,368,0,0,368,T
1-PB2,1702,0,0,0,362,362,C
1-PB2,1703,1,1,0,365,367,C
1-PB2,1704,0,363,0,1,364,T
1-PB2,1705,0,0,363,0,363,G
1-PB2,1706,0,1,0,360,361,C
1-PB2,1707,363,0,0,0,363,A
1-PB2,1708,364,0,0,0,364,A
1-PB2,1709,0,362,0,0,362,T
1-PB2,1710,0,0,372,0,372,G
1-PB2,1711,0,373,0,0,373,T
1-PB2,1712,0,365,0,0,365,T
1-PB2,1713,0,0,369,0,369,G
1-PB2,1714,0,368,0,0,368,T
1-PB2,1715,368,0,0,0,368,A
1-PB2,1716,0,0,0,367,367,C
1-PB2,1717,357,0,0,0,357,A
1-PB2,1718,359,0,0,0,359,A
1-PB2,1719,0,0,0,354,354,C
1-PB2,1720,348,0,0,0,348,A
1-PB2,1721,348,0,0,0,348,A
1-PB2,1722,344,0,0,0,344,A
1-PB2,1723,346,0,0,0,346,A
1-PB2,1724,0,348,0,0,348,T
1-PB2,1725,0,0,346,0,346,G
1-PB2,1726,0,0,347,0,347,G
1-PB2,1727,344,0,0,0,344,A
1-PB2,1728,347,0,0,0,347,A
1-PB2,1729,0,345,0,0,345,T
1-PB2,1730,0,344,0,0,344,T
1-PB2,1731,0,345,0,0,345,T
1-PB2,1732,2,0,344,0,346,G
1-PB2,1733,345,0,0,0,345,A
1-PB2,1734,346,0,0,0,346,A
1-PB2,1735,0,0,0,344,344,C
1-PB2,1736,0,0,0,340,340,C
1-PB2,1737,341,0,1,0,342,A
1-PB2,1738,0,346,0,0,346,T
1-PB2,1739,0,347,0,0,347,T
1-PB2,1740,0,349,0,0,349,T
1-PB2,1741,1,0,0,346,347,C
1-PB2,1742,347,0,0,0,347,A
1-PB2,1743,348,0,0,0,348,A
1-PB2,1744,0,349,0,0,349,T
1-PB2,1745,0,0,0,361,361,C
1-PB2,1746,0,352,0,0,352,T
1-PB2,1747,0,354,0,0,354,T
1-PB2,1748,0,354,0,0,354,T
1-PB2,1749,354,0,0,0,354,A
1-PB2,1750,0,0,360,0,360,G
1-PB2,1751,0,360,0,0,360,T
1-PB2,1752,0,1,0,367,368,C
1-PB2,1753,0,0,0,369,369,C
1-PB2,1754,2,1,0,358,361,C
1-PB2,1755,0,0,0,362,362,C
1-PB2,1756,360,0,0,0,360,A
1-PB2,1757,357,0,1,0,358,A
1-PB2,1758,0,0,368,0,368,G
1-PB2,1759,1,1,365,0,367,G
1-PB2,1760,0,0,0,369,369,C
1-PB2,1761,1,0,0,360,361,C
1-PB2,1762,362,0,0,0,362,A
1-PB2,1763,0,368,0,0,368,T
1-PB2,1764,0,369,0,0,369,T
1-PB2,1765,369,0,0,0,369,A
1-PB2,1766,0,1,369,0,370,G
1-PB2,1767,360,0,0,0,360,A
1-PB2,1768,371,0,0,0,371,A
1-PB2,1769,0,0,375,0,375,G
1-PB2,1770,0,1,0,375,376,C
1-PB2,1771,2,0,0,376,378,C
1-PB2,1772,371,0,0,0,371,A
1-PB2,1773,377,0,0,0,377,A
1-PB2,1774,0,380,0,0,380,T
1-PB2,1775,382,0,0,0,382,A
1-PB2,1776,0,0,0,384,384,C
1-PB2,1777,365,0,0,0,365,A
1-PB2,1778,0,0,366,0,366,G
1-PB2,1779,0,363,0,0,363,T
1-PB2,1780,0,0,365,0,365,G
1-PB2,1781,0,1,361,0,362,G
1-PB2,1782,1,0,365,0,366,G
1-PB2,1783,0,364,0,1,365,T
1-PB2,1784,0,363,0,0,363,T
1-PB2,1785,0,365,1,0,366,T
1-PB2,1786,0,0,369,0,369,G
1-PB2,1787,0,368,0,0,368,T
1-PB2,1788,3,0,0,366,369,C
1-PB2,1789,362,0,1,0,363,A
1-PB2,1790,0,1,364,0,365,G
1-PB2,1791,364,0,0,0,364,A
1-PB2,1792,363,1,0,0,364,A
1-PB2,1793,0,0,0,363,363,C
1-PB2,1794,0,353,0,1,354,T
1-PB2,1795,0,0,0,365,365,C
1-PB2,1796,0,365,0,0,365,T
1-PB2,1797,368,0,0,0,368,A
1-PB2,1798,0,365,0,0,365,T
1-PB2,1799,0,367,0,0,367,T
1-PB2,1800,0,0,0,367,367,C
1-PB2,1801,0,0,0,366,366,C
1-PB2,1802,363,0,2,0,365,A
1-PB2,1803,365,0,0,0,365,A
1-PB2,1804,1,0,0,362,363,C
1-PB2,1805,361,0,0,0,361,A
1-PB2,1806,365,0,0,0,365,A
1-PB2,1807,363,0,0,0,363,A
1-PB2,1808,0,366,0,0,366,T
1-PB2,1809,0,1,365,0,366,G
1-PB2,1810,361,1,0,0,362,A
1-PB2,1811,0,0,368,0,368,G
1-PB2,1812,366,0,1,0,367,A
1-PB2,1813,0,0,371,0,371,G
1-PB2,1814,367,0,0,0,367,A
1-PB2,1815,0,0,0,367,367,C
1-PB2,1816,0,0,369,0,369,G
1-PB2,1817,0,378,0,0,378,T
1-PB2,1818,383,0,0,0,383,A
1-PB2,1819,0,0,0,384,384,C
1-PB2,1820,0,381,0,0,381,T
1-PB2,1821,0,378,0,0,378,T
1-PB2,1822,0,1,375,0,376,G
1-PB2,1823,1,0,383,0,384,G
1-PB2,1824,0,2,382,0,384,G
1-PB2,1825,378,0,0,0,378,A
1-PB2,1826,0,0,0,376,376,C
1-PB2,1827,382,0,0,0,382,A
1-PB2,1828,0,381,0,0,381,T
1-PB2,1829,0,382,0,0,382,T
1-PB2,1830,0,383,0,0,383,T
1-PB2,1831,0,1,380,0,381,G
1-PB2,1832,384,0,0,0,384,A
1-PB2,1833,0,0,0,383,383,C
1-PB2,1834,384,0,0,0,384,A
1-PB2,1835,0,0,0,388,388,C
1-PB2,1836,1,0,0,379,380,C
1-PB2,1837,381,0,1,0,382,A
1-PB2,1838,1,0,0,385,386,C
1-PB2,1839,2,0,0,381,383,C
1-PB2,1840,0,0,0,384,384,C
1-PB2,1841,380,0,0,0,380,A
1-PB2,1842,0,1,382,0,383,G
1-PB2,1843,383,0,2,0,385,A
1-PB2,1844,0,406,0,0,406,T
1-PB2,1845,403,0,0,0,403,A
1-PB2,1846,396,0,0,0,396,A
1-PB2,1847,0,401,0,0,401,T
1-PB2,1848,394,0,0,0,394,A
1-PB2,1849,396,0,0,0,396,A
1-PB2,1850,393,0,0,0,393,A
1-PB2,1851,0,0,394,0,394,G
1-PB2,1852,0,0,0,393,393,C
1-PB2,1853,0,378,0,0,378,T
1-PB2,1854,0,379,0,0,379,T
1-PB2,1855,1,0,0,379,380,C
1-PB2,1856,0,376,0,0,376,T
1-PB2,1857,3,0,0,381,384,C
1-PB2,1858,0,0,0,385,385,C
1-PB2,1859,0,0,0,389,389,C
1-PB2,1860,0,388,0,0,388,T
1-PB2,1861,0,384,0,2,386,T
1-PB2,1862,0,384,0,1,385,T
1-PB2,1863,0,382,0,1,383,T
1-PB2,1864,0,0,384,0,384,G
1-PB2,1865,0,0,0,386,386,C
1-PB2,1866,379,0,0,0,379,A
1-PB2,1867,0,0,379,0,379,G
1-PB2,1868,1,0,0,375,376,C
1-PB2,1869,0,370,0,0,370,T
1-PB2,1870,0,0,372,0,372,G
1-PB2,1871,0,0,0,374,374,C
1-PB2,1872,0,371,0,1,372,T
1-PB2,1873,1,0,0,372,373,C
1-PB2,1874,1,0,0,379,380,C
1-PB2,1875,381,0,0,0,381,A
1-PB2,1876,0,0,0,381,381,C
1-PB2,1877,3,0,0,377,380,C
1-PB2,1878,376,0,0,0,376,A
1-PB2,1879,373,0,0,0,373,A
1-PB2,1880,374,0,0,0,374,A
1-PB2,1881,0,0,378,0,378,G
1-PB2,1882,0,1,0,375,376,C
1-PB2,1883,370,0,0,0,370,A
1-PB2,1884,370,0,0,0,370,A
1-PB2,1885,370,0,0,0,370,A
1-PB2,1886,1,0,377,0,378,G
1-PB2,1887,2,0,0,375,377,C
1-PB2,1888,371,0,1,0,372,A
1-PB2,1889,0,1,376,0,377,G
1-PB2,1890,374,0,0,0,374,A
1-PB2,1891,377,1,0,0,378,A
1-PB2,1892,0,378,0,0,378,T
1-PB2,1893,0,0,379,0,379,G
1-PB2,1894,0,0,0,383,383,C
1-PB2,1895,378,0,0,0,378,A
1-PB2,1896,0,0,380,0,380,G
1-PB2,1897,0,379,0,1,380,T
1-PB2,1898,0,394,0,0,394,T
1-PB2,1899,1,0,0,393,394,C
1-PB2,1900,0,390,0,0,390,T
1-PB2,1901,0,0,0,395,395,C
1-PB2,1902,0,392,0,0,392,T
1-PB2,1903,0,393,0,0,393,T
1-PB2,1904,0,0,0,392,392,C
1-PB2,1905,387,0,0,0,387,A
1-PB2,1906,0,0,0,388,388,C
1-PB2,1907,0,375,0,0,375,T
1-PB2,1908,0,2,377,0,379,G
1-PB2,1909,372,0,0,0,372,A
1-PB2,1910,1,0,0,380,381,C
1-PB2,1911,0,378,0,0,378,T
1-PB2,1912,0,0,388,0,388,G
1-PB2,1913,0,385,0,1,386,T
1-PB2,1914,0,1,388,0,389,G
1-PB2,1915,388,0,0,0,388,A
1-PB2,1916,387,0,0,0,387,A
1-PB2,1917,0,384,0,0,384,T
1-PB2,1918,0,1,385,0,386,G
1-PB2,1919,0,378,0,0,378,T
1-PB2,1920,0,1,375,0,376,G
1-PB2,1921,365,0,0,0,365,A
1-PB2,1922,0,1,365,0,366,G
1-PB2,1923,0,2,361,0,363,G
1-PB2,1924,0,0,360,0,360,G
1-PB2,1925,0,0,371,0,371,G
1-PB2,1926,367,0,1,0,368,A
1-PB2,1927,0,368,0,1,369,T
1-PB2,1928,0,1,0,369,370,C
1-PB2,1929,365,0,1,0,366,A
1-PB2,1930,0,1,374,0,375,G
1-PB2,1931,0,0,374,0,374,G
1-PB2,1932,0,0,374,0,374,G
1-PB2,1933,371,1,0,0,372,A
1-PB2,1934,0,348,0,0,348,T
1-PB2,1935,0,1,345,1,347,G
1-PB2,1936,347,0,0,0,347,A
1-PB2,1937,0,1,353,1,355,G
1-PB2,1938,355,0,0,0,355,A
1-PB2,1939,349,0,0,0,349,A
1-PB2,1940,0,354,0,1,355,T
1-PB2,1941,351,0,0,0,351,A
1-PB2,1942,0,0,0,353,353,C
1-PB2,1943,0,350,0,0,350,T
1-PB2,1944,0,347,0,2,349,T
1-PB2,1945,0,2,349,0,351,G
1-PB2,1946,0,339,0,0,339,T
1-PB2,1947,339,0,0,0,339,A
1-PB2,1948,334,0,1,0,335,A
1-PB2,1949,1,2,328,0,331,G
1-PB2,1950,0,1,335,0,336,G
1-PB2,1951,0,3,323,0,326,G
1-PB2,1952,0,0,327,0,327,G
1-PB2,1953,0,0,0,330,330,C
1-PB2,1954,324,0,1,0,325,A
1-PB2,1955,330,0,0,1,331,A
1-PB2,1956,0,330,0,1,331,T
1-PB2,1957,0,332,0,1,333,T
1-PB2,1958,1,0,0,334,335,C
1-PB2,1959,0,333,0,0,333,T
1-PB2,1960,1,0,0,337,338,C
1-PB2,1961,0,0,0,339,339,C
1-PB2,1962,0,338,0,0,338,T
1-PB2,1963,0,0,348,0,348,G
1-PB2,1964,0,343,0,0,343,T
1-PB2,1965,346,0,0,0,346,A
1-PB2,1966,0,346,0,0,346,T
1-PB2,1967,0,341,0,0,341,T
1-PB2,1968,2,0,0,340,342,C
1-PB2,1969,343,0,0,0,343,A
1-PB2,1970,345,0,0,0,345,A
1-PB2,1971,0,0,0,345,345,C
1-PB2,1972,0,342,0,0,342,T
1-PB2,1973,341,0,0,0,341,A
1-PB2,1974,0,0,0,349,349,C
1-PB2,1975,350,0,0,0,350,A
1-PB2,1976,350,0,0,0,350,A
1-PB2,1977,0,0,0,346,346,C
1-PB2,1978,344,0,0,0,344,A
1-PB2,1979,342,0,0,0,342,A
1-PB2,1980,0,2,337,1,340,G
1-PB2,1981,341,0,2,0,343,A
1-PB2,1982,0,0,0,344,344,C
1-PB2,1983,3,0,0,334,337,C
1-PB2,1984,342,0,0,0,342,A
1-PB2,1985,0,0,0,357,357,C
1-PB2,1986,0,355,0,1,356,T
1-PB2,1987,355,0,0,0,355,A
1-PB2,1988,354,0,0,0,354,A
1-PB2,1989,356,0,0,0,356,A
1-PB2,1990,355,0,0,0,355,A
1-PB2,1991,0,1,359,0,360,G
1-PB2,1992,356,0,0,0,356,A
1-PB2,1993,0,0,0,358,358,C
1-PB2,1994,0,350,0,0,350,T
1-PB2,1995,349,0,1,0,350,A
1-PB2,1996,349,0,0,0,349,A
1-PB2,1997,0,0,0,350,350,C
1-PB2,1998,350,0,0,0,350,A
1-PB2,1999,349,0,0,0,349,A
1-PB2,2000,0,345,0,0,345,T
1-PB2,2001,0,343,0,0,343,T
1-PB2,2002,2,0,0,340,342,C
1-PB2,2003,0,346,0,0,346,T
1-PB2,2004,0,0,0,344,344,C
1-PB2,2005,1,1,343,0,345,G
1-PB2,2006,0,0,344,0,344,G
1-PB2,2007,343,0,0,0,343,A
1-PB2,2008,344,0,0,0,344,A
1-PB2,2009,344,0,0,0,344,A
1-PB2,2010,345,0,0,0,345,A
1-PB2,2011,0,0,345,0,345,G
1-PB2,2012,345,0,0,0,345,A
1-PB2,2013,0,344,0,0,344,T
1-PB2,2014,1,0,344,0,345,G
1-PB2,2015,0,0,0,343,343,C
1-PB2,2016,0,1,0,344,345,C
1-PB2,2017,1,0,341,0,342,G
1-PB2,2018,0,0,344,0,344,G
1-PB2,2019,0,0,0,343,343,C
1-PB2,2020,346,0,0,0,346,A
1-PB2,2021,0,0,0,361,361,C
1-PB2,2022,0,360,0,0,360,T
1-PB2,2023,0,361,0,0,361,T
1-PB2,2024,0,360,0,0,360,T
1-PB2,2025,361,1,0,0,362,A
1-PB2,2026,359,0,3,0,362,A
1-PB2,2027,0,362,0,0,362,T
1-PB2,2028,328,0,0,0,328,A
1-PB2,2029,0,0,329,0,329,G
1-PB2,2030,324,1,1,0,326,A
1-PB2,2031,328,0,0,0,328,A
1-PB2,2032,0,1,328,0,329,G
1-PB2,2033,335,0,0,0,335,A
1-PB2,2034,0,1,0,335,336,C
1-PB2,2035,2,0,0,327,329,C
1-PB2,2036,0,1,0,329,330,C
1-PB2,2037,328,0,0,0,328,A
1-PB2,2038,0,0,340,0,340,G
1-PB2,2039,340,0,1,0,341,A
1-PB2,2040,0,340,0,0,340,T
1-PB2,2041,0,1,339,0,340,G
1-PB2,2042,331,0,1,0,332,A
1-PB2,2043,334,0,0,0,334,A
1-PB2,2044,336,0,0,0,336,A
1-PB2,2045,0,0,334,0,334,G
1-PB2,2046,0,0,0,334,334,C
1-PB2,2047,323,0,0,0,323,A
1-PB2,2048,0,0,1,325,326,C
1-PB2,2049,327,0,0,0,327,A
1-PB2,2050,0,329,0,0,329,T
1-PB2,2051,0,0,0,329,329,C
1-PB2,2052,0,1,0,328,329,C
1-PB2,2053,0,0,333,0,333,G
1-PB2,2054,0,0,333,0,333,G
1-PB2,2055,330,0,0,0,330,A
1-PB2,2056,0,0,332,0,332,G
1-PB2,2057,0,327,0,0,327,T
1-PB2,2058,0,0,330,0,330,G
1-PB2,2059,0,0,331,0,331,G
1-PB2,2060,321,0,1,0,322,A
1-PB2,2061,0,0,323,0,323,G
1-PB2,2062,0,314,0,0,314,T
1-PB2,2063,0,1,0,314,315,C
1-PB2,2064,0,0,0,314,314,C
1-PB2,2065,1,1,311,0,313,G
1-PB2,2066,0,0,0,315,315,C
1-PB2,2067,1,0,0,311,312,C
1-PB2,2068,1,0,317,0,318,G
1-PB2,2069,0,318,0,0,318,T
1-PB2,2070,0,0,0,321,321,C
1-PB2,2071,0,320,0,0,320,T
1-PB2,2072,0,319,0,1,320,T
1-PB2,2073,0,0,319,0,319,G
1-PB2,2074,316,0,1,0,317,A
1-PB2,2075,0,0,318,0,318,G
1-PB2,2076,316,1,0,0,317,A
1-PB2,2077,0,0,313,0,313,G
1-PB2,2078,0,1,315,0,316,G
1-PB2,2079,0,1,314,0,315,G
1-PB2,2080,0,310,0,1,311,T
1-PB2,2081,0,311,0,0,311,T
1-PB2,2082,0,315,0,0,315,T
1-PB2,2083,0,0,0,317,317,C
1-PB2,2084,1,312,0,0,313,T
1-PB2,2085,1,0,0,319,320,C
1-PB2,2086,316,0,0,0,316,A
1-PB2,2087,0,313,0,1,314,T
1-PB2,2088,0,314,0,0,314,T
1-PB2,2089,313,0,0,0,313,A
1-PB2,2090,0,313,0,0,313,T
1-PB2,2091,310,0,0,0,310,A
1-PB2,2092,0,0,313,0,313,G
1-PB2,2093,0,0,315,0,315,G
1-PB2,2094,0,299,0,0,299,T
1-PB2,2095,298,0,0,0,298,A
1-PB2,2096,297,0,1,0,298,A
1-PB2,2097,0,0,298,0,298,G
1-PB2,2098,0,0,299,0,299,G
1-PB2,2099,297,0,0,0,297,A
1-PB2,2100,292,0,0,0,292,A
1-PB2,2101,0,1,287,0,288,G
1-PB2,2102,281,0,0,0,281,A
1-PB2,2103,0,0,0,282,282,C
1-PB2,2104,276,0,1,0,277,A
1-PB2,2105,0,0,278,0,278,G
1-PB2,2106,275,0,1,0,276,A
1-PB2,2107,271,0,0,0,271,A
1-PB2,2108,0,0,270,0,270,G
1-PB2,2109,266,0,1,0,267,A
1-PB2,2110,0,263,0,0,263,T
1-PB2,2111,261,0,0,0,261,A
1-PB2,2112,1,0,0,262,263,C
1-PB2,2113,0,0,260,0,260,G
1-PB2,2114,0,0,266,0,266,G
1-PB2,2115,264,0,0,0,264,A
1-PB2,2116,0,0,0,263,263,C
1-PB2,2117,0,0,0,263,263,C
1-PB2,2118,257,0,0,0,257,A
1-PB2,2119,0,0,270,0,270,G
1-PB2,2120,0,0,0,272,272,C
1-PB2,2121,269,0,1,0,270,A
1-PB2,2122,0,268,0,0,268,T
1-PB2,2123,0,260,0,0,260,T
1-PB2,2124,261,0,0,0,261,A
1-PB2,2125,259,0,1,0,260,A
1-PB2,2126,0,0,261,0,261,G
1-PB2,2127,0,0,0,262,262,C
1-PB2,2128,245,0,0,0,245,A
1-PB2,2129,0,251,0,0,251,T
1-PB2,2130,1,0,0,250,251,C
1-PB2,2131,252,0,0,0,252,A
1-PB2,2132,252,0,0,0,252,A
1-PB2,2133,0,252,0,0,252,T
1-PB2,2134,0,1,250,0,251,G
1-PB2,2135,247,0,0,0,247,A
1-PB2,2136,248,0,0,0,248,A
1-PB2,2137,0,0,0,252,252,C
1-PB2,2138,0,234,0,0,234,T
1-PB2,2139,0,3,238,0,241,G
1-PB2,2140,241,0,0,0,241,A
1-PB2,2141,0,0,241,0,241,G
1-PB2,2142,0,238,0,0,238,T
1-PB2,2143,237,0,0,0,237,A
1-PB2,2144,238,0,0,0,238,A
1-PB2,2145,1,0,0,239,240,C
1-PB2,2146,0,0,0,233,233,C
1-PB2,2147,0,231,0,0,231,T
1-PB2,2148,0,229,0,0,229,T
1-PB2,2149,0,0,228,0,228,G
1-PB2,2150,0,0,0,226,226,C
1-PB2,2151,226,0,0,0,226,A
1-PB2,2152,226,0,1,0,227,A
1-PB2,2153,225,0,0,0,225,A
1-PB2,2154,222,0,0,0,222,A
1-PB2,2155,0,0,221,0,221,G
1-PB2,2156,0,0,220,0,220,G
1-PB2,2157,0,2,216,0,218,G
1-PB2,2158,0,0,219,0,219,G
1-PB2,2159,215,0,0,0,215,A
1-PB2,2160,217,0,0,0,217,A
1-PB2,2161,217,0,0,0,217,A
1-PB2,2162,216,0,1,0,217,A
1-PB2,2163,0,0,219,0,219,G
1-PB2,2164,0,0,219,0,219,G
1-PB2,2165,0,0,0,218,218,C
1-PB2,2166,0,216,0,0,216,T
1-PB2,2167,215,0,0,0,215,A
1-PB2,2168,215,0,0,0,215,A
1-PB2,2169,0,214,0,0,214,T
1-PB2,2170,0,0,224,0,224,G
1-PB2,2171,0,219,0,0,219,T
1-PB2,2172,0,0,214,0,214,G
1-PB2,2173,0,0,0,214,214,C
1-PB2,2174,0,210,0,0,210,T
1-PB2,2175,211,0,0,0,211,A
1-PB2,2176,212,0,0,0,212,A
1-PB2,2177,0,211,0,0,211,T
1-PB2,2178,0,0,0,212,212,C
1-PB2,2179,0,1,201,0,202,G
1-PB2,2180,0,1,204,0,205,G
1-PB2,2181,0,0,205,0,205,G
1-PB2,2182,0,1,0,201,202,C
1-PB2,2183,204,0,0,0,204,A
1-PB2,2184,200,0,0,0,200,A
1-PB2,2185,0,0,199,0,199,G
1-PB2,2186,0,0,201,0,201,G
1-PB2,2187,201,0,0,0,201,A
1-PB2,2188,0,1,199,0,200,G
1-PB2,2189,197,0,0,0,197,A
1-PB2,2190,0,0,0,195,195,C
1-PB2,2191,0,0,194,0,194,G
1-PB2,2192,0,193,0,0,193,T
1-PB2,2193,0,0,193,0,193,G
1-PB2,2194,0,0,195,0,195,G
1-PB2,2195,0,188,0,0,188,T
1-PB2,2196,0,0,188,0,188,G
1-PB2,2197,0,186,0,0,186,T
1-PB2,2198,0,185,0,0,185,T
1-PB2,2199,0,0,185,0,185,G
1-PB2,2200,0,0,185,0,185,G
1-PB2,2201,0,185,0,0,185,T
1-PB2,2202,182,0,0,0,182,A
1-PB2,2203,179,0,0,0,179,A
1-PB2,2204,0,175,0,0,175,T
1-PB2,2205,0,0,174,0,174,G
1-PB2,2206,174,0,0,0,174,A
1-PB2,2207,170,0,0,0,170,A
1-PB2,2208,171,0,0,0,171,A
1-PB2,2209,0,0,0,173,173,C
1-PB2,2210,0,0,172,0,172,G
1-PB2,2211,171,0,1,0,172,A
1-PB2,2212,172,0,0,0,172,A
1-PB2,2213,172,0,0,0,172,A
1-PB2,2214,172,0,0,0,172,A
1-PB2,2215,0,0,0,172,172,C
1-PB2,2216,0,0,173,0,173,G
1-PB2,2217,0,0,173,0,173,G
1-PB2,2218,0,0,172,0,172,G
1-PB2,2219,172,0,0,0,172,A
1-PB2,2220,0,0,0,177,177,C
1-PB2,2221,0,175,0,0,175,T
1-PB2,2222,0,0,0,177,177,C
1-PB2,2223,0,177,0,0,177,T
1-PB2,2224,177,0,0,0,177,A
1-PB2,2225,0,0,177,0,177,G
1-PB2,2226,0,0,0,173,173,C
1-PB2,2227,172,0,0,0,172,A
1-PB2,2228,0,172,0,0,172,T
1-PB2,2229,169,0,0,0,169,A
1-PB2,2230,0,0,0,170,170,C
1-PB2,2231,0,149,0,2,151,T
1-PB2,2232,0,151,0,0,151,T
1-PB2,2233,147,0,0,0,147,A
1-PB2,2234,0,0,0,148,148,C
1-PB2,2235,0,146,0,0,146,T
1-PB2,2236,0,1,145,0,146,G
1-PB2,2237,147,0,0,0,147,A
1-PB2,2238,0,0,0,146,146,C
1-PB2,2239,135,0,0,1,136,A
1-PB2,2240,0,0,136,0,136,G
1-PB2,2241,0,0,0,135,135,C
1-PB2,2242,0,0,0,136,136,C
1-PB2,2243,133,0,0,1,134,A
1-PB2,2244,0,0,134,0,134,G
1-PB2,2245,132,0,0,1,133,A
1-PB2,2246,1,0,0,132,133,C
1-PB2,2247,122,1,0,0,123,A
1-PB2,2248,0,0,122,0,122,G
1-PB2,2249,0,0,0,112,112,C
1-PB2,2250,1,2,108,0,111,G
1-PB2,2251,109,0,0,1,110,A
1-PB2,2252,0,0,0,111,111,C
1-PB2,2253,1,0,0,109,110,C
1-PB2,2254,111,0,0,0,111,A
1-PB2,2255,111,0,0,0,111,A
1-PB2,2256,109,0,0,1,110,A
1-PB2,2257,110,0,0,0,110,A
1-PB2,2258,0,1,110,0,111,G
1-PB2,2259,109,0,0,0,109,A
1-PB2,2260,109,0,0,0,109,A
1-PB2,2261,0,108,0,0,108,T
1-PB2,2262,0,108,0,0,108,T
1-PB2,2263,0,0,0,108,108,C
1-PB2,2264,0,1,105,1,107,G
1-PB2,2265,0,0,107,0,107,G
1-PB2,2266,107,0,0,0,107,A
1-PB2,2267,0,100,0,0,100,T
1-PB2,2268,0,0,100,0,100,G
1-PB2,2269,1,0,97,0,98,G
1-PB2,2270,0,0,0,97,97,C
1-PB2,2271,0,0,0,96,96,C
1-PB2,2272,97,0,0,0,97,A
1-PB2,2273,0,97,0,0,97,T
1-PB2,2274,0,0,0,96,96,C
1-PB2,2275,96,0,0,0,96,A
1-PB2,2276,96,0,0,0,96,A
1-PB2,2277,0,93,0,0,93,T
1-PB2,2278,0,79,0,0,79,T
1-PB2,2279,76,0,0,0,76,A
1-PB2,2280,75,0,0,0,75,A
2-PB1,1,210,0,0,0,210,A
2-PB1,2,0,211,0,0,211,T
2-PB1,3,0,0,214,0,214,G
2-PB1,4,0,0,233,0,233,G
2-PB1,5,263,0,0,0,263,A
2-PB1,6,0,284,0,0,284,T
2-PB1,7,0,0,289,0,289,G
2-PB1,8,0,289,0,0,289,T
2-PB1,9,0,0,0,314,314,C
2-PB1,10,315,0,0,0,315,A
2-PB1,11,323,0,0,0,323,A
2-PB1,12,0,323,0,0,323,T
2-PB1,13,0,0,0,332,332,C
2-PB1,14,0,0,0,345,345,C
2-PB1,15,0,1,350,0,351,G
2-PB1,16,396,0,0,0,396,A
2-PB1,17,0,0,0,404,404,C
2-PB1,18,0,404,0,0,404,T
2-PB1,19,0,0,0,458,458,C
2-PB1,20,0,457,0,1,458,T
2-PB1,21,465,0,0,0,465,A
2-PB1,22,0,0,0,465,465,C
2-PB1,23,0,465,0,0,465,T
2-PB1,24,0,0,516,0,516,G
2-PB1,25,0,523,0,0,523,T
2-PB1,26,0,522,0,0,522,T
2-PB1,27,2,1,0,518,521,C
2-PB1,28,0,0,0,523,523,C
2-PB1,29,0,614,0,2,616,T
2-PB1,30,620,0,0,0,620,A
2-PB1,31,623,0,0,0,623,A
2-PB1,32,631,0,0,0,631,A
2-PB1,33,0,1,630,0,631,G
2-PB1,34,0,0,635,1,636,G
2-PB1,35,0,639,0,1,640,T
2-PB1,36,0,640,0,0,640,T
2-PB1,37,0,0,0,640,640,C
2-PB1,38,0,0,0,641,641,C
2-PB1,39,639,0,0,1,640,A
2-PB1,40,0,0,653,0,653,G
2-PB1,41,0,0,0,655,655,C
2-PB1,42,0,2,656,0,658,G
2-PB1,43,0,0,0,657,657,C
2-PB1,44,657,0,1,0,658,A
2-PB1,45,659,1,0,1,661,A
2-PB1,46,662,0,0,1,663,A
2-PB1,47,671,1,0,0,672,A
2-PB1,48,0,675,0,0,675,T
2-PB1,49,0,0,705,0,705,G
2-PB1,50,0,0,0,709,709,C
2-PB1,51,2,0,0,707,709,C
2-PB1,52,708,0,0,0,708,A
2-PB1,53,0,716,0,0,716,T
2-PB1,54,770,0,0,0,770,A
2-PB1,55,770,0,1,0,771,A
2-PB1,56,0,1,806,0,807,G
2-PB1,57,0,0,0,809,809,C
2-PB1,58,807,0,0,0,807,A
2-PB1,59,1,0,0,841,842,C
2-PB1,60,843,0,0,0,843,A
2-PB1,61,886,1,0,0,887,A
2-PB1,62,0,0,0,893,893,C
2-PB1,63,894,0,0,0,894,A
2-PB1,64,0,906,0,1,907,T
2-PB1,65,0,900,0,1,901,T
2-PB1,66,1,0,0,1108,1109,C
2-PB1,67,1,0,1,1106,1108,C
2-PB1,68,0,0,0,1123,1123,C
2-PB1,69,0,1142,0,0,1142,T
2-PB1,70,0,1145,0,0,1145,T
2-PB1,71,1247,0,0,0,1247,A
2-PB1,72,0,1254,0,1,1255,T
2-PB1,73,1254,0,1,0,1255,A
2-PB1,74,1,1,0,1263,1265,C
2-PB1,75,2,1229,0,0,1231,T
2-PB1,76,1,3,1238,0,1242,G
2-PB1,77,0,2,1245,0,1247,G
2-PB1,78,1240,2,0,0,1242,A
2-PB1,79,0,3,1247,0,1250,G
2-PB1,80,1238,0,0,0,1238,A
2-PB1,81,0,1249,0,0,1249,T
2-PB1,82,5,0,0,1334,1339,C
2-PB1,83,2,0,0,1341,1343,C
2-PB1,84,0,1347,0,4,1351,T
2-PB1,85,2,0,2,1451,1455,C
2-PB1,86,2,0,0,1462,1464,C
2-PB1,87,1474,0,0,1,1475,A
2-PB1,88,0,1475,0,0,1475,T
2-PB1,89,1477,0,0,0,1477,A
2-PB1,90,1,0,0,1480,1481,C
2-PB1,91,1458,0,1,0,1459,A
2-PB1,92,0,0,1525,0,1525,G
2-PB1,93,3,1,0,1536,1540,C
2-PB1,94,0,0,0,1534,1534,C
2-PB1,95,1539,2,0,0,1541,A
2-PB1,96,0,1541,0,1,1542,T
2-PB1,97,1,4,1534,0,1539,G
2-PB1,98,0,10,1621,0,1631,G
2-PB1,99,1635,0,1,0,1636,A
2-PB1,100,1636,1,2,0,1639,A
2-PB1,101,1,0,0,1642,1643,C
2-PB1,102,1624,0,1,0,1625,A
2-PB1,103,0,1,1666,0,1667,G
2-PB1,104,0,4,1687,1,1692,G
2-PB1,105,1693,0,1,0,1694,A
2-PB1,106,1704,0,2,0,1706,A
2-PB1,107,1,0,0,1711,1712,C
2-PB1,108,1701,0,1,1,1703,A
2-PB1,109,0,3,1919,0,1922,G
2-PB1,110,0,7,1917,0,1924,G
2-PB1,111,1,1,1961,0,1963,G
2-PB1,112,0,1961,0,0,1961,T
2-PB1,113,1958,0,0,0,1958,A
2-PB1,114,0,0,0,1973,1973,C
2-PB1,115,2033,1,2,0,2036,A
2-PB1,116,1,0,0,2120,2121,C
2-PB1,117,3,0,0,2109,2112,C
2-PB1,118,2051,1,0,0,2052,A
2-PB1,119,0,2047,0,1,2048,T
2-PB1,120,1,6,2051,0,2058,G
2-PB1,121,1,8,2051,0,2060,G
2-PB1,122,2061,0,1,0,2062,A
2-PB1,123,0,0,0,2069,2069,C
2-PB1,124,2037,0,1,0,2038,A
2-PB1,125,1,2,0,2072,2075,C
2-PB1,126,2082,0,2,0,2084,A
2-PB1,127,0,0,2137,0,2137,G
2-PB1,128,0,2129,0,2,2131,T
2-PB1,129,7,2,0,2192,2201,C
2-PB1,130,2197,1,2,0,2200,A
2-PB1,131,2223,0,2,0,2225,A
2-PB1,132,0,2,0,2219,2221,C
2-PB1,133,2216,0,1,0,2217,A
2-PB1,134,0,6,2249,0,2255,G
2-PB1,135,2226,1,0,0,2227,A
2-PB1,136,2234,1,0,0,2235,A
2-PB1,137,0,1,0,2236,2237,C
2-PB1,138,2199,1,1,0,2201,A
2-PB1,139,0,3,0,2267,2270,C
2-PB1,140,2264,0,3,0,2267,A
2-PB1,141,2,0,0,2343,2345,C
2-PB1,142,3,0,0,2340,2343,C
2-PB1,143,2343,0,0,0,2343,A
2-PB1,144,2360,1,0,0,2361,A
2-PB1,145,1,2424,0,0,2425,T
2-PB1,146,2493,1,0,0,2494,A
2-PB1,147,0,2498,0,1,2499,T
2-PB1,148,0,2463,0,3,2466,T
2-PB1,149,6,6,0,2459,2471,C
2-PB1,150,2433,0,1,0,2434,A
2-PB1,151,3,4,2428,0,2435,G
2-PB1,152,2419,1,1,0,2421,A
2-PB1,153,0,2,2421,0,2423,G
2-PB1,154,2371,0,2,0,2373,A
2-PB1,155,2,1,2330,0,2333,G
2-PB1,156,1,5,2319,0,2325,G
2-PB1,157,1,3,2407,0,2411,G
2-PB1,158,0,1,2413,1,2415,G
2-PB1,159,0,1,2431,1,2433,G
2-PB1,160,2420,0,0,0,2420,A
2-PB1,161,2432,0,0,0,2432,A
2-PB1,162,1,0,2445,0,2446,G
2-PB1,163,0,2428,0,3,2431,T
2-PB1,164,2,5,2422,0,2429,G
2-PB1,165,0,1,2420,0,2421,G
2-PB1,166,2414,0,2,0,2416,A
2-PB1,167,0,0,0,2426,2426,C
2-PB1,168,2,12,2420,0,2434,G
2-PB1,169,2454,0,2,0,2456,A
2-PB1,170,0,0,0,2471,2471,C
2-PB1,171,2465,0,2,0,2467,A
2-PB1,172,2464,0,1,0,2465,A
2-PB1,173,2475,0,2,0,2477,A
2-PB1,174,0,2521,0,0,2521,T
2-PB1,175,2528,0,0,0,2528,A
2-PB1,176,1,0,0,2535,2536,C
2-PB1,177,2516,0,1,0,2517,A
2-PB1,178,0,7,2522,0,2529,G
2-PB1,179,2527,0,0,0,2527,A
2-PB1,180,2551,0,0,0,2551,A
2-PB1,181,2551,0,0,0,2551,A
2-PB1,182,1,1,0,2559,2561,C
2-PB1,183,0,2525,0,1,2526,T
2-PB1,184,0,2,2522,0,2524,G
2-PB1,185,1,5,2516,1,2523,G
2-PB1,186,1,4,2512,0,2517,G
2-PB1,187,1,2,2517,0,2520,G
2-PB1,188,1,0,0,2519,2520,C
2-PB1,189,2521,0,0,0,2521,A
2-PB1,190,1,0,0,2600,2601,C
2-PB1,191,3,2,1,2592,2598,C
2-PB1,192,7,0,0,2592,2599,C
2-PB1,193,5,1,0,2595,2601,C
2-PB1,194,2624,0,1,0,2625,A
2-PB1,195,2639,0,2,0,2641,A
2-PB1,196,2,0,0,2637,2639,C
2-PB1,197,1,2631,0,0,2632,T
2-PB1,198,9,0,0,2625,2634,C
2-PB1,199,2575,2,0,0,2577,A
2-PB1,200,2618,0,2,0,2620,A
2-PB1,201,4,0,0,2610,2614,C
2-PB1,202,1,0,0,2614,2615,C
2-PB1,203,5,0,0,2620,2625,C
2-PB1,204,2602,0,1,0,2603,A
2-PB1,205,2612,0,0,0,2612,A
2-PB1,206,0,2623,0,1,2624,T
2-PB1,207,0,2627,0,2,2629,T
2-PB1,208,0,6,2621,0,2627,G
2-PB1,209,2599,1,0,0,2600,A
2-PB1,210,1,2605,1,1,2608,T
2-PB1,211,2,6,2600,0,2608,G
2-PB1,212,1,12,2610,0,2623,G
2-PB1,213,2637,3,2,0,2642,A
2-PB1,214,1,1,0,2649,2651,C
2-PB1,215,4,0,0,2628,2632,C
2-PB1,216,2629,0,3,0,2632,A
2-PB1,217,1,0,1,2701,2703,C
2-PB1,218,0,2704,0,1,2705,T
2-PB1,219,2729,1,3,0,2733,A
2-PB1,220,5,2,0,2741,2748,C
2-PB1,221,5,1,1,2715,2722,C
2-PB1,222,0,2686,0,0,2686,T
2-PB1,223,0,4,2700,0,2704,G
2-PB1,224,2695,0,2,0,2697,A
2-PB1,225,0,3,2701,0,2704,G
2-PB1,226,0,9,2682,0,2691,G
2-PB1,227,2686,0,0,0,2686,A
2-PB1,228,0,2668,0,1,2669,T
2-PB1,229,2630,1,0,0,2631,A
2-PB1,230,2625,1,0,1,2627,A
2-PB1,231,0,2624,0,1,2625,T
2-PB1,232,1,11,2614,0,2626,G
2-PB1,233,2626,2,2,0,2630,A
2-PB1,234,2617,1,1,0,2619,A
2-PB1,235,0,0,0,2618,2618,C
2-PB1,236,12,0,0,2564,2576,C
2-PB1,237,2585,0,0,0,2585,A
2-PB1,238,2598,0,2,0,2600,A
2-PB1,239,1,2,2608,1,2612,G
2-PB1,240,2,2603,0,0,2605,T
2-PB1,241,1,2,2604,0,2607,G
2-PB1,242,0,3,2643,0,2646,G
2-PB1,243,2638,0,1,0,2639,A
2-PB1,244,0,2618,0,2,2620,T
2-PB1,245,2625,1,1,1,2628,A
2-PB1,246,1,2660,1,1,2663,T
2-PB1,247,1,5,2671,0,2677,G
2-PB1,248,1,0,0,2670,2671,C
2-PB1,249,2665,2,3,0,2670,A
2-PB1,250,2,1,0,2744,2747,C
2-PB1,251,2694,1,0,0,2695,A
2-PB1,252,2745,0,2,0,2747,A
2-PB1,253,2749,0,1,0,2750,A
2-PB1,254,3,0,0,2754,2757,C
2-PB1,255,2685,0,1,0,2686,A
2-PB1,256,0,7,2712,0,2719,G
2-PB1,257,2702,0,0,0,2702,A
2-PB1,258,1,0,0,2704,2705,C
2-PB1,259,0,2638,0,0,2638,T
2-PB1,260,6,1,2685,0,2692,G
2-PB1,261,0,2659,0,2,2661,T
2-PB1,262,1,2,2770,0,2773,G
2-PB1,263,0,2772,0,1,2773,T
2-PB1,264,12,1,0,2760,2773,C
2-PB1,265,5,0,0,2773,2778,C
2-PB1,266,2,2749,1,4,2756,T
2-PB1,267,1,1,2755,0,2757,G
2-PB1,268,1,5,2750,0,2756,G
2-PB1,269,2715,1,4,0,2720,A
2-PB1,270,0,2,2778,0,2780,G
2-PB1,271,0,1,2691,0,2692,G
2-PB1,272,2,0,0,2694,2696,C
2-PB1,273,0,2677,1,2,2680,T
2-PB1,274,2690,0,0,1,2691,A
2-PB1,275,0,2687,0,1,2688,T
2-PB1,276,1,5,2681,0,2687,G
2-PB1,277,1,0,2689,0,2690,G
2-PB1,278,1,0,1,2676,2678,C
2-PB1,279,1,0,0,2648,2649,C
2-PB1,280,0,2622,0,1,2623,T
2-PB1,281,0,2752,0,0,2752,T
2-PB1,282,1,0,0,2763,2764,C
2-PB1,283,3,0,0,2764,2767,C
2-PB1,284,0,2764,1,0,2765,T
2-PB1,285,0,2764,0,0,2764,T
2-PB1,286,0,6,2772,1,2779,G
2-PB1,287,2776,0,1,0,2777,A
2-PB1,288,2780,0,0,0,2780,A
2-PB1,289,0,10,2776,0,2786,G
2-PB1,290,2668,0,0,0,2668,A
2-PB1,291,2693,0,0,0,2693,A
2-PB1,292,0,2685,1,0,2686,T
2-PB1,293,2,3,0,2682,2687,C
2-PB1,294,5,0,0,2697,2702,C
2-PB1,295,6,1,0,2683,2690,C
2-PB1,296,2704,0,0,0,2704,A
2-PB1,297,3,0,0,2708,2711,C
2-PB1,298,6,5,0,2700,2711,C
2-PB1,299,4,0,0,2721,2725,C
2-PB1,300,2708,0,0,2,2710,A
2-PB1,301,0,3,2730,1,2734,G
2-PB1,302,2,2,2741,1,2746,G
2-PB1,303,0,2734,1,2,2737,T
2-PB1,304,2750,0,2,2,2754,A
2-PB1,305,0,2737,0,1,2738,T
2-PB1,306,2,0,0,2741,2743,C
2-PB1,307,0,2734,0,2,2736,T
2-PB1,308,0,2736,0,0,2736,T
2-PB1,309,1,2727,0,1,2729,T
2-PB1,310,1,4,2721,1,2727,G
2-PB1,311,2700,0,5,0,2705,A
2-PB1,312,0,10,2702,1,2713,G
2-PB1,313,2677,0,3,0,2680,A
2-PB1,314,2694,0,0,0,2694,A
2-PB1,315,0,2,1,2715,2718,C
2-PB1,316,0,2687,0,1,2688,T
2-PB1,317,9,1,0,2685,2695,C
2-PB1,318,2686,0,2,0,2688,A
2-PB1,319,1,2694,0,1,2696,T
2-PB1,320,0,1,2701,0,2702,G
2-PB1,321,0,2,0,2739,2741,C
2-PB1,322,6,0,0,2736,2742,C
2-PB1,323,0,2720,1,1,2722,T
2-PB1,324,1,2701,0,3,2705,T
2-PB1,325,2,7,2710,0,2719,G
2-PB1,326,2734,1,2,0,2737,A
2-PB1,327,2741,0,1,0,2742,A
2-PB1,328,2740,1,0,0,2741,A
2-PB1,329,1,0,0,2756,2757,C
2-PB1,330,2688,0,2,0,2690,A
2-PB1,331,2700,0,1,0,2701,A
2-PB1,332,0,2704,0,0,2704,T
2-PB1,333,1,1,2706,0,2708,G
2-PB1,334,1,4,2684,0,2689,G
2-PB1,335,2667,0,1,0,2668,A
2-PB1,336,2663,0,2,0,2665,A
2-PB1,337,1,1,2664,0,2666,G
2-PB1,338,1,1,0,2671,2673,C
2-PB1,339,2,1,0,2642,2645,C
2-PB1,340,2,0,2669,0,2671,G
2-PB1,341,0,2667,0,1,2668,T
2-PB1,342,0,2666,1,0,2667,T
2-PB1,343,16,0,0,2670,2686,C
2-PB1,344,2689,0,1,0,2690,A
2-PB1,345,2715,1,1,0,2717,A
2-PB1,346,0,0,0,2722,2722,C
2-PB1,347,2726,0,1,0,2727,A
2-PB1,348,0,4,2738,0,2742,G
2-PB1,349,2684,1,0,1,2686,A
2-PB1,350,0,0,0,2687,2687,C
2-PB1,351,2682,0,0,0,2682,A
2-PB1,352,2692,0,5,0,2697,A
2-PB1,353,0,6,2713,1,2720,G
2-PB1,354,0,3,2696,0,2699,G
2-PB1,355,0,3,2701,0,2704,G
2-PB1,356,0,2645,0,3,2648,T
2-PB1,357,0,5,2642,0,2647,G
2-PB1,358,0,7,2648,0,2655,G
2-PB1,359,2647,0,4,0,2651,A
2-PB1,360,1,1,0,2650,2652,C
2-PB1,361,2606,0,0,0,2606,A
2-PB1,362,2642,0,0,1,2643,A
2-PB1,363,2641,0,1,0,2642,A
2-PB1,364,2,1,0,2630,2633,C
2-PB1,365,0,2623,0,3,2626,T
2-PB1,366,2616,0,0,0,2616,A
2-PB1,367,2640,0,0,0,2640,A
2-PB1,368,2,1,0,2640,2643,C
2-PB1,369,3,0,0,2643,2646,C
2-PB1,370,12,1,0,2627,2640,C
2-PB1,371,2576,0,0,0,2576,A
2-PB1,372,2574,0,2,0,2576,A
2-PB1,373,0,3,2569,0,2572,G
2-PB1,374,0,0,2581,0,2581,G
2-PB1,375,0,2578,0,3,2581,T
2-PB1,376,7,1,0,2545,2553,C
2-PB1,377,2,2,2547,1,2552,G
2-PB1,378,1,2,0,2536,2539,C
2-PB1,379,4,0,0,2553,2557,C
2-PB1,380,2558,1,0,0,2559,A
2-PB1,381,0,10,2599,0,2609,G
2-PB1,382,2654,1,1,0,2656,A
2-PB1,383,2,0,1,2648,2651,C
2-PB1,384,0,2635,0,1,2636,T
2-PB1,385,1,2624,1,0,2626,T
2-PB1,386,2635,0,2,1,2638,A
2-PB1,387,0,2640,0,0,2640,T
2-PB1,388,1,4,2641,0,2646,G
2-PB1,389,2638,0,0,1,2639,A
2-PB1,390,0,2578,0,0,2578,T
2-PB1,391,2,2501,0,1,2504,T
2-PB1,392,1,6,2490,0,2497,G
2-PB1,393,0,3,2497,0,2500,G
2-PB1,394,2520,0,1,0,2521,A
2-PB1,395,2,0,0,2515,2517,C
2-PB1,396,2486,1,0,0,2487,A
2-PB1,397,1,2461,0,1,2463,T
2-PB1,398,1,2489,0,0,2490,T
2-PB1,399,2500,0,1,1,2502,A
2-PB1,400,2499,1,0,0,2500,A
2-PB1,401,2496,0,1,1,2498,A
2-PB1,402,1,0,0,2499,2500,C
2-PB1,403,2435,0,1,1,2437,A
2-PB1,404,0,1,2458,1,2460,G
2-PB1,405,2442,1,0,0,2443,A
2-PB1,406,2448,1,0,0,2449,A
2-PB1,407,2444,0,2,0,2446,A
2-PB1,408,0,2430,0,0,2430,T
2-PB1,409,14,0,0,2426,2440,C
2-PB1,410,2430,0,0,0,2430,A
2-PB1,411,2438,0,0,0,2438,A
2-PB1,412,2,0,0,2430,2432,C
2-PB1,413,4,2,0,2411,2417,C
2-PB1,414,1,3,2411,0,2415,G
2-PB1,415,0,0,2417,0,2417,G
2-PB1,416,1,1,0,2424,2426,C
2-PB1,417,2423,0,1,0,2424,A
2-PB1,418,1,0,2424,0,2425,G
2-PB1,419,1,0,0,2437,2438,C
2-PB1,420,2437,0,0,0,2437,A
2-PB1,421,2439,0,0,0,2439,A
2-PB1,422,0,0,0,2444,2444,C
2-PB1,423,0,2421,0,3,2424,T
2-PB1,424,1,1,2496,0,2498,G
2-PB1,425,2,0,0,2487,2489,C
2-PB1,426,2489,1,3,0,2493,A
2-PB1,427,0,2494,0,0,2494,T
2-PB1,428,0,2461,0,0,2461,T
2-PB1,429,2606,0,1,1,2608,A
2-PB1,430,0,0,2611,0,2611,G
2-PB1,431,1,1,0,2595,2597,C
2-PB1,432,1,0,0,2594,2595,C
2-PB1,433,2506,1,1,0,2508,A
2-PB1,434,2519,0,2,0,2521,A
2-PB1,435,3,1,0,2528,2532,C
2-PB1,436,2538,0,1,0,2539,A
2-PB1,437,1,0,1,2600,2602,C
2-PB1,438,7,0,1,2433,2441,C
2-PB1,439,2440,0,1,0,2441,A
2-PB1,440,1,2440,0,1,2442,T
2-PB1,441,2445,0,0,0,2445,A
2-PB1,442,0,4,2448,0,2452,G
2-PB1,443,2425,1,1,1,2428,A
2-PB1,444,2394,0,1,0,2395,A
2-PB1,445,0,0,2409,0,2409,G
2-PB1,446,1,2327,0,0,2328,T
2-PB1,447,1,2323,0,1,2325,T
2-PB1,448,1,2329,0,0,2330,T
2-PB1,449,0,2330,0,0,2330,T
2-PB1,450,0,2339,0,0,2339,T
2-PB1,451,2330,1,0,0,2331,A
2-PB1,452,0,3,2329,0,2332,G
2-PB1,453,2323,0,1,0,2324,A
2-PB1,454,0,2315,0,1,2316,T
2-PB1,455,6,6,0,2269,2281,C
2-PB1,456,0,10,2286,0,2296,G
2-PB1,457,2292,1,2,0,2295,A
2-PB1,458,2293,2,1,0,2296,A
2-PB1,459,3,1,0,2303,2307,C
2-PB1,460,11,6,2289,0,2306,G
2-PB1,461,0,3,2395,0,2398,G
2-PB1,462,2398,0,1,0,2399,A
2-PB1,463,0,2393,0,1,2394,T
2-PB1,464,0,2392,0,1,2393,T
2-PB1,465,2392,1,5,0,2398,A
2-PB1,466,2396,1,1,0,2398,A
2-PB1,467,0,0,0,2411,2411,C
2-PB1,468,2385,0,3,0,2388,A
2-PB1,469,1,0,2401,0,2402,G
2-PB1,470,0,0,0,2300,2300,C
2-PB1,471,0,2286,0,1,2287,T
2-PB1,472,2290,0,0,0,2290,A
2-PB1,473,2287,0,1,0,2288,A
2-PB1,474,1,2286,0,2,2289,T
2-PB1,475,0,11,2300,0,2311,G
2-PB1,476,2295,0,0,0,2295,A
2-PB1,477,2300,0,2,0,2302,A
2-PB1,478,0,2271,0,0,2271,T
2-PB1,479,13,1,0,2261,2275,C
2-PB1,480,2268,1,0,0,2269,A
2-PB1,481,1,4,2267,0,2272,G
2-PB1,482,0,1,2269,0,2270,G
2-PB1,483,2267,0,1,0,2268,A
2-PB1,484,2237,0,1,0,2238,A
2-PB1,485,1,2,2311,0,2314,G
2-PB1,486,12,1,2306,0,2319,G
2-PB1,487,0,0,0,2320,2320,C
2-PB1,488,0,2314,0,2,2316,T
2-PB1,489,2312,0,0,0,2312,A
2-PB1,490,2315,0,0,0,2315,A
2-PB1,491,0,2316,0,1,2317,T
2-PB1,492,2316,1,0,0,2317,A
2-PB1,493,0,7,2321,1,2329,G
2-PB1,494,2183,0,0,0,2183,A
2-PB1,495,0,2164,0,0,2164,T
2-PB1,496,0,2146,0,0,2146,T
2-PB1,497,0,2158,0,0,2158,T
2-PB1,498,4,0,0,2216,2220,C
2-PB1,499,2,1,0,2226,2229,C
2-PB1,500,1,2223,0,3,2227,T
2-PB1,501,9,1,0,2229,2239,C
2-PB1,502,2230,0,0,0,2230,A
2-PB1,503,2230,1,2,0,2233,A
2-PB1,504,0,7,2235,0,2242,G
2-PB1,505,0,6,2253,0,2259,G
2-PB1,506,2259,0,2,0,2261,A
2-PB1,507,0,2187,0,0,2187,T
2-PB1,508,0,0,2204,0,2204,G
2-PB1,509,0,2195,0,1,2196,T
2-PB1,510,2,5,2211,0,2218,G
2-PB1,511,2212,0,6,0,2218,A
2-PB1,512,1,2202,0,0,2203,T
2-PB1,513,1,1,2194,0,2196,G
2-PB1,514,0,4,2172,1,2177,G
2-PB1,515,2175,0,1,0,2176,A
2-PB1,516,2178,0,0,0,2178,A
2-PB1,517,0,2151,0,0,2151,T
2-PB1,518,8,0,0,2145,2153,C
2-PB1,519,2128,0,0,0,2128,A
2-PB1,520,2133,0,1,0,2134,A
2-PB1,521,1,2133,0,1,2135,T
2-PB1,522,2,3,2160,0,2165,G
2-PB1,523,0,2,2163,0,2165,G
2-PB1,524,2161,0,2,0,2163,A
2-PB1,525,0,2156,0,1,2157,T
2-PB1,526,2155,0,0,0,2155,A
2-PB1,527,2150,0,0,0,2150,A
2-PB1,528,2140,0,1,0,2141,A
2-PB1,529,0,2,2171,0,2173,G
2-PB1,530,2153,0,4,0,2157,A
2-PB1,531,0,5,2136,0,2141,G
2-PB1,532,0,2,2145,1,2148,G
2-PB1,533,2137,0,3,0,2140,A
2-PB1,534,2135,0,3,0,2138,A
2-PB1,535,2143,1,0,0,2144,A
2-PB1,536,0,2144,0,1,2145,T
2-PB1,537,0,4,2168,0,2172,G
2-PB1,538,0,6,2159,0,2165,G
2-PB1,539,2138,0,2,2,2142,A
2-PB1,540,0,3,2160,0,2163,G
2-PB1,541,2131,1,1,0,2133,A
2-PB1,542,0,2168,0,0,2168,T
2-PB1,543,2173,0,0,0,2173,A
2-PB1,544,2190,0,1,0,2191,A
2-PB1,545,0,0,0,2207,2207,C
2-PB1,546,2174,1,0,1,2176,A
2-PB1,547,2181,0,1,0,2182,A
2-PB1,548,1,0,0,2174,2175,C
2-PB1,549,2164,0,0,0,2164,A
2-PB1,550,2,1,0,2163,2166,C
2-PB1,551,2116,0,0,0,2116,A
2-PB1,552,0,0,0,2137,2137,C
2-PB1,553,0,2111,1,0,2112,T
2-PB1,554,0,2103,0,1,2104,T
2-PB1,555,0,2108,0,0,2108,T
2-PB1,556,9,1,0,2089,2099,C
2-PB1,557,2097,0,0,0,2097,A
2-PB1,558,2096,1,1,1,2099,A
2-PB1,559,2101,0,1,0,2102,A
2-PB1,560,0,8,2117,0,2125,G
2-PB1,561,2095,0,1,1,2097,A
2-PB1,562,2100,0,0,0,2100,A
2-PB1,563,2095,1,1,0,2097,A
2-PB1,564,2092,1,5,0,2098,A
2-PB1,565,2092,0,1,0,2093,A
2-PB1,566,0,1,2106,0,2107,G
2-PB1,567,0,3,2100,0,2103,G
2-PB1,568,2083,0,2,0,2085,A
2-PB1,569,0,3,2121,0,2124,G
2-PB1,570,2112,0,4,0,2116,A
2-PB1,571,1,1,2184,0,2186,G
2-PB1,572,0,2184,0,0,2184,T
2-PB1,573,2181,0,2,0,2183,A
2-PB1,574,2187,0,3,1,2191,A
2-PB1,575,0,3,2186,0,2189,G
2-PB1,576,1,4,2204,0,2209,G
2-PB1,577,0,6,2205,0,2211,G
2-PB1,578,2173,2,0,0,2175,A
2-PB1,579,0,1,0,2185,2186,C
2-PB1,580,2124,0,1,0,2125,A
2-PB1,581,2139,0,1,0,2140,A
2-PB1,582,1,0,0,2137,2138,C
2-PB1,583,2132,1,1,0,2134,A
2-PB1,584,0,2108,1,0,2109,T
2-PB1,585,2,7,2083,0,2092,G
2-PB1,586,2096,1,2,0,2099,A
2-PB1,587,1,1,0,2090,2092,C
2-PB1,588,6,1,0,2046,2053,C
2-PB1,589,2048,0,1,0,2049,A
2-PB1,590,2050,0,0,0,2050,A
2-PB1,591,0,5,2054,0,2059,G
2-PB1,592,2057,1,0,0,2058,A
2-PB1,593,2055,0,1,0,2056,A
2-PB1,594,2036,0,0,0,2036,A
2-PB1,595,2028,0,0,2,2030,A
2-PB1,596,1,2033,0,0,2034,T
2-PB1,597,2,2,2025,0,2029,G
2-PB1,598,0,0,2040,0,2040,G
2-PB1,599,0,1995,0,4,1999,T
2-PB1,600,14,2,0,1959,1975,C
2-PB1,601,1988,0,1,0,1989,A
2-PB1,602,1,1,0,2182,2184,C
2-PB1,603,2246,0,1,0,2247,A
2-PB1,604,2,2,0,2257,2261,C
2-PB1,605,2257,0,0,0,2257,A
2-PB1,606,2369,1,2,0,2372,A
2-PB1,607,2355,1,2,2,2360,A
2-PB1,608,0,12,2557,0,2569,G
2-PB1,609,2569,0,1,1,2571,A
2-PB1,610,2586,1,1,1,2589,A
2-PB1,611,2,0,0,2696,2698,C
2-PB1,612,2636,0,0,0,2636,A
2-PB1,613,2669,1,1,0,2671,A
2-PB1,614,0,2657,0,1,2658,T
2-PB1,615,2632,0,2,0,2634,A
2-PB1,616,2,4,2633,0,2639,G
2-PB1,617,2,3,2570,0,2575,G
2-PB1,618,0,11,2571,0,2582,G
2-PB1,619,2574,0,3,0,2577,A
2-PB1,620,2543,0,1,1,2545,A
2-PB1,621,0,9,2578,0,2587,G
2-PB1,622,2587,0,0,1,2588,A
2-PB1,623,2601,0,0,0,2601,A
2-PB1,624,2609,1,0,0,2610,A
2-PB1,625,2617,1,0,2,2620,A
2-PB1,626,2687,0,2,0,2689,A
2-PB1,627,2699,1,2,0,2702,A
2-PB1,628,0,0,0,2706,2706,C
2-PB1,629,2699,0,0,0,2699,A
2-PB1,630,2693,0,0,1,2694,A
2-PB1,631,2695,0,1,0,2696,A
2-PB1,632,0,13,2736,1,2750,G
2-PB1,633,2743,0,1,0,2744,A
2-PB1,634,0,0,2812,0,2812,G
2-PB1,635,0,2788,0,1,2789,T
2-PB1,636,0,13,2977,0,2990,G
2-PB1,637,2994,0,3,0,2997,A
2-PB1,638,3004,0,0,0,3004,A
2-PB1,639,1,3080,1,1,3083,T
2-PB1,640,3108,1,1,0,3110,A
2-PB1,641,3091,1,3,0,3095,A
2-PB1,642,1,8,3090,0,3099,G
2-PB1,643,3065,0,1,0,3066,A
2-PB1,644,2958,0,1,0,2959,A
2-PB1,645,3007,1,1,1,3010,A
2-PB1,646,1,2,3043,1,3047,G
2-PB1,647,0,0,3057,0,3057,G
2-PB1,648,0,0,0,3049,3049,C
2-PB1,649,0,3037,0,1,3038,T
2-PB1,650,3140,0,1,0,3141,A
2-PB1,651,2,1,0,3333,3336,C
2-PB1,652,8,0,0,3341,3349,C
2-PB1,653,0,3380,1,4,3385,T
2-PB1,654,3549,0,0,0,3549,A
2-PB1,655,3546,0,1,0,3547,A
2-PB1,656,0,3550,1,0,3551,T
2-PB1,657,3545,0,0,0,3545,A
2-PB1,658,3533,1,1,0,3535,A
2-PB1,659,0,8,3548,0,3556,G
2-PB1,660,3465,0,6,0,3471,A
2-PB1,661,1,1,3506,0,3508,G
2-PB1,662,0,0,0,3542,3542,C
2-PB1,663,0,3481,0,1,3482,T
2-PB1,664,2,3497,0,0,3499,T
2-PB1,665,0,3499,0,3,3502,T
2-PB1,666,3,23,3483,0,3509,G
2-PB1,667,3580,0,0,0,3580,A
2-PB1,668,0,3,0,3607,3610,C
2-PB1,669,3612,0,1,0,3613,A
2-PB1,670,0,3604,0,2,3606,T
2-PB1,671,3,3597,0,0,3600,T
2-PB1,672,0,18,3688,1,3707,G
2-PB1,673,3699,0,5,0,3704,A
2-PB1,674,3708,0,1,0,3709,A
2-PB1,675,4,3,3,3718,3728,C
2-PB1,676,3688,0,3,0,3691,A
2-PB1,677,1,3,0,3691,3695,C
2-PB1,678,6,12,3675,0,3693,G
2-PB1,679,3712,0,5,0,3717,A
2-PB1,680,0,3726,0,3,3729,T
2-PB1,681,3,26,3790,0,3819,G
2-PB1,682,3821,1,4,0,3826,A
2-PB1,683,4,0,0,3848,3852,C
2-PB1,684,8,1,0,3835,3844,C
2-PB1,685,3854,0,0,0,3854,A
2-PB1,686,3905,2,3,0,3910,A
2-PB1,687,3900,0,3,0,3903,A
2-PB1,688,1,5,4022,0,4028,G
2-PB1,689,4085,2,5,0,4092,A
2-PB1,690,0,4061,0,2,4063,T
2-PB1,691,2,2,4069,0,4073,G
2-PB1,692,0,3,0,4065,4068,C
2-PB1,693,4058,2,6,0,4066,A
2-PB1,694,0,6,4091,1,4098,G
2-PB1,695,4051,2,2,1,4056,A
2-PB1,696,0,6,4058,0,4064,G
2-PB1,697,3985,0,1,1,3987,A
2-PB1,698,1,8,3980,0,3989,G
2-PB1,699,3939,0,12,0,3951,A
2-PB1,700,3,8,3946,0,3957,G
2-PB1,701,1,4,3948,0,3953,G
2-PB1,702,4,2,0,3944,3950,C
2-PB1,703,3929,0,0,0,3929,A
2-PB1,704,3942,1,1,0,3944,A
2-PB1,705,3977,0,2,0,3979,A
2-PB1,706,1,3988,0,2,3991,T
2-PB1,707,1,3976,0,0,3977,T
2-PB1,708,3981,4,1,0,3986,A
2-PB1,709,3976,1,1,1,3979,A
2-PB1,710,3989,0,1,0,3990,A
2-PB1,711,4009,0,0,0,4009,A
2-PB1,712,4008,0,2,0,4010,A
2-PB1,713,0,8,4013,0,4021,G
2-PB1,714,3984,0,1,0,3985,A
2-PB1,715,3980,0,6,0,3986,A
2-PB1,716,0,9,4055,0,4064,G
2-PB1,717,1,9,4142,0,4152,G
2-PB1,718,0,1,4160,0,4161,G
2-PB1,719,2,1,1,4197,4201,C
2-PB1,720,0,4180,0,1,4181,T
2-PB1,721,4221,1,0,1,4223,A
2-PB1,722,1,4282,0,2,4285,T
2-PB1,723,1,4302,0,1,4304,T
2-PB1,724,10,0,4318,0,4328,G
2-PB1,725,0,6,0,4296,4302,C
2-PB1,726,4208,0,8,0,4216,A
2-PB1,727,4231,0,0,0,4231,A
2-PB1,728,1,0,0,4238,4239,C
2-PB1,729,4237,1,2,0,4240,A
2-PB1,730,4,0,1,4248,4253,C
2-PB1,731,7,0,0,4146,4153,C
2-PB1,732,6,0,0,4165,4171,C
2-PB1,733,1,3,4151,0,4155,G
2-PB1,734,1,7,4158,1,4167,G
2-PB1,735,0,13,4161,0,4174,G
2-PB1,736,4186,1,5,0,4192,A
2-PB1,737,2,4158,0,2,4162,T
2-PB1,738,3,1,4178,0,4182,G
2-PB1,739,2,0,1,4159,4162,C
2-PB1,740,4216,1,2,0,4219,A
2-PB1,741,4309,0,0,0,4309,A
2-PB1,742,4359,1,0,0,4360,A
2-PB1,743,0,4359,0,0,4359,T
2-PB1,744,0,4364,0,0,4364,T
2-PB1,745,4329,0,0,1,4330,A
2-PB1,746,8,2,4319,0,4329,G
2-PB1,747,4294,1,5,1,4301,A
2-PB1,748,0,8,4313,1,4322,G
2-PB1,749,0,12,4253,0,4265,G
2-PB1,750,2,5,4398,0,4405,G
2-PB1,751,0,4381,0,3,4384,T
2-PB1,752,0,4390,0,3,4393,T
2-PB1,753,19,2,1,4382,4404,C
2-PB1,754,3,2,4475,0,4480,G
2-PB1,755,0,4465,0,3,4468,T
2-PB1,756,2,0,4478,0,4480,G
2-PB1,757,0,4473,0,2,4475,T
2-PB1,758,4455,0,5,0,4460,A
2-PB1,759,4,0,0,4449,4453,C
2-PB1,760,0,4254,0,1,4255,T
2-PB1,761,0,4289,0,1,4290,T
2-PB1,762,12,6,0,4248,4266,C
2-PB1,763,1,1,4240,1,4243,G
2-PB1,764,2,4233,0,0,4235,T
2-PB1,765,0,4234,0,3,4237,T
2-PB1,766,1,12,4229,0,4242,G
2-PB1,767,4238,0,1,0,4239,A
2-PB1,768,4227,0,4,0,4231,A
2-PB1,769,4281,0,4,0,4285,A
2-PB1,770,2,0,0,4303,4305,C
2-PB1,771,0,4277,0,0,4277,T
2-PB1,772,1,4265,0,0,4266,T
2-PB1,773,1,4269,0,2,4272,T
2-PB1,774,4348,1,4,1,4354,A
2-PB1,775,0,0,4369,1,4370,G
2-PB1,776,0,0,0,4377,4377,C
2-PB1,777,0,4375,0,1,4376,T
2-PB1,778,4349,1,4,0,4354,A
2-PB1,779,0,5,4337,0,4342,G
2-PB1,780,4339,0,0,0,4339,A
2-PB1,781,4332,0,2,0,4334,A
2-PB1,782,0,3,4353,0,4356,G
2-PB1,783,2,2,0,4290,4294,C
2-PB1,784,4288,0,0,1,4289,A
2-PB1,785,1,4271,0,0,4272,T
2-PB1,786,1,4270,0,0,4271,T
2-PB1,787,1,4270,0,0,4271,T
2-PB1,788,0,3,4274,0,4277,G
2-PB1,789,3,4,0,4276,4283,C
2-PB1,790,4,16,4268,0,4288,G
2-PB1,791,4274,1,2,0,4277,A
2-PB1,792,4261,0,2,1,4264,A
2-PB1,793,4261,0,1,2,4264,A
2-PB1,794,4399,0,1,0,4400,A
2-PB1,795,0,0,4466,0,4466,G
2-PB1,796,0,0,0,4475,4475,C
2-PB1,797,0,4478,0,2,4480,T
2-PB1,798,1,4472,0,3,4476,T
2-PB1,799,8,27,4448,0,4483,G
2-PB1,800,4479,1,9,0,4489,A
2-PB1,801,4479,3,4,0,4486,A
2-PB1,802,1,1,1,4517,4520,C
2-PB1,803,4418,4,1,0,4423,A
2-PB1,804,1,1,4861,0,4863,G
2-PB1,805,0,4821,0,3,4824,T
2-PB1,806,21,0,0,4811,4832,C
2-PB1,807,1,4838,0,3,4842,T
2-PB1,808,11,8,4832,0,4851,G
2-PB1,809,0,12,4842,0,4854,G
2-PB1,810,4867,0,0,0,4867,A
2-PB1,811,1,0,0,4876,4877,C
2-PB1,812,0,4708,0,6,4714,T
2-PB1,813,2,4440,0,4,4446,T
2-PB1,814,7,0,0,4434,4441,C
2-PB1,815,5,2,0,4443,4450,C
2-PB1,816,3,8,4461,0,4472,G
2-PB1,817,4,5,4481,0,4490,G
2-PB1,818,1,4462,1,0,4464,T
2-PB1,819,0,4449,0,2,4451,T
2-PB1,820,0,6,4428,0,4434,G
2-PB1,821,4,6,4439,2,4451,G
2-PB1,822,0,8,4475,0,4483,G
2-PB1,823,1,11,4460,1,4473,G
2-PB1,824,5,4,4492,0,4501,G
2-PB1,825,0,4478,0,1,4479,T
2-PB1,826,4462,1,4,0,4467,A
2-PB1,827,4486,2,2,2,4492,A
2-PB1,828,0,4500,0,0,4500,T
2-PB1,829,8,12,4493,0,4513,G
2-PB1,830,4461,1,1,0,4463,A
2-PB1,831,4416,0,2,0,4418,A
2-PB1,832,4420,0,0,0,4420,A
2-PB1,833,4401,0,5,0,4406,A
2-PB1,834,0,5,4407,0,4412,G
2-PB1,835,4362,0,3,0,4365,A
2-PB1,836,4337,0,7,1,4345,A
2-PB1,837,1,4,4361,0,4366,G
2-PB1,838,2,2,4355,0,4359,G
2-PB1,839,5,1,0,4352,4358,C
2-PB1,840,8,3,0,4329,4340,C
2-PB1,841,4345,0,2,1,4348,A
2-PB1,842,4345,0,0,1,4346,A
2-PB1,843,4351,0,2,0,4353,A
2-PB1,844,1,0,0,4359,4360,C
2-PB1,845,0,4347,0,3,4350,T
2-PB1,846,4,9,4404,0,4417,G
2-PB1,847,1,3,4411,0,4415,G
2-PB1,848,1,0,0,4419,4420,C
2-PB1,849,4429,0,1,0,4430,A
2-PB1,850,4419,0,1,0,4420,A
2-PB1,851,4427,0,0,0,4427,A
2-PB1,852,0,4419,0,1,4420,T
2-PB1,853,1,1,4437,0,4439,G
2-PB1,854,1,4425,0,3,4429,T
2-PB1,855,1,4314,0,1,4316,T
2-PB1,856,0,3,4316,0,4319,G
2-PB1,857,1,4305,1,0,4307,T
2-PB1,858,1,20,4297,0,4318,G
2-PB1,859,4321,2,2,0,4325,A
2-PB1,860,0,11,4337,0,4348,G
2-PB1,861,4344,1,1,1,4347,A
2-PB1,862,4323,1,0,0,4324,A
2-PB1,863,4320,2,0,0,4322,A
2-PB1,864,4330,1,1,0,4332,A
2-PB1,865,4346,1,0,3,4350,A
2-PB1,866,1,4341,1,1,4344,T
2-PB1,867,0,12,4325,0,4337,G
2-PB1,868,4335,0,1,0,4336,A
2-PB1,869,0,4298,0,1,4299,T
2-PB1,870,3,22,4313,0,4338,G
2-PB1,871,4333,2,6,0,4341,A
2-PB1,872,3,1,0,4389,4393,C
2-PB1,873,1,4377,1,1,4380,T
2-PB1,874,4370,1,1,0,4372,A
2-PB1,875,4412,2,0,0,4414,A
2-PB1,876,3,4409,0,4,4416,T
2-PB1,877,2,4461,0,4,4467,T
2-PB1,878,16,4,0,4467,4487,C
2-PB1,879,4482,1,4,0,4487,A
2-PB1,880,1,2,0,4495,4498,C
2-PB1,881,4441,1,5,0,4447,A
2-PB1,882,4456,1,3,0,4460,A
2-PB1,883,0,15,4456,0,4471,G
2-PB1,884,4536,0,1,0,4537,A
2-PB1,885,1,2,0,4528,4531,C
2-PB1,886,4493,1,2,0,4496,A
2-PB1,887,2,1,0,4487,4490,C
2-PB1,888,4448,1,2,1,4452,A
2-PB1,889,1,10,4468,4,4483,G
2-PB1,890,4461,1,3,2,4467,A
2-PB1,891,1,0,4482,0,4483,G
2-PB1,892,1,2,0,4458,4461,C
2-PB1,893,0,4358,3,7,4368,T
2-PB1,894,0,4409,1,2,4412,T
2-PB1,895,0,4417,0,1,4418,T
2-PB1,896,12,1,0,4424,4437,C
2-PB1,897,0,4423,0,0,4423,T
2-PB1,898,0,4404,1,1,4406,T
2-PB1,899,1,4391,0,2,4394,T
2-PB1,900,6,4,0,4408,4418,C
2-PB1,901,4401,1,5,1,4408,A
2-PB1,902,3,1,1,4430,4435,C
2-PB1,903,4388,2,2,1,4393,A
2-PB1,904,4430,0,0,0,4430,A
2-PB1,905,1,4464,1,2,4468,T
2-PB1,906,18,1,0,4492,4511,C
2-PB1,907,4536,1,1,0,4538,A
2-PB1,908,0,4,0,4551,4555,C
2-PB1,909,0,4517,1,3,4521,T
2-PB1,910,2,6,4542,1,4551,G
2-PB1,911,0,7,4519,0,4526,G
2-PB1,912,1,9,4632,0,4642,G
2-PB1,913,3,13,4616,0,4632,G
2-PB1,914,4562,0,6,0,4568,A
2-PB1,915,1,2,0,4390,4393,C
2-PB1,916,4446,1,3,1,4451,A
2-PB1,917,4753,0,7,1,4761,A
2-PB1,918,2,0,0,4807,4809,C
2-PB1,919,4797,2,4,0,4803,A
2-PB1,920,2,0,0,4786,4788,C
2-PB1,921,1,4587,0,1,4589,T
2-PB1,922,4601,0,0,0,4601,A
2-PB1,923,4599,0,2,0,4601,A
2-PB1,924,1,3,4635,0,4639,G
2-PB1,925,0,4615,0,1,4616,T
2-PB1,926,2,9,4316,1,4328,G
2-PB1,927,0,8,4284,0,4292,G
2-PB1,928,4267,0,5,0,4272,A
2-PB1,929,4275,0,2,0,4277,A
2-PB1,930,0,4275,0,1,4276,T
2-PB1,931,1,16,4252,0,4269,G
2-PB1,932,4260,2,2,1,4265,A
2-PB1,933,4206,0,0,0,4206,A
2-PB1,934,4225,0,1,1,4227,A
2-PB1,935,4247,1,1,0,4249,A
2-PB1,936,1,4228,0,2,4231,T
2-PB1,937,22,0,0,4220,4242,C
2-PB1,938,4242,0,1,1,4244,A
2-PB1,939,4241,1,1,0,4243,A
2-PB1,940,4228,0,3,0,4231,A
2-PB1,941,4232,0,5,1,4238,A
2-PB1,942,3,0,0,4258,4261,C
2-PB1,943,8,0,0,4216,4224,C
2-PB1,944,4,1,0,4213,4218,C
2-PB1,945,0,4209,0,4,4213,T
2-PB1,946,10,5,0,4212,4227,C
2-PB1,947,0,11,4212,0,4223,G
2-PB1,948,4225,2,0,0,4227,A
2-PB1,949,4228,1,0,1,4230,A
2-PB1,950,1,4226,0,1,4228,T
2-PB1,951,1,3,4249,0,4253,G
2-PB1,952,0,4209,0,3,4212,T
2-PB1,953,1,4205,1,2,4209,T
2-PB1,954,1,4214,0,0,4215,T
2-PB1,955,1,4209,0,2,4212,T
2-PB1,956,1,4210,0,2,4213,T
2-PB1,957,4,7,4197,0,4208,G
2-PB1,958,1,3,4201,0,4205,G
2-PB1,959,0,2,0,4197,4199,C
2-PB1,960,2,8,4153,0,4163,G
2-PB1,961,4151,1,1,0,4153,A
2-PB1,962,0,4316,0,1,4317,T
2-PB1,963,1,11,4459,0,4471,G
2-PB1,964,4669,2,1,0,4672,A
2-PB1,965,0,4690,0,3,4693,T
2-PB1,966,0,4690,0,2,4692,T
2-PB1,967,4719,0,4,0,4723,A
2-PB1,968,2,1,0,4732,4735,C
2-PB1,969,4753,0,3,0,4756,A
2-PB1,970,0,4749,0,4,4753,T
2-PB1,971,4494,0,0,0,4494,A
2-PB1,972,5,0,1,4521,4527,C
2-PB1,973,4148,1,1,0,4150,A
2-PB1,974,0,4149,0,2,4151,T
2-PB1,975,7,0,0,4128,4135,C
2-PB1,976,4118,2,0,0,4120,A
2-PB1,977,0,1,0,4125,4126,C
2-PB1,978,4094,0,1,0,4095,A
2-PB1,979,4094,0,3,0,4097,A
2-PB1,980,4084,0,5,0,4089,A
2-PB1,981,4,9,3959,0,3972,G
2-PB1,982,4121,0,2,0,4123,A
2-PB1,983,4129,0,0,1,4130,A
2-PB1,984,1,4135,0,0,4136,T
2-PB1,985,24,1,0,4112,4137,C
2-PB1,986,4152,0,1,0,4153,A
2-PB1,987,4176,2,1,0,4179,A
2-PB1,988,6,3,0,4181,4190,C
2-PB1,989,2,1,0,4188,4191,C
2-PB1,990,0,3994,1,3,3998,T
2-PB1,991,0,4,4036,0,4040,G
2-PB1,992,4022,1,3,0,4026,A
2-PB1,993,0,2,4032,0,4034,G
2-PB1,994,0,4021,0,2,4023,T
2-PB1,995,2,15,3938,0,3955,G
2-PB1,996,0,2,4146,0,4148,G
2-PB1,997,0,4113,0,3,4116,T
2-PB1,998,1,4117,0,1,4119,T
2-PB1,999,20,0,0,4109,4129,C
2-PB1,1000,4081,1,3,0,4085,A
2-PB1,1001,0,9,4146,0,4155,G
2-PB1,1002,4159,3,0,0,4162,A
2-PB1,1003,4157,1,2,1,4161,A
2-PB1,1004,4138,1,3,1,4143,A
2-PB1,1005,2,3,1,3852,3858,C
2-PB1,1006,3905,0,0,0,3905,A
2-PB1,1007,0,3898,0,4,3902,T
2-PB1,1008,13,0,1,3939,3953,C
2-PB1,1009,2,1,0,3957,3960,C
2-PB1,1010,0,3841,0,2,3843,T
2-PB1,1011,0,14,3830,1,3845,G
2-PB1,1012,3834,1,5,0,3840,A
2-PB1,1013,6,3,3876,0,3885,G
2-PB1,1014,0,1,0,3859,3860,C
2-PB1,1015,3756,1,1,1,3759,A
2-PB1,1016,0,3779,0,1,3780,T
2-PB1,1017,8,0,0,3728,3736,C
2-PB1,1018,2,0,3735,2,3739,G
2-PB1,1019,1,0,0,3842,3843,C
2-PB1,1020,3855,1,1,0,3857,A
2-PB1,1021,3,1,0,3981,3985,C
2-PB1,1022,11,1,1,3956,3969,C
2-PB1,1023,3973,1,5,0,3979,A
2-PB1,1024,4032,1,10,0,4043,A
2-PB1,1025,0,4030,0,4,4034,T
2-PB1,1026,4032,0,1,0,4033,A
2-PB1,1027,4036,1,1,0,4038,A
2-PB1,1028,0,3914,0,1,3915,T
2-PB1,1029,2,1,3926,0,3929,G
2-PB1,1030,0,3823,0,1,3824,T
2-PB1,1031,0,3793,0,2,3795,T
2-PB1,1032,13,0,0,3795,3808,C
2-PB1,1033,0,3785,0,1,3786,T
2-PB1,1034,11,2,1,3788,3802,C
2-PB1,1035,3796,0,3,0,3799,A
2-PB1,1036,3781,1,19,0,3801,A
2-PB1,1037,3805,0,0,1,3806,A
2-PB1,1038,2,0,0,3819,3821,C
2-PB1,1039,3817,0,0,0,3817,A
2-PB1,1040,3808,0,1,4,3813,A
2-PB1,1041,3793,0,3,1,3797,A
2-PB1,1042,3813,0,1,0,3814,A
2-PB1,1043,1,3846,6,2,3855,T
2-PB1,1044,2,10,3844,0,3856,G
2-PB1,1045,2,2,3846,0,3850,G
2-PB1,1046,2,2,0,3853,3857,C
2-PB1,1047,3853,0,2,0,3855,A
2-PB1,1048,3864,0,1,0,3865,A
2-PB1,1049,2,11,3876,0,3889,G
2-PB1,1050,3905,1,0,0,3906,A
2-PB1,1051,1,1,0,3916,3918,C
2-PB1,1052,0,3870,0,0,3870,T
2-PB1,1053,1,6,3940,0,3947,G
2-PB1,1054,2,4,3947,0,3953,G
2-PB1,1055,2,9,3962,2,3975,G
2-PB1,1056,3971,0,1,0,3972,A
2-PB1,1057,3968,2,0,0,3970,A
2-PB1,1058,3945,0,1,1,3947,A
2-PB1,1059,3910,0,7,0,3917,A
2-PB1,1060,1,2,4025,0,4028,G
2-PB1,1061,0,13,4006,2,4021,G
2-PB1,1062,4007,0,4,0,4011,A
2-PB1,1063,0,3984,1,0,3985,T
2-PB1,1064,3972,0,4,0,3976,A
2-PB1,1065,0,0,0,3979,3979,C
2-PB1,1066,4005,0,0,0,4005,A
2-PB1,1067,1,3992,1,0,3994,T
2-PB1,1068,4,2,4016,0,4022,G
2-PB1,1069,3,3920,0,2,3925,T
2-PB1,1070,1,3942,0,0,3943,T
2-PB1,1071,29,1,0,3889,3919,C
2-PB1,1072,4,11,3907,0,3922,G
2-PB1,1073,3921,0,4,0,3925,A
2-PB1,1074,2,14,3988,0,4004,G
2-PB1,1075,3937,0,1,0,3938,A
2-PB1,1076,0,0,3992,0,3992,G
2-PB1,1077,1,3974,0,0,3975,T
2-PB1,1078,3957,0,2,0,3959,A
2-PB1,1079,3975,2,3,0,3980,A
2-PB1,1080,0,6,3992,1,3999,G
2-PB1,1081,3990,1,4,1,3996,A
2-PB1,1082,10,10,4031,0,4051,G
2-PB1,1083,3949,1,4,0,3954,A
2-PB1,1084,3978,1,2,0,3981,A
2-PB1,1085,1,3936,0,1,3938,T
2-PB1,1086,0,16,3912,2,3930,G
2-PB1,1087,3929,0,7,0,3936,A
2-PB1,1088,3910,0,3,0,3913,A
2-PB1,1089,0,1,3922,0,3923,G
2-PB1,1090,2,0,0,3909,3911,C
2-PB1,1091,1,3868,0,0,3869,T
2-PB1,1092,6,1,1,3872,3880,C
2-PB1,1093,3,6,0,3854,3863,C
2-PB1,1094,1,5,3877,1,3884,G
2-PB1,1095,1,13,3872,0,3886,G
2-PB1,1096,3901,1,4,0,3906,A
2-PB1,1097,1,0,0,3957,3958,C
2-PB1,1098,3958,2,3,0,3963,A
2-PB1,1099,0,1,0,4010,4011,C
2-PB1,1100,4000,0,3,0,4003,A
2-PB1,1101,4009,0,1,0,4010,A
2-PB1,1102,4008,0,2,0,4010,A
2-PB1,1103,0,4004,1,9,4014,T
2-PB1,1104,4012,0,1,0,4013,A
2-PB1,1105,4,0,0,4005,4009,C
2-PB1,1106,5,0,0,3963,3968,C
2-PB1,1107,2,3916,0,7,3925,T
2-PB1,1108,4,0,3941,0,3945,G
2-PB1,1109,0,2,0,3952,3954,C
2-PB1,1110,3947,0,3,0,3950,A
2-PB1,1111,0,6,3949,0,3955,G
2-PB1,1112,3932,1,0,0,3933,A
2-PB1,1113,3949,1,0,0,3950,A
2-PB1,1114,3953,0,1,0,3954,A
2-PB1,1115,0,3951,0,0,3951,T
2-PB1,1116,0,4,3959,0,3963,G
2-PB1,1117,0,0,1,3950,3951,C
2-PB1,1118,0,3943,0,3,3946,T
2-PB1,1119,4000,0,2,0,4002,A
2-PB1,1120,1,0,3999,0,4000,G
2-PB1,1121,2,0,0,3989,3991,C
2-PB1,1122,3993,0,1,0,3994,A
2-PB1,1123,3977,1,1,0,3979,A
2-PB1,1124,7,0,3960,0,3967,G
2-PB1,1125,2,1,0,3953,3956,C
2-PB1,1126,3904,0,0,0,3904,A
2-PB1,1127,0,3989,0,4,3993,T
2-PB1,1128,0,3991,1,1,3993,T
2-PB1,1129,2,10,4092,0,4104,G
2-PB1,1130,4143,0,5,1,4149,A
2-PB1,1131,1,1,0,4136,4138,C
2-PB1,1132,5,1,1,4144,4151,C
2-PB1,1133,2,4057,0,3,4062,T
2-PB1,1134,8,13,4104,0,4125,G
2-PB1,1135,4136,2,1,0,4139,A
2-PB1,1136,4135,4,2,0,4141,A
2-PB1,1137,0,2,4192,0,4194,G
2-PB1,1138,0,4062,0,1,4063,T
2-PB1,1139,4064,0,0,0,4064,A
2-PB1,1140,1,4036,0,0,4037,T
2-PB1,1141,1,4027,0,1,4029,T
2-PB1,1142,1,4032,0,1,4034,T
2-PB1,1143,11,1,0,3962,3974,C
2-PB1,1144,3959,0,4,0,3963,A
2-PB1,1145,3968,0,0,0,3968,A
2-PB1,1146,0,3911,1,0,3912,T
2-PB1,1147,2,25,3892,0,3919,G
2-PB1,1148,3895,4,0,0,3899,A
2-PB1,1149,3908,2,3,1,3914,A
2-PB1,1150,2,3901,0,0,3903,T
2-PB1,1151,15,0,1,3915,3931,C
2-PB1,1152,3923,1,5,0,3929,A
2-PB1,1153,3934,1,2,0,3937,A
2-PB1,1154,2,1,0,3937,3940,C
2-PB1,1155,3925,0,2,0,3927,A
2-PB1,1156,3911,0,2,2,3915,A
2-PB1,1157,0,6,3925,1,3932,G
2-PB1,1158,1,7,3945,0,3953,G
2-PB1,1159,3941,2,6,0,3949,A
2-PB1,1160,3935,0,7,0,3942,A
2-PB1,1161,1,6,3941,0,3948,G
2-PB1,1162,3928,0,0,0,3928,A
2-PB1,1163,3928,0,0,0,3928,A
2-PB1,1164,3928,0,0,0,3928,A
2-PB1,1165,3930,0,0,0,3930,A
2-PB1,1166,1,3917,1,2,3921,T
2-PB1,1167,1,3881,0,2,3884,T
2-PB1,1168,2,19,3875,0,3896,G
2-PB1,1169,3882,1,5,0,3888,A
2-PB1,1170,1,4,3894,0,3899,G
2-PB1,1171,3884,0,13,0,3897,A
2-PB1,1172,3923,0,1,3,3927,A
2-PB1,1173,3960,2,1,0,3963,A
2-PB1,1174,3976,0,2,1,3979,A
2-PB1,1175,1,3975,1,0,3977,T
2-PB1,1176,3977,0,1,0,3978,A
2-PB1,1177,3961,4,6,1,3972,A
2-PB1,1178,0,5,3995,0,4000,G
2-PB1,1179,2,3,3991,0,3996,G
2-PB1,1180,3,0,0,3977,3980,C
2-PB1,1181,2,1,0,3959,3962,C
2-PB1,1182,0,3939,0,5,3944,T
2-PB1,1183,6,0,1,4421,4428,C
2-PB1,1184,0,4491,0,1,4492,T
2-PB1,1185,1,4504,0,1,4506,T
2-PB1,1186,7,0,1,4578,4586,C
2-PB1,1187,1,4558,0,1,4560,T
2-PB1,1188,4568,0,1,0,4569,A
2-PB1,1189,4579,0,0,0,4579,A
2-PB1,1190,0,4573,0,1,4574,T
2-PB1,1191,4632,0,0,1,4633,A
2-PB1,1192,0,5,4531,0,4536,G
2-PB1,1193,4144,1,0,0,4145,A
2-PB1,1194,0,4136,0,1,4137,T
2-PB1,1195,2,13,4046,0,4061,G
2-PB1,1196,2,2,4113,0,4117,G
2-PB1,1197,3,2,0,4103,4108,C
2-PB1,1198,4116,1,4,0,4121,A
2-PB1,1199,3,1,0,4127,4131,C
2-PB1,1200,4060,1,7,0,4068,A
2-PB1,1201,6,1,4192,1,4200,G
2-PB1,1202,1,5,0,4186,4192,C
2-PB1,1203,4189,0,1,0,4190,A
2-PB1,1204,2,4300,0,2,4304,T
2-PB1,1205,12,2,0,4238,4252,C
2-PB1,1206,4300,0,1,0,4301,A
2-PB1,1207,2,4288,1,2,4293,T
2-PB1,1208,0,4271,0,2,4273,T
2-PB1,1209,2,15,4251,0,4268,G
2-PB1,1210,4141,0,4,0,4145,A
2-PB1,1211,0,0,4244,1,4245,G
2-PB1,1212,1,2,0,4234,4237,C
2-PB1,1213,7,1,1,4178,4187,C
2-PB1,1214,7,2,0,4244,4253,C
2-PB1,1215,0,4212,0,8,4220,T
2-PB1,1216,0,9,4398,0,4407,G
2-PB1,1217,0,10,4469,0,4479,G
2-PB1,1218,4469,1,13,0,4483,A
2-PB1,1219,4563,0,0,1,4564,A
2-PB1,1220,0,4431,0,2,4433,T
2-PB1,1221,2,11,4513,1,4527,G
2-PB1,1222,4594,0,1,1,4596,A
2-PB1,1223,1,4565,1,1,4568,T
2-PB1,1224,1,8,4569,1,4579,G
2-PB1,1225,4527,4,2,1,4534,A
2-PB1,1226,1,4473,1,0,4475,T
2-PB1,1227,1,6,4477,0,4484,G
2-PB1,1228,1,11,4514,0,4526,G
2-PB1,1229,1,2,4533,0,4536,G
2-PB1,1230,1,1,0,4487,4489,C
2-PB1,1231,4496,0,3,1,4500,A
2-PB1,1232,0,4509,1,0,4510,T
2-PB1,1233,9,4,4629,1,4643,G
2-PB1,1234,0,4638,0,5,4643,T
2-PB1,1235,0,4657,0,1,4658,T
2-PB1,1236,21,1,1,4639,4662,C
2-PB1,1237,4622,1,0,0,4623,A
2-PB1,1238,4634,0,5,0,4639,A
2-PB1,1239,0,0,0,4651,4651,C
2-PB1,1240,4641,0,1,2,4644,A
2-PB1,1241,0,4644,0,3,4647,T
2-PB1,1242,0,0,4694,0,4694,G
2-PB1,1243,1,0,0,4683,4684,C
2-PB1,1244,0,4674,0,1,4675,T
2-PB1,1245,4710,0,0,1,4711,A
2-PB1,1246,4709,1,2,0,4712,A
2-PB1,1247,0,2,4785,0,4787,G
2-PB1,1248,1,4777,0,3,4781,T
2-PB1,1249,4758,0,2,0,4760,A
2-PB1,1250,1,4,0,4773,4778,C
2-PB1,1251,2,15,4761,0,4778,G
2-PB1,1252,0,1,5024,1,5026,G
2-PB1,1253,0,5007,2,2,5011,T
2-PB1,1254,0,4981,0,2,4983,T
2-PB1,1255,0,4978,1,2,4981,T
2-PB1,1256,1,4948,0,0,4949,T
2-PB1,1257,4950,0,4,3,4957,A
2-PB1,1258,1,5,4949,0,4955,G
2-PB1,1259,2,14,4927,1,4944,G
2-PB1,1260,4803,0,7,1,4811,A
2-PB1,1261,0,1,4772,0,4773,G
2-PB1,1262,2,4829,0,0,4831,T
2-PB1,1263,13,0,0,4819,4832,C
2-PB1,1264,0,4840,0,0,4840,T
2-PB1,1265,16,2,1,4829,4848,C
2-PB1,1266,2,10,4846,0,4858,G
2-PB1,1267,4990,2,0,0,4992,A
2-PB1,1268,0,4999,0,1,5000,T
2-PB1,1269,5014,1,8,0,5023,A
2-PB1,1270,6,2,0,5011,5019,C
2-PB1,1271,1,4934,0,6,4941,T
2-PB1,1272,0,18,4942,0,4960,G
2-PB1,1273,4942,0,3,1,4946,A
2-PB1,1274,5027,0,2,1,5030,A
2-PB1,1275,2,5027,1,2,5032,T
2-PB1,1276,10,0,0,4903,4913,C
2-PB1,1277,1,4887,0,1,4889,T
2-PB1,1278,2,4869,0,1,4872,T
2-PB1,1279,1,9,4868,1,4879,G
2-PB1,1280,2,12,4866,0,4880,G
2-PB1,1281,4870,1,8,0,4879,A
2-PB1,1282,0,2,0,4881,4883,C
2-PB1,1283,4812,1,0,0,4813,A
2-PB1,1284,4832,2,2,0,4836,A
2-PB1,1285,4860,0,0,0,4860,A
2-PB1,1286,4861,0,9,1,4871,A
2-PB1,1287,0,13,4927,0,4940,G
2-PB1,1288,4937,1,2,0,4940,A
2-PB1,1289,4934,2,1,1,4938,A
2-PB1,1290,4943,0,5,0,4948,A
2-PB1,1291,3,4944,0,1,4948,T
2-PB1,1292,4956,1,4,0,4961,A
2-PB1,1293,1,1,0,5103,5105,C
2-PB1,1294,5079,0,1,1,5081,A
2-PB1,1295,4,2,0,5086,5092,C
2-PB1,1296,3,1,1,5042,5047,C
2-PB1,1297,5032,1,2,0,5035,A
2-PB1,1298,5088,0,2,0,5090,A
2-PB1,1299,1,17,5215,0,5233,G
2-PB1,1300,5276,1,2,0,5279,A
2-PB1,1301,2,1,0,5313,5316,C
2-PB1,1302,5186,1,1,0,5188,A
2-PB1,1303,5346,2,6,0,5354,A
2-PB1,1304,3,4,0,5375,5382,C
2-PB1,1305,5465,1,2,0,5468,A
2-PB1,1306,0,5487,0,0,5487,T
2-PB1,1307,5439,0,2,0,5441,A
2-PB1,1308,2,1,0,5519,5522,C
2-PB1,1309,10,5304,1,6,5321,T
2-PB1,1310,3,10,5371,0,5384,G
2-PB1,1311,5,4,5372,0,5381,G
2-PB1,1312,0,5282,0,1,5283,T
2-PB1,1313,1,15,5254,1,5271,G
2-PB1,1314,4,8,5185,0,5197,G
2-PB1,1315,2,11,5230,0,5243,G
2-PB1,1316,5226,3,6,1,5236,A
2-PB1,1317,0,5120,0,0,5120,T
2-PB1,1318,3,8,5106,1,5118,G
2-PB1,1319,0,2,5090,1,5093,G
2-PB1,1320,3,1,5132,0,5136,G
2-PB1,1321,2,0,0,5188,5190,C
2-PB1,1322,1,5157,0,4,5162,T
2-PB1,1323,17,0,1,5186,5204,C
2-PB1,1324,13,0,1,5176,5190,C
2-PB1,1325,5196,0,1,0,5197,A
2-PB1,1326,5201,0,1,4,5206,A
2-PB1,1327,0,5191,0,1,5192,T
2-PB1,1328,10,1,1,5176,5188,C
2-PB1,1329,3,0,0,5162,5165,C
2-PB1,1330,0,5108,0,5,5113,T
2-PB1,1331,5,0,0,5111,5116,C
2-PB1,1332,3,4,0,5089,5096,C
2-PB1,1333,4,16,5083,1,5104,G
2-PB1,1334,5096,0,1,0,5097,A
2-PB1,1335,1,3,0,5096,5100,C
2-PB1,1336,0,12,5091,0,5103,G
2-PB1,1337,5123,2,1,0,5126,A
2-PB1,1338,1,5112,0,0,5113,T
2-PB1,1339,0,5102,0,0,5102,T
2-PB1,1340,2,5108,0,2,5112,T
2-PB1,1341,0,5115,0,1,5116,T
2-PB1,1342,1,2,5122,0,5125,G
2-PB1,1343,3,3,0,5160,5166,C
2-PB1,1344,11,3,0,5149,5163,C
2-PB1,1345,16,2,0,5289,5307,C
2-PB1,1346,0,5222,0,4,5226,T
2-PB1,1347,14,1,0,5417,5432,C
2-PB1,1348,5463,0,2,0,5465,A
2-PB1,1349,0,5487,0,0,5487,T
2-PB1,1350,5494,2,0,0,5496,A
2-PB1,1351,0,1,5540,0,5541,G
2-PB1,1352,1,5476,1,1,5479,T
2-PB1,1353,3,19,5489,1,5512,G
2-PB1,1354,5338,0,0,0,5338,A
2-PB1,1355,5340,0,1,0,5341,A
2-PB1,1356,5,5103,0,3,5111,T
2-PB1,1357,1,3,5096,0,5100,G
2-PB1,1358,5,6,0,5110,5121,C
2-PB1,1359,5124,0,2,0,5126,A
2-PB1,1360,1,1,0,5127,5129,C
2-PB1,1361,11,1,0,5079,5091,C
2-PB1,1362,5066,1,2,0,5069,A
2-PB1,1363,5067,0,0,0,5067,A
2-PB1,1364,5055,0,1,1,5057,A
2-PB1,1365,1,4925,0,1,4927,T
2-PB1,1366,23,2,1,5042,5068,C
2-PB1,1367,5073,0,1,0,5074,A
2-PB1,1368,5,5070,1,2,5078,T
2-PB1,1369,0,10,5068,0,5078,G
2-PB1,1370,5066,1,6,0,5073,A
2-PB1,1371,2,15,5098,0,5115,G
2-PB1,1372,1,8,5069,0,5078,G
2-PB1,1373,4,11,5075,1,5091,G
2-PB1,1374,5060,1,4,1,5066,A
2-PB1,1375,5130,0,4,0,5134,A
2-PB1,1376,0,5148,0,1,5149,T
2-PB1,1377,5153,0,5,0,5158,A
2-PB1,1378,4,2,0,5153,5159,C
2-PB1,1379,5170,1,1,0,5172,A
2-PB1,1380,5150,2,16,0,5168,A
2-PB1,1381,0,0,5157,1,5158,G
2-PB1,1382,2,3,0,5118,5123,C
2-PB1,1383,5076,1,2,0,5079,A
2-PB1,1384,1,3,5094,0,5098,G
2-PB1,1385,1,17,5089,0,5107,G
2-PB1,1386,5096,0,0,0,5096,A
2-PB1,1387,1,10,5102,0,5113,G
2-PB1,1388,0,5016,1,2,5019,T
2-PB1,1389,0,12,5046,0,5058,G
2-PB1,1390,1,7,5074,0,5082,G
2-PB1,1391,5069,1,5,0,5075,A
2-PB1,1392,2,5068,2,1,5073,T
2-PB1,1393,4982,0,5,1,4988,A
2-PB1,1394,2,9,5022,0,5033,G
2-PB1,1395,5078,1,0,0,5079,A
2-PB1,1396,2,5077,0,1,5080,T
2-PB1,1397,1,5055,0,1,5057,T
2-PB1,1398,10,1,0,5179,5190,C
2-PB1,1399,0,5159,1,3,5163,T
2-PB1,1400,5159,0,1,1,5161,A
2-PB1,1401,1,0,0,5161,5162,C
2-PB1,1402,5052,1,3,0,5056,A
2-PB1,1403,1,9,5068,0,5078,G
2-PB1,1404,0,12,4977,0,4989,G
2-PB1,1405,5033,0,2,0,5035,A
2-PB1,1406,2,0,0,5031,5033,C
2-PB1,1407,3,1,0,4898,4902,C
2-PB1,1408,2,4835,0,6,4843,T
2-PB1,1409,1,2,4866,0,4869,G
2-PB1,1410,2,0,0,4844,4846,C
2-PB1,1411,4860,0,4,0,4864,A
2-PB1,1412,4877,0,4,0,4881,A
2-PB1,1413,1,1,4893,0,4895,G
2-PB1,1414,0,4808,0,2,4810,T
2-PB1,1415,0,4808,0,1,4809,T
2-PB1,1416,4729,0,3,0,4732,A
2-PB1,1417,2,1,4748,0,4751,G
2-PB1,1418,1,4717,0,1,4719,T
2-PB1,1419,1,4,4709,0,4714,G
2-PB1,1420,0,2,4704,0,4706,G
2-PB1,1421,1,19,4695,1,4716,G
2-PB1,1422,4681,0,9,0,4690,A
2-PB1,1423,4702,0,0,0,4702,A
2-PB1,1424,1,4691,0,4,4696,T
2-PB1,1425,20,1,0,4684,4705,C
2-PB1,1426,4695,0,3,0,4698,A
2-PB1,1427,4707,1,5,0,4713,A
2-PB1,1428,1,1,0,4706,4708,C
2-PB1,1429,4695,1,0,0,4696,A
2-PB1,1430,0,4603,1,0,4604,T
2-PB1,1431,1,22,4584,0,4607,G
2-PB1,1432,4612,1,2,0,4615,A
2-PB1,1433,0,0,4655,0,4655,G
2-PB1,1434,4,0,0,4624,4628,C
2-PB1,1435,4611,0,1,0,4612,A
2-PB1,1436,4615,2,1,0,4618,A
2-PB1,1437,4619,0,1,0,4620,A
2-PB1,1438,4641,1,0,1,4643,A
2-PB1,1439,4634,2,1,0,4637,A
2-PB1,1440,0,4,4627,0,4631,G
2-PB1,1441,4581,2,0,0,4583,A
2-PB1,1442,4536,3,4,0,4543,A
2-PB1,1443,1,3,4694,1,4699,G
2-PB1,1444,0,4695,0,1,4696,T
2-PB1,1445,14,6,0,4668,4688,C
2-PB1,1446,10,1,1,4696,4708,C
2-PB1,1447,0,4684,0,1,4685,T
2-PB1,1448,4742,0,0,0,4742,A
2-PB1,1449,1,4728,0,0,4729,T
2-PB1,1450,4729,1,0,0,4730,A
2-PB1,1451,1,4730,0,6,4737,T
2-PB1,1452,4600,0,0,0,4600,A
2-PB1,1453,4601,1,2,4,4608,A
2-PB1,1454,4591,0,2,0,4593,A
2-PB1,1455,3,4582,0,0,4585,T
2-PB1,1456,4534,0,0,0,4534,A
2-PB1,1457,4484,2,0,0,4486,A
2-PB1,1458,4502,0,1,0,4503,A
2-PB1,1459,4497,0,4,1,4502,A
2-PB1,1460,1,0,0,4504,4505,C
2-PB1,1461,4257,0,1,0,4258,A
2-PB1,1462,1,4,4254,1,4260,G
2-PB1,1463,1,7,4229,0,4237,G
2-PB1,1464,1,20,4224,0,4245,G
2-PB1,1465,4254,0,3,1,4258,A
2-PB1,1466,0,0,0,4265,4265,C
2-PB1,1467,4220,0,0,1,4221,A
2-PB1,1468,1,4241,0,0,4242,T
2-PB1,1469,1,4230,0,4,4235,T
2-PB1,1470,1,4248,0,0,4249,T
2-PB1,1471,1,18,4216,1,4236,G
2-PB1,1472,4208,1,2,0,4211,A
2-PB1,1473,4219,1,2,0,4222,A
2-PB1,1474,0,4218,0,0,4218,T
2-PB1,1475,0,4130,1,3,4134,T
2-PB1,1476,20,0,0,4143,4163,C
2-PB1,1477,4116,3,1,0,4120,A
2-PB1,1478,0,2,0,4119,4121,C
2-PB1,1479,0,4118,0,1,4119,T
2-PB1,1480,4114,3,3,0,4120,A
2-PB1,1481,0,4,4107,0,4111,G
2-PB1,1482,0,0,0,4113,4113,C
2-PB1,1483,0,4066,1,4,4071,T
2-PB1,1484,1,4124,0,1,4126,T
2-PB1,1485,0,4100,1,0,4101,T
2-PB1,1486,2,4101,0,2,4105,T
2-PB1,1487,0,4102,0,0,4102,T
2-PB1,1488,1,4095,0,1,4097,T
2-PB1,1489,0,4090,0,0,4090,T
2-PB1,1490,4095,0,1,0,4096,A
2-PB1,1491,2,4071,0,1,4074,T
2-PB1,1492,10,3,0,4082,4095,C
2-PB1,1493,1,10,4101,0,4112,G
2-PB1,1494,4226,1,1,0,4228,A
2-PB1,1495,0,4235,0,1,4236,T
2-PB1,1496,4243,0,0,0,4243,A
2-PB1,1497,0,4267,0,1,4268,T
2-PB1,1498,0,5,4258,1,4264,G
2-PB1,1499,0,12,4278,0,4290,G
2-PB1,1500,4289,0,3,0,4292,A
2-PB1,1501,1,4239,0,1,4241,T
2-PB1,1502,0,4217,1,0,4218,T
2-PB1,1503,0,4096,1,1,4098,T
2-PB1,1504,2,0,4100,1,4103,G
2-PB1,1505,1,4084,0,2,4087,T
2-PB1,1506,0,4,4073,1,4078,G
2-PB1,1507,4,1,4070,0,4075,G
2-PB1,1508,0,0,0,4040,4040,C
2-PB1,1509,1,4078,0,5,4084,T
2-PB1,1510,4087,0,1,0,4088,A
2-PB1,1511,4119,0,0,0,4119,A
2-PB1,1512,2,4146,0,1,4149,T
2-PB1,1513,1,4139,0,1,4141,T
2-PB1,1514,0,4147,0,0,4147,T
2-PB1,1515,0,4153,0,1,4154,T
2-PB1,1516,4147,0,2,0,4149,A
2-PB1,1517,0,1,4195,0,4196,G
2-PB1,1518,0,1,2,4181,4184,C
2-PB1,1519,4178,1,0,0,4179,A
2-PB1,1520,2,4142,0,0,4144,T
2-PB1,1521,3,6,4064,3,4076,G
2-PB1,1522,0,6,4140,0,4146,G
2-PB1,1523,4119,2,4,0,4125,A
2-PB1,1524,3,1,4137,0,4141,G
2-PB1,1525,1,3,0,4124,4128,C
2-PB1,1526,1,4062,1,3,4067,T
2-PB1,1527,1,4,4096,0,4101,G
2-PB1,1528,1,3,0,4088,4092,C
2-PB1,1529,5,0,0,4064,4069,C
2-PB1,1530,7,1,0,4087,4095,C
2-PB1,1531,3980,0,0,0,3980,A
2-PB1,1532,3,0,4132,0,4135,G
2-PB1,1533,0,4130,1,1,4132,T
2-PB1,1534,1,4133,2,0,4136,T
2-PB1,1535,0,4130,3,1,4134,T
2-PB1,1536,0,4074,0,2,4076,T
2-PB1,1537,1,5,4049,0,4055,G
2-PB1,1538,0,10,4071,0,4081,G
2-PB1,1539,4068,0,1,0,4069,A
2-PB1,1540,0,1,4064,0,4065,G
2-PB1,1541,0,3767,0,1,3768,T
2-PB1,1542,3753,0,0,0,3753,A
2-PB1,1543,1,3830,1,2,3834,T
2-PB1,1544,6,0,0,3830,3836,C
2-PB1,1545,1,3831,1,3,3836,T
2-PB1,1546,4,6,3861,0,3871,G
2-PB1,1547,1,9,3892,1,3903,G
2-PB1,1548,3899,1,0,0,3900,A
2-PB1,1549,3894,0,3,2,3899,A
2-PB1,1550,1,3888,1,0,3890,T
2-PB1,1551,3729,0,1,0,3730,A
2-PB1,1552,3724,0,1,0,3725,A
2-PB1,1553,3718,0,2,2,3722,A
2-PB1,1554,1,3,0,3717,3721,C
2-PB1,1555,1,9,3659,0,3669,G
2-PB1,1556,3621,0,1,0,3622,A
2-PB1,1557,2,2,3616,0,3620,G
2-PB1,1558,0,3607,0,3,3610,T
2-PB1,1559,19,0,0,3601,3620,C
2-PB1,1560,3606,0,1,0,3607,A
2-PB1,1561,0,3,3644,0,3647,G
2-PB1,1562,2,1,1,3642,3646,C
2-PB1,1563,0,3638,0,1,3639,T
2-PB1,1564,1,6,3722,0,3729,G
2-PB1,1565,3700,0,2,0,3702,A
2-PB1,1566,0,3695,2,0,3697,T
2-PB1,1567,3697,0,3,0,3700,A
2-PB1,1568,2,3616,0,2,3620,T
2-PB1,1569,0,16,3617,0,3633,G
2-PB1,1570,3478,3,5,1,3487,A
2-PB1,1571,1,2,3528,1,3532,G
2-PB1,1572,0,2,0,3535,3537,C
2-PB1,1573,3316,0,3,1,3320,A
2-PB1,1574,0,3326,1,0,3327,T
2-PB1,1575,0,3313,1,2,3316,T
2-PB1,1576,5,8,3329,0,3342,G
2-PB1,1577,0,5,3415,0,3420,G
2-PB1,1578,3349,0,6,0,3355,A
2-PB1,1579,2,2,3356,0,3360,G
2-PB1,1580,0,3209,0,1,3210,T
2-PB1,1581,3191,0,1,0,3192,A
2-PB1,1582,3187,0,3,1,3191,A
2-PB1,1583,0,2,0,3197,3199,C
2-PB1,1584,3169,0,5,0,3174,A
2-PB1,1585,0,0,3209,0,3209,G
2-PB1,1586,0,2796,0,1,2797,T
2-PB1,1587,6,7,2797,0,2810,G
2-PB1,1588,2826,0,2,0,2828,A
2-PB1,1589,1,2819,0,0,2820,T
2-PB1,1590,2808,0,0,0,2808,A
2-PB1,1591,2803,0,1,0,2804,A
2-PB1,1592,2700,0,2,0,2702,A
2-PB1,1593,1,11,2719,0,2731,G
2-PB1,1594,2566,1,0,0,2567,A
2-PB1,1595,2559,0,1,1,2561,A
2-PB1,1596,0,0,1,2560,2561,C
2-PB1,1597,2434,1,0,0,2435,A
2-PB1,1598,2455,1,1,0,2457,A
2-PB1,1599,3,0,1,2452,2456,C
2-PB1,1600,2476,2,0,0,2478,A
2-PB1,1601,0,2468,3,0,2471,T
2-PB1,1602,1,8,2388,0,2397,G
2-PB1,1603,2394,0,1,0,2395,A
2-PB1,1604,2,2390,0,0,2392,T
2-PB1,1605,2354,0,1,0,2355,A
2-PB1,1606,2372,1,0,0,2373,A
2-PB1,1607,2294,0,1,0,2295,A
2-PB1,1608,0,0,0,2305,2305,C
2-PB1,1609,2150,0,1,0,2151,A
2-PB1,1610,2142,2,0,0,2144,A
2-PB1,1611,0,2086,0,0,2086,T
2-PB1,1612,2,8,2077,0,2087,G
2-PB1,1613,2123,1,1,0,2125,A
2-PB1,1614,2,0,1,2132,2135,C
2-PB1,1615,2,0,0,2085,2087,C
2-PB1,1616,0,1968,0,1,1969,T
2-PB1,1617,0,1899,0,0,1899,T
2-PB1,1618,1,5,1897,0,1903,G
2-PB1,1619,0,4,1923,0,1927,G
2-PB1,1620,1947,0,2,0,1949,A
2-PB1,1621,3,0,0,1948,1951,C
2-PB1,1622,3,0,0,1911,1914,C
2-PB1,1623,1910,0,1,0,1911,A
2-PB1,1624,1,0,1934,0,1935,G
2-PB1,1625,0,0,0,1941,1941,C
2-PB1,1626,1943,1,1,1,1946,A
2-PB1,1627,1938,0,0,0,1938,A
2-PB1,1628,0,1,0,1938,1939,C
2-PB1,1629,1920,0,1,0,1921,A
2-PB1,1630,1,0,1975,0,1976,G
2-PB1,1631,3,1,0,1957,1961,C
2-PB1,1632,3,0,0,1977,1980,C
2-PB1,1633,5,1,0,1963,1969,C
2-PB1,1634,1971,1,1,0,1973,A
2-PB1,1635,1970,0,0,0,1970,A
2-PB1,1636,1972,0,1,0,1973,A
2-PB1,1637,0,1969,0,0,1969,T
2-PB1,1638,5,4,1952,1,1962,G
2-PB1,1639,0,1,1937,0,1938,G
2-PB1,1640,0,0,0,1944,1944,C
2-PB1,1641,0,1924,0,2,1926,T
2-PB1,1642,1,1,0,1966,1968,C
2-PB1,1643,0,1962,0,3,1965,T
2-PB1,1644,2,0,0,1977,1979,C
2-PB1,1645,6,1,0,1978,1985,C
2-PB1,1646,1981,0,0,0,1981,A
2-PB1,1647,1987,0,1,1,1989,A
2-PB1,1648,0,1978,0,1,1979,T
2-PB1,1649,0,1954,1,0,1955,T
2-PB1,1650,1,0,1972,0,1973,G
2-PB1,1651,1,1922,0,2,1925,T
2-PB1,1652,0,1920,0,2,1922,T
2-PB1,1653,13,7,0,1898,1918,C
2-PB1,1654,1910,0,3,0,1913,A
2-PB1,1655,1,1912,0,0,1913,T
2-PB1,1656,2,1,0,1909,1912,C
2-PB1,1657,1921,0,0,0,1921,A
2-PB1,1658,1916,1,0,0,1917,A
2-PB1,1659,1908,0,3,0,1911,A
2-PB1,1660,0,2,1947,0,1949,G
2-PB1,1661,1951,0,0,0,1951,A
2-PB1,1662,1,1957,0,0,1958,T
2-PB1,1663,0,1964,0,0,1964,T
2-PB1,1664,1965,1,0,1,1967,A
2-PB1,1665,3,0,0,2003,2006,C
2-PB1,1666,1996,0,0,0,1996,A
2-PB1,1667,0,4,2008,1,2013,G
2-PB1,1668,2004,0,0,0,2004,A
2-PB1,1669,1,2042,0,0,2043,T
2-PB1,1670,2046,0,6,0,2052,A
2-PB1,1671,0,2,0,2165,2167,C
2-PB1,1672,2207,0,1,0,2208,A
2-PB1,1673,1,0,0,2371,2372,C
2-PB1,1674,2340,0,0,1,2341,A
2-PB1,1675,0,2359,2,3,2364,T
2-PB1,1676,2342,0,1,0,2343,A
2-PB1,1677,0,2339,0,0,2339,T
2-PB1,1678,2280,0,0,1,2281,A
2-PB1,1679,1,3,2279,0,2283,G
2-PB1,1680,0,1,2268,0,2269,G
2-PB1,1681,0,2175,0,2,2177,T
2-PB1,1682,1,2,2148,0,2151,G
2-PB1,1683,2,1,1,2233,2237,C
2-PB1,1684,4,0,0,2224,2228,C
2-PB1,1685,2254,0,3,0,2257,A
2-PB1,1686,0,2256,0,1,2257,T
2-PB1,1687,2270,0,0,0,2270,A
2-PB1,1688,2,2,2280,0,2284,G
2-PB1,1689,2240,0,2,0,2242,A
2-PB1,1690,1,1,2260,1,2263,G
2-PB1,1691,0,5,2246,0,2251,G
2-PB1,1692,2165,0,2,1,2168,A
2-PB1,1693,0,5,2168,0,2173,G
2-PB1,1694,2146,1,6,1,2154,A
2-PB1,1695,0,1,0,2157,2158,C
2-PB1,1696,2157,0,1,1,2159,A
2-PB1,1697,0,1,0,2191,2192,C
2-PB1,1698,2192,0,0,1,2193,A
2-PB1,1699,2,0,0,2192,2194,C
2-PB1,1700,2182,2,1,0,2185,A
2-PB1,1701,2197,0,1,0,2198,A
2-PB1,1702,2205,0,0,0,2205,A
2-PB1,1703,1,2198,0,1,2200,T
2-PB1,1704,4,1,0,2194,2199,C
2-PB1,1705,6,0,1,2197,2204,C
2-PB1,1706,2175,1,4,0,2180,A
2-PB1,1707,1,4,2188,0,2193,G
2-PB1,1708,2188,0,3,0,2191,A
2-PB1,1709,0,1,0,2202,2203,C
2-PB1,1710,2,6,2187,0,2195,G
2-PB1,1711,2177,0,0,0,2177,A
2-PB1,1712,0,5,2180,0,2185,G
2-PB1,1713,2182,0,3,0,2185,A
2-PB1,1714,2184,0,1,0,2185,A
2-PB1,1715,0,8,2187,1,2196,G
2-PB1,1716,2177,0,6,1,2184,A
2-PB1,1717,1,2175,0,0,2176,T
2-PB1,1718,4,0,0,2160,2164,C
2-PB1,1719,2167,1,0,0,2168,A
2-PB1,1720,1,2160,0,1,2162,T
2-PB1,1721,1,2162,0,0,2163,T
2-PB1,1722,6,1,0,2152,2159,C
2-PB1,1723,0,4,2151,1,2156,G
2-PB1,1724,2140,1,1,0,2142,A
2-PB1,1725,0,0,2151,0,2151,G
2-PB1,1726,2140,2,0,0,2142,A
2-PB1,1727,0,2218,0,0,2218,T
2-PB1,1728,2221,1,1,0,2223,A
2-PB1,1729,2228,0,1,0,2229,A
2-PB1,1730,2231,0,1,0,2232,A
2-PB1,1731,2,3,2234,0,2239,G
2-PB1,1732,2235,1,0,0,2236,A
2-PB1,1733,2179,1,0,0,2180,A
2-PB1,1734,2,1,2193,0,2196,G
2-PB1,1735,0,0,1,2190,2191,C
2-PB1,1736,0,2158,0,0,2158,T
2-PB1,1737,0,1,2183,0,2184,G
2-PB1,1738,0,2175,0,0,2175,T
2-PB1,1739,2,5,2167,0,2174,G
2-PB1,1740,2,1,2179,0,2182,G
2-PB1,1741,0,6,2195,1,2202,G
2-PB1,1742,2207,0,1,0,2208,A
2-PB1,1743,0,2192,0,1,2193,T
2-PB1,1744,7,1,0,2184,2192,C
2-PB1,1745,2190,0,1,0,2191,A
2-PB1,1746,2203,0,3,0,2206,A
2-PB1,1747,2221,0,0,0,2221,A
2-PB1,1748,2,0,0,2218,2220,C
2-PB1,1749,2,0,0,2205,2207,C
2-PB1,1750,5,1,1,2196,2203,C
2-PB1,1751,2202,0,1,0,2203,A
2-PB1,1752,2234,0,1,0,2235,A
2-PB1,1753,0,2228,0,1,2229,T
2-PB1,1754,3,0,0,2233,2236,C
2-PB1,1755,2215,0,2,0,2217,A
2-PB1,1756,2199,2,1,0,2202,A
2-PB1,1757,0,9,2234,0,2243,G
2-PB1,1758,1,2,2230,0,2233,G
2-PB1,1759,0,0,2237,0,2237,G
2-PB1,1760,0,5,0,2235,2240,C
2-PB1,1761,2201,2,1,0,2204,A
2-PB1,1762,0,3,2262,0,2265,G
2-PB1,1763,8,7,2260,0,2275,G
2-PB1,1764,2278,1,1,0,2280,A
2-PB1,1765,3,0,0,2305,2308,C
2-PB1,1766,0,2262,0,1,2263,T
2-PB1,1767,2315,1,3,0,2319,A
2-PB1,1768,0,2307,0,1,2308,T
2-PB1,1769,1,2307,0,1,2309,T
2-PB1,1770,2,4,2306,0,2312,G
2-PB1,1771,1,2,2322,1,2326,G
2-PB1,1772,1,2287,0,5,2293,T
2-PB1,1773,2302,0,1,0,2303,A
2-PB1,1774,0,2280,0,0,2280,T
2-PB1,1775,4,0,0,2277,2281,C
2-PB1,1776,2226,1,3,0,2230,A
2-PB1,1777,0,1,2351,0,2352,G
2-PB1,1778,2345,1,1,0,2347,A
2-PB1,1779,0,2323,0,1,2324,T
2-PB1,1780,1,1,2245,0,2247,G
2-PB1,1781,1,2,2241,0,2244,G
2-PB1,1782,3,8,2230,1,2242,G
2-PB1,1783,0,5,2261,0,2266,G
2-PB1,1784,0,5,2261,0,2266,G
2-PB1,1785,2256,1,0,0,2257,A
2-PB1,1786,2,0,0,2240,2242,C
2-PB1,1787,3,1,0,2230,2234,C
2-PB1,1788,2231,0,1,1,2233,A
2-PB1,1789,2446,0,0,0,2446,A
2-PB1,1790,2455,1,1,0,2457,A
2-PB1,1791,0,1,0,2527,2528,C
2-PB1,1792,0,2517,0,0,2517,T
2-PB1,1793,0,2518,1,0,2519,T
2-PB1,1794,2536,0,0,0,2536,A
2-PB1,1795,0,2539,0,0,2539,T
2-PB1,1796,2543,1,2,0,2546,A
2-PB1,1797,0,0,0,2546,2546,C
2-PB1,1798,2369,1,1,0,2371,A
2-PB1,1799,2388,0,0,0,2388,A
2-PB1,1800,0,2352,0,0,2352,T
2-PB1,1801,2402,0,0,0,2402,A
2-PB1,1802,0,2404,0,1,2405,T
2-PB1,1803,4,0,0,2395,2399,C
2-PB1,1804,1,9,0,2387,2397,C
2-PB1,1805,1,2,2394,0,2397,G
2-PB1,1806,0,3,2402,0,2405,G
2-PB1,1807,2409,0,0,0,2409,A
2-PB1,1808,2421,0,1,1,2423,A
2-PB1,1809,0,2421,0,1,2422,T
2-PB1,1810,3,0,0,2420,2423,C
2-PB1,1811,1,2415,0,1,2417,T
2-PB1,1812,0,2430,0,1,2431,T
2-PB1,1813,4,1,0,2426,2431,C
2-PB1,1814,2428,0,2,0,2430,A
2-PB1,1815,1,1,0,2442,2444,C
2-PB1,1816,2428,0,1,0,2429,A
2-PB1,1817,0,2423,0,0,2423,T
2-PB1,1818,0,2402,0,2,2404,T
2-PB1,1819,5,0,0,2669,2674,C
2-PB1,1820,5,1,0,2670,2676,C
2-PB1,1821,0,2681,0,2,2683,T
2-PB1,1822,0,4,2679,0,2683,G
2-PB1,1823,2673,0,0,0,2673,A
2-PB1,1824,2675,0,1,0,2676,A
2-PB1,1825,1,1,2680,0,2682,G
2-PB1,1826,0,2566,0,0,2566,T
2-PB1,1827,10,0,0,2557,2567,C
2-PB1,1828,1,2531,0,0,2532,T
2-PB1,1829,2,1,2632,0,2635,G
2-PB1,1830,1,0,0,2632,2633,C
2-PB1,1831,0,2635,0,0,2635,T
2-PB1,1832,0,2634,0,0,2634,T
2-PB1,1833,2634,1,0,0,2635,A
2-PB1,1834,2647,0,0,0,2647,A
2-PB1,1835,2651,0,1,0,2652,A
2-PB1,1836,1,2,2667,0,2670,G
2-PB1,1837,0,2649,0,0,2649,T
2-PB1,1838,5,3,2598,0,2606,G
2-PB1,1839,1,11,2600,0,2612,G
2-PB1,1840,2,12,2617,0,2631,G
2-PB1,1841,2623,1,3,0,2627,A
2-PB1,1842,3,0,2618,0,2621,G
2-PB1,1843,8,1,0,2609,2618,C
2-PB1,1844,1,2624,0,3,2628,T
2-PB1,1845,0,6,2627,2,2635,G
2-PB1,1846,2632,0,1,1,2634,A
2-PB1,1847,1,2635,0,0,2636,T
2-PB1,1848,0,5,2643,0,2648,G
2-PB1,1849,6,5,2642,0,2653,G
2-PB1,1850,2651,1,0,0,2652,A
2-PB1,1851,0,2641,0,1,2642,T
2-PB1,1852,0,9,2638,1,2648,G
2-PB1,1853,2637,0,2,0,2639,A
2-PB1,1854,1,10,2673,0,2684,G
2-PB1,1855,2678,0,2,0,2680,A
2-PB1,1856,2675,1,1,0,2677,A
2-PB1,1857,0,2666,0,0,2666,T
2-PB1,1858,0,2640,0,2,2642,T
2-PB1,1859,2652,1,0,0,2653,A
2-PB1,1860,1,2650,0,0,2651,T
2-PB1,1861,4,1,0,2646,2651,C
2-PB1,1862,2,1,2668,1,2672,G
2-PB1,1863,0,3,2649,1,2653,G
2-PB1,1864,2,4,2633,1,2640,G
2-PB1,1865,0,7,2635,1,2643,G
2-PB1,1866,2651,0,0,0,2651,A
2-PB1,1867,2643,0,1,0,2644,A
2-PB1,1868,0,12,2668,0,2680,G
2-PB1,1869,2713,0,1,0,2714,A
2-PB1,1870,1,0,0,2725,2726,C
2-PB1,1871,1,2694,0,1,2696,T
2-PB1,1872,0,2750,0,2,2752,T
2-PB1,1873,0,2750,0,3,2753,T
2-PB1,1874,1,2,2776,0,2779,G
2-PB1,1875,1,2778,0,1,2780,T
2-PB1,1876,2768,0,0,0,2768,A
2-PB1,1877,2761,0,0,1,2762,A
2-PB1,1878,0,2733,0,1,2734,T
2-PB1,1879,5,0,0,2746,2751,C
2-PB1,1880,9,8,0,2741,2758,C
2-PB1,1881,8,2,0,2742,2752,C
2-PB1,1882,7,1,0,2760,2768,C
2-PB1,1883,1,2750,1,1,2753,T
2-PB1,1884,1,8,2753,0,2762,G
2-PB1,1885,2755,1,0,0,2756,A
2-PB1,1886,2775,0,1,1,2777,A
2-PB1,1887,1,2778,0,2,2781,T
2-PB1,1888,5,1,0,2755,2761,C
2-PB1,1889,3,2,0,2747,2752,C
2-PB1,1890,4,0,0,2737,2741,C
2-PB1,1891,0,2731,0,3,2734,T
2-PB1,1892,1,2748,0,2,2751,T
2-PB1,1893,0,2743,0,0,2743,T
2-PB1,1894,0,0,2744,0,2744,G
2-PB1,1895,1,2732,0,5,2738,T
2-PB1,1896,12,0,0,2724,2736,C
2-PB1,1897,2708,0,6,1,2715,A
2-PB1,1898,0,2,2767,0,2769,G
2-PB1,1899,1,2,0,2759,2762,C
2-PB1,1900,4,1,0,2754,2759,C
2-PB1,1901,2763,0,2,0,2765,A
2-PB1,1902,1,2760,0,4,2765,T
2-PB1,1903,2769,0,2,0,2771,A
2-PB1,1904,2778,0,0,0,2778,A
2-PB1,1905,2783,0,1,0,2784,A
2-PB1,1906,0,5,2804,0,2809,G
2-PB1,1907,2742,1,1,0,2744,A
2-PB1,1908,2750,1,0,0,2751,A
2-PB1,1909,2749,0,2,0,2751,A
2-PB1,1910,0,2751,0,0,2751,T
2-PB1,1911,0,2743,0,1,2744,T
2-PB1,1912,0,8,2740,0,2748,G
2-PB1,1913,2745,0,0,0,2745,A
2-PB1,1914,2703,0,1,0,2704,A
2-PB1,1915,0,2790,0,1,2791,T
2-PB1,1916,8,0,0,2798,2806,C
2-PB1,1917,0,2801,0,3,2804,T
2-PB1,1918,1,0,2861,0,2862,G
2-PB1,1919,0,2856,0,0,2856,T
2-PB1,1920,2888,0,0,0,2888,A
2-PB1,1921,2884,1,0,1,2886,A
2-PB1,1922,2894,0,1,0,2895,A
2-PB1,1923,0,2,0,2903,2905,C
2-PB1,1924,2818,0,0,0,2818,A
2-PB1,1925,2889,0,2,0,2891,A
2-PB1,1926,0,2892,0,1,2893,T
2-PB1,1927,9,1,2880,0,2890,G
2-PB1,1928,0,0,1,2917,2918,C
2-PB1,1929,0,2887,0,2,2889,T
2-PB1,1930,1,2,2984,0,2987,G
2-PB1,1931,0,2982,1,2,2985,T
2-PB1,1932,3045,0,1,0,3046,A
2-PB1,1933,0,2,3047,0,3049,G
2-PB1,1934,0,2971,0,2,2973,T
2-PB1,1935,2962,0,1,0,2963,A
2-PB1,1936,2937,0,0,0,2937,A
2-PB1,1937,1,2913,1,1,2916,T
2-PB1,1938,0,0,2914,0,2914,G
2-PB1,1939,1,1,0,2878,2880,C
2-PB1,1940,4,1,0,2835,2840,C
2-PB1,1941,2782,8,3,0,2793,A
2-PB1,1942,0,1,2821,0,2822,G
2-PB1,1943,0,0,0,2915,2915,C
2-PB1,1944,4,1,0,2911,2916,C
2-PB1,1945,9,1,1,2886,2897,C
2-PB1,1946,2884,1,3,0,2888,A
2-PB1,1947,0,2886,0,0,2886,T
2-PB1,1948,0,9,2873,1,2883,G
2-PB1,1949,0,0,2893,0,2893,G
2-PB1,1950,0,2869,1,1,2871,T
2-PB1,1951,4,0,0,2847,2851,C
2-PB1,1952,6,3,0,2771,2780,C
2-PB1,1953,3,1,2810,0,2814,G
2-PB1,1954,4,1,2819,0,2824,G
2-PB1,1955,2,0,1,2808,2811,C
2-PB1,1956,7,0,1,2817,2825,C
2-PB1,1957,2824,1,0,0,2825,A
2-PB1,1958,2824,0,1,0,2825,A
2-PB1,1959,2829,0,0,0,2829,A
2-PB1,1960,2836,0,1,0,2837,A
2-PB1,1961,0,1,2877,0,2878,G
2-PB1,1962,0,2793,1,2,2796,T
2-PB1,1963,2817,0,1,0,2818,A
2-PB1,1964,2,2815,0,0,2817,T
2-PB1,1965,0,3,2833,0,2836,G
2-PB1,1966,0,4,2884,0,2888,G
2-PB1,1967,2862,0,0,1,2863,A
2-PB1,1968,2882,4,2,0,2888,A
2-PB1,1969,1,2878,5,1,2885,T
2-PB1,1970,2861,0,2,0,2863,A
2-PB1,1971,0,2859,0,1,2860,T
2-PB1,1972,1,6,2839,0,2846,G
2-PB1,1973,2848,0,0,0,2848,A
2-PB1,1974,0,2830,0,2,2832,T
2-PB1,1975,1,1,2759,0,2761,G
2-PB1,1976,0,0,26,2732,2758,C
2-PB1,1977,7,0,0,2741,2748,C
2-PB1,1978,4,2,2748,0,2754,G
2-PB1,1979,0,2755,0,1,2756,T
2-PB1,1980,0,2750,0,5,2755,T
2-PB1,1981,1,0,2761,0,2762,G
2-PB1,1982,0,1,0,2823,2824,C
2-PB1,1983,2814,0,2,0,2816,A
2-PB1,1984,2873,0,0,0,2873,A
2-PB1,1985,3,0,0,2875,2878,C
2-PB1,1986,0,2855,0,1,2856,T
2-PB1,1987,2868,1,1,0,2870,A
2-PB1,1988,0,2,0,2864,2866,C
2-PB1,1989,2861,0,0,1,2862,A
2-PB1,1990,1,0,0,2862,2863,C
2-PB1,1991,2755,1,1,0,2757,A
2-PB1,1992,1,1,0,2991,2993,C
2-PB1,1993,0,2952,0,1,2953,T
2-PB1,1994,7,2,0,2962,2971,C
2-PB1,1995,4,0,0,2959,2963,C
2-PB1,1996,0,2945,0,2,2947,T
2-PB1,1997,0,9,2935,0,2944,G
2-PB1,1998,1,3,2945,0,2949,G
2-PB1,1999,2949,0,1,0,2950,A
2-PB1,2000,0,2944,0,1,2945,T
2-PB1,2001,0,2712,0,2,2714,T
2-PB1,2002,9,0,1,2751,2761,C
2-PB1,2003,5,0,1,2739,2745,C
2-PB1,2004,3,1,0,2747,2751,C
2-PB1,2005,2764,0,0,0,2764,A
2-PB1,2006,2761,1,0,0,2762,A
2-PB1,2007,0,3,2763,0,2766,G
2-PB1,2008,2752,0,4,0,2756,A
2-PB1,2009,1,7,2745,0,2753,G
2-PB1,2010,1,5,2769,0,2775,G
2-PB1,2011,2721,3,1,1,2726,A
2-PB1,2012,2735,0,0,0,2735,A
2-PB1,2013,1,0,0,2738,2739,C
2-PB1,2014,3,0,0,2718,2721,C
2-PB1,2015,1,0,2766,0,2767,G
2-PB1,2016,1,0,0,2758,2759,C
2-PB1,2017,0,2751,1,0,2752,T
2-PB1,2018,6,0,1,2757,2764,C
2-PB1,2019,0,2749,0,1,2750,T
2-PB1,2020,2936,0,0,0,2936,A
2-PB1,2021,2,2929,0,3,2934,T
2-PB1,2022,0,2948,0,2,2950,T
2-PB1,2023,7,0,1,2941,2949,C
2-PB1,2024,1,2859,0,2,2862,T
2-PB1,2025,2866,0,1,0,2867,A
2-PB1,2026,2866,1,0,0,2867,A
2-PB1,2027,2868,0,3,0,2871,A
2-PB1,2028,0,1,0,2867,2868,C
2-PB1,2029,2676,0,2,0,2678,A
2-PB1,2030,1,1,0,2674,2676,C
2-PB1,2031,2633,1,1,0,2635,A
2-PB1,2032,2659,0,4,0,2663,A
2-PB1,2033,1,1,2677,0,2679,G
2-PB1,2034,0,1,0,2681,2682,C
2-PB1,2035,5,0,0,2681,2686,C
2-PB1,2036,2671,1,0,1,2673,A
2-PB1,2037,2661,1,6,0,2668,A
2-PB1,2038,2658,0,3,0,2661,A
2-PB1,2039,0,5,2690,0,2695,G
2-PB1,2040,1,3,2691,0,2695,G
2-PB1,2041,1,2,2658,0,2661,G
2-PB1,2042,0,6,2652,0,2658,G
2-PB1,2043,2643,0,2,0,2645,A
2-PB1,2044,2658,1,0,0,2659,A
2-PB1,2045,1,2662,0,0,2663,T
2-PB1,2046,0,2671,0,0,2671,T
2-PB1,2047,8,0,0,2677,2685,C
2-PB1,2048,1,2659,1,1,2662,T
2-PB1,2049,0,2651,1,4,2656,T
2-PB1,2050,0,3,2655,0,2658,G
2-PB1,2051,2652,0,4,0,2656,A
2-PB1,2052,1,6,2662,0,2669,G
2-PB1,2053,0,4,2661,0,2665,G
2-PB1,2054,2654,2,1,0,2657,A
2-PB1,2055,1,2642,0,0,2643,T
2-PB1,2056,1,13,2650,0,2664,G
2-PB1,2057,2661,0,4,0,2665,A
2-PB1,2058,2659,1,3,0,2663,A
2-PB1,2059,0,1,0,2672,2673,C
2-PB1,2060,2633,1,0,0,2634,A
2-PB1,2061,1,3,2674,0,2678,G
2-PB1,2062,2668,0,1,0,2669,A
2-PB1,2063,0,2664,0,3,2667,T
2-PB1,2064,0,1,2682,0,2683,G
2-PB1,2065,0,2735,0,6,2741,T
2-PB1,2066,2745,0,3,0,2748,A
2-PB1,2067,3,2,0,2736,2741,C
2-PB1,2068,6,0,0,2723,2729,C
2-PB1,2069,2701,0,0,1,2702,A
2-PB1,2070,0,7,2674,0,2681,G
2-PB1,2071,2652,0,1,0,2653,A
2-PB1,2072,2639,0,1,0,2640,A
2-PB1,2073,0,2,2658,0,2660,G
2-PB1,2074,0,2516,0,1,2517,T
2-PB1,2075,0,0,2512,0,2512,G
2-PB1,2076,0,1,0,2511,2512,C
2-PB1,2077,0,2502,0,5,2507,T
2-PB1,2078,0,1,2502,0,2503,G
2-PB1,2079,3,2,1,2489,2495,C
2-PB1,2080,2492,1,3,0,2496,A
2-PB1,2081,2493,3,0,0,2496,A
2-PB1,2082,0,0,0,2470,2470,C
2-PB1,2083,1,2453,1,1,2456,T
2-PB1,2084,0,2427,0,0,2427,T
2-PB1,2085,1,0,2431,0,2432,G
2-PB1,2086,0,2422,0,1,2423,T
2-PB1,2087,1,2417,0,1,2419,T
2-PB1,2088,13,0,0,2407,2420,C
2-PB1,2089,1,2,2412,0,2415,G
2-PB1,2090,2416,0,1,1,2418,A
2-PB1,2091,1,6,2415,0,2422,G
2-PB1,2092,2410,0,0,0,2410,A
2-PB1,2093,2413,0,0,0,2413,A
2-PB1,2094,2409,0,8,0,2417,A
2-PB1,2095,0,2422,0,0,2422,T
2-PB1,2096,0,2420,0,0,2420,T
2-PB1,2097,1,2421,0,1,2423,T
2-PB1,2098,0,2430,0,0,2430,T
2-PB1,2099,1,2414,0,0,2415,T
2-PB1,2100,4,1,0,2431,2436,C
2-PB1,2101,6,0,0,2428,2434,C
2-PB1,2102,5,0,1,2432,2438,C
2-PB1,2103,0,2434,0,4,2438,T
2-PB1,2104,2439,0,2,0,2441,A
2-PB1,2105,0,1,2447,0,2448,G
2-PB1,2106,1,2451,0,1,2453,T
2-PB1,2107,2466,0,1,0,2467,A
2-PB1,2108,1,0,2475,0,2476,G
2-PB1,2109,2,2458,0,0,2460,T
2-PB1,2110,1,2546,0,0,2547,T
2-PB1,2111,20,1,0,2542,2563,C
2-PB1,2112,2591,0,2,0,2593,A
2-PB1,2113,0,2602,0,2,2604,T
2-PB1,2114,2612,0,0,0,2612,A
2-PB1,2115,0,2616,0,0,2616,T
2-PB1,2116,2530,0,3,0,2533,A
2-PB1,2117,1,3,2513,0,2517,G
2-PB1,2118,0,1,2507,0,2508,G
2-PB1,2119,2249,0,0,0,2249,A
2-PB1,2120,0,10,2246,0,2256,G
2-PB1,2121,2136,0,3,0,2139,A
2-PB1,2122,2,1,0,2135,2138,C
2-PB1,2123,0,0,0,2072,2072,C
2-PB1,2124,0,3,2068,1,2072,G
2-PB1,2125,2070,0,0,0,2070,A
2-PB1,2126,1,2053,0,0,2054,T
2-PB1,2127,0,2053,0,0,2053,T
2-PB1,2128,2,1,2047,0,2050,G
2-PB1,2129,0,5,2046,0,2051,G
2-PB1,2130,2051,1,0,0,2052,A
2-PB1,2131,2050,0,0,0,2050,A
2-PB1,2132,0,2040,0,0,2040,T
2-PB1,2133,0,2052,0,0,2052,T
2-PB1,2134,0,2049,0,1,2050,T
2-PB1,2135,5,0,0,2051,2056,C
2-PB1,2136,1,2048,1,1,2051,T
2-PB1,2137,2043,0,4,1,2048,A
2-PB1,2138,0,0,2052,0,2052,G
2-PB1,2139,0,0,0,2046,2046,C
2-PB1,2140,2040,0,1,0,2041,A
2-PB1,2141,0,2034,0,0,2034,T
2-PB1,2142,0,2,2014,0,2016,G
2-PB1,2143,3,2,2063,0,2068,G
2-PB1,2144,0,2056,1,1,2058,T
2-PB1,2145,1,0,2056,0,2057,G
2-PB1,2146,0,1,2053,0,2054,G
2-PB1,2147,2030,0,4,0,2034,A
2-PB1,2148,1,1,2035,0,2037,G
2-PB1,2149,1,1,2025,0,2027,G
2-PB1,2150,0,3,0,2011,2014,C
2-PB1,2151,1,1,0,1992,1994,C
2-PB1,2152,1885,1,2,0,1888,A
2-PB1,2153,0,1881,1,2,1884,T
2-PB1,2154,2,2,1896,0,1900,G
2-PB1,2155,1,1,1915,0,1917,G
2-PB1,2156,1,1869,0,1,1871,T
2-PB1,2157,0,0,1895,0,1895,G
2-PB1,2158,1,1855,0,0,1856,T
2-PB1,2159,6,1,0,1832,1839,C
2-PB1,2160,1,1839,0,1,1841,T
2-PB1,2161,1824,0,0,0,1824,A
2-PB1,2162,0,0,1816,0,1816,G
2-PB1,2163,0,1,1775,1,1777,G
2-PB1,2164,0,0,1756,0,1756,G
2-PB1,2165,0,3,0,1725,1728,C
2-PB1,2166,4,0,0,1659,1663,C
2-PB1,2167,2,2,0,1620,1624,C
2-PB1,2168,2,0,1622,0,1624,G
2-PB1,2169,1,5,1623,2,1631,G
2-PB1,2170,1628,1,0,0,1629,A
2-PB1,2171,1,1623,0,0,1624,T
2-PB1,2172,0,1563,0,0,1563,T
2-PB1,2173,0,0,1542,0,1542,G
2-PB1,2174,1543,0,0,0,1543,A
2-PB1,2175,0,1544,1,0,1545,T
2-PB1,2176,0,0,1547,0,1547,G
2-PB1,2177,2,0,0,1524,1526,C
2-PB1,2178,2,3,0,1516,1521,C
2-PB1,2179,1504,0,1,0,1505,A
2-PB1,2180,0,2,1517,0,1519,G
2-PB1,2181,1518,0,0,0,1518,A
2-PB1,2182,1520,0,3,0,1523,A
2-PB1,2183,0,1514,0,0,1514,T
2-PB1,2184,0,1485,1,0,1486,T
2-PB1,2185,0,7,1477,0,1484,G
2-PB1,2186,1475,0,0,1,1476,A
2-PB1,2187,0,1446,0,0,1446,T
2-PB1,2188,0,1450,1,1,1452,T
2-PB1,2189,1,1455,0,0,1456,T
2-PB1,2190,8,0,0,1448,1456,C
2-PB1,2191,2,3,1451,0,1456,G
2-PB1,2192,1450,0,0,0,1450,A
2-PB1,2193,0,0,1438,0,1438,G
2-PB1,2194,0,1454,0,1,1455,T
2-PB1,2195,8,0,0,1448,1456,C
2-PB1,2196,0,1454,1,2,1457,T
2-PB1,2197,1,3,1457,0,1461,G
2-PB1,2198,0,0,1457,0,1457,G
2-PB1,2199,1459,0,0,0,1459,A
2-PB1,2200,1372,0,5,0,1377,A
2-PB1,2201,2,1,1385,1,1389,G
2-PB1,2202,0,3,1402,0,1405,G
2-PB1,2203,1404,0,1,1,1406,A
2-PB1,2204,0,1392,0,0,1392,T
2-PB1,2205,0,1388,1,0,1389,T
2-PB1,2206,1376,1,1,1,1379,A
2-PB1,2207,1383,1,0,0,1384,A
2-PB1,2208,0,1,1386,0,1387,G
2-PB1,2209,1374,0,2,0,1376,A
2-PB1,2210,1324,1,0,0,1325,A
2-PB1,2211,0,0,1238,0,1238,G
2-PB1,2212,0,1,1231,0,1232,G
2-PB1,2213,1232,0,0,0,1232,A
2-PB1,2214,1230,0,0,0,1230,A
2-PB1,2215,0,1,1237,0,1238,G
2-PB1,2216,1151,0,0,0,1151,A
2-PB1,2217,0,0,1148,0,1148,G
2-PB1,2218,0,1092,0,0,1092,T
2-PB1,2219,0,1078,0,0,1078,T
2-PB1,2220,2,0,0,1082,1084,C
2-PB1,2221,0,1050,0,2,1052,T
2-PB1,2222,2,0,0,1051,1053,C
2-PB1,2223,0,1049,0,0,1049,T
2-PB1,2224,0,1,1035,0,1036,G
2-PB1,2225,1010,0,2,0,1012,A
2-PB1,2226,0,2,999,0,1001,G
2-PB1,2227,986,0,3,1,990,A
2-PB1,2228,0,962,0,0,962,T
2-PB1,2229,2,1,0,908,911,C
2-PB1,2230,914,0,0,0,914,A
2-PB1,2231,0,906,0,1,907,T
2-PB1,2232,0,2,906,0,908,G
2-PB1,2233,903,0,0,0,903,A
2-PB1,2234,901,0,0,0,901,A
2-PB1,2235,0,0,883,0,883,G
2-PB1,2236,870,0,0,0,870,A
2-PB1,2237,0,867,0,1,868,T
2-PB1,2238,2,0,0,862,864,C
2-PB1,2239,0,820,0,0,820,T
2-PB1,2240,1,0,822,0,823,G
2-PB1,2241,0,817,0,1,818,T
2-PB1,2242,0,816,0,0,816,T
2-PB1,2243,4,0,0,814,818,C
2-PB1,2244,2,0,1,779,782,C
2-PB1,2245,771,0,1,0,772,A
2-PB1,2246,1,0,0,772,773,C
2-PB1,2247,2,0,0,735,737,C
2-PB1,2248,715,0,1,0,716,A
2-PB1,2249,0,683,0,0,683,T
2-PB1,2250,0,667,0,0,667,T
2-PB1,2251,0,0,666,0,666,G
2-PB1,2252,662,0,1,0,663,A
2-PB1,2253,655,0,2,0,657,A
2-PB1,2254,1,2,656,0,659,G
2-PB1,2255,563,0,2,0,565,A
2-PB1,2256,565,0,0,0,565,A
2-PB1,2257,0,0,0,553,553,C
2-PB1,2258,0,534,0,2,536,T
2-PB1,2259,0,0,0,535,535,C
2-PB1,2260,507,0,2,0,509,A
2-PB1,2261,0,2,509,0,511,G
2-PB1,2262,507,0,1,0,508,A
2-PB1,2263,0,0,0,492,492,C
2-PB1,2264,0,3,483,0,486,G
2-PB1,2265,0,0,470,0,470,G
2-PB1,2266,0,0,0,475,475,C
2-PB1,2267,474,0,0,0,474,A
2-PB1,2268,469,0,0,1,470,A
2-PB1,2269,466,0,0,0,466,A
2-PB1,2270,462,0,0,1,463,A
2-PB1,2271,463,0,0,0,463,A
2-PB1,2272,0,458,0,0,458,T
2-PB1,2273,438,0,0,0,438,A
2-PB1,2274,436,0,0,0,436,A
3-PA,1,107,0,0,0,107,A
3-PA,2,0,107,0,0,107,T
3-PA,3,0,0,113,0,113,G
3-PA,4,0,0,114,0,114,G
3-PA,5,115,0,0,0,115,A
3-PA,6,115,0,0,0,115,A
3-PA,7,0,0,117,0,117,G
3-PA,8,127,0,0,0,127,A
3-PA,9,0,128,0,0,128,T
3-PA,10,0,128,0,0,128,T
3-PA,11,0,136,0,0,136,T
3-PA,12,0,136,0,0,136,T
3-PA,13,0,0,140,0,140,G
3-PA,14,0,140,0,0,140,T
3-PA,15,0,0,141,0,141,G
3-PA,16,0,0,0,146,146,C
3-PA,17,0,2,144,0,146,G
3-PA,18,162,0,0,0,162,A
3-PA,19,0,0,0,166,166,C
3-PA,20,165,0,0,0,165,A
3-PA,21,168,0,0,0,168,A
3-PA,22,0,170,0,0,170,T
3-PA,23,0,1,200,0,201,G
3-PA,24,0,0,0,206,206,C
3-PA,25,0,205,0,1,206,T
3-PA,26,0,204,0,0,204,T
3-PA,27,0,0,0,208,208,C
3-PA,28,216,0,0,0,216,A
3-PA,29,224,0,0,0,224,A
3-PA,30,0,0,0,236,236,C
3-PA,31,0,0,0,237,237,C
3-PA,32,0,0,0,239,239,C
3-PA,33,0,1,240,0,241,G
3-PA,34,240,0,0,0,240,A
3-PA,35,0,243,0,0,243,T
3-PA,36,0,3,243,0,246,G
3-PA,37,249,0,0,0,249,A
3-PA,38,0,257,0,0,257,T
3-PA,39,0,259,0,0,259,T
3-PA,40,0,0,260,0,260,G
3-PA,41,0,260,0,0,260,T
3-PA,42,1,0,0,256,257,C
3-PA,43,0,0,258,0,258,G
3-PA,44,263,0,0,0,263,A
3-PA,45,264,0,0,0,264,A
3-PA,46,0,0,0,266,266,C
3-PA,47,0,267,0,0,267,T
3-PA,48,0,267,0,0,267,T
3-PA,49,0,0,270,0,270,G
3-PA,50,0,2,0,269,271,C
3-PA,51,270,0,0,0,270,A
3-PA,52,0,1,270,0,271,G
3-PA,53,271,0,0,0,271,A
3-PA,54,272,0,0,0,272,A
3-PA,55,271,0,0,0,271,A
3-PA,56,272,0,0,0,272,A
3-PA,57,273,0,0,0,273,A
3-PA,58,0,0,277,0,277,G
3-PA,59,0,0,0,287,287,C
3-PA,60,288,0,0,0,288,A
3-PA,61,309,0,0,0,309,A
3-PA,62,0,309,0,0,309,T
3-PA,63,1,1,312,0,314,G
3-PA,64,318,0,0,0,318,A
3-PA,65,316,0,0,1,317,A
3-PA,66,322,0,0,0,322,A
3-PA,67,0,2,346,0,348,G
3-PA,68,370,0,0,0,370,A
3-PA,69,0,0,438,0,438,G
3-PA,70,0,441,1,1,443,T
3-PA,71,444,0,0,0,444,A
3-PA,72,0,441,0,0,441,T
3-PA,73,0,2,435,0,437,G
3-PA,74,0,0,440,0,440,G
3-PA,75,0,2,438,0,440,G
3-PA,76,0,1,442,0,443,G
3-PA,77,438,0,0,0,438,A
3-PA,78,0,3,436,0,439,G
3-PA,79,0,0,445,0,445,G
3-PA,80,441,1,0,0,442,A
3-PA,81,0,450,0,0,450,T
3-PA,82,2,0,0,449,451,C
3-PA,83,0,450,0,0,450,T
3-PA,84,0,3,450,0,453,G
3-PA,85,453,0,0,0,453,A
3-PA,86,453,0,1,0,454,A
3-PA,87,455,0,0,0,455,A
3-PA,88,453,1,0,0,454,A
3-PA,89,0,453,0,0,453,T
3-PA,90,1,452,0,1,454,T
3-PA,91,0,3,448,0,451,G
3-PA,92,456,1,0,0,457,A
3-PA,93,456,0,0,0,456,A
3-PA,94,456,0,1,0,457,A
3-PA,95,0,0,0,457,457,C
3-PA,96,461,0,0,0,461,A
3-PA,97,460,0,1,0,461,A
3-PA,98,463,0,0,0,463,A
3-PA,99,1,0,0,465,466,C
3-PA,100,465,0,0,0,465,A
3-PA,101,467,0,0,0,467,A
3-PA,102,474,0,0,0,474,A
3-PA,103,0,473,0,0,473,T
3-PA,104,0,474,0,0,474,T
3-PA,105,0,476,0,1,477,T
3-PA,106,0,0,476,0,476,G
3-PA,107,0,0,0,481,481,C
3-PA,108,479,0,0,0,479,A
3-PA,109,0,0,497,0,497,G
3-PA,110,0,0,1,498,499,C
3-PA,111,531,1,0,0,532,A
3-PA,112,539,1,1,0,541,A
3-PA,113,0,552,0,0,552,T
3-PA,114,564,0,0,0,564,A
3-PA,115,0,563,1,0,564,T
3-PA,116,1,1,565,0,567,G
3-PA,117,0,0,0,567,567,C
3-PA,118,566,0,0,0,566,A
3-PA,119,0,0,0,575,575,C
3-PA,120,0,565,0,0,565,T
3-PA,121,4,0,0,670,674,C
3-PA,122,701,0,0,0,701,A
3-PA,123,0,0,0,717,717,C
3-PA,124,1,716,0,0,717,T
3-PA,125,0,719,0,0,719,T
3-PA,126,0,0,717,0,717,G
3-PA,127,0,3,720,0,723,G
3-PA,128,718,0,2,0,720,A
3-PA,129,0,4,734,0,738,G
3-PA,130,0,0,736,0,736,G
3-PA,131,1,714,0,2,717,T
3-PA,132,0,0,744,0,744,G
3-PA,133,0,746,0,0,746,T
3-PA,134,0,0,764,0,764,G
3-PA,135,1,762,0,1,764,T
3-PA,136,0,761,0,0,761,T
3-PA,137,0,764,0,0,764,T
3-PA,138,1,1,0,770,772,C
3-PA,139,771,0,1,0,772,A
3-PA,140,0,772,0,0,772,T
3-PA,141,0,0,784,0,784,G
3-PA,142,0,779,0,0,779,T
3-PA,143,794,0,0,0,794,A
3-PA,144,0,794,0,0,794,T
3-PA,145,0,793,0,0,793,T
3-PA,146,1,2,0,792,795,C
3-PA,147,790,0,0,0,790,A
3-PA,148,0,2,799,0,801,G
3-PA,149,800,0,0,0,800,A
3-PA,150,0,801,0,0,801,T
3-PA,151,0,799,1,1,801,T
3-PA,152,0,796,0,0,796,T
3-PA,153,1,0,0,791,792,C
3-PA,154,0,0,0,810,810,C
3-PA,155,812,0,0,0,812,A
3-PA,156,0,810,0,0,810,T
3-PA,157,0,806,0,1,807,T
3-PA,158,0,810,0,1,811,T
3-PA,159,0,0,0,812,812,C
3-PA,160,809,0,5,0,814,A
3-PA,161,0,835,0,0,835,T
3-PA,162,2,0,0,836,838,C
3-PA,163,834,0,1,0,835,A
3-PA,164,835,0,0,0,835,A
3-PA,165,0,833,0,0,833,T
3-PA,166,0,4,855,0,859,G
3-PA,167,856,0,0,0,856,A
3-PA,168,859,0,0,0,859,A
3-PA,169,0,0,0,856,856,C
3-PA,170,847,0,0,0,847,A
3-PA,171,855,0,0,0,855,A
3-PA,172,0,2,859,0,861,G
3-PA,173,0,0,862,0,862,G
3-PA,174,0,0,0,866,866,C
3-PA,175,0,1,862,0,863,G
3-PA,176,912,0,1,0,913,A
3-PA,177,911,0,0,0,911,A
3-PA,178,0,911,0,0,911,T
3-PA,179,1,0,1,925,927,C
3-PA,180,924,0,1,0,925,A
3-PA,181,927,0,2,0,929,A
3-PA,182,0,933,0,0,933,T
3-PA,183,930,0,0,0,930,A
3-PA,184,0,1,940,0,941,G
3-PA,185,0,934,0,1,935,T
3-PA,186,0,2,941,0,943,G
3-PA,187,0,0,944,0,944,G
3-PA,188,0,939,0,0,939,T
3-PA,189,937,0,1,0,938,A
3-PA,190,0,7,944,0,951,G
3-PA,191,944,0,1,0,945,A
3-PA,192,951,0,0,0,951,A
3-PA,193,0,0,0,947,947,C
3-PA,194,0,933,0,0,933,T
3-PA,195,0,933,0,1,934,T
3-PA,196,0,5,926,0,931,G
3-PA,197,929,1,2,0,932,A
3-PA,198,0,2,0,931,933,C
3-PA,199,1,3,926,0,930,G
3-PA,200,945,0,2,0,947,A
3-PA,201,0,958,0,1,959,T
3-PA,202,1,0,0,964,965,C
3-PA,203,2,0,0,983,985,C
3-PA,204,985,0,0,0,985,A
3-PA,205,983,0,0,0,983,A
3-PA,206,985,0,0,0,985,A
3-PA,207,0,989,0,0,989,T
3-PA,208,0,0,989,0,989,G
3-PA,209,0,0,0,978,978,C
3-PA,210,974,1,0,0,975,A
3-PA,211,0,0,1,999,1000,C
3-PA,212,0,994,0,1,995,T
3-PA,213,0,1,1129,0,1130,G
3-PA,214,0,1133,0,0,1133,T
3-PA,215,0,1132,0,0,1132,T
3-PA,216,1133,0,0,0,1133,A
3-PA,217,1130,1,2,0,1133,A
3-PA,218,1133,0,1,0,1134,A
3-PA,219,0,0,1133,0,1133,G
3-PA,220,0,0,0,1120,1120,C
3-PA,221,1114,0,1,0,1115,A
3-PA,222,1,0,0,1110,1111,C
3-PA,223,1039,1,2,0,1042,A
3-PA,224,0,5,1094,0,1099,G
3-PA,225,1098,0,0,0,1098,A
3-PA,226,0,1097,0,0,1097,T
3-PA,227,1,1092,0,1,1094,T
3-PA,228,0,1093,0,0,1093,T
3-PA,229,1,1,1098,1,1101,G
3-PA,230,1095,1,0,0,1096,A
3-PA,231,1100,0,1,0,1101,A
3-PA,232,1102,1,1,0,1104,A
3-PA,233,0,1079,0,0,1079,T
3-PA,234,1077,0,1,0,1078,A
3-PA,235,1088,0,1,0,1089,A
3-PA,236,1,1087,1,0,1089,T
3-PA,237,5,1,0,1089,1095,C
3-PA,238,0,2,1089,0,1091,G
3-PA,239,1085,0,1,0,1086,A
3-PA,240,0,1,1089,0,1090,G
3-PA,241,0,4,1099,0,1103,G
3-PA,242,0,1,1104,0,1105,G
3-PA,243,0,4,1098,0,1102,G
3-PA,244,1090,1,4,0,1095,A
3-PA,245,1,7,1091,0,1099,G
3-PA,246,1114,0,1,0,1115,A
3-PA,247,0,3,1121,0,1124,G
3-PA,248,1124,0,1,0,1125,A
3-PA,249,2,2,0,1120,1124,C
3-PA,250,1106,0,1,0,1107,A
3-PA,251,0,2,1118,1,1121,G
3-PA,252,1122,1,0,0,1123,A
3-PA,253,1137,0,1,0,1138,A
3-PA,254,1,0,0,1137,1138,C
3-PA,255,1114,1,1,0,1116,A
3-PA,256,1117,0,0,0,1117,A
3-PA,257,0,1109,0,0,1109,T
3-PA,258,1,1,1162,0,1164,G
3-PA,259,0,0,1171,0,1171,G
3-PA,260,0,0,0,1162,1162,C
3-PA,261,1,0,0,1168,1169,C
3-PA,262,0,1161,0,1,1162,T
3-PA,263,1,1,1194,1,1197,G
3-PA,264,0,5,1192,0,1197,G
3-PA,265,1199,0,0,0,1199,A
3-PA,266,1,0,0,1198,1199,C
3-PA,267,1159,0,0,0,1159,A
3-PA,268,0,1,1293,0,1294,G
3-PA,269,0,1295,0,1,1296,T
3-PA,270,1318,0,0,0,1318,A
3-PA,271,0,3,1317,0,1320,G
3-PA,272,0,1300,0,0,1300,T
3-PA,273,1305,0,1,0,1306,A
3-PA,274,1311,0,0,0,1311,A
3-PA,275,1303,0,0,0,1303,A
3-PA,276,0,1,0,1315,1316,C
3-PA,277,1242,1,0,0,1243,A
3-PA,278,2,0,1276,0,1278,G
3-PA,279,0,1261,0,1,1262,T
3-PA,280,1282,0,0,0,1282,A
3-PA,281,0,1281,0,0,1281,T
3-PA,282,0,0,0,1288,1288,C
3-PA,283,1,1286,0,0,1287,T
3-PA,284,0,0,1283,0,1283,G
3-PA,285,0,0,1,1277,1278,C
3-PA,286,1270,0,0,0,1270,A
3-PA,287,1271,0,0,0,1271,A
3-PA,288,2,0,0,1281,1283,C
3-PA,289,1271,0,0,0,1271,A
3-PA,290,4,0,0,1326,1330,C
3-PA,291,0,1301,0,0,1301,T
3-PA,292,1311,0,0,0,1311,A
3-PA,293,0,0,0,1310,1310,C
3-PA,294,1,1305,0,0,1306,T
3-PA,295,0,3,1301,1,1305,G
3-PA,296,0,5,1285,0,1290,G
3-PA,297,1282,0,1,0,1283,A
3-PA,298,0,0,1278,0,1278,G
3-PA,299,1,0,0,1260,1261,C
3-PA,300,0,1259,0,2,1261,T
3-PA,301,0,2,1259,0,1261,G
3-PA,302,0,2,1263,0,1265,G
3-PA,303,1257,0,1,0,1258,A
3-PA,304,1262,0,0,0,1262,A
3-PA,305,1256,0,0,0,1256,A
3-PA,306,1261,0,0,0,1261,A
3-PA,307,0,0,0,1261,1261,C
3-PA,308,1,0,0,1260,1261,C
3-PA,309,1,6,1252,0,1259,G
3-PA,310,1258,0,0,0,1258,A
3-PA,311,1259,0,0,0,1259,A
3-PA,312,0,1,1261,0,1262,G
3-PA,313,1,1257,3,0,1261,T
3-PA,314,0,1259,0,1,1260,T
3-PA,315,0,1263,0,0,1263,T
3-PA,316,4,0,0,1270,1274,C
3-PA,317,0,1277,0,0,1277,T
3-PA,318,1284,0,0,0,1284,A
3-PA,319,2,1,0,1275,1278,C
3-PA,320,1,0,0,1280,1281,C
3-PA,321,1269,1,0,0,1270,A
3-PA,322,0,1,1267,1,1269,G
3-PA,323,1270,0,0,0,1270,A
3-PA,324,2,0,0,1256,1258,C
3-PA,325,0,1289,0,1,1290,T
3-PA,326,0,1297,0,0,1297,T
3-PA,327,1,0,1313,0,1314,G
3-PA,328,0,1311,0,0,1311,T
3-PA,329,1313,1,0,0,1314,A
3-PA,330,1,1317,0,0,1318,T
3-PA,331,0,5,1307,0,1312,G
3-PA,332,1368,1,1,0,1370,A
3-PA,333,1,1357,0,2,1360,T
3-PA,334,2,1352,0,0,1354,T
3-PA,335,1358,2,0,0,1360,A
3-PA,336,1,0,0,1358,1359,C
3-PA,337,1359,0,1,0,1360,A
3-PA,338,1363,0,0,0,1363,A
3-PA,339,1,3,1361,0,1365,G
3-PA,340,0,1,1386,0,1387,G
3-PA,341,1326,0,0,0,1326,A
3-PA,342,0,5,1337,0,1342,G
3-PA,343,1341,0,0,0,1341,A
3-PA,344,1342,0,1,0,1343,A
3-PA,345,3,1,0,1338,1342,C
3-PA,346,1329,0,1,0,1330,A
3-PA,347,0,4,1329,0,1333,G
3-PA,348,1323,0,1,0,1324,A
3-PA,349,0,1304,0,0,1304,T
3-PA,350,1,1302,0,0,1303,T
3-PA,351,3,0,0,1289,1292,C
3-PA,352,1,0,1293,0,1294,G
3-PA,353,0,1292,0,0,1292,T
3-PA,354,4,0,0,1295,1299,C
3-PA,355,0,5,1295,0,1300,G
3-PA,356,1298,0,2,0,1300,A
3-PA,357,1299,1,0,0,1300,A
3-PA,358,1306,0,0,0,1306,A
3-PA,359,0,1303,0,0,1303,T
3-PA,360,0,1301,0,0,1301,T
3-PA,361,1,0,1292,0,1293,G
3-PA,362,0,4,1291,0,1295,G
3-PA,363,0,3,1291,0,1294,G
3-PA,364,1,0,1301,0,1302,G
3-PA,365,1,1291,0,1,1293,T
3-PA,366,0,5,1308,0,1313,G
3-PA,367,1311,0,1,0,1312,A
3-PA,368,0,1,0,1329,1330,C
3-PA,369,1333,0,0,0,1333,A
3-PA,370,1330,0,1,0,1331,A
3-PA,371,1,1,1349,0,1351,G
3-PA,372,0,2,1350,0,1352,G
3-PA,373,1337,0,1,0,1338,A
3-PA,374,0,1,1335,0,1336,G
3-PA,375,1305,1,1,0,1307,A
3-PA,376,0,3,1313,0,1316,G
3-PA,377,1297,0,0,0,1297,A
3-PA,378,1298,0,1,0,1299,A
3-PA,379,1,1,1340,0,1342,G
3-PA,380,0,1304,0,0,1304,T
3-PA,381,8,0,0,1309,1317,C
3-PA,382,5,1,0,1322,1328,C
3-PA,383,1337,0,1,0,1338,A
3-PA,384,0,0,0,1365,1365,C
3-PA,385,1399,1,0,0,1400,A
3-PA,386,0,1427,0,1,1428,T
3-PA,387,1448,0,0,0,1448,A
3-PA,388,0,1404,0,0,1404,T
3-PA,389,1401,0,0,0,1401,A
3-PA,390,0,1380,0,0,1380,T
3-PA,391,0,1375,0,0,1375,T
3-PA,392,1395,1,0,0,1396,A
3-PA,393,1,0,0,1389,1390,C
3-PA,394,0,0,0,1325,1325,C
3-PA,395,0,1303,0,1,1304,T
3-PA,396,0,1276,0,7,1283,T
3-PA,397,0,5,1285,0,1290,G
3-PA,398,1286,0,0,0,1286,A
3-PA,399,1290,0,0,0,1290,A
3-PA,400,1288,0,1,0,1289,A
3-PA,401,1229,0,0,0,1229,A
3-PA,402,0,2,1235,0,1237,G
3-PA,403,0,0,1239,0,1239,G
3-PA,404,0,3,0,1238,1241,C
3-PA,405,1,1,0,1243,1245,C
3-PA,406,1245,0,0,0,1245,A
3-PA,407,1245,0,0,0,1245,A
3-PA,408,0,1245,0,0,1245,T
3-PA,409,1245,0,0,0,1245,A
3-PA,410,1242,1,1,2,1246,A
3-PA,411,0,3,1274,0,1277,G
3-PA,412,1261,1,0,0,1262,A
3-PA,413,0,1261,0,0,1261,T
3-PA,414,0,1257,0,1,1258,T
3-PA,415,1259,1,0,0,1260,A
3-PA,416,1253,0,0,0,1253,A
3-PA,417,1260,0,0,0,1260,A
3-PA,418,0,1267,1,0,1268,T
3-PA,419,3,0,0,1271,1274,C
3-PA,420,0,1237,0,0,1237,T
3-PA,421,0,4,1245,0,1249,G
3-PA,422,1251,1,0,0,1252,A
3-PA,423,1,5,1259,0,1265,G
3-PA,424,1264,0,1,0,1265,A
3-PA,425,1270,0,0,0,1270,A
3-PA,426,1,0,0,1275,1276,C
3-PA,427,1271,0,1,0,1272,A
3-PA,428,0,0,0,1275,1275,C
3-PA,429,1276,0,1,0,1277,A
3-PA,430,1,1,0,1295,1297,C
3-PA,431,1289,0,0,0,1289,A
3-PA,432,1,0,0,1311,1312,C
3-PA,433,1303,1,0,0,1304,A
3-PA,434,0,1305,0,0,1305,T
3-PA,435,0,1298,0,0,1298,T
3-PA,436,7,0,0,1302,1309,C
3-PA,437,1299,0,0,0,1299,A
3-PA,438,0,0,0,1305,1305,C
3-PA,439,1294,0,0,0,1294,A
3-PA,440,0,1290,1,0,1291,T
3-PA,441,1,1263,0,1,1265,T
3-PA,442,0,1271,1,0,1272,T
3-PA,443,0,1272,0,1,1273,T
3-PA,444,1,0,0,1288,1289,C
3-PA,445,0,1280,0,2,1282,T
3-PA,446,4,1,0,1282,1287,C
3-PA,447,1281,0,0,0,1281,A
3-PA,448,0,1281,0,0,1281,T
3-PA,449,0,1290,1,0,1291,T
3-PA,450,4,0,0,1289,1293,C
3-PA,451,1286,0,0,0,1286,A
3-PA,452,1,0,0,1293,1294,C
3-PA,453,0,1280,0,0,1280,T
3-PA,454,0,2,1302,0,1304,G
3-PA,455,0,2,1300,0,1302,G
3-PA,456,0,1,1307,0,1308,G
3-PA,457,1,1,1307,0,1309,G
3-PA,458,1294,0,2,0,1296,A
3-PA,459,0,0,1300,1,1301,G
3-PA,460,0,3,1302,0,1305,G
3-PA,461,1296,1,2,0,1299,A
3-PA,462,1303,0,0,0,1303,A
3-PA,463,1285,0,0,0,1285,A
3-PA,464,0,1272,0,0,1272,T
3-PA,465,1,2,1276,0,1279,G
3-PA,466,0,2,1279,0,1281,G
3-PA,467,0,0,0,1281,1281,C
3-PA,468,3,0,0,1270,1273,C
3-PA,469,1268,1,0,0,1269,A
3-PA,470,0,1,0,1276,1277,C
3-PA,471,1275,0,0,0,1275,A
3-PA,472,1278,1,0,0,1279,A
3-PA,473,1278,0,0,0,1278,A
3-PA,474,0,3,1292,0,1295,G
3-PA,475,0,2,1292,0,1294,G
3-PA,476,0,1,0,1299,1300,C
3-PA,477,1303,0,0,0,1303,A
3-PA,478,0,2,1318,0,1320,G
3-PA,479,1322,0,0,0,1322,A
3-PA,480,3,0,0,1337,1340,C
3-PA,481,0,1329,0,1,1330,T
3-PA,482,1326,1,1,0,1328,A
3-PA,483,1,0,0,1324,1325,C
3-PA,484,1314,0,0,0,1314,A
3-PA,485,1,0,0,1328,1329,C
3-PA,486,0,1298,0,0,1298,T
3-PA,487,2,0,0,1303,1305,C
3-PA,488,1,1301,0,0,1302,T
3-PA,489,1,0,0,1287,1288,C
3-PA,490,1,1,1281,0,1283,G
3-PA,491,1287,0,0,0,1287,A
3-PA,492,0,1,0,1280,1281,C
3-PA,493,0,1,1290,0,1291,G
3-PA,494,1282,0,3,0,1285,A
3-PA,495,0,0,1290,0,1290,G
3-PA,496,0,2,1282,0,1284,G
3-PA,497,1283,0,0,0,1283,A
3-PA,498,1277,0,1,0,1278,A
3-PA,499,1270,1,0,1,1272,A
3-PA,500,0,0,1280,0,1280,G
3-PA,501,1,0,0,1277,1278,C
3-PA,502,1268,0,1,0,1269,A
3-PA,503,1,4,1280,0,1285,G
3-PA,504,0,0,1288,0,1288,G
3-PA,505,0,0,1290,0,1290,G
3-PA,506,0,0,0,1290,1290,C
3-PA,507,0,1273,0,0,1273,T
3-PA,508,1273,0,2,0,1275,A
3-PA,509,2,0,1293,0,1295,G
3-PA,510,1,1,1355,0,1357,G
3-PA,511,1362,0,0,0,1362,A
3-PA,512,0,1335,0,0,1335,T
3-PA,513,0,1312,0,0,1312,T
3-PA,514,1311,0,1,0,1312,A
3-PA,515,1313,0,1,0,1314,A
3-PA,516,0,3,1314,0,1317,G
3-PA,517,1314,0,0,0,1314,A
3-PA,518,3,0,0,1307,1310,C
3-PA,519,1,1,0,1226,1228,C
3-PA,520,1207,0,0,0,1207,A
3-PA,521,0,2,1220,0,1222,G
3-PA,522,0,0,1225,0,1225,G
3-PA,523,0,0,0,1224,1224,C
3-PA,524,0,1207,0,0,1207,T
3-PA,525,0,1,1250,2,1253,G
3-PA,526,0,1249,0,0,1249,T
3-PA,527,0,1251,0,0,1251,T
3-PA,528,1,1251,0,0,1252,T
3-PA,529,1246,0,0,0,1246,A
3-PA,530,0,1,0,1256,1257,C
3-PA,531,5,1,0,1231,1237,C
3-PA,532,1231,0,0,0,1231,A
3-PA,533,0,1231,0,0,1231,T
3-PA,534,1177,0,0,0,1177,A
3-PA,535,1178,0,1,0,1179,A
3-PA,536,3,1,1200,0,1204,G
3-PA,537,1202,0,0,0,1202,A
3-PA,538,4,1,0,1191,1196,C
3-PA,539,1161,0,0,0,1161,A
3-PA,540,1161,0,0,0,1161,A
3-PA,541,0,6,1164,0,1170,G
3-PA,542,1163,0,1,0,1164,A
3-PA,543,1164,1,0,0,1165,A
3-PA,544,1157,0,0,0,1157,A
3-PA,545,0,1126,0,3,1129,T
3-PA,546,0,3,1151,0,1154,G
3-PA,547,0,2,1147,0,1149,G
3-PA,548,2,1,1,1146,1150,C
3-PA,549,0,2,0,1155,1157,C
3-PA,550,1145,2,0,0,1147,A
3-PA,551,1146,0,1,0,1147,A
3-PA,552,0,1094,1,0,1095,T
3-PA,553,1130,0,2,0,1132,A
3-PA,554,1,3,1130,0,1134,G
3-PA,555,1135,0,0,0,1135,A
3-PA,556,0,1,1133,0,1134,G
3-PA,557,0,1,1135,0,1136,G
3-PA,558,0,0,0,1138,1138,C
3-PA,559,0,0,0,1149,1149,C
3-PA,560,0,1120,0,0,1120,T
3-PA,561,2,0,0,1126,1128,C
3-PA,562,0,1126,0,0,1126,T
3-PA,563,1,1,1123,0,1125,G
3-PA,564,0,2,1124,0,1126,G
3-PA,565,2,4,1110,0,1116,G
3-PA,566,1104,0,0,0,1104,A
3-PA,567,0,1067,0,2,1069,T
3-PA,568,0,1036,0,0,1036,T
3-PA,569,5,2,0,1137,1144,C
3-PA,570,2,0,0,1100,1102,C
3-PA,571,0,1068,0,2,1070,T
3-PA,572,0,1069,0,1,1070,T
3-PA,573,0,1064,0,1,1065,T
3-PA,574,4,1,0,1068,1073,C
3-PA,575,1,0,1072,0,1073,G
3-PA,576,0,1066,0,2,1068,T
3-PA,577,3,0,0,1071,1074,C
3-PA,578,1053,0,0,0,1053,A
3-PA,579,0,0,1205,0,1205,G
3-PA,580,0,1210,0,0,1210,T
3-PA,581,3,1,0,1204,1208,C
3-PA,582,3,0,0,1206,1209,C
3-PA,583,1,10,1210,0,1221,G
3-PA,584,1222,0,0,0,1222,A
3-PA,585,1219,0,1,0,1220,A
3-PA,586,1220,0,1,0,1221,A
3-PA,587,0,1,1226,1,1228,G
3-PA,588,1187,0,0,1,1188,A
3-PA,589,1,2,1198,0,1201,G
3-PA,590,1,0,1203,0,1204,G
3-PA,591,1,0,0,1206,1207,C
3-PA,592,0,1,1211,0,1212,G
3-PA,593,1213,0,0,0,1213,A
3-PA,594,1213,0,1,0,1214,A
3-PA,595,0,1,1218,0,1219,G
3-PA,596,1220,1,0,0,1221,A
3-PA,597,1216,0,2,0,1218,A
3-PA,598,1209,1,1,0,1211,A
3-PA,599,0,0,0,1227,1227,C
3-PA,600,1224,0,0,0,1224,A
3-PA,601,1228,0,1,0,1229,A
3-PA,602,1,1223,0,1,1225,T
3-PA,603,0,1226,0,0,1226,T
3-PA,604,0,2,1223,0,1225,G
3-PA,605,1223,0,1,0,1224,A
3-PA,606,1220,2,0,0,1222,A
3-PA,607,1,2,1222,0,1225,G
3-PA,608,1219,0,2,0,1221,A
3-PA,609,1218,0,1,0,1219,A
3-PA,610,1215,0,2,0,1217,A
3-PA,611,1215,0,0,0,1215,A
3-PA,612,1224,0,0,0,1224,A
3-PA,613,0,1223,0,0,1223,T
3-PA,614,0,1224,0,1,1225,T
3-PA,615,0,1227,0,0,1227,T
3-PA,616,0,2,1227,0,1229,G
3-PA,617,1227,0,0,0,1227,A
3-PA,618,1225,0,1,0,1226,A
3-PA,619,1234,0,0,0,1234,A
3-PA,620,0,1251,1,1,1253,T
3-PA,621,6,2,0,1375,1383,C
3-PA,622,1379,0,0,0,1379,A
3-PA,623,0,0,0,1392,1392,C
3-PA,624,1384,0,1,0,1385,A
3-PA,625,0,1,1428,0,1429,G
3-PA,626,1,11,1472,0,1484,G
3-PA,627,1514,0,2,0,1516,A
3-PA,628,1530,0,0,0,1530,A
3-PA,629,1,2,0,1545,1548,C
3-PA,630,0,1494,0,0,1494,T
3-PA,631,1629,0,0,0,1629,A
3-PA,632,0,1663,0,0,1663,T
3-PA,633,0,1,1711,0,1712,G
3-PA,634,1,1,0,1691,1693,C
3-PA,635,1,1,1680,0,1682,G
3-PA,636,0,1670,0,1,1671,T
3-PA,637,1657,0,1,0,1658,A
3-PA,638,1,3,1666,0,1670,G
3-PA,639,1,0,1664,0,1665,G
3-PA,640,1,1,0,1639,1641,C
3-PA,641,0,1616,0,1,1617,T
3-PA,642,0,1598,0,1,1599,T
3-PA,643,2,1,1600,0,1603,G
3-PA,644,2,2,0,1600,1604,C
3-PA,645,7,2,0,1597,1606,C
3-PA,646,0,6,1609,0,1615,G
3-PA,647,1616,2,0,0,1618,A
3-PA,648,0,0,0,1625,1625,C
3-PA,649,4,1,0,1625,1630,C
3-PA,650,1634,0,0,0,1634,A
3-PA,651,1638,1,0,0,1639,A
3-PA,652,1639,1,0,0,1640,A
3-PA,653,0,2,1671,0,1673,G
3-PA,654,0,1666,0,0,1666,T
3-PA,655,6,0,0,1654,1660,C
3-PA,656,1,1656,0,1,1658,T
3-PA,657,1,0,0,1667,1668,C
3-PA,658,2,3,0,1667,1672,C
3-PA,659,4,1,0,1679,1684,C
3-PA,660,1688,0,1,0,1689,A
3-PA,661,0,0,0,1700,1700,C
3-PA,662,2,0,0,1686,1688,C
3-PA,663,0,10,1690,0,1700,G
3-PA,664,1715,0,0,0,1715,A
3-PA,665,1720,0,0,0,1720,A
3-PA,666,0,0,0,1732,1732,C
3-PA,667,0,1704,0,3,1707,T
3-PA,668,0,1750,0,0,1750,T
3-PA,669,4,0,1,1767,1772,C
3-PA,670,0,1760,0,0,1760,T
3-PA,671,7,0,0,1763,1770,C
3-PA,672,0,0,0,1764,1764,C
3-PA,673,0,1747,0,3,1750,T
3-PA,674,1,4,1773,0,1778,G
3-PA,675,1,0,0,1771,1772,C
3-PA,676,7,0,0,1775,1782,C
3-PA,677,0,1766,0,0,1766,T
3-PA,678,0,1758,0,0,1758,T
3-PA,679,0,5,1753,0,1758,G
3-PA,680,1761,1,2,0,1764,A
3-PA,681,1,3,1780,0,1784,G
3-PA,682,1775,0,3,0,1778,A
3-PA,683,1780,1,0,0,1781,A
3-PA,684,0,1817,0,3,1820,T
3-PA,685,0,1824,0,0,1824,T
3-PA,686,0,1832,0,0,1832,T
3-PA,687,0,1833,1,0,1834,T
3-PA,688,1827,0,0,0,1827,A
3-PA,689,1,1,1827,0,1829,G
3-PA,690,1806,0,3,0,1809,A
3-PA,691,5,0,1873,0,1878,G
3-PA,692,2,1,0,1878,1881,C
3-PA,693,3,0,0,1903,1906,C
3-PA,694,0,1927,0,0,1927,T
3-PA,695,2008,0,0,0,2008,A
3-PA,696,0,2009,0,0,2009,T
3-PA,697,2,0,2031,0,2033,G
3-PA,698,0,2029,0,1,2030,T
3-PA,699,2,6,2031,0,2039,G
3-PA,700,0,4,2004,0,2008,G
3-PA,701,1995,1,2,0,1998,A
3-PA,702,0,1970,0,1,1971,T
3-PA,703,0,6,1913,0,1919,G
3-PA,704,1,4,1962,0,1967,G
3-PA,705,1961,0,2,0,1963,A
3-PA,706,0,1960,0,0,1960,T
3-PA,707,1,1954,0,0,1955,T
3-PA,708,7,0,0,1939,1946,C
3-PA,709,1,6,1945,0,1952,G
3-PA,710,1957,0,2,0,1959,A
3-PA,711,1950,0,2,0,1952,A
3-PA,712,0,1,0,1964,1965,C
3-PA,713,3,0,0,1917,1920,C
3-PA,714,2,10,1917,0,1929,G
3-PA,715,1927,0,2,0,1929,A
3-PA,716,1929,0,0,1,1930,A
3-PA,717,0,1,0,1948,1949,C
3-PA,718,0,8,1929,0,1937,G
3-PA,719,0,0,1995,0,1995,G
3-PA,720,1,0,0,1992,1993,C
3-PA,721,0,1986,0,1,1987,T
3-PA,722,0,2,2037,0,2039,G
3-PA,723,0,3,0,2039,2042,C
3-PA,724,2063,0,1,0,2064,A
3-PA,725,0,2062,0,1,2063,T
3-PA,726,0,2040,0,0,2040,T
3-PA,727,1,5,2038,0,2044,G
3-PA,728,1992,1,4,0,1997,A
3-PA,729,0,1,2021,0,2022,G
3-PA,730,1,6,2010,0,2017,G
3-PA,731,2,0,1998,0,2000,G
3-PA,732,0,0,0,1998,1998,C
3-PA,733,1980,0,0,0,1980,A
3-PA,734,1994,0,3,0,1997,A
3-PA,735,1,2,2017,0,2020,G
3-PA,736,0,0,0,2025,2025,C
3-PA,737,0,2015,0,6,2021,T
3-PA,738,0,2022,0,1,2023,T
3-PA,739,0,2026,0,1,2027,T
3-PA,740,4,1,0,2029,2034,C
3-PA,741,1,2024,0,2,2027,T
3-PA,742,2,1,0,2037,2040,C
3-PA,743,2027,1,0,0,2028,A
3-PA,744,2024,0,0,1,2025,A
3-PA,745,2019,0,0,1,2020,A
3-PA,746,0,2026,0,0,2026,T
3-PA,747,1,1,2084,0,2086,G
3-PA,748,1,2074,0,4,2079,T
3-PA,749,2,0,0,2099,2101,C
3-PA,750,5,1,0,2098,2104,C
3-PA,751,2108,0,1,0,2109,A
3-PA,752,2109,0,1,0,2110,A
3-PA,753,2111,0,0,0,2111,A
3-PA,754,0,1,2147,1,2149,G
3-PA,755,2131,1,0,0,2132,A
3-PA,756,2098,0,0,0,2098,A
3-PA,757,0,2,2111,0,2113,G
3-PA,758,0,2101,0,0,2101,T
3-PA,759,0,13,2085,0,2098,G
3-PA,760,2091,0,2,0,2093,A
3-PA,761,2090,0,2,0,2092,A
3-PA,762,1,2101,0,0,2102,T
3-PA,763,0,2,2098,0,2100,G
3-PA,764,2,1,1,2098,2102,C
3-PA,765,4,0,0,2097,2101,C
3-PA,766,1,0,1,2102,2104,C
3-PA,767,2112,0,0,1,2113,A
3-PA,768,2137,0,0,1,2138,A
3-PA,769,2145,0,0,0,2145,A
3-PA,770,0,2150,0,0,2150,T
3-PA,771,0,2135,0,1,2136,T
3-PA,772,1,14,2119,0,2134,G
3-PA,773,2122,1,0,0,2123,A
3-PA,774,2128,0,2,0,2130,A
3-PA,775,2,1,0,2133,2136,C
3-PA,776,1,0,0,2122,2123,C
3-PA,777,0,2102,1,1,2104,T
3-PA,778,0,2146,1,1,2148,T
3-PA,779,0,2155,0,0,2155,T
3-PA,780,0,2200,0,0,2200,T
3-PA,781,5,0,0,2201,2206,C
3-PA,782,0,2193,1,4,2198,T
3-PA,783,1,4,2197,0,2202,G
3-PA,784,2197,0,0,0,2197,A
3-PA,785,2214,0,4,0,2218,A
3-PA,786,0,4,2227,0,2231,G
3-PA,787,2194,0,1,0,2195,A
3-PA,788,2,0,0,2202,2204,C
3-PA,789,2170,0,1,0,2171,A
3-PA,790,2188,1,5,0,2194,A
3-PA,791,0,0,0,2402,2402,C
3-PA,792,2411,0,0,0,2411,A
3-PA,793,4,2,0,2405,2411,C
3-PA,794,6,1,0,2377,2384,C
3-PA,795,2378,0,0,0,2378,A
3-PA,796,2371,0,1,0,2372,A
3-PA,797,0,7,2367,0,2374,G
3-PA,798,2372,1,3,0,2376,A
3-PA,799,1,1,0,2371,2373,C
3-PA,800,4,0,0,2187,2191,C
3-PA,801,2176,0,0,0,2176,A
3-PA,802,2179,0,2,0,2181,A
3-PA,803,0,2181,0,0,2181,T
3-PA,804,8,0,0,2173,2181,C
3-PA,805,2176,0,0,0,2176,A
3-PA,806,2171,0,0,0,2171,A
3-PA,807,2170,0,0,0,2170,A
3-PA,808,1,0,0,2180,2181,C
3-PA,809,0,2162,0,1,2163,T
3-PA,810,0,2166,0,1,2167,T
3-PA,811,5,0,0,2167,2172,C
3-PA,812,1,0,0,2177,2178,C
3-PA,813,0,6,2187,0,2193,G
3-PA,814,2190,1,0,0,2191,A
3-PA,815,2195,0,0,0,2195,A
3-PA,816,0,2196,0,1,2197,T
3-PA,817,0,3,2185,0,2188,G
3-PA,818,1,3,2194,1,2199,G
3-PA,819,2200,1,4,0,2205,A
3-PA,820,2,1,1,2213,2217,C
3-PA,821,4,0,0,2197,2201,C
3-PA,822,1,2259,0,1,2261,T
3-PA,823,2,0,0,2317,2319,C
3-PA,824,4,0,0,2316,2320,C
3-PA,825,0,2318,1,1,2320,T
3-PA,826,1,2321,0,0,2322,T
3-PA,827,3,0,2423,0,2426,G
3-PA,828,1,2396,0,3,2400,T
3-PA,829,0,2394,0,0,2394,T
3-PA,830,2394,0,2,1,2397,A
3-PA,831,0,2324,0,0,2324,T
3-PA,832,4,1,0,2293,2298,C
3-PA,833,2261,1,1,0,2263,A
3-PA,834,0,0,2261,0,2261,G
3-PA,835,0,2,0,2252,2254,C
3-PA,836,2,5,2180,0,2187,G
3-PA,837,1,1,2241,0,2243,G
3-PA,838,0,2246,0,1,2247,T
3-PA,839,11,1,0,2233,2245,C
3-PA,840,6,1,0,2247,2254,C
3-PA,841,2250,1,2,0,2253,A
3-PA,842,2268,1,0,0,2269,A
3-PA,843,2266,0,1,3,2270,A
3-PA,844,0,2276,0,0,2276,T
3-PA,845,0,2258,0,3,2261,T
3-PA,846,10,0,1,2242,2253,C
3-PA,847,3,0,1,2244,2248,C
3-PA,848,0,2243,0,2,2245,T
3-PA,849,4,1,0,2254,2259,C
3-PA,850,3,0,0,2265,2268,C
3-PA,851,0,2254,0,0,2254,T
3-PA,852,1,2,2266,1,2270,G
3-PA,853,2264,0,2,0,2266,A
3-PA,854,0,2265,0,1,2266,T
3-PA,855,1,8,2227,0,2236,G
3-PA,856,0,2,2203,0,2205,G
3-PA,857,2196,1,2,1,2200,A
3-PA,858,0,2186,0,1,2187,T
3-PA,859,0,0,2191,0,2191,G
3-PA,860,0,0,0,2290,2290,C
3-PA,861,0,2275,0,2,2277,T
3-PA,862,0,2283,0,2,2285,T
3-PA,863,0,2289,0,0,2289,T
3-PA,864,2287,0,0,0,2287,A
3-PA,865,2296,0,0,0,2296,A
3-PA,866,2301,0,0,0,2301,A
3-PA,867,2299,0,1,0,2300,A
3-PA,868,0,2300,0,0,2300,T
3-PA,869,0,2132,0,1,2133,T
3-PA,870,2,12,2119,0,2133,G
3-PA,871,2121,0,5,0,2126,A
3-PA,872,0,2,2146,0,2148,G
3-PA,873,0,0,0,2150,2150,C
3-PA,874,2139,2,0,1,2142,A
3-PA,875,0,2186,0,1,2187,T
3-PA,876,0,2183,0,1,2184,T
3-PA,877,0,4,2172,0,2176,G
3-PA,878,2184,1,0,0,2185,A
3-PA,879,2167,2,3,0,2172,A
3-PA,880,1,7,2172,0,2180,G
3-PA,881,2135,0,1,0,2136,A
3-PA,882,1,0,0,2156,2157,C
3-PA,883,7,1,1,2125,2134,C
3-PA,884,3,0,2,2089,2094,C
3-PA,885,2082,0,0,0,2082,A
3-PA,886,2093,0,4,0,2097,A
3-PA,887,0,0,2099,0,2099,G
3-PA,888,0,2104,1,1,2106,T
3-PA,889,7,2,0,2094,2103,C
3-PA,890,2106,1,1,0,2108,A
3-PA,891,0,0,0,2101,2101,C
3-PA,892,0,1,2097,0,2098,G
3-PA,893,2126,0,2,0,2128,A
3-PA,894,2122,0,0,0,2122,A
3-PA,895,1,8,2189,0,2198,G
3-PA,896,0,5,2187,1,2193,G
3-PA,897,2180,1,3,0,2184,A
3-PA,898,0,2,2192,0,2194,G
3-PA,899,2197,0,3,0,2200,A
3-PA,900,2193,0,2,0,2195,A
3-PA,901,0,2,2200,0,2202,G
3-PA,902,1,5,2171,0,2177,G
3-PA,903,1,2,2183,0,2186,G
3-PA,904,2141,0,3,0,2144,A
3-PA,905,0,2143,0,2,2145,T
3-PA,906,3,0,0,2160,2163,C
3-PA,907,2,0,1,2325,2328,C
3-PA,908,6,0,0,2349,2355,C
3-PA,909,2385,0,1,0,2386,A
3-PA,910,0,2383,0,1,2384,T
3-PA,911,0,2393,0,2,2395,T
3-PA,912,2449,0,0,0,2449,A
3-PA,913,1,2437,0,0,2438,T
3-PA,914,2438,0,0,0,2438,A
3-PA,915,0,2426,0,1,2427,T
3-PA,916,1,8,2159,1,2169,G
3-PA,917,2173,1,0,0,2174,A
3-PA,918,0,2135,0,1,2136,T
3-PA,919,1,1,2142,0,2144,G
3-PA,920,2,1,1,2125,2129,C
3-PA,921,0,9,2114,0,2123,G
3-PA,922,2143,0,1,0,2144,A
3-PA,923,1,2136,0,2,2139,T
3-PA,924,9,0,0,2138,2147,C
3-PA,925,2136,0,0,0,2136,A
3-PA,926,2131,0,0,1,2132,A
3-PA,927,3,2,2139,0,2144,G
3-PA,928,0,2123,0,0,2123,T
3-PA,929,4,3,2131,0,2138,G
3-PA,930,4,1,0,2147,2152,C
3-PA,931,2140,0,4,0,2144,A
3-PA,932,0,2149,0,0,2149,T
3-PA,933,2141,0,1,0,2142,A
3-PA,934,2173,0,0,0,2173,A
3-PA,935,2169,1,0,1,2171,A
3-PA,936,2166,0,0,0,2166,A
3-PA,937,2167,0,2,0,2169,A
3-PA,938,1,0,0,2170,2171,C
3-PA,939,2148,0,1,0,2149,A
3-PA,940,0,2156,1,0,2157,T
3-PA,941,0,2154,0,1,2155,T
3-PA,942,3,0,0,2160,2163,C
3-PA,943,0,2135,0,1,2136,T
3-PA,944,0,2131,0,0,2131,T
3-PA,945,1,2132,1,1,2135,T
3-PA,946,0,2,2127,0,2129,G
3-PA,947,0,1,2144,0,2145,G
3-PA,948,2144,0,3,0,2147,A
3-PA,949,1,2135,0,2,2138,T
3-PA,950,3,5,2160,1,2169,G
3-PA,951,1,4,2194,0,2199,G
3-PA,952,2203,0,0,0,2203,A
3-PA,953,2206,0,1,0,2207,A
3-PA,954,2204,0,3,0,2207,A
3-PA,955,0,3,2233,0,2236,G
3-PA,956,2224,0,1,0,2225,A
3-PA,957,2427,1,4,0,2432,A
3-PA,958,0,1,0,2468,2469,C
3-PA,959,0,2,0,2471,2473,C
3-PA,960,0,2457,1,2,2460,T
3-PA,961,0,2502,0,1,2503,T
3-PA,962,2522,0,0,0,2522,A
3-PA,963,1,2524,0,0,2525,T
3-PA,964,2502,1,1,0,2504,A
3-PA,965,0,2528,0,1,2529,T
3-PA,966,2333,0,2,0,2335,A
3-PA,967,1,4,2349,2,2356,G
3-PA,968,0,2339,1,3,2343,T
3-PA,969,5,1,0,2329,2335,C
3-PA,970,2308,0,0,0,2308,A
3-PA,971,2306,0,3,0,2309,A
3-PA,972,2314,0,0,1,2315,A
3-PA,973,1,0,0,2323,2324,C
3-PA,974,3,0,0,2290,2293,C
3-PA,975,2276,2,0,0,2278,A
3-PA,976,1,0,0,2292,2293,C
3-PA,977,2289,0,5,0,2294,A
3-PA,978,0,1,1,2306,2308,C
3-PA,979,0,9,2293,0,2302,G
3-PA,980,2295,0,0,1,2296,A
3-PA,981,2299,0,1,1,2301,A
3-PA,982,2288,0,2,0,2290,A
3-PA,983,2286,0,3,0,2289,A
3-PA,984,0,6,2297,0,2303,G
3-PA,985,1,4,2275,0,2280,G
3-PA,986,4,6,2290,0,2300,G
3-PA,987,2295,0,3,0,2298,A
3-PA,988,2299,0,1,0,2300,A
3-PA,989,0,2291,0,5,2296,T
3-PA,990,2301,0,0,1,2302,A
3-PA,991,2308,0,1,0,2309,A
3-PA,992,2317,0,0,0,2317,A
3-PA,993,0,2308,0,0,2308,T
3-PA,994,1,2296,0,2,2299,T
3-PA,995,12,7,0,2288,2307,C
3-PA,996,2310,0,0,0,2310,A
3-PA,997,2307,0,1,0,2308,A
3-PA,998,2312,0,1,0,2313,A
3-PA,999,1,2305,0,1,2307,T
3-PA,1000,0,2323,0,1,2324,T
3-PA,1001,2329,1,0,0,2330,A
3-PA,1002,3,0,0,2322,2325,C
3-PA,1003,2,0,0,2333,2335,C
3-PA,1004,0,2313,0,1,2314,T
3-PA,1005,0,0,2335,0,2335,G
3-PA,1006,0,0,0,2329,2329,C
3-PA,1007,1,2326,0,3,2330,T
3-PA,1008,5,2,2358,0,2365,G
3-PA,1009,0,2363,0,8,2371,T
3-PA,1010,10,2,0,2364,2376,C
3-PA,1011,2373,1,4,0,2378,A
3-PA,1012,0,2372,0,2,2374,T
3-PA,1013,1,4,2367,1,2373,G
3-PA,1014,1,4,2366,0,2371,G
3-PA,1015,2368,0,3,0,2371,A
3-PA,1016,2429,0,1,3,2433,A
3-PA,1017,0,1,2422,0,2423,G
3-PA,1018,1,0,0,2424,2425,C
3-PA,1019,2409,0,1,1,2411,A
3-PA,1020,2418,0,2,1,2421,A
3-PA,1021,1,2,2437,0,2440,G
3-PA,1022,0,2440,1,0,2441,T
3-PA,1023,2433,0,1,1,2435,A
3-PA,1024,1,3,0,2438,2442,C
3-PA,1025,0,2402,0,2,2404,T
3-PA,1026,0,0,2433,0,2433,G
3-PA,1027,1,2411,0,8,2420,T
3-PA,1028,10,0,0,2418,2428,C
3-PA,1029,2426,1,2,1,2430,A
3-PA,1030,0,6,2445,0,2451,G
3-PA,1031,2444,0,0,0,2444,A
3-PA,1032,2438,1,0,0,2439,A
3-PA,1033,0,2487,0,0,2487,T
3-PA,1034,0,2468,0,0,2468,T
3-PA,1035,1,0,2455,1,2457,G
3-PA,1036,2,2,0,2446,2450,C
3-PA,1037,2422,22,6,0,2450,A
3-PA,1038,0,3,2465,0,2468,G
3-PA,1039,0,11,2434,1,2446,G
3-PA,1040,2456,0,2,0,2458,A
3-PA,1041,1,0,0,2479,2480,C
3-PA,1042,2426,0,1,0,2427,A
3-PA,1043,1,2441,0,1,2443,T
3-PA,1044,1,2434,0,2,2437,T
3-PA,1045,1,5,2459,1,2466,G
3-PA,1046,2472,0,2,0,2474,A
3-PA,1047,2474,0,0,0,2474,A
3-PA,1048,2470,0,2,0,2472,A
3-PA,1049,2467,0,1,0,2468,A
3-PA,1050,0,2443,0,0,2443,T
3-PA,1051,8,1,2465,0,2474,G
3-PA,1052,2454,2,4,0,2460,A
3-PA,1053,0,2,2469,0,2471,G
3-PA,1054,0,8,2471,1,2480,G
3-PA,1055,2463,0,1,0,2464,A
3-PA,1056,0,3,2472,0,2475,G
3-PA,1057,2471,0,0,0,2471,A
3-PA,1058,2459,0,2,1,2462,A
3-PA,1059,0,3,2453,0,2456,G
3-PA,1060,0,1,2423,0,2424,G
3-PA,1061,1,2522,0,2,2525,T
3-PA,1062,2,2523,0,1,2526,T
3-PA,1063,6,0,0,2532,2538,C
3-PA,1064,5,1,0,2529,2535,C
3-PA,1065,2534,1,2,0,2537,A
3-PA,1066,2531,0,1,0,2532,A
3-PA,1067,5,2,2544,0,2551,G
3-PA,1068,0,6,2579,0,2585,G
3-PA,1069,2538,0,0,0,2538,A
3-PA,1070,1,0,0,2550,2551,C
3-PA,1071,0,2551,0,0,2551,T
3-PA,1072,2552,0,1,0,2553,A
3-PA,1073,2552,1,1,0,2554,A
3-PA,1074,2555,0,1,0,2556,A
3-PA,1075,2556,0,1,0,2557,A
3-PA,1076,2544,1,1,0,2546,A
3-PA,1077,3,0,0,2513,2516,C
3-PA,1078,2502,1,1,0,2504,A
3-PA,1079,1,2482,0,3,2486,T
3-PA,1080,0,10,2510,0,2520,G
3-PA,1081,2521,1,3,0,2525,A
3-PA,1082,2527,0,4,0,2531,A
3-PA,1083,1,5,2533,1,2540,G
3-PA,1084,2532,0,0,0,2532,A
3-PA,1085,2534,1,1,0,2536,A
3-PA,1086,2513,0,2,1,2516,A
3-PA,1087,2514,0,2,1,2517,A
3-PA,1088,0,0,0,2525,2525,C
3-PA,1089,0,8,2510,0,2518,G
3-PA,1090,2522,1,1,0,2524,A
3-PA,1091,0,1,2527,0,2528,G
3-PA,1092,0,2508,0,1,2509,T
3-PA,1093,12,0,0,2557,2569,C
3-PA,1094,2568,0,2,0,2570,A
3-PA,1095,2603,0,2,0,2605,A
3-PA,1096,1,0,0,2598,2599,C
3-PA,1097,0,2589,2,1,2592,T
3-PA,1098,0,2,2642,0,2644,G
3-PA,1099,2629,0,0,0,2629,A
3-PA,1100,2628,0,4,0,2632,A
3-PA,1101,0,1,2635,0,2636,G
3-PA,1102,0,2596,0,1,2597,T
3-PA,1103,1,1,2598,1,2601,G
3-PA,1104,0,3,2579,0,2582,G
3-PA,1105,1,1,2586,0,2588,G
3-PA,1106,0,0,0,2600,2600,C
3-PA,1107,0,2569,0,1,2570,T
3-PA,1108,4,0,0,2592,2596,C
3-PA,1109,0,2593,0,0,2593,T
3-PA,1110,0,2597,0,0,2597,T
3-PA,1111,1,6,2652,0,2659,G
3-PA,1112,0,5,2660,0,2665,G
3-PA,1113,1,2657,0,2,2660,T
3-PA,1114,1,11,2651,0,2663,G
3-PA,1115,2653,1,1,0,2655,A
3-PA,1116,2677,1,0,0,2678,A
3-PA,1117,2666,2,2,0,2670,A
3-PA,1118,2682,1,0,2,2685,A
3-PA,1119,2,1,0,2697,2700,C
3-PA,1120,2652,1,0,0,2653,A
3-PA,1121,0,2659,0,2,2661,T
3-PA,1122,2,7,2645,0,2654,G
3-PA,1123,2,1,2704,0,2707,G
3-PA,1124,4,0,0,2713,2717,C
3-PA,1125,2728,2,1,0,2731,A
3-PA,1126,2,0,0,2742,2744,C
3-PA,1127,3,0,1,2742,2746,C
3-PA,1128,2771,0,7,1,2779,A
3-PA,1129,0,7,2799,0,2806,G
3-PA,1130,2789,2,3,0,2794,A
3-PA,1131,3,0,2822,0,2825,G
3-PA,1132,2827,0,1,0,2828,A
3-PA,1133,2828,0,2,0,2830,A
3-PA,1134,1,8,2835,0,2844,G
3-PA,1135,5,2,2819,0,2826,G
3-PA,1136,1,2819,0,1,2821,T
3-PA,1137,2788,0,1,0,2789,A
3-PA,1138,2,10,2774,0,2786,G
3-PA,1139,2789,0,1,0,2790,A
3-PA,1140,0,0,0,2801,2801,C
3-PA,1141,0,2758,1,4,2763,T
3-PA,1142,0,2747,0,4,2751,T
3-PA,1143,1,2748,0,1,2750,T
3-PA,1144,0,4,2750,2,2756,G
3-PA,1145,2757,0,1,0,2758,A
3-PA,1146,2766,0,1,0,2767,A
3-PA,1147,2760,1,3,0,2764,A
3-PA,1148,2741,0,0,0,2741,A
3-PA,1149,0,0,0,2800,2800,C
3-PA,1150,0,2783,0,1,2784,T
3-PA,1151,1,0,2810,0,2811,G
3-PA,1152,3,2,3,2795,2803,C
3-PA,1153,2809,0,1,0,2810,A
3-PA,1154,0,2,2815,0,2817,G
3-PA,1155,2808,0,1,0,2809,A
3-PA,1156,0,6,2922,1,2929,G
3-PA,1157,2942,0,1,0,2943,A
3-PA,1158,1,0,0,2926,2927,C
3-PA,1159,2910,1,5,0,2916,A
3-PA,1160,0,2903,0,1,2904,T
3-PA,1161,2903,0,2,0,2905,A
3-PA,1162,2898,1,2,1,2902,A
3-PA,1163,0,0,2902,0,2902,G
3-PA,1164,0,2,0,2890,2892,C
3-PA,1165,1,13,2838,0,2852,G
3-PA,1166,2919,0,0,0,2919,A
3-PA,1167,1,2894,0,1,2896,T
3-PA,1168,0,2898,0,0,2898,T
3-PA,1169,0,2901,0,0,2901,T
3-PA,1170,0,11,2900,0,2911,G
3-PA,1171,2920,0,0,0,2920,A
3-PA,1172,2914,0,4,0,2918,A
3-PA,1173,0,0,2928,0,2928,G
3-PA,1174,0,3,0,2966,2969,C
3-PA,1175,2945,0,0,0,2945,A
3-PA,1176,3151,0,1,1,3153,A
3-PA,1177,0,3151,0,1,3152,T
3-PA,1178,3163,2,1,0,3166,A
3-PA,1179,1,3166,0,0,3167,T
3-PA,1180,0,4,3171,0,3175,G
3-PA,1181,3201,0,2,0,3203,A
3-PA,1182,2,3193,0,1,3196,T
3-PA,1183,3092,0,2,0,3094,A
3-PA,1184,0,2,3104,0,3106,G
3-PA,1185,0,2999,0,5,3004,T
3-PA,1186,0,11,2980,0,2991,G
3-PA,1187,2997,0,2,0,2999,A
3-PA,1188,1,0,0,2978,2979,C
3-PA,1189,2,12,2958,0,2972,G
3-PA,1190,2984,0,0,0,2984,A
3-PA,1191,2981,1,3,1,2986,A
3-PA,1192,1,0,0,3018,3019,C
3-PA,1193,6,2,0,3014,3022,C
3-PA,1194,0,3001,0,3,3004,T
3-PA,1195,2,7,3096,0,3105,G
3-PA,1196,3101,0,2,0,3103,A
3-PA,1197,3108,0,1,0,3109,A
3-PA,1198,0,3097,1,1,3099,T
3-PA,1199,0,3076,0,0,3076,T
3-PA,1200,3077,0,1,0,3078,A
3-PA,1201,3036,0,5,1,3042,A
3-PA,1202,0,4,3049,0,3053,G
3-PA,1203,2,1,3057,0,3060,G
3-PA,1204,2,3001,1,3,3007,T
3-PA,1205,14,0,1,2988,3003,C
3-PA,1206,3007,0,0,0,3007,A
3-PA,1207,2,1,1,3106,3110,C
3-PA,1208,1,3109,0,3,3113,T
3-PA,1209,1,3118,0,2,3121,T
3-PA,1210,0,3122,0,0,3122,T
3-PA,1211,6,0,0,3110,3116,C
3-PA,1212,3117,1,0,0,3118,A
3-PA,1213,3117,2,1,0,3120,A
3-PA,1214,0,1,3169,0,3170,G
3-PA,1215,0,1,0,3164,3165,C
3-PA,1216,1,3100,0,0,3101,T
3-PA,1217,2,2,3186,0,3190,G
3-PA,1218,0,5,3200,0,3205,G
3-PA,1219,3243,1,5,0,3249,A
3-PA,1220,2,3270,0,2,3274,T
3-PA,1221,3271,1,0,0,3272,A
3-PA,1222,2,1,0,3283,3286,C
3-PA,1223,3222,0,0,1,3223,A
3-PA,1224,0,6,3253,0,3259,G
3-PA,1225,3247,0,2,0,3249,A
3-PA,1226,3210,0,2,1,3213,A
3-PA,1227,0,3181,1,1,3183,T
3-PA,1228,0,7,3193,0,3200,G
3-PA,1229,3174,0,2,0,3176,A
3-PA,1230,9,0,3201,0,3210,G
3-PA,1231,3,3192,0,3,3198,T
3-PA,1232,0,3191,1,1,3193,T
3-PA,1233,10,0,0,3233,3243,C
3-PA,1234,3243,0,1,0,3244,A
3-PA,1235,3248,1,1,1,3251,A
3-PA,1236,2,1,0,3247,3250,C
3-PA,1237,3224,1,0,0,3225,A
3-PA,1238,3222,3,0,0,3225,A
3-PA,1239,0,7,3202,0,3209,G
3-PA,1240,0,5,3233,0,3238,G
3-PA,1241,1,0,0,3249,3250,C
3-PA,1242,5,0,0,3233,3238,C
3-PA,1243,1,3223,0,1,3225,T
3-PA,1244,1,0,3252,0,3253,G
3-PA,1245,0,3250,0,1,3251,T
3-PA,1246,0,12,3260,0,3272,G
3-PA,1247,3277,0,4,0,3281,A
3-PA,1248,0,1,3273,0,3274,G
3-PA,1249,2,0,0,3240,3242,C
3-PA,1250,0,3209,0,3,3212,T
3-PA,1251,3265,1,1,0,3267,A
3-PA,1252,3271,1,0,0,3272,A
3-PA,1253,0,0,0,3276,3276,C
3-PA,1254,0,3250,0,3,3253,T
3-PA,1255,2,13,3251,1,3267,G
3-PA,1256,3253,1,0,1,3255,A
3-PA,1257,0,3260,0,0,3260,T
3-PA,1258,0,3264,0,2,3266,T
3-PA,1259,14,0,1,3258,3273,C
3-PA,1260,3305,1,1,0,3307,A
3-PA,1261,1,3,3355,0,3359,G
3-PA,1262,0,3353,0,4,3357,T
3-PA,1263,9,0,0,3344,3353,C
3-PA,1264,1,3336,0,8,3345,T
3-PA,1265,4,2,3513,0,3519,G
3-PA,1266,0,7,3519,0,3526,G
3-PA,1267,3523,0,1,0,3524,A
3-PA,1268,0,3525,0,2,3527,T
3-PA,1269,3391,0,2,0,3393,A
3-PA,1270,0,3,3398,0,3401,G
3-PA,1271,3384,0,5,0,3389,A
3-PA,1272,1,10,3387,0,3398,G
3-PA,1273,2,1,0,3387,3390,C
3-PA,1274,0,3275,0,4,3279,T
3-PA,1275,1,3263,0,2,3266,T
3-PA,1276,0,8,3276,0,3284,G
3-PA,1277,3274,1,5,1,3281,A
3-PA,1278,1,3287,0,0,3288,T
3-PA,1279,1,14,3260,0,3275,G
3-PA,1280,3304,1,2,0,3307,A
3-PA,1281,3289,0,2,0,3291,A
3-PA,1282,3308,1,0,0,3309,A
3-PA,1283,0,3308,0,0,3308,T
3-PA,1284,0,3306,0,2,3308,T
3-PA,1285,2,5,3335,0,3342,G
3-PA,1286,0,5,3335,0,3340,G
3-PA,1287,3328,0,5,1,3334,A
3-PA,1288,0,6,3329,0,3335,G
3-PA,1289,3284,0,4,0,3288,A
3-PA,1290,1,4,3316,1,3322,G
3-PA,1291,0,6,3341,0,3347,G
3-PA,1292,3371,0,2,0,3373,A
3-PA,1293,3,2,0,3371,3376,C
3-PA,1294,4,1,3350,0,3355,G
3-PA,1295,0,3354,0,1,3355,T
3-PA,1296,3373,0,0,0,3373,A
3-PA,1297,0,1,3415,0,3416,G
3-PA,1298,1,0,0,3439,3440,C
3-PA,1299,4,1,0,3405,3410,C
3-PA,1300,7,1,0,3386,3394,C
3-PA,1301,3,1,0,3396,3400,C
3-PA,1302,3411,1,2,0,3414,A
3-PA,1303,3522,0,0,0,3522,A
3-PA,1304,0,3512,0,1,3513,T
3-PA,1305,1,3491,1,1,3494,T
3-PA,1306,0,13,3484,0,3497,G
3-PA,1307,3452,0,5,0,3457,A
3-PA,1308,4,2,3451,1,3458,G
3-PA,1309,6,2,0,3450,3458,C
3-PA,1310,3436,1,3,0,3440,A
3-PA,1311,1,1,1,3509,3512,C
3-PA,1312,3426,0,0,0,3426,A
3-PA,1313,1,3504,0,1,3506,T
3-PA,1314,0,3497,0,6,3503,T
3-PA,1315,0,1,3511,1,3513,G
3-PA,1316,2,0,0,3508,3510,C
3-PA,1317,3500,1,1,0,3502,A
3-PA,1318,3500,1,6,0,3507,A
3-PA,1319,0,1,3502,0,3503,G
3-PA,1320,1,1,1,3474,3477,C
3-PA,1321,3471,0,2,0,3473,A
3-PA,1322,0,3402,0,2,3404,T
3-PA,1323,2,10,3405,0,3417,G
3-PA,1324,3395,1,5,0,3401,A
3-PA,1325,0,1,3405,0,3406,G
3-PA,1326,3407,0,3,0,3410,A
3-PA,1327,3399,0,1,0,3400,A
3-PA,1328,0,5,3393,0,3398,G
3-PA,1329,1,8,3388,0,3397,G
3-PA,1330,3395,0,3,1,3399,A
3-PA,1331,3390,0,1,1,3392,A
3-PA,1332,0,3408,0,0,3408,T
3-PA,1333,0,3405,0,0,3405,T
3-PA,1334,3416,0,0,0,3416,A
3-PA,1335,1,3417,0,1,3419,T
3-PA,1336,0,3422,1,1,3424,T
3-PA,1337,1,3423,0,1,3425,T
3-PA,1338,8,1,0,3381,3390,C
3-PA,1339,3384,0,2,0,3386,A
3-PA,1340,2,1,0,3460,3463,C
3-PA,1341,3450,0,0,1,3451,A
3-PA,1342,1,1,3475,0,3477,G
3-PA,1343,0,3,1,3464,3468,C
3-PA,1344,3446,0,1,0,3447,A
3-PA,1345,0,3,3464,0,3467,G
3-PA,1346,3448,0,1,1,3450,A
3-PA,1347,1,2,3462,0,3465,G
3-PA,1348,1,3,3474,0,3478,G
3-PA,1349,0,3378,0,2,3380,T
3-PA,1350,2,4,3434,0,3440,G
3-PA,1351,2,3395,0,5,3402,T
3-PA,1352,3,1,0,3397,3401,C
3-PA,1353,7,2,0,3418,3427,C
3-PA,1354,8,1,3,3398,3410,C
3-PA,1355,3439,1,1,1,3442,A
3-PA,1356,0,3477,1,1,3479,T
3-PA,1357,1,3453,0,1,3455,T
3-PA,1358,0,1,3478,0,3479,G
3-PA,1359,0,3411,0,2,3413,T
3-PA,1360,3361,0,2,1,3364,A
3-PA,1361,0,6,3350,0,3356,G
3-PA,1362,3289,0,1,0,3290,A
3-PA,1363,0,1,3313,0,3314,G
3-PA,1364,2,0,0,3275,3277,C
3-PA,1365,3,1,0,3219,3223,C
3-PA,1366,3268,1,1,1,3271,A
3-PA,1367,1,0,0,3285,3286,C
3-PA,1368,0,3251,0,8,3259,T
3-PA,1369,1,8,3245,0,3254,G
3-PA,1370,3245,0,0,0,3245,A
3-PA,1371,3187,0,1,0,3188,A
3-PA,1372,0,3276,0,0,3276,T
3-PA,1373,3299,0,2,0,3301,A
3-PA,1374,1,0,0,3323,3324,C
3-PA,1375,3242,0,2,1,3245,A
3-PA,1376,0,3256,0,1,3257,T
3-PA,1377,3242,0,2,0,3244,A
3-PA,1378,3260,0,0,1,3261,A
3-PA,1379,0,3243,0,1,3244,T
3-PA,1380,0,1,3196,0,3197,G
3-PA,1381,3185,0,0,1,3186,A
3-PA,1382,3114,0,3,0,3117,A
3-PA,1383,1,5,3118,0,3124,G
3-PA,1384,2,3,3109,1,3115,G
3-PA,1385,1,10,3129,0,3140,G
3-PA,1386,0,7,3145,0,3152,G
3-PA,1387,1,0,3188,0,3189,G
3-PA,1388,0,3127,0,6,3133,T
3-PA,1389,3151,0,0,0,3151,A
3-PA,1390,0,3171,0,2,3173,T
3-PA,1391,3212,1,1,1,3215,A
3-PA,1392,0,1,0,3480,3481,C
3-PA,1393,3373,0,0,0,3373,A
3-PA,1394,0,3313,0,0,3313,T
3-PA,1395,0,3290,0,6,3296,T
3-PA,1396,3253,0,4,0,3257,A
3-PA,1397,3329,1,2,0,3332,A
3-PA,1398,3,0,0,3329,3332,C
3-PA,1399,3282,0,0,0,3282,A
3-PA,1400,1,0,0,3279,3280,C
3-PA,1401,0,2956,1,2,2959,T
3-PA,1402,2,1,3044,0,3047,G
3-PA,1403,1,0,0,3048,3049,C
3-PA,1404,6,0,1,3019,3026,C
3-PA,1405,3,4,0,3045,3052,C
3-PA,1406,0,2951,1,2,2954,T
3-PA,1407,0,1,3064,0,3065,G
3-PA,1408,1,0,0,3057,3058,C
3-PA,1409,1,3055,0,3,3059,T
3-PA,1410,8,0,1,3125,3134,C
3-PA,1411,3011,1,0,0,3012,A
3-PA,1412,3033,1,0,0,3034,A
3-PA,1413,0,3031,0,1,3032,T
3-PA,1414,1,2,3031,0,3034,G
3-PA,1415,1,0,0,3030,3031,C
3-PA,1416,2952,0,0,0,2952,A
3-PA,1417,0,2949,0,2,2951,T
3-PA,1418,5,2,0,2942,2949,C
3-PA,1419,1,1,0,2970,2972,C
3-PA,1420,0,2860,0,0,2860,T
3-PA,1421,1,1,2921,0,2923,G
3-PA,1422,2,2911,0,3,2916,T
3-PA,1423,2,3,2898,1,2904,G
3-PA,1424,1,2,0,2905,2908,C
3-PA,1425,2860,1,1,0,2862,A
3-PA,1426,0,0,2881,0,2881,G
3-PA,1427,0,0,14,2864,2878,C
3-PA,1428,2837,0,2,0,2839,A
3-PA,1429,2839,0,1,0,2840,A
3-PA,1430,0,2738,0,0,2738,T
3-PA,1431,1,4,2731,0,2736,G
3-PA,1432,1,4,2727,0,2732,G
3-PA,1433,2734,1,1,0,2736,A
3-PA,1434,1,3,0,2729,2733,C
3-PA,1435,1,12,2678,0,2691,G
3-PA,1436,2725,2,0,0,2727,A
3-PA,1437,0,2724,0,0,2724,T
3-PA,1438,0,2720,0,1,2721,T
3-PA,1439,0,2722,0,3,2725,T
3-PA,1440,2,2714,0,1,2717,T
3-PA,1441,5,1,0,2715,2721,C
3-PA,1442,2723,0,0,0,2723,A
3-PA,1443,2736,0,0,1,2737,A
3-PA,1444,1,0,0,2738,2739,C
3-PA,1445,0,2684,0,1,2685,T
3-PA,1446,2677,0,0,0,2677,A
3-PA,1447,2676,0,0,0,2676,A
3-PA,1448,0,2684,0,3,2687,T
3-PA,1449,2,2681,0,0,2683,T
3-PA,1450,12,0,0,2673,2685,C
3-PA,1451,3,0,0,2659,2662,C
3-PA,1452,4,1,0,2657,2662,C
3-PA,1453,2659,0,1,0,2660,A
3-PA,1454,0,2709,0,4,2713,T
3-PA,1455,9,7,2697,0,2713,G
3-PA,1456,2718,0,0,0,2718,A
3-PA,1457,0,2699,0,1,2700,T
3-PA,1458,2692,0,1,0,2693,A
3-PA,1459,2694,1,1,0,2696,A
3-PA,1460,1,1,2695,0,2697,G
3-PA,1461,1,0,0,2685,2686,C
3-PA,1462,2681,0,0,0,2681,A
3-PA,1463,2593,0,1,0,2594,A
3-PA,1464,1,0,2649,0,2650,G
3-PA,1465,0,2629,0,1,2630,T
3-PA,1466,3,2,2621,0,2626,G
3-PA,1467,1,1,1,2618,2621,C
3-PA,1468,2599,1,1,0,2601,A
3-PA,1469,0,5,2652,0,2657,G
3-PA,1470,2648,0,0,0,2648,A
3-PA,1471,2685,0,0,0,2685,A
3-PA,1472,0,0,0,2697,2697,C
3-PA,1473,0,2608,0,0,2608,T
3-PA,1474,2618,0,3,0,2621,A
3-PA,1475,2615,0,1,0,2616,A
3-PA,1476,2613,0,2,0,2615,A
3-PA,1477,0,0,2621,0,2621,G
3-PA,1478,2495,1,8,0,2504,A
3-PA,1479,0,3,2508,0,2511,G
3-PA,1480,1,1,2453,0,2455,G
3-PA,1481,2,3,2442,0,2447,G
3-PA,1482,2425,1,0,0,2426,A
3-PA,1483,2375,0,0,0,2375,A
3-PA,1484,1,2,2365,0,2368,G
3-PA,1485,0,2,2361,0,2363,G
3-PA,1486,1,1,1,2364,2367,C
3-PA,1487,1,7,2359,0,2367,G
3-PA,1488,2353,0,0,0,2353,A
3-PA,1489,2347,0,1,0,2348,A
3-PA,1490,2350,0,0,0,2350,A
3-PA,1491,2352,0,0,0,2352,A
3-PA,1492,2348,0,2,0,2350,A
3-PA,1493,2,0,0,2358,2360,C
3-PA,1494,12,1,0,2328,2341,C
3-PA,1495,2343,0,0,0,2343,A
3-PA,1496,2368,0,0,0,2368,A
3-PA,1497,0,2372,0,0,2372,T
3-PA,1498,0,2368,0,1,2369,T
3-PA,1499,1,2381,0,0,2382,T
3-PA,1500,2388,1,0,0,2389,A
3-PA,1501,0,2382,0,1,2383,T
3-PA,1502,2375,2,2,0,2379,A
3-PA,1503,0,2378,0,0,2378,T
3-PA,1504,0,0,2346,0,2346,G
3-PA,1505,9,5,2308,0,2322,G
3-PA,1506,2323,0,0,0,2323,A
3-PA,1507,1,2296,0,1,2298,T
3-PA,1508,0,2277,0,0,2277,T
3-PA,1509,6,0,0,2269,2275,C
3-PA,1510,2284,0,1,0,2285,A
3-PA,1511,0,2302,0,2,2304,T
3-PA,1512,7,0,0,2293,2300,C
3-PA,1513,2286,0,1,1,2288,A
3-PA,1514,0,2253,0,1,2254,T
3-PA,1515,2226,0,1,0,2227,A
3-PA,1516,2226,1,0,0,2227,A
3-PA,1517,2228,0,4,0,2232,A
3-PA,1518,0,5,2231,0,2236,G
3-PA,1519,1,4,2181,0,2186,G
3-PA,1520,0,3,2151,0,2154,G
3-PA,1521,2143,0,8,0,2151,A
3-PA,1522,2129,0,1,0,2130,A
3-PA,1523,9,3,2129,0,2141,G
3-PA,1524,2120,1,0,0,2121,A
3-PA,1525,0,2118,0,2,2120,T
3-PA,1526,3,1,0,2106,2110,C
3-PA,1527,2,2063,0,2,2067,T
3-PA,1528,5,0,0,2100,2105,C
3-PA,1529,2099,0,0,1,2100,A
3-PA,1530,0,2091,1,1,2093,T
3-PA,1531,0,2094,0,0,2094,T
3-PA,1532,0,2071,0,2,2073,T
3-PA,1533,2062,0,1,0,2063,A
3-PA,1534,2063,0,0,0,2063,A
3-PA,1535,0,5,2066,0,2071,G
3-PA,1536,0,2,2079,0,2081,G
3-PA,1537,1969,0,0,0,1969,A
3-PA,1538,1975,0,1,1,1977,A
3-PA,1539,0,1971,3,0,1974,T
3-PA,1540,0,7,1973,0,1980,G
3-PA,1541,2013,0,4,0,2017,A
3-PA,1542,1,1,0,2008,2010,C
3-PA,1543,1997,1,5,1,2004,A
3-PA,1544,0,2,0,2002,2004,C
3-PA,1545,1938,0,1,0,1939,A
3-PA,1546,0,1,1956,0,1957,G
3-PA,1547,1940,0,3,0,1943,A
3-PA,1548,2,1,0,1916,1919,C
3-PA,1549,0,0,1891,0,1891,G
3-PA,1550,0,1749,0,1,1750,T
3-PA,1551,0,5,1746,0,1751,G
3-PA,1552,0,1,1757,0,1758,G
3-PA,1553,0,1758,0,1,1759,T
3-PA,1554,1751,0,1,0,1752,A
3-PA,1555,1730,0,0,0,1730,A
3-PA,1556,1737,0,0,0,1737,A
3-PA,1557,0,1732,0,0,1732,T
3-PA,1558,0,1705,0,0,1705,T
3-PA,1559,0,1703,0,0,1703,T
3-PA,1560,0,1682,0,0,1682,T
3-PA,1561,0,0,1681,0,1681,G
3-PA,1562,0,1649,0,2,1651,T
3-PA,1563,0,7,1646,0,1653,G
3-PA,1564,1636,1,1,0,1638,A
3-PA,1565,0,1,1638,0,1639,G
3-PA,1566,0,0,0,1625,1625,C
3-PA,1567,1629,0,1,0,1630,A
3-PA,1568,0,1631,0,0,1631,T
3-PA,1569,0,0,1627,0,1627,G
3-PA,1570,0,4,1630,1,1635,G
3-PA,1571,1636,0,1,0,1637,A
3-PA,1572,7,0,1632,0,1639,G
3-PA,1573,1,1612,0,3,1616,T
3-PA,1574,0,1586,1,1,1588,T
3-PA,1575,0,1593,0,0,1593,T
3-PA,1576,0,1586,0,0,1586,T
3-PA,1577,6,0,0,1588,1594,C
3-PA,1578,2,1577,0,2,1581,T
3-PA,1579,5,1,0,1570,1576,C
3-PA,1580,0,1536,0,2,1538,T
3-PA,1581,2,1,0,1528,1531,C
3-PA,1582,1531,0,1,0,1532,A
3-PA,1583,0,0,0,1527,1527,C
3-PA,1584,0,1486,0,3,1489,T
3-PA,1585,1,1,1478,0,1480,G
3-PA,1586,1482,0,1,0,1483,A
3-PA,1587,1,1,0,1485,1487,C
3-PA,1588,1,0,0,1488,1489,C
3-PA,1589,1,0,0,1469,1470,C
3-PA,1590,1,1,1465,0,1467,G
3-PA,1591,1453,0,1,0,1454,A
3-PA,1592,0,4,1464,0,1468,G
3-PA,1593,1466,0,1,0,1467,A
3-PA,1594,0,0,0,1435,1435,C
3-PA,1595,0,1412,0,0,1412,T
3-PA,1596,0,1325,0,8,1333,T
3-PA,1597,1,5,1326,1,1333,G
3-PA,1598,1321,0,6,0,1327,A
3-PA,1599,0,0,1328,0,1328,G
3-PA,1600,1,0,0,1318,1319,C
3-PA,1601,5,2,0,1241,1248,C
3-PA,1602,1256,0,0,0,1256,A
3-PA,1603,0,2,0,1248,1250,C
3-PA,1604,1254,0,1,0,1255,A
3-PA,1605,0,1252,0,0,1252,T
3-PA,1606,1239,0,0,0,1239,A
3-PA,1607,1232,1,2,0,1235,A
3-PA,1608,1231,0,1,0,1232,A
3-PA,1609,0,1222,0,1,1223,T
3-PA,1610,0,0,1214,0,1214,G
3-PA,1611,0,0,1100,0,1100,G
3-PA,1612,0,2,1093,0,1095,G
3-PA,1613,1067,0,2,0,1069,A
3-PA,1614,0,1,1074,0,1075,G
3-PA,1615,1051,0,0,0,1051,A
3-PA,1616,1034,0,0,0,1034,A
3-PA,1617,1039,1,0,1,1041,A
3-PA,1618,0,1034,0,0,1034,T
3-PA,1619,1019,0,0,0,1019,A
3-PA,1620,2,0,0,1016,1018,C
3-PA,1621,0,661,0,0,661,T
3-PA,1622,2,0,655,0,657,G
3-PA,1623,0,518,0,0,518,T
3-PA,1624,0,1,523,0,524,G
3-PA,1625,0,512,0,0,512,T
3-PA,1626,1,0,0,430,431,C
3-PA,1627,0,0,1,425,426,C
3-PA,1628,0,410,0,1,411,T
3-PA,1629,0,413,0,0,413,T
3-PA,1630,0,0,423,0,423,G
3-PA,1631,420,0,0,0,420,A
3-PA,1632,0,0,436,0,436,G
3-PA,1633,423,0,0,0,423,A
3-PA,1634,0,423,0,0,423,T
3-PA,1635,414,0,0,0,414,A
3-PA,1636,0,1,419,0,420,G
3-PA,1637,0,0,422,0,422,G
3-PA,1638,417,0,0,0,417,A
3-PA,1639,0,0,419,0,419,G
3-PA,1640,416,0,0,0,416,A
3-PA,1641,0,414,0,0,414,T
3-PA,1642,413,0,0,0,413,A
3-PA,1643,0,408,0,0,408,T
3-PA,1644,3,0,412,0,415,G
3-PA,1645,0,410,1,0,411,T
3-PA,1646,0,406,0,0,406,T
3-PA,1647,413,0,0,0,413,A
3-PA,1648,0,2,0,411,413,C
3-PA,1649,0,409,0,0,409,T
3-PA,1650,408,0,0,0,408,A
3-PA,1651,402,0,0,0,402,A
3-PA,1652,0,1,410,0,411,G
3-PA,1653,404,0,0,0,404,A
3-PA,1654,395,0,0,0,395,A
3-PA,1655,0,0,389,0,389,G
3-PA,1656,0,395,0,0,395,T
3-PA,1657,0,0,400,0,400,G
3-PA,1658,0,0,0,402,402,C
3-PA,1659,1,0,0,398,399,C
3-PA,1660,399,0,0,0,399,A
3-PA,1661,0,397,0,0,397,T
3-PA,1662,395,0,0,0,395,A
3-PA,1663,0,0,397,0,397,G
3-PA,1664,0,0,396,0,396,G
3-PA,1665,1,0,0,393,394,C
3-PA,1666,0,0,0,388,388,C
3-PA,1667,390,0,0,0,390,A
3-PA,1668,391,0,0,0,391,A
3-PA,1669,387,0,0,0,387,A
3-PA,1670,0,396,0,0,396,T
3-PA,1671,0,395,0,0,395,T
3-PA,1672,0,395,0,0,395,T
3-PA,1673,0,0,0,394,394,C
3-PA,1674,382,1,0,0,383,A
3-PA,1675,392,1,0,0,393,A
3-PA,1676,0,0,396,0,396,G
3-PA,1677,0,0,393,0,393,G
3-PA,1678,0,0,0,393,393,C
3-PA,1679,0,0,0,393,393,C
3-PA,1680,0,2,393,0,395,G
3-PA,1681,414,0,0,0,414,A
3-PA,1682,0,417,0,0,417,T
3-PA,1683,0,0,431,0,431,G
3-PA,1684,0,430,0,0,430,T
3-PA,1685,0,442,0,0,442,T
3-PA,1686,1,0,0,440,441,C
3-PA,1687,0,442,0,0,442,T
3-PA,1688,0,443,0,0,443,T
3-PA,1689,0,1,444,0,445,G
3-PA,1690,0,434,0,0,434,T
3-PA,1691,434,0,2,0,436,A
3-PA,1692,0,436,0,0,436,T
3-PA,1693,0,0,435,0,435,G
3-PA,1694,0,429,0,0,429,T
3-PA,1695,0,2,429,0,431,G
3-PA,1696,428,0,0,0,428,A
3-PA,1697,0,0,429,0,429,G
3-PA,1698,0,1,431,0,432,G
3-PA,1699,430,0,0,0,430,A
3-PA,1700,0,0,0,425,425,C
3-PA,1701,425,0,0,0,425,A
3-PA,1702,423,1,0,0,424,A
3-PA,1703,425,0,0,0,425,A
3-PA,1704,0,1,0,424,425,C
3-PA,1705,0,0,425,0,425,G
3-PA,1706,0,1,432,0,433,G
3-PA,1707,432,0,0,0,432,A
3-PA,1708,434,0,0,0,434,A
3-PA,1709,0,0,0,435,435,C
3-PA,1710,432,0,0,0,432,A
3-PA,1711,0,435,0,0,435,T
3-PA,1712,2,0,0,434,436,C
3-PA,1713,435,0,0,0,435,A
3-PA,1714,435,0,0,0,435,A
3-PA,1715,421,0,1,0,422,A
3-PA,1716,0,0,427,0,427,G
3-PA,1717,0,0,428,0,428,G
3-PA,1718,0,420,0,1,421,T
3-PA,1719,2,0,0,417,419,C
3-PA,1720,418,0,0,0,418,A
3-PA,1721,424,0,0,0,424,A
3-PA,1722,421,0,0,0,421,A
3-PA,1723,424,0,0,0,424,A
3-PA,1724,0,423,0,0,423,T
3-PA,1725,0,0,426,0,426,G
3-PA,1726,425,0,1,0,426,A
3-PA,1727,423,0,0,0,423,A
3-PA,1728,422,0,0,0,422,A
3-PA,1729,0,425,0,0,425,T
3-PA,1730,0,0,428,0,428,G
3-PA,1731,0,0,429,0,429,G
3-PA,1732,1,0,421,0,422,G
3-PA,1733,0,0,431,0,431,G
3-PA,1734,425,0,0,0,425,A
3-PA,1735,428,0,0,0,428,A
3-PA,1736,0,426,0,0,426,T
3-PA,1737,0,0,431,0,431,G
3-PA,1738,0,1,433,0,434,G
3-PA,1739,431,0,0,0,431,A
3-PA,1740,0,1,433,0,434,G
3-PA,1741,433,0,1,0,434,A
3-PA,1742,0,427,0,2,429,T
3-PA,1743,0,2,428,0,430,G
3-PA,1744,423,0,1,0,424,A
3-PA,1745,1,3,423,0,427,G
3-PA,1746,425,0,0,0,425,A
3-PA,1747,0,0,0,419,419,C
3-PA,1748,1,0,413,0,414,G
3-PA,1749,0,410,0,1,411,T
3-PA,1750,1,407,0,0,408,T
3-PA,1751,0,0,412,0,412,G
3-PA,1752,0,0,0,410,410,C
3-PA,1753,0,0,0,416,416,C
3-PA,1754,0,413,0,0,413,T
3-PA,1755,0,0,0,419,419,C
3-PA,1756,0,0,0,421,421,C
3-PA,1757,0,420,0,0,420,T
3-PA,1758,0,421,0,0,421,T
3-PA,1759,1,0,0,424,425,C
3-PA,1760,422,0,2,0,424,A
3-PA,1761,0,0,426,0,426,G
3-PA,1762,1,424,1,0,426,T
3-PA,1763,1,0,0,430,431,C
3-PA,1764,424,0,0,0,424,A
3-PA,1765,0,1,0,442,443,C
3-PA,1766,0,441,0,0,441,T
3-PA,1767,0,0,0,443,443,C
3-PA,1768,0,0,0,443,443,C
3-PA,1769,440,0,0,0,440,A
3-PA,1770,0,0,440,0,440,G
3-PA,1771,0,0,0,442,442,C
3-PA,1772,439,0,0,0,439,A
3-PA,1773,0,3,439,0,442,G
3-PA,1774,431,0,0,0,431,A
3-PA,1775,0,429,0,0,429,T
3-PA,1776,0,0,0,426,426,C
3-PA,1777,0,2,427,0,429,G
3-PA,1778,426,0,0,0,426,A
3-PA,1779,0,1,429,0,430,G
3-PA,1780,427,0,0,0,427,A
3-PA,1781,0,0,428,0,428,G
3-PA,1782,0,0,0,426,426,C
3-PA,1783,424,0,0,0,424,A
3-PA,1784,0,424,0,1,425,T
3-PA,1785,1,2,430,0,433,G
3-PA,1786,439,0,0,0,439,A
3-PA,1787,0,438,0,0,438,T
3-PA,1788,0,440,0,0,440,T
3-PA,1789,0,1,438,0,439,G
3-PA,1790,432,0,1,1,434,A
3-PA,1791,434,0,0,0,434,A
3-PA,1792,1,0,433,0,434,G
3-PA,1793,0,0,0,433,433,C
3-PA,1794,2,0,0,423,425,C
3-PA,1795,0,1,425,0,426,G
3-PA,1796,425,0,0,0,425,A
3-PA,1797,0,0,429,0,429,G
3-PA,1798,0,425,0,0,425,T
3-PA,1799,3,0,0,422,425,C
3-PA,1800,3,0,0,423,426,C
3-PA,1801,0,421,0,0,421,T
3-PA,1802,2,0,0,423,425,C
3-PA,1803,0,1,421,0,422,G
3-PA,1804,0,0,422,0,422,G
3-PA,1805,0,421,0,0,421,T
3-PA,1806,0,1,0,423,424,C
3-PA,1807,431,0,1,0,432,A
3-PA,1808,435,0,0,0,435,A
3-PA,1809,435,0,0,0,435,A
3-PA,1810,0,2,438,0,440,G
3-PA,1811,439,0,0,0,439,A
3-PA,1812,0,0,440,0,440,G
3-PA,1813,422,0,2,0,424,A
3-PA,1814,424,1,0,0,425,A
3-PA,1815,423,0,0,0,423,A
3-PA,1816,0,0,428,0,428,G
3-PA,1817,427,0,0,0,427,A
3-PA,1818,0,0,0,426,426,C
3-PA,1819,422,0,0,0,422,A
3-PA,1820,0,422,0,0,422,T
3-PA,1821,0,2,420,0,422,G
3-PA,1822,428,0,0,0,428,A
3-PA,1823,0,0,0,428,428,C
3-PA,1824,4,0,0,419,423,C
3-PA,1825,420,0,0,0,420,A
3-PA,1826,422,0,0,0,422,A
3-PA,1827,422,0,0,0,422,A
3-PA,1828,0,1,421,0,422,G
3-PA,1829,421,0,0,0,421,A
3-PA,1830,0,0,423,0,423,G
3-PA,1831,0,419,0,0,419,T
3-PA,1832,0,413,0,0,413,T
3-PA,1833,0,416,0,0,416,T
3-PA,1834,0,419,0,0,419,T
3-PA,1835,0,416,0,0,416,T
3-PA,1836,0,417,0,0,417,T
3-PA,1837,0,1,419,0,420,G
3-PA,1838,418,0,0,0,418,A
3-PA,1839,0,1,422,0,423,G
3-PA,1840,421,0,0,0,421,A
3-PA,1841,421,0,0,0,421,A
3-PA,1842,0,422,0,0,422,T
3-PA,1843,424,0,0,0,424,A
3-PA,1844,422,0,0,0,422,A
3-PA,1845,0,0,418,0,418,G
3-PA,1846,0,433,0,0,433,T
3-PA,1847,0,0,0,435,435,C
3-PA,1848,435,0,0,0,435,A
3-PA,1849,0,0,435,0,435,G
3-PA,1850,435,0,0,0,435,A
3-PA,1851,437,0,0,0,437,A
3-PA,1852,0,0,436,0,436,G
3-PA,1853,0,0,0,427,427,C
3-PA,1854,425,0,0,0,425,A
3-PA,1855,1,424,0,0,425,T
3-PA,1856,0,0,423,0,423,G
3-PA,1857,0,1,429,0,430,G
3-PA,1858,0,0,0,428,428,C
3-PA,1859,0,0,0,432,432,C
3-PA,1860,2,0,0,435,437,C
3-PA,1861,435,0,0,0,435,A
3-PA,1862,0,438,0,0,438,T
3-PA,1863,0,438,0,0,438,T
3-PA,1864,0,0,435,0,435,G
3-PA,1865,0,0,436,0,436,G
3-PA,1866,0,1,425,0,426,G
3-PA,1867,0,1,426,0,427,G
3-PA,1868,406,0,1,0,407,A
3-PA,1869,0,0,413,0,413,G
3-PA,1870,0,410,0,1,411,T
3-PA,1871,2,0,0,419,421,C
3-PA,1872,2,0,0,430,432,C
3-PA,1873,0,0,0,435,435,C
3-PA,1874,0,0,0,435,435,C
3-PA,1875,2,0,0,433,435,C
3-PA,1876,436,0,0,0,436,A
3-PA,1877,435,0,1,0,436,A
3-PA,1878,0,0,439,0,439,G
3-PA,1879,0,0,429,0,429,G
3-PA,1880,0,1,428,0,429,G
3-PA,1881,385,0,1,0,386,A
3-PA,1882,0,0,391,0,391,G
3-PA,1883,0,391,0,0,391,T
3-PA,1884,0,0,391,0,391,G
3-PA,1885,0,0,396,0,396,G
3-PA,1886,393,0,0,0,393,A
3-PA,1887,393,0,0,0,393,A
3-PA,1888,0,0,391,0,391,G
3-PA,1889,387,0,0,0,387,A
3-PA,1890,387,1,0,0,388,A
3-PA,1891,0,1,378,0,379,G
3-PA,1892,0,0,379,0,379,G
3-PA,1893,0,375,0,3,378,T
3-PA,1894,0,370,0,0,370,T
3-PA,1895,0,0,0,374,374,C
3-PA,1896,0,0,0,370,370,C
3-PA,1897,372,0,0,0,372,A
3-PA,1898,0,372,0,0,372,T
3-PA,1899,0,373,0,0,373,T
3-PA,1900,0,0,372,0,372,G
3-PA,1901,0,0,371,0,371,G
3-PA,1902,0,1,369,0,370,G
3-PA,1903,370,0,0,0,370,A
3-PA,1904,366,0,0,0,366,A
3-PA,1905,365,0,1,0,366,A
3-PA,1906,0,0,377,0,377,G
3-PA,1907,1,378,0,0,379,T
3-PA,1908,1,0,0,383,384,C
3-PA,1909,0,379,0,0,379,T
3-PA,1910,0,0,378,0,378,G
3-PA,1911,0,378,0,0,378,T
3-PA,1912,379,0,0,0,379,A
3-PA,1913,0,0,382,0,382,G
3-PA,1914,0,1,376,0,377,G
3-PA,1915,370,0,0,0,370,A
3-PA,1916,0,0,0,369,369,C
3-PA,1917,0,364,0,0,364,T
3-PA,1918,0,0,0,383,383,C
3-PA,1919,0,380,0,1,381,T
3-PA,1920,382,0,0,0,382,A
3-PA,1921,0,381,0,0,381,T
3-PA,1922,0,378,0,0,378,T
3-PA,1923,0,0,389,0,389,G
3-PA,1924,0,0,386,0,386,G
3-PA,1925,1,0,0,385,386,C
3-PA,1926,0,380,0,0,380,T
3-PA,1927,359,0,0,0,359,A
3-PA,1928,361,0,0,0,361,A
3-PA,1929,0,0,364,0,364,G
3-PA,1930,0,359,0,0,359,T
3-PA,1931,0,0,0,359,359,C
3-PA,1932,348,0,0,0,348,A
3-PA,1933,0,1,359,0,360,G
3-PA,1934,0,360,0,0,360,T
3-PA,1935,370,0,0,0,370,A
3-PA,1936,0,369,0,0,369,T
3-PA,1937,0,368,0,0,368,T
3-PA,1938,2,0,0,366,368,C
3-PA,1939,363,0,1,0,364,A
3-PA,1940,363,0,0,0,363,A
3-PA,1941,0,364,0,0,364,T
3-PA,1942,357,0,0,0,357,A
3-PA,1943,0,0,360,0,360,G
3-PA,1944,0,0,0,354,354,C
3-PA,1945,1,0,0,355,356,C
3-PA,1946,0,352,0,0,352,T
3-PA,1947,0,0,363,0,363,G
3-PA,1948,0,362,0,0,362,T
3-PA,1949,363,0,0,0,363,A
3-PA,1950,0,363,0,0,363,T
3-PA,1951,0,0,357,0,357,G
3-PA,1952,0,0,0,352,352,C
3-PA,1953,337,0,1,0,338,A
3-PA,1954,0,338,0,1,339,T
3-PA,1955,2,0,1,336,339,C
3-PA,1956,325,0,0,0,325,A
3-PA,1957,0,0,0,328,328,C
3-PA,1958,1,1,0,323,325,C
3-PA,1959,325,0,0,0,325,A
3-PA,1960,0,0,0,328,328,C
3-PA,1961,326,0,0,0,326,A
3-PA,1962,327,0,0,0,327,A
3-PA,1963,0,323,0,0,323,T
3-PA,1964,0,323,0,0,323,T
3-PA,1965,0,1,322,0,323,G
3-PA,1966,0,0,318,0,318,G
3-PA,1967,317,0,0,0,317,A
3-PA,1968,316,0,0,0,316,A
3-PA,1969,0,1,313,0,314,G
3-PA,1970,0,2,314,0,316,G
3-PA,1971,314,0,1,0,315,A
3-PA,1972,0,314,0,0,314,T
3-PA,1973,0,313,0,0,313,T
3-PA,1974,0,315,0,0,315,T
3-PA,1975,0,314,0,0,314,T
3-PA,1976,0,0,0,316,316,C
3-PA,1977,313,0,2,0,315,A
3-PA,1978,0,0,316,0,316,G
3-PA,1979,0,0,0,314,314,C
3-PA,1980,1,0,309,0,310,G
3-PA,1981,0,0,309,0,309,G
3-PA,1982,312,0,0,0,312,A
3-PA,1983,0,1,313,0,314,G
3-PA,1984,0,315,0,0,315,T
3-PA,1985,3,0,0,314,317,C
3-PA,1986,317,0,0,0,317,A
3-PA,1987,320,0,0,0,320,A
3-PA,1988,0,0,319,0,319,G
3-PA,1989,321,0,0,0,321,A
3-PA,1990,319,0,0,0,319,A
3-PA,1991,316,1,1,0,318,A
3-PA,1992,312,0,0,0,312,A
3-PA,1993,0,0,0,312,312,C
3-PA,1994,0,306,0,0,306,T
3-PA,1995,2,0,306,0,308,G
3-PA,1996,0,0,0,305,305,C
3-PA,1997,0,308,0,0,308,T
3-PA,1998,0,0,0,307,307,C
3-PA,1999,0,0,0,305,305,C
3-PA,2000,0,303,0,0,303,T
3-PA,2001,0,304,0,0,304,T
3-PA,2002,0,0,303,0,303,G
3-PA,2003,0,303,0,0,303,T
3-PA,2004,1,297,0,0,298,T
3-PA,2005,0,0,303,0,303,G
3-PA,2006,0,302,0,0,302,T
3-PA,2007,0,300,0,0,300,T
3-PA,2008,2,0,0,300,302,C
3-PA,2009,295,0,0,0,295,A
3-PA,2010,1,0,295,0,296,G
3-PA,2011,0,0,296,0,296,G
3-PA,2012,0,0,0,297,297,C
3-PA,2013,0,297,0,0,297,T
3-PA,2014,2,0,0,300,302,C
3-PA,2015,0,300,0,1,301,T
3-PA,2016,0,300,0,0,300,T
3-PA,2017,299,0,1,0,300,A
3-PA,2018,0,0,300,0,300,G
3-PA,2019,0,1,293,0,294,G
3-PA,2020,0,0,292,0,292,G
3-PA,2021,287,0,0,0,287,A
3-PA,2022,0,0,0,287,287,C
3-PA,2023,274,0,0,0,274,A
3-PA,2024,280,0,0,0,280,A
3-PA,2025,0,0,0,280,280,C
3-PA,2026,0,0,0,279,279,C
3-PA,2027,0,279,0,0,279,T
3-PA,2028,0,1,0,273,274,C
3-PA,2029,0,0,274,0,274,G
3-PA,2030,273,0,0,0,273,A
3-PA,2031,275,0,0,0,275,A
3-PA,2032,0,0,0,274,274,C
3-PA,2033,0,0,0,264,264,C
3-PA,2034,1,253,0,1,255,T
3-PA,2035,0,0,255,0,255,G
3-PA,2036,0,1,254,0,255,G
3-PA,2037,0,0,256,0,256,G
3-PA,2038,257,0,0,0,257,A
3-PA,2039,1,0,0,256,257,C
3-PA,2040,1,0,0,255,256,C
3-PA,2041,0,248,0,0,248,T
3-PA,2042,0,247,0,0,247,T
3-PA,2043,0,247,0,0,247,T
3-PA,2044,0,0,247,0,247,G
3-PA,2045,248,0,0,0,248,A
3-PA,2046,0,246,0,0,246,T
3-PA,2047,0,0,0,245,245,C
3-PA,2048,0,242,0,0,242,T
3-PA,2049,0,238,0,0,238,T
3-PA,2050,0,0,238,0,238,G
3-PA,2051,0,0,238,0,238,G
3-PA,2052,0,1,237,0,238,G
3-PA,2053,0,1,238,0,239,G
3-PA,2054,0,0,234,0,234,G
3-PA,2055,0,1,232,1,234,G
3-PA,2056,0,0,0,234,234,C
3-PA,2057,0,231,0,0,231,T
3-PA,2058,238,0,0,0,238,A
3-PA,2059,0,237,0,0,237,T
3-PA,2060,236,0,1,0,237,A
3-PA,2061,0,236,0,0,236,T
3-PA,2062,0,0,230,0,230,G
3-PA,2063,229,0,1,0,230,A
3-PA,2064,227,0,0,0,227,A
3-PA,2065,0,0,228,0,228,G
3-PA,2066,1,0,0,230,231,C
3-PA,2067,214,0,0,0,214,A
3-PA,2068,220,0,0,0,220,A
3-PA,2069,0,219,0,0,219,T
3-PA,2070,0,218,0,0,218,T
3-PA,2071,0,0,218,0,218,G
3-PA,2072,216,0,0,0,216,A
3-PA,2073,1,0,215,0,216,G
3-PA,2074,0,0,215,0,215,G
3-PA,2075,204,0,0,0,204,A
3-PA,2076,0,0,206,0,206,G
3-PA,2077,0,190,0,0,190,T
3-PA,2078,0,0,191,0,191,G
3-PA,2079,1,0,0,191,192,C
3-PA,2080,1,0,0,190,191,C
3-PA,2081,0,190,0,0,190,T
3-PA,2082,0,0,191,0,191,G
3-PA,2083,190,0,0,0,190,A
3-PA,2084,0,189,0,0,189,T
3-PA,2085,0,183,0,0,183,T
3-PA,2086,184,0,0,0,184,A
3-PA,2087,182,0,1,0,183,A
3-PA,2088,0,181,0,0,181,T
3-PA,2089,0,0,180,0,180,G
3-PA,2090,179,0,0,0,179,A
3-PA,2091,0,174,0,0,174,T
3-PA,2092,0,0,0,174,174,C
3-PA,2093,1,0,0,168,169,C
3-PA,2094,1,0,0,168,169,C
3-PA,2095,0,167,0,0,167,T
3-PA,2096,0,0,167,0,167,G
3-PA,2097,0,0,170,0,170,G
3-PA,2098,0,0,170,0,170,G
3-PA,2099,0,168,0,0,168,T
3-PA,2100,0,154,0,0,154,T
3-PA,2101,0,155,0,0,155,T
3-PA,2102,0,154,0,0,154,T
3-PA,2103,0,0,155,0,155,G
3-PA,2104,0,1,0,154,155,C
3-PA,2105,0,154,0,0,154,T
3-PA,2106,0,0,0,154,154,C
3-PA,2107,144,0,0,0,144,A
3-PA,2108,144,0,0,0,144,A
3-PA,2109,0,143,0,0,143,T
3-PA,2110,0,0,144,0,144,G
3-PA,2111,0,1,0,143,144,C
3-PA,2112,0,0,140,0,140,G
3-PA,2113,0,141,0,0,141,T
3-PA,2114,0,0,0,140,140,C
3-PA,2115,0,139,0,0,139,T
3-PA,2116,0,138,0,0,138,T
3-PA,2117,0,0,140,0,140,G
3-PA,2118,0,0,141,0,141,G
3-PA,2119,0,139,0,0,139,T
3-PA,2120,0,137,0,0,137,T
3-PA,2121,0,0,0,135,135,C
3-PA,2122,134,0,0,0,134,A
3-PA,2123,134,0,0,0,134,A
3-PA,2124,0,0,0,134,134,C
3-PA,2125,0,131,0,0,131,T
3-PA,2126,0,0,0,131,131,C
3-PA,2127,0,1,0,124,125,C
3-PA,2128,0,126,0,0,126,T
3-PA,2129,0,125,0,0,125,T
3-PA,2130,1,0,0,125,126,C
3-PA,2131,0,0,0,126,126,C
3-PA,2132,0,121,0,0,121,T
3-PA,2133,0,1,120,0,121,G
3-PA,2134,121,0,0,0,121,A
3-PA,2135,0,0,0,118,118,C
3-PA,2136,109,0,0,0,109,A
3-PA,2137,0,0,0,104,104,C
3-PA,2138,103,0,0,0,103,A
3-PA,2139,0,102,0,0,102,T
3-PA,2140,0,0,101,0,101,G
3-PA,2141,0,0,0,101,101,C
3-PA,2142,100,0,0,0,100,A
3-PA,2143,0,100,0,0,100,T
3-PA,2144,0,98,0,0,98,T
3-PA,2145,99,0,0,0,99,A
3-PA,2146,99,0,0,0,99,A
3-PA,2147,99,0,0,0,99,A
3-PA,2148,99,0,0,0,99,A
3-PA,2149,0,97,0,0,97,T
3-PA,2150,78,0,0,0,78,A
3-PA,2151,0,0,78,0,78,G
4-HA,1,288,0,0,0,288,A
4-HA,2,0,287,0,0,287,T
4-HA,3,0,0,295,0,295,G
4-HA,4,300,0,0,0,300,A
4-HA,5,306,0,0,0,306,A
4-HA,6,0,0,330,0,330,G
4-HA,7,330,0,2,0,332,A
4-HA,8,0,0,0,353,353,C
4-HA,9,0,355,0,0,355,T
4-HA,10,375,0,0,0,375,A
4-HA,11,0,390,0,0,390,T
4-HA,12,1,0,0,390,391,C
4-HA,13,390,0,0,0,390,A
4-HA,14,0,392,0,0,392,T
4-HA,15,0,393,0,0,393,T
4-HA,16,1,1,424,0,426,G
4-HA,17,0,0,0,431,431,C
4-HA,18,0,431,0,0,431,T
4-HA,19,0,432,0,1,433,T
4-HA,20,0,433,0,0,433,T
4-HA,21,0,1,461,0,462,G
4-HA,22,461,0,1,0,462,A
4-HA,23,1,1,472,0,474,G
4-HA,24,0,0,0,476,476,C
4-HA,25,0,479,0,0,479,T
4-HA,26,508,0,0,0,508,A
4-HA,27,0,0,0,512,512,C
4-HA,28,525,1,0,0,526,A
4-HA,29,0,561,0,0,561,T
4-HA,30,0,558,0,0,558,T
4-HA,31,0,0,0,569,569,C
4-HA,32,0,568,0,0,568,T
4-HA,33,579,0,0,0,579,A
4-HA,34,0,583,0,0,583,T
4-HA,35,0,1,586,0,587,G
4-HA,36,0,587,0,1,588,T
4-HA,37,0,0,0,589,589,C
4-HA,38,0,587,0,0,587,T
4-HA,39,1,0,587,0,588,G
4-HA,40,0,0,590,0,590,G
4-HA,41,0,587,0,0,587,T
4-HA,42,0,590,0,0,590,T
4-HA,43,0,590,0,0,590,T
4-HA,44,0,589,0,1,590,T
4-HA,45,1,0,0,589,590,C
4-HA,46,0,1,588,0,589,G
4-HA,47,0,0,0,592,592,C
4-HA,48,0,593,1,2,596,T
4-HA,49,4,0,0,594,598,C
4-HA,50,597,0,0,0,597,A
4-HA,51,599,0,0,0,599,A
4-HA,52,601,0,0,0,601,A
4-HA,53,601,0,0,0,601,A
4-HA,54,600,0,0,0,600,A
4-HA,55,0,0,0,606,606,C
4-HA,56,0,604,0,0,604,T
4-HA,57,0,603,0,0,603,T
4-HA,58,2,0,1,599,602,C
4-HA,59,0,0,0,603,603,C
4-HA,60,0,601,0,1,602,T
4-HA,61,0,1,610,0,611,G
4-HA,62,0,2,607,0,609,G
4-HA,63,612,0,0,0,612,A
4-HA,64,623,0,0,0,623,A
4-HA,65,624,0,1,0,625,A
4-HA,66,0,631,0,0,631,T
4-HA,67,0,6,635,0,641,G
4-HA,68,642,1,0,0,643,A
4-HA,69,0,1,0,652,653,C
4-HA,70,653,0,0,0,653,A
4-HA,71,652,0,0,0,652,A
4-HA,72,0,1,0,662,663,C
4-HA,73,655,0,2,0,657,A
4-HA,74,0,0,670,0,670,G
4-HA,75,0,1,0,665,666,C
4-HA,76,671,0,0,0,671,A
4-HA,77,0,2,0,705,707,C
4-HA,78,0,3,702,0,705,G
4-HA,79,0,0,711,0,711,G
4-HA,80,0,1,0,711,712,C
4-HA,81,711,0,0,0,711,A
4-HA,82,717,0,0,0,717,A
4-HA,83,0,1,0,719,720,C
4-HA,84,0,2,723,0,725,G
4-HA,85,1,0,0,727,728,C
4-HA,86,0,725,0,1,726,T
4-HA,87,0,0,737,0,737,G
4-HA,88,0,734,0,0,734,T
4-HA,89,0,3,753,0,756,G
4-HA,90,0,2,0,764,766,C
4-HA,91,1,0,0,777,778,C
4-HA,92,0,775,0,0,775,T
4-HA,93,0,774,0,1,775,T
4-HA,94,0,2,779,0,781,G
4-HA,95,0,4,782,0,786,G
4-HA,96,0,0,790,0,790,G
4-HA,97,0,0,0,798,798,C
4-HA,98,791,0,0,0,791,A
4-HA,99,0,0,0,800,800,C
4-HA,100,1,0,0,783,784,C
4-HA,101,855,0,2,0,857,A
4-HA,102,0,857,0,1,858,T
4-HA,103,0,1,859,0,860,G
4-HA,104,1,0,0,862,863,C
4-HA,105,848,0,1,0,849,A
4-HA,106,0,1,905,0,906,G
4-HA,107,0,902,0,2,904,T
4-HA,108,908,0,2,0,910,A
4-HA,109,2,0,0,908,910,C
4-HA,110,2,0,0,874,876,C
4-HA,111,884,0,0,0,884,A
4-HA,112,885,0,1,0,886,A
4-HA,113,885,0,0,0,885,A
4-HA,114,0,0,0,892,892,C
4-HA,115,0,3,870,0,873,G
4-HA,116,0,4,905,0,909,G
4-HA,117,910,0,0,0,910,A
4-HA,118,911,0,0,0,911,A
4-HA,119,0,1,0,909,910,C
4-HA,120,898,0,0,0,898,A
4-HA,121,914,1,0,0,915,A
4-HA,122,0,915,0,0,915,T
4-HA,123,932,0,0,0,932,A
4-HA,124,1,0,937,0,938,G
4-HA,125,0,923,0,0,923,T
4-HA,126,0,2,921,0,923,G
4-HA,127,925,0,0,0,925,A
4-HA,128,925,0,0,0,925,A
4-HA,129,925,0,0,0,925,A
4-HA,130,927,0,0,0,927,A
4-HA,131,0,0,0,944,944,C
4-HA,132,945,0,0,0,945,A
4-HA,133,945,0,0,0,945,A
4-HA,134,0,944,0,2,946,T
4-HA,135,1,1,1,943,946,C
4-HA,136,948,0,0,0,948,A
4-HA,137,0,0,0,951,951,C
4-HA,138,0,4,948,0,952,G
4-HA,139,948,2,0,0,950,A
4-HA,140,949,0,1,0,950,A
4-HA,141,0,946,0,0,946,T
4-HA,142,0,4,943,0,947,G
4-HA,143,956,0,3,0,959,A
4-HA,144,1,0,0,957,958,C
4-HA,145,3,0,0,957,960,C
4-HA,146,970,0,0,0,970,A
4-HA,147,974,0,0,0,974,A
4-HA,148,976,0,0,0,976,A
4-HA,149,0,975,0,1,976,T
4-HA,150,0,976,0,1,977,T
4-HA,151,0,1,983,0,984,G
4-HA,152,985,0,1,0,986,A
4-HA,153,990,0,0,0,990,A
4-HA,154,0,2,990,0,992,G
4-HA,155,0,995,0,1,996,T
4-HA,156,0,1017,0,1,1018,T
4-HA,157,1028,0,1,0,1029,A
4-HA,158,0,0,0,1034,1034,C
4-HA,159,0,1040,0,0,1040,T
4-HA,160,1040,0,0,0,1040,A
4-HA,161,1055,0,1,0,1056,A
4-HA,162,0,1057,0,0,1057,T
4-HA,163,1,1,1060,0,1062,G
4-HA,164,0,0,0,1100,1100,C
4-HA,165,0,1085,0,0,1085,T
4-HA,166,1082,0,0,0,1082,A
4-HA,167,0,0,0,1082,1082,C
4-HA,168,0,1077,0,1,1078,T
4-HA,169,1,4,1076,0,1081,G
4-HA,170,1072,1,0,0,1073,A
4-HA,171,5,0,1074,0,1079,G
4-HA,172,0,0,0,1078,1078,C
4-HA,173,0,1047,0,0,1047,T
4-HA,174,0,4,1076,0,1080,G
4-HA,175,0,2,1113,0,1115,G
4-HA,176,0,1111,0,1,1112,T
4-HA,177,0,1114,0,1,1115,T
4-HA,178,3,0,0,1110,1113,C
4-HA,179,1109,1,1,0,1111,A
4-HA,180,0,7,1113,0,1120,G
4-HA,181,1122,0,0,0,1122,A
4-HA,182,0,0,1142,0,1142,G
4-HA,183,0,1128,0,1,1129,T
4-HA,184,0,1119,0,0,1119,T
4-HA,185,2,1,0,1120,1123,C
4-HA,186,2,1,0,1127,1130,C
4-HA,187,1,1122,0,0,1123,T
4-HA,188,0,0,0,1128,1128,C
4-HA,189,1131,0,0,0,1131,A
4-HA,190,1129,0,1,1,1131,A
4-HA,191,0,0,0,1135,1135,C
4-HA,192,1119,0,0,0,1119,A
4-HA,193,0,0,1142,0,1142,G
4-HA,194,0,0,1140,0,1140,G
4-HA,195,0,1133,0,1,1134,T
4-HA,196,1,5,1134,1,1141,G
4-HA,197,1145,0,0,0,1145,A
4-HA,198,1143,0,1,0,1144,A
4-HA,199,1176,1,1,0,1178,A
4-HA,200,0,1168,0,0,1168,T
4-HA,201,1182,0,0,0,1182,A
4-HA,202,0,1166,0,0,1166,T
4-HA,203,0,1,1165,0,1166,G
4-HA,204,0,2,0,1173,1175,C
4-HA,205,0,5,1170,0,1175,G
4-HA,206,1177,0,2,0,1179,A
4-HA,207,0,0,0,1178,1178,C
4-HA,208,1152,0,1,0,1153,A
4-HA,209,0,1,1226,0,1227,G
4-HA,210,0,1215,0,0,1215,T
4-HA,211,4,2,0,1224,1230,C
4-HA,212,1,1,0,1228,1230,C
4-HA,213,0,1219,0,0,1219,T
4-HA,214,4,1,0,1231,1236,C
4-HA,215,1231,0,0,0,1231,A
4-HA,216,0,1234,0,0,1234,T
4-HA,217,2,0,0,1231,1233,C
4-HA,218,1178,0,0,1,1179,A
4-HA,219,0,0,1188,0,1188,G
4-HA,220,1181,0,1,0,1182,A
4-HA,221,0,1183,0,0,1183,T
4-HA,222,1,0,0,1195,1196,C
4-HA,223,1,1,0,1190,1192,C
4-HA,224,0,1208,0,0,1208,T
4-HA,225,0,1207,0,1,1208,T
4-HA,226,0,1,1205,0,1206,G
4-HA,227,1212,0,0,0,1212,A
4-HA,228,0,1206,0,1,1207,T
4-HA,229,0,2,1219,0,1221,G
4-HA,230,0,3,1214,0,1217,G
4-HA,231,1206,0,1,0,1207,A
4-HA,232,0,2,1208,0,1210,G
4-HA,233,1195,0,0,0,1195,A
4-HA,234,0,8,1180,0,1188,G
4-HA,235,1209,0,0,0,1209,A
4-HA,236,1220,0,1,0,1221,A
4-HA,237,0,0,0,1235,1235,C
4-HA,238,0,1218,0,1,1219,T
4-HA,239,0,0,1242,0,1242,G
4-HA,240,0,0,0,1237,1237,C
4-HA,241,1238,0,1,0,1239,A
4-HA,242,0,0,0,1278,1278,C
4-HA,243,1264,0,1,0,1265,A
4-HA,244,0,0,0,1403,1403,C
4-HA,245,0,1397,0,0,1397,T
4-HA,246,1411,0,1,0,1412,A
4-HA,247,1407,0,1,0,1408,A
4-HA,248,0,1417,0,1,1418,T
4-HA,249,1405,1,0,0,1406,A
4-HA,250,1,0,1410,0,1411,G
4-HA,251,1404,1,1,0,1406,A
4-HA,252,0,1384,0,1,1385,T
4-HA,253,0,0,1352,0,1352,G
4-HA,254,1,1,0,1357,1359,C
4-HA,255,0,1348,0,0,1348,T
4-HA,256,2,0,0,1437,1439,C
4-HA,257,0,1439,0,0,1439,T
4-HA,258,1483,0,1,0,1484,A
4-HA,259,0,1486,0,0,1486,T
4-HA,260,0,1488,0,0,1488,T
4-HA,261,2,4,1499,0,1505,G
4-HA,262,0,3,1502,0,1505,G
4-HA,263,0,4,1509,1,1514,G
4-HA,264,1490,1,2,1,1494,A
4-HA,265,0,3,1476,0,1479,G
4-HA,266,1456,0,1,0,1457,A
4-HA,267,1,0,0,1604,1605,C
4-HA,268,1,0,0,1635,1636,C
4-HA,269,1,0,0,1675,1676,C
4-HA,270,0,1673,0,1,1674,T
4-HA,271,2,0,0,1703,1705,C
4-HA,272,1707,0,0,0,1707,A
4-HA,273,1397,0,335,0,1732,A
4-HA,274,0,1770,1,3,1774,T
4-HA,275,0,3,1800,1,1804,G
4-HA,276,1,1797,0,2,1800,T
4-HA,277,1,4,1786,0,1791,G
4-HA,278,1777,3,4,0,1784,A
4-HA,279,0,1785,0,0,1785,T
4-HA,280,1,4,1774,0,1779,G
4-HA,281,0,0,1783,0,1783,G
4-HA,282,0,1,0,1780,1781,C
4-HA,283,1,1780,0,2,1783,T
4-HA,284,0,1776,0,2,1778,T
4-HA,285,2,0,0,1778,1780,C
4-HA,286,2,0,0,1772,1774,C
4-HA,287,1780,0,0,0,1780,A
4-HA,288,1789,0,0,0,1789,A
4-HA,289,1787,0,0,0,1787,A
4-HA,290,1792,1,0,0,1793,A
4-HA,291,0,1803,0,0,1803,T
4-HA,292,1793,0,3,1,1797,A
4-HA,293,1796,1,1,0,1798,A
4-HA,294,1,5,1805,0,1811,G
4-HA,295,1824,0,0,0,1824,A
4-HA,296,1830,0,1,0,1831,A
4-HA,297,1825,0,1,0,1826,A
4-HA,298,1,1828,0,0,1829,T
4-HA,299,5,3,1822,0,1830,G
4-HA,300,1,3,1820,0,1824,G
4-HA,301,0,7,1819,0,1826,G
4-HA,302,1828,0,2,0,1830,A
4-HA,303,3,0,0,1836,1839,C
4-HA,304,2,0,0,1839,1841,C
4-HA,305,2,1867,0,1,1870,T
4-HA,306,0,1870,1,1,1872,T
4-HA,307,0,1872,0,0,1872,T
4-HA,308,0,1876,1,0,1877,T
4-HA,309,0,1880,0,0,1880,T
4-HA,310,1,1,1883,0,1885,G
4-HA,311,0,1886,0,0,1886,T
4-HA,312,0,1875,0,3,1878,T
4-HA,313,5,11,1863,0,1879,G
4-HA,314,1862,0,0,0,1862,A
4-HA,315,1869,0,0,0,1869,A
4-HA,316,0,0,0,1874,1874,C
4-HA,317,2,1,1863,0,1866,G
4-HA,318,0,0,0,1898,1898,C
4-HA,319,1890,0,2,0,1892,A
4-HA,320,1,0,1899,0,1900,G
4-HA,321,0,0,0,1900,1900,C
4-HA,322,1901,0,0,0,1901,A
4-HA,323,1901,0,1,0,1902,A
4-HA,324,1904,0,2,0,1906,A
4-HA,325,0,0,1993,1,1994,G
4-HA,326,1,0,0,1991,1992,C
4-HA,327,1,0,0,1993,1994,C
4-HA,328,0,1988,0,1,1989,T
4-HA,329,1985,0,1,1,1987,A
4-HA,330,1,0,0,2001,2002,C
4-HA,331,2000,0,1,0,2001,A
4-HA,332,0,0,2003,0,2003,G
4-HA,333,1,0,0,1990,1991,C
4-HA,334,1943,0,0,0,1943,A
4-HA,335,1968,0,0,0,1968,A
4-HA,336,2,1,1,2038,2042,C
4-HA,337,2,2033,0,0,2035,T
4-HA,338,1,2,2046,0,2049,G
4-HA,339,0,2023,0,3,2026,T
4-HA,340,0,2018,0,6,2024,T
4-HA,341,2027,1,0,0,2028,A
4-HA,342,1,4,0,2182,2187,C
4-HA,343,4,6,0,2194,2204,C
4-HA,344,0,1,0,2259,2260,C
4-HA,345,0,2181,1,1,2183,T
4-HA,346,0,2182,1,1,2184,T
4-HA,347,2193,0,0,1,2194,A
4-HA,348,0,2194,0,0,2194,T
4-HA,349,2,6,2180,0,2188,G
4-HA,350,2188,0,3,0,2191,A
4-HA,351,0,2049,1,0,2050,T
4-HA,352,1,1,2076,0,2078,G
4-HA,353,0,2053,0,1,2054,T
4-HA,354,3,0,2041,0,2044,G
4-HA,355,0,1,0,2048,2049,C
4-HA,356,4,1,0,2047,2052,C
4-HA,357,1,3,2080,0,2084,G
4-HA,358,1,4,2108,0,2113,G
4-HA,359,2106,1,0,0,2107,A
4-HA,360,0,2116,0,0,2116,T
4-HA,361,0,2083,0,0,2083,T
4-HA,362,2095,0,0,0,2095,A
4-HA,363,0,2089,1,1,2091,T
4-HA,364,1,0,2097,0,2098,G
4-HA,365,1,0,0,2098,2099,C
4-HA,366,5,1,0,2081,2087,C
4-HA,367,0,2100,0,1,2101,T
4-HA,368,2,1,0,2215,2218,C
4-HA,369,2,0,1,2229,2232,C
4-HA,370,6,1,0,2231,2238,C
4-HA,371,0,2228,1,0,2229,T
4-HA,372,0,2240,0,0,2240,T
4-HA,373,2227,0,0,0,2227,A
4-HA,374,1,1,2291,0,2293,G
4-HA,375,0,1,2293,0,2294,G
4-HA,376,0,2282,0,1,2283,T
4-HA,377,9,1,1,2241,2252,C
4-HA,378,2230,0,0,0,2230,A
4-HA,379,0,0,0,2280,2280,C
4-HA,380,0,2286,0,0,2286,T
4-HA,381,2283,0,1,0,2284,A
4-HA,382,0,0,2287,0,2287,G
4-HA,383,0,2258,0,2,2260,T
4-HA,384,1,2244,1,1,2247,T
4-HA,385,1,2,2264,2,2269,G
4-HA,386,2,2,0,2266,2270,C
4-HA,387,4,0,0,2271,2275,C
4-HA,388,0,2263,1,1,2265,T
4-HA,389,2,0,0,2267,2269,C
4-HA,390,2344,1,1,0,2346,A
4-HA,391,0,2352,0,1,2353,T
4-HA,392,2,3,0,2349,2354,C
4-HA,393,5,2,0,2344,2351,C
4-HA,394,1,2,2332,0,2335,G
4-HA,395,2,0,2329,0,2331,G
4-HA,396,1,1,0,2351,2353,C
4-HA,397,2357,1,0,0,2358,A
4-HA,398,0,1,0,2381,2382,C
4-HA,399,2341,0,2,2,2345,A
4-HA,400,1,2,0,2352,2355,C
4-HA,401,0,2345,0,1,2346,T
4-HA,402,0,3,2355,0,2358,G
4-HA,403,0,4,2378,0,2382,G
4-HA,404,2366,0,2,0,2368,A
4-HA,405,0,1,2396,0,2397,G
4-HA,406,0,2384,0,0,2384,T
4-HA,407,0,2351,0,1,2352,T
4-HA,408,0,2355,0,6,2361,T
4-HA,409,2359,0,1,0,2360,A
4-HA,410,2356,1,0,0,2357,A
4-HA,411,2,1,0,2376,2379,C
4-HA,412,2336,0,1,0,2337,A
4-HA,413,2333,0,2,1,2336,A
4-HA,414,1,2323,0,0,2324,T
4-HA,415,0,7,2315,0,2322,G
4-HA,416,2319,0,0,0,2319,A
4-HA,417,2315,2,1,0,2318,A
4-HA,418,2308,0,9,0,2317,A
4-HA,419,0,1,2330,0,2331,G
4-HA,420,1,0,0,2349,2350,C
4-HA,421,0,2336,1,0,2337,T
4-HA,422,2,2342,0,0,2344,T
4-HA,423,7,3,0,2356,2366,C
4-HA,424,2375,1,1,0,2377,A
4-HA,425,2380,0,0,0,2380,A
4-HA,426,0,2383,1,1,2385,T
4-HA,427,1,2376,0,0,2377,T
4-HA,428,2,7,2428,0,2437,G
4-HA,429,2,5,2457,0,2464,G
4-HA,430,2458,0,3,0,2461,A
4-HA,431,2,0,0,2456,2458,C
4-HA,432,0,2433,0,11,2444,T
4-HA,433,0,2,2456,0,2458,G
4-HA,434,0,2,2464,0,2466,G
4-HA,435,2459,0,3,0,2462,A
4-HA,436,0,0,2468,0,2468,G
4-HA,437,0,2419,0,2,2421,T
4-HA,438,8,0,0,2382,2390,C
4-HA,439,2417,1,1,0,2419,A
4-HA,440,0,2,1,2429,2432,C
4-HA,441,1,2429,0,2,2432,T
4-HA,442,12,1,0,2410,2423,C
4-HA,443,2411,0,0,0,2411,A
4-HA,444,2433,0,1,0,2434,A
4-HA,445,2426,0,0,0,2426,A
4-HA,446,2424,0,1,1,2426,A
4-HA,447,2,1,0,2435,2438,C
4-HA,448,0,6,2397,0,2403,G
4-HA,449,1,4,2437,0,2442,G
4-HA,450,2439,0,1,0,2440,A
4-HA,451,2442,0,0,0,2442,A
4-HA,452,0,0,0,2446,2446,C
4-HA,453,2429,1,0,0,2430,A
4-HA,454,2452,0,3,0,2455,A
4-HA,455,2,3,2464,0,2469,G
4-HA,456,2,0,0,2476,2478,C
4-HA,457,0,2452,1,1,2454,T
4-HA,458,2,0,0,2470,2472,C
4-HA,459,1,2466,0,0,2467,T
4-HA,460,0,3,2466,0,2469,G
4-HA,461,0,0,0,2471,2471,C
4-HA,462,0,2467,2,2,2471,T
4-HA,463,1,2525,1,0,2527,T
4-HA,464,1,1,2562,0,2564,G
4-HA,465,3,1,0,2574,2578,C
4-HA,466,2582,0,0,0,2582,A
4-HA,467,1,2559,0,0,2560,T
4-HA,468,2562,0,0,1,2563,A
4-HA,469,2554,1,1,0,2556,A
4-HA,470,2,3,2550,0,2555,G
4-HA,471,0,4,2551,0,2555,G
4-HA,472,2457,0,6,1,2464,A
4-HA,473,2,5,2442,0,2449,G
4-HA,474,2426,1,1,0,2428,A
4-HA,475,0,2516,0,0,2516,T
4-HA,476,5,0,0,2536,2541,C
4-HA,477,0,2550,0,0,2550,T
4-HA,478,2555,0,0,0,2555,A
4-HA,479,2548,0,2,0,2550,A
4-HA,480,1,2548,0,0,2549,T
4-HA,481,2539,1,0,0,2540,A
4-HA,482,2517,0,2,0,2519,A
4-HA,483,1,0,0,2526,2527,C
4-HA,484,2427,0,2,0,2429,A
4-HA,485,1,2,2459,1,2463,G
4-HA,486,0,2417,0,1,2418,T
4-HA,487,2,2481,0,1,2484,T
4-HA,488,1,2487,0,0,2488,T
4-HA,489,3,0,0,2538,2541,C
4-HA,490,0,2537,0,2,2539,T
4-HA,491,0,2544,0,1,2545,T
4-HA,492,0,2544,0,0,2544,T
4-HA,493,2540,0,1,0,2541,A
4-HA,494,0,0,2538,0,2538,G
4-HA,495,1,2534,0,0,2535,T
4-HA,496,2512,0,0,1,2513,A
4-HA,497,0,4,2523,0,2527,G
4-HA,498,2475,0,2,0,2477,A
4-HA,499,0,2473,0,1,2474,T
4-HA,500,0,2473,0,0,2473,T
4-HA,501,2,9,2506,0,2517,G
4-HA,502,2508,0,1,0,2509,A
4-HA,503,2515,0,1,0,2516,A
4-HA,504,0,2513,0,1,2514,T
4-HA,505,0,2486,0,0,2486,T
4-HA,506,1,6,2510,0,2517,G
4-HA,507,1,0,2503,0,2504,G
4-HA,508,1,2504,0,3,2508,T
4-HA,509,0,2502,0,1,2503,T
4-HA,510,0,17,2462,0,2479,G
4-HA,511,2468,1,2,0,2471,A
4-HA,512,2,1,0,2453,2456,C
4-HA,513,4,0,0,2454,2458,C
4-HA,514,7,1,0,2459,2467,C
4-HA,515,2456,0,0,0,2456,A
4-HA,516,0,3,0,2465,2468,C
4-HA,517,2,2464,0,0,2466,T
4-HA,518,0,2467,0,3,2470,T
4-HA,519,2468,0,0,1,2469,A
4-HA,520,2466,0,1,0,2467,A
4-HA,521,2464,1,1,0,2466,A
4-HA,522,2475,0,0,0,2475,A
4-HA,523,0,2506,0,0,2506,T
4-HA,524,0,2501,0,1,2502,T
4-HA,525,11,0,0,2497,2508,C
4-HA,526,2501,0,1,1,2503,A
4-HA,527,2510,0,0,0,2510,A
4-HA,528,2513,0,0,0,2513,A
4-HA,529,0,2513,0,1,2514,T
4-HA,530,2567,0,0,0,2567,A
4-HA,531,0,0,1,2567,2568,C
4-HA,532,5,0,0,2518,2523,C
4-HA,533,1,0,0,2527,2528,C
4-HA,534,2514,0,3,0,2517,A
4-HA,535,0,0,2731,1,2732,G
4-HA,536,2,2,0,2765,2769,C
4-HA,537,2765,0,1,0,2766,A
4-HA,538,0,2751,1,5,2757,T
4-HA,539,1,2711,0,0,2712,T
4-HA,540,604,14,2166,0,2784,G
4-HA,541,2817,0,0,0,2817,A
4-HA,542,2821,0,6,0,2827,A
4-HA,543,0,2,0,2823,2825,C
4-HA,544,2,0,2741,0,2743,G
4-HA,545,0,2639,1,1,2641,T
4-HA,546,0,6,2633,0,2639,G
4-HA,547,2636,0,9,0,2645,A
4-HA,548,1,0,0,2648,2649,C
4-HA,549,0,2556,2,0,2558,T
4-HA,550,2608,0,0,0,2608,A
4-HA,551,0,2594,1,4,2599,T
4-HA,552,3,1,2609,0,2613,G
4-HA,553,0,0,2,2610,2612,C
4-HA,554,4,0,0,2576,2580,C
4-HA,555,2571,1,3,2,2577,A
4-HA,556,2575,0,0,0,2575,A
4-HA,557,2600,2,2,0,2604,A
4-HA,558,3,1,0,2609,2613,C
4-HA,559,2562,0,2,0,2564,A
4-HA,560,2569,0,1,0,2570,A
4-HA,561,0,2539,0,0,2539,T
4-HA,562,0,17,2529,0,2546,G
4-HA,563,2534,0,3,0,2537,A
4-HA,564,2543,0,1,0,2544,A
4-HA,565,5,2,0,2490,2497,C
4-HA,566,2515,0,0,0,2515,A
4-HA,567,2541,0,1,0,2542,A
4-HA,568,0,2536,1,0,2537,T
4-HA,569,0,2531,1,0,2532,T
4-HA,570,0,2544,0,0,2544,T
4-HA,571,0,12,2525,1,2538,G
4-HA,572,2542,0,0,0,2542,A
4-HA,573,1,1,0,2544,2546,C
4-HA,574,2544,1,0,0,2545,A
4-HA,575,2543,0,0,0,2543,A
4-HA,576,2569,0,0,0,2569,A
4-HA,577,0,2588,1,1,2590,T
4-HA,578,0,2574,0,0,2574,T
4-HA,579,0,0,2592,0,2592,G
4-HA,580,0,2587,0,1,2588,T
4-HA,581,2590,1,3,0,2594,A
4-HA,582,0,1,0,2637,2638,C
4-HA,583,2631,0,0,0,2631,A
4-HA,584,2,2661,0,1,2664,T
4-HA,585,0,2634,0,0,2634,T
4-HA,586,0,2624,0,0,2624,T
4-HA,587,1,4,2610,0,2615,G
4-HA,588,0,5,2595,0,2600,G
4-HA,589,0,5,2591,0,2596,G
4-HA,590,1,5,2602,0,2608,G
4-HA,591,0,8,2552,0,2560,G
4-HA,592,2,2,2607,0,2611,G
4-HA,593,0,2586,0,1,2587,T
4-HA,594,0,2587,0,4,2591,T
4-HA,595,6,2,0,2590,2598,C
4-HA,596,2599,0,7,0,2606,A
4-HA,597,0,0,0,2615,2615,C
4-HA,598,5,0,0,2607,2612,C
4-HA,599,2619,1,1,0,2621,A
4-HA,600,0,1,0,2649,2650,C
4-HA,601,5,0,0,2600,2605,C
4-HA,602,1,2,0,2594,2597,C
4-HA,603,3,3,2601,1,2608,G
4-HA,604,2,9,2699,0,2710,G
4-HA,605,0,2,2717,0,2719,G
4-HA,606,0,2708,0,1,2709,T
4-HA,607,2710,0,0,0,2710,A
4-HA,608,1,3,0,2696,2700,C
4-HA,609,1,2,2665,0,2668,G
4-HA,610,0,12,2692,0,2704,G
4-HA,611,2698,0,0,0,2698,A
4-HA,612,2,0,1,2696,2699,C
4-HA,613,2551,0,0,0,2551,A
4-HA,614,2550,0,0,3,2553,A
4-HA,615,0,2558,0,0,2558,T
4-HA,616,0,13,2584,0,2597,G
4-HA,617,2589,0,6,1,2596,A
4-HA,618,1,2,1,2595,2599,C
4-HA,619,9,4,0,2552,2565,C
4-HA,620,2569,0,0,0,2569,A
4-HA,621,2561,0,0,0,2561,A
4-HA,622,2597,0,0,0,2597,A
4-HA,623,0,2591,0,2,2593,T
4-HA,624,8,0,0,2615,2623,C
4-HA,625,1,2533,0,3,2537,T
4-HA,626,2,2528,0,0,2530,T
4-HA,627,3,0,0,2556,2559,C
4-HA,628,3,0,0,2569,2572,C
4-HA,629,1,2561,0,3,2565,T
4-HA,630,1,1,2583,0,2585,G
4-HA,631,0,2547,0,1,2548,T
4-HA,632,2570,0,0,0,2570,A
4-HA,633,0,2547,0,3,2550,T
4-HA,634,0,2,2562,0,2564,G
4-HA,635,2,1,0,2573,2576,C
4-HA,636,0,2554,0,2,2556,T
4-HA,637,9,1,1,2543,2554,C
4-HA,638,2557,1,1,0,2559,A
4-HA,639,2548,0,2,0,2550,A
4-HA,640,0,1,2563,0,2564,G
4-HA,641,1,0,0,2570,2571,C
4-HA,642,2568,1,2,0,2571,A
4-HA,643,0,2550,0,0,2550,T
4-HA,644,5,0,1,2541,2547,C
4-HA,645,2540,2,4,0,2546,A
4-HA,646,1,1,2565,1,2568,G
4-HA,647,0,4,2567,0,2571,G
4-HA,648,2561,1,2,0,2564,A
4-HA,649,2545,0,1,0,2546,A
4-HA,650,0,6,2584,0,2590,G
4-HA,651,2586,0,0,0,2586,A
4-HA,652,2620,0,2,0,2622,A
4-HA,653,0,2648,0,0,2648,T
4-HA,654,5,0,0,2644,2649,C
4-HA,655,2626,0,3,0,2629,A
4-HA,656,0,1,0,2637,2638,C
4-HA,657,2627,0,2,0,2629,A
4-HA,658,1,1,2683,0,2685,G
4-HA,659,1,2627,0,1,2629,T
4-HA,660,6,0,0,2644,2650,C
4-HA,661,0,2619,0,1,2620,T
4-HA,662,5,1,0,2669,2675,C
4-HA,663,1,2671,0,3,2675,T
4-HA,664,2702,1,0,1,2704,A
4-HA,665,1,0,0,2703,2704,C
4-HA,666,9,2,0,2686,2697,C
4-HA,667,2644,1,0,0,2645,A
4-HA,668,2655,0,0,1,2656,A
4-HA,669,2641,1,0,1,2643,A
4-HA,670,2643,0,6,0,2649,A
4-HA,671,2,5,2643,0,2650,G
4-HA,672,2583,1,1,1,2586,A
4-HA,673,2570,0,4,0,2574,A
4-HA,674,9,2,2576,0,2587,G
4-HA,675,1,1,0,2576,2578,C
4-HA,676,4,1,0,2573,2578,C
4-HA,677,2574,2,0,0,2576,A
4-HA,678,2582,5,1,0,2588,A
4-HA,679,2,1,0,2588,2591,C
4-HA,680,2582,0,2,0,2584,A
4-HA,681,2577,0,1,5,2583,A
4-HA,682,2576,0,3,0,2579,A
4-HA,683,1,0,0,2636,2637,C
4-HA,684,2,2603,0,0,2605,T
4-HA,685,2,2,2621,0,2625,G
4-HA,686,0,2614,0,1,2615,T
4-HA,687,2608,1,0,1,2610,A
4-HA,688,2617,1,0,0,2618,A
4-HA,689,0,2606,0,0,2606,T
4-HA,690,4,1,0,2616,2621,C
4-HA,691,3,1,0,2610,2614,C
4-HA,692,4,2,0,2560,2566,C
4-HA,693,1,10,2553,0,2564,G
4-HA,694,2559,0,0,0,2559,A
4-HA,695,2560,0,1,0,2561,A
4-HA,696,1,2561,0,0,2562,T
4-HA,697,2571,0,2,0,2573,A
4-HA,698,0,2569,0,1,2570,T
4-HA,699,5,0,0,2543,2548,C
4-HA,700,1,3,2536,0,2540,G
4-HA,701,0,2,2612,0,2614,G
4-HA,702,2612,0,0,0,2612,A
4-HA,703,0,2621,0,3,2624,T
4-HA,704,6,0,1,2620,2627,C
4-HA,705,1,2625,0,0,2626,T
4-HA,706,2616,0,2,0,2618,A
4-HA,707,0,2,2634,0,2636,G
4-HA,708,2641,0,4,0,2645,A
4-HA,709,3,1,0,2638,2642,C
4-HA,710,1,0,0,2558,2559,C
4-HA,711,6,0,0,2563,2569,C
4-HA,712,2545,0,1,0,2546,A
4-HA,713,1,8,2684,0,2693,G
4-HA,714,2692,0,2,0,2694,A
4-HA,715,2,0,2736,0,2738,G
4-HA,716,1,2701,0,2,2704,T
4-HA,717,2695,0,0,0,2695,A
4-HA,718,2689,1,3,0,2693,A
4-HA,719,1,2,2735,0,2738,G
4-HA,720,1,4,2746,1,2752,G
4-HA,721,2723,0,0,1,2724,A
4-HA,722,2524,0,0,0,2524,A
4-HA,723,0,2513,0,1,2514,T
4-HA,724,2517,0,0,0,2517,A
4-HA,725,0,2508,1,2,2511,T
4-HA,726,3,1,0,2528,2532,C
4-HA,727,8,0,0,2523,2531,C
4-HA,728,2,0,0,2473,2475,C
4-HA,729,1,2463,0,1,2465,T
4-HA,730,2469,0,2,1,2472,A
4-HA,731,0,0,2484,0,2484,G
4-HA,732,1,2,0,2480,2483,C
4-HA,733,2417,1,1,0,2419,A
4-HA,734,0,5,2485,0,2490,G
4-HA,735,2444,1,1,0,2446,A
4-HA,736,2455,0,0,0,2455,A
4-HA,737,0,2443,0,0,2443,T
4-HA,738,2449,0,0,0,2449,A
4-HA,739,2455,0,3,0,2458,A
4-HA,740,3,1,2452,0,2456,G
4-HA,741,2,0,0,2461,2463,C
4-HA,742,2466,0,0,0,2466,A
4-HA,743,2,2397,0,2,2401,T
4-HA,744,3,0,0,2520,2523,C
4-HA,745,1,2519,0,0,2520,T
4-HA,746,2529,2,0,0,2531,A
4-HA,747,0,2524,0,0,2524,T
4-HA,748,0,2516,0,0,2516,T
4-HA,749,0,7,2522,0,2529,G
4-HA,750,0,8,2514,0,2522,G
4-HA,751,2516,1,2,0,2519,A
4-HA,752,0,2,1,2496,2499,C
4-HA,753,2349,0,1,0,2350,A
4-HA,754,2383,0,1,0,2384,A
4-HA,755,0,2500,0,0,2500,T
4-HA,756,2519,0,1,1,2521,A
4-HA,757,1,2,2548,0,2551,G
4-HA,758,0,2525,0,0,2525,T
4-HA,759,2523,0,2,0,2525,A
4-HA,760,2526,0,0,0,2526,A
4-HA,761,2560,0,0,0,2560,A
4-HA,762,2582,0,0,0,2582,A
4-HA,763,2,0,0,2590,2592,C
4-HA,764,4,0,0,2491,2495,C
4-HA,765,1,2,2488,2,2493,G
4-HA,766,5,3,2505,0,2513,G
4-HA,767,1,4,2529,0,2534,G
4-HA,768,2531,0,6,0,2537,A
4-HA,769,0,9,2548,0,2557,G
4-HA,770,2595,0,1,0,2596,A
4-HA,771,0,2,0,2590,2592,C
4-HA,772,2593,0,0,1,2594,A
4-HA,773,0,2596,0,2,2598,T
4-HA,774,2601,2,1,1,2605,A
4-HA,775,1,1,0,2656,2658,C
4-HA,776,1,2646,0,3,2650,T
4-HA,777,0,2666,0,0,2666,T
4-HA,778,0,2687,0,0,2687,T
4-HA,779,0,2666,0,0,2666,T
4-HA,780,0,12,2691,0,2703,G
4-HA,781,2705,0,1,1,2707,A
4-HA,782,0,2701,0,4,2705,T
4-HA,783,0,2767,0,2,2769,T
4-HA,784,2757,0,0,1,2758,A
4-HA,785,2785,0,1,0,2786,A
4-HA,786,0,1,0,2815,2816,C
4-HA,787,2809,0,1,0,2810,A
4-HA,788,1,1,2928,0,2930,G
4-HA,789,1,1,0,2910,2912,C
4-HA,790,2921,2,0,0,2923,A
4-HA,791,1,0,1,2946,2948,C
4-HA,792,2915,0,4,0,2919,A
4-HA,793,0,4,2955,0,2959,G
4-HA,794,1,7,2932,0,2940,G
4-HA,795,1,9,3040,0,3050,G
4-HA,796,3029,1,1,0,3031,A
4-HA,797,3039,0,8,0,3047,A
4-HA,798,0,3051,0,1,3052,T
4-HA,799,3,0,0,3064,3067,C
4-HA,800,1,3079,0,1,3081,T
4-HA,801,3091,0,1,0,3092,A
4-HA,802,3072,0,2,1,3075,A
4-HA,803,0,3069,0,0,3069,T
4-HA,804,0,2990,0,3,2993,T
4-HA,805,1,4,3031,1,3037,G
4-HA,806,2,0,0,3110,3112,C
4-HA,807,0,3200,0,10,3210,T
4-HA,808,12,1,0,3307,3320,C
4-HA,809,2,1,0,3320,3323,C
4-HA,810,1,3317,0,2,3320,T
4-HA,811,3318,0,5,1,3324,A
4-HA,812,1,6,3321,0,3328,G
4-HA,813,3,7,3351,0,3361,G
4-HA,814,2,7,3359,2,3370,G
4-HA,815,1,6,3335,0,3342,G
4-HA,816,1,3261,0,3,3265,T
4-HA,817,0,3233,1,0,3234,T
4-HA,818,3248,0,0,0,3248,A
4-HA,819,1,1,0,3306,3308,C
4-HA,820,0,3290,0,5,3295,T
4-HA,821,0,3314,0,2,3316,T
4-HA,822,3,0,0,3302,3305,C
4-HA,823,3285,0,0,0,3285,A
4-HA,824,3290,0,0,0,3290,A
4-HA,825,3295,0,3,0,3298,A
4-HA,826,3318,0,1,0,3319,A
4-HA,827,1,3314,0,0,3315,T
4-HA,828,3302,0,0,0,3302,A
4-HA,829,0,1,0,3299,3300,C
4-HA,830,1,4,3292,1,3298,G
4-HA,831,3305,0,0,2,3307,A
4-HA,832,3322,0,1,0,3323,A
4-HA,833,0,1,3354,1,3356,G
4-HA,834,0,3354,0,0,3354,T
4-HA,835,1,7,3357,0,3365,G
4-HA,836,0,6,3369,0,3375,G
4-HA,837,7,10,3365,0,3382,G
4-HA,838,3376,0,3,0,3379,A
4-HA,839,3384,0,3,0,3387,A
4-HA,840,3388,0,2,1,3391,A
4-HA,841,3369,0,7,0,3376,A
4-HA,842,0,2,3438,0,3440,G
4-HA,843,2,0,0,3433,3435,C
4-HA,844,1,3413,0,1,3415,T
4-HA,845,12,1,0,3444,3457,C
4-HA,846,3449,1,1,0,3451,A
4-HA,847,3483,0,1,1,3485,A
4-HA,848,0,3485,0,1,3486,T
4-HA,849,3524,0,1,0,3525,A
4-HA,850,3519,0,1,0,3520,A
4-HA,851,0,3452,0,0,3452,T
4-HA,852,2,10,3459,0,3471,G
4-HA,853,3441,0,3,0,3444,A
4-HA,854,0,10,3555,0,3565,G
4-HA,855,3574,0,0,0,3574,A
4-HA,856,0,3547,0,4,3551,T
4-HA,857,9,0,0,3598,3607,C
4-HA,858,3572,1,0,0,3573,A
4-HA,859,0,3,3655,0,3658,G
4-HA,860,3657,0,1,1,3659,A
4-HA,861,2,3638,0,0,3640,T
4-HA,862,1,0,3630,1,3632,G
4-HA,863,1,0,0,3598,3599,C
4-HA,864,3603,0,3,0,3606,A
4-HA,865,3,2,0,3669,3674,C
4-HA,866,7,0,0,3624,3631,C
4-HA,867,8,0,1,3634,3643,C
4-HA,868,3601,0,1,0,3602,A
4-HA,869,0,3590,0,2,3592,T
4-HA,870,0,3587,0,2,3589,T
4-HA,871,2,10,3621,0,3633,G
4-HA,872,1,2,3617,1,3621,G
4-HA,873,2,0,0,3623,3625,C
4-HA,874,3551,0,1,0,3552,A
4-HA,875,3543,0,2,0,3545,A
4-HA,876,3609,3,0,0,3612,A
4-HA,877,0,3614,0,0,3614,T
4-HA,878,0,4,3615,0,3619,G
4-HA,879,1,0,0,3618,3619,C
4-HA,880,3570,1,2,0,3573,A
4-HA,881,3675,0,0,0,3675,A
4-HA,882,1,3679,0,0,3680,T
4-HA,883,1,3688,1,2,3692,T
4-HA,884,11,0,0,3690,3701,C
4-HA,885,0,3643,0,1,3644,T
4-HA,886,0,10,3678,1,3689,G
4-HA,887,3684,1,1,0,3686,A
4-HA,888,3691,0,4,0,3695,A
4-HA,889,1,3688,1,2,3692,T
4-HA,890,2,0,3631,2,3635,G
4-HA,891,2,1,0,3653,3656,C
4-HA,892,3620,0,2,0,3622,A
4-HA,893,1,3619,0,5,3625,T
4-HA,894,8,0,0,3608,3616,C
4-HA,895,3617,0,0,0,3617,A
4-HA,896,2,0,0,3774,3776,C
4-HA,897,2,3757,0,4,3763,T
4-HA,898,4,4,1,3778,3787,C
4-HA,899,6,2,0,3751,3759,C
4-HA,900,3796,0,0,0,3796,A
4-HA,901,3795,0,0,1,3796,A
4-HA,902,3788,0,1,0,3789,A
4-HA,903,0,3641,0,0,3641,T
4-HA,904,0,3,3669,0,3672,G
4-HA,905,2,11,3666,0,3679,G
4-HA,906,3684,0,2,0,3686,A
4-HA,907,3684,0,1,0,3685,A
4-HA,908,0,1,3708,0,3709,G
4-HA,909,1,0,0,3674,3675,C
4-HA,910,3655,0,1,0,3656,A
4-HA,911,0,3659,0,1,3660,T
4-HA,912,0,3655,0,2,3657,T
4-HA,913,11,1,0,3758,3770,C
4-HA,914,7,0,0,3742,3749,C
4-HA,915,4,0,0,3757,3761,C
4-HA,916,3756,0,1,0,3757,A
4-HA,917,3836,1,0,3,3840,A
4-HA,918,0,3874,0,4,3878,T
4-HA,919,1,15,3871,0,3887,G
4-HA,920,3881,0,2,0,3883,A
4-HA,921,1,0,0,3883,3884,C
4-HA,922,3773,0,0,0,3773,A
4-HA,923,3779,0,0,0,3779,A
4-HA,924,3775,0,4,0,3779,A
4-HA,925,3,1,0,3795,3799,C
4-HA,926,10,0,0,3766,3776,C
4-HA,927,3715,0,0,0,3715,A
4-HA,928,0,3725,0,1,3726,T
4-HA,929,1,3718,0,11,3730,T
4-HA,930,5,0,0,3742,3747,C
4-HA,931,12,2,0,3733,3747,C
4-HA,932,3751,1,0,0,3752,A
4-HA,933,3740,1,1,1,3743,A
4-HA,934,3718,0,2,0,3720,A
4-HA,935,3773,1,3,0,3777,A
4-HA,936,0,3766,0,0,3766,T
4-HA,937,1,4,3749,0,3754,G
4-HA,938,0,3741,0,1,3742,T
4-HA,939,0,3717,0,5,3722,T
4-HA,940,3796,0,3,0,3799,A
4-HA,941,3792,2,2,0,3796,A
4-HA,942,1,0,7,3800,3808,C
4-HA,943,3772,1,1,1,3775,A
4-HA,944,0,6,3790,0,3796,G
4-HA,945,0,13,3820,0,3833,G
4-HA,946,3904,0,0,0,3904,A
4-HA,947,0,3911,1,2,3914,T
4-HA,948,17,2,0,3939,3958,C
4-HA,949,3978,1,3,0,3982,A
4-HA,950,2,2,0,4102,4106,C
4-HA,951,4092,2,0,0,4094,A
4-HA,952,0,4202,0,1,4203,T
4-HA,953,4121,0,1,0,4122,A
4-HA,954,1,3,0,4066,4070,C
4-HA,955,2,7,3933,0,3942,G
4-HA,956,1,6,3949,0,3956,G
4-HA,957,0,3,3932,1,3936,G
4-HA,958,4,4,3935,1,3944,G
4-HA,959,2,1,0,3841,3844,C
4-HA,960,0,0,0,3823,3823,C
4-HA,961,1,3717,0,5,3723,T
4-HA,962,1,3,4059,0,4063,G
4-HA,963,1,4062,0,1,4064,T
4-HA,964,13,1,0,4059,4073,C
4-HA,965,10,2,0,4053,4065,C
4-HA,966,1,1,0,4068,4070,C
4-HA,967,4053,0,1,1,4055,A
4-HA,968,1,6,4074,0,4081,G
4-HA,969,4075,1,1,0,4077,A
4-HA,970,0,4069,0,0,4069,T
4-HA,971,3739,0,2,0,3741,A
4-HA,972,0,3692,0,1,3693,T
4-HA,973,2,2,3716,0,3720,G
4-HA,974,0,3700,0,1,3701,T
4-HA,975,0,3653,0,1,3654,T
4-HA,976,3698,1,2,0,3701,A
4-HA,977,3663,0,0,0,3663,A
4-HA,978,0,9,3687,0,3696,G
4-HA,979,1,2,0,3684,3687,C
4-HA,980,3637,0,0,0,3637,A
4-HA,981,3634,1,0,1,3636,A
4-HA,982,3606,0,0,0,3606,A
4-HA,983,3609,0,1,0,3610,A
4-HA,984,1,1,1,3613,3616,C
4-HA,985,3571,1,0,1,3573,A
4-HA,986,0,1,1,3603,3605,C
4-HA,987,1,3523,0,3,3527,T
4-HA,988,11,2,0,3548,3561,C
4-HA,989,1,3553,1,5,3560,T
4-HA,990,0,8,3578,0,3586,G
4-HA,991,3576,0,0,0,3576,A
4-HA,992,3568,0,0,0,3568,A
4-HA,993,3567,0,2,0,3569,A
4-HA,994,1,3537,1,0,3539,T
4-HA,995,1,3509,0,2,3512,T
4-HA,996,1,5,3554,0,3560,G
4-HA,997,1,2,3537,0,3540,G
4-HA,998,0,2,0,3552,3554,C
4-HA,999,3524,0,1,0,3525,A
4-HA,1000,3531,1,0,1,3533,A
4-HA,1001,2,0,0,3533,3535,C
4-HA,1002,3523,0,0,0,3523,A
4-HA,1003,0,4,3568,0,3572,G
4-HA,1004,0,5,3553,0,3558,G
4-HA,1005,1,8,3541,1,3551,G
4-HA,1006,3538,0,8,1,3547,A
4-HA,1007,1,3531,0,0,3532,T
4-HA,1008,1,0,3538,0,3539,G
4-HA,1009,1,2,0,3529,3532,C
4-HA,1010,4,12,3533,0,3549,G
4-HA,1011,3565,0,0,0,3565,A
4-HA,1012,3505,0,0,0,3505,A
4-HA,1013,3545,0,0,0,3545,A
4-HA,1014,0,3504,0,0,3504,T
4-HA,1015,2,1,3566,0,3569,G
4-HA,1016,0,3572,0,1,3573,T
4-HA,1017,3560,1,4,1,3566,A
4-HA,1018,3,1,1,3557,3562,C
4-HA,1019,6,1,1,3541,3549,C
4-HA,1020,3494,0,0,0,3494,A
4-HA,1021,0,7,3502,1,3510,G
4-HA,1022,3439,1,2,0,3442,A
4-HA,1023,0,7,3478,0,3485,G
4-HA,1024,3431,0,0,0,3431,A
4-HA,1025,3417,0,2,0,3419,A
4-HA,1026,3441,1,1,1,3444,A
4-HA,1027,1,1,0,3443,3445,C
4-HA,1028,3426,0,1,0,3427,A
4-HA,1029,3496,0,0,0,3496,A
4-HA,1030,3497,1,1,0,3499,A
4-HA,1031,1,0,0,3528,3529,C
4-HA,1032,0,3495,1,1,3497,T
4-HA,1033,3464,1,1,0,3466,A
4-HA,1034,0,4,3465,0,3469,G
4-HA,1035,3436,0,1,0,3437,A
4-HA,1036,0,3,3504,1,3508,G
4-HA,1037,0,2,3504,0,3506,G
4-HA,1038,4,1,0,3450,3455,C
4-HA,1039,3446,3,1,7,3457,A
4-HA,1040,0,3455,0,0,3455,T
4-HA,1041,3470,3,1,0,3474,A
4-HA,1042,0,3466,0,2,3468,T
4-HA,1043,0,3453,0,0,3453,T
4-HA,1044,0,3447,0,1,3448,T
4-HA,1045,0,7,3306,1,3314,G
4-HA,1046,1,2,3314,0,3317,G
4-HA,1047,1,6,0,3310,3317,C
4-HA,1048,2,3,3313,0,3318,G
4-HA,1049,0,2,0,3297,3299,C
4-HA,1050,3286,0,0,0,3286,A
4-HA,1051,3311,0,1,0,3312,A
4-HA,1052,0,3308,0,0,3308,T
4-HA,1053,10,0,0,3303,3313,C
4-HA,1054,3,1,3321,0,3325,G
4-HA,1055,1,2,0,3303,3306,C
4-HA,1056,1,2,3307,1,3311,G
4-HA,1057,1,3,3339,0,3343,G
4-HA,1058,0,2,3355,0,3357,G
4-HA,1059,1,3342,0,1,3344,T
4-HA,1060,0,3300,0,0,3300,T
4-HA,1061,1,3300,0,0,3301,T
4-HA,1062,15,1,0,3295,3311,C
4-HA,1063,3314,1,0,1,3316,A
4-HA,1064,0,3327,0,1,3328,T
4-HA,1065,3322,0,0,0,3322,A
4-HA,1066,0,3,3340,0,3343,G
4-HA,1067,3275,2,0,0,3277,A
4-HA,1068,3282,0,1,1,3284,A
4-HA,1069,3288,0,2,0,3290,A
4-HA,1070,3294,0,2,0,3296,A
4-HA,1071,0,3280,0,0,3280,T
4-HA,1072,2,4,3314,0,3320,G
4-HA,1073,8,5,3320,0,3333,G
4-HA,1074,0,3301,0,0,3301,T
4-HA,1075,1,3252,0,0,3253,T
4-HA,1076,2,6,3245,1,3254,G
4-HA,1077,1,3,3261,1,3266,G
4-HA,1078,1,8,3262,1,3272,G
4-HA,1079,3238,0,3,1,3242,A
4-HA,1080,1,2,3263,0,3266,G
4-HA,1081,0,6,3222,0,3228,G
4-HA,1082,0,5,3274,0,3279,G
4-HA,1083,3267,0,4,0,3271,A
4-HA,1084,3292,1,3,0,3296,A
4-HA,1085,0,3294,0,2,3296,T
4-HA,1086,1,7,3280,0,3288,G
4-HA,1087,9,1,3322,0,3332,G
4-HA,1088,0,3303,1,1,3305,T
4-HA,1089,2,10,3285,0,3297,G
4-HA,1090,1,7,3271,1,3280,G
4-HA,1091,3208,3,5,0,3216,A
4-HA,1092,0,3210,1,0,3211,T
4-HA,1093,0,4,3260,0,3264,G
4-HA,1094,0,2,3285,0,3287,G
4-HA,1095,2,3245,0,0,3247,T
4-HA,1096,0,3167,0,1,3168,T
4-HA,1097,2,7,3163,0,3172,G
4-HA,1098,0,1,3211,0,3212,G
4-HA,1099,1,3206,0,3,3210,T
4-HA,1100,3206,0,0,0,3206,A
4-HA,1101,2,2,1,3047,3052,C
4-HA,1102,2,6,3064,0,3072,G
4-HA,1103,1,2,3167,0,3170,G
4-HA,1104,0,3173,0,1,3174,T
4-HA,1105,0,3164,0,1,3165,T
4-HA,1106,0,3159,0,1,3160,T
4-HA,1107,8,0,0,3104,3112,C
4-HA,1108,3112,0,3,1,3116,A
4-HA,1109,1,5,3111,1,3118,G
4-HA,1110,1,4,3109,0,3114,G
4-HA,1111,3,0,0,3098,3101,C
4-HA,1112,2997,1,1,0,2999,A
4-HA,1113,0,3011,0,1,3012,T
4-HA,1114,10,1,0,3006,3017,C
4-HA,1115,3023,2,0,0,3025,A
4-HA,1116,3026,0,0,0,3026,A
4-HA,1117,3024,0,1,0,3025,A
4-HA,1118,3051,1,0,0,3052,A
4-HA,1119,1,3043,1,0,3045,T
4-HA,1120,2,3049,0,0,3051,T
4-HA,1121,13,1,0,3048,3062,C
4-HA,1122,1,3038,0,1,3040,T
4-HA,1123,3,4,3033,1,3041,G
4-HA,1124,3041,0,1,0,3042,A
4-HA,1125,3013,0,2,0,3015,A
4-HA,1126,2,4,3043,0,3049,G
4-HA,1127,0,3,3095,0,3098,G
4-HA,1128,3093,1,0,0,3094,A
4-HA,1129,3084,2,0,0,3086,A
4-HA,1130,0,3,3053,0,3056,G
4-HA,1131,3089,1,3,0,3093,A
4-HA,1132,1,7,3101,0,3109,G
4-HA,1133,1,10,3111,0,3122,G
4-HA,1134,3117,0,3,1,3121,A
4-HA,1135,0,3,0,3104,3107,C
4-HA,1136,3072,2,0,0,3074,A
4-HA,1137,3076,2,0,0,3078,A
4-HA,1138,0,0,3089,0,3089,G
4-HA,1139,0,3,0,3085,3088,C
4-HA,1140,3056,1,2,0,3059,A
4-HA,1141,1,0,3066,0,3067,G
4-HA,1142,3,3,1,3043,3050,C
4-HA,1143,3043,0,0,0,3043,A
4-HA,1144,1,2,3070,0,3073,G
4-HA,1145,3039,1,3,1,3044,A
4-HA,1146,1,3127,0,1,3129,T
4-HA,1147,7,1,0,3136,3144,C
4-HA,1148,0,3128,0,1,3129,T
4-HA,1149,3,1,0,3144,3148,C
4-HA,1150,3124,0,2,0,3126,A
4-HA,1151,3125,1,2,1,3129,A
4-HA,1152,3132,0,3,1,3136,A
4-HA,1153,3047,0,4,1,3052,A
4-HA,1154,2,0,3056,1,3059,G
4-HA,1155,1,2,0,3002,3005,C
4-HA,1156,2984,0,1,1,2986,A
4-HA,1157,1,0,0,3028,3029,C
4-HA,1158,0,3011,0,2,3013,T
4-HA,1159,10,3,0,3001,3014,C
4-HA,1160,3013,1,1,0,3015,A
4-HA,1161,3060,0,1,0,3061,A
4-HA,1162,0,0,3061,1,3062,G
4-HA,1163,0,2,0,3054,3056,C
4-HA,1164,3030,0,3,0,3033,A
4-HA,1165,1,0,3049,2,3052,G
4-HA,1166,2,0,1,2994,2997,C
4-HA,1167,2982,1,1,2,2986,A
4-HA,1168,2980,3,1,1,2985,A
4-HA,1169,0,2981,0,0,2981,T
4-HA,1170,12,0,0,2911,2923,C
4-HA,1171,1,6,2926,0,2933,G
4-HA,1172,2932,0,1,0,2933,A
4-HA,1173,1,2921,0,0,2922,T
4-HA,1174,11,0,0,2899,2910,C
4-HA,1175,2903,0,0,0,2903,A
4-HA,1176,2959,1,0,0,2960,A
4-HA,1177,2972,0,0,0,2972,A
4-HA,1178,0,2964,0,0,2964,T
4-HA,1179,12,2,0,2954,2968,C
4-HA,1180,2928,3,1,0,2932,A
4-HA,1181,2956,0,2,0,2958,A
4-HA,1182,0,2955,0,0,2955,T
4-HA,1183,0,5,2951,1,2957,G
4-HA,1184,0,3,2939,0,2942,G
4-HA,1185,0,3,2898,0,2901,G
4-HA,1186,2895,0,0,0,2895,A
4-HA,1187,2886,1,1,0,2888,A
4-HA,1188,2,0,2934,0,2936,G
4-HA,1189,1,1,0,2936,2938,C
4-HA,1190,0,2910,0,2,2912,T
4-HA,1191,0,9,3015,0,3024,G
4-HA,1192,3019,1,5,0,3025,A
4-HA,1193,3029,0,0,0,3029,A
4-HA,1194,0,3026,0,0,3026,T
4-HA,1195,2955,0,0,0,2955,A
4-HA,1196,0,5,2955,0,2960,G
4-HA,1197,2732,1,9,0,2742,A
4-HA,1198,0,2762,0,0,2762,T
4-HA,1199,0,2763,0,1,2764,T
4-HA,1200,0,9,2775,1,2785,G
4-HA,1201,2761,1,1,0,2763,A
4-HA,1202,0,2765,0,0,2765,T
4-HA,1203,10,0,0,2749,2759,C
4-HA,1204,3,4,2762,0,2769,G
4-HA,1205,1,3,2754,0,2758,G
4-HA,1206,1,8,2760,0,2769,G
4-HA,1207,2745,0,0,0,2745,A
4-HA,1208,2758,0,2,0,2760,A
4-HA,1209,2722,2,3,0,2727,A
4-HA,1210,2741,0,5,0,2746,A
4-HA,1211,1,2,0,2749,2752,C
4-HA,1212,7,0,0,2744,2751,C
4-HA,1213,2735,0,2,0,2737,A
4-HA,1214,2733,0,1,0,2734,A
4-HA,1215,2,3,0,2729,2734,C
4-HA,1216,0,8,2740,0,2748,G
4-HA,1217,2739,1,2,0,2742,A
4-HA,1218,0,5,2735,0,2740,G
4-HA,1219,2743,0,0,1,2744,A
4-HA,1220,2742,0,0,0,2742,A
4-HA,1221,2746,0,0,1,2747,A
4-HA,1222,1,2747,0,1,2749,T
4-HA,1223,1,2740,0,3,2744,T
4-HA,1224,10,0,0,2743,2753,C
4-HA,1225,1,1,0,2733,2735,C
4-HA,1226,2736,0,1,0,2737,A
4-HA,1227,0,2729,0,6,2735,T
4-HA,1228,5,0,1,2723,2729,C
4-HA,1229,2721,0,1,0,2722,A
4-HA,1230,0,4,2726,0,2730,G
4-HA,1231,2705,0,0,0,2705,A
4-HA,1232,0,2704,0,0,2704,T
4-HA,1233,0,2685,0,0,2685,T
4-HA,1234,1,6,2687,0,2694,G
4-HA,1235,2688,2,1,0,2691,A
4-HA,1236,2693,1,0,0,2694,A
4-HA,1237,2699,0,1,0,2700,A
4-HA,1238,2697,0,0,0,2697,A
4-HA,1239,2669,0,0,0,2669,A
4-HA,1240,1,12,2661,1,2675,G
4-HA,1241,2662,0,1,0,2663,A
4-HA,1242,2669,0,1,0,2670,A
4-HA,1243,0,2629,0,0,2629,T
4-HA,1244,0,2624,0,0,2624,T
4-HA,1245,3,0,0,2632,2635,C
4-HA,1246,0,2625,0,1,2626,T
4-HA,1247,8,1,1,2617,2627,C
4-HA,1248,2627,0,1,0,2628,A
4-HA,1249,0,2,2633,0,2635,G
4-HA,1250,2626,0,0,0,2626,A
4-HA,1251,2600,0,0,0,2600,A
4-HA,1252,0,1,2643,0,2644,G
4-HA,1253,1,2629,0,0,2630,T
4-HA,1254,5,1,0,2617,2623,C
4-HA,1255,0,0,2626,0,2626,G
4-HA,1256,2624,0,1,0,2625,A
4-HA,1257,2615,1,3,0,2619,A
4-HA,1258,1,3,2607,0,2611,G
4-HA,1259,0,5,2639,0,2644,G
4-HA,1260,0,3,2637,1,2641,G
4-HA,1261,2580,0,4,0,2584,A
4-HA,1262,1,3,2594,0,2598,G
4-HA,1263,2588,0,0,0,2588,A
4-HA,1264,2745,0,1,0,2746,A
4-HA,1265,0,2741,0,2,2743,T
4-HA,1266,1,2738,0,2,2741,T
4-HA,1267,10,2,0,2734,2746,C
4-HA,1268,2691,1,4,0,2696,A
4-HA,1269,1,3,2701,1,2706,G
4-HA,1270,4,9,2686,1,2700,G
4-HA,1271,2686,0,1,0,2687,A
4-HA,1272,2,1,0,2683,2686,C
4-HA,1273,2,0,0,2474,2476,C
4-HA,1274,0,2449,0,2,2451,T
4-HA,1275,0,2402,0,55,2457,T
4-HA,1276,1,6,2461,0,2468,G
4-HA,1277,2465,1,1,0,2467,A
4-HA,1278,0,4,2516,0,2520,G
4-HA,1279,2497,0,1,0,2498,A
4-HA,1280,2321,2,0,0,2323,A
4-HA,1281,2311,0,2,0,2313,A
4-HA,1282,0,2284,0,0,2284,T
4-HA,1283,2330,0,1,0,2331,A
4-HA,1284,0,2332,1,2,2335,T
4-HA,1285,2,1,2355,0,2358,G
4-HA,1286,0,2353,0,1,2354,T
4-HA,1287,0,2277,0,1,2278,T
4-HA,1288,1,8,2278,0,2287,G
4-HA,1289,2260,0,1,0,2261,A
4-HA,1290,0,9,2275,1,2285,G
4-HA,1291,0,5,2273,0,2278,G
4-HA,1292,2238,0,0,0,2238,A
4-HA,1293,2,1,0,2298,2301,C
4-HA,1294,2276,1,3,0,2280,A
4-HA,1295,1,2,0,2324,2327,C
4-HA,1296,3,0,0,2335,2338,C
4-HA,1297,2344,0,1,0,2345,A
4-HA,1298,2387,0,1,0,2388,A
4-HA,1299,2388,0,0,0,2388,A
4-HA,1300,2406,0,1,0,2407,A
4-HA,1301,1,2403,0,0,2404,T
4-HA,1302,2350,0,0,0,2350,A
4-HA,1303,0,4,2357,0,2361,G
4-HA,1304,2321,0,0,0,2321,A
4-HA,1305,1,2332,0,1,2334,T
4-HA,1306,4,0,0,2335,2339,C
4-HA,1307,0,2296,0,0,2296,T
4-HA,1308,4,0,0,2339,2343,C
4-HA,1309,1,2339,1,0,2341,T
4-HA,1310,2,2,2391,0,2395,G
4-HA,1311,0,2,2434,0,2436,G
4-HA,1312,2,2412,0,3,2417,T
4-HA,1313,13,0,0,2404,2417,C
4-HA,1314,2441,2,1,0,2444,A
4-HA,1315,0,2447,0,2,2449,T
4-HA,1316,2446,0,2,0,2448,A
4-HA,1317,0,1,0,2439,2440,C
4-HA,1318,2360,0,0,0,2360,A
4-HA,1319,2376,0,1,0,2377,A
4-HA,1320,0,0,0,2313,2313,C
4-HA,1321,3,0,2308,0,2311,G
4-HA,1322,1,5,0,2298,2304,C
4-HA,1323,0,2,2284,2,2288,G
4-HA,1324,0,1,2300,0,2301,G
4-HA,1325,2301,0,0,0,2301,A
4-HA,1326,0,0,2320,1,2321,G
4-HA,1327,0,0,0,2321,2321,C
4-HA,1328,0,2306,0,1,2307,T
4-HA,1329,1,2325,1,2,2329,T
4-HA,1330,4,0,0,2335,2339,C
4-HA,1331,0,2345,0,0,2345,T
4-HA,1332,0,2340,1,1,2342,T
4-HA,1333,0,1,2338,0,2339,G
4-HA,1334,0,2324,0,2,2326,T
4-HA,1335,0,2271,0,2,2273,T
4-HA,1336,1,0,2311,0,2312,G
4-HA,1337,0,0,0,2303,2303,C
4-HA,1338,8,2,0,2295,2305,C
4-HA,1339,7,0,0,2320,2327,C
4-HA,1340,1,2316,0,2,2319,T
4-HA,1341,1,3,2348,0,2352,G
4-HA,1342,0,4,2346,0,2350,G
4-HA,1343,2349,1,0,0,2350,A
4-HA,1344,0,6,2359,0,2365,G
4-HA,1345,2319,0,3,0,2322,A
4-HA,1346,2333,2,0,0,2335,A
4-HA,1347,3,1,0,2377,2381,C
4-HA,1348,15,0,0,2357,2372,C
4-HA,1349,2370,0,4,0,2374,A
4-HA,1350,2452,1,0,0,2453,A
4-HA,1351,0,0,0,2458,2458,C
4-HA,1352,2457,2,1,0,2460,A
4-HA,1353,0,2448,0,1,2449,T
4-HA,1354,2437,2,1,0,2440,A
4-HA,1355,1,0,0,2494,2495,C
4-HA,1356,2429,0,1,1,2431,A
4-HA,1357,2430,0,0,1,2431,A
4-HA,1358,1,2428,0,0,2429,T
4-HA,1359,0,2344,0,0,2344,T
4-HA,1360,0,8,2374,0,2382,G
4-HA,1361,2396,1,0,0,2397,A
4-HA,1362,0,2391,0,3,2394,T
4-HA,1363,9,0,0,2395,2404,C
4-HA,1364,1,2358,0,1,2360,T
4-HA,1365,2390,0,0,0,2390,A
4-HA,1366,2385,0,0,0,2385,A
4-HA,1367,1,0,0,2386,2387,C
4-HA,1368,0,2366,0,1,2367,T
4-HA,1369,10,16,2331,0,2357,G
4-HA,1370,2366,1,2,0,2369,A
4-HA,1371,2,0,0,2373,2375,C
4-HA,1372,0,2375,0,2,2377,T
4-HA,1373,9,2,0,2368,2379,C
4-HA,1374,2368,0,2,0,2370,A
4-HA,1375,0,4,2410,0,2414,G
4-HA,1376,2412,0,0,0,2412,A
4-HA,1377,2415,0,0,0,2415,A
4-HA,1378,2416,0,0,0,2416,A
4-HA,1379,0,2398,1,0,2399,T
4-HA,1380,1,11,2408,0,2420,G
4-HA,1381,2420,0,3,0,2423,A
4-HA,1382,2423,0,3,0,2426,A
4-HA,1383,1,1,0,2423,2425,C
4-HA,1384,2389,0,0,0,2389,A
4-HA,1385,2390,2,0,0,2392,A
4-HA,1386,2388,0,4,0,2392,A
4-HA,1387,0,0,0,2397,2397,C
4-HA,1388,0,2372,0,2,2374,T
4-HA,1389,2,1,2387,0,2390,G
4-HA,1390,0,2351,0,2,2353,T
4-HA,1391,1,2352,0,0,2353,T
4-HA,1392,2,2348,0,1,2351,T
4-HA,1393,1,4,2352,0,2357,G
4-HA,1394,2356,0,0,0,2356,A
4-HA,1395,2356,0,1,0,2357,A
4-HA,1396,2349,0,1,0,2350,A
4-HA,1397,2347,1,0,0,2348,A
4-HA,1398,2341,0,1,0,2342,A
4-HA,1399,2345,0,2,0,2347,A
4-HA,1400,1,0,0,2357,2358,C
4-HA,1401,2357,0,0,0,2357,A
4-HA,1402,2357,0,0,0,2357,A
4-HA,1403,2359,0,4,0,2363,A
4-HA,1404,2,7,2367,0,2376,G
4-HA,1405,2382,1,0,0,2383,A
4-HA,1406,2380,0,1,0,2381,A
4-HA,1407,0,0,2378,0,2378,G
4-HA,1408,0,1,0,2366,2367,C
4-HA,1409,2377,0,0,0,2377,A
4-HA,1410,2386,0,0,0,2386,A
4-HA,1411,2,1,0,2390,2393,C
4-HA,1412,1,2384,0,0,2385,T
4-HA,1413,1,5,2394,0,2400,G
4-HA,1414,2367,0,0,0,2367,A
4-HA,1415,1,3,2392,0,2396,G
4-HA,1416,0,4,2407,0,2411,G
4-HA,1417,2,6,2406,0,2414,G
4-HA,1418,2411,0,2,0,2413,A
4-HA,1419,2393,0,1,0,2394,A
4-HA,1420,2386,1,2,2,2391,A
4-HA,1421,2427,0,0,1,2428,A
4-HA,1422,0,2416,0,0,2416,T
4-HA,1423,6,0,2427,0,2433,G
4-HA,1424,0,0,0,2436,2436,C
4-HA,1425,1,2409,0,7,2417,T
4-HA,1426,2,3,2416,0,2421,G
4-HA,1427,2415,0,1,0,2416,A
4-HA,1428,0,1,2537,0,2538,G
4-HA,1429,0,2,2573,0,2575,G
4-HA,1430,2539,1,1,0,2541,A
4-HA,1431,0,2541,0,1,2542,T
4-HA,1432,2520,0,2,0,2522,A
4-HA,1433,1,2509,0,3,2513,T
4-HA,1434,1,5,2535,1,2542,G
4-HA,1435,6,3,2555,0,2564,G
4-HA,1436,0,3,2557,0,2560,G
4-HA,1437,9,0,0,2443,2452,C
4-HA,1438,2386,0,2,0,2388,A
4-HA,1439,2386,0,2,1,2389,A
4-HA,1440,0,2380,0,1,2381,T
4-HA,1441,0,7,2391,0,2398,G
4-HA,1442,0,2,2393,0,2395,G
4-HA,1443,1,2363,0,0,2364,T
4-HA,1444,0,2305,0,1,2306,T
4-HA,1445,1,1,2316,0,2318,G
4-HA,1446,0,2343,1,2,2346,T
4-HA,1447,0,2335,0,2,2337,T
4-HA,1448,0,2337,0,0,2337,T
4-HA,1449,7,0,0,2340,2347,C
4-HA,1450,2343,0,0,0,2343,A
4-HA,1451,2347,1,1,0,2349,A
4-HA,1452,2356,0,1,0,2357,A
4-HA,1453,2387,0,0,0,2387,A
4-HA,1454,0,2380,1,0,2381,T
4-HA,1455,2367,0,0,0,2367,A
4-HA,1456,1,2371,0,1,2373,T
4-HA,1457,2371,0,1,0,2372,A
4-HA,1458,2,0,1,2386,2389,C
4-HA,1459,5,0,0,2364,2369,C
4-HA,1460,2373,1,0,0,2374,A
4-HA,1461,1,0,1,2376,2378,C
4-HA,1462,2383,0,0,0,2383,A
4-HA,1463,2389,0,0,0,2389,A
4-HA,1464,2385,0,0,0,2385,A
4-HA,1465,0,2389,0,0,2389,T
4-HA,1466,11,0,2387,0,2398,G
4-HA,1467,0,2354,0,2,2356,T
4-HA,1468,1,11,2366,0,2378,G
4-HA,1469,2375,0,6,0,2381,A
4-HA,1470,3,1,0,2379,2383,C
4-HA,1471,2345,0,0,0,2345,A
4-HA,1472,2346,1,0,0,2347,A
4-HA,1473,0,2362,0,1,2363,T
4-HA,1474,0,3,2375,0,2378,G
4-HA,1475,1,0,0,2362,2363,C
4-HA,1476,4,3,0,2357,2364,C
4-HA,1477,0,2346,1,3,2350,T
4-HA,1478,0,3,2458,0,2461,G
4-HA,1479,0,2,0,2462,2464,C
4-HA,1480,2459,0,6,0,2465,A
4-HA,1481,0,2466,0,1,2467,T
4-HA,1482,2385,0,1,0,2386,A
4-HA,1483,0,4,2398,1,2403,G
4-HA,1484,0,8,2386,0,2394,G
4-HA,1485,2380,0,2,0,2382,A
4-HA,1486,0,2372,0,0,2372,T
4-HA,1487,11,0,0,2250,2261,C
4-HA,1488,2255,0,1,0,2256,A
4-HA,1489,2263,0,0,0,2263,A
4-HA,1490,0,2261,0,1,2262,T
4-HA,1491,6,2,1,2257,2266,C
4-HA,1492,2232,0,0,0,2232,A
4-HA,1493,0,1,2246,0,2247,G
4-HA,1494,2249,3,0,0,2252,A
4-HA,1495,2253,0,0,0,2253,A
4-HA,1496,2251,0,2,0,2253,A
4-HA,1497,1,2235,0,1,2237,T
4-HA,1498,1,5,2222,1,2229,G
4-HA,1499,0,8,2220,0,2228,G
4-HA,1500,2229,0,1,0,2230,A
4-HA,1501,2238,0,0,0,2238,A
4-HA,1502,0,0,0,2224,2224,C
4-HA,1503,0,2210,0,0,2210,T
4-HA,1504,0,2214,0,1,2215,T
4-HA,1505,2219,0,0,0,2219,A
4-HA,1506,1,2215,0,0,2216,T
4-HA,1507,3,10,2200,0,2213,G
4-HA,1508,2214,0,2,0,2216,A
4-HA,1509,1,0,0,2217,2218,C
4-HA,1510,7,1,0,2188,2196,C
4-HA,1511,2194,0,0,0,2194,A
4-HA,1512,3,2,1,2244,2250,C
4-HA,1513,1,1,2300,0,2302,G
4-HA,1514,2344,0,1,0,2345,A
4-HA,1515,0,2385,0,0,2385,T
4-HA,1516,3,1,2481,0,2485,G
4-HA,1517,1,2467,0,1,2469,T
4-HA,1518,2543,0,0,1,2544,A
4-HA,1519,0,2543,0,0,2543,T
4-HA,1520,2533,0,2,0,2535,A
4-HA,1521,0,2,1,2531,2534,C
4-HA,1522,2259,0,1,0,2260,A
4-HA,1523,0,3,2281,0,2284,G
4-HA,1524,2137,0,0,0,2137,A
4-HA,1525,0,0,2067,0,2067,G
4-HA,1526,2055,0,0,1,2056,A
4-HA,1527,0,1919,0,1,1920,T
4-HA,1528,1,9,1907,0,1917,G
4-HA,1529,1915,1,0,0,1916,A
4-HA,1530,1907,0,1,0,1908,A
4-HA,1531,2,0,1955,0,1957,G
4-HA,1532,1,1,0,1915,1917,C
4-HA,1533,1910,0,0,0,1910,A
4-HA,1534,0,1915,0,0,1915,T
4-HA,1535,0,1911,0,1,1912,T
4-HA,1536,1926,0,1,0,1927,A
4-HA,1537,1929,0,1,0,1930,A
4-HA,1538,1930,1,0,1,1932,A
4-HA,1539,2,0,0,1932,1934,C
4-HA,1540,1869,0,0,0,1869,A
4-HA,1541,1881,0,0,0,1881,A
4-HA,1542,0,0,0,1876,1876,C
4-HA,1543,1,1,0,1857,1859,C
4-HA,1544,1,1,1849,0,1851,G
4-HA,1545,0,2,1888,0,1890,G
4-HA,1546,0,1886,0,2,1888,T
4-HA,1547,0,1889,0,0,1889,T
4-HA,1548,3,0,0,1884,1887,C
4-HA,1549,1,2,0,1886,1889,C
4-HA,1550,1874,6,0,0,1880,A
4-HA,1551,1,6,1907,0,1914,G
4-HA,1552,1914,0,0,1,1915,A
4-HA,1553,0,1918,0,0,1918,T
4-HA,1554,8,0,0,1851,1859,C
4-HA,1555,1847,1,0,0,1848,A
4-HA,1556,1841,2,11,0,1854,A
4-HA,1557,2,4,1843,0,1849,G
4-HA,1558,2,2,1836,0,1840,G
4-HA,1559,0,4,1839,0,1843,G
4-HA,1560,1757,0,1,0,1758,A
4-HA,1561,1,2,1774,0,1777,G
4-HA,1562,0,1778,0,0,1778,T
4-HA,1563,1,1776,0,2,1779,T
4-HA,1564,0,5,1781,1,1787,G
4-HA,1565,1771,1,1,0,1773,A
4-HA,1566,1,4,1782,0,1787,G
4-HA,1567,0,0,1,1784,1785,C
4-HA,1568,0,1763,0,4,1767,T
4-HA,1569,1,2,1774,0,1777,G
4-HA,1570,1760,0,0,0,1760,A
4-HA,1571,1768,0,1,0,1769,A
4-HA,1572,0,0,1770,0,1770,G
4-HA,1573,0,1719,0,2,1721,T
4-HA,1574,7,0,0,1716,1723,C
4-HA,1575,1702,0,0,0,1702,A
4-HA,1576,0,3,1697,0,1700,G
4-HA,1577,3,1,1691,0,1695,G
4-HA,1578,0,1,1663,0,1664,G
4-HA,1579,0,1723,0,0,1723,T
4-HA,1580,1741,0,1,0,1742,A
4-HA,1581,2,0,0,1737,1739,C
4-HA,1582,1728,1,1,0,1730,A
4-HA,1583,1731,0,0,0,1731,A
4-HA,1584,1728,0,3,0,1731,A
4-HA,1585,0,2,1753,0,1755,G
4-HA,1586,1699,0,0,0,1699,A
4-HA,1587,1,1607,0,28,1636,T
4-HA,1588,0,1624,0,0,1624,T
4-HA,1589,0,2,1618,0,1620,G
4-HA,1590,0,0,1621,0,1621,G
4-HA,1591,1624,0,1,0,1625,A
4-HA,1592,0,1630,1,1,1632,T
4-HA,1593,3,0,0,1622,1625,C
4-HA,1594,4,1,0,1586,1591,C
4-HA,1595,0,1579,0,0,1579,T
4-HA,1596,1588,0,0,0,1588,A
4-HA,1597,1,1591,0,2,1594,T
4-HA,1598,0,2,1588,0,1590,G
4-HA,1599,0,3,1580,0,1583,G
4-HA,1600,1554,1,0,0,1555,A
4-HA,1601,0,1550,0,0,1550,T
4-HA,1602,0,1530,0,0,1530,T
4-HA,1603,0,1539,0,1,1540,T
4-HA,1604,1,0,0,1537,1538,C
4-HA,1605,1,1,0,1532,1534,C
4-HA,1606,0,1518,0,1,1519,T
4-HA,1607,0,1516,0,2,1518,T
4-HA,1608,1,1504,1,0,1506,T
4-HA,1609,0,0,1518,0,1518,G
4-HA,1610,1,0,0,1512,1513,C
4-HA,1611,4,1,1,1513,1519,C
4-HA,1612,1499,0,0,0,1499,A
4-HA,1613,1,1490,0,0,1491,T
4-HA,1614,1509,0,0,0,1509,A
4-HA,1615,0,1507,0,2,1509,T
4-HA,1616,8,0,0,1490,1498,C
4-HA,1617,1499,0,0,0,1499,A
4-HA,1618,0,1483,0,0,1483,T
4-HA,1619,0,0,1494,0,1494,G
4-HA,1620,0,1477,1,3,1481,T
4-HA,1621,0,1464,0,0,1464,T
4-HA,1622,0,1459,0,0,1459,T
4-HA,1623,0,1441,0,0,1441,T
4-HA,1624,0,1440,1,0,1441,T
4-HA,1625,1,1436,0,1,1438,T
4-HA,1626,0,0,1444,0,1444,G
4-HA,1627,0,0,0,1441,1441,C
4-HA,1628,0,1401,0,3,1404,T
4-HA,1629,0,1406,0,1,1407,T
4-HA,1630,0,1405,0,0,1405,T
4-HA,1631,0,0,1430,0,1430,G
4-HA,1632,0,1427,0,2,1429,T
4-HA,1633,1,0,1429,0,1430,G
4-HA,1634,1,1429,0,2,1432,T
4-HA,1635,1,1404,1,0,1406,T
4-HA,1636,0,0,1414,0,1414,G
4-HA,1637,0,0,0,1412,1412,C
4-HA,1638,0,1399,1,3,1403,T
4-HA,1639,0,1430,0,0,1430,T
4-HA,1640,0,1356,0,0,1356,T
4-HA,1641,0,2,1362,0,1364,G
4-HA,1642,0,1359,0,0,1359,T
4-HA,1643,0,1347,0,1,1348,T
4-HA,1644,0,3,1347,0,1350,G
4-HA,1645,0,4,1324,0,1328,G
4-HA,1646,0,2,1329,0,1331,G
4-HA,1647,0,2,1331,0,1333,G
4-HA,1648,0,1302,0,0,1302,T
4-HA,1649,0,1297,0,1,1298,T
4-HA,1650,11,1,0,1274,1286,C
4-HA,1651,1270,0,0,0,1270,A
4-HA,1652,0,1271,0,1,1272,T
4-HA,1653,3,0,0,1261,1264,C
4-HA,1654,1261,1,2,0,1264,A
4-HA,1655,0,1236,0,0,1236,T
4-HA,1656,0,1,1230,0,1231,G
4-HA,1657,0,1214,1,1,1216,T
4-HA,1658,2,2,1204,0,1208,G
4-HA,1659,0,0,1188,0,1188,G
4-HA,1660,0,0,1181,0,1181,G
4-HA,1661,0,0,0,1163,1163,C
4-HA,1662,2,1,0,1141,1144,C
4-HA,1663,0,1084,0,3,1087,T
4-HA,1664,1,0,1094,0,1095,G
4-HA,1665,2,1,0,1091,1094,C
4-HA,1666,4,0,0,1090,1094,C
4-HA,1667,1090,0,0,0,1090,A
4-HA,1668,1083,0,0,0,1083,A
4-HA,1669,1074,0,5,0,1079,A
4-HA,1670,1078,0,0,0,1078,A
4-HA,1671,1081,0,1,0,1082,A
4-HA,1672,1,4,1075,0,1080,G
4-HA,1673,1,0,1045,0,1046,G
4-HA,1674,1,0,0,1035,1036,C
4-HA,1675,1029,1,1,0,1031,A
4-HA,1676,1028,0,4,0,1032,A
4-HA,1677,1,0,0,1029,1030,C
4-HA,1678,1027,0,1,0,1028,A
4-HA,1679,0,1026,0,1,1027,T
4-HA,1680,0,1023,0,0,1023,T
4-HA,1681,997,0,5,0,1002,A
4-HA,1682,0,0,991,0,991,G
4-HA,1683,0,0,987,0,987,G
4-HA,1684,0,968,0,0,968,T
4-HA,1685,0,1,909,0,910,G
4-HA,1686,0,0,0,877,877,C
4-HA,1687,861,0,0,0,861,A
4-HA,1688,861,0,0,0,861,A
4-HA,1689,0,0,0,858,858,C
4-HA,1690,845,0,0,1,846,A
4-HA,1691,0,837,0,0,837,T
4-HA,1692,0,801,0,2,803,T
4-HA,1693,0,801,0,0,801,T
4-HA,1694,0,1,801,0,802,G
4-HA,1695,1,2,0,790,793,C
4-HA,1696,789,0,1,0,790,A
4-HA,1697,1,747,0,0,748,T
4-HA,1698,1,727,0,0,728,T
4-HA,1699,1,692,0,0,693,T
4-HA,1700,0,0,694,0,694,G
4-HA,1701,675,0,0,0,675,A
5-NP,1,93,0,0,0,93,A
5-NP,2,0,93,0,0,93,T
5-NP,3,0,0,93,0,93,G
5-NP,4,0,0,94,0,94,G
5-NP,5,1,0,0,92,93,C
5-NP,6,0,0,96,0,96,G
5-NP,7,0,100,0,0,100,T
5-NP,8,0,0,0,101,101,C
5-NP,9,0,0,0,102,102,C
5-NP,10,0,0,0,102,102,C
5-NP,11,102,0,0,0,102,A
5-NP,12,103,0,0,0,103,A
5-NP,13,0,0,104,0,104,G
5-NP,14,0,0,107,0,107,G
5-NP,15,0,0,0,106,106,C
5-NP,16,106,0,0,0,106,A
5-NP,17,0,0,0,109,109,C
5-NP,18,0,0,0,109,109,C
5-NP,19,109,0,1,0,110,A
5-NP,20,110,0,0,0,110,A
5-NP,21,110,0,0,0,110,A
5-NP,22,0,1,0,109,110,C
5-NP,23,1,2,108,0,111,G
5-NP,24,0,0,119,0,119,G
5-NP,25,0,118,0,0,118,T
5-NP,26,0,0,0,131,131,C
5-NP,27,0,131,0,0,131,T
5-NP,28,0,135,0,0,135,T
5-NP,29,135,0,0,0,135,A
5-NP,30,0,135,0,0,135,T
5-NP,31,0,2,134,0,136,G
5-NP,32,136,0,0,0,136,A
5-NP,33,134,0,0,0,134,A
5-NP,34,0,0,0,134,134,C
5-NP,35,133,0,0,0,133,A
5-NP,36,0,0,145,0,145,G
5-NP,37,144,0,0,0,144,A
5-NP,38,0,145,0,0,145,T
5-NP,39,0,0,144,0,144,G
5-NP,40,0,0,144,0,144,G
5-NP,41,145,0,0,0,145,A
5-NP,42,145,0,0,0,145,A
5-NP,43,143,0,1,0,144,A
5-NP,44,0,0,0,150,150,C
5-NP,45,0,149,0,0,149,T
5-NP,46,0,0,152,0,152,G
5-NP,47,152,0,0,0,152,A
5-NP,48,0,151,0,0,151,T
5-NP,49,0,0,151,0,151,G
5-NP,50,0,1,152,0,153,G
5-NP,51,0,2,152,0,154,G
5-NP,52,0,0,154,0,154,G
5-NP,53,151,0,0,0,151,A
5-NP,54,0,149,0,2,151,T
5-NP,55,0,0,0,151,151,C
5-NP,56,0,0,152,0,152,G
5-NP,57,0,0,0,153,153,C
5-NP,58,0,1,0,150,151,C
5-NP,59,153,0,0,0,153,A
5-NP,60,0,0,154,0,154,G
5-NP,61,152,0,0,0,152,A
5-NP,62,157,0,0,0,157,A
5-NP,63,0,156,0,0,156,T
5-NP,64,0,0,157,0,157,G
5-NP,65,0,0,0,159,159,C
5-NP,66,158,0,0,0,158,A
5-NP,67,159,0,1,0,160,A
5-NP,68,0,0,0,160,160,C
5-NP,69,0,159,0,0,159,T
5-NP,70,0,0,162,0,162,G
5-NP,71,163,1,0,0,164,A
5-NP,72,0,1,178,0,179,G
5-NP,73,180,0,0,0,180,A
5-NP,74,0,180,0,0,180,T
5-NP,75,0,180,0,0,180,T
5-NP,76,180,0,0,0,180,A
5-NP,77,0,0,181,0,181,G
5-NP,78,0,1,180,0,181,G
5-NP,79,0,0,181,0,181,G
5-NP,80,0,0,0,179,179,C
5-NP,81,174,0,0,0,174,A
5-NP,82,0,177,0,0,177,T
5-NP,83,1,0,0,177,178,C
5-NP,84,1,0,0,176,177,C
5-NP,85,0,0,177,0,177,G
5-NP,86,1,177,0,0,178,T
5-NP,87,1,0,0,176,177,C
5-NP,88,0,0,179,0,179,G
5-NP,89,0,0,178,0,178,G
5-NP,90,0,0,178,0,178,G
5-NP,91,178,0,0,0,178,A
5-NP,92,178,0,0,0,178,A
5-NP,93,0,0,178,0,178,G
5-NP,94,179,0,0,0,179,A
5-NP,95,0,182,0,0,182,T
5-NP,96,0,1,182,0,183,G
5-NP,97,178,0,1,0,179,A
5-NP,98,0,180,0,0,180,T
5-NP,99,0,180,0,0,180,T
5-NP,100,0,0,180,0,180,G
5-NP,101,180,0,0,0,180,A
5-NP,102,0,180,0,0,180,T
5-NP,103,0,1,179,0,180,G
5-NP,104,0,0,179,0,179,G
5-NP,105,0,0,178,0,178,G
5-NP,106,190,0,0,0,190,A
5-NP,107,0,189,0,0,189,T
5-NP,108,0,190,0,0,190,T
5-NP,109,0,0,194,0,194,G
5-NP,110,0,0,196,0,196,G
5-NP,111,0,1,194,0,195,G
5-NP,112,197,0,0,0,197,A
5-NP,113,0,0,196,0,196,G
5-NP,114,194,0,0,0,194,A
5-NP,115,0,199,0,0,199,T
5-NP,116,0,199,0,0,199,T
5-NP,117,0,0,0,200,200,C
5-NP,118,0,199,0,0,199,T
5-NP,119,205,0,0,0,205,A
5-NP,120,0,0,0,206,206,C
5-NP,121,209,0,0,0,209,A
5-NP,122,0,210,0,0,210,T
5-NP,123,0,0,0,209,209,C
5-NP,124,0,0,0,212,212,C
5-NP,125,213,0,0,0,213,A
5-NP,126,213,0,0,1,214,A
5-NP,127,216,0,0,0,216,A
5-NP,128,0,216,0,0,216,T
5-NP,129,0,0,216,0,216,G
5-NP,130,0,213,0,0,213,T
5-NP,131,0,0,216,0,216,G
5-NP,132,1,0,0,214,215,C
5-NP,133,217,0,0,0,217,A
5-NP,134,0,0,0,217,217,C
5-NP,135,0,217,0,0,217,T
5-NP,136,0,1,224,0,225,G
5-NP,137,228,0,0,0,228,A
5-NP,138,233,0,0,0,233,A
5-NP,139,1,0,0,233,234,C
5-NP,140,0,233,0,0,233,T
5-NP,141,0,233,0,0,233,T
5-NP,142,234,0,0,0,234,A
5-NP,143,234,0,0,0,234,A
5-NP,144,235,0,0,0,235,A
5-NP,145,0,0,0,237,237,C
5-NP,146,0,229,0,0,229,T
5-NP,147,2,0,0,227,229,C
5-NP,148,228,0,0,0,228,A
5-NP,149,0,0,232,0,232,G
5-NP,150,0,232,0,0,232,T
5-NP,151,0,0,234,0,234,G
5-NP,152,237,0,0,0,237,A
5-NP,153,0,236,0,0,236,T
5-NP,154,1,0,0,240,241,C
5-NP,155,241,0,0,0,241,A
5-NP,156,0,240,0,0,240,T
5-NP,157,0,0,240,0,240,G
5-NP,158,242,0,0,0,242,A
5-NP,159,241,0,0,0,241,A
5-NP,160,1,1,242,0,244,G
5-NP,161,0,0,240,0,240,G
5-NP,162,0,0,241,0,241,G
5-NP,163,0,0,0,238,238,C
5-NP,164,0,1,241,0,242,G
5-NP,165,0,0,243,0,243,G
5-NP,166,0,244,0,0,244,T
5-NP,167,0,243,0,0,243,T
5-NP,168,0,0,243,0,243,G
5-NP,169,267,0,0,0,267,A
5-NP,170,0,268,0,0,268,T
5-NP,171,1,0,0,267,268,C
5-NP,172,0,0,0,267,267,C
5-NP,173,265,0,0,0,265,A
5-NP,174,0,1,266,0,267,G
5-NP,175,265,0,0,0,265,A
5-NP,176,267,0,0,0,267,A
5-NP,177,1,0,0,268,269,C
5-NP,178,254,0,0,0,254,A
5-NP,179,0,0,257,0,257,G
5-NP,180,0,0,0,257,257,C
5-NP,181,0,256,0,0,256,T
5-NP,182,0,257,0,0,257,T
5-NP,183,0,0,259,0,259,G
5-NP,184,263,0,0,0,263,A
5-NP,185,0,0,0,262,262,C
5-NP,186,262,0,0,0,262,A
5-NP,187,262,0,0,0,262,A
5-NP,188,0,260,0,0,260,T
5-NP,189,258,0,0,0,258,A
5-NP,190,0,0,261,0,261,G
5-NP,191,261,0,0,0,261,A
5-NP,192,0,0,262,0,262,G
5-NP,193,258,0,0,0,258,A
5-NP,194,260,0,0,0,260,A
5-NP,195,258,0,0,0,258,A
5-NP,196,267,0,0,0,267,A
5-NP,197,0,266,0,0,266,T
5-NP,198,0,0,265,0,265,G
5-NP,199,0,0,265,0,265,G
5-NP,200,0,264,0,0,264,T
5-NP,201,260,0,0,0,260,A
5-NP,202,0,0,0,263,263,C
5-NP,203,0,263,0,0,263,T
5-NP,204,0,0,0,267,267,C
5-NP,205,0,258,0,0,258,T
5-NP,206,1,2,0,259,262,C
5-NP,207,0,262,0,0,262,T
5-NP,208,0,1,266,0,267,G
5-NP,209,0,0,0,267,267,C
5-NP,210,0,265,0,1,266,T
5-NP,211,0,264,0,0,264,T
5-NP,212,0,266,0,0,266,T
5-NP,213,0,267,0,0,267,T
5-NP,214,0,1,267,0,268,G
5-NP,215,266,1,0,0,267,A
5-NP,216,0,267,0,0,267,T
5-NP,217,0,0,267,0,267,G
5-NP,218,268,0,0,0,268,A
5-NP,219,267,0,0,0,267,A
5-NP,220,268,0,0,0,268,A
5-NP,221,0,0,269,0,269,G
5-NP,222,269,0,0,0,269,A
5-NP,223,268,0,0,0,268,A
5-NP,224,0,0,269,0,269,G
5-NP,225,0,1,273,0,274,G
5-NP,226,272,0,1,0,273,A
5-NP,227,275,0,0,0,275,A
5-NP,228,0,276,0,1,277,T
5-NP,229,277,0,0,0,277,A
5-NP,230,276,0,0,0,276,A
5-NP,231,276,0,0,0,276,A
5-NP,232,0,278,0,0,278,T
5-NP,233,277,0,0,0,277,A
5-NP,234,0,0,0,274,274,C
5-NP,235,1,0,0,271,272,C
5-NP,236,0,269,0,1,270,T
5-NP,237,0,0,274,0,274,G
5-NP,238,0,0,278,0,278,G
5-NP,239,275,1,0,0,276,A
5-NP,240,275,0,0,0,275,A
5-NP,241,1,1,275,0,277,G
5-NP,242,277,0,0,1,278,A
5-NP,243,277,0,0,0,277,A
5-NP,244,0,0,0,277,277,C
5-NP,245,276,0,0,0,276,A
5-NP,246,0,0,0,276,276,C
5-NP,247,0,0,0,274,274,C
5-NP,248,0,0,0,274,274,C
5-NP,249,0,0,0,274,274,C
5-NP,250,276,0,0,0,276,A
5-NP,251,0,0,277,0,277,G
5-NP,252,0,1,0,276,277,C
5-NP,253,0,0,277,0,277,G
5-NP,254,0,0,0,278,278,C
5-NP,255,1,0,274,1,276,G
5-NP,256,0,0,277,0,277,G
5-NP,257,1,0,278,0,279,G
5-NP,258,0,0,281,0,281,G
5-NP,259,277,0,0,0,277,A
5-NP,260,280,0,0,0,280,A
5-NP,261,280,0,0,0,280,A
5-NP,262,0,0,279,0,279,G
5-NP,263,278,0,0,0,278,A
5-NP,264,0,276,0,0,276,T
5-NP,265,0,0,0,272,272,C
5-NP,266,1,0,0,269,270,C
5-NP,267,0,0,0,274,274,C
5-NP,268,275,0,0,0,275,A
5-NP,269,274,0,0,0,274,A
5-NP,270,0,0,275,0,275,G
5-NP,271,275,0,0,0,275,A
5-NP,272,272,0,0,0,272,A
5-NP,273,275,0,0,0,275,A
5-NP,274,273,0,0,0,273,A
5-NP,275,0,0,0,272,272,C
5-NP,276,0,272,0,0,272,T
5-NP,277,0,0,268,0,268,G
5-NP,278,0,0,271,0,271,G
5-NP,279,0,0,272,0,272,G
5-NP,280,0,0,272,0,272,G
5-NP,281,0,0,270,0,270,G
5-NP,282,0,0,274,0,274,G
5-NP,283,0,0,0,299,299,C
5-NP,284,1,0,0,298,299,C
5-NP,285,1,0,0,300,301,C
5-NP,286,333,0,0,0,333,A
5-NP,287,1,334,0,0,335,T
5-NP,288,349,0,0,0,349,A
5-NP,289,0,349,0,0,349,T
5-NP,290,345,0,0,0,345,A
5-NP,291,0,0,0,349,349,C
5-NP,292,320,0,0,0,320,A
5-NP,293,1,0,322,0,323,G
5-NP,294,0,3,319,0,322,G
5-NP,295,294,0,0,0,294,A
5-NP,296,0,0,297,0,297,G
5-NP,297,283,0,0,0,283,A
5-NP,298,0,0,286,0,286,G
5-NP,299,0,286,0,0,286,T
5-NP,300,281,0,0,0,281,A
5-NP,301,0,0,280,0,280,G
5-NP,302,276,0,0,0,276,A
5-NP,303,0,277,0,0,277,T
5-NP,304,0,2,275,0,277,G
5-NP,305,0,0,277,0,277,G
5-NP,306,275,0,0,0,275,A
5-NP,307,276,0,0,0,276,A
5-NP,308,275,0,0,0,275,A
5-NP,309,275,0,0,0,275,A
5-NP,310,0,272,0,0,272,T
5-NP,311,0,1,272,0,273,G
5-NP,312,0,1,274,0,275,G
5-NP,313,274,0,0,0,274,A
5-NP,314,0,272,0,0,272,T
5-NP,315,0,0,272,0,272,G
5-NP,316,272,0,0,0,272,A
5-NP,317,0,0,274,0,274,G
5-NP,318,0,1,273,0,274,G
5-NP,319,0,0,283,0,283,G
5-NP,320,314,0,0,0,314,A
5-NP,321,315,0,1,0,316,A
5-NP,322,0,0,0,347,347,C
5-NP,323,0,345,0,0,345,T
5-NP,324,0,0,0,390,390,C
5-NP,325,0,0,409,0,409,G
5-NP,326,0,426,0,0,426,T
5-NP,327,1,2,0,439,442,C
5-NP,328,2,1,0,614,617,C
5-NP,329,0,616,0,0,616,T
5-NP,330,0,626,0,0,626,T
5-NP,331,0,626,0,1,627,T
5-NP,332,636,0,0,1,637,A
5-NP,333,1,638,0,0,639,T
5-NP,334,0,15,626,0,641,G
5-NP,335,656,0,0,1,657,A
5-NP,336,0,1,0,663,664,C
5-NP,337,656,0,0,1,657,A
5-NP,338,666,0,0,0,666,A
5-NP,339,671,1,1,0,673,A
5-NP,340,0,2,739,0,741,G
5-NP,341,741,0,0,0,741,A
5-NP,342,744,1,0,0,745,A
5-NP,343,0,0,839,0,839,G
5-NP,344,853,0,0,0,853,A
5-NP,345,859,0,0,0,859,A
5-NP,346,857,0,0,0,857,A
5-NP,347,0,856,0,0,856,T
5-NP,348,860,0,0,0,860,A
5-NP,349,864,0,1,0,865,A
5-NP,350,0,0,886,0,886,G
5-NP,351,0,0,886,0,886,G
5-NP,352,0,0,0,888,888,C
5-NP,353,1,5,880,0,886,G
5-NP,354,895,0,1,0,896,A
5-NP,355,922,0,0,0,922,A
5-NP,356,0,927,0,4,931,T
5-NP,357,1,0,0,932,933,C
5-NP,358,0,933,0,0,933,T
5-NP,359,0,2,940,0,942,G
5-NP,360,0,1,946,0,947,G
5-NP,361,0,1,0,948,949,C
5-NP,362,0,0,949,0,949,G
5-NP,363,0,0,0,947,947,C
5-NP,364,1,0,0,948,949,C
5-NP,365,955,0,0,0,955,A
5-NP,366,986,0,1,0,987,A
5-NP,367,0,0,1042,0,1042,G
5-NP,368,0,0,0,1044,1044,C
5-NP,369,1,0,0,1073,1074,C
5-NP,370,1075,0,0,0,1075,A
5-NP,371,1117,0,1,0,1118,A
5-NP,372,0,0,0,1153,1153,C
5-NP,373,1157,0,1,0,1158,A
5-NP,374,1220,0,0,0,1220,A
5-NP,375,0,1219,0,0,1219,T
5-NP,376,1,4,1277,0,1282,G
5-NP,377,0,1,1280,0,1281,G
5-NP,378,1,1282,0,0,1283,T
5-NP,379,0,1,1293,0,1294,G
5-NP,380,1292,0,0,0,1292,A
5-NP,381,1,2,1351,0,1354,G
5-NP,382,0,4,1358,0,1362,G
5-NP,383,1396,0,1,0,1397,A
5-NP,384,0,1597,0,0,1597,T
5-NP,385,0,0,1648,0,1648,G
5-NP,386,0,0,0,1661,1661,C
5-NP,387,0,1661,0,0,1661,T
5-NP,388,1682,0,1,0,1683,A
5-NP,389,2,0,0,1722,1724,C
5-NP,390,1737,0,0,0,1737,A
5-NP,391,0,1737,0,0,1737,T
5-NP,392,1,0,0,1729,1730,C
5-NP,393,0,1699,0,0,1699,T
5-NP,394,0,5,1797,0,1802,G
5-NP,395,0,2,1861,0,1863,G
5-NP,396,2,1863,0,0,1865,T
5-NP,397,6,1,0,1857,1864,C
5-NP,398,0,1856,0,0,1856,T
5-NP,399,1905,0,1,0,1906,A
5-NP,400,1915,0,0,0,1915,A
5-NP,401,0,0,0,1942,1942,C
5-NP,402,0,1941,0,0,1941,T
5-NP,403,9,0,0,1964,1973,C
5-NP,404,1970,1,1,0,1972,A
5-NP,405,0,1,0,2118,2119,C
5-NP,406,2116,0,0,0,2116,A
5-NP,407,1,2127,0,1,2129,T
5-NP,408,2121,0,1,0,2122,A
5-NP,409,2136,0,0,0,2136,A
5-NP,410,0,2162,0,0,2162,T
5-NP,411,0,13,2194,0,2207,G
5-NP,412,2204,0,0,0,2204,A
5-NP,413,1,2188,0,1,2190,T
5-NP,414,0,2172,1,1,2174,T
5-NP,415,0,2181,0,1,2182,T
5-NP,416,4,8,2159,0,2171,G
5-NP,417,1,3,2172,0,2176,G
5-NP,418,2,0,0,2180,2182,C
5-NP,419,2171,0,0,0,2171,A
5-NP,420,1,2181,0,1,2183,T
5-NP,421,0,2182,0,0,2182,T
5-NP,422,7,0,0,2173,2180,C
5-NP,423,5,1,0,2184,2190,C
5-NP,424,2242,0,1,0,2243,A
5-NP,425,2249,0,1,0,2250,A
5-NP,426,0,2256,1,1,2258,T
5-NP,427,0,2255,0,1,2256,T
5-NP,428,0,2258,0,0,2258,T
5-NP,429,1,8,2285,1,2295,G
5-NP,430,2291,0,1,0,2292,A
5-NP,431,2294,0,3,0,2297,A
5-NP,432,1,2318,0,2,2321,T
5-NP,433,0,6,2302,0,2308,G
5-NP,434,2427,0,1,1,2429,A
5-NP,435,0,2437,0,1,2438,T
5-NP,436,4,2,2441,0,2447,G
5-NP,437,3,1,0,2516,2520,C
5-NP,438,2522,0,0,0,2522,A
5-NP,439,2648,1,1,0,2650,A
5-NP,440,2,0,0,2650,2652,C
5-NP,441,2702,1,0,0,2703,A
5-NP,442,0,2787,0,1,2788,T
5-NP,443,2742,0,1,0,2743,A
5-NP,444,0,1,0,2802,2803,C
5-NP,445,0,0,1,2799,2800,C
5-NP,446,2762,1,1,0,2764,A
5-NP,447,8,3,2805,1,2817,G
5-NP,448,2778,0,5,0,2783,A
5-NP,449,4,3,2853,0,2860,G
5-NP,450,0,10,2842,1,2853,G
5-NP,451,2839,0,2,0,2841,A
5-NP,452,1,1,0,2859,2861,C
5-NP,453,2839,0,1,0,2840,A
5-NP,454,2843,0,0,0,2843,A
5-NP,455,2,4,2854,0,2860,G
5-NP,456,2839,0,4,0,2843,A
5-NP,457,0,2,2862,0,2864,G
5-NP,458,0,3,0,2863,2866,C
5-NP,459,0,2849,0,2,2851,T
5-NP,460,4,0,1,2877,2882,C
5-NP,461,0,2863,0,3,2866,T
5-NP,462,0,2882,0,0,2882,T
5-NP,463,1,2,2895,0,2898,G
5-NP,464,1,2885,0,0,2886,T
5-NP,465,0,2886,0,0,2886,T
5-NP,466,7,0,1,2870,2878,C
5-NP,467,0,18,2866,0,2884,G
5-NP,468,2953,0,1,0,2954,A
5-NP,469,2952,1,0,1,2954,A
5-NP,470,1,0,0,2979,2980,C
5-NP,471,0,2967,0,4,2971,T
5-NP,472,0,5,2999,0,3004,G
5-NP,473,2,7,3026,0,3035,G
5-NP,474,3033,0,0,1,3034,A
5-NP,475,3037,0,1,0,3038,A
5-NP,476,2,3042,0,1,3045,T
5-NP,477,2,9,3044,0,3055,G
5-NP,478,1,5,3065,0,3071,G
5-NP,479,3096,1,2,0,3099,A
5-NP,480,1,3121,0,1,3123,T
5-NP,481,6,1,0,3143,3150,C
5-NP,482,5,1,0,3156,3162,C
5-NP,483,4,0,1,3180,3185,C
5-NP,484,3201,2,1,0,3204,A
5-NP,485,0,12,3224,0,3236,G
5-NP,486,3256,0,0,0,3256,A
5-NP,487,3251,0,0,1,3252,A
5-NP,488,2,3234,1,1,3238,T
5-NP,489,1,0,3280,0,3281,G
5-NP,490,0,3265,0,1,3266,T
5-NP,491,2,0,3287,0,3289,G
5-NP,492,2,2,0,3292,3296,C
5-NP,493,2,3277,0,3,3282,T
5-NP,494,7,4,1,3472,3484,C
5-NP,495,0,3465,0,3,3468,T
5-NP,496,3,1,0,3638,3642,C
5-NP,497,2,3629,0,2,3633,T
5-NP,498,10,3,3635,0,3648,G
5-NP,499,3689,2,1,0,3692,A
5-NP,500,1,3680,0,2,3683,T
5-NP,501,4,4,3673,0,3681,G
5-NP,502,1,1,0,3675,3677,C
5-NP,503,3579,0,3,0,3582,A
5-NP,504,0,3,3670,0,3673,G
5-NP,505,0,6,3613,0,3619,G
5-NP,506,0,3,3664,0,3667,G
5-NP,507,3,0,0,3657,3660,C
5-NP,508,0,3649,1,6,3656,T
5-NP,509,6,3,0,3658,3667,C
5-NP,510,9,19,3644,0,3672,G
5-NP,511,3726,0,0,0,3726,A
5-NP,512,1,0,1,3726,3728,C
5-NP,513,1,3695,0,2,3698,T
5-NP,514,9,1,0,3886,3896,C
5-NP,515,1,3867,0,3,3871,T
5-NP,516,8,4,0,4442,4454,C
5-NP,517,6,0,0,4455,4461,C
5-NP,518,3,0,0,4471,4474,C
5-NP,519,1,4467,0,3,4471,T
5-NP,520,4460,3,1,0,4464,A
5-NP,521,0,7,4451,2,4460,G
5-NP,522,4453,0,0,0,4453,A
5-NP,523,4332,0,4,0,4336,A
5-NP,524,0,14,4337,0,4351,G
5-NP,525,0,8,4302,0,4310,G
5-NP,526,0,4254,0,2,4256,T
5-NP,527,11,0,0,4232,4243,C
5-NP,528,6,3,0,4245,4254,C
5-NP,529,1,12,4245,0,4258,G
5-NP,530,0,7,4282,1,4290,G
5-NP,531,4282,0,1,0,4283,A
5-NP,532,2,0,4337,0,4339,G
5-NP,533,1,0,0,4347,4348,C
5-NP,534,1,4314,0,4,4319,T
5-NP,535,1,0,4325,0,4326,G
5-NP,536,1,1,0,4341,4343,C
5-NP,537,4324,1,11,1,4337,A
5-NP,538,1,4,4351,0,4356,G
5-NP,539,1,4,4374,0,4379,G
5-NP,540,0,4382,0,2,4384,T
5-NP,541,0,1,4353,0,4354,G
5-NP,542,4,0,0,4364,4368,C
5-NP,543,2,4341,0,10,4353,T
5-NP,544,1,1,4362,0,4364,G
5-NP,545,0,0,1,4361,4362,C
5-NP,546,4410,0,1,0,4411,A
5-NP,547,3,1,4484,0,4488,G
5-NP,548,0,4461,0,1,4462,T
5-NP,549,24,0,0,4463,4487,C
5-NP,550,4479,0,0,0,4479,A
5-NP,551,4494,0,0,0,4494,A
5-NP,552,4481,1,8,0,4490,A
5-NP,553,1,9,4501,1,4512,G
5-NP,554,0,11,4518,0,4529,G
5-NP,555,4519,2,0,0,4521,A
5-NP,556,4489,1,2,0,4492,A
5-NP,557,2,4474,1,3,4480,T
5-NP,558,4,2,0,4473,4479,C
5-NP,559,2,8,4473,0,4483,G
5-NP,560,1,6,4577,1,4585,G
5-NP,561,0,17,4586,1,4604,G
5-NP,562,4591,0,1,0,4592,A
5-NP,563,2,1,0,4603,4606,C
5-NP,564,4551,0,2,0,4553,A
5-NP,565,4658,0,3,1,4662,A
5-NP,566,2,4671,1,3,4677,T
5-NP,567,0,9,4704,1,4714,G
5-NP,568,2,5,4815,1,4823,G
5-NP,569,0,4828,0,3,4831,T
5-NP,570,1,12,4829,0,4842,G
5-NP,571,4843,1,2,0,4846,A
5-NP,572,0,4831,1,2,4834,T
5-NP,573,18,13,4812,0,4843,G
5-NP,574,1,8,4872,1,4882,G
5-NP,575,4867,0,0,1,4868,A
5-NP,576,4859,0,2,0,4861,A
5-NP,577,3,0,0,4864,4867,C
5-NP,578,0,4742,0,1,4743,T
5-NP,579,3,13,5011,1,5028,G
5-NP,580,5014,0,1,0,5015,A
5-NP,581,0,5026,0,0,5026,T
5-NP,582,10,0,1,5021,5032,C
5-NP,583,4967,2,1,0,4970,A
5-NP,584,6,12,5075,1,5094,G
5-NP,585,5084,0,1,1,5086,A
5-NP,586,5087,1,1,0,5089,A
5-NP,587,0,5083,1,3,5087,T
5-NP,588,3,6,4975,2,4986,G
5-NP,589,2,5,5036,0,5043,G
5-NP,590,2,5035,2,6,5045,T
5-NP,591,12,0,0,5038,5050,C
5-NP,592,5040,0,1,0,5041,A
5-NP,593,5006,0,2,0,5008,A
5-NP,594,5004,2,3,2,5011,A
5-NP,595,2,2,0,5018,5022,C
5-NP,596,11,9,4998,0,5018,G
5-NP,597,2,10,5036,0,5048,G
5-NP,598,3,6,4995,1,5005,G
5-NP,599,0,13,5000,1,5014,G
5-NP,600,4983,2,7,0,4992,A
5-NP,601,5036,0,0,0,5036,A
5-NP,602,0,5023,0,1,5024,T
5-NP,603,21,0,1,5012,5034,C
5-NP,604,5020,1,2,0,5023,A
5-NP,605,5026,0,3,0,5029,A
5-NP,606,2,4,0,4991,4997,C
5-NP,607,2,26,4957,0,4985,G
5-NP,608,4991,1,3,0,4995,A
5-NP,609,2,4981,0,3,4986,T
5-NP,610,19,3,0,4956,4978,C
5-NP,611,2,10,4975,1,4988,G
5-NP,612,4987,0,0,0,4987,A
5-NP,613,4980,0,0,1,4981,A
5-NP,614,4989,0,2,0,4991,A
5-NP,615,0,5032,3,0,5035,T
5-NP,616,1,5029,2,3,5035,T
5-NP,617,0,5012,1,0,5013,T
5-NP,618,0,5033,1,4,5038,T
5-NP,619,0,5053,0,1,5054,T
5-NP,620,0,16,5050,0,5066,G
5-NP,621,0,13,5054,0,5067,G
5-NP,622,5020,0,7,0,5027,A
5-NP,623,0,7,5064,0,5071,G
5-NP,624,5003,0,7,0,5010,A
5-NP,625,0,8,5192,0,5200,G
5-NP,626,1,6,5217,0,5224,G
5-NP,627,1,5202,0,6,5209,T
5-NP,628,1,26,5207,0,5234,G
5-NP,629,5214,1,9,0,5224,A
5-NP,630,5,17,5227,1,5250,G
5-NP,631,5235,2,4,0,5241,A
5-NP,632,5230,0,1,0,5231,A
5-NP,633,1,5212,1,0,5214,T
5-NP,634,5,15,5039,2,5061,G
5-NP,635,0,10,4983,0,4993,G
5-NP,636,2,3,5002,0,5007,G
5-NP,637,1,4,0,4980,4985,C
5-NP,638,0,8,4984,0,4992,G
5-NP,639,3,4,5011,1,5019,G
5-NP,640,5015,0,1,0,5016,A
5-NP,641,5028,0,0,0,5028,A
5-NP,642,5093,1,1,0,5095,A
5-NP,643,5101,1,7,1,5110,A
5-NP,644,1,2,0,5149,5152,C
5-NP,645,5134,0,1,0,5135,A
5-NP,646,5126,1,1,0,5128,A
5-NP,647,0,12,5121,0,5133,G
5-NP,648,5010,1,0,1,5012,A
5-NP,649,5037,0,1,0,5038,A
5-NP,650,1,0,5139,0,5140,G
5-NP,651,0,5125,0,7,5132,T
5-NP,652,3,2,5373,1,5379,G
5-NP,653,3,0,1,5345,5349,C
5-NP,654,0,5347,0,1,5348,T
5-NP,655,0,5362,1,1,5364,T
5-NP,656,5425,0,0,0,5425,A
5-NP,657,1,5429,0,0,5430,T
5-NP,658,2,8,5445,0,5455,G
5-NP,659,5346,1,11,0,5358,A
5-NP,660,1,13,5363,1,5378,G
5-NP,661,5138,0,2,0,5140,A
5-NP,662,0,11,5161,1,5173,G
5-NP,663,5150,0,1,0,5151,A
5-NP,664,5183,1,0,0,5184,A
5-NP,665,0,5146,1,2,5149,T
5-NP,666,2,1,5231,0,5234,G
5-NP,667,0,5197,0,4,5201,T
5-NP,668,1,6,5213,0,5220,G
5-NP,669,6,3,1,5197,5207,C
5-NP,670,5188,1,4,0,5193,A
5-NP,671,5208,1,7,0,5216,A
5-NP,672,4,1,0,5201,5206,C
5-NP,673,5176,0,0,0,5176,A
5-NP,674,1,5188,0,1,5190,T
5-NP,675,2,5151,0,1,5154,T
5-NP,676,10,0,0,5167,5177,C
5-NP,677,1,5152,1,0,5154,T
5-NP,678,0,5154,0,5,5159,T
5-NP,679,5157,2,2,1,5162,A
5-NP,680,5147,0,1,0,5148,A
5-NP,681,5151,0,1,0,5152,A
5-NP,682,0,8,5147,0,5155,G
5-NP,683,0,11,5130,1,5142,G
5-NP,684,5116,2,1,0,5119,A
5-NP,685,5108,0,5,1,5114,A
5-NP,686,5122,0,2,0,5124,A
5-NP,687,5180,0,4,0,5184,A
5-NP,688,1,5162,0,2,5165,T
5-NP,689,2,5159,0,2,5163,T
5-NP,690,1,5194,0,0,5195,T
5-NP,691,11,1,1,5193,5206,C
5-NP,692,5209,2,1,0,5212,A
5-NP,693,5216,0,0,0,5216,A
5-NP,694,5207,1,1,0,5209,A
5-NP,695,0,0,0,5277,5277,C
5-NP,696,5207,2,0,1,5210,A
5-NP,697,0,0,5306,1,5307,G
5-NP,698,0,0,0,5302,5302,C
5-NP,699,0,5301,0,1,5302,T
5-NP,700,1,3,5381,2,5387,G
5-NP,701,5,4,1,5361,5371,C
5-NP,702,5414,1,5,0,5420,A
5-NP,703,6,2,0,5414,5422,C
5-NP,704,5379,0,0,0,5379,A
5-NP,705,5385,0,4,0,5389,A
5-NP,706,5282,1,4,0,5287,A
5-NP,707,1,14,5451,0,5466,G
5-NP,708,5455,1,11,0,5467,A
5-NP,709,0,3,5509,0,5512,G
5-NP,710,1,1,0,5510,5512,C
5-NP,711,5505,0,3,0,5508,A
5-NP,712,5575,0,3,1,5579,A
5-NP,713,3,5585,0,2,5590,T
5-NP,714,2,19,5574,1,5596,G
5-NP,715,1,3,5607,0,5611,G
5-NP,716,0,5468,1,2,5471,T
5-NP,717,5,21,5454,0,5480,G
5-NP,718,1,17,5465,0,5483,G
5-NP,719,5470,0,6,1,5477,A
5-NP,720,0,5468,0,4,5472,T
5-NP,721,14,1,1,5385,5401,C
5-NP,722,5446,0,3,1,5450,A
5-NP,723,5594,2,1,1,5598,A
5-NP,724,0,2,5596,0,5598,G
5-NP,725,0,5570,0,1,5571,T
5-NP,726,0,5512,0,2,5514,T
5-NP,727,5557,1,0,0,5558,A
5-NP,728,0,12,5558,0,5570,G
5-NP,729,5563,1,1,0,5565,A
5-NP,730,0,11,5554,1,5566,G
5-NP,731,5497,1,1,0,5499,A
5-NP,732,5332,0,1,0,5333,A
5-NP,733,5351,0,3,0,5354,A
5-NP,734,4,1,5388,0,5393,G
5-NP,735,0,5380,0,0,5380,T
5-NP,736,13,0,0,5363,5376,C
5-NP,737,4,8,5357,0,5369,G
5-NP,738,2,20,5356,0,5378,G
5-NP,739,5385,0,5,0,5390,A
5-NP,740,5415,2,1,1,5419,A
5-NP,741,3,9,1,5411,5424,C
5-NP,742,8,1,0,5379,5388,C
5-NP,743,11,1,1,5387,5400,C
5-NP,744,5394,1,7,1,5403,A
5-NP,745,5,4,5410,0,5419,G
5-NP,746,2,15,5410,1,5428,G
5-NP,747,5416,1,1,0,5418,A
5-NP,748,5415,0,2,0,5417,A
5-NP,749,5390,0,1,1,5392,A
5-NP,750,2,1,0,5389,5392,C
5-NP,751,3,2,5373,0,5378,G
5-NP,752,1,1,0,5372,5374,C
5-NP,753,1,5354,1,6,5362,T
5-NP,754,0,10,5355,0,5365,G
5-NP,755,5351,2,0,0,5353,A
5-NP,756,0,13,5413,0,5426,G
5-NP,757,5433,1,1,0,5435,A
5-NP,758,0,5429,1,1,5431,T
5-NP,759,17,2,0,5346,5365,C
5-NP,760,3,10,5376,0,5389,G
5-NP,761,5380,1,0,0,5381,A
5-NP,762,5385,1,1,0,5387,A
5-NP,763,0,5,5393,1,5399,G
5-NP,764,5380,0,0,0,5380,A
5-NP,765,0,5347,0,2,5349,T
5-NP,766,10,0,0,5382,5392,C
5-NP,767,1,5377,1,5,5384,T
5-NP,768,18,0,0,5440,5458,C
5-NP,769,5475,1,1,0,5477,A
5-NP,770,2,5468,0,0,5470,T
5-NP,771,5483,1,1,1,5486,A
5-NP,772,5,5468,1,2,5476,T
5-NP,773,0,5437,1,4,5442,T
5-NP,774,0,5427,1,0,5428,T
5-NP,775,0,5386,1,1,5388,T
5-NP,776,0,5398,0,0,5398,T
5-NP,777,5409,0,1,0,5410,A
5-NP,778,0,3,5407,1,5411,G
5-NP,779,2,0,0,5402,5404,C
5-NP,780,5393,1,1,0,5395,A
5-NP,781,5364,2,2,0,5368,A
5-NP,782,2,7,5536,0,5545,G
5-NP,783,5550,0,0,0,5550,A
5-NP,784,2,5546,0,1,5549,T
5-NP,785,8,3,0,5571,5582,C
5-NP,786,0,5551,0,2,5553,T
5-NP,787,1,2,5710,0,5713,G
5-NP,788,1,3,0,5708,5712,C
5-NP,789,5734,0,1,0,5735,A
5-NP,790,1,5778,0,3,5782,T
5-NP,791,0,5623,0,1,5624,T
5-NP,792,4,10,5976,0,5990,G
5-NP,793,6096,0,3,0,6099,A
5-NP,794,1,6086,0,1,6088,T
5-NP,795,6110,0,1,0,6111,A
5-NP,796,0,5995,0,1,5996,T
5-NP,797,4,5935,0,1,5940,T
5-NP,798,3,17,5951,0,5971,G
5-NP,799,5890,1,6,0,5897,A
5-NP,800,0,10,5940,0,5950,G
5-NP,801,5667,1,3,0,5671,A
5-NP,802,1,12,5581,0,5594,G
5-NP,803,0,13,5658,1,5672,G
5-NP,804,5669,2,3,0,5674,A
5-NP,805,1,5671,0,2,5674,T
5-NP,806,9,1,0,5670,5680,C
5-NP,807,5659,0,1,0,5660,A
5-NP,808,0,1,5686,0,5687,G
5-NP,809,0,5664,0,4,5668,T
5-NP,810,2,5625,0,3,5630,T
5-NP,811,1,3,5643,0,5647,G
5-NP,812,3,1,0,5614,5618,C
5-NP,813,1,5602,0,8,5611,T
5-NP,814,25,2,1,5617,5645,C
5-NP,815,5643,1,1,0,5645,A
5-NP,816,2,1,0,5647,5650,C
5-NP,817,5639,1,0,0,5640,A
5-NP,818,5682,0,0,0,5682,A
5-NP,819,5694,2,0,1,5697,A
5-NP,820,1,5686,1,0,5688,T
5-NP,821,13,1,0,5681,5695,C
5-NP,822,2,5687,0,1,5690,T
5-NP,823,0,5675,1,3,5679,T
5-NP,824,0,2,5705,0,5707,G
5-NP,825,3,2,1,5703,5709,C
5-NP,826,6,1,0,5800,5807,C
5-NP,827,2,5787,0,2,5791,T
5-NP,828,5815,2,2,1,5820,A
5-NP,829,4,1,1,5803,5809,C
5-NP,830,7,1,0,5809,5817,C
5-NP,831,2,5793,2,7,5804,T
5-NP,832,1,2,5887,0,5890,G
5-NP,833,7,1,0,5856,5864,C
5-NP,834,7,0,0,5877,5884,C
5-NP,835,0,5777,0,7,5784,T
5-NP,836,1,3,5866,0,5870,G
5-NP,837,0,5825,1,5,5831,T
5-NP,838,2,4,5877,1,5884,G
5-NP,839,9,1,1,5911,5922,C
5-NP,840,3,6,6002,0,6011,G
5-NP,841,1,5909,2,1,5913,T
5-NP,842,5889,0,2,1,5892,A
5-NP,843,0,5903,0,2,5905,T
5-NP,844,1,12,5893,1,5907,G
5-NP,845,2,12,6105,0,6119,G
5-NP,846,6093,2,4,0,6099,A
5-NP,847,5,3,0,5980,5988,C
5-NP,848,9,0,0,5977,5986,C
5-NP,849,4,5884,1,4,5893,T
5-NP,850,0,0,6164,0,6164,G
5-NP,851,4,7,5,6150,6166,C
5-NP,852,6167,0,7,0,6174,A
5-NP,853,1,1,6286,0,6288,G
5-NP,854,0,5994,0,0,5994,T
5-NP,855,6187,0,0,0,6187,A
5-NP,856,2,6163,0,6,6171,T
5-NP,857,6,0,1,6138,6145,C
5-NP,858,8,2,1,6146,6157,C
5-NP,859,5885,0,1,0,5886,A
5-NP,860,2,1,5917,0,5920,G
5-NP,861,0,5880,0,1,5881,T
5-NP,862,1,14,5894,0,5909,G
5-NP,863,4,15,5878,0,5897,G
5-NP,864,2,5,5800,0,5807,G
5-NP,865,1,5801,1,5,5808,T
5-NP,866,5795,0,2,1,5798,A
5-NP,867,3,3,0,5781,5787,C
5-NP,868,2,36,5731,0,5769,G
5-NP,869,5734,2,1,0,5737,A
5-NP,870,1,1,0,5743,5745,C
5-NP,871,0,5550,2,2,5554,T
5-NP,872,0,5566,0,3,5569,T
5-NP,873,12,6,0,5537,5555,C
5-NP,874,5,17,5539,0,5561,G
5-NP,875,5557,2,1,1,5561,A
5-NP,876,5552,0,2,1,5555,A
5-NP,877,5568,0,4,1,5573,A
5-NP,878,5563,1,0,0,5564,A
5-NP,879,5553,1,4,0,5558,A
5-NP,880,2,6,5582,0,5590,G
5-NP,881,5562,0,8,1,5571,A
5-NP,882,1,5,5616,0,5622,G
5-NP,883,2,7,5643,1,5653,G
5-NP,884,0,14,5650,0,5664,G
5-NP,885,5681,1,2,0,5684,A
5-NP,886,0,5678,1,2,5681,T
5-NP,887,5727,0,1,1,5729,A
5-NP,888,0,5716,0,3,5719,T
5-NP,889,0,5744,0,1,5745,T
5-NP,890,14,2,0,5771,5787,C
5-NP,891,5,0,0,5739,5744,C
5-NP,892,0,5668,1,0,5669,T
5-NP,893,1,5662,0,0,5663,T
5-NP,894,5,11,5690,1,5707,G
5-NP,895,0,1,5731,0,5732,G
5-NP,896,1,5693,0,3,5697,T
5-NP,897,3,5,5653,0,5661,G
5-NP,898,2,8,5638,0,5648,G
5-NP,899,3,12,5882,0,5897,G
5-NP,900,5897,0,0,0,5897,A
5-NP,901,5902,0,1,0,5903,A
5-NP,902,1,5896,1,1,5899,T
5-NP,903,5796,1,3,0,5800,A
5-NP,904,3,9,5792,0,5804,G
5-NP,905,5745,0,8,0,5753,A
5-NP,906,4,2,0,5736,5742,C
5-NP,907,7,2,0,5692,5701,C
5-NP,908,14,1,0,5523,5538,C
5-NP,909,1,5586,0,12,5599,T
5-NP,910,0,5594,0,10,5604,T
5-NP,911,0,5603,0,6,5609,T
5-NP,912,18,0,0,5599,5617,C
5-NP,913,5601,0,0,0,5601,A
5-NP,914,5598,1,0,0,5599,A
5-NP,915,5573,0,4,1,5578,A
5-NP,916,2,0,0,5586,5588,C
5-NP,917,2,5453,1,1,5457,T
5-NP,918,5422,1,0,0,5423,A
5-NP,919,1,1,0,5480,5482,C
5-NP,920,1,5459,2,2,5464,T
5-NP,921,0,5455,0,4,5459,T
5-NP,922,7,2,0,5469,5478,C
5-NP,923,5460,0,3,1,5464,A
5-NP,924,5465,0,1,0,5466,A
5-NP,925,5460,1,1,0,5462,A
5-NP,926,5460,0,1,0,5461,A
5-NP,927,0,5412,1,0,5413,T
5-NP,928,5323,1,3,1,5328,A
5-NP,929,0,1,5396,0,5397,G
5-NP,930,1,1,0,5409,5411,C
5-NP,931,6,0,0,5472,5478,C
5-NP,932,5471,0,4,0,5475,A
5-NP,933,5494,1,1,0,5496,A
5-NP,934,5660,0,4,0,5664,A
5-NP,935,1,5676,0,0,5677,T
5-NP,936,5704,2,1,0,5707,A
5-NP,937,0,5696,0,3,5699,T
5-NP,938,5607,2,7,0,5616,A
5-NP,939,4,4,0,5620,5628,C
5-NP,940,5475,1,3,1,5480,A
5-NP,941,2,1,5613,0,5616,G
5-NP,942,0,1,0,5596,5597,C
5-NP,943,0,5423,0,5,5428,T
5-NP,944,1,5479,0,2,5482,T
5-NP,945,5515,0,2,0,5517,A
5-NP,946,5521,1,0,0,5522,A
5-NP,947,0,5525,0,1,5526,T
5-NP,948,16,2,0,5505,5523,C
5-NP,949,5353,0,3,1,5357,A
5-NP,950,5,16,5391,0,5412,G
5-NP,951,5415,1,1,0,5417,A
5-NP,952,2,2,2,5435,5441,C
5-NP,953,8,2,1,5391,5402,C
5-NP,954,1,5328,0,2,5331,T
5-NP,955,5372,0,3,0,5375,A
5-NP,956,5379,1,0,0,5380,A
5-NP,957,1,2,1,5395,5399,C
5-NP,958,0,10,5383,0,5393,G
5-NP,959,5298,2,3,0,5303,A
5-NP,960,1,14,5296,0,5311,G
5-NP,961,5249,1,1,0,5251,A
5-NP,962,5303,0,0,0,5303,A
5-NP,963,1,5298,1,3,5303,T
5-NP,964,9,2,3,5257,5271,C
5-NP,965,6,3,0,5262,5271,C
5-NP,966,5182,2,5,0,5189,A
5-NP,967,0,1,5224,0,5225,G
5-NP,968,3,2,0,5218,5223,C
5-NP,969,5262,0,7,1,5270,A
5-NP,970,2,1,1,5296,5300,C
5-NP,971,5226,1,0,0,5227,A
5-NP,972,4,0,1,5239,5244,C
5-NP,973,5214,0,2,0,5216,A
5-NP,974,5230,0,5,0,5235,A
5-NP,975,0,18,5232,0,5250,G
5-NP,976,5196,1,3,0,5200,A
5-NP,977,2,2,5221,1,5226,G
5-NP,978,1,5142,0,1,5144,T
5-NP,979,22,0,0,5117,5139,C
5-NP,980,5134,1,6,0,5141,A
5-NP,981,1,1,5138,0,5140,G
5-NP,982,1,0,1,5134,5136,C
5-NP,983,0,5087,0,3,5090,T
5-NP,984,2,9,5136,2,5149,G
5-NP,985,1,5,5169,0,5175,G
5-NP,986,5,5126,0,2,5133,T
5-NP,987,2,3,5151,0,5156,G
5-NP,988,0,5109,0,0,5109,T
5-NP,989,1,20,5092,0,5113,G
5-NP,990,0,10,5098,0,5108,G
5-NP,991,5065,0,2,0,5067,A
5-NP,992,2,5078,0,0,5080,T
5-NP,993,3,17,4875,0,4895,G
5-NP,994,0,3,4886,0,4889,G
5-NP,995,3,1,0,4877,4881,C
5-NP,996,4851,0,4,1,4856,A
5-NP,997,0,4855,0,1,4856,T
5-NP,998,3,1,4830,0,4834,G
5-NP,999,2,6,0,4867,4875,C
5-NP,1000,5,1,0,4861,4867,C
5-NP,1001,4899,0,0,0,4899,A
5-NP,1002,0,4878,0,3,4881,T
5-NP,1003,0,4814,1,1,4816,T
5-NP,1004,9,0,1,4813,4823,C
5-NP,1005,1,4769,1,3,4774,T
5-NP,1006,1,1,4782,0,4784,G
5-NP,1007,1,0,1,4771,4773,C
5-NP,1008,2,4666,0,2,4670,T
5-NP,1009,7,2,4696,2,4707,G
5-NP,1010,1,1,0,4663,4665,C
5-NP,1011,4670,0,2,0,4672,A
5-NP,1012,0,4678,1,1,4680,T
5-NP,1013,1,4632,0,1,4634,T
5-NP,1014,0,4635,0,0,4635,T
5-NP,1015,1,7,4621,0,4629,G
5-NP,1016,4622,2,1,1,4626,A
5-NP,1017,4622,1,1,0,4624,A
5-NP,1018,1,13,4623,0,4637,G
5-NP,1019,4622,0,2,0,4624,A
5-NP,1020,1,4586,0,1,4588,T
5-NP,1021,1,4581,0,1,4583,T
5-NP,1022,1,4589,0,0,4590,T
5-NP,1023,4583,2,0,2,4587,A
5-NP,1024,4598,0,2,0,4600,A
5-NP,1025,0,9,4589,0,4598,G
5-NP,1026,4589,1,0,0,4590,A
5-NP,1027,0,4571,1,1,4573,T
5-NP,1028,1,4472,0,3,4476,T
5-NP,1029,3,0,4509,0,4512,G
5-NP,1030,0,4502,0,4,4506,T
5-NP,1031,1,4502,0,1,4504,T
5-NP,1032,4496,2,1,1,4500,A
5-NP,1033,4514,0,3,0,4517,A
5-NP,1034,6,3,4509,0,4518,G
5-NP,1035,2,1,0,4519,4522,C
5-NP,1036,0,4423,0,9,4432,T
5-NP,1037,1,4439,0,3,4443,T
5-NP,1038,13,1,0,4456,4470,C
5-NP,1039,4461,0,4,1,4466,A
5-NP,1040,2,4464,0,3,4469,T
5-NP,1041,7,0,0,4469,4476,C
5-NP,1042,4389,0,3,1,4393,A
5-NP,1043,4,3,4385,0,4392,G
5-NP,1044,4327,0,6,1,4334,A
5-NP,1045,0,7,4337,2,4346,G
5-NP,1046,1,10,4304,0,4315,G
5-NP,1047,5,14,4263,0,4282,G
5-NP,1048,4279,1,3,0,4283,A
5-NP,1049,7,3,0,4271,4281,C
5-NP,1050,4271,0,0,0,4271,A
5-NP,1051,4283,0,0,0,4283,A
5-NP,1052,4284,2,2,0,4288,A
5-NP,1053,4279,0,12,0,4291,A
5-NP,1054,2,3,4305,0,4310,G
5-NP,1055,1,4207,0,2,4210,T
5-NP,1056,4188,0,0,0,4188,A
5-NP,1057,1,4158,2,2,4163,T
5-NP,1058,9,0,0,4132,4141,C
5-NP,1059,1,4114,0,5,4120,T
5-NP,1060,17,0,0,4120,4137,C
5-NP,1061,7,1,1,4096,4105,C
5-NP,1062,0,4065,1,2,4068,T
5-NP,1063,10,1,2,4042,4055,C
5-NP,1064,3,3,4042,1,4049,G
5-NP,1065,0,6,4062,0,4068,G
5-NP,1066,1,7,4058,1,4067,G
5-NP,1067,1,6,4052,0,4059,G
5-NP,1068,5,7,4039,1,4052,G
5-NP,1069,3973,1,1,1,3976,A
5-NP,1070,3971,0,3,0,3974,A
5-NP,1071,3974,2,2,0,3978,A
5-NP,1072,2,0,0,3996,3998,C
5-NP,1073,0,3971,1,1,3973,T
5-NP,1074,2,4,3991,0,3997,G
5-NP,1075,2,3958,0,3,3963,T
5-NP,1076,25,0,1,3937,3963,C
5-NP,1077,4007,0,5,2,4014,A
5-NP,1078,4031,0,2,1,4034,A
5-NP,1079,4,0,0,4044,4048,C
5-NP,1080,2,4029,1,1,4033,T
5-NP,1081,3943,0,3,0,3946,A
5-NP,1082,0,3,3960,0,3963,G
5-NP,1083,3880,0,3,0,3883,A
5-NP,1084,1,4,3886,0,3891,G
5-NP,1085,0,8,3875,0,3883,G
5-NP,1086,3664,1,7,1,3673,A
5-NP,1087,0,2,3740,0,3742,G
5-NP,1088,0,3695,0,1,3696,T
5-NP,1089,3693,0,2,2,3697,A
5-NP,1090,3,1,0,3691,3695,C
5-NP,1091,3636,1,0,0,3637,A
5-NP,1092,3637,1,1,0,3639,A
5-NP,1093,3593,0,0,1,3594,A
5-NP,1094,0,3545,1,1,3547,T
5-NP,1095,0,3518,0,0,3518,T
5-NP,1096,0,0,3422,0,3422,G
5-NP,1097,0,1,0,3368,3369,C
5-NP,1098,0,3358,0,3,3361,T
5-NP,1099,1,3344,0,2,3347,T
5-NP,1100,7,2,0,3346,3355,C
5-NP,1101,3353,1,2,0,3356,A
5-NP,1102,3361,0,1,0,3362,A
5-NP,1103,3354,1,1,0,3356,A
5-NP,1104,0,3358,0,0,3358,T
5-NP,1105,0,5,3356,0,3361,G
5-NP,1106,3303,1,3,2,3309,A
5-NP,1107,1,12,3302,1,3316,G
5-NP,1108,3323,0,1,0,3324,A
5-NP,1109,3315,0,1,0,3316,A
5-NP,1110,3,1,0,3317,3321,C
5-NP,1111,3275,0,2,0,3277,A
5-NP,1112,0,3272,0,3,3275,T
5-NP,1113,1,2,3294,0,3297,G
5-NP,1114,2,3,3300,1,3306,G
5-NP,1115,3300,1,2,0,3303,A
5-NP,1116,0,3230,1,1,3232,T
5-NP,1117,3168,0,0,1,3169,A
5-NP,1118,3268,0,1,1,3270,A
5-NP,1119,0,3190,1,2,3193,T
5-NP,1120,3167,1,0,0,3168,A
5-NP,1121,1,3148,1,2,3152,T
5-NP,1122,3,6,2872,0,2881,G
5-NP,1123,2,4,2796,0,2802,G
5-NP,1124,2,6,2784,1,2793,G
5-NP,1125,2778,0,0,0,2778,A
5-NP,1126,0,2772,0,0,2772,T
5-NP,1127,4,1,0,2097,2102,C
5-NP,1128,1,6,2093,0,2100,G
5-NP,1129,2085,2,4,0,2091,A
5-NP,1130,0,1,2090,0,2091,G
5-NP,1131,0,1,0,2086,2087,C
5-NP,1132,2063,1,0,0,2064,A
5-NP,1133,0,0,0,2114,2114,C
5-NP,1134,0,2066,0,2,2068,T
5-NP,1135,5,0,0,2083,2088,C
5-NP,1136,1,2080,0,0,2081,T
5-NP,1137,1,2046,0,0,2047,T
5-NP,1138,1,10,2037,0,2048,G
5-NP,1139,2042,0,0,0,2042,A
5-NP,1140,2045,0,0,0,2045,A
5-NP,1141,0,1499,0,2,1501,T
5-NP,1142,0,1511,0,0,1511,T
5-NP,1143,1,3,1509,0,1513,G
5-NP,1144,1507,0,2,0,1509,A
5-NP,1145,1,1,1510,0,1512,G
5-NP,1146,1505,1,0,1,1507,A
5-NP,1147,1469,0,0,0,1469,A
5-NP,1148,0,1,1472,0,1473,G
5-NP,1149,1,0,0,1417,1418,C
5-NP,1150,0,0,1418,0,1418,G
5-NP,1151,1,2,1414,0,1417,G
5-NP,1152,0,0,1410,0,1410,G
5-NP,1153,0,1407,0,1,1408,T
5-NP,1154,1381,0,0,0,1381,A
5-NP,1155,0,0,0,1379,1379,C
5-NP,1156,0,1067,0,1,1068,T
5-NP,1157,2,1,1038,0,1041,G
5-NP,1158,0,2,1012,0,1014,G
5-NP,1159,0,0,988,0,988,G
5-NP,1160,0,0,1,972,973,C
5-NP,1161,1,0,0,883,884,C
5-NP,1162,887,0,1,0,888,A
5-NP,1163,0,888,0,0,888,T
5-NP,1164,885,0,0,0,885,A
5-NP,1165,888,0,0,0,888,A
5-NP,1166,0,0,883,0,883,G
5-NP,1167,0,7,893,0,900,G
5-NP,1168,879,0,0,0,879,A
5-NP,1169,0,1,0,886,887,C
5-NP,1170,2,0,0,883,885,C
5-NP,1171,878,0,1,0,879,A
5-NP,1172,0,1,894,0,895,G
5-NP,1173,0,1,899,0,900,G
5-NP,1174,896,0,0,0,896,A
5-NP,1175,0,0,901,0,901,G
5-NP,1176,0,866,0,0,866,T
5-NP,1177,0,1,862,0,863,G
5-NP,1178,0,1,868,0,869,G
5-NP,1179,868,0,1,0,869,A
5-NP,1180,0,2,872,0,874,G
5-NP,1181,0,1,857,0,858,G
5-NP,1182,856,0,0,0,856,A
5-NP,1183,851,0,1,0,852,A
5-NP,1184,852,1,0,0,853,A
5-NP,1185,0,0,0,855,855,C
5-NP,1186,853,1,3,0,857,A
5-NP,1187,1,0,0,871,872,C
5-NP,1188,0,858,0,0,858,T
5-NP,1189,882,0,0,0,882,A
5-NP,1190,880,0,0,0,880,A
5-NP,1191,1,879,0,1,881,T
5-NP,1192,4,0,0,884,888,C
5-NP,1193,880,0,1,0,881,A
5-NP,1194,884,0,1,0,885,A
5-NP,1195,3,0,1,878,882,C
5-NP,1196,861,1,1,0,863,A
5-NP,1197,0,0,867,0,867,G
5-NP,1198,838,0,0,0,838,A
5-NP,1199,0,0,842,0,842,G
5-NP,1200,0,0,844,0,844,G
5-NP,1201,1,0,844,0,845,G
5-NP,1202,1,3,0,838,842,C
5-NP,1203,1,0,0,837,838,C
5-NP,1204,0,826,0,0,826,T
5-NP,1205,1,0,0,835,836,C
5-NP,1206,0,1,0,836,837,C
5-NP,1207,0,0,839,0,839,G
5-NP,1208,0,0,0,835,835,C
5-NP,1209,822,0,0,0,822,A
5-NP,1210,0,0,848,0,848,G
5-NP,1211,0,0,850,0,850,G
5-NP,1212,0,2,0,851,853,C
5-NP,1213,2,0,0,852,854,C
5-NP,1214,848,0,0,0,848,A
5-NP,1215,857,0,0,0,857,A
5-NP,1216,857,0,0,0,857,A
5-NP,1217,0,0,0,860,860,C
5-NP,1218,1,0,0,859,860,C
5-NP,1219,802,0,0,0,802,A
5-NP,1220,0,1,812,0,813,G
5-NP,1221,0,806,0,0,806,T
5-NP,1222,0,0,811,0,811,G
5-NP,1223,0,812,0,2,814,T
5-NP,1224,0,0,811,0,811,G
5-NP,1225,0,0,0,811,811,C
5-NP,1226,796,1,2,0,799,A
5-NP,1227,815,0,0,0,815,A
5-NP,1228,0,0,0,814,814,C
5-NP,1229,0,2,1,814,817,C
5-NP,1230,1,820,0,0,821,T
5-NP,1231,812,1,0,0,813,A
5-NP,1232,0,0,0,812,812,C
5-NP,1233,0,1,815,0,816,G
5-NP,1234,0,806,0,0,806,T
5-NP,1235,0,817,0,1,818,T
5-NP,1236,0,804,0,0,804,T
5-NP,1237,0,799,0,0,799,T
5-NP,1238,0,0,0,796,796,C
5-NP,1239,0,792,0,0,792,T
5-NP,1240,2,1,809,0,812,G
5-NP,1241,2,810,0,0,812,T
5-NP,1242,812,0,0,0,812,A
5-NP,1243,1,0,0,814,815,C
5-NP,1244,800,0,0,0,800,A
5-NP,1245,799,0,1,0,800,A
5-NP,1246,797,0,0,0,797,A
5-NP,1247,0,2,802,0,804,G
5-NP,1248,801,0,0,0,801,A
5-NP,1249,769,0,0,1,770,A
5-NP,1250,772,0,1,0,773,A
5-NP,1251,0,0,0,771,771,C
5-NP,1252,0,0,0,764,764,C
5-NP,1253,0,757,0,1,758,T
5-NP,1254,2,0,0,753,755,C
5-NP,1255,0,1,0,758,759,C
5-NP,1256,3,0,0,762,765,C
5-NP,1257,766,1,0,0,767,A
5-NP,1258,1,778,0,0,779,T
5-NP,1259,0,778,0,0,778,T
5-NP,1260,0,776,0,0,776,T
5-NP,1261,0,2,770,0,772,G
5-NP,1262,775,0,0,0,775,A
5-NP,1263,771,0,0,0,771,A
5-NP,1264,772,0,0,0,772,A
5-NP,1265,766,0,1,0,767,A
5-NP,1266,0,0,782,0,782,G
5-NP,1267,0,779,0,0,779,T
5-NP,1268,5,0,0,773,778,C
5-NP,1269,778,1,0,0,779,A
5-NP,1270,783,0,1,0,784,A
5-NP,1271,0,0,0,783,783,C
5-NP,1272,2,0,0,788,790,C
5-NP,1273,793,0,0,0,793,A
5-NP,1274,0,801,0,0,801,T
5-NP,1275,1,0,0,792,793,C
5-NP,1276,787,0,0,0,787,A
5-NP,1277,0,796,0,0,796,T
5-NP,1278,0,3,793,0,796,G
5-NP,1279,1,0,793,0,794,G
5-NP,1280,0,1,0,794,795,C
5-NP,1281,763,0,2,0,765,A
5-NP,1282,0,0,767,0,767,G
5-NP,1283,0,0,0,763,763,C
5-NP,1284,765,0,0,1,766,A
5-NP,1285,0,766,0,0,766,T
5-NP,1286,0,759,0,0,759,T
5-NP,1287,2,0,0,762,764,C
5-NP,1288,758,0,0,0,758,A
5-NP,1289,0,0,0,768,768,C
5-NP,1290,0,766,0,1,767,T
5-NP,1291,1,4,768,0,773,G
5-NP,1292,0,1,775,0,776,G
5-NP,1293,775,0,0,0,775,A
5-NP,1294,777,0,0,0,777,A
5-NP,1295,782,0,0,0,782,A
5-NP,1296,0,769,1,0,770,T
5-NP,1297,771,0,0,0,771,A
5-NP,1298,0,0,0,767,767,C
5-NP,1299,1,0,757,0,758,G
5-NP,1300,0,1,758,0,759,G
5-NP,1301,735,0,0,0,735,A
5-NP,1302,1,0,741,0,742,G
5-NP,1303,0,0,742,0,742,G
5-NP,1304,1,1,742,0,744,G
5-NP,1305,744,0,0,0,744,A
5-NP,1306,742,0,1,0,743,A
5-NP,1307,0,4,741,0,745,G
5-NP,1308,744,0,0,0,744,A
5-NP,1309,742,0,0,0,742,A
5-NP,1310,1,0,0,746,747,C
5-NP,1311,0,737,0,1,738,T
5-NP,1312,0,738,0,0,738,T
5-NP,1313,0,0,0,735,735,C
5-NP,1314,738,0,2,0,740,A
5-NP,1315,0,1,741,0,742,G
5-NP,1316,737,0,0,0,737,A
5-NP,1317,1,0,0,740,741,C
5-NP,1318,729,0,0,0,729,A
5-NP,1319,0,704,0,0,704,T
5-NP,1320,2,2,703,0,707,G
5-NP,1321,700,0,0,0,700,A
5-NP,1322,0,2,702,0,704,G
5-NP,1323,0,0,702,0,702,G
5-NP,1324,0,0,703,0,703,G
5-NP,1325,3,0,0,700,703,C
5-NP,1326,699,0,0,0,699,A
5-NP,1327,0,3,695,0,698,G
5-NP,1328,694,0,0,0,694,A
5-NP,1329,699,0,1,0,700,A
5-NP,1330,700,0,0,0,700,A
5-NP,1331,0,692,0,0,692,T
5-NP,1332,5,0,0,698,703,C
5-NP,1333,702,0,0,0,702,A
5-NP,1334,0,699,0,0,699,T
5-NP,1335,701,0,0,0,701,A
5-NP,1336,696,0,0,0,696,A
5-NP,1337,0,0,704,0,704,G
5-NP,1338,697,0,0,0,697,A
5-NP,1339,703,0,0,0,703,A
5-NP,1340,1,690,0,0,691,T
5-NP,1341,0,1,694,0,695,G
5-NP,1342,696,0,0,0,696,A
5-NP,1343,0,695,0,1,696,T
5-NP,1344,0,2,694,0,696,G
5-NP,1345,0,1,694,0,695,G
5-NP,1346,678,0,0,0,678,A
5-NP,1347,672,0,0,0,672,A
5-NP,1348,0,1,653,0,654,G
5-NP,1349,0,0,660,0,660,G
5-NP,1350,0,649,0,0,649,T
5-NP,1351,2,0,647,0,649,G
5-NP,1352,1,0,0,644,645,C
5-NP,1353,646,0,0,0,646,A
5-NP,1354,648,0,0,0,648,A
5-NP,1355,644,0,0,0,644,A
5-NP,1356,649,0,0,0,649,A
5-NP,1357,0,1,0,648,649,C
5-NP,1358,0,0,0,641,641,C
5-NP,1359,627,0,0,0,627,A
5-NP,1360,0,2,633,0,635,G
5-NP,1361,634,0,0,0,634,A
5-NP,1362,634,0,0,0,634,A
5-NP,1363,0,4,627,0,631,G
5-NP,1364,626,0,1,0,627,A
5-NP,1365,614,0,3,0,617,A
5-NP,1366,0,1,621,0,622,G
5-NP,1367,0,617,0,1,618,T
5-NP,1368,0,1,618,0,619,G
5-NP,1369,0,611,0,0,611,T
5-NP,1370,4,0,0,608,612,C
5-NP,1371,613,0,0,0,613,A
5-NP,1372,0,617,0,2,619,T
5-NP,1373,0,615,0,0,615,T
5-NP,1374,0,0,0,615,615,C
5-NP,1375,1,0,0,598,599,C
5-NP,1376,1,0,596,0,597,G
5-NP,1377,0,1,590,0,591,G
5-NP,1378,1,0,596,0,597,G
5-NP,1379,1,0,596,0,597,G
5-NP,1380,0,1,593,0,594,G
5-NP,1381,559,0,0,0,559,A
5-NP,1382,0,0,564,0,564,G
5-NP,1383,0,0,562,0,562,G
5-NP,1384,0,0,561,0,561,G
5-NP,1385,0,5,558,1,564,G
5-NP,1386,558,0,0,0,558,A
5-NP,1387,2,0,563,1,566,G
5-NP,1388,0,557,1,0,558,T
5-NP,1389,0,557,0,0,557,T
5-NP,1390,0,559,0,0,559,T
5-NP,1391,1,555,0,1,557,T
5-NP,1392,2,0,0,549,551,C
5-NP,1393,0,4,548,0,552,G
5-NP,1394,546,2,1,0,549,A
5-NP,1395,0,0,670,0,670,G
5-NP,1396,0,0,0,665,665,C
5-NP,1397,0,668,0,2,670,T
5-NP,1398,1,0,0,683,684,C
5-NP,1399,0,679,0,1,680,T
5-NP,1400,4,0,0,690,694,C
5-NP,1401,696,0,0,1,697,A
5-NP,1402,1,3,713,0,717,G
5-NP,1403,714,0,0,0,714,A
5-NP,1404,0,0,0,727,727,C
5-NP,1405,0,2,723,0,725,G
5-NP,1406,721,0,1,0,722,A
5-NP,1407,0,2,719,0,721,G
5-NP,1408,709,0,0,0,709,A
5-NP,1409,709,0,0,0,709,A
5-NP,1410,0,2,706,0,708,G
5-NP,1411,1,1,706,0,708,G
5-NP,1412,0,1,1,716,718,C
5-NP,1413,711,0,0,0,711,A
5-NP,1414,711,0,0,0,711,A
5-NP,1415,0,0,0,709,709,C
5-NP,1416,1,3,711,0,715,G
5-NP,1417,723,0,0,0,723,A
5-NP,1418,724,0,1,0,725,A
5-NP,1419,1,0,0,725,726,C
5-NP,1420,1,0,0,720,721,C
5-NP,1421,2,0,1,720,723,C
5-NP,1422,0,3,719,0,722,G
5-NP,1423,721,0,0,0,721,A
5-NP,1424,0,726,0,0,726,T
5-NP,1425,4,0,0,712,716,C
5-NP,1426,0,1,727,0,728,G
5-NP,1427,0,722,0,0,722,T
5-NP,1428,0,0,728,0,728,G
5-NP,1429,0,0,0,722,722,C
5-NP,1430,1,9,0,713,723,C
5-NP,1431,0,1,0,728,729,C
5-NP,1432,0,715,1,1,717,T
5-NP,1433,0,0,0,795,795,C
5-NP,1434,0,797,0,0,797,T
5-NP,1435,0,799,1,0,800,T
5-NP,1436,0,799,0,0,799,T
5-NP,1437,1,789,0,1,791,T
5-NP,1438,0,3,798,0,801,G
5-NP,1439,801,0,0,0,801,A
5-NP,1440,0,795,0,1,796,T
5-NP,1441,790,1,0,0,791,A
5-NP,1442,0,697,0,0,697,T
5-NP,1443,0,5,724,0,729,G
5-NP,1444,728,0,0,0,728,A
5-NP,1445,0,0,752,0,752,G
5-NP,1446,0,746,0,0,746,T
5-NP,1447,738,0,0,0,738,A
5-NP,1448,738,0,0,0,738,A
5-NP,1449,0,740,0,0,740,T
5-NP,1450,0,2,738,0,740,G
5-NP,1451,736,0,0,0,736,A
5-NP,1452,681,0,0,0,681,A
5-NP,1453,0,1,682,0,683,G
5-NP,1454,0,1,648,1,650,G
5-NP,1455,653,0,0,0,653,A
5-NP,1456,0,655,0,0,655,T
5-NP,1457,2,0,0,651,653,C
5-NP,1458,0,645,0,3,648,T
5-NP,1459,0,649,0,0,649,T
5-NP,1460,647,0,0,2,649,A
5-NP,1461,0,647,0,0,647,T
5-NP,1462,0,641,0,0,641,T
5-NP,1463,1,631,0,1,633,T
5-NP,1464,1,1,0,619,621,C
5-NP,1465,0,609,0,0,609,T
5-NP,1466,0,609,0,0,609,T
5-NP,1467,2,0,0,610,612,C
5-NP,1468,0,0,606,0,606,G
5-NP,1469,0,0,607,0,607,G
5-NP,1470,603,1,0,0,604,A
5-NP,1471,0,1,604,1,606,G
5-NP,1472,601,1,2,0,604,A
5-NP,1473,0,2,0,599,601,C
5-NP,1474,579,0,0,0,579,A
5-NP,1475,578,0,1,0,579,A
5-NP,1476,0,578,0,0,578,T
5-NP,1477,0,0,577,0,577,G
5-NP,1478,0,0,0,576,576,C
5-NP,1479,558,0,0,0,558,A
5-NP,1480,0,1,556,0,557,G
5-NP,1481,554,0,1,0,555,A
5-NP,1482,527,0,0,0,527,A
5-NP,1483,0,0,525,0,525,G
5-NP,1484,382,0,0,0,382,A
5-NP,1485,0,0,381,0,381,G
5-NP,1486,0,346,0,1,347,T
5-NP,1487,345,1,1,0,347,A
5-NP,1488,0,0,0,346,346,C
5-NP,1489,0,0,323,0,323,G
5-NP,1490,323,0,0,0,323,A
5-NP,1491,0,0,0,318,318,C
5-NP,1492,254,0,0,0,254,A
5-NP,1493,254,0,0,0,254,A
5-NP,1494,0,211,0,0,211,T
5-NP,1495,0,209,0,0,209,T
5-NP,1496,209,0,0,0,209,A
5-NP,1497,197,0,0,0,197,A
6-NA,1,62,0,0,0,62,A
6-NA,2,0,62,0,0,62,T
6-NA,3,0,0,62,0,62,G
6-NA,4,63,0,0,1,64,A
6-NA,5,67,0,0,0,67,A
6-NA,6,0,67,0,0,67,T
6-NA,7,0,0,0,67,67,C
6-NA,8,1,0,0,66,67,C
6-NA,9,67,0,0,0,67,A
6-NA,10,68,0,0,0,68,A
6-NA,11,67,1,0,0,68,A
6-NA,12,0,68,0,0,68,T
6-NA,13,0,0,0,68,68,C
6-NA,14,67,0,0,0,67,A
6-NA,15,69,0,0,0,69,A
6-NA,16,69,0,0,0,69,A
6-NA,17,75,0,0,0,75,A
6-NA,18,0,0,80,0,80,G
6-NA,19,83,0,0,0,83,A
6-NA,20,0,83,0,0,83,T
6-NA,21,83,0,0,0,83,A
6-NA,22,86,0,0,0,86,A
6-NA,23,0,87,0,0,87,T
6-NA,24,87,0,0,0,87,A
6-NA,25,87,0,0,0,87,A
6-NA,26,0,1,0,90,91,C
6-NA,27,0,0,93,0,93,G
6-NA,28,93,0,0,0,93,A
6-NA,29,0,94,0,0,94,T
6-NA,30,0,93,0,0,93,T
6-NA,31,0,0,94,0,94,G
6-NA,32,0,0,98,0,98,G
6-NA,33,0,0,0,97,97,C
6-NA,34,0,98,0,0,98,T
6-NA,35,0,0,0,103,103,C
6-NA,36,0,102,0,1,103,T
6-NA,37,0,0,106,0,106,G
6-NA,38,0,105,0,1,106,T
6-NA,39,0,108,0,0,108,T
6-NA,40,0,110,0,0,110,T
6-NA,41,0,0,0,110,110,C
6-NA,42,0,110,0,0,110,T
6-NA,43,1,0,0,110,111,C
6-NA,44,0,110,0,0,110,T
6-NA,45,0,0,0,112,112,C
6-NA,46,112,0,0,0,112,A
6-NA,47,0,0,0,118,118,C
6-NA,48,0,0,0,118,118,C
6-NA,49,118,0,0,0,118,A
6-NA,50,0,118,0,0,118,T
6-NA,51,0,123,0,0,123,T
6-NA,52,0,125,0,0,125,T
6-NA,53,0,0,0,129,129,C
6-NA,54,0,0,0,130,130,C
6-NA,55,129,0,1,0,130,A
6-NA,56,1,0,0,135,136,C
6-NA,57,136,0,0,0,136,A
6-NA,58,142,0,0,0,142,A
6-NA,59,0,141,0,0,141,T
6-NA,60,150,0,0,0,150,A
6-NA,61,0,152,0,0,152,T
6-NA,62,1,0,151,0,152,G
6-NA,63,0,0,0,154,154,C
6-NA,64,0,152,0,1,153,T
6-NA,65,0,157,0,0,157,T
6-NA,66,2,0,0,154,156,C
6-NA,67,0,158,0,0,158,T
6-NA,68,0,158,0,0,158,T
6-NA,69,1,0,0,154,155,C
6-NA,70,153,0,0,1,154,A
6-NA,71,0,154,0,0,154,T
6-NA,72,0,0,154,0,154,G
6-NA,73,0,0,0,156,156,C
6-NA,74,156,0,0,0,156,A
6-NA,75,157,0,0,0,157,A
6-NA,76,157,0,0,0,157,A
6-NA,77,0,158,0,0,158,T
6-NA,78,0,157,0,0,157,T
6-NA,79,1,0,156,0,157,G
6-NA,80,0,0,0,159,159,C
6-NA,81,0,0,0,159,159,C
6-NA,82,160,0,0,0,160,A
6-NA,83,0,160,0,0,160,T
6-NA,84,0,0,0,175,175,C
6-NA,85,0,175,1,0,176,T
6-NA,86,0,173,0,0,173,T
6-NA,87,0,1,181,0,182,G
6-NA,88,182,0,0,0,182,A
6-NA,89,0,183,0,1,184,T
6-NA,90,184,0,0,0,184,A
6-NA,91,184,0,0,0,184,A
6-NA,92,0,0,0,207,207,C
6-NA,93,0,206,0,0,206,T
6-NA,94,208,0,0,0,208,A
6-NA,95,0,0,0,217,217,C
6-NA,96,0,213,0,0,213,T
6-NA,97,0,0,220,0,220,G
6-NA,98,0,219,0,0,219,T
6-NA,99,220,0,0,0,220,A
6-NA,100,221,0,1,0,222,A
6-NA,101,0,0,0,220,220,C
6-NA,102,220,0,0,0,220,A
6-NA,103,0,222,0,0,222,T
6-NA,104,0,220,0,0,220,T
6-NA,105,0,0,220,0,220,G
6-NA,106,0,0,0,218,218,C
6-NA,107,221,0,0,0,221,A
6-NA,108,0,223,0,0,223,T
6-NA,109,0,221,0,0,221,T
6-NA,110,0,222,0,0,222,T
6-NA,111,1,0,0,221,222,C
6-NA,112,219,0,0,0,219,A
6-NA,113,220,0,0,0,220,A
6-NA,114,0,0,222,0,222,G
6-NA,115,0,0,0,223,223,C
6-NA,116,221,0,0,0,221,A
6-NA,117,230,0,0,0,230,A
6-NA,118,0,236,0,0,236,T
6-NA,119,238,0,0,0,238,A
6-NA,120,0,239,0,0,239,T
6-NA,121,0,1,238,0,239,G
6-NA,122,238,0,1,0,239,A
6-NA,123,249,0,0,0,249,A
6-NA,124,0,249,0,1,250,T
6-NA,125,0,250,0,0,250,T
6-NA,126,2,0,1,245,248,C
6-NA,127,247,0,0,0,247,A
6-NA,128,247,0,1,0,248,A
6-NA,129,0,0,0,248,248,C
6-NA,130,0,244,0,0,244,T
6-NA,131,1,0,0,242,243,C
6-NA,132,0,0,0,243,243,C
6-NA,133,0,0,0,255,255,C
6-NA,134,0,0,0,257,257,C
6-NA,135,0,0,0,255,255,C
6-NA,136,0,0,0,263,263,C
6-NA,137,1,0,0,263,264,C
6-NA,138,264,0,0,0,264,A
6-NA,139,263,0,0,0,263,A
6-NA,140,261,0,1,0,262,A
6-NA,141,0,0,0,265,265,C
6-NA,142,262,0,0,0,262,A
6-NA,143,262,0,2,0,264,A
6-NA,144,0,0,0,267,267,C
6-NA,145,1,0,0,265,266,C
6-NA,146,275,0,0,0,275,A
6-NA,147,272,0,0,0,272,A
6-NA,148,0,1,278,0,279,G
6-NA,149,0,279,0,0,279,T
6-NA,150,0,0,274,0,274,G
6-NA,151,280,0,0,0,280,A
6-NA,152,0,281,0,0,281,T
6-NA,153,0,0,281,0,281,G
6-NA,154,0,0,0,281,281,C
6-NA,155,0,279,0,0,279,T
6-NA,156,0,0,300,0,300,G
6-NA,157,0,296,0,0,296,T
6-NA,158,0,0,298,0,298,G
6-NA,159,0,297,0,0,297,T
6-NA,160,0,1,297,0,298,G
6-NA,161,297,0,1,0,298,A
6-NA,162,298,0,0,0,298,A
6-NA,163,0,0,0,300,300,C
6-NA,164,1,0,0,300,301,C
6-NA,165,294,0,0,0,294,A
6-NA,166,295,0,0,0,295,A
6-NA,167,0,0,0,305,305,C
6-NA,168,308,0,0,0,308,A
6-NA,169,312,0,0,0,312,A
6-NA,170,0,312,0,0,312,T
6-NA,171,307,0,6,0,313,A
6-NA,172,313,0,0,0,313,A
6-NA,173,0,315,0,0,315,T
6-NA,174,314,0,0,0,314,A
6-NA,175,0,0,317,0,317,G
6-NA,176,310,0,0,0,310,A
6-NA,177,311,0,0,0,311,A
6-NA,178,306,0,0,0,306,A
6-NA,179,0,0,308,0,308,G
6-NA,180,312,0,0,0,312,A
6-NA,181,311,0,0,0,311,A
6-NA,182,322,0,0,0,322,A
6-NA,183,0,0,0,324,324,C
6-NA,184,323,0,0,0,323,A
6-NA,185,0,325,0,0,325,T
6-NA,186,327,0,0,0,327,A
6-NA,187,330,0,0,0,330,A
6-NA,188,0,0,0,334,334,C
6-NA,189,329,0,0,0,329,A
6-NA,190,0,0,340,0,340,G
6-NA,191,335,0,1,0,336,A
6-NA,192,0,0,335,0,335,G
6-NA,193,337,0,0,0,337,A
6-NA,194,0,354,0,1,355,T
6-NA,195,352,0,0,0,352,A
6-NA,196,0,0,361,0,361,G
6-NA,197,1,359,0,0,360,T
6-NA,198,0,0,368,0,368,G
6-NA,199,0,366,0,0,366,T
6-NA,200,364,0,0,0,364,A
6-NA,201,0,360,0,0,360,T
6-NA,202,0,0,0,363,363,C
6-NA,203,0,356,0,0,356,T
6-NA,204,0,4,369,0,373,G
6-NA,205,370,0,0,0,370,A
6-NA,206,0,0,0,369,369,C
6-NA,207,0,0,0,368,368,C
6-NA,208,367,0,0,0,367,A
6-NA,209,370,0,1,0,371,A
6-NA,210,0,0,0,375,375,C
6-NA,211,376,0,0,0,376,A
6-NA,212,0,0,0,382,382,C
6-NA,213,1,0,0,378,379,C
6-NA,214,389,0,0,0,389,A
6-NA,215,0,0,0,405,405,C
6-NA,216,0,0,0,409,409,C
6-NA,217,412,0,0,0,412,A
6-NA,218,0,415,0,0,415,T
6-NA,219,413,0,0,0,413,A
6-NA,220,0,2,414,0,416,G
6-NA,221,408,0,2,0,410,A
6-NA,222,0,0,423,0,423,G
6-NA,223,422,0,0,0,422,A
6-NA,224,412,0,0,0,412,A
6-NA,225,1,0,417,0,418,G
6-NA,226,0,2,416,0,418,G
6-NA,227,417,0,0,0,417,A
6-NA,228,417,0,0,0,417,A
6-NA,229,416,0,0,0,416,A
6-NA,230,0,414,0,0,414,T
6-NA,231,413,0,0,0,413,A
6-NA,232,0,407,0,0,407,T
6-NA,233,0,0,406,0,406,G
6-NA,234,0,0,0,413,413,C
6-NA,235,1,0,0,408,409,C
6-NA,236,0,0,0,409,409,C
6-NA,237,0,0,0,410,410,C
6-NA,238,413,0,0,0,413,A
6-NA,239,413,0,0,0,413,A
6-NA,240,412,0,0,0,412,A
6-NA,241,0,408,0,3,411,T
6-NA,242,0,422,0,0,422,T
6-NA,243,422,0,0,0,422,A
6-NA,244,0,0,425,0,425,G
6-NA,245,1,0,0,424,425,C
6-NA,246,424,0,1,0,425,A
6-NA,247,0,1,433,0,434,G
6-NA,248,431,0,0,0,431,A
6-NA,249,452,0,0,0,452,A
6-NA,250,0,453,0,0,453,T
6-NA,251,453,0,0,0,453,A
6-NA,252,0,0,0,453,453,C
6-NA,253,453,0,0,0,453,A
6-NA,254,0,0,455,0,455,G
6-NA,255,454,0,0,0,454,A
6-NA,256,455,0,0,0,455,A
6-NA,257,454,0,0,0,454,A
6-NA,258,0,442,0,0,442,T
6-NA,259,0,442,0,0,442,T
6-NA,260,0,1,443,0,444,G
6-NA,261,0,0,446,0,446,G
6-NA,262,0,444,0,2,446,T
6-NA,263,7,0,0,438,445,C
6-NA,264,440,0,1,0,441,A
6-NA,265,442,0,0,0,442,A
6-NA,266,439,0,1,0,440,A
6-NA,267,440,0,0,0,440,A
6-NA,268,0,0,0,443,443,C
6-NA,269,0,1,0,443,444,C
6-NA,270,0,0,445,0,445,G
6-NA,271,0,0,0,446,446,C
6-NA,272,445,0,0,0,445,A
6-NA,273,447,0,0,0,447,A
6-NA,274,0,447,0,0,447,T
6-NA,275,0,1,447,0,448,G
6-NA,276,0,1,0,446,447,C
6-NA,277,0,2,449,0,451,G
6-NA,278,455,0,0,0,455,A
6-NA,279,0,0,0,456,456,C
6-NA,280,461,0,0,0,461,A
6-NA,281,0,479,0,0,479,T
6-NA,282,0,476,0,1,477,T
6-NA,283,476,0,1,0,477,A
6-NA,284,0,0,0,476,476,C
6-NA,285,474,0,0,0,474,A
6-NA,286,0,1,475,0,476,G
6-NA,287,0,3,467,0,470,G
6-NA,288,471,0,0,0,471,A
6-NA,289,0,468,0,0,468,T
6-NA,290,0,460,0,0,460,T
6-NA,291,0,463,0,0,463,T
6-NA,292,0,0,463,0,463,G
6-NA,293,0,0,0,463,463,C
6-NA,294,461,0,0,0,461,A
6-NA,295,0,0,0,462,462,C
6-NA,296,0,0,0,466,466,C
6-NA,297,1,463,0,1,465,T
6-NA,298,1,463,0,0,464,T
6-NA,299,0,467,0,0,467,T
6-NA,300,0,466,0,0,466,T
6-NA,301,0,475,0,0,475,T
6-NA,302,1,0,0,474,475,C
6-NA,303,0,473,0,0,473,T
6-NA,304,470,0,1,0,471,A
6-NA,305,468,0,1,0,469,A
6-NA,306,0,1,472,0,473,G
6-NA,307,0,0,469,0,469,G
6-NA,308,467,0,0,0,467,A
6-NA,309,0,0,0,472,472,C
6-NA,310,467,0,0,0,467,A
6-NA,311,465,0,0,0,465,A
6-NA,312,0,465,0,0,465,T
6-NA,313,0,463,0,1,464,T
6-NA,314,0,0,0,474,474,C
6-NA,315,0,0,475,0,475,G
6-NA,316,475,0,0,0,475,A
6-NA,317,0,473,0,0,473,T
6-NA,318,0,473,0,0,473,T
6-NA,319,471,0,1,0,472,A
6-NA,320,0,1,471,0,472,G
6-NA,321,0,0,471,0,471,G
6-NA,322,0,0,0,474,474,C
6-NA,323,0,467,0,0,467,T
6-NA,324,0,469,0,0,469,T
6-NA,325,0,471,0,0,471,T
6-NA,326,1,0,0,470,471,C
6-NA,327,2,0,0,469,471,C
6-NA,328,0,0,472,0,472,G
6-NA,329,1,0,0,471,472,C
6-NA,330,0,473,0,0,473,T
6-NA,331,0,0,487,0,487,G
6-NA,332,1,0,482,0,483,G
6-NA,333,0,484,0,0,484,T
6-NA,334,0,1,480,0,481,G
6-NA,335,0,3,483,0,486,G
6-NA,336,1,0,484,0,485,G
6-NA,337,0,4,480,0,484,G
6-NA,338,487,0,0,0,487,A
6-NA,339,0,1,0,490,491,C
6-NA,340,478,0,0,1,479,A
6-NA,341,0,475,0,1,476,T
6-NA,342,1,0,0,475,476,C
6-NA,343,0,472,0,0,472,T
6-NA,344,0,3,463,0,466,G
6-NA,345,0,2,468,0,470,G
6-NA,346,0,0,474,0,474,G
6-NA,347,0,470,0,2,472,T
6-NA,348,0,1,467,0,468,G
6-NA,349,457,0,1,0,458,A
6-NA,350,0,0,0,471,471,C
6-NA,351,471,0,0,0,471,A
6-NA,352,507,0,0,0,507,A
6-NA,353,0,1,518,0,519,G
6-NA,354,518,0,0,0,518,A
6-NA,355,0,1,536,0,537,G
6-NA,356,550,0,0,0,550,A
6-NA,357,609,0,0,0,609,A
6-NA,358,1,0,0,784,785,C
6-NA,359,1,0,0,873,874,C
6-NA,360,0,875,0,3,878,T
6-NA,361,0,879,0,0,879,T
6-NA,362,879,0,0,0,879,A
6-NA,363,0,885,0,1,886,T
6-NA,364,0,0,942,0,942,G
6-NA,365,0,943,0,1,944,T
6-NA,366,0,0,971,0,971,G
6-NA,367,1,960,0,0,961,T
6-NA,368,1,1,0,961,963,C
6-NA,369,980,6,0,1,987,A
6-NA,370,0,988,0,1,989,T
6-NA,371,0,0,984,1,985,G
6-NA,372,0,1,0,987,988,C
6-NA,373,1,1,987,0,989,G
6-NA,374,1149,1,1,0,1151,A
6-NA,375,0,1152,0,0,1152,T
6-NA,376,2,0,0,1169,1171,C
6-NA,377,1,0,0,1175,1176,C
6-NA,378,0,1209,0,1,1210,T
6-NA,379,1,9,1214,0,1224,G
6-NA,380,1220,1,1,0,1222,A
6-NA,381,0,0,0,1226,1226,C
6-NA,382,1226,0,0,0,1226,A
6-NA,383,1210,0,1,0,1211,A
6-NA,384,0,0,1275,0,1275,G
6-NA,385,0,1270,0,0,1270,T
6-NA,386,0,0,1291,0,1291,G
6-NA,387,0,1288,0,1,1289,T
6-NA,388,0,1285,1,0,1286,T
6-NA,389,1286,0,0,0,1286,A
6-NA,390,1,1279,0,2,1282,T
6-NA,391,0,0,0,1303,1303,C
6-NA,392,1303,0,0,0,1303,A
6-NA,393,1307,0,0,0,1307,A
6-NA,394,0,1297,1,0,1298,T
6-NA,395,0,1299,0,1,1300,T
6-NA,396,0,1298,0,0,1298,T
6-NA,397,0,1,1305,0,1306,G
6-NA,398,0,0,0,1389,1389,C
6-NA,399,2,0,0,1389,1391,C
6-NA,400,7,1,0,1393,1401,C
6-NA,401,0,1403,0,1,1404,T
6-NA,402,0,1403,0,1,1404,T
6-NA,403,0,8,1422,0,1430,G
6-NA,404,0,5,1433,0,1438,G
6-NA,405,1442,2,0,0,1444,A
6-NA,406,1,0,1,1443,1445,C
6-NA,407,1413,1,0,0,1414,A
6-NA,408,1,2,1450,0,1453,G
6-NA,409,1,1,1452,0,1454,G
6-NA,410,0,6,1510,0,1516,G
6-NA,411,1511,0,5,0,1516,A
6-NA,412,1503,0,1,1,1505,A
6-NA,413,0,0,0,1505,1505,C
6-NA,414,1496,1,1,0,1498,A
6-NA,415,1654,1,2,0,1657,A
6-NA,416,0,0,0,1683,1683,C
6-NA,417,1685,0,1,0,1686,A
6-NA,418,0,0,0,1711,1711,C
6-NA,419,0,1673,2,1,1676,T
6-NA,420,1703,0,0,0,1703,A
6-NA,421,1704,0,0,0,1704,A
6-NA,422,1702,0,2,0,1704,A
6-NA,423,0,0,0,1711,1711,C
6-NA,424,1646,0,0,0,1646,A
6-NA,425,1653,1,0,0,1654,A
6-NA,426,0,0,0,1654,1654,C
6-NA,427,3,1,1652,0,1656,G
6-NA,428,0,1650,0,0,1650,T
6-NA,429,1,2,1644,0,1647,G
6-NA,430,0,2,0,1661,1663,C
6-NA,431,1665,0,0,0,1665,A
6-NA,432,0,1669,0,0,1669,T
6-NA,433,0,1670,0,1,1671,T
6-NA,434,5,0,0,1689,1694,C
6-NA,435,1722,0,0,0,1722,A
6-NA,436,1734,0,0,0,1734,A
6-NA,437,1747,0,2,0,1749,A
6-NA,438,0,1751,0,1,1752,T
6-NA,439,2,9,1737,0,1748,G
6-NA,440,1776,0,0,0,1776,A
6-NA,441,0,3,0,1786,1789,C
6-NA,442,1787,0,0,0,1787,A
6-NA,443,1,0,0,1819,1820,C
6-NA,444,1797,0,0,0,1797,A
6-NA,445,1,1,2250,0,2252,G
6-NA,446,0,2247,0,1,2248,T
6-NA,447,2290,1,1,0,2292,A
6-NA,448,0,5,0,2298,2303,C
6-NA,449,1,0,2294,0,2295,G
6-NA,450,0,2381,0,1,2382,T
6-NA,451,0,12,2371,0,2383,G
6-NA,452,2389,0,0,0,2389,A
6-NA,453,0,2407,0,0,2407,T
6-NA,454,2198,1,1,0,2200,A
6-NA,455,0,3,2195,0,2198,G
6-NA,456,1,5,2188,0,2194,G
6-NA,457,2194,0,1,0,2195,A
6-NA,458,2,1,1,2228,2232,C
6-NA,459,5,0,0,2210,2215,C
6-NA,460,1,0,0,2247,2248,C
6-NA,461,4,0,0,2257,2261,C
6-NA,462,1,2271,0,1,2273,T
6-NA,463,0,2311,0,1,2312,T
6-NA,464,2316,0,1,0,2317,A
6-NA,465,0,2323,0,0,2323,T
6-NA,466,1,0,0,2315,2316,C
6-NA,467,2,4,2299,0,2305,G
6-NA,468,0,8,2298,0,2306,G
6-NA,469,2307,0,0,0,2307,A
6-NA,470,1,3,0,2328,2332,C
6-NA,471,7,3,0,2315,2325,C
6-NA,472,5,0,2,2453,2460,C
6-NA,473,0,2452,0,1,2453,T
6-NA,474,2497,0,0,0,2497,A
6-NA,475,1,2501,0,0,2502,T
6-NA,476,1,2500,1,0,2502,T
6-NA,477,0,6,2500,0,2506,G
6-NA,478,2503,0,1,0,2504,A
6-NA,479,0,2500,0,0,2500,T
6-NA,480,1,17,2490,0,2508,G
6-NA,481,2454,0,1,0,2455,A
6-NA,482,2458,0,1,0,2459,A
6-NA,483,0,2453,0,0,2453,T
6-NA,484,0,9,2483,0,2492,G
6-NA,485,2553,1,4,0,2558,A
6-NA,486,1,2,2577,0,2580,G
6-NA,487,0,2574,0,2,2576,T
6-NA,488,0,2572,1,0,2573,T
6-NA,489,2576,1,1,0,2578,A
6-NA,490,0,3,2584,0,2587,G
6-NA,491,0,1,2597,0,2598,G
6-NA,492,1,2589,0,4,2594,T
6-NA,493,0,0,2609,0,2609,G
6-NA,494,0,2571,0,3,2574,T
6-NA,495,0,2562,0,3,2565,T
6-NA,496,10,0,1,2592,2603,C
6-NA,497,3,1,0,2614,2618,C
6-NA,498,1,2610,0,0,2611,T
6-NA,499,0,2611,0,2,2613,T
6-NA,500,0,2606,0,5,2611,T
6-NA,501,0,2612,0,1,2613,T
6-NA,502,9,0,0,2616,2625,C
6-NA,503,2622,0,0,0,2622,A
6-NA,504,1,2674,1,1,2677,T
6-NA,505,7,1,0,2674,2682,C
6-NA,506,0,2650,0,1,2651,T
6-NA,507,0,1,2648,1,2650,G
6-NA,508,0,6,2637,0,2643,G
6-NA,509,0,5,2642,0,2647,G
6-NA,510,1,10,2661,0,2672,G
6-NA,511,2673,2,0,0,2675,A
6-NA,512,3,1,0,2689,2693,C
6-NA,513,1,2,0,2669,2672,C
6-NA,514,2705,1,1,0,2707,A
6-NA,515,2712,0,3,0,2715,A
6-NA,516,0,1,2714,0,2715,G
6-NA,517,0,1,0,2723,2724,C
6-NA,518,2712,1,3,0,2716,A
6-NA,519,2737,0,1,1,2739,A
6-NA,520,1,1,2753,0,2755,G
6-NA,521,0,2743,0,0,2743,T
6-NA,522,0,0,2837,0,2837,G
6-NA,523,0,2818,0,0,2818,T
6-NA,524,1,3,2899,1,2904,G
6-NA,525,1,2,0,2895,2898,C
6-NA,526,2902,1,1,0,2904,A
6-NA,527,1,2930,0,1,2932,T
6-NA,528,2895,0,1,0,2896,A
6-NA,529,0,1,2979,0,2980,G
6-NA,530,2,0,0,2968,2970,C
6-NA,531,2917,1,0,1,2919,A
6-NA,532,0,2915,1,1,2917,T
6-NA,533,0,11,2837,0,2848,G
6-NA,534,1,1,3053,0,3055,G
6-NA,535,1,3056,0,2,3059,T
6-NA,536,5,0,0,3041,3046,C
6-NA,537,3,1,0,3064,3068,C
6-NA,538,3036,0,3,2,3041,A
6-NA,539,1,2,3139,2,3144,G
6-NA,540,1,2,0,3151,3154,C
6-NA,541,1,3138,0,8,3147,T
6-NA,542,5,1,1,3150,3157,C
6-NA,543,3086,0,1,0,3087,A
6-NA,544,3117,0,2,0,3119,A
6-NA,545,0,3,3125,0,3128,G
6-NA,546,0,3143,0,4,3147,T
6-NA,547,0,3134,1,0,3135,T
6-NA,548,0,2,3129,0,3131,G
6-NA,549,2,3130,0,0,3132,T
6-NA,550,13,0,0,3113,3126,C
6-NA,551,3132,0,0,0,3132,A
6-NA,552,0,2,0,3160,3162,C
6-NA,553,1,5,3138,2,3146,G
6-NA,554,3203,1,2,0,3206,A
6-NA,555,0,3208,0,2,3210,T
6-NA,556,4,5,3262,0,3271,G
6-NA,557,0,3,3282,1,3286,G
6-NA,558,3288,0,2,0,3290,A
6-NA,559,3292,1,2,0,3295,A
6-NA,560,3319,1,1,1,3322,A
6-NA,561,3315,0,4,0,3319,A
6-NA,562,0,2,3357,0,3359,G
6-NA,563,4,0,0,3349,3353,C
6-NA,564,3344,2,1,0,3347,A
6-NA,565,0,3348,0,0,3348,T
6-NA,566,1,9,3371,0,3381,G
6-NA,567,1,0,3406,0,3407,G
6-NA,568,4,0,0,3437,3441,C
6-NA,569,0,3420,0,3,3423,T
6-NA,570,1,1,3448,0,3450,G
6-NA,571,1,0,0,3440,3441,C
6-NA,572,3454,0,0,0,3454,A
6-NA,573,0,3567,0,4,3571,T
6-NA,574,3,0,3581,0,3584,G
6-NA,575,1,3606,1,0,3608,T
6-NA,576,0,3679,0,0,3679,T
6-NA,577,0,3674,0,2,3676,T
6-NA,578,1,2,3895,0,3898,G
6-NA,579,1,3894,0,1,3896,T
6-NA,580,3904,0,1,0,3905,A
6-NA,581,0,3920,0,1,3921,T
6-NA,582,3878,0,2,0,3880,A
6-NA,583,3892,1,1,0,3894,A
6-NA,584,6,0,0,3862,3868,C
6-NA,585,16,4,3805,0,3825,G
6-NA,586,0,4,3840,0,3844,G
6-NA,587,0,8,3779,0,3787,G
6-NA,588,3,8,3789,1,3801,G
6-NA,589,2,8,3789,0,3799,G
6-NA,590,3778,1,10,1,3790,A
6-NA,591,0,3799,0,0,3799,T
6-NA,592,9,10,3787,0,3806,G
6-NA,593,3811,1,8,2,3822,A
6-NA,594,2,3842,0,1,3845,T
6-NA,595,3834,0,0,0,3834,A
6-NA,596,3923,1,1,0,3925,A
6-NA,597,3932,0,5,0,3937,A
6-NA,598,3942,0,0,0,3942,A
6-NA,599,3956,0,2,0,3958,A
6-NA,600,0,3950,0,0,3950,T
6-NA,601,1,8,3943,0,3952,G
6-NA,602,8,1,1,3936,3946,C
6-NA,603,3945,0,0,0,3945,A
6-NA,604,3968,0,3,0,3971,A
6-NA,605,1,1,0,4006,4008,C
6-NA,606,0,3997,0,1,3998,T
6-NA,607,8,3,4002,0,4013,G
6-NA,608,2,1,0,4003,4006,C
6-NA,609,2,4009,0,1,4012,T
6-NA,610,4013,0,7,0,4020,A
6-NA,611,0,2,4023,0,4025,G
6-NA,612,0,1,0,4053,4054,C
6-NA,613,1,4052,0,2,4055,T
6-NA,614,1,4031,0,2,4034,T
6-NA,615,17,0,1,4069,4087,C
6-NA,616,4112,0,0,0,4112,A
6-NA,617,0,4116,0,0,4116,T
6-NA,618,0,4122,0,0,4122,T
6-NA,619,0,4149,0,1,4150,T
6-NA,620,4152,2,0,0,4154,A
6-NA,621,1,1,1,4190,4193,C
6-NA,622,4157,1,1,0,4159,A
6-NA,623,4187,0,2,2,4191,A
6-NA,624,0,4154,0,2,4156,T
6-NA,625,1,7,4138,0,4146,G
6-NA,626,0,7,4131,0,4138,G
6-NA,627,1,3,4125,0,4129,G
6-NA,628,4103,0,11,0,4114,A
6-NA,629,2,5,4215,0,4222,G
6-NA,630,0,0,4257,0,4257,G
6-NA,631,2,2,0,4531,4535,C
6-NA,632,0,4528,0,3,4531,T
6-NA,633,0,4584,0,1,4585,T
6-NA,634,0,1,4633,0,4634,G
6-NA,635,1,4627,0,0,4628,T
6-NA,636,4689,0,5,0,4694,A
6-NA,637,0,7,4698,0,4705,G
6-NA,638,4650,1,1,0,4652,A
6-NA,639,0,4651,0,0,4651,T
6-NA,640,4333,0,1,0,4334,A
6-NA,641,0,2,4334,0,4336,G
6-NA,642,1,4289,0,2,4292,T
6-NA,643,1,3,4227,0,4231,G
6-NA,644,1,4392,0,1,4394,T
6-NA,645,1,4393,1,0,4395,T
6-NA,646,1,1,4459,0,4461,G
6-NA,647,1,4440,0,2,4443,T
6-NA,648,0,4438,1,4,4443,T
6-NA,649,0,4444,1,6,4451,T
6-NA,650,19,1,0,4364,4384,C
6-NA,651,4375,0,3,0,4378,A
6-NA,652,3,4364,0,4,4371,T
6-NA,653,1,12,4362,0,4375,G
6-NA,654,0,3,4608,0,4611,G
6-NA,655,0,4572,0,3,4575,T
6-NA,656,18,0,0,4545,4563,C
6-NA,657,9,2,2,4547,4560,C
6-NA,658,4572,0,2,0,4574,A
6-NA,659,4592,0,9,0,4601,A
6-NA,660,4592,1,7,0,4600,A
6-NA,661,0,3,4644,0,4647,G
6-NA,662,4628,0,0,1,4629,A
6-NA,663,4506,1,2,0,4509,A
6-NA,664,4514,0,1,1,4516,A
6-NA,665,3,4508,0,0,4511,T
6-NA,666,9,2,0,4628,4639,C
6-NA,667,8,1,0,4623,4632,C
6-NA,668,0,4620,0,3,4623,T
6-NA,669,6,3,0,4612,4621,C
6-NA,670,4621,2,3,1,4627,A
6-NA,671,2,6,4656,0,4664,G
6-NA,672,0,17,4645,0,4662,G
6-NA,673,4774,3,3,0,4780,A
6-NA,674,2,0,4,4766,4772,C
6-NA,675,8,2,0,4683,4693,C
6-NA,676,10,1,1,4693,4705,C
6-NA,677,4712,1,1,1,4715,A
6-NA,678,0,6,4725,0,4731,G
6-NA,679,0,16,4739,0,4755,G
6-NA,680,4732,1,2,1,4736,A
6-NA,681,4,2,4794,0,4800,G
6-NA,682,0,4720,0,1,4721,T
6-NA,683,12,1,1,4741,4755,C
6-NA,684,4733,1,6,0,4740,A
6-NA,685,1,10,4765,1,4777,G
6-NA,686,4756,0,1,0,4757,A
6-NA,687,4657,2,97,0,4756,A
6-NA,688,1,4747,0,0,4748,T
6-NA,689,0,1,4772,0,4773,G
6-NA,690,2,3,1,4758,4764,C
6-NA,691,2,2,4788,0,4792,G
6-NA,692,1,4755,1,0,4757,T
6-NA,693,0,4758,0,3,4761,T
6-NA,694,1,4730,0,1,4732,T
6-NA,695,1,1,4768,0,4770,G
6-NA,696,2,4784,0,3,4789,T
6-NA,697,4793,2,1,0,4796,A
6-NA,698,2,4776,0,2,4780,T
6-NA,699,18,1,1,4754,4774,C
6-NA,700,4753,0,7,0,4760,A
6-NA,701,4754,0,1,0,4755,A
6-NA,702,5,4753,1,0,4759,T
6-NA,703,1,10,4742,1,4754,G
6-NA,704,1,20,4751,0,4772,G
6-NA,705,4847,2,5,0,4854,A
6-NA,706,4848,0,4,0,4852,A
6-NA,707,0,0,1,4895,4896,C
6-NA,708,1,4930,1,3,4935,T
6-NA,709,1,4924,0,1,4926,T
6-NA,710,0,0,5063,0,5063,G
6-NA,711,0,5059,0,2,5061,T
6-NA,712,5056,0,2,1,5059,A
6-NA,713,1,0,0,5126,5127,C
6-NA,714,5014,0,2,0,5016,A
6-NA,715,1,1,5308,1,5311,G
6-NA,716,2,5284,1,1,5288,T
6-NA,717,5466,0,1,0,5467,A
6-NA,718,1,3,5492,0,5496,G
6-NA,719,2,5377,1,3,5383,T
6-NA,720,5381,0,0,0,5381,A
6-NA,721,5369,2,2,0,5373,A
6-NA,722,0,5330,0,1,5331,T
6-NA,723,6,33,5302,0,5341,G
6-NA,724,5192,2,2,0,5196,A
6-NA,725,3,1,0,5225,5229,C
6-NA,726,1,5069,0,2,5072,T
6-NA,727,1,7,5086,0,5094,G
6-NA,728,5089,0,4,0,5093,A
6-NA,729,1,5111,0,4,5116,T
6-NA,730,1,11,5103,0,5115,G
6-NA,731,0,10,5048,0,5058,G
6-NA,732,1,15,5058,0,5074,G
6-NA,733,4990,0,8,1,4999,A
6-NA,734,1,2,4987,0,4990,G
6-NA,735,1,4946,0,4,4951,T
6-NA,736,10,6,4958,0,4974,G
6-NA,737,0,1,0,4979,4980,C
6-NA,738,1,4949,1,3,4954,T
6-NA,739,2,4956,0,0,4958,T
6-NA,740,11,0,0,4943,4954,C
6-NA,741,1,22,4889,0,4912,G
6-NA,742,1,1,4966,1,4969,G
6-NA,743,0,10,4966,0,4976,G
6-NA,744,4957,0,18,0,4975,A
6-NA,745,4934,0,3,0,4937,A
6-NA,746,4921,2,2,1,4926,A
6-NA,747,4940,0,6,1,4947,A
6-NA,748,0,3,4972,1,4976,G
6-NA,749,0,1,0,4969,4970,C
6-NA,750,0,4943,0,1,4944,T
6-NA,751,0,14,4939,0,4953,G
6-NA,752,4952,0,2,2,4956,A
6-NA,753,1,5005,0,3,5009,T
6-NA,754,5022,0,3,0,5025,A
6-NA,755,0,1,0,5282,5283,C
6-NA,756,1,5230,0,2,5233,T
6-NA,757,5241,0,1,0,5242,A
6-NA,758,5237,0,1,1,5239,A
6-NA,759,5240,0,0,0,5240,A
6-NA,760,5327,2,5,1,5335,A
6-NA,761,0,5325,1,0,5326,T
6-NA,762,5301,0,1,0,5302,A
6-NA,763,6,1,0,5320,5327,C
6-NA,764,1,5102,0,3,5106,T
6-NA,765,5198,0,0,1,5199,A
6-NA,766,2,5164,1,3,5170,T
6-NA,767,1,5565,0,3,5569,T
6-NA,768,16,1,0,5620,5637,C
6-NA,769,5546,0,0,0,5546,A
6-NA,770,1,5537,1,0,5539,T
6-NA,771,1,5535,1,2,5539,T
6-NA,772,5441,0,0,0,5441,A
6-NA,773,5457,1,1,0,5459,A
6-NA,774,1,5,5483,0,5489,G
6-NA,775,0,12,5486,0,5498,G
6-NA,776,5117,1,1,3,5122,A
6-NA,777,1,13,5156,1,5171,G
6-NA,778,1,8,5169,0,5178,G
6-NA,779,1,8,5186,0,5195,G
6-NA,780,4,10,5183,2,5199,G
6-NA,781,5165,1,3,0,5169,A
6-NA,782,5200,1,3,0,5204,A
6-NA,783,5174,2,2,0,5178,A
6-NA,784,5165,0,1,0,5166,A
6-NA,785,0,5171,0,1,5172,T
6-NA,786,23,6,0,5114,5143,C
6-NA,787,5,4,5190,0,5199,G
6-NA,788,2,5181,0,0,5183,T
6-NA,789,0,5172,0,6,5178,T
6-NA,790,22,1,0,5165,5188,C
6-NA,791,5173,3,0,1,5177,A
6-NA,792,0,5530,1,2,5533,T
6-NA,793,5524,2,1,0,5527,A
6-NA,794,3,0,1,5555,5559,C
6-NA,795,0,5540,1,0,5541,T
6-NA,796,5521,0,3,0,5524,A
6-NA,797,2,3,5509,0,5514,G
6-NA,798,2,3,0,5512,5517,C
6-NA,799,5513,6,4,0,5523,A
6-NA,800,5,1,0,5526,5532,C
6-NA,801,5321,1,1,0,5323,A
6-NA,802,4,5434,0,0,5438,T
6-NA,803,0,5404,0,3,5407,T
6-NA,804,3,1,5841,0,5845,G
6-NA,805,0,5812,0,8,5820,T
6-NA,806,25,2,0,5790,5817,C
6-NA,807,5802,2,4,1,5809,A
6-NA,808,6,7,5830,0,5843,G
6-NA,809,0,15,5832,0,5847,G
6-NA,810,5832,0,3,0,5835,A
6-NA,811,5749,1,3,1,5754,A
6-NA,812,0,2,5825,0,5827,G
6-NA,813,0,5521,0,5,5526,T
6-NA,814,0,5,5551,0,5556,G
6-NA,815,4,0,1,5538,5543,C
6-NA,816,2,5535,0,6,5543,T
6-NA,817,23,2,0,5534,5559,C
6-NA,818,5525,1,2,0,5528,A
6-NA,819,3,1,5558,1,5563,G
6-NA,820,2,0,2,5564,5568,C
6-NA,821,5558,0,1,0,5559,A
6-NA,822,2,5557,0,1,5560,T
6-NA,823,4,2,5746,0,5752,G
6-NA,824,0,5742,0,2,5744,T
6-NA,825,23,2,0,5718,5743,C
6-NA,826,1,13,5729,0,5743,G
6-NA,827,5729,0,0,0,5729,A
6-NA,828,1,8,5684,0,5693,G
6-NA,829,0,16,5674,1,5691,G
6-NA,830,5638,1,4,0,5643,A
6-NA,831,3,3,5717,1,5724,G
6-NA,832,4,5555,0,4,5563,T
6-NA,833,2,3,5587,0,5592,G
6-NA,834,3,1,0,5685,5689,C
6-NA,835,1,5657,0,4,5662,T
6-NA,836,18,0,1,5672,5691,C
6-NA,837,7,0,0,5701,5708,C
6-NA,838,1,5695,2,1,5699,T
6-NA,839,3,0,5718,0,5721,G
6-NA,840,1,0,0,5667,5668,C
6-NA,841,0,5620,1,3,5624,T
6-NA,842,5670,1,1,0,5672,A
6-NA,843,0,5577,0,1,5578,T
6-NA,844,6,0,0,5609,5615,C
6-NA,845,13,4,0,5592,5609,C
6-NA,846,2,5601,1,5,5609,T
6-NA,847,7,4,0,5647,5658,C
6-NA,848,3,10,5632,1,5646,G
6-NA,849,5693,1,0,0,5694,A
6-NA,850,1,5693,0,12,5706,T
6-NA,851,5709,0,1,0,5710,A
6-NA,852,0,5695,0,18,5713,T
6-NA,853,11,1,9,5662,5683,C
6-NA,854,9,1,1,5665,5676,C
6-NA,855,0,5637,0,3,5640,T
6-NA,856,1,8,5657,0,5666,G
6-NA,857,1,2,5679,1,5683,G
6-NA,858,0,5735,1,4,5740,T
6-NA,859,2,2,5760,0,5764,G
6-NA,860,2,5708,0,8,5718,T
6-NA,861,30,4,0,5689,5723,C
6-NA,862,5715,1,3,0,5719,A
6-NA,863,0,5,5726,0,5731,G
6-NA,864,5754,4,1,1,5760,A
6-NA,865,1,5715,0,0,5716,T
6-NA,866,2,6,5701,0,5709,G
6-NA,867,1,5631,0,2,5634,T
6-NA,868,5,1,5631,3,5640,G
6-NA,869,1,5621,0,4,5626,T
6-NA,870,21,0,0,5635,5656,C
6-NA,871,0,5631,0,7,5638,T
6-NA,872,3,4,5652,0,5659,G
6-NA,873,2,0,1,5654,5657,C
6-NA,874,5631,1,6,0,5638,A
6-NA,875,2,6,5642,0,5650,G
6-NA,876,5520,0,3,0,5523,A
6-NA,877,1,14,5527,4,5546,G
6-NA,878,5526,2,12,0,5540,A
6-NA,879,4,0,0,5568,5572,C
6-NA,880,5578,0,1,1,5580,A
6-NA,881,5586,7,3,0,5596,A
6-NA,882,3,3,0,5626,5632,C
6-NA,883,1,5630,1,5,5637,T
6-NA,884,3,5,5641,0,5649,G
6-NA,885,0,5,5635,1,5641,G
6-NA,886,5607,1,3,0,5611,A
6-NA,887,5598,1,6,0,5605,A
6-NA,888,5477,1,4,1,5483,A
6-NA,889,0,4,5574,0,5578,G
6-NA,890,2,3,5564,0,5569,G
6-NA,891,0,0,0,5575,5575,C
6-NA,892,1,5556,0,9,5566,T
6-NA,893,13,1,1,5673,5688,C
6-NA,894,8,0,0,5716,5724,C
6-NA,895,5749,2,1,0,5752,A
6-NA,896,5750,0,0,1,5751,A
6-NA,897,2,5760,0,1,5763,T
6-NA,898,5574,1,2,1,5578,A
6-NA,899,1,6,5564,0,5571,G
6-NA,900,7,1,5587,0,5595,G
6-NA,901,3,2,0,5598,5603,C
6-NA,902,7,3,0,5484,5494,C
6-NA,903,11,3,0,5424,5438,C
6-NA,904,5497,0,1,0,5498,A
6-NA,905,2,5543,0,7,5552,T
6-NA,906,14,2,1,5537,5554,C
6-NA,907,2,1,5568,0,5571,G
6-NA,908,1,5557,0,2,5560,T
6-NA,909,5449,0,1,0,5450,A
6-NA,910,1,6,5549,0,5556,G
6-NA,911,5568,1,4,0,5573,A
6-NA,912,0,5592,0,1,5593,T
6-NA,913,5495,1,0,0,5496,A
6-NA,914,0,5448,1,2,5451,T
6-NA,915,5435,0,1,1,5437,A
6-NA,916,5427,2,3,0,5432,A
6-NA,917,5567,1,1,0,5569,A
6-NA,918,2,3,0,5699,5704,C
6-NA,919,5565,1,3,0,5569,A
6-NA,920,1,5580,0,1,5582,T
6-NA,921,5518,0,12,0,5530,A
6-NA,922,5538,0,3,0,5541,A
6-NA,923,5525,2,9,0,5536,A
6-NA,924,6,12,5594,0,5612,G
6-NA,925,1,12,5644,0,5657,G
6-NA,926,5487,0,0,0,5487,A
6-NA,927,1,5485,0,5,5491,T
6-NA,928,10,0,0,5486,5496,C
6-NA,929,5547,1,4,0,5552,A
6-NA,930,0,5557,0,2,5559,T
6-NA,931,5555,0,1,0,5556,A
6-NA,932,1,0,5563,0,5564,G
6-NA,933,2,0,0,5519,5521,C
6-NA,934,5438,1,1,0,5440,A
6-NA,935,0,5295,0,0,5295,T
6-NA,936,3,5287,1,12,5303,T
6-NA,937,1,2,5450,0,5453,G
6-NA,938,1,5455,0,1,5457,T
6-NA,939,0,5516,1,3,5520,T
6-NA,940,0,5515,0,3,5518,T
6-NA,941,10,0,0,5482,5492,C
6-NA,942,10,1,0,5503,5514,C
6-NA,943,5568,0,1,0,5569,A
6-NA,944,0,3,5639,0,5642,G
6-NA,945,0,5642,0,3,5645,T
6-NA,946,0,5465,0,5,5470,T
6-NA,947,5475,1,2,0,5478,A
6-NA,948,1,5434,1,0,5436,T
6-NA,949,3,1,5433,0,5437,G
6-NA,950,0,5399,0,1,5400,T
6-NA,951,6,2,5416,0,5424,G
6-NA,952,1,5281,0,2,5284,T
6-NA,953,2,5,5413,0,5420,G
6-NA,954,0,5418,0,2,5420,T
6-NA,955,0,5401,0,3,5404,T
6-NA,956,17,1,0,5386,5404,C
6-NA,957,5356,0,3,0,5359,A
6-NA,958,1,12,5378,0,5391,G
6-NA,959,0,25,5356,2,5383,G
6-NA,960,5352,2,7,0,5361,A
6-NA,961,1,0,0,5355,5356,C
6-NA,962,0,5205,0,1,5206,T
6-NA,963,0,5217,0,1,5218,T
6-NA,964,0,4,5417,0,5421,G
6-NA,965,0,5421,0,2,5423,T
6-NA,966,1,5420,0,1,5422,T
6-NA,967,1,8,5365,0,5374,G
6-NA,968,0,12,5369,1,5382,G
6-NA,969,5370,1,11,1,5383,A
6-NA,970,1,21,5377,0,5399,G
6-NA,971,5366,2,10,1,5379,A
6-NA,972,3,3,0,5353,5359,C
6-NA,973,5159,0,10,0,5169,A
6-NA,974,0,1,1,5181,5183,C
6-NA,975,5182,2,1,4,5189,A
6-NA,976,5,1,0,5194,5200,C
6-NA,977,7,2,0,5165,5174,C
6-NA,978,8,3,1,5163,5175,C
6-NA,979,5165,0,2,0,5167,A
6-NA,980,0,9,5182,0,5191,G
6-NA,981,5178,0,0,0,5178,A
6-NA,982,5204,0,2,0,5206,A
6-NA,983,5164,0,1,1,5166,A
6-NA,984,5165,0,1,0,5166,A
6-NA,985,5137,0,5,0,5142,A
6-NA,986,5142,0,2,1,5145,A
6-NA,987,0,1,0,5149,5150,C
6-NA,988,0,34,5106,0,5140,G
6-NA,989,5124,1,12,0,5137,A
6-NA,990,0,0,0,5136,5136,C
6-NA,991,5116,0,1,1,5118,A
6-NA,992,2,0,5183,0,5185,G
6-NA,993,0,1,0,5313,5314,C
6-NA,994,1,5304,1,2,5308,T
6-NA,995,8,1,0,5300,5309,C
6-NA,996,15,1,1,5304,5321,C
6-NA,997,5309,0,10,0,5319,A
6-NA,998,1,2,5373,0,5376,G
6-NA,999,0,3,0,5368,5371,C
6-NA,1000,5350,2,1,0,5353,A
6-NA,1001,1,1,5346,0,5348,G
6-NA,1002,1,5113,0,2,5116,T
6-NA,1003,5114,0,4,0,5118,A
6-NA,1004,2,2,5126,1,5131,G
6-NA,1005,3,4,0,5131,5138,C
6-NA,1006,8,3,0,5128,5139,C
6-NA,1007,5064,1,7,0,5072,A
6-NA,1008,0,5058,0,19,5077,T
6-NA,1009,2,5071,0,0,5073,T
6-NA,1010,1,1,5183,0,5185,G
6-NA,1011,0,5142,0,5,5147,T
6-NA,1012,0,5133,1,1,5135,T
6-NA,1013,2,5123,0,3,5128,T
6-NA,1014,0,12,5069,0,5081,G
6-NA,1015,17,6,5105,0,5128,G
6-NA,1016,5123,1,1,0,5125,A
6-NA,1017,2,5142,1,5,5150,T
6-NA,1018,9,0,0,5136,5145,C
6-NA,1019,11,2,0,5052,5065,C
6-NA,1020,4,5056,0,1,5061,T
6-NA,1021,5065,0,6,0,5071,A
6-NA,1022,5083,0,2,0,5085,A
6-NA,1023,1,6,2,5163,5172,C
6-NA,1024,5054,0,1,1,5056,A
6-NA,1025,5111,1,0,0,5112,A
6-NA,1026,2,5099,0,2,5103,T
6-NA,1027,1,11,5156,0,5168,G
6-NA,1028,5146,2,1,1,5150,A
6-NA,1029,5110,1,4,0,5115,A
6-NA,1030,1,6,5140,1,5148,G
6-NA,1031,5134,0,4,0,5138,A
6-NA,1032,4993,1,4,0,4998,A
6-NA,1033,0,7,5009,0,5016,G
6-NA,1034,1,2,5022,1,5026,G
6-NA,1035,0,4975,1,1,4977,T
6-NA,1036,0,11,4930,0,4941,G
6-NA,1037,0,1,5089,0,5090,G
6-NA,1038,2,5056,0,11,5069,T
6-NA,1039,24,1,0,5019,5044,C
6-NA,1040,5052,1,1,0,5054,A
6-NA,1041,2,5031,0,2,5035,T
6-NA,1042,4,5,5018,1,5028,G
6-NA,1043,0,15,5035,0,5050,G
6-NA,1044,5005,0,8,2,5015,A
6-NA,1045,3,2,5145,1,5151,G
6-NA,1046,1,4951,0,1,4953,T
6-NA,1047,1,14,4947,0,4962,G
6-NA,1048,4955,1,1,1,4958,A
6-NA,1049,4961,0,2,1,4964,A
6-NA,1050,4958,0,7,2,4967,A
6-NA,1051,1,7,4975,0,4983,G
6-NA,1052,0,3,4935,0,4938,G
6-NA,1053,3,2,0,4924,4929,C
6-NA,1054,2,4786,0,2,4790,T
6-NA,1055,2,4,4798,0,4804,G
6-NA,1056,0,4,4801,1,4806,G
6-NA,1057,0,2,4862,0,4864,G
6-NA,1058,2,2,0,4861,4865,C
6-NA,1059,2,1,0,4875,4878,C
6-NA,1060,1,4789,0,7,4797,T
6-NA,1061,0,4813,0,3,4816,T
6-NA,1062,1,4810,0,3,4814,T
6-NA,1063,1,6,4824,0,4831,G
6-NA,1064,4820,1,7,0,4828,A
6-NA,1065,1,4792,0,1,4794,T
6-NA,1066,1,8,4711,1,4721,G
6-NA,1067,4652,1,3,1,4657,A
6-NA,1068,2,4657,1,2,4662,T
6-NA,1069,2,8,4652,0,4662,G
6-NA,1070,9,12,4685,0,4706,G
6-NA,1071,4691,0,3,0,4694,A
6-NA,1072,4676,0,4,0,4680,A
6-NA,1073,4695,1,1,1,4698,A
6-NA,1074,1,4692,0,1,4694,T
6-NA,1075,0,14,4724,0,4738,G
6-NA,1076,4752,0,4,0,4756,A
6-NA,1077,4,3,1,4756,4764,C
6-NA,1078,3,0,4747,0,4750,G
6-NA,1079,1,4671,0,0,4672,T
6-NA,1080,4652,1,3,0,4656,A
6-NA,1081,1,4687,0,1,4689,T
6-NA,1082,3,11,4690,0,4704,G
6-NA,1083,1,2,4750,0,4753,G
6-NA,1084,4691,1,5,0,4697,A
6-NA,1085,1,4627,0,1,4629,T
6-NA,1086,14,13,4551,0,4578,G
6-NA,1087,6,10,4550,0,4566,G
6-NA,1088,1,12,4583,0,4596,G
6-NA,1089,4569,3,3,0,4575,A
6-NA,1090,4562,1,3,0,4566,A
6-NA,1091,1,13,4540,1,4555,G
6-NA,1092,4461,0,2,0,4463,A
6-NA,1093,4459,3,2,0,4464,A
6-NA,1094,1,6,0,4428,4435,C
6-NA,1095,1,13,4400,0,4414,G
6-NA,1096,4412,1,3,0,4416,A
6-NA,1097,0,4339,0,0,4339,T
6-NA,1098,19,1,1,4331,4352,C
6-NA,1099,4348,0,4,1,4353,A
6-NA,1100,0,0,4377,0,4377,G
6-NA,1101,3,2,0,4357,4362,C
6-NA,1102,6,13,4338,0,4357,G
6-NA,1103,4340,0,3,1,4344,A
6-NA,1104,0,9,4349,0,4358,G
6-NA,1105,4349,0,1,0,4350,A
6-NA,1106,4348,1,1,1,4351,A
6-NA,1107,1,1,4380,0,4382,G
6-NA,1108,2,4345,0,6,4353,T
6-NA,1109,28,1,0,4288,4317,C
6-NA,1110,4312,0,1,0,4313,A
6-NA,1111,1,1,0,4424,4426,C
6-NA,1112,9,5,4418,0,4432,G
6-NA,1113,3,0,0,4429,4432,C
6-NA,1114,0,4404,0,1,4405,T
6-NA,1115,0,4423,0,0,4423,T
6-NA,1116,4370,1,7,0,4378,A
6-NA,1117,0,5,4467,0,4472,G
6-NA,1118,0,8,4463,1,4472,G
6-NA,1119,1,1,4554,0,4556,G
6-NA,1120,0,4276,0,2,4278,T
6-NA,1121,4274,0,2,0,4276,A
6-NA,1122,1,4256,1,1,4259,T
6-NA,1123,2,15,4233,0,4250,G
6-NA,1124,4239,0,1,0,4240,A
6-NA,1125,4232,0,1,0,4233,A
6-NA,1126,4042,1,5,0,4048,A
6-NA,1127,1,1,0,4044,4046,C
6-NA,1128,7,6,0,3942,3955,C
6-NA,1129,1,3851,0,2,3854,T
6-NA,1130,2,3845,0,1,3848,T
6-NA,1131,1,2,0,3851,3854,C
6-NA,1132,3853,0,0,0,3853,A
6-NA,1133,3854,0,0,0,3854,A
6-NA,1134,3834,3,17,0,3854,A
6-NA,1135,2,1,3881,0,3884,G
6-NA,1136,2,3814,1,2,3819,T
6-NA,1137,26,0,1,3803,3830,C
6-NA,1138,3890,2,1,0,3893,A
6-NA,1139,1,3897,1,1,3900,T
6-NA,1140,1,3889,1,1,3892,T
6-NA,1141,4,7,3883,0,3894,G
6-NA,1142,3886,0,2,0,3888,A
6-NA,1143,3897,0,1,0,3898,A
6-NA,1144,0,4,3868,0,3872,G
6-NA,1145,0,0,3870,0,3870,G
6-NA,1146,1,3,0,3835,3839,C
6-NA,1147,1,3697,0,1,3699,T
6-NA,1148,0,9,3715,0,3724,G
6-NA,1149,1,1,3784,0,3786,G
6-NA,1150,0,3773,1,11,3785,T
6-NA,1151,6,1,1,3764,3772,C
6-NA,1152,4,2,0,3750,3756,C
6-NA,1153,3731,1,1,0,3733,A
6-NA,1154,3746,1,2,0,3749,A
6-NA,1155,0,2,0,3746,3748,C
6-NA,1156,9,2,0,3706,3717,C
6-NA,1157,7,0,0,3695,3702,C
6-NA,1158,5,4,0,3528,3537,C
6-NA,1159,3554,0,1,0,3555,A
6-NA,1160,3565,0,2,0,3567,A
6-NA,1161,1,3,3580,0,3584,G
6-NA,1162,0,3569,0,2,3571,T
6-NA,1163,9,1,0,3547,3557,C
6-NA,1164,17,1,0,3513,3531,C
6-NA,1165,3520,0,2,1,3523,A
6-NA,1166,3524,0,1,0,3525,A
6-NA,1167,3525,0,0,1,3526,A
6-NA,1168,1,3525,0,1,3527,T
6-NA,1169,0,3501,0,1,3502,T
6-NA,1170,0,1,3490,1,3492,G
6-NA,1171,3,0,0,3465,3468,C
6-NA,1172,3454,2,3,0,3459,A
6-NA,1173,0,8,3455,0,3463,G
6-NA,1174,3454,0,2,0,3456,A
6-NA,1175,3,0,0,3425,3428,C
6-NA,1176,3510,0,0,1,3511,A
6-NA,1177,3512,0,0,0,3512,A
6-NA,1178,3507,0,2,0,3509,A
6-NA,1179,0,3512,0,0,3512,T
6-NA,1180,3507,1,2,0,3510,A
6-NA,1181,0,8,3509,0,3517,G
6-NA,1182,1,4,3485,1,3491,G
6-NA,1183,3,2,0,3478,3483,C
6-NA,1184,3259,0,3,0,3262,A
6-NA,1185,3302,0,0,0,3302,A
6-NA,1186,1,1,3338,0,3340,G
6-NA,1187,0,3332,0,5,3337,T
6-NA,1188,37,1,1,3299,3338,C
6-NA,1189,3346,2,2,0,3350,A
6-NA,1190,0,3338,1,0,3339,T
6-NA,1191,3401,0,1,0,3402,A
6-NA,1192,1,2,3410,0,3413,G
6-NA,1193,0,3405,0,0,3405,T
6-NA,1194,0,3261,0,1,3262,T
6-NA,1195,0,15,3182,1,3198,G
6-NA,1196,3174,0,4,0,3178,A
6-NA,1197,2,2,0,3175,3179,C
6-NA,1198,3136,1,3,0,3140,A
6-NA,1199,2,3,3173,0,3178,G
6-NA,1200,3086,0,3,0,3089,A
6-NA,1201,1,4,3085,0,3090,G
6-NA,1202,3034,1,3,0,3038,A
6-NA,1203,1,3229,0,0,3230,T
6-NA,1204,3231,0,0,1,3232,A
6-NA,1205,3226,0,3,0,3229,A
6-NA,1206,0,3230,0,0,3230,T
6-NA,1207,3190,2,4,0,3196,A
6-NA,1208,0,5,3114,0,3119,G
6-NA,1209,0,1,2998,0,2999,G
6-NA,1210,1,2765,0,5,2771,T
6-NA,1211,7,0,0,2742,2749,C
6-NA,1212,4,4,0,2690,2698,C
6-NA,1213,3,6,2687,0,2696,G
6-NA,1214,1,3,2701,0,2705,G
6-NA,1215,0,2695,0,1,2696,T
6-NA,1216,0,2684,0,0,2684,T
6-NA,1217,2645,1,3,1,2650,A
6-NA,1218,1,2613,0,0,2614,T
6-NA,1219,0,2605,0,2,2607,T
6-NA,1220,6,0,2,2606,2614,C
6-NA,1221,0,2489,0,2,2491,T
6-NA,1222,0,3,2486,0,2489,G
6-NA,1223,0,1,2498,0,2499,G
6-NA,1224,1,2490,0,1,2492,T
6-NA,1225,2493,0,0,0,2493,A
6-NA,1226,9,2455,0,0,2464,T
6-NA,1227,0,2455,0,2,2457,T
6-NA,1228,1,2457,0,0,2458,T
6-NA,1229,0,2467,0,2,2469,T
6-NA,1230,9,0,0,2461,2470,C
6-NA,1231,0,2424,0,0,2424,T
6-NA,1232,6,2,0,2462,2470,C
6-NA,1233,0,2455,0,0,2455,T
6-NA,1234,0,2,2542,0,2544,G
6-NA,1235,2,2545,0,2,2549,T
6-NA,1236,0,2525,0,0,2525,T
6-NA,1237,0,3,2531,0,2534,G
6-NA,1238,2507,1,0,0,2508,A
6-NA,1239,2496,4,2,1,2503,A
6-NA,1240,0,2,2529,0,2531,G
6-NA,1241,0,1,2520,0,2521,G
6-NA,1242,0,0,0,2520,2520,C
6-NA,1243,2456,0,1,0,2457,A
6-NA,1244,2454,0,3,0,2457,A
6-NA,1245,2464,1,1,0,2466,A
6-NA,1246,2471,0,4,0,2475,A
6-NA,1247,0,1,2485,0,2486,G
6-NA,1248,1,1,0,2473,2475,C
6-NA,1249,0,2438,1,2,2441,T
6-NA,1250,0,3,2465,0,2468,G
6-NA,1251,0,2,1,2457,2460,C
6-NA,1252,2473,1,1,0,2475,A
6-NA,1253,0,2474,1,2,2477,T
6-NA,1254,5,0,0,2438,2443,C
6-NA,1255,2443,1,0,0,2444,A
6-NA,1256,2448,0,2,0,2450,A
6-NA,1257,1,2442,0,0,2443,T
6-NA,1258,5,0,0,2440,2445,C
6-NA,1259,1,1,2410,0,2412,G
6-NA,1260,7,3,2446,0,2456,G
6-NA,1261,1,2453,0,1,2455,T
6-NA,1262,0,1,2475,0,2476,G
6-NA,1263,0,6,0,2475,2481,C
6-NA,1264,0,2464,0,6,2470,T
6-NA,1265,0,2495,0,2,2497,T
6-NA,1266,0,2497,0,0,2497,T
6-NA,1267,0,2503,0,1,2504,T
6-NA,1268,2513,0,0,0,2513,A
6-NA,1269,1,2428,0,0,2429,T
6-NA,1270,1,0,2431,0,2432,G
6-NA,1271,0,2397,0,2,2399,T
6-NA,1272,1,3,2371,0,2375,G
6-NA,1273,0,8,2399,0,2407,G
6-NA,1274,2367,0,2,0,2369,A
6-NA,1275,0,0,2401,0,2401,G
6-NA,1276,1,2378,0,5,2384,T
6-NA,1277,1,2372,1,0,2374,T
6-NA,1278,0,6,2389,0,2395,G
6-NA,1279,2388,0,3,0,2391,A
6-NA,1280,0,2386,0,1,2387,T
6-NA,1281,2384,0,0,0,2384,A
6-NA,1282,2334,1,0,0,2335,A
6-NA,1283,0,0,2347,0,2347,G
6-NA,1284,0,6,2309,0,2315,G
6-NA,1285,0,4,2297,0,2301,G
6-NA,1286,1,5,2299,0,2305,G
6-NA,1287,2267,1,4,0,2272,A
6-NA,1288,2261,2,3,0,2266,A
6-NA,1289,1,5,2275,0,2281,G
6-NA,1290,2280,0,0,0,2280,A
6-NA,1291,2274,0,0,0,2274,A
6-NA,1292,2244,0,1,0,2245,A
6-NA,1293,2210,0,5,0,2215,A
6-NA,1294,1,5,2210,0,2216,G
6-NA,1295,2185,0,2,0,2187,A
6-NA,1296,0,2,2184,0,2186,G
6-NA,1297,1,6,2182,0,2189,G
6-NA,1298,2153,0,1,0,2154,A
6-NA,1299,2156,1,0,0,2157,A
6-NA,1300,2155,0,3,0,2158,A
6-NA,1301,2,0,0,2168,2170,C
6-NA,1302,2,2153,1,1,2157,T
6-NA,1303,0,8,2158,0,2166,G
6-NA,1304,2150,1,3,0,2154,A
6-NA,1305,2143,0,7,0,2150,A
6-NA,1306,0,1,2165,0,2166,G
6-NA,1307,1,2144,0,2,2147,T
6-NA,1308,6,0,0,2183,2189,C
6-NA,1309,0,2178,0,7,2185,T
6-NA,1310,0,2165,0,1,2166,T
6-NA,1311,0,0,2166,0,2166,G
6-NA,1312,1,2155,0,4,2160,T
6-NA,1313,1,3,2153,0,2157,G
6-NA,1314,0,4,2149,0,2153,G
6-NA,1315,2122,1,2,0,2125,A
6-NA,1316,0,2,2,2113,2117,C
6-NA,1317,2046,0,0,0,2046,A
6-NA,1318,0,2043,0,1,2044,T
6-NA,1319,3,0,0,2043,2046,C
6-NA,1320,4,10,2027,0,2041,G
6-NA,1321,2087,2,0,1,2090,A
6-NA,1322,2087,2,2,0,2091,A
6-NA,1323,4,1,0,2098,2103,C
6-NA,1324,2065,1,0,0,2066,A
6-NA,1325,0,0,2139,0,2139,G
6-NA,1326,0,2120,0,1,2121,T
6-NA,1327,2127,0,0,0,2127,A
6-NA,1328,0,2131,0,1,2132,T
6-NA,1329,0,2053,0,0,2053,T
6-NA,1330,2,3,2070,0,2075,G
6-NA,1331,1,2064,0,3,2068,T
6-NA,1332,0,2020,0,1,2021,T
6-NA,1333,2,0,2023,0,2025,G
6-NA,1334,0,1821,0,1,1822,T
6-NA,1335,1,1,1830,0,1832,G
6-NA,1336,0,1804,3,4,1811,T
6-NA,1337,0,1789,1,0,1790,T
6-NA,1338,2,1790,0,0,1792,T
6-NA,1339,0,1754,0,0,1754,T
6-NA,1340,0,0,1750,0,1750,G
6-NA,1341,1,1747,0,2,1750,T
6-NA,1342,0,7,1734,0,1741,G
6-NA,1343,1,0,1740,0,1741,G
6-NA,1344,0,0,1,1725,1726,C
6-NA,1345,1721,0,2,0,1723,A
6-NA,1346,1,0,0,1749,1750,C
6-NA,1347,1,0,0,1742,1743,C
6-NA,1348,1,1737,0,2,1740,T
6-NA,1349,9,0,0,1744,1753,C
6-NA,1350,1753,1,2,0,1756,A
6-NA,1351,0,0,1775,0,1775,G
6-NA,1352,0,1,1778,0,1779,G
6-NA,1353,1,1764,0,0,1765,T
6-NA,1354,1756,1,0,0,1757,A
6-NA,1355,2,2,0,1684,1688,C
6-NA,1356,1661,0,0,0,1661,A
6-NA,1357,0,1659,0,0,1659,T
6-NA,1358,1623,0,1,0,1624,A
6-NA,1359,1,1619,0,0,1620,T
6-NA,1360,1,4,1515,1,1521,G
6-NA,1361,0,5,1514,0,1519,G
6-NA,1362,1509,1,3,0,1513,A
6-NA,1363,1496,0,0,0,1496,A
6-NA,1364,0,1,0,1484,1485,C
6-NA,1365,1241,0,0,0,1241,A
6-NA,1366,0,0,1247,1,1248,G
6-NA,1367,0,0,1244,0,1244,G
6-NA,1368,1,0,0,1250,1251,C
6-NA,1369,0,1235,0,3,1238,T
6-NA,1370,4,0,0,1179,1183,C
6-NA,1371,1170,0,1,0,1171,A
6-NA,1372,1,1166,0,1,1168,T
6-NA,1373,1,0,1164,0,1165,G
6-NA,1374,1,0,1166,0,1167,G
6-NA,1375,0,0,0,1122,1122,C
6-NA,1376,4,0,0,1101,1105,C
6-NA,1377,1,1040,0,1,1042,T
6-NA,1378,0,1,1039,0,1040,G
6-NA,1379,1039,0,0,0,1039,A
6-NA,1380,0,1035,0,0,1035,T
6-NA,1381,0,2,1020,0,1022,G
6-NA,1382,0,1,997,0,998,G
6-NA,1383,0,0,949,0,949,G
6-NA,1384,0,0,948,0,948,G
6-NA,1385,1,0,1,930,932,C
6-NA,1386,1,4,923,0,928,G
6-NA,1387,0,2,910,0,912,G
6-NA,1388,907,1,1,0,909,A
6-NA,1389,1,1,0,902,904,C
6-NA,1390,906,0,0,0,906,A
6-NA,1391,1,891,1,2,895,T
6-NA,1392,3,0,0,882,885,C
6-NA,1393,875,0,0,0,875,A
6-NA,1394,873,0,0,0,873,A
6-NA,1395,0,871,0,0,871,T
6-NA,1396,2,1,0,855,858,C
6-NA,1397,0,830,0,0,830,T
6-NA,1398,10,0,0,714,724,C
6-NA,1399,718,0,1,0,719,A
6-NA,1400,0,715,0,0,715,T
6-NA,1401,0,0,712,0,712,G
6-NA,1402,0,0,0,710,710,C
6-NA,1403,2,0,0,681,683,C
6-NA,1404,0,601,0,0,601,T
6-NA,1405,591,0,1,0,592,A
6-NA,1406,0,591,0,0,591,T
6-NA,1407,581,0,1,0,582,A
6-NA,1408,0,580,0,0,580,T
6-NA,1409,522,0,0,0,522,A
6-NA,1410,497,0,0,0,497,A
7-M,1,34,0,0,0,34,A
7-M,2,0,35,0,0,35,T
7-M,3,0,0,35,0,35,G
7-M,4,36,0,0,0,36,A
7-M,5,0,0,37,0,37,G
7-M,6,1,0,0,38,39,C
7-M,7,0,0,0,44,44,C
7-M,8,0,61,0,0,61,T
7-M,9,0,61,0,0,61,T
7-M,10,0,0,0,62,62,C
7-M,11,0,62,0,0,62,T
7-M,12,66,0,0,0,66,A
7-M,13,67,0,0,0,67,A
7-M,14,0,0,0,67,67,C
7-M,15,0,0,0,67,67,C
7-M,16,0,0,67,0,67,G
7-M,17,67,0,0,0,67,A
7-M,18,0,0,67,0,67,G
7-M,19,0,0,68,0,68,G
7-M,20,0,68,0,0,68,T
7-M,21,0,0,0,67,67,C
7-M,22,0,0,68,0,68,G
7-M,23,70,0,0,0,70,A
7-M,24,70,0,0,0,70,A
7-M,25,71,0,0,0,71,A
7-M,26,0,0,0,76,76,C
7-M,27,0,0,75,0,75,G
7-M,28,0,78,0,0,78,T
7-M,29,79,0,0,0,79,A
7-M,30,0,80,0,0,80,T
7-M,31,0,0,82,0,82,G
7-M,32,0,82,0,0,82,T
7-M,33,0,92,0,0,92,T
7-M,34,0,0,0,94,94,C
7-M,35,0,95,0,0,95,T
7-M,36,0,0,0,100,100,C
7-M,37,0,100,0,0,100,T
7-M,38,0,0,0,105,105,C
7-M,39,0,105,0,0,105,T
7-M,40,105,0,0,0,105,A
7-M,41,0,106,0,0,106,T
7-M,42,0,0,0,108,108,C
7-M,43,0,0,111,0,111,G
7-M,44,0,111,0,0,111,T
7-M,45,0,111,0,0,111,T
7-M,46,0,0,0,116,116,C
7-M,47,0,0,0,121,121,C
7-M,48,122,0,0,0,122,A
7-M,49,0,121,0,0,121,T
7-M,50,0,0,0,122,122,C
7-M,51,121,0,0,0,121,A
7-M,52,0,2,120,0,122,G
7-M,53,0,0,123,0,123,G
7-M,54,0,1,0,122,123,C
7-M,55,0,0,0,123,123,C
7-M,56,1,0,0,121,122,C
7-M,57,0,0,0,125,125,C
7-M,58,0,0,0,127,127,C
7-M,59,0,127,0,0,127,T
7-M,60,0,0,0,127,127,C
7-M,61,126,0,0,0,126,A
7-M,62,126,0,0,1,127,A
7-M,63,126,0,0,0,126,A
7-M,64,0,2,127,0,129,G
7-M,65,0,0,1,128,129,C
7-M,66,0,0,0,127,127,C
7-M,67,0,0,127,0,127,G
7-M,68,126,0,0,1,127,A
7-M,69,0,0,129,0,129,G
7-M,70,128,0,0,0,128,A
7-M,71,0,131,0,0,131,T
7-M,72,0,0,0,130,130,C
7-M,73,0,0,127,0,127,G
7-M,74,0,0,0,130,130,C
7-M,75,0,1,129,0,130,G
7-M,76,0,0,0,130,130,C
7-M,77,130,0,0,0,130,A
7-M,78,0,0,131,0,131,G
7-M,79,131,0,0,0,131,A
7-M,80,0,1,134,0,135,G
7-M,81,133,0,0,0,133,A
7-M,82,0,0,0,140,140,C
7-M,83,0,139,0,0,139,T
7-M,84,0,140,0,0,140,T
7-M,85,0,0,141,0,141,G
7-M,86,141,0,0,0,141,A
7-M,87,141,0,0,0,141,A
7-M,88,0,0,142,0,142,G
7-M,89,140,0,0,0,140,A
7-M,90,0,142,0,0,142,T
7-M,91,0,0,143,0,143,G
7-M,92,0,144,0,0,144,T
7-M,93,0,0,0,145,145,C
7-M,94,0,144,0,0,144,T
7-M,95,0,146,0,0,146,T
7-M,96,0,146,0,0,146,T
7-M,97,0,0,146,0,146,G
7-M,98,0,0,0,144,144,C
7-M,99,0,145,0,1,146,T
7-M,100,0,0,148,0,148,G
7-M,101,1,1,147,0,149,G
7-M,102,0,0,150,0,150,G
7-M,103,148,0,0,0,148,A
7-M,104,149,0,0,0,149,A
7-M,105,149,0,0,0,149,A
7-M,106,151,0,0,0,151,A
7-M,107,150,0,0,0,150,A
7-M,108,0,0,0,151,151,C
7-M,109,150,0,0,0,150,A
7-M,110,0,0,0,151,151,C
7-M,111,148,0,0,0,148,A
7-M,112,0,1,151,0,152,G
7-M,113,154,0,0,0,154,A
7-M,114,0,158,0,0,158,T
7-M,115,0,0,0,157,157,C
7-M,116,0,159,0,0,159,T
7-M,117,0,159,0,0,159,T
7-M,118,0,1,158,0,159,G
7-M,119,158,0,0,0,158,A
7-M,120,0,2,153,0,155,G
7-M,121,0,0,158,0,158,G
7-M,122,0,0,0,161,161,C
7-M,123,0,161,0,0,161,T
7-M,124,1,0,0,175,176,C
7-M,125,0,177,0,0,177,T
7-M,126,1,0,0,176,177,C
7-M,127,179,0,0,0,179,A
7-M,128,0,179,0,0,179,T
7-M,129,1,0,177,0,178,G
7-M,130,0,0,177,1,178,G
7-M,131,179,0,0,0,179,A
7-M,132,178,0,0,0,178,A
7-M,133,0,177,0,0,177,T
7-M,134,0,0,182,0,182,G
7-M,135,0,0,190,0,190,G
7-M,136,0,0,0,190,190,C
7-M,137,0,190,0,0,190,T
7-M,138,189,0,0,0,189,A
7-M,139,189,0,0,0,189,A
7-M,140,194,0,0,0,194,A
7-M,141,0,0,194,0,194,G
7-M,142,194,0,0,0,194,A
7-M,143,0,0,0,194,194,C
7-M,144,189,0,0,0,189,A
7-M,145,189,0,0,0,189,A
7-M,146,0,2,192,0,194,G
7-M,147,195,0,0,0,195,A
7-M,148,0,0,0,196,196,C
7-M,149,0,0,0,192,192,C
7-M,150,190,0,0,0,190,A
7-M,151,194,0,0,0,194,A
7-M,152,0,196,0,0,196,T
7-M,153,0,195,0,0,195,T
7-M,154,0,0,0,198,198,C
7-M,155,0,198,0,0,198,T
7-M,156,0,0,200,0,200,G
7-M,157,0,199,0,1,200,T
7-M,158,0,0,0,200,200,C
7-M,159,199,0,0,0,199,A
7-M,160,0,0,0,202,202,C
7-M,161,0,0,0,201,201,C
7-M,162,0,200,0,0,200,T
7-M,163,0,0,0,199,199,C
7-M,164,0,200,0,0,200,T
7-M,165,0,0,209,0,209,G
7-M,166,209,0,0,0,209,A
7-M,167,0,0,0,210,210,C
7-M,168,0,209,0,0,209,T
7-M,169,206,0,0,0,206,A
7-M,170,203,0,0,0,203,A
7-M,171,1,0,201,0,202,G
7-M,172,0,0,204,0,204,G
7-M,173,1,0,204,0,205,G
7-M,174,0,0,208,0,208,G
7-M,175,210,0,0,0,210,A
7-M,176,0,210,0,0,210,T
7-M,177,0,210,0,0,210,T
7-M,178,0,210,0,0,210,T
7-M,179,0,211,0,0,211,T
7-M,180,0,0,211,0,211,G
7-M,181,0,1,209,0,210,G
7-M,182,0,1,211,0,212,G
7-M,183,0,0,210,0,210,G
7-M,184,0,207,0,0,207,T
7-M,185,0,208,0,0,208,T
7-M,186,0,207,0,0,207,T
7-M,187,0,0,216,0,216,G
7-M,188,0,216,0,0,216,T
7-M,189,0,0,215,0,215,G
7-M,190,0,215,0,0,215,T
7-M,191,0,214,0,0,214,T
7-M,192,1,0,0,217,218,C
7-M,193,219,0,0,0,219,A
7-M,194,0,0,0,225,225,C
7-M,195,1,1,223,0,225,G
7-M,196,0,0,0,223,223,C
7-M,197,0,222,0,0,222,T
7-M,198,0,0,0,229,229,C
7-M,199,229,0,0,0,229,A
7-M,200,0,0,0,235,235,C
7-M,201,0,0,0,234,234,C
7-M,202,0,0,234,0,234,G
7-M,203,0,234,0,0,234,T
7-M,204,1,0,232,1,234,G
7-M,205,0,0,0,234,234,C
7-M,206,0,0,0,234,234,C
7-M,207,0,0,0,235,235,C
7-M,208,231,0,0,0,231,A
7-M,209,0,0,233,0,233,G
7-M,210,0,232,0,0,232,T
7-M,211,0,1,231,0,232,G
7-M,212,234,0,0,0,234,A
7-M,213,0,0,233,0,233,G
7-M,214,0,0,0,233,233,C
7-M,215,0,0,234,0,234,G
7-M,216,233,0,0,0,233,A
7-M,217,0,0,237,0,237,G
7-M,218,0,2,235,0,237,G
7-M,219,235,0,0,0,235,A
7-M,220,0,0,0,240,240,C
7-M,221,0,237,0,0,237,T
7-M,222,0,0,237,0,237,G
7-M,223,0,0,0,240,240,C
7-M,224,241,0,0,0,241,A
7-M,225,0,0,243,0,243,G
7-M,226,0,0,0,243,243,C
7-M,227,0,0,245,0,245,G
7-M,228,0,245,0,0,245,T
7-M,229,244,0,0,0,244,A
7-M,230,0,0,243,0,243,G
7-M,231,244,0,0,0,244,A
7-M,232,0,0,0,243,243,C
7-M,233,0,0,246,0,246,G
7-M,234,0,0,0,245,245,C
7-M,235,0,241,0,0,241,T
7-M,236,0,243,0,0,243,T
7-M,237,0,242,0,0,242,T
7-M,238,0,0,247,0,247,G
7-M,239,0,247,0,0,247,T
7-M,240,1,0,0,246,247,C
7-M,241,1,0,0,246,247,C
7-M,242,249,0,0,0,249,A
7-M,243,250,0,0,0,250,A
7-M,244,248,0,0,0,248,A
7-M,245,250,0,0,0,250,A
7-M,246,0,249,0,0,249,T
7-M,247,0,0,241,0,241,G
7-M,248,0,0,0,235,235,C
7-M,249,1,1,0,235,237,C
7-M,250,1,0,0,237,238,C
7-M,251,0,237,0,0,237,T
7-M,252,0,0,0,247,247,C
7-M,253,246,0,0,0,246,A
7-M,254,246,0,1,0,247,A
7-M,255,0,246,0,1,247,T
7-M,256,0,2,245,1,248,G
7-M,257,0,1,245,0,246,G
7-M,258,0,0,248,0,248,G
7-M,259,245,0,0,0,245,A
7-M,260,243,0,0,0,243,A
7-M,261,0,239,0,0,239,T
7-M,262,0,0,240,0,240,G
7-M,263,0,0,238,0,238,G
7-M,264,236,0,1,0,237,A
7-M,265,0,1,234,0,235,G
7-M,266,232,1,0,0,233,A
7-M,267,0,0,0,229,229,C
7-M,268,2,0,0,231,233,C
7-M,269,2,0,0,234,236,C
7-M,270,238,0,0,0,238,A
7-M,271,237,0,0,0,237,A
7-M,272,237,0,1,0,238,A
7-M,273,0,242,0,0,242,T
7-M,274,255,0,0,0,255,A
7-M,275,255,0,0,0,255,A
7-M,276,0,0,0,252,252,C
7-M,277,251,0,0,0,251,A
7-M,278,0,253,0,0,253,T
7-M,279,0,1,256,0,257,G
7-M,280,0,0,257,0,257,G
7-M,281,254,0,1,0,255,A
7-M,282,0,0,0,256,256,C
7-M,283,251,0,0,0,251,A
7-M,284,251,0,0,0,251,A
7-M,285,252,0,0,0,252,A
7-M,286,0,0,258,0,258,G
7-M,287,0,0,0,261,261,C
7-M,288,252,0,0,0,252,A
7-M,289,0,1,252,0,253,G
7-M,290,0,252,0,0,252,T
7-M,291,0,252,0,0,252,T
7-M,292,254,0,1,0,255,A
7-M,293,252,0,0,0,252,A
7-M,294,252,0,0,0,252,A
7-M,295,0,0,0,251,251,C
7-M,296,0,245,0,0,245,T
7-M,297,0,0,260,0,260,G
7-M,298,0,259,0,0,259,T
7-M,299,261,0,0,0,261,A
7-M,300,0,261,0,0,261,T
7-M,301,256,0,0,0,256,A
7-M,302,0,1,255,0,256,G
7-M,303,241,0,3,0,244,A
7-M,304,248,0,0,0,248,A
7-M,305,246,0,0,0,246,A
7-M,306,257,0,0,0,257,A
7-M,307,0,0,0,262,262,C
7-M,308,0,260,0,0,260,T
7-M,309,0,262,0,0,262,T
7-M,310,260,0,0,0,260,A
7-M,311,259,0,0,0,259,A
7-M,312,0,0,257,0,257,G
7-M,313,260,0,0,0,260,A
7-M,314,0,0,259,0,259,G
7-M,315,0,0,258,0,258,G
7-M,316,0,1,257,0,258,G
7-M,317,257,0,0,0,257,A
7-M,318,0,0,264,0,264,G
7-M,319,266,0,0,0,266,A
7-M,320,0,267,0,0,267,T
7-M,321,267,0,0,0,267,A
7-M,322,266,0,0,0,266,A
7-M,323,0,0,0,267,267,C
7-M,324,2,0,266,0,268,G
7-M,325,1,263,0,0,264,T
7-M,326,0,264,0,0,264,T
7-M,327,0,0,0,268,268,C
7-M,328,0,0,0,267,267,C
7-M,329,267,0,0,0,267,A
7-M,330,0,267,0,0,267,T
7-M,331,0,0,266,0,266,G
7-M,332,0,1,269,0,270,G
7-M,333,0,0,268,0,268,G
7-M,334,0,0,268,0,268,G
7-M,335,0,0,0,266,266,C
7-M,336,0,1,0,268,269,C
7-M,337,270,0,0,0,270,A
7-M,338,273,0,0,0,273,A
7-M,339,275,0,0,0,275,A
7-M,340,0,1,276,0,277,G
7-M,341,277,0,0,0,277,A
7-M,342,275,0,0,0,275,A
7-M,343,277,0,0,0,277,A
7-M,344,0,275,0,0,275,T
7-M,345,275,0,0,0,275,A
7-M,346,0,0,277,0,277,G
7-M,347,0,0,0,272,272,C
7-M,348,1,270,0,1,272,T
7-M,349,0,0,0,274,274,C
7-M,350,0,274,0,0,274,T
7-M,351,2,0,0,281,283,C
7-M,352,283,0,0,0,283,A
7-M,353,0,0,283,0,283,G
7-M,354,0,280,0,0,280,T
7-M,355,0,282,0,0,282,T
7-M,356,282,0,0,0,282,A
7-M,357,0,284,0,0,284,T
7-M,358,0,283,0,0,283,T
7-M,359,0,0,0,282,282,C
7-M,360,0,272,0,0,272,T
7-M,361,0,0,275,0,275,G
7-M,362,0,0,0,278,278,C
7-M,363,0,277,0,0,277,T
7-M,364,0,0,277,0,277,G
7-M,365,0,0,275,0,275,G
7-M,366,0,278,0,0,278,T
7-M,367,0,0,277,0,277,G
7-M,368,0,0,0,274,274,C
7-M,369,275,1,0,0,276,A
7-M,370,0,0,0,276,276,C
7-M,371,0,276,0,0,276,T
7-M,372,0,276,0,0,276,T
7-M,373,0,0,275,0,275,G
7-M,374,0,0,0,277,277,C
7-M,375,0,0,0,277,277,C
7-M,376,277,0,0,0,277,A
7-M,377,0,0,279,0,279,G
7-M,378,0,278,0,0,278,T
7-M,379,0,276,0,2,278,T
7-M,380,1,1,276,0,278,G
7-M,381,0,0,0,274,274,C
7-M,382,273,0,0,0,273,A
7-M,383,0,272,0,1,273,T
7-M,384,1,1,270,0,272,G
7-M,385,0,0,276,0,276,G
7-M,386,0,0,278,0,278,G
7-M,387,0,0,0,278,278,C
7-M,388,0,0,0,283,283,C
7-M,389,1,279,0,0,280,T
7-M,390,1,0,0,290,291,C
7-M,391,301,0,0,0,301,A
7-M,392,0,301,0,0,301,T
7-M,393,300,0,4,0,304,A
7-M,394,0,295,0,0,295,T
7-M,395,294,0,0,0,294,A
7-M,396,0,0,0,313,313,C
7-M,397,301,0,0,0,301,A
7-M,398,300,0,0,0,300,A
7-M,399,0,296,0,0,296,T
7-M,400,272,0,0,0,272,A
7-M,401,0,0,275,0,275,G
7-M,402,0,0,270,0,270,G
7-M,403,269,0,0,0,269,A
7-M,404,0,268,0,0,268,T
7-M,405,0,0,262,0,262,G
7-M,406,0,0,262,0,262,G
7-M,407,0,0,263,0,263,G
7-M,408,0,1,261,0,262,G
7-M,409,0,0,266,0,266,G
7-M,410,0,0,0,263,263,C
7-M,411,0,257,0,0,257,T
7-M,412,0,0,258,0,258,G
7-M,413,0,257,0,0,257,T
7-M,414,259,0,0,0,259,A
7-M,415,261,0,0,0,261,A
7-M,416,0,0,0,261,261,C
7-M,417,1,0,0,254,255,C
7-M,418,252,0,1,0,253,A
7-M,419,0,0,0,255,255,C
7-M,420,0,255,0,0,255,T
7-M,421,0,0,259,0,259,G
7-M,422,260,0,0,0,260,A
7-M,423,257,0,0,0,257,A
7-M,424,0,0,259,0,259,G
7-M,425,0,257,0,0,257,T
7-M,426,0,2,253,0,255,G
7-M,427,0,0,257,0,257,G
7-M,428,1,0,0,259,260,C
7-M,429,260,0,0,0,260,A
7-M,430,0,259,0,0,259,T
7-M,431,0,259,0,0,259,T
7-M,432,0,260,0,0,260,T
7-M,433,0,2,264,0,266,G
7-M,434,0,0,265,0,265,G
7-M,435,1,0,0,266,267,C
7-M,436,0,0,0,264,264,C
7-M,437,0,260,0,0,260,T
7-M,438,0,0,271,0,271,G
7-M,439,0,0,272,0,272,G
7-M,440,0,272,0,0,272,T
7-M,441,277,0,0,0,277,A
7-M,442,0,270,0,0,270,T
7-M,443,0,0,273,0,273,G
7-M,444,0,274,0,0,274,T
7-M,445,0,0,273,0,273,G
7-M,446,0,0,0,273,273,C
7-M,447,264,0,1,0,265,A
7-M,448,266,0,0,0,266,A
7-M,449,0,0,0,270,270,C
7-M,450,269,0,0,0,269,A
7-M,451,0,270,0,0,270,T
7-M,452,0,1,265,0,266,G
7-M,453,0,257,0,0,257,T
7-M,454,0,0,258,0,258,G
7-M,455,254,0,1,0,255,A
7-M,456,0,0,257,0,257,G
7-M,457,0,0,0,257,257,C
7-M,458,253,0,0,0,253,A
7-M,459,0,0,256,0,256,G
7-M,460,255,0,0,0,255,A
7-M,461,0,257,0,0,257,T
7-M,462,0,257,0,1,258,T
7-M,463,0,0,257,0,257,G
7-M,464,0,1,0,255,256,C
7-M,465,0,257,0,0,257,T
7-M,466,0,1,257,0,258,G
7-M,467,259,0,0,0,259,A
7-M,468,1,0,0,266,267,C
7-M,469,0,264,0,1,265,T
7-M,470,0,0,0,265,265,C
7-M,471,2,0,0,263,265,C
7-M,472,1,0,0,264,265,C
7-M,473,262,0,0,0,262,A
7-M,474,0,0,263,0,263,G
7-M,475,0,0,0,261,261,C
7-M,476,263,0,0,0,263,A
7-M,477,0,0,0,264,264,C
7-M,478,242,0,0,0,242,A
7-M,479,0,0,248,0,248,G
7-M,480,0,0,249,0,249,G
7-M,481,1,248,0,0,249,T
7-M,482,0,0,0,251,251,C
7-M,483,0,249,0,0,249,T
7-M,484,0,0,0,254,254,C
7-M,485,252,0,0,0,252,A
7-M,486,0,253,0,0,253,T
7-M,487,253,0,0,0,253,A
7-M,488,0,0,251,0,251,G
7-M,489,0,0,250,0,250,G
7-M,490,1,0,0,246,247,C
7-M,491,239,0,0,0,239,A
7-M,492,0,1,236,0,237,G
7-M,493,242,0,0,0,242,A
7-M,494,0,244,0,0,244,T
7-M,495,0,0,244,0,244,G
7-M,496,0,1,244,0,245,G
7-M,497,0,245,0,0,245,T
7-M,498,0,1,246,0,247,G
7-M,499,0,0,247,0,247,G
7-M,500,0,0,0,247,247,C
7-M,501,245,0,0,0,245,A
7-M,502,246,0,0,0,246,A
7-M,503,0,0,0,247,247,C
7-M,504,245,0,0,0,245,A
7-M,505,246,0,0,0,246,A
7-M,506,0,0,0,243,243,C
7-M,507,1,0,0,239,240,C
7-M,508,240,0,0,0,240,A
7-M,509,240,0,0,0,240,A
7-M,510,0,239,0,0,239,T
7-M,511,0,0,0,240,240,C
7-M,512,1,0,0,234,235,C
7-M,513,236,0,0,0,236,A
7-M,514,0,234,0,1,235,T
7-M,515,0,236,0,0,236,T
7-M,516,237,0,0,0,237,A
7-M,517,238,0,0,0,238,A
7-M,518,0,237,0,0,237,T
7-M,519,236,0,0,0,236,A
7-M,520,235,0,0,0,235,A
7-M,521,234,0,0,0,234,A
7-M,522,237,0,0,0,237,A
7-M,523,0,0,0,242,242,C
7-M,524,244,0,0,0,244,A
7-M,525,0,244,0,0,244,T
7-M,526,0,1,242,0,243,G
7-M,527,242,0,0,0,242,A
7-M,528,0,1,244,0,245,G
7-M,529,244,0,0,0,244,A
7-M,530,246,0,0,0,246,A
7-M,531,0,0,0,247,247,C
7-M,532,235,0,0,0,235,A
7-M,533,0,1,237,0,238,G
7-M,534,238,0,0,0,238,A
7-M,535,238,0,1,0,239,A
7-M,536,0,237,0,0,237,T
7-M,537,0,0,237,0,237,G
7-M,538,0,0,240,0,240,G
7-M,539,0,237,0,0,237,T
7-M,540,0,231,0,0,231,T
7-M,541,0,235,0,0,235,T
7-M,542,0,237,0,0,237,T
7-M,543,0,0,237,0,237,G
7-M,544,0,0,237,0,237,G
7-M,545,0,0,0,237,237,C
7-M,546,0,0,1,236,237,C
7-M,547,227,0,0,0,227,A
7-M,548,0,0,232,0,232,G
7-M,549,0,0,0,229,229,C
7-M,550,232,0,0,0,232,A
7-M,551,0,0,0,235,235,C
7-M,552,0,229,0,0,229,T
7-M,553,229,0,0,0,229,A
7-M,554,0,1,0,229,230,C
7-M,555,232,0,1,0,233,A
7-M,556,0,0,238,0,238,G
7-M,557,0,0,0,230,230,C
7-M,558,0,226,0,0,226,T
7-M,559,228,0,0,0,228,A
7-M,560,222,0,0,1,223,A
7-M,561,0,0,224,0,224,G
7-M,562,0,0,224,0,224,G
7-M,563,0,0,0,221,221,C
7-M,564,0,208,0,0,208,T
7-M,565,209,0,1,0,210,A
7-M,566,0,209,0,0,209,T
7-M,567,0,0,209,0,209,G
7-M,568,0,1,209,0,210,G
7-M,569,204,0,0,0,204,A
7-M,570,0,0,208,0,208,G
7-M,571,0,0,0,206,206,C
7-M,572,203,0,0,0,203,A
7-M,573,204,0,0,0,204,A
7-M,574,203,0,0,0,203,A
7-M,575,0,203,0,0,203,T
7-M,576,0,0,204,0,204,G
7-M,577,0,1,201,0,202,G
7-M,578,0,0,0,200,200,C
7-M,579,0,196,0,0,196,T
7-M,580,0,0,197,0,197,G
7-M,581,0,1,194,0,195,G
7-M,582,197,0,0,0,197,A
7-M,583,0,196,0,0,196,T
7-M,584,2,0,0,196,198,C
7-M,585,199,0,0,0,199,A
7-M,586,200,0,0,0,200,A
7-M,587,0,1,199,0,200,G
7-M,588,0,199,0,0,199,T
7-M,589,0,0,201,0,201,G
7-M,590,198,0,0,0,198,A
7-M,591,0,0,201,0,201,G
7-M,592,0,0,0,201,201,C
7-M,593,202,0,0,0,202,A
7-M,594,0,0,205,0,205,G
7-M,595,0,0,202,0,202,G
7-M,596,0,0,0,202,202,C
7-M,597,200,0,0,0,200,A
7-M,598,0,0,201,0,201,G
7-M,599,0,0,0,201,201,C
7-M,600,0,0,200,0,200,G
7-M,601,0,0,201,0,201,G
7-M,602,201,0,0,0,201,A
7-M,603,0,1,203,0,204,G
7-M,604,0,0,208,0,208,G
7-M,605,0,0,0,211,211,C
7-M,606,1,0,0,208,209,C
7-M,607,206,0,0,0,206,A
7-M,608,0,208,0,0,208,T
7-M,609,0,0,209,0,209,G
7-M,610,0,0,211,0,211,G
7-M,611,210,0,0,0,210,A
7-M,612,0,0,210,0,210,G
7-M,613,206,0,0,0,206,A
7-M,614,0,211,0,0,211,T
7-M,615,0,209,0,0,209,T
7-M,616,0,0,209,0,209,G
7-M,617,0,0,0,208,208,C
7-M,618,0,208,0,0,208,T
7-M,619,209,0,0,0,209,A
7-M,620,0,0,210,0,210,G
7-M,621,0,203,0,0,203,T
7-M,622,1,0,0,204,205,C
7-M,623,201,0,0,0,201,A
7-M,624,0,0,203,0,203,G
7-M,625,0,0,203,0,203,G
7-M,626,1,0,0,200,201,C
7-M,627,1,0,0,203,204,C
7-M,628,203,0,0,0,203,A
7-M,629,0,1,203,0,204,G
7-M,630,0,0,207,0,207,G
7-M,631,0,0,0,206,206,C
7-M,632,207,0,0,0,207,A
7-M,633,0,0,206,0,206,G
7-M,634,204,0,0,0,204,A
7-M,635,0,204,0,0,204,T
7-M,636,0,0,205,0,205,G
7-M,637,0,1,208,0,209,G
7-M,638,0,200,0,0,200,T
7-M,639,1,0,199,0,200,G
7-M,640,0,0,0,202,202,C
7-M,641,202,0,0,0,202,A
7-M,642,0,0,203,0,203,G
7-M,643,0,0,204,0,204,G
7-M,644,0,1,0,201,202,C
7-M,645,203,0,0,0,203,A
7-M,646,202,0,0,0,202,A
7-M,647,0,198,0,0,198,T
7-M,648,0,0,199,0,199,G
7-M,649,199,0,0,0,199,A
7-M,650,0,0,199,0,199,G
7-M,651,193,0,1,0,194,A
7-M,652,0,0,197,0,197,G
7-M,653,0,0,0,200,200,C
7-M,654,0,0,0,200,200,C
7-M,655,201,0,0,0,201,A
7-M,656,0,202,0,0,202,T
7-M,657,0,202,0,0,202,T
7-M,658,0,1,201,0,202,G
7-M,659,0,0,197,0,197,G
7-M,660,0,0,199,0,199,G
7-M,661,200,0,0,0,200,A
7-M,662,0,0,0,199,199,C
7-M,663,0,193,0,1,194,T
7-M,664,0,0,0,196,196,C
7-M,665,195,0,0,0,195,A
7-M,666,1,201,0,0,202,T
7-M,667,0,0,0,203,203,C
7-M,668,0,0,0,201,201,C
7-M,669,0,200,0,0,200,T
7-M,670,200,0,0,0,200,A
7-M,671,0,0,203,0,203,G
7-M,672,1,225,0,0,226,T
7-M,673,0,225,0,0,225,T
7-M,674,2,0,0,223,225,C
7-M,675,0,0,0,219,219,C
7-M,676,217,0,0,0,217,A
7-M,677,0,0,221,0,221,G
7-M,678,1,220,0,0,221,T
7-M,679,221,0,0,0,221,A
7-M,680,0,0,1,220,221,C
7-M,681,0,197,0,0,197,T
7-M,682,0,1,204,0,205,G
7-M,683,0,0,205,0,205,G
7-M,684,0,202,0,0,202,T
7-M,685,1,0,0,206,207,C
7-M,686,0,205,0,1,206,T
7-M,687,205,0,0,0,205,A
7-M,688,205,0,0,1,206,A
7-M,689,0,1,205,0,206,G
7-M,690,204,0,0,0,204,A
7-M,691,0,1,198,0,199,G
7-M,692,190,0,0,0,190,A
7-M,693,0,191,0,0,191,T
7-M,694,0,0,190,0,190,G
7-M,695,189,0,0,0,189,A
7-M,696,0,188,0,1,189,T
7-M,697,0,0,0,188,188,C
7-M,698,0,187,0,0,187,T
7-M,699,0,186,0,0,186,T
7-M,700,1,0,0,185,186,C
7-M,701,0,185,0,1,186,T
7-M,702,0,185,0,0,185,T
7-M,703,0,0,185,0,185,G
7-M,704,186,0,0,0,186,A
7-M,705,186,0,0,0,186,A
7-M,706,186,0,0,0,186,A
7-M,707,186,0,0,0,186,A
7-M,708,0,186,0,0,186,T
7-M,709,0,186,0,0,186,T
7-M,710,0,185,0,0,185,T
7-M,711,0,0,185,0,185,G
7-M,712,0,0,0,186,186,C
7-M,713,184,0,0,0,184,A
7-M,714,0,1,185,0,186,G
7-M,715,184,0,0,0,184,A
7-M,716,0,0,0,193,193,C
7-M,717,1,0,0,192,193,C
7-M,718,0,192,0,0,192,T
7-M,719,193,0,0,0,193,A
7-M,720,0,193,0,0,193,T
7-M,721,0,0,0,194,194,C
7-M,722,193,1,0,0,194,A
7-M,723,0,0,194,0,194,G
7-M,724,192,0,0,0,192,A
7-M,725,184,0,0,0,184,A
7-M,726,184,0,0,0,184,A
7-M,727,0,0,0,184,184,C
7-M,728,0,0,186,0,186,G
7-M,729,185,0,0,0,185,A
7-M,730,186,0,0,0,186,A
7-M,731,0,185,0,0,185,T
7-M,732,0,0,185,0,185,G
7-M,733,0,0,186,0,186,G
7-M,734,0,0,184,0,184,G
7-M,735,0,0,186,0,186,G
7-M,736,0,0,189,0,189,G
7-M,737,0,180,1,0,181,T
7-M,738,0,0,182,0,182,G
7-M,739,0,0,0,185,185,C
7-M,740,183,1,0,0,184,A
7-M,741,0,0,186,0,186,G
7-M,742,182,0,0,0,182,A
7-M,743,0,182,0,0,182,T
7-M,744,0,0,182,0,182,G
7-M,745,0,0,1,175,176,C
7-M,746,176,0,0,0,176,A
7-M,747,176,0,1,0,177,A
7-M,748,0,0,0,175,175,C
7-M,749,0,0,176,0,176,G
7-M,750,176,0,0,0,176,A
7-M,751,0,175,0,0,175,T
7-M,752,0,174,0,0,174,T
7-M,753,1,0,0,175,176,C
7-M,754,173,0,0,0,173,A
7-M,755,173,0,0,0,173,A
7-M,756,0,0,174,0,174,G
7-M,757,0,171,0,0,171,T
7-M,758,0,2,169,0,171,G
7-M,759,168,0,0,0,168,A
7-M,760,0,0,0,169,169,C
7-M,761,0,0,0,167,167,C
7-M,762,0,0,0,168,168,C
7-M,763,0,0,169,0,169,G
7-M,764,1,0,0,170,171,C
7-M,765,0,170,0,0,170,T
7-M,766,0,172,0,0,172,T
7-M,767,0,0,173,0,173,G
7-M,768,0,172,0,0,172,T
7-M,769,0,172,0,0,172,T
7-M,770,0,0,171,0,171,G
7-M,771,0,167,0,0,167,T
7-M,772,0,165,0,0,165,T
7-M,773,0,0,163,0,163,G
7-M,774,0,0,0,163,163,C
7-M,775,0,0,0,161,161,C
7-M,776,1,0,162,0,163,G
7-M,777,0,1,0,160,161,C
7-M,778,0,0,163,0,163,G
7-M,779,163,0,0,0,163,A
7-M,780,163,0,0,0,163,A
7-M,781,0,163,0,0,163,T
7-M,782,162,0,0,0,162,A
7-M,783,0,163,0,0,163,T
7-M,784,0,0,0,162,162,C
7-M,785,163,0,0,0,163,A
7-M,786,0,162,0,1,163,T
7-M,787,0,161,0,0,161,T
7-M,788,0,1,161,0,162,G
7-M,789,0,0,160,0,160,G
7-M,790,0,0,162,0,162,G
7-M,791,164,0,0,0,164,A
7-M,792,1,161,0,0,162,T
7-M,793,0,0,0,160,160,C
7-M,794,0,159,0,0,159,T
7-M,795,1,158,0,0,159,T
7-M,796,0,0,159,0,159,G
7-M,797,0,0,0,158,158,C
7-M,798,161,0,0,0,161,A
7-M,799,0,0,0,164,164,C
7-M,800,0,160,0,0,160,T
7-M,801,0,158,0,1,159,T
7-M,802,0,0,158,0,158,G
7-M,803,161,0,0,0,161,A
7-M,804,0,161,0,0,161,T
7-M,805,159,0,0,0,159,A
7-M,806,0,159,0,0,159,T
7-M,807,0,155,0,0,155,T
7-M,808,0,0,155,0,155,G
7-M,809,0,154,0,0,154,T
7-M,810,0,1,152,0,153,G
7-M,811,0,1,152,0,153,G
7-M,812,149,0,0,0,149,A
7-M,813,0,152,0,0,152,T
7-M,814,0,153,0,0,153,T
7-M,815,0,0,0,152,152,C
7-M,816,0,153,0,0,153,T
7-M,817,0,150,0,0,150,T
7-M,818,0,0,150,0,150,G
7-M,819,149,0,0,0,149,A
7-M,820,0,149,0,0,149,T
7-M,821,0,0,0,148,148,C
7-M,822,0,0,147,0,147,G
7-M,823,1,145,0,0,146,T
7-M,824,0,0,0,147,147,C
7-M,825,0,145,0,0,145,T
7-M,826,0,146,0,0,146,T
7-M,827,0,147,0,0,147,T
7-M,828,0,147,0,0,147,T
7-M,829,0,148,0,0,148,T
7-M,830,0,148,0,0,148,T
7-M,831,0,148,0,0,148,T
7-M,832,1,0,0,147,148,C
7-M,833,148,0,0,0,148,A
7-M,834,148,0,0,0,148,A
7-M,835,148,0,0,0,148,A
7-M,836,0,147,0,0,147,T
7-M,837,0,1,148,0,149,G
7-M,838,0,0,0,150,150,C
7-M,839,1,0,149,0,150,G
7-M,840,1,150,0,1,152,T
7-M,841,0,0,0,150,150,C
7-M,842,0,150,0,0,150,T
7-M,843,151,0,0,0,151,A
7-M,844,0,151,0,0,151,T
7-M,845,0,0,0,149,149,C
7-M,846,0,0,147,0,147,G
7-M,847,148,0,0,0,148,A
7-M,848,0,0,0,148,148,C
7-M,849,1,139,0,0,140,T
7-M,850,0,0,0,144,144,C
7-M,851,0,144,0,0,144,T
7-M,852,0,143,0,0,143,T
7-M,853,2,0,0,141,143,C
7-M,854,143,0,0,0,143,A
7-M,855,143,0,0,0,143,A
7-M,856,143,0,0,0,143,A
7-M,857,0,0,0,143,143,C
7-M,858,143,0,0,0,143,A
7-M,859,0,0,0,137,137,C
7-M,860,0,0,128,0,128,G
7-M,861,0,0,138,0,138,G
7-M,862,0,0,0,138,138,C
7-M,863,0,0,0,137,137,C
7-M,864,0,137,0,0,137,T
7-M,865,0,137,0,0,137,T
7-M,866,137,0,0,0,137,A
7-M,867,137,0,0,0,137,A
7-M,868,136,0,0,0,136,A
7-M,869,135,0,0,0,135,A
7-M,870,0,1,135,0,136,G
7-M,871,116,0,1,0,117,A
7-M,872,0,0,117,0,117,G
7-M,873,0,0,117,0,117,G
7-M,874,0,0,0,117,117,C
7-M,875,1,0,0,116,117,C
7-M,876,1,0,0,114,115,C
7-M,877,0,116,0,0,116,T
7-M,878,0,117,0,0,117,T
7-M,879,0,0,0,116,116,C
7-M,880,0,117,0,0,117,T
7-M,881,116,0,1,0,117,A
7-M,882,0,0,0,117,117,C
7-M,883,0,0,113,0,113,G
7-M,884,0,0,113,0,113,G
7-M,885,108,0,0,0,108,A
7-M,886,106,0,0,0,106,A
7-M,887,0,0,107,0,107,G
7-M,888,0,0,107,0,107,G
7-M,889,102,0,0,0,102,A
7-M,890,0,0,103,0,103,G
7-M,891,0,101,0,0,101,T
7-M,892,102,0,0,0,102,A
7-M,893,0,0,0,102,102,C
7-M,894,0,0,0,102,102,C
7-M,895,0,101,0,0,101,T
7-M,896,0,0,100,0,100,G
7-M,897,94,0,0,0,94,A
7-M,898,0,0,97,0,97,G
7-M,899,0,95,0,0,95,T
7-M,900,1,0,0,94,95,C
7-M,901,0,92,0,0,92,T
7-M,902,93,0,0,0,93,A
7-M,903,0,91,0,0,91,T
7-M,904,0,0,92,0,92,G
7-M,905,90,0,0,0,90,A
7-M,906,0,0,89,0,89,G
7-M,907,0,0,83,0,83,G
7-M,908,0,0,82,0,82,G
7-M,909,79,0,0,0,79,A
7-M,910,79,0,0,0,79,A
7-M,911,0,0,79,0,79,G
7-M,912,79,0,0,0,79,A
7-M,913,114,0,0,0,114,A
7-M,914,1,114,0,0,115,T
7-M,915,110,0,0,0,110,A
7-M,916,0,110,0,0,110,T
7-M,917,0,37,0,70,107,C
7-M,918,0,0,123,0,123,G
7-M,919,123,0,0,0,123,A
7-M,920,124,0,0,0,124,A
7-M,921,124,0,0,0,124,A
7-M,922,0,0,122,0,122,G
7-M,923,0,0,134,0,134,G
7-M,924,134,0,0,0,134,A
7-M,925,134,0,0,0,134,A
7-M,926,0,0,0,137,137,C
7-M,927,136,0,0,0,136,A
7-M,928,0,1,149,0,150,G
7-M,929,0,0,0,150,150,C
7-M,930,151,0,0,0,151,A
7-M,931,0,1,153,0,154,G
7-M,932,149,0,0,0,149,A
7-M,933,151,0,0,0,151,A
7-M,934,0,152,0,0,152,T
7-M,935,0,0,156,0,156,G
7-M,936,0,0,0,156,156,C
7-M,937,0,147,0,0,147,T
7-M,938,0,0,147,0,147,G
7-M,939,0,146,0,0,146,T
7-M,940,0,1,144,0,145,G
7-M,941,0,0,146,0,146,G
7-M,942,146,0,0,0,146,A
7-M,943,0,146,0,0,146,T
7-M,944,0,0,149,0,149,G
7-M,945,0,0,0,147,147,C
7-M,946,0,145,0,0,145,T
7-M,947,0,1,144,0,145,G
7-M,948,144,0,0,0,144,A
7-M,949,0,0,0,143,143,C
7-M,950,0,0,142,0,142,G
7-M,951,141,0,0,0,141,A
7-M,952,0,0,0,142,142,C
7-M,953,135,0,0,0,135,A
7-M,954,0,0,135,0,135,G
7-M,955,0,134,0,0,134,T
7-M,956,1,0,0,136,137,C
7-M,957,137,0,0,0,137,A
7-M,958,0,136,0,0,136,T
7-M,959,0,136,0,0,136,T
7-M,960,0,135,0,0,135,T
7-M,961,0,134,0,0,134,T
7-M,962,0,0,134,0,134,G
7-M,963,0,127,0,0,127,T
7-M,964,1,0,0,126,127,C
7-M,965,121,0,0,0,121,A
7-M,966,0,0,121,0,121,G
7-M,967,0,0,0,122,122,C
7-M,968,122,0,0,0,122,A
7-M,969,0,121,0,0,121,T
7-M,970,116,0,0,0,116,A
7-M,971,0,0,117,0,117,G
7-M,972,116,0,0,0,116,A
7-M,973,0,0,116,0,116,G
7-M,974,0,115,0,0,115,T
7-M,975,0,84,0,0,84,T
7-M,976,0,0,83,0,83,G
7-M,977,0,0,84,0,84,G
7-M,978,83,0,0,0,83,A
7-M,979,0,0,84,0,84,G
7-M,980,0,63,0,0,63,T
7-M,981,60,0,0,0,60,A
7-M,982,60,0,0,0,60,A
8-NS,1,246,0,0,0,246,A
8-NS,2,0,246,0,0,246,T
8-NS,3,0,0,260,0,260,G
8-NS,4,0,2,273,0,275,G
8-NS,5,294,0,0,0,294,A
8-NS,6,0,608,0,0,608,T
8-NS,7,0,606,0,1,607,T
8-NS,8,0,0,0,633,633,C
8-NS,9,0,0,0,635,635,C
8-NS,10,637,0,0,0,637,A
8-NS,11,644,0,0,0,644,A
8-NS,12,0,0,0,644,644,C
8-NS,13,644,0,1,0,645,A
8-NS,14,0,0,0,651,651,C
8-NS,15,0,652,0,0,652,T
8-NS,16,0,0,724,0,724,G
8-NS,17,0,724,1,0,725,T
8-NS,18,0,0,733,0,733,G
8-NS,19,0,734,0,1,735,T
8-NS,20,2,0,0,734,736,C
8-NS,21,737,0,0,0,737,A
8-NS,22,735,0,1,0,736,A
8-NS,23,1,1,749,0,751,G
8-NS,24,0,766,0,0,766,T
8-NS,25,0,758,0,1,759,T
8-NS,26,0,775,0,0,775,T
8-NS,27,1,1,0,772,774,C
8-NS,28,1,0,0,772,773,C
8-NS,29,774,0,1,0,775,A
8-NS,30,0,2,781,0,783,G
8-NS,31,1,0,789,0,790,G
8-NS,32,0,792,0,0,792,T
8-NS,33,792,1,0,0,793,A
8-NS,34,0,1,802,0,803,G
8-NS,35,804,0,0,0,804,A
8-NS,36,0,803,0,1,804,T
8-NS,37,0,803,0,0,803,T
8-NS,38,0,1,812,0,813,G
8-NS,39,0,1,0,810,811,C
8-NS,40,0,811,0,0,811,T
8-NS,41,0,815,0,1,816,T
8-NS,42,0,818,0,0,818,T
8-NS,43,3,0,0,832,835,C
8-NS,44,0,833,0,0,833,T
8-NS,45,0,832,0,0,832,T
8-NS,46,0,832,0,0,832,T
8-NS,47,1,1,837,0,839,G
8-NS,48,0,1,841,0,842,G
8-NS,49,0,1,0,842,843,C
8-NS,50,841,0,1,0,842,A
8-NS,51,0,843,0,0,843,T
8-NS,52,848,1,0,0,849,A
8-NS,53,0,865,0,0,865,T
8-NS,54,0,0,0,865,865,C
8-NS,55,2,1,0,862,865,C
8-NS,56,1,1,863,0,865,G
8-NS,57,0,2,871,0,873,G
8-NS,58,873,0,0,0,873,A
8-NS,59,875,0,0,0,875,A
8-NS,60,874,0,1,0,875,A
8-NS,61,0,0,0,882,882,C
8-NS,62,884,0,0,0,884,A
8-NS,63,884,0,1,0,885,A
8-NS,64,0,0,918,0,918,G
8-NS,65,0,925,0,0,925,T
8-NS,66,1,922,0,0,923,T
8-NS,67,7,1,913,0,921,G
8-NS,68,0,924,0,0,924,T
8-NS,69,922,0,2,0,924,A
8-NS,70,0,3,921,0,924,G
8-NS,71,975,0,0,0,975,A
8-NS,72,0,0,0,991,991,C
8-NS,73,1,0,0,978,979,C
8-NS,74,979,0,0,0,979,A
8-NS,75,981,0,0,0,981,A
8-NS,76,0,2,1033,0,1035,G
8-NS,77,1033,1,1,0,1035,A
8-NS,78,1046,0,0,0,1046,A
8-NS,79,1,0,0,1048,1049,C
8-NS,80,0,1032,0,0,1032,T
8-NS,81,1,5,1038,0,1044,G
8-NS,82,1041,1,0,0,1042,A
8-NS,83,0,0,1062,0,1062,G
8-NS,84,0,1060,0,1,1061,T
8-NS,85,0,1,1047,0,1048,G
8-NS,86,1053,0,1,0,1054,A
8-NS,87,1,1055,0,0,1056,T
8-NS,88,2,3,1064,0,1069,G
8-NS,89,0,0,0,1092,1092,C
8-NS,90,3,0,0,1095,1098,C
8-NS,91,1,0,0,1102,1103,C
8-NS,92,2,0,1,1087,1090,C
8-NS,93,1102,0,0,0,1102,A
8-NS,94,0,1119,0,1,1120,T
8-NS,95,0,1138,0,0,1138,T
8-NS,96,1,0,1,1145,1147,C
8-NS,97,0,0,0,1143,1143,C
8-NS,98,0,1138,0,2,1140,T
8-NS,99,1,1136,0,0,1137,T
8-NS,100,0,11,1128,0,1139,G
8-NS,101,1138,0,0,0,1138,A
8-NS,102,1,1140,0,1,1142,T
8-NS,103,6,1,0,1131,1138,C
8-NS,104,0,1,1131,0,1132,G
8-NS,105,0,0,1144,0,1144,G
8-NS,106,0,0,0,1145,1145,C
8-NS,107,2,1140,0,1,1143,T
8-NS,108,0,1145,0,0,1145,T
8-NS,109,1,0,0,1139,1140,C
8-NS,110,0,0,1144,0,1144,G
8-NS,111,0,0,0,1140,1140,C
8-NS,112,0,0,0,1143,1143,C
8-NS,113,1,4,1143,1,1149,G
8-NS,114,1139,0,0,0,1139,A
8-NS,115,0,3,1173,0,1176,G
8-NS,116,1180,0,1,0,1181,A
8-NS,117,0,1181,1,0,1182,T
8-NS,118,2,0,0,1181,1183,C
8-NS,119,1181,0,0,0,1181,A
8-NS,120,0,1,1185,0,1186,G
8-NS,121,1181,0,2,0,1183,A
8-NS,122,1,3,1180,0,1184,G
8-NS,123,0,0,1201,0,1201,G
8-NS,124,0,1191,0,5,1196,T
8-NS,125,2,1,0,1268,1271,C
8-NS,126,3,0,0,1272,1275,C
8-NS,127,0,0,0,1280,1280,C
8-NS,128,0,1281,0,0,1281,T
8-NS,129,1282,0,0,0,1282,A
8-NS,130,1283,0,1,0,1284,A
8-NS,131,1,2,1302,0,1305,G
8-NS,132,0,3,1300,0,1303,G
8-NS,133,0,0,1289,0,1289,G
8-NS,134,0,3,1258,0,1261,G
8-NS,135,1252,1,0,0,1253,A
8-NS,136,1252,0,0,0,1252,A
8-NS,137,0,3,1263,0,1266,G
8-NS,138,1282,0,1,0,1283,A
8-NS,139,0,2,1285,0,1287,G
8-NS,140,0,3,1291,0,1294,G
8-NS,141,1,0,0,1285,1286,C
8-NS,142,1282,0,2,1,1285,A
8-NS,143,1292,0,1,0,1293,A
8-NS,144,0,1293,0,0,1293,T
8-NS,145,1300,0,2,0,1302,A
8-NS,146,1,0,0,1318,1319,C
8-NS,147,0,1290,0,1,1291,T
8-NS,148,6,0,1,1285,1292,C
8-NS,149,0,1286,0,1,1287,T
8-NS,150,3,5,0,1289,1297,C
8-NS,151,0,0,1310,0,1310,G
8-NS,152,0,0,1396,0,1396,G
8-NS,153,0,1401,0,0,1401,T
8-NS,154,3,0,0,1398,1401,C
8-NS,155,1,1393,0,1,1395,T
8-NS,156,1401,1,1,0,1403,A
8-NS,157,0,2,1403,1,1406,G
8-NS,158,1406,0,1,0,1407,A
8-NS,159,0,1,0,1431,1432,C
8-NS,160,1406,0,0,0,1406,A
8-NS,161,0,1388,0,2,1390,T
8-NS,162,5,3,0,1387,1395,C
8-NS,163,1390,0,0,0,1390,A
8-NS,164,1389,0,0,1,1390,A
8-NS,165,1384,0,2,1,1387,A
8-NS,166,0,0,1387,0,1387,G
8-NS,167,0,0,0,1391,1391,C
8-NS,168,1378,0,1,0,1379,A
8-NS,169,0,0,1386,0,1386,G
8-NS,170,0,0,0,1381,1381,C
8-NS,171,1,1,0,1382,1384,C
8-NS,172,1397,1,0,0,1398,A
8-NS,173,4,0,0,1413,1417,C
8-NS,174,1,0,0,1420,1421,C
8-NS,175,3,0,1,1420,1424,C
8-NS,176,1434,7,1,0,1442,A
8-NS,177,0,1449,0,0,1449,T
8-NS,178,1,1,1451,0,1453,G
8-NS,179,0,1447,0,2,1449,T
8-NS,180,1,1443,0,1,1445,T
8-NS,181,1,0,1434,1,1436,G
8-NS,182,0,1,1427,0,1428,G
8-NS,183,1421,0,3,0,1424,A
8-NS,184,1426,0,0,0,1426,A
8-NS,185,1400,1,2,0,1403,A
8-NS,186,1,0,1416,0,1417,G
8-NS,187,1,0,0,1415,1416,C
8-NS,188,1414,0,0,0,1414,A
8-NS,189,1414,0,0,0,1414,A
8-NS,190,1411,0,0,0,1411,A
8-NS,191,0,1420,0,0,1420,T
8-NS,192,0,1417,0,1,1418,T
8-NS,193,0,1,1436,0,1437,G
8-NS,194,0,1435,0,0,1435,T
8-NS,195,1424,0,1,0,1425,A
8-NS,196,0,9,1419,0,1428,G
8-NS,197,1421,0,2,0,1423,A
8-NS,198,1420,0,0,1,1421,A
8-NS,199,1423,0,0,0,1423,A
8-NS,200,1409,1,0,0,1410,A
8-NS,201,0,2,1412,0,1414,G
8-NS,202,1403,0,0,0,1403,A
8-NS,203,0,1404,0,0,1404,T
8-NS,204,0,1400,0,0,1400,T
8-NS,205,3,0,0,1401,1404,C
8-NS,206,0,1402,0,0,1402,T
8-NS,207,0,2,1403,0,1405,G
8-NS,208,1402,0,1,0,1403,A
8-NS,209,1400,0,0,1,1401,A
8-NS,210,1390,0,2,0,1392,A
8-NS,211,1,0,1399,0,1400,G
8-NS,212,1402,0,0,0,1402,A
8-NS,213,1407,0,0,0,1407,A
8-NS,214,8,3,1407,0,1418,G
8-NS,215,1424,0,1,1,1426,A
8-NS,216,1423,0,0,0,1423,A
8-NS,217,0,1430,0,1,1431,T
8-NS,218,2,1,0,1440,1443,C
8-NS,219,0,1432,0,1,1433,T
8-NS,220,0,3,1436,0,1439,G
8-NS,221,1439,0,1,0,1440,A
8-NS,222,0,1436,0,0,1436,T
8-NS,223,0,3,1427,0,1430,G
8-NS,224,1410,0,1,0,1411,A
8-NS,225,0,1,1407,0,1408,G
8-NS,226,0,0,1407,0,1407,G
8-NS,227,0,1,0,1397,1398,C
8-NS,228,1407,0,1,0,1408,A
8-NS,229,0,1,0,1427,1428,C
8-NS,230,0,1426,0,0,1426,T
8-NS,231,1,1429,0,0,1430,T
8-NS,232,1437,0,0,0,1437,A
8-NS,233,1432,1,1,0,1434,A
8-NS,234,1435,0,0,0,1435,A
8-NS,235,1434,0,0,0,1434,A
8-NS,236,0,1432,0,0,1432,T
8-NS,237,0,7,1432,0,1439,G
8-NS,238,1431,0,1,0,1432,A
8-NS,239,0,0,0,1434,1434,C
8-NS,240,0,1,0,1426,1427,C
8-NS,241,1429,0,2,0,1431,A
8-NS,242,0,1428,0,1,1429,T
8-NS,243,0,4,1479,0,1483,G
8-NS,244,0,2,1490,0,1492,G
8-NS,245,0,1496,0,0,1496,T
8-NS,246,3,0,0,1569,1572,C
8-NS,247,0,1551,0,0,1551,T
8-NS,248,5,1,0,1573,1579,C
8-NS,249,3,0,0,1576,1579,C
8-NS,250,1585,0,0,1,1586,A
8-NS,251,2,0,0,1598,1600,C
8-NS,252,1561,1,1,2,1565,A
8-NS,253,0,0,1,1570,1571,C
8-NS,254,3,0,0,1554,1557,C
8-NS,255,0,1489,0,0,1489,T
8-NS,256,0,1,1506,0,1507,G
8-NS,257,0,1,0,1503,1504,C
8-NS,258,0,1487,0,0,1487,T
8-NS,259,0,1500,0,0,1500,T
8-NS,260,2,1,0,1490,1493,C
8-NS,261,1,0,1494,0,1495,G
8-NS,262,2,0,0,1490,1492,C
8-NS,263,0,4,1485,0,1489,G
8-NS,264,1561,0,2,0,1563,A
8-NS,265,0,1559,0,1,1560,T
8-NS,266,1608,1,0,0,1609,A
8-NS,267,3,0,0,1611,1614,C
8-NS,268,1610,0,1,0,1611,A
8-NS,269,0,1646,0,0,1646,T
8-NS,270,1634,0,0,0,1634,A
8-NS,271,1640,0,1,0,1641,A
8-NS,272,0,0,0,1644,1644,C
8-NS,273,0,1583,0,1,1584,T
8-NS,274,0,7,1588,0,1595,G
8-NS,275,1568,0,2,0,1570,A
8-NS,276,0,0,0,1584,1584,C
8-NS,277,1582,0,0,0,1582,A
8-NS,278,0,1567,0,0,1567,T
8-NS,279,1,3,1570,0,1574,G
8-NS,280,1567,0,2,0,1569,A
8-NS,281,1,0,0,1613,1614,C
8-NS,282,0,1603,0,1,1604,T
8-NS,283,1639,0,0,0,1639,A
8-NS,284,0,1636,0,1,1637,T
8-NS,285,0,1628,1,0,1629,T
8-NS,286,1,2,1628,0,1631,G
8-NS,287,1618,0,0,0,1618,A
8-NS,288,1,1,1614,0,1616,G
8-NS,289,1,2,1613,0,1616,G
8-NS,290,1572,0,0,0,1572,A
8-NS,291,1574,0,0,0,1574,A
8-NS,292,0,1547,0,0,1547,T
8-NS,293,0,1548,1,0,1549,T
8-NS,294,0,1,1571,0,1572,G
8-NS,295,0,1566,1,1,1568,T
8-NS,296,6,1,0,1565,1572,C
8-NS,297,1569,0,0,0,1569,A
8-NS,298,1572,0,0,0,1572,A
8-NS,299,0,4,1570,0,1574,G
8-NS,300,1566,2,1,0,1569,A
8-NS,301,1574,0,1,0,1575,A
8-NS,302,1568,2,2,0,1572,A
8-NS,303,0,0,0,1574,1574,C
8-NS,304,1,1548,0,0,1549,T
8-NS,305,0,5,1581,0,1586,G
8-NS,306,0,0,1611,0,1611,G
8-NS,307,0,1613,0,0,1613,T
8-NS,308,1,1609,1,0,1611,T
8-NS,309,5,0,0,1601,1606,C
8-NS,310,1613,0,0,0,1613,A
8-NS,311,0,1632,0,1,1633,T
8-NS,312,0,0,1649,0,1649,G
8-NS,313,0,0,0,1661,1661,C
8-NS,314,0,1643,0,1,1644,T
8-NS,315,1618,0,1,0,1619,A
8-NS,316,1643,0,0,0,1643,A
8-NS,317,1,1652,0,0,1653,T
8-NS,318,0,2,1653,0,1655,G
8-NS,319,1,1,0,1655,1657,C
8-NS,320,2,2,1,1630,1635,C
8-NS,321,5,1,0,1626,1632,C
8-NS,322,1625,0,0,0,1625,A
8-NS,323,1639,0,0,0,1639,A
8-NS,324,0,0,1648,0,1648,G
8-NS,325,0,0,0,1646,1646,C
8-NS,326,1647,0,0,0,1647,A
8-NS,327,1,5,1648,0,1654,G
8-NS,328,1650,0,0,0,1650,A
8-NS,329,1648,0,1,0,1649,A
8-NS,330,1647,0,1,0,1648,A
8-NS,331,3,1,1665,0,1669,G
8-NS,332,0,1655,1,0,1656,T
8-NS,333,1,1,1642,0,1644,G
8-NS,334,0,1,1652,0,1653,G
8-NS,335,1644,1,1,0,1646,A
8-NS,336,1637,0,0,0,1637,A
8-NS,337,0,3,1635,0,1638,G
8-NS,338,0,3,1637,0,1640,G
8-NS,339,1638,1,1,0,1640,A
8-NS,340,1,2,0,1631,1634,C
8-NS,341,3,0,0,1625,1628,C
8-NS,342,0,1630,0,0,1630,T
8-NS,343,3,0,0,1642,1645,C
8-NS,344,1,1646,0,0,1647,T
8-NS,345,0,1653,0,1,1654,T
8-NS,346,0,1652,0,1,1653,T
8-NS,347,4,1,1641,0,1646,G
8-NS,348,3,0,0,1653,1656,C
8-NS,349,1649,0,0,1,1650,A
8-NS,350,0,1640,0,3,1643,T
8-NS,351,6,0,1,1638,1645,C
8-NS,352,1660,0,1,0,1661,A
8-NS,353,0,1,1716,0,1717,G
8-NS,354,1704,2,0,0,1706,A
8-NS,355,1707,0,1,0,1708,A
8-NS,356,0,1705,0,0,1705,T
8-NS,357,0,4,1689,0,1693,G
8-NS,358,3,4,1694,0,1701,G
8-NS,359,1700,0,3,0,1703,A
8-NS,360,2,0,2,1701,1705,C
8-NS,361,2,0,0,1658,1660,C
8-NS,362,1629,0,1,0,1630,A
8-NS,363,1,4,1647,0,1652,G
8-NS,364,4,1,1640,0,1645,G
8-NS,365,0,1,1,1649,1651,C
8-NS,366,1636,0,1,1,1638,A
8-NS,367,1641,1,0,0,1642,A
8-NS,368,1,1636,0,1,1638,T
8-NS,369,5,0,0,1637,1642,C
8-NS,370,1644,0,0,0,1644,A
8-NS,371,0,1632,0,2,1634,T
8-NS,372,1,4,1614,0,1619,G
8-NS,373,0,2,1626,0,1628,G
8-NS,374,1616,0,3,0,1619,A
8-NS,375,0,2,1636,0,1638,G
8-NS,376,1608,0,0,0,1608,A
8-NS,377,1609,0,1,0,1610,A
8-NS,378,1608,1,1,0,1610,A
8-NS,379,1606,1,0,0,1607,A
8-NS,380,1616,0,1,1,1618,A
8-NS,381,1,1,0,1617,1619,C
8-NS,382,1610,0,0,0,1610,A
8-NS,383,1,1606,0,2,1609,T
8-NS,384,6,0,0,1589,1595,C
8-NS,385,1596,0,0,0,1596,A
8-NS,386,0,1594,0,1,1595,T
8-NS,387,0,1,1599,0,1600,G
8-NS,388,0,1597,0,1,1598,T
8-NS,389,0,1581,0,2,1583,T
8-NS,390,0,2,1585,0,1587,G
8-NS,391,1576,0,0,0,1576,A
8-NS,392,1577,0,3,0,1580,A
8-NS,393,1571,0,7,0,1578,A
8-NS,394,1,0,1587,0,1588,G
8-NS,395,0,1,0,1570,1571,C
8-NS,396,0,4,1571,0,1575,G
8-NS,397,1580,1,0,0,1581,A
8-NS,398,1579,0,0,0,1579,A
8-NS,399,0,1581,0,0,1581,T
8-NS,400,0,1579,0,3,1582,T
8-NS,401,0,1579,0,0,1579,T
8-NS,402,2,0,0,1579,1581,C
8-NS,403,1566,0,0,0,1566,A
8-NS,404,0,1,1573,0,1574,G
8-NS,405,0,1567,1,0,1568,T
8-NS,406,0,2,1568,0,1570,G
8-NS,407,0,1567,0,0,1567,T
8-NS,408,1,9,1559,0,1569,G
8-NS,409,1566,0,0,0,1566,A
8-NS,410,0,1564,0,0,1564,T
8-NS,411,0,1568,1,0,1569,T
8-NS,412,1,1567,0,0,1568,T
8-NS,413,1,1568,0,0,1569,T
8-NS,414,0,1571,0,0,1571,T
8-NS,415,0,11,1554,0,1565,G
8-NS,416,1565,0,3,0,1568,A
8-NS,417,2,1545,0,0,1547,T
8-NS,418,5,0,1,1555,1561,C
8-NS,419,0,8,1553,0,1561,G
8-NS,420,1679,0,0,0,1679,A
8-NS,421,2,0,0,1693,1695,C
8-NS,422,0,1695,0,1,1696,T
8-NS,423,1704,0,0,0,1704,A
8-NS,424,0,3,1702,0,1705,G
8-NS,425,1708,0,3,0,1711,A
8-NS,426,0,2,1733,0,1735,G
8-NS,427,1732,0,1,0,1733,A
8-NS,428,3,0,0,1794,1797,C
8-NS,429,3,0,0,1701,1704,C
8-NS,430,1665,0,0,0,1665,A
8-NS,431,0,1747,0,0,1747,T
8-NS,432,1737,0,0,0,1737,A
8-NS,433,0,0,1857,0,1857,G
8-NS,434,0,1843,0,1,1844,T
8-NS,435,1837,0,0,0,1837,A
8-NS,436,0,1842,0,0,1842,T
8-NS,437,0,1795,0,0,1795,T
8-NS,438,1855,0,2,0,1857,A
8-NS,439,0,0,0,1854,1854,C
8-NS,440,0,1788,0,1,1789,T
8-NS,441,1780,0,1,0,1781,A
8-NS,442,1636,0,4,0,1640,A
8-NS,443,1,1,1644,0,1646,G
8-NS,444,0,2,1637,1,1640,G
8-NS,445,1,0,1638,0,1639,G
8-NS,446,1,2,0,1623,1626,C
8-NS,447,0,1608,1,2,1611,T
8-NS,448,0,1601,0,2,1603,T
8-NS,449,0,1624,0,1,1625,T
8-NS,450,1,0,0,1626,1627,C
8-NS,451,1649,1,0,0,1650,A
8-NS,452,0,1,0,1651,1652,C
8-NS,453,3,2,1,1626,1632,C
8-NS,454,0,3,1632,0,1635,G
8-NS,455,1639,0,1,0,1640,A
8-NS,456,1632,3,1,1,1637,A
8-NS,457,0,1,1643,0,1644,G
8-NS,458,1618,0,1,0,1619,A
8-NS,459,0,5,1612,0,1617,G
8-NS,460,0,3,1588,0,1591,G
8-NS,461,4,6,1588,0,1598,G
8-NS,462,1605,0,4,0,1609,A
8-NS,463,2,1,1602,0,1605,G
8-NS,464,1,0,0,1600,1601,C
8-NS,465,1599,0,0,0,1599,A
8-NS,466,1601,0,0,0,1601,A
8-NS,467,1,1600,0,0,1601,T
8-NS,468,0,1593,0,2,1595,T
8-NS,469,1,2,1595,0,1598,G
8-NS,470,0,1572,0,0,1572,T
8-NS,471,0,1571,0,3,1574,T
8-NS,472,1,1,1570,0,1572,G
8-NS,473,1,1,1565,0,1567,G
8-NS,474,1,1,0,1570,1572,C
8-NS,475,0,2,1569,0,1571,G
8-NS,476,1573,0,0,1,1574,A
8-NS,477,1578,0,0,0,1578,A
8-NS,478,1583,0,1,0,1584,A
8-NS,479,0,1592,0,0,1592,T
8-NS,480,2,0,0,1585,1587,C
8-NS,481,0,1581,0,3,1584,T
8-NS,482,4,2,0,1580,1586,C
8-NS,483,1590,0,1,0,1591,A
8-NS,484,1,0,0,1591,1592,C
8-NS,485,4,0,0,1582,1586,C
8-NS,486,1588,0,0,0,1588,A
8-NS,487,0,1583,0,0,1583,T
8-NS,488,0,1557,0,0,1557,T
8-NS,489,0,1,1562,0,1563,G
8-NS,490,2,0,0,1555,1557,C
8-NS,491,4,1,0,1549,1554,C
8-NS,492,0,1552,0,6,1558,T
8-NS,493,0,1557,0,2,1559,T
8-NS,494,3,0,0,1569,1572,C
8-NS,495,0,1556,0,7,1563,T
8-NS,496,1,1568,1,0,1570,T
8-NS,497,0,1599,0,0,1599,T
8-NS,498,1,1590,1,0,1592,T
8-NS,499,3,0,0,1588,1591,C
8-NS,500,0,0,0,1586,1586,C
8-NS,501,1583,0,1,0,1584,A
8-NS,502,0,1,1609,0,1610,G
8-NS,503,0,6,1604,0,1610,G
8-NS,504,1635,1,0,0,1636,A
8-NS,505,0,5,0,1631,1636,C
8-NS,506,1631,0,0,0,1631,A
8-NS,507,0,1637,0,0,1637,T
8-NS,508,1643,0,0,0,1643,A
8-NS,509,1,1,0,1759,1761,C
8-NS,510,0,1749,0,0,1749,T
8-NS,511,1736,0,1,0,1737,A
8-NS,512,0,1717,0,13,1730,T
8-NS,513,0,1665,0,0,1665,T
8-NS,514,0,0,1672,1,1673,G
8-NS,515,1607,0,0,0,1607,A
8-NS,516,0,0,1609,0,1609,G
8-NS,517,0,1,1598,0,1599,G
8-NS,518,1453,0,0,0,1453,A
8-NS,519,0,1455,0,0,1455,T
8-NS,520,0,0,1447,1,1448,G
8-NS,521,0,1443,0,3,1446,T
8-NS,522,7,0,0,1434,1441,C
8-NS,523,1448,0,0,0,1448,A
8-NS,524,1444,1,1,0,1446,A
8-NS,525,1440,0,0,0,1440,A
8-NS,526,1437,1,1,0,1439,A
8-NS,527,1446,0,0,0,1446,A
8-NS,528,0,1442,0,0,1442,T
8-NS,529,0,0,1442,0,1442,G
8-NS,530,1,0,0,1454,1455,C
8-NS,531,1455,0,1,0,1456,A
8-NS,532,1456,0,0,0,1456,A
8-NS,533,0,1456,0,0,1456,T
8-NS,534,1,1454,0,1,1456,T
8-NS,535,1,0,1461,0,1462,G
8-NS,536,1,4,1441,0,1446,G
8-NS,537,0,1,1446,0,1447,G
8-NS,538,0,0,1456,0,1456,G
8-NS,539,0,1428,0,0,1428,T
8-NS,540,1,1,0,1438,1440,C
8-NS,541,1,0,0,1444,1445,C
8-NS,542,0,1443,1,0,1444,T
8-NS,543,1,0,0,1457,1458,C
8-NS,544,1458,0,0,0,1458,A
8-NS,545,0,1469,0,0,1469,T
8-NS,546,4,2,0,1456,1462,C
8-NS,547,1,3,1445,0,1449,G
8-NS,548,1,2,1452,0,1455,G
8-NS,549,1430,0,2,0,1432,A
8-NS,550,1,1,1435,0,1437,G
8-NS,551,1,5,1440,0,1446,G
8-NS,552,1428,0,1,0,1429,A
8-NS,553,1,0,0,1434,1435,C
8-NS,554,0,1429,0,0,1429,T
8-NS,555,0,1427,0,1,1428,T
8-NS,556,1,2,1435,0,1438,G
8-NS,557,1427,0,1,0,1428,A
8-NS,558,1428,0,1,0,1429,A
8-NS,559,0,1427,0,0,1427,T
8-NS,560,1,3,1395,0,1399,G
8-NS,561,0,1,1415,0,1416,G
8-NS,562,1397,1,1,0,1399,A
8-NS,563,1411,0,1,0,1412,A
8-NS,564,0,1477,0,1,1478,T
8-NS,565,0,2,1490,0,1492,G
8-NS,566,1497,1,0,0,1498,A
8-NS,567,0,1497,0,0,1497,T
8-NS,568,1500,0,0,0,1500,A
8-NS,569,1502,0,1,0,1503,A
8-NS,570,0,0,0,1485,1485,C
8-NS,571,1467,0,0,0,1467,A
8-NS,572,1,0,0,1478,1479,C
8-NS,573,1364,0,0,0,1364,A
8-NS,574,0,0,1395,0,1395,G
8-NS,575,0,1387,0,0,1387,T
8-NS,576,0,1385,1,0,1386,T
8-NS,577,6,0,0,1382,1388,C
8-NS,578,0,3,1379,2,1384,G
8-NS,579,1382,0,0,0,1382,A
8-NS,580,1,0,1384,0,1385,G
8-NS,581,0,1362,0,1,1363,T
8-NS,582,4,0,0,1368,1372,C
8-NS,583,0,1339,0,3,1342,T
8-NS,584,2,0,0,1359,1361,C
8-NS,585,0,1357,1,1,1359,T
8-NS,586,1361,0,1,0,1362,A
8-NS,587,1357,0,0,0,1357,A
8-NS,588,1360,0,0,0,1360,A
8-NS,589,1369,0,0,1,1370,A
8-NS,590,1374,0,0,0,1374,A
8-NS,591,0,1350,0,0,1350,T
8-NS,592,1,1,0,1358,1360,C
8-NS,593,0,1342,0,0,1342,T
8-NS,594,1345,0,1,0,1346,A
8-NS,595,0,1,0,1344,1345,C
8-NS,596,1341,0,0,0,1341,A
8-NS,597,0,2,1350,0,1352,G
8-NS,598,1330,1,0,0,1331,A
8-NS,599,0,4,1330,0,1334,G
8-NS,600,1329,0,0,0,1329,A
8-NS,601,1,1316,0,2,1319,T
8-NS,602,1,1314,0,0,1315,T
8-NS,603,3,1,0,1317,1321,C
8-NS,604,1,1,1325,0,1327,G
8-NS,605,2,0,0,1322,1324,C
8-NS,606,0,1317,0,1,1318,T
8-NS,607,0,1320,1,1,1322,T
8-NS,608,0,1,1313,0,1314,G
8-NS,609,0,4,1318,1,1323,G
8-NS,610,1322,0,0,0,1322,A
8-NS,611,0,2,1322,0,1324,G
8-NS,612,1315,0,0,0,1315,A
8-NS,613,1302,0,1,0,1303,A
8-NS,614,0,0,1322,0,1322,G
8-NS,615,0,2,0,1326,1328,C
8-NS,616,1325,0,0,0,1325,A
8-NS,617,0,3,1350,0,1353,G
8-NS,618,0,1337,0,0,1337,T
8-NS,619,1345,0,1,0,1346,A
8-NS,620,1347,0,0,0,1347,A
8-NS,621,0,1342,0,0,1342,T
8-NS,622,0,8,1340,0,1348,G
8-NS,623,1294,0,3,0,1297,A
8-NS,624,0,2,1306,0,1308,G
8-NS,625,1303,0,2,0,1305,A
8-NS,626,1256,0,1,0,1257,A
8-NS,627,1,1250,0,0,1251,T
8-NS,628,0,1,1233,0,1234,G
8-NS,629,0,3,1236,0,1239,G
8-NS,630,0,1,1231,0,1232,G
8-NS,631,1,2,1218,0,1221,G
8-NS,632,2,2,1222,1,1227,G
8-NS,633,1185,0,7,0,1192,A
8-NS,634,2,0,0,1196,1198,C
8-NS,635,1,0,0,1199,1200,C
8-NS,636,0,1165,0,1,1166,T
8-NS,637,2,0,0,1178,1180,C
8-NS,638,1,0,0,1170,1171,C
8-NS,639,1180,0,0,0,1180,A
8-NS,640,0,1,0,1178,1179,C
8-NS,641,0,1146,0,0,1146,T
8-NS,642,0,1143,0,0,1143,T
8-NS,643,1114,0,0,0,1114,A
8-NS,644,0,1,0,1133,1134,C
8-NS,645,1,1119,0,4,1124,T
8-NS,646,5,1,0,1114,1120,C
8-NS,647,0,1,0,1102,1103,C
8-NS,648,1106,0,0,0,1106,A
8-NS,649,1105,0,0,0,1105,A
8-NS,650,1103,0,0,0,1103,A
8-NS,651,1107,0,0,0,1107,A
8-NS,652,2,1,0,1104,1107,C
8-NS,653,1073,0,0,0,1073,A
8-NS,654,0,5,1071,0,1076,G
8-NS,655,1072,0,0,0,1072,A
8-NS,656,1067,1,0,0,1068,A
8-NS,657,1070,0,0,0,1070,A
8-NS,658,1,1,0,1068,1070,C
8-NS,659,0,2,1065,0,1067,G
8-NS,660,1,4,1066,0,1071,G
8-NS,661,0,1,1071,0,1072,G
8-NS,662,1069,0,1,0,1070,A
8-NS,663,1064,0,1,0,1065,A
8-NS,664,1065,0,1,0,1066,A
8-NS,665,0,1062,0,0,1062,T
8-NS,666,1,3,1069,0,1073,G
8-NS,667,1,0,1071,0,1072,G
8-NS,668,1,4,0,1058,1063,C
8-NS,669,1,2,1062,0,1065,G
8-NS,670,1065,0,0,0,1065,A
8-NS,671,0,9,1057,0,1066,G
8-NS,672,1068,0,0,1,1069,A
8-NS,673,1069,0,0,0,1069,A
8-NS,674,0,1,0,1074,1075,C
8-NS,675,1056,0,0,0,1056,A
8-NS,676,0,0,1055,0,1055,G
8-NS,677,1,0,0,1050,1051,C
8-NS,678,0,1049,0,0,1049,T
8-NS,679,1048,0,0,1,1049,A
8-NS,680,2,2,1038,0,1042,G
8-NS,681,4,0,1040,0,1044,G
8-NS,682,1,1036,0,0,1037,T
8-NS,683,4,0,0,1012,1016,C
8-NS,684,1012,0,0,0,1012,A
8-NS,685,1010,0,0,0,1010,A
8-NS,686,1006,0,0,0,1006,A
8-NS,687,1012,0,0,0,1012,A
8-NS,688,0,0,1011,0,1011,G
8-NS,689,1,983,0,0,984,T
8-NS,690,0,974,0,1,975,T
8-NS,691,0,980,1,1,982,T
8-NS,692,0,3,979,0,982,G
8-NS,693,981,0,1,0,982,A
8-NS,694,978,0,0,0,978,A
8-NS,695,0,2,978,0,980,G
8-NS,696,970,0,1,0,971,A
8-NS,697,966,0,0,0,966,A
8-NS,698,986,0,0,0,986,A
8-NS,699,0,984,1,0,985,T
8-NS,700,987,0,0,0,987,A
8-NS,701,985,0,0,0,985,A
8-NS,702,0,5,975,0,980,G
8-NS,703,931,0,2,0,933,A
8-NS,704,0,936,0,0,936,T
8-NS,705,1,1,943,0,945,G
8-NS,706,0,0,947,0,947,G
8-NS,707,1,0,0,941,942,C
8-NS,708,0,942,0,0,942,T
8-NS,709,941,0,0,0,941,A
8-NS,710,941,1,0,0,942,A
8-NS,711,0,941,0,0,941,T
8-NS,712,0,944,0,1,945,T
8-NS,713,0,1,941,0,942,G
8-NS,714,919,0,0,0,919,A
8-NS,715,915,0,2,0,917,A
8-NS,716,0,3,911,0,914,G
8-NS,717,913,0,0,0,913,A
8-NS,718,900,0,0,0,900,A
8-NS,719,0,0,910,0,910,G
8-NS,720,0,890,0,1,891,T
8-NS,721,0,4,892,0,896,G
8-NS,722,884,0,2,0,886,A
8-NS,723,1,3,884,0,888,G
8-NS,724,888,0,0,1,889,A
8-NS,725,1,0,0,882,883,C
8-NS,726,873,1,0,0,874,A
8-NS,727,0,1,0,874,875,C
8-NS,728,813,0,1,1,815,A
8-NS,729,0,1,834,0,835,G
8-NS,730,830,0,3,0,833,A
8-NS,731,0,827,0,0,827,T
8-NS,732,0,828,0,0,828,T
8-NS,733,827,0,0,0,827,A
8-NS,734,830,0,0,0,830,A
8-NS,735,830,0,0,0,830,A
8-NS,736,826,0,0,0,826,A
8-NS,737,827,0,0,0,827,A
8-NS,738,0,0,1,799,800,C
8-NS,739,755,0,0,0,755,A
8-NS,740,759,0,0,0,759,A
8-NS,741,1,0,0,762,763,C
8-NS,742,0,756,0,0,756,T
8-NS,743,0,2,764,1,767,G
8-NS,744,765,0,1,0,766,A
8-NS,745,765,0,0,0,765,A
8-NS,746,765,0,0,0,765,A
8-NS,747,757,0,0,0,757,A
8-NS,748,1,754,1,1,757,T
8-NS,749,740,0,2,0,742,A
8-NS,750,0,0,748,0,748,G
8-NS,751,0,1,0,747,748,C
8-NS,752,0,726,0,0,726,T
8-NS,753,0,728,0,0,728,T
8-NS,754,0,724,0,0,724,T
8-NS,755,0,2,722,1,725,G
8-NS,756,727,0,0,0,727,A
8-NS,757,726,0,1,0,727,A
8-NS,758,1,1,0,726,728,C
8-NS,759,711,0,0,0,711,A
8-NS,760,711,1,1,0,713,A
8-NS,761,716,1,0,0,717,A
8-NS,762,0,715,1,0,716,T
8-NS,763,716,0,0,0,716,A
8-NS,764,707,0,0,0,707,A
8-NS,765,0,1,0,705,706,C
8-NS,766,706,0,0,0,706,A
8-NS,767,0,700,0,0,700,T
8-NS,768,0,683,1,1,685,T
8-NS,769,0,0,0,680,680,C
8-NS,770,676,0,0,0,676,A
8-NS,771,0,678,0,0,678,T
8-NS,772,0,0,677,0,677,G
8-NS,773,0,0,0,666,666,C
8-NS,774,656,0,0,0,656,A
8-NS,775,655,0,1,0,656,A
8-NS,776,0,0,662,0,662,G
8-NS,777,0,0,0,669,669,C
8-NS,778,664,0,0,0,664,A
8-NS,779,0,661,0,0,661,T
8-NS,780,0,658,0,0,658,T
8-NS,781,657,0,0,0,657,A
8-NS,782,0,0,0,657,657,C
8-NS,783,645,0,0,0,645,A
8-NS,784,0,1,560,0,561,G
8-NS,785,0,0,0,562,562,C
8-NS,786,0,560,0,0,560,T
8-NS,787,0,0,561,0,561,G
8-NS,788,0,0,0,551,551,C
8-NS,789,0,535,0,2,537,T
8-NS,790,1,0,539,0,540,G
8-NS,791,0,529,0,0,529,T
8-NS,792,0,529,0,0,529,T
8-NS,793,0,527,0,1,528,T
8-NS,794,0,0,518,0,518,G
8-NS,795,516,0,2,0,518,A
8-NS,796,502,0,0,0,502,A
8-NS,797,0,0,501,0,501,G
8-NS,798,0,490,0,0,490,T
8-NS,799,0,1,462,0,463,G
8-NS,800,0,6,463,0,469,G
8-NS,801,468,0,0,0,468,A
8-NS,802,467,0,0,0,467,A
8-NS,803,0,0,0,467,467,C
8-NS,804,458,0,1,0,459,A
8-NS,805,0,0,463,0,463,G
8-NS,806,0,0,455,0,455,G
8-NS,807,448,0,2,0,450,A
8-NS,808,0,1,451,0,452,G
8-NS,809,384,0,1,0,385,A
8-NS,810,0,382,0,1,383,T
8-NS,811,382,0,0,0,382,A
8-NS,812,378,0,0,0,378,A
8-NS,813,0,1,376,0,377,G
8-NS,814,330,0,0,0,330,A
8-NS,815,328,0,0,0,328,A
8-NS,816,1,0,0,322,323,C
8-NS,817,1,286,0,0,287,T
8-NS,818,0,283,0,0,283,T
8-NS,819,0,281,0,0,281,T
8-NS,820,1,0,0,281,282,C
8-NS,821,0,276,0,0,276,T
8-NS,822,1,0,0,269,270,C
8-NS,823,260,0,0,0,260,A
8-NS,824,0,261,0,0,261,T
8-NS,825,0,257,0,0,257,T
8-NS,826,1,254,0,0,255,T
8-NS,827,1,0,0,252,253,C
8-NS,828,244,1,0,0,245,A
8-NS,829,0,0,243,0,243,G
8-NS,830,0,0,0,244,244,C
8-NS,831,0,230,0,0,230,T
8-NS,832,0,229,0,1,230,T
8-NS,833,222,0,0,0,222,A
8-NS,834,0,223,0,0,223,T
8-NS,835,0,222,0,0,222,T
8-NS,836,0,220,0,0,220,T
8-NS,837,209,0,0,0,209,A
8-NS,838,199,0,0,0,199,A
8-NS,839,0,195,0,0,195,T
8-NS,840,0,0,195,0,195,G
8-NS,841,191,0,0,0,191,A
8-NS,842,1,169,0,0,170,T
8-NS,843,168,0,0,0,168,A
8-NS,844,168,0,0,0,168,A
8-NS,845,167,0,0,0,167,A
8-NS,846,168,0,0,0,168,A
8-NS,847,167,0,0,0,167,A
8-NS,848,165,0,0,1,166,A
8-NS,849,0,1,0,164,165,C
8-NS,850,139,0,0,0,139,A
8-NS,851,0,0,0,139,139,C
8-NS,852,1,0,0,131,132,C
8-NS,853,0,0,0,130,130,C
8-NS,854,0,114,0,0,114,T
8-NS,855,0,109,0,0,109,T
8-NS,856,0,0,109,0,109,G
8-NS,857,0,104,0,0,104,T
8-NS,858,0,104,0,0,104,T
8-NS,859,0,102,0,0,102,T
8-NS,860,0,0,0,43,43,C
8-NS,861,0,29,0,0,29,T
8-NS,862,23,0,0,0,23,A
8-NS,863,0,0,0,22,22,C
