Gene,Position,A,T,G,C,Coverage,Consensus
1-PB2,1,123,0,0,0,123,A
1-PB2,2,0,123,0,0,123,T
1-PB2,3,0,0,123,0,123,G
1-PB2,4,0,0,125,0,125,G
1-PB2,5,124,1,0,0,125,A
1-PB2,6,124,0,1,0,125,A
1-PB2,7,125,0,0,0,125,A
1-PB2,8,0,1,145,0,146,G
1-PB2,9,146,0,0,0,146,A
1-PB2,10,147,0,0,0,147,A
1-PB2,11,1,147,0,0,148,T
1-PB2,12,145,1,0,0,146,A
1-PB2,13,148,0,0,0,148,A
1-PB2,14,148,0,0,0,148,A
1-PB2,15,148,0,0,0,148,A
1-PB2,16,0,1,153,0,154,G
1-PB2,17,153,0,0,0,153,A
1-PB2,18,154,0,0,0,154,A
1-PB2,19,0,0,0,157,157,C
1-PB2,20,0,157,0,0,157,T
1-PB2,21,159,0,0,0,159,A
1-PB2,22,0,0,0,159,159,C
1-PB2,23,0,0,159,0,159,G
1-PB2,24,0,0,163,0,163,G
1-PB2,25,165,0,0,0,165,A
1-PB2,26,171,0,0,0,171,A
1-PB2,27,0,170,0,1,171,T
1-PB2,28,1,0,0,171,172,C
1-PB2,29,0,172,0,0,172,T
1-PB2,30,0,0,177,0,177,G
1-PB2,31,178,0,1,0,179,A
1-PB2,32,0,180,0,0,180,T
1-PB2,33,1,0,179,0,180,G
1-PB2,34,0,184,0,2,186,T
1-PB2,35,0,0,0,184,184,C
1-PB2,36,0,0,186,0,186,G
1-PB2,37,0,0,0,186,186,C
1-PB2,38,185,0,0,0,185,A
1-PB2,39,0,0,194,0,194,G
1-PB2,40,0,194,0,1,195,T
1-PB2,41,3,0,0,193,196,C
1-PB2,42,0,194,0,1,195,T
1-PB2,43,1,0,0,194,195,C
1-PB2,44,0,1,195,0,196,G
1-PB2,45,0,0,0,197,197,C
1-PB2,46,197,0,0,0,197,A
1-PB2,47,0,0,0,201,201,C
1-PB2,48,0,198,0,0,198,T
1-PB2,49,2,0,0,201,203,C
1-PB2,50,0,1,200,0,201,G
1-PB2,51,0,1,0,202,203,C
1-PB2,52,0,0,202,0,202,G
1-PB2,53,203,0,0,0,203,A
1-PB2,54,0,0,207,0,207,G
1-PB2,55,213,0,1,0,214,A
1-PB2,56,0,214,0,0,214,T
1-PB2,57,214,0,0,0,214,A
1-PB2,58,0,0,0,213,213,C
1-PB2,59,0,213,0,0,213,T
1-PB2,60,1,4,213,0,218,G
1-PB2,61,219,0,0,0,219,A
1-PB2,62,0,0,0,219,219,C
1-PB2,63,220,0,1,0,221,A
1-PB2,64,217,0,0,0,217,A
1-PB2,65,218,0,0,0,218,A
1-PB2,66,218,0,0,0,218,A
1-PB2,67,219,0,0,0,219,A
1-PB2,68,0,0,0,223,223,C
1-PB2,69,1,0,0,222,223,C
1-PB2,70,227,0,0,0,227,A
1-PB2,71,0,1,0,229,230,C
1-PB2,72,230,0,0,0,230,A
1-PB2,73,0,0,239,0,239,G
1-PB2,74,0,237,0,0,237,T
1-PB2,75,0,1,252,0,253,G
1-PB2,76,0,1,254,0,255,G
1-PB2,77,257,0,1,0,258,A
1-PB2,78,0,1,0,269,270,C
1-PB2,79,2,0,0,268,270,C
1-PB2,80,274,0,0,0,274,A
1-PB2,81,0,273,0,0,273,T
1-PB2,82,269,0,1,0,270,A
1-PB2,83,0,268,0,0,268,T
1-PB2,84,0,0,271,0,271,G
1-PB2,85,0,0,270,0,270,G
1-PB2,86,1,0,0,268,269,C
1-PB2,87,1,0,1,262,264,C
1-PB2,88,264,0,0,0,264,A
1-PB2,89,0,279,0,0,279,T
1-PB2,90,281,0,0,0,281,A
1-PB2,91,293,0,0,0,293,A
1-PB2,92,0,294,0,0,294,T
1-PB2,93,0,291,0,0,291,T
1-PB2,94,296,0,0,0,296,A
1-PB2,95,296,0,0,0,296,A
1-PB2,96,0,1,309,0,310,G
1-PB2,97,311,0,0,0,311,A
1-PB2,98,307,0,0,0,307,A
1-PB2,99,0,0,318,0,318,G
1-PB2,100,0,312,0,1,313,T
1-PB2,101,315,0,0,0,315,A
1-PB2,102,0,0,0,315,315,C
1-PB2,103,319,0,0,0,319,A
1-PB2,104,0,0,0,326,326,C
1-PB2,105,318,0,0,0,318,A
1-PB2,106,0,320,0,0,320,T
1-PB2,107,1,0,0,320,321,C
1-PB2,108,0,0,311,0,311,G
1-PB2,109,0,2,309,0,311,G
1-PB2,110,1,1,312,0,314,G
1-PB2,111,0,2,313,0,315,G
1-PB2,112,314,0,0,0,314,A
1-PB2,113,0,4,315,0,319,G
1-PB2,114,315,0,2,0,317,A
1-PB2,115,0,0,0,318,318,C
1-PB2,116,317,0,1,0,318,A
1-PB2,117,0,0,321,0,321,G
1-PB2,118,0,2,320,0,322,G
1-PB2,119,320,0,0,0,320,A
1-PB2,120,325,0,0,0,325,A
1-PB2,121,324,0,1,0,325,A
1-PB2,122,325,0,0,0,325,A
1-PB2,123,0,2,323,0,325,G
1-PB2,124,322,1,0,0,323,A
1-PB2,125,323,0,0,0,323,A
1-PB2,126,0,0,0,326,326,C
1-PB2,127,0,0,0,321,321,C
1-PB2,128,0,0,0,322,322,C
1-PB2,129,1,4,318,0,323,G
1-PB2,130,0,320,0,2,322,T
1-PB2,131,1,0,0,327,328,C
1-PB2,132,330,0,0,0,330,A
1-PB2,133,0,0,0,334,334,C
1-PB2,134,0,334,0,0,334,T
1-PB2,135,0,334,0,0,334,T
1-PB2,136,335,0,0,0,335,A
1-PB2,137,0,3,338,0,341,G
1-PB2,138,0,1,342,0,343,G
1-PB2,139,343,0,0,0,343,A
1-PB2,140,0,342,0,0,342,T
1-PB2,141,0,3,342,0,345,G
1-PB2,142,348,0,1,0,349,A
1-PB2,143,349,0,0,0,349,A
1-PB2,144,349,0,0,0,349,A
1-PB2,145,0,349,0,0,349,T
1-PB2,146,0,2,346,0,348,G
1-PB2,147,0,0,354,0,354,G
1-PB2,148,353,0,0,0,353,A
1-PB2,149,0,353,0,1,354,T
1-PB2,150,0,1,351,0,352,G
1-PB2,151,343,0,1,0,344,A
1-PB2,152,0,349,0,0,349,T
1-PB2,153,1,1,342,0,344,G
1-PB2,154,1,0,347,0,348,G
1-PB2,155,1,0,0,349,350,C
1-PB2,156,348,0,0,0,348,A
1-PB2,157,349,0,0,0,349,A
1-PB2,158,0,349,0,2,351,T
1-PB2,159,0,0,368,0,368,G
1-PB2,160,367,0,1,0,368,A
1-PB2,161,365,0,0,0,365,A
1-PB2,162,367,0,0,0,367,A
1-PB2,163,0,367,0,0,367,T
1-PB2,164,369,0,0,0,369,A
1-PB2,165,0,0,0,373,373,C
1-PB2,166,0,0,0,370,370,C
1-PB2,167,1,0,0,369,370,C
1-PB2,168,376,0,0,0,376,A
1-PB2,169,377,0,0,0,377,A
1-PB2,170,0,374,0,2,376,T
1-PB2,171,1,1,0,376,378,C
1-PB2,172,374,0,0,0,374,A
1-PB2,173,0,0,0,379,379,C
1-PB2,174,0,371,0,0,371,T
1-PB2,175,1,0,369,0,370,G
1-PB2,176,0,0,0,371,371,C
1-PB2,177,1,370,0,0,371,T
1-PB2,178,0,2,372,0,374,G
1-PB2,179,375,0,0,0,375,A
1-PB2,180,0,0,0,377,377,C
1-PB2,181,376,0,0,0,376,A
1-PB2,182,374,0,0,0,374,A
1-PB2,183,373,0,1,0,374,A
1-PB2,184,372,0,0,0,372,A
1-PB2,185,369,0,3,0,372,A
1-PB2,186,0,2,379,0,381,G
1-PB2,187,381,0,0,0,381,A
1-PB2,188,0,382,0,0,382,T
1-PB2,189,377,0,0,0,377,A
1-PB2,190,379,1,0,0,380,A
1-PB2,191,0,0,0,387,387,C
1-PB2,192,386,0,0,0,386,A
1-PB2,193,0,0,387,0,387,G
1-PB2,194,383,0,0,0,383,A
1-PB2,195,384,0,0,0,384,A
1-PB2,196,385,0,0,0,385,A
1-PB2,197,0,387,0,0,387,T
1-PB2,198,0,1,387,0,388,G
1-PB2,199,0,0,388,0,388,G
1-PB2,200,0,388,0,0,388,T
1-PB2,201,1,387,0,0,388,T
1-PB2,202,1,0,0,384,385,C
1-PB2,203,2,1,0,382,385,C
1-PB2,204,0,0,388,0,388,G
1-PB2,205,0,1,387,0,388,G
1-PB2,206,387,0,0,0,387,A
1-PB2,207,0,3,383,0,386,G
1-PB2,208,382,0,1,0,383,A
1-PB2,209,0,3,394,0,397,G
1-PB2,210,397,0,0,0,397,A
1-PB2,211,398,0,0,0,398,A
1-PB2,212,398,0,0,0,398,A
1-PB2,213,0,396,0,0,396,T
1-PB2,214,0,3,394,0,397,G
1-PB2,215,400,0,1,0,401,A
1-PB2,216,398,1,2,0,401,A
1-PB2,217,0,0,0,400,400,C
1-PB2,218,394,0,1,0,395,A
1-PB2,219,395,0,1,0,396,A
1-PB2,220,0,0,404,0,404,G
1-PB2,221,0,6,409,0,415,G
1-PB2,222,414,1,0,0,415,A
1-PB2,223,0,0,0,415,415,C
1-PB2,224,413,0,0,0,413,A
1-PB2,225,414,0,0,0,414,A
1-PB2,226,414,0,1,0,415,A
1-PB2,227,0,0,0,412,412,C
1-PB2,228,3,0,0,398,401,C
1-PB2,229,3,0,0,428,431,C
1-PB2,230,0,431,0,1,432,T
1-PB2,231,435,0,1,0,436,A
1-PB2,232,0,435,0,0,435,T
1-PB2,233,0,1,438,0,439,G
1-PB2,234,0,5,438,0,443,G
1-PB2,235,420,0,1,0,421,A
1-PB2,236,0,0,422,0,422,G
1-PB2,237,0,421,0,0,421,T
1-PB2,238,419,0,1,0,420,A
1-PB2,239,422,0,0,0,422,A
1-PB2,240,424,0,0,0,424,A
1-PB2,241,422,0,0,0,422,A
1-PB2,242,0,422,0,0,422,T
1-PB2,243,0,7,416,0,423,G
1-PB2,244,417,0,0,0,417,A
1-PB2,245,0,1,419,0,420,G
1-PB2,246,0,415,0,0,415,T
1-PB2,247,1,1,413,0,415,G
1-PB2,248,418,0,0,0,418,A
1-PB2,249,0,416,0,0,416,T
1-PB2,250,1,0,418,0,419,G
1-PB2,251,0,0,0,421,421,C
1-PB2,252,0,418,0,1,419,T
1-PB2,253,0,2,436,0,438,G
1-PB2,254,0,2,436,0,438,G
1-PB2,255,444,0,0,0,444,A
1-PB2,256,0,441,0,0,441,T
1-PB2,257,5,0,0,441,446,C
1-PB2,258,451,0,0,0,451,A
1-PB2,259,0,3,460,0,463,G
1-PB2,260,463,0,1,0,464,A
1-PB2,261,0,463,0,0,463,T
1-PB2,262,454,0,0,0,454,A
1-PB2,263,0,2,460,0,462,G
1-PB2,264,455,0,1,0,456,A
1-PB2,265,0,0,463,0,463,G
1-PB2,266,0,458,0,0,458,T
1-PB2,267,0,5,447,0,452,G
1-PB2,268,448,0,0,0,448,A
1-PB2,269,0,448,0,0,448,T
1-PB2,270,1,2,448,0,451,G
1-PB2,271,0,0,458,0,458,G
1-PB2,272,1,457,0,0,458,T
1-PB2,273,455,0,0,0,455,A
1-PB2,274,0,444,0,3,447,T
1-PB2,275,4,0,0,442,446,C
1-PB2,276,453,0,0,0,453,A
1-PB2,277,1,0,0,461,462,C
1-PB2,278,0,1,0,457,458,C
1-PB2,279,1,446,0,0,447,T
1-PB2,280,0,448,0,2,450,T
1-PB2,281,0,450,0,0,450,T
1-PB2,282,11,2,442,0,455,G
1-PB2,283,0,1,459,0,460,G
1-PB2,284,0,0,0,465,465,C
1-PB2,285,0,456,0,2,458,T
1-PB2,286,0,0,467,0,467,G
1-PB2,287,0,467,0,0,467,T
1-PB2,288,467,0,0,0,467,A
1-PB2,289,467,0,1,0,468,A
1-PB2,290,0,0,0,467,467,C
1-PB2,291,461,0,0,0,461,A
1-PB2,292,0,459,0,0,459,T
1-PB2,293,0,1,454,0,455,G
1-PB2,294,0,0,463,0,463,G
1-PB2,295,0,461,0,0,461,T
1-PB2,296,0,2,463,0,465,G
1-PB2,297,0,2,472,0,474,G
1-PB2,298,472,0,0,0,472,A
1-PB2,299,472,0,1,0,473,A
1-PB2,300,0,471,0,1,472,T
1-PB2,301,474,0,0,0,474,A
1-PB2,302,0,3,483,0,486,G
1-PB2,303,479,0,0,0,479,A
1-PB2,304,479,0,0,0,479,A
1-PB2,305,478,0,0,0,478,A
1-PB2,306,0,465,0,0,465,T
1-PB2,307,0,0,465,0,465,G
1-PB2,308,0,1,460,0,461,G
1-PB2,309,467,0,0,0,467,A
1-PB2,310,0,0,0,467,467,C
1-PB2,311,0,0,0,463,463,C
1-PB2,312,2,0,0,459,461,C
1-PB2,313,0,0,461,0,461,G
1-PB2,314,0,466,0,0,466,T
1-PB2,315,0,8,462,0,470,G
1-PB2,316,468,1,0,0,469,A
1-PB2,317,0,1,0,470,471,C
1-PB2,318,473,0,0,0,473,A
1-PB2,319,474,0,0,0,474,A
1-PB2,320,0,1,483,0,484,G
1-PB2,321,0,484,0,0,484,T
1-PB2,322,482,0,0,0,482,A
1-PB2,323,0,0,0,477,477,C
1-PB2,324,0,0,467,0,467,G
1-PB2,325,0,0,480,0,480,G
1-PB2,326,0,475,0,0,475,T
1-PB2,327,5,0,0,476,481,C
1-PB2,328,3,0,0,478,481,C
1-PB2,329,475,0,1,0,476,A
1-PB2,330,1,475,1,0,477,T
1-PB2,331,0,478,0,0,478,T
1-PB2,332,505,0,1,0,506,A
1-PB2,333,0,0,0,503,503,C
1-PB2,334,0,1,0,496,497,C
1-PB2,335,2,0,0,498,500,C
1-PB2,336,495,1,0,0,496,A
1-PB2,337,501,0,0,0,501,A
1-PB2,338,500,0,0,0,500,A
1-PB2,339,500,0,2,0,502,A
1-PB2,340,0,2,507,0,509,G
1-PB2,341,0,496,0,0,496,T
1-PB2,342,0,0,505,0,505,G
1-PB2,343,0,503,0,1,504,T
1-PB2,344,506,0,0,0,506,A
1-PB2,345,0,1,0,506,507,C
1-PB2,346,504,0,1,0,505,A
1-PB2,347,505,0,0,0,505,A
1-PB2,348,0,4,505,0,509,G
1-PB2,349,509,0,0,0,509,A
1-PB2,350,0,0,0,508,508,C
1-PB2,351,0,502,0,0,502,T
1-PB2,352,0,506,0,0,506,T
1-PB2,353,509,0,0,0,509,A
1-PB2,354,0,509,0,0,509,T
1-PB2,355,0,510,0,0,510,T
1-PB2,356,0,506,0,0,506,T
1-PB2,357,1,1,0,503,505,C
1-PB2,358,0,7,497,0,504,G
1-PB2,359,499,0,5,0,504,A
1-PB2,360,0,0,0,503,503,C
1-PB2,361,502,0,0,0,502,A
1-PB2,362,501,1,0,0,502,A
1-PB2,363,499,0,1,0,500,A
1-PB2,364,0,0,511,0,511,G
1-PB2,365,0,511,0,0,511,T
1-PB2,366,3,0,0,506,509,C
1-PB2,367,0,2,504,0,506,G
1-PB2,368,506,1,0,1,508,A
1-PB2,369,508,0,1,0,509,A
1-PB2,370,511,0,0,0,511,A
1-PB2,371,0,0,515,0,515,G
1-PB2,372,0,0,518,0,518,G
1-PB2,373,0,512,0,0,512,T
1-PB2,374,0,513,0,0,513,T
1-PB2,375,514,0,0,0,514,A
1-PB2,376,513,0,0,0,513,A
1-PB2,377,514,0,0,0,514,A
1-PB2,378,516,0,0,1,517,A
1-PB2,379,0,0,0,521,521,C
1-PB2,380,508,0,0,0,508,A
1-PB2,381,0,501,0,2,503,T
1-PB2,382,0,1,502,0,503,G
1-PB2,383,0,0,505,0,505,G
1-PB2,384,507,0,0,0,507,A
1-PB2,385,512,0,0,0,512,A
1-PB2,386,1,0,0,518,519,C
1-PB2,387,3,0,0,517,520,C
1-PB2,388,0,514,1,0,515,T
1-PB2,389,0,515,0,0,515,T
1-PB2,390,0,511,0,2,513,T
1-PB2,391,2,1,512,0,515,G
1-PB2,392,0,0,517,0,517,G
1-PB2,393,0,0,0,516,516,C
1-PB2,394,2,0,0,510,512,C
1-PB2,395,1,0,0,510,511,C
1-PB2,396,1,499,0,1,501,T
1-PB2,397,0,0,511,0,511,G
1-PB2,398,0,510,0,1,511,T
1-PB2,399,0,508,0,0,508,T
1-PB2,400,8,0,0,500,508,C
1-PB2,401,507,0,0,0,507,A
1-PB2,402,0,506,0,1,507,T
1-PB2,403,0,506,0,0,506,T
1-PB2,404,0,507,0,0,507,T
1-PB2,405,0,508,0,0,508,T
1-PB2,406,503,0,0,0,503,A
1-PB2,407,0,3,497,0,500,G
1-PB2,408,504,0,0,0,504,A
1-PB2,409,502,0,0,0,502,A
1-PB2,410,503,0,0,1,504,A
1-PB2,411,0,502,0,0,502,T
1-PB2,412,4,0,0,501,505,C
1-PB2,413,505,0,0,0,505,A
1-PB2,414,510,0,0,0,510,A
1-PB2,415,0,0,514,0,514,G
1-PB2,416,0,512,0,0,512,T
1-PB2,417,4,0,0,509,513,C
1-PB2,418,516,0,1,0,517,A
1-PB2,419,520,0,0,0,520,A
1-PB2,420,0,2,521,0,523,G
1-PB2,421,522,0,2,0,524,A
1-PB2,422,0,523,0,0,523,T
1-PB2,423,527,1,1,0,529,A
1-PB2,424,0,0,0,523,523,C
1-PB2,425,0,0,524,0,524,G
1-PB2,426,1,0,0,537,538,C
1-PB2,427,527,0,0,1,528,A
1-PB2,428,0,1,528,0,529,G
1-PB2,429,524,0,0,0,524,A
1-PB2,430,522,1,0,0,523,A
1-PB2,431,1,3,526,0,530,G
1-PB2,432,519,0,1,0,520,A
1-PB2,433,0,0,525,0,525,G
1-PB2,434,0,520,0,0,520,T
1-PB2,435,514,0,3,0,517,A
1-PB2,436,0,2,522,0,524,G
1-PB2,437,485,0,0,0,485,A
1-PB2,438,0,0,0,502,502,C
1-PB2,439,490,0,0,0,490,A
1-PB2,440,0,481,0,0,481,T
1-PB2,441,477,0,0,0,477,A
1-PB2,442,471,0,2,0,473,A
1-PB2,443,481,0,0,0,481,A
1-PB2,444,0,0,0,489,489,C
1-PB2,445,2,0,0,482,484,C
1-PB2,446,0,0,0,473,473,C
1-PB2,447,0,422,0,4,426,T
1-PB2,448,1,0,428,0,429,G
1-PB2,449,1,0,436,0,437,G
1-PB2,450,0,439,0,0,439,T
1-PB2,451,5,1,0,428,434,C
1-PB2,452,436,0,0,0,436,A
1-PB2,453,0,433,0,1,434,T
1-PB2,454,1,1,431,0,433,G
1-PB2,455,0,0,0,436,436,C
1-PB2,456,431,0,1,0,432,A
1-PB2,457,0,1,433,0,434,G
1-PB2,458,431,0,1,0,432,A
1-PB2,459,0,0,0,432,432,C
1-PB2,460,1,0,0,432,433,C
1-PB2,461,0,429,0,2,431,T
1-PB2,462,0,0,0,429,429,C
1-PB2,463,430,0,0,0,430,A
1-PB2,464,0,0,437,0,437,G
1-PB2,465,0,438,0,0,438,T
1-PB2,466,0,0,437,0,437,G
1-PB2,467,0,0,0,437,437,C
1-PB2,468,2,0,0,427,429,C
1-PB2,469,428,0,0,0,428,A
1-PB2,470,425,0,0,0,425,A
1-PB2,471,426,0,0,0,426,A
1-PB2,472,0,2,423,0,425,G
1-PB2,473,411,0,0,0,411,A
1-PB2,474,0,1,412,0,413,G
1-PB2,475,0,0,410,0,410,G
1-PB2,476,0,0,0,410,410,C
1-PB2,477,410,1,0,0,411,A
1-PB2,478,0,0,0,412,412,C
1-PB2,479,409,0,0,0,409,A
1-PB2,480,417,0,1,0,418,A
1-PB2,481,0,0,416,0,416,G
1-PB2,482,426,0,0,1,427,A
1-PB2,483,0,423,0,0,423,T
1-PB2,484,0,0,423,0,423,G
1-PB2,485,0,424,0,0,424,T
1-PB2,486,424,0,1,0,425,A
1-PB2,487,423,0,1,0,424,A
1-PB2,488,0,425,0,0,425,T
1-PB2,489,0,412,0,0,412,T
1-PB2,490,408,0,0,0,408,A
1-PB2,491,0,392,0,0,392,T
1-PB2,492,0,1,392,0,393,G
1-PB2,493,0,1,390,0,391,G
1-PB2,494,386,0,0,0,386,A
1-PB2,495,386,0,0,0,386,A
1-PB2,496,0,0,387,0,387,G
1-PB2,497,0,391,0,0,391,T
1-PB2,498,0,391,0,0,391,T
1-PB2,499,0,0,391,0,391,G
1-PB2,500,0,389,0,1,390,T
1-PB2,501,0,390,0,0,390,T
1-PB2,502,0,390,0,0,390,T
1-PB2,503,0,388,0,1,389,T
1-PB2,504,0,392,0,1,393,T
1-PB2,505,3,0,0,393,396,C
1-PB2,506,1,1,0,389,391,C
1-PB2,507,1,1,0,393,395,C
1-PB2,508,389,0,0,0,389,A
1-PB2,509,388,0,1,0,389,A
1-PB2,510,0,390,0,0,390,T
1-PB2,511,0,3,389,0,392,G
1-PB2,512,387,0,1,0,388,A
1-PB2,513,387,0,1,0,388,A
1-PB2,514,0,0,394,0,394,G
1-PB2,515,0,388,0,1,389,T
1-PB2,516,0,1,386,0,387,G
1-PB2,517,0,1,388,0,389,G
1-PB2,518,1,0,385,0,386,G
1-PB2,519,387,0,0,0,387,A
1-PB2,520,0,0,380,0,380,G
1-PB2,521,0,0,0,386,386,C
1-PB2,522,2,0,0,383,385,C
1-PB2,523,387,0,1,0,388,A
1-PB2,524,0,0,402,0,402,G
1-PB2,525,0,1,405,0,406,G
1-PB2,526,406,0,0,0,406,A
1-PB2,527,0,406,0,1,407,T
1-PB2,528,409,0,0,0,409,A
1-PB2,529,0,0,0,411,411,C
1-PB2,530,0,408,0,0,408,T
1-PB2,531,407,0,0,0,407,A
1-PB2,532,407,1,0,0,408,A
1-PB2,533,0,0,0,413,413,C
1-PB2,534,402,0,0,0,402,A
1-PB2,535,0,401,0,0,401,T
1-PB2,536,0,1,0,401,402,C
1-PB2,537,394,0,0,0,394,A
1-PB2,538,0,2,397,0,399,G
1-PB2,539,397,0,0,0,397,A
1-PB2,540,396,0,0,0,396,A
1-PB2,541,0,394,0,1,395,T
1-PB2,542,3,0,0,387,390,C
1-PB2,543,385,0,0,0,385,A
1-PB2,544,0,0,0,398,398,C
1-PB2,545,395,0,0,0,395,A
1-PB2,546,398,1,0,0,399,A
1-PB2,547,0,396,0,0,396,T
1-PB2,548,0,396,0,0,396,T
1-PB2,549,401,0,0,0,401,A
1-PB2,550,403,0,1,0,404,A
1-PB2,551,0,0,0,407,407,C
1-PB2,552,402,0,1,0,403,A
1-PB2,553,398,0,0,0,398,A
1-PB2,554,0,402,0,0,402,T
1-PB2,555,402,0,0,0,402,A
1-PB2,556,404,1,0,0,405,A
1-PB2,557,0,0,0,401,401,C
1-PB2,558,0,400,0,0,400,T
1-PB2,559,394,0,0,0,394,A
1-PB2,560,393,0,0,0,393,A
1-PB2,561,391,0,1,0,392,A
1-PB2,562,0,2,395,0,397,G
1-PB2,563,386,0,0,0,386,A
1-PB2,564,0,1,391,0,392,G
1-PB2,565,388,0,1,0,389,A
1-PB2,566,389,0,0,0,389,A
1-PB2,567,389,0,0,0,389,A
1-PB2,568,389,0,0,0,389,A
1-PB2,569,390,0,0,0,390,A
1-PB2,570,389,0,1,0,390,A
1-PB2,571,0,0,391,0,391,G
1-PB2,572,390,0,0,0,390,A
1-PB2,573,386,1,0,0,387,A
1-PB2,574,0,2,387,0,389,G
1-PB2,575,389,0,0,0,389,A
1-PB2,576,390,0,1,0,391,A
1-PB2,577,0,0,0,390,390,C
1-PB2,578,0,387,0,0,387,T
1-PB2,579,2,0,0,385,387,C
1-PB2,580,1,0,0,386,387,C
1-PB2,581,1,3,385,0,389,G
1-PB2,582,389,0,0,0,389,A
1-PB2,583,0,1,387,0,388,G
1-PB2,584,387,0,0,0,387,A
1-PB2,585,0,383,0,0,383,T
1-PB2,586,0,379,0,0,379,T
1-PB2,587,0,1,381,0,382,G
1-PB2,588,0,0,0,382,382,C
1-PB2,589,382,0,0,0,382,A
1-PB2,590,384,0,0,0,384,A
1-PB2,591,384,0,0,0,384,A
1-PB2,592,383,0,1,0,384,A
1-PB2,593,0,382,0,0,382,T
1-PB2,594,0,381,0,0,381,T
1-PB2,595,0,381,0,0,381,T
1-PB2,596,2,0,0,379,381,C
1-PB2,597,0,376,0,0,376,T
1-PB2,598,3,0,0,414,417,C
1-PB2,599,1,2,0,419,422,C
1-PB2,600,1,0,0,481,482,C
1-PB2,601,0,479,0,0,479,T
1-PB2,602,0,494,0,0,494,T
1-PB2,603,0,1,496,0,497,G
1-PB2,604,494,0,2,0,496,A
1-PB2,605,0,505,0,0,505,T
1-PB2,606,0,1,514,0,515,G
1-PB2,607,0,0,588,0,588,G
1-PB2,608,0,605,0,4,609,T
1-PB2,609,0,605,0,3,608,T
1-PB2,610,0,0,671,0,671,G
1-PB2,611,1,0,0,678,679,C
1-PB2,612,707,0,0,0,707,A
1-PB2,613,0,708,0,1,709,T
1-PB2,614,725,0,0,0,725,A
1-PB2,615,1,0,0,780,781,C
1-PB2,616,903,0,0,2,905,A
1-PB2,617,0,933,0,0,933,T
1-PB2,618,1,0,994,0,995,G
1-PB2,619,0,979,0,2,981,T
1-PB2,620,0,975,1,0,976,T
1-PB2,621,974,0,0,0,974,A
1-PB2,622,0,6,970,0,976,G
1-PB2,623,992,0,0,0,992,A
1-PB2,624,0,6,998,0,1004,G
1-PB2,625,979,0,1,0,980,A
1-PB2,626,0,5,981,0,986,G
1-PB2,627,973,1,2,0,976,A
1-PB2,628,0,7,978,0,985,G
1-PB2,629,990,0,2,0,992,A
1-PB2,630,993,0,1,0,994,A
1-PB2,631,0,0,0,998,998,C
1-PB2,632,1,993,0,0,994,T
1-PB2,633,0,990,0,0,990,T
1-PB2,634,0,0,992,0,992,G
1-PB2,635,0,987,0,6,993,T
1-PB2,636,992,0,0,0,992,A
1-PB2,637,0,0,0,991,991,C
1-PB2,638,1,6,982,0,989,G
1-PB2,639,989,1,0,0,990,A
1-PB2,640,992,0,0,0,992,A
1-PB2,641,1005,0,1,0,1006,A
1-PB2,642,1004,0,1,1,1006,A
1-PB2,643,1010,0,3,0,1013,A
1-PB2,644,0,0,0,1014,1014,C
1-PB2,645,1016,0,0,0,1016,A
1-PB2,646,1019,0,0,0,1019,A
1-PB2,647,0,8,1012,0,1020,G
1-PB2,648,1027,0,0,0,1027,A
1-PB2,649,0,1027,0,0,1027,T
1-PB2,650,0,1022,0,0,1022,T
1-PB2,651,0,1025,0,0,1025,T
1-PB2,652,3,0,0,1027,1030,C
1-PB2,653,0,1028,0,2,1030,T
1-PB2,654,6,2,0,1024,1032,C
1-PB2,655,2,1,0,1025,1028,C
1-PB2,656,5,0,0,1027,1032,C
1-PB2,657,1028,0,2,0,1030,A
1-PB2,658,0,0,1054,0,1054,G
1-PB2,659,1,1048,0,2,1051,T
1-PB2,660,1,1045,0,0,1046,T
1-PB2,661,1,2,1044,0,1047,G
1-PB2,662,1,2,0,1044,1047,C
1-PB2,663,0,1041,0,1,1042,T
1-PB2,664,0,2,1046,0,1048,G
1-PB2,665,1,1,1041,0,1043,G
1-PB2,666,0,3,0,1049,1052,C
1-PB2,667,0,2,1046,0,1048,G
1-PB2,668,0,6,1062,0,1068,G
1-PB2,669,1075,0,1,0,1076,A
1-PB2,670,1075,0,1,0,1076,A
1-PB2,671,0,0,0,1083,1083,C
1-PB2,672,1090,0,0,0,1090,A
1-PB2,673,1087,0,2,0,1089,A
1-PB2,674,1,0,1159,0,1160,G
1-PB2,675,1,0,0,1185,1186,C
1-PB2,676,1198,0,1,0,1199,A
1-PB2,677,0,1,1518,0,1519,G
1-PB2,678,0,1520,1,0,1521,T
1-PB2,679,1534,0,0,0,1534,A
1-PB2,680,0,1537,0,0,1537,T
1-PB2,681,1535,0,2,0,1537,A
1-PB2,682,1,1536,0,1,1538,T
1-PB2,683,1515,0,1,0,1516,A
1-PB2,684,0,1,0,1531,1532,C
1-PB2,685,1468,1,2,0,1471,A
1-PB2,686,0,1414,0,0,1414,T
1-PB2,687,0,1386,0,0,1386,T
1-PB2,688,0,5,1383,0,1388,G
1-PB2,689,1387,0,1,0,1388,A
1-PB2,690,1386,1,2,0,1389,A
1-PB2,691,0,0,1414,0,1414,G
1-PB2,692,0,1407,0,1,1408,T
1-PB2,693,0,1402,0,0,1402,T
1-PB2,694,0,1403,0,1,1404,T
1-PB2,695,0,1405,0,2,1407,T
1-PB2,696,1428,1,2,0,1431,A
1-PB2,697,2,0,0,1438,1440,C
1-PB2,698,1439,0,1,5,1445,A
1-PB2,699,1,1440,0,1,1442,T
1-PB2,700,0,1436,0,1,1437,T
1-PB2,701,0,1436,0,0,1436,T
1-PB2,702,0,20,1435,0,1455,G
1-PB2,703,1462,0,2,0,1464,A
1-PB2,704,0,0,0,1468,1468,C
1-PB2,705,0,1456,1,0,1457,T
1-PB2,706,5,1,0,1454,1460,C
1-PB2,707,1456,0,2,0,1458,A
1-PB2,708,0,6,1446,0,1452,G
1-PB2,709,0,4,1483,0,1487,G
1-PB2,710,0,3,1488,0,1491,G
1-PB2,711,1489,0,2,0,1491,A
1-PB2,712,1495,0,3,0,1498,A
1-PB2,713,0,0,0,1497,1497,C
1-PB2,714,2,0,1508,0,1510,G
1-PB2,715,0,1507,1,1,1509,T
1-PB2,716,1,1,1520,0,1522,G
1-PB2,717,0,1510,0,0,1510,T
1-PB2,718,1,1508,0,1,1510,T
1-PB2,719,0,9,1505,0,1514,G
1-PB2,720,1,2,1513,0,1516,G
1-PB2,721,1,14,1517,0,1532,G
1-PB2,722,1526,0,1,0,1527,A
1-PB2,723,1516,1,0,1,1518,A
1-PB2,724,1,1,0,1560,1562,C
1-PB2,725,1554,0,0,0,1554,A
1-PB2,726,1596,0,1,0,1597,A
1-PB2,727,1600,1,0,0,1601,A
1-PB2,728,0,1615,1,1,1617,T
1-PB2,729,0,1,1634,1,1636,G
1-PB2,730,0,1626,0,2,1628,T
1-PB2,731,1624,1,1,1,1627,A
1-PB2,732,1,5,1,1628,1635,C
1-PB2,733,1597,0,0,0,1597,A
1-PB2,734,1,0,0,1593,1594,C
1-PB2,735,0,1543,0,3,1546,T
1-PB2,736,4,1,0,1669,1674,C
1-PB2,737,3,0,0,1676,1679,C
1-PB2,738,1701,0,5,0,1706,A
1-PB2,739,0,1,1718,0,1719,G
1-PB2,740,0,0,1753,0,1753,G
1-PB2,741,1,1746,0,0,1747,T
1-PB2,742,1,6,1733,0,1740,G
1-PB2,743,0,3,1691,0,1694,G
1-PB2,744,1670,1,2,0,1673,A
1-PB2,745,0,2,1678,0,1680,G
1-PB2,746,0,9,1676,0,1685,G
1-PB2,747,1663,0,2,0,1665,A
1-PB2,748,0,0,1681,0,1681,G
1-PB2,749,0,1650,0,0,1650,T
1-PB2,750,0,4,1655,0,1659,G
1-PB2,751,1657,0,1,1,1659,A
1-PB2,752,0,3,1663,0,1666,G
1-PB2,753,0,7,1668,0,1675,G
1-PB2,754,1658,1,0,0,1659,A
1-PB2,755,1659,1,4,0,1664,A
1-PB2,756,0,1656,0,2,1658,T
1-PB2,757,0,11,1642,0,1653,G
1-PB2,758,1653,1,1,0,1655,A
1-PB2,759,0,1,0,1651,1652,C
1-PB2,760,1,12,1637,0,1650,G
1-PB2,761,1661,1,1,0,1663,A
1-PB2,762,0,1651,0,0,1651,T
1-PB2,763,0,0,1667,0,1667,G
1-PB2,764,0,1662,0,1,1663,T
1-PB2,765,1,1648,0,5,1654,T
1-PB2,766,1,12,1666,0,1679,G
1-PB2,767,1682,1,3,0,1686,A
1-PB2,768,1,0,0,1688,1689,C
1-PB2,769,12,0,0,1671,1683,C
1-PB2,770,1666,0,0,0,1666,A
1-PB2,771,1667,0,0,0,1667,A
1-PB2,772,1671,0,2,0,1673,A
1-PB2,773,1,0,1710,0,1711,G
1-PB2,774,3,1,0,1706,1710,C
1-PB2,775,2,1,0,1697,1700,C
1-PB2,776,0,1710,0,0,1710,T
1-PB2,777,1712,0,1,0,1713,A
1-PB2,778,1709,0,2,0,1711,A
1-PB2,779,0,1715,0,0,1715,T
1-PB2,780,0,1712,0,0,1712,T
1-PB2,781,1692,1,0,0,1693,A
1-PB2,782,1,1651,0,3,1655,T
1-PB2,783,0,1647,0,0,1647,T
1-PB2,784,0,3,1640,0,1643,G
1-PB2,785,2,2,0,1632,1636,C
1-PB2,786,1,5,1630,0,1636,G
1-PB2,787,0,1,1676,0,1677,G
1-PB2,788,0,0,0,1670,1670,C
1-PB2,789,4,0,0,1675,1679,C
1-PB2,790,1679,0,6,0,1685,A
1-PB2,791,0,3,1694,0,1697,G
1-PB2,792,0,16,1689,0,1705,G
1-PB2,793,1711,0,0,0,1711,A
1-PB2,794,1718,0,1,0,1719,A
1-PB2,795,0,0,0,1731,1731,C
1-PB2,796,1703,0,2,0,1705,A
1-PB2,797,0,1727,0,1,1728,T
1-PB2,798,1753,0,1,0,1754,A
1-PB2,799,0,0,1767,0,1767,G
1-PB2,800,0,1740,0,1,1741,T
1-PB2,801,1725,0,1,1,1727,A
1-PB2,802,1721,0,2,1,1724,A
1-PB2,803,0,4,1725,0,1729,G
1-PB2,804,1718,1,2,0,1721,A
1-PB2,805,1690,0,3,0,1693,A
1-PB2,806,0,5,1683,0,1688,G
1-PB2,807,1640,0,4,1,1645,A
1-PB2,808,0,0,1646,0,1646,G
1-PB2,809,0,0,0,1643,1643,C
1-PB2,810,4,10,0,1629,1643,C
1-PB2,811,1,0,1645,0,1646,G
1-PB2,812,1,0,0,1647,1648,C
1-PB2,813,1659,0,0,0,1659,A
1-PB2,814,1,0,1760,0,1761,G
1-PB2,815,1,1762,0,1,1764,T
1-PB2,816,1771,0,0,0,1771,A
1-PB2,817,0,1757,0,1,1758,T
1-PB2,818,10,0,0,1764,1774,C
1-PB2,819,1757,0,5,0,1762,A
1-PB2,820,0,0,1765,0,1765,G
1-PB2,821,0,1,1,1766,1768,C
1-PB2,822,1704,0,1,0,1705,A
1-PB2,823,0,5,1689,0,1694,G
1-PB2,824,1704,0,0,0,1704,A
1-PB2,825,0,1698,0,0,1698,T
1-PB2,826,4,0,0,1705,1709,C
1-PB2,827,3,2,1,1698,1704,C
1-PB2,828,1707,0,1,0,1708,A
1-PB2,829,0,0,0,1716,1716,C
1-PB2,830,0,1710,0,0,1710,T
1-PB2,831,1720,0,0,0,1720,A
1-PB2,832,0,4,1708,0,1712,G
1-PB2,833,2,0,0,1692,1694,C
1-PB2,834,1689,1,1,0,1691,A
1-PB2,835,1,1705,0,0,1706,T
1-PB2,836,4,0,0,1720,1724,C
1-PB2,837,0,1715,0,3,1718,T
1-PB2,838,0,1759,0,1,1760,T
1-PB2,839,0,1765,0,0,1765,T
1-PB2,840,1760,0,0,0,1760,A
1-PB2,841,0,1761,0,2,1763,T
1-PB2,842,0,1754,0,3,1757,T
1-PB2,843,0,2,1751,1,1754,G
1-PB2,844,2,15,1731,0,1748,G
1-PB2,845,1711,0,6,0,1717,A
1-PB2,846,0,10,1711,0,1721,G
1-PB2,847,1697,0,1,0,1698,A
1-PB2,848,0,1689,0,1,1690,T
1-PB2,849,0,4,1723,0,1727,G
1-PB2,850,0,1716,0,3,1719,T
1-PB2,851,0,1,1720,0,1721,G
1-PB2,852,0,0,0,1727,1727,C
1-PB2,853,12,1,0,1702,1715,C
1-PB2,854,1713,1,2,0,1716,A
1-PB2,855,3,2,0,1712,1717,C
1-PB2,856,1696,0,3,0,1699,A
1-PB2,857,1,1,1721,0,1723,G
1-PB2,858,0,1,0,1699,1700,C
1-PB2,859,1696,0,0,0,1696,A
1-PB2,860,1,1,0,1695,1697,C
1-PB2,861,1690,1,3,0,1694,A
1-PB2,862,0,1,0,1720,1721,C
1-PB2,863,1713,0,1,0,1714,A
1-PB2,864,1718,0,1,0,1719,A
1-PB2,865,1718,0,1,0,1719,A
1-PB2,866,0,1679,0,2,1681,T
1-PB2,867,0,1678,0,0,1678,T
1-PB2,868,2,3,1673,0,1678,G
1-PB2,869,0,0,1671,0,1671,G
1-PB2,870,0,2,0,1673,1675,C
1-PB2,871,4,4,1653,0,1661,G
1-PB2,872,0,8,1658,0,1666,G
1-PB2,873,1653,0,2,0,1655,A
1-PB2,874,1688,1,2,0,1691,A
1-PB2,875,0,0,0,1699,1699,C
1-PB2,876,1694,1,4,0,1699,A
1-PB2,877,1687,1,16,0,1704,A
1-PB2,878,0,2,1708,0,1710,G
1-PB2,879,2,4,1703,0,1709,G
1-PB2,880,1716,0,1,0,1717,A
1-PB2,881,0,1629,0,1,1630,T
1-PB2,882,0,4,1616,1,1621,G
1-PB2,883,1,0,1628,0,1629,G
1-PB2,884,0,1612,0,1,1613,T
1-PB2,885,1,6,1611,0,1618,G
1-PB2,886,0,17,1597,0,1614,G
1-PB2,887,1598,1,2,0,1601,A
1-PB2,888,1,2,0,1594,1597,C
1-PB2,889,1570,0,0,0,1570,A
1-PB2,890,0,1817,0,0,1817,T
1-PB2,891,0,1810,0,0,1810,T
1-PB2,892,17,0,0,1800,1817,C
1-PB2,893,0,1796,0,3,1799,T
1-PB2,894,0,1797,0,1,1798,T
1-PB2,895,1795,1,1,0,1797,A
1-PB2,896,0,13,1799,0,1812,G
1-PB2,897,1807,0,1,0,1808,A
1-PB2,898,2,0,0,1809,1811,C
1-PB2,899,1545,1,0,0,1546,A
1-PB2,900,1,4,1564,0,1569,G
1-PB2,901,1556,0,6,0,1562,A
1-PB2,902,1562,0,3,0,1565,A
1-PB2,903,1,1,0,1562,1564,C
1-PB2,904,10,1,0,1546,1557,C
1-PB2,905,9,2,0,1534,1545,C
1-PB2,906,2,17,1527,0,1546,G
1-PB2,907,1549,0,0,0,1549,A
1-PB2,908,3,0,0,1552,1555,C
1-PB2,909,0,1528,0,1,1529,T
1-PB2,910,0,8,1533,0,1541,G
1-PB2,911,1538,0,0,0,1538,A
1-PB2,912,1551,0,4,0,1555,A
1-PB2,913,2,13,1549,0,1564,G
1-PB2,914,1558,0,0,2,1560,A
1-PB2,915,1555,0,2,1,1558,A
1-PB2,916,0,1,0,1547,1548,C
1-PB2,917,1538,0,1,1,1540,A
1-PB2,918,1542,0,4,0,1546,A
1-PB2,919,0,2,1559,0,1561,G
1-PB2,920,0,0,0,1577,1577,C
1-PB2,921,0,1565,0,0,1565,T
1-PB2,922,1,0,1587,0,1588,G
1-PB2,923,1,1584,0,0,1585,T
1-PB2,924,1,6,1607,0,1614,G
1-PB2,925,0,2,1669,0,1671,G
1-PB2,926,1676,0,0,0,1676,A
1-PB2,927,0,1670,0,2,1672,T
1-PB2,928,1652,0,2,1,1655,A
1-PB2,929,0,1632,1,0,1633,T
1-PB2,930,1674,1,0,1,1676,A
1-PB2,931,0,1649,0,1,1650,T
1-PB2,932,1,3,1646,0,1650,G
1-PB2,933,4,0,1,1617,1622,C
1-PB2,934,1571,0,0,1,1572,A
1-PB2,935,1570,1,4,0,1575,A
1-PB2,936,1,3,1571,0,1575,G
1-PB2,937,1,1,1574,0,1576,G
1-PB2,938,1,0,1,1574,1576,C
1-PB2,939,0,1541,1,4,1546,T
1-PB2,940,1,0,1552,0,1553,G
1-PB2,941,0,0,0,1556,1556,C
1-PB2,942,1556,1,1,0,1558,A
1-PB2,943,1559,0,1,1,1561,A
1-PB2,944,0,1555,1,1,1557,T
1-PB2,945,1,3,1558,0,1562,G
1-PB2,946,0,5,1545,0,1550,G
1-PB2,947,1,7,1543,0,1551,G
1-PB2,948,1544,0,5,0,1549,A
1-PB2,949,0,1544,0,0,1544,T
1-PB2,950,0,1528,0,1,1529,T
1-PB2,951,0,12,1523,0,1535,G
1-PB2,952,1529,1,3,0,1533,A
1-PB2,953,0,8,1539,0,1547,G
1-PB2,954,1526,0,2,0,1528,A
1-PB2,955,1513,0,0,0,1513,A
1-PB2,956,0,1497,1,2,1500,T
1-PB2,957,7,0,0,1499,1506,C
1-PB2,958,1499,0,1,0,1500,A
1-PB2,959,0,0,1509,0,1509,G
1-PB2,960,1,0,0,1506,1507,C
1-PB2,961,0,1492,0,2,1494,T
1-PB2,962,14,1,0,1478,1493,C
1-PB2,963,1492,0,0,0,1492,A
1-PB2,964,1,1520,0,3,1524,T
1-PB2,965,6,1,0,1521,1528,C
1-PB2,966,4,0,0,1529,1533,C
1-PB2,967,0,1533,0,2,1535,T
1-PB2,968,0,1524,1,1,1526,T
1-PB2,969,10,0,0,1518,1528,C
1-PB2,970,1524,0,1,0,1525,A
1-PB2,971,0,2,1549,0,1551,G
1-PB2,972,9,1,0,1534,1544,C
1-PB2,973,0,1513,0,6,1519,T
1-PB2,974,0,1526,0,0,1526,T
1-PB2,975,0,1518,0,0,1518,T
1-PB2,976,0,7,1516,0,1523,G
1-PB2,977,0,0,1523,0,1523,G
1-PB2,978,0,1523,0,1,1524,T
1-PB2,979,0,3,1527,0,1530,G
1-PB2,980,1,4,1511,0,1516,G
1-PB2,981,0,1,1529,0,1530,G
1-PB2,982,1,1514,0,5,1520,T
1-PB2,983,0,1517,1,0,1518,T
1-PB2,984,0,1518,0,3,1521,T
1-PB2,985,1522,0,2,0,1524,A
1-PB2,986,0,3,0,1525,1528,C
1-PB2,987,1537,0,0,0,1537,A
1-PB2,988,0,1522,0,1,1523,T
1-PB2,989,0,1502,0,0,1502,T
1-PB2,990,1,1505,0,0,1506,T
1-PB2,991,1508,0,0,0,1508,A
1-PB2,992,1502,0,0,0,1502,A
1-PB2,993,1507,0,0,0,1507,A
1-PB2,994,1489,0,5,0,1494,A
1-PB2,995,1,11,1494,0,1506,G
1-PB2,996,1494,0,0,0,1494,A
1-PB2,997,1497,1,1,0,1499,A
1-PB2,998,0,1,0,1502,1503,C
1-PB2,999,1494,0,0,0,1494,A
1-PB2,1000,1496,0,1,0,1497,A
1-PB2,1001,0,0,1499,0,1499,G
1-PB2,1002,3,1,0,1491,1495,C
1-PB2,1003,3,5,1487,0,1495,G
1-PB2,1004,1,3,1506,0,1510,G
1-PB2,1005,0,0,1511,0,1511,G
1-PB2,1006,1,1496,0,6,1503,T
1-PB2,1007,15,0,0,1488,1503,C
1-PB2,1008,1495,1,5,0,1501,A
1-PB2,1009,0,1492,0,2,1494,T
1-PB2,1010,7,1,0,1493,1501,C
1-PB2,1011,1491,3,1,0,1495,A
1-PB2,1012,0,0,1522,0,1522,G
1-PB2,1013,0,1499,0,2,1501,T
1-PB2,1014,16,1,0,1486,1503,C
1-PB2,1015,1496,0,3,0,1499,A
1-PB2,1016,1507,2,2,0,1511,A
1-PB2,1017,1507,0,2,0,1509,A
1-PB2,1018,1509,0,0,0,1509,A
1-PB2,1019,1515,0,2,0,1517,A
1-PB2,1020,1516,0,2,0,1518,A
1-PB2,1021,0,4,1523,0,1527,G
1-PB2,1022,1517,0,4,0,1521,A
1-PB2,1023,1516,0,0,0,1516,A
1-PB2,1024,0,6,1512,0,1518,G
1-PB2,1025,1512,0,0,0,1512,A
1-PB2,1026,1466,0,3,0,1469,A
1-PB2,1027,0,2,1471,0,1473,G
1-PB2,1028,1468,0,2,0,1470,A
1-PB2,1029,1,1,1470,0,1472,G
1-PB2,1030,0,1,1502,0,1503,G
1-PB2,1031,0,1502,1,0,1503,T
1-PB2,1032,1,0,1526,0,1527,G
1-PB2,1033,1,0,0,1526,1527,C
1-PB2,1034,0,1520,1,1,1522,T
1-PB2,1035,0,1524,0,1,1525,T
1-PB2,1036,1520,0,1,0,1521,A
1-PB2,1037,0,2,0,1520,1522,C
1-PB2,1038,1494,0,5,0,1499,A
1-PB2,1039,0,2,1504,0,1506,G
1-PB2,1040,1,0,1504,0,1505,G
1-PB2,1041,0,0,0,1476,1476,C
1-PB2,1042,1462,0,2,0,1464,A
1-PB2,1043,1464,0,1,0,1465,A
1-PB2,1044,0,1477,0,1,1478,T
1-PB2,1045,7,0,0,1510,1517,C
1-PB2,1046,0,1508,0,1,1509,T
1-PB2,1047,4,1,0,1508,1513,C
1-PB2,1048,2,1,1,1504,1508,C
1-PB2,1049,1505,0,1,0,1506,A
1-PB2,1050,1507,0,1,0,1508,A
1-PB2,1051,1507,1,1,1,1510,A
1-PB2,1052,1,0,0,1515,1516,C
1-PB2,1053,1465,0,0,0,1465,A
1-PB2,1054,1,1442,0,2,1445,T
1-PB2,1055,0,1418,0,0,1418,T
1-PB2,1056,1,2,1422,0,1425,G
1-PB2,1057,1416,0,0,1,1417,A
1-PB2,1058,3,11,1374,0,1388,G
1-PB2,1059,1481,0,3,0,1484,A
1-PB2,1060,1485,0,1,0,1486,A
1-PB2,1061,0,1497,0,0,1497,T
1-PB2,1062,1492,0,1,0,1493,A
1-PB2,1063,1496,0,5,0,1501,A
1-PB2,1064,0,11,1534,0,1545,G
1-PB2,1065,1507,0,3,0,1510,A
1-PB2,1066,0,2,1553,0,1555,G
1-PB2,1067,0,1509,1,0,1510,T
1-PB2,1068,1515,0,0,0,1515,A
1-PB2,1069,2,1,0,1538,1541,C
1-PB2,1070,1530,0,2,0,1532,A
1-PB2,1071,2,1528,0,0,1530,T
1-PB2,1072,0,7,1519,0,1526,G
1-PB2,1073,1473,0,3,0,1476,A
1-PB2,1074,0,6,1480,1,1487,G
1-PB2,1075,3,5,1481,1,1490,G
1-PB2,1076,0,1,1540,1,1542,G
1-PB2,1077,4,1,1543,0,1548,G
1-PB2,1078,0,1509,0,0,1509,T
1-PB2,1079,1512,0,6,0,1518,A
1-PB2,1080,0,1509,0,0,1509,T
1-PB2,1081,0,7,1511,0,1518,G
1-PB2,1082,1510,0,2,0,1512,A
1-PB2,1083,0,0,1504,0,1504,G
1-PB2,1084,0,3,1500,0,1503,G
1-PB2,1085,1385,0,1,0,1386,A
1-PB2,1086,1,1,1442,0,1444,G
1-PB2,1087,1,1428,0,4,1433,T
1-PB2,1088,0,1478,0,1,1479,T
1-PB2,1089,21,0,1,1469,1491,C
1-PB2,1090,1483,0,0,1,1484,A
1-PB2,1091,1,0,0,1492,1493,C
1-PB2,1092,1490,0,0,0,1490,A
1-PB2,1093,1486,1,1,0,1488,A
1-PB2,1094,1,1485,0,0,1486,T
1-PB2,1095,0,9,1445,0,1454,G
1-PB2,1096,0,0,1469,0,1469,G
1-PB2,1097,1,1430,0,2,1433,T
1-PB2,1098,0,5,1436,0,1441,G
1-PB2,1099,0,3,1433,0,1436,G
1-PB2,1100,1,4,1436,0,1441,G
1-PB2,1101,1,3,1443,0,1447,G
1-PB2,1102,1440,1,0,0,1441,A
1-PB2,1103,1439,0,5,0,1444,A
1-PB2,1104,1437,1,1,0,1439,A
1-PB2,1105,1403,0,4,1,1408,A
1-PB2,1106,0,12,1412,0,1424,G
1-PB2,1107,1418,0,3,0,1421,A
1-PB2,1108,0,1,1421,1,1423,G
1-PB2,1109,0,1,1,1421,1423,C
1-PB2,1110,1407,0,2,0,1409,A
1-PB2,1111,1413,0,0,0,1413,A
1-PB2,1112,0,1,0,1458,1459,C
1-PB2,1113,1451,1,2,0,1454,A
1-PB2,1114,0,1,1481,0,1482,G
1-PB2,1115,2,1,0,1470,1473,C
1-PB2,1116,0,1469,0,1,1470,T
1-PB2,1117,1513,0,0,0,1513,A
1-PB2,1118,0,1514,0,0,1514,T
1-PB2,1119,1523,1,1,0,1525,A
1-PB2,1120,0,0,0,1524,1524,C
1-PB2,1121,0,1427,0,2,1429,T
1-PB2,1122,1437,1,0,0,1438,A
1-PB2,1123,1402,0,1,0,1403,A
1-PB2,1124,0,6,1400,0,1406,G
1-PB2,1125,1399,0,0,1,1400,A
1-PB2,1126,1355,0,0,1,1356,A
1-PB2,1127,1355,0,3,0,1358,A
1-PB2,1128,1350,0,2,0,1352,A
1-PB2,1129,0,0,1353,0,1353,G
1-PB2,1130,0,0,0,1351,1351,C
1-PB2,1131,1348,0,0,0,1348,A
1-PB2,1132,1350,0,2,0,1352,A
1-PB2,1133,1,1,0,1348,1350,C
1-PB2,1134,5,0,0,1346,1351,C
1-PB2,1135,1357,0,1,0,1358,A
1-PB2,1136,0,2,1365,0,1367,G
1-PB2,1137,1360,0,0,1,1361,A
1-PB2,1138,1361,0,1,1,1363,A
1-PB2,1139,0,8,1371,1,1380,G
1-PB2,1140,1368,0,1,0,1369,A
1-PB2,1141,0,1359,0,3,1362,T
1-PB2,1142,0,1351,0,0,1351,T
1-PB2,1143,0,9,1348,1,1358,G
1-PB2,1144,0,0,1383,0,1383,G
1-PB2,1145,1,1369,0,2,1372,T
1-PB2,1146,0,1366,0,2,1368,T
1-PB2,1147,17,1,0,1353,1371,C
1-PB2,1148,1365,0,1,0,1366,A
1-PB2,1149,1348,0,4,0,1352,A
1-PB2,1150,0,0,0,1458,1458,C
1-PB2,1151,0,1452,1,0,1453,T
1-PB2,1152,9,1,1,1458,1469,C
1-PB2,1153,1453,0,2,0,1455,A
1-PB2,1154,0,1461,0,0,1461,T
1-PB2,1155,1461,0,1,0,1462,A
1-PB2,1156,1,0,1470,0,1471,G
1-PB2,1157,0,1426,0,0,1426,T
1-PB2,1158,0,8,1436,0,1444,G
1-PB2,1159,1385,0,0,0,1385,A
1-PB2,1160,0,0,1400,0,1400,G
1-PB2,1161,0,1388,0,2,1390,T
1-PB2,1162,0,4,1380,1,1385,G
1-PB2,1163,2,3,1395,0,1400,G
1-PB2,1164,1401,1,2,0,1404,A
1-PB2,1165,1391,0,2,0,1393,A
1-PB2,1166,0,7,1398,0,1405,G
1-PB2,1167,1379,1,1,0,1381,A
1-PB2,1168,1,5,1385,0,1391,G
1-PB2,1169,1373,0,4,0,1377,A
1-PB2,1170,0,2,0,1378,1380,C
1-PB2,1171,1,10,1374,1,1386,G
1-PB2,1172,1365,0,2,0,1367,A
1-PB2,1173,1372,0,2,0,1374,A
1-PB2,1174,0,1,0,1377,1378,C
1-PB2,1175,1365,0,1,0,1366,A
1-PB2,1176,1,1,1454,0,1456,G
1-PB2,1177,0,1448,1,0,1449,T
1-PB2,1178,9,0,0,1441,1450,C
1-PB2,1179,1450,1,2,0,1453,A
1-PB2,1180,1447,0,3,0,1450,A
1-PB2,1181,0,1450,0,0,1450,T
1-PB2,1182,1448,0,1,0,1449,A
1-PB2,1183,1,0,1448,0,1449,G
1-PB2,1184,0,1,0,1443,1444,C
1-PB2,1185,5,2,0,1385,1392,C
1-PB2,1186,1,6,1378,0,1385,G
1-PB2,1187,1386,0,0,0,1386,A
1-PB2,1188,1381,0,1,0,1382,A
1-PB2,1189,0,0,1405,0,1405,G
1-PB2,1190,1,3,0,1414,1418,C
1-PB2,1191,1419,0,1,0,1420,A
1-PB2,1192,1414,0,2,1,1417,A
1-PB2,1193,0,1418,0,0,1418,T
1-PB2,1194,1417,0,0,1,1418,A
1-PB2,1195,1454,0,3,0,1457,A
1-PB2,1196,0,1449,0,0,1449,T
1-PB2,1197,10,1,0,1437,1448,C
1-PB2,1198,1,1,1435,0,1437,G
1-PB2,1199,0,1417,0,0,1417,T
1-PB2,1200,1406,0,3,0,1409,A
1-PB2,1201,0,2,1432,0,1434,G
1-PB2,1202,1,1,0,1434,1436,C
1-PB2,1203,5,1,0,1434,1440,C
1-PB2,1204,1421,0,0,0,1421,A
1-PB2,1205,0,1412,0,3,1415,T
1-PB2,1206,0,5,1415,0,1420,G
1-PB2,1207,0,1,1431,0,1432,G
1-PB2,1208,0,1402,0,2,1404,T
1-PB2,1209,0,0,1411,0,1411,G
1-PB2,1210,0,1354,1,1,1356,T
1-PB2,1211,0,1346,0,0,1346,T
1-PB2,1212,1,1349,1,0,1351,T
1-PB2,1213,0,1353,0,0,1353,T
1-PB2,1214,9,0,0,1359,1368,C
1-PB2,1215,1363,0,5,0,1368,A
1-PB2,1216,0,0,0,1420,1420,C
1-PB2,1217,1396,1,1,0,1398,A
1-PB2,1218,1399,0,0,1,1400,A
1-PB2,1219,0,3,1396,0,1399,G
1-PB2,1220,1393,0,1,0,1394,A
1-PB2,1221,1333,1,39,0,1373,A
1-PB2,1222,0,5,1393,0,1398,G
1-PB2,1223,1398,0,3,0,1401,A
1-PB2,1224,0,1401,0,2,1403,T
1-PB2,1225,0,1380,0,0,1380,T
1-PB2,1226,1,1,1380,0,1382,G
1-PB2,1227,0,0,0,1361,1361,C
1-PB2,1228,1366,0,1,1,1368,A
1-PB2,1229,0,1377,0,0,1377,T
1-PB2,1230,0,5,1442,0,1447,G
1-PB2,1231,1454,0,3,0,1457,A
1-PB2,1232,0,1460,0,0,1460,T
1-PB2,1233,1458,0,0,0,1458,A
1-PB2,1234,1457,1,1,0,1459,A
1-PB2,1235,1456,0,0,0,1456,A
1-PB2,1236,1459,0,1,0,1460,A
1-PB2,1237,3,0,1467,0,1470,G
1-PB2,1238,2,0,0,1495,1497,C
1-PB2,1239,1505,0,1,0,1506,A
1-PB2,1240,0,2,1548,0,1550,G
1-PB2,1241,0,1544,0,1,1545,T
1-PB2,1242,0,1545,1,0,1546,T
1-PB2,1243,1546,0,1,0,1547,A
1-PB2,1244,0,4,1545,0,1549,G
1-PB2,1245,1547,1,2,0,1550,A
1-PB2,1246,0,9,1541,0,1550,G
1-PB2,1247,0,1,1550,0,1551,G
1-PB2,1248,0,1480,0,0,1480,T
1-PB2,1249,0,22,1453,0,1475,G
1-PB2,1250,1486,0,3,0,1489,A
1-PB2,1251,1,7,0,1485,1493,C
1-PB2,1252,4,1,0,1492,1497,C
1-PB2,1253,0,1486,0,0,1486,T
1-PB2,1254,6,12,1480,0,1498,G
1-PB2,1255,1494,0,2,0,1496,A
1-PB2,1256,1497,0,0,0,1497,A
1-PB2,1257,1,1492,0,1,1494,T
1-PB2,1258,0,1498,0,1,1499,T
1-PB2,1259,0,1509,0,0,1509,T
1-PB2,1260,7,0,0,1495,1502,C
1-PB2,1261,3,2,1498,0,1503,G
1-PB2,1262,0,1500,0,2,1502,T
1-PB2,1263,9,1,0,1492,1502,C
1-PB2,1264,1505,0,0,0,1505,A
1-PB2,1265,1508,0,1,0,1509,A
1-PB2,1266,0,0,0,1506,1506,C
1-PB2,1267,1486,0,1,0,1487,A
1-PB2,1268,0,5,1507,0,1512,G
1-PB2,1269,1498,0,7,0,1505,A
1-PB2,1270,0,0,1519,0,1519,G
1-PB2,1271,2,3,0,1519,1524,C
1-PB2,1272,1516,0,1,0,1517,A
1-PB2,1273,1521,1,6,0,1528,A
1-PB2,1274,1529,0,1,0,1530,A
1-PB2,1275,0,1522,0,0,1522,T
1-PB2,1276,6,1,0,1525,1532,C
1-PB2,1277,1508,0,1,0,1509,A
1-PB2,1278,0,3,1511,0,1514,G
1-PB2,1279,0,1,0,1521,1522,C
1-PB2,1280,1,2,1515,0,1518,G
1-PB2,1281,1,0,1590,0,1591,G
1-PB2,1282,0,1581,0,1,1582,T
1-PB2,1283,0,1581,0,3,1584,T
1-PB2,1284,0,15,1567,0,1582,G
1-PB2,1285,1585,0,2,0,1587,A
1-PB2,1286,1596,1,3,0,1600,A
1-PB2,1287,0,0,0,1607,1607,C
1-PB2,1288,13,0,0,1592,1605,C
1-PB2,1289,5,0,0,1614,1619,C
1-PB2,1290,1,1,0,1574,1576,C
1-PB2,1291,1586,0,2,0,1588,A
1-PB2,1292,0,1589,0,2,1591,T
1-PB2,1293,2,0,1593,0,1595,G
1-PB2,1294,0,2,0,1600,1602,C
1-PB2,1295,1599,1,1,0,1601,A
1-PB2,1296,0,1589,0,3,1592,T
1-PB2,1297,9,1,0,1585,1595,C
1-PB2,1298,1584,0,2,0,1586,A
1-PB2,1299,2,0,1601,0,1603,G
1-PB2,1300,0,0,0,1605,1605,C
1-PB2,1301,0,1599,0,1,1600,T
1-PB2,1302,0,1604,0,0,1604,T
1-PB2,1303,0,1597,0,0,1597,T
1-PB2,1304,0,1601,0,0,1601,T
1-PB2,1305,1604,0,0,0,1604,A
1-PB2,1306,1602,0,2,0,1604,A
1-PB2,1307,0,8,1595,0,1603,G
1-PB2,1308,1,2,1579,0,1582,G
1-PB2,1309,0,1,0,1570,1571,C
1-PB2,1310,1565,0,1,0,1566,A
1-PB2,1311,0,1566,0,1,1567,T
1-PB2,1312,1,1566,1,3,1571,T
1-PB2,1313,0,1576,0,1,1577,T
1-PB2,1314,0,1583,0,2,1585,T
1-PB2,1315,14,0,0,1575,1589,C
1-PB2,1316,1584,0,1,0,1585,A
1-PB2,1317,0,9,1572,0,1581,G
1-PB2,1318,1580,0,0,0,1580,A
1-PB2,1319,1579,0,0,0,1579,A
1-PB2,1320,1563,0,15,0,1578,A
1-PB2,1321,0,3,1584,0,1587,G
1-PB2,1322,1597,0,4,0,1601,A
1-PB2,1323,0,1603,0,2,1605,T
1-PB2,1324,2,0,1604,0,1606,G
1-PB2,1325,0,1,0,1602,1603,C
1-PB2,1326,0,8,1592,0,1600,G
1-PB2,1327,1604,0,2,0,1606,A
1-PB2,1328,1606,0,0,0,1606,A
1-PB2,1329,1603,0,1,0,1604,A
1-PB2,1330,0,2,1603,0,1605,G
1-PB2,1331,0,1585,0,3,1588,T
1-PB2,1332,0,1,1584,0,1585,G
1-PB2,1333,1,1,0,1577,1579,C
1-PB2,1334,0,1579,0,4,1583,T
1-PB2,1335,0,1578,1,0,1579,T
1-PB2,1336,0,1579,0,1,1580,T
1-PB2,1337,0,1579,0,2,1581,T
1-PB2,1338,0,1579,0,1,1580,T
1-PB2,1339,5,0,0,1572,1577,C
1-PB2,1340,1583,0,0,0,1583,A
1-PB2,1341,1591,0,0,0,1591,A
1-PB2,1342,1583,0,1,0,1584,A
1-PB2,1343,1592,0,1,0,1593,A
1-PB2,1344,0,1594,0,0,1594,T
1-PB2,1345,0,1585,0,2,1587,T
1-PB2,1346,0,6,1586,1,1593,G
1-PB2,1347,0,4,1589,0,1593,G
1-PB2,1348,0,5,1586,0,1591,G
1-PB2,1349,0,6,1611,0,1617,G
1-PB2,1350,1605,0,3,0,1608,A
1-PB2,1351,0,0,1634,0,1634,G
1-PB2,1352,0,1620,0,5,1625,T
1-PB2,1353,0,1624,0,0,1624,T
1-PB2,1354,0,10,1623,0,1633,G
1-PB2,1355,1632,0,0,0,1632,A
1-PB2,1356,1634,1,0,1,1636,A
1-PB2,1357,0,1,0,1677,1678,C
1-PB2,1358,1659,1,0,0,1660,A
1-PB2,1359,0,0,0,1702,1702,C
1-PB2,1360,1674,0,0,0,1674,A
1-PB2,1361,0,1681,1,0,1682,T
1-PB2,1362,6,1,0,1682,1689,C
1-PB2,1363,2,12,1668,0,1682,G
1-PB2,1364,1696,1,1,0,1698,A
1-PB2,1365,1,6,0,1691,1698,C
1-PB2,1366,1635,0,0,0,1635,A
1-PB2,1367,0,1,1682,0,1683,G
1-PB2,1368,1,1635,0,0,1636,T
1-PB2,1369,1,0,1663,0,1664,G
1-PB2,1370,0,1659,0,0,1659,T
1-PB2,1371,0,5,1655,0,1660,G
1-PB2,1372,1655,1,4,0,1660,A
1-PB2,1373,1,1645,0,0,1646,T
1-PB2,1374,2,9,1648,0,1659,G
1-PB2,1375,0,4,1649,0,1653,G
1-PB2,1376,0,8,1616,1,1625,G
1-PB2,1377,1607,0,1,0,1608,A
1-PB2,1378,1595,1,3,0,1599,A
1-PB2,1379,0,1601,0,1,1602,T
1-PB2,1380,0,17,1596,0,1613,G
1-PB2,1381,1609,0,1,0,1610,A
1-PB2,1382,0,1612,0,0,1612,T
1-PB2,1383,0,1605,0,1,1606,T
1-PB2,1384,1,8,1591,0,1600,G
1-PB2,1385,0,6,1630,0,1636,G
1-PB2,1386,1624,0,3,0,1627,A
1-PB2,1387,0,1,1647,0,1648,G
1-PB2,1388,0,1625,0,0,1625,T
1-PB2,1389,1613,1,1,0,1615,A
1-PB2,1390,0,1622,0,1,1623,T
1-PB2,1391,0,1634,0,1,1635,T
1-PB2,1392,1650,0,1,1,1652,A
1-PB2,1393,1,1,0,1657,1659,C
1-PB2,1394,1,0,0,1632,1633,C
1-PB2,1395,1603,0,0,0,1603,A
1-PB2,1396,0,4,1609,0,1613,G
1-PB2,1397,1650,0,1,0,1651,A
1-PB2,1398,0,1626,1,2,1629,T
1-PB2,1399,1614,0,1,0,1615,A
1-PB2,1400,0,1599,0,2,1601,T
1-PB2,1401,0,18,1566,0,1584,G
1-PB2,1402,1582,0,5,0,1587,A
1-PB2,1403,0,0,0,1591,1591,C
1-PB2,1404,0,1583,0,5,1588,T
1-PB2,1405,7,1,0,1581,1589,C
1-PB2,1406,6,0,0,1561,1567,C
1-PB2,1407,1569,0,2,1,1572,A
1-PB2,1408,1586,0,0,0,1586,A
1-PB2,1409,0,0,1612,1,1613,G
1-PB2,1410,1,0,1,1603,1605,C
1-PB2,1411,1601,0,1,0,1602,A
1-PB2,1412,0,2,0,1595,1597,C
1-PB2,1413,1578,2,2,0,1582,A
1-PB2,1414,0,1,1586,0,1587,G
1-PB2,1415,1576,0,0,0,1576,A
1-PB2,1416,1,3,1585,0,1589,G
1-PB2,1417,1589,0,2,0,1591,A
1-PB2,1418,0,1530,0,0,1530,T
1-PB2,1419,0,1,1555,0,1556,G
1-PB2,1420,0,1550,0,2,1552,T
1-PB2,1421,13,1,0,1536,1550,C
1-PB2,1422,1552,0,1,0,1553,A
1-PB2,1423,1547,0,0,0,1547,A
1-PB2,1424,0,1545,0,1,1546,T
1-PB2,1425,0,13,1528,0,1541,G
1-PB2,1426,1510,0,2,0,1512,A
1-PB2,1427,0,3,1518,0,1521,G
1-PB2,1428,1490,0,2,0,1492,A
1-PB2,1429,1,3,1501,0,1505,G
1-PB2,1430,2,4,1565,0,1571,G
1-PB2,1431,1569,0,0,0,1569,A
1-PB2,1432,1573,0,0,0,1573,A
1-PB2,1433,0,1568,0,0,1568,T
1-PB2,1434,1570,0,0,0,1570,A
1-PB2,1435,1570,0,0,0,1570,A
1-PB2,1436,0,9,1564,0,1573,G
1-PB2,1437,1556,0,3,0,1559,A
1-PB2,1438,0,0,1563,0,1563,G
1-PB2,1439,0,1474,0,0,1474,T
1-PB2,1440,15,0,0,1459,1474,C
1-PB2,1441,1475,0,2,0,1477,A
1-PB2,1442,0,0,1485,0,1485,G
1-PB2,1443,1,1,0,1483,1485,C
1-PB2,1444,1486,0,1,0,1487,A
1-PB2,1445,1486,1,0,0,1487,A
1-PB2,1446,1481,0,1,0,1482,A
1-PB2,1447,1482,0,1,0,1483,A
1-PB2,1448,0,1487,0,1,1488,T
1-PB2,1449,0,2,1493,0,1495,G
1-PB2,1450,0,4,1490,0,1494,G
1-PB2,1451,0,1,1509,0,1510,G
1-PB2,1452,0,1489,0,1,1490,T
1-PB2,1453,0,0,1497,0,1497,G
1-PB2,1454,0,1499,0,0,1499,T
1-PB2,1455,0,8,1487,0,1495,G
1-PB2,1456,0,1,1511,0,1512,G
1-PB2,1457,1510,0,0,0,1510,A
1-PB2,1458,0,1494,0,2,1496,T
1-PB2,1459,2,8,1483,0,1493,G
1-PB2,1460,1475,0,0,0,1475,A
1-PB2,1461,0,0,1452,0,1452,G
1-PB2,1462,0,1481,0,1,1482,T
1-PB2,1463,1481,0,0,0,1481,A
1-PB2,1464,0,0,0,1581,1581,C
1-PB2,1465,0,1549,0,2,1551,T
1-PB2,1466,10,0,0,1568,1578,C
1-PB2,1467,1,0,1,1572,1574,C
1-PB2,1468,1564,0,1,0,1565,A
1-PB2,1469,0,0,1614,0,1614,G
1-PB2,1470,0,1587,0,1,1588,T
1-PB2,1471,1594,1,2,0,1597,A
1-PB2,1472,0,0,0,1603,1603,C
1-PB2,1473,1454,1,0,0,1455,A
1-PB2,1474,0,6,1454,0,1460,G
1-PB2,1475,1407,0,3,0,1410,A
1-PB2,1476,0,2,1414,0,1416,G
1-PB2,1477,1358,0,2,0,1360,A
1-PB2,1478,0,7,1333,0,1340,G
1-PB2,1479,0,3,1331,0,1334,G
1-PB2,1480,0,1,1336,0,1337,G
1-PB2,1481,0,1319,0,2,1321,T
1-PB2,1482,0,4,1316,0,1320,G
1-PB2,1483,0,1,1319,0,1320,G
1-PB2,1484,0,1302,0,1,1303,T
1-PB2,1485,0,5,1331,1,1337,G
1-PB2,1486,0,0,1336,0,1336,G
1-PB2,1487,1,1299,0,1,1301,T
1-PB2,1488,0,1299,0,1,1300,T
1-PB2,1489,1277,0,1,0,1278,A
1-PB2,1490,1,0,1285,0,1286,G
1-PB2,1491,0,0,0,1284,1284,C
1-PB2,1492,1278,1,0,0,1279,A
1-PB2,1493,0,1278,0,0,1278,T
1-PB2,1494,0,1207,0,1,1208,T
1-PB2,1495,0,8,1203,0,1211,G
1-PB2,1496,1209,0,1,0,1210,A
1-PB2,1497,0,1203,0,4,1207,T
1-PB2,1498,9,1,0,1191,1201,C
1-PB2,1499,0,4,1195,0,1199,G
1-PB2,1500,1,0,1230,0,1231,G
1-PB2,1501,0,1227,0,1,1228,T
1-PB2,1502,0,1220,2,3,1225,T
1-PB2,1503,0,1227,0,0,1227,T
1-PB2,1504,0,1227,0,0,1227,T
1-PB2,1505,0,1223,1,1,1225,T
1-PB2,1506,1,12,1215,0,1228,G
1-PB2,1507,1222,0,2,0,1224,A
1-PB2,1508,0,5,1224,0,1229,G
1-PB2,1509,1177,0,1,0,1178,A
1-PB2,1510,1,0,1185,0,1186,G
1-PB2,1511,0,1181,0,3,1184,T
1-PB2,1512,0,1183,1,0,1184,T
1-PB2,1513,12,0,0,1174,1186,C
1-PB2,1514,1,7,1176,0,1184,G
1-PB2,1515,1186,0,2,0,1188,A
1-PB2,1516,0,12,1177,0,1189,G
1-PB2,1517,1182,0,2,0,1184,A
1-PB2,1518,0,1,0,1187,1188,C
1-PB2,1519,6,0,0,1172,1178,C
1-PB2,1520,1165,0,4,1,1170,A
1-PB2,1521,1181,0,2,0,1183,A
1-PB2,1522,0,0,0,1185,1185,C
1-PB2,1523,2,0,1184,0,1186,G
1-PB2,1524,0,1179,0,1,1180,T
1-PB2,1525,0,5,1172,0,1177,G
1-PB2,1526,0,2,1181,0,1183,G
1-PB2,1527,2,6,1179,0,1187,G
1-PB2,1528,1180,0,3,0,1183,A
1-PB2,1529,1183,0,0,0,1183,A
1-PB2,1530,0,1142,0,2,1144,T
1-PB2,1531,1,1,1184,0,1186,G
1-PB2,1532,0,1183,0,0,1183,T
1-PB2,1533,1188,0,1,0,1189,A
1-PB2,1534,0,1188,0,0,1188,T
1-PB2,1535,0,1168,0,0,1168,T
1-PB2,1536,1174,1,0,0,1175,A
1-PB2,1537,1,1163,0,1,1165,T
1-PB2,1538,0,1150,0,0,1150,T
1-PB2,1539,1145,0,0,0,1145,A
1-PB2,1540,0,1003,0,0,1003,T
1-PB2,1541,4,1,0,1022,1027,C
1-PB2,1542,0,1010,1,1,1012,T
1-PB2,1543,6,0,0,1010,1016,C
1-PB2,1544,3,0,0,1013,1016,C
1-PB2,1545,1,979,0,0,980,T
1-PB2,1546,0,4,982,0,986,G
1-PB2,1547,982,0,0,0,982,A
1-PB2,1548,2,0,982,0,984,G
1-PB2,1549,0,2,977,0,979,G
1-PB2,1550,885,0,1,1,887,A
1-PB2,1551,0,3,891,0,894,G
1-PB2,1552,0,0,891,0,891,G
1-PB2,1553,0,853,0,5,858,T
1-PB2,1554,7,1,0,848,856,C
1-PB2,1555,847,1,1,0,849,A
1-PB2,1556,0,0,855,0,855,G
1-PB2,1557,1,848,0,0,849,T
1-PB2,1558,2,6,841,0,849,G
1-PB2,1559,846,0,1,0,847,A
1-PB2,1560,817,1,1,0,819,A
1-PB2,1561,818,0,2,0,820,A
1-PB2,1562,0,1,0,817,818,C
1-PB2,1563,810,0,2,0,812,A
1-PB2,1564,0,0,0,812,812,C
1-PB2,1565,760,0,2,0,762,A
1-PB2,1566,0,5,761,0,766,G
1-PB2,1567,1,2,764,0,767,G
1-PB2,1568,0,2,767,0,769,G
1-PB2,1569,764,0,2,0,766,A
1-PB2,1570,755,0,2,0,757,A
1-PB2,1571,0,0,0,764,764,C
1-PB2,1572,0,742,0,0,742,T
1-PB2,1573,1,5,738,0,744,G
1-PB2,1574,740,0,1,0,741,A
1-PB2,1575,0,2,740,0,742,G
1-PB2,1576,730,0,0,0,730,A
1-PB2,1577,0,3,681,0,684,G
1-PB2,1578,684,0,1,0,685,A
1-PB2,1579,1,0,0,681,682,C
1-PB2,1580,0,648,0,0,648,T
1-PB2,1581,0,7,651,0,658,G
1-PB2,1582,655,0,2,0,657,A
1-PB2,1583,0,0,0,661,661,C
1-PB2,1584,654,0,0,0,654,A
1-PB2,1585,656,0,0,0,656,A
1-PB2,1586,0,653,0,0,653,T
1-PB2,1587,652,0,0,1,653,A
1-PB2,1588,650,0,0,0,650,A
1-PB2,1589,0,0,0,658,658,C
1-PB2,1590,0,609,0,0,609,T
1-PB2,1591,0,599,0,0,599,T
1-PB2,1592,588,1,1,0,590,A
1-PB2,1593,1,588,0,2,591,T
1-PB2,1594,0,590,0,0,590,T
1-PB2,1595,6,0,0,584,590,C
1-PB2,1596,547,0,0,0,547,A
1-PB2,1597,0,544,1,0,545,T
1-PB2,1598,1,0,0,507,508,C
1-PB2,1599,0,0,506,0,506,G
1-PB2,1600,1,506,0,1,508,T
1-PB2,1601,3,0,2,499,504,C
1-PB2,1602,2,1,501,0,504,G
1-PB2,1603,504,0,1,0,505,A
1-PB2,1604,0,505,0,0,505,T
1-PB2,1605,0,1,501,0,502,G
1-PB2,1606,502,0,1,0,503,A
1-PB2,1607,0,503,0,0,503,T
1-PB2,1608,1,0,497,0,498,G
1-PB2,1609,0,477,1,0,478,T
1-PB2,1610,1,1,476,0,478,G
1-PB2,1611,0,0,479,0,479,G
1-PB2,1612,0,1,476,0,477,G
1-PB2,1613,461,0,1,0,462,A
1-PB2,1614,0,1,455,0,456,G
1-PB2,1615,415,1,0,0,416,A
1-PB2,1616,0,412,0,0,412,T
1-PB2,1617,0,399,0,0,399,T
1-PB2,1618,397,0,1,0,398,A
1-PB2,1619,393,0,1,0,394,A
1-PB2,1620,0,0,0,387,387,C
1-PB2,1621,0,2,358,0,360,G
1-PB2,1622,0,0,349,0,349,G
1-PB2,1623,0,293,0,0,293,T
1-PB2,1624,4,0,0,282,286,C
1-PB2,1625,0,0,0,287,287,C
1-PB2,1626,0,270,0,0,270,T
1-PB2,1627,0,0,286,0,286,G
1-PB2,1628,285,0,1,0,286,A
1-PB2,1629,0,0,294,0,294,G
1-PB2,1630,0,295,0,0,295,T
1-PB2,1631,3,0,0,288,291,C
1-PB2,1632,0,3,289,0,292,G
1-PB2,1633,0,0,295,0,295,G
1-PB2,1634,0,295,0,0,295,T
1-PB2,1635,0,294,0,0,294,T
1-PB2,1636,0,292,0,0,292,T
1-PB2,1637,0,292,0,0,292,T
1-PB2,1638,0,1,299,0,300,G
1-PB2,1639,0,0,301,0,301,G
1-PB2,1640,0,301,0,0,301,T
1-PB2,1641,4,0,0,296,300,C
1-PB2,1642,298,0,0,0,298,A
1-PB2,1643,304,0,0,0,304,A
1-PB2,1644,0,305,0,0,305,T
1-PB2,1645,307,0,0,0,307,A
1-PB2,1646,0,1,0,312,313,C
1-PB2,1647,0,0,0,302,302,C
1-PB2,1648,0,301,0,0,301,T
1-PB2,1649,309,0,0,0,309,A
1-PB2,1650,0,308,0,0,308,T
1-PB2,1651,1,0,0,310,311,C
1-PB2,1652,299,0,0,0,299,A
1-PB2,1653,299,0,0,0,299,A
1-PB2,1654,0,299,0,0,299,T
1-PB2,1655,0,0,292,0,292,G
1-PB2,1656,0,5,288,0,293,G
1-PB2,1657,290,0,0,0,290,A
1-PB2,1658,0,285,0,0,285,T
1-PB2,1659,0,0,0,286,286,C
1-PB2,1660,289,0,1,0,290,A
1-PB2,1661,0,290,0,0,290,T
1-PB2,1662,0,0,0,289,289,C
1-PB2,1663,289,1,0,0,290,A
1-PB2,1664,0,2,289,0,291,G
1-PB2,1665,291,0,0,0,291,A
1-PB2,1666,291,0,0,0,291,A
1-PB2,1667,290,0,1,0,291,A
1-PB2,1668,0,293,0,0,293,T
1-PB2,1669,0,290,0,0,290,T
1-PB2,1670,0,0,290,0,290,G
1-PB2,1671,0,0,290,0,290,G
1-PB2,1672,0,1,289,0,290,G
1-PB2,1673,289,0,0,0,289,A
1-PB2,1674,289,0,0,0,289,A
1-PB2,1675,0,0,289,0,289,G
1-PB2,1676,0,0,0,289,289,C
1-PB2,1677,0,284,0,1,285,T
1-PB2,1678,0,0,289,0,289,G
1-PB2,1679,0,289,0,0,289,T
1-PB2,1680,1,0,0,286,287,C
1-PB2,1681,290,0,0,0,290,A
1-PB2,1682,290,0,0,0,290,A
1-PB2,1683,289,0,0,0,289,A
1-PB2,1684,289,0,0,0,289,A
1-PB2,1685,0,289,0,0,289,T
1-PB2,1686,0,287,0,0,287,T
1-PB2,1687,2,0,0,282,284,C
1-PB2,1688,279,0,0,0,279,A
1-PB2,1689,280,0,0,0,280,A
1-PB2,1690,0,280,0,0,280,T
1-PB2,1691,0,3,278,0,281,G
1-PB2,1692,0,1,283,0,284,G
1-PB2,1693,0,291,0,0,291,T
1-PB2,1694,1,0,0,295,296,C
1-PB2,1695,1,295,1,0,297,T
1-PB2,1696,1,0,0,297,298,C
1-PB2,1697,298,0,0,0,298,A
1-PB2,1698,0,1,300,0,301,G
1-PB2,1699,301,0,0,0,301,A
1-PB2,1700,300,0,0,0,300,A
1-PB2,1701,0,294,0,0,294,T
1-PB2,1702,3,0,0,287,290,C
1-PB2,1703,2,0,0,294,296,C
1-PB2,1704,0,294,0,1,295,T
1-PB2,1705,0,0,297,1,298,G
1-PB2,1706,0,0,0,297,297,C
1-PB2,1707,296,0,0,0,296,A
1-PB2,1708,301,0,0,0,301,A
1-PB2,1709,0,296,0,1,297,T
1-PB2,1710,3,0,299,0,302,G
1-PB2,1711,0,301,0,0,301,T
1-PB2,1712,0,297,0,0,297,T
1-PB2,1713,0,0,301,0,301,G
1-PB2,1714,0,302,0,0,302,T
1-PB2,1715,301,0,1,0,302,A
1-PB2,1716,0,0,0,303,303,C
1-PB2,1717,299,0,0,0,299,A
1-PB2,1718,303,0,1,0,304,A
1-PB2,1719,0,0,0,301,301,C
1-PB2,1720,297,0,0,0,297,A
1-PB2,1721,297,0,0,0,297,A
1-PB2,1722,292,0,0,0,292,A
1-PB2,1723,292,0,0,0,292,A
1-PB2,1724,0,293,1,0,294,T
1-PB2,1725,0,3,287,0,290,G
1-PB2,1726,0,3,290,0,293,G
1-PB2,1727,288,0,0,0,288,A
1-PB2,1728,292,0,0,0,292,A
1-PB2,1729,0,291,0,0,291,T
1-PB2,1730,0,291,0,0,291,T
1-PB2,1731,0,291,0,0,291,T
1-PB2,1732,0,2,289,0,291,G
1-PB2,1733,292,0,0,0,292,A
1-PB2,1734,291,0,0,0,291,A
1-PB2,1735,0,0,0,290,290,C
1-PB2,1736,0,0,0,289,289,C
1-PB2,1737,291,0,0,0,291,A
1-PB2,1738,0,294,0,0,294,T
1-PB2,1739,0,293,0,1,294,T
1-PB2,1740,0,292,0,2,294,T
1-PB2,1741,0,0,0,294,294,C
1-PB2,1742,292,0,0,0,292,A
1-PB2,1743,292,0,0,0,292,A
1-PB2,1744,0,290,0,0,290,T
1-PB2,1745,0,0,0,299,299,C
1-PB2,1746,0,292,0,2,294,T
1-PB2,1747,0,294,0,2,296,T
1-PB2,1748,0,297,0,0,297,T
1-PB2,1749,297,0,0,0,297,A
1-PB2,1750,0,1,299,0,300,G
1-PB2,1751,0,297,0,1,298,T
1-PB2,1752,1,0,0,300,301,C
1-PB2,1753,1,0,0,300,301,C
1-PB2,1754,0,0,0,302,302,C
1-PB2,1755,1,0,0,305,306,C
1-PB2,1756,306,0,0,0,306,A
1-PB2,1757,305,0,0,0,305,A
1-PB2,1758,0,2,310,0,312,G
1-PB2,1759,1,0,311,0,312,G
1-PB2,1760,1,0,0,310,311,C
1-PB2,1761,3,0,0,304,307,C
1-PB2,1762,307,0,0,0,307,A
1-PB2,1763,0,308,0,0,308,T
1-PB2,1764,0,307,0,1,308,T
1-PB2,1765,307,0,0,0,307,A
1-PB2,1766,0,1,303,0,304,G
1-PB2,1767,306,1,0,0,307,A
1-PB2,1768,315,0,0,0,315,A
1-PB2,1769,0,0,315,0,315,G
1-PB2,1770,0,0,0,314,314,C
1-PB2,1771,0,0,0,314,314,C
1-PB2,1772,308,0,0,0,308,A
1-PB2,1773,313,0,0,0,313,A
1-PB2,1774,0,313,0,0,313,T
1-PB2,1775,314,0,1,0,315,A
1-PB2,1776,0,1,0,314,315,C
1-PB2,1777,291,0,0,0,291,A
1-PB2,1778,0,0,291,0,291,G
1-PB2,1779,0,280,0,0,280,T
1-PB2,1780,0,1,284,0,285,G
1-PB2,1781,0,0,285,0,285,G
1-PB2,1782,0,0,284,0,284,G
1-PB2,1783,0,281,0,0,281,T
1-PB2,1784,0,276,0,0,276,T
1-PB2,1785,0,276,0,0,276,T
1-PB2,1786,0,0,279,0,279,G
1-PB2,1787,0,280,0,0,280,T
1-PB2,1788,3,0,0,276,279,C
1-PB2,1789,275,0,0,0,275,A
1-PB2,1790,0,0,276,0,276,G
1-PB2,1791,274,1,0,0,275,A
1-PB2,1792,275,0,1,0,276,A
1-PB2,1793,0,0,0,276,276,C
1-PB2,1794,0,266,0,1,267,T
1-PB2,1795,2,0,0,274,276,C
1-PB2,1796,0,275,0,0,275,T
1-PB2,1797,277,0,0,0,277,A
1-PB2,1798,1,276,0,0,277,T
1-PB2,1799,0,276,0,0,276,T
1-PB2,1800,2,0,0,273,275,C
1-PB2,1801,2,0,0,272,274,C
1-PB2,1802,271,0,1,0,272,A
1-PB2,1803,273,0,0,0,273,A
1-PB2,1804,0,0,0,270,270,C
1-PB2,1805,267,0,0,0,267,A
1-PB2,1806,269,0,0,0,269,A
1-PB2,1807,270,0,0,0,270,A
1-PB2,1808,0,270,0,0,270,T
1-PB2,1809,0,1,268,1,270,G
1-PB2,1810,269,0,0,0,269,A
1-PB2,1811,0,0,272,0,272,G
1-PB2,1812,270,0,0,0,270,A
1-PB2,1813,0,2,269,0,271,G
1-PB2,1814,273,0,0,0,273,A
1-PB2,1815,0,0,0,272,272,C
1-PB2,1816,0,0,277,0,277,G
1-PB2,1817,0,278,0,1,279,T
1-PB2,1818,280,0,2,0,282,A
1-PB2,1819,0,0,0,286,286,C
1-PB2,1820,0,281,0,0,281,T
1-PB2,1821,0,282,0,0,282,T
1-PB2,1822,0,1,280,0,281,G
1-PB2,1823,0,1,279,0,280,G
1-PB2,1824,0,0,283,0,283,G
1-PB2,1825,277,0,2,0,279,A
1-PB2,1826,0,0,0,279,279,C
1-PB2,1827,269,0,1,0,270,A
1-PB2,1828,0,270,0,0,270,T
1-PB2,1829,0,270,0,0,270,T
1-PB2,1830,0,270,0,0,270,T
1-PB2,1831,1,2,265,0,268,G
1-PB2,1832,266,0,1,0,267,A
1-PB2,1833,0,2,0,266,268,C
1-PB2,1834,266,0,1,0,267,A
1-PB2,1835,0,0,0,272,272,C
1-PB2,1836,0,0,0,264,264,C
1-PB2,1837,268,0,0,0,268,A
1-PB2,1838,0,0,0,272,272,C
1-PB2,1839,0,1,0,271,272,C
1-PB2,1840,0,0,0,271,271,C
1-PB2,1841,270,0,0,0,270,A
1-PB2,1842,0,2,270,0,272,G
1-PB2,1843,274,0,0,0,274,A
1-PB2,1844,0,282,0,0,282,T
1-PB2,1845,278,0,0,0,278,A
1-PB2,1846,277,0,0,0,277,A
1-PB2,1847,0,278,0,0,278,T
1-PB2,1848,277,0,0,0,277,A
1-PB2,1849,277,0,0,0,277,A
1-PB2,1850,275,0,1,0,276,A
1-PB2,1851,12,0,263,0,275,G
1-PB2,1852,0,0,0,273,273,C
1-PB2,1853,0,264,0,0,264,T
1-PB2,1854,0,264,0,0,264,T
1-PB2,1855,1,0,0,263,264,C
1-PB2,1856,0,261,0,0,261,T
1-PB2,1857,2,0,0,264,266,C
1-PB2,1858,0,1,0,264,265,C
1-PB2,1859,2,0,0,262,264,C
1-PB2,1860,0,267,0,0,267,T
1-PB2,1861,0,265,0,1,266,T
1-PB2,1862,0,265,0,0,265,T
1-PB2,1863,0,266,0,0,266,T
1-PB2,1864,0,0,265,0,265,G
1-PB2,1865,0,0,0,266,266,C
1-PB2,1866,264,0,0,0,264,A
1-PB2,1867,1,0,263,0,264,G
1-PB2,1868,0,0,0,264,264,C
1-PB2,1869,0,261,0,1,262,T
1-PB2,1870,0,0,263,0,263,G
1-PB2,1871,0,0,0,262,262,C
1-PB2,1872,0,262,0,0,262,T
1-PB2,1873,2,0,0,262,264,C
1-PB2,1874,2,1,0,263,266,C
1-PB2,1875,266,0,0,0,266,A
1-PB2,1876,0,0,0,268,268,C
1-PB2,1877,1,0,0,266,267,C
1-PB2,1878,264,0,1,0,265,A
1-PB2,1879,263,0,0,0,263,A
1-PB2,1880,262,0,0,0,262,A
1-PB2,1881,0,0,266,0,266,G
1-PB2,1882,0,0,0,266,266,C
1-PB2,1883,258,0,0,0,258,A
1-PB2,1884,258,0,0,0,258,A
1-PB2,1885,258,0,0,0,258,A
1-PB2,1886,0,0,261,0,261,G
1-PB2,1887,0,0,0,261,261,C
1-PB2,1888,261,0,0,0,261,A
1-PB2,1889,0,0,263,0,263,G
1-PB2,1890,263,0,0,0,263,A
1-PB2,1891,267,0,1,0,268,A
1-PB2,1892,0,267,0,0,267,T
1-PB2,1893,1,0,264,0,265,G
1-PB2,1894,0,1,0,265,266,C
1-PB2,1895,255,0,1,0,256,A
1-PB2,1896,0,0,260,0,260,G
1-PB2,1897,0,259,0,0,259,T
1-PB2,1898,0,266,0,0,266,T
1-PB2,1899,0,0,0,265,265,C
1-PB2,1900,0,265,0,0,265,T
1-PB2,1901,0,0,0,268,268,C
1-PB2,1902,0,267,0,0,267,T
1-PB2,1903,0,264,0,3,267,T
1-PB2,1904,1,0,0,267,268,C
1-PB2,1905,259,0,1,0,260,A
1-PB2,1906,0,1,0,260,261,C
1-PB2,1907,0,257,0,0,257,T
1-PB2,1908,0,4,251,0,255,G
1-PB2,1909,256,0,0,0,256,A
1-PB2,1910,0,0,0,257,257,C
1-PB2,1911,0,249,0,1,250,T
1-PB2,1912,0,0,252,0,252,G
1-PB2,1913,0,251,0,0,251,T
1-PB2,1914,0,0,253,0,253,G
1-PB2,1915,252,0,0,0,252,A
1-PB2,1916,255,0,1,0,256,A
1-PB2,1917,0,248,0,0,248,T
1-PB2,1918,1,0,247,0,248,G
1-PB2,1919,0,239,1,0,240,T
1-PB2,1920,232,0,0,0,232,A
1-PB2,1921,234,0,1,0,235,A
1-PB2,1922,0,1,236,0,237,G
1-PB2,1923,0,2,236,0,238,G
1-PB2,1924,0,2,237,0,239,G
1-PB2,1925,0,2,234,0,236,G
1-PB2,1926,237,0,0,0,237,A
1-PB2,1927,0,237,0,1,238,T
1-PB2,1928,3,0,0,234,237,C
1-PB2,1929,236,0,0,0,236,A
1-PB2,1930,0,1,240,0,241,G
1-PB2,1931,0,0,240,0,240,G
1-PB2,1932,1,1,238,0,240,G
1-PB2,1933,238,0,1,0,239,A
1-PB2,1934,0,227,0,0,227,T
1-PB2,1935,0,1,227,0,228,G
1-PB2,1936,222,0,0,0,222,A
1-PB2,1937,0,3,226,0,229,G
1-PB2,1938,229,0,0,0,229,A
1-PB2,1939,228,0,0,0,228,A
1-PB2,1940,0,230,0,0,230,T
1-PB2,1941,230,0,0,0,230,A
1-PB2,1942,0,1,0,235,236,C
1-PB2,1943,0,231,0,0,231,T
1-PB2,1944,0,231,0,0,231,T
1-PB2,1945,0,0,232,0,232,G
1-PB2,1946,0,226,0,0,226,T
1-PB2,1947,225,0,1,0,226,A
1-PB2,1948,220,0,1,2,223,A
1-PB2,1949,0,1,217,0,218,G
1-PB2,1950,0,0,221,0,221,G
1-PB2,1951,0,0,219,0,219,G
1-PB2,1952,1,0,218,0,219,G
1-PB2,1953,0,0,0,218,218,C
1-PB2,1954,219,0,0,0,219,A
1-PB2,1955,225,0,1,0,226,A
1-PB2,1956,0,225,0,0,225,T
1-PB2,1957,0,226,0,0,226,T
1-PB2,1958,2,0,0,228,230,C
1-PB2,1959,0,226,0,0,226,T
1-PB2,1960,0,0,0,231,231,C
1-PB2,1961,1,0,0,229,230,C
1-PB2,1962,0,228,0,0,228,T
1-PB2,1963,0,0,239,0,239,G
1-PB2,1964,0,238,0,0,238,T
1-PB2,1965,240,0,0,0,240,A
1-PB2,1966,0,240,0,0,240,T
1-PB2,1967,0,235,0,0,235,T
1-PB2,1968,1,0,0,237,238,C
1-PB2,1969,231,0,0,0,231,A
1-PB2,1970,234,0,0,0,234,A
1-PB2,1971,0,0,0,234,234,C
1-PB2,1972,0,229,0,0,229,T
1-PB2,1973,229,0,0,0,229,A
1-PB2,1974,0,0,0,234,234,C
1-PB2,1975,233,0,0,0,233,A
1-PB2,1976,233,0,0,0,233,A
1-PB2,1977,0,0,0,230,230,C
1-PB2,1978,227,0,0,0,227,A
1-PB2,1979,227,0,0,0,227,A
1-PB2,1980,0,2,225,0,227,G
1-PB2,1981,224,0,3,0,227,A
1-PB2,1982,1,0,0,226,227,C
1-PB2,1983,0,0,0,222,222,C
1-PB2,1984,223,0,0,0,223,A
1-PB2,1985,0,0,0,240,240,C
1-PB2,1986,0,240,0,0,240,T
1-PB2,1987,241,0,0,0,241,A
1-PB2,1988,240,0,0,0,240,A
1-PB2,1989,242,0,0,0,242,A
1-PB2,1990,241,0,1,0,242,A
1-PB2,1991,0,2,243,0,245,G
1-PB2,1992,245,0,0,0,245,A
1-PB2,1993,0,0,0,246,246,C
1-PB2,1994,0,237,0,0,237,T
1-PB2,1995,237,0,0,0,237,A
1-PB2,1996,237,0,0,0,237,A
1-PB2,1997,0,0,0,237,237,C
1-PB2,1998,236,0,0,0,236,A
1-PB2,1999,236,0,0,0,236,A
1-PB2,2000,0,233,0,0,233,T
1-PB2,2001,0,232,0,0,232,T
1-PB2,2002,0,0,0,229,229,C
1-PB2,2003,0,228,0,0,228,T
1-PB2,2004,0,0,0,229,229,C
1-PB2,2005,0,0,230,0,230,G
1-PB2,2006,1,0,232,0,233,G
1-PB2,2007,233,0,0,0,233,A
1-PB2,2008,233,0,0,0,233,A
1-PB2,2009,232,0,0,0,232,A
1-PB2,2010,233,0,0,0,233,A
1-PB2,2011,0,0,231,0,231,G
1-PB2,2012,231,0,0,0,231,A
1-PB2,2013,0,231,0,0,231,T
1-PB2,2014,0,0,230,0,230,G
1-PB2,2015,0,0,0,229,229,C
1-PB2,2016,0,0,0,228,228,C
1-PB2,2017,0,2,223,0,225,G
1-PB2,2018,0,0,226,0,226,G
1-PB2,2019,0,0,0,229,229,C
1-PB2,2020,227,0,0,0,227,A
1-PB2,2021,0,0,0,233,233,C
1-PB2,2022,0,231,0,0,231,T
1-PB2,2023,0,229,0,2,231,T
1-PB2,2024,0,231,0,0,231,T
1-PB2,2025,228,0,1,0,229,A
1-PB2,2026,231,0,0,0,231,A
1-PB2,2027,0,230,0,0,230,T
1-PB2,2028,0,231,0,0,231,T
1-PB2,2029,0,4,226,0,230,G
1-PB2,2030,221,0,0,0,221,A
1-PB2,2031,222,0,0,0,222,A
1-PB2,2032,0,2,221,0,223,G
1-PB2,2033,225,0,0,0,225,A
1-PB2,2034,0,1,0,225,226,C
1-PB2,2035,1,0,0,223,224,C
1-PB2,2036,0,1,0,223,224,C
1-PB2,2037,225,0,0,0,225,A
1-PB2,2038,1,0,229,0,230,G
1-PB2,2039,231,0,0,0,231,A
1-PB2,2040,0,229,0,0,229,T
1-PB2,2041,0,1,230,0,231,G
1-PB2,2042,229,0,0,0,229,A
1-PB2,2043,229,0,0,0,229,A
1-PB2,2044,230,0,0,0,230,A
1-PB2,2045,0,0,229,0,229,G
1-PB2,2046,0,0,0,228,228,C
1-PB2,2047,224,0,0,0,224,A
1-PB2,2048,0,1,0,226,227,C
1-PB2,2049,228,0,0,0,228,A
1-PB2,2050,0,228,0,0,228,T
1-PB2,2051,0,0,0,229,229,C
1-PB2,2052,0,0,0,229,229,C
1-PB2,2053,0,1,227,0,228,G
1-PB2,2054,1,0,229,0,230,G
1-PB2,2055,229,0,0,0,229,A
1-PB2,2056,0,0,230,0,230,G
1-PB2,2057,0,226,0,1,227,T
1-PB2,2058,0,0,226,0,226,G
1-PB2,2059,0,0,224,0,224,G
1-PB2,2060,225,0,0,0,225,A
1-PB2,2061,0,0,225,0,225,G
1-PB2,2062,0,220,0,0,220,T
1-PB2,2063,2,0,0,219,221,C
1-PB2,2064,0,0,1,221,222,C
1-PB2,2065,0,0,220,0,220,G
1-PB2,2066,0,0,0,219,219,C
1-PB2,2067,0,0,0,219,219,C
1-PB2,2068,0,0,224,0,224,G
1-PB2,2069,0,223,0,1,224,T
1-PB2,2070,2,0,0,225,227,C
1-PB2,2071,0,226,0,0,226,T
1-PB2,2072,0,228,0,0,228,T
1-PB2,2073,0,0,228,0,228,G
1-PB2,2074,226,0,0,0,226,A
1-PB2,2075,0,1,227,0,228,G
1-PB2,2076,225,0,0,1,226,A
1-PB2,2077,0,0,218,0,218,G
1-PB2,2078,0,1,216,0,217,G
1-PB2,2079,1,0,216,0,217,G
1-PB2,2080,1,215,0,1,217,T
1-PB2,2081,0,217,0,0,217,T
1-PB2,2082,0,219,1,0,220,T
1-PB2,2083,1,0,0,219,220,C
1-PB2,2084,0,219,0,0,219,T
1-PB2,2085,0,0,0,226,226,C
1-PB2,2086,224,0,0,0,224,A
1-PB2,2087,0,224,0,0,224,T
1-PB2,2088,0,224,0,0,224,T
1-PB2,2089,224,0,1,0,225,A
1-PB2,2090,0,225,0,0,225,T
1-PB2,2091,223,0,0,0,223,A
1-PB2,2092,0,0,227,0,227,G
1-PB2,2093,0,0,230,0,230,G
1-PB2,2094,0,219,0,0,219,T
1-PB2,2095,219,0,0,0,219,A
1-PB2,2096,216,0,0,0,216,A
1-PB2,2097,0,1,216,0,217,G
1-PB2,2098,0,2,215,0,217,G
1-PB2,2099,215,1,0,0,216,A
1-PB2,2100,211,0,1,0,212,A
1-PB2,2101,0,4,208,0,212,G
1-PB2,2102,206,0,1,0,207,A
1-PB2,2103,0,0,0,208,208,C
1-PB2,2104,207,0,0,0,207,A
1-PB2,2105,0,0,208,0,208,G
1-PB2,2106,203,0,0,0,203,A
1-PB2,2107,199,0,0,0,199,A
1-PB2,2108,0,0,199,0,199,G
1-PB2,2109,0,0,190,0,190,G
1-PB2,2110,0,196,0,0,196,T
1-PB2,2111,196,0,0,0,196,A
1-PB2,2112,0,0,0,195,195,C
1-PB2,2113,0,0,194,0,194,G
1-PB2,2114,0,2,200,0,202,G
1-PB2,2115,201,0,0,0,201,A
1-PB2,2116,0,0,0,199,199,C
1-PB2,2117,0,0,0,199,199,C
1-PB2,2118,192,0,0,0,192,A
1-PB2,2119,0,0,199,0,199,G
1-PB2,2120,1,0,0,200,201,C
1-PB2,2121,201,0,0,0,201,A
1-PB2,2122,0,201,0,0,201,T
1-PB2,2123,0,196,0,0,196,T
1-PB2,2124,195,0,0,0,195,A
1-PB2,2125,195,0,0,0,195,A
1-PB2,2126,0,0,197,0,197,G
1-PB2,2127,0,0,0,196,196,C
1-PB2,2128,185,0,2,0,187,A
1-PB2,2129,0,197,0,0,197,T
1-PB2,2130,3,0,0,193,196,C
1-PB2,2131,199,0,0,0,199,A
1-PB2,2132,198,1,0,0,199,A
1-PB2,2133,0,198,0,0,198,T
1-PB2,2134,0,1,197,0,198,G
1-PB2,2135,196,0,0,0,196,A
1-PB2,2136,195,0,1,0,196,A
1-PB2,2137,0,0,0,199,199,C
1-PB2,2138,0,184,0,0,184,T
1-PB2,2139,0,1,191,0,192,G
1-PB2,2140,190,0,1,0,191,A
1-PB2,2141,0,0,191,0,191,G
1-PB2,2142,0,191,0,0,191,T
1-PB2,2143,188,0,0,0,188,A
1-PB2,2144,189,0,0,0,189,A
1-PB2,2145,1,0,0,188,189,C
1-PB2,2146,1,0,0,183,184,C
1-PB2,2147,1,183,0,0,184,T
1-PB2,2148,0,174,0,1,175,T
1-PB2,2149,0,0,175,0,175,G
1-PB2,2150,0,0,0,174,174,C
1-PB2,2151,173,0,1,0,174,A
1-PB2,2152,175,0,0,0,175,A
1-PB2,2153,173,0,0,0,173,A
1-PB2,2154,170,0,0,0,170,A
1-PB2,2155,0,0,171,0,171,G
1-PB2,2156,0,0,171,0,171,G
1-PB2,2157,0,0,172,0,172,G
1-PB2,2158,0,1,172,0,173,G
1-PB2,2159,173,0,0,0,173,A
1-PB2,2160,170,0,1,0,171,A
1-PB2,2161,173,0,0,0,173,A
1-PB2,2162,175,0,0,0,175,A
1-PB2,2163,0,0,179,0,179,G
1-PB2,2164,0,0,177,0,177,G
1-PB2,2165,0,0,0,175,175,C
1-PB2,2166,0,172,0,0,172,T
1-PB2,2167,172,0,0,0,172,A
1-PB2,2168,173,0,0,0,173,A
1-PB2,2169,0,173,0,0,173,T
1-PB2,2170,0,0,174,0,174,G
1-PB2,2171,0,170,0,0,170,T
1-PB2,2172,0,0,169,0,169,G
1-PB2,2173,0,0,0,168,168,C
1-PB2,2174,0,169,0,0,169,T
1-PB2,2175,168,0,0,0,168,A
1-PB2,2176,168,0,0,0,168,A
1-PB2,2177,0,168,0,0,168,T
1-PB2,2178,0,0,0,164,164,C
1-PB2,2179,1,0,158,0,159,G
1-PB2,2180,0,1,158,0,159,G
1-PB2,2181,0,0,160,0,160,G
1-PB2,2182,0,0,0,161,161,C
1-PB2,2183,159,0,0,0,159,A
1-PB2,2184,157,0,0,0,157,A
1-PB2,2185,0,0,157,0,157,G
1-PB2,2186,0,0,157,0,157,G
1-PB2,2187,157,0,0,0,157,A
1-PB2,2188,0,1,156,0,157,G
1-PB2,2189,151,0,0,0,151,A
1-PB2,2190,0,0,0,151,151,C
1-PB2,2191,0,0,150,0,150,G
1-PB2,2192,0,149,0,0,149,T
1-PB2,2193,0,0,150,0,150,G
1-PB2,2194,0,0,155,0,155,G
1-PB2,2195,0,151,0,0,151,T
1-PB2,2196,0,0,151,0,151,G
1-PB2,2197,0,150,0,0,150,T
1-PB2,2198,0,148,0,0,148,T
1-PB2,2199,0,1,149,0,150,G
1-PB2,2200,0,0,150,0,150,G
1-PB2,2201,0,151,0,0,151,T
1-PB2,2202,149,0,0,0,149,A
1-PB2,2203,144,0,0,0,144,A
1-PB2,2204,0,140,0,1,141,T
1-PB2,2205,0,3,136,0,139,G
1-PB2,2206,139,0,0,0,139,A
1-PB2,2207,139,0,0,0,139,A
1-PB2,2208,139,0,0,0,139,A
1-PB2,2209,0,0,0,137,137,C
1-PB2,2210,0,3,134,0,137,G
1-PB2,2211,137,0,0,0,137,A
1-PB2,2212,136,0,0,0,136,A
1-PB2,2213,136,0,0,0,136,A
1-PB2,2214,137,0,0,0,137,A
1-PB2,2215,1,0,0,136,137,C
1-PB2,2216,0,0,137,0,137,G
1-PB2,2217,0,2,135,0,137,G
1-PB2,2218,1,0,136,0,137,G
1-PB2,2219,137,0,0,0,137,A
1-PB2,2220,0,0,0,137,137,C
1-PB2,2221,0,135,0,0,135,T
1-PB2,2222,1,0,0,136,137,C
1-PB2,2223,0,136,0,0,136,T
1-PB2,2224,136,0,0,0,136,A
1-PB2,2225,0,0,136,0,136,G
1-PB2,2226,0,0,0,134,134,C
1-PB2,2227,134,0,0,0,134,A
1-PB2,2228,0,131,0,0,131,T
1-PB2,2229,127,0,0,0,127,A
1-PB2,2230,0,0,2,127,129,C
1-PB2,2231,0,109,0,0,109,T
1-PB2,2232,0,109,0,0,109,T
1-PB2,2233,105,0,0,0,105,A
1-PB2,2234,0,0,0,104,104,C
1-PB2,2235,0,100,0,0,100,T
1-PB2,2236,0,0,100,0,100,G
1-PB2,2237,95,0,0,0,95,A
1-PB2,2238,0,0,0,95,95,C
1-PB2,2239,87,0,0,0,87,A
1-PB2,2240,1,0,86,0,87,G
1-PB2,2241,0,0,0,87,87,C
1-PB2,2242,0,0,0,87,87,C
1-PB2,2243,86,0,0,0,86,A
1-PB2,2244,0,0,86,0,86,G
1-PB2,2245,86,0,0,0,86,A
1-PB2,2246,0,0,0,86,86,C
1-PB2,2247,80,0,0,0,80,A
1-PB2,2248,0,0,81,0,81,G
1-PB2,2249,0,0,0,74,74,C
1-PB2,2250,0,0,74,0,74,G
1-PB2,2251,74,0,0,0,74,A
1-PB2,2252,0,0,0,74,74,C
1-PB2,2253,0,0,0,74,74,C
1-PB2,2254,74,0,0,0,74,A
1-PB2,2255,73,0,0,0,73,A
1-PB2,2256,75,0,0,0,75,A
1-PB2,2257,73,0,0,0,73,A
1-PB2,2258,0,0,73,0,73,G
1-PB2,2259,69,0,0,0,69,A
1-PB2,2260,67,0,0,0,67,A
1-PB2,2261,0,68,0,0,68,T
1-PB2,2262,0,68,0,0,68,T
1-PB2,2263,0,0,0,68,68,C
1-PB2,2264,0,0,64,0,64,G
1-PB2,2265,0,0,64,0,64,G
1-PB2,2266,64,0,0,0,64,A
1-PB2,2267,0,55,0,0,55,T
1-PB2,2268,0,0,54,0,54,G
1-PB2,2269,0,0,52,0,52,G
1-PB2,2270,0,0,0,52,52,C
1-PB2,2271,0,0,0,52,52,C
1-PB2,2272,51,0,0,0,51,A
1-PB2,2273,0,52,0,0,52,T
1-PB2,2274,1,0,0,51,52,C
1-PB2,2275,51,0,0,0,51,A
1-PB2,2276,51,0,0,0,51,A
1-PB2,2277,0,51,0,0,51,T
1-PB2,2278,0,47,0,0,47,T
1-PB2,2279,45,0,0,0,45,A
1-PB2,2280,43,0,0,0,43,A
2-PB1,1,264,0,0,0,264,A
2-PB1,2,0,264,0,0,264,T
2-PB1,3,0,0,270,0,270,G
2-PB1,4,0,3,287,0,290,G
2-PB1,5,317,0,2,0,319,A
2-PB1,6,0,335,0,0,335,T
2-PB1,7,1,0,342,0,343,G
2-PB1,8,0,342,0,2,344,T
2-PB1,9,2,0,0,367,369,C
2-PB1,10,370,1,0,0,371,A
2-PB1,11,382,0,0,0,382,A
2-PB1,12,0,383,0,2,385,T
2-PB1,13,2,1,0,386,389,C
2-PB1,14,3,3,0,413,419,C
2-PB1,15,0,11,419,1,431,G
2-PB1,16,484,0,0,0,484,A
2-PB1,17,0,0,0,490,490,C
2-PB1,18,0,485,0,3,488,T
2-PB1,19,0,0,0,570,570,C
2-PB1,20,1,567,0,2,570,T
2-PB1,21,583,0,0,0,583,A
2-PB1,22,0,0,0,585,585,C
2-PB1,23,0,584,0,2,586,T
2-PB1,24,0,0,658,0,658,G
2-PB1,25,0,665,0,2,667,T
2-PB1,26,0,667,1,0,668,T
2-PB1,27,4,1,0,662,667,C
2-PB1,28,2,0,0,663,665,C
2-PB1,29,0,800,0,0,800,T
2-PB1,30,808,0,0,0,808,A
2-PB1,31,809,0,1,0,810,A
2-PB1,32,818,0,1,0,819,A
2-PB1,33,0,1,826,0,827,G
2-PB1,34,0,0,837,0,837,G
2-PB1,35,1,838,0,2,841,T
2-PB1,36,0,838,0,0,838,T
2-PB1,37,5,0,0,836,841,C
2-PB1,38,0,1,1,840,842,C
2-PB1,39,841,0,1,0,842,A
2-PB1,40,1,0,844,0,845,G
2-PB1,41,0,1,0,845,846,C
2-PB1,42,1,2,849,0,852,G
2-PB1,43,2,1,0,852,855,C
2-PB1,44,859,0,0,0,859,A
2-PB1,45,863,0,0,0,863,A
2-PB1,46,865,0,0,0,865,A
2-PB1,47,873,0,0,0,873,A
2-PB1,48,0,875,0,0,875,T
2-PB1,49,0,1,912,0,913,G
2-PB1,50,0,0,0,928,928,C
2-PB1,51,2,0,0,933,935,C
2-PB1,52,937,0,0,0,937,A
2-PB1,53,0,940,0,0,940,T
2-PB1,54,995,0,1,0,996,A
2-PB1,55,998,0,1,0,999,A
2-PB1,56,0,2,1038,0,1040,G
2-PB1,57,0,0,0,1043,1043,C
2-PB1,58,1042,0,0,0,1042,A
2-PB1,59,0,1,1,1080,1082,C
2-PB1,60,1080,0,1,0,1081,A
2-PB1,61,1143,0,2,0,1145,A
2-PB1,62,0,0,0,1148,1148,C
2-PB1,63,1138,1,0,0,1139,A
2-PB1,64,1,1144,0,1,1146,T
2-PB1,65,0,1140,0,3,1143,T
2-PB1,66,4,1,0,1411,1416,C
2-PB1,67,4,0,0,1414,1418,C
2-PB1,68,5,1,0,1428,1434,C
2-PB1,69,0,1442,0,2,1444,T
2-PB1,70,0,1441,0,0,1441,T
2-PB1,71,1540,0,0,0,1540,A
2-PB1,72,0,1548,0,0,1548,T
2-PB1,73,1550,0,1,0,1551,A
2-PB1,74,1,2,0,1558,1561,C
2-PB1,75,0,1522,0,0,1522,T
2-PB1,76,0,2,1539,0,1541,G
2-PB1,77,0,13,1534,0,1547,G
2-PB1,78,1543,1,1,0,1545,A
2-PB1,79,1,6,1544,0,1551,G
2-PB1,80,1532,0,0,0,1532,A
2-PB1,81,1,1545,0,2,1548,T
2-PB1,82,3,0,0,1627,1630,C
2-PB1,83,4,0,0,1626,1630,C
2-PB1,84,0,1633,1,2,1636,T
2-PB1,85,8,1,0,1742,1751,C
2-PB1,86,5,0,0,1751,1756,C
2-PB1,87,1770,0,3,0,1773,A
2-PB1,88,0,1777,0,1,1778,T
2-PB1,89,1776,0,1,0,1777,A
2-PB1,90,0,1,0,1788,1789,C
2-PB1,91,1759,0,3,0,1762,A
2-PB1,92,0,1,1847,1,1849,G
2-PB1,93,0,0,0,1869,1869,C
2-PB1,94,6,0,0,1840,1846,C
2-PB1,95,1846,1,0,0,1847,A
2-PB1,96,0,1849,0,0,1849,T
2-PB1,97,0,2,1844,0,1846,G
2-PB1,98,0,8,1922,1,1931,G
2-PB1,99,1937,0,2,0,1939,A
2-PB1,100,1947,0,1,0,1948,A
2-PB1,101,0,1,0,1949,1950,C
2-PB1,102,1929,0,3,0,1932,A
2-PB1,103,1,8,1976,0,1985,G
2-PB1,104,1,19,1988,0,2008,G
2-PB1,105,2006,0,9,0,2015,A
2-PB1,106,2024,0,3,0,2027,A
2-PB1,107,1,0,0,2038,2039,C
2-PB1,108,2013,0,3,0,2016,A
2-PB1,109,0,10,2218,0,2228,G
2-PB1,110,1,12,2222,0,2235,G
2-PB1,111,1,0,2273,0,2274,G
2-PB1,112,1,2266,0,2,2269,T
2-PB1,113,2256,0,5,0,2261,A
2-PB1,114,1,3,0,2285,2289,C
2-PB1,115,2356,1,5,1,2363,A
2-PB1,116,0,1,0,2427,2428,C
2-PB1,117,6,0,0,2399,2405,C
2-PB1,118,2352,0,7,0,2359,A
2-PB1,119,1,2343,0,4,2348,T
2-PB1,120,0,12,2343,0,2355,G
2-PB1,121,1,15,2343,1,2360,G
2-PB1,122,2352,0,7,0,2359,A
2-PB1,123,0,1,0,2367,2368,C
2-PB1,124,2334,0,2,0,2336,A
2-PB1,125,0,0,0,2368,2368,C
2-PB1,126,2361,0,1,1,2363,A
2-PB1,127,1,0,2413,0,2414,G
2-PB1,128,0,2415,0,2,2417,T
2-PB1,129,17,1,0,2479,2497,C
2-PB1,130,2485,0,8,0,2493,A
2-PB1,131,2511,1,2,1,2515,A
2-PB1,132,1,2,0,2513,2516,C
2-PB1,133,2496,0,2,0,2498,A
2-PB1,134,0,14,2520,0,2534,G
2-PB1,135,2490,3,4,1,2498,A
2-PB1,136,2500,0,2,0,2502,A
2-PB1,137,1,2,0,2505,2508,C
2-PB1,138,2459,1,3,0,2463,A
2-PB1,139,2,2,0,2461,2465,C
2-PB1,140,2444,1,1,0,2446,A
2-PB1,141,0,2429,0,3,2432,T
2-PB1,142,9,0,0,2604,2613,C
2-PB1,143,2616,0,2,0,2618,A
2-PB1,144,2656,0,2,0,2658,A
2-PB1,145,0,2689,0,1,2690,T
2-PB1,146,2757,1,0,0,2758,A
2-PB1,147,0,2761,1,1,2763,T
2-PB1,148,0,2729,0,3,2732,T
2-PB1,149,17,0,0,2718,2735,C
2-PB1,150,2695,0,1,0,2696,A
2-PB1,151,0,9,2702,0,2711,G
2-PB1,152,2694,0,0,0,2694,A
2-PB1,153,1,9,2680,1,2691,G
2-PB1,154,2637,0,3,0,2640,A
2-PB1,155,31,7,2566,0,2604,G
2-PB1,156,0,11,2592,0,2603,G
2-PB1,157,0,14,2696,0,2710,G
2-PB1,158,0,11,2697,0,2708,G
2-PB1,159,1,9,2721,0,2731,G
2-PB1,160,2721,1,5,1,2728,A
2-PB1,161,2728,0,1,0,2729,A
2-PB1,162,0,0,2758,0,2758,G
2-PB1,163,0,2734,0,3,2737,T
2-PB1,164,1,24,2700,0,2725,G
2-PB1,165,0,9,2707,0,2716,G
2-PB1,166,2704,1,8,0,2713,A
2-PB1,167,1,4,6,2710,2721,C
2-PB1,168,2,29,2700,0,2731,G
2-PB1,169,2739,0,5,0,2744,A
2-PB1,170,2,2,0,2761,2765,C
2-PB1,171,2739,0,3,0,2742,A
2-PB1,172,2741,0,1,0,2742,A
2-PB1,173,2747,3,5,0,2755,A
2-PB1,174,0,2792,0,1,2793,T
2-PB1,175,2788,0,13,0,2801,A
2-PB1,176,1,1,0,2805,2807,C
2-PB1,177,2775,0,1,0,2776,A
2-PB1,178,0,12,2785,0,2797,G
2-PB1,179,2781,1,5,0,2787,A
2-PB1,180,2816,1,1,0,2818,A
2-PB1,181,2812,0,5,0,2817,A
2-PB1,182,0,0,0,2820,2820,C
2-PB1,183,0,2789,0,1,2790,T
2-PB1,184,0,6,2777,0,2783,G
2-PB1,185,3,7,2776,0,2786,G
2-PB1,186,1,12,2781,1,2795,G
2-PB1,187,2,4,2782,0,2788,G
2-PB1,188,1,0,9,2782,2792,C
2-PB1,189,2779,0,2,0,2781,A
2-PB1,190,3,0,0,2878,2881,C
2-PB1,191,5,0,0,2872,2877,C
2-PB1,192,6,3,0,2870,2879,C
2-PB1,193,5,0,0,2886,2891,C
2-PB1,194,2891,0,1,1,2893,A
2-PB1,195,2912,1,1,0,2914,A
2-PB1,196,0,0,0,2916,2916,C
2-PB1,197,0,2901,0,4,2905,T
2-PB1,198,13,1,0,2906,2920,C
2-PB1,199,2816,0,1,0,2817,A
2-PB1,200,2879,0,1,0,2880,A
2-PB1,201,0,1,0,2881,2882,C
2-PB1,202,5,1,0,2872,2878,C
2-PB1,203,10,1,0,2879,2890,C
2-PB1,204,2861,0,17,1,2879,A
2-PB1,205,2905,0,2,0,2907,A
2-PB1,206,0,2915,0,0,2915,T
2-PB1,207,2,2908,0,2,2912,T
2-PB1,208,0,12,2906,0,2918,G
2-PB1,209,2875,0,4,0,2879,A
2-PB1,210,0,2875,1,2,2878,T
2-PB1,211,4,20,2851,1,2876,G
2-PB1,212,3,26,2881,0,2910,G
2-PB1,213,2925,0,7,0,2932,A
2-PB1,214,3,0,0,2956,2959,C
2-PB1,215,19,0,0,2926,2945,C
2-PB1,216,2939,1,6,0,2946,A
2-PB1,217,0,0,1,3009,3010,C
2-PB1,218,0,2997,0,6,3003,T
2-PB1,219,3038,1,3,0,3042,A
2-PB1,220,1,0,0,3070,3071,C
2-PB1,221,7,0,0,3042,3049,C
2-PB1,222,0,2981,0,1,2982,T
2-PB1,223,0,10,2986,0,2996,G
2-PB1,224,2972,0,9,0,2981,A
2-PB1,225,0,9,2990,1,3000,G
2-PB1,226,0,8,2979,0,2987,G
2-PB1,227,2998,0,5,0,3003,A
2-PB1,228,1,2991,0,1,2993,T
2-PB1,229,2955,0,1,0,2956,A
2-PB1,230,2949,2,2,1,2954,A
2-PB1,231,0,2956,0,1,2957,T
2-PB1,232,2,37,2909,0,2948,G
2-PB1,233,2935,2,5,0,2942,A
2-PB1,234,2923,0,4,0,2927,A
2-PB1,235,0,0,0,2929,2929,C
2-PB1,236,11,0,0,2881,2892,C
2-PB1,237,2897,1,2,0,2900,A
2-PB1,238,2903,0,2,1,2906,A
2-PB1,239,0,1,2925,1,2927,G
2-PB1,240,1,2912,0,2,2915,T
2-PB1,241,2,13,2890,0,2905,G
2-PB1,242,0,9,2947,0,2956,G
2-PB1,243,2932,2,10,0,2944,A
2-PB1,244,0,2926,0,1,2927,T
2-PB1,245,2934,0,0,0,2934,A
2-PB1,246,0,2972,1,2,2975,T
2-PB1,247,1,8,2990,0,2999,G
2-PB1,248,5,2,0,2982,2989,C
2-PB1,249,2980,0,6,0,2986,A
2-PB1,250,0,0,0,3081,3081,C
2-PB1,251,3027,0,1,0,3028,A
2-PB1,252,3085,0,3,0,3088,A
2-PB1,253,3083,1,2,0,3086,A
2-PB1,254,0,25,0,3066,3091,C
2-PB1,255,3008,0,3,0,3011,A
2-PB1,256,0,20,3025,0,3045,G
2-PB1,257,3028,2,3,0,3033,A
2-PB1,258,1,0,0,3040,3041,C
2-PB1,259,0,2938,0,4,2942,T
2-PB1,260,1,1,3013,0,3015,G
2-PB1,261,1,2974,1,6,2982,T
2-PB1,262,4,0,3104,0,3108,G
2-PB1,263,0,3108,2,0,3110,T
2-PB1,264,18,7,0,3087,3112,C
2-PB1,265,8,1,0,3108,3117,C
2-PB1,266,2,3080,0,3,3085,T
2-PB1,267,1,5,3072,1,3079,G
2-PB1,268,0,4,3085,0,3089,G
2-PB1,269,3038,1,6,1,3046,A
2-PB1,270,0,5,3080,0,3085,G
2-PB1,271,0,0,3025,0,3025,G
2-PB1,272,1,0,0,3030,3031,C
2-PB1,273,0,3007,1,2,3010,T
2-PB1,274,3012,2,2,0,3016,A
2-PB1,275,1,3014,0,6,3021,T
2-PB1,276,2,9,3004,0,3015,G
2-PB1,277,0,0,3022,0,3022,G
2-PB1,278,2,1,0,3010,3013,C
2-PB1,279,7,1,0,2962,2970,C
2-PB1,280,0,2941,0,2,2943,T
2-PB1,281,0,3093,0,0,3093,T
2-PB1,282,8,0,1,3084,3093,C
2-PB1,283,19,0,0,3078,3097,C
2-PB1,284,1,3096,0,4,3101,T
2-PB1,285,3,3083,0,3,3089,T
2-PB1,286,0,14,3086,0,3100,G
2-PB1,287,3101,1,3,1,3106,A
2-PB1,288,3099,0,8,0,3107,A
2-PB1,289,3,12,3106,0,3121,G
2-PB1,290,2993,0,3,0,2996,A
2-PB1,291,3025,0,1,1,3027,A
2-PB1,292,0,3018,0,3,3021,T
2-PB1,293,24,4,0,2992,3020,C
2-PB1,294,12,0,0,3000,3012,C
2-PB1,295,15,1,0,2987,3003,C
2-PB1,296,3013,2,5,0,3020,A
2-PB1,297,2,0,0,3039,3041,C
2-PB1,298,3,1,0,3029,3033,C
2-PB1,299,19,1,0,3018,3038,C
2-PB1,300,2965,0,6,15,2986,A
2-PB1,301,1,5,3010,0,3016,G
2-PB1,302,2,1,3018,0,3021,G
2-PB1,303,0,3012,0,5,3017,T
2-PB1,304,3026,0,3,0,3029,A
2-PB1,305,0,3008,0,5,3013,T
2-PB1,306,5,1,0,3005,3011,C
2-PB1,307,1,2999,0,3,3003,T
2-PB1,308,1,3003,1,1,3006,T
2-PB1,309,2,2989,0,1,2992,T
2-PB1,310,2,20,2959,0,2981,G
2-PB1,311,2941,2,5,0,2948,A
2-PB1,312,1,26,2929,1,2957,G
2-PB1,313,2913,0,4,0,2917,A
2-PB1,314,2923,1,0,0,2924,A
2-PB1,315,1,0,1,2952,2954,C
2-PB1,316,2,2916,0,5,2923,T
2-PB1,317,25,0,0,2898,2923,C
2-PB1,318,2913,0,4,0,2917,A
2-PB1,319,0,2918,0,2,2920,T
2-PB1,320,0,1,2932,0,2933,G
2-PB1,321,1,0,0,2976,2977,C
2-PB1,322,9,1,0,2961,2971,C
2-PB1,323,0,2957,1,2,2960,T
2-PB1,324,0,2928,0,2,2930,T
2-PB1,325,0,23,2916,0,2939,G
2-PB1,326,2973,0,3,0,2976,A
2-PB1,327,2974,0,0,0,2974,A
2-PB1,328,2975,1,5,0,2981,A
2-PB1,329,2,2,0,2992,2996,C
2-PB1,330,2926,0,2,0,2928,A
2-PB1,331,2953,0,3,0,2956,A
2-PB1,332,1,2959,0,1,2961,T
2-PB1,333,3,10,2944,0,2957,G
2-PB1,334,0,13,2944,0,2957,G
2-PB1,335,2922,0,3,0,2925,A
2-PB1,336,2922,0,2,0,2924,A
2-PB1,337,10,1,2913,0,2924,G
2-PB1,338,2,1,0,2934,2937,C
2-PB1,339,9,2,0,2889,2900,C
2-PB1,340,4,1,2930,0,2935,G
2-PB1,341,1,2914,0,4,2919,T
2-PB1,342,1,2928,1,4,2934,T
2-PB1,343,41,2,0,2915,2958,C
2-PB1,344,2944,0,8,0,2952,A
2-PB1,345,2981,0,2,1,2984,A
2-PB1,346,0,2,0,2985,2987,C
2-PB1,347,2974,1,4,0,2979,A
2-PB1,348,0,13,2996,1,3010,G
2-PB1,349,2954,0,2,0,2956,A
2-PB1,350,0,0,0,2958,2958,C
2-PB1,351,2948,0,2,0,2950,A
2-PB1,352,2962,1,4,0,2967,A
2-PB1,353,0,11,2974,0,2985,G
2-PB1,354,0,7,2941,0,2948,G
2-PB1,355,1,2,2969,0,2972,G
2-PB1,356,1,2918,0,1,2920,T
2-PB1,357,2,10,2909,0,2921,G
2-PB1,358,0,13,2908,0,2921,G
2-PB1,359,2914,1,11,0,2926,A
2-PB1,360,0,2,1,2925,2928,C
2-PB1,361,2875,0,1,0,2876,A
2-PB1,362,2914,0,1,0,2915,A
2-PB1,363,2901,0,5,0,2906,A
2-PB1,364,0,0,0,2908,2908,C
2-PB1,365,0,2885,1,4,2890,T
2-PB1,366,2888,1,2,0,2891,A
2-PB1,367,2905,0,5,0,2910,A
2-PB1,368,3,1,0,2914,2918,C
2-PB1,369,9,0,0,2910,2919,C
2-PB1,370,8,1,0,2899,2908,C
2-PB1,371,2832,0,1,0,2833,A
2-PB1,372,2835,1,1,0,2837,A
2-PB1,373,0,9,2826,0,2835,G
2-PB1,374,0,1,2843,0,2844,G
2-PB1,375,1,2834,0,3,2838,T
2-PB1,376,35,1,0,2778,2814,C
2-PB1,377,3,1,2810,0,2814,G
2-PB1,378,2,2,0,2805,2809,C
2-PB1,379,6,1,0,2810,2817,C
2-PB1,380,2807,0,4,0,2811,A
2-PB1,381,0,16,2836,0,2852,G
2-PB1,382,2884,0,4,0,2888,A
2-PB1,383,0,0,0,2893,2893,C
2-PB1,384,0,2868,0,4,2872,T
2-PB1,385,1,2866,0,0,2867,T
2-PB1,386,2865,0,3,1,2869,A
2-PB1,387,0,2873,0,4,2877,T
2-PB1,388,1,20,2865,0,2886,G
2-PB1,389,2875,0,0,0,2875,A
2-PB1,390,0,2814,1,1,2816,T
2-PB1,391,1,2718,0,2,2721,T
2-PB1,392,2,8,2702,0,2712,G
2-PB1,393,0,15,2695,0,2710,G
2-PB1,394,2727,1,5,0,2733,A
2-PB1,395,1,2,0,2725,2728,C
2-PB1,396,2689,0,1,0,2690,A
2-PB1,397,2,2669,0,2,2673,T
2-PB1,398,0,2701,0,0,2701,T
2-PB1,399,2717,1,0,0,2718,A
2-PB1,400,2718,0,2,0,2720,A
2-PB1,401,2720,1,4,1,2726,A
2-PB1,402,0,0,0,2728,2728,C
2-PB1,403,2686,0,1,0,2687,A
2-PB1,404,1,9,2700,1,2711,G
2-PB1,405,2694,0,1,0,2695,A
2-PB1,406,2693,2,5,0,2700,A
2-PB1,407,2698,2,3,0,2703,A
2-PB1,408,1,2673,0,1,2675,T
2-PB1,409,17,1,0,2669,2687,C
2-PB1,410,2676,1,2,0,2679,A
2-PB1,411,2681,0,4,0,2685,A
2-PB1,412,0,1,0,2680,2681,C
2-PB1,413,13,7,0,2642,2662,C
2-PB1,414,0,5,2670,1,2676,G
2-PB1,415,2,0,2678,0,2680,G
2-PB1,416,1,2,0,2685,2688,C
2-PB1,417,2689,0,0,0,2689,A
2-PB1,418,2,1,2685,0,2688,G
2-PB1,419,4,1,0,2704,2709,C
2-PB1,420,2702,1,0,0,2703,A
2-PB1,421,2709,0,3,0,2712,A
2-PB1,422,2,1,0,2713,2716,C
2-PB1,423,2,2699,1,1,2703,T
2-PB1,424,1,2,2813,0,2816,G
2-PB1,425,2,1,0,2811,2814,C
2-PB1,426,2813,0,1,1,2815,A
2-PB1,427,0,2807,0,0,2807,T
2-PB1,428,0,2772,0,1,2773,T
2-PB1,429,2922,0,4,0,2926,A
2-PB1,430,0,1,2934,0,2935,G
2-PB1,431,6,2,0,2917,2925,C
2-PB1,432,11,4,0,2906,2921,C
2-PB1,433,2808,0,3,0,2811,A
2-PB1,434,2820,1,5,0,2826,A
2-PB1,435,0,0,0,2841,2841,C
2-PB1,436,2840,1,2,0,2843,A
2-PB1,437,0,0,1,2944,2945,C
2-PB1,438,15,0,0,2734,2749,C
2-PB1,439,2746,0,4,0,2750,A
2-PB1,440,1,2741,1,2,2745,T
2-PB1,441,2740,2,4,0,2746,A
2-PB1,442,0,7,2743,0,2750,G
2-PB1,443,2732,1,0,1,2734,A
2-PB1,444,2687,0,1,0,2688,A
2-PB1,445,1,0,2717,0,2718,G
2-PB1,446,1,2608,0,1,2610,T
2-PB1,447,0,2612,0,3,2615,T
2-PB1,448,0,2607,0,1,2608,T
2-PB1,449,1,2605,0,3,2609,T
2-PB1,450,0,2612,0,1,2613,T
2-PB1,451,2608,0,0,0,2608,A
2-PB1,452,0,8,2604,0,2612,G
2-PB1,453,2588,0,3,0,2591,A
2-PB1,454,0,2582,0,2,2584,T
2-PB1,455,12,1,0,2531,2544,C
2-PB1,456,0,18,2531,0,2549,G
2-PB1,457,2547,0,0,0,2547,A
2-PB1,458,2548,0,2,0,2550,A
2-PB1,459,1,2,0,2551,2554,C
2-PB1,460,1,7,2554,0,2562,G
2-PB1,461,0,16,2629,1,2646,G
2-PB1,462,2646,1,3,0,2650,A
2-PB1,463,0,2647,0,1,2648,T
2-PB1,464,1,2641,1,2,2645,T
2-PB1,465,2641,0,0,1,2642,A
2-PB1,466,2639,0,7,0,2646,A
2-PB1,467,1,1,0,2661,2663,C
2-PB1,468,2618,0,4,0,2622,A
2-PB1,469,1,0,2644,0,2645,G
2-PB1,470,1,1,0,2530,2532,C
2-PB1,471,0,2523,0,1,2524,T
2-PB1,472,2526,0,1,0,2527,A
2-PB1,473,2520,0,3,0,2523,A
2-PB1,474,0,2522,0,1,2523,T
2-PB1,475,1,29,2529,0,2559,G
2-PB1,476,2546,0,2,0,2548,A
2-PB1,477,2551,0,1,0,2552,A
2-PB1,478,0,2509,0,2,2511,T
2-PB1,479,17,1,1,2502,2521,C
2-PB1,480,2503,2,4,1,2510,A
2-PB1,481,0,3,2506,0,2509,G
2-PB1,482,0,2,2506,0,2508,G
2-PB1,483,2491,0,1,0,2492,A
2-PB1,484,2454,0,4,2,2460,A
2-PB1,485,0,5,2567,0,2572,G
2-PB1,486,2,3,2587,0,2592,G
2-PB1,487,1,0,0,2589,2590,C
2-PB1,488,1,2583,0,2,2586,T
2-PB1,489,2588,0,2,0,2590,A
2-PB1,490,2587,0,3,0,2590,A
2-PB1,491,0,2595,0,0,2595,T
2-PB1,492,2585,1,4,0,2590,A
2-PB1,493,0,14,2592,0,2606,G
2-PB1,494,2449,0,2,0,2451,A
2-PB1,495,0,2428,0,3,2431,T
2-PB1,496,2,2420,0,5,2427,T
2-PB1,497,1,2434,0,1,2436,T
2-PB1,498,9,0,0,2494,2503,C
2-PB1,499,5,0,0,2500,2505,C
2-PB1,500,0,2501,0,6,2507,T
2-PB1,501,7,1,0,2494,2502,C
2-PB1,502,2505,0,0,0,2505,A
2-PB1,503,2519,0,1,0,2520,A
2-PB1,504,0,6,2519,1,2526,G
2-PB1,505,0,5,2537,0,2542,G
2-PB1,506,2530,0,13,0,2543,A
2-PB1,507,0,2446,0,3,2449,T
2-PB1,508,0,0,2475,1,2476,G
2-PB1,509,0,2473,0,4,2477,T
2-PB1,510,5,11,2474,0,2490,G
2-PB1,511,2486,0,8,0,2494,A
2-PB1,512,0,2471,0,3,2474,T
2-PB1,513,2,8,2458,0,2468,G
2-PB1,514,0,12,2448,1,2461,G
2-PB1,515,2461,0,4,0,2465,A
2-PB1,516,2467,0,2,0,2469,A
2-PB1,517,0,2440,0,0,2440,T
2-PB1,518,21,0,0,2424,2445,C
2-PB1,519,2429,0,1,0,2430,A
2-PB1,520,2432,0,2,1,2435,A
2-PB1,521,0,2435,0,2,2437,T
2-PB1,522,0,12,2437,0,2449,G
2-PB1,523,0,7,2446,0,2453,G
2-PB1,524,2443,0,3,0,2446,A
2-PB1,525,0,2435,0,1,2436,T
2-PB1,526,2435,1,0,0,2436,A
2-PB1,527,2438,0,1,0,2439,A
2-PB1,528,2435,0,3,0,2438,A
2-PB1,529,0,3,2470,0,2473,G
2-PB1,530,2456,0,1,0,2457,A
2-PB1,531,0,10,2439,0,2449,G
2-PB1,532,0,8,2437,0,2445,G
2-PB1,533,2427,1,1,0,2429,A
2-PB1,534,2431,0,3,0,2434,A
2-PB1,535,2437,0,0,1,2438,A
2-PB1,536,0,2431,0,1,2432,T
2-PB1,537,0,8,2473,0,2481,G
2-PB1,538,0,11,2473,1,2485,G
2-PB1,539,2450,0,5,0,2455,A
2-PB1,540,0,6,2477,2,2485,G
2-PB1,541,2454,1,3,0,2458,A
2-PB1,542,0,2506,0,2,2508,T
2-PB1,543,2509,0,1,0,2510,A
2-PB1,544,2541,2,5,0,2548,A
2-PB1,545,3,0,0,2566,2569,C
2-PB1,546,2523,1,1,0,2525,A
2-PB1,547,2542,1,1,1,2545,A
2-PB1,548,2,1,0,2538,2541,C
2-PB1,549,2508,1,4,0,2513,A
2-PB1,550,0,3,0,2512,2515,C
2-PB1,551,2462,1,5,0,2468,A
2-PB1,552,0,0,0,2511,2511,C
2-PB1,553,0,2475,1,9,2485,T
2-PB1,554,1,2473,0,1,2475,T
2-PB1,555,1,2467,0,1,2469,T
2-PB1,556,9,0,0,2464,2473,C
2-PB1,557,2472,0,1,0,2473,A
2-PB1,558,2483,1,0,0,2484,A
2-PB1,559,2486,0,2,0,2488,A
2-PB1,560,0,14,2502,1,2517,G
2-PB1,561,2482,1,1,0,2484,A
2-PB1,562,2488,0,1,0,2489,A
2-PB1,563,2482,0,1,0,2483,A
2-PB1,564,2484,0,2,0,2486,A
2-PB1,565,2481,1,6,0,2488,A
2-PB1,566,0,6,2497,0,2503,G
2-PB1,567,0,11,2494,0,2505,G
2-PB1,568,2465,0,3,0,2468,A
2-PB1,569,1,11,2514,0,2526,G
2-PB1,570,2509,0,9,0,2518,A
2-PB1,571,0,1,2602,0,2603,G
2-PB1,572,2,2595,0,0,2597,T
2-PB1,573,2583,0,3,0,2586,A
2-PB1,574,2594,0,4,0,2598,A
2-PB1,575,1,11,2595,0,2607,G
2-PB1,576,1,13,2616,0,2630,G
2-PB1,577,1,22,2619,0,2642,G
2-PB1,578,2588,0,11,0,2599,A
2-PB1,579,1,0,0,2616,2617,C
2-PB1,580,2543,0,2,0,2545,A
2-PB1,581,2547,0,3,0,2550,A
2-PB1,582,0,2,0,2546,2548,C
2-PB1,583,2543,0,2,0,2545,A
2-PB1,584,1,2523,0,0,2524,T
2-PB1,585,0,35,2473,1,2509,G
2-PB1,586,2498,1,7,0,2506,A
2-PB1,587,1,0,0,2497,2498,C
2-PB1,588,16,0,0,2452,2468,C
2-PB1,589,2458,2,0,1,2461,A
2-PB1,590,2473,0,1,0,2474,A
2-PB1,591,1,14,2472,0,2487,G
2-PB1,592,2479,1,2,0,2482,A
2-PB1,593,2466,0,10,0,2476,A
2-PB1,594,2467,0,0,0,2467,A
2-PB1,595,2463,0,3,1,2467,A
2-PB1,596,0,2459,0,4,2463,T
2-PB1,597,2,12,2448,1,2463,G
2-PB1,598,1,1,2483,0,2485,G
2-PB1,599,0,2436,0,6,2442,T
2-PB1,600,29,1,1,2399,2430,C
2-PB1,601,2432,0,3,0,2435,A
2-PB1,602,1,1,0,2592,2594,C
2-PB1,603,2639,0,2,0,2641,A
2-PB1,604,0,0,0,2658,2658,C
2-PB1,605,2645,1,0,0,2646,A
2-PB1,606,2725,0,4,0,2729,A
2-PB1,607,2704,0,6,0,2710,A
2-PB1,608,0,10,2915,0,2925,G
2-PB1,609,2917,0,3,1,2921,A
2-PB1,610,2940,0,5,0,2945,A
2-PB1,611,1,1,0,3031,3033,C
2-PB1,612,2953,1,0,1,2955,A
2-PB1,613,2977,0,4,0,2981,A
2-PB1,614,0,2972,0,1,2973,T
2-PB1,615,2936,0,4,0,2940,A
2-PB1,616,0,9,2938,0,2947,G
2-PB1,617,0,5,2844,0,2849,G
2-PB1,618,0,8,2853,1,2862,G
2-PB1,619,2850,0,0,0,2850,A
2-PB1,620,2814,0,5,0,2819,A
2-PB1,621,2,19,2826,0,2847,G
2-PB1,622,2839,0,2,0,2841,A
2-PB1,623,2846,1,4,1,2852,A
2-PB1,624,2867,0,4,0,2871,A
2-PB1,625,2885,2,5,0,2892,A
2-PB1,626,2950,0,12,0,2962,A
2-PB1,627,2967,1,2,2,2972,A
2-PB1,628,0,0,1,2973,2974,C
2-PB1,629,2972,0,1,0,2973,A
2-PB1,630,2967,1,1,0,2969,A
2-PB1,631,2953,1,5,0,2959,A
2-PB1,632,0,14,3017,0,3031,G
2-PB1,633,3012,0,3,0,3015,A
2-PB1,634,2,2,3174,0,3178,G
2-PB1,635,0,3148,0,2,3150,T
2-PB1,636,2,31,3699,0,3732,G
2-PB1,637,3737,1,7,2,3747,A
2-PB1,638,3755,0,2,0,3757,A
2-PB1,639,1,3819,0,3,3823,T
2-PB1,640,3835,0,1,0,3836,A
2-PB1,641,3746,0,73,0,3819,A
2-PB1,642,0,24,3801,0,3825,G
2-PB1,643,3757,2,6,1,3766,A
2-PB1,644,0,13,3774,0,3787,G
2-PB1,645,3613,1,10,1,3625,A
2-PB1,646,0,10,3631,0,3641,G
2-PB1,647,1,1,3645,0,3647,G
2-PB1,648,2,0,0,3659,3661,C
2-PB1,649,0,3655,0,6,3661,T
2-PB1,650,3770,1,2,0,3773,A
2-PB1,651,2,1,0,3965,3968,C
2-PB1,652,4,2,1,3967,3974,C
2-PB1,653,0,3998,0,4,4002,T
2-PB1,654,4178,0,2,0,4180,A
2-PB1,655,4174,3,2,2,4181,A
2-PB1,656,0,4189,0,0,4189,T
2-PB1,657,4183,0,1,0,4184,A
2-PB1,658,4159,1,8,0,4168,A
2-PB1,659,1,14,4180,1,4196,G
2-PB1,660,4053,0,11,1,4065,A
2-PB1,661,0,0,4118,0,4118,G
2-PB1,662,3,2,0,4134,4139,C
2-PB1,663,0,4087,0,7,4094,T
2-PB1,664,0,4113,0,1,4114,T
2-PB1,665,0,4114,0,2,4116,T
2-PB1,666,0,44,4094,0,4138,G
2-PB1,667,4192,3,6,1,4202,A
2-PB1,668,1,0,0,4218,4219,C
2-PB1,669,4195,0,2,0,4197,A
2-PB1,670,0,4163,0,6,4169,T
2-PB1,671,0,4137,0,4,4141,T
2-PB1,672,3,61,4158,1,4223,G
2-PB1,673,4198,2,8,0,4208,A
2-PB1,674,4216,0,7,0,4223,A
2-PB1,675,0,2,0,4240,4242,C
2-PB1,676,4200,0,5,1,4206,A
2-PB1,677,0,4,0,4210,4214,C
2-PB1,678,1,18,4191,0,4210,G
2-PB1,679,4234,1,6,0,4241,A
2-PB1,680,1,4228,0,2,4231,T
2-PB1,681,3,73,4225,1,4302,G
2-PB1,682,4297,1,5,0,4303,A
2-PB1,683,2,9,0,4313,4324,C
2-PB1,684,29,4,1,4279,4313,C
2-PB1,685,4311,2,1,0,4314,A
2-PB1,686,4376,2,1,1,4380,A
2-PB1,687,4371,0,3,0,4374,A
2-PB1,688,0,11,4491,0,4502,G
2-PB1,689,4524,0,13,0,4537,A
2-PB1,690,0,4490,1,0,4491,T
2-PB1,691,6,3,4494,0,4503,G
2-PB1,692,4,6,0,4486,4496,C
2-PB1,693,4489,0,7,0,4496,A
2-PB1,694,0,17,4518,0,4535,G
2-PB1,695,4481,0,3,0,4484,A
2-PB1,696,0,24,4483,0,4507,G
2-PB1,697,4381,0,10,0,4391,A
2-PB1,698,1,10,4378,0,4389,G
2-PB1,699,4348,0,14,1,4363,A
2-PB1,700,2,10,4356,0,4368,G
2-PB1,701,0,5,4355,0,4360,G
2-PB1,702,1,2,0,4361,4364,C
2-PB1,703,4352,0,4,0,4356,A
2-PB1,704,4363,1,1,0,4365,A
2-PB1,705,4386,1,8,2,4397,A
2-PB1,706,0,4401,1,1,4403,T
2-PB1,707,0,4390,0,0,4390,T
2-PB1,708,4407,2,4,0,4413,A
2-PB1,709,4396,1,1,1,4399,A
2-PB1,710,4414,0,8,1,4423,A
2-PB1,711,4442,0,2,1,4445,A
2-PB1,712,4448,1,3,0,4452,A
2-PB1,713,0,11,4456,0,4467,G
2-PB1,714,4431,0,2,0,4433,A
2-PB1,715,4403,0,10,1,4414,A
2-PB1,716,1,21,4463,0,4485,G
2-PB1,717,1,10,4560,0,4571,G
2-PB1,718,3,1,4576,0,4580,G
2-PB1,719,2,3,0,4613,4618,C
2-PB1,720,2,4592,0,6,4600,T
2-PB1,721,4636,0,2,0,4638,A
2-PB1,722,1,4735,0,8,4744,T
2-PB1,723,0,4746,0,6,4752,T
2-PB1,724,2,5,4778,0,4785,G
2-PB1,725,5,5,0,4731,4741,C
2-PB1,726,4624,1,11,0,4636,A
2-PB1,727,4632,0,13,0,4645,A
2-PB1,728,0,2,0,4640,4642,C
2-PB1,729,4641,0,3,0,4644,A
2-PB1,730,3,1,0,4636,4640,C
2-PB1,731,12,0,0,4537,4549,C
2-PB1,732,7,4,1,4534,4546,C
2-PB1,733,5,20,4508,0,4533,G
2-PB1,734,0,7,4540,2,4549,G
2-PB1,735,1,13,4547,0,4561,G
2-PB1,736,4560,2,4,0,4566,A
2-PB1,737,0,4525,0,2,4527,T
2-PB1,738,2,6,4533,0,4541,G
2-PB1,739,3,0,0,4519,4522,C
2-PB1,740,4561,0,3,0,4564,A
2-PB1,741,4630,2,5,1,4638,A
2-PB1,742,4686,0,4,0,4690,A
2-PB1,743,0,4703,1,0,4704,T
2-PB1,744,0,4701,0,1,4702,T
2-PB1,745,4664,0,0,1,4665,A
2-PB1,746,0,16,4656,1,4673,G
2-PB1,747,4622,0,9,0,4631,A
2-PB1,748,2,16,4646,1,4665,G
2-PB1,749,3,27,4585,0,4615,G
2-PB1,750,13,2,4686,1,4702,G
2-PB1,751,1,4691,0,5,4697,T
2-PB1,752,0,4677,3,10,4690,T
2-PB1,753,41,3,0,4678,4722,C
2-PB1,754,5,2,4766,0,4773,G
2-PB1,755,2,4760,0,8,4770,T
2-PB1,756,2,2,4777,0,4781,G
2-PB1,757,0,4769,0,3,4772,T
2-PB1,758,4751,1,0,0,4752,A
2-PB1,759,1,2,1,4732,4736,C
2-PB1,760,1,4509,1,8,4519,T
2-PB1,761,1,4536,0,7,4544,T
2-PB1,762,17,1,1,4503,4522,C
2-PB1,763,3,0,4487,0,4490,G
2-PB1,764,0,4483,0,2,4485,T
2-PB1,765,2,4473,0,4,4479,T
2-PB1,766,1,27,4456,0,4484,G
2-PB1,767,4476,1,4,1,4482,A
2-PB1,768,4476,0,3,0,4479,A
2-PB1,769,4519,0,3,0,4522,A
2-PB1,770,1,0,0,4543,4544,C
2-PB1,771,0,4499,0,4,4503,T
2-PB1,772,0,4489,1,1,4491,T
2-PB1,773,0,4491,0,3,4494,T
2-PB1,774,4554,1,3,0,4558,A
2-PB1,775,4,3,4571,0,4578,G
2-PB1,776,2,3,0,4586,4591,C
2-PB1,777,0,4587,1,5,4593,T
2-PB1,778,4557,0,2,0,4559,A
2-PB1,779,3,14,4529,0,4546,G
2-PB1,780,4542,1,2,1,4546,A
2-PB1,781,4538,0,6,1,4545,A
2-PB1,782,0,5,4552,0,4557,G
2-PB1,783,4,2,0,4489,4495,C
2-PB1,784,4478,0,2,1,4481,A
2-PB1,785,1,4455,0,1,4457,T
2-PB1,786,0,4455,0,1,4456,T
2-PB1,787,0,4460,0,0,4460,T
2-PB1,788,0,1,4472,0,4473,G
2-PB1,789,2,8,2,4464,4476,C
2-PB1,790,2,33,4434,0,4469,G
2-PB1,791,4456,1,2,0,4459,A
2-PB1,792,4434,1,0,1,4436,A
2-PB1,793,4433,0,4,1,4438,A
2-PB1,794,4564,0,6,0,4570,A
2-PB1,795,0,1,4635,0,4636,G
2-PB1,796,3,2,0,4637,4642,C
2-PB1,797,1,4638,0,6,4645,T
2-PB1,798,0,4638,0,5,4643,T
2-PB1,799,3,61,4589,0,4653,G
2-PB1,800,4638,1,7,3,4649,A
2-PB1,801,4645,1,7,1,4654,A
2-PB1,802,0,6,0,4656,4662,C
2-PB1,803,4486,0,4,0,4490,A
2-PB1,804,0,0,4848,1,4849,G
2-PB1,805,0,4791,0,3,4794,T
2-PB1,806,32,1,1,4766,4800,C
2-PB1,807,1,4798,1,7,4807,T
2-PB1,808,2,25,4783,1,4811,G
2-PB1,809,2,22,4800,0,4824,G
2-PB1,810,4826,0,4,0,4830,A
2-PB1,811,3,1,0,4834,4838,C
2-PB1,812,2,4690,0,7,4699,T
2-PB1,813,0,4473,0,1,4474,T
2-PB1,814,17,1,1,4449,4468,C
2-PB1,815,10,4,0,4454,4468,C
2-PB1,816,3,9,4471,0,4483,G
2-PB1,817,1,2,4508,0,4511,G
2-PB1,818,0,4480,0,5,4485,T
2-PB1,819,0,4466,1,5,4472,T
2-PB1,820,6,8,4442,0,4456,G
2-PB1,821,1,11,4481,0,4493,G
2-PB1,822,1,16,4506,0,4523,G
2-PB1,823,2,20,4493,0,4515,G
2-PB1,824,1,3,4536,1,4541,G
2-PB1,825,1,4512,0,1,4514,T
2-PB1,826,4505,0,0,1,4506,A
2-PB1,827,4527,1,10,1,4539,A
2-PB1,828,0,4534,0,3,4537,T
2-PB1,829,20,41,4495,0,4556,G
2-PB1,830,4510,1,2,1,4514,A
2-PB1,831,4465,0,7,1,4473,A
2-PB1,832,4468,0,9,0,4477,A
2-PB1,833,4458,0,3,0,4461,A
2-PB1,834,0,10,4451,0,4461,G
2-PB1,835,4380,1,4,0,4385,A
2-PB1,836,4333,2,8,0,4343,A
2-PB1,837,1,13,4355,0,4369,G
2-PB1,838,2,2,4351,0,4355,G
2-PB1,839,3,2,0,4320,4325,C
2-PB1,840,19,3,0,4309,4331,C
2-PB1,841,4332,0,3,1,4336,A
2-PB1,842,4333,1,6,0,4340,A
2-PB1,843,4337,1,5,0,4343,A
2-PB1,844,2,0,0,4353,4355,C
2-PB1,845,0,4334,0,1,4335,T
2-PB1,846,4,13,4377,0,4394,G
2-PB1,847,3,0,4386,0,4389,G
2-PB1,848,3,3,2,4382,4390,C
2-PB1,849,4403,0,2,0,4405,A
2-PB1,850,4388,2,4,0,4394,A
2-PB1,851,4406,2,1,2,4411,A
2-PB1,852,0,4413,0,0,4413,T
2-PB1,853,3,1,4419,1,4424,G
2-PB1,854,1,4405,1,3,4410,T
2-PB1,855,1,4275,0,2,4278,T
2-PB1,856,2,1,4281,0,4284,G
2-PB1,857,0,4268,0,7,4275,T
2-PB1,858,4,28,4253,2,4287,G
2-PB1,859,4271,1,14,1,4287,A
2-PB1,860,0,18,4285,1,4304,G
2-PB1,861,4298,0,2,0,4300,A
2-PB1,862,4276,4,0,0,4280,A
2-PB1,863,4270,1,2,0,4273,A
2-PB1,864,4282,0,2,0,4284,A
2-PB1,865,4312,1,1,0,4314,A
2-PB1,866,0,4298,1,2,4301,T
2-PB1,867,0,26,4270,0,4296,G
2-PB1,868,4285,1,3,0,4289,A
2-PB1,869,0,4229,1,5,4235,T
2-PB1,870,5,44,4223,1,4273,G
2-PB1,871,4258,4,14,0,4276,A
2-PB1,872,1,0,1,4318,4320,C
2-PB1,873,2,4299,1,0,4302,T
2-PB1,874,4292,1,1,0,4294,A
2-PB1,875,4336,0,3,1,4340,A
2-PB1,876,0,4338,1,0,4339,T
2-PB1,877,0,4375,1,5,4381,T
2-PB1,878,39,0,1,4376,4416,C
2-PB1,879,4387,1,3,0,4391,A
2-PB1,880,1,1,0,4402,4404,C
2-PB1,881,4335,0,4,0,4339,A
2-PB1,882,4335,1,9,0,4345,A
2-PB1,883,0,32,4318,0,4350,G
2-PB1,884,4394,0,5,0,4399,A
2-PB1,885,1,3,0,4396,4400,C
2-PB1,886,4346,1,10,0,4357,A
2-PB1,887,0,2,1,4356,4359,C
2-PB1,888,4297,0,7,0,4304,A
2-PB1,889,4,16,4306,0,4326,G
2-PB1,890,4301,0,5,0,4306,A
2-PB1,891,0,0,4318,0,4318,G
2-PB1,892,0,2,0,4297,4299,C
2-PB1,893,1,4189,0,9,4199,T
2-PB1,894,0,4253,1,3,4257,T
2-PB1,895,1,4244,0,8,4253,T
2-PB1,896,16,4,0,4248,4268,C
2-PB1,897,0,4252,0,6,4258,T
2-PB1,898,2,4232,1,2,4237,T
2-PB1,899,2,4221,1,8,4232,T
2-PB1,900,20,1,0,4204,4225,C
2-PB1,901,4214,1,4,0,4219,A
2-PB1,902,2,4,0,4233,4239,C
2-PB1,903,4179,1,1,0,4181,A
2-PB1,904,4207,1,0,0,4208,A
2-PB1,905,0,4244,1,7,4252,T
2-PB1,906,29,0,1,4274,4304,C
2-PB1,907,4313,1,2,0,4316,A
2-PB1,908,2,1,1,4340,4344,C
2-PB1,909,0,4290,0,6,4296,T
2-PB1,910,3,6,4319,0,4328,G
2-PB1,911,2,4,4292,1,4299,G
2-PB1,912,1,18,4395,0,4414,G
2-PB1,913,1,25,4366,0,4392,G
2-PB1,914,4301,0,10,1,4312,A
2-PB1,915,0,3,0,4143,4146,C
2-PB1,916,4184,2,9,0,4195,A
2-PB1,917,4416,0,8,0,4424,A
2-PB1,918,3,0,0,4470,4473,C
2-PB1,919,4455,0,4,0,4459,A
2-PB1,920,0,0,0,4477,4477,C
2-PB1,921,0,4252,1,6,4259,T
2-PB1,922,4274,0,2,0,4276,A
2-PB1,923,4267,1,9,1,4278,A
2-PB1,924,2,1,4305,1,4309,G
2-PB1,925,1,4262,1,2,4266,T
2-PB1,926,4,17,3982,1,4004,G
2-PB1,927,1,18,3951,0,3970,G
2-PB1,928,3944,1,3,0,3948,A
2-PB1,929,3956,0,4,0,3960,A
2-PB1,930,1,3950,1,1,3953,T
2-PB1,931,2,25,3911,0,3938,G
2-PB1,932,3931,0,1,0,3932,A
2-PB1,933,3868,1,8,0,3877,A
2-PB1,934,3894,0,9,0,3903,A
2-PB1,935,3924,0,2,0,3926,A
2-PB1,936,0,3913,1,1,3915,T
2-PB1,937,61,3,0,3859,3923,C
2-PB1,938,3913,0,0,0,3913,A
2-PB1,939,3905,0,3,0,3908,A
2-PB1,940,3896,1,1,0,3898,A
2-PB1,941,3904,0,4,0,3908,A
2-PB1,942,2,16,1,3908,3927,C
2-PB1,943,13,0,0,3887,3900,C
2-PB1,944,22,0,0,3858,3880,C
2-PB1,945,2,3865,0,4,3871,T
2-PB1,946,11,3,0,3868,3882,C
2-PB1,947,1,18,3865,0,3884,G
2-PB1,948,3875,1,5,1,3882,A
2-PB1,949,3881,1,1,1,3884,A
2-PB1,950,1,3880,0,0,3881,T
2-PB1,951,14,1,3888,0,3903,G
2-PB1,952,0,3855,0,6,3861,T
2-PB1,953,1,3858,4,3,3866,T
2-PB1,954,0,3860,0,2,3862,T
2-PB1,955,0,3866,0,1,3867,T
2-PB1,956,0,3865,0,1,3866,T
2-PB1,957,3,14,3855,0,3872,G
2-PB1,958,1,3,3866,0,3870,G
2-PB1,959,6,7,0,3846,3859,C
2-PB1,960,2,8,3790,0,3800,G
2-PB1,961,3803,0,1,0,3804,A
2-PB1,962,1,3906,0,2,3909,T
2-PB1,963,2,23,3984,0,4009,G
2-PB1,964,4181,1,2,1,4185,A
2-PB1,965,0,4202,1,5,4208,T
2-PB1,966,0,4204,0,0,4204,T
2-PB1,967,4229,2,2,0,4233,A
2-PB1,968,0,1,0,4236,4237,C
2-PB1,969,4242,0,2,0,4244,A
2-PB1,970,1,4231,1,3,4236,T
2-PB1,971,4025,0,2,0,4027,A
2-PB1,972,2,0,0,4059,4061,C
2-PB1,973,3700,0,3,0,3703,A
2-PB1,974,1,3689,1,6,3697,T
2-PB1,975,17,3,0,3670,3690,C
2-PB1,976,3668,0,5,0,3673,A
2-PB1,977,1,3,1,3679,3684,C
2-PB1,978,3641,0,2,0,3643,A
2-PB1,979,3640,0,2,0,3642,A
2-PB1,980,3622,0,12,0,3634,A
2-PB1,981,2,17,3465,0,3484,G
2-PB1,982,3644,0,4,1,3649,A
2-PB1,983,3654,1,6,1,3662,A
2-PB1,984,1,3652,0,12,3665,T
2-PB1,985,34,1,0,3628,3663,C
2-PB1,986,3685,0,6,0,3691,A
2-PB1,987,3705,2,4,1,3712,A
2-PB1,988,0,5,0,3718,3723,C
2-PB1,989,11,1,1,3713,3726,C
2-PB1,990,1,3529,0,3,3533,T
2-PB1,991,1,19,3538,0,3558,G
2-PB1,992,3543,0,5,0,3548,A
2-PB1,993,0,0,3548,0,3548,G
2-PB1,994,0,3527,0,6,3533,T
2-PB1,995,2,18,3436,0,3456,G
2-PB1,996,3,3,3588,0,3594,G
2-PB1,997,1,3564,0,2,3567,T
2-PB1,998,0,3562,0,6,3568,T
2-PB1,999,23,1,0,3550,3574,C
2-PB1,1000,3517,1,2,0,3520,A
2-PB1,1001,0,5,3587,0,3592,G
2-PB1,1002,3583,1,3,0,3587,A
2-PB1,1003,3579,2,6,0,3587,A
2-PB1,1004,3570,0,2,0,3572,A
2-PB1,1005,1,1,0,3307,3309,C
2-PB1,1006,3337,0,2,0,3339,A
2-PB1,1007,2,3325,0,3,3330,T
2-PB1,1008,7,0,0,3353,3360,C
2-PB1,1009,7,0,0,3363,3370,C
2-PB1,1010,0,3251,0,7,3258,T
2-PB1,1011,2,26,3235,0,3263,G
2-PB1,1012,3246,0,4,2,3252,A
2-PB1,1013,2,1,3272,0,3275,G
2-PB1,1014,0,0,0,3250,3250,C
2-PB1,1015,3137,3,2,0,3142,A
2-PB1,1016,1,3154,0,0,3155,T
2-PB1,1017,12,2,0,3113,3127,C
2-PB1,1018,2,2,3123,1,3128,G
2-PB1,1019,2,3,0,3213,3218,C
2-PB1,1020,3223,0,1,1,3225,A
2-PB1,1021,4,2,0,3341,3347,C
2-PB1,1022,27,2,0,3308,3337,C
2-PB1,1023,3335,0,8,1,3344,A
2-PB1,1024,3402,0,1,2,3405,A
2-PB1,1025,0,3402,0,1,3403,T
2-PB1,1026,3397,0,0,1,3398,A
2-PB1,1027,3401,0,1,1,3403,A
2-PB1,1028,0,3278,0,1,3279,T
2-PB1,1029,1,1,3292,0,3294,G
2-PB1,1030,0,3161,0,3,3164,T
2-PB1,1031,3,3124,0,16,3143,T
2-PB1,1032,20,1,1,3136,3158,C
2-PB1,1033,1,3119,1,3,3124,T
2-PB1,1034,22,0,0,3117,3139,C
2-PB1,1035,3140,1,0,1,3142,A
2-PB1,1036,3138,0,1,2,3141,A
2-PB1,1037,3143,2,1,0,3146,A
2-PB1,1038,0,1,0,3150,3151,C
2-PB1,1039,3132,0,0,1,3133,A
2-PB1,1040,3131,1,3,1,3136,A
2-PB1,1041,3116,1,5,0,3122,A
2-PB1,1042,3125,1,5,0,3131,A
2-PB1,1043,0,3135,0,4,3139,T
2-PB1,1044,0,16,3132,0,3148,G
2-PB1,1045,2,3,3133,0,3138,G
2-PB1,1046,5,3,0,3130,3138,C
2-PB1,1047,3125,0,5,1,3131,A
2-PB1,1048,3139,0,4,1,3144,A
2-PB1,1049,1,10,3136,0,3147,G
2-PB1,1050,3131,1,2,1,3135,A
2-PB1,1051,1,3106,0,4,3111,T
2-PB1,1052,0,3166,0,3,3169,T
2-PB1,1053,1,5,3185,0,3191,G
2-PB1,1054,0,9,3178,0,3187,G
2-PB1,1055,1,12,3204,0,3217,G
2-PB1,1056,3206,0,2,2,3210,A
2-PB1,1057,3203,0,1,0,3204,A
2-PB1,1058,3195,0,2,0,3197,A
2-PB1,1059,3171,0,4,0,3175,A
2-PB1,1060,1,11,3283,0,3295,G
2-PB1,1061,0,12,3286,0,3298,G
2-PB1,1062,3273,1,12,0,3286,A
2-PB1,1063,0,3269,1,2,3272,T
2-PB1,1064,3278,0,3,0,3281,A
2-PB1,1065,0,0,0,3291,3291,C
2-PB1,1066,3300,0,4,0,3304,A
2-PB1,1067,1,3295,0,0,3296,T
2-PB1,1068,0,0,3330,0,3330,G
2-PB1,1069,0,3234,0,4,3238,T
2-PB1,1070,0,3235,1,4,3240,T
2-PB1,1071,40,5,0,3180,3225,C
2-PB1,1072,2,18,3209,0,3229,G
2-PB1,1073,3230,0,3,0,3233,A
2-PB1,1074,0,18,3281,0,3299,G
2-PB1,1075,3245,1,10,0,3256,A
2-PB1,1076,0,1,3295,0,3296,G
2-PB1,1077,0,3265,0,0,3265,T
2-PB1,1078,3245,1,3,0,3249,A
2-PB1,1079,3258,0,4,0,3262,A
2-PB1,1080,1,24,3255,0,3280,G
2-PB1,1081,3270,0,8,1,3279,A
2-PB1,1082,0,20,3307,0,3327,G
2-PB1,1083,3221,0,4,1,3226,A
2-PB1,1084,3251,0,1,0,3252,A
2-PB1,1085,0,3224,0,1,3225,T
2-PB1,1086,1,23,3194,0,3218,G
2-PB1,1087,3200,2,8,0,3210,A
2-PB1,1088,3180,1,6,0,3187,A
2-PB1,1089,0,3,3203,0,3206,G
2-PB1,1090,15,0,0,3182,3197,C
2-PB1,1091,0,3157,0,2,3159,T
2-PB1,1092,6,1,0,3177,3184,C
2-PB1,1093,8,6,2,3163,3179,C
2-PB1,1094,1,6,3169,1,3177,G
2-PB1,1095,1,16,3171,1,3189,G
2-PB1,1096,3187,1,0,1,3189,A
2-PB1,1097,2,3,0,3233,3238,C
2-PB1,1098,3223,0,2,2,3227,A
2-PB1,1099,0,0,0,3265,3265,C
2-PB1,1100,3255,0,3,2,3260,A
2-PB1,1101,3261,0,4,1,3266,A
2-PB1,1102,3252,2,7,1,3262,A
2-PB1,1103,0,3280,1,0,3281,T
2-PB1,1104,3281,1,1,1,3284,A
2-PB1,1105,2,0,1,3287,3290,C
2-PB1,1106,8,1,0,3244,3253,C
2-PB1,1107,1,3182,2,3,3188,T
2-PB1,1108,0,2,3206,1,3209,G
2-PB1,1109,1,0,0,3210,3211,C
2-PB1,1110,3202,1,2,0,3205,A
2-PB1,1111,0,13,3200,1,3214,G
2-PB1,1112,3191,1,0,1,3193,A
2-PB1,1113,3184,0,0,0,3184,A
2-PB1,1114,3201,0,1,0,3202,A
2-PB1,1115,1,3188,0,2,3191,T
2-PB1,1116,2,0,3208,0,3210,G
2-PB1,1117,1,1,1,3196,3199,C
2-PB1,1118,0,3191,0,2,3193,T
2-PB1,1119,3243,0,1,0,3244,A
2-PB1,1120,1,0,3236,0,3237,G
2-PB1,1121,1,5,0,3237,3243,C
2-PB1,1122,3238,0,3,0,3241,A
2-PB1,1123,3223,0,1,1,3225,A
2-PB1,1124,0,1,3210,0,3211,G
2-PB1,1125,0,0,0,3207,3207,C
2-PB1,1126,3152,0,2,2,3156,A
2-PB1,1127,1,3235,2,2,3240,T
2-PB1,1128,0,3238,0,1,3239,T
2-PB1,1129,0,18,3329,1,3348,G
2-PB1,1130,3385,0,4,0,3389,A
2-PB1,1131,1,2,0,3364,3367,C
2-PB1,1132,12,0,0,3369,3381,C
2-PB1,1133,1,3292,1,1,3295,T
2-PB1,1134,0,9,3342,0,3351,G
2-PB1,1135,3357,2,2,0,3361,A
2-PB1,1136,3361,0,5,1,3367,A
2-PB1,1137,0,0,3413,0,3413,G
2-PB1,1138,0,3299,0,1,3300,T
2-PB1,1139,3309,0,0,0,3309,A
2-PB1,1140,1,3284,0,4,3289,T
2-PB1,1141,0,3289,0,2,3291,T
2-PB1,1142,1,3253,26,3,3283,T
2-PB1,1143,13,0,0,3231,3244,C
2-PB1,1144,3238,1,1,0,3240,A
2-PB1,1145,3241,0,3,0,3244,A
2-PB1,1146,0,3192,0,2,3194,T
2-PB1,1147,4,31,3151,0,3186,G
2-PB1,1148,3180,0,1,1,3182,A
2-PB1,1149,3195,0,3,0,3198,A
2-PB1,1150,2,3169,1,14,3186,T
2-PB1,1151,27,0,0,3181,3208,C
2-PB1,1152,3191,1,6,0,3198,A
2-PB1,1153,3206,0,1,0,3207,A
2-PB1,1154,0,1,0,3199,3200,C
2-PB1,1155,3205,0,1,0,3206,A
2-PB1,1156,3185,1,1,3,3190,A
2-PB1,1157,1,12,3182,0,3195,G
2-PB1,1158,0,10,3198,1,3209,G
2-PB1,1159,3203,1,2,0,3206,A
2-PB1,1160,3179,1,5,1,3186,A
2-PB1,1161,0,6,3190,0,3196,G
2-PB1,1162,3178,2,2,0,3182,A
2-PB1,1163,3176,0,5,0,3181,A
2-PB1,1164,3177,0,5,0,3182,A
2-PB1,1165,3175,0,3,1,3179,A
2-PB1,1166,0,3170,0,0,3170,T
2-PB1,1167,0,3156,0,1,3157,T
2-PB1,1168,0,28,3132,0,3160,G
2-PB1,1169,3152,0,2,0,3154,A
2-PB1,1170,3146,0,2,0,3148,A
2-PB1,1171,3158,0,1,0,3159,A
2-PB1,1172,3179,0,1,1,3181,A
2-PB1,1173,3222,0,1,0,3223,A
2-PB1,1174,3229,0,1,0,3230,A
2-PB1,1175,0,3224,0,0,3224,T
2-PB1,1176,3229,0,1,0,3230,A
2-PB1,1177,3213,0,8,0,3221,A
2-PB1,1178,0,12,3223,0,3235,G
2-PB1,1179,3,0,3233,0,3236,G
2-PB1,1180,4,2,0,3213,3219,C
2-PB1,1181,6,1,0,3209,3216,C
2-PB1,1182,0,3212,0,7,3219,T
2-PB1,1183,6,0,0,3619,3625,C
2-PB1,1184,1,3668,0,3,3672,T
2-PB1,1185,0,3675,0,4,3679,T
2-PB1,1186,13,0,0,3749,3762,C
2-PB1,1187,1,3739,0,7,3747,T
2-PB1,1188,3753,0,0,0,3753,A
2-PB1,1189,3755,0,4,2,3761,A
2-PB1,1190,0,3755,0,1,3756,T
2-PB1,1191,3764,0,3,1,3768,A
2-PB1,1192,0,10,3677,0,3687,G
2-PB1,1193,3377,0,7,1,3385,A
2-PB1,1194,0,3377,1,4,3382,T
2-PB1,1195,1,16,3300,1,3318,G
2-PB1,1196,4,2,3355,1,3362,G
2-PB1,1197,4,3,0,3343,3350,C
2-PB1,1198,3356,1,4,0,3361,A
2-PB1,1199,1,2,0,3356,3359,C
2-PB1,1200,3305,0,3,0,3308,A
2-PB1,1201,0,2,3435,0,3437,G
2-PB1,1202,2,2,0,3422,3426,C
2-PB1,1203,3427,1,3,1,3432,A
2-PB1,1204,1,3510,0,8,3519,T
2-PB1,1205,21,3,1,3439,3464,C
2-PB1,1206,3493,0,3,1,3497,A
2-PB1,1207,1,3489,1,0,3491,T
2-PB1,1208,0,3455,0,13,3468,T
2-PB1,1209,0,21,3442,0,3463,G
2-PB1,1210,3331,1,3,0,3335,A
2-PB1,1211,0,2,3424,1,3427,G
2-PB1,1212,1,2,0,3406,3409,C
2-PB1,1213,12,0,1,3351,3364,C
2-PB1,1214,9,2,0,3408,3419,C
2-PB1,1215,7,3364,0,7,3378,T
2-PB1,1216,5,6,3550,0,3561,G
2-PB1,1217,1,14,3608,0,3623,G
2-PB1,1218,3606,0,9,0,3615,A
2-PB1,1219,3699,3,2,0,3704,A
2-PB1,1220,1,3596,0,3,3600,T
2-PB1,1221,1,12,3681,1,3695,G
2-PB1,1222,3743,1,3,1,3748,A
2-PB1,1223,1,3726,0,7,3734,T
2-PB1,1224,0,20,3730,0,3750,G
2-PB1,1225,3709,0,4,1,3714,A
2-PB1,1226,0,3666,1,3,3670,T
2-PB1,1227,3,21,3649,0,3673,G
2-PB1,1228,1,16,3695,0,3712,G
2-PB1,1229,1,2,3735,0,3738,G
2-PB1,1230,5,2,0,3691,3698,C
2-PB1,1231,3708,0,3,1,3712,A
2-PB1,1232,0,3726,0,3,3729,T
2-PB1,1233,0,2,3852,0,3854,G
2-PB1,1234,1,3844,0,8,3853,T
2-PB1,1235,0,3870,0,4,3874,T
2-PB1,1236,54,1,1,3832,3888,C
2-PB1,1237,3852,0,0,0,3852,A
2-PB1,1238,3861,1,4,0,3866,A
2-PB1,1239,1,3,0,3867,3871,C
2-PB1,1240,3891,0,3,0,3894,A
2-PB1,1241,0,3898,0,4,3902,T
2-PB1,1242,3,2,3935,0,3940,G
2-PB1,1243,1,1,0,3950,3952,C
2-PB1,1244,0,3943,0,2,3945,T
2-PB1,1245,3981,0,2,1,3984,A
2-PB1,1246,3979,0,3,0,3982,A
2-PB1,1247,2,2,4046,0,4050,G
2-PB1,1248,0,4042,0,2,4044,T
2-PB1,1249,4027,2,5,0,4034,A
2-PB1,1250,0,3,0,4044,4047,C
2-PB1,1251,2,19,4032,0,4053,G
2-PB1,1252,1,3,4299,0,4303,G
2-PB1,1253,1,4293,0,3,4297,T
2-PB1,1254,0,4278,0,0,4278,T
2-PB1,1255,0,4274,0,2,4276,T
2-PB1,1256,1,4245,0,1,4247,T
2-PB1,1257,4246,2,5,0,4253,A
2-PB1,1258,0,11,4239,0,4250,G
2-PB1,1259,2,22,4220,0,4244,G
2-PB1,1260,4136,0,7,0,4143,A
2-PB1,1261,0,0,4128,0,4128,G
2-PB1,1262,0,4102,0,4,4106,T
2-PB1,1263,27,0,0,4092,4119,C
2-PB1,1264,2,4107,0,10,4119,T
2-PB1,1265,16,5,0,4090,4111,C
2-PB1,1266,3,26,4088,0,4117,G
2-PB1,1267,4112,1,0,0,4113,A
2-PB1,1268,0,4101,0,8,4109,T
2-PB1,1269,24,1,1,4037,4063,C
2-PB1,1270,13,1,0,4227,4241,C
2-PB1,1271,0,4240,0,6,4246,T
2-PB1,1272,4,34,4231,0,4269,G
2-PB1,1273,4264,2,3,0,4269,A
2-PB1,1274,4335,0,7,0,4342,A
2-PB1,1275,0,4336,1,4,4341,T
2-PB1,1276,18,0,0,4243,4261,C
2-PB1,1277,0,4240,0,3,4243,T
2-PB1,1278,0,4217,0,7,4224,T
2-PB1,1279,1,20,4221,1,4243,G
2-PB1,1280,1,24,4222,0,4247,G
2-PB1,1281,4233,0,10,0,4243,A
2-PB1,1282,0,3,0,4250,4253,C
2-PB1,1283,4211,0,0,0,4211,A
2-PB1,1284,4247,0,2,0,4249,A
2-PB1,1285,4266,0,7,0,4273,A
2-PB1,1286,4266,0,7,0,4273,A
2-PB1,1287,0,21,4349,0,4370,G
2-PB1,1288,4367,1,8,0,4376,A
2-PB1,1289,4370,1,3,0,4374,A
2-PB1,1290,4380,1,4,0,4385,A
2-PB1,1291,1,4374,2,4,4381,T
2-PB1,1292,4387,1,7,1,4396,A
2-PB1,1293,0,2,1,4535,4538,C
2-PB1,1294,4506,1,6,1,4514,A
2-PB1,1295,1,3,0,4532,4536,C
2-PB1,1296,13,1,0,4449,4463,C
2-PB1,1297,4452,0,3,0,4455,A
2-PB1,1298,4515,0,3,0,4518,A
2-PB1,1299,0,40,4631,0,4671,G
2-PB1,1300,4704,1,7,0,4712,A
2-PB1,1301,2,20,0,4725,4747,C
2-PB1,1302,4620,1,3,0,4624,A
2-PB1,1303,4733,0,11,0,4744,A
2-PB1,1304,0,3,0,4748,4751,C
2-PB1,1305,4799,0,3,0,4802,A
2-PB1,1306,0,4810,0,2,4812,T
2-PB1,1307,4748,2,4,0,4754,A
2-PB1,1308,0,3,0,4806,4809,C
2-PB1,1309,1,4646,0,1,4648,T
2-PB1,1310,2,7,4680,0,4689,G
2-PB1,1311,1,2,4692,0,4695,G
2-PB1,1312,1,4591,0,4,4596,T
2-PB1,1313,0,18,4582,0,4600,G
2-PB1,1314,1,13,4549,0,4563,G
2-PB1,1315,2,9,4570,0,4581,G
2-PB1,1316,4568,0,10,0,4578,A
2-PB1,1317,0,4516,0,9,4525,T
2-PB1,1318,1,18,4487,0,4506,G
2-PB1,1319,1,21,4450,0,4472,G
2-PB1,1320,4415,1,8,0,4424,A
2-PB1,1321,1,1,0,4605,4607,C
2-PB1,1322,1,4595,0,5,4601,T
2-PB1,1323,17,3,0,4649,4669,C
2-PB1,1324,15,4,1,4619,4639,C
2-PB1,1325,4638,1,5,0,4644,A
2-PB1,1326,4647,0,2,1,4650,A
2-PB1,1327,1,4643,0,2,4646,T
2-PB1,1328,14,0,1,4618,4633,C
2-PB1,1329,17,0,0,4600,4617,C
2-PB1,1330,1,4561,0,8,4570,T
2-PB1,1331,12,0,0,4574,4586,C
2-PB1,1332,9,3,0,4536,4548,C
2-PB1,1333,5,16,4532,0,4553,G
2-PB1,1334,4544,0,3,0,4547,A
2-PB1,1335,0,4515,0,6,4521,T
2-PB1,1336,0,47,4524,0,4571,G
2-PB1,1337,4605,0,1,0,4606,A
2-PB1,1338,1,4599,0,3,4603,T
2-PB1,1339,2,4580,0,2,4584,T
2-PB1,1340,1,4564,0,2,4567,T
2-PB1,1341,2,4577,0,1,4580,T
2-PB1,1342,4,4,4575,0,4583,G
2-PB1,1343,2,3,0,4617,4622,C
2-PB1,1344,26,1,0,4594,4621,C
2-PB1,1345,18,1,1,4754,4774,C
2-PB1,1346,0,4728,0,4,4732,T
2-PB1,1347,19,0,0,4913,4932,C
2-PB1,1348,4965,1,2,1,4969,A
2-PB1,1349,1,4986,0,3,4990,T
2-PB1,1350,4987,2,6,0,4995,A
2-PB1,1351,1,0,5051,0,5052,G
2-PB1,1352,0,4992,0,4,4996,T
2-PB1,1353,1,50,4976,0,5027,G
2-PB1,1354,4873,0,4,0,4877,A
2-PB1,1355,4866,1,7,0,4874,A
2-PB1,1356,1,4681,0,1,4683,T
2-PB1,1357,1,4,4682,0,4687,G
2-PB1,1358,3,2,0,4729,4734,C
2-PB1,1359,4725,0,6,0,4731,A
2-PB1,1360,1,1,0,4741,4743,C
2-PB1,1361,19,2,1,4675,4697,C
2-PB1,1362,4676,1,1,1,4679,A
2-PB1,1363,4684,0,0,1,4685,A
2-PB1,1364,4665,0,1,0,4666,A
2-PB1,1365,1,4532,1,7,4541,T
2-PB1,1366,43,0,0,4636,4679,C
2-PB1,1367,4673,0,4,0,4677,A
2-PB1,1368,0,4672,0,4,4676,T
2-PB1,1369,3,15,4659,0,4677,G
2-PB1,1370,4674,0,4,2,4680,A
2-PB1,1371,2,21,4678,0,4701,G
2-PB1,1372,2,17,4662,0,4681,G
2-PB1,1373,4,23,4680,1,4708,G
2-PB1,1374,4678,0,8,0,4686,A
2-PB1,1375,4735,0,6,0,4741,A
2-PB1,1376,0,4756,1,4,4761,T
2-PB1,1377,4765,1,7,0,4773,A
2-PB1,1378,0,0,0,4782,4782,C
2-PB1,1379,4777,0,4,0,4781,A
2-PB1,1380,4773,0,9,0,4782,A
2-PB1,1381,1,2,4761,0,4764,G
2-PB1,1382,0,0,1,4734,4735,C
2-PB1,1383,4701,0,1,0,4702,A
2-PB1,1384,1,11,4754,0,4766,G
2-PB1,1385,2,29,4736,2,4769,G
2-PB1,1386,4730,1,5,0,4736,A
2-PB1,1387,3,1,4763,0,4767,G
2-PB1,1388,0,4680,0,2,4682,T
2-PB1,1389,3,15,4713,0,4731,G
2-PB1,1390,19,12,4727,0,4758,G
2-PB1,1391,4740,2,7,0,4749,A
2-PB1,1392,1,4746,0,3,4750,T
2-PB1,1393,4647,0,5,0,4652,A
2-PB1,1394,1,21,4678,0,4700,G
2-PB1,1395,4742,3,1,1,4747,A
2-PB1,1396,0,4729,0,8,4737,T
2-PB1,1397,0,4711,0,4,4715,T
2-PB1,1398,18,0,0,4851,4869,C
2-PB1,1399,1,4833,0,4,4838,T
2-PB1,1400,4838,0,2,0,4840,A
2-PB1,1401,0,1,0,4840,4841,C
2-PB1,1402,4755,1,5,0,4761,A
2-PB1,1403,1,8,4763,0,4772,G
2-PB1,1404,0,38,4677,0,4715,G
2-PB1,1405,4752,1,5,0,4758,A
2-PB1,1406,5,2,0,4721,4728,C
2-PB1,1407,12,1,0,4609,4622,C
2-PB1,1408,0,4578,0,11,4589,T
2-PB1,1409,2,0,4607,0,4609,G
2-PB1,1410,0,2,0,4595,4597,C
2-PB1,1411,4613,0,4,0,4617,A
2-PB1,1412,4619,1,9,0,4629,A
2-PB1,1413,0,0,4661,0,4661,G
2-PB1,1414,0,4556,0,4,4560,T
2-PB1,1415,0,4568,0,3,4571,T
2-PB1,1416,4487,0,5,0,4492,A
2-PB1,1417,2,2,4507,0,4511,G
2-PB1,1418,0,4474,0,4,4478,T
2-PB1,1419,13,12,4448,0,4473,G
2-PB1,1420,3,5,4457,0,4465,G
2-PB1,1421,4,31,4434,0,4469,G
2-PB1,1422,4432,0,13,0,4445,A
2-PB1,1423,4467,2,3,0,4472,A
2-PB1,1424,3,4453,0,6,4462,T
2-PB1,1425,32,0,0,4450,4482,C
2-PB1,1426,4474,0,8,0,4482,A
2-PB1,1427,4489,1,5,0,4495,A
2-PB1,1428,1,0,0,4486,4487,C
2-PB1,1429,4472,0,13,0,4485,A
2-PB1,1430,0,4370,0,4,4374,T
2-PB1,1431,1,40,4330,0,4371,G
2-PB1,1432,4365,1,10,0,4376,A
2-PB1,1433,2,4,4394,1,4401,G
2-PB1,1434,3,1,0,4385,4389,C
2-PB1,1435,4374,0,3,0,4377,A
2-PB1,1436,4382,0,2,0,4384,A
2-PB1,1437,4392,0,5,0,4397,A
2-PB1,1438,4417,1,6,0,4424,A
2-PB1,1439,4421,0,5,0,4426,A
2-PB1,1440,0,6,4415,0,4421,G
2-PB1,1441,4352,1,4,2,4359,A
2-PB1,1442,4301,0,7,1,4309,A
2-PB1,1443,1,2,4482,0,4485,G
2-PB1,1444,0,4469,0,9,4478,T
2-PB1,1445,30,2,0,4443,4475,C
2-PB1,1446,19,0,0,4473,4492,C
2-PB1,1447,2,4461,1,4,4468,T
2-PB1,1448,4521,2,4,1,4528,A
2-PB1,1449,1,4523,0,2,4526,T
2-PB1,1450,4523,0,2,0,4525,A
2-PB1,1451,0,4527,0,1,4528,T
2-PB1,1452,4394,0,0,0,4394,A
2-PB1,1453,4404,0,6,1,4411,A
2-PB1,1454,4394,0,2,0,4396,A
2-PB1,1455,1,4376,0,1,4378,T
2-PB1,1456,4334,1,3,0,4338,A
2-PB1,1457,4336,1,0,0,4337,A
2-PB1,1458,4348,1,1,1,4351,A
2-PB1,1459,4362,0,3,0,4365,A
2-PB1,1460,2,1,0,4366,4369,C
2-PB1,1461,4163,0,2,0,4165,A
2-PB1,1462,1,12,4153,0,4166,G
2-PB1,1463,1,13,4154,1,4169,G
2-PB1,1464,3,37,4127,0,4167,G
2-PB1,1465,4159,3,10,1,4173,A
2-PB1,1466,1,1,0,4202,4204,C
2-PB1,1467,4168,1,4,0,4173,A
2-PB1,1468,0,4193,0,5,4198,T
2-PB1,1469,0,4188,0,3,4191,T
2-PB1,1470,0,4193,0,2,4195,T
2-PB1,1471,1,39,4170,0,4210,G
2-PB1,1472,4172,0,9,0,4181,A
2-PB1,1473,4191,1,0,0,4192,A
2-PB1,1474,0,4181,0,3,4184,T
2-PB1,1475,0,4090,0,1,4091,T
2-PB1,1476,40,0,0,4070,4110,C
2-PB1,1477,4067,2,0,0,4069,A
2-PB1,1478,1,0,0,4078,4079,C
2-PB1,1479,0,4072,0,6,4078,T
2-PB1,1480,4075,0,1,0,4076,A
2-PB1,1481,0,3,4078,0,4081,G
2-PB1,1482,3,3,0,4072,4078,C
2-PB1,1483,0,4005,0,11,4016,T
2-PB1,1484,0,4073,0,4,4077,T
2-PB1,1485,0,4050,0,3,4053,T
2-PB1,1486,1,4060,0,0,4061,T
2-PB1,1487,1,4060,0,4,4065,T
2-PB1,1488,0,4058,0,5,4063,T
2-PB1,1489,0,4048,0,1,4049,T
2-PB1,1490,4046,0,2,0,4048,A
2-PB1,1491,1,4034,0,1,4036,T
2-PB1,1492,14,1,0,4027,4042,C
2-PB1,1493,6,17,4038,0,4061,G
2-PB1,1494,4178,0,1,0,4179,A
2-PB1,1495,1,4174,0,4,4179,T
2-PB1,1496,4194,2,1,0,4197,A
2-PB1,1497,0,4209,0,6,4215,T
2-PB1,1498,3,27,4195,0,4225,G
2-PB1,1499,1,24,4218,0,4243,G
2-PB1,1500,4236,0,8,1,4245,A
2-PB1,1501,1,4204,1,7,4213,T
2-PB1,1502,1,4167,0,0,4168,T
2-PB1,1503,0,4024,0,3,4027,T
2-PB1,1504,0,1,4031,0,4032,G
2-PB1,1505,1,4015,0,1,4017,T
2-PB1,1506,2,12,3994,0,4008,G
2-PB1,1507,3,3,3995,0,4001,G
2-PB1,1508,0,3,1,3971,3975,C
2-PB1,1509,1,3962,1,1,3965,T
2-PB1,1510,3975,0,1,0,3976,A
2-PB1,1511,3997,2,1,0,4000,A
2-PB1,1512,0,4017,1,1,4019,T
2-PB1,1513,0,4019,0,1,4020,T
2-PB1,1514,0,4020,1,0,4021,T
2-PB1,1515,0,4017,0,2,4019,T
2-PB1,1516,4007,0,4,1,4012,A
2-PB1,1517,2,0,4042,0,4044,G
2-PB1,1518,1,2,0,4039,4042,C
2-PB1,1519,4029,0,2,0,4031,A
2-PB1,1520,2,3984,0,4,3990,T
2-PB1,1521,3,26,3908,0,3937,G
2-PB1,1522,0,19,3972,0,3991,G
2-PB1,1523,3980,0,4,0,3984,A
2-PB1,1524,0,2,3990,0,3992,G
2-PB1,1525,0,0,0,3976,3976,C
2-PB1,1526,1,3914,1,2,3918,T
2-PB1,1527,1,5,3945,0,3951,G
2-PB1,1528,3,1,1,3933,3938,C
2-PB1,1529,22,2,0,3911,3935,C
2-PB1,1530,17,0,0,3936,3953,C
2-PB1,1531,3820,0,1,0,3821,A
2-PB1,1532,0,0,4028,0,4028,G
2-PB1,1533,0,4009,1,5,4015,T
2-PB1,1534,0,4002,1,4,4007,T
2-PB1,1535,0,3997,0,3,4000,T
2-PB1,1536,0,3942,1,5,3948,T
2-PB1,1537,0,11,3935,0,3946,G
2-PB1,1538,3,19,3930,0,3952,G
2-PB1,1539,3914,0,14,0,3928,A
2-PB1,1540,0,0,3930,0,3930,G
2-PB1,1541,0,3542,1,0,3543,T
2-PB1,1542,0,0,3682,0,3682,G
2-PB1,1543,0,3665,1,6,3672,T
2-PB1,1544,34,2,0,3639,3675,C
2-PB1,1545,0,3669,0,8,3677,T
2-PB1,1546,1,9,3685,0,3695,G
2-PB1,1547,0,24,3714,0,3738,G
2-PB1,1548,3733,0,3,0,3736,A
2-PB1,1549,3742,1,0,2,3745,A
2-PB1,1550,0,3720,0,1,3721,T
2-PB1,1551,3426,0,3,0,3429,A
2-PB1,1552,3417,0,5,0,3422,A
2-PB1,1553,3421,0,4,0,3425,A
2-PB1,1554,0,1,0,3428,3429,C
2-PB1,1555,3,26,3362,0,3391,G
2-PB1,1556,3330,0,1,0,3331,A
2-PB1,1557,1,2,3330,0,3333,G
2-PB1,1558,0,3313,0,5,3318,T
2-PB1,1559,36,1,0,3298,3335,C
2-PB1,1560,3322,0,3,0,3325,A
2-PB1,1561,5,1,3362,1,3369,G
2-PB1,1562,0,2,0,3363,3365,C
2-PB1,1563,0,3352,0,5,3357,T
2-PB1,1564,0,20,3435,0,3455,G
2-PB1,1565,3424,0,3,0,3427,A
2-PB1,1566,0,3418,0,1,3419,T
2-PB1,1567,3426,0,3,0,3429,A
2-PB1,1568,0,3351,0,2,3353,T
2-PB1,1569,1,31,3334,0,3366,G
2-PB1,1570,3226,2,4,0,3232,A
2-PB1,1571,2,1,3290,0,3293,G
2-PB1,1572,1,0,0,3296,3297,C
2-PB1,1573,3074,1,2,0,3077,A
2-PB1,1574,0,3076,0,2,3078,T
2-PB1,1575,0,3063,0,1,3064,T
2-PB1,1576,1,12,3092,0,3105,G
2-PB1,1577,1,15,3181,0,3197,G
2-PB1,1578,3110,2,9,0,3121,A
2-PB1,1579,3,0,3127,0,3130,G
2-PB1,1580,0,2993,0,3,2996,T
2-PB1,1581,2984,0,2,0,2986,A
2-PB1,1582,2986,0,1,0,2987,A
2-PB1,1583,0,2,0,3012,3014,C
2-PB1,1584,2983,1,2,0,2986,A
2-PB1,1585,0,1,3041,0,3042,G
2-PB1,1586,2,2686,0,5,2693,T
2-PB1,1587,1,21,2704,0,2726,G
2-PB1,1588,2742,0,4,0,2746,A
2-PB1,1589,0,2745,0,1,2746,T
2-PB1,1590,2730,0,1,0,2731,A
2-PB1,1591,2730,0,2,1,2733,A
2-PB1,1592,2646,0,8,0,2654,A
2-PB1,1593,0,17,2654,0,2671,G
2-PB1,1594,2498,0,3,1,2502,A
2-PB1,1595,2488,1,4,0,2493,A
2-PB1,1596,2,2,0,2497,2501,C
2-PB1,1597,2386,0,4,0,2390,A
2-PB1,1598,2415,0,4,0,2419,A
2-PB1,1599,1,1,0,2434,2436,C
2-PB1,1600,2452,0,3,0,2455,A
2-PB1,1601,1,2423,17,2,2443,T
2-PB1,1602,0,12,2369,0,2381,G
2-PB1,1603,2376,1,3,0,2380,A
2-PB1,1604,0,2378,0,1,2379,T
2-PB1,1605,2340,1,1,0,2342,A
2-PB1,1606,2346,1,4,1,2352,A
2-PB1,1607,2326,0,5,0,2331,A
2-PB1,1608,0,0,0,2341,2341,C
2-PB1,1609,2198,1,2,0,2201,A
2-PB1,1610,2197,0,1,0,2198,A
2-PB1,1611,0,2152,0,2,2154,T
2-PB1,1612,1,26,2122,0,2149,G
2-PB1,1613,2187,0,3,0,2190,A
2-PB1,1614,0,1,0,2218,2219,C
2-PB1,1615,8,0,0,2168,2176,C
2-PB1,1616,1,2064,0,2,2067,T
2-PB1,1617,0,2011,0,9,2020,T
2-PB1,1618,0,12,2005,0,2017,G
2-PB1,1619,1,18,2017,1,2037,G
2-PB1,1620,2056,1,4,0,2061,A
2-PB1,1621,0,0,0,2060,2060,C
2-PB1,1622,4,1,0,2032,2037,C
2-PB1,1623,2016,2,1,0,2019,A
2-PB1,1624,3,1,2038,0,2042,G
2-PB1,1625,2,2,0,2048,2052,C
2-PB1,1626,2050,1,2,0,2053,A
2-PB1,1627,2048,1,1,0,2050,A
2-PB1,1628,1,0,0,2047,2048,C
2-PB1,1629,2024,0,3,0,2027,A
2-PB1,1630,1,0,2057,0,2058,G
2-PB1,1631,2,1,0,2054,2057,C
2-PB1,1632,8,0,0,2047,2055,C
2-PB1,1633,10,0,0,2041,2051,C
2-PB1,1634,2054,1,0,0,2055,A
2-PB1,1635,2050,0,3,1,2054,A
2-PB1,1636,2050,0,2,0,2052,A
2-PB1,1637,0,2057,0,0,2057,T
2-PB1,1638,0,7,2037,0,2044,G
2-PB1,1639,0,2,2035,0,2037,G
2-PB1,1640,2,0,0,2039,2041,C
2-PB1,1641,2,2011,0,5,2018,T
2-PB1,1642,4,0,0,2062,2066,C
2-PB1,1643,1,2072,0,2,2075,T
2-PB1,1644,11,0,0,2075,2086,C
2-PB1,1645,4,1,0,2087,2092,C
2-PB1,1646,2095,0,0,0,2095,A
2-PB1,1647,2097,0,1,0,2098,A
2-PB1,1648,2,2083,0,3,2088,T
2-PB1,1649,0,2063,0,0,2063,T
2-PB1,1650,1,0,2084,0,2085,G
2-PB1,1651,0,2045,0,1,2046,T
2-PB1,1652,1,2040,0,3,2044,T
2-PB1,1653,22,7,0,2016,2045,C
2-PB1,1654,2035,0,0,1,2036,A
2-PB1,1655,0,2040,0,2,2042,T
2-PB1,1656,2,1,0,2040,2043,C
2-PB1,1657,2044,0,2,0,2046,A
2-PB1,1658,2043,0,1,0,2044,A
2-PB1,1659,2042,0,4,0,2046,A
2-PB1,1660,0,7,2079,0,2086,G
2-PB1,1661,2087,0,1,0,2088,A
2-PB1,1662,0,2086,0,1,2087,T
2-PB1,1663,0,2094,0,1,2095,T
2-PB1,1664,2105,0,1,0,2106,A
2-PB1,1665,0,0,0,2148,2148,C
2-PB1,1666,2128,1,2,0,2131,A
2-PB1,1667,0,5,2157,0,2162,G
2-PB1,1668,2105,0,57,0,2162,A
2-PB1,1669,0,2200,0,0,2200,T
2-PB1,1670,2203,1,1,0,2205,A
2-PB1,1671,0,1,0,2334,2335,C
2-PB1,1672,2370,0,9,1,2380,A
2-PB1,1673,0,1,0,2540,2541,C
2-PB1,1674,2487,0,6,0,2493,A
2-PB1,1675,1,2515,1,0,2517,T
2-PB1,1676,2487,0,3,0,2490,A
2-PB1,1677,1,2484,0,0,2485,T
2-PB1,1678,2441,0,2,1,2444,A
2-PB1,1679,1,6,2443,0,2450,G
2-PB1,1680,0,2,2425,0,2427,G
2-PB1,1681,0,2317,0,1,2318,T
2-PB1,1682,0,2,2291,0,2293,G
2-PB1,1683,2,0,0,2372,2374,C
2-PB1,1684,7,1,0,2360,2368,C
2-PB1,1685,2410,0,1,0,2411,A
2-PB1,1686,0,2409,0,1,2410,T
2-PB1,1687,2420,0,0,0,2420,A
2-PB1,1688,0,6,2422,0,2428,G
2-PB1,1689,2359,0,6,0,2365,A
2-PB1,1690,1,4,2374,0,2379,G
2-PB1,1691,0,10,2371,0,2381,G
2-PB1,1692,2297,0,4,0,2301,A
2-PB1,1693,1,26,2281,0,2308,G
2-PB1,1694,2294,0,4,0,2298,A
2-PB1,1695,0,1,0,2304,2305,C
2-PB1,1696,2291,0,4,0,2295,A
2-PB1,1697,1,2,0,2322,2325,C
2-PB1,1698,2315,0,3,0,2318,A
2-PB1,1699,0,0,0,2320,2320,C
2-PB1,1700,2287,1,2,0,2290,A
2-PB1,1701,2304,0,0,0,2304,A
2-PB1,1702,2324,0,0,0,2324,A
2-PB1,1703,0,2321,0,0,2321,T
2-PB1,1704,10,0,0,2312,2322,C
2-PB1,1705,6,0,0,2313,2319,C
2-PB1,1706,2289,0,2,0,2291,A
2-PB1,1707,0,12,2284,0,2296,G
2-PB1,1708,2295,0,2,0,2297,A
2-PB1,1709,1,1,0,2315,2317,C
2-PB1,1710,0,20,2295,0,2315,G
2-PB1,1711,2293,2,3,1,2299,A
2-PB1,1712,0,7,2294,1,2302,G
2-PB1,1713,2301,0,5,0,2306,A
2-PB1,1714,2293,0,6,0,2299,A
2-PB1,1715,2,9,2308,0,2319,G
2-PB1,1716,2306,0,3,0,2309,A
2-PB1,1717,0,2300,0,2,2302,T
2-PB1,1718,20,1,0,2270,2291,C
2-PB1,1719,2293,1,0,1,2295,A
2-PB1,1720,0,2284,1,0,2285,T
2-PB1,1721,0,2279,0,0,2279,T
2-PB1,1722,21,1,0,2254,2276,C
2-PB1,1723,0,12,2280,0,2292,G
2-PB1,1724,2276,0,2,0,2278,A
2-PB1,1725,0,10,2270,0,2280,G
2-PB1,1726,2267,1,2,0,2270,A
2-PB1,1727,0,2341,0,1,2342,T
2-PB1,1728,2352,0,0,0,2352,A
2-PB1,1729,2359,0,1,0,2360,A
2-PB1,1730,2359,0,0,0,2359,A
2-PB1,1731,0,9,2358,0,2367,G
2-PB1,1732,2358,1,2,0,2361,A
2-PB1,1733,2297,1,3,0,2301,A
2-PB1,1734,0,1,2316,0,2317,G
2-PB1,1735,2,0,0,2318,2320,C
2-PB1,1736,1,2298,1,2,2302,T
2-PB1,1737,1,0,2310,0,2311,G
2-PB1,1738,0,2300,1,1,2302,T
2-PB1,1739,2,12,2283,1,2298,G
2-PB1,1740,0,8,2294,0,2302,G
2-PB1,1741,0,9,2309,0,2318,G
2-PB1,1742,2317,0,1,0,2318,A
2-PB1,1743,1,2277,1,27,2306,T
2-PB1,1744,12,0,0,2285,2297,C
2-PB1,1745,2287,0,3,0,2290,A
2-PB1,1746,2297,0,2,0,2299,A
2-PB1,1747,2321,0,1,0,2322,A
2-PB1,1748,1,0,0,2320,2321,C
2-PB1,1749,7,1,0,2307,2315,C
2-PB1,1750,6,1,0,2296,2303,C
2-PB1,1751,2306,0,2,0,2308,A
2-PB1,1752,2338,0,2,0,2340,A
2-PB1,1753,0,2333,1,1,2335,T
2-PB1,1754,15,0,0,2328,2343,C
2-PB1,1755,2319,0,1,0,2320,A
2-PB1,1756,2307,0,3,0,2310,A
2-PB1,1757,0,11,2330,0,2341,G
2-PB1,1758,0,7,2322,0,2329,G
2-PB1,1759,0,1,2327,0,2328,G
2-PB1,1760,4,0,0,2320,2324,C
2-PB1,1761,2265,0,3,0,2268,A
2-PB1,1762,0,6,2313,1,2320,G
2-PB1,1763,0,6,2335,0,2341,G
2-PB1,1764,2341,1,2,0,2344,A
2-PB1,1765,0,1,0,2360,2361,C
2-PB1,1766,0,2321,0,0,2321,T
2-PB1,1767,2369,2,2,0,2373,A
2-PB1,1768,0,2365,0,1,2366,T
2-PB1,1769,0,2369,0,1,2370,T
2-PB1,1770,3,7,2366,0,2376,G
2-PB1,1771,0,1,2368,1,2370,G
2-PB1,1772,0,2352,0,0,2352,T
2-PB1,1773,2350,1,2,0,2353,A
2-PB1,1774,1,2324,1,1,2327,T
2-PB1,1775,11,6,0,2322,2339,C
2-PB1,1776,2302,0,3,0,2305,A
2-PB1,1777,0,2,2324,0,2326,G
2-PB1,1778,2315,1,3,1,2320,A
2-PB1,1779,0,2303,1,0,2304,T
2-PB1,1780,2,6,2235,1,2244,G
2-PB1,1781,0,5,2231,0,2236,G
2-PB1,1782,1,5,2233,0,2239,G
2-PB1,1783,3,8,2246,0,2257,G
2-PB1,1784,1,17,2224,0,2242,G
2-PB1,1785,2238,0,3,0,2241,A
2-PB1,1786,3,0,0,2240,2243,C
2-PB1,1787,13,1,1,2201,2216,C
2-PB1,1788,2210,0,0,0,2210,A
2-PB1,1789,2350,0,0,0,2350,A
2-PB1,1790,2358,1,5,0,2364,A
2-PB1,1791,0,0,0,2423,2423,C
2-PB1,1792,1,2397,0,1,2399,T
2-PB1,1793,0,2390,1,2,2393,T
2-PB1,1794,2397,0,0,0,2397,A
2-PB1,1795,0,2372,0,19,2391,T
2-PB1,1796,2392,0,4,0,2396,A
2-PB1,1797,0,1,0,2399,2400,C
2-PB1,1798,2198,0,0,0,2198,A
2-PB1,1799,2208,0,3,0,2211,A
2-PB1,1800,0,2131,0,0,2131,T
2-PB1,1801,2159,0,1,0,2160,A
2-PB1,1802,0,2163,0,0,2163,T
2-PB1,1803,6,0,1,2143,2150,C
2-PB1,1804,9,2,0,2143,2154,C
2-PB1,1805,5,4,2152,0,2161,G
2-PB1,1806,0,9,2149,0,2158,G
2-PB1,1807,2163,1,1,0,2165,A
2-PB1,1808,2152,2,2,0,2156,A
2-PB1,1809,1,2153,0,2,2156,T
2-PB1,1810,3,0,0,2129,2132,C
2-PB1,1811,0,2120,2,4,2126,T
2-PB1,1812,6,2,0,2110,2118,C
2-PB1,1813,1,0,0,2164,2165,C
2-PB1,1814,2165,1,2,0,2168,A
2-PB1,1815,2,2,1,2179,2184,C
2-PB1,1816,2171,0,3,0,2174,A
2-PB1,1817,0,2389,1,1,2391,T
2-PB1,1818,3,1,0,2390,2394,C
2-PB1,1819,14,0,0,2385,2399,C
2-PB1,1820,4,1,1,2402,2408,C
2-PB1,1821,0,2389,0,7,2396,T
2-PB1,1822,1,9,2392,0,2402,G
2-PB1,1823,2400,0,2,0,2402,A
2-PB1,1824,2385,0,0,0,2385,A
2-PB1,1825,1,0,2397,0,2398,G
2-PB1,1826,0,2234,0,6,2240,T
2-PB1,1827,10,0,0,2233,2243,C
2-PB1,1828,0,2208,0,0,2208,T
2-PB1,1829,0,4,2248,0,2252,G
2-PB1,1830,0,0,0,2252,2252,C
2-PB1,1831,1,2243,0,6,2250,T
2-PB1,1832,1,2260,0,0,2261,T
2-PB1,1833,2257,1,1,0,2259,A
2-PB1,1834,2253,1,1,0,2255,A
2-PB1,1835,2250,0,1,0,2251,A
2-PB1,1836,2186,0,3,0,2189,A
2-PB1,1837,1,2209,0,2,2212,T
2-PB1,1838,0,6,2204,1,2211,G
2-PB1,1839,0,14,2199,0,2213,G
2-PB1,1840,1,11,2213,0,2225,G
2-PB1,1841,2211,0,8,0,2219,A
2-PB1,1842,1,1,2230,0,2232,G
2-PB1,1843,5,0,0,2221,2226,C
2-PB1,1844,0,2221,0,2,2223,T
2-PB1,1845,2,7,2219,0,2228,G
2-PB1,1846,2226,1,3,0,2230,A
2-PB1,1847,0,2220,1,3,2224,T
2-PB1,1848,0,8,2232,0,2240,G
2-PB1,1849,0,2,2237,0,2239,G
2-PB1,1850,2232,0,2,0,2234,A
2-PB1,1851,1,2226,0,2,2229,T
2-PB1,1852,0,17,2211,0,2228,G
2-PB1,1853,2213,0,5,0,2218,A
2-PB1,1854,0,19,2231,0,2250,G
2-PB1,1855,2243,0,2,0,2245,A
2-PB1,1856,2240,0,2,0,2242,A
2-PB1,1857,0,2238,0,1,2239,T
2-PB1,1858,0,2222,0,1,2223,T
2-PB1,1859,2227,0,1,2,2230,A
2-PB1,1860,1,2226,0,2,2229,T
2-PB1,1861,8,3,1,2215,2227,C
2-PB1,1862,2,4,2233,0,2239,G
2-PB1,1863,0,14,2205,0,2219,G
2-PB1,1864,1,3,2210,0,2214,G
2-PB1,1865,0,8,2203,0,2211,G
2-PB1,1866,2207,0,1,0,2208,A
2-PB1,1867,2209,0,5,0,2214,A
2-PB1,1868,0,6,2227,0,2233,G
2-PB1,1869,2244,0,1,0,2245,A
2-PB1,1870,0,1,0,2268,2269,C
2-PB1,1871,0,2228,0,5,2233,T
2-PB1,1872,0,2263,0,1,2264,T
2-PB1,1873,0,2269,1,0,2270,T
2-PB1,1874,2,0,2282,0,2284,G
2-PB1,1875,0,2285,0,2,2287,T
2-PB1,1876,2268,0,0,0,2268,A
2-PB1,1877,2261,0,4,0,2265,A
2-PB1,1878,0,2223,0,2,2225,T
2-PB1,1879,12,0,0,2242,2254,C
2-PB1,1880,14,0,0,2239,2253,C
2-PB1,1881,12,1,0,2230,2243,C
2-PB1,1882,5,0,0,2257,2262,C
2-PB1,1883,1,2238,0,4,2243,T
2-PB1,1884,0,18,2239,0,2257,G
2-PB1,1885,2252,1,0,0,2253,A
2-PB1,1886,2262,0,1,0,2263,A
2-PB1,1887,0,2246,0,16,2262,T
2-PB1,1888,11,1,0,2237,2249,C
2-PB1,1889,6,1,1,2225,2233,C
2-PB1,1890,11,0,0,2215,2226,C
2-PB1,1891,1,2205,0,1,2207,T
2-PB1,1892,0,2215,0,2,2217,T
2-PB1,1893,1,2201,0,2,2204,T
2-PB1,1894,1,0,2206,0,2207,G
2-PB1,1895,0,2193,0,1,2194,T
2-PB1,1896,18,0,0,2177,2195,C
2-PB1,1897,2167,1,4,0,2172,A
2-PB1,1898,0,2,2200,0,2202,G
2-PB1,1899,1,0,0,2205,2206,C
2-PB1,1900,5,2,1,2192,2200,C
2-PB1,1901,2206,0,0,1,2207,A
2-PB1,1902,1,2216,1,1,2219,T
2-PB1,1903,2217,0,0,0,2217,A
2-PB1,1904,2219,0,2,0,2221,A
2-PB1,1905,2214,1,12,0,2227,A
2-PB1,1906,1,7,2254,0,2262,G
2-PB1,1907,2196,0,3,0,2199,A
2-PB1,1908,2198,0,0,0,2198,A
2-PB1,1909,2206,0,0,0,2206,A
2-PB1,1910,0,2202,0,0,2202,T
2-PB1,1911,0,2188,0,1,2189,T
2-PB1,1912,1,13,2184,0,2198,G
2-PB1,1913,2180,1,4,0,2185,A
2-PB1,1914,13,1,2203,0,2217,G
2-PB1,1915,0,2205,0,4,2209,T
2-PB1,1916,13,0,0,2213,2226,C
2-PB1,1917,0,2207,0,5,2212,T
2-PB1,1918,1,0,2266,0,2267,G
2-PB1,1919,0,2261,0,4,2265,T
2-PB1,1920,2300,0,0,0,2300,A
2-PB1,1921,2303,0,3,0,2306,A
2-PB1,1922,2296,0,4,1,2301,A
2-PB1,1923,2,2,0,2302,2306,C
2-PB1,1924,2233,0,2,0,2235,A
2-PB1,1925,2277,0,2,0,2279,A
2-PB1,1926,0,2283,0,1,2284,T
2-PB1,1927,0,2,2292,0,2294,G
2-PB1,1928,1,0,0,2303,2304,C
2-PB1,1929,1,2271,1,3,2276,T
2-PB1,1930,2,1,2355,0,2358,G
2-PB1,1931,1,2349,1,1,2352,T
2-PB1,1932,2409,0,1,0,2410,A
2-PB1,1933,2,1,2413,0,2416,G
2-PB1,1934,1,2345,0,2,2348,T
2-PB1,1935,2338,1,0,0,2339,A
2-PB1,1936,2321,0,3,0,2324,A
2-PB1,1937,0,2313,0,1,2314,T
2-PB1,1938,1,4,2307,0,2312,G
2-PB1,1939,0,1,0,2297,2298,C
2-PB1,1940,3,1,0,2261,2265,C
2-PB1,1941,2225,0,1,0,2226,A
2-PB1,1942,1,1,2268,0,2270,G
2-PB1,1943,0,0,0,2305,2305,C
2-PB1,1944,1,0,0,2317,2318,C
2-PB1,1945,7,2,1,2301,2311,C
2-PB1,1946,2298,0,1,0,2299,A
2-PB1,1947,0,2292,0,2,2294,T
2-PB1,1948,1,11,2287,0,2299,G
2-PB1,1949,0,0,2320,0,2320,G
2-PB1,1950,0,2317,0,1,2318,T
2-PB1,1951,18,0,0,2248,2266,C
2-PB1,1952,8,0,0,2223,2231,C
2-PB1,1953,1,2211,0,3,2215,T
2-PB1,1954,2,2,2264,0,2268,G
2-PB1,1955,1,1,0,2260,2262,C
2-PB1,1956,13,1,0,2256,2270,C
2-PB1,1957,2265,0,2,0,2267,A
2-PB1,1958,2233,0,0,0,2233,A
2-PB1,1959,2239,0,0,0,2239,A
2-PB1,1960,2239,0,5,0,2244,A
2-PB1,1961,0,1,2270,0,2271,G
2-PB1,1962,0,2248,0,1,2249,T
2-PB1,1963,2245,0,0,0,2245,A
2-PB1,1964,0,2240,0,0,2240,T
2-PB1,1965,2,7,2237,0,2246,G
2-PB1,1966,0,12,2278,0,2290,G
2-PB1,1967,2278,0,1,1,2280,A
2-PB1,1968,2294,0,1,0,2295,A
2-PB1,1969,1,2286,0,0,2287,T
2-PB1,1970,2249,0,2,0,2251,A
2-PB1,1971,1,2242,0,4,2247,T
2-PB1,1972,1,10,2215,0,2226,G
2-PB1,1973,2224,1,3,0,2228,A
2-PB1,1974,2,2211,0,1,2214,T
2-PB1,1975,2,6,2157,0,2165,G
2-PB1,1976,0,0,0,2174,2174,C
2-PB1,1977,5,0,0,2142,2147,C
2-PB1,1978,6,0,2151,0,2157,G
2-PB1,1979,0,2146,0,3,2149,T
2-PB1,1980,0,2140,0,4,2144,T
2-PB1,1981,2,0,2151,1,2154,G
2-PB1,1982,3,1,0,2187,2191,C
2-PB1,1983,2184,0,6,1,2191,A
2-PB1,1984,2231,0,2,0,2233,A
2-PB1,1985,0,0,0,2237,2237,C
2-PB1,1986,0,2215,0,2,2217,T
2-PB1,1987,2230,0,0,0,2230,A
2-PB1,1988,2,2,0,2225,2229,C
2-PB1,1989,2225,0,4,0,2229,A
2-PB1,1990,0,0,1,2231,2232,C
2-PB1,1991,2157,1,0,1,2159,A
2-PB1,1992,0,0,0,2330,2330,C
2-PB1,1993,0,2283,0,2,2285,T
2-PB1,1994,13,0,1,2275,2289,C
2-PB1,1995,3,0,0,2293,2296,C
2-PB1,1996,0,2276,1,2,2279,T
2-PB1,1997,0,4,2278,0,2282,G
2-PB1,1998,0,5,2273,0,2278,G
2-PB1,1999,2277,0,4,1,2282,A
2-PB1,2000,0,2274,1,1,2276,T
2-PB1,2001,0,2069,1,2,2072,T
2-PB1,2002,9,1,0,2087,2097,C
2-PB1,2003,1,0,0,2090,2091,C
2-PB1,2004,8,2,0,2091,2101,C
2-PB1,2005,2106,0,1,0,2107,A
2-PB1,2006,2101,0,2,0,2103,A
2-PB1,2007,0,5,2107,0,2112,G
2-PB1,2008,2098,0,4,0,2102,A
2-PB1,2009,2,4,2089,1,2096,G
2-PB1,2010,0,8,2095,0,2103,G
2-PB1,2011,2064,0,3,0,2067,A
2-PB1,2012,2057,0,4,8,2069,A
2-PB1,2013,0,2,0,2068,2070,C
2-PB1,2014,6,0,0,2050,2056,C
2-PB1,2015,2,2,2079,0,2083,G
2-PB1,2016,1,0,0,2077,2078,C
2-PB1,2017,0,2070,0,1,2071,T
2-PB1,2018,13,0,0,2059,2072,C
2-PB1,2019,0,2048,0,8,2056,T
2-PB1,2020,2201,0,1,0,2202,A
2-PB1,2021,0,2199,0,4,2203,T
2-PB1,2022,2,2206,0,5,2213,T
2-PB1,2023,14,0,1,2208,2223,C
2-PB1,2024,0,2129,2,4,2135,T
2-PB1,2025,2139,1,0,0,2140,A
2-PB1,2026,2132,1,1,0,2134,A
2-PB1,2027,2140,0,1,1,2142,A
2-PB1,2028,1,0,0,2142,2143,C
2-PB1,2029,1970,0,0,0,1970,A
2-PB1,2030,0,0,0,1971,1971,C
2-PB1,2031,1950,0,1,0,1951,A
2-PB1,2032,1971,0,3,0,1974,A
2-PB1,2033,2,4,1969,0,1975,G
2-PB1,2034,3,1,0,1970,1974,C
2-PB1,2035,9,1,0,1969,1979,C
2-PB1,2036,1964,0,3,0,1967,A
2-PB1,2037,1959,0,3,0,1962,A
2-PB1,2038,1957,1,3,1,1962,A
2-PB1,2039,0,3,1980,0,1983,G
2-PB1,2040,1,6,1971,0,1978,G
2-PB1,2041,1,6,1943,0,1950,G
2-PB1,2042,0,13,1946,0,1959,G
2-PB1,2043,1931,0,2,0,1933,A
2-PB1,2044,1954,0,3,0,1957,A
2-PB1,2045,0,1956,0,0,1956,T
2-PB1,2046,0,1951,0,4,1955,T
2-PB1,2047,8,1,0,1949,1958,C
2-PB1,2048,0,1938,0,1,1939,T
2-PB1,2049,0,1938,0,0,1938,T
2-PB1,2050,0,5,1935,0,1940,G
2-PB1,2051,1938,0,1,0,1939,A
2-PB1,2052,2,6,1937,0,1945,G
2-PB1,2053,0,5,1926,0,1931,G
2-PB1,2054,1939,1,1,0,1941,A
2-PB1,2055,1,1922,0,1,1924,T
2-PB1,2056,0,28,1903,0,1931,G
2-PB1,2057,1922,1,3,0,1926,A
2-PB1,2058,1911,0,13,0,1924,A
2-PB1,2059,1,0,1,1935,1937,C
2-PB1,2060,1912,0,3,1,1916,A
2-PB1,2061,0,7,1943,0,1950,G
2-PB1,2062,1938,0,3,0,1941,A
2-PB1,2063,0,1931,0,0,1931,T
2-PB1,2064,0,2,1946,0,1948,G
2-PB1,2065,0,1988,0,2,1990,T
2-PB1,2066,1993,0,4,0,1997,A
2-PB1,2067,2,0,0,1985,1987,C
2-PB1,2068,10,0,0,1971,1981,C
2-PB1,2069,1956,1,2,0,1959,A
2-PB1,2070,1,3,1944,0,1948,G
2-PB1,2071,1928,0,1,0,1929,A
2-PB1,2072,1921,0,1,0,1922,A
2-PB1,2073,0,0,1937,0,1937,G
2-PB1,2074,0,1815,0,0,1815,T
2-PB1,2075,1,1,1821,0,1823,G
2-PB1,2076,0,1,0,1826,1827,C
2-PB1,2077,1,1820,0,2,1823,T
2-PB1,2078,3,2,1818,0,1823,G
2-PB1,2079,1,1,0,1811,1813,C
2-PB1,2080,1810,0,0,0,1810,A
2-PB1,2081,1808,1,2,0,1811,A
2-PB1,2082,0,0,0,1792,1792,C
2-PB1,2083,0,1788,0,3,1791,T
2-PB1,2084,0,1769,0,0,1769,T
2-PB1,2085,0,0,1766,0,1766,G
2-PB1,2086,1,1759,0,1,1761,T
2-PB1,2087,0,1757,0,1,1758,T
2-PB1,2088,21,2,1,1734,1758,C
2-PB1,2089,2,11,1746,0,1759,G
2-PB1,2090,1756,1,1,0,1758,A
2-PB1,2091,0,5,1752,1,1758,G
2-PB1,2092,1754,0,1,1,1756,A
2-PB1,2093,1749,0,1,0,1750,A
2-PB1,2094,1756,0,0,0,1756,A
2-PB1,2095,0,1758,0,0,1758,T
2-PB1,2096,1,1755,1,0,1757,T
2-PB1,2097,0,1762,1,1,1764,T
2-PB1,2098,0,1766,0,1,1767,T
2-PB1,2099,4,1758,0,1,1763,T
2-PB1,2100,6,0,0,1766,1772,C
2-PB1,2101,5,0,0,1766,1771,C
2-PB1,2102,10,3,1,1757,1771,C
2-PB1,2103,0,1767,1,2,1770,T
2-PB1,2104,1769,0,0,0,1769,A
2-PB1,2105,0,0,1781,0,1781,G
2-PB1,2106,1,1780,0,1,1782,T
2-PB1,2107,1792,0,1,0,1793,A
2-PB1,2108,0,1,1802,0,1803,G
2-PB1,2109,0,1775,0,1,1776,T
2-PB1,2110,0,1849,1,3,1853,T
2-PB1,2111,18,1,0,1853,1872,C
2-PB1,2112,1885,1,3,2,1891,A
2-PB1,2113,0,1890,0,1,1891,T
2-PB1,2114,1884,0,0,0,1884,A
2-PB1,2115,0,1886,1,1,1888,T
2-PB1,2116,1826,0,2,0,1828,A
2-PB1,2117,0,2,1811,0,1813,G
2-PB1,2118,0,6,1796,0,1802,G
2-PB1,2119,1600,1,4,0,1605,A
2-PB1,2120,0,13,1590,0,1603,G
2-PB1,2121,1517,0,3,0,1520,A
2-PB1,2122,0,1,0,1517,1518,C
2-PB1,2123,7,0,1,1466,1474,C
2-PB1,2124,2,7,1464,0,1473,G
2-PB1,2125,1467,0,1,0,1468,A
2-PB1,2126,0,1461,0,0,1461,T
2-PB1,2127,0,1463,0,0,1463,T
2-PB1,2128,1,0,1461,0,1462,G
2-PB1,2129,1,6,1457,0,1464,G
2-PB1,2130,1467,0,0,0,1467,A
2-PB1,2131,1465,0,2,0,1467,A
2-PB1,2132,0,1463,0,0,1463,T
2-PB1,2133,0,1464,0,2,1466,T
2-PB1,2134,0,1458,0,1,1459,T
2-PB1,2135,9,0,0,1457,1466,C
2-PB1,2136,0,1461,1,1,1463,T
2-PB1,2137,1456,1,3,0,1460,A
2-PB1,2138,0,1,1461,0,1462,G
2-PB1,2139,1,0,0,1455,1456,C
2-PB1,2140,1457,0,1,0,1458,A
2-PB1,2141,1,1458,1,0,1460,T
2-PB1,2142,0,4,1444,0,1448,G
2-PB1,2143,0,0,1490,0,1490,G
2-PB1,2144,1,1486,1,0,1488,T
2-PB1,2145,0,5,1481,0,1486,G
2-PB1,2146,1,3,1483,0,1487,G
2-PB1,2147,1477,0,2,0,1479,A
2-PB1,2148,1,1,1481,0,1483,G
2-PB1,2149,1,1,1478,0,1480,G
2-PB1,2150,0,0,0,1464,1464,C
2-PB1,2151,6,1,0,1452,1459,C
2-PB1,2152,1368,0,3,0,1371,A
2-PB1,2153,0,1366,0,1,1367,T
2-PB1,2154,0,1,1373,0,1374,G
2-PB1,2155,0,0,1386,0,1386,G
2-PB1,2156,0,1357,1,0,1358,T
2-PB1,2157,0,0,1377,0,1377,G
2-PB1,2158,0,1341,1,4,1346,T
2-PB1,2159,12,0,0,1326,1338,C
2-PB1,2160,0,1327,1,0,1328,T
2-PB1,2161,1315,0,0,0,1315,A
2-PB1,2162,2,1,1312,0,1315,G
2-PB1,2163,0,2,1285,0,1287,G
2-PB1,2164,2,1,1252,0,1255,G
2-PB1,2165,0,3,0,1227,1230,C
2-PB1,2166,7,0,1,1170,1178,C
2-PB1,2167,3,1,0,1153,1157,C
2-PB1,2168,1,4,1157,0,1162,G
2-PB1,2169,0,6,1155,0,1161,G
2-PB1,2170,1158,0,1,0,1159,A
2-PB1,2171,0,1159,0,0,1159,T
2-PB1,2172,0,1116,0,0,1116,T
2-PB1,2173,0,7,1096,0,1103,G
2-PB1,2174,1101,0,1,0,1102,A
2-PB1,2175,0,1106,0,0,1106,T
2-PB1,2176,0,1,1103,0,1104,G
2-PB1,2177,3,0,0,1089,1092,C
2-PB1,2178,2,1,0,1087,1090,C
2-PB1,2179,1076,0,1,1,1078,A
2-PB1,2180,0,7,1071,0,1078,G
2-PB1,2181,1077,0,0,0,1077,A
2-PB1,2182,1079,0,0,0,1079,A
2-PB1,2183,0,1075,0,0,1075,T
2-PB1,2184,1,1046,0,2,1049,T
2-PB1,2185,0,16,1035,0,1051,G
2-PB1,2186,1037,1,3,0,1041,A
2-PB1,2187,2,0,0,1041,1043,C
2-PB1,2188,0,1030,0,1,1031,T
2-PB1,2189,0,1021,1,0,1022,T
2-PB1,2190,4,0,0,1003,1007,C
2-PB1,2191,0,3,1002,0,1005,G
2-PB1,2192,1007,0,0,0,1007,A
2-PB1,2193,0,0,982,0,982,G
2-PB1,2194,0,986,0,1,987,T
2-PB1,2195,14,0,0,976,990,C
2-PB1,2196,0,989,0,2,991,T
2-PB1,2197,0,2,989,0,991,G
2-PB1,2198,0,2,988,0,990,G
2-PB1,2199,990,0,0,0,990,A
2-PB1,2200,913,0,2,0,915,A
2-PB1,2201,0,1,916,0,917,G
2-PB1,2202,0,1,925,0,926,G
2-PB1,2203,926,0,0,0,926,A
2-PB1,2204,0,922,1,0,923,T
2-PB1,2205,1,926,0,1,928,T
2-PB1,2206,920,0,1,0,921,A
2-PB1,2207,918,0,2,0,920,A
2-PB1,2208,0,0,924,0,924,G
2-PB1,2209,919,0,0,0,919,A
2-PB1,2210,913,0,0,0,913,A
2-PB1,2211,785,0,3,0,788,A
2-PB1,2212,0,0,793,0,793,G
2-PB1,2213,786,4,2,1,793,A
2-PB1,2214,790,0,3,0,793,A
2-PB1,2215,0,6,788,0,794,G
2-PB1,2216,745,0,0,0,745,A
2-PB1,2217,0,0,749,0,749,G
2-PB1,2218,0,715,0,0,715,T
2-PB1,2219,1,708,0,0,709,T
2-PB1,2220,7,0,1,711,719,C
2-PB1,2221,0,706,0,4,710,T
2-PB1,2222,5,0,0,703,708,C
2-PB1,2223,0,706,0,0,706,T
2-PB1,2224,0,4,706,0,710,G
2-PB1,2225,686,1,1,0,688,A
2-PB1,2226,0,2,680,0,682,G
2-PB1,2227,671,0,1,0,672,A
2-PB1,2228,0,659,0,1,660,T
2-PB1,2229,12,0,0,606,618,C
2-PB1,2230,618,0,0,0,618,A
2-PB1,2231,1,611,0,1,613,T
2-PB1,2232,0,0,613,0,613,G
2-PB1,2233,610,0,1,0,611,A
2-PB1,2234,606,0,3,0,609,A
2-PB1,2235,1,2,596,0,599,G
2-PB1,2236,586,0,1,0,587,A
2-PB1,2237,0,583,0,1,584,T
2-PB1,2238,2,1,0,573,576,C
2-PB1,2239,0,537,0,0,537,T
2-PB1,2240,1,0,540,0,541,G
2-PB1,2241,0,539,0,1,540,T
2-PB1,2242,0,539,0,0,539,T
2-PB1,2243,9,0,0,527,536,C
2-PB1,2244,1,0,0,510,511,C
2-PB1,2245,505,0,2,0,507,A
2-PB1,2246,0,0,0,513,513,C
2-PB1,2247,7,0,0,480,487,C
2-PB1,2248,480,0,0,0,480,A
2-PB1,2249,0,449,0,1,450,T
2-PB1,2250,0,435,0,0,435,T
2-PB1,2251,0,0,435,0,435,G
2-PB1,2252,435,0,0,0,435,A
2-PB1,2253,430,0,1,0,431,A
2-PB1,2254,1,0,432,0,433,G
2-PB1,2255,362,0,1,0,363,A
2-PB1,2256,362,0,0,0,362,A
2-PB1,2257,0,1,0,358,359,C
2-PB1,2258,0,343,0,1,344,T
2-PB1,2259,1,0,0,343,344,C
2-PB1,2260,328,0,0,0,328,A
2-PB1,2261,0,0,327,0,327,G
2-PB1,2262,325,0,1,0,326,A
2-PB1,2263,0,0,0,309,309,C
2-PB1,2264,0,0,300,0,300,G
2-PB1,2265,1,0,290,0,291,G
2-PB1,2266,0,0,0,287,287,C
2-PB1,2267,286,0,0,0,286,A
2-PB1,2268,287,0,0,0,287,A
2-PB1,2269,286,0,0,0,286,A
2-PB1,2270,287,0,0,0,287,A
2-PB1,2271,286,0,0,0,286,A
2-PB1,2272,0,282,0,0,282,T
2-PB1,2273,272,0,0,0,272,A
2-PB1,2274,270,0,0,0,270,A
3-PA,1,27,0,0,0,27,A
3-PA,2,0,28,0,0,28,T
3-PA,3,0,0,29,0,29,G
3-PA,4,0,0,29,0,29,G
3-PA,5,29,0,0,0,29,A
3-PA,6,29,0,0,0,29,A
3-PA,7,0,1,28,0,29,G
3-PA,8,30,0,0,0,30,A
3-PA,9,0,30,0,0,30,T
3-PA,10,0,30,0,0,30,T
3-PA,11,0,31,0,0,31,T
3-PA,12,0,31,0,0,31,T
3-PA,13,0,0,32,0,32,G
3-PA,14,0,32,0,0,32,T
3-PA,15,0,0,32,0,32,G
3-PA,16,0,0,0,32,32,C
3-PA,17,1,0,31,0,32,G
3-PA,18,36,0,0,0,36,A
3-PA,19,0,0,0,36,36,C
3-PA,20,36,0,0,0,36,A
3-PA,21,36,0,0,0,36,A
3-PA,22,0,36,0,0,36,T
3-PA,23,0,0,41,0,41,G
3-PA,24,0,0,0,41,41,C
3-PA,25,0,41,0,0,41,T
3-PA,26,0,41,0,0,41,T
3-PA,27,0,0,0,42,42,C
3-PA,28,44,0,0,0,44,A
3-PA,29,46,0,0,0,46,A
3-PA,30,0,0,0,46,46,C
3-PA,31,1,0,0,45,46,C
3-PA,32,0,0,0,48,48,C
3-PA,33,0,0,49,0,49,G
3-PA,34,49,0,0,0,49,A
3-PA,35,0,49,0,0,49,T
3-PA,36,0,0,48,0,48,G
3-PA,37,48,0,0,0,48,A
3-PA,38,0,49,0,0,49,T
3-PA,39,0,50,0,0,50,T
3-PA,40,0,0,50,0,50,G
3-PA,41,0,50,0,1,51,T
3-PA,42,1,0,0,51,52,C
3-PA,43,0,0,51,0,51,G
3-PA,44,51,0,0,0,51,A
3-PA,45,52,0,0,0,52,A
3-PA,46,0,0,0,52,52,C
3-PA,47,0,52,0,0,52,T
3-PA,48,0,52,0,0,52,T
3-PA,49,0,0,51,0,51,G
3-PA,50,0,0,0,53,53,C
3-PA,51,52,0,0,0,52,A
3-PA,52,0,0,54,0,54,G
3-PA,53,53,0,0,0,53,A
3-PA,54,54,0,0,0,54,A
3-PA,55,54,0,0,0,54,A
3-PA,56,54,0,0,0,54,A
3-PA,57,56,0,0,0,56,A
3-PA,58,0,0,56,0,56,G
3-PA,59,0,0,0,55,55,C
3-PA,60,56,0,0,0,56,A
3-PA,61,57,0,0,0,57,A
3-PA,62,0,57,0,0,57,T
3-PA,63,0,0,57,0,57,G
3-PA,64,60,0,0,0,60,A
3-PA,65,60,0,0,0,60,A
3-PA,66,60,0,0,0,60,A
3-PA,67,0,0,65,0,65,G
3-PA,68,70,0,0,0,70,A
3-PA,69,0,0,84,0,84,G
3-PA,70,0,86,0,0,86,T
3-PA,71,87,0,0,0,87,A
3-PA,72,0,87,0,0,87,T
3-PA,73,0,0,85,0,85,G
3-PA,74,0,0,87,0,87,G
3-PA,75,0,1,85,0,86,G
3-PA,76,0,0,88,0,88,G
3-PA,77,87,0,0,0,87,A
3-PA,78,0,1,85,0,86,G
3-PA,79,0,0,88,0,88,G
3-PA,80,88,0,0,0,88,A
3-PA,81,0,88,0,0,88,T
3-PA,82,1,0,0,88,89,C
3-PA,83,0,90,0,0,90,T
3-PA,84,0,0,90,0,90,G
3-PA,85,90,0,0,0,90,A
3-PA,86,90,0,0,0,90,A
3-PA,87,90,0,0,0,90,A
3-PA,88,87,0,0,0,87,A
3-PA,89,0,89,0,0,89,T
3-PA,90,0,89,0,0,89,T
3-PA,91,0,0,88,0,88,G
3-PA,92,89,0,0,0,89,A
3-PA,93,89,0,0,0,89,A
3-PA,94,89,0,0,0,89,A
3-PA,95,1,0,0,89,90,C
3-PA,96,91,0,0,0,91,A
3-PA,97,91,0,0,0,91,A
3-PA,98,91,0,0,0,91,A
3-PA,99,0,0,0,90,90,C
3-PA,100,90,0,0,0,90,A
3-PA,101,90,0,0,0,90,A
3-PA,102,92,0,0,0,92,A
3-PA,103,0,92,0,0,92,T
3-PA,104,0,94,0,0,94,T
3-PA,105,0,93,0,0,93,T
3-PA,106,0,0,93,0,93,G
3-PA,107,0,0,0,94,94,C
3-PA,108,94,0,0,0,94,A
3-PA,109,0,0,101,0,101,G
3-PA,110,0,0,0,101,101,C
3-PA,111,106,0,0,0,106,A
3-PA,112,108,0,0,0,108,A
3-PA,113,0,109,0,0,109,T
3-PA,114,111,0,0,0,111,A
3-PA,115,0,111,0,0,111,T
3-PA,116,0,0,111,0,111,G
3-PA,117,0,0,0,111,111,C
3-PA,118,111,0,0,0,111,A
3-PA,119,0,0,0,113,113,C
3-PA,120,0,109,0,1,110,T
3-PA,121,1,0,0,130,131,C
3-PA,122,136,0,0,0,136,A
3-PA,123,0,0,0,141,141,C
3-PA,124,0,141,0,0,141,T
3-PA,125,0,141,0,0,141,T
3-PA,126,1,0,139,0,140,G
3-PA,127,0,2,140,0,142,G
3-PA,128,140,0,0,0,140,A
3-PA,129,0,1,143,0,144,G
3-PA,130,0,0,146,0,146,G
3-PA,131,0,138,0,3,141,T
3-PA,132,0,0,143,0,143,G
3-PA,133,0,143,0,0,143,T
3-PA,134,0,0,144,0,144,G
3-PA,135,0,143,0,1,144,T
3-PA,136,0,143,0,0,143,T
3-PA,137,0,144,0,0,144,T
3-PA,138,2,0,0,144,146,C
3-PA,139,148,0,0,0,148,A
3-PA,140,0,147,0,0,147,T
3-PA,141,0,0,152,0,152,G
3-PA,142,0,149,0,0,149,T
3-PA,143,149,0,0,0,149,A
3-PA,144,0,149,0,0,149,T
3-PA,145,0,148,0,0,148,T
3-PA,146,1,0,0,147,148,C
3-PA,147,147,0,0,0,147,A
3-PA,148,0,1,152,0,153,G
3-PA,149,151,0,0,0,151,A
3-PA,150,0,151,0,0,151,T
3-PA,151,0,151,0,0,151,T
3-PA,152,0,152,0,0,152,T
3-PA,153,1,0,0,148,149,C
3-PA,154,0,0,0,152,152,C
3-PA,155,155,0,0,0,155,A
3-PA,156,0,154,0,1,155,T
3-PA,157,0,152,0,0,152,T
3-PA,158,0,155,0,0,155,T
3-PA,159,0,0,0,155,155,C
3-PA,160,156,0,0,0,156,A
3-PA,161,0,157,0,0,157,T
3-PA,162,1,0,0,156,157,C
3-PA,163,156,0,0,0,156,A
3-PA,164,156,0,0,0,156,A
3-PA,165,0,158,0,0,158,T
3-PA,166,0,2,164,0,166,G
3-PA,167,166,0,1,0,167,A
3-PA,168,166,0,0,0,166,A
3-PA,169,0,0,0,166,166,C
3-PA,170,166,0,0,0,166,A
3-PA,171,164,0,2,0,166,A
3-PA,172,0,0,166,0,166,G
3-PA,173,0,1,164,0,165,G
3-PA,174,160,0,1,0,161,A
3-PA,175,0,2,171,0,173,G
3-PA,176,179,0,0,0,179,A
3-PA,177,179,0,1,0,180,A
3-PA,178,0,179,0,0,179,T
3-PA,179,0,0,0,181,181,C
3-PA,180,183,0,0,0,183,A
3-PA,181,182,0,0,0,182,A
3-PA,182,0,182,0,0,182,T
3-PA,183,179,0,0,0,179,A
3-PA,184,0,0,186,0,186,G
3-PA,185,0,186,0,1,187,T
3-PA,186,0,1,188,0,189,G
3-PA,187,0,0,189,0,189,G
3-PA,188,0,187,0,0,187,T
3-PA,189,188,0,0,0,188,A
3-PA,190,0,0,191,0,191,G
3-PA,191,191,0,0,0,191,A
3-PA,192,191,0,1,0,192,A
3-PA,193,0,0,0,193,193,C
3-PA,194,0,188,0,1,189,T
3-PA,195,0,189,0,0,189,T
3-PA,196,0,2,184,0,186,G
3-PA,197,189,0,0,0,189,A
3-PA,198,0,0,0,190,190,C
3-PA,199,0,1,190,0,191,G
3-PA,200,193,0,0,0,193,A
3-PA,201,1,196,0,1,198,T
3-PA,202,1,0,0,198,199,C
3-PA,203,0,0,0,202,202,C
3-PA,204,202,0,0,0,202,A
3-PA,205,201,0,0,0,201,A
3-PA,206,202,0,0,0,202,A
3-PA,207,0,201,0,1,202,T
3-PA,208,0,0,202,0,202,G
3-PA,209,1,0,0,194,195,C
3-PA,210,196,0,0,0,196,A
3-PA,211,0,0,0,201,201,C
3-PA,212,0,200,0,0,200,T
3-PA,213,0,0,226,0,226,G
3-PA,214,0,227,0,0,227,T
3-PA,215,0,226,0,0,226,T
3-PA,216,226,0,0,0,226,A
3-PA,217,223,0,0,0,223,A
3-PA,218,223,0,1,0,224,A
3-PA,219,0,0,224,0,224,G
3-PA,220,1,0,0,219,220,C
3-PA,221,220,0,0,0,220,A
3-PA,222,0,0,0,219,219,C
3-PA,223,206,0,0,0,206,A
3-PA,224,0,3,217,0,220,G
3-PA,225,218,1,0,0,219,A
3-PA,226,0,219,0,0,219,T
3-PA,227,0,218,0,0,218,T
3-PA,228,0,217,0,1,218,T
3-PA,229,0,1,214,0,215,G
3-PA,230,218,0,0,0,218,A
3-PA,231,218,0,0,0,218,A
3-PA,232,216,0,0,0,216,A
3-PA,233,0,208,0,0,208,T
3-PA,234,210,0,0,0,210,A
3-PA,235,211,0,0,0,211,A
3-PA,236,0,210,0,0,210,T
3-PA,237,0,209,0,0,209,T
3-PA,238,0,0,209,0,209,G
3-PA,239,209,0,0,0,209,A
3-PA,240,0,3,209,0,212,G
3-PA,241,0,1,211,0,212,G
3-PA,242,0,1,214,0,215,G
3-PA,243,0,1,214,0,215,G
3-PA,244,213,0,1,0,214,A
3-PA,245,0,0,216,0,216,G
3-PA,246,219,0,0,0,219,A
3-PA,247,1,1,218,0,220,G
3-PA,248,217,0,2,0,219,A
3-PA,249,0,0,0,222,222,C
3-PA,250,219,0,0,0,219,A
3-PA,251,0,2,218,0,220,G
3-PA,252,219,0,0,0,219,A
3-PA,253,224,0,0,0,224,A
3-PA,254,0,0,0,223,223,C
3-PA,255,216,0,0,0,216,A
3-PA,256,217,0,0,0,217,A
3-PA,257,0,216,0,0,216,T
3-PA,258,0,1,226,0,227,G
3-PA,259,0,0,228,0,228,G
3-PA,260,0,0,0,225,225,C
3-PA,261,0,0,0,226,226,C
3-PA,262,0,225,0,0,225,T
3-PA,263,0,0,231,0,231,G
3-PA,264,0,0,229,0,229,G
3-PA,265,231,0,0,0,231,A
3-PA,266,0,0,0,232,232,C
3-PA,267,224,0,0,0,224,A
3-PA,268,0,0,254,0,254,G
3-PA,269,0,254,0,0,254,T
3-PA,270,261,0,0,0,261,A
3-PA,271,0,1,264,0,265,G
3-PA,272,0,259,0,1,260,T
3-PA,273,262,0,0,0,262,A
3-PA,274,264,0,0,0,264,A
3-PA,275,260,0,1,0,261,A
3-PA,276,0,1,0,263,264,C
3-PA,277,240,0,0,0,240,A
3-PA,278,0,0,243,0,243,G
3-PA,279,0,241,0,0,241,T
3-PA,280,242,0,0,0,242,A
3-PA,281,0,242,0,0,242,T
3-PA,282,0,0,0,249,249,C
3-PA,283,0,246,0,2,248,T
3-PA,284,0,0,248,0,248,G
3-PA,285,0,1,0,246,247,C
3-PA,286,247,0,0,0,247,A
3-PA,287,249,0,0,0,249,A
3-PA,288,0,0,0,251,251,C
3-PA,289,250,0,0,0,250,A
3-PA,290,0,0,0,266,266,C
3-PA,291,0,262,0,0,262,T
3-PA,292,267,0,0,0,267,A
3-PA,293,1,0,0,265,266,C
3-PA,294,0,265,0,0,265,T
3-PA,295,0,2,264,0,266,G
3-PA,296,0,0,265,0,265,G
3-PA,297,265,0,0,0,265,A
3-PA,298,0,0,265,0,265,G
3-PA,299,0,0,0,257,257,C
3-PA,300,0,257,0,0,257,T
3-PA,301,0,0,256,0,256,G
3-PA,302,0,0,257,0,257,G
3-PA,303,0,1,254,0,255,G
3-PA,304,254,0,0,0,254,A
3-PA,305,255,0,0,0,255,A
3-PA,306,255,0,0,0,255,A
3-PA,307,0,0,0,254,254,C
3-PA,308,1,1,0,252,254,C
3-PA,309,0,1,254,0,255,G
3-PA,310,255,0,1,0,256,A
3-PA,311,256,0,0,0,256,A
3-PA,312,0,0,255,0,255,G
3-PA,313,0,255,0,0,255,T
3-PA,314,0,256,0,0,256,T
3-PA,315,0,256,0,0,256,T
3-PA,316,1,0,0,252,253,C
3-PA,317,0,256,0,0,256,T
3-PA,318,255,0,1,0,256,A
3-PA,319,0,0,0,254,254,C
3-PA,320,0,0,0,256,256,C
3-PA,321,253,0,2,0,255,A
3-PA,322,0,1,258,0,259,G
3-PA,323,258,0,0,0,258,A
3-PA,324,0,257,0,0,257,T
3-PA,325,0,256,0,0,256,T
3-PA,326,0,254,0,1,255,T
3-PA,327,0,0,255,0,255,G
3-PA,328,0,256,0,0,256,T
3-PA,329,257,0,0,0,257,A
3-PA,330,0,256,0,0,256,T
3-PA,331,0,3,253,0,256,G
3-PA,332,277,1,0,0,278,A
3-PA,333,0,277,0,0,277,T
3-PA,334,0,277,0,0,277,T
3-PA,335,277,0,0,0,277,A
3-PA,336,0,1,0,277,278,C
3-PA,337,281,0,0,0,281,A
3-PA,338,279,0,2,0,281,A
3-PA,339,0,0,283,0,283,G
3-PA,340,0,2,283,0,285,G
3-PA,341,270,0,1,0,271,A
3-PA,342,0,1,277,0,278,G
3-PA,343,278,0,0,0,278,A
3-PA,344,278,0,0,0,278,A
3-PA,345,0,0,0,278,278,C
3-PA,346,271,0,0,0,271,A
3-PA,347,0,0,274,0,274,G
3-PA,348,271,0,1,0,272,A
3-PA,349,0,270,0,0,270,T
3-PA,350,0,269,0,0,269,T
3-PA,351,4,0,0,267,271,C
3-PA,352,270,0,0,0,270,A
3-PA,353,0,269,0,0,269,T
3-PA,354,1,0,0,269,270,C
3-PA,355,0,4,265,0,269,G
3-PA,356,271,0,0,0,271,A
3-PA,357,271,0,0,0,271,A
3-PA,358,271,0,0,0,271,A
3-PA,359,0,271,0,0,271,T
3-PA,360,0,271,0,0,271,T
3-PA,361,0,1,270,0,271,G
3-PA,362,0,0,271,0,271,G
3-PA,363,0,0,273,0,273,G
3-PA,364,0,0,273,0,273,G
3-PA,365,0,271,0,0,271,T
3-PA,366,0,2,269,0,271,G
3-PA,367,271,0,0,0,271,A
3-PA,368,1,0,0,276,277,C
3-PA,369,276,0,1,0,277,A
3-PA,370,276,0,0,0,276,A
3-PA,371,0,1,276,0,277,G
3-PA,372,1,1,277,0,279,G
3-PA,373,279,0,0,0,279,A
3-PA,374,0,1,279,0,280,G
3-PA,375,274,0,0,0,274,A
3-PA,376,0,0,273,0,273,G
3-PA,377,268,0,0,0,268,A
3-PA,378,271,0,1,0,272,A
3-PA,379,0,0,280,0,280,G
3-PA,380,0,274,0,0,274,T
3-PA,381,1,0,0,279,280,C
3-PA,382,7,0,1,273,281,C
3-PA,383,281,0,0,0,281,A
3-PA,384,0,2,0,282,284,C
3-PA,385,290,0,0,0,290,A
3-PA,386,0,295,0,1,296,T
3-PA,387,302,0,0,0,302,A
3-PA,388,0,288,0,0,288,T
3-PA,389,288,0,0,0,288,A
3-PA,390,0,283,0,0,283,T
3-PA,391,0,282,0,0,282,T
3-PA,392,284,1,0,0,285,A
3-PA,393,0,0,0,287,287,C
3-PA,394,1,0,0,277,278,C
3-PA,395,0,273,0,0,273,T
3-PA,396,0,265,0,3,268,T
3-PA,397,0,2,267,0,269,G
3-PA,398,269,0,0,0,269,A
3-PA,399,269,0,0,0,269,A
3-PA,400,266,0,1,0,267,A
3-PA,401,260,0,1,0,261,A
3-PA,402,0,0,261,0,261,G
3-PA,403,0,0,263,0,263,G
3-PA,404,0,0,0,264,264,C
3-PA,405,0,0,0,264,264,C
3-PA,406,262,0,0,1,263,A
3-PA,407,264,0,0,0,264,A
3-PA,408,0,264,0,0,264,T
3-PA,409,264,0,0,0,264,A
3-PA,410,264,0,0,0,264,A
3-PA,411,0,1,261,0,262,G
3-PA,412,259,0,1,0,260,A
3-PA,413,0,260,0,0,260,T
3-PA,414,0,259,0,0,259,T
3-PA,415,259,0,0,0,259,A
3-PA,416,258,0,0,0,258,A
3-PA,417,258,0,0,0,258,A
3-PA,418,0,260,0,0,260,T
3-PA,419,2,0,0,256,258,C
3-PA,420,0,253,0,0,253,T
3-PA,421,0,1,253,0,254,G
3-PA,422,254,0,0,0,254,A
3-PA,423,0,1,257,0,258,G
3-PA,424,258,0,0,0,258,A
3-PA,425,259,0,0,0,259,A
3-PA,426,0,0,0,261,261,C
3-PA,427,261,0,0,0,261,A
3-PA,428,0,0,0,263,263,C
3-PA,429,264,0,0,0,264,A
3-PA,430,0,0,0,264,264,C
3-PA,431,262,0,0,0,262,A
3-PA,432,0,0,0,269,269,C
3-PA,433,266,0,0,0,266,A
3-PA,434,0,265,0,0,265,T
3-PA,435,0,265,0,0,265,T
3-PA,436,3,0,0,263,266,C
3-PA,437,264,0,0,0,264,A
3-PA,438,0,0,0,264,264,C
3-PA,439,263,0,0,0,263,A
3-PA,440,0,263,0,0,263,T
3-PA,441,0,251,0,0,251,T
3-PA,442,0,256,0,0,256,T
3-PA,443,0,255,0,0,255,T
3-PA,444,1,0,0,255,256,C
3-PA,445,0,256,0,0,256,T
3-PA,446,1,0,0,254,255,C
3-PA,447,254,0,0,0,254,A
3-PA,448,0,255,0,0,255,T
3-PA,449,0,259,0,0,259,T
3-PA,450,1,0,0,257,258,C
3-PA,451,254,0,0,0,254,A
3-PA,452,0,0,0,259,259,C
3-PA,453,0,255,0,2,257,T
3-PA,454,0,0,258,0,258,G
3-PA,455,1,3,254,0,258,G
3-PA,456,255,0,1,0,256,A
3-PA,457,0,2,263,0,265,G
3-PA,458,264,0,0,1,265,A
3-PA,459,0,2,266,0,268,G
3-PA,460,0,0,268,0,268,G
3-PA,461,265,0,1,0,266,A
3-PA,462,264,0,0,0,264,A
3-PA,463,262,0,0,0,262,A
3-PA,464,0,260,0,0,260,T
3-PA,465,0,0,260,0,260,G
3-PA,466,0,0,259,0,259,G
3-PA,467,1,0,0,260,261,C
3-PA,468,0,1,0,258,259,C
3-PA,469,256,0,0,0,256,A
3-PA,470,0,0,0,256,256,C
3-PA,471,256,0,0,0,256,A
3-PA,472,258,0,0,0,258,A
3-PA,473,259,0,0,0,259,A
3-PA,474,0,1,261,0,262,G
3-PA,475,0,0,260,0,260,G
3-PA,476,0,0,0,263,263,C
3-PA,477,265,0,0,0,265,A
3-PA,478,0,0,268,0,268,G
3-PA,479,267,0,0,0,267,A
3-PA,480,0,0,0,268,268,C
3-PA,481,0,266,0,0,266,T
3-PA,482,266,0,0,0,266,A
3-PA,483,0,0,0,263,263,C
3-PA,484,260,0,0,0,260,A
3-PA,485,0,0,0,260,260,C
3-PA,486,0,253,0,0,253,T
3-PA,487,2,0,0,251,253,C
3-PA,488,0,254,0,0,254,T
3-PA,489,2,0,0,246,248,C
3-PA,490,1,1,248,0,250,G
3-PA,491,249,0,0,0,249,A
3-PA,492,0,0,0,248,248,C
3-PA,493,0,0,249,0,249,G
3-PA,494,251,0,0,0,251,A
3-PA,495,1,0,250,0,251,G
3-PA,496,0,0,251,0,251,G
3-PA,497,250,0,1,0,251,A
3-PA,498,250,0,1,0,251,A
3-PA,499,250,0,2,0,252,A
3-PA,500,0,0,251,0,251,G
3-PA,501,0,0,0,248,248,C
3-PA,502,245,0,0,0,245,A
3-PA,503,0,1,247,0,248,G
3-PA,504,0,1,254,0,255,G
3-PA,505,0,0,252,0,252,G
3-PA,506,1,1,0,250,252,C
3-PA,507,0,249,0,2,251,T
3-PA,508,251,0,0,0,251,A
3-PA,509,0,2,254,0,256,G
3-PA,510,0,1,270,0,271,G
3-PA,511,272,0,0,0,272,A
3-PA,512,0,266,0,0,266,T
3-PA,513,0,261,0,1,262,T
3-PA,514,261,0,0,0,261,A
3-PA,515,262,0,2,0,264,A
3-PA,516,0,1,266,0,267,G
3-PA,517,265,0,1,0,266,A
3-PA,518,0,0,0,264,264,C
3-PA,519,1,1,0,238,240,C
3-PA,520,241,0,0,0,241,A
3-PA,521,0,0,241,0,241,G
3-PA,522,0,0,242,0,242,G
3-PA,523,0,0,0,242,242,C
3-PA,524,0,237,0,0,237,T
3-PA,525,0,0,241,0,241,G
3-PA,526,0,237,0,1,238,T
3-PA,527,0,237,0,0,237,T
3-PA,528,0,239,0,0,239,T
3-PA,529,242,0,0,0,242,A
3-PA,530,0,0,0,241,241,C
3-PA,531,2,0,0,237,239,C
3-PA,532,236,0,0,0,236,A
3-PA,533,0,238,0,0,238,T
3-PA,534,230,0,0,0,230,A
3-PA,535,231,0,0,0,231,A
3-PA,536,0,1,232,0,233,G
3-PA,537,232,0,0,0,232,A
3-PA,538,0,0,0,233,233,C
3-PA,539,227,0,0,0,227,A
3-PA,540,228,0,0,0,228,A
3-PA,541,0,0,229,0,229,G
3-PA,542,230,0,0,0,230,A
3-PA,543,230,0,0,0,230,A
3-PA,544,229,0,0,0,229,A
3-PA,545,1,222,0,0,223,T
3-PA,546,0,1,230,0,231,G
3-PA,547,0,0,230,0,230,G
3-PA,548,0,0,0,231,231,C
3-PA,549,0,1,0,230,231,C
3-PA,550,229,1,0,0,230,A
3-PA,551,234,0,0,0,234,A
3-PA,552,0,0,0,234,234,C
3-PA,553,234,0,0,0,234,A
3-PA,554,0,0,234,0,234,G
3-PA,555,227,0,0,0,227,A
3-PA,556,0,0,231,0,231,G
3-PA,557,0,1,235,0,236,G
3-PA,558,0,2,0,231,233,C
3-PA,559,0,0,0,232,232,C
3-PA,560,0,223,0,0,223,T
3-PA,561,221,0,1,0,222,A
3-PA,562,0,226,0,0,226,T
3-PA,563,0,0,225,0,225,G
3-PA,564,0,1,224,0,225,G
3-PA,565,0,0,218,0,218,G
3-PA,566,205,0,0,0,205,A
3-PA,567,0,205,0,0,205,T
3-PA,568,0,205,0,0,205,T
3-PA,569,1,0,0,259,260,C
3-PA,570,0,0,0,253,253,C
3-PA,571,0,248,0,0,248,T
3-PA,572,0,249,0,0,249,T
3-PA,573,0,251,0,0,251,T
3-PA,574,3,0,0,259,262,C
3-PA,575,0,0,264,0,264,G
3-PA,576,0,263,0,0,263,T
3-PA,577,1,0,0,261,262,C
3-PA,578,258,0,0,0,258,A
3-PA,579,0,0,328,0,328,G
3-PA,580,0,327,0,1,328,T
3-PA,581,1,0,0,327,328,C
3-PA,582,1,0,0,330,331,C
3-PA,583,0,2,331,3,336,G
3-PA,584,337,0,0,1,338,A
3-PA,585,337,0,0,1,338,A
3-PA,586,339,1,1,0,341,A
3-PA,587,0,1,353,0,354,G
3-PA,588,341,0,1,0,342,A
3-PA,589,0,3,347,0,350,G
3-PA,590,0,0,351,0,351,G
3-PA,591,0,0,0,355,355,C
3-PA,592,0,3,354,0,357,G
3-PA,593,355,0,0,0,355,A
3-PA,594,358,0,0,0,358,A
3-PA,595,0,1,362,0,363,G
3-PA,596,360,0,1,0,361,A
3-PA,597,362,0,1,0,363,A
3-PA,598,362,0,1,0,363,A
3-PA,599,1,0,0,367,368,C
3-PA,600,365,0,0,0,365,A
3-PA,601,369,0,1,0,370,A
3-PA,602,0,370,0,0,370,T
3-PA,603,0,369,0,0,369,T
3-PA,604,0,4,369,0,373,G
3-PA,605,370,0,0,0,370,A
3-PA,606,367,2,0,0,369,A
3-PA,607,0,2,372,0,374,G
3-PA,608,370,0,1,0,371,A
3-PA,609,369,0,0,0,369,A
3-PA,610,368,0,2,0,370,A
3-PA,611,369,0,0,0,369,A
3-PA,612,372,0,0,0,372,A
3-PA,613,0,375,0,0,375,T
3-PA,614,0,371,1,0,372,T
3-PA,615,1,373,0,0,374,T
3-PA,616,0,3,373,0,376,G
3-PA,617,373,0,1,0,374,A
3-PA,618,379,0,0,0,379,A
3-PA,619,380,0,1,0,381,A
3-PA,620,0,391,0,1,392,T
3-PA,621,4,0,0,441,445,C
3-PA,622,446,0,0,0,446,A
3-PA,623,0,0,0,461,461,C
3-PA,624,459,0,0,0,459,A
3-PA,625,0,2,469,0,471,G
3-PA,626,0,4,492,0,496,G
3-PA,627,515,0,0,0,515,A
3-PA,628,522,0,0,0,522,A
3-PA,629,0,0,0,534,534,C
3-PA,630,0,521,0,0,521,T
3-PA,631,575,0,0,0,575,A
3-PA,632,0,586,0,0,586,T
3-PA,633,1,0,610,0,611,G
3-PA,634,0,0,0,607,607,C
3-PA,635,0,2,601,0,603,G
3-PA,636,0,600,0,0,600,T
3-PA,637,599,0,0,0,599,A
3-PA,638,0,2,603,0,605,G
3-PA,639,0,1,603,0,604,G
3-PA,640,1,0,0,599,600,C
3-PA,641,0,600,0,0,600,T
3-PA,642,0,592,0,0,592,T
3-PA,643,0,0,593,0,593,G
3-PA,644,1,0,0,594,595,C
3-PA,645,3,7,0,584,594,C
3-PA,646,0,3,597,0,600,G
3-PA,647,603,1,1,0,605,A
3-PA,648,0,5,0,605,610,C
3-PA,649,3,0,0,608,611,C
3-PA,650,612,0,0,0,612,A
3-PA,651,612,0,0,0,612,A
3-PA,652,611,0,0,0,611,A
3-PA,653,0,0,630,0,630,G
3-PA,654,0,628,0,1,629,T
3-PA,655,3,0,0,630,633,C
3-PA,656,0,629,0,0,629,T
3-PA,657,4,0,0,629,633,C
3-PA,658,1,0,0,637,638,C
3-PA,659,6,0,0,630,636,C
3-PA,660,637,0,0,0,637,A
3-PA,661,0,1,0,640,641,C
3-PA,662,3,1,0,636,640,C
3-PA,663,1,6,643,0,650,G
3-PA,664,662,0,0,0,662,A
3-PA,665,661,0,0,0,661,A
3-PA,666,0,0,0,671,671,C
3-PA,667,0,671,0,0,671,T
3-PA,668,0,680,0,0,680,T
3-PA,669,2,0,0,691,693,C
3-PA,670,0,686,0,3,689,T
3-PA,671,4,0,1,685,690,C
3-PA,672,0,0,0,689,689,C
3-PA,673,0,685,0,0,685,T
3-PA,674,0,0,695,0,695,G
3-PA,675,0,0,0,695,695,C
3-PA,676,1,0,0,692,693,C
3-PA,677,0,690,0,0,690,T
3-PA,678,0,685,0,0,685,T
3-PA,679,0,3,684,0,687,G
3-PA,680,684,0,3,0,687,A
3-PA,681,0,2,700,0,702,G
3-PA,682,702,0,0,0,702,A
3-PA,683,710,0,0,0,710,A
3-PA,684,0,729,0,0,729,T
3-PA,685,0,736,0,1,737,T
3-PA,686,0,733,0,1,734,T
3-PA,687,0,739,0,0,739,T
3-PA,688,734,0,1,0,735,A
3-PA,689,2,2,737,0,741,G
3-PA,690,735,0,4,0,739,A
3-PA,691,1,0,758,0,759,G
3-PA,692,0,0,0,767,767,C
3-PA,693,0,0,0,770,770,C
3-PA,694,0,789,0,1,790,T
3-PA,695,822,0,0,0,822,A
3-PA,696,0,821,0,3,824,T
3-PA,697,0,0,830,0,830,G
3-PA,698,0,826,0,0,826,T
3-PA,699,0,5,823,0,828,G
3-PA,700,0,0,828,0,828,G
3-PA,701,820,0,2,0,822,A
3-PA,702,0,816,0,0,816,T
3-PA,703,1,6,793,0,800,G
3-PA,704,1,2,822,0,825,G
3-PA,705,822,0,0,0,822,A
3-PA,706,0,819,0,0,819,T
3-PA,707,1,820,0,0,821,T
3-PA,708,7,1,1,809,818,C
3-PA,709,2,7,814,0,823,G
3-PA,710,825,0,1,0,826,A
3-PA,711,824,0,2,0,826,A
3-PA,712,0,0,0,831,831,C
3-PA,713,7,0,0,809,816,C
3-PA,714,0,12,811,0,823,G
3-PA,715,817,0,0,0,817,A
3-PA,716,819,0,0,0,819,A
3-PA,717,0,1,0,833,834,C
3-PA,718,1,4,821,0,826,G
3-PA,719,0,0,860,0,860,G
3-PA,720,0,1,0,857,858,C
3-PA,721,0,854,0,2,856,T
3-PA,722,0,0,889,0,889,G
3-PA,723,0,0,1,890,891,C
3-PA,724,890,0,6,0,896,A
3-PA,725,0,895,0,1,896,T
3-PA,726,0,884,0,1,885,T
3-PA,727,0,4,886,0,890,G
3-PA,728,863,0,1,0,864,A
3-PA,729,0,4,874,0,878,G
3-PA,730,0,3,871,0,874,G
3-PA,731,0,1,867,0,868,G
3-PA,732,0,1,0,868,869,C
3-PA,733,863,0,0,0,863,A
3-PA,734,865,0,0,1,866,A
3-PA,735,0,1,875,0,876,G
3-PA,736,0,0,0,881,881,C
3-PA,737,0,881,0,1,882,T
3-PA,738,0,879,0,1,880,T
3-PA,739,0,886,0,0,886,T
3-PA,740,2,0,0,886,888,C
3-PA,741,1,882,0,2,885,T
3-PA,742,5,0,0,885,890,C
3-PA,743,890,0,0,0,890,A
3-PA,744,883,0,2,1,886,A
3-PA,745,883,0,1,0,884,A
3-PA,746,0,889,0,0,889,T
3-PA,747,0,0,935,0,935,G
3-PA,748,0,932,0,0,932,T
3-PA,749,4,2,0,933,939,C
3-PA,750,8,1,0,934,943,C
3-PA,751,947,0,0,0,947,A
3-PA,752,947,0,0,0,947,A
3-PA,753,946,1,0,0,947,A
3-PA,754,0,2,964,0,966,G
3-PA,755,952,0,2,1,955,A
3-PA,756,930,0,1,1,932,A
3-PA,757,1,1,939,0,941,G
3-PA,758,0,935,0,0,935,T
3-PA,759,0,7,929,0,936,G
3-PA,760,934,0,2,0,936,A
3-PA,761,927,0,1,1,929,A
3-PA,762,0,930,0,0,930,T
3-PA,763,0,1,927,0,928,G
3-PA,764,0,0,0,940,940,C
3-PA,765,8,0,0,931,939,C
3-PA,766,3,0,0,934,937,C
3-PA,767,938,0,0,0,938,A
3-PA,768,941,0,6,0,947,A
3-PA,769,954,0,0,0,954,A
3-PA,770,0,952,0,0,952,T
3-PA,771,0,948,0,1,949,T
3-PA,772,0,6,944,1,951,G
3-PA,773,948,0,0,0,948,A
3-PA,774,948,0,0,0,948,A
3-PA,775,0,0,0,952,952,C
3-PA,776,1,0,0,950,951,C
3-PA,777,0,935,0,1,936,T
3-PA,778,0,971,0,1,972,T
3-PA,779,0,969,0,0,969,T
3-PA,780,0,990,0,0,990,T
3-PA,781,0,0,0,993,993,C
3-PA,782,0,988,0,2,990,T
3-PA,783,1,3,988,0,992,G
3-PA,784,984,1,4,0,989,A
3-PA,785,994,0,3,0,997,A
3-PA,786,1,9,997,0,1007,G
3-PA,787,988,0,1,0,989,A
3-PA,788,0,0,0,993,993,C
3-PA,789,982,0,0,0,982,A
3-PA,790,987,1,2,0,990,A
3-PA,791,0,0,0,1100,1100,C
3-PA,792,1099,0,1,0,1100,A
3-PA,793,1,0,0,1100,1101,C
3-PA,794,4,1,0,1085,1090,C
3-PA,795,1082,1,2,0,1085,A
3-PA,796,1078,0,5,1,1084,A
3-PA,797,0,7,1069,0,1076,G
3-PA,798,1081,1,2,0,1084,A
3-PA,799,0,0,0,1086,1086,C
3-PA,800,6,0,0,1020,1026,C
3-PA,801,1027,0,0,0,1027,A
3-PA,802,1026,0,0,0,1026,A
3-PA,803,0,1027,0,0,1027,T
3-PA,804,9,0,0,1017,1026,C
3-PA,805,1022,0,0,0,1022,A
3-PA,806,1018,0,1,0,1019,A
3-PA,807,1018,1,1,0,1020,A
3-PA,808,0,0,0,1030,1030,C
3-PA,809,0,1026,0,0,1026,T
3-PA,810,2,1021,0,0,1023,T
3-PA,811,1,0,0,1030,1031,C
3-PA,812,5,2,0,1023,1030,C
3-PA,813,1,7,1032,1,1041,G
3-PA,814,1036,2,0,0,1038,A
3-PA,815,1038,0,1,0,1039,A
3-PA,816,1,1039,0,0,1040,T
3-PA,817,0,3,1030,0,1033,G
3-PA,818,0,5,1039,0,1044,G
3-PA,819,1039,0,1,0,1040,A
3-PA,820,0,0,0,1047,1047,C
3-PA,821,5,0,0,1039,1044,C
3-PA,822,0,1049,0,19,1068,T
3-PA,823,1,0,0,1102,1103,C
3-PA,824,1,0,0,1104,1105,C
3-PA,825,0,1106,0,0,1106,T
3-PA,826,0,1113,0,0,1113,T
3-PA,827,1,0,1151,0,1152,G
3-PA,828,1,1142,0,3,1146,T
3-PA,829,0,1141,0,1,1142,T
3-PA,830,1139,0,0,0,1139,A
3-PA,831,0,1107,0,1,1108,T
3-PA,832,3,0,0,1099,1102,C
3-PA,833,1078,1,0,0,1079,A
3-PA,834,0,0,1077,0,1077,G
3-PA,835,0,1,0,1074,1075,C
3-PA,836,0,0,1052,0,1052,G
3-PA,837,0,0,1075,0,1075,G
3-PA,838,0,1075,0,1,1076,T
3-PA,839,7,0,0,1073,1080,C
3-PA,840,5,1,0,1077,1083,C
3-PA,841,1086,1,1,0,1088,A
3-PA,842,1095,0,2,0,1097,A
3-PA,843,1097,0,1,0,1098,A
3-PA,844,0,1096,0,2,1098,T
3-PA,845,0,1097,0,2,1099,T
3-PA,846,3,0,0,1094,1097,C
3-PA,847,3,0,0,1078,1081,C
3-PA,848,0,1073,0,2,1075,T
3-PA,849,0,0,0,1086,1086,C
3-PA,850,1,0,0,1090,1091,C
3-PA,851,0,1075,0,6,1081,T
3-PA,852,0,4,1083,0,1087,G
3-PA,853,1083,0,0,0,1083,A
3-PA,854,0,1082,0,1,1083,T
3-PA,855,0,3,1075,0,1078,G
3-PA,856,0,3,1066,0,1069,G
3-PA,857,1065,0,3,0,1068,A
3-PA,858,0,1058,0,1,1059,T
3-PA,859,2,1,1064,0,1067,G
3-PA,860,0,0,0,1118,1118,C
3-PA,861,0,1108,0,2,1110,T
3-PA,862,0,1113,0,2,1115,T
3-PA,863,1,1114,0,0,1115,T
3-PA,864,1119,0,0,0,1119,A
3-PA,865,1121,0,1,0,1122,A
3-PA,866,1120,0,2,0,1122,A
3-PA,867,1126,0,0,0,1126,A
3-PA,868,1,1123,0,0,1124,T
3-PA,869,0,1052,1,1,1054,T
3-PA,870,0,12,1043,0,1055,G
3-PA,871,1057,0,3,0,1060,A
3-PA,872,0,3,1070,0,1073,G
3-PA,873,1,2,0,1067,1070,C
3-PA,874,1072,0,0,0,1072,A
3-PA,875,0,1105,1,0,1106,T
3-PA,876,1,1102,0,0,1103,T
3-PA,877,0,0,1101,0,1101,G
3-PA,878,1101,0,0,0,1101,A
3-PA,879,1092,0,3,0,1095,A
3-PA,880,1,8,1093,0,1102,G
3-PA,881,1095,1,1,0,1097,A
3-PA,882,1,5,0,1095,1101,C
3-PA,883,9,0,0,1087,1096,C
3-PA,884,5,0,1,1077,1083,C
3-PA,885,1074,0,0,0,1074,A
3-PA,886,1086,0,2,0,1088,A
3-PA,887,1,0,1094,0,1095,G
3-PA,888,0,1090,0,0,1090,T
3-PA,889,15,0,0,1077,1092,C
3-PA,890,1089,0,0,0,1089,A
3-PA,891,0,2,0,1085,1087,C
3-PA,892,2,4,1078,0,1084,G
3-PA,893,1093,1,1,1,1096,A
3-PA,894,1087,1,2,0,1090,A
3-PA,895,0,1,1133,0,1134,G
3-PA,896,0,6,1126,0,1132,G
3-PA,897,1130,0,2,0,1132,A
3-PA,898,0,3,1137,0,1140,G
3-PA,899,1131,0,10,0,1141,A
3-PA,900,1134,0,6,0,1140,A
3-PA,901,0,4,1136,0,1140,G
3-PA,902,1,5,1130,0,1136,G
3-PA,903,3,3,1128,0,1134,G
3-PA,904,1104,1,5,0,1110,A
3-PA,905,0,1109,0,0,1109,T
3-PA,906,5,1,0,1111,1117,C
3-PA,907,4,0,0,1188,1192,C
3-PA,908,4,1,0,1200,1205,C
3-PA,909,1212,0,1,0,1213,A
3-PA,910,1,1206,1,0,1208,T
3-PA,911,0,1217,0,0,1217,T
3-PA,912,1245,0,1,0,1246,A
3-PA,913,0,1242,0,1,1243,T
3-PA,914,1242,0,2,0,1244,A
3-PA,915,1,1237,0,2,1240,T
3-PA,916,3,8,1125,0,1136,G
3-PA,917,1130,1,2,0,1133,A
3-PA,918,1,1121,0,0,1122,T
3-PA,919,0,0,1127,0,1127,G
3-PA,920,1,1,0,1110,1112,C
3-PA,921,0,11,1107,0,1118,G
3-PA,922,1130,0,0,0,1130,A
3-PA,923,0,1126,0,4,1130,T
3-PA,924,8,0,0,1125,1133,C
3-PA,925,1126,1,2,0,1129,A
3-PA,926,1114,0,2,0,1116,A
3-PA,927,0,1,1123,0,1124,G
3-PA,928,0,1113,1,2,1116,T
3-PA,929,0,2,1121,0,1123,G
3-PA,930,2,0,0,1120,1122,C
3-PA,931,1118,0,2,0,1120,A
3-PA,932,0,1119,0,0,1119,T
3-PA,933,1119,0,1,0,1120,A
3-PA,934,1134,0,1,0,1135,A
3-PA,935,1132,0,1,0,1133,A
3-PA,936,1128,0,1,0,1129,A
3-PA,937,1125,0,2,1,1128,A
3-PA,938,0,0,0,1131,1131,C
3-PA,939,1119,0,1,0,1120,A
3-PA,940,0,1125,0,0,1125,T
3-PA,941,0,1120,0,0,1120,T
3-PA,942,6,0,0,1123,1129,C
3-PA,943,0,1114,0,1,1115,T
3-PA,944,1,1111,0,0,1112,T
3-PA,945,0,1114,0,2,1116,T
3-PA,946,0,3,1111,0,1114,G
3-PA,947,0,2,1117,0,1119,G
3-PA,948,1112,0,2,0,1114,A
3-PA,949,0,1111,0,2,1113,T
3-PA,950,2,4,1121,0,1127,G
3-PA,951,0,6,1147,0,1153,G
3-PA,952,1151,1,0,0,1152,A
3-PA,953,1152,0,3,0,1155,A
3-PA,954,1154,0,2,0,1156,A
3-PA,955,0,7,1159,0,1166,G
3-PA,956,1161,0,2,0,1163,A
3-PA,957,1280,1,3,0,1284,A
3-PA,958,1,1,0,1305,1307,C
3-PA,959,7,0,0,1307,1314,C
3-PA,960,0,1309,0,0,1309,T
3-PA,961,0,1322,0,1,1323,T
3-PA,962,1328,0,1,0,1329,A
3-PA,963,0,1329,0,0,1329,T
3-PA,964,1312,1,0,0,1313,A
3-PA,965,0,1329,0,0,1329,T
3-PA,966,1210,0,1,0,1211,A
3-PA,967,0,1,1226,0,1227,G
3-PA,968,1,1210,0,3,1214,T
3-PA,969,12,1,0,1202,1215,C
3-PA,970,1199,0,0,0,1199,A
3-PA,971,1197,0,0,0,1197,A
3-PA,972,1199,0,0,0,1199,A
3-PA,973,0,1,0,1205,1206,C
3-PA,974,6,0,0,1180,1186,C
3-PA,975,1167,0,0,0,1167,A
3-PA,976,0,2,0,1164,1166,C
3-PA,977,1169,0,1,0,1170,A
3-PA,978,0,1,0,1171,1172,C
3-PA,979,1,4,1170,0,1175,G
3-PA,980,1179,0,0,0,1179,A
3-PA,981,1180,0,1,0,1181,A
3-PA,982,1173,1,1,1,1176,A
3-PA,983,1176,0,3,0,1179,A
3-PA,984,0,3,1180,0,1183,G
3-PA,985,1,6,1163,0,1170,G
3-PA,986,0,10,1169,0,1179,G
3-PA,987,1168,0,3,0,1171,A
3-PA,988,1170,0,3,0,1173,A
3-PA,989,0,1170,0,0,1170,T
3-PA,990,1172,0,0,0,1172,A
3-PA,991,1173,0,1,1,1175,A
3-PA,992,1180,0,0,0,1180,A
3-PA,993,0,1174,0,1,1175,T
3-PA,994,0,1172,0,0,1172,T
3-PA,995,12,0,0,1168,1180,C
3-PA,996,1180,0,0,0,1180,A
3-PA,997,1183,0,1,0,1184,A
3-PA,998,1189,0,0,1,1190,A
3-PA,999,0,1183,0,3,1186,T
3-PA,1000,0,1188,0,1,1189,T
3-PA,1001,1196,0,0,1,1197,A
3-PA,1002,0,1,0,1195,1196,C
3-PA,1003,3,0,0,1195,1198,C
3-PA,1004,1,1183,0,1,1185,T
3-PA,1005,0,1,1192,0,1193,G
3-PA,1006,1,0,0,1201,1202,C
3-PA,1007,0,1198,0,0,1198,T
3-PA,1008,0,0,1222,0,1222,G
3-PA,1009,0,1218,0,2,1220,T
3-PA,1010,18,0,0,1205,1223,C
3-PA,1011,1222,0,1,1,1224,A
3-PA,1012,0,1216,0,3,1219,T
3-PA,1013,0,3,1216,0,1219,G
3-PA,1014,0,3,1215,0,1218,G
3-PA,1015,1220,0,1,0,1221,A
3-PA,1016,1256,0,1,0,1257,A
3-PA,1017,2,2,1249,0,1253,G
3-PA,1018,0,1,0,1244,1245,C
3-PA,1019,1237,1,1,0,1239,A
3-PA,1020,1239,0,2,0,1241,A
3-PA,1021,0,0,1255,0,1255,G
3-PA,1022,0,1261,0,0,1261,T
3-PA,1023,1251,0,0,0,1251,A
3-PA,1024,2,1,0,1249,1252,C
3-PA,1025,0,1225,0,1,1226,T
3-PA,1026,0,0,1239,0,1239,G
3-PA,1027,0,1235,0,1,1236,T
3-PA,1028,5,0,0,1236,1241,C
3-PA,1029,1231,0,1,0,1232,A
3-PA,1030,0,9,1234,0,1243,G
3-PA,1031,1241,0,1,0,1242,A
3-PA,1032,1247,0,0,0,1247,A
3-PA,1033,0,1262,0,1,1263,T
3-PA,1034,2,1244,0,0,1246,T
3-PA,1035,0,1,1244,0,1245,G
3-PA,1036,3,2,0,1243,1248,C
3-PA,1037,1239,1,4,0,1244,A
3-PA,1038,0,2,1243,0,1245,G
3-PA,1039,2,3,1223,0,1228,G
3-PA,1040,1229,0,2,0,1231,A
3-PA,1041,1,0,0,1226,1227,C
3-PA,1042,1,0,1209,0,1210,G
3-PA,1043,0,1232,0,1,1233,T
3-PA,1044,0,1236,0,0,1236,T
3-PA,1045,0,3,1242,0,1245,G
3-PA,1046,1237,0,3,1,1241,A
3-PA,1047,1241,0,1,0,1242,A
3-PA,1048,1243,0,1,0,1244,A
3-PA,1049,1239,0,1,0,1240,A
3-PA,1050,0,1228,0,1,1229,T
3-PA,1051,0,4,1231,0,1235,G
3-PA,1052,1224,0,2,0,1226,A
3-PA,1053,0,2,1233,0,1235,G
3-PA,1054,0,7,1227,0,1234,G
3-PA,1055,1231,0,1,0,1232,A
3-PA,1056,1,3,1229,0,1233,G
3-PA,1057,1231,0,2,0,1233,A
3-PA,1058,1232,1,1,0,1234,A
3-PA,1059,1,2,1230,0,1233,G
3-PA,1060,1,1,1217,0,1219,G
3-PA,1061,0,1261,0,2,1263,T
3-PA,1062,0,1263,0,11,1274,T
3-PA,1063,6,0,1,1265,1272,C
3-PA,1064,3,1,0,1270,1274,C
3-PA,1065,1274,0,0,0,1274,A
3-PA,1066,1271,0,0,0,1271,A
3-PA,1067,1,7,1272,0,1280,G
3-PA,1068,0,4,1293,0,1297,G
3-PA,1069,1257,0,2,0,1259,A
3-PA,1070,0,2,0,1275,1277,C
3-PA,1071,0,1270,0,3,1273,T
3-PA,1072,1274,0,0,0,1274,A
3-PA,1073,1275,0,1,0,1276,A
3-PA,1074,1271,0,2,0,1273,A
3-PA,1075,1274,0,1,0,1275,A
3-PA,1076,1269,0,0,1,1270,A
3-PA,1077,0,2,0,1258,1260,C
3-PA,1078,1254,2,0,0,1256,A
3-PA,1079,1,1246,0,1,1248,T
3-PA,1080,0,9,1244,0,1253,G
3-PA,1081,1257,0,1,0,1258,A
3-PA,1082,1253,1,2,0,1256,A
3-PA,1083,1,6,1266,0,1273,G
3-PA,1084,1267,0,0,0,1267,A
3-PA,1085,1272,0,0,0,1272,A
3-PA,1086,1262,0,0,0,1262,A
3-PA,1087,1260,1,3,0,1264,A
3-PA,1088,0,2,0,1260,1262,C
3-PA,1089,0,11,1245,0,1256,G
3-PA,1090,1265,0,2,0,1267,A
3-PA,1091,0,0,1271,0,1271,G
3-PA,1092,0,1257,0,5,1262,T
3-PA,1093,15,0,1,1266,1282,C
3-PA,1094,1280,1,0,0,1281,A
3-PA,1095,1312,1,0,0,1313,A
3-PA,1096,0,1,0,1313,1314,C
3-PA,1097,1,1308,0,2,1311,T
3-PA,1098,0,3,1340,0,1343,G
3-PA,1099,1340,0,0,0,1340,A
3-PA,1100,1335,0,1,0,1336,A
3-PA,1101,0,0,1340,0,1340,G
3-PA,1102,1,1298,0,5,1304,T
3-PA,1103,0,5,1311,0,1316,G
3-PA,1104,0,3,1299,0,1302,G
3-PA,1105,1,1,1303,0,1305,G
3-PA,1106,0,1,0,1314,1315,C
3-PA,1107,0,1294,0,1,1295,T
3-PA,1108,4,0,0,1306,1310,C
3-PA,1109,0,1304,0,2,1306,T
3-PA,1110,0,1306,0,1,1307,T
3-PA,1111,0,5,1323,0,1328,G
3-PA,1112,0,1,1333,0,1334,G
3-PA,1113,0,1324,0,1,1325,T
3-PA,1114,0,6,1315,0,1321,G
3-PA,1115,1313,0,0,0,1313,A
3-PA,1116,1326,0,1,0,1327,A
3-PA,1117,1319,0,1,0,1320,A
3-PA,1118,1324,0,4,0,1328,A
3-PA,1119,0,0,0,1334,1334,C
3-PA,1120,1313,0,0,1,1314,A
3-PA,1121,0,1308,0,0,1308,T
3-PA,1122,1,11,1294,0,1306,G
3-PA,1123,0,1,1321,0,1322,G
3-PA,1124,1,3,0,1315,1319,C
3-PA,1125,1324,0,3,0,1327,A
3-PA,1126,1,0,0,1332,1333,C
3-PA,1127,4,2,0,1329,1335,C
3-PA,1128,1351,1,0,0,1352,A
3-PA,1129,1,7,1354,0,1362,G
3-PA,1130,1359,0,1,0,1360,A
3-PA,1131,1,6,1366,0,1373,G
3-PA,1132,1366,0,3,0,1369,A
3-PA,1133,1375,0,2,0,1377,A
3-PA,1134,0,7,1376,0,1383,G
3-PA,1135,0,1,1370,0,1371,G
3-PA,1136,0,1366,0,2,1368,T
3-PA,1137,1348,0,2,0,1350,A
3-PA,1138,0,8,1345,0,1353,G
3-PA,1139,1349,1,2,0,1352,A
3-PA,1140,1,0,0,1362,1363,C
3-PA,1141,1,1350,0,2,1353,T
3-PA,1142,0,1348,0,0,1348,T
3-PA,1143,0,1350,0,0,1350,T
3-PA,1144,0,5,1347,0,1352,G
3-PA,1145,1341,1,0,1,1343,A
3-PA,1146,1351,0,1,0,1352,A
3-PA,1147,1351,0,1,0,1352,A
3-PA,1148,1336,0,3,0,1339,A
3-PA,1149,0,0,0,1363,1363,C
3-PA,1150,0,1350,0,1,1351,T
3-PA,1151,0,0,1364,0,1364,G
3-PA,1152,0,0,0,1363,1363,C
3-PA,1153,1353,0,6,0,1359,A
3-PA,1154,0,1,1357,0,1358,G
3-PA,1155,1351,0,3,0,1354,A
3-PA,1156,0,3,1422,0,1425,G
3-PA,1157,1422,0,5,0,1427,A
3-PA,1158,0,1,0,1417,1418,C
3-PA,1159,1416,0,0,1,1417,A
3-PA,1160,0,1412,0,0,1412,T
3-PA,1161,1409,0,0,0,1409,A
3-PA,1162,1406,0,4,0,1410,A
3-PA,1163,0,1,1412,0,1413,G
3-PA,1164,1,3,0,1408,1412,C
3-PA,1165,1,6,1380,0,1387,G
3-PA,1166,1418,0,1,0,1419,A
3-PA,1167,0,1407,0,1,1408,T
3-PA,1168,0,1407,0,1,1408,T
3-PA,1169,1,1408,0,0,1409,T
3-PA,1170,0,6,1411,0,1417,G
3-PA,1171,1421,0,3,0,1424,A
3-PA,1172,1419,0,2,0,1421,A
3-PA,1173,0,0,1425,0,1425,G
3-PA,1174,0,0,0,1461,1461,C
3-PA,1175,1444,0,1,0,1445,A
3-PA,1176,1529,0,0,0,1529,A
3-PA,1177,0,1523,0,0,1523,T
3-PA,1178,1533,0,3,0,1536,A
3-PA,1179,1,1537,0,3,1541,T
3-PA,1180,1,6,1547,0,1554,G
3-PA,1181,1560,0,2,0,1562,A
3-PA,1182,2,1548,0,2,1552,T
3-PA,1183,1501,0,1,0,1502,A
3-PA,1184,0,0,1507,0,1507,G
3-PA,1185,1,1429,1,1,1432,T
3-PA,1186,0,7,1431,0,1438,G
3-PA,1187,1435,1,2,0,1438,A
3-PA,1188,1,3,0,1423,1427,C
3-PA,1189,3,12,1408,0,1423,G
3-PA,1190,1428,0,1,0,1429,A
3-PA,1191,1429,0,3,0,1432,A
3-PA,1192,1,0,0,1453,1454,C
3-PA,1193,12,0,0,1445,1457,C
3-PA,1194,0,1442,1,1,1444,T
3-PA,1195,1,11,1471,0,1483,G
3-PA,1196,1482,0,0,0,1482,A
3-PA,1197,1484,0,0,0,1484,A
3-PA,1198,1,1480,0,0,1481,T
3-PA,1199,0,1464,0,0,1464,T
3-PA,1200,1459,0,1,0,1460,A
3-PA,1201,1447,0,1,1,1449,A
3-PA,1202,0,4,1452,0,1456,G
3-PA,1203,0,0,1461,0,1461,G
3-PA,1204,0,1424,1,1,1426,T
3-PA,1205,22,3,0,1397,1422,C
3-PA,1206,1416,0,4,0,1420,A
3-PA,1207,0,1,0,1481,1482,C
3-PA,1208,0,1474,0,12,1486,T
3-PA,1209,0,1487,0,3,1490,T
3-PA,1210,0,1486,0,2,1488,T
3-PA,1211,9,0,0,1475,1484,C
3-PA,1212,1487,1,1,0,1489,A
3-PA,1213,1487,0,0,0,1487,A
3-PA,1214,0,1,1504,0,1505,G
3-PA,1215,2,0,0,1505,1507,C
3-PA,1216,0,1460,1,2,1463,T
3-PA,1217,0,5,1498,0,1503,G
3-PA,1218,0,4,1501,0,1505,G
3-PA,1219,1527,0,3,0,1530,A
3-PA,1220,0,1542,1,0,1543,T
3-PA,1221,1541,0,0,0,1541,A
3-PA,1222,1,1,0,1552,1554,C
3-PA,1223,1532,0,1,0,1533,A
3-PA,1224,2,6,1549,1,1558,G
3-PA,1225,1554,0,0,0,1554,A
3-PA,1226,1536,0,0,0,1536,A
3-PA,1227,0,1521,1,0,1522,T
3-PA,1228,2,12,1512,0,1526,G
3-PA,1229,1517,0,1,0,1518,A
3-PA,1230,0,0,1536,0,1536,G
3-PA,1231,0,1517,1,2,1520,T
3-PA,1232,0,1514,0,2,1516,T
3-PA,1233,16,0,0,1537,1553,C
3-PA,1234,1555,1,2,0,1558,A
3-PA,1235,1560,0,2,0,1562,A
3-PA,1236,1,0,0,1559,1560,C
3-PA,1237,1542,0,1,1,1544,A
3-PA,1238,1541,0,1,0,1542,A
3-PA,1239,0,1,1538,0,1539,G
3-PA,1240,1,1,1548,0,1550,G
3-PA,1241,1,0,0,1559,1560,C
3-PA,1242,1,0,0,1556,1557,C
3-PA,1243,1,1538,0,1,1540,T
3-PA,1244,0,0,1554,0,1554,G
3-PA,1245,0,1549,0,2,1551,T
3-PA,1246,0,14,1555,0,1569,G
3-PA,1247,1564,2,1,0,1567,A
3-PA,1248,0,1,1567,0,1568,G
3-PA,1249,1,0,0,1561,1562,C
3-PA,1250,0,1544,0,5,1549,T
3-PA,1251,1583,0,0,0,1583,A
3-PA,1252,1584,0,1,0,1585,A
3-PA,1253,0,0,0,1586,1586,C
3-PA,1254,0,1576,0,0,1576,T
3-PA,1255,3,8,1569,0,1580,G
3-PA,1256,1574,1,0,0,1575,A
3-PA,1257,0,1569,1,0,1570,T
3-PA,1258,1,1573,0,1,1575,T
3-PA,1259,13,1,0,1564,1578,C
3-PA,1260,1590,0,2,0,1592,A
3-PA,1261,0,1,1637,0,1638,G
3-PA,1262,1,1635,0,2,1638,T
3-PA,1263,16,0,0,1628,1644,C
3-PA,1264,0,1625,0,1,1626,T
3-PA,1265,0,3,1685,0,1688,G
3-PA,1266,1,3,1684,0,1688,G
3-PA,1267,1691,0,0,0,1691,A
3-PA,1268,0,1688,0,2,1690,T
3-PA,1269,1612,0,0,0,1612,A
3-PA,1270,2,8,1605,0,1615,G
3-PA,1271,1592,0,2,0,1594,A
3-PA,1272,2,1,1599,0,1602,G
3-PA,1273,0,0,0,1594,1594,C
3-PA,1274,0,1567,0,1,1568,T
3-PA,1275,7,2,0,1557,1566,C
3-PA,1276,1,3,1569,0,1573,G
3-PA,1277,1576,0,1,0,1577,A
3-PA,1278,1,1575,0,0,1576,T
3-PA,1279,0,4,1572,0,1576,G
3-PA,1280,1603,0,1,0,1604,A
3-PA,1281,1594,1,2,0,1597,A
3-PA,1282,1605,0,1,1,1607,A
3-PA,1283,0,1609,0,2,1611,T
3-PA,1284,0,1605,0,0,1605,T
3-PA,1285,5,6,1608,0,1619,G
3-PA,1286,0,10,1611,0,1621,G
3-PA,1287,1616,0,3,0,1619,A
3-PA,1288,0,2,1619,0,1621,G
3-PA,1289,1589,0,2,0,1591,A
3-PA,1290,0,7,1605,0,1612,G
3-PA,1291,1,4,1606,0,1611,G
3-PA,1292,1620,1,1,0,1622,A
3-PA,1293,0,0,0,1618,1618,C
3-PA,1294,1,0,1606,0,1607,G
3-PA,1295,0,1608,0,0,1608,T
3-PA,1296,1608,0,2,0,1610,A
3-PA,1297,1,0,1629,0,1630,G
3-PA,1298,0,0,0,1638,1638,C
3-PA,1299,7,1,0,1617,1625,C
3-PA,1300,1,0,0,1620,1621,C
3-PA,1301,6,1,0,1618,1625,C
3-PA,1302,1622,1,0,0,1623,A
3-PA,1303,1661,0,1,0,1662,A
3-PA,1304,0,1663,0,1,1664,T
3-PA,1305,0,1652,0,1,1653,T
3-PA,1306,0,14,1641,0,1655,G
3-PA,1307,1624,0,1,0,1625,A
3-PA,1308,1,1,1625,0,1627,G
3-PA,1309,0,3,0,1626,1629,C
3-PA,1310,1611,0,0,0,1611,A
3-PA,1311,2,2,0,1637,1641,C
3-PA,1312,1589,0,0,0,1589,A
3-PA,1313,0,1625,0,0,1625,T
3-PA,1314,0,1621,0,3,1624,T
3-PA,1315,0,1,1626,0,1627,G
3-PA,1316,2,0,1,1624,1627,C
3-PA,1317,1622,0,2,0,1624,A
3-PA,1318,1624,0,3,0,1627,A
3-PA,1319,0,1,1624,0,1625,G
3-PA,1320,3,1,0,1601,1605,C
3-PA,1321,1602,0,2,0,1604,A
3-PA,1322,1,1556,10,0,1567,T
3-PA,1323,0,9,1561,1,1571,G
3-PA,1324,1560,0,2,0,1562,A
3-PA,1325,0,6,1559,0,1565,G
3-PA,1326,1563,0,1,0,1564,A
3-PA,1327,1559,0,1,0,1560,A
3-PA,1328,1,4,1558,0,1563,G
3-PA,1329,0,8,1564,0,1572,G
3-PA,1330,1569,0,1,0,1570,A
3-PA,1331,1569,0,3,0,1572,A
3-PA,1332,0,1574,0,2,1576,T
3-PA,1333,0,1574,0,1,1575,T
3-PA,1334,1576,0,0,0,1576,A
3-PA,1335,0,1578,2,2,1582,T
3-PA,1336,0,1573,0,1,1574,T
3-PA,1337,0,1574,1,3,1578,T
3-PA,1338,7,0,0,1563,1570,C
3-PA,1339,1560,0,1,0,1561,A
3-PA,1340,0,1,0,1603,1604,C
3-PA,1341,1596,0,0,0,1596,A
3-PA,1342,0,2,1611,0,1613,G
3-PA,1343,2,0,0,1605,1607,C
3-PA,1344,1591,0,1,0,1592,A
3-PA,1345,0,1,1602,1,1604,G
3-PA,1346,1590,0,5,0,1595,A
3-PA,1347,0,2,1598,0,1600,G
3-PA,1348,0,2,1610,0,1612,G
3-PA,1349,0,1549,0,1,1550,T
3-PA,1350,1,0,1570,0,1571,G
3-PA,1351,0,1570,0,3,1573,T
3-PA,1352,7,0,0,1573,1580,C
3-PA,1353,4,1,0,1585,1590,C
3-PA,1354,8,0,0,1584,1592,C
3-PA,1355,1604,0,1,0,1605,A
3-PA,1356,1,1625,0,3,1629,T
3-PA,1357,0,1610,0,3,1613,T
3-PA,1358,3,1,1614,0,1618,G
3-PA,1359,1,1595,0,0,1596,T
3-PA,1360,1571,0,1,0,1572,A
3-PA,1361,0,7,1563,0,1570,G
3-PA,1362,1531,0,1,0,1532,A
3-PA,1363,0,0,1533,0,1533,G
3-PA,1364,2,0,0,1517,1519,C
3-PA,1365,2,2,1,1492,1497,C
3-PA,1366,1511,1,0,0,1512,A
3-PA,1367,1,0,0,1521,1522,C
3-PA,1368,1,1514,0,1,1516,T
3-PA,1369,1,4,1509,0,1514,G
3-PA,1370,1508,1,0,0,1509,A
3-PA,1371,1480,0,1,0,1481,A
3-PA,1372,0,1523,0,1,1524,T
3-PA,1373,1546,0,1,0,1547,A
3-PA,1374,1,1,0,1564,1566,C
3-PA,1375,1517,0,3,0,1520,A
3-PA,1376,0,1536,0,1,1537,T
3-PA,1377,1524,0,0,0,1524,A
3-PA,1378,1535,0,0,0,1535,A
3-PA,1379,0,1526,0,0,1526,T
3-PA,1380,0,1,1504,0,1505,G
3-PA,1381,1498,0,1,0,1499,A
3-PA,1382,1464,0,0,0,1464,A
3-PA,1383,1,2,1469,0,1472,G
3-PA,1384,0,5,1456,0,1461,G
3-PA,1385,0,6,1472,0,1478,G
3-PA,1386,0,4,1478,0,1482,G
3-PA,1387,0,0,1494,0,1494,G
3-PA,1388,0,1466,0,1,1467,T
3-PA,1389,1473,0,2,0,1475,A
3-PA,1390,1,1483,0,3,1487,T
3-PA,1391,1506,0,1,0,1507,A
3-PA,1392,0,2,0,1628,1630,C
3-PA,1393,1596,0,0,0,1596,A
3-PA,1394,0,1554,0,0,1554,T
3-PA,1395,0,1538,0,0,1538,T
3-PA,1396,1526,1,0,0,1527,A
3-PA,1397,1547,0,2,0,1549,A
3-PA,1398,0,0,0,1549,1549,C
3-PA,1399,1515,0,1,0,1516,A
3-PA,1400,1,0,0,1512,1513,C
3-PA,1401,0,1354,1,2,1357,T
3-PA,1402,1,0,1414,0,1415,G
3-PA,1403,1,0,0,1405,1406,C
3-PA,1404,0,1,0,1400,1401,C
3-PA,1405,3,1,0,1406,1410,C
3-PA,1406,0,1369,0,0,1369,T
3-PA,1407,0,2,1415,0,1417,G
3-PA,1408,1,0,0,1417,1418,C
3-PA,1409,0,1411,2,2,1415,T
3-PA,1410,13,0,0,1434,1447,C
3-PA,1411,1411,0,0,0,1411,A
3-PA,1412,1426,0,1,0,1427,A
3-PA,1413,0,1425,0,1,1426,T
3-PA,1414,0,0,1425,1,1426,G
3-PA,1415,1,0,0,1423,1424,C
3-PA,1416,1388,1,1,0,1390,A
3-PA,1417,0,1389,0,2,1391,T
3-PA,1418,6,0,0,1384,1390,C
3-PA,1419,4,0,0,1398,1402,C
3-PA,1420,0,1347,0,3,1350,T
3-PA,1421,0,0,1387,0,1387,G
3-PA,1422,1,1372,0,1,1374,T
3-PA,1423,1,0,1369,0,1370,G
3-PA,1424,0,1,0,1375,1376,C
3-PA,1425,1362,0,1,0,1363,A
3-PA,1426,0,1,1383,0,1384,G
3-PA,1427,0,0,0,1378,1378,C
3-PA,1428,1359,0,2,0,1361,A
3-PA,1429,1362,0,1,0,1363,A
3-PA,1430,0,1315,0,2,1317,T
3-PA,1431,0,10,1304,0,1314,G
3-PA,1432,0,6,1309,1,1316,G
3-PA,1433,1315,1,1,0,1317,A
3-PA,1434,0,0,0,1319,1319,C
3-PA,1435,0,14,1292,0,1306,G
3-PA,1436,1321,0,0,0,1321,A
3-PA,1437,0,1317,0,0,1317,T
3-PA,1438,0,1312,0,1,1313,T
3-PA,1439,0,1319,0,0,1319,T
3-PA,1440,0,1308,0,0,1308,T
3-PA,1441,10,1,0,1296,1307,C
3-PA,1442,1308,1,2,0,1311,A
3-PA,1443,1313,0,1,0,1314,A
3-PA,1444,2,1,0,1315,1318,C
3-PA,1445,0,1293,0,2,1295,T
3-PA,1446,1289,0,0,0,1289,A
3-PA,1447,1294,0,0,0,1294,A
3-PA,1448,0,1289,0,2,1291,T
3-PA,1449,1,1290,0,0,1291,T
3-PA,1450,13,0,0,1287,1300,C
3-PA,1451,3,0,0,1290,1293,C
3-PA,1452,3,1,0,1284,1288,C
3-PA,1453,1285,0,1,0,1286,A
3-PA,1454,0,1300,0,3,1303,T
3-PA,1455,3,2,1299,0,1304,G
3-PA,1456,1307,0,2,0,1309,A
3-PA,1457,0,1297,0,2,1299,T
3-PA,1458,1295,0,2,0,1297,A
3-PA,1459,1297,0,2,0,1299,A
3-PA,1460,0,0,1301,0,1301,G
3-PA,1461,1,1,0,1293,1295,C
3-PA,1462,1285,0,0,0,1285,A
3-PA,1463,1248,1,0,0,1249,A
3-PA,1464,1,0,1267,0,1268,G
3-PA,1465,0,1253,0,3,1256,T
3-PA,1466,1,0,1250,0,1251,G
3-PA,1467,1,0,0,1249,1250,C
3-PA,1468,1235,0,0,0,1235,A
3-PA,1469,0,11,1247,0,1258,G
3-PA,1470,1250,0,2,0,1252,A
3-PA,1471,1267,0,1,0,1268,A
3-PA,1472,0,1,0,1270,1271,C
3-PA,1473,0,1237,0,2,1239,T
3-PA,1474,1241,1,0,0,1242,A
3-PA,1475,1242,0,0,0,1242,A
3-PA,1476,1239,0,2,0,1241,A
3-PA,1477,0,1,1243,0,1244,G
3-PA,1478,1179,0,4,0,1183,A
3-PA,1479,0,10,1174,0,1184,G
3-PA,1480,0,2,1154,0,1156,G
3-PA,1481,1,1,1155,0,1157,G
3-PA,1482,1143,0,0,1,1144,A
3-PA,1483,1115,0,3,0,1118,A
3-PA,1484,0,3,1112,0,1115,G
3-PA,1485,0,1,1114,0,1115,G
3-PA,1486,1,1,0,1114,1116,C
3-PA,1487,1,6,1106,0,1113,G
3-PA,1488,1109,0,2,0,1111,A
3-PA,1489,1109,0,1,0,1110,A
3-PA,1490,1106,0,3,0,1109,A
3-PA,1491,1109,0,0,0,1109,A
3-PA,1492,1112,0,1,0,1113,A
3-PA,1493,1,0,0,1107,1108,C
3-PA,1494,4,1,0,1097,1102,C
3-PA,1495,1099,0,0,0,1099,A
3-PA,1496,1116,0,0,0,1116,A
3-PA,1497,0,1111,0,0,1111,T
3-PA,1498,0,1108,1,0,1109,T
3-PA,1499,0,1113,0,0,1113,T
3-PA,1500,1114,0,0,0,1114,A
3-PA,1501,0,1112,0,0,1112,T
3-PA,1502,1103,0,3,0,1106,A
3-PA,1503,0,1097,0,0,1097,T
3-PA,1504,0,4,1083,0,1087,G
3-PA,1505,1,2,1070,0,1073,G
3-PA,1506,1067,0,0,1,1068,A
3-PA,1507,0,1061,0,1,1062,T
3-PA,1508,0,1045,0,0,1045,T
3-PA,1509,10,0,0,1038,1048,C
3-PA,1510,1048,0,1,0,1049,A
3-PA,1511,1,1052,1,0,1054,T
3-PA,1512,2,0,0,1050,1052,C
3-PA,1513,1052,0,0,0,1052,A
3-PA,1514,0,1034,0,0,1034,T
3-PA,1515,1031,0,0,0,1031,A
3-PA,1516,1030,0,1,0,1031,A
3-PA,1517,1026,0,3,0,1029,A
3-PA,1518,1,4,1028,0,1033,G
3-PA,1519,1,3,993,0,997,G
3-PA,1520,0,2,990,0,992,G
3-PA,1521,983,0,0,0,983,A
3-PA,1522,974,0,1,0,975,A
3-PA,1523,0,3,977,0,980,G
3-PA,1524,971,0,2,0,973,A
3-PA,1525,0,969,0,1,970,T
3-PA,1526,6,0,0,965,971,C
3-PA,1527,0,951,0,1,952,T
3-PA,1528,10,2,0,961,973,C
3-PA,1529,973,0,0,0,973,A
3-PA,1530,0,971,0,0,971,T
3-PA,1531,0,966,0,2,968,T
3-PA,1532,0,949,0,0,949,T
3-PA,1533,940,0,0,0,940,A
3-PA,1534,940,0,2,0,942,A
3-PA,1535,7,4,928,0,939,G
3-PA,1536,0,2,942,0,944,G
3-PA,1537,883,0,1,0,884,A
3-PA,1538,881,0,4,0,885,A
3-PA,1539,0,877,2,1,880,T
3-PA,1540,1,10,870,0,881,G
3-PA,1541,893,0,1,0,894,A
3-PA,1542,0,1,0,894,895,C
3-PA,1543,883,0,4,0,887,A
3-PA,1544,0,0,0,885,885,C
3-PA,1545,850,0,1,0,851,A
3-PA,1546,1,1,851,0,853,G
3-PA,1547,841,0,2,0,843,A
3-PA,1548,0,1,0,823,824,C
3-PA,1549,0,0,820,0,820,G
3-PA,1550,0,767,0,0,767,T
3-PA,1551,2,1,768,0,771,G
3-PA,1552,0,0,770,0,770,G
3-PA,1553,0,770,0,0,770,T
3-PA,1554,765,0,0,0,765,A
3-PA,1555,747,0,0,0,747,A
3-PA,1556,744,0,0,0,744,A
3-PA,1557,0,740,0,0,740,T
3-PA,1558,0,730,0,0,730,T
3-PA,1559,0,729,0,1,730,T
3-PA,1560,0,711,0,0,711,T
3-PA,1561,0,0,712,0,712,G
3-PA,1562,0,702,0,1,703,T
3-PA,1563,0,7,697,0,704,G
3-PA,1564,692,0,0,0,692,A
3-PA,1565,0,1,688,0,689,G
3-PA,1566,0,0,0,686,686,C
3-PA,1567,686,0,0,0,686,A
3-PA,1568,0,683,0,1,684,T
3-PA,1569,1,3,680,0,684,G
3-PA,1570,0,5,681,0,686,G
3-PA,1571,687,0,0,0,687,A
3-PA,1572,0,0,687,0,687,G
3-PA,1573,0,669,0,1,670,T
3-PA,1574,0,656,1,0,657,T
3-PA,1575,0,659,1,0,660,T
3-PA,1576,0,657,1,0,658,T
3-PA,1577,1,2,0,656,659,C
3-PA,1578,0,647,0,3,650,T
3-PA,1579,1,0,0,646,647,C
3-PA,1580,0,627,0,4,631,T
3-PA,1581,5,1,0,619,625,C
3-PA,1582,621,0,1,0,622,A
3-PA,1583,0,0,0,621,621,C
3-PA,1584,0,592,0,1,593,T
3-PA,1585,1,3,585,0,589,G
3-PA,1586,589,0,0,0,589,A
3-PA,1587,2,0,1,586,589,C
3-PA,1588,1,0,0,586,587,C
3-PA,1589,2,2,0,573,577,C
3-PA,1590,1,1,570,0,572,G
3-PA,1591,571,0,1,0,572,A
3-PA,1592,0,2,570,0,572,G
3-PA,1593,572,0,0,0,572,A
3-PA,1594,0,0,0,561,561,C
3-PA,1595,0,543,0,2,545,T
3-PA,1596,0,512,0,0,512,T
3-PA,1597,0,1,509,0,510,G
3-PA,1598,505,0,2,0,507,A
3-PA,1599,0,0,508,0,508,G
3-PA,1600,0,0,0,503,503,C
3-PA,1601,2,0,1,479,482,C
3-PA,1602,479,0,2,0,481,A
3-PA,1603,0,0,0,477,477,C
3-PA,1604,473,0,1,0,474,A
3-PA,1605,0,475,0,0,475,T
3-PA,1606,472,0,0,0,472,A
3-PA,1607,469,0,1,0,470,A
3-PA,1608,464,0,1,0,465,A
3-PA,1609,0,460,0,0,460,T
3-PA,1610,1,2,452,0,455,G
3-PA,1611,0,1,389,0,390,G
3-PA,1612,0,2,385,0,387,G
3-PA,1613,367,0,0,0,367,A
3-PA,1614,1,1,361,0,363,G
3-PA,1615,354,0,0,0,354,A
3-PA,1616,347,0,0,0,347,A
3-PA,1617,344,0,0,0,344,A
3-PA,1618,0,340,0,0,340,T
3-PA,1619,334,0,0,0,334,A
3-PA,1620,2,0,0,333,335,C
3-PA,1621,0,180,0,0,180,T
3-PA,1622,0,0,179,0,179,G
3-PA,1623,0,100,0,0,100,T
3-PA,1624,0,0,96,0,96,G
3-PA,1625,0,89,0,0,89,T
3-PA,1626,0,0,0,49,49,C
3-PA,1627,0,0,0,46,46,C
3-PA,1628,0,41,0,0,41,T
3-PA,1629,0,40,0,0,40,T
3-PA,1630,0,0,41,0,41,G
3-PA,1631,40,0,0,0,40,A
3-PA,1632,0,0,40,0,40,G
3-PA,1633,39,0,0,0,39,A
3-PA,1634,0,39,0,0,39,T
3-PA,1635,39,0,0,0,39,A
3-PA,1636,0,0,39,0,39,G
3-PA,1637,0,1,38,0,39,G
3-PA,1638,39,0,0,0,39,A
3-PA,1639,0,0,39,0,39,G
3-PA,1640,38,0,0,0,38,A
3-PA,1641,0,39,0,0,39,T
3-PA,1642,39,0,0,0,39,A
3-PA,1643,0,39,0,0,39,T
3-PA,1644,0,0,39,0,39,G
3-PA,1645,0,38,0,0,38,T
3-PA,1646,0,38,0,0,38,T
3-PA,1647,39,0,0,0,39,A
3-PA,1648,0,0,0,39,39,C
3-PA,1649,0,39,0,0,39,T
3-PA,1650,39,0,0,0,39,A
3-PA,1651,39,0,0,0,39,A
3-PA,1652,0,0,40,0,40,G
3-PA,1653,40,0,0,0,40,A
3-PA,1654,38,0,1,0,39,A
3-PA,1655,0,0,39,0,39,G
3-PA,1656,0,39,0,0,39,T
3-PA,1657,0,1,37,0,38,G
3-PA,1658,0,0,0,41,41,C
3-PA,1659,0,0,0,41,41,C
3-PA,1660,41,0,0,0,41,A
3-PA,1661,0,41,0,0,41,T
3-PA,1662,41,0,0,0,41,A
3-PA,1663,0,0,41,0,41,G
3-PA,1664,0,0,41,0,41,G
3-PA,1665,0,0,0,41,41,C
3-PA,1666,0,0,0,40,40,C
3-PA,1667,40,0,0,0,40,A
3-PA,1668,40,0,0,0,40,A
3-PA,1669,40,0,0,0,40,A
3-PA,1670,0,40,0,0,40,T
3-PA,1671,0,40,0,0,40,T
3-PA,1672,0,38,0,0,38,T
3-PA,1673,0,0,0,38,38,C
3-PA,1674,38,0,0,0,38,A
3-PA,1675,39,0,0,0,39,A
3-PA,1676,0,0,39,0,39,G
3-PA,1677,0,0,39,0,39,G
3-PA,1678,0,0,0,39,39,C
3-PA,1679,0,0,0,39,39,C
3-PA,1680,39,0,0,0,39,A
3-PA,1681,41,0,0,0,41,A
3-PA,1682,0,41,0,0,41,T
3-PA,1683,0,0,43,0,43,G
3-PA,1684,0,42,0,0,42,T
3-PA,1685,0,42,0,1,43,T
3-PA,1686,0,0,0,43,43,C
3-PA,1687,0,43,0,0,43,T
3-PA,1688,0,43,0,0,43,T
3-PA,1689,39,0,0,0,39,A
3-PA,1690,0,40,0,0,40,T
3-PA,1691,40,0,0,0,40,A
3-PA,1692,0,40,0,0,40,T
3-PA,1693,0,0,40,0,40,G
3-PA,1694,0,33,0,0,33,T
3-PA,1695,0,0,33,0,33,G
3-PA,1696,33,0,0,0,33,A
3-PA,1697,0,1,32,0,33,G
3-PA,1698,0,0,34,0,34,G
3-PA,1699,34,0,0,0,34,A
3-PA,1700,0,0,0,34,34,C
3-PA,1701,34,0,0,0,34,A
3-PA,1702,34,0,0,0,34,A
3-PA,1703,34,0,0,0,34,A
3-PA,1704,0,0,0,34,34,C
3-PA,1705,0,1,33,0,34,G
3-PA,1706,0,2,32,0,34,G
3-PA,1707,34,0,0,0,34,A
3-PA,1708,32,1,0,0,33,A
3-PA,1709,0,0,0,34,34,C
3-PA,1710,34,0,0,0,34,A
3-PA,1711,0,34,0,0,34,T
3-PA,1712,0,0,0,34,34,C
3-PA,1713,34,0,0,0,34,A
3-PA,1714,34,0,0,0,34,A
3-PA,1715,33,0,0,0,33,A
3-PA,1716,0,0,34,0,34,G
3-PA,1717,0,0,33,0,33,G
3-PA,1718,0,33,0,1,34,T
3-PA,1719,0,0,0,34,34,C
3-PA,1720,35,0,0,0,35,A
3-PA,1721,35,0,0,0,35,A
3-PA,1722,35,0,0,0,35,A
3-PA,1723,35,0,0,0,35,A
3-PA,1724,0,35,0,0,35,T
3-PA,1725,0,0,37,0,37,G
3-PA,1726,37,0,0,0,37,A
3-PA,1727,37,0,0,0,37,A
3-PA,1728,37,0,0,0,37,A
3-PA,1729,0,37,0,0,37,T
3-PA,1730,0,0,37,0,37,G
3-PA,1731,0,0,37,0,37,G
3-PA,1732,0,0,37,0,37,G
3-PA,1733,0,0,38,0,38,G
3-PA,1734,37,0,0,0,37,A
3-PA,1735,37,0,0,0,37,A
3-PA,1736,0,37,0,0,37,T
3-PA,1737,0,0,37,0,37,G
3-PA,1738,0,0,37,0,37,G
3-PA,1739,37,0,0,0,37,A
3-PA,1740,0,0,38,0,38,G
3-PA,1741,37,0,0,0,37,A
3-PA,1742,0,37,0,0,37,T
3-PA,1743,0,0,37,0,37,G
3-PA,1744,36,0,1,0,37,A
3-PA,1745,0,0,37,0,37,G
3-PA,1746,37,0,0,0,37,A
3-PA,1747,0,0,0,37,37,C
3-PA,1748,0,0,37,0,37,G
3-PA,1749,0,36,0,0,36,T
3-PA,1750,0,36,0,0,36,T
3-PA,1751,0,0,37,0,37,G
3-PA,1752,0,0,0,37,37,C
3-PA,1753,0,0,0,37,37,C
3-PA,1754,0,37,0,0,37,T
3-PA,1755,1,0,0,37,38,C
3-PA,1756,1,0,0,37,38,C
3-PA,1757,0,38,0,0,38,T
3-PA,1758,0,38,0,0,38,T
3-PA,1759,1,0,0,37,38,C
3-PA,1760,37,0,0,0,37,A
3-PA,1761,0,0,37,0,37,G
3-PA,1762,0,36,0,0,36,T
3-PA,1763,0,0,0,36,36,C
3-PA,1764,35,0,0,0,35,A
3-PA,1765,0,0,0,39,39,C
3-PA,1766,0,39,0,0,39,T
3-PA,1767,0,0,0,40,40,C
3-PA,1768,0,0,0,40,40,C
3-PA,1769,40,0,0,0,40,A
3-PA,1770,0,0,40,0,40,G
3-PA,1771,0,0,0,40,40,C
3-PA,1772,39,0,0,0,39,A
3-PA,1773,0,0,39,0,39,G
3-PA,1774,38,0,0,0,38,A
3-PA,1775,0,37,0,0,37,T
3-PA,1776,0,0,0,37,37,C
3-PA,1777,0,0,37,0,37,G
3-PA,1778,37,0,0,0,37,A
3-PA,1779,0,0,36,0,36,G
3-PA,1780,36,0,0,0,36,A
3-PA,1781,0,0,36,0,36,G
3-PA,1782,0,0,0,36,36,C
3-PA,1783,36,0,0,0,36,A
3-PA,1784,0,36,0,0,36,T
3-PA,1785,0,0,36,0,36,G
3-PA,1786,37,0,0,0,37,A
3-PA,1787,0,37,0,0,37,T
3-PA,1788,0,37,0,0,37,T
3-PA,1789,1,0,37,0,38,G
3-PA,1790,39,0,0,0,39,A
3-PA,1791,39,0,0,0,39,A
3-PA,1792,0,0,39,0,39,G
3-PA,1793,0,0,0,38,38,C
3-PA,1794,0,0,0,39,39,C
3-PA,1795,0,0,39,0,39,G
3-PA,1796,39,0,0,0,39,A
3-PA,1797,0,0,42,0,42,G
3-PA,1798,0,42,0,0,42,T
3-PA,1799,0,0,0,42,42,C
3-PA,1800,0,0,0,42,42,C
3-PA,1801,0,42,0,0,42,T
3-PA,1802,0,0,0,43,43,C
3-PA,1803,0,0,42,0,42,G
3-PA,1804,0,0,46,0,46,G
3-PA,1805,0,46,0,0,46,T
3-PA,1806,0,46,0,0,46,T
3-PA,1807,46,0,0,0,46,A
3-PA,1808,46,0,0,0,46,A
3-PA,1809,45,0,0,0,45,A
3-PA,1810,0,0,46,0,46,G
3-PA,1811,46,0,0,0,46,A
3-PA,1812,0,0,45,0,45,G
3-PA,1813,45,0,0,0,45,A
3-PA,1814,45,0,0,0,45,A
3-PA,1815,44,1,0,0,45,A
3-PA,1816,0,0,45,0,45,G
3-PA,1817,45,0,0,0,45,A
3-PA,1818,0,0,0,45,45,C
3-PA,1819,45,0,0,0,45,A
3-PA,1820,0,45,0,0,45,T
3-PA,1821,0,0,45,0,45,G
3-PA,1822,45,0,0,0,45,A
3-PA,1823,0,0,0,45,45,C
3-PA,1824,0,0,0,45,45,C
3-PA,1825,45,0,0,0,45,A
3-PA,1826,45,0,0,0,45,A
3-PA,1827,45,0,0,0,45,A
3-PA,1828,0,0,45,0,45,G
3-PA,1829,45,0,0,0,45,A
3-PA,1830,0,0,45,0,45,G
3-PA,1831,0,44,0,0,44,T
3-PA,1832,0,45,0,0,45,T
3-PA,1833,0,45,0,0,45,T
3-PA,1834,0,45,0,0,45,T
3-PA,1835,0,45,0,0,45,T
3-PA,1836,0,45,0,0,45,T
3-PA,1837,0,0,45,0,45,G
3-PA,1838,44,0,0,0,44,A
3-PA,1839,0,0,44,0,44,G
3-PA,1840,44,0,0,0,44,A
3-PA,1841,44,0,0,0,44,A
3-PA,1842,0,44,0,0,44,T
3-PA,1843,44,0,0,0,44,A
3-PA,1844,45,0,0,0,45,A
3-PA,1845,45,0,0,0,45,A
3-PA,1846,0,45,0,0,45,T
3-PA,1847,0,0,0,45,45,C
3-PA,1848,44,0,0,0,44,A
3-PA,1849,0,0,44,0,44,G
3-PA,1850,44,0,0,0,44,A
3-PA,1851,44,0,0,0,44,A
3-PA,1852,0,0,44,0,44,G
3-PA,1853,0,0,0,44,44,C
3-PA,1854,44,0,0,0,44,A
3-PA,1855,0,43,0,0,43,T
3-PA,1856,0,0,43,0,43,G
3-PA,1857,0,0,44,0,44,G
3-PA,1858,0,0,0,44,44,C
3-PA,1859,0,0,0,43,43,C
3-PA,1860,0,0,0,43,43,C
3-PA,1861,43,0,0,0,43,A
3-PA,1862,0,43,0,0,43,T
3-PA,1863,0,42,0,0,42,T
3-PA,1864,0,0,43,0,43,G
3-PA,1865,0,0,43,0,43,G
3-PA,1866,0,0,41,0,41,G
3-PA,1867,0,0,42,0,42,G
3-PA,1868,40,0,0,0,40,A
3-PA,1869,0,0,40,0,40,G
3-PA,1870,0,39,0,0,39,T
3-PA,1871,0,0,0,39,39,C
3-PA,1872,1,0,0,37,38,C
3-PA,1873,0,0,0,39,39,C
3-PA,1874,0,0,0,39,39,C
3-PA,1875,1,0,0,38,39,C
3-PA,1876,39,0,0,0,39,A
3-PA,1877,39,0,0,0,39,A
3-PA,1878,0,0,39,0,39,G
3-PA,1879,0,0,39,0,39,G
3-PA,1880,0,0,39,0,39,G
3-PA,1881,35,0,0,0,35,A
3-PA,1882,0,0,35,0,35,G
3-PA,1883,0,35,0,0,35,T
3-PA,1884,0,0,35,0,35,G
3-PA,1885,0,0,36,0,36,G
3-PA,1886,36,0,0,0,36,A
3-PA,1887,36,0,0,0,36,A
3-PA,1888,0,0,36,0,36,G
3-PA,1889,36,0,0,0,36,A
3-PA,1890,36,0,0,0,36,A
3-PA,1891,0,0,35,0,35,G
3-PA,1892,0,0,35,0,35,G
3-PA,1893,0,35,0,0,35,T
3-PA,1894,0,35,0,0,35,T
3-PA,1895,0,0,0,35,35,C
3-PA,1896,0,0,0,35,35,C
3-PA,1897,35,0,0,0,35,A
3-PA,1898,0,35,0,0,35,T
3-PA,1899,0,35,0,0,35,T
3-PA,1900,0,1,34,0,35,G
3-PA,1901,0,0,35,0,35,G
3-PA,1902,0,0,35,0,35,G
3-PA,1903,35,0,0,0,35,A
3-PA,1904,34,0,0,0,34,A
3-PA,1905,35,0,0,0,35,A
3-PA,1906,0,0,35,0,35,G
3-PA,1907,0,34,0,1,35,T
3-PA,1908,0,0,0,36,36,C
3-PA,1909,0,36,0,0,36,T
3-PA,1910,0,0,36,0,36,G
3-PA,1911,0,36,0,0,36,T
3-PA,1912,35,0,0,0,35,A
3-PA,1913,0,0,35,0,35,G
3-PA,1914,0,0,32,0,32,G
3-PA,1915,33,0,0,0,33,A
3-PA,1916,0,0,0,33,33,C
3-PA,1917,0,31,0,0,31,T
3-PA,1918,0,0,0,32,32,C
3-PA,1919,0,32,0,0,32,T
3-PA,1920,33,0,0,0,33,A
3-PA,1921,0,33,0,0,33,T
3-PA,1922,0,33,0,0,33,T
3-PA,1923,0,0,33,0,33,G
3-PA,1924,0,0,33,0,33,G
3-PA,1925,0,0,0,32,32,C
3-PA,1926,0,32,0,0,32,T
3-PA,1927,31,0,0,0,31,A
3-PA,1928,31,0,0,0,31,A
3-PA,1929,0,0,31,0,31,G
3-PA,1930,0,30,0,1,31,T
3-PA,1931,1,0,0,30,31,C
3-PA,1932,29,0,0,0,29,A
3-PA,1933,0,0,30,0,30,G
3-PA,1934,0,30,0,0,30,T
3-PA,1935,30,0,0,0,30,A
3-PA,1936,0,30,0,0,30,T
3-PA,1937,0,29,0,0,29,T
3-PA,1938,0,0,0,28,28,C
3-PA,1939,28,0,0,0,28,A
3-PA,1940,28,0,0,0,28,A
3-PA,1941,0,28,0,0,28,T
3-PA,1942,27,0,0,0,27,A
3-PA,1943,0,0,27,0,27,G
3-PA,1944,0,0,0,25,25,C
3-PA,1945,0,0,0,25,25,C
3-PA,1946,0,24,0,0,24,T
3-PA,1947,0,0,26,0,26,G
3-PA,1948,0,26,0,0,26,T
3-PA,1949,27,0,0,0,27,A
3-PA,1950,0,27,0,0,27,T
3-PA,1951,0,0,26,0,26,G
3-PA,1952,0,0,0,25,25,C
3-PA,1953,24,0,0,0,24,A
3-PA,1954,0,24,0,0,24,T
3-PA,1955,0,0,0,24,24,C
3-PA,1956,24,0,0,0,24,A
3-PA,1957,0,1,0,23,24,C
3-PA,1958,0,0,0,24,24,C
3-PA,1959,24,0,0,0,24,A
3-PA,1960,0,0,0,25,25,C
3-PA,1961,24,0,0,0,24,A
3-PA,1962,23,0,0,0,23,A
3-PA,1963,0,22,0,0,22,T
3-PA,1964,0,22,0,0,22,T
3-PA,1965,0,0,22,0,22,G
3-PA,1966,0,0,22,0,22,G
3-PA,1967,22,0,0,0,22,A
3-PA,1968,22,0,0,0,22,A
3-PA,1969,0,0,22,0,22,G
3-PA,1970,0,0,22,0,22,G
3-PA,1971,22,0,0,0,22,A
3-PA,1972,0,22,0,0,22,T
3-PA,1973,0,22,0,0,22,T
3-PA,1974,0,22,0,0,22,T
3-PA,1975,0,22,0,0,22,T
3-PA,1976,1,0,0,21,22,C
3-PA,1977,22,0,0,0,22,A
3-PA,1978,0,0,22,0,22,G
3-PA,1979,0,0,0,22,22,C
3-PA,1980,0,0,22,0,22,G
3-PA,1981,0,0,22,0,22,G
3-PA,1982,22,0,0,0,22,A
3-PA,1983,0,0,22,0,22,G
3-PA,1984,0,22,0,0,22,T
3-PA,1985,0,0,0,23,23,C
3-PA,1986,23,0,0,0,23,A
3-PA,1987,23,0,0,0,23,A
3-PA,1988,0,0,23,0,23,G
3-PA,1989,23,0,0,0,23,A
3-PA,1990,23,0,0,0,23,A
3-PA,1991,23,0,0,0,23,A
3-PA,1992,23,0,0,0,23,A
3-PA,1993,0,0,0,23,23,C
3-PA,1994,0,21,0,0,21,T
3-PA,1995,0,0,21,0,21,G
3-PA,1996,0,0,0,21,21,C
3-PA,1997,0,21,0,0,21,T
3-PA,1998,0,0,0,21,21,C
3-PA,1999,0,0,0,21,21,C
3-PA,2000,0,21,0,0,21,T
3-PA,2001,0,21,0,0,21,T
3-PA,2002,0,0,21,0,21,G
3-PA,2003,0,21,0,0,21,T
3-PA,2004,0,21,0,0,21,T
3-PA,2005,0,0,21,0,21,G
3-PA,2006,0,20,0,0,20,T
3-PA,2007,0,20,0,0,20,T
3-PA,2008,0,0,0,20,20,C
3-PA,2009,20,0,0,0,20,A
3-PA,2010,0,0,20,0,20,G
3-PA,2011,0,0,20,0,20,G
3-PA,2012,0,0,0,20,20,C
3-PA,2013,0,20,0,0,20,T
3-PA,2014,0,0,0,22,22,C
3-PA,2015,0,21,0,0,21,T
3-PA,2016,0,21,0,0,21,T
3-PA,2017,21,0,0,0,21,A
3-PA,2018,0,0,21,0,21,G
3-PA,2019,0,0,21,0,21,G
3-PA,2020,0,0,21,0,21,G
3-PA,2021,20,0,0,0,20,A
3-PA,2022,0,0,0,20,20,C
3-PA,2023,20,0,0,0,20,A
3-PA,2024,20,0,0,0,20,A
3-PA,2025,0,0,0,20,20,C
3-PA,2026,0,0,0,20,20,C
3-PA,2027,0,20,0,0,20,T
3-PA,2028,0,0,0,20,20,C
3-PA,2029,0,0,20,0,20,G
3-PA,2030,20,0,0,0,20,A
3-PA,2031,20,0,0,0,20,A
3-PA,2032,0,0,0,20,20,C
3-PA,2033,0,0,0,20,20,C
3-PA,2034,0,20,0,0,20,T
3-PA,2035,0,0,20,0,20,G
3-PA,2036,0,0,20,0,20,G
3-PA,2037,0,0,20,0,20,G
3-PA,2038,20,0,0,0,20,A
3-PA,2039,0,0,0,20,20,C
3-PA,2040,0,0,0,20,20,C
3-PA,2041,0,20,0,0,20,T
3-PA,2042,0,20,0,0,20,T
3-PA,2043,0,20,0,0,20,T
3-PA,2044,0,0,20,0,20,G
3-PA,2045,20,0,0,0,20,A
3-PA,2046,0,20,0,0,20,T
3-PA,2047,1,0,0,19,20,C
3-PA,2048,0,20,0,0,20,T
3-PA,2049,0,20,0,0,20,T
3-PA,2050,0,0,20,0,20,G
3-PA,2051,0,0,20,0,20,G
3-PA,2052,0,0,20,0,20,G
3-PA,2053,0,0,20,0,20,G
3-PA,2054,0,0,20,0,20,G
3-PA,2055,0,0,20,0,20,G
3-PA,2056,0,0,0,19,19,C
3-PA,2057,0,20,0,0,20,T
3-PA,2058,22,0,0,0,22,A
3-PA,2059,0,22,0,0,22,T
3-PA,2060,22,0,0,0,22,A
3-PA,2061,0,22,0,0,22,T
3-PA,2062,0,1,19,0,20,G
3-PA,2063,20,0,0,0,20,A
3-PA,2064,20,0,0,0,20,A
3-PA,2065,0,0,20,0,20,G
3-PA,2066,0,0,0,20,20,C
3-PA,2067,18,0,0,0,18,A
3-PA,2068,19,0,0,0,19,A
3-PA,2069,0,19,0,0,19,T
3-PA,2070,0,19,0,0,19,T
3-PA,2071,0,0,19,0,19,G
3-PA,2072,19,0,0,0,19,A
3-PA,2073,0,0,19,0,19,G
3-PA,2074,0,0,19,0,19,G
3-PA,2075,17,0,0,0,17,A
3-PA,2076,0,0,17,0,17,G
3-PA,2077,0,16,0,0,16,T
3-PA,2078,0,0,16,0,16,G
3-PA,2079,0,0,0,15,15,C
3-PA,2080,0,0,0,16,16,C
3-PA,2081,0,16,0,0,16,T
3-PA,2082,0,0,16,0,16,G
3-PA,2083,16,0,0,0,16,A
3-PA,2084,0,16,0,0,16,T
3-PA,2085,0,15,0,0,15,T
3-PA,2086,15,0,0,0,15,A
3-PA,2087,15,0,0,0,15,A
3-PA,2088,0,15,0,0,15,T
3-PA,2089,0,0,15,0,15,G
3-PA,2090,15,0,0,0,15,A
3-PA,2091,0,14,0,0,14,T
3-PA,2092,0,0,0,14,14,C
3-PA,2093,0,0,0,14,14,C
3-PA,2094,0,0,0,14,14,C
3-PA,2095,0,14,0,0,14,T
3-PA,2096,0,0,14,0,14,G
3-PA,2097,0,0,14,0,14,G
3-PA,2098,0,0,14,0,14,G
3-PA,2099,0,14,0,0,14,T
3-PA,2100,0,14,0,0,14,T
3-PA,2101,0,14,0,0,14,T
3-PA,2102,0,14,0,0,14,T
3-PA,2103,0,0,14,0,14,G
3-PA,2104,0,0,0,14,14,C
3-PA,2105,0,13,0,0,13,T
3-PA,2106,0,0,0,12,12,C
3-PA,2107,12,0,0,0,12,A
3-PA,2108,12,0,0,0,12,A
3-PA,2109,0,12,0,0,12,T
3-PA,2110,0,0,12,0,12,G
3-PA,2111,0,0,0,12,12,C
3-PA,2112,0,0,12,0,12,G
3-PA,2113,0,12,0,0,12,T
3-PA,2114,0,0,0,12,12,C
3-PA,2115,0,12,0,0,12,T
3-PA,2116,0,12,0,0,12,T
3-PA,2117,0,0,12,0,12,G
3-PA,2118,0,0,12,0,12,G
3-PA,2119,0,12,0,0,12,T
3-PA,2120,0,12,0,0,12,T
3-PA,2121,0,0,0,12,12,C
3-PA,2122,12,0,0,0,12,A
3-PA,2123,12,0,0,0,12,A
3-PA,2124,0,0,0,12,12,C
3-PA,2125,0,12,0,0,12,T
3-PA,2126,1,0,0,11,12,C
3-PA,2127,0,0,0,11,11,C
3-PA,2128,0,11,0,0,11,T
3-PA,2129,0,11,0,0,11,T
3-PA,2130,0,0,0,11,11,C
3-PA,2131,0,0,0,11,11,C
3-PA,2132,0,11,0,0,11,T
3-PA,2133,0,0,11,0,11,G
3-PA,2134,11,0,0,0,11,A
3-PA,2135,0,0,0,11,11,C
3-PA,2136,11,0,0,0,11,A
3-PA,2137,0,0,0,11,11,C
3-PA,2138,11,0,0,0,11,A
3-PA,2139,0,11,0,0,11,T
3-PA,2140,0,0,11,0,11,G
3-PA,2141,0,0,0,11,11,C
3-PA,2142,11,0,0,0,11,A
3-PA,2143,0,11,0,0,11,T
3-PA,2144,0,11,0,0,11,T
3-PA,2145,11,0,0,0,11,A
3-PA,2146,10,0,0,0,10,A
3-PA,2147,10,0,0,0,10,A
3-PA,2148,10,0,0,0,10,A
3-PA,2149,0,10,0,0,10,T
3-PA,2150,9,0,0,0,9,A
3-PA,2151,0,0,9,0,9,G
4-HA,1,128,0,0,0,128,A
4-HA,2,0,128,0,0,128,T
4-HA,3,0,0,128,0,128,G
4-HA,4,129,0,0,0,129,A
4-HA,5,132,0,0,0,132,A
4-HA,6,0,2,143,0,145,G
4-HA,7,145,0,0,0,145,A
4-HA,8,0,0,0,160,160,C
4-HA,9,0,162,0,0,162,T
4-HA,10,165,0,0,0,165,A
4-HA,11,0,171,0,0,171,T
4-HA,12,0,0,0,171,171,C
4-HA,13,171,0,0,0,171,A
4-HA,14,0,173,0,0,173,T
4-HA,15,0,173,0,0,173,T
4-HA,16,0,0,184,0,184,G
4-HA,17,0,1,0,184,185,C
4-HA,18,0,183,0,1,184,T
4-HA,19,0,185,0,0,185,T
4-HA,20,0,186,0,0,186,T
4-HA,21,0,1,205,1,207,G
4-HA,22,207,0,0,0,207,A
4-HA,23,0,0,213,0,213,G
4-HA,24,1,0,0,212,213,C
4-HA,25,0,213,0,0,213,T
4-HA,26,230,0,0,0,230,A
4-HA,27,0,0,0,233,233,C
4-HA,28,236,0,0,0,236,A
4-HA,29,0,249,0,0,249,T
4-HA,30,0,246,0,0,246,T
4-HA,31,1,0,0,252,253,C
4-HA,32,0,248,0,2,250,T
4-HA,33,255,0,0,0,255,A
4-HA,34,0,252,0,1,253,T
4-HA,35,0,1,256,0,257,G
4-HA,36,0,257,0,0,257,T
4-HA,37,3,0,0,252,255,C
4-HA,38,0,256,0,0,256,T
4-HA,39,0,2,255,0,257,G
4-HA,40,0,0,257,0,257,G
4-HA,41,0,257,0,0,257,T
4-HA,42,0,257,0,0,257,T
4-HA,43,0,256,1,0,257,T
4-HA,44,0,256,0,1,257,T
4-HA,45,2,0,0,255,257,C
4-HA,46,0,0,257,0,257,G
4-HA,47,0,0,0,263,263,C
4-HA,48,0,261,0,1,262,T
4-HA,49,3,1,0,259,263,C
4-HA,50,262,0,0,0,262,A
4-HA,51,265,0,0,0,265,A
4-HA,52,265,0,0,0,265,A
4-HA,53,265,0,0,0,265,A
4-HA,54,266,0,0,0,266,A
4-HA,55,0,0,0,266,266,C
4-HA,56,0,266,0,0,266,T
4-HA,57,0,268,0,0,268,T
4-HA,58,0,0,0,267,267,C
4-HA,59,0,0,0,267,267,C
4-HA,60,0,264,0,4,268,T
4-HA,61,0,0,270,0,270,G
4-HA,62,0,1,269,0,270,G
4-HA,63,271,0,0,0,271,A
4-HA,64,275,0,0,0,275,A
4-HA,65,275,0,0,0,275,A
4-HA,66,0,278,0,0,278,T
4-HA,67,0,5,277,0,282,G
4-HA,68,283,0,0,0,283,A
4-HA,69,0,0,0,286,286,C
4-HA,70,286,0,0,0,286,A
4-HA,71,286,0,0,0,286,A
4-HA,72,0,1,0,292,293,C
4-HA,73,291,0,0,0,291,A
4-HA,74,0,0,293,0,293,G
4-HA,75,0,0,0,293,293,C
4-HA,76,292,0,0,0,292,A
4-HA,77,1,290,0,0,291,T
4-HA,78,0,1,301,0,302,G
4-HA,79,0,0,309,0,309,G
4-HA,80,0,0,0,309,309,C
4-HA,81,307,0,0,0,307,A
4-HA,82,307,1,0,0,308,A
4-HA,83,0,0,0,308,308,C
4-HA,84,0,2,312,0,314,G
4-HA,85,0,0,0,315,315,C
4-HA,86,0,312,0,0,312,T
4-HA,87,0,0,315,0,315,G
4-HA,88,0,316,0,0,316,T
4-HA,89,1,0,335,0,336,G
4-HA,90,0,0,0,337,337,C
4-HA,91,0,0,0,343,343,C
4-HA,92,0,341,0,0,341,T
4-HA,93,0,341,0,0,341,T
4-HA,94,0,2,346,0,348,G
4-HA,95,0,0,348,0,348,G
4-HA,96,0,0,352,0,352,G
4-HA,97,1,0,0,352,353,C
4-HA,98,350,0,0,0,350,A
4-HA,99,0,0,0,355,355,C
4-HA,100,0,0,0,351,351,C
4-HA,101,376,0,0,0,376,A
4-HA,102,0,376,0,0,376,T
4-HA,103,0,0,374,0,374,G
4-HA,104,0,0,0,375,375,C
4-HA,105,369,0,3,0,372,A
4-HA,106,1,0,395,0,396,G
4-HA,107,0,396,0,0,396,T
4-HA,108,395,0,0,0,395,A
4-HA,109,0,0,0,398,398,C
4-HA,110,1,0,0,381,382,C
4-HA,111,384,0,0,0,384,A
4-HA,112,383,0,0,0,383,A
4-HA,113,383,0,1,0,384,A
4-HA,114,0,2,0,382,384,C
4-HA,115,0,4,373,0,377,G
4-HA,116,0,2,381,0,383,G
4-HA,117,381,0,1,0,382,A
4-HA,118,381,0,0,0,381,A
4-HA,119,0,0,0,381,381,C
4-HA,120,2,2,378,0,382,G
4-HA,121,388,0,0,0,388,A
4-HA,122,0,387,0,0,387,T
4-HA,123,393,0,0,0,393,A
4-HA,124,0,1,396,0,397,G
4-HA,125,0,392,0,1,393,T
4-HA,126,1,4,388,0,393,G
4-HA,127,394,1,0,0,395,A
4-HA,128,392,0,2,0,394,A
4-HA,129,396,0,0,0,396,A
4-HA,130,397,0,0,0,397,A
4-HA,131,0,0,0,403,403,C
4-HA,132,399,0,0,0,399,A
4-HA,133,404,0,0,0,404,A
4-HA,134,0,402,0,0,402,T
4-HA,135,2,0,0,402,404,C
4-HA,136,404,0,0,0,404,A
4-HA,137,0,0,0,409,409,C
4-HA,138,3,3,403,0,409,G
4-HA,139,408,0,0,0,408,A
4-HA,140,409,0,0,0,409,A
4-HA,141,0,408,0,0,408,T
4-HA,142,0,7,400,0,407,G
4-HA,143,411,0,0,0,411,A
4-HA,144,0,0,0,409,409,C
4-HA,145,1,0,0,410,411,C
4-HA,146,411,0,0,0,411,A
4-HA,147,409,0,0,0,409,A
4-HA,148,411,0,0,0,411,A
4-HA,149,0,410,0,0,410,T
4-HA,150,1,409,0,0,410,T
4-HA,151,0,0,413,0,413,G
4-HA,152,412,0,0,0,412,A
4-HA,153,413,0,0,0,413,A
4-HA,154,0,0,420,0,420,G
4-HA,155,0,417,0,0,417,T
4-HA,156,0,428,0,0,428,T
4-HA,157,432,0,0,0,432,A
4-HA,158,0,0,0,433,433,C
4-HA,159,0,432,0,0,432,T
4-HA,160,430,0,0,0,430,A
4-HA,161,443,0,0,0,443,A
4-HA,162,0,442,0,0,442,T
4-HA,163,1,0,444,0,445,G
4-HA,164,0,0,0,465,465,C
4-HA,165,0,458,0,0,458,T
4-HA,166,460,0,0,0,460,A
4-HA,167,0,0,1,458,459,C
4-HA,168,0,458,0,0,458,T
4-HA,169,0,3,459,0,462,G
4-HA,170,463,1,0,0,464,A
4-HA,171,0,0,465,0,465,G
4-HA,172,0,0,0,464,464,C
4-HA,173,0,460,0,0,460,T
4-HA,174,2,1,475,0,478,G
4-HA,175,0,0,482,0,482,G
4-HA,176,0,486,0,0,486,T
4-HA,177,0,486,0,0,486,T
4-HA,178,3,0,0,484,487,C
4-HA,179,481,0,2,0,483,A
4-HA,180,0,2,487,0,489,G
4-HA,181,487,0,1,0,488,A
4-HA,182,0,0,507,0,507,G
4-HA,183,0,500,0,0,500,T
4-HA,184,0,495,0,0,495,T
4-HA,185,1,0,0,496,497,C
4-HA,186,3,0,0,495,498,C
4-HA,187,0,496,0,0,496,T
4-HA,188,2,0,0,497,499,C
4-HA,189,498,0,1,0,499,A
4-HA,190,502,0,0,0,502,A
4-HA,191,0,0,0,506,506,C
4-HA,192,496,0,1,0,497,A
4-HA,193,0,0,512,0,512,G
4-HA,194,0,0,511,0,511,G
4-HA,195,0,512,0,0,512,T
4-HA,196,0,5,507,0,512,G
4-HA,197,511,1,1,0,513,A
4-HA,198,515,0,0,0,515,A
4-HA,199,534,0,1,0,535,A
4-HA,200,0,531,0,0,531,T
4-HA,201,533,0,0,0,533,A
4-HA,202,0,529,0,0,529,T
4-HA,203,0,0,528,0,528,G
4-HA,204,0,1,0,535,536,C
4-HA,205,1,7,528,0,536,G
4-HA,206,536,1,1,0,538,A
4-HA,207,0,1,0,536,537,C
4-HA,208,526,0,0,0,526,A
4-HA,209,0,0,564,0,564,G
4-HA,210,0,562,0,1,563,T
4-HA,211,3,0,0,564,567,C
4-HA,212,1,0,0,563,564,C
4-HA,213,2,563,0,1,566,T
4-HA,214,0,0,0,576,576,C
4-HA,215,578,0,0,0,578,A
4-HA,216,0,578,0,0,578,T
4-HA,217,0,1,0,578,579,C
4-HA,218,550,0,0,0,550,A
4-HA,219,0,0,550,0,550,G
4-HA,220,546,0,0,0,546,A
4-HA,221,0,545,0,1,546,T
4-HA,222,2,0,0,545,547,C
4-HA,223,3,0,0,535,538,C
4-HA,224,0,534,0,0,534,T
4-HA,225,0,534,0,0,534,T
4-HA,226,0,3,532,0,535,G
4-HA,227,533,0,1,0,534,A
4-HA,228,0,531,0,0,531,T
4-HA,229,0,2,531,0,533,G
4-HA,230,0,3,532,0,535,G
4-HA,231,532,0,2,0,534,A
4-HA,232,535,0,0,0,535,A
4-HA,233,536,0,0,0,536,A
4-HA,234,539,0,0,0,539,A
4-HA,235,535,0,0,0,535,A
4-HA,236,538,0,0,0,538,A
4-HA,237,0,0,0,540,540,C
4-HA,238,0,535,0,1,536,T
4-HA,239,0,0,541,0,541,G
4-HA,240,0,0,0,540,540,C
4-HA,241,540,0,0,0,540,A
4-HA,242,0,1,0,552,553,C
4-HA,243,551,0,1,0,552,A
4-HA,244,0,0,0,613,613,C
4-HA,245,0,610,1,0,611,T
4-HA,246,627,0,0,0,627,A
4-HA,247,626,0,0,0,626,A
4-HA,248,0,627,0,0,627,T
4-HA,249,629,0,0,0,629,A
4-HA,250,0,4,626,0,630,G
4-HA,251,617,0,0,0,617,A
4-HA,252,0,607,0,0,607,T
4-HA,253,0,0,563,0,563,G
4-HA,254,0,0,0,566,566,C
4-HA,255,0,555,0,1,556,T
4-HA,256,6,0,0,589,595,C
4-HA,257,0,594,0,1,595,T
4-HA,258,605,0,0,1,606,A
4-HA,259,0,607,0,0,607,T
4-HA,260,0,601,0,0,601,T
4-HA,261,0,0,608,0,608,G
4-HA,262,0,1,606,0,607,G
4-HA,263,1,4,608,0,613,G
4-HA,264,601,0,2,0,603,A
4-HA,265,0,4,587,0,591,G
4-HA,266,577,0,0,0,577,A
4-HA,267,0,0,1,653,654,C
4-HA,268,2,0,0,655,657,C
4-HA,269,3,1,0,655,659,C
4-HA,270,0,663,0,1,664,T
4-HA,271,2,1,0,669,672,C
4-HA,272,675,0,0,0,675,A
4-HA,273,0,1,742,0,743,G
4-HA,274,1,741,0,0,742,T
4-HA,275,1,0,747,0,748,G
4-HA,276,0,733,0,3,736,T
4-HA,277,1,5,723,0,729,G
4-HA,278,732,0,0,0,732,A
4-HA,279,0,731,0,1,732,T
4-HA,280,0,1,726,0,727,G
4-HA,281,0,0,727,0,727,G
4-HA,282,0,0,0,724,724,C
4-HA,283,0,720,0,2,722,T
4-HA,284,0,720,0,0,720,T
4-HA,285,2,1,0,717,720,C
4-HA,286,2,0,0,716,718,C
4-HA,287,722,0,0,0,722,A
4-HA,288,722,0,1,0,723,A
4-HA,289,722,0,0,0,722,A
4-HA,290,724,1,0,0,725,A
4-HA,291,0,728,0,0,728,T
4-HA,292,724,0,0,0,724,A
4-HA,293,727,1,1,0,729,A
4-HA,294,0,2,733,0,735,G
4-HA,295,739,0,1,0,740,A
4-HA,296,735,0,0,0,735,A
4-HA,297,737,0,0,0,737,A
4-HA,298,0,735,0,0,735,T
4-HA,299,1,0,733,0,734,G
4-HA,300,0,2,731,0,733,G
4-HA,301,0,6,729,0,735,G
4-HA,302,735,0,1,0,736,A
4-HA,303,0,0,0,744,744,C
4-HA,304,2,1,0,731,734,C
4-HA,305,0,749,1,0,750,T
4-HA,306,0,749,0,0,749,T
4-HA,307,0,750,0,0,750,T
4-HA,308,0,755,0,1,756,T
4-HA,309,0,758,0,0,758,T
4-HA,310,2,0,759,0,761,G
4-HA,311,0,758,0,1,759,T
4-HA,312,1,752,0,0,753,T
4-HA,313,0,6,749,0,755,G
4-HA,314,742,0,2,0,744,A
4-HA,315,749,0,0,0,749,A
4-HA,316,0,1,0,749,750,C
4-HA,317,2,0,746,0,748,G
4-HA,318,1,0,0,752,753,C
4-HA,319,754,0,0,0,754,A
4-HA,320,0,0,774,0,774,G
4-HA,321,0,0,0,771,771,C
4-HA,322,770,0,0,0,770,A
4-HA,323,774,0,0,0,774,A
4-HA,324,765,1,0,0,766,A
4-HA,325,0,0,785,0,785,G
4-HA,326,2,0,0,783,785,C
4-HA,327,1,0,0,781,782,C
4-HA,328,3,0,0,769,772,C
4-HA,329,787,0,0,0,787,A
4-HA,330,0,0,0,810,810,C
4-HA,331,812,0,0,0,812,A
4-HA,332,1,2,811,0,814,G
4-HA,333,0,0,0,815,815,C
4-HA,334,805,1,1,0,807,A
4-HA,335,819,0,3,0,822,A
4-HA,336,0,0,0,871,871,C
4-HA,337,0,865,0,0,865,T
4-HA,338,0,0,871,0,871,G
4-HA,339,0,831,0,33,864,T
4-HA,340,0,864,0,1,865,T
4-HA,341,860,1,1,0,862,A
4-HA,342,0,1,0,919,920,C
4-HA,343,6,0,0,916,922,C
4-HA,344,2,1,0,941,944,C
4-HA,345,0,905,0,0,905,T
4-HA,346,0,901,0,0,901,T
4-HA,347,909,0,0,0,909,A
4-HA,348,0,908,0,0,908,T
4-HA,349,0,4,904,0,908,G
4-HA,350,905,0,0,0,905,A
4-HA,351,0,838,0,1,839,T
4-HA,352,2,1,852,0,855,G
4-HA,353,0,842,0,0,842,T
4-HA,354,1,0,841,0,842,G
4-HA,355,0,0,0,840,840,C
4-HA,356,4,0,0,837,841,C
4-HA,357,0,0,855,0,855,G
4-HA,358,0,5,865,0,870,G
4-HA,359,869,0,0,0,869,A
4-HA,360,0,870,0,1,871,T
4-HA,361,0,866,0,0,866,T
4-HA,362,872,0,2,0,874,A
4-HA,363,1,872,0,0,873,T
4-HA,364,2,1,872,0,875,G
4-HA,365,0,1,0,874,875,C
4-HA,366,4,0,0,866,870,C
4-HA,367,0,880,0,0,880,T
4-HA,368,3,1,0,920,924,C
4-HA,369,2,4,0,922,928,C
4-HA,370,3,0,0,933,936,C
4-HA,371,1,927,0,1,929,T
4-HA,372,1,928,0,0,929,T
4-HA,373,925,0,1,2,928,A
4-HA,374,0,1,948,0,949,G
4-HA,375,0,0,949,0,949,G
4-HA,376,0,940,0,3,943,T
4-HA,377,3,0,0,929,932,C
4-HA,378,923,0,2,0,925,A
4-HA,379,0,0,0,941,941,C
4-HA,380,0,942,0,0,942,T
4-HA,381,941,0,0,0,941,A
4-HA,382,0,0,942,0,942,G
4-HA,383,0,931,0,0,931,T
4-HA,384,0,929,0,0,929,T
4-HA,385,2,2,938,0,942,G
4-HA,386,0,0,0,939,939,C
4-HA,387,3,0,1,936,940,C
4-HA,388,0,923,0,2,925,T
4-HA,389,1,0,0,931,932,C
4-HA,390,958,0,0,0,958,A
4-HA,391,0,960,0,0,960,T
4-HA,392,1,0,0,962,963,C
4-HA,393,6,4,1,952,963,C
4-HA,394,1,3,951,0,955,G
4-HA,395,1,1,968,0,970,G
4-HA,396,0,0,0,971,971,C
4-HA,397,976,0,3,0,979,A
4-HA,398,0,0,0,994,994,C
4-HA,399,973,0,2,0,975,A
4-HA,400,0,0,0,986,986,C
4-HA,401,0,978,1,2,981,T
4-HA,402,1,1,993,0,995,G
4-HA,403,1,5,1007,0,1013,G
4-HA,404,1003,0,1,0,1004,A
4-HA,405,0,0,1020,0,1020,G
4-HA,406,0,1014,1,0,1015,T
4-HA,407,0,1011,0,0,1011,T
4-HA,408,1,1008,0,3,1012,T
4-HA,409,1005,0,1,0,1006,A
4-HA,410,1005,0,0,0,1005,A
4-HA,411,0,0,0,1011,1011,C
4-HA,412,989,0,3,0,992,A
4-HA,413,992,0,1,0,993,A
4-HA,414,1,983,0,0,984,T
4-HA,415,0,8,976,0,984,G
4-HA,416,982,0,3,0,985,A
4-HA,417,983,0,1,0,984,A
4-HA,418,979,0,4,0,983,A
4-HA,419,1,0,988,0,989,G
4-HA,420,1,0,0,1000,1001,C
4-HA,421,0,992,0,2,994,T
4-HA,422,0,999,0,0,999,T
4-HA,423,2,1,0,1006,1009,C
4-HA,424,1004,1,2,0,1007,A
4-HA,425,1011,0,1,0,1012,A
4-HA,426,0,1011,0,0,1011,T
4-HA,427,0,1008,0,0,1008,T
4-HA,428,1,2,1029,0,1032,G
4-HA,429,0,9,1034,0,1043,G
4-HA,430,1043,0,0,0,1043,A
4-HA,431,0,0,0,1044,1044,C
4-HA,432,0,1033,0,0,1033,T
4-HA,433,2,2,1035,0,1039,G
4-HA,434,1,8,1034,0,1043,G
4-HA,435,1037,0,2,0,1039,A
4-HA,436,0,0,1043,0,1043,G
4-HA,437,0,1024,0,2,1026,T
4-HA,438,9,0,0,1007,1016,C
4-HA,439,1026,0,2,0,1028,A
4-HA,440,0,0,0,1032,1032,C
4-HA,441,0,1032,0,0,1032,T
4-HA,442,4,0,0,1027,1031,C
4-HA,443,1020,0,0,0,1020,A
4-HA,444,1032,0,0,0,1032,A
4-HA,445,1031,0,0,0,1031,A
4-HA,446,1033,0,1,0,1034,A
4-HA,447,0,1,0,1035,1036,C
4-HA,448,0,5,1020,0,1025,G
4-HA,449,0,9,1035,0,1044,G
4-HA,450,1043,0,1,1,1045,A
4-HA,451,1038,0,6,0,1044,A
4-HA,452,0,0,0,1046,1046,C
4-HA,453,1035,0,2,0,1037,A
4-HA,454,1047,0,2,0,1049,A
4-HA,455,0,0,1058,0,1058,G
4-HA,456,0,0,0,1060,1060,C
4-HA,457,0,1041,0,1,1042,T
4-HA,458,1,1,0,1050,1052,C
4-HA,459,0,1047,0,0,1047,T
4-HA,460,1,6,1048,0,1055,G
4-HA,461,0,0,0,1053,1053,C
4-HA,462,0,1049,0,2,1051,T
4-HA,463,0,1069,0,0,1069,T
4-HA,464,0,2,1088,0,1090,G
4-HA,465,2,2,0,1089,1093,C
4-HA,466,1094,0,0,0,1094,A
4-HA,467,0,1085,1,0,1086,T
4-HA,468,1078,0,5,0,1083,A
4-HA,469,1077,0,1,0,1078,A
4-HA,470,0,2,1078,0,1080,G
4-HA,471,0,7,1069,1,1077,G
4-HA,472,1042,0,1,0,1043,A
4-HA,473,1,3,1026,0,1030,G
4-HA,474,1021,0,1,0,1022,A
4-HA,475,0,1051,0,0,1051,T
4-HA,476,2,0,0,1057,1059,C
4-HA,477,0,1055,0,0,1055,T
4-HA,478,1053,0,1,0,1054,A
4-HA,479,1050,1,0,0,1051,A
4-HA,480,1046,0,0,0,1046,A
4-HA,481,1046,0,3,0,1049,A
4-HA,482,1049,0,2,0,1051,A
4-HA,483,0,0,0,1055,1055,C
4-HA,484,1028,0,0,0,1028,A
4-HA,485,0,1,1037,0,1038,G
4-HA,486,1,1033,0,1,1035,T
4-HA,487,0,1049,0,0,1049,T
4-HA,488,0,1053,0,0,1053,T
4-HA,489,5,0,0,1076,1081,C
4-HA,490,0,1081,0,0,1081,T
4-HA,491,0,1090,0,0,1090,T
4-HA,492,0,1089,0,1,1090,T
4-HA,493,1079,1,1,0,1081,A
4-HA,494,0,0,1091,0,1091,G
4-HA,495,0,1085,0,0,1085,T
4-HA,496,1081,0,0,0,1081,A
4-HA,497,0,2,1079,0,1081,G
4-HA,498,1059,0,2,0,1061,A
4-HA,499,0,1057,0,1,1058,T
4-HA,500,0,1056,0,0,1056,T
4-HA,501,0,10,1068,0,1078,G
4-HA,502,1076,0,1,1,1078,A
4-HA,503,1077,0,2,0,1079,A
4-HA,504,0,1075,0,0,1075,T
4-HA,505,0,1064,1,0,1065,T
4-HA,506,2,1,1085,0,1088,G
4-HA,507,0,0,1090,0,1090,G
4-HA,508,0,1087,0,1,1088,T
4-HA,509,0,1084,0,0,1084,T
4-HA,510,9,7,1059,0,1075,G
4-HA,511,1073,0,0,0,1073,A
4-HA,512,3,0,0,1067,1070,C
4-HA,513,7,0,0,1056,1063,C
4-HA,514,7,0,0,1073,1080,C
4-HA,515,1090,0,1,0,1091,A
4-HA,516,0,0,0,1094,1094,C
4-HA,517,0,1092,0,0,1092,T
4-HA,518,0,1096,0,0,1096,T
4-HA,519,1090,0,0,0,1090,A
4-HA,520,1086,0,0,0,1086,A
4-HA,521,1084,1,1,0,1086,A
4-HA,522,1,0,0,1061,1062,C
4-HA,523,0,1093,0,0,1093,T
4-HA,524,0,1098,0,1,1099,T
4-HA,525,4,0,1,1100,1105,C
4-HA,526,1107,0,1,0,1108,A
4-HA,527,1108,0,1,0,1109,A
4-HA,528,1104,1,1,0,1106,A
4-HA,529,0,1106,0,0,1106,T
4-HA,530,1128,0,0,0,1128,A
4-HA,531,0,1,0,1125,1126,C
4-HA,532,6,0,0,1090,1096,C
4-HA,533,0,0,0,1098,1098,C
4-HA,534,1090,0,2,0,1092,A
4-HA,535,1,1,1135,0,1137,G
4-HA,536,2,1,0,1139,1142,C
4-HA,537,1140,0,0,0,1140,A
4-HA,538,0,1130,1,2,1133,T
4-HA,539,0,1117,0,2,1119,T
4-HA,540,0,10,1139,0,1149,G
4-HA,541,1149,0,0,0,1149,A
4-HA,542,1147,0,4,0,1151,A
4-HA,543,0,0,0,1149,1149,C
4-HA,544,0,0,1120,0,1120,G
4-HA,545,0,1125,0,0,1125,T
4-HA,546,1,11,1116,0,1128,G
4-HA,547,1130,0,2,0,1132,A
4-HA,548,0,1,1,1126,1128,C
4-HA,549,0,1100,0,1,1101,T
4-HA,550,1128,0,0,0,1128,A
4-HA,551,1,1113,0,7,1121,T
4-HA,552,0,2,1133,0,1135,G
4-HA,553,1,0,0,1131,1132,C
4-HA,554,4,1,0,1108,1113,C
4-HA,555,1108,0,0,0,1108,A
4-HA,556,1105,0,3,0,1108,A
4-HA,557,1130,1,1,0,1132,A
4-HA,558,0,1,0,1138,1139,C
4-HA,559,1115,0,2,0,1117,A
4-HA,560,1120,0,0,0,1120,A
4-HA,561,1,1110,0,0,1111,T
4-HA,562,0,18,1094,0,1112,G
4-HA,563,1108,1,0,1,1110,A
4-HA,564,1103,2,2,0,1107,A
4-HA,565,0,0,0,1075,1075,C
4-HA,566,1088,0,2,0,1090,A
4-HA,567,1096,0,0,0,1096,A
4-HA,568,0,1092,0,0,1092,T
4-HA,569,0,1095,1,1,1097,T
4-HA,570,0,1095,0,0,1095,T
4-HA,571,0,12,1080,0,1092,G
4-HA,572,1094,0,1,0,1095,A
4-HA,573,1,0,0,1093,1094,C
4-HA,574,1088,0,2,0,1090,A
4-HA,575,1090,0,0,0,1090,A
4-HA,576,1100,0,0,1,1101,A
4-HA,577,0,1109,0,0,1109,T
4-HA,578,0,1102,0,1,1103,T
4-HA,579,0,0,1120,0,1120,G
4-HA,580,0,1113,0,2,1115,T
4-HA,581,1118,0,1,0,1119,A
4-HA,582,0,0,0,1140,1140,C
4-HA,583,1135,0,2,1,1138,A
4-HA,584,0,1153,0,0,1153,T
4-HA,585,0,1142,1,0,1143,T
4-HA,586,0,1141,0,0,1141,T
4-HA,587,0,2,1132,0,1134,G
4-HA,588,0,0,1128,0,1128,G
4-HA,589,1,4,1125,0,1130,G
4-HA,590,0,7,1121,0,1128,G
4-HA,591,0,6,1109,0,1115,G
4-HA,592,0,1,1149,0,1150,G
4-HA,593,0,1128,0,2,1130,T
4-HA,594,0,1130,0,3,1133,T
4-HA,595,6,0,0,1126,1132,C
4-HA,596,1108,24,0,0,1132,A
4-HA,597,1,1,0,1139,1141,C
4-HA,598,0,0,0,1141,1141,C
4-HA,599,1139,0,2,0,1141,A
4-HA,600,1,0,0,1150,1151,C
4-HA,601,0,0,0,1133,1133,C
4-HA,602,2,2,0,1119,1123,C
4-HA,603,0,4,1118,0,1122,G
4-HA,604,1,4,1142,0,1147,G
4-HA,605,0,2,1151,1,1154,G
4-HA,606,0,1147,0,0,1147,T
4-HA,607,1148,1,2,0,1151,A
4-HA,608,0,1,0,1147,1148,C
4-HA,609,1,9,1128,0,1138,G
4-HA,610,1,5,1152,0,1158,G
4-HA,611,1155,1,2,0,1158,A
4-HA,612,0,1,0,1157,1158,C
4-HA,613,1134,0,0,0,1134,A
4-HA,614,1135,0,1,1,1137,A
4-HA,615,1128,1,3,1,1133,A
4-HA,616,0,7,1154,0,1161,G
4-HA,617,1151,2,4,0,1157,A
4-HA,618,0,1,0,1157,1158,C
4-HA,619,4,0,1,1133,1138,C
4-HA,620,1140,0,0,0,1140,A
4-HA,621,1137,0,0,0,1137,A
4-HA,622,1148,0,0,0,1148,A
4-HA,623,1,1151,0,0,1152,T
4-HA,624,3,0,0,1155,1158,C
4-HA,625,0,1103,0,1,1104,T
4-HA,626,0,1100,1,1,1102,T
4-HA,627,0,1,0,1111,1112,C
4-HA,628,2,0,0,1113,1115,C
4-HA,629,0,1114,0,2,1116,T
4-HA,630,1,0,1125,1,1127,G
4-HA,631,2,1100,0,0,1102,T
4-HA,632,1118,0,0,0,1118,A
4-HA,633,0,1103,1,2,1106,T
4-HA,634,1,0,1110,0,1111,G
4-HA,635,1,2,0,1118,1121,C
4-HA,636,0,1110,0,4,1114,T
4-HA,637,9,1,0,1109,1119,C
4-HA,638,1114,0,0,0,1114,A
4-HA,639,1118,0,1,0,1119,A
4-HA,640,1,0,1119,0,1120,G
4-HA,641,0,2,0,1126,1128,C
4-HA,642,1126,0,0,0,1126,A
4-HA,643,1,1113,0,1,1115,T
4-HA,644,5,0,0,1106,1111,C
4-HA,645,1093,0,11,0,1104,A
4-HA,646,0,4,1110,0,1114,G
4-HA,647,0,4,1112,0,1116,G
4-HA,648,1109,1,0,0,1110,A
4-HA,649,1109,0,2,0,1111,A
4-HA,650,0,10,1112,0,1122,G
4-HA,651,1114,0,3,0,1117,A
4-HA,652,1141,1,0,0,1142,A
4-HA,653,0,1146,0,2,1148,T
4-HA,654,6,0,0,1143,1149,C
4-HA,655,1142,0,1,0,1143,A
4-HA,656,0,1,0,1149,1150,C
4-HA,657,1147,0,0,1,1148,A
4-HA,658,0,2,1170,0,1172,G
4-HA,659,0,1152,0,0,1152,T
4-HA,660,4,3,0,1147,1154,C
4-HA,661,0,1137,0,4,1141,T
4-HA,662,3,0,0,1172,1175,C
4-HA,663,0,1174,0,2,1176,T
4-HA,664,1183,0,1,0,1184,A
4-HA,665,1,1,0,1178,1180,C
4-HA,666,5,0,0,1176,1181,C
4-HA,667,1150,0,1,1,1152,A
4-HA,668,1149,0,1,0,1150,A
4-HA,669,1148,0,2,0,1150,A
4-HA,670,1152,0,0,0,1152,A
4-HA,671,0,1,1147,0,1148,G
4-HA,672,1116,0,2,0,1118,A
4-HA,673,1117,0,2,0,1119,A
4-HA,674,1,2,1118,0,1121,G
4-HA,675,0,0,0,1120,1120,C
4-HA,676,4,0,0,1123,1127,C
4-HA,677,1123,0,0,1,1124,A
4-HA,678,1125,1,3,0,1129,A
4-HA,679,1,0,0,1129,1130,C
4-HA,680,1127,0,1,0,1128,A
4-HA,681,1129,0,0,1,1130,A
4-HA,682,1127,0,0,0,1127,A
4-HA,683,0,0,0,1164,1164,C
4-HA,684,0,1158,0,0,1158,T
4-HA,685,1,0,1163,0,1164,G
4-HA,686,0,1157,0,2,1159,T
4-HA,687,1155,0,0,1,1156,A
4-HA,688,1159,0,0,0,1159,A
4-HA,689,1,1145,0,3,1149,T
4-HA,690,10,1,0,1145,1156,C
4-HA,691,6,0,0,1157,1163,C
4-HA,692,7,1,0,1134,1142,C
4-HA,693,1,9,1130,0,1140,G
4-HA,694,1139,0,0,0,1139,A
4-HA,695,1136,0,0,0,1136,A
4-HA,696,0,1143,0,0,1143,T
4-HA,697,1139,0,1,0,1140,A
4-HA,698,0,1134,0,0,1134,T
4-HA,699,4,0,0,1129,1133,C
4-HA,700,1,2,1128,0,1131,G
4-HA,701,0,6,1161,0,1167,G
4-HA,702,1162,0,2,0,1164,A
4-HA,703,0,1171,0,1,1172,T
4-HA,704,1,3,0,1163,1167,C
4-HA,705,0,1163,0,2,1165,T
4-HA,706,1164,0,2,0,1166,A
4-HA,707,0,5,1167,0,1172,G
4-HA,708,1178,0,2,0,1180,A
4-HA,709,3,0,0,1175,1178,C
4-HA,710,5,0,0,1137,1142,C
4-HA,711,6,0,0,1138,1144,C
4-HA,712,1123,0,1,1,1125,A
4-HA,713,0,7,1175,0,1182,G
4-HA,714,1177,0,1,0,1178,A
4-HA,715,4,0,1196,0,1200,G
4-HA,716,0,1186,0,1,1187,T
4-HA,717,1178,0,0,0,1178,A
4-HA,718,1174,0,1,0,1175,A
4-HA,719,0,1,1199,0,1200,G
4-HA,720,2,10,1201,0,1213,G
4-HA,721,1200,0,1,0,1201,A
4-HA,722,1117,0,1,0,1118,A
4-HA,723,0,1120,0,0,1120,T
4-HA,724,1112,0,1,0,1113,A
4-HA,725,0,1110,0,0,1110,T
4-HA,726,5,0,0,1113,1118,C
4-HA,727,6,0,0,1106,1112,C
4-HA,728,4,0,0,1082,1086,C
4-HA,729,0,1070,1,1,1072,T
4-HA,730,1076,1,1,0,1078,A
4-HA,731,0,1,1081,0,1082,G
4-HA,732,0,0,0,1085,1085,C
4-HA,733,1056,1,0,0,1057,A
4-HA,734,0,7,1079,0,1086,G
4-HA,735,1075,0,0,0,1075,A
4-HA,736,1081,1,0,0,1082,A
4-HA,737,0,1082,0,0,1082,T
4-HA,738,1075,0,3,0,1078,A
4-HA,739,1077,0,2,0,1079,A
4-HA,740,0,0,1083,0,1083,G
4-HA,741,1,1,0,1082,1084,C
4-HA,742,1084,0,0,0,1084,A
4-HA,743,0,1064,0,0,1064,T
4-HA,744,1,0,0,1124,1125,C
4-HA,745,0,1119,0,1,1120,T
4-HA,746,1118,1,0,0,1119,A
4-HA,747,0,1116,0,1,1117,T
4-HA,748,0,1111,0,1,1112,T
4-HA,749,0,5,1120,0,1125,G
4-HA,750,0,8,1117,0,1125,G
4-HA,751,1120,0,1,0,1121,A
4-HA,752,0,0,0,1118,1118,C
4-HA,753,1033,0,0,2,1035,A
4-HA,754,1067,0,1,1,1069,A
4-HA,755,0,1121,0,0,1121,T
4-HA,756,1149,0,0,0,1149,A
4-HA,757,0,1,1162,0,1163,G
4-HA,758,0,1155,0,0,1155,T
4-HA,759,1150,0,1,0,1151,A
4-HA,760,1159,0,0,0,1159,A
4-HA,761,1186,1,1,0,1188,A
4-HA,762,1201,0,1,0,1202,A
4-HA,763,0,1,0,1221,1222,C
4-HA,764,4,0,0,1172,1176,C
4-HA,765,0,3,1177,0,1180,G
4-HA,766,0,2,1183,0,1185,G
4-HA,767,0,8,1196,0,1204,G
4-HA,768,1214,1,2,0,1217,A
4-HA,769,0,10,1222,1,1233,G
4-HA,770,1254,0,0,0,1254,A
4-HA,771,0,0,0,1258,1258,C
4-HA,772,1249,1,1,9,1260,A
4-HA,773,0,1268,0,1,1269,T
4-HA,774,1282,0,1,0,1283,A
4-HA,775,0,0,0,1309,1309,C
4-HA,776,0,1297,0,1,1298,T
4-HA,777,0,1310,0,0,1310,T
4-HA,778,0,1306,0,6,1312,T
4-HA,779,0,1302,0,1,1303,T
4-HA,780,1,19,1301,0,1321,G
4-HA,781,1326,0,3,1,1330,A
4-HA,782,0,1332,0,0,1332,T
4-HA,783,0,1361,1,1,1363,T
4-HA,784,1354,0,1,0,1355,A
4-HA,785,1365,0,0,1,1366,A
4-HA,786,0,0,0,1390,1390,C
4-HA,787,1384,0,0,3,1387,A
4-HA,788,1,2,1466,0,1469,G
4-HA,789,3,1,0,1462,1466,C
4-HA,790,1464,0,2,0,1466,A
4-HA,791,0,1,0,1482,1483,C
4-HA,792,1470,0,2,0,1472,A
4-HA,793,0,6,1494,0,1500,G
4-HA,794,0,5,1496,0,1501,G
4-HA,795,1,13,1549,0,1563,G
4-HA,796,1553,0,2,0,1555,A
4-HA,797,1559,0,2,0,1561,A
4-HA,798,0,1565,0,1,1566,T
4-HA,799,8,0,0,1567,1575,C
4-HA,800,0,1588,0,0,1588,T
4-HA,801,1593,0,0,0,1593,A
4-HA,802,1587,0,1,0,1588,A
4-HA,803,0,1580,0,1,1581,T
4-HA,804,0,1542,0,1,1543,T
4-HA,805,1,1,1576,0,1578,G
4-HA,806,0,0,0,1653,1653,C
4-HA,807,0,1724,0,4,1728,T
4-HA,808,11,0,0,1785,1796,C
4-HA,809,0,1,0,1787,1788,C
4-HA,810,0,1788,0,1,1789,T
4-HA,811,1789,1,2,0,1792,A
4-HA,812,0,6,1788,0,1794,G
4-HA,813,0,6,1815,0,1821,G
4-HA,814,1,3,1819,0,1823,G
4-HA,815,2,0,1807,0,1809,G
4-HA,816,0,1765,0,1,1766,T
4-HA,817,0,1746,1,1,1748,T
4-HA,818,1745,0,1,1,1747,A
4-HA,819,0,0,0,1783,1783,C
4-HA,820,1,1778,0,1,1780,T
4-HA,821,0,1794,0,1,1795,T
4-HA,822,7,0,1,1784,1792,C
4-HA,823,1788,0,1,0,1789,A
4-HA,824,1791,1,0,0,1792,A
4-HA,825,1796,0,3,0,1799,A
4-HA,826,1811,0,1,0,1812,A
4-HA,827,0,1813,0,0,1813,T
4-HA,828,1804,0,2,0,1806,A
4-HA,829,0,1,0,1806,1807,C
4-HA,830,0,9,1793,0,1802,G
4-HA,831,1807,1,2,0,1810,A
4-HA,832,1812,0,3,1,1816,A
4-HA,833,0,0,1852,0,1852,G
4-HA,834,1,1838,0,1,1840,T
4-HA,835,6,10,1844,0,1860,G
4-HA,836,0,4,1862,0,1866,G
4-HA,837,0,17,1852,0,1869,G
4-HA,838,1858,0,8,0,1866,A
4-HA,839,1861,1,4,0,1866,A
4-HA,840,1863,1,3,0,1867,A
4-HA,841,1859,0,7,0,1866,A
4-HA,842,0,1,1900,0,1901,G
4-HA,843,2,0,0,1898,1900,C
4-HA,844,1,1885,1,3,1890,T
4-HA,845,11,0,0,1922,1933,C
4-HA,846,1931,0,3,0,1934,A
4-HA,847,1948,1,1,0,1950,A
4-HA,848,0,1949,0,1,1950,T
4-HA,849,1978,0,0,0,1978,A
4-HA,850,1981,1,1,0,1983,A
4-HA,851,0,1953,0,0,1953,T
4-HA,852,3,16,1935,0,1954,G
4-HA,853,1944,0,2,0,1946,A
4-HA,854,0,16,2004,0,2020,G
4-HA,855,2018,0,0,0,2018,A
4-HA,856,1,2003,0,3,2007,T
4-HA,857,11,0,0,2036,2047,C
4-HA,858,2037,0,0,0,2037,A
4-HA,859,0,5,2077,0,2082,G
4-HA,860,2082,1,2,0,2085,A
4-HA,861,0,2075,0,3,2078,T
4-HA,862,2,2,2078,0,2082,G
4-HA,863,1,4,0,2037,2042,C
4-HA,864,2037,1,3,0,2041,A
4-HA,865,0,1,0,2080,2081,C
4-HA,866,4,0,0,2066,2070,C
4-HA,867,7,1,0,2063,2071,C
4-HA,868,2054,0,0,0,2054,A
4-HA,869,0,2042,0,1,2043,T
4-HA,870,0,2040,0,6,2046,T
4-HA,871,4,10,2062,0,2076,G
4-HA,872,3,0,2071,0,2074,G
4-HA,873,1,2,0,2071,2074,C
4-HA,874,2036,1,3,0,2040,A
4-HA,875,2034,1,2,0,2037,A
4-HA,876,2056,1,2,0,2059,A
4-HA,877,0,2065,0,0,2065,T
4-HA,878,0,0,2068,0,2068,G
4-HA,879,2,0,1,2066,2069,C
4-HA,880,2043,1,0,0,2044,A
4-HA,881,2104,0,1,0,2105,A
4-HA,882,0,2110,0,1,2111,T
4-HA,883,0,2114,1,1,2116,T
4-HA,884,9,1,0,2113,2123,C
4-HA,885,0,2089,1,3,2093,T
4-HA,886,0,17,2105,0,2122,G
4-HA,887,2117,0,1,0,2118,A
4-HA,888,2133,0,0,0,2133,A
4-HA,889,0,2133,0,2,2135,T
4-HA,890,0,1,2113,0,2114,G
4-HA,891,0,3,0,2130,2133,C
4-HA,892,2115,2,2,1,2120,A
4-HA,893,0,2114,0,4,2118,T
4-HA,894,10,0,1,2112,2123,C
4-HA,895,2127,1,2,0,2130,A
4-HA,896,0,0,0,2229,2229,C
4-HA,897,0,2215,0,2,2217,T
4-HA,898,14,0,0,2215,2229,C
4-HA,899,6,1,0,2217,2224,C
4-HA,900,2244,1,1,1,2247,A
4-HA,901,2241,0,2,1,2244,A
4-HA,902,2238,1,1,1,2241,A
4-HA,903,0,2156,0,6,2162,T
4-HA,904,0,11,2176,0,2187,G
4-HA,905,1,4,2187,0,2192,G
4-HA,906,2190,0,1,0,2191,A
4-HA,907,2196,0,2,2,2200,A
4-HA,908,0,0,2207,0,2207,G
4-HA,909,3,0,0,2178,2181,C
4-HA,910,2174,2,1,1,2178,A
4-HA,911,0,2179,0,2,2181,T
4-HA,912,2,2167,0,9,2178,T
4-HA,913,13,0,0,2254,2267,C
4-HA,914,4,1,0,2262,2267,C
4-HA,915,2,0,0,2263,2265,C
4-HA,916,2261,0,0,0,2261,A
4-HA,917,2297,0,1,0,2298,A
4-HA,918,0,2327,0,6,2333,T
4-HA,919,0,31,2302,0,2333,G
4-HA,920,2329,1,2,1,2333,A
4-HA,921,1,1,0,2329,2331,C
4-HA,922,2274,0,2,0,2276,A
4-HA,923,2283,0,0,0,2283,A
4-HA,924,2272,0,4,1,2277,A
4-HA,925,0,2,0,2294,2296,C
4-HA,926,14,1,0,2251,2266,C
4-HA,927,2231,0,4,1,2236,A
4-HA,928,0,2243,0,2,2245,T
4-HA,929,0,2234,1,2,2237,T
4-HA,930,12,0,0,2234,2246,C
4-HA,931,4,0,0,2244,2248,C
4-HA,932,2239,0,2,1,2242,A
4-HA,933,2235,1,1,0,2237,A
4-HA,934,2243,0,2,0,2245,A
4-HA,935,2312,1,1,1,2315,A
4-HA,936,0,2306,0,0,2306,T
4-HA,937,0,1,2316,0,2317,G
4-HA,938,0,2318,0,2,2320,T
4-HA,939,2321,0,2,1,2324,A
4-HA,940,2326,0,0,1,2327,A
4-HA,941,2321,0,3,1,2325,A
4-HA,942,1,3,0,2333,2337,C
4-HA,943,2305,0,1,1,2307,A
4-HA,944,1,9,2337,0,2347,G
4-HA,945,0,10,2346,0,2356,G
4-HA,946,2393,0,4,0,2397,A
4-HA,947,0,2400,1,3,2404,T
4-HA,948,14,3,0,2409,2426,C
4-HA,949,2439,0,1,0,2440,A
4-HA,950,0,8,0,2502,2510,C
4-HA,951,2513,1,0,0,2514,A
4-HA,952,0,2607,0,0,2607,T
4-HA,953,2541,0,4,0,2545,A
4-HA,954,1,5,0,2519,2525,C
4-HA,955,0,4,2456,1,2461,G
4-HA,956,0,3,2464,0,2467,G
4-HA,957,2,4,2452,0,2458,G
4-HA,958,1,0,2464,0,2465,G
4-HA,959,2,1,0,2399,2402,C
4-HA,960,2,1,0,2393,2396,C
4-HA,961,0,2352,0,1,2353,T
4-HA,962,0,0,2570,0,2570,G
4-HA,963,1,2567,0,3,2571,T
4-HA,964,16,0,0,2559,2575,C
4-HA,965,3,1,0,2569,2573,C
4-HA,966,6,2,0,2564,2572,C
4-HA,967,2553,0,3,0,2556,A
4-HA,968,1,9,2571,1,2582,G
4-HA,969,2580,0,0,0,2580,A
4-HA,970,0,2575,0,1,2576,T
4-HA,971,2425,1,0,0,2426,A
4-HA,972,0,2397,0,1,2398,T
4-HA,973,1,0,2405,0,2406,G
4-HA,974,1,2401,0,1,2403,T
4-HA,975,0,2375,0,0,2375,T
4-HA,976,2401,0,1,0,2402,A
4-HA,977,2380,0,2,0,2382,A
4-HA,978,3,3,2408,0,2414,G
4-HA,979,1,1,0,2408,2410,C
4-HA,980,2344,2,1,0,2347,A
4-HA,981,2338,0,6,0,2344,A
4-HA,982,2334,1,1,1,2337,A
4-HA,983,2338,0,4,0,2342,A
4-HA,984,0,0,0,2347,2347,C
4-HA,985,2327,0,5,0,2332,A
4-HA,986,0,1,0,2359,2360,C
4-HA,987,0,2315,1,2,2318,T
4-HA,988,13,0,0,2323,2336,C
4-HA,989,1,2333,0,1,2335,T
4-HA,990,2,9,2351,0,2362,G
4-HA,991,2357,0,0,0,2357,A
4-HA,992,2348,0,2,1,2351,A
4-HA,993,2359,0,1,0,2360,A
4-HA,994,0,2346,0,1,2347,T
4-HA,995,0,2337,0,2,2339,T
4-HA,996,0,11,2346,1,2358,G
4-HA,997,1,3,2345,0,2349,G
4-HA,998,1,1,0,2351,2353,C
4-HA,999,2337,0,1,0,2338,A
4-HA,1000,2345,1,0,0,2346,A
4-HA,1001,1,0,0,2347,2348,C
4-HA,1002,2341,0,1,0,2342,A
4-HA,1003,0,3,2372,0,2375,G
4-HA,1004,0,6,2360,0,2366,G
4-HA,1005,0,6,2359,0,2365,G
4-HA,1006,2367,0,3,2,2372,A
4-HA,1007,1,2355,0,0,2356,T
4-HA,1008,0,1,2355,0,2356,G
4-HA,1009,0,1,0,2357,2358,C
4-HA,1010,1,6,2365,0,2372,G
4-HA,1011,2397,0,1,0,2398,A
4-HA,1012,2373,1,1,0,2375,A
4-HA,1013,2386,0,1,0,2387,A
4-HA,1014,0,2346,1,16,2363,T
4-HA,1015,4,1,2400,0,2405,G
4-HA,1016,0,2394,1,2,2397,T
4-HA,1017,2393,1,3,0,2397,A
4-HA,1018,1,0,0,2389,2390,C
4-HA,1019,13,1,0,2357,2371,C
4-HA,1020,2335,0,1,0,2336,A
4-HA,1021,0,15,2332,0,2347,G
4-HA,1022,2307,0,0,0,2307,A
4-HA,1023,0,11,2318,0,2329,G
4-HA,1024,2275,0,2,0,2277,A
4-HA,1025,2267,0,5,0,2272,A
4-HA,1026,2278,0,6,0,2284,A
4-HA,1027,0,1,0,2285,2286,C
4-HA,1028,2276,0,1,0,2277,A
4-HA,1029,2309,0,0,0,2309,A
4-HA,1030,2307,2,2,0,2311,A
4-HA,1031,1,0,0,2325,2326,C
4-HA,1032,0,2310,0,0,2310,T
4-HA,1033,2298,0,1,0,2299,A
4-HA,1034,0,5,2288,0,2293,G
4-HA,1035,2283,0,2,0,2285,A
4-HA,1036,0,5,2328,0,2333,G
4-HA,1037,0,3,2314,0,2317,G
4-HA,1038,5,1,0,2283,2289,C
4-HA,1039,2282,0,4,0,2286,A
4-HA,1040,0,2283,0,2,2285,T
4-HA,1041,2297,0,0,0,2297,A
4-HA,1042,2,2288,1,0,2291,T
4-HA,1043,0,2274,1,1,2276,T
4-HA,1044,0,2264,0,14,2278,T
4-HA,1045,1,5,2214,0,2220,G
4-HA,1046,0,7,2216,0,2223,G
4-HA,1047,1,5,0,2211,2217,C
4-HA,1048,0,2,2213,0,2215,G
4-HA,1049,3,0,0,2197,2200,C
4-HA,1050,2185,0,0,0,2185,A
4-HA,1051,2208,0,1,0,2209,A
4-HA,1052,0,2202,1,2,2205,T
4-HA,1053,14,1,0,2199,2214,C
4-HA,1054,2,3,2212,0,2217,G
4-HA,1055,1,1,0,2206,2208,C
4-HA,1056,3,4,2205,0,2212,G
4-HA,1057,1,7,2204,0,2212,G
4-HA,1058,0,0,2239,1,2240,G
4-HA,1059,2,2229,0,0,2231,T
4-HA,1060,0,2202,0,2,2204,T
4-HA,1061,0,2199,0,2,2201,T
4-HA,1062,14,0,0,2202,2216,C
4-HA,1063,2214,0,1,0,2215,A
4-HA,1064,0,2215,0,3,2218,T
4-HA,1065,2220,1,3,0,2224,A
4-HA,1066,1,10,2246,0,2257,G
4-HA,1067,2210,0,0,0,2210,A
4-HA,1068,2207,0,3,0,2210,A
4-HA,1069,2215,0,0,0,2215,A
4-HA,1070,2221,0,1,0,2222,A
4-HA,1071,0,2209,0,1,2210,T
4-HA,1072,2,14,2239,0,2255,G
4-HA,1073,0,0,2261,0,2261,G
4-HA,1074,0,2250,0,1,2251,T
4-HA,1075,1,2207,0,4,2212,T
4-HA,1076,0,10,2203,0,2213,G
4-HA,1077,1,2,2220,0,2223,G
4-HA,1078,1,7,2222,1,2231,G
4-HA,1079,2206,1,5,0,2212,A
4-HA,1080,0,6,2223,1,2230,G
4-HA,1081,0,5,2195,0,2200,G
4-HA,1082,0,3,2234,0,2237,G
4-HA,1083,2220,2,5,0,2227,A
4-HA,1084,2257,0,1,0,2258,A
4-HA,1085,1,2251,0,1,2253,T
4-HA,1086,1,10,2247,0,2258,G
4-HA,1087,2,1,2308,0,2311,G
4-HA,1088,0,2284,0,3,2287,T
4-HA,1089,4,9,2267,0,2280,G
4-HA,1090,1,4,2256,0,2261,G
4-HA,1091,2221,1,5,0,2227,A
4-HA,1092,0,2217,0,11,2228,T
4-HA,1093,0,10,2229,0,2239,G
4-HA,1094,1,0,2269,0,2270,G
4-HA,1095,0,2240,0,2,2242,T
4-HA,1096,1,2180,2,1,2184,T
4-HA,1097,2,19,2169,0,2190,G
4-HA,1098,0,1,2217,0,2218,G
4-HA,1099,1,2208,0,4,2213,T
4-HA,1100,2212,0,2,0,2214,A
4-HA,1101,1,3,0,2104,2108,C
4-HA,1102,2,4,2127,0,2133,G
4-HA,1103,1,0,2197,0,2198,G
4-HA,1104,1,2189,0,5,2195,T
4-HA,1105,0,2192,0,0,2192,T
4-HA,1106,0,2189,0,1,2190,T
4-HA,1107,7,0,0,2152,2159,C
4-HA,1108,2144,0,3,9,2156,A
4-HA,1109,0,3,2152,0,2155,G
4-HA,1110,0,3,2148,0,2151,G
4-HA,1111,0,0,0,2147,2147,C
4-HA,1112,2074,1,0,0,2075,A
4-HA,1113,0,2100,0,4,2104,T
4-HA,1114,14,0,0,2096,2110,C
4-HA,1115,2111,1,1,0,2113,A
4-HA,1116,2112,0,1,0,2113,A
4-HA,1117,2108,0,1,1,2110,A
4-HA,1118,2127,0,0,0,2127,A
4-HA,1119,1,2131,0,2,2134,T
4-HA,1120,0,2133,0,2,2135,T
4-HA,1121,15,1,0,2123,2139,C
4-HA,1122,0,2110,0,0,2110,T
4-HA,1123,3,8,2109,0,2120,G
4-HA,1124,2115,0,4,0,2119,A
4-HA,1125,1,10,2128,0,2139,G
4-HA,1126,0,5,2136,0,2141,G
4-HA,1127,3,6,2152,0,2161,G
4-HA,1128,2152,1,0,1,2154,A
4-HA,1129,2139,1,2,0,2142,A
4-HA,1130,1,6,2128,0,2135,G
4-HA,1131,2170,0,2,0,2172,A
4-HA,1132,0,9,2173,0,2182,G
4-HA,1133,0,10,2186,0,2196,G
4-HA,1134,2178,0,12,0,2190,A
4-HA,1135,0,0,0,2198,2198,C
4-HA,1136,2170,2,4,0,2176,A
4-HA,1137,2169,0,7,0,2176,A
4-HA,1138,0,0,2181,0,2181,G
4-HA,1139,0,2,0,2187,2189,C
4-HA,1140,2148,1,1,0,2150,A
4-HA,1141,0,0,2155,0,2155,G
4-HA,1142,1,1,0,2146,2148,C
4-HA,1143,2138,0,4,0,2142,A
4-HA,1144,0,6,2163,0,2169,G
4-HA,1145,2146,0,4,0,2150,A
4-HA,1146,0,2188,0,0,2188,T
4-HA,1147,9,9,0,2175,2193,C
4-HA,1148,0,2170,0,9,2179,T
4-HA,1149,12,1,1,2187,2201,C
4-HA,1150,2199,0,2,0,2201,A
4-HA,1151,2195,0,1,0,2196,A
4-HA,1152,2196,0,4,0,2200,A
4-HA,1153,2148,0,3,1,2152,A
4-HA,1154,0,0,2155,1,2156,G
4-HA,1155,2,1,0,2115,2118,C
4-HA,1156,2096,0,2,0,2098,A
4-HA,1157,1,1,0,2135,2137,C
4-HA,1158,1,2120,0,3,2124,T
4-HA,1159,16,0,0,2117,2133,C
4-HA,1160,2127,0,1,0,2128,A
4-HA,1161,2157,0,3,0,2160,A
4-HA,1162,0,1,2156,0,2157,G
4-HA,1163,1,1,0,2149,2151,C
4-HA,1164,2129,0,1,2,2132,A
4-HA,1165,0,1,2147,0,2148,G
4-HA,1166,0,0,0,2114,2114,C
4-HA,1167,2092,0,6,6,2104,A
4-HA,1168,2106,1,0,1,2108,A
4-HA,1169,0,2094,1,2,2097,T
4-HA,1170,4,1,0,2046,2051,C
4-HA,1171,2,11,2047,0,2060,G
4-HA,1172,2056,0,2,1,2059,A
4-HA,1173,0,2051,0,2,2053,T
4-HA,1174,26,0,1,2012,2039,C
4-HA,1175,2018,1,11,0,2030,A
4-HA,1176,2074,1,0,0,2075,A
4-HA,1177,2082,0,1,0,2083,A
4-HA,1178,0,2070,0,1,2071,T
4-HA,1179,19,0,0,2061,2080,C
4-HA,1180,2047,1,0,0,2048,A
4-HA,1181,2071,0,0,0,2071,A
4-HA,1182,0,2067,0,1,2068,T
4-HA,1183,0,9,2065,0,2074,G
4-HA,1184,0,5,2065,0,2070,G
4-HA,1185,1,10,2035,1,2047,G
4-HA,1186,2035,1,2,0,2038,A
4-HA,1187,2032,0,3,0,2035,A
4-HA,1188,0,0,2073,0,2073,G
4-HA,1189,1,1,0,2073,2075,C
4-HA,1190,0,2060,1,5,2066,T
4-HA,1191,1,11,2147,0,2159,G
4-HA,1192,2151,2,3,0,2156,A
4-HA,1193,2156,0,2,0,2158,A
4-HA,1194,0,2159,0,0,2159,T
4-HA,1195,2103,0,1,0,2104,A
4-HA,1196,0,7,2093,0,2100,G
4-HA,1197,1942,2,3,0,1947,A
4-HA,1198,0,1949,0,2,1951,T
4-HA,1199,0,1955,0,1,1956,T
4-HA,1200,5,18,1954,0,1977,G
4-HA,1201,1969,0,1,0,1970,A
4-HA,1202,1,1964,0,0,1965,T
4-HA,1203,16,2,0,1952,1970,C
4-HA,1204,1,1,1967,0,1969,G
4-HA,1205,1,2,1970,0,1973,G
4-HA,1206,0,6,1977,0,1983,G
4-HA,1207,1973,2,1,0,1976,A
4-HA,1208,1980,0,1,1,1982,A
4-HA,1209,1958,0,4,0,1962,A
4-HA,1210,1970,0,2,0,1972,A
4-HA,1211,0,0,0,1977,1977,C
4-HA,1212,8,0,0,1974,1982,C
4-HA,1213,1964,1,0,0,1965,A
4-HA,1214,1964,0,2,0,1966,A
4-HA,1215,0,0,0,1964,1964,C
4-HA,1216,0,17,1953,0,1970,G
4-HA,1217,1963,0,3,1,1967,A
4-HA,1218,0,7,1961,0,1968,G
4-HA,1219,1969,0,2,0,1971,A
4-HA,1220,1971,0,0,0,1971,A
4-HA,1221,1973,0,0,0,1973,A
4-HA,1222,0,1983,1,4,1988,T
4-HA,1223,0,1975,0,4,1979,T
4-HA,1224,14,0,1,1977,1992,C
4-HA,1225,8,1,0,1975,1984,C
4-HA,1226,1988,1,0,1,1990,A
4-HA,1227,1,1980,0,3,1984,T
4-HA,1228,3,1,1,1982,1987,C
4-HA,1229,1967,1,3,1,1972,A
4-HA,1230,0,9,1989,0,1998,G
4-HA,1231,1974,0,0,0,1974,A
4-HA,1232,0,1970,0,1,1971,T
4-HA,1233,0,1966,0,3,1969,T
4-HA,1234,0,22,1962,0,1984,G
4-HA,1235,1978,1,2,0,1981,A
4-HA,1236,1982,0,0,0,1982,A
4-HA,1237,1981,0,2,0,1983,A
4-HA,1238,1979,1,2,0,1982,A
4-HA,1239,1962,0,5,0,1967,A
4-HA,1240,1,10,1962,0,1973,G
4-HA,1241,1963,0,1,0,1964,A
4-HA,1242,1970,0,6,0,1976,A
4-HA,1243,0,1946,0,1,1947,T
4-HA,1244,0,1948,0,0,1948,T
4-HA,1245,5,1,0,1948,1954,C
4-HA,1246,1,1951,0,2,1954,T
4-HA,1247,12,1,0,1937,1950,C
4-HA,1248,1950,0,2,0,1952,A
4-HA,1249,0,3,1951,0,1954,G
4-HA,1250,1944,0,3,0,1947,A
4-HA,1251,1942,0,2,0,1944,A
4-HA,1252,0,1,1963,0,1964,G
4-HA,1253,2,1958,0,0,1960,T
4-HA,1254,17,1,0,1940,1958,C
4-HA,1255,1,4,1952,0,1957,G
4-HA,1256,1946,1,8,0,1955,A
4-HA,1257,1951,0,7,0,1958,A
4-HA,1258,0,3,1958,0,1961,G
4-HA,1259,0,2,1987,0,1989,G
4-HA,1260,1,14,1966,0,1981,G
4-HA,1261,1922,0,3,0,1925,A
4-HA,1262,1,11,1929,0,1941,G
4-HA,1263,1925,0,4,0,1929,A
4-HA,1264,2040,0,3,0,2043,A
4-HA,1265,0,2043,0,0,2043,T
4-HA,1266,0,2039,1,0,2040,T
4-HA,1267,16,0,1,2019,2036,C
4-HA,1268,2004,0,3,1,2008,A
4-HA,1269,2,7,1998,0,2007,G
4-HA,1270,3,11,1996,0,2010,G
4-HA,1271,1992,1,4,0,1997,A
4-HA,1272,0,0,1,2001,2002,C
4-HA,1273,2,0,0,1853,1855,C
4-HA,1274,0,1841,0,0,1841,T
4-HA,1275,0,1790,0,57,1847,T
4-HA,1276,1,11,1851,0,1863,G
4-HA,1277,1864,0,3,0,1867,A
4-HA,1278,0,6,1892,0,1898,G
4-HA,1279,1881,0,2,0,1883,A
4-HA,1280,1792,0,3,0,1795,A
4-HA,1281,1785,0,1,0,1786,A
4-HA,1282,0,1758,0,1,1759,T
4-HA,1283,1793,1,2,0,1796,A
4-HA,1284,0,1791,0,1,1792,T
4-HA,1285,2,0,1806,0,1808,G
4-HA,1286,1,1795,0,6,1802,T
4-HA,1287,0,1747,0,2,1749,T
4-HA,1288,0,4,1751,0,1755,G
4-HA,1289,1731,0,1,0,1732,A
4-HA,1290,0,10,1758,0,1768,G
4-HA,1291,1,7,1752,0,1760,G
4-HA,1292,1726,0,4,0,1730,A
4-HA,1293,0,1,0,1795,1796,C
4-HA,1294,1765,0,0,0,1765,A
4-HA,1295,2,0,0,1761,1763,C
4-HA,1296,0,1743,0,4,1747,T
4-HA,1297,1827,1,0,0,1828,A
4-HA,1298,1845,0,0,1,1846,A
4-HA,1299,1847,0,0,1,1848,A
4-HA,1300,1860,0,6,0,1866,A
4-HA,1301,0,1859,0,7,1866,T
4-HA,1302,1780,0,2,0,1782,A
4-HA,1303,0,7,1790,0,1797,G
4-HA,1304,1732,0,3,0,1735,A
4-HA,1305,0,1750,0,4,1754,T
4-HA,1306,6,1,0,1740,1747,C
4-HA,1307,1,1719,0,4,1724,T
4-HA,1308,8,0,0,1754,1762,C
4-HA,1309,0,1745,2,4,1751,T
4-HA,1310,2,6,1793,1,1802,G
4-HA,1311,1,0,1839,0,1840,G
4-HA,1312,1,1827,0,0,1828,T
4-HA,1313,23,0,0,1809,1832,C
4-HA,1314,1844,0,0,0,1844,A
4-HA,1315,1,1842,1,4,1848,T
4-HA,1316,1840,0,3,0,1843,A
4-HA,1317,0,0,0,1848,1848,C
4-HA,1318,1799,0,2,0,1801,A
4-HA,1319,1815,1,1,0,1817,A
4-HA,1320,0,0,0,1767,1767,C
4-HA,1321,0,2,1765,0,1767,G
4-HA,1322,1,0,0,1759,1760,C
4-HA,1323,1,2,1756,0,1759,G
4-HA,1324,0,7,1755,1,1763,G
4-HA,1325,1758,0,2,1,1761,A
4-HA,1326,0,0,1775,0,1775,G
4-HA,1327,2,0,0,1774,1776,C
4-HA,1328,0,1749,0,16,1765,T
4-HA,1329,0,1773,0,3,1776,T
4-HA,1330,6,2,0,1768,1776,C
4-HA,1331,0,1788,0,2,1790,T
4-HA,1332,0,1786,0,3,1789,T
4-HA,1333,0,3,1773,0,1776,G
4-HA,1334,0,1773,0,0,1773,T
4-HA,1335,0,1732,0,1,1733,T
4-HA,1336,0,1,1766,0,1767,G
4-HA,1337,3,0,0,1761,1764,C
4-HA,1338,8,0,0,1746,1754,C
4-HA,1339,6,0,0,1764,1770,C
4-HA,1340,0,1763,0,3,1766,T
4-HA,1341,1,3,1781,0,1785,G
4-HA,1342,0,6,1789,0,1795,G
4-HA,1343,1785,1,8,0,1794,A
4-HA,1344,0,11,1789,0,1800,G
4-HA,1345,1770,0,4,0,1774,A
4-HA,1346,1785,0,3,0,1788,A
4-HA,1347,0,0,0,1818,1818,C
4-HA,1348,8,0,0,1799,1807,C
4-HA,1349,1799,0,3,0,1802,A
4-HA,1350,1852,0,3,0,1855,A
4-HA,1351,0,0,0,1864,1864,C
4-HA,1352,1868,0,1,0,1869,A
4-HA,1353,0,1867,0,1,1868,T
4-HA,1354,1853,0,4,0,1857,A
4-HA,1355,0,0,0,1881,1881,C
4-HA,1356,1844,0,1,0,1845,A
4-HA,1357,1844,0,2,0,1846,A
4-HA,1358,0,1842,0,1,1843,T
4-HA,1359,0,1780,0,1,1781,T
4-HA,1360,0,13,1796,0,1809,G
4-HA,1361,1822,0,0,0,1822,A
4-HA,1362,1,1817,0,3,1821,T
4-HA,1363,16,0,0,1814,1830,C
4-HA,1364,0,1805,0,2,1807,T
4-HA,1365,1816,0,0,0,1816,A
4-HA,1366,1817,1,1,0,1819,A
4-HA,1367,0,0,0,1818,1818,C
4-HA,1368,1,1796,3,2,1802,T
4-HA,1369,0,15,1776,0,1791,G
4-HA,1370,1793,1,0,0,1794,A
4-HA,1371,0,0,0,1795,1795,C
4-HA,1372,0,1792,0,4,1796,T
4-HA,1373,7,1,0,1788,1796,C
4-HA,1374,1785,0,0,0,1785,A
4-HA,1375,0,5,1825,0,1830,G
4-HA,1376,1823,0,1,0,1824,A
4-HA,1377,1824,0,4,0,1828,A
4-HA,1378,1823,0,4,0,1827,A
4-HA,1379,1,1801,0,3,1805,T
4-HA,1380,0,22,1801,0,1823,G
4-HA,1381,1825,0,1,0,1826,A
4-HA,1382,1820,0,4,0,1824,A
4-HA,1383,2,0,0,1819,1821,C
4-HA,1384,1788,1,0,0,1789,A
4-HA,1385,1791,0,1,0,1792,A
4-HA,1386,1789,0,1,0,1790,A
4-HA,1387,0,0,0,1800,1800,C
4-HA,1388,0,1789,0,1,1790,T
4-HA,1389,0,0,1800,0,1800,G
4-HA,1390,1,1779,0,1,1781,T
4-HA,1391,0,1780,0,1,1781,T
4-HA,1392,0,1781,0,2,1783,T
4-HA,1393,0,10,1780,0,1790,G
4-HA,1394,1784,1,1,0,1786,A
4-HA,1395,1788,0,0,0,1788,A
4-HA,1396,1782,0,0,0,1782,A
4-HA,1397,1781,0,0,0,1781,A
4-HA,1398,1777,0,0,0,1777,A
4-HA,1399,1773,2,2,0,1777,A
4-HA,1400,1,1,0,1783,1785,C
4-HA,1401,1779,1,1,0,1781,A
4-HA,1402,1784,0,0,0,1784,A
4-HA,1403,1777,0,3,0,1780,A
4-HA,1404,0,1,1804,0,1805,G
4-HA,1405,1804,0,2,0,1806,A
4-HA,1406,1799,1,4,0,1804,A
4-HA,1407,0,0,1803,0,1803,G
4-HA,1408,1,1,1,1802,1805,C
4-HA,1409,1803,0,1,0,1804,A
4-HA,1410,1809,1,0,0,1810,A
4-HA,1411,1,0,0,1811,1812,C
4-HA,1412,0,1799,0,0,1799,T
4-HA,1413,1,1,1810,0,1812,G
4-HA,1414,1792,0,4,0,1796,A
4-HA,1415,1,5,1805,1,1812,G
4-HA,1416,0,2,1819,0,1821,G
4-HA,1417,1,2,1817,0,1820,G
4-HA,1418,1825,0,2,0,1827,A
4-HA,1419,1820,0,1,0,1821,A
4-HA,1420,1812,0,5,0,1817,A
4-HA,1421,1847,1,0,0,1848,A
4-HA,1422,1,1841,0,0,1842,T
4-HA,1423,1,1,1852,0,1854,G
4-HA,1424,0,0,0,1855,1855,C
4-HA,1425,0,1822,0,3,1825,T
4-HA,1426,1,3,1829,1,1834,G
4-HA,1427,1836,0,3,0,1839,A
4-HA,1428,0,3,1919,0,1922,G
4-HA,1429,0,6,1944,0,1950,G
4-HA,1430,1927,0,0,0,1927,A
4-HA,1431,1,1919,4,1,1925,T
4-HA,1432,1904,0,3,0,1907,A
4-HA,1433,0,1899,0,0,1899,T
4-HA,1434,0,4,1913,0,1917,G
4-HA,1435,2,8,1912,0,1922,G
4-HA,1436,1,3,1923,0,1927,G
4-HA,1437,3,1,0,1819,1823,C
4-HA,1438,1774,0,2,0,1776,A
4-HA,1439,1773,0,2,0,1775,A
4-HA,1440,0,1768,0,1,1769,T
4-HA,1441,0,7,1775,0,1782,G
4-HA,1442,0,1,1780,0,1781,G
4-HA,1443,1,1746,0,2,1749,T
4-HA,1444,0,1717,3,1,1721,T
4-HA,1445,0,1,1734,0,1735,G
4-HA,1446,0,1757,1,2,1760,T
4-HA,1447,0,1751,0,2,1753,T
4-HA,1448,0,1764,0,1,1765,T
4-HA,1449,6,1,0,1755,1762,C
4-HA,1450,1750,0,1,0,1751,A
4-HA,1451,1754,0,0,0,1754,A
4-HA,1452,1753,0,0,0,1753,A
4-HA,1453,1770,0,0,0,1770,A
4-HA,1454,0,1769,0,0,1769,T
4-HA,1455,1738,0,3,0,1741,A
4-HA,1456,0,1746,0,2,1748,T
4-HA,1457,1739,0,1,0,1740,A
4-HA,1458,3,2,0,1755,1760,C
4-HA,1459,6,3,1,1741,1751,C
4-HA,1460,1748,1,0,0,1749,A
4-HA,1461,0,0,0,1764,1764,C
4-HA,1462,1758,0,1,0,1759,A
4-HA,1463,1761,0,1,0,1762,A
4-HA,1464,1764,0,3,0,1767,A
4-HA,1465,1,1766,0,1,1768,T
4-HA,1466,0,0,1764,0,1764,G
4-HA,1467,0,1744,0,5,1749,T
4-HA,1468,1,28,1732,0,1761,G
4-HA,1469,1760,1,1,0,1762,A
4-HA,1470,1,0,0,1753,1754,C
4-HA,1471,1728,0,2,0,1730,A
4-HA,1472,1732,0,0,0,1732,A
4-HA,1473,1,1751,1,3,1756,T
4-HA,1474,0,0,1774,0,1774,G
4-HA,1475,0,2,0,1760,1762,C
4-HA,1476,4,1,0,1759,1764,C
4-HA,1477,0,1737,0,4,1741,T
4-HA,1478,2,0,1809,0,1811,G
4-HA,1479,0,1,1,1817,1819,C
4-HA,1480,1817,0,0,0,1817,A
4-HA,1481,0,1816,1,0,1817,T
4-HA,1482,1762,0,2,0,1764,A
4-HA,1483,0,3,1770,0,1773,G
4-HA,1484,1,12,1761,0,1774,G
4-HA,1485,1765,0,1,0,1766,A
4-HA,1486,0,1752,1,1,1754,T
4-HA,1487,14,0,0,1628,1642,C
4-HA,1488,1638,0,0,0,1638,A
4-HA,1489,1644,0,0,0,1644,A
4-HA,1490,0,1642,1,0,1643,T
4-HA,1491,11,1,0,1635,1647,C
4-HA,1492,1621,0,1,0,1622,A
4-HA,1493,0,5,1626,0,1631,G
4-HA,1494,1633,0,1,0,1634,A
4-HA,1495,1631,0,1,0,1632,A
4-HA,1496,1630,0,1,0,1631,A
4-HA,1497,1,1621,1,2,1625,T
4-HA,1498,1,6,1610,0,1617,G
4-HA,1499,1,12,1609,0,1622,G
4-HA,1500,1621,0,1,0,1622,A
4-HA,1501,1627,0,0,0,1627,A
4-HA,1502,1,0,0,1626,1627,C
4-HA,1503,0,1610,1,2,1613,T
4-HA,1504,1,1623,0,0,1624,T
4-HA,1505,1621,0,3,0,1624,A
4-HA,1506,0,1621,1,0,1622,T
4-HA,1507,2,23,1596,0,1621,G
4-HA,1508,1619,0,3,0,1622,A
4-HA,1509,1,2,0,1628,1631,C
4-HA,1510,8,1,0,1599,1608,C
4-HA,1511,1608,0,1,0,1609,A
4-HA,1512,0,3,0,1640,1643,C
4-HA,1513,0,4,1697,0,1701,G
4-HA,1514,1733,0,3,0,1736,A
4-HA,1515,1,1754,0,0,1755,T
4-HA,1516,0,0,1826,0,1826,G
4-HA,1517,0,1807,2,1,1810,T
4-HA,1518,1864,1,3,0,1868,A
4-HA,1519,0,1867,0,0,1867,T
4-HA,1520,1857,0,3,0,1860,A
4-HA,1521,0,0,0,1857,1857,C
4-HA,1522,1648,0,0,0,1648,A
4-HA,1523,0,10,1673,1,1684,G
4-HA,1524,1596,1,2,0,1599,A
4-HA,1525,1,0,1561,0,1562,G
4-HA,1526,1550,0,1,0,1551,A
4-HA,1527,0,1446,0,0,1446,T
4-HA,1528,0,6,1440,0,1446,G
4-HA,1529,1443,0,1,0,1444,A
4-HA,1530,1432,1,5,0,1438,A
4-HA,1531,1,0,1470,0,1471,G
4-HA,1532,0,2,0,1426,1428,C
4-HA,1533,1420,0,0,0,1420,A
4-HA,1534,0,1422,0,2,1424,T
4-HA,1535,0,1423,0,0,1423,T
4-HA,1536,1429,0,0,0,1429,A
4-HA,1537,1432,0,0,0,1432,A
4-HA,1538,1429,1,3,0,1433,A
4-HA,1539,0,0,0,1434,1434,C
4-HA,1540,1372,0,2,0,1374,A
4-HA,1541,1378,0,1,0,1379,A
4-HA,1542,0,0,0,1379,1379,C
4-HA,1543,4,3,0,1364,1371,C
4-HA,1544,3,2,1365,0,1370,G
4-HA,1545,1,0,1380,0,1381,G
4-HA,1546,0,1377,0,2,1379,T
4-HA,1547,0,1377,0,1,1378,T
4-HA,1548,1,1360,0,1,1362,T
4-HA,1549,11,1,0,1357,1369,C
4-HA,1550,1364,0,3,1,1368,A
4-HA,1551,0,10,1375,0,1385,G
4-HA,1552,1383,0,0,1,1384,A
4-HA,1553,0,1377,0,0,1377,T
4-HA,1554,11,0,0,1342,1353,C
4-HA,1555,1347,0,0,0,1347,A
4-HA,1556,1345,1,1,0,1347,A
4-HA,1557,0,14,1338,0,1352,G
4-HA,1558,0,2,1340,0,1342,G
4-HA,1559,0,8,1336,0,1344,G
4-HA,1560,1291,0,1,1,1293,A
4-HA,1561,0,0,1313,0,1313,G
4-HA,1562,0,1313,1,1,1315,T
4-HA,1563,0,1311,1,1,1313,T
4-HA,1564,1,11,1309,0,1321,G
4-HA,1565,1302,0,5,0,1307,A
4-HA,1566,3,0,1312,0,1315,G
4-HA,1567,0,2,0,1306,1308,C
4-HA,1568,0,1301,0,1,1302,T
4-HA,1569,0,5,1302,1,1308,G
4-HA,1570,1299,0,0,0,1299,A
4-HA,1571,1300,2,0,0,1302,A
4-HA,1572,0,0,1302,0,1302,G
4-HA,1573,0,1280,0,0,1280,T
4-HA,1574,12,0,0,1269,1281,C
4-HA,1575,1253,0,2,1,1256,A
4-HA,1576,0,3,1251,0,1254,G
4-HA,1577,0,4,1248,1,1253,G
4-HA,1578,1,1,1223,0,1225,G
4-HA,1579,0,1276,0,1,1277,T
4-HA,1580,1280,0,2,0,1282,A
4-HA,1581,0,0,0,1281,1281,C
4-HA,1582,1276,0,1,0,1277,A
4-HA,1583,1274,0,0,0,1274,A
4-HA,1584,1270,0,3,0,1273,A
4-HA,1585,0,4,1279,1,1284,G
4-HA,1586,1245,0,0,0,1245,A
4-HA,1587,0,1204,0,3,1207,T
4-HA,1588,0,1185,0,1,1186,T
4-HA,1589,0,3,1188,0,1191,G
4-HA,1590,0,3,1183,0,1186,G
4-HA,1591,1194,0,0,1,1195,A
4-HA,1592,0,1195,0,2,1197,T
4-HA,1593,2,0,1,1187,1190,C
4-HA,1594,5,0,0,1173,1178,C
4-HA,1595,0,1160,1,7,1168,T
4-HA,1596,1180,0,1,0,1181,A
4-HA,1597,1,1181,0,1,1183,T
4-HA,1598,0,10,1176,0,1186,G
4-HA,1599,1,7,1177,0,1185,G
4-HA,1600,1155,1,2,0,1158,A
4-HA,1601,0,1151,0,2,1153,T
4-HA,1602,0,1136,0,1,1137,T
4-HA,1603,0,1137,1,2,1140,T
4-HA,1604,8,0,0,1131,1139,C
4-HA,1605,2,0,0,1135,1137,C
4-HA,1606,0,1124,0,1,1125,T
4-HA,1607,0,1119,0,0,1119,T
4-HA,1608,0,1119,0,0,1119,T
4-HA,1609,0,1,1122,0,1123,G
4-HA,1610,0,1,0,1119,1120,C
4-HA,1611,8,0,0,1113,1121,C
4-HA,1612,1112,0,0,0,1112,A
4-HA,1613,0,1114,0,0,1114,T
4-HA,1614,1119,0,0,0,1119,A
4-HA,1615,0,1116,0,1,1117,T
4-HA,1616,8,0,0,1105,1113,C
4-HA,1617,1110,0,1,0,1111,A
4-HA,1618,0,1094,0,0,1094,T
4-HA,1619,0,0,1105,0,1105,G
4-HA,1620,0,1094,0,4,1098,T
4-HA,1621,0,1078,0,1,1079,T
4-HA,1622,0,1072,0,1,1073,T
4-HA,1623,0,1054,0,0,1054,T
4-HA,1624,0,1051,0,0,1051,T
4-HA,1625,2,1046,0,0,1048,T
4-HA,1626,0,2,1052,0,1054,G
4-HA,1627,0,0,0,1052,1052,C
4-HA,1628,0,1021,0,1,1022,T
4-HA,1629,0,1027,0,0,1027,T
4-HA,1630,0,1017,0,0,1017,T
4-HA,1631,0,0,1036,0,1036,G
4-HA,1632,1,1033,0,1,1035,T
4-HA,1633,1,1,1034,0,1036,G
4-HA,1634,0,1035,0,0,1035,T
4-HA,1635,0,1010,0,0,1010,T
4-HA,1636,0,0,1017,0,1017,G
4-HA,1637,0,0,0,1015,1015,C
4-HA,1638,0,1009,0,0,1009,T
4-HA,1639,1,1018,0,0,1019,T
4-HA,1640,0,967,1,0,968,T
4-HA,1641,0,1,977,0,978,G
4-HA,1642,0,975,0,0,975,T
4-HA,1643,0,972,0,0,972,T
4-HA,1644,1,1,971,0,973,G
4-HA,1645,0,0,947,1,948,G
4-HA,1646,0,2,940,0,942,G
4-HA,1647,1,0,943,0,944,G
4-HA,1648,0,911,0,1,912,T
4-HA,1649,0,903,0,1,904,T
4-HA,1650,14,0,0,877,891,C
4-HA,1651,872,1,3,0,876,A
4-HA,1652,0,885,0,0,885,T
4-HA,1653,10,0,0,873,883,C
4-HA,1654,885,0,0,0,885,A
4-HA,1655,0,852,0,1,853,T
4-HA,1656,0,0,842,0,842,G
4-HA,1657,1,816,0,1,818,T
4-HA,1658,0,2,815,0,817,G
4-HA,1659,0,0,798,0,798,G
4-HA,1660,0,1,787,0,788,G
4-HA,1661,0,0,0,764,764,C
4-HA,1662,1,0,1,740,742,C
4-HA,1663,0,705,0,0,705,T
4-HA,1664,2,3,701,0,706,G
4-HA,1665,0,0,0,704,704,C
4-HA,1666,4,0,0,703,707,C
4-HA,1667,701,0,1,0,702,A
4-HA,1668,700,0,0,0,700,A
4-HA,1669,698,0,0,0,698,A
4-HA,1670,697,0,1,0,698,A
4-HA,1671,697,0,0,0,697,A
4-HA,1672,0,4,691,0,695,G
4-HA,1673,0,0,662,0,662,G
4-HA,1674,0,0,0,654,654,C
4-HA,1675,645,0,2,0,647,A
4-HA,1676,652,0,0,0,652,A
4-HA,1677,0,0,0,652,652,C
4-HA,1678,648,0,0,0,648,A
4-HA,1679,0,645,0,0,645,T
4-HA,1680,0,640,1,0,641,T
4-HA,1681,618,0,1,0,619,A
4-HA,1682,1,1,615,0,617,G
4-HA,1683,0,0,616,0,616,G
4-HA,1684,0,597,0,0,597,T
4-HA,1685,0,1,540,0,541,G
4-HA,1686,0,0,0,511,511,C
4-HA,1687,506,0,0,0,506,A
4-HA,1688,505,0,1,0,506,A
4-HA,1689,0,0,0,504,504,C
4-HA,1690,499,0,0,0,499,A
4-HA,1691,0,486,0,0,486,T
4-HA,1692,0,456,0,0,456,T
4-HA,1693,0,453,0,1,454,T
4-HA,1694,0,0,452,0,452,G
4-HA,1695,1,0,0,446,447,C
4-HA,1696,444,0,0,0,444,A
4-HA,1697,0,417,0,0,417,T
4-HA,1698,0,398,0,0,398,T
4-HA,1699,0,381,0,0,381,T
4-HA,1700,0,0,380,0,380,G
4-HA,1701,358,0,0,0,358,A
5-NP,1,369,0,0,0,369,A
5-NP,2,0,367,0,0,367,T
5-NP,3,0,0,369,0,369,G
5-NP,4,3,1,367,0,371,G
5-NP,5,0,0,0,369,369,C
5-NP,6,0,1,382,0,383,G
5-NP,7,0,400,0,0,400,T
5-NP,8,1,0,0,404,405,C
5-NP,9,2,0,0,407,409,C
5-NP,10,1,0,0,411,412,C
5-NP,11,410,0,1,0,411,A
5-NP,12,411,0,0,0,411,A
5-NP,13,0,1,420,0,421,G
5-NP,14,1,0,441,0,442,G
5-NP,15,1,1,0,440,442,C
5-NP,16,445,0,0,0,445,A
5-NP,17,0,0,0,456,456,C
5-NP,18,2,0,0,454,456,C
5-NP,19,460,0,0,0,460,A
5-NP,20,457,0,0,0,457,A
5-NP,21,460,0,0,0,460,A
5-NP,22,0,1,0,461,462,C
5-NP,23,0,4,460,0,464,G
5-NP,24,0,0,521,0,521,G
5-NP,25,0,520,0,0,520,T
5-NP,26,6,0,0,550,556,C
5-NP,27,1,553,0,3,557,T
5-NP,28,0,564,0,0,564,T
5-NP,29,564,0,1,0,565,A
5-NP,30,0,563,0,0,563,T
5-NP,31,0,10,561,0,571,G
5-NP,32,571,0,0,0,571,A
5-NP,33,561,0,0,0,561,A
5-NP,34,0,0,0,561,561,C
5-NP,35,555,1,1,0,557,A
5-NP,36,0,2,596,0,598,G
5-NP,37,598,0,0,0,598,A
5-NP,38,0,598,0,1,599,T
5-NP,39,0,1,600,0,601,G
5-NP,40,0,3,596,0,599,G
5-NP,41,604,0,2,0,606,A
5-NP,42,608,0,1,0,609,A
5-NP,43,609,0,0,1,610,A
5-NP,44,0,0,0,624,624,C
5-NP,45,0,612,0,1,613,T
5-NP,46,0,7,614,0,621,G
5-NP,47,618,0,3,0,621,A
5-NP,48,0,616,0,4,620,T
5-NP,49,1,2,617,0,620,G
5-NP,50,0,3,622,0,625,G
5-NP,51,0,3,627,0,630,G
5-NP,52,0,4,635,0,639,G
5-NP,53,634,0,0,0,634,A
5-NP,54,0,635,0,0,635,T
5-NP,55,5,2,0,627,634,C
5-NP,56,0,0,637,0,637,G
5-NP,57,1,0,0,640,641,C
5-NP,58,2,0,0,641,643,C
5-NP,59,637,0,2,0,639,A
5-NP,60,0,5,647,0,652,G
5-NP,61,651,0,1,0,652,A
5-NP,62,659,0,0,0,659,A
5-NP,63,0,658,0,1,659,T
5-NP,64,0,2,657,0,659,G
5-NP,65,0,12,0,651,663,C
5-NP,66,661,0,0,0,661,A
5-NP,67,671,0,2,0,673,A
5-NP,68,0,0,0,674,674,C
5-NP,69,0,670,0,3,673,T
5-NP,70,0,5,672,0,677,G
5-NP,71,679,0,0,0,679,A
5-NP,72,1,4,704,0,709,G
5-NP,73,708,0,1,0,709,A
5-NP,74,0,699,0,0,699,T
5-NP,75,0,703,0,0,703,T
5-NP,76,701,0,0,0,701,A
5-NP,77,0,2,703,0,705,G
5-NP,78,0,0,706,0,706,G
5-NP,79,0,1,702,0,703,G
5-NP,80,2,0,0,694,696,C
5-NP,81,683,0,3,0,686,A
5-NP,82,0,687,0,1,688,T
5-NP,83,4,0,0,686,690,C
5-NP,84,4,0,1,683,688,C
5-NP,85,0,0,696,0,696,G
5-NP,86,0,693,0,0,693,T
5-NP,87,3,0,0,689,692,C
5-NP,88,0,2,693,0,695,G
5-NP,89,0,1,699,0,700,G
5-NP,90,0,2,705,0,707,G
5-NP,91,704,0,2,0,706,A
5-NP,92,707,0,1,1,709,A
5-NP,93,0,2,714,0,716,G
5-NP,94,710,0,2,1,713,A
5-NP,95,0,711,0,0,711,T
5-NP,96,0,4,711,0,715,G
5-NP,97,709,0,0,0,709,A
5-NP,98,0,714,0,0,714,T
5-NP,99,1,708,0,0,709,T
5-NP,100,0,3,708,0,711,G
5-NP,101,712,1,0,1,714,A
5-NP,102,0,714,0,1,715,T
5-NP,103,0,3,713,0,716,G
5-NP,104,1,3,731,0,735,G
5-NP,105,735,0,0,0,735,A
5-NP,106,740,0,0,0,740,A
5-NP,107,6,736,0,0,742,T
5-NP,108,0,743,0,0,743,T
5-NP,109,0,1,744,0,745,G
5-NP,110,0,1,748,0,749,G
5-NP,111,0,4,746,0,750,G
5-NP,112,744,0,2,0,746,A
5-NP,113,0,1,742,0,743,G
5-NP,114,743,1,0,0,744,A
5-NP,115,0,756,0,2,758,T
5-NP,116,0,759,0,0,759,T
5-NP,117,3,0,0,760,763,C
5-NP,118,0,758,0,1,759,T
5-NP,119,765,0,1,0,766,A
5-NP,120,0,0,0,770,770,C
5-NP,121,783,0,1,0,784,A
5-NP,122,0,785,0,0,785,T
5-NP,123,0,0,1,784,785,C
5-NP,124,4,0,0,779,783,C
5-NP,125,784,0,0,1,785,A
5-NP,126,808,1,0,0,809,A
5-NP,127,811,0,1,0,812,A
5-NP,128,0,807,0,0,807,T
5-NP,129,0,0,810,0,810,G
5-NP,130,0,799,0,1,800,T
5-NP,131,0,0,807,1,808,G
5-NP,132,0,0,0,808,808,C
5-NP,133,807,0,0,0,807,A
5-NP,134,0,0,0,810,810,C
5-NP,135,0,798,0,2,800,T
5-NP,136,2,8,834,0,844,G
5-NP,137,857,0,0,0,857,A
5-NP,138,875,0,2,0,877,A
5-NP,139,0,0,0,886,886,C
5-NP,140,0,877,0,1,878,T
5-NP,141,0,885,0,0,885,T
5-NP,142,887,0,0,0,887,A
5-NP,143,886,0,0,0,886,A
5-NP,144,892,1,0,0,893,A
5-NP,145,0,1,0,894,895,C
5-NP,146,0,863,0,0,863,T
5-NP,147,2,0,0,863,865,C
5-NP,148,855,0,1,0,856,A
5-NP,149,0,0,864,0,864,G
5-NP,150,0,865,0,1,866,T
5-NP,151,0,7,867,0,874,G
5-NP,152,891,0,2,0,893,A
5-NP,153,0,889,0,2,891,T
5-NP,154,6,0,0,897,903,C
5-NP,155,912,1,0,0,913,A
5-NP,156,1,909,0,1,911,T
5-NP,157,0,5,911,0,916,G
5-NP,158,912,1,0,0,913,A
5-NP,159,908,0,1,0,909,A
5-NP,160,0,1,906,0,907,G
5-NP,161,0,2,899,0,901,G
5-NP,162,0,3,900,0,903,G
5-NP,163,0,2,0,883,885,C
5-NP,164,0,3,885,0,888,G
5-NP,165,0,0,897,0,897,G
5-NP,166,0,897,0,0,897,T
5-NP,167,0,893,0,2,895,T
5-NP,168,0,6,892,0,898,G
5-NP,169,978,0,0,0,978,A
5-NP,170,0,975,0,3,978,T
5-NP,171,7,0,0,966,973,C
5-NP,172,3,1,0,974,978,C
5-NP,173,968,0,1,0,969,A
5-NP,174,0,5,973,0,978,G
5-NP,175,977,0,0,0,977,A
5-NP,176,976,0,0,0,976,A
5-NP,177,0,1,0,981,982,C
5-NP,178,915,0,0,0,915,A
5-NP,179,0,0,930,0,930,G
5-NP,180,1,0,1,932,934,C
5-NP,181,0,929,0,3,932,T
5-NP,182,0,937,0,0,937,T
5-NP,183,0,6,930,0,936,G
5-NP,184,943,0,0,0,943,A
5-NP,185,1,0,0,951,952,C
5-NP,186,939,0,0,0,939,A
5-NP,187,941,0,0,0,941,A
5-NP,188,0,945,0,0,945,T
5-NP,189,941,0,0,0,941,A
5-NP,190,0,7,937,0,944,G
5-NP,191,939,0,0,0,939,A
5-NP,192,0,6,940,0,946,G
5-NP,193,937,0,0,0,937,A
5-NP,194,948,0,2,0,950,A
5-NP,195,953,0,0,0,953,A
5-NP,196,961,0,0,0,961,A
5-NP,197,0,959,0,0,959,T
5-NP,198,1,5,951,0,957,G
5-NP,199,0,2,952,0,954,G
5-NP,200,0,947,0,2,949,T
5-NP,201,921,0,2,0,923,A
5-NP,202,0,0,0,933,933,C
5-NP,203,0,933,0,2,935,T
5-NP,204,3,0,0,956,959,C
5-NP,205,0,943,0,3,946,T
5-NP,206,4,1,0,946,951,C
5-NP,207,0,948,0,2,950,T
5-NP,208,0,0,954,0,954,G
5-NP,209,0,1,0,954,955,C
5-NP,210,0,942,0,1,943,T
5-NP,211,0,947,0,1,948,T
5-NP,212,0,943,0,0,943,T
5-NP,213,0,929,0,0,929,T
5-NP,214,0,2,933,1,936,G
5-NP,215,931,0,3,0,934,A
5-NP,216,0,933,0,0,933,T
5-NP,217,0,3,921,0,924,G
5-NP,218,923,0,0,0,923,A
5-NP,219,921,0,0,0,921,A
5-NP,220,923,0,0,0,923,A
5-NP,221,0,1,927,0,928,G
5-NP,222,932,0,2,0,934,A
5-NP,223,931,0,0,0,931,A
5-NP,224,0,2,935,0,937,G
5-NP,225,0,5,954,1,960,G
5-NP,226,962,0,2,0,964,A
5-NP,227,962,0,3,0,965,A
5-NP,228,0,967,0,0,967,T
5-NP,229,967,0,0,0,967,A
5-NP,230,961,1,0,0,962,A
5-NP,231,967,0,0,0,967,A
5-NP,232,0,970,0,0,970,T
5-NP,233,964,0,1,0,965,A
5-NP,234,1,0,0,964,965,C
5-NP,235,4,0,0,945,949,C
5-NP,236,0,943,0,3,946,T
5-NP,237,0,0,949,0,949,G
5-NP,238,0,2,957,0,959,G
5-NP,239,963,0,0,0,963,A
5-NP,240,951,0,1,0,952,A
5-NP,241,0,6,955,0,961,G
5-NP,242,956,1,1,0,958,A
5-NP,243,957,0,1,0,958,A
5-NP,244,0,1,0,956,957,C
5-NP,245,953,0,0,0,953,A
5-NP,246,1,0,0,994,995,C
5-NP,247,5,0,0,979,984,C
5-NP,248,2,0,0,981,983,C
5-NP,249,1,0,0,989,990,C
5-NP,250,976,0,1,0,977,A
5-NP,251,0,3,973,0,976,G
5-NP,252,0,1,0,970,971,C
5-NP,253,0,0,971,0,971,G
5-NP,254,2,1,0,972,975,C
5-NP,255,1,2,954,0,957,G
5-NP,256,0,2,962,0,964,G
5-NP,257,0,4,960,0,964,G
5-NP,258,0,6,960,0,966,G
5-NP,259,971,0,0,0,971,A
5-NP,260,967,0,1,0,968,A
5-NP,261,959,0,2,0,961,A
5-NP,262,0,0,963,0,963,G
5-NP,263,957,0,4,0,961,A
5-NP,264,1,961,0,1,963,T
5-NP,265,3,1,0,952,956,C
5-NP,266,3,1,0,952,956,C
5-NP,267,5,0,0,959,964,C
5-NP,268,964,0,0,0,964,A
5-NP,269,963,0,0,0,963,A
5-NP,270,0,2,966,0,968,G
5-NP,271,965,0,0,0,965,A
5-NP,272,967,0,0,0,967,A
5-NP,273,968,0,1,0,969,A
5-NP,274,967,0,0,0,967,A
5-NP,275,1,1,0,967,969,C
5-NP,276,0,954,0,0,954,T
5-NP,277,0,0,951,0,951,G
5-NP,278,0,1,954,0,955,G
5-NP,279,0,3,953,0,956,G
5-NP,280,0,3,948,0,951,G
5-NP,281,0,1,950,0,951,G
5-NP,282,0,0,962,0,962,G
5-NP,283,2,0,0,1022,1024,C
5-NP,284,2,2,0,1017,1021,C
5-NP,285,2,0,0,1025,1027,C
5-NP,286,1092,0,1,0,1093,A
5-NP,287,0,1100,0,0,1100,T
5-NP,288,1136,0,0,0,1136,A
5-NP,289,0,1137,0,0,1137,T
5-NP,290,1115,0,0,0,1115,A
5-NP,291,0,0,0,1127,1127,C
5-NP,292,1017,0,0,1,1018,A
5-NP,293,1,0,1040,0,1041,G
5-NP,294,0,7,1032,0,1039,G
5-NP,295,951,0,0,0,951,A
5-NP,296,0,7,943,0,950,G
5-NP,297,913,0,1,0,914,A
5-NP,298,892,1,0,0,893,A
5-NP,299,0,905,0,0,905,T
5-NP,300,909,0,1,0,910,A
5-NP,301,0,1,914,0,915,G
5-NP,302,891,0,0,0,891,A
5-NP,303,1,891,0,0,892,T
5-NP,304,0,3,888,0,891,G
5-NP,305,0,1,891,0,892,G
5-NP,306,893,0,1,0,894,A
5-NP,307,896,0,0,0,896,A
5-NP,308,893,0,1,0,894,A
5-NP,309,901,0,2,0,903,A
5-NP,310,0,898,0,1,899,T
5-NP,311,0,3,903,0,906,G
5-NP,312,0,3,906,0,909,G
5-NP,313,906,0,0,0,906,A
5-NP,314,0,897,0,0,897,T
5-NP,315,0,3,899,0,902,G
5-NP,316,906,0,1,0,907,A
5-NP,317,0,1,908,0,909,G
5-NP,318,0,1,904,0,905,G
5-NP,319,0,6,903,0,909,G
5-NP,320,929,0,2,0,931,A
5-NP,321,937,0,1,0,938,A
5-NP,322,0,0,0,958,958,C
5-NP,323,1,952,0,1,954,T
5-NP,324,4,1,0,977,982,C
5-NP,325,1,0,997,0,998,G
5-NP,326,0,1003,0,0,1003,T
5-NP,327,9,0,0,1008,1017,C
5-NP,328,2,0,0,1178,1180,C
5-NP,329,0,1176,0,0,1176,T
5-NP,330,0,1188,0,0,1188,T
5-NP,331,0,1183,0,0,1183,T
5-NP,332,1192,0,1,0,1193,A
5-NP,333,0,1197,0,2,1199,T
5-NP,334,0,28,1170,0,1198,G
5-NP,335,1207,0,3,1,1211,A
5-NP,336,0,0,0,1212,1212,C
5-NP,337,1189,1,0,0,1190,A
5-NP,338,1197,0,0,0,1197,A
5-NP,339,1210,0,0,0,1210,A
5-NP,340,0,2,1299,0,1301,G
5-NP,341,1302,0,2,0,1304,A
5-NP,342,1300,0,4,0,1304,A
5-NP,343,0,8,1424,0,1432,G
5-NP,344,1440,1,1,0,1442,A
5-NP,345,1440,0,2,0,1442,A
5-NP,346,1445,0,1,0,1446,A
5-NP,347,1,1442,0,2,1445,T
5-NP,348,1443,0,1,1,1445,A
5-NP,349,1432,0,2,0,1434,A
5-NP,350,0,2,1465,0,1467,G
5-NP,351,0,1,1466,0,1467,G
5-NP,352,0,2,0,1450,1452,C
5-NP,353,2,7,1444,0,1453,G
5-NP,354,1464,0,1,0,1465,A
5-NP,355,1497,0,2,0,1499,A
5-NP,356,0,1500,0,1,1501,T
5-NP,357,7,0,0,1495,1502,C
5-NP,358,0,1506,0,0,1506,T
5-NP,359,0,5,1505,0,1510,G
5-NP,360,0,1,1515,0,1516,G
5-NP,361,0,0,0,1516,1516,C
5-NP,362,2,1,1516,0,1519,G
5-NP,363,1,0,0,1518,1519,C
5-NP,364,7,0,0,1504,1511,C
5-NP,365,1524,0,0,0,1524,A
5-NP,366,1555,0,0,0,1555,A
5-NP,367,0,1,1614,0,1615,G
5-NP,368,0,1,0,1621,1622,C
5-NP,369,5,0,0,1635,1640,C
5-NP,370,1640,0,1,1,1642,A
5-NP,371,1676,0,2,0,1678,A
5-NP,372,0,0,0,1713,1713,C
5-NP,373,1712,0,1,1,1714,A
5-NP,374,1768,1,0,0,1769,A
5-NP,375,0,1770,0,2,1772,T
5-NP,376,2,9,1809,0,1820,G
5-NP,377,1,1,1818,0,1820,G
5-NP,378,0,1809,0,2,1811,T
5-NP,379,1,4,1811,1,1817,G
5-NP,380,1817,0,5,0,1822,A
5-NP,381,0,6,1880,1,1887,G
5-NP,382,0,2,1889,0,1891,G
5-NP,383,1906,1,0,0,1907,A
5-NP,384,1,2081,0,1,2083,T
5-NP,385,2,1,2117,0,2120,G
5-NP,386,1,3,0,2129,2133,C
5-NP,387,0,2129,0,4,2133,T
5-NP,388,2154,1,3,0,2158,A
5-NP,389,1,2,1,2199,2203,C
5-NP,390,2196,0,1,1,2198,A
5-NP,391,0,2192,0,3,2195,T
5-NP,392,3,0,1,2183,2187,C
5-NP,393,0,2108,0,2,2110,T
5-NP,394,1,9,2196,0,2206,G
5-NP,395,0,0,2268,0,2268,G
5-NP,396,0,2264,0,1,2265,T
5-NP,397,20,0,1,2249,2270,C
5-NP,398,0,2251,0,2,2253,T
5-NP,399,2292,0,1,0,2293,A
5-NP,400,2297,0,5,1,2303,A
5-NP,401,0,0,0,2339,2339,C
5-NP,402,0,2333,0,2,2335,T
5-NP,403,12,1,0,2342,2355,C
5-NP,404,2346,0,1,0,2347,A
5-NP,405,0,0,0,2471,2471,C
5-NP,406,2470,2,1,0,2473,A
5-NP,407,0,2480,0,1,2481,T
5-NP,408,2458,0,0,1,2459,A
5-NP,409,2479,0,3,0,2482,A
5-NP,410,0,2495,0,1,2496,T
5-NP,411,0,22,2531,0,2553,G
5-NP,412,2545,0,0,0,2545,A
5-NP,413,0,2531,0,3,2534,T
5-NP,414,0,2481,0,1,2482,T
5-NP,415,0,2481,0,3,2484,T
5-NP,416,4,10,2472,0,2486,G
5-NP,417,1,1,2485,0,2487,G
5-NP,418,4,0,0,2488,2492,C
5-NP,419,2479,0,2,0,2481,A
5-NP,420,0,2481,1,5,2487,T
5-NP,421,3,2482,0,4,2489,T
5-NP,422,7,1,0,2479,2487,C
5-NP,423,13,1,0,2488,2502,C
5-NP,424,2567,0,0,0,2567,A
5-NP,425,2570,0,4,0,2574,A
5-NP,426,0,2571,0,1,2572,T
5-NP,427,0,2574,0,3,2577,T
5-NP,428,1,2569,0,1,2571,T
5-NP,429,1,28,2576,0,2605,G
5-NP,430,2594,1,2,0,2597,A
5-NP,431,2601,2,0,0,2603,A
5-NP,432,0,2620,1,2,2623,T
5-NP,433,0,19,2590,0,2609,G
5-NP,434,2731,0,0,0,2731,A
5-NP,435,0,2737,0,2,2739,T
5-NP,436,2,0,2760,0,2762,G
5-NP,437,5,2,0,2850,2857,C
5-NP,438,2844,1,3,0,2848,A
5-NP,439,2975,1,4,0,2980,A
5-NP,440,0,1,0,2978,2979,C
5-NP,441,3021,1,2,0,3024,A
5-NP,442,0,3111,0,1,3112,T
5-NP,443,3081,2,1,0,3084,A
5-NP,444,1,2,0,3142,3145,C
5-NP,445,4,2,0,3128,3134,C
5-NP,446,3091,0,2,0,3093,A
5-NP,447,18,6,3112,0,3136,G
5-NP,448,3067,0,8,0,3075,A
5-NP,449,0,11,3123,0,3134,G
5-NP,450,3,22,3112,0,3137,G
5-NP,451,3107,0,6,0,3113,A
5-NP,452,0,1,1,3145,3147,C
5-NP,453,3115,0,5,0,3120,A
5-NP,454,3100,2,9,1,3112,A
5-NP,455,1,13,3112,0,3126,G
5-NP,456,3086,0,9,0,3095,A
5-NP,457,1,1,3127,0,3129,G
5-NP,458,0,1,0,3139,3140,C
5-NP,459,0,3109,0,7,3116,T
5-NP,460,9,1,0,3126,3136,C
5-NP,461,1,3116,0,3,3120,T
5-NP,462,3,3134,1,1,3139,T
5-NP,463,3,1,3144,0,3148,G
5-NP,464,0,3141,1,3,3145,T
5-NP,465,0,3143,0,2,3145,T
5-NP,466,36,5,0,3095,3136,C
5-NP,467,1,42,3096,0,3139,G
5-NP,468,3176,1,4,1,3182,A
5-NP,469,3156,1,18,0,3175,A
5-NP,470,0,2,0,3212,3214,C
5-NP,471,0,3203,1,1,3205,T
5-NP,472,0,7,3262,0,3269,G
5-NP,473,1,14,3271,1,3287,G
5-NP,474,3281,0,3,0,3284,A
5-NP,475,3279,0,10,1,3290,A
5-NP,476,0,3280,0,1,3281,T
5-NP,477,3,5,3274,0,3282,G
5-NP,478,0,12,3292,0,3304,G
5-NP,479,3320,0,3,0,3323,A
5-NP,480,0,3351,0,2,3353,T
5-NP,481,11,2,2,3342,3357,C
5-NP,482,5,0,0,3365,3370,C
5-NP,483,5,0,0,3381,3386,C
5-NP,484,3420,0,1,0,3421,A
5-NP,485,0,20,3458,0,3478,G
5-NP,486,3492,0,0,2,3494,A
5-NP,487,3473,0,2,0,3475,A
5-NP,488,1,3445,0,2,3448,T
5-NP,489,1,1,3490,0,3492,G
5-NP,490,0,3463,0,5,3468,T
5-NP,491,4,3,3482,0,3489,G
5-NP,492,0,0,0,3489,3489,C
5-NP,493,1,3469,1,12,3483,T
5-NP,494,18,1,0,3680,3699,C
5-NP,495,2,3667,2,4,3675,T
5-NP,496,13,0,0,3822,3835,C
5-NP,497,1,3816,0,2,3819,T
5-NP,498,1,14,3822,0,3837,G
5-NP,499,3872,1,9,0,3882,A
5-NP,500,1,3880,0,1,3882,T
5-NP,501,0,3,3868,1,3872,G
5-NP,502,4,2,0,3859,3865,C
5-NP,503,3738,2,9,0,3749,A
5-NP,504,2,8,3834,0,3844,G
5-NP,505,0,15,3786,0,3801,G
5-NP,506,1,1,3848,0,3850,G
5-NP,507,3,2,0,3837,3842,C
5-NP,508,0,3831,0,3,3834,T
5-NP,509,15,4,0,3830,3849,C
5-NP,510,0,56,3791,0,3847,G
5-NP,511,3901,2,3,1,3907,A
5-NP,512,2,0,0,3897,3899,C
5-NP,513,0,3830,0,3,3833,T
5-NP,514,16,3,0,3971,3990,C
5-NP,515,0,3977,0,3,3980,T
5-NP,516,17,1,0,4471,4489,C
5-NP,517,7,0,0,4481,4488,C
5-NP,518,13,1,1,4500,4515,C
5-NP,519,2,4499,0,4,4505,T
5-NP,520,4472,0,1,1,4474,A
5-NP,521,0,9,4467,1,4477,G
5-NP,522,4461,0,4,1,4466,A
5-NP,523,4354,1,5,0,4360,A
5-NP,524,0,19,4352,0,4371,G
5-NP,525,1,1,4321,1,4324,G
5-NP,526,1,4248,0,2,4251,T
5-NP,527,15,3,0,4229,4247,C
5-NP,528,5,8,0,4238,4251,C
5-NP,529,5,10,4244,0,4259,G
5-NP,530,1,14,4257,0,4272,G
5-NP,531,4271,0,8,0,4279,A
5-NP,532,0,1,4328,0,4329,G
5-NP,533,3,2,0,4332,4337,C
5-NP,534,0,4280,0,8,4288,T
5-NP,535,5,0,4291,2,4298,G
5-NP,536,1,1,0,4313,4315,C
5-NP,537,4295,1,11,0,4307,A
5-NP,538,2,6,4328,0,4336,G
5-NP,539,1,0,4349,1,4351,G
5-NP,540,0,4341,1,7,4349,T
5-NP,541,1,4,4311,0,4316,G
5-NP,542,1,1,0,4328,4330,C
5-NP,543,0,4308,0,6,4314,T
5-NP,544,5,2,4327,1,4335,G
5-NP,545,5,2,0,4324,4331,C
5-NP,546,4366,1,5,1,4373,A
5-NP,547,0,0,4461,0,4461,G
5-NP,548,1,4421,0,5,4427,T
5-NP,549,44,1,1,4392,4438,C
5-NP,550,4434,0,2,0,4436,A
5-NP,551,4442,0,4,0,4446,A
5-NP,552,4432,1,5,2,4440,A
5-NP,553,1,5,4471,0,4477,G
5-NP,554,0,29,4480,0,4509,G
5-NP,555,4495,0,3,0,4498,A
5-NP,556,4467,0,5,1,4473,A
5-NP,557,1,4466,0,0,4467,T
5-NP,558,22,4,0,4434,4460,C
5-NP,559,4,10,4451,0,4465,G
5-NP,560,4,10,4592,1,4607,G
5-NP,561,3,28,4581,1,4613,G
5-NP,562,4595,3,3,1,4602,A
5-NP,563,1,0,0,4595,4596,C
5-NP,564,4567,0,3,0,4570,A
5-NP,565,4682,0,3,0,4685,A
5-NP,566,0,4684,1,2,4687,T
5-NP,567,1,18,4710,0,4729,G
5-NP,568,4,2,4772,0,4778,G
5-NP,569,0,4674,2,5,4681,T
5-NP,570,1,20,4677,0,4698,G
5-NP,571,4680,0,7,0,4687,A
5-NP,572,2,4664,0,5,4671,T
5-NP,573,2,10,4665,0,4677,G
5-NP,574,1,33,4717,0,4751,G
5-NP,575,4735,0,4,0,4739,A
5-NP,576,4741,0,7,0,4748,A
5-NP,577,0,1,0,4722,4723,C
5-NP,578,1,4657,0,0,4658,T
5-NP,579,4651,0,4,0,4655,A
5-NP,580,4866,0,1,0,4867,A
5-NP,581,0,4874,0,2,4876,T
5-NP,582,34,0,1,4853,4888,C
5-NP,583,4753,1,2,0,4756,A
5-NP,584,0,20,4817,0,4837,G
5-NP,585,4802,1,5,1,4809,A
5-NP,586,4821,0,3,1,4825,A
5-NP,587,0,4812,0,1,4813,T
5-NP,588,2,20,4747,0,4769,G
5-NP,589,2,2,4843,0,4847,G
5-NP,590,0,4841,0,7,4848,T
5-NP,591,44,2,0,4794,4840,C
5-NP,592,4845,0,0,0,4845,A
5-NP,593,4846,0,2,0,4848,A
5-NP,594,4838,0,5,2,4845,A
5-NP,595,3,7,0,4846,4856,C
5-NP,596,3,11,4814,1,4829,G
5-NP,597,1,12,4858,1,4872,G
5-NP,598,1,12,4825,1,4839,G
5-NP,599,4,19,4847,0,4870,G
5-NP,600,2,43,4828,1,4874,G
5-NP,601,4868,1,9,0,4878,A
5-NP,602,1,4838,0,11,4850,T
5-NP,603,33,1,0,4817,4851,C
5-NP,604,4844,1,14,0,4859,A
5-NP,605,4859,0,5,0,4864,A
5-NP,606,0,6,0,4830,4836,C
5-NP,607,4,33,4757,0,4794,G
5-NP,608,4777,0,2,0,4779,A
5-NP,609,1,4778,0,2,4781,T
5-NP,610,41,0,0,4739,4780,C
5-NP,611,0,33,4755,0,4788,G
5-NP,612,4780,2,0,1,4783,A
5-NP,613,4774,0,0,0,4774,A
5-NP,614,4778,0,0,0,4778,A
5-NP,615,1,4830,1,0,4832,T
5-NP,616,0,4825,0,0,4825,T
5-NP,617,0,4819,1,1,4821,T
5-NP,618,0,4840,0,2,4842,T
5-NP,619,1,4837,1,1,4840,T
5-NP,620,2,19,4838,1,4860,G
5-NP,621,1,23,4836,1,4861,G
5-NP,622,4802,2,20,0,4824,A
5-NP,623,3,14,4838,0,4855,G
5-NP,624,4770,1,5,0,4776,A
5-NP,625,2,15,4952,0,4969,G
5-NP,626,2,1,4991,0,4994,G
5-NP,627,1,4978,2,14,4995,T
5-NP,628,0,29,4981,0,5010,G
5-NP,629,4994,2,10,0,5006,A
5-NP,630,2,32,5003,0,5037,G
5-NP,631,5032,1,4,0,5037,A
5-NP,632,5021,2,1,0,5024,A
5-NP,633,1,5014,0,0,5015,T
5-NP,634,2,24,4833,0,4859,G
5-NP,635,3,19,4807,0,4829,G
5-NP,636,4775,1,8,0,4784,A
5-NP,637,1,8,0,4807,4816,C
5-NP,638,1,14,4810,1,4826,G
5-NP,639,1,8,4893,0,4902,G
5-NP,640,4897,0,2,0,4899,A
5-NP,641,4911,1,1,0,4913,A
5-NP,642,4958,0,8,0,4966,A
5-NP,643,4974,1,9,2,4986,A
5-NP,644,3,4,0,5019,5026,C
5-NP,645,5013,0,1,1,5015,A
5-NP,646,5000,0,8,1,5009,A
5-NP,647,1,14,4988,0,5003,G
5-NP,648,4854,1,3,1,4859,A
5-NP,649,4884,0,8,0,4892,A
5-NP,650,0,1,5002,0,5003,G
5-NP,651,1,4991,0,3,4995,T
5-NP,652,4,3,5205,0,5212,G
5-NP,653,3,1,0,5170,5174,C
5-NP,654,0,5178,0,7,5185,T
5-NP,655,0,5195,1,4,5200,T
5-NP,656,5266,0,0,0,5266,A
5-NP,657,1,5255,1,4,5261,T
5-NP,658,1,36,5239,0,5276,G
5-NP,659,5128,2,18,0,5148,A
5-NP,660,0,28,5140,0,5168,G
5-NP,661,4905,3,8,2,4918,A
5-NP,662,1,29,4917,0,4947,G
5-NP,663,4921,0,8,0,4929,A
5-NP,664,4993,0,3,0,4996,A
5-NP,665,0,4961,0,0,4961,T
5-NP,666,3,1,5031,0,5035,G
5-NP,667,0,5004,0,11,5015,T
5-NP,668,4,5,5016,0,5025,G
5-NP,669,9,4,2,5010,5025,C
5-NP,670,5018,0,2,0,5020,A
5-NP,671,5023,0,9,0,5032,A
5-NP,672,4,3,0,5010,5017,C
5-NP,673,4967,2,0,0,4969,A
5-NP,674,0,4969,1,3,4973,T
5-NP,675,0,4918,1,4,4923,T
5-NP,676,20,0,11,4913,4944,C
5-NP,677,3,4920,0,3,4926,T
5-NP,678,1,4925,0,0,4926,T
5-NP,679,4929,0,2,1,4932,A
5-NP,680,4898,0,1,0,4899,A
5-NP,681,4900,1,4,0,4905,A
5-NP,682,2,8,4903,0,4913,G
5-NP,683,0,21,4884,0,4905,G
5-NP,684,4887,0,5,1,4893,A
5-NP,685,4869,0,4,1,4874,A
5-NP,686,4868,2,3,0,4873,A
5-NP,687,4943,1,6,1,4951,A
5-NP,688,0,4937,1,4,4942,T
5-NP,689,1,4940,0,0,4941,T
5-NP,690,0,4952,0,1,4953,T
5-NP,691,38,0,0,4914,4952,C
5-NP,692,4948,0,5,0,4953,A
5-NP,693,4950,0,2,1,4953,A
5-NP,694,4946,1,6,0,4953,A
5-NP,695,0,2,0,5008,5010,C
5-NP,696,4928,0,3,0,4931,A
5-NP,697,0,0,5027,0,5027,G
5-NP,698,4,3,0,5011,5018,C
5-NP,699,1,5003,0,4,5008,T
5-NP,700,2,6,5085,0,5093,G
5-NP,701,3,3,0,5085,5091,C
5-NP,702,5131,1,9,1,5142,A
5-NP,703,2,3,2,5146,5153,C
5-NP,704,5100,0,5,1,5106,A
5-NP,705,5115,1,6,0,5122,A
5-NP,706,5027,2,3,0,5032,A
5-NP,707,1,41,5176,0,5218,G
5-NP,708,5186,0,16,1,5203,A
5-NP,709,2,3,5219,0,5224,G
5-NP,710,1,2,0,5182,5185,C
5-NP,711,5161,0,7,1,5169,A
5-NP,712,5327,1,2,0,5330,A
5-NP,713,2,5329,0,1,5332,T
5-NP,714,4,20,5332,1,5357,G
5-NP,715,3,1,5385,0,5389,G
5-NP,716,1,5240,0,5,5246,T
5-NP,717,8,23,5211,0,5242,G
5-NP,718,3,27,5263,0,5293,G
5-NP,719,5281,3,8,0,5292,A
5-NP,720,0,5279,0,10,5289,T
5-NP,721,41,1,0,5145,5187,C
5-NP,722,5207,0,1,1,5209,A
5-NP,723,5245,1,2,1,5249,A
5-NP,724,1,1,5253,0,5255,G
5-NP,725,2,5212,0,3,5217,T
5-NP,726,5,32,5182,0,5219,G
5-NP,727,5126,0,9,1,5136,A
5-NP,728,1,29,5132,0,5162,G
5-NP,729,5139,2,10,0,5151,A
5-NP,730,1,19,5137,0,5157,G
5-NP,731,5111,1,6,0,5118,A
5-NP,732,5033,0,2,0,5035,A
5-NP,733,5039,1,7,0,5047,A
5-NP,734,1,1,5084,0,5086,G
5-NP,735,2,5068,0,0,5070,T
5-NP,736,43,6,0,5008,5057,C
5-NP,737,3,14,5028,0,5045,G
5-NP,738,0,25,5040,0,5065,G
5-NP,739,5040,1,9,0,5050,A
5-NP,740,5075,1,3,1,5080,A
5-NP,741,2,1,0,5089,5092,C
5-NP,742,6,3,0,5031,5040,C
5-NP,743,14,2,0,5033,5049,C
5-NP,744,5031,0,3,0,5034,A
5-NP,745,1,7,5051,0,5059,G
5-NP,746,0,20,5049,0,5069,G
5-NP,747,5040,1,4,0,5045,A
5-NP,748,5040,0,1,0,5041,A
5-NP,749,5024,0,12,1,5037,A
5-NP,750,1,3,0,5037,5041,C
5-NP,751,2,2,5024,0,5028,G
5-NP,752,6,1,0,5017,5024,C
5-NP,753,0,5008,0,5,5013,T
5-NP,754,1,21,5008,0,5030,G
5-NP,755,5002,0,4,0,5006,A
5-NP,756,0,21,5067,0,5088,G
5-NP,757,5088,1,7,0,5096,A
5-NP,758,0,5080,0,3,5083,T
5-NP,759,34,7,0,4997,5038,C
5-NP,760,1,14,5033,0,5048,G
5-NP,761,5037,1,1,0,5039,A
5-NP,762,5031,1,6,0,5038,A
5-NP,763,0,16,5035,0,5051,G
5-NP,764,5066,0,3,0,5069,A
5-NP,765,1,4993,1,2,4997,T
5-NP,766,17,1,0,5026,5044,C
5-NP,767,3,5018,1,7,5029,T
5-NP,768,37,0,0,5041,5078,C
5-NP,769,5085,0,2,0,5087,A
5-NP,770,0,5089,0,0,5089,T
5-NP,771,5098,1,1,0,5100,A
5-NP,772,2,5079,1,3,5085,T
5-NP,773,0,5059,1,1,5061,T
5-NP,774,1,5028,0,0,5029,T
5-NP,775,0,4964,2,1,4967,T
5-NP,776,0,4981,0,2,4983,T
5-NP,777,5004,0,3,0,5007,A
5-NP,778,1,5,4996,0,5002,G
5-NP,779,0,3,1,4997,5001,C
5-NP,780,4984,3,2,1,4990,A
5-NP,781,4969,3,4,0,4976,A
5-NP,782,0,20,5126,0,5146,G
5-NP,783,5133,1,7,2,5143,A
5-NP,784,0,5149,2,2,5153,T
5-NP,785,4,1,1,5179,5185,C
5-NP,786,1,5140,0,12,5153,T
5-NP,787,4,5,5320,0,5329,G
5-NP,788,3,5,0,5329,5337,C
5-NP,789,5332,6,4,0,5342,A
5-NP,790,0,5393,0,3,5396,T
5-NP,791,1,5195,0,10,5206,T
5-NP,792,0,28,5470,1,5499,G
5-NP,793,5601,0,5,0,5606,A
5-NP,794,2,5604,2,3,5611,T
5-NP,795,5611,1,3,0,5615,A
5-NP,796,0,5490,0,6,5496,T
5-NP,797,0,5448,3,4,5455,T
5-NP,798,3,42,5443,1,5489,G
5-NP,799,5404,0,11,1,5416,A
5-NP,800,0,15,5457,0,5472,G
5-NP,801,5136,3,17,2,5158,A
5-NP,802,0,17,5081,0,5098,G
5-NP,803,1,31,5114,1,5147,G
5-NP,804,5131,0,8,1,5140,A
5-NP,805,1,5128,0,4,5133,T
5-NP,806,35,1,1,5096,5133,C
5-NP,807,5102,2,3,0,5107,A
5-NP,808,0,2,5123,0,5125,G
5-NP,809,0,5098,0,2,5100,T
5-NP,810,0,5047,0,5,5052,T
5-NP,811,7,10,5034,0,5051,G
5-NP,812,3,1,0,5015,5019,C
5-NP,813,0,4995,2,8,5005,T
5-NP,814,45,5,1,5010,5061,C
5-NP,815,5052,2,7,0,5061,A
5-NP,816,1,4,0,5071,5076,C
5-NP,817,5055,0,2,1,5058,A
5-NP,818,5096,2,2,0,5100,A
5-NP,819,5106,0,1,0,5107,A
5-NP,820,0,5094,0,2,5096,T
5-NP,821,25,1,1,5078,5105,C
5-NP,822,1,5082,1,5,5089,T
5-NP,823,0,5068,0,5,5073,T
5-NP,824,1,3,5072,0,5076,G
5-NP,825,2,4,0,5071,5077,C
5-NP,826,19,0,0,5127,5146,C
5-NP,827,0,5119,2,3,5124,T
5-NP,828,5153,0,2,0,5155,A
5-NP,829,2,1,0,5141,5144,C
5-NP,830,10,0,0,5142,5152,C
5-NP,831,2,5122,1,5,5130,T
5-NP,832,6,3,5190,0,5199,G
5-NP,833,3,0,0,5189,5192,C
5-NP,834,10,2,1,5184,5197,C
5-NP,835,1,5098,1,6,5106,T
5-NP,836,1,0,5175,0,5176,G
5-NP,837,2,5138,0,2,5142,T
5-NP,838,2,6,5173,0,5181,G
5-NP,839,6,2,1,5207,5216,C
5-NP,840,3,0,5277,0,5280,G
5-NP,841,1,5202,1,5,5209,T
5-NP,842,5192,1,0,0,5193,A
5-NP,843,0,5195,0,6,5201,T
5-NP,844,1,23,5185,0,5209,G
5-NP,845,0,31,5339,0,5370,G
5-NP,846,5348,1,8,1,5358,A
5-NP,847,2,1,0,5270,5273,C
5-NP,848,14,0,0,5253,5267,C
5-NP,849,2,5166,0,2,5170,T
5-NP,850,2,0,5404,0,5406,G
5-NP,851,1,5,0,5409,5415,C
5-NP,852,5411,1,3,0,5415,A
5-NP,853,2,2,5522,0,5526,G
5-NP,854,1,5272,3,0,5276,T
5-NP,855,5485,0,2,0,5487,A
5-NP,856,2,5470,1,6,5479,T
5-NP,857,18,3,0,5439,5460,C
5-NP,858,13,2,0,5461,5476,C
5-NP,859,5239,3,3,0,5245,A
5-NP,860,0,1,5269,0,5270,G
5-NP,861,0,5239,0,4,5243,T
5-NP,862,4,16,5263,0,5283,G
5-NP,863,27,13,5235,0,5275,G
5-NP,864,1,4,5176,0,5181,G
5-NP,865,1,5166,0,4,5171,T
5-NP,866,5157,0,3,1,5161,A
5-NP,867,4,28,0,5119,5151,C
5-NP,868,1,63,5072,0,5136,G
5-NP,869,5104,3,5,0,5112,A
5-NP,870,1,3,0,5105,5109,C
5-NP,871,0,4927,1,9,4937,T
5-NP,872,0,4940,1,4,4945,T
5-NP,873,24,2,0,4893,4919,C
5-NP,874,1,31,4899,1,4932,G
5-NP,875,4929,1,1,0,4931,A
5-NP,876,4927,0,2,2,4931,A
5-NP,877,4936,1,3,1,4941,A
5-NP,878,4937,0,0,0,4937,A
5-NP,879,4913,0,12,0,4925,A
5-NP,880,0,9,4935,0,4944,G
5-NP,881,4900,4,12,1,4917,A
5-NP,882,0,27,4943,0,4970,G
5-NP,883,0,14,4980,1,4995,G
5-NP,884,4,22,4976,1,5003,G
5-NP,885,5012,0,6,0,5018,A
5-NP,886,0,5011,0,4,5015,T
5-NP,887,5036,1,4,0,5041,A
5-NP,888,0,5026,1,2,5029,T
5-NP,889,1,5066,1,2,5070,T
5-NP,890,37,1,0,5051,5089,C
5-NP,891,13,1,0,5029,5043,C
5-NP,892,0,4977,0,3,4980,T
5-NP,893,1,4979,0,2,4982,T
5-NP,894,3,18,4999,0,5020,G
5-NP,895,1,0,5050,0,5051,G
5-NP,896,2,4991,0,3,4996,T
5-NP,897,1,18,4969,0,4988,G
5-NP,898,3,10,4946,1,4960,G
5-NP,899,2,32,5144,1,5179,G
5-NP,900,5174,1,5,0,5180,A
5-NP,901,5180,0,2,3,5185,A
5-NP,902,1,5184,0,1,5186,T
5-NP,903,5095,0,6,0,5101,A
5-NP,904,0,24,5088,0,5112,G
5-NP,905,5051,1,14,0,5066,A
5-NP,906,2,0,0,5063,5065,C
5-NP,907,21,2,0,4998,5021,C
5-NP,908,20,1,1,4860,4882,C
5-NP,909,0,4894,1,13,4908,T
5-NP,910,2,4910,0,2,4914,T
5-NP,911,0,4914,0,4,4918,T
5-NP,912,35,2,0,4890,4927,C
5-NP,913,4906,0,2,0,4908,A
5-NP,914,4909,0,1,0,4910,A
5-NP,915,4891,0,4,0,4895,A
5-NP,916,1,0,0,4908,4909,C
5-NP,917,0,4750,0,1,4751,T
5-NP,918,4724,1,2,0,4727,A
5-NP,919,0,0,0,4793,4793,C
5-NP,920,1,4752,2,5,4760,T
5-NP,921,1,4755,0,5,4761,T
5-NP,922,15,0,0,4765,4780,C
5-NP,923,4764,1,4,0,4769,A
5-NP,924,4761,1,2,0,4764,A
5-NP,925,4753,1,1,0,4755,A
5-NP,926,4755,0,4,1,4760,A
5-NP,927,0,4727,0,1,4728,T
5-NP,928,4616,0,5,0,4621,A
5-NP,929,2,6,4680,0,4688,G
5-NP,930,4,2,0,4710,4716,C
5-NP,931,18,1,0,4759,4778,C
5-NP,932,4767,1,3,0,4771,A
5-NP,933,4784,0,1,0,4785,A
5-NP,934,4924,1,6,1,4932,A
5-NP,935,0,4944,0,1,4945,T
5-NP,936,4977,0,1,2,4980,A
5-NP,937,1,4975,1,6,4983,T
5-NP,938,4872,1,5,0,4878,A
5-NP,939,1,3,0,4899,4903,C
5-NP,940,4765,2,3,1,4771,A
5-NP,941,6,0,4884,0,4890,G
5-NP,942,4,1,0,4864,4869,C
5-NP,943,1,4618,1,91,4711,T
5-NP,944,2,4749,0,3,4754,T
5-NP,945,4775,0,0,0,4775,A
5-NP,946,4779,1,6,0,4786,A
5-NP,947,1,4782,0,3,4786,T
5-NP,948,39,3,0,4725,4767,C
5-NP,949,4578,1,8,1,4588,A
5-NP,950,0,38,4577,0,4615,G
5-NP,951,4615,0,5,0,4620,A
5-NP,952,4,1,0,4654,4659,C
5-NP,953,22,1,0,4590,4613,C
5-NP,954,1,4551,0,2,4554,T
5-NP,955,4596,0,2,0,4598,A
5-NP,956,4598,0,1,0,4599,A
5-NP,957,1,4,0,4616,4621,C
5-NP,958,3,29,4592,1,4625,G
5-NP,959,4526,0,2,0,4528,A
5-NP,960,0,19,4516,0,4535,G
5-NP,961,4482,0,7,1,4490,A
5-NP,962,4523,2,3,0,4528,A
5-NP,963,1,4435,0,83,4519,T
5-NP,964,19,3,1,4457,4480,C
5-NP,965,10,1,0,4468,4479,C
5-NP,966,4409,0,9,0,4418,A
5-NP,967,1,4,4446,0,4451,G
5-NP,968,2,0,0,4439,4441,C
5-NP,969,4465,1,4,0,4470,A
5-NP,970,1,2,0,4490,4493,C
5-NP,971,4445,1,7,0,4453,A
5-NP,972,1,0,1,4463,4465,C
5-NP,973,4451,1,2,0,4454,A
5-NP,974,4466,0,10,1,4477,A
5-NP,975,0,18,4466,0,4484,G
5-NP,976,4412,4,9,0,4425,A
5-NP,977,1,2,4443,0,4446,G
5-NP,978,0,4345,0,5,4350,T
5-NP,979,50,1,0,4297,4348,C
5-NP,980,4332,1,2,0,4335,A
5-NP,981,0,0,4338,0,4338,G
5-NP,982,1,2,0,4339,4342,C
5-NP,983,0,4287,1,7,4295,T
5-NP,984,4,10,4335,0,4349,G
5-NP,985,1,0,4365,0,4366,G
5-NP,986,1,4340,2,4,4347,T
5-NP,987,1,1,4374,1,4377,G
5-NP,988,0,4314,1,4,4319,T
5-NP,989,2,6,4300,0,4308,G
5-NP,990,2,11,4283,0,4296,G
5-NP,991,4281,0,5,0,4286,A
5-NP,992,0,4290,0,5,4295,T
5-NP,993,2,16,4100,2,4120,G
5-NP,994,1,0,4097,0,4098,G
5-NP,995,3,5,0,4085,4093,C
5-NP,996,4044,1,5,0,4050,A
5-NP,997,0,4038,3,11,4052,T
5-NP,998,2,2,4025,1,4030,G
5-NP,999,2,4,0,4056,4062,C
5-NP,1000,24,1,1,4032,4058,C
5-NP,1001,4054,0,5,0,4059,A
5-NP,1002,1,4028,13,3,4045,T
5-NP,1003,0,3981,0,4,3985,T
5-NP,1004,26,0,0,3985,4011,C
5-NP,1005,0,3947,0,6,3953,T
5-NP,1006,1,1,3958,0,3960,G
5-NP,1007,1,0,0,3947,3948,C
5-NP,1008,1,3802,0,7,3810,T
5-NP,1009,1,2,3824,0,3827,G
5-NP,1010,5,1,0,3778,3784,C
5-NP,1011,3784,1,0,0,3785,A
5-NP,1012,1,3776,1,4,3782,T
5-NP,1013,1,3742,2,2,3747,T
5-NP,1014,1,3738,1,1,3741,T
5-NP,1015,1,13,3723,0,3737,G
5-NP,1016,3729,0,0,0,3729,A
5-NP,1017,3727,0,7,0,3734,A
5-NP,1018,0,18,3741,0,3759,G
5-NP,1019,3746,0,4,0,3750,A
5-NP,1020,0,3733,0,0,3733,T
5-NP,1021,0,3724,0,1,3725,T
5-NP,1022,0,3726,0,1,3727,T
5-NP,1023,3722,0,2,0,3724,A
5-NP,1024,3720,0,4,0,3724,A
5-NP,1025,1,18,3706,0,3725,G
5-NP,1026,3717,0,3,0,3720,A
5-NP,1027,1,3713,2,2,3718,T
5-NP,1028,1,3622,1,1,3625,T
5-NP,1029,1,2,3650,0,3653,G
5-NP,1030,1,3642,0,1,3644,T
5-NP,1031,3,3640,0,1,3644,T
5-NP,1032,3642,1,1,0,3644,A
5-NP,1033,3648,0,4,2,3654,A
5-NP,1034,1,0,3668,0,3669,G
5-NP,1035,0,1,0,3674,3675,C
5-NP,1036,1,3605,0,12,3618,T
5-NP,1037,1,3612,0,4,3617,T
5-NP,1038,22,0,0,3602,3624,C
5-NP,1039,3623,0,6,0,3629,A
5-NP,1040,1,3618,0,5,3624,T
5-NP,1041,15,4,0,3613,3632,C
5-NP,1042,3562,1,3,0,3566,A
5-NP,1043,0,9,3551,0,3560,G
5-NP,1044,3501,2,5,0,3508,A
5-NP,1045,2,8,3509,0,3519,G
5-NP,1046,1,15,3498,0,3514,G
5-NP,1047,1,12,3475,0,3488,G
5-NP,1048,3480,0,6,0,3486,A
5-NP,1049,2,2,0,3489,3493,C
5-NP,1050,3484,0,4,0,3488,A
5-NP,1051,3493,0,1,0,3494,A
5-NP,1052,3506,0,0,0,3506,A
5-NP,1053,3507,2,8,1,3518,A
5-NP,1054,0,1,3538,0,3539,G
5-NP,1055,1,3427,0,3,3431,T
5-NP,1056,3414,0,1,0,3415,A
5-NP,1057,1,3397,0,8,3406,T
5-NP,1058,18,4,0,3382,3404,C
5-NP,1059,0,3366,0,5,3371,T
5-NP,1060,19,1,0,3383,3403,C
5-NP,1061,6,0,0,3369,3375,C
5-NP,1062,0,3359,0,2,3361,T
5-NP,1063,7,2,0,3347,3356,C
5-NP,1064,0,11,3344,0,3355,G
5-NP,1065,1,7,3365,1,3374,G
5-NP,1066,1,8,3356,0,3365,G
5-NP,1067,3,8,3346,1,3358,G
5-NP,1068,2,16,3336,0,3354,G
5-NP,1069,3307,0,1,0,3308,A
5-NP,1070,3305,0,2,0,3307,A
5-NP,1071,3307,1,4,1,3313,A
5-NP,1072,0,1,0,3336,3337,C
5-NP,1073,0,3315,1,2,3318,T
5-NP,1074,0,0,3330,0,3330,G
5-NP,1075,2,3288,0,6,3296,T
5-NP,1076,50,0,0,3252,3302,C
5-NP,1077,3342,0,2,0,3344,A
5-NP,1078,3360,0,2,0,3362,A
5-NP,1079,0,10,0,3365,3375,C
5-NP,1080,0,3354,0,6,3360,T
5-NP,1081,3275,0,1,0,3276,A
5-NP,1082,0,9,3280,0,3289,G
5-NP,1083,3213,0,4,0,3217,A
5-NP,1084,0,9,3209,0,3218,G
5-NP,1085,1,14,3197,0,3212,G
5-NP,1086,3030,0,4,0,3034,A
5-NP,1087,2,4,3087,0,3093,G
5-NP,1088,0,3053,0,1,3054,T
5-NP,1089,3052,0,2,0,3054,A
5-NP,1090,0,2,0,3052,3054,C
5-NP,1091,3008,0,0,0,3008,A
5-NP,1092,3011,0,3,0,3014,A
5-NP,1093,2976,1,0,0,2977,A
5-NP,1094,0,2958,1,1,2960,T
5-NP,1095,0,2930,0,0,2930,T
5-NP,1096,2,1,2841,0,2844,G
5-NP,1097,2,0,0,2814,2816,C
5-NP,1098,0,2790,0,7,2797,T
5-NP,1099,0,2794,0,3,2797,T
5-NP,1100,10,1,0,2787,2798,C
5-NP,1101,2793,0,0,0,2793,A
5-NP,1102,2807,0,2,0,2809,A
5-NP,1103,2804,0,0,1,2805,A
5-NP,1104,0,2805,0,0,2805,T
5-NP,1105,0,16,2778,0,2794,G
5-NP,1106,2722,1,5,0,2728,A
5-NP,1107,0,16,2729,0,2745,G
5-NP,1108,2737,0,11,0,2748,A
5-NP,1109,2738,0,7,0,2745,A
5-NP,1110,0,0,0,2747,2747,C
5-NP,1111,2700,0,3,0,2703,A
5-NP,1112,0,2697,0,3,2700,T
5-NP,1113,0,9,2722,0,2731,G
5-NP,1114,7,8,2724,0,2739,G
5-NP,1115,2744,1,2,0,2747,A
5-NP,1116,0,2678,0,1,2679,T
5-NP,1117,2637,0,1,0,2638,A
5-NP,1118,2768,0,0,0,2768,A
5-NP,1119,0,2705,0,1,2706,T
5-NP,1120,2691,0,0,0,2691,A
5-NP,1121,0,2678,0,0,2678,T
5-NP,1122,2,8,2473,1,2484,G
5-NP,1123,0,3,2436,0,2439,G
5-NP,1124,1,3,2424,0,2428,G
5-NP,1125,2419,0,0,0,2419,A
5-NP,1126,0,2412,0,0,2412,T
5-NP,1127,8,0,0,1915,1923,C
5-NP,1128,2,10,1919,0,1931,G
5-NP,1129,1923,1,0,0,1924,A
5-NP,1130,0,1,1927,0,1928,G
5-NP,1131,1,1,0,1918,1920,C
5-NP,1132,1901,1,0,0,1902,A
5-NP,1133,0,0,0,1975,1975,C
5-NP,1134,0,1943,0,2,1945,T
5-NP,1135,17,0,0,1946,1963,C
5-NP,1136,1,1940,1,13,1955,T
5-NP,1137,2,1925,0,2,1929,T
5-NP,1138,0,9,1930,0,1939,G
5-NP,1139,1925,0,3,0,1928,A
5-NP,1140,1934,0,1,0,1935,A
5-NP,1141,0,0,0,1935,1935,C
5-NP,1142,0,1471,0,2,1473,T
5-NP,1143,1,10,1473,0,1484,G
5-NP,1144,1430,0,3,0,1433,A
5-NP,1145,0,3,1435,0,1438,G
5-NP,1146,1437,0,0,2,1439,A
5-NP,1147,1440,0,2,0,1442,A
5-NP,1148,1,1,1445,0,1447,G
5-NP,1149,0,2,0,1417,1419,C
5-NP,1150,170,1,1242,0,1413,G
5-NP,1151,0,3,1409,0,1412,G
5-NP,1152,1,0,1394,1,1396,G
5-NP,1153,0,1385,0,1,1386,T
5-NP,1154,1355,0,1,0,1356,A
5-NP,1155,1,0,0,1354,1355,C
5-NP,1156,0,1108,1,0,1109,T
5-NP,1157,0,8,1099,0,1107,G
5-NP,1158,0,3,1090,0,1093,G
5-NP,1159,0,0,1086,0,1086,G
5-NP,1160,0,0,0,1074,1074,C
5-NP,1161,2,0,0,1006,1008,C
5-NP,1162,1035,0,0,0,1035,A
5-NP,1163,0,1037,0,0,1037,T
5-NP,1164,1037,0,1,0,1038,A
5-NP,1165,1037,0,1,0,1038,A
5-NP,1166,2,1,1023,0,1026,G
5-NP,1167,0,7,1044,0,1051,G
5-NP,1168,1040,0,0,0,1040,A
5-NP,1169,0,1,0,1044,1045,C
5-NP,1170,2,0,0,1040,1042,C
5-NP,1171,1040,0,1,0,1041,A
5-NP,1172,0,0,1053,0,1053,G
5-NP,1173,0,3,1052,0,1055,G
5-NP,1174,1054,0,2,0,1056,A
5-NP,1175,0,0,1061,0,1061,G
5-NP,1176,0,1028,0,0,1028,T
5-NP,1177,1,2,1026,0,1029,G
5-NP,1178,0,0,1033,0,1033,G
5-NP,1179,1034,0,1,0,1035,A
5-NP,1180,0,4,1040,1,1045,G
5-NP,1181,0,2,1026,0,1028,G
5-NP,1182,1016,0,1,0,1017,A
5-NP,1183,1015,0,1,0,1016,A
5-NP,1184,1017,0,3,0,1020,A
5-NP,1185,0,1,0,1029,1030,C
5-NP,1186,1021,0,0,1,1022,A
5-NP,1187,0,0,0,1034,1034,C
5-NP,1188,0,1020,0,0,1020,T
5-NP,1189,1045,0,0,0,1045,A
5-NP,1190,1045,0,1,0,1046,A
5-NP,1191,1,1038,0,1,1040,T
5-NP,1192,6,0,0,1043,1049,C
5-NP,1193,1034,0,1,0,1035,A
5-NP,1194,1044,0,2,0,1046,A
5-NP,1195,1,0,1,1047,1049,C
5-NP,1196,1029,0,0,0,1029,A
5-NP,1197,0,1,1025,0,1026,G
5-NP,1198,995,0,2,0,997,A
5-NP,1199,0,2,1011,1,1014,G
5-NP,1200,0,0,1015,0,1015,G
5-NP,1201,0,0,1007,0,1007,G
5-NP,1202,0,1,0,1002,1003,C
5-NP,1203,1,0,0,997,998,C
5-NP,1204,0,981,0,1,982,T
5-NP,1205,2,0,0,992,994,C
5-NP,1206,1,1,0,993,995,C
5-NP,1207,16,0,978,0,994,G
5-NP,1208,0,1,0,995,996,C
5-NP,1209,975,0,1,0,976,A
5-NP,1210,0,6,1003,0,1009,G
5-NP,1211,1,0,1007,0,1008,G
5-NP,1212,0,0,0,1016,1016,C
5-NP,1213,3,2,0,1011,1016,C
5-NP,1214,1002,0,1,0,1003,A
5-NP,1215,1003,0,1,0,1004,A
5-NP,1216,1005,0,1,0,1006,A
5-NP,1217,0,0,0,1013,1013,C
5-NP,1218,5,1,0,1007,1013,C
5-NP,1219,965,0,1,0,966,A
5-NP,1220,0,0,983,0,983,G
5-NP,1221,1,974,0,0,975,T
5-NP,1222,0,0,983,0,983,G
5-NP,1223,0,979,0,0,979,T
5-NP,1224,0,1,977,0,978,G
5-NP,1225,0,0,0,980,980,C
5-NP,1226,969,1,0,0,970,A
5-NP,1227,978,1,2,0,981,A
5-NP,1228,0,0,0,985,985,C
5-NP,1229,1,1,1,977,980,C
5-NP,1230,0,972,0,1,973,T
5-NP,1231,974,0,0,0,974,A
5-NP,1232,0,0,0,975,975,C
5-NP,1233,0,1,975,0,976,G
5-NP,1234,0,971,2,1,974,T
5-NP,1235,0,984,0,1,985,T
5-NP,1236,0,969,0,2,971,T
5-NP,1237,0,968,0,1,969,T
5-NP,1238,4,0,0,964,968,C
5-NP,1239,0,954,0,1,955,T
5-NP,1240,0,0,976,0,976,G
5-NP,1241,0,972,0,0,972,T
5-NP,1242,976,0,0,0,976,A
5-NP,1243,0,2,0,981,983,C
5-NP,1244,970,0,0,0,970,A
5-NP,1245,970,0,1,0,971,A
5-NP,1246,968,0,1,0,969,A
5-NP,1247,0,2,973,0,975,G
5-NP,1248,974,0,0,0,974,A
5-NP,1249,944,0,1,0,945,A
5-NP,1250,946,0,0,0,946,A
5-NP,1251,0,0,0,947,947,C
5-NP,1252,2,0,0,940,942,C
5-NP,1253,0,938,0,1,939,T
5-NP,1254,1,0,0,942,943,C
5-NP,1255,2,0,0,939,941,C
5-NP,1256,1,0,0,939,940,C
5-NP,1257,936,0,2,0,938,A
5-NP,1258,0,938,0,1,939,T
5-NP,1259,0,940,0,0,940,T
5-NP,1260,0,937,0,1,938,T
5-NP,1261,1,5,929,0,935,G
5-NP,1262,932,0,2,0,934,A
5-NP,1263,932,0,0,0,932,A
5-NP,1264,929,0,1,0,930,A
5-NP,1265,927,0,0,0,927,A
5-NP,1266,0,0,939,0,939,G
5-NP,1267,0,929,0,1,930,T
5-NP,1268,12,0,0,920,932,C
5-NP,1269,930,1,1,0,932,A
5-NP,1270,939,0,1,0,940,A
5-NP,1271,0,2,0,940,942,C
5-NP,1272,8,0,0,945,953,C
5-NP,1273,956,0,0,0,956,A
5-NP,1274,0,952,0,3,955,T
5-NP,1275,8,0,0,940,948,C
5-NP,1276,941,0,2,0,943,A
5-NP,1277,0,946,0,0,946,T
5-NP,1278,1,2,943,0,946,G
5-NP,1279,0,0,942,0,942,G
5-NP,1280,0,0,0,943,943,C
5-NP,1281,918,0,0,0,918,A
5-NP,1282,0,0,920,0,920,G
5-NP,1283,1,0,0,911,912,C
5-NP,1284,915,0,0,0,915,A
5-NP,1285,0,912,1,1,914,T
5-NP,1286,0,907,0,0,907,T
5-NP,1287,3,1,0,903,907,C
5-NP,1288,894,2,1,0,897,A
5-NP,1289,0,0,0,904,904,C
5-NP,1290,0,898,0,1,899,T
5-NP,1291,0,4,898,0,902,G
5-NP,1292,1,1,900,0,902,G
5-NP,1293,895,0,2,0,897,A
5-NP,1294,896,0,1,0,897,A
5-NP,1295,901,0,0,0,901,A
5-NP,1296,0,896,0,0,896,T
5-NP,1297,897,0,0,0,897,A
5-NP,1298,0,0,0,894,894,C
5-NP,1299,0,2,885,0,887,G
5-NP,1300,0,2,881,0,883,G
5-NP,1301,864,1,1,0,866,A
5-NP,1302,850,5,1,0,856,A
5-NP,1303,1,2,865,0,868,G
5-NP,1304,0,3,874,0,877,G
5-NP,1305,875,0,1,0,876,A
5-NP,1306,868,0,3,0,871,A
5-NP,1307,0,8,865,1,874,G
5-NP,1308,873,0,0,0,873,A
5-NP,1309,869,0,2,0,871,A
5-NP,1310,0,2,0,881,883,C
5-NP,1311,0,871,0,0,871,T
5-NP,1312,0,881,0,1,882,T
5-NP,1313,3,0,0,874,877,C
5-NP,1314,875,0,1,0,876,A
5-NP,1315,1,0,880,0,881,G
5-NP,1316,878,0,0,0,878,A
5-NP,1317,0,0,0,876,876,C
5-NP,1318,869,0,0,0,869,A
5-NP,1319,0,853,0,0,853,T
5-NP,1320,0,3,852,0,855,G
5-NP,1321,839,0,1,0,840,A
5-NP,1322,0,4,849,0,853,G
5-NP,1323,0,1,851,0,852,G
5-NP,1324,0,0,850,0,850,G
5-NP,1325,0,0,0,851,851,C
5-NP,1326,837,0,2,0,839,A
5-NP,1327,0,3,840,0,843,G
5-NP,1328,843,0,0,0,843,A
5-NP,1329,846,1,0,0,847,A
5-NP,1330,849,0,0,0,849,A
5-NP,1331,1,842,0,1,844,T
5-NP,1332,5,0,0,844,849,C
5-NP,1333,848,0,0,0,848,A
5-NP,1334,0,846,0,2,848,T
5-NP,1335,850,0,0,0,850,A
5-NP,1336,838,0,2,0,840,A
5-NP,1337,0,4,849,0,853,G
5-NP,1338,841,0,2,0,843,A
5-NP,1339,851,0,2,0,853,A
5-NP,1340,0,831,0,1,832,T
5-NP,1341,0,2,837,0,839,G
5-NP,1342,835,0,1,0,836,A
5-NP,1343,0,833,0,2,835,T
5-NP,1344,0,3,832,0,835,G
5-NP,1345,0,4,831,0,835,G
5-NP,1346,822,0,0,0,822,A
5-NP,1347,819,0,1,0,820,A
5-NP,1348,786,0,1,0,787,A
5-NP,1349,0,0,799,0,799,G
5-NP,1350,0,796,0,0,796,T
5-NP,1351,0,0,798,0,798,G
5-NP,1352,1,1,0,797,799,C
5-NP,1353,789,0,1,0,790,A
5-NP,1354,793,0,0,0,793,A
5-NP,1355,792,0,1,0,793,A
5-NP,1356,801,0,2,0,803,A
5-NP,1357,0,0,0,806,806,C
5-NP,1358,4,0,0,799,803,C
5-NP,1359,793,0,3,0,796,A
5-NP,1360,0,2,798,0,800,G
5-NP,1361,795,0,2,0,797,A
5-NP,1362,800,0,0,0,800,A
5-NP,1363,0,1,801,0,802,G
5-NP,1364,793,0,0,0,793,A
5-NP,1365,774,0,1,0,775,A
5-NP,1366,0,0,777,0,777,G
5-NP,1367,0,770,0,1,771,T
5-NP,1368,0,1,776,1,778,G
5-NP,1369,0,765,0,2,767,T
5-NP,1370,7,0,0,761,768,C
5-NP,1371,771,0,0,0,771,A
5-NP,1372,0,771,0,3,774,T
5-NP,1373,0,771,0,2,773,T
5-NP,1374,8,3,0,766,777,C
5-NP,1375,2,0,0,766,768,C
5-NP,1376,0,2,766,0,768,G
5-NP,1377,2,3,763,1,769,G
5-NP,1378,1,4,764,0,769,G
5-NP,1379,1,0,769,0,770,G
5-NP,1380,0,2,767,0,769,G
5-NP,1381,740,0,3,0,743,A
5-NP,1382,0,1,744,0,745,G
5-NP,1383,1,4,736,0,741,G
5-NP,1384,0,4,737,0,741,G
5-NP,1385,1,7,734,0,742,G
5-NP,1386,730,0,1,0,731,A
5-NP,1387,0,0,730,0,730,G
5-NP,1388,0,719,0,1,720,T
5-NP,1389,4,0,0,702,706,C
5-NP,1390,0,713,0,0,713,T
5-NP,1391,0,716,0,0,716,T
5-NP,1392,6,1,0,710,717,C
5-NP,1393,1,2,708,0,711,G
5-NP,1394,709,0,2,0,711,A
5-NP,1395,0,0,713,0,713,G
5-NP,1396,1,0,0,695,696,C
5-NP,1397,0,693,0,1,694,T
5-NP,1398,1,1,0,692,694,C
5-NP,1399,0,692,0,0,692,T
5-NP,1400,3,0,0,692,695,C
5-NP,1401,694,0,0,0,694,A
5-NP,1402,0,5,691,0,696,G
5-NP,1403,696,0,1,0,697,A
5-NP,1404,1,0,0,689,690,C
5-NP,1405,0,5,684,0,689,G
5-NP,1406,676,0,1,0,677,A
5-NP,1407,0,2,675,0,677,G
5-NP,1408,670,0,0,0,670,A
5-NP,1409,666,0,0,0,666,A
5-NP,1410,0,3,662,0,665,G
5-NP,1411,0,1,658,0,659,G
5-NP,1412,0,0,0,654,654,C
5-NP,1413,650,0,0,0,650,A
5-NP,1414,648,0,0,0,648,A
5-NP,1415,0,0,0,646,646,C
5-NP,1416,0,5,645,0,650,G
5-NP,1417,649,0,0,0,649,A
5-NP,1418,652,0,0,0,652,A
5-NP,1419,0,0,0,648,648,C
5-NP,1420,2,0,0,639,641,C
5-NP,1421,1,0,0,632,633,C
5-NP,1422,1,6,626,0,633,G
5-NP,1423,635,0,1,0,636,A
5-NP,1424,0,635,0,1,636,T
5-NP,1425,5,0,0,618,623,C
5-NP,1426,0,0,618,0,618,G
5-NP,1427,0,612,0,3,615,T
5-NP,1428,0,1,617,0,618,G
5-NP,1429,1,0,0,611,612,C
5-NP,1430,2,0,1,611,614,C
5-NP,1431,2,0,0,612,614,C
5-NP,1432,0,603,0,1,604,T
5-NP,1433,1,0,0,628,629,C
5-NP,1434,1,622,0,2,625,T
5-NP,1435,0,627,0,0,627,T
5-NP,1436,0,623,0,0,623,T
5-NP,1437,0,617,0,0,617,T
5-NP,1438,0,4,620,0,624,G
5-NP,1439,621,0,0,0,621,A
5-NP,1440,0,610,0,0,610,T
5-NP,1441,609,0,0,0,609,A
5-NP,1442,0,507,0,1,508,T
5-NP,1443,1,8,518,0,527,G
5-NP,1444,518,1,0,0,519,A
5-NP,1445,0,0,526,0,526,G
5-NP,1446,0,522,0,1,523,T
5-NP,1447,516,0,0,0,516,A
5-NP,1448,517,0,1,0,518,A
5-NP,1449,0,515,0,3,518,T
5-NP,1450,0,2,516,0,518,G
5-NP,1451,515,1,0,0,516,A
5-NP,1452,458,0,1,0,459,A
5-NP,1453,0,1,457,0,458,G
5-NP,1454,0,2,425,0,427,G
5-NP,1455,422,0,0,0,422,A
5-NP,1456,0,420,0,0,420,T
5-NP,1457,0,0,1,417,418,C
5-NP,1458,0,415,0,0,415,T
5-NP,1459,0,414,0,0,414,T
5-NP,1460,415,0,0,0,415,A
5-NP,1461,0,414,0,0,414,T
5-NP,1462,0,408,0,0,408,T
5-NP,1463,0,405,0,0,405,T
5-NP,1464,1,0,0,400,401,C
5-NP,1465,0,386,0,1,387,T
5-NP,1466,0,385,0,0,385,T
5-NP,1467,2,1,0,383,386,C
5-NP,1468,0,0,384,0,384,G
5-NP,1469,0,1,384,0,385,G
5-NP,1470,382,0,2,0,384,A
5-NP,1471,0,2,382,0,384,G
5-NP,1472,380,1,0,0,381,A
5-NP,1473,0,0,0,378,378,C
5-NP,1474,352,0,0,0,352,A
5-NP,1475,352,0,0,0,352,A
5-NP,1476,0,352,0,0,352,T
5-NP,1477,0,0,352,0,352,G
5-NP,1478,0,0,0,352,352,C
5-NP,1479,339,0,0,0,339,A
5-NP,1480,0,0,337,0,337,G
5-NP,1481,338,0,1,0,339,A
5-NP,1482,320,0,1,0,321,A
5-NP,1483,0,0,322,0,322,G
5-NP,1484,234,0,1,0,235,A
5-NP,1485,0,0,234,0,234,G
5-NP,1486,0,215,0,0,215,T
5-NP,1487,215,0,0,0,215,A
5-NP,1488,0,194,0,0,194,T
5-NP,1489,0,1,193,0,194,G
5-NP,1490,194,0,0,0,194,A
5-NP,1491,0,0,0,194,194,C
5-NP,1492,134,0,0,0,134,A
5-NP,1493,134,0,0,0,134,A
5-NP,1494,0,103,0,0,103,T
5-NP,1495,0,95,0,0,95,T
5-NP,1496,93,0,0,0,93,A
5-NP,1497,92,0,0,0,92,A
6-NA,1,92,0,0,0,92,A
6-NA,2,0,92,0,0,92,T
6-NA,3,0,0,92,0,92,G
6-NA,4,89,0,3,1,93,A
6-NA,5,101,0,0,0,101,A
6-NA,6,0,101,0,0,101,T
6-NA,7,0,0,0,101,101,C
6-NA,8,0,0,0,100,100,C
6-NA,9,101,0,0,0,101,A
6-NA,10,107,0,0,0,107,A
6-NA,11,109,0,0,0,109,A
6-NA,12,0,109,0,0,109,T
6-NA,13,0,0,0,110,110,C
6-NA,14,109,0,0,1,110,A
6-NA,15,111,0,0,0,111,A
6-NA,16,110,0,1,0,111,A
6-NA,17,116,0,0,0,116,A
6-NA,18,0,1,124,0,125,G
6-NA,19,127,0,0,0,127,A
6-NA,20,0,127,0,0,127,T
6-NA,21,128,0,0,0,128,A
6-NA,22,129,1,0,0,130,A
6-NA,23,0,131,0,0,131,T
6-NA,24,131,0,0,0,131,A
6-NA,25,131,0,0,0,131,A
6-NA,26,0,0,0,139,139,C
6-NA,27,0,1,146,0,147,G
6-NA,28,147,0,0,0,147,A
6-NA,29,0,146,0,1,147,T
6-NA,30,0,146,0,1,147,T
6-NA,31,0,2,145,0,147,G
6-NA,32,0,4,152,0,156,G
6-NA,33,0,1,0,158,159,C
6-NA,34,0,159,0,0,159,T
6-NA,35,0,0,0,173,173,C
6-NA,36,0,173,0,0,173,T
6-NA,37,0,0,178,0,178,G
6-NA,38,0,178,0,0,178,T
6-NA,39,0,178,0,0,178,T
6-NA,40,0,186,0,0,186,T
6-NA,41,0,0,0,187,187,C
6-NA,42,0,188,0,0,188,T
6-NA,43,0,1,0,191,192,C
6-NA,44,0,191,0,1,192,T
6-NA,45,1,0,0,195,196,C
6-NA,46,195,0,1,0,196,A
6-NA,47,0,0,0,209,209,C
6-NA,48,0,0,0,211,211,C
6-NA,49,210,0,0,0,210,A
6-NA,50,0,217,0,0,217,T
6-NA,51,0,221,0,4,225,T
6-NA,52,0,225,0,0,225,T
6-NA,53,2,0,0,231,233,C
6-NA,54,0,0,0,235,235,C
6-NA,55,239,0,1,0,240,A
6-NA,56,0,0,0,255,255,C
6-NA,57,254,0,0,0,254,A
6-NA,58,265,0,0,0,265,A
6-NA,59,0,264,0,0,264,T
6-NA,60,283,0,0,0,283,A
6-NA,61,0,284,0,0,284,T
6-NA,62,0,0,283,0,283,G
6-NA,63,0,0,0,283,283,C
6-NA,64,0,281,0,1,282,T
6-NA,65,0,289,0,0,289,T
6-NA,66,0,0,0,290,290,C
6-NA,67,1,287,0,0,288,T
6-NA,68,1,287,0,0,288,T
6-NA,69,1,0,0,285,286,C
6-NA,70,288,0,0,0,288,A
6-NA,71,0,290,0,0,290,T
6-NA,72,0,2,290,0,292,G
6-NA,73,0,1,0,295,296,C
6-NA,74,296,0,0,0,296,A
6-NA,75,297,0,0,0,297,A
6-NA,76,294,3,0,0,297,A
6-NA,77,0,304,0,0,304,T
6-NA,78,0,304,0,0,304,T
6-NA,79,0,0,304,0,304,G
6-NA,80,0,0,0,305,305,C
6-NA,81,3,0,0,300,303,C
6-NA,82,306,0,0,0,306,A
6-NA,83,0,304,0,1,305,T
6-NA,84,0,0,0,338,338,C
6-NA,85,0,339,0,0,339,T
6-NA,86,0,343,0,0,343,T
6-NA,87,0,5,352,0,357,G
6-NA,88,356,0,1,0,357,A
6-NA,89,0,357,0,3,360,T
6-NA,90,363,0,0,0,363,A
6-NA,91,361,0,0,0,361,A
6-NA,92,0,0,0,417,417,C
6-NA,93,0,408,0,7,415,T
6-NA,94,418,0,0,0,418,A
6-NA,95,0,0,0,433,433,C
6-NA,96,0,433,0,1,434,T
6-NA,97,0,1,445,0,446,G
6-NA,98,0,447,0,0,447,T
6-NA,99,447,0,0,0,447,A
6-NA,100,452,0,1,0,453,A
6-NA,101,0,0,0,445,445,C
6-NA,102,438,0,2,0,440,A
6-NA,103,0,440,0,0,440,T
6-NA,104,0,429,0,1,430,T
6-NA,105,0,3,429,0,432,G
6-NA,106,0,1,0,432,433,C
6-NA,107,439,0,0,0,439,A
6-NA,108,0,438,0,2,440,T
6-NA,109,0,440,0,0,440,T
6-NA,110,0,441,0,0,441,T
6-NA,111,2,0,0,436,438,C
6-NA,112,439,0,0,0,439,A
6-NA,113,444,0,0,0,444,A
6-NA,114,0,1,443,0,444,G
6-NA,115,0,0,0,445,445,C
6-NA,116,444,0,0,0,444,A
6-NA,117,461,0,0,0,461,A
6-NA,118,0,469,0,0,469,T
6-NA,119,469,0,0,0,469,A
6-NA,120,0,468,0,2,470,T
6-NA,121,4,6,472,0,482,G
6-NA,122,479,0,0,0,479,A
6-NA,123,484,0,0,0,484,A
6-NA,124,0,488,0,0,488,T
6-NA,125,0,486,0,0,486,T
6-NA,126,4,0,0,479,483,C
6-NA,127,485,0,1,0,486,A
6-NA,128,484,0,1,0,485,A
6-NA,129,0,0,0,486,486,C
6-NA,130,0,482,0,2,484,T
6-NA,131,1,0,0,482,483,C
6-NA,132,4,0,0,480,484,C
6-NA,133,1,0,0,496,497,C
6-NA,134,0,0,0,498,498,C
6-NA,135,0,1,0,500,501,C
6-NA,136,2,0,0,502,504,C
6-NA,137,2,0,0,504,506,C
6-NA,138,509,0,0,0,509,A
6-NA,139,509,0,0,0,509,A
6-NA,140,510,0,0,0,510,A
6-NA,141,0,0,0,521,521,C
6-NA,142,510,0,0,0,510,A
6-NA,143,518,0,2,0,520,A
6-NA,144,0,1,0,521,522,C
6-NA,145,3,0,1,515,519,C
6-NA,146,533,0,0,0,533,A
6-NA,147,530,0,1,0,531,A
6-NA,148,0,0,542,0,542,G
6-NA,149,0,540,0,0,540,T
6-NA,150,1,5,535,0,541,G
6-NA,151,547,0,0,0,547,A
6-NA,152,0,548,0,0,548,T
6-NA,153,0,2,546,0,548,G
6-NA,154,0,0,0,548,548,C
6-NA,155,1,538,0,7,546,T
6-NA,156,0,1,575,0,576,G
6-NA,157,0,570,0,2,572,T
6-NA,158,0,0,570,0,570,G
6-NA,159,0,571,0,0,571,T
6-NA,160,0,4,561,0,565,G
6-NA,161,563,0,4,0,567,A
6-NA,162,572,0,1,0,573,A
6-NA,163,0,0,0,574,574,C
6-NA,164,4,0,0,568,572,C
6-NA,165,562,0,0,0,562,A
6-NA,166,565,0,0,0,565,A
6-NA,167,0,1,0,594,595,C
6-NA,168,591,0,0,0,591,A
6-NA,169,596,0,0,0,596,A
6-NA,170,0,590,0,7,597,T
6-NA,171,598,0,0,0,598,A
6-NA,172,598,0,0,0,598,A
6-NA,173,0,601,0,0,601,T
6-NA,174,597,0,0,0,597,A
6-NA,175,0,4,600,0,604,G
6-NA,176,589,1,1,0,591,A
6-NA,177,590,0,2,0,592,A
6-NA,178,589,0,1,0,590,A
6-NA,179,0,1,593,0,594,G
6-NA,180,607,0,0,0,607,A
6-NA,181,609,0,0,0,609,A
6-NA,182,631,0,3,0,634,A
6-NA,183,0,0,0,646,646,C
6-NA,184,646,0,0,0,646,A
6-NA,185,0,653,0,0,653,T
6-NA,186,661,0,2,0,663,A
6-NA,187,667,0,1,0,668,A
6-NA,188,0,0,0,687,687,C
6-NA,189,682,0,0,0,682,A
6-NA,190,0,1,715,0,716,G
6-NA,191,704,0,0,0,704,A
6-NA,192,0,3,707,0,710,G
6-NA,193,713,0,0,0,713,A
6-NA,194,0,740,0,0,740,T
6-NA,195,738,0,0,0,738,A
6-NA,196,0,0,756,0,756,G
6-NA,197,1,746,0,0,747,T
6-NA,198,0,2,770,0,772,G
6-NA,199,0,760,0,7,767,T
6-NA,200,769,0,0,0,769,A
6-NA,201,0,765,0,0,765,T
6-NA,202,0,0,0,768,768,C
6-NA,203,0,754,0,1,755,T
6-NA,204,0,19,756,0,775,G
6-NA,205,775,0,1,0,776,A
6-NA,206,0,1,0,772,773,C
6-NA,207,4,0,0,773,777,C
6-NA,208,770,0,0,0,770,A
6-NA,209,770,0,2,0,772,A
6-NA,210,0,1,0,789,790,C
6-NA,211,785,0,1,0,786,A
6-NA,212,0,0,0,808,808,C
6-NA,213,5,0,0,794,799,C
6-NA,214,809,1,0,0,810,A
6-NA,215,0,1,0,841,842,C
6-NA,216,3,0,0,837,840,C
6-NA,217,839,1,2,0,842,A
6-NA,218,1,838,0,1,840,T
6-NA,219,834,0,0,0,834,A
6-NA,220,0,2,836,0,838,G
6-NA,221,825,0,1,0,826,A
6-NA,222,0,2,837,0,839,G
6-NA,223,833,0,0,0,833,A
6-NA,224,815,0,2,0,817,A
6-NA,225,0,3,815,0,818,G
6-NA,226,0,5,819,0,824,G
6-NA,227,824,0,1,0,825,A
6-NA,228,830,1,0,0,831,A
6-NA,229,831,0,1,0,832,A
6-NA,230,0,828,0,0,828,T
6-NA,231,825,0,0,0,825,A
6-NA,232,0,821,0,0,821,T
6-NA,233,0,0,819,0,819,G
6-NA,234,0,0,0,828,828,C
6-NA,235,5,1,0,821,827,C
6-NA,236,3,0,1,818,822,C
6-NA,237,3,0,0,823,826,C
6-NA,238,827,0,0,0,827,A
6-NA,239,840,0,0,0,840,A
6-NA,240,841,0,1,0,842,A
6-NA,241,1,0,0,840,841,C
6-NA,242,0,840,0,0,840,T
6-NA,243,840,0,0,0,840,A
6-NA,244,0,0,842,0,842,G
6-NA,245,0,1,0,843,844,C
6-NA,246,843,0,1,0,844,A
6-NA,247,0,2,850,0,852,G
6-NA,248,845,0,0,0,845,A
6-NA,249,867,0,1,0,868,A
6-NA,250,0,867,0,0,867,T
6-NA,251,868,0,0,0,868,A
6-NA,252,0,1,0,868,869,C
6-NA,253,861,0,1,0,862,A
6-NA,254,0,3,867,0,870,G
6-NA,255,861,0,1,0,862,A
6-NA,256,850,0,0,0,850,A
6-NA,257,849,0,3,0,852,A
6-NA,258,0,833,0,0,833,T
6-NA,259,0,829,0,1,830,T
6-NA,260,0,5,829,0,834,G
6-NA,261,0,1,834,0,835,G
6-NA,262,0,835,0,5,840,T
6-NA,263,7,0,0,828,835,C
6-NA,264,833,0,0,0,833,A
6-NA,265,833,0,0,0,833,A
6-NA,266,831,1,0,0,832,A
6-NA,267,0,0,840,0,840,G
6-NA,268,0,0,0,841,841,C
6-NA,269,1,0,0,830,831,C
6-NA,270,0,1,833,0,834,G
6-NA,271,0,0,0,840,840,C
6-NA,272,840,0,1,0,841,A
6-NA,273,852,0,0,0,852,A
6-NA,274,0,850,0,0,850,T
6-NA,275,1,0,858,0,859,G
6-NA,276,0,859,0,1,860,T
6-NA,277,0,15,845,0,860,G
6-NA,278,871,1,3,0,875,A
6-NA,279,0,0,0,888,888,C
6-NA,280,899,0,0,0,899,A
6-NA,281,0,909,0,0,909,T
6-NA,282,0,903,0,1,904,T
6-NA,283,904,0,0,1,905,A
6-NA,284,0,0,0,903,903,C
6-NA,285,896,0,0,0,896,A
6-NA,286,0,4,890,0,894,G
6-NA,287,0,4,882,0,886,G
6-NA,288,0,2,851,0,853,G
6-NA,289,0,879,0,1,880,T
6-NA,290,0,880,0,0,880,T
6-NA,291,0,881,0,0,881,T
6-NA,292,0,0,884,0,884,G
6-NA,293,0,0,0,882,882,C
6-NA,294,882,0,2,0,884,A
6-NA,295,1,0,1,887,889,C
6-NA,296,1,0,0,879,880,C
6-NA,297,1,874,0,1,876,T
6-NA,298,0,876,0,1,877,T
6-NA,299,1,880,0,0,881,T
6-NA,300,0,878,0,0,878,T
6-NA,301,0,896,0,0,896,T
6-NA,302,2,0,0,895,897,C
6-NA,303,0,897,0,0,897,T
6-NA,304,891,0,0,0,891,A
6-NA,305,884,0,1,0,885,A
6-NA,306,0,1,892,0,893,G
6-NA,307,1,6,886,0,893,G
6-NA,308,888,0,1,0,889,A
6-NA,309,0,1,1,892,894,C
6-NA,310,884,0,0,0,884,A
6-NA,311,881,0,2,0,883,A
6-NA,312,0,882,0,1,883,T
6-NA,313,0,885,0,0,885,T
6-NA,314,5,0,0,888,893,C
6-NA,315,1,7,884,0,892,G
6-NA,316,892,0,0,0,892,A
6-NA,317,0,893,0,0,893,T
6-NA,318,0,887,0,0,887,T
6-NA,319,888,0,1,0,889,A
6-NA,320,0,0,889,0,889,G
6-NA,321,0,1,890,0,891,G
6-NA,322,1,0,0,896,897,C
6-NA,323,0,885,0,1,886,T
6-NA,324,0,882,0,0,882,T
6-NA,325,0,885,0,1,886,T
6-NA,326,2,0,0,886,888,C
6-NA,327,1,0,0,891,892,C
6-NA,328,1,0,890,0,891,G
6-NA,329,0,0,0,896,896,C
6-NA,330,0,885,0,1,886,T
6-NA,331,0,1,907,0,908,G
6-NA,332,0,0,910,0,910,G
6-NA,333,1,905,0,0,906,T
6-NA,334,0,2,907,0,909,G
6-NA,335,0,4,901,0,905,G
6-NA,336,0,6,895,0,901,G
6-NA,337,0,2,901,0,903,G
6-NA,338,900,0,2,0,902,A
6-NA,339,0,0,0,907,907,C
6-NA,340,889,0,1,0,890,A
6-NA,341,0,885,0,2,887,T
6-NA,342,1,0,0,890,891,C
6-NA,343,1,884,0,0,885,T
6-NA,344,0,2,883,0,885,G
6-NA,345,0,3,881,0,884,G
6-NA,346,2,0,881,0,883,G
6-NA,347,0,886,0,0,886,T
6-NA,348,0,3,853,0,856,G
6-NA,349,852,0,0,0,852,A
6-NA,350,1,0,0,877,878,C
6-NA,351,869,0,2,0,871,A
6-NA,352,944,0,3,0,947,A
6-NA,353,1,6,971,0,978,G
6-NA,354,965,0,4,0,969,A
6-NA,355,0,6,1020,0,1026,G
6-NA,356,1072,0,2,0,1074,A
6-NA,357,1184,0,1,0,1185,A
6-NA,358,0,0,0,1586,1586,C
6-NA,359,3,0,1,1731,1735,C
6-NA,360,0,1729,0,3,1732,T
6-NA,361,0,1743,0,2,1745,T
6-NA,362,1752,1,1,0,1754,A
6-NA,363,0,1764,0,2,1766,T
6-NA,364,1,1,1912,0,1914,G
6-NA,365,0,1931,0,3,1934,T
6-NA,366,2,0,2002,0,2004,G
6-NA,367,0,1983,0,5,1988,T
6-NA,368,22,1,0,1964,1987,C
6-NA,369,1995,1,0,24,2020,A
6-NA,370,0,2026,0,5,2031,T
6-NA,371,2,2,2026,0,2030,G
6-NA,372,1,3,1,2025,2030,C
6-NA,373,1,11,2018,0,2030,G
6-NA,374,2319,0,0,0,2319,A
6-NA,375,0,2313,0,3,2316,T
6-NA,376,9,0,0,2372,2381,C
6-NA,377,8,0,0,2378,2386,C
6-NA,378,0,2443,1,7,2451,T
6-NA,379,0,20,2464,1,2485,G
6-NA,380,2465,1,23,0,2489,A
6-NA,381,1,0,1,2493,2495,C
6-NA,382,2490,1,1,0,2492,A
6-NA,383,2462,0,2,0,2464,A
6-NA,384,0,0,2620,0,2620,G
6-NA,385,0,2615,0,2,2617,T
6-NA,386,0,3,2673,0,2676,G
6-NA,387,0,2666,0,2,2668,T
6-NA,388,0,2664,0,5,2669,T
6-NA,389,2674,0,2,0,2676,A
6-NA,390,0,2672,0,4,2676,T
6-NA,391,18,0,0,2710,2728,C
6-NA,392,2723,0,1,1,2725,A
6-NA,393,2722,0,5,0,2727,A
6-NA,394,0,2722,0,3,2725,T
6-NA,395,0,2704,0,6,2710,T
6-NA,396,0,2706,1,5,2712,T
6-NA,397,2,1,2739,0,2742,G
6-NA,398,2,0,0,2927,2929,C
6-NA,399,11,1,0,2920,2932,C
6-NA,400,9,0,0,2926,2935,C
6-NA,401,0,2931,0,1,2932,T
6-NA,402,1,2928,0,4,2933,T
6-NA,403,0,18,2968,0,2986,G
6-NA,404,1,16,2981,0,2998,G
6-NA,405,3008,1,6,0,3015,A
6-NA,406,1,5,0,3008,3014,C
6-NA,407,2947,1,5,1,2954,A
6-NA,408,1,11,3045,0,3057,G
6-NA,409,17,12,3028,0,3057,G
6-NA,410,1,34,3150,0,3185,G
6-NA,411,3181,0,6,0,3187,A
6-NA,412,3171,0,11,0,3182,A
6-NA,413,2,4,0,3189,3195,C
6-NA,414,3175,0,4,2,3181,A
6-NA,415,3544,0,6,0,3550,A
6-NA,416,2,0,0,3567,3569,C
6-NA,417,3546,0,0,0,3546,A
6-NA,418,17,0,0,3552,3569,C
6-NA,419,0,3510,0,2,3512,T
6-NA,420,3556,0,0,0,3556,A
6-NA,421,3554,0,2,0,3556,A
6-NA,422,3579,0,3,1,3583,A
6-NA,423,0,14,0,3584,3598,C
6-NA,424,3424,1,7,0,3432,A
6-NA,425,3491,0,3,0,3494,A
6-NA,426,1,0,0,3510,3511,C
6-NA,427,2,0,3505,0,3507,G
6-NA,428,1,3504,0,2,3507,T
6-NA,429,3457,0,4,0,3461,A
6-NA,430,2,2,0,3524,3528,C
6-NA,431,3529,1,2,0,3532,A
6-NA,432,0,3554,0,3,3557,T
6-NA,433,0,3557,0,5,3562,T
6-NA,434,17,3,1,3689,3710,C
6-NA,435,3838,0,1,0,3839,A
6-NA,436,3868,1,2,2,3873,A
6-NA,437,3872,0,1,1,3874,A
6-NA,438,0,3874,0,1,3875,T
6-NA,439,3832,0,2,0,3834,A
6-NA,440,3991,0,4,1,3996,A
6-NA,441,2,12,0,4005,4019,C
6-NA,442,4019,0,4,1,4024,A
6-NA,443,2,2,0,4077,4081,C
6-NA,444,3978,2,10,0,3990,A
6-NA,445,0,0,4747,0,4747,G
6-NA,446,0,4740,0,0,4740,T
6-NA,447,4819,0,4,1,4824,A
6-NA,448,2,4,0,4837,4843,C
6-NA,449,2,3,4832,0,4837,G
6-NA,450,0,5048,0,11,5059,T
6-NA,451,4,27,5038,0,5069,G
6-NA,452,5079,0,7,0,5086,A
6-NA,453,0,5119,0,1,5120,T
6-NA,454,4847,2,2,3,4854,A
6-NA,455,2,8,4853,1,4864,G
6-NA,456,2,20,4820,0,4842,G
6-NA,457,4849,0,8,0,4857,A
6-NA,458,1,1,0,4916,4918,C
6-NA,459,16,5,0,4844,4865,C
6-NA,460,16,1,1,4897,4915,C
6-NA,461,10,1,0,4917,4928,C
6-NA,462,2,4968,0,3,4973,T
6-NA,463,0,5054,0,1,5055,T
6-NA,464,5070,1,0,0,5071,A
6-NA,465,2,5072,0,1,5075,T
6-NA,466,20,7,0,5039,5066,C
6-NA,467,5,20,5014,0,5039,G
6-NA,468,0,37,5011,1,5049,G
6-NA,469,5032,1,11,0,5044,A
6-NA,470,0,3,0,5099,5102,C
6-NA,471,15,0,0,5065,5080,C
6-NA,472,11,0,0,5334,5345,C
6-NA,473,1,5324,0,5,5330,T
6-NA,474,5427,1,1,0,5429,A
6-NA,475,0,5416,0,7,5423,T
6-NA,476,0,5420,0,13,5433,T
6-NA,477,3,31,5407,1,5442,G
6-NA,478,5435,0,4,1,5440,A
6-NA,479,0,5405,0,4,5409,T
6-NA,480,3,40,5388,1,5432,G
6-NA,481,5261,4,12,2,5279,A
6-NA,482,5280,0,5,1,5286,A
6-NA,483,0,5285,0,0,5285,T
6-NA,484,19,41,5317,0,5377,G
6-NA,485,5456,0,8,0,5464,A
6-NA,486,1,2,5518,0,5521,G
6-NA,487,0,5497,0,6,5503,T
6-NA,488,0,5505,0,1,5506,T
6-NA,489,5512,1,3,0,5516,A
6-NA,490,0,13,5542,0,5555,G
6-NA,491,1,1,5573,0,5575,G
6-NA,492,0,5543,0,8,5551,T
6-NA,493,2,2,5556,1,5561,G
6-NA,494,1,5456,0,10,5467,T
6-NA,495,1,5447,0,5,5453,T
6-NA,496,37,2,0,5406,5445,C
6-NA,497,13,1,1,5418,5433,C
6-NA,498,12,1,0,5384,5397,C
6-NA,499,1,5561,0,22,5584,T
6-NA,500,0,5593,1,4,5598,T
6-NA,501,0,5599,0,5,5604,T
6-NA,502,22,1,0,5624,5647,C
6-NA,503,5652,0,5,0,5657,A
6-NA,504,1,5789,2,4,5796,T
6-NA,505,4,1,0,5796,5801,C
6-NA,506,1,5714,0,5,5720,T
6-NA,507,2,19,5691,0,5712,G
6-NA,508,2,24,5669,0,5695,G
6-NA,509,2,17,5686,1,5706,G
6-NA,510,4,51,5723,2,5780,G
6-NA,511,5740,1,12,0,5753,A
6-NA,512,1,1,0,5820,5822,C
6-NA,513,20,2,0,5731,5753,C
6-NA,514,5813,0,3,0,5816,A
6-NA,515,5810,1,8,1,5820,A
6-NA,516,3,2,5840,0,5845,G
6-NA,517,4,5,0,5839,5848,C
6-NA,518,5813,2,11,0,5826,A
6-NA,519,5891,0,6,1,5898,A
6-NA,520,2,2,5928,0,5932,G
6-NA,521,0,5892,0,5,5897,T
6-NA,522,2,3,6054,1,6060,G
6-NA,523,1,6020,0,2,6023,T
6-NA,524,3,5,6191,0,6199,G
6-NA,525,2,2,0,6192,6196,C
6-NA,526,6173,1,5,0,6179,A
6-NA,527,0,6251,0,10,6261,T
6-NA,528,6158,1,12,0,6171,A
6-NA,529,0,1,6378,0,6379,G
6-NA,530,4,5,0,6355,6364,C
6-NA,531,6207,1,8,0,6216,A
6-NA,532,1,6204,0,2,6207,T
6-NA,533,2,42,6017,1,6062,G
6-NA,534,3,0,6394,0,6397,G
6-NA,535,2,6393,0,15,6410,T
6-NA,536,38,1,0,6346,6385,C
6-NA,537,22,5,1,6391,6419,C
6-NA,538,6338,2,11,0,6351,A
6-NA,539,3,3,6484,0,6490,G
6-NA,540,1,0,0,6488,6489,C
6-NA,541,1,6469,1,12,6483,T
6-NA,542,41,2,0,6460,6503,C
6-NA,543,6361,0,0,1,6362,A
6-NA,544,6414,2,3,1,6420,A
6-NA,545,1,3,6432,0,6436,G
6-NA,546,0,6437,0,6,6443,T
6-NA,547,0,6421,0,8,6429,T
6-NA,548,5,2,6416,0,6423,G
6-NA,549,1,6410,0,5,6416,T
6-NA,550,76,3,0,6325,6404,C
6-NA,551,6407,0,7,0,6414,A
6-NA,552,1,3,0,6450,6454,C
6-NA,553,1,25,6398,0,6424,G
6-NA,554,6483,1,5,1,6490,A
6-NA,555,0,6495,1,4,6500,T
6-NA,556,1,24,6584,1,6610,G
6-NA,557,2,26,6605,1,6634,G
6-NA,558,6614,1,16,2,6633,A
6-NA,559,6627,0,12,1,6640,A
6-NA,560,6703,2,11,0,6716,A
6-NA,561,6725,0,9,0,6734,A
6-NA,562,6,6,6783,1,6796,G
6-NA,563,3,4,0,6770,6777,C
6-NA,564,6761,0,7,0,6768,A
6-NA,565,1,6737,0,8,6746,T
6-NA,566,3,35,6758,1,6797,G
6-NA,567,1,2,6822,0,6825,G
6-NA,568,3,1,0,6870,6874,C
6-NA,569,1,6834,0,12,6847,T
6-NA,570,2,7,6871,0,6880,G
6-NA,571,2,3,0,6846,6851,C
6-NA,572,6879,0,4,0,6883,A
6-NA,573,7,7088,0,0,7095,T
6-NA,574,3,1,7108,0,7112,G
6-NA,575,0,7122,1,6,7129,T
6-NA,576,1,7248,1,4,7254,T
6-NA,577,1,7223,1,5,7230,T
6-NA,578,1,2,7614,0,7617,G
6-NA,579,2,7594,0,11,7607,T
6-NA,580,7610,1,5,0,7616,A
6-NA,581,1,7620,0,6,7627,T
6-NA,582,7515,0,7,0,7522,A
6-NA,583,7541,1,8,0,7550,A
6-NA,584,0,9,1,7503,7513,C
6-NA,585,19,23,7396,0,7438,G
6-NA,586,0,22,7451,0,7473,G
6-NA,587,3,28,7310,1,7342,G
6-NA,588,5,26,7316,0,7347,G
6-NA,589,1,23,7338,0,7362,G
6-NA,590,7327,2,12,1,7342,A
6-NA,591,1,7360,0,11,7372,T
6-NA,592,4,46,7345,1,7396,G
6-NA,593,7417,0,11,0,7428,A
6-NA,594,0,7451,1,3,7455,T
6-NA,595,7427,1,5,1,7434,A
6-NA,596,7439,1,1,1,7442,A
6-NA,597,7479,1,4,1,7485,A
6-NA,598,7467,2,6,0,7475,A
6-NA,599,7508,0,3,1,7512,A
6-NA,600,0,7495,0,5,7500,T
6-NA,601,3,8,7500,0,7511,G
6-NA,602,6,3,0,7485,7494,C
6-NA,603,7470,0,3,1,7474,A
6-NA,604,7487,0,20,2,7509,A
6-NA,605,3,1,0,7567,7571,C
6-NA,606,1,7554,1,5,7561,T
6-NA,607,3,8,7573,1,7585,G
6-NA,608,3,1,1,7567,7572,C
6-NA,609,0,7575,0,5,7580,T
6-NA,610,7572,0,9,0,7581,A
6-NA,611,2,1,7583,0,7586,G
6-NA,612,5,0,0,7661,7666,C
6-NA,613,0,7640,0,17,7657,T
6-NA,614,0,7624,0,8,7632,T
6-NA,615,43,1,1,7659,7704,C
6-NA,616,7716,1,7,0,7724,A
6-NA,617,0,7729,1,3,7733,T
6-NA,618,0,7739,0,6,7745,T
6-NA,619,1,7745,1,6,7753,T
6-NA,620,7785,2,0,1,7788,A
6-NA,621,4,3,0,7806,7813,C
6-NA,622,7734,1,5,0,7740,A
6-NA,623,7776,3,10,0,7789,A
6-NA,624,1,7740,0,5,7746,T
6-NA,625,3,31,7730,1,7765,G
6-NA,626,0,19,7735,0,7754,G
6-NA,627,1,24,7725,0,7750,G
6-NA,628,7729,1,22,0,7752,A
6-NA,629,7623,0,15,0,7638,A
6-NA,630,1,2,7937,0,7940,G
6-NA,631,0,2,1,8472,8475,C
6-NA,632,0,8479,1,14,8494,T
6-NA,633,1,8570,1,2,8574,T
6-NA,634,6,1,8625,0,8632,G
6-NA,635,0,8616,2,2,8620,T
6-NA,636,8756,1,8,0,8765,A
6-NA,637,1,20,8775,0,8796,G
6-NA,638,8729,1,15,0,8745,A
6-NA,639,0,8740,0,3,8743,T
6-NA,640,8067,1,31,0,8099,A
6-NA,641,3,1,8107,0,8111,G
6-NA,642,1,8033,0,3,8037,T
6-NA,643,6,0,7884,0,7890,G
6-NA,644,0,8225,2,9,8236,T
6-NA,645,0,8242,1,3,8246,T
6-NA,646,2,3,8397,0,8402,G
6-NA,647,1,8346,2,16,8365,T
6-NA,648,1,8365,1,10,8377,T
6-NA,649,0,8374,1,8,8383,T
6-NA,650,45,2,1,8207,8255,C
6-NA,651,8218,2,17,0,8237,A
6-NA,652,1,8204,0,3,8208,T
6-NA,653,3,44,8160,0,8207,G
6-NA,654,1,1,8615,0,8617,G
6-NA,655,1,8537,0,14,8552,T
6-NA,656,59,1,2,8491,8553,C
6-NA,657,32,9,0,8505,8546,C
6-NA,658,8572,0,5,0,8577,A
6-NA,659,8638,4,6,0,8648,A
6-NA,660,8641,0,9,0,8650,A
6-NA,661,0,35,8682,0,8717,G
6-NA,662,8674,0,10,0,8684,A
6-NA,663,8380,1,16,0,8397,A
6-NA,664,8397,0,17,0,8414,A
6-NA,665,5,8382,0,5,8392,T
6-NA,666,48,1,0,8627,8676,C
6-NA,667,25,1,1,8651,8678,C
6-NA,668,2,8629,1,19,8651,T
6-NA,669,23,3,3,8634,8663,C
6-NA,670,8620,0,8,0,8628,A
6-NA,671,31,28,8641,0,8700,G
6-NA,672,7,56,8640,0,8703,G
6-NA,673,8850,2,21,0,8873,A
6-NA,674,6,1,0,8862,8869,C
6-NA,675,15,3,0,8713,8731,C
6-NA,676,25,7,0,8700,8732,C
6-NA,677,8738,1,8,0,8747,A
6-NA,678,1,7,8768,0,8776,G
6-NA,679,2,36,8769,0,8807,G
6-NA,680,8748,3,12,0,8763,A
6-NA,681,2,4,8860,0,8866,G
6-NA,682,1,8723,0,11,8735,T
6-NA,683,71,6,1,8699,8777,C
6-NA,684,8728,4,16,0,8748,A
6-NA,685,0,51,8765,0,8816,G
6-NA,686,8776,1,11,0,8788,A
6-NA,687,8776,0,4,0,8780,A
6-NA,688,1,8736,1,7,8745,T
6-NA,689,3,11,8774,0,8788,G
6-NA,690,8,4,1,8753,8766,C
6-NA,691,7,2,8818,0,8827,G
6-NA,692,2,8764,0,20,8786,T
6-NA,693,2,8772,1,19,8794,T
6-NA,694,2,8704,2,2,8710,T
6-NA,695,3,9,8777,0,8789,G
6-NA,696,3,8801,1,10,8815,T
6-NA,697,8815,1,5,1,8822,A
6-NA,698,1,8755,0,12,8768,T
6-NA,699,51,1,0,8692,8744,C
6-NA,700,8703,1,3,0,8707,A
6-NA,701,8704,2,9,0,8715,A
6-NA,702,0,8710,1,4,8715,T
6-NA,703,9,29,8683,0,8721,G
6-NA,704,4,52,8679,1,8736,G
6-NA,705,8835,1,13,0,8849,A
6-NA,706,8850,1,15,1,8867,A
6-NA,707,1,2,0,8937,8940,C
6-NA,708,1,8955,0,13,8969,T
6-NA,709,0,8938,1,5,8944,T
6-NA,710,4,1,9227,0,9232,G
6-NA,711,3,9223,0,8,9234,T
6-NA,712,9214,2,15,0,9231,A
6-NA,713,2,1,0,9309,9312,C
6-NA,714,9067,0,9,0,9076,A
6-NA,715,2,2,9649,0,9653,G
6-NA,716,0,9552,0,3,9555,T
6-NA,717,9896,1,6,0,9903,A
6-NA,718,4,2,9956,0,9962,G
6-NA,719,2,9740,0,6,9748,T
6-NA,720,9734,0,4,0,9738,A
6-NA,721,9741,2,5,0,9748,A
6-NA,722,0,9640,0,4,9644,T
6-NA,723,2,113,9560,0,9675,G
6-NA,724,9384,1,15,0,9400,A
6-NA,725,5,3,0,9472,9480,C
6-NA,726,1,9173,0,10,9184,T
6-NA,727,6,32,9188,2,9228,G
6-NA,728,9180,10,15,1,9206,A
6-NA,729,1,9239,1,4,9245,T
6-NA,730,5,33,9212,1,9251,G
6-NA,731,2,16,9144,0,9162,G
6-NA,732,1,34,9167,0,9202,G
6-NA,733,9009,0,18,0,9027,A
6-NA,734,4,2,9022,2,9030,G
6-NA,735,3,8965,1,6,8975,T
6-NA,736,5,4,9011,0,9020,G
6-NA,737,9,8,1,9057,9075,C
6-NA,738,1,9054,0,13,9068,T
6-NA,739,2,9054,1,4,9061,T
6-NA,740,40,4,0,9026,9070,C
6-NA,741,9046,2,13,1,9062,A
6-NA,742,3,18,9088,1,9110,G
6-NA,743,3,35,9074,0,9112,G
6-NA,744,9069,2,4,0,9075,A
6-NA,745,8991,0,5,2,8998,A
6-NA,746,8916,4,6,1,8927,A
6-NA,747,8950,0,14,1,8965,A
6-NA,748,1,2,9015,0,9018,G
6-NA,749,4,7,0,9001,9012,C
6-NA,750,1,8973,0,5,8979,T
6-NA,751,3,41,8935,0,8979,G
6-NA,752,8956,2,8,3,8969,A
6-NA,753,2,9041,1,1,9045,T
6-NA,754,9079,4,6,1,9090,A
6-NA,755,5,3,2,9487,9497,C
6-NA,756,1,9418,1,5,9425,T
6-NA,757,9432,3,1,1,9437,A
6-NA,758,9426,1,7,3,9437,A
6-NA,759,9438,2,6,1,9447,A
6-NA,760,9688,2,18,2,9710,A
6-NA,761,0,9700,1,0,9701,T
6-NA,762,9675,2,5,0,9682,A
6-NA,763,3,3,0,9719,9725,C
6-NA,764,1,9246,1,12,9260,T
6-NA,765,9383,0,8,0,9391,A
6-NA,766,2,9323,1,11,9337,T
6-NA,767,2,9728,0,8,9738,T
6-NA,768,70,0,1,9713,9784,C
6-NA,769,9578,0,4,0,9582,A
6-NA,770,4,9565,0,6,9575,T
6-NA,771,3,9522,0,4,9529,T
6-NA,772,2,26,9540,1,9569,G
6-NA,773,9489,2,13,0,9504,A
6-NA,774,1,28,9437,1,9467,G
6-NA,775,6,26,9407,3,9442,G
6-NA,776,9048,1,12,1,9062,A
6-NA,777,2,28,9173,2,9205,G
6-NA,778,2,32,9166,0,9200,G
6-NA,779,5,26,9188,0,9219,G
6-NA,780,3,44,9196,1,9244,G
6-NA,781,9178,6,15,1,9200,A
6-NA,782,9220,0,9,1,9230,A
6-NA,783,9184,1,12,1,9198,A
6-NA,784,9201,1,11,1,9214,A
6-NA,785,2,9217,0,2,9221,T
6-NA,786,100,1,2,9042,9145,C
6-NA,787,87,1,9159,0,9247,G
6-NA,788,1,9190,0,6,9197,T
6-NA,789,0,9180,0,15,9195,T
6-NA,790,112,5,0,9105,9222,C
6-NA,791,9217,0,8,1,9226,A
6-NA,792,2,9811,0,7,9820,T
6-NA,793,9808,0,3,0,9811,A
6-NA,794,5,2,0,9848,9855,C
6-NA,795,6,9791,0,12,9809,T
6-NA,796,9772,4,5,0,9781,A
6-NA,797,6,4,9782,0,9792,G
6-NA,798,5,4,1,9783,9793,C
6-NA,799,9780,0,16,2,9798,A
6-NA,800,3,3,0,9817,9823,C
6-NA,801,9378,0,4,1,9383,A
6-NA,802,0,9544,0,9,9553,T
6-NA,803,0,9496,0,8,9504,T
6-NA,804,2,1,10280,0,10283,G
6-NA,805,2,10206,0,11,10219,T
6-NA,806,112,2,2,10093,10209,C
6-NA,807,10182,1,8,1,10192,A
6-NA,808,4,31,10175,0,10210,G
6-NA,809,3,31,10172,2,10208,G
6-NA,810,10165,1,9,0,10175,A
6-NA,811,9978,2,13,0,9993,A
6-NA,812,1,2,10159,0,10162,G
6-NA,813,0,9463,0,4,9467,T
6-NA,814,6,7,9504,1,9518,G
6-NA,815,12,1,0,9501,9514,C
6-NA,816,2,9488,1,12,9503,T
6-NA,817,70,2,1,9431,9504,C
6-NA,818,9478,2,5,1,9486,A
6-NA,819,9266,0,15,0,9281,A
6-NA,820,2,4,0,9380,9386,C
6-NA,821,9469,0,6,2,9477,A
6-NA,822,2,9486,0,4,9492,T
6-NA,823,5,0,9743,1,9749,G
6-NA,824,2,9761,1,13,9777,T
6-NA,825,64,8,0,9701,9773,C
6-NA,826,12,37,9712,2,9763,G
6-NA,827,9734,1,9,0,9744,A
6-NA,828,3,26,9685,0,9714,G
6-NA,829,1,50,9674,1,9726,G
6-NA,830,9600,1,11,0,9612,A
6-NA,831,4,2,9738,0,9744,G
6-NA,832,0,9447,0,6,9453,T
6-NA,833,5,5,9458,0,9468,G
6-NA,834,9,2,1,9607,9619,C
6-NA,835,2,9568,0,24,9594,T
6-NA,836,67,9,1,9590,9667,C
6-NA,837,38,2,0,9647,9687,C
6-NA,838,0,9667,0,5,9672,T
6-NA,839,82,9,9637,0,9728,G
6-NA,840,5,3,0,9633,9641,C
6-NA,841,1,9558,0,9,9568,T
6-NA,842,9626,5,36,1,9668,A
6-NA,843,1,9505,1,4,9511,T
6-NA,844,33,3,1,9563,9600,C
6-NA,845,34,1,0,9544,9579,C
6-NA,846,7,9537,0,17,9561,T
6-NA,847,30,8,0,9562,9600,C
6-NA,848,5,44,9523,0,9572,G
6-NA,849,9642,1,10,1,9654,A
6-NA,850,3,9666,0,5,9674,T
6-NA,851,9640,0,4,0,9644,A
6-NA,852,1,9636,0,7,9644,T
6-NA,853,30,16,0,9579,9625,C
6-NA,854,25,15,0,9553,9593,C
6-NA,855,2,9495,2,17,9516,T
6-NA,856,3,18,9589,0,9610,G
6-NA,857,2,5,9646,1,9654,G
6-NA,858,1,9733,1,18,9753,T
6-NA,859,80,6,9682,0,9768,G
6-NA,860,0,9684,0,23,9707,T
6-NA,861,112,4,1,9595,9712,C
6-NA,862,9691,3,10,3,9707,A
6-NA,863,2,19,9710,0,9731,G
6-NA,864,9697,3,15,0,9715,A
6-NA,865,0,9585,0,7,9592,T
6-NA,866,5,3,9594,0,9602,G
6-NA,867,2,9441,1,13,9457,T
6-NA,868,1,1,9485,3,9490,G
6-NA,869,3,9446,0,16,9465,T
6-NA,870,63,2,1,9431,9497,C
6-NA,871,3,9461,0,12,9476,T
6-NA,872,5,6,9478,0,9489,G
6-NA,873,3,5,0,9474,9482,C
6-NA,874,9453,1,15,1,9470,A
6-NA,875,2,26,9462,0,9490,G
6-NA,876,9274,1,19,0,9294,A
6-NA,877,0,48,9287,1,9336,G
6-NA,878,9304,2,17,0,9323,A
6-NA,879,4,3,1,9365,9373,C
6-NA,880,9340,3,8,1,9352,A
6-NA,881,9410,5,7,0,9422,A
6-NA,882,4,0,0,9451,9455,C
6-NA,883,5,9435,1,5,9446,T
6-NA,884,4,28,9419,3,9454,G
6-NA,885,0,30,9408,1,9439,G
6-NA,886,9375,1,8,0,9384,A
6-NA,887,9362,1,13,1,9377,A
6-NA,888,9161,0,9,1,9171,A
6-NA,889,1,22,9135,1,9159,G
6-NA,890,0,39,9015,0,9054,G
6-NA,891,8921,2,13,0,8936,A
6-NA,892,1,9194,2,5,9202,T
6-NA,893,38,7,0,9209,9254,C
6-NA,894,43,6,1,9407,9457,C
6-NA,895,9481,1,2,0,9484,A
6-NA,896,9472,3,3,2,9480,A
6-NA,897,2,9484,0,1,9487,T
6-NA,898,9144,1,8,1,9154,A
6-NA,899,0,19,9072,1,9092,G
6-NA,900,3,10,9100,0,9113,G
6-NA,901,4,1,0,9100,9105,C
6-NA,902,18,2,0,9051,9071,C
6-NA,903,27,8,0,8840,8875,C
6-NA,904,8943,2,7,0,8952,A
6-NA,905,2,9017,0,14,9033,T
6-NA,906,26,2,0,9017,9045,C
6-NA,907,10,3,9061,1,9075,G
6-NA,908,2,9037,0,1,9040,T
6-NA,909,8863,1,9,1,8874,A
6-NA,910,4,20,9069,0,9093,G
6-NA,911,9114,2,16,1,9133,A
6-NA,912,1,9137,1,4,9143,T
6-NA,913,8947,2,4,0,8953,A
6-NA,914,1,8868,0,2,8871,T
6-NA,915,8851,0,7,0,8858,A
6-NA,916,8831,1,7,2,8841,A
6-NA,917,9043,2,13,0,9058,A
6-NA,918,2,3,0,9214,9219,C
6-NA,919,8908,0,0,0,8908,A
6-NA,920,1,8888,0,2,8891,T
6-NA,921,8794,0,6,1,8801,A
6-NA,922,8806,2,8,0,8816,A
6-NA,923,8805,0,10,0,8815,A
6-NA,924,5,29,8869,1,8904,G
6-NA,925,2,47,8928,0,8977,G
6-NA,926,8681,2,5,1,8689,A
6-NA,927,4,8628,0,9,8641,T
6-NA,928,53,3,1,8597,8654,C
6-NA,929,8703,2,17,0,8722,A
6-NA,930,1,8739,0,6,8746,T
6-NA,931,8715,1,8,0,8724,A
6-NA,932,2,4,8807,0,8813,G
6-NA,933,5,4,0,8678,8687,C
6-NA,934,8494,0,1,0,8495,A
6-NA,935,2,8227,0,7,8236,T
6-NA,936,2,8266,0,3,8271,T
6-NA,937,2,0,8421,0,8423,G
6-NA,938,1,8427,1,10,8439,T
6-NA,939,3,8451,0,14,8468,T
6-NA,940,0,8451,0,7,8458,T
6-NA,941,31,4,0,8365,8400,C
6-NA,942,14,3,4,8379,8400,C
6-NA,943,8424,1,7,0,8432,A
6-NA,944,1,1,8501,0,8503,G
6-NA,945,1,8474,0,13,8488,T
6-NA,946,0,8353,0,1,8354,T
6-NA,947,8345,1,1,1,8348,A
6-NA,948,2,8259,1,8,8270,T
6-NA,949,1,8097,1,13,8112,T
6-NA,950,2,8185,0,4,8191,T
6-NA,951,4,2,8240,0,8246,G
6-NA,952,2,8245,0,7,8254,T
6-NA,953,1,0,8431,0,8432,G
6-NA,954,5,8398,0,8,8411,T
6-NA,955,2,8355,3,12,8372,T
6-NA,956,80,1,1,8289,8371,C
6-NA,957,8327,2,8,0,8337,A
6-NA,958,7,31,8346,2,8386,G
6-NA,959,10,41,8331,1,8383,G
6-NA,960,8344,1,6,0,8351,A
6-NA,961,4,3,1,8358,8366,C
6-NA,962,0,8210,1,9,8220,T
6-NA,963,1,8242,0,4,8247,T
6-NA,964,3,1,8528,0,8532,G
6-NA,965,3,8528,0,5,8536,T
6-NA,966,2,8509,1,9,8521,T
6-NA,967,4,13,8454,0,8471,G
6-NA,968,3,37,8431,1,8472,G
6-NA,969,8445,2,23,1,8471,A
6-NA,970,2,58,8418,1,8479,G
6-NA,971,8430,1,21,2,8454,A
6-NA,972,1,6,0,8500,8507,C
6-NA,973,8183,2,22,0,8207,A
6-NA,974,3,7,0,8252,8262,C
6-NA,975,8238,4,9,25,8276,A
6-NA,976,4,2,1,8271,8278,C
6-NA,977,22,2,0,8205,8229,C
6-NA,978,23,3,0,8208,8234,C
6-NA,979,8188,2,11,0,8201,A
6-NA,980,2,28,8218,1,8249,G
6-NA,981,8216,1,9,0,8226,A
6-NA,982,8282,0,3,1,8286,A
6-NA,983,8217,0,1,1,8219,A
6-NA,984,8213,3,7,1,8224,A
6-NA,985,8179,0,7,1,8187,A
6-NA,986,8181,1,10,4,8196,A
6-NA,987,1,3,0,8194,8198,C
6-NA,988,1,89,8092,1,8183,G
6-NA,989,8142,2,12,0,8156,A
6-NA,990,1,2,0,8153,8156,C
6-NA,991,8095,1,12,0,8108,A
6-NA,992,1,5,8160,0,8166,G
6-NA,993,3,4,0,8350,8357,C
6-NA,994,0,8307,0,15,8322,T
6-NA,995,37,1,0,8312,8350,C
6-NA,996,35,3,0,8321,8359,C
6-NA,997,8341,1,15,2,8359,A
6-NA,998,2,4,8440,0,8446,G
6-NA,999,3,5,0,8446,8454,C
6-NA,1000,8404,1,5,1,8411,A
6-NA,1001,0,3,8408,0,8411,G
6-NA,1002,3,8051,0,3,8057,T
6-NA,1003,8039,2,5,0,8046,A
6-NA,1004,0,4,8072,0,8076,G
6-NA,1005,4,6,1,8076,8087,C
6-NA,1006,26,5,0,8067,8098,C
6-NA,1007,7975,0,10,0,7985,A
6-NA,1008,2,7975,0,7,7984,T
6-NA,1009,1,7991,0,2,7994,T
6-NA,1010,0,0,8178,0,8178,G
6-NA,1011,2,8105,0,10,8117,T
6-NA,1012,1,8088,3,3,8095,T
6-NA,1013,5,8070,0,2,8077,T
6-NA,1014,1,37,7954,0,7992,G
6-NA,1015,2,29,8041,0,8072,G
6-NA,1016,8030,3,4,1,8038,A
6-NA,1017,2,8091,0,23,8116,T
6-NA,1018,41,1,0,8075,8117,C
6-NA,1019,31,2,0,7962,7995,C
6-NA,1020,5,7979,0,5,7989,T
6-NA,1021,8005,0,10,0,8015,A
6-NA,1022,8030,1,9,2,8042,A
6-NA,1023,1,2,0,8168,8171,C
6-NA,1024,8000,0,3,1,8004,A
6-NA,1025,8050,1,0,0,8051,A
6-NA,1026,1,7977,0,5,7983,T
6-NA,1027,1,21,7960,0,7982,G
6-NA,1028,7845,2,13,0,7860,A
6-NA,1029,4,20,7538,0,7562,G
6-NA,1030,2,13,7718,0,7733,G
6-NA,1031,7722,1,6,0,7729,A
6-NA,1032,7733,1,14,1,7749,A
6-NA,1033,2,22,7756,0,7780,G
6-NA,1034,3,2,7817,0,7822,G
6-NA,1035,1,7728,0,5,7734,T
6-NA,1036,0,22,7721,0,7743,G
6-NA,1037,0,2,7906,0,7908,G
6-NA,1038,2,7818,0,9,7829,T
6-NA,1039,91,5,1,7712,7809,C
6-NA,1040,7802,1,4,0,7807,A
6-NA,1041,0,7751,0,4,7755,T
6-NA,1042,1,29,7689,0,7719,G
6-NA,1043,21,21,7620,0,7662,G
6-NA,1044,2,25,7308,0,7335,G
6-NA,1045,3,3,7679,0,7685,G
6-NA,1046,0,7684,1,6,7691,T
6-NA,1047,2,31,7664,2,7699,G
6-NA,1048,7688,0,4,1,7693,A
6-NA,1049,7685,0,2,0,7687,A
6-NA,1050,7703,0,20,1,7724,A
6-NA,1051,5,16,7726,0,7747,G
6-NA,1052,3,6,7698,1,7708,G
6-NA,1053,2,3,0,7670,7675,C
6-NA,1054,0,7452,1,8,7461,T
6-NA,1055,7,25,7436,1,7469,G
6-NA,1056,2,15,7458,3,7478,G
6-NA,1057,0,3,7540,0,7543,G
6-NA,1058,4,0,0,7522,7526,C
6-NA,1059,18,1,0,7499,7518,C
6-NA,1060,3,7406,3,22,7434,T
6-NA,1061,2,7424,1,5,7432,T
6-NA,1062,1,7442,1,2,7446,T
6-NA,1063,0,11,7455,0,7466,G
6-NA,1064,7445,0,6,2,7453,A
6-NA,1065,3,7392,2,2,7399,T
6-NA,1066,0,20,7251,1,7272,G
6-NA,1067,7194,2,7,1,7204,A
6-NA,1068,0,7225,0,4,7229,T
6-NA,1069,3,14,7226,1,7244,G
6-NA,1070,2,29,7300,1,7332,G
6-NA,1071,7311,1,10,1,7323,A
6-NA,1072,7258,0,36,0,7294,A
6-NA,1073,7302,0,1,0,7303,A
6-NA,1074,3,7297,1,6,7307,T
6-NA,1075,3,43,7278,0,7324,G
6-NA,1076,7298,0,16,0,7314,A
6-NA,1077,0,5,0,7266,7271,C
6-NA,1078,1,3,7308,0,7312,G
6-NA,1079,0,7110,2,9,7121,T
6-NA,1080,3,3,7160,0,7166,G
6-NA,1081,4,7142,0,7,7153,T
6-NA,1082,8,26,7139,0,7173,G
6-NA,1083,1,13,7182,0,7196,G
6-NA,1084,7137,2,1,0,7140,A
6-NA,1085,0,7136,1,4,7141,T
6-NA,1086,4,34,7082,0,7120,G
6-NA,1087,1,12,7076,0,7089,G
6-NA,1088,2,21,7107,0,7130,G
6-NA,1089,7073,2,14,0,7089,A
6-NA,1090,7062,0,12,3,7077,A
6-NA,1091,1,50,7027,1,7079,G
6-NA,1092,6982,1,11,1,6995,A
6-NA,1093,6997,0,6,0,7003,A
6-NA,1094,1,8,0,6959,6968,C
6-NA,1095,4,49,6874,1,6928,G
6-NA,1096,6903,0,7,2,6912,A
6-NA,1097,1,6795,0,1,6797,T
6-NA,1098,49,3,0,6769,6821,C
6-NA,1099,6786,0,7,0,6793,A
6-NA,1100,1,4,6810,0,6815,G
6-NA,1101,2,7,0,6773,6782,C
6-NA,1102,4,45,6741,2,6792,G
6-NA,1103,6762,4,11,1,6778,A
6-NA,1104,0,14,6771,0,6785,G
6-NA,1105,6760,0,5,1,6766,A
6-NA,1106,6766,0,5,0,6771,A
6-NA,1107,1,2,6797,0,6800,G
6-NA,1108,1,6742,0,7,6750,T
6-NA,1109,68,2,0,6636,6706,C
6-NA,1110,6672,0,8,0,6680,A
6-NA,1111,2,7,1,6841,6851,C
6-NA,1112,4,5,6853,0,6862,G
6-NA,1113,4,1,0,6852,6857,C
6-NA,1114,0,6803,0,6,6809,T
6-NA,1115,0,6809,0,4,6813,T
6-NA,1116,6701,2,7,0,6710,A
6-NA,1117,6,20,6845,0,6871,G
6-NA,1118,1,18,6848,1,6868,G
6-NA,1119,4,6,6993,0,7003,G
6-NA,1120,1,6578,0,8,6587,T
6-NA,1121,6570,1,4,0,6575,A
6-NA,1122,0,6553,1,4,6558,T
6-NA,1123,3,36,6510,1,6550,G
6-NA,1124,6517,0,14,0,6531,A
6-NA,1125,6512,1,7,0,6520,A
6-NA,1126,6205,2,14,1,6222,A
6-NA,1127,4,0,0,6199,6203,C
6-NA,1128,33,0,0,5999,6032,C
6-NA,1129,1,5919,1,7,5928,T
6-NA,1130,0,5922,0,7,5929,T
6-NA,1131,18,2,1,5914,5935,C
6-NA,1132,5921,1,5,0,5927,A
6-NA,1133,5930,0,6,1,5937,A
6-NA,1134,5930,2,4,0,5936,A
6-NA,1135,0,0,5984,0,5984,G
6-NA,1136,2,5848,1,8,5859,T
6-NA,1137,102,2,0,5736,5840,C
6-NA,1138,5893,3,4,0,5900,A
6-NA,1139,0,5893,1,9,5903,T
6-NA,1140,3,5895,0,5,5903,T
6-NA,1141,3,15,5898,1,5917,G
6-NA,1142,5887,0,5,0,5892,A
6-NA,1143,5895,1,13,1,5910,A
6-NA,1144,2,19,5894,0,5915,G
6-NA,1145,3,2,5908,0,5913,G
6-NA,1146,1,0,1,5877,5879,C
6-NA,1147,0,5709,1,10,5720,T
6-NA,1148,1,18,5797,0,5816,G
6-NA,1149,1,1,5959,0,5961,G
6-NA,1150,1,5946,0,8,5955,T
6-NA,1151,50,1,0,5901,5952,C
6-NA,1152,0,5845,0,11,5856,T
6-NA,1153,5879,2,0,0,5881,A
6-NA,1154,5893,0,4,0,5897,A
6-NA,1155,1,1,0,5936,5938,C
6-NA,1156,24,1,0,5916,5941,C
6-NA,1157,19,1,0,5799,5819,C
6-NA,1158,1,5360,0,5,5366,T
6-NA,1159,5377,0,1,0,5378,A
6-NA,1160,5367,0,4,2,5373,A
6-NA,1161,1,1,5428,0,5430,G
6-NA,1162,0,5361,1,15,5377,T
6-NA,1163,49,3,1,5308,5361,C
6-NA,1164,36,3,1,5205,5245,C
6-NA,1165,5225,1,4,0,5230,A
6-NA,1166,5224,1,4,0,5229,A
6-NA,1167,5238,0,0,0,5238,A
6-NA,1168,1,5236,0,2,5239,T
6-NA,1169,1,5215,0,1,5217,T
6-NA,1170,4,1,5166,1,5172,G
6-NA,1171,5,2,1,5120,5128,C
6-NA,1172,5104,1,6,1,5112,A
6-NA,1173,1,15,5125,0,5141,G
6-NA,1174,5116,1,1,0,5118,A
6-NA,1175,0,5211,0,1,5212,T
6-NA,1176,5204,0,0,0,5204,A
6-NA,1177,5190,0,1,0,5191,A
6-NA,1178,5185,1,8,0,5194,A
6-NA,1179,1,5161,2,1,5165,T
6-NA,1180,5132,0,4,1,5137,A
6-NA,1181,2,24,5114,0,5140,G
6-NA,1182,2,4,5094,0,5100,G
6-NA,1183,4,1,1,5072,5078,C
6-NA,1184,4860,1,2,0,4863,A
6-NA,1185,4887,0,8,1,4896,A
6-NA,1186,0,2,4934,0,4936,G
6-NA,1187,2,4900,1,20,4923,T
6-NA,1188,88,1,0,4837,4926,C
6-NA,1189,4932,1,5,2,4940,A
6-NA,1190,1,4932,1,3,4937,T
6-NA,1191,4938,0,6,0,4944,A
6-NA,1192,1,1,4957,0,4959,G
6-NA,1193,0,4941,1,3,4945,T
6-NA,1194,1,4707,0,10,4718,T
6-NA,1195,3,31,4547,1,4582,G
6-NA,1196,4543,1,8,0,4552,A
6-NA,1197,0,0,0,4546,4546,C
6-NA,1198,4431,0,5,0,4436,A
6-NA,1199,0,13,4459,0,4472,G
6-NA,1200,4387,0,11,0,4398,A
6-NA,1201,1,7,4516,0,4524,G
6-NA,1202,2,3,4530,0,4535,G
6-NA,1203,1,4499,1,4,4505,T
6-NA,1204,4481,0,3,0,4484,A
6-NA,1205,4477,2,5,0,4484,A
6-NA,1206,0,4490,0,0,4490,T
6-NA,1207,4453,1,2,0,4456,A
6-NA,1208,0,19,4292,0,4311,G
6-NA,1209,1,1,4152,0,4154,G
6-NA,1210,1,3537,0,5,3543,T
6-NA,1211,23,1,1,3477,3502,C
6-NA,1212,11,2,1,3434,3448,C
6-NA,1213,6,4,3432,1,3443,G
6-NA,1214,0,2,3455,0,3457,G
6-NA,1215,1,3439,0,3,3443,T
6-NA,1216,1,3433,0,1,3435,T
6-NA,1217,3362,1,0,0,3363,A
6-NA,1218,0,3272,0,0,3272,T
6-NA,1219,0,3266,0,0,3266,T
6-NA,1220,17,0,1,3252,3270,C
6-NA,1221,1,3016,0,2,3019,T
6-NA,1222,4,8,3005,0,3017,G
6-NA,1223,3,0,3022,0,3025,G
6-NA,1224,0,3009,0,2,3011,T
6-NA,1225,3008,0,3,0,3011,A
6-NA,1226,0,2953,0,7,2960,T
6-NA,1227,0,2950,0,5,2955,T
6-NA,1228,0,2952,0,3,2955,T
6-NA,1229,2,2967,0,3,2972,T
6-NA,1230,24,1,0,2956,2981,C
6-NA,1231,1,2924,0,4,2929,T
6-NA,1232,17,0,0,2937,2954,C
6-NA,1233,0,2929,0,2,2931,T
6-NA,1234,0,0,3007,0,3007,G
6-NA,1235,0,2998,0,2,3000,T
6-NA,1236,0,2957,0,21,2978,T
6-NA,1237,1,8,2978,0,2987,G
6-NA,1238,2958,0,4,0,2962,A
6-NA,1239,2954,4,3,0,2961,A
6-NA,1240,0,14,2988,1,3003,G
6-NA,1241,0,4,2983,0,2987,G
6-NA,1242,1,4,0,2983,2988,C
6-NA,1243,2931,0,3,0,2934,A
6-NA,1244,2929,1,3,0,2933,A
6-NA,1245,2936,0,2,0,2938,A
6-NA,1246,2941,0,11,0,2952,A
6-NA,1247,1,0,2951,0,2952,G
6-NA,1248,1,0,1,2952,2954,C
6-NA,1249,0,2890,0,4,2894,T
6-NA,1250,3,2,2929,0,2934,G
6-NA,1251,2,2,0,2916,2920,C
6-NA,1252,2936,0,1,0,2937,A
6-NA,1253,0,2928,0,4,2932,T
6-NA,1254,21,0,0,2900,2921,C
6-NA,1255,2924,0,1,0,2925,A
6-NA,1256,2928,1,0,0,2929,A
6-NA,1257,0,2921,0,1,2922,T
6-NA,1258,13,1,0,2905,2919,C
6-NA,1259,2,4,2876,0,2882,G
6-NA,1260,1,0,2927,0,2928,G
6-NA,1261,0,2911,0,10,2921,T
6-NA,1262,0,0,2935,0,2935,G
6-NA,1263,1,0,0,2951,2952,C
6-NA,1264,0,2918,0,11,2929,T
6-NA,1265,0,2975,0,4,2979,T
6-NA,1266,2,2972,0,4,2978,T
6-NA,1267,0,2986,0,2,2988,T
6-NA,1268,3000,0,0,0,3000,A
6-NA,1269,1,2890,0,3,2894,T
6-NA,1270,0,0,2897,0,2897,G
6-NA,1271,3,2845,0,4,2852,T
6-NA,1272,4,9,2812,0,2825,G
6-NA,1273,0,13,2840,0,2853,G
6-NA,1274,2797,0,3,0,2800,A
6-NA,1275,0,1,2832,0,2833,G
6-NA,1276,0,2811,0,3,2814,T
6-NA,1277,0,2791,0,10,2801,T
6-NA,1278,2,14,2808,0,2824,G
6-NA,1279,2817,0,2,0,2819,A
6-NA,1280,0,2816,1,2,2819,T
6-NA,1281,2804,0,1,0,2805,A
6-NA,1282,2708,0,7,0,2715,A
6-NA,1283,0,9,2730,0,2739,G
6-NA,1284,1,10,2702,0,2713,G
6-NA,1285,2,8,2687,0,2697,G
6-NA,1286,1,8,2672,0,2681,G
6-NA,1287,2633,1,3,0,2637,A
6-NA,1288,2626,1,7,0,2634,A
6-NA,1289,0,13,2642,0,2655,G
6-NA,1290,2649,0,0,0,2649,A
6-NA,1291,2644,0,0,0,2644,A
6-NA,1292,2612,1,3,1,2617,A
6-NA,1293,2561,0,16,0,2577,A
6-NA,1294,2,11,2570,0,2583,G
6-NA,1295,2533,1,5,0,2539,A
6-NA,1296,0,7,2537,0,2544,G
6-NA,1297,2,11,2530,0,2543,G
6-NA,1298,2500,0,3,0,2503,A
6-NA,1299,2501,0,2,0,2503,A
6-NA,1300,2504,0,4,0,2508,A
6-NA,1301,0,0,0,2518,2518,C
6-NA,1302,2,2504,0,2,2508,T
6-NA,1303,0,6,2510,0,2516,G
6-NA,1304,2507,0,3,0,2510,A
6-NA,1305,2502,0,5,0,2507,A
6-NA,1306,1,0,2520,0,2521,G
6-NA,1307,0,2496,0,5,2501,T
6-NA,1308,19,1,0,2512,2532,C
6-NA,1309,0,2504,0,4,2508,T
6-NA,1310,0,2488,0,1,2489,T
6-NA,1311,1,1,2492,0,2494,G
6-NA,1312,1,2469,0,1,2471,T
6-NA,1313,1,7,2458,1,2467,G
6-NA,1314,0,8,2458,0,2466,G
6-NA,1315,2440,0,4,0,2444,A
6-NA,1316,1,13,0,2454,2468,C
6-NA,1317,12,0,0,2402,2414,C
6-NA,1318,0,2405,0,4,2409,T
6-NA,1319,7,1,0,2407,2415,C
6-NA,1320,2424,0,1,0,2425,A
6-NA,1321,2422,1,2,0,2425,A
6-NA,1322,2423,0,2,0,2425,A
6-NA,1323,0,2,0,2453,2455,C
6-NA,1324,2380,0,2,0,2382,A
6-NA,1325,0,0,2427,0,2427,G
6-NA,1326,1,2390,0,0,2391,T
6-NA,1327,2387,1,3,0,2391,A
6-NA,1328,0,2389,0,1,2390,T
6-NA,1329,0,2353,0,2,2355,T
6-NA,1330,1,0,2370,0,2371,G
6-NA,1331,2,2351,0,2,2355,T
6-NA,1332,1,2249,0,3,2253,T
6-NA,1333,0,0,2257,0,2257,G
6-NA,1334,0,2104,0,2,2106,T
6-NA,1335,1,7,2110,0,2118,G
6-NA,1336,0,2101,0,6,2107,T
6-NA,1337,0,2077,0,0,2077,T
6-NA,1338,0,2078,0,0,2078,T
6-NA,1339,0,2024,0,3,2027,T
6-NA,1340,0,1,2026,0,2027,G
6-NA,1341,1,2019,0,2,2022,T
6-NA,1342,0,5,1993,0,1998,G
6-NA,1343,0,2,2002,0,2004,G
6-NA,1344,2,2,0,1978,1982,C
6-NA,1345,1963,0,4,0,1967,A
6-NA,1346,0,3,0,1984,1987,C
6-NA,1347,3,1,0,1974,1978,C
6-NA,1348,0,1977,0,1,1978,T
6-NA,1349,11,0,1,1967,1979,C
6-NA,1350,1966,0,6,0,1972,A
6-NA,1351,1,7,1981,0,1989,G
6-NA,1352,0,0,1997,0,1997,G
6-NA,1353,0,1981,0,2,1983,T
6-NA,1354,1969,1,0,0,1970,A
6-NA,1355,1,6,0,1866,1873,C
6-NA,1356,1858,0,1,0,1859,A
6-NA,1357,0,1856,0,2,1858,T
6-NA,1358,1810,0,3,1,1814,A
6-NA,1359,0,1809,0,1,1810,T
6-NA,1360,0,10,1686,0,1696,G
6-NA,1361,0,8,1689,1,1698,G
6-NA,1362,1677,0,0,0,1677,A
6-NA,1363,1652,0,2,0,1654,A
6-NA,1364,0,0,0,1631,1631,C
6-NA,1365,1397,0,0,0,1397,A
6-NA,1366,0,3,1397,0,1400,G
6-NA,1367,0,1,1391,0,1392,G
6-NA,1368,0,0,0,1400,1400,C
6-NA,1369,1,1392,0,0,1393,T
6-NA,1370,9,0,1,1333,1343,C
6-NA,1371,1331,0,2,0,1333,A
6-NA,1372,0,1331,0,1,1332,T
6-NA,1373,0,5,1333,0,1338,G
6-NA,1374,0,0,1338,0,1338,G
6-NA,1375,1,1,0,1293,1295,C
6-NA,1376,6,2,0,1281,1289,C
6-NA,1377,0,1205,1,4,1210,T
6-NA,1378,1,1,1209,0,1211,G
6-NA,1379,1205,0,5,0,1210,A
6-NA,1380,0,1206,1,0,1207,T
6-NA,1381,1,5,1180,1,1187,G
6-NA,1382,1,7,1152,0,1160,G
6-NA,1383,0,3,1087,0,1090,G
6-NA,1384,0,0,1087,0,1087,G
6-NA,1385,0,1,0,1069,1070,C
6-NA,1386,10,1,1054,0,1065,G
6-NA,1387,14,8,1032,0,1054,G
6-NA,1388,1043,0,2,0,1045,A
6-NA,1389,0,0,0,1039,1039,C
6-NA,1390,1036,0,0,0,1036,A
6-NA,1391,1,1012,0,0,1013,T
6-NA,1392,5,1,1,984,991,C
6-NA,1393,979,0,0,0,979,A
6-NA,1394,976,0,0,1,977,A
6-NA,1395,0,976,0,0,976,T
6-NA,1396,4,0,0,942,946,C
6-NA,1397,0,922,0,1,923,T
6-NA,1398,12,0,0,797,809,C
6-NA,1399,801,0,1,0,802,A
6-NA,1400,1,794,0,0,795,T
6-NA,1401,0,1,789,0,790,G
6-NA,1402,1,0,2,786,789,C
6-NA,1403,7,1,0,751,759,C
6-NA,1404,0,679,0,2,681,T
6-NA,1405,674,0,0,0,674,A
6-NA,1406,0,672,0,1,673,T
6-NA,1407,666,0,1,0,667,A
6-NA,1408,0,662,0,0,662,T
6-NA,1409,607,0,0,0,607,A
6-NA,1410,574,0,0,0,574,A
7-M,1,13,0,0,0,13,A
7-M,2,0,14,0,0,14,T
7-M,3,0,0,14,0,14,G
7-M,4,15,0,0,0,15,A
7-M,5,0,0,15,0,15,G
7-M,6,0,0,0,18,18,C
7-M,7,0,0,0,20,20,C
7-M,8,0,28,0,0,28,T
7-M,9,0,28,0,0,28,T
7-M,10,0,0,0,29,29,C
7-M,11,0,29,0,0,29,T
7-M,12,31,0,0,0,31,A
7-M,13,31,0,0,0,31,A
7-M,14,0,0,0,31,31,C
7-M,15,0,0,0,31,31,C
7-M,16,0,1,30,0,31,G
7-M,17,32,0,0,0,32,A
7-M,18,0,0,32,0,32,G
7-M,19,0,0,32,0,32,G
7-M,20,0,32,0,0,32,T
7-M,21,0,0,0,32,32,C
7-M,22,0,0,32,0,32,G
7-M,23,32,0,0,0,32,A
7-M,24,32,0,0,0,32,A
7-M,25,31,0,0,0,31,A
7-M,26,0,0,0,32,32,C
7-M,27,0,0,32,0,32,G
7-M,28,0,33,0,0,33,T
7-M,29,33,0,0,0,33,A
7-M,30,0,33,0,0,33,T
7-M,31,0,0,34,0,34,G
7-M,32,0,34,0,0,34,T
7-M,33,0,39,0,0,39,T
7-M,34,0,0,0,40,40,C
7-M,35,0,40,0,0,40,T
7-M,36,0,0,0,45,45,C
7-M,37,0,45,0,0,45,T
7-M,38,0,0,0,48,48,C
7-M,39,0,48,0,0,48,T
7-M,40,50,0,0,0,50,A
7-M,41,0,50,0,0,50,T
7-M,42,0,0,0,51,51,C
7-M,43,0,0,50,0,50,G
7-M,44,0,50,0,0,50,T
7-M,45,0,49,0,0,49,T
7-M,46,0,0,0,53,53,C
7-M,47,0,0,0,55,55,C
7-M,48,56,0,0,0,56,A
7-M,49,0,56,0,0,56,T
7-M,50,0,0,0,56,56,C
7-M,51,56,0,0,0,56,A
7-M,52,0,0,57,0,57,G
7-M,53,0,0,57,0,57,G
7-M,54,0,0,0,57,57,C
7-M,55,0,0,0,57,57,C
7-M,56,0,1,0,56,57,C
7-M,57,0,0,0,64,64,C
7-M,58,1,0,0,63,64,C
7-M,59,0,64,0,0,64,T
7-M,60,0,0,0,65,65,C
7-M,61,65,0,0,0,65,A
7-M,62,65,0,0,0,65,A
7-M,63,65,0,0,0,65,A
7-M,64,0,0,67,0,67,G
7-M,65,0,0,0,67,67,C
7-M,66,0,0,0,67,67,C
7-M,67,0,0,67,0,67,G
7-M,68,67,0,0,0,67,A
7-M,69,0,0,66,0,66,G
7-M,70,68,0,0,0,68,A
7-M,71,0,68,0,0,68,T
7-M,72,0,0,0,67,67,C
7-M,73,0,1,66,0,67,G
7-M,74,0,0,0,67,67,C
7-M,75,1,0,67,0,68,G
7-M,76,1,0,0,67,68,C
7-M,77,68,0,0,0,68,A
7-M,78,0,0,69,0,69,G
7-M,79,68,0,0,0,68,A
7-M,80,0,0,78,0,78,G
7-M,81,78,0,0,0,78,A
7-M,82,0,0,0,80,80,C
7-M,83,0,80,0,0,80,T
7-M,84,0,80,0,1,81,T
7-M,85,0,2,79,0,81,G
7-M,86,81,0,0,0,81,A
7-M,87,81,0,0,0,81,A
7-M,88,0,0,81,0,81,G
7-M,89,81,0,0,0,81,A
7-M,90,0,80,0,1,81,T
7-M,91,0,0,82,0,82,G
7-M,92,0,82,0,0,82,T
7-M,93,0,0,0,82,82,C
7-M,94,0,81,0,0,81,T
7-M,95,0,81,0,0,81,T
7-M,96,0,81,0,0,81,T
7-M,97,0,0,80,0,80,G
7-M,98,0,0,0,81,81,C
7-M,99,0,80,0,0,80,T
7-M,100,0,0,80,0,80,G
7-M,101,1,0,78,0,79,G
7-M,102,80,0,0,0,80,A
7-M,103,83,0,0,0,83,A
7-M,104,82,0,0,0,82,A
7-M,105,83,0,0,0,83,A
7-M,106,83,0,0,0,83,A
7-M,107,85,0,0,0,85,A
7-M,108,1,1,0,82,84,C
7-M,109,85,0,0,0,85,A
7-M,110,0,0,0,85,85,C
7-M,111,84,0,0,0,84,A
7-M,112,0,1,83,0,84,G
7-M,113,85,0,0,0,85,A
7-M,114,0,88,0,0,88,T
7-M,115,0,0,0,88,88,C
7-M,116,0,88,0,0,88,T
7-M,117,0,87,0,0,87,T
7-M,118,0,1,86,0,87,G
7-M,119,88,0,0,0,88,A
7-M,120,0,1,87,0,88,G
7-M,121,0,0,87,0,87,G
7-M,122,0,0,0,89,89,C
7-M,123,0,86,0,1,87,T
7-M,124,1,0,0,98,99,C
7-M,125,0,99,0,0,99,T
7-M,126,0,0,0,101,101,C
7-M,127,101,0,0,0,101,A
7-M,128,0,101,0,0,101,T
7-M,129,0,0,101,0,101,G
7-M,130,0,0,101,0,101,G
7-M,131,100,0,0,0,100,A
7-M,132,101,0,0,0,101,A
7-M,133,0,99,0,0,99,T
7-M,134,1,1,101,0,103,G
7-M,135,0,1,105,0,106,G
7-M,136,0,0,0,106,106,C
7-M,137,0,106,0,0,106,T
7-M,138,106,0,0,0,106,A
7-M,139,107,0,0,0,107,A
7-M,140,107,0,0,0,107,A
7-M,141,0,2,108,0,110,G
7-M,142,109,0,0,0,109,A
7-M,143,0,0,0,108,108,C
7-M,144,103,0,0,0,103,A
7-M,145,103,0,0,0,103,A
7-M,146,0,3,103,0,106,G
7-M,147,106,0,0,0,106,A
7-M,148,0,0,0,106,106,C
7-M,149,0,0,0,103,103,C
7-M,150,104,0,1,0,105,A
7-M,151,105,0,0,0,105,A
7-M,152,0,105,0,0,105,T
7-M,153,0,105,0,0,105,T
7-M,154,0,0,0,108,108,C
7-M,155,0,105,0,0,105,T
7-M,156,0,0,106,0,106,G
7-M,157,1,104,0,0,105,T
7-M,158,1,1,0,103,105,C
7-M,159,105,0,0,0,105,A
7-M,160,0,0,0,109,109,C
7-M,161,0,0,0,110,110,C
7-M,162,0,109,0,0,109,T
7-M,163,0,110,0,0,110,T
7-M,164,0,110,0,0,110,T
7-M,165,0,1,111,0,112,G
7-M,166,114,0,1,0,115,A
7-M,167,0,0,0,115,115,C
7-M,168,0,115,0,0,115,T
7-M,169,113,0,0,0,113,A
7-M,170,113,0,0,0,113,A
7-M,171,109,0,0,0,109,A
7-M,172,0,1,112,0,113,G
7-M,173,0,1,112,0,113,G
7-M,174,0,0,116,0,116,G
7-M,175,115,0,0,0,115,A
7-M,176,0,116,0,0,116,T
7-M,177,0,115,0,0,115,T
7-M,178,0,117,0,0,117,T
7-M,179,1,116,0,0,117,T
7-M,180,0,1,117,0,118,G
7-M,181,0,0,116,0,116,G
7-M,182,0,2,117,0,119,G
7-M,183,0,1,118,0,119,G
7-M,184,0,119,0,0,119,T
7-M,185,0,119,0,0,119,T
7-M,186,0,119,0,0,119,T
7-M,187,0,0,121,0,121,G
7-M,188,0,123,0,0,123,T
7-M,189,0,0,123,0,123,G
7-M,190,0,123,0,0,123,T
7-M,191,0,123,0,0,123,T
7-M,192,0,0,0,124,124,C
7-M,193,124,0,0,0,124,A
7-M,194,0,0,0,127,127,C
7-M,195,0,0,126,0,126,G
7-M,196,0,0,0,127,127,C
7-M,197,0,126,0,0,126,T
7-M,198,1,0,0,127,128,C
7-M,199,129,0,0,0,129,A
7-M,200,0,0,0,131,131,C
7-M,201,0,0,0,131,131,C
7-M,202,0,0,132,0,132,G
7-M,203,0,132,0,1,133,T
7-M,204,0,0,135,0,135,G
7-M,205,0,0,0,136,136,C
7-M,206,0,0,0,137,137,C
7-M,207,0,0,0,139,139,C
7-M,208,138,0,0,0,138,A
7-M,209,0,0,141,0,141,G
7-M,210,0,139,0,0,139,T
7-M,211,0,2,139,0,141,G
7-M,212,141,0,0,0,141,A
7-M,213,0,0,142,0,142,G
7-M,214,0,0,0,143,143,C
7-M,215,0,2,140,0,142,G
7-M,216,142,0,0,0,142,A
7-M,217,0,0,147,0,147,G
7-M,218,0,2,143,0,145,G
7-M,219,145,0,0,0,145,A
7-M,220,0,0,0,148,148,C
7-M,221,0,148,0,0,148,T
7-M,222,0,0,150,0,150,G
7-M,223,0,0,0,150,150,C
7-M,224,148,0,0,0,148,A
7-M,225,0,1,149,0,150,G
7-M,226,0,0,0,149,149,C
7-M,227,0,0,149,0,149,G
7-M,228,0,149,0,0,149,T
7-M,229,148,0,0,0,148,A
7-M,230,0,1,147,0,148,G
7-M,231,148,0,0,0,148,A
7-M,232,0,0,0,149,149,C
7-M,233,0,1,148,0,149,G
7-M,234,0,0,0,150,150,C
7-M,235,0,145,0,2,147,T
7-M,236,0,144,0,0,144,T
7-M,237,0,146,0,0,146,T
7-M,238,0,0,149,0,149,G
7-M,239,0,149,0,0,149,T
7-M,240,1,0,0,147,148,C
7-M,241,2,0,0,146,148,C
7-M,242,148,0,0,0,148,A
7-M,243,147,0,0,0,147,A
7-M,244,148,0,0,0,148,A
7-M,245,147,0,1,0,148,A
7-M,246,0,148,0,0,148,T
7-M,247,0,0,150,0,150,G
7-M,248,0,0,0,149,149,C
7-M,249,2,0,0,145,147,C
7-M,250,1,0,0,150,151,C
7-M,251,0,151,0,0,151,T
7-M,252,2,0,0,152,154,C
7-M,253,156,0,0,0,156,A
7-M,254,157,0,1,0,158,A
7-M,255,0,165,0,0,165,T
7-M,256,0,0,163,0,163,G
7-M,257,0,0,164,0,164,G
7-M,258,0,161,0,0,161,T
7-M,259,165,0,0,0,165,A
7-M,260,164,0,0,0,164,A
7-M,261,0,165,0,0,165,T
7-M,262,0,1,163,0,164,G
7-M,263,0,0,165,0,165,G
7-M,264,162,0,0,0,162,A
7-M,265,0,2,158,0,160,G
7-M,266,160,0,0,0,160,A
7-M,267,1,0,0,158,159,C
7-M,268,3,0,0,162,165,C
7-M,269,0,0,0,168,168,C
7-M,270,168,0,0,0,168,A
7-M,271,166,0,0,0,166,A
7-M,272,167,0,0,0,167,A
7-M,273,0,170,0,0,170,T
7-M,274,171,0,0,0,171,A
7-M,275,170,0,0,0,170,A
7-M,276,1,0,0,168,169,C
7-M,277,166,0,1,0,167,A
7-M,278,0,168,0,0,168,T
7-M,279,0,0,168,0,168,G
7-M,280,0,1,168,0,169,G
7-M,281,169,0,0,0,169,A
7-M,282,0,0,0,169,169,C
7-M,283,164,0,1,0,165,A
7-M,284,165,0,1,0,166,A
7-M,285,168,0,0,0,168,A
7-M,286,0,0,172,0,172,G
7-M,287,1,0,0,174,175,C
7-M,288,174,0,0,0,174,A
7-M,289,0,0,174,0,174,G
7-M,290,0,174,0,0,174,T
7-M,291,0,173,0,0,173,T
7-M,292,175,0,0,0,175,A
7-M,293,173,0,2,0,175,A
7-M,294,176,0,0,0,176,A
7-M,295,0,0,0,178,178,C
7-M,296,0,171,0,1,172,T
7-M,297,0,0,184,0,184,G
7-M,298,0,180,0,0,180,T
7-M,299,182,0,0,0,182,A
7-M,300,0,181,0,0,181,T
7-M,301,183,0,0,0,183,A
7-M,302,0,1,181,0,182,G
7-M,303,0,1,181,0,182,G
7-M,304,182,0,1,0,183,A
7-M,305,180,0,1,1,182,A
7-M,306,171,0,0,0,171,A
7-M,307,0,0,0,177,177,C
7-M,308,0,176,0,0,176,T
7-M,309,0,175,0,0,175,T
7-M,310,177,0,0,0,177,A
7-M,311,174,0,0,0,174,A
7-M,312,0,0,175,0,175,G
7-M,313,175,0,0,0,175,A
7-M,314,0,2,174,0,176,G
7-M,315,0,0,175,0,175,G
7-M,316,0,1,174,0,175,G
7-M,317,174,0,0,0,174,A
7-M,318,0,0,175,0,175,G
7-M,319,175,0,0,0,175,A
7-M,320,0,175,0,0,175,T
7-M,321,176,0,0,0,176,A
7-M,322,177,0,0,0,177,A
7-M,323,0,0,0,177,177,C
7-M,324,0,0,172,0,172,G
7-M,325,0,170,0,0,170,T
7-M,326,0,172,0,0,172,T
7-M,327,1,0,0,171,172,C
7-M,328,2,0,0,169,171,C
7-M,329,172,0,0,0,172,A
7-M,330,0,169,0,0,169,T
7-M,331,0,0,170,0,170,G
7-M,332,0,1,174,0,175,G
7-M,333,0,0,176,0,176,G
7-M,334,0,0,178,0,178,G
7-M,335,0,0,0,176,176,C
7-M,336,3,1,0,174,178,C
7-M,337,180,0,0,0,180,A
7-M,338,182,0,0,0,182,A
7-M,339,183,0,0,0,183,A
7-M,340,0,0,183,0,183,G
7-M,341,182,0,1,0,183,A
7-M,342,183,0,0,0,183,A
7-M,343,181,0,1,0,182,A
7-M,344,0,183,0,0,183,T
7-M,345,182,0,0,0,182,A
7-M,346,0,0,185,0,185,G
7-M,347,0,0,0,183,183,C
7-M,348,0,181,0,1,182,T
7-M,349,0,0,0,183,183,C
7-M,350,0,181,0,1,182,T
7-M,351,1,0,0,190,191,C
7-M,352,191,0,0,0,191,A
7-M,353,0,0,190,0,190,G
7-M,354,0,189,0,0,189,T
7-M,355,0,191,0,0,191,T
7-M,356,191,0,0,0,191,A
7-M,357,0,191,0,0,191,T
7-M,358,0,189,0,0,189,T
7-M,359,0,0,0,189,189,C
7-M,360,0,178,0,0,178,T
7-M,361,0,0,178,0,178,G
7-M,362,0,0,0,177,177,C
7-M,363,0,178,0,0,178,T
7-M,364,0,0,177,0,177,G
7-M,365,0,0,177,0,177,G
7-M,366,0,178,0,0,178,T
7-M,367,0,1,177,0,178,G
7-M,368,0,0,0,177,177,C
7-M,369,177,0,0,0,177,A
7-M,370,0,0,0,178,178,C
7-M,371,0,176,0,0,176,T
7-M,372,0,181,0,0,181,T
7-M,373,0,0,182,0,182,G
7-M,374,0,0,0,182,182,C
7-M,375,1,0,0,180,181,C
7-M,376,180,0,0,0,180,A
7-M,377,0,0,180,0,180,G
7-M,378,0,179,0,1,180,T
7-M,379,0,178,0,0,178,T
7-M,380,0,0,180,0,180,G
7-M,381,0,0,0,176,176,C
7-M,382,177,0,0,0,177,A
7-M,383,0,175,0,0,175,T
7-M,384,0,1,173,0,174,G
7-M,385,1,0,175,0,176,G
7-M,386,0,0,183,0,183,G
7-M,387,0,1,0,182,183,C
7-M,388,1,0,0,186,187,C
7-M,389,0,187,0,0,187,T
7-M,390,3,3,0,181,187,C
7-M,391,198,0,0,0,198,A
7-M,392,0,198,0,0,198,T
7-M,393,202,0,0,0,202,A
7-M,394,0,199,0,0,199,T
7-M,395,195,0,0,0,195,A
7-M,396,0,2,0,207,209,C
7-M,397,195,0,0,0,195,A
7-M,398,195,0,0,0,195,A
7-M,399,0,195,0,0,195,T
7-M,400,182,0,0,0,182,A
7-M,401,0,0,184,0,184,G
7-M,402,0,0,183,0,183,G
7-M,403,182,0,1,0,183,A
7-M,404,0,183,0,1,184,T
7-M,405,0,1,175,0,176,G
7-M,406,0,1,175,0,176,G
7-M,407,0,2,171,0,173,G
7-M,408,0,0,175,0,175,G
7-M,409,0,0,175,0,175,G
7-M,410,0,0,0,175,175,C
7-M,411,0,168,0,2,170,T
7-M,412,0,0,171,0,171,G
7-M,413,0,170,0,0,170,T
7-M,414,169,0,0,0,169,A
7-M,415,168,0,0,0,168,A
7-M,416,0,0,0,168,168,C
7-M,417,2,0,0,166,168,C
7-M,418,167,0,0,0,167,A
7-M,419,1,0,0,167,168,C
7-M,420,0,168,0,0,168,T
7-M,421,0,2,165,0,167,G
7-M,422,168,0,0,0,168,A
7-M,423,167,0,1,0,168,A
7-M,424,0,0,167,0,167,G
7-M,425,0,168,0,0,168,T
7-M,426,0,0,168,0,168,G
7-M,427,0,0,169,0,169,G
7-M,428,0,0,0,169,169,C
7-M,429,171,0,0,0,171,A
7-M,430,0,169,0,1,170,T
7-M,431,0,169,0,0,169,T
7-M,432,0,169,0,0,169,T
7-M,433,0,2,169,0,171,G
7-M,434,0,0,170,0,170,G
7-M,435,0,0,0,169,169,C
7-M,436,0,0,0,170,170,C
7-M,437,0,169,0,0,169,T
7-M,438,0,0,177,0,177,G
7-M,439,0,0,179,0,179,G
7-M,440,0,179,0,0,179,T
7-M,441,181,0,0,0,181,A
7-M,442,0,171,0,0,171,T
7-M,443,0,0,178,0,178,G
7-M,444,0,181,0,0,181,T
7-M,445,0,0,181,0,181,G
7-M,446,0,0,0,179,179,C
7-M,447,174,0,0,0,174,A
7-M,448,170,0,0,0,170,A
7-M,449,0,0,0,171,171,C
7-M,450,171,0,0,0,171,A
7-M,451,0,171,0,0,171,T
7-M,452,0,0,168,0,168,G
7-M,453,0,165,0,0,165,T
7-M,454,0,0,165,0,165,G
7-M,455,165,0,0,0,165,A
7-M,456,0,0,164,0,164,G
7-M,457,1,0,0,164,165,C
7-M,458,165,0,0,0,165,A
7-M,459,1,1,165,0,167,G
7-M,460,166,0,0,0,166,A
7-M,461,1,165,0,0,166,T
7-M,462,0,164,0,1,165,T
7-M,463,0,0,164,0,164,G
7-M,464,0,0,0,165,165,C
7-M,465,0,163,0,0,163,T
7-M,466,0,2,161,0,163,G
7-M,467,163,1,0,0,164,A
7-M,468,0,0,0,169,169,C
7-M,469,0,173,0,0,173,T
7-M,470,0,0,0,172,172,C
7-M,471,0,0,0,168,168,C
7-M,472,1,0,0,169,170,C
7-M,473,171,0,0,0,171,A
7-M,474,0,0,172,0,172,G
7-M,475,0,0,0,171,171,C
7-M,476,173,0,0,0,173,A
7-M,477,0,1,0,172,173,C
7-M,478,161,0,0,0,161,A
7-M,479,0,1,164,0,165,G
7-M,480,0,0,164,0,164,G
7-M,481,0,163,0,0,163,T
7-M,482,0,0,0,168,168,C
7-M,483,0,162,0,0,162,T
7-M,484,3,1,0,159,163,C
7-M,485,163,0,0,0,163,A
7-M,486,0,163,0,1,164,T
7-M,487,164,0,0,0,164,A
7-M,488,0,0,162,0,162,G
7-M,489,0,0,161,0,161,G
7-M,490,0,0,0,159,159,C
7-M,491,147,0,0,0,147,A
7-M,492,0,1,143,0,144,G
7-M,493,144,0,0,0,144,A
7-M,494,0,145,0,0,145,T
7-M,495,0,0,144,0,144,G
7-M,496,0,0,145,0,145,G
7-M,497,0,144,0,0,144,T
7-M,498,0,0,146,0,146,G
7-M,499,0,1,146,0,147,G
7-M,500,0,1,0,146,147,C
7-M,501,146,0,0,0,146,A
7-M,502,146,0,0,0,146,A
7-M,503,0,0,0,149,149,C
7-M,504,149,0,0,0,149,A
7-M,505,149,0,0,0,149,A
7-M,506,0,0,0,148,148,C
7-M,507,2,0,0,145,147,C
7-M,508,148,0,0,0,148,A
7-M,509,148,0,0,0,148,A
7-M,510,0,148,0,0,148,T
7-M,511,1,0,0,147,148,C
7-M,512,0,0,0,144,144,C
7-M,513,145,0,0,0,145,A
7-M,514,0,144,0,0,144,T
7-M,515,0,144,0,0,144,T
7-M,516,145,0,0,0,145,A
7-M,517,144,0,0,0,144,A
7-M,518,0,145,0,0,145,T
7-M,519,143,0,0,0,143,A
7-M,520,142,0,0,0,142,A
7-M,521,140,1,0,0,141,A
7-M,522,142,0,0,0,142,A
7-M,523,0,0,0,142,142,C
7-M,524,142,0,0,0,142,A
7-M,525,0,141,0,0,141,T
7-M,526,0,0,141,0,141,G
7-M,527,139,0,0,0,139,A
7-M,528,0,0,139,0,139,G
7-M,529,138,0,1,0,139,A
7-M,530,139,0,0,0,139,A
7-M,531,0,0,0,141,141,C
7-M,532,132,0,0,0,132,A
7-M,533,0,0,134,0,134,G
7-M,534,133,0,0,0,133,A
7-M,535,134,0,0,0,134,A
7-M,536,0,133,0,0,133,T
7-M,537,0,1,130,0,131,G
7-M,538,0,0,130,0,130,G
7-M,539,0,131,0,1,132,T
7-M,540,0,132,0,0,132,T
7-M,541,0,136,0,0,136,T
7-M,542,0,135,0,0,135,T
7-M,543,0,2,135,0,137,G
7-M,544,0,0,139,0,139,G
7-M,545,0,0,0,138,138,C
7-M,546,0,0,0,137,137,C
7-M,547,134,0,0,0,134,A
7-M,548,0,0,142,0,142,G
7-M,549,0,0,0,141,141,C
7-M,550,142,0,0,0,142,A
7-M,551,0,0,0,145,145,C
7-M,552,0,145,0,0,145,T
7-M,553,146,0,0,0,146,A
7-M,554,0,0,0,146,146,C
7-M,555,145,0,0,0,145,A
7-M,556,0,0,147,0,147,G
7-M,557,0,0,0,145,145,C
7-M,558,0,143,0,0,143,T
7-M,559,142,0,0,0,142,A
7-M,560,133,0,0,0,133,A
7-M,561,0,1,137,0,138,G
7-M,562,0,0,138,0,138,G
7-M,563,0,0,0,135,135,C
7-M,564,0,133,0,0,133,T
7-M,565,130,0,0,0,130,A
7-M,566,0,131,0,0,131,T
7-M,567,0,1,128,1,130,G
7-M,568,0,0,133,0,133,G
7-M,569,131,0,0,0,131,A
7-M,570,0,0,130,0,130,G
7-M,571,1,0,0,128,129,C
7-M,572,125,0,0,0,125,A
7-M,573,126,0,0,0,126,A
7-M,574,126,0,0,0,126,A
7-M,575,0,126,0,0,126,T
7-M,576,0,1,124,0,125,G
7-M,577,0,0,126,0,126,G
7-M,578,0,0,0,125,125,C
7-M,579,0,122,0,1,123,T
7-M,580,0,0,124,0,124,G
7-M,581,0,3,122,0,125,G
7-M,582,124,0,1,0,125,A
7-M,583,0,125,0,0,125,T
7-M,584,2,0,0,121,123,C
7-M,585,121,0,0,0,121,A
7-M,586,119,0,0,0,119,A
7-M,587,0,0,121,0,121,G
7-M,588,0,121,0,0,121,T
7-M,589,0,1,120,0,121,G
7-M,590,120,0,0,0,120,A
7-M,591,117,0,0,0,117,A
7-M,592,0,0,0,119,119,C
7-M,593,119,0,0,0,119,A
7-M,594,0,2,117,0,119,G
7-M,595,0,0,118,0,118,G
7-M,596,0,0,0,119,119,C
7-M,597,115,0,0,0,115,A
7-M,598,0,0,115,0,115,G
7-M,599,0,0,0,114,114,C
7-M,600,0,1,114,0,115,G
7-M,601,0,0,115,0,115,G
7-M,602,113,0,1,0,114,A
7-M,603,0,0,116,0,116,G
7-M,604,0,0,116,0,116,G
7-M,605,0,0,0,116,116,C
7-M,606,3,0,0,112,115,C
7-M,607,114,0,0,0,114,A
7-M,608,0,113,0,0,113,T
7-M,609,0,0,114,0,114,G
7-M,610,0,0,116,0,116,G
7-M,611,115,0,0,0,115,A
7-M,612,0,1,111,0,112,G
7-M,613,107,0,1,0,108,A
7-M,614,0,107,0,0,107,T
7-M,615,0,105,0,0,105,T
7-M,616,0,0,107,0,107,G
7-M,617,0,0,0,107,107,C
7-M,618,0,108,0,0,108,T
7-M,619,106,0,0,0,106,A
7-M,620,0,0,107,0,107,G
7-M,621,0,107,0,0,107,T
7-M,622,2,0,0,102,104,C
7-M,623,99,0,0,0,99,A
7-M,624,0,0,100,0,100,G
7-M,625,0,1,99,0,100,G
7-M,626,0,0,0,99,99,C
7-M,627,1,0,0,99,100,C
7-M,628,99,0,0,0,99,A
7-M,629,0,0,100,0,100,G
7-M,630,0,0,100,0,100,G
7-M,631,0,0,0,101,101,C
7-M,632,100,0,0,0,100,A
7-M,633,1,0,101,0,102,G
7-M,634,102,0,0,0,102,A
7-M,635,0,102,0,0,102,T
7-M,636,0,0,103,0,103,G
7-M,637,0,0,106,0,106,G
7-M,638,0,106,0,0,106,T
7-M,639,0,0,105,0,105,G
7-M,640,0,0,0,104,104,C
7-M,641,104,0,0,0,104,A
7-M,642,0,0,107,0,107,G
7-M,643,0,0,108,0,108,G
7-M,644,0,0,0,108,108,C
7-M,645,108,0,0,0,108,A
7-M,646,106,0,0,0,106,A
7-M,647,0,104,0,0,104,T
7-M,648,0,0,104,0,104,G
7-M,649,104,0,0,0,104,A
7-M,650,0,0,103,0,103,G
7-M,651,101,0,0,0,101,A
7-M,652,0,0,104,0,104,G
7-M,653,0,0,0,106,106,C
7-M,654,0,0,0,108,108,C
7-M,655,110,0,0,0,110,A
7-M,656,0,110,0,0,110,T
7-M,657,0,110,0,0,110,T
7-M,658,0,1,110,0,111,G
7-M,659,0,0,108,0,108,G
7-M,660,0,2,108,0,110,G
7-M,661,110,0,0,0,110,A
7-M,662,0,0,0,110,110,C
7-M,663,0,104,0,0,104,T
7-M,664,1,0,0,107,108,C
7-M,665,110,0,0,0,110,A
7-M,666,0,116,0,1,117,T
7-M,667,0,0,0,117,117,C
7-M,668,0,0,0,116,116,C
7-M,669,0,115,0,0,115,T
7-M,670,112,0,0,0,112,A
7-M,671,0,0,113,0,113,G
7-M,672,0,116,0,0,116,T
7-M,673,0,115,0,0,115,T
7-M,674,0,0,0,115,115,C
7-M,675,1,0,0,114,115,C
7-M,676,113,0,0,0,113,A
7-M,677,0,0,117,0,117,G
7-M,678,0,117,0,0,117,T
7-M,679,117,0,0,0,117,A
7-M,680,0,0,0,117,117,C
7-M,681,0,109,0,0,109,T
7-M,682,0,0,114,0,114,G
7-M,683,0,0,113,0,113,G
7-M,684,0,114,0,0,114,T
7-M,685,0,113,0,0,113,T
7-M,686,0,113,0,0,113,T
7-M,687,113,0,0,0,113,A
7-M,688,113,0,0,0,113,A
7-M,689,0,1,112,0,113,G
7-M,690,111,0,0,0,111,A
7-M,691,0,0,109,0,109,G
7-M,692,106,0,0,0,106,A
7-M,693,0,106,0,0,106,T
7-M,694,0,1,105,0,106,G
7-M,695,105,1,1,0,107,A
7-M,696,0,107,0,0,107,T
7-M,697,1,0,0,106,107,C
7-M,698,0,104,0,1,105,T
7-M,699,0,106,0,0,106,T
7-M,700,0,0,0,106,106,C
7-M,701,0,105,0,0,105,T
7-M,702,0,105,0,0,105,T
7-M,703,0,0,105,0,105,G
7-M,704,103,0,0,0,103,A
7-M,705,105,0,0,0,105,A
7-M,706,105,0,0,0,105,A
7-M,707,105,0,0,0,105,A
7-M,708,0,103,0,0,103,T
7-M,709,0,105,0,0,105,T
7-M,710,0,105,0,0,105,T
7-M,711,0,0,105,0,105,G
7-M,712,0,1,0,104,105,C
7-M,713,105,0,0,0,105,A
7-M,714,0,0,103,0,103,G
7-M,715,105,0,0,0,105,A
7-M,716,0,0,0,109,109,C
7-M,717,0,0,0,108,108,C
7-M,718,0,107,0,0,107,T
7-M,719,109,0,0,0,109,A
7-M,720,0,108,0,0,108,T
7-M,721,1,0,0,107,108,C
7-M,722,109,0,0,0,109,A
7-M,723,0,0,109,0,109,G
7-M,724,108,0,0,0,108,A
7-M,725,104,0,0,0,104,A
7-M,726,104,0,1,0,105,A
7-M,727,1,0,0,104,105,C
7-M,728,0,1,105,0,106,G
7-M,729,106,0,0,0,106,A
7-M,730,105,0,0,0,105,A
7-M,731,0,106,0,1,107,T
7-M,732,0,0,106,1,107,G
7-M,733,0,0,109,0,109,G
7-M,734,0,0,110,0,110,G
7-M,735,0,1,109,0,110,G
7-M,736,0,0,113,0,113,G
7-M,737,0,111,0,0,111,T
7-M,738,0,0,111,0,111,G
7-M,739,0,1,0,110,111,C
7-M,740,110,0,0,1,111,A
7-M,741,0,1,111,0,112,G
7-M,742,108,0,0,0,108,A
7-M,743,0,108,0,1,109,T
7-M,744,0,0,109,0,109,G
7-M,745,0,0,0,110,110,C
7-M,746,109,0,1,0,110,A
7-M,747,110,0,0,0,110,A
7-M,748,0,0,0,110,110,C
7-M,749,0,1,111,0,112,G
7-M,750,111,0,0,0,111,A
7-M,751,0,110,0,0,110,T
7-M,752,0,111,0,0,111,T
7-M,753,3,0,0,111,114,C
7-M,754,109,0,0,0,109,A
7-M,755,109,0,0,0,109,A
7-M,756,0,0,109,0,109,G
7-M,757,0,108,0,0,108,T
7-M,758,0,2,105,0,107,G
7-M,759,107,0,0,0,107,A
7-M,760,0,0,1,107,108,C
7-M,761,0,0,0,108,108,C
7-M,762,0,0,0,108,108,C
7-M,763,0,0,107,0,107,G
7-M,764,0,0,0,110,110,C
7-M,765,0,109,0,0,109,T
7-M,766,0,111,0,0,111,T
7-M,767,0,0,111,0,111,G
7-M,768,0,110,0,0,110,T
7-M,769,0,108,1,0,109,T
7-M,770,0,0,109,0,109,G
7-M,771,0,106,0,0,106,T
7-M,772,0,105,0,0,105,T
7-M,773,0,0,104,0,104,G
7-M,774,0,1,0,104,105,C
7-M,775,0,0,0,106,106,C
7-M,776,0,1,105,0,106,G
7-M,777,0,0,0,107,107,C
7-M,778,0,0,106,0,106,G
7-M,779,107,0,0,0,107,A
7-M,780,107,0,0,0,107,A
7-M,781,0,107,0,0,107,T
7-M,782,107,0,0,0,107,A
7-M,783,1,106,0,0,107,T
7-M,784,1,0,0,107,108,C
7-M,785,109,0,0,0,109,A
7-M,786,0,109,0,0,109,T
7-M,787,0,106,0,0,106,T
7-M,788,0,1,106,0,107,G
7-M,789,0,0,106,0,106,G
7-M,790,0,1,105,0,106,G
7-M,791,108,0,0,0,108,A
7-M,792,0,106,0,0,106,T
7-M,793,1,0,0,103,104,C
7-M,794,0,104,0,0,104,T
7-M,795,0,103,0,0,103,T
7-M,796,0,1,102,0,103,G
7-M,797,0,0,0,104,104,C
7-M,798,102,0,0,0,102,A
7-M,799,0,0,0,102,102,C
7-M,800,0,99,0,0,99,T
7-M,801,0,98,0,1,99,T
7-M,802,0,0,100,0,100,G
7-M,803,102,0,0,0,102,A
7-M,804,0,101,0,1,102,T
7-M,805,98,0,0,0,98,A
7-M,806,0,98,0,0,98,T
7-M,807,0,94,0,2,96,T
7-M,808,0,0,96,0,96,G
7-M,809,0,96,0,0,96,T
7-M,810,0,0,95,0,95,G
7-M,811,0,0,95,0,95,G
7-M,812,94,0,0,0,94,A
7-M,813,0,93,0,0,93,T
7-M,814,0,91,0,0,91,T
7-M,815,0,0,0,92,92,C
7-M,816,0,91,0,0,91,T
7-M,817,0,90,0,0,90,T
7-M,818,0,1,88,0,89,G
7-M,819,89,0,0,0,89,A
7-M,820,0,88,0,0,88,T
7-M,821,0,0,0,88,88,C
7-M,822,0,0,89,0,89,G
7-M,823,0,87,0,1,88,T
7-M,824,0,0,0,89,89,C
7-M,825,0,87,0,1,88,T
7-M,826,0,89,0,0,89,T
7-M,827,0,89,0,0,89,T
7-M,828,0,88,0,1,89,T
7-M,829,0,90,0,0,90,T
7-M,830,0,90,0,0,90,T
7-M,831,0,89,0,1,90,T
7-M,832,0,1,0,89,90,C
7-M,833,88,0,0,0,88,A
7-M,834,88,0,0,0,88,A
7-M,835,89,0,0,0,89,A
7-M,836,0,89,0,0,89,T
7-M,837,0,0,89,0,89,G
7-M,838,0,0,0,87,87,C
7-M,839,0,0,88,0,88,G
7-M,840,0,89,0,1,90,T
7-M,841,0,0,0,90,90,C
7-M,842,0,90,0,0,90,T
7-M,843,90,0,0,0,90,A
7-M,844,0,90,0,0,90,T
7-M,845,1,0,0,89,90,C
7-M,846,0,0,89,0,89,G
7-M,847,90,0,0,0,90,A
7-M,848,0,0,0,90,90,C
7-M,849,0,88,0,0,88,T
7-M,850,0,0,0,88,88,C
7-M,851,0,86,0,0,86,T
7-M,852,0,87,0,0,87,T
7-M,853,1,0,0,86,87,C
7-M,854,87,0,0,0,87,A
7-M,855,88,0,0,0,88,A
7-M,856,87,0,0,0,87,A
7-M,857,0,0,0,88,88,C
7-M,858,88,0,0,0,88,A
7-M,859,0,0,0,83,83,C
7-M,860,0,0,83,0,83,G
7-M,861,0,0,85,0,85,G
7-M,862,0,0,0,84,84,C
7-M,863,1,0,0,83,84,C
7-M,864,0,84,0,0,84,T
7-M,865,0,82,0,0,82,T
7-M,866,82,0,0,0,82,A
7-M,867,83,0,0,0,83,A
7-M,868,83,0,0,0,83,A
7-M,869,82,0,0,0,82,A
7-M,870,0,0,81,0,81,G
7-M,871,67,0,0,0,67,A
7-M,872,0,0,67,0,67,G
7-M,873,0,0,66,0,66,G
7-M,874,0,0,0,65,65,C
7-M,875,1,0,0,64,65,C
7-M,876,0,1,0,65,66,C
7-M,877,0,66,0,0,66,T
7-M,878,0,66,0,0,66,T
7-M,879,1,0,0,66,67,C
7-M,880,0,67,0,0,67,T
7-M,881,67,0,0,0,67,A
7-M,882,0,0,0,67,67,C
7-M,883,0,0,67,0,67,G
7-M,884,0,0,67,0,67,G
7-M,885,65,0,0,0,65,A
7-M,886,66,0,0,0,66,A
7-M,887,0,0,66,0,66,G
7-M,888,0,1,66,0,67,G
7-M,889,63,0,1,0,64,A
7-M,890,0,0,64,0,64,G
7-M,891,0,63,0,0,63,T
7-M,892,63,0,0,0,63,A
7-M,893,0,0,0,63,63,C
7-M,894,0,1,0,61,62,C
7-M,895,0,62,0,0,62,T
7-M,896,0,0,62,0,62,G
7-M,897,59,0,0,0,59,A
7-M,898,0,0,60,0,60,G
7-M,899,0,54,0,0,54,T
7-M,900,0,0,0,53,53,C
7-M,901,0,54,0,0,54,T
7-M,902,54,0,0,0,54,A
7-M,903,0,54,0,0,54,T
7-M,904,0,0,54,0,54,G
7-M,905,54,0,0,0,54,A
7-M,906,0,1,53,0,54,G
7-M,907,0,0,50,0,50,G
7-M,908,0,0,50,0,50,G
7-M,909,49,0,0,0,49,A
7-M,910,49,0,0,0,49,A
7-M,911,0,0,51,0,51,G
7-M,912,51,0,0,0,51,A
7-M,913,53,0,0,0,53,A
7-M,914,0,53,0,0,53,T
7-M,915,48,0,0,0,48,A
7-M,916,0,48,0,0,48,T
7-M,917,0,2,0,45,47,C
7-M,918,0,0,48,0,48,G
7-M,919,48,0,0,0,48,A
7-M,920,46,0,0,0,46,A
7-M,921,45,0,0,0,45,A
7-M,922,0,0,45,0,45,G
7-M,923,0,1,45,0,46,G
7-M,924,45,1,0,0,46,A
7-M,925,46,0,0,0,46,A
7-M,926,0,0,0,46,46,C
7-M,927,45,0,0,0,45,A
7-M,928,0,0,47,0,47,G
7-M,929,0,0,0,47,47,C
7-M,930,44,0,1,0,45,A
7-M,931,0,0,45,0,45,G
7-M,932,44,0,0,0,44,A
7-M,933,44,0,0,0,44,A
7-M,934,0,44,0,0,44,T
7-M,935,0,0,43,0,43,G
7-M,936,0,0,0,44,44,C
7-M,937,0,43,0,0,43,T
7-M,938,0,0,43,0,43,G
7-M,939,0,42,0,0,42,T
7-M,940,0,0,42,0,42,G
7-M,941,0,0,41,0,41,G
7-M,942,41,0,0,0,41,A
7-M,943,0,41,0,0,41,T
7-M,944,0,0,38,0,38,G
7-M,945,0,0,0,39,39,C
7-M,946,0,36,0,0,36,T
7-M,947,0,0,35,0,35,G
7-M,948,34,0,0,0,34,A
7-M,949,0,0,0,34,34,C
7-M,950,0,0,34,0,34,G
7-M,951,33,0,0,0,33,A
7-M,952,0,0,0,33,33,C
7-M,953,32,0,0,0,32,A
7-M,954,0,0,33,0,33,G
7-M,955,0,33,0,0,33,T
7-M,956,1,0,0,32,33,C
7-M,957,33,0,0,0,33,A
7-M,958,0,33,0,0,33,T
7-M,959,0,33,0,0,33,T
7-M,960,0,32,0,0,32,T
7-M,961,0,31,0,0,31,T
7-M,962,0,0,31,0,31,G
7-M,963,0,30,0,0,30,T
7-M,964,0,0,0,30,30,C
7-M,965,29,0,0,0,29,A
7-M,966,0,0,29,0,29,G
7-M,967,0,0,0,29,29,C
7-M,968,29,0,0,0,29,A
7-M,969,0,29,0,0,29,T
7-M,970,28,0,0,0,28,A
7-M,971,0,0,28,0,28,G
7-M,972,28,0,0,0,28,A
7-M,973,0,0,28,0,28,G
7-M,974,0,28,0,0,28,T
7-M,975,0,18,0,0,18,T
7-M,976,0,0,18,0,18,G
7-M,977,0,0,18,0,18,G
7-M,978,18,0,0,0,18,A
7-M,979,0,0,18,0,18,G
7-M,980,0,14,0,0,14,T
7-M,981,14,0,0,0,14,A
7-M,982,14,0,0,0,14,A
8-NS,1,189,0,0,0,189,A
8-NS,2,0,193,0,0,193,T
8-NS,3,0,0,220,0,220,G
8-NS,4,0,2,243,0,245,G
8-NS,5,260,0,0,0,260,A
8-NS,6,0,411,0,0,411,T
8-NS,7,0,411,0,1,412,T
8-NS,8,1,0,0,426,427,C
8-NS,9,0,0,0,429,429,C
8-NS,10,429,0,0,0,429,A
8-NS,11,437,0,1,0,438,A
8-NS,12,2,0,0,438,440,C
8-NS,13,441,0,0,0,441,A
8-NS,14,0,0,0,458,458,C
8-NS,15,0,458,0,1,459,T
8-NS,16,0,0,458,0,458,G
8-NS,17,0,458,0,1,459,T
8-NS,18,458,0,0,0,458,A
8-NS,19,0,570,0,0,570,T
8-NS,20,0,0,0,571,571,C
8-NS,21,572,0,1,0,573,A
8-NS,22,573,0,0,0,573,A
8-NS,23,0,0,581,0,581,G
8-NS,24,0,592,0,0,592,T
8-NS,25,0,588,0,0,588,T
8-NS,26,0,598,0,0,598,T
8-NS,27,1,1,0,599,601,C
8-NS,28,0,1,0,605,606,C
8-NS,29,603,0,3,0,606,A
8-NS,30,1,2,607,0,610,G
8-NS,31,0,0,619,0,619,G
8-NS,32,0,619,0,0,619,T
8-NS,33,619,1,0,0,620,A
8-NS,34,0,1,623,0,624,G
8-NS,35,625,0,0,0,625,A
8-NS,36,0,628,0,0,628,T
8-NS,37,0,627,0,0,627,T
8-NS,38,0,0,641,0,641,G
8-NS,39,0,0,0,645,645,C
8-NS,40,0,643,0,2,645,T
8-NS,41,0,653,0,0,653,T
8-NS,42,0,656,0,1,657,T
8-NS,43,3,0,0,672,675,C
8-NS,44,0,670,0,3,673,T
8-NS,45,0,671,0,0,671,T
8-NS,46,0,670,0,1,671,T
8-NS,47,0,2,669,0,671,G
8-NS,48,0,0,674,0,674,G
8-NS,49,1,0,0,672,673,C
8-NS,50,674,0,0,0,674,A
8-NS,51,0,673,0,1,674,T
8-NS,52,679,0,0,0,679,A
8-NS,53,0,703,0,1,704,T
8-NS,54,1,0,0,703,704,C
8-NS,55,3,3,0,697,703,C
8-NS,56,0,0,703,0,703,G
8-NS,57,0,3,707,0,710,G
8-NS,58,710,0,0,0,710,A
8-NS,59,711,0,1,0,712,A
8-NS,60,717,0,2,0,719,A
8-NS,61,1,0,0,725,726,C
8-NS,62,720,0,1,0,721,A
8-NS,63,721,0,0,0,721,A
8-NS,64,1,1,750,1,753,G
8-NS,65,0,753,0,1,754,T
8-NS,66,0,751,0,2,753,T
8-NS,67,0,0,758,0,758,G
8-NS,68,0,759,0,0,759,T
8-NS,69,756,0,3,0,759,A
8-NS,70,0,10,758,0,768,G
8-NS,71,810,1,0,0,811,A
8-NS,72,0,0,0,823,823,C
8-NS,73,10,0,0,799,809,C
8-NS,74,805,0,0,0,805,A
8-NS,75,810,0,0,0,810,A
8-NS,76,0,9,843,0,852,G
8-NS,77,850,0,0,0,850,A
8-NS,78,856,0,2,0,858,A
8-NS,79,1,0,0,859,860,C
8-NS,80,0,833,0,0,833,T
8-NS,81,0,4,850,0,854,G
8-NS,82,850,0,0,0,850,A
8-NS,83,1,0,874,0,875,G
8-NS,84,1,874,0,0,875,T
8-NS,85,0,9,861,0,870,G
8-NS,86,875,0,1,0,876,A
8-NS,87,0,871,0,1,872,T
8-NS,88,0,1,888,0,889,G
8-NS,89,1,4,0,900,905,C
8-NS,90,1,1,0,902,904,C
8-NS,91,2,0,0,903,905,C
8-NS,92,3,1,0,903,907,C
8-NS,93,909,0,0,0,909,A
8-NS,94,0,918,0,1,919,T
8-NS,95,0,928,0,1,929,T
8-NS,96,6,0,0,928,934,C
8-NS,97,0,0,1,929,930,C
8-NS,98,0,939,0,1,940,T
8-NS,99,0,935,0,0,935,T
8-NS,100,0,13,926,0,939,G
8-NS,101,937,0,1,0,938,A
8-NS,102,0,938,0,2,940,T
8-NS,103,9,2,0,926,937,C
8-NS,104,2,1,933,0,936,G
8-NS,105,0,0,941,0,941,G
8-NS,106,1,0,0,940,941,C
8-NS,107,0,936,0,3,939,T
8-NS,108,0,940,0,1,941,T
8-NS,109,5,0,0,938,943,C
8-NS,110,1,2,946,0,949,G
8-NS,111,0,0,0,949,949,C
8-NS,112,4,1,0,946,951,C
8-NS,113,0,4,948,0,952,G
8-NS,114,948,0,0,0,948,A
8-NS,115,0,8,982,0,990,G
8-NS,116,985,0,2,1,988,A
8-NS,117,0,992,0,0,992,T
8-NS,118,5,1,0,986,992,C
8-NS,119,986,0,2,0,988,A
8-NS,120,0,3,994,0,997,G
8-NS,121,992,0,2,0,994,A
8-NS,122,0,0,1002,0,1002,G
8-NS,123,0,0,1009,0,1009,G
8-NS,124,0,1011,0,0,1011,T
8-NS,125,4,0,1,1062,1067,C
8-NS,126,4,0,0,1069,1073,C
8-NS,127,6,0,0,1068,1074,C
8-NS,128,0,1071,0,2,1073,T
8-NS,129,1082,0,0,0,1082,A
8-NS,130,1075,0,5,0,1080,A
8-NS,131,0,4,1095,0,1099,G
8-NS,132,0,2,1093,0,1095,G
8-NS,133,1,5,1085,1,1092,G
8-NS,134,0,2,1072,0,1074,G
8-NS,135,1068,0,3,0,1071,A
8-NS,136,1065,0,3,0,1068,A
8-NS,137,0,4,1070,0,1074,G
8-NS,138,1111,0,1,0,1112,A
8-NS,139,0,1,1119,0,1120,G
8-NS,140,1,2,1108,0,1111,G
8-NS,141,1,1,0,1115,1117,C
8-NS,142,1108,0,2,0,1110,A
8-NS,143,1111,0,0,0,1111,A
8-NS,144,0,1110,0,0,1110,T
8-NS,145,1114,0,0,0,1114,A
8-NS,146,0,0,0,1139,1139,C
8-NS,147,0,1107,0,1,1108,T
8-NS,148,3,0,0,1108,1111,C
8-NS,149,1,1100,0,0,1101,T
8-NS,150,3,1,0,1104,1108,C
8-NS,151,1,7,1109,0,1117,G
8-NS,152,1,0,1171,0,1172,G
8-NS,153,0,1173,0,1,1174,T
8-NS,154,6,0,0,1180,1186,C
8-NS,155,0,1182,0,0,1182,T
8-NS,156,1183,0,2,0,1185,A
8-NS,157,1,7,1177,0,1185,G
8-NS,158,1182,0,0,0,1182,A
8-NS,159,0,1,0,1227,1228,C
8-NS,160,1214,0,0,0,1214,A
8-NS,161,0,1192,0,1,1193,T
8-NS,162,3,0,0,1187,1190,C
8-NS,163,1186,0,1,0,1187,A
8-NS,164,1189,0,0,0,1189,A
8-NS,165,1180,1,0,0,1181,A
8-NS,166,0,0,1181,0,1181,G
8-NS,167,0,0,0,1191,1191,C
8-NS,168,1174,0,2,0,1176,A
8-NS,169,0,5,1180,0,1185,G
8-NS,170,0,2,0,1180,1182,C
8-NS,171,5,2,0,1177,1184,C
8-NS,172,1183,0,3,0,1186,A
8-NS,173,0,0,0,1216,1216,C
8-NS,174,4,0,0,1212,1216,C
8-NS,175,5,0,0,1206,1211,C
8-NS,176,1228,2,0,0,1230,A
8-NS,177,0,1232,0,0,1232,T
8-NS,178,0,0,1228,0,1228,G
8-NS,179,0,1225,1,3,1229,T
8-NS,180,1,1226,0,0,1227,T
8-NS,181,0,3,1224,1,1228,G
8-NS,182,0,6,1214,0,1220,G
8-NS,183,1217,0,2,0,1219,A
8-NS,184,1217,0,1,1,1219,A
8-NS,185,1205,0,2,0,1207,A
8-NS,186,0,0,1210,0,1210,G
8-NS,187,1,1,0,1210,1212,C
8-NS,188,1209,0,0,0,1209,A
8-NS,189,1211,0,0,0,1211,A
8-NS,190,1206,0,0,0,1206,A
8-NS,191,0,1217,0,1,1218,T
8-NS,192,0,1217,0,0,1217,T
8-NS,193,0,0,1248,0,1248,G
8-NS,194,1,1245,0,0,1246,T
8-NS,195,1235,0,1,0,1236,A
8-NS,196,0,6,1228,1,1235,G
8-NS,197,1235,0,0,0,1235,A
8-NS,198,1229,0,1,0,1230,A
8-NS,199,1236,0,0,0,1236,A
8-NS,200,1220,0,4,0,1224,A
8-NS,201,0,1,1233,0,1234,G
8-NS,202,1228,0,0,0,1228,A
8-NS,203,0,1226,0,0,1226,T
8-NS,204,0,1222,1,2,1225,T
8-NS,205,5,0,0,1226,1231,C
8-NS,206,0,1226,0,3,1229,T
8-NS,207,0,6,1229,0,1235,G
8-NS,208,1235,0,0,0,1235,A
8-NS,209,1231,1,0,0,1232,A
8-NS,210,1231,0,2,0,1233,A
8-NS,211,6,3,1228,0,1237,G
8-NS,212,1233,0,0,0,1233,A
8-NS,213,1239,0,2,0,1241,A
8-NS,214,0,7,1245,0,1252,G
8-NS,215,1250,1,2,0,1253,A
8-NS,216,1257,1,0,0,1258,A
8-NS,217,0,1251,0,1,1252,T
8-NS,218,3,0,0,1264,1267,C
8-NS,219,0,1261,0,2,1263,T
8-NS,220,0,5,1267,0,1272,G
8-NS,221,1267,0,1,0,1268,A
8-NS,222,0,1271,0,1,1272,T
8-NS,223,0,2,1261,0,1263,G
8-NS,224,1242,0,3,0,1245,A
8-NS,225,0,3,1242,1,1246,G
8-NS,226,1,1,1240,0,1242,G
8-NS,227,1,1,0,1239,1241,C
8-NS,228,1245,0,0,0,1245,A
8-NS,229,0,1,0,1274,1275,C
8-NS,230,1,1278,0,0,1279,T
8-NS,231,0,1288,0,0,1288,T
8-NS,232,1289,0,0,0,1289,A
8-NS,233,1290,0,0,0,1290,A
8-NS,234,1289,1,1,0,1291,A
8-NS,235,1282,1,2,0,1285,A
8-NS,236,0,1287,0,0,1287,T
8-NS,237,0,22,1264,0,1286,G
8-NS,238,1276,0,4,0,1280,A
8-NS,239,0,0,0,1280,1280,C
8-NS,240,6,3,1,1264,1274,C
8-NS,241,1269,1,1,0,1271,A
8-NS,242,0,1269,0,2,1271,T
8-NS,243,1,5,1283,0,1289,G
8-NS,244,0,0,1313,0,1313,G
8-NS,245,0,1307,0,4,1311,T
8-NS,246,8,0,0,1367,1375,C
8-NS,247,0,1362,0,3,1365,T
8-NS,248,5,1,0,1385,1391,C
8-NS,249,3,0,0,1386,1389,C
8-NS,250,1380,0,1,12,1393,A
8-NS,251,0,1,0,1403,1404,C
8-NS,252,1375,0,2,0,1377,A
8-NS,253,0,0,0,1374,1374,C
8-NS,254,5,0,0,1358,1363,C
8-NS,255,0,1298,0,4,1302,T
8-NS,256,1,0,1303,0,1304,G
8-NS,257,0,0,0,1309,1309,C
8-NS,258,0,1288,0,4,1292,T
8-NS,259,0,1309,0,3,1312,T
8-NS,260,4,1,0,1299,1304,C
8-NS,261,0,2,1309,1,1312,G
8-NS,262,2,1,0,1307,1310,C
8-NS,263,1,6,1301,0,1308,G
8-NS,264,1368,0,2,0,1370,A
8-NS,265,0,1358,0,1,1359,T
8-NS,266,1392,0,1,0,1393,A
8-NS,267,0,0,0,1405,1405,C
8-NS,268,1387,0,8,0,1395,A
8-NS,269,0,1435,0,0,1435,T
8-NS,270,1417,0,1,0,1418,A
8-NS,271,1422,1,3,0,1426,A
8-NS,272,0,0,0,1429,1429,C
8-NS,273,1,1379,0,0,1380,T
8-NS,274,2,14,1379,0,1395,G
8-NS,275,1360,2,2,0,1364,A
8-NS,276,1,1,0,1369,1371,C
8-NS,277,1360,0,1,0,1361,A
8-NS,278,0,1339,0,2,1341,T
8-NS,279,2,12,1332,1,1347,G
8-NS,280,1344,1,1,0,1346,A
8-NS,281,0,8,0,1385,1393,C
8-NS,282,0,1388,0,1,1389,T
8-NS,283,1399,0,0,0,1399,A
8-NS,284,0,1401,0,0,1401,T
8-NS,285,0,1388,0,0,1388,T
8-NS,286,0,5,1382,0,1387,G
8-NS,287,1384,0,1,0,1385,A
8-NS,288,0,3,1381,0,1384,G
8-NS,289,0,7,1379,0,1386,G
8-NS,290,1344,1,0,0,1345,A
8-NS,291,1352,0,1,0,1353,A
8-NS,292,1,1324,0,0,1325,T
8-NS,293,0,1332,0,0,1332,T
8-NS,294,1,0,1348,0,1349,G
8-NS,295,2,1338,0,2,1342,T
8-NS,296,12,0,0,1330,1342,C
8-NS,297,1340,0,1,0,1341,A
8-NS,298,1340,0,1,1,1342,A
8-NS,299,0,11,1331,0,1342,G
8-NS,300,1344,0,1,1,1346,A
8-NS,301,1347,0,3,0,1350,A
8-NS,302,1346,2,0,0,1348,A
8-NS,303,0,0,0,1352,1352,C
8-NS,304,0,1329,0,0,1329,T
8-NS,305,0,7,1350,0,1357,G
8-NS,306,0,0,1374,0,1374,G
8-NS,307,0,1373,0,0,1373,T
8-NS,308,0,1372,0,0,1372,T
8-NS,309,10,0,0,1347,1357,C
8-NS,310,1363,0,1,0,1364,A
8-NS,311,0,1393,0,2,1395,T
8-NS,312,0,3,1411,0,1414,G
8-NS,313,2,0,0,1426,1428,C
8-NS,314,0,1411,0,1,1412,T
8-NS,315,1381,0,4,1,1386,A
8-NS,316,1387,0,27,0,1414,A
8-NS,317,0,1423,0,0,1423,T
8-NS,318,1,1,1423,0,1425,G
8-NS,319,11,0,0,1409,1420,C
8-NS,320,2,0,0,1396,1398,C
8-NS,321,5,0,0,1381,1386,C
8-NS,322,1375,1,1,0,1377,A
8-NS,323,1380,1,0,0,1381,A
8-NS,324,0,0,1389,0,1389,G
8-NS,325,1,0,0,1389,1390,C
8-NS,326,1379,0,3,0,1382,A
8-NS,327,0,4,1389,0,1393,G
8-NS,328,1389,1,1,0,1391,A
8-NS,329,1390,0,2,0,1392,A
8-NS,330,1386,0,2,0,1388,A
8-NS,331,1376,0,0,0,1376,A
8-NS,332,0,1406,0,0,1406,T
8-NS,333,0,3,1401,0,1404,G
8-NS,334,0,8,1405,0,1413,G
8-NS,335,1408,0,3,0,1411,A
8-NS,336,1397,1,2,0,1400,A
8-NS,337,0,3,1400,0,1403,G
8-NS,338,0,10,1399,0,1409,G
8-NS,339,1406,0,2,0,1408,A
8-NS,340,1,0,0,1416,1417,C
8-NS,341,2,0,0,1409,1411,C
8-NS,342,1,1406,0,1,1408,T
8-NS,343,4,1,0,1433,1438,C
8-NS,344,0,1434,0,0,1434,T
8-NS,345,0,1438,1,1,1440,T
8-NS,346,0,1434,0,1,1435,T
8-NS,347,0,1,1431,0,1432,G
8-NS,348,2,1,0,1447,1450,C
8-NS,349,1433,0,1,0,1434,A
8-NS,350,0,1437,0,0,1437,T
8-NS,351,3,1,0,1430,1434,C
8-NS,352,1443,0,1,0,1444,A
8-NS,353,0,7,1474,0,1481,G
8-NS,354,1476,0,1,0,1477,A
8-NS,355,1479,0,1,0,1480,A
8-NS,356,0,1476,0,0,1476,T
8-NS,357,0,7,1450,1,1458,G
8-NS,358,1,8,1465,0,1474,G
8-NS,359,1471,0,1,0,1472,A
8-NS,360,0,0,0,1468,1468,C
8-NS,361,3,0,0,1438,1441,C
8-NS,362,1418,0,1,0,1419,A
8-NS,363,2,6,1424,0,1432,G
8-NS,364,0,0,1433,0,1433,G
8-NS,365,2,1,0,1431,1434,C
8-NS,366,1420,1,2,0,1423,A
8-NS,367,1429,1,2,0,1432,A
8-NS,368,0,1432,0,1,1433,T
8-NS,369,6,0,0,1424,1430,C
8-NS,370,1429,0,2,0,1431,A
8-NS,371,0,1424,0,0,1424,T
8-NS,372,0,3,1405,0,1408,G
8-NS,373,0,4,1414,0,1418,G
8-NS,374,1404,0,6,0,1410,A
8-NS,375,2,8,1417,0,1427,G
8-NS,376,1409,0,2,0,1411,A
8-NS,377,1418,0,1,0,1419,A
8-NS,378,1418,0,2,0,1420,A
8-NS,379,1418,0,0,0,1418,A
8-NS,380,1424,0,1,0,1425,A
8-NS,381,0,1,0,1432,1433,C
8-NS,382,1420,0,2,0,1422,A
8-NS,383,0,1418,0,0,1418,T
8-NS,384,6,1,0,1390,1397,C
8-NS,385,1399,0,2,0,1401,A
8-NS,386,0,1409,0,3,1412,T
8-NS,387,0,0,1411,0,1411,G
8-NS,388,0,1414,0,2,1416,T
8-NS,389,1,1401,0,0,1402,T
8-NS,390,0,11,1386,0,1397,G
8-NS,391,1396,0,2,0,1398,A
8-NS,392,1394,0,1,1,1396,A
8-NS,393,1398,0,1,0,1399,A
8-NS,394,0,1,1398,0,1399,G
8-NS,395,1,1,0,1391,1393,C
8-NS,396,1,17,1378,0,1396,G
8-NS,397,1389,0,2,0,1391,A
8-NS,398,1391,0,0,0,1391,A
8-NS,399,0,1386,0,0,1386,T
8-NS,400,0,1392,1,2,1395,T
8-NS,401,0,1396,0,1,1397,T
8-NS,402,9,1,0,1390,1400,C
8-NS,403,1375,1,4,0,1380,A
8-NS,404,0,0,1388,0,1388,G
8-NS,405,0,1384,0,1,1385,T
8-NS,406,0,2,1384,0,1386,G
8-NS,407,1,1379,0,1,1381,T
8-NS,408,0,8,1374,1,1383,G
8-NS,409,1388,1,1,0,1390,A
8-NS,410,2,1386,0,1,1389,T
8-NS,411,0,1384,0,2,1386,T
8-NS,412,0,1382,0,0,1382,T
8-NS,413,0,1379,0,2,1381,T
8-NS,414,0,1373,0,2,1375,T
8-NS,415,0,22,1353,0,1375,G
8-NS,416,1376,0,0,0,1376,A
8-NS,417,0,0,0,1376,1376,C
8-NS,418,6,1,0,1347,1354,C
8-NS,419,1,9,1359,1,1370,G
8-NS,420,1450,1,2,0,1453,A
8-NS,421,0,0,1,1477,1478,C
8-NS,422,0,1478,0,0,1478,T
8-NS,423,1478,1,2,0,1481,A
8-NS,424,0,6,1475,0,1481,G
8-NS,425,1476,0,3,0,1479,A
8-NS,426,0,3,1494,0,1497,G
8-NS,427,1489,0,4,0,1493,A
8-NS,428,0,0,1,1545,1546,C
8-NS,429,3,2,0,1482,1487,C
8-NS,430,1453,0,1,0,1454,A
8-NS,431,1,1536,0,1,1538,T
8-NS,432,1526,0,1,0,1527,A
8-NS,433,0,1,1667,0,1668,G
8-NS,434,0,1669,0,1,1670,T
8-NS,435,1652,0,3,0,1655,A
8-NS,436,0,1653,0,2,1655,T
8-NS,437,0,1622,0,1,1623,T
8-NS,438,1673,0,0,0,1673,A
8-NS,439,0,0,0,1674,1674,C
8-NS,440,2,1608,0,1,1611,T
8-NS,441,1603,0,1,0,1604,A
8-NS,442,1465,0,1,0,1466,A
8-NS,443,0,5,1478,0,1483,G
8-NS,444,0,6,1472,0,1478,G
8-NS,445,0,1,1482,0,1483,G
8-NS,446,0,1,0,1469,1470,C
8-NS,447,0,1423,0,9,1432,T
8-NS,448,0,1429,1,1,1431,T
8-NS,449,1,1452,0,3,1456,T
8-NS,450,8,2,0,1453,1463,C
8-NS,451,1480,0,3,0,1483,A
8-NS,452,1,1,0,1478,1480,C
8-NS,453,4,20,0,1440,1464,C
8-NS,454,0,3,1460,0,1463,G
8-NS,455,1461,1,0,0,1462,A
8-NS,456,1464,0,1,0,1465,A
8-NS,457,0,5,1463,1,1469,G
8-NS,458,1447,0,1,0,1448,A
8-NS,459,0,3,1453,0,1456,G
8-NS,460,0,2,1428,0,1430,G
8-NS,461,1,5,1441,0,1447,G
8-NS,462,1436,0,4,0,1440,A
8-NS,463,0,1,1451,0,1452,G
8-NS,464,0,0,0,1450,1450,C
8-NS,465,1448,0,0,0,1448,A
8-NS,466,1452,0,0,0,1452,A
8-NS,467,0,1452,0,1,1453,T
8-NS,468,0,1446,0,0,1446,T
8-NS,469,0,0,1449,0,1449,G
8-NS,470,1,1432,0,3,1436,T
8-NS,471,0,1433,0,0,1433,T
8-NS,472,0,7,1433,0,1440,G
8-NS,473,1,2,1436,0,1439,G
8-NS,474,1,3,0,1436,1440,C
8-NS,475,0,5,1433,0,1438,G
8-NS,476,1442,0,0,0,1442,A
8-NS,477,1452,1,2,0,1455,A
8-NS,478,1461,1,1,0,1463,A
8-NS,479,0,1464,0,1,1465,T
8-NS,480,10,1,0,1456,1467,C
8-NS,481,0,1457,0,1,1458,T
8-NS,482,12,0,0,1457,1469,C
8-NS,483,1472,0,3,0,1475,A
8-NS,484,0,0,0,1478,1478,C
8-NS,485,7,1,0,1466,1474,C
8-NS,486,1467,0,0,0,1467,A
8-NS,487,0,1462,0,2,1464,T
8-NS,488,1,1448,0,1,1450,T
8-NS,489,0,1,1457,0,1458,G
8-NS,490,1,2,0,1458,1461,C
8-NS,491,4,0,1,1452,1457,C
8-NS,492,0,1452,0,2,1454,T
8-NS,493,0,1446,0,3,1449,T
8-NS,494,2,0,0,1461,1463,C
8-NS,495,0,1453,0,3,1456,T
8-NS,496,0,1460,0,1,1461,T
8-NS,497,0,1473,0,6,1479,T
8-NS,498,0,1473,0,0,1473,T
8-NS,499,2,0,0,1472,1474,C
8-NS,500,3,0,0,1471,1474,C
8-NS,501,1468,0,2,0,1470,A
8-NS,502,1,5,1483,0,1489,G
8-NS,503,0,7,1481,0,1488,G
8-NS,504,1505,0,2,0,1507,A
8-NS,505,1,1,0,1504,1506,C
8-NS,506,1521,0,0,0,1521,A
8-NS,507,0,1530,0,1,1531,T
8-NS,508,1536,0,2,0,1538,A
8-NS,509,0,2,0,1651,1653,C
8-NS,510,1,1644,0,2,1647,T
8-NS,511,1648,0,1,0,1649,A
8-NS,512,0,1635,0,10,1645,T
8-NS,513,0,1588,0,0,1588,T
8-NS,514,3,5,1581,0,1589,G
8-NS,515,1532,0,2,0,1534,A
8-NS,516,0,6,1529,0,1535,G
8-NS,517,0,1,1521,0,1522,G
8-NS,518,1391,0,0,0,1391,A
8-NS,519,0,1393,0,1,1394,T
8-NS,520,1,0,1405,0,1406,G
8-NS,521,0,1400,0,1,1401,T
8-NS,522,16,1,0,1387,1404,C
8-NS,523,1401,0,0,0,1401,A
8-NS,524,1392,2,2,0,1396,A
8-NS,525,1401,0,0,0,1401,A
8-NS,526,1397,0,2,0,1399,A
8-NS,527,1408,0,0,0,1408,A
8-NS,528,0,1406,0,0,1406,T
8-NS,529,1,1,1403,0,1405,G
8-NS,530,2,1,0,1407,1410,C
8-NS,531,1409,1,1,0,1411,A
8-NS,532,1417,0,0,0,1417,A
8-NS,533,0,1421,0,0,1421,T
8-NS,534,0,1421,0,2,1423,T
8-NS,535,9,7,1403,0,1419,G
8-NS,536,0,8,1406,0,1414,G
8-NS,537,15,2,1397,0,1414,G
8-NS,538,1,0,1418,0,1419,G
8-NS,539,0,1398,0,4,1402,T
8-NS,540,7,0,1,1412,1420,C
8-NS,541,3,0,0,1412,1415,C
8-NS,542,0,1415,0,0,1415,T
8-NS,543,6,0,0,1422,1428,C
8-NS,544,1421,0,0,0,1421,A
8-NS,545,0,1422,0,0,1422,T
8-NS,546,7,2,0,1417,1426,C
8-NS,547,0,2,1412,0,1414,G
8-NS,548,0,3,1414,0,1417,G
8-NS,549,1392,0,2,0,1394,A
8-NS,550,0,5,1387,0,1392,G
8-NS,551,0,8,1385,0,1393,G
8-NS,552,1385,0,2,0,1387,A
8-NS,553,0,1,0,1400,1401,C
8-NS,554,1,1397,0,1,1399,T
8-NS,555,0,1398,0,1,1399,T
8-NS,556,0,7,1396,0,1403,G
8-NS,557,1391,1,2,0,1394,A
8-NS,558,1393,0,2,0,1395,A
8-NS,559,0,1392,0,0,1392,T
8-NS,560,1,5,1366,0,1372,G
8-NS,561,0,8,1380,0,1388,G
8-NS,562,1374,0,2,0,1376,A
8-NS,563,1377,5,1,0,1383,A
8-NS,564,0,1450,0,1,1451,T
8-NS,565,0,7,1460,0,1467,G
8-NS,566,1470,0,0,0,1470,A
8-NS,567,0,1471,0,0,1471,T
8-NS,568,1469,0,1,0,1470,A
8-NS,569,1478,0,1,0,1479,A
8-NS,570,0,1,0,1470,1471,C
8-NS,571,1447,0,3,0,1450,A
8-NS,572,0,1,0,1461,1462,C
8-NS,573,1362,0,0,0,1362,A
8-NS,574,0,1,1384,0,1385,G
8-NS,575,0,1371,0,3,1374,T
8-NS,576,1,1376,0,0,1377,T
8-NS,577,20,0,0,1350,1370,C
8-NS,578,1,5,1360,0,1366,G
8-NS,579,1359,0,1,0,1360,A
8-NS,580,1,0,1362,0,1363,G
8-NS,581,0,1344,0,2,1346,T
8-NS,582,13,0,0,1339,1352,C
8-NS,583,0,1323,0,4,1327,T
8-NS,584,7,0,0,1331,1338,C
8-NS,585,0,1338,0,2,1340,T
8-NS,586,1339,1,0,0,1340,A
8-NS,587,1339,0,0,0,1339,A
8-NS,588,1335,0,1,0,1336,A
8-NS,589,1347,0,2,0,1349,A
8-NS,590,1349,0,0,0,1349,A
8-NS,591,0,1344,0,0,1344,T
8-NS,592,1,1,0,1354,1356,C
8-NS,593,0,1338,0,1,1339,T
8-NS,594,1341,0,0,0,1341,A
8-NS,595,0,0,0,1343,1343,C
8-NS,596,1336,0,3,2,1341,A
8-NS,597,0,7,1338,0,1345,G
8-NS,598,1317,0,2,0,1319,A
8-NS,599,1,7,1317,0,1325,G
8-NS,600,1321,0,3,0,1324,A
8-NS,601,1,1303,0,6,1310,T
8-NS,602,0,1310,0,3,1313,T
8-NS,603,13,0,0,1298,1311,C
8-NS,604,1,3,1301,0,1305,G
8-NS,605,1,0,0,1308,1309,C
8-NS,606,0,1306,0,3,1309,T
8-NS,607,1,1311,0,1,1313,T
8-NS,608,0,2,1300,0,1302,G
8-NS,609,1,4,1308,1,1314,G
8-NS,610,1312,0,2,0,1314,A
8-NS,611,0,3,1312,0,1315,G
8-NS,612,1302,1,0,0,1303,A
8-NS,613,1293,1,2,0,1296,A
8-NS,614,2,0,1308,0,1310,G
8-NS,615,2,1,1,1306,1310,C
8-NS,616,1306,0,4,0,1310,A
8-NS,617,1,1,1337,0,1339,G
8-NS,618,0,1320,0,0,1320,T
8-NS,619,1321,0,0,0,1321,A
8-NS,620,1319,1,2,0,1322,A
8-NS,621,0,1320,0,0,1320,T
8-NS,622,0,11,1315,0,1326,G
8-NS,623,1255,0,4,0,1259,A
8-NS,624,0,7,1276,0,1283,G
8-NS,625,1276,0,2,0,1278,A
8-NS,626,1240,0,2,0,1242,A
8-NS,627,0,1230,0,1,1231,T
8-NS,628,1,2,1210,0,1213,G
8-NS,629,0,1,1218,0,1219,G
8-NS,630,1,2,1212,0,1215,G
8-NS,631,2,2,1203,0,1207,G
8-NS,632,1,1,1207,0,1209,G
8-NS,633,1174,1,1,0,1176,A
8-NS,634,0,1149,0,1,1150,T
8-NS,635,6,4,0,1171,1181,C
8-NS,636,1,1182,0,1,1184,T
8-NS,637,1,0,0,1193,1194,C
8-NS,638,1,3,1,1191,1196,C
8-NS,639,1199,0,2,0,1201,A
8-NS,640,1,0,0,1196,1197,C
8-NS,641,0,1166,1,3,1170,T
8-NS,642,0,1159,0,1,1160,T
8-NS,643,1142,0,1,0,1143,A
8-NS,644,0,0,0,1154,1154,C
8-NS,645,0,1142,0,4,1146,T
8-NS,646,6,9,0,1132,1147,C
8-NS,647,0,2,1,1132,1135,C
8-NS,648,1104,18,0,0,1122,A
8-NS,649,1118,0,1,0,1119,A
8-NS,650,1123,0,0,0,1123,A
8-NS,651,1119,0,1,0,1120,A
8-NS,652,0,1,0,1122,1123,C
8-NS,653,1070,0,0,0,1070,A
8-NS,654,1,2,1074,0,1077,G
8-NS,655,1068,0,1,0,1069,A
8-NS,656,1066,0,2,0,1068,A
8-NS,657,1068,1,2,0,1071,A
8-NS,658,0,0,0,1070,1070,C
8-NS,659,0,2,1068,0,1070,G
8-NS,660,0,1,1069,0,1070,G
8-NS,661,0,3,1070,0,1073,G
8-NS,662,1068,0,4,0,1072,A
8-NS,663,1058,0,0,0,1058,A
8-NS,664,1055,0,2,0,1057,A
8-NS,665,0,1053,0,0,1053,T
8-NS,666,0,5,1059,0,1064,G
8-NS,667,0,1,1063,0,1064,G
8-NS,668,0,0,0,1056,1056,C
8-NS,669,1,8,1046,0,1055,G
8-NS,670,1055,0,1,0,1056,A
8-NS,671,1,8,1050,0,1059,G
8-NS,672,1061,0,0,0,1061,A
8-NS,673,1061,0,0,0,1061,A
8-NS,674,1,0,0,1058,1059,C
8-NS,675,1042,0,2,0,1044,A
8-NS,676,0,0,1045,0,1045,G
8-NS,677,0,0,0,1043,1043,C
8-NS,678,0,1037,0,1,1038,T
8-NS,679,1032,0,2,1,1035,A
8-NS,680,0,0,1026,0,1026,G
8-NS,681,1,0,1030,0,1031,G
8-NS,682,0,1024,0,2,1026,T
8-NS,683,13,2,0,995,1010,C
8-NS,684,999,1,0,0,1000,A
8-NS,685,1014,0,0,0,1014,A
8-NS,686,1012,2,0,0,1014,A
8-NS,687,1017,0,1,0,1018,A
8-NS,688,0,0,1024,0,1024,G
8-NS,689,0,992,0,1,993,T
8-NS,690,0,987,0,1,988,T
8-NS,691,0,985,0,0,985,T
8-NS,692,0,11,976,0,987,G
8-NS,693,988,0,1,0,989,A
8-NS,694,992,0,1,0,993,A
8-NS,695,0,2,1001,0,1003,G
8-NS,696,975,0,1,0,976,A
8-NS,697,0,1,974,0,975,G
8-NS,698,979,0,0,0,979,A
8-NS,699,0,977,0,2,979,T
8-NS,700,974,2,0,0,976,A
8-NS,701,970,1,1,0,972,A
8-NS,702,0,1,970,0,971,G
8-NS,703,920,0,1,0,921,A
8-NS,704,0,921,0,1,922,T
8-NS,705,1,3,925,0,929,G
8-NS,706,0,0,929,1,930,G
8-NS,707,1,0,0,923,924,C
8-NS,708,0,919,1,0,920,T
8-NS,709,919,0,0,0,919,A
8-NS,710,917,0,0,1,918,A
8-NS,711,0,918,0,1,919,T
8-NS,712,1,915,0,1,917,T
8-NS,713,0,3,919,0,922,G
8-NS,714,909,0,0,0,909,A
8-NS,715,906,0,3,0,909,A
8-NS,716,0,1,908,0,909,G
8-NS,717,912,0,0,0,912,A
8-NS,718,897,0,2,0,899,A
8-NS,719,0,0,912,0,912,G
8-NS,720,0,898,0,3,901,T
8-NS,721,0,7,896,1,904,G
8-NS,722,891,0,3,2,896,A
8-NS,723,0,4,893,0,897,G
8-NS,724,894,1,3,0,898,A
8-NS,725,1,1,0,884,886,C
8-NS,726,884,0,0,0,884,A
8-NS,727,0,2,0,879,881,C
8-NS,728,810,0,1,1,812,A
8-NS,729,0,2,832,0,834,G
8-NS,730,828,1,0,0,829,A
8-NS,731,0,820,0,3,823,T
8-NS,732,0,822,0,0,822,T
8-NS,733,816,0,0,0,816,A
8-NS,734,814,0,1,0,815,A
8-NS,735,811,0,0,0,811,A
8-NS,736,813,0,1,0,814,A
8-NS,737,813,0,0,0,813,A
8-NS,738,0,0,0,782,782,C
8-NS,739,749,0,0,0,749,A
8-NS,740,750,0,0,0,750,A
8-NS,741,0,0,0,750,750,C
8-NS,742,0,745,0,0,745,T
8-NS,743,1,2,750,0,753,G
8-NS,744,751,0,1,0,752,A
8-NS,745,752,0,0,0,752,A
8-NS,746,752,0,0,0,752,A
8-NS,747,741,2,0,0,743,A
8-NS,748,0,741,0,0,741,T
8-NS,749,718,0,2,2,722,A
8-NS,750,0,1,727,0,728,G
8-NS,751,1,0,0,731,732,C
8-NS,752,0,719,0,1,720,T
8-NS,753,0,720,0,0,720,T
8-NS,754,0,711,0,0,711,T
8-NS,755,1,4,706,2,713,G
8-NS,756,714,0,1,0,715,A
8-NS,757,715,0,0,0,715,A
8-NS,758,0,0,0,714,714,C
8-NS,759,703,0,0,0,703,A
8-NS,760,704,0,1,0,705,A
8-NS,761,707,0,0,0,707,A
8-NS,762,0,706,0,0,706,T
8-NS,763,703,0,1,0,704,A
8-NS,764,693,1,2,0,696,A
8-NS,765,0,0,0,696,696,C
8-NS,766,689,0,1,0,690,A
8-NS,767,0,684,0,0,684,T
8-NS,768,1,667,0,0,668,T
8-NS,769,6,0,0,656,662,C
8-NS,770,660,0,0,0,660,A
8-NS,771,0,652,0,2,654,T
8-NS,772,1,3,654,0,658,G
8-NS,773,0,1,0,641,642,C
8-NS,774,633,0,0,0,633,A
8-NS,775,635,0,0,0,635,A
8-NS,776,0,1,626,0,627,G
8-NS,777,0,0,0,637,637,C
8-NS,778,623,0,0,0,623,A
8-NS,779,0,618,0,0,618,T
8-NS,780,0,617,0,0,617,T
8-NS,781,617,0,0,0,617,A
8-NS,782,1,0,0,619,620,C
8-NS,783,613,0,1,0,614,A
8-NS,784,610,0,0,0,610,A
8-NS,785,0,0,0,607,607,C
8-NS,786,0,532,0,0,532,T
8-NS,787,1,0,529,0,530,G
8-NS,788,0,0,0,525,525,C
8-NS,789,0,510,0,1,511,T
8-NS,790,1,0,510,0,511,G
8-NS,791,0,503,0,1,504,T
8-NS,792,0,503,0,0,503,T
8-NS,793,0,504,0,0,504,T
8-NS,794,1,2,495,0,498,G
8-NS,795,492,2,4,0,498,A
8-NS,796,482,0,0,0,482,A
8-NS,797,1,1,479,0,481,G
8-NS,798,0,476,0,0,476,T
8-NS,799,0,2,450,0,452,G
8-NS,800,0,2,452,0,454,G
8-NS,801,453,0,0,0,453,A
8-NS,802,452,2,0,0,454,A
8-NS,803,0,1,0,453,454,C
8-NS,804,427,0,4,0,431,A
8-NS,805,0,0,431,0,431,G
8-NS,806,0,1,425,0,426,G
8-NS,807,416,0,1,0,417,A
8-NS,808,0,1,417,0,418,G
8-NS,809,349,0,1,0,350,A
8-NS,810,0,349,0,0,349,T
8-NS,811,350,0,0,0,350,A
8-NS,812,347,0,1,0,348,A
8-NS,813,0,4,344,0,348,G
8-NS,814,307,0,1,0,308,A
8-NS,815,305,0,2,0,307,A
8-NS,816,0,0,0,301,301,C
8-NS,817,1,261,0,0,262,T
8-NS,818,0,257,0,0,257,T
8-NS,819,0,256,0,0,256,T
8-NS,820,0,0,1,256,257,C
8-NS,821,0,255,0,0,255,T
8-NS,822,4,0,0,247,251,C
8-NS,823,241,1,0,0,242,A
8-NS,824,0,237,0,2,239,T
8-NS,825,0,236,1,0,237,T
8-NS,826,1,236,0,1,238,T
8-NS,827,2,0,0,234,236,C
8-NS,828,229,1,0,0,230,A
8-NS,829,1,1,227,0,229,G
8-NS,830,0,0,0,228,228,C
8-NS,831,0,214,0,0,214,T
8-NS,832,0,212,0,0,212,T
8-NS,833,208,0,0,0,208,A
8-NS,834,0,208,0,0,208,T
8-NS,835,0,208,0,0,208,T
8-NS,836,0,208,0,0,208,T
8-NS,837,197,0,0,0,197,A
8-NS,838,194,0,0,0,194,A
8-NS,839,0,189,0,0,189,T
8-NS,840,0,1,185,0,186,G
8-NS,841,180,0,0,0,180,A
8-NS,842,0,157,0,0,157,T
8-NS,843,154,0,0,0,154,A
8-NS,844,155,0,0,0,155,A
8-NS,845,155,0,0,0,155,A
8-NS,846,153,0,1,0,154,A
8-NS,847,150,0,0,0,150,A
8-NS,848,150,0,0,0,150,A
8-NS,849,0,0,0,149,149,C
8-NS,850,132,0,0,0,132,A
8-NS,851,0,0,0,132,132,C
8-NS,852,0,0,0,127,127,C
8-NS,853,2,0,0,123,125,C
8-NS,854,0,120,0,0,120,T
8-NS,855,0,115,0,0,115,T
8-NS,856,0,0,114,0,114,G
8-NS,857,0,112,0,0,112,T
8-NS,858,0,110,0,0,110,T
8-NS,859,0,109,0,0,109,T
8-NS,860,0,0,0,39,39,C
8-NS,861,0,29,0,0,29,T
8-NS,862,22,0,0,0,22,A
8-NS,863,0,0,0,22,22,C
