Gene,Position,A,T,G,C,Coverage,Consensus
1-PB2,1,914,0,0,0,914,A
1-PB2,2,0,912,0,0,912,T
1-PB2,3,0,0,938,0,938,G
1-PB2,4,0,0,940,0,940,G
1-PB2,5,936,0,0,0,936,A
1-PB2,6,938,0,1,0,939,A
1-PB2,7,937,0,1,0,938,A
1-PB2,8,0,0,1062,0,1062,G
1-PB2,9,1060,0,1,0,1061,A
1-PB2,10,1070,0,1,0,1071,A
1-PB2,11,0,1098,0,1,1099,T
1-PB2,12,1097,0,1,0,1098,A
1-PB2,13,1097,1,0,0,1098,A
1-PB2,14,1099,0,0,0,1099,A
1-PB2,15,1097,0,3,0,1100,A
1-PB2,16,0,0,1140,0,1140,G
1-PB2,17,1140,0,1,0,1141,A
1-PB2,18,1148,0,1,0,1149,A
1-PB2,19,0,0,0,1169,1169,C
1-PB2,20,0,1170,0,1,1171,T
1-PB2,21,1188,0,1,0,1189,A
1-PB2,22,0,1,0,1191,1192,C
1-PB2,23,0,1,1194,0,1195,G
1-PB2,24,0,1,1211,0,1212,G
1-PB2,25,1209,0,0,0,1209,A
1-PB2,26,1246,0,0,0,1246,A
1-PB2,27,0,1245,0,2,1247,T
1-PB2,28,1,0,0,1253,1254,C
1-PB2,29,0,1254,0,1,1255,T
1-PB2,30,2,3,1255,0,1260,G
1-PB2,31,1256,0,0,1,1257,A
1-PB2,32,0,1268,0,0,1268,T
1-PB2,33,1,1,1268,0,1270,G
1-PB2,34,0,1296,0,1,1297,T
1-PB2,35,0,2,0,1278,1280,C
1-PB2,36,0,0,1287,0,1287,G
1-PB2,37,0,0,0,1285,1285,C
1-PB2,38,1287,0,0,0,1287,A
1-PB2,39,0,0,1346,0,1346,G
1-PB2,40,0,1341,0,2,1343,T
1-PB2,41,1,0,0,1341,1342,C
1-PB2,42,0,1324,0,2,1326,T
1-PB2,43,1,1,0,1345,1347,C
1-PB2,44,1,2,1340,0,1343,G
1-PB2,45,0,1,0,1345,1346,C
1-PB2,46,1340,1,2,1,1344,A
1-PB2,47,0,0,0,1361,1361,C
1-PB2,48,0,1333,0,2,1335,T
1-PB2,49,0,1,0,1367,1368,C
1-PB2,50,0,0,1368,0,1368,G
1-PB2,51,0,0,0,1372,1372,C
1-PB2,52,0,3,1367,0,1370,G
1-PB2,53,1356,0,2,0,1358,A
1-PB2,54,0,0,1371,0,1371,G
1-PB2,55,1410,0,3,0,1413,A
1-PB2,56,0,1412,0,0,1412,T
1-PB2,57,1412,0,0,0,1412,A
1-PB2,58,0,1,0,1403,1404,C
1-PB2,59,0,1394,0,2,1396,T
1-PB2,60,2,2,1430,0,1434,G
1-PB2,61,1437,0,2,0,1439,A
1-PB2,62,0,0,0,1451,1451,C
1-PB2,63,1447,0,1,0,1448,A
1-PB2,64,1440,1,0,0,1441,A
1-PB2,65,1441,0,4,0,1445,A
1-PB2,66,1459,0,2,0,1461,A
1-PB2,67,1465,0,0,2,1467,A
1-PB2,68,0,0,0,1488,1488,C
1-PB2,69,1,1,0,1478,1480,C
1-PB2,70,1510,0,0,0,1510,A
1-PB2,71,0,0,0,1522,1522,C
1-PB2,72,1511,0,1,0,1512,A
1-PB2,73,1,1,1557,0,1559,G
1-PB2,74,0,1548,0,0,1548,T
1-PB2,75,0,2,1579,0,1581,G
1-PB2,76,0,0,1583,0,1583,G
1-PB2,77,1576,0,3,0,1579,A
1-PB2,78,0,1,0,1647,1648,C
1-PB2,79,2,0,0,1627,1629,C
1-PB2,80,1645,0,0,0,1645,A
1-PB2,81,0,1652,0,0,1652,T
1-PB2,82,1624,1,1,1,1627,A
1-PB2,83,0,1622,0,0,1622,T
1-PB2,84,0,2,1606,0,1608,G
1-PB2,85,1,0,1621,1,1623,G
1-PB2,86,0,2,1,1613,1616,C
1-PB2,87,1,2,0,1578,1581,C
1-PB2,88,1569,0,2,0,1571,A
1-PB2,89,0,1699,0,1,1700,T
1-PB2,90,1710,0,0,0,1710,A
1-PB2,91,1792,0,0,0,1792,A
1-PB2,92,0,1791,1,0,1792,T
1-PB2,93,0,1779,0,3,1782,T
1-PB2,94,1795,1,0,0,1796,A
1-PB2,95,1792,0,1,0,1793,A
1-PB2,96,2,2,1837,0,1841,G
1-PB2,97,1829,1,3,0,1833,A
1-PB2,98,1781,0,0,0,1781,A
1-PB2,99,0,0,1859,0,1859,G
1-PB2,100,0,1821,0,3,1824,T
1-PB2,101,1820,0,0,0,1820,A
1-PB2,102,1,0,0,1829,1830,C
1-PB2,103,1821,0,4,0,1825,A
1-PB2,104,1,0,0,1871,1872,C
1-PB2,105,1846,1,1,0,1848,A
1-PB2,106,0,1838,1,1,1840,T
1-PB2,107,1,0,0,1853,1854,C
1-PB2,108,3,6,1820,0,1829,G
1-PB2,109,1,3,1827,0,1831,G
1-PB2,110,0,0,1821,1,1822,G
1-PB2,111,0,1,1826,0,1827,G
1-PB2,112,1809,0,4,0,1813,A
1-PB2,113,0,1,1801,0,1802,G
1-PB2,114,1794,0,4,0,1798,A
1-PB2,115,0,2,0,1814,1816,C
1-PB2,116,1808,0,4,0,1812,A
1-PB2,117,0,1,1834,0,1835,G
1-PB2,118,0,0,1862,0,1862,G
1-PB2,119,1855,2,2,0,1859,A
1-PB2,120,1859,0,2,0,1861,A
1-PB2,121,1862,0,3,0,1865,A
1-PB2,122,1845,0,2,2,1849,A
1-PB2,123,0,0,1863,0,1863,G
1-PB2,124,1832,0,2,0,1834,A
1-PB2,125,1843,0,4,0,1847,A
1-PB2,126,1,1,0,1834,1836,C
1-PB2,127,2,3,0,1810,1815,C
1-PB2,128,2,0,0,1811,1813,C
1-PB2,129,1,0,1813,0,1814,G
1-PB2,130,1,1810,0,2,1813,T
1-PB2,131,3,0,0,1817,1820,C
1-PB2,132,1842,0,0,0,1842,A
1-PB2,133,0,1,0,1855,1856,C
1-PB2,134,0,1849,0,3,1852,T
1-PB2,135,0,1844,0,1,1845,T
1-PB2,136,1851,0,1,0,1852,A
1-PB2,137,1,1,1886,0,1888,G
1-PB2,138,0,2,1879,0,1881,G
1-PB2,139,1871,1,2,0,1874,A
1-PB2,140,0,1867,0,0,1867,T
1-PB2,141,0,2,1879,0,1881,G
1-PB2,142,1887,1,0,1,1889,A
1-PB2,143,1884,1,3,0,1888,A
1-PB2,144,1896,1,3,0,1900,A
1-PB2,145,0,1905,0,0,1905,T
1-PB2,146,3,2,1894,0,1899,G
1-PB2,147,0,0,1904,0,1904,G
1-PB2,148,1899,1,2,0,1902,A
1-PB2,149,0,1898,0,0,1898,T
1-PB2,150,0,3,1882,0,1885,G
1-PB2,151,1866,1,1,0,1868,A
1-PB2,152,0,1873,0,0,1873,T
1-PB2,153,0,2,1871,0,1873,G
1-PB2,154,0,0,1879,0,1879,G
1-PB2,155,0,1,0,1871,1872,C
1-PB2,156,1860,0,0,1,1861,A
1-PB2,157,1869,0,1,0,1870,A
1-PB2,158,0,1875,0,0,1875,T
1-PB2,159,1,2,1943,0,1946,G
1-PB2,160,1945,0,2,0,1947,A
1-PB2,161,1937,0,1,0,1938,A
1-PB2,162,1945,0,2,0,1947,A
1-PB2,163,0,1928,0,1,1929,T
1-PB2,164,1922,0,0,0,1922,A
1-PB2,165,0,1859,0,1,1860,T
1-PB2,166,0,0,1,1950,1951,C
1-PB2,167,3,2,0,1953,1958,C
1-PB2,168,1971,0,2,0,1973,A
1-PB2,169,1976,0,0,0,1976,A
1-PB2,170,0,1972,0,0,1972,T
1-PB2,171,2,2,1,1962,1967,C
1-PB2,172,1953,0,1,1,1955,A
1-PB2,173,0,1,0,2006,2007,C
1-PB2,174,0,1980,0,2,1982,T
1-PB2,175,0,1,1988,0,1989,G
1-PB2,176,0,0,0,1989,1989,C
1-PB2,177,0,1984,0,2,1986,T
1-PB2,178,1,2,2007,0,2010,G
1-PB2,179,2012,0,0,1,2013,A
1-PB2,180,0,0,1,2036,2037,C
1-PB2,181,2037,0,1,0,2038,A
1-PB2,182,2005,0,1,0,2006,A
1-PB2,183,2004,1,3,0,2008,A
1-PB2,184,2001,0,5,0,2006,A
1-PB2,185,0,7,2068,0,2075,G
1-PB2,186,0,1,2057,0,2058,G
1-PB2,187,2032,1,2,0,2035,A
1-PB2,188,0,2056,0,1,2057,T
1-PB2,189,2040,0,0,0,2040,A
1-PB2,190,2063,0,5,0,2068,A
1-PB2,191,0,0,0,2101,2101,C
1-PB2,192,2085,0,1,0,2086,A
1-PB2,193,1,2,2091,0,2094,G
1-PB2,194,2047,1,1,0,2049,A
1-PB2,195,2038,1,3,0,2042,A
1-PB2,196,2043,0,0,0,2043,A
1-PB2,197,1,2048,0,0,2049,T
1-PB2,198,0,5,2045,0,2050,G
1-PB2,199,0,0,2070,0,2070,G
1-PB2,200,0,2041,0,1,2042,T
1-PB2,201,0,2041,0,2,2043,T
1-PB2,202,2,2,0,2025,2029,C
1-PB2,203,1,0,0,2033,2034,C
1-PB2,204,1,0,2035,0,2036,G
1-PB2,205,0,1,2043,0,2044,G
1-PB2,206,2029,0,3,0,2032,A
1-PB2,207,0,2,2038,0,2040,G
1-PB2,208,2017,0,0,0,2017,A
1-PB2,209,0,1,2068,0,2069,G
1-PB2,210,2068,0,0,0,2068,A
1-PB2,211,2069,0,0,0,2069,A
1-PB2,212,2064,0,5,0,2069,A
1-PB2,213,0,2057,0,0,2057,T
1-PB2,214,0,3,2079,0,2082,G
1-PB2,215,2088,0,3,1,2092,A
1-PB2,216,2088,0,3,0,2091,A
1-PB2,217,0,2,0,2084,2086,C
1-PB2,218,2060,0,1,0,2061,A
1-PB2,219,2073,0,3,0,2076,A
1-PB2,220,1,5,2103,0,2109,G
1-PB2,221,2,1,2137,0,2140,G
1-PB2,222,2136,0,3,0,2139,A
1-PB2,223,1,0,0,2132,2133,C
1-PB2,224,2121,0,3,0,2124,A
1-PB2,225,2128,0,1,0,2129,A
1-PB2,226,2228,1,3,0,2232,A
1-PB2,227,0,1,0,2261,2262,C
1-PB2,228,0,2219,0,2,2221,T
1-PB2,229,2,0,0,2288,2290,C
1-PB2,230,0,2240,0,1,2241,T
1-PB2,231,2253,0,3,0,2256,A
1-PB2,232,0,2253,0,1,2254,T
1-PB2,233,1,3,2253,0,2257,G
1-PB2,234,1,3,2318,0,2322,G
1-PB2,235,2210,0,1,0,2211,A
1-PB2,236,0,1,2235,0,2236,G
1-PB2,237,0,2238,0,1,2239,T
1-PB2,238,2222,0,1,0,2223,A
1-PB2,239,2223,0,0,0,2223,A
1-PB2,240,2218,0,2,0,2220,A
1-PB2,241,2217,0,1,0,2218,A
1-PB2,242,0,2201,0,1,2202,T
1-PB2,243,1,3,2188,0,2192,G
1-PB2,244,2144,0,4,1,2149,A
1-PB2,245,1,0,2170,0,2171,G
1-PB2,246,1,2140,0,1,2142,T
1-PB2,247,1,4,2149,0,2154,G
1-PB2,248,2201,0,2,0,2203,A
1-PB2,249,0,2219,0,2,2221,T
1-PB2,250,0,2,2219,0,2221,G
1-PB2,251,0,1,0,2214,2215,C
1-PB2,252,1,2208,1,1,2211,T
1-PB2,253,0,1,2290,1,2292,G
1-PB2,254,1,2,2287,0,2290,G
1-PB2,255,2313,0,3,0,2316,A
1-PB2,256,1,2305,0,2,2308,T
1-PB2,257,2,0,0,2336,2338,C
1-PB2,258,2325,0,6,0,2331,A
1-PB2,259,0,1,2400,0,2401,G
1-PB2,260,2398,0,3,0,2401,A
1-PB2,261,0,2402,0,0,2402,T
1-PB2,262,2323,0,1,0,2324,A
1-PB2,263,1,3,2396,0,2400,G
1-PB2,264,2360,0,6,0,2366,A
1-PB2,265,0,0,2409,0,2409,G
1-PB2,266,1,2356,0,0,2357,T
1-PB2,267,1,1,2340,0,2342,G
1-PB2,268,2274,0,6,0,2280,A
1-PB2,269,0,2292,0,1,2293,T
1-PB2,270,0,0,2325,0,2325,G
1-PB2,271,0,0,2384,0,2384,G
1-PB2,272,0,2354,0,3,2357,T
1-PB2,273,2344,0,2,0,2346,A
1-PB2,274,0,2297,0,4,2301,T
1-PB2,275,1,0,0,2303,2304,C
1-PB2,276,2349,0,1,0,2350,A
1-PB2,277,0,0,0,2401,2401,C
1-PB2,278,1,0,0,2400,2401,C
1-PB2,279,0,2327,0,4,2331,T
1-PB2,280,0,2292,0,2,2294,T
1-PB2,281,0,2285,0,1,2286,T
1-PB2,282,1,2,2335,0,2338,G
1-PB2,283,2,1,2355,1,2359,G
1-PB2,284,1,1,0,2378,2380,C
1-PB2,285,0,2329,0,4,2333,T
1-PB2,286,1,0,2344,0,2345,G
1-PB2,287,0,2344,0,3,2347,T
1-PB2,288,2347,0,2,0,2349,A
1-PB2,289,2358,0,1,0,2359,A
1-PB2,290,1,0,0,2354,2355,C
1-PB2,291,2321,1,1,0,2323,A
1-PB2,292,0,2317,0,1,2318,T
1-PB2,293,2,2,2297,0,2301,G
1-PB2,294,3,0,2356,0,2359,G
1-PB2,295,1,2337,0,2,2340,T
1-PB2,296,0,0,2332,0,2332,G
1-PB2,297,0,2,2382,0,2384,G
1-PB2,298,2375,1,0,0,2376,A
1-PB2,299,2385,1,1,0,2387,A
1-PB2,300,0,2386,0,0,2386,T
1-PB2,301,2373,0,2,0,2375,A
1-PB2,302,2,0,2422,0,2424,G
1-PB2,303,2385,0,1,0,2386,A
1-PB2,304,2384,1,0,0,2385,A
1-PB2,305,2382,1,3,0,2386,A
1-PB2,306,0,2334,0,0,2334,T
1-PB2,307,0,3,2326,0,2329,G
1-PB2,308,0,2,2314,0,2316,G
1-PB2,309,2320,0,4,0,2324,A
1-PB2,310,0,1,0,2331,2332,C
1-PB2,311,3,1,0,2286,2290,C
1-PB2,312,7,0,0,2276,2283,C
1-PB2,313,2,1,2299,0,2302,G
1-PB2,314,0,2315,0,2,2317,T
1-PB2,315,3,2,2363,0,2368,G
1-PB2,316,2365,0,4,0,2369,A
1-PB2,317,0,0,0,2387,2387,C
1-PB2,318,2377,0,5,0,2382,A
1-PB2,319,2368,0,2,0,2370,A
1-PB2,320,0,1,2453,0,2454,G
1-PB2,321,0,2442,0,1,2443,T
1-PB2,322,2435,0,0,0,2435,A
1-PB2,323,0,0,0,2420,2420,C
1-PB2,324,5,2,2367,0,2374,G
1-PB2,325,0,0,2457,0,2457,G
1-PB2,326,0,2439,0,4,2443,T
1-PB2,327,4,0,0,2464,2468,C
1-PB2,328,6,0,0,2460,2466,C
1-PB2,329,2438,0,3,0,2441,A
1-PB2,330,0,2445,0,1,2446,T
1-PB2,331,0,2445,0,0,2445,T
1-PB2,332,2612,0,1,0,2613,A
1-PB2,333,1,4,0,2603,2608,C
1-PB2,334,1,0,0,2524,2525,C
1-PB2,335,5,0,0,2519,2524,C
1-PB2,336,2493,0,1,0,2494,A
1-PB2,337,2501,0,2,0,2503,A
1-PB2,338,2502,0,0,0,2502,A
1-PB2,339,2480,0,2,0,2482,A
1-PB2,340,2,0,2506,0,2508,G
1-PB2,341,0,2350,0,0,2350,T
1-PB2,342,0,2,2398,0,2400,G
1-PB2,343,0,2394,0,1,2395,T
1-PB2,344,2397,0,1,0,2398,A
1-PB2,345,0,1,0,2394,2395,C
1-PB2,346,2386,0,0,0,2386,A
1-PB2,347,2383,0,0,0,2383,A
1-PB2,348,2326,0,0,0,2326,A
1-PB2,349,2344,0,1,0,2345,A
1-PB2,350,2,0,0,2352,2354,C
1-PB2,351,0,2342,0,1,2343,T
1-PB2,352,0,2354,0,1,2355,T
1-PB2,353,2359,0,0,0,2359,A
1-PB2,354,0,2354,0,2,2356,T
1-PB2,355,0,2351,0,3,2354,T
1-PB2,356,0,2353,0,0,2353,T
1-PB2,357,0,0,0,2340,2340,C
1-PB2,358,1,4,2340,0,2345,G
1-PB2,359,2336,1,2,0,2339,A
1-PB2,360,0,0,0,2345,2345,C
1-PB2,361,2326,1,4,0,2331,A
1-PB2,362,2328,1,0,0,2329,A
1-PB2,363,2321,0,2,0,2323,A
1-PB2,364,1,0,2377,0,2378,G
1-PB2,365,0,2375,0,0,2375,T
1-PB2,366,2,2,0,2372,2376,C
1-PB2,367,0,2,2379,0,2381,G
1-PB2,368,2364,0,5,0,2369,A
1-PB2,369,2365,0,2,2,2369,A
1-PB2,370,2368,0,1,0,2369,A
1-PB2,371,0,1,2455,0,2456,G
1-PB2,372,0,0,2467,0,2467,G
1-PB2,373,0,2443,0,0,2443,T
1-PB2,374,0,2436,0,1,2437,T
1-PB2,375,2442,0,1,0,2443,A
1-PB2,376,2437,0,2,0,2439,A
1-PB2,377,2445,0,1,0,2446,A
1-PB2,378,2458,0,3,1,2462,A
1-PB2,379,0,1,0,2495,2496,C
1-PB2,380,2396,0,2,0,2398,A
1-PB2,381,0,2384,0,0,2384,T
1-PB2,382,0,3,2375,0,2378,G
1-PB2,383,0,1,2380,1,2382,G
1-PB2,384,2370,0,5,0,2375,A
1-PB2,385,2388,1,1,0,2390,A
1-PB2,386,0,0,0,2453,2453,C
1-PB2,387,1,1,0,2462,2464,C
1-PB2,388,0,2442,0,2,2444,T
1-PB2,389,0,2445,0,0,2445,T
1-PB2,390,0,2434,0,4,2438,T
1-PB2,391,2,2,2433,0,2437,G
1-PB2,392,1,4,2432,0,2437,G
1-PB2,393,2,3,0,2438,2443,C
1-PB2,394,4,1,0,2419,2424,C
1-PB2,395,1,4,0,2411,2416,C
1-PB2,396,0,2311,0,2,2313,T
1-PB2,397,0,0,2365,1,2366,G
1-PB2,398,0,2354,0,3,2357,T
1-PB2,399,1,2362,0,0,2363,T
1-PB2,400,4,0,0,2366,2370,C
1-PB2,401,2342,0,0,0,2342,A
1-PB2,402,0,2339,0,1,2340,T
1-PB2,403,0,2343,0,2,2345,T
1-PB2,404,0,2347,0,1,2348,T
1-PB2,405,0,2352,0,1,2353,T
1-PB2,406,2319,1,0,0,2320,A
1-PB2,407,0,2,2312,0,2314,G
1-PB2,408,2310,0,0,0,2310,A
1-PB2,409,2321,0,0,0,2321,A
1-PB2,410,2318,1,2,0,2321,A
1-PB2,411,0,2303,0,1,2304,T
1-PB2,412,4,1,0,2312,2317,C
1-PB2,413,2309,0,1,0,2310,A
1-PB2,414,2319,0,5,0,2324,A
1-PB2,415,0,1,2339,0,2340,G
1-PB2,416,1,2326,0,4,2331,T
1-PB2,417,4,0,0,2331,2335,C
1-PB2,418,2343,0,3,0,2346,A
1-PB2,419,2345,1,2,1,2349,A
1-PB2,420,1,0,2360,0,2361,G
1-PB2,421,2365,0,1,0,2366,A
1-PB2,422,0,2371,1,2,2374,T
1-PB2,423,2390,1,2,0,2393,A
1-PB2,424,1,2,0,2380,2383,C
1-PB2,425,0,3,2365,0,2368,G
1-PB2,426,0,1,0,2487,2488,C
1-PB2,427,2441,0,0,0,2441,A
1-PB2,428,1,0,2468,0,2469,G
1-PB2,429,2456,0,0,0,2456,A
1-PB2,430,2478,0,4,0,2482,A
1-PB2,431,0,4,2544,0,2548,G
1-PB2,432,2463,1,5,0,2469,A
1-PB2,433,2,0,2483,0,2485,G
1-PB2,434,1,2477,0,0,2478,T
1-PB2,435,2444,0,1,0,2445,A
1-PB2,436,0,1,2495,0,2496,G
1-PB2,437,2444,1,4,0,2449,A
1-PB2,438,0,0,0,2567,2567,C
1-PB2,439,2525,0,2,0,2527,A
1-PB2,440,0,2487,0,0,2487,T
1-PB2,441,2481,0,4,0,2485,A
1-PB2,442,2483,0,1,0,2484,A
1-PB2,443,2503,0,0,1,2504,A
1-PB2,444,0,0,0,2524,2524,C
1-PB2,445,4,0,0,2486,2490,C
1-PB2,446,3,0,0,2460,2463,C
1-PB2,447,0,2303,0,2,2305,T
1-PB2,448,0,3,2332,0,2335,G
1-PB2,449,0,0,2366,1,2367,G
1-PB2,450,0,2361,0,4,2365,T
1-PB2,451,2,0,0,2360,2362,C
1-PB2,452,2393,0,4,1,2398,A
1-PB2,453,1,2377,1,4,2383,T
1-PB2,454,0,0,2403,0,2403,G
1-PB2,455,0,1,0,2395,2396,C
1-PB2,456,2386,0,2,0,2388,A
1-PB2,457,0,2,2399,0,2401,G
1-PB2,458,2336,1,3,0,2340,A
1-PB2,459,0,0,0,2388,2388,C
1-PB2,460,4,0,0,2378,2382,C
1-PB2,461,0,2339,0,6,2345,T
1-PB2,462,0,0,1,2348,2349,C
1-PB2,463,2318,0,0,0,2318,A
1-PB2,464,1,1,2376,0,2378,G
1-PB2,465,0,2370,1,4,2375,T
1-PB2,466,1,0,2375,0,2376,G
1-PB2,467,3,0,1,2364,2368,C
1-PB2,468,4,2,0,2323,2329,C
1-PB2,469,2328,0,1,0,2329,A
1-PB2,470,2332,0,2,0,2334,A
1-PB2,471,2321,0,3,0,2324,A
1-PB2,472,0,1,2335,0,2336,G
1-PB2,473,2260,0,4,0,2264,A
1-PB2,474,0,0,2287,0,2287,G
1-PB2,475,1,1,2288,0,2290,G
1-PB2,476,0,0,0,2292,2292,C
1-PB2,477,2287,2,4,2,2295,A
1-PB2,478,0,1,0,2296,2297,C
1-PB2,479,2287,2,0,0,2289,A
1-PB2,480,2342,1,1,0,2344,A
1-PB2,481,1,2,2359,0,2362,G
1-PB2,482,2401,0,0,0,2401,A
1-PB2,483,0,2379,0,0,2379,T
1-PB2,484,2,0,2386,0,2388,G
1-PB2,485,0,2392,1,1,2394,T
1-PB2,486,2396,0,0,0,2396,A
1-PB2,487,2396,0,1,0,2397,A
1-PB2,488,0,2408,0,1,2409,T
1-PB2,489,0,2304,0,0,2304,T
1-PB2,490,2292,0,2,0,2294,A
1-PB2,491,0,2211,0,1,2212,T
1-PB2,492,0,1,2217,0,2218,G
1-PB2,493,0,1,2223,0,2224,G
1-PB2,494,2204,0,1,0,2205,A
1-PB2,495,2193,0,4,1,2198,A
1-PB2,496,1,0,2200,1,2202,G
1-PB2,497,0,2180,0,0,2180,T
1-PB2,498,1,2170,0,2,2173,T
1-PB2,499,0,1,2200,0,2201,G
1-PB2,500,0,2183,0,4,2187,T
1-PB2,501,0,2183,1,1,2185,T
1-PB2,502,0,2180,0,0,2180,T
1-PB2,503,0,2174,0,0,2174,T
1-PB2,504,0,2189,0,2,2191,T
1-PB2,505,2,0,0,2190,2192,C
1-PB2,506,2,2,1,2192,2197,C
1-PB2,507,2,1,1,2194,2198,C
1-PB2,508,2188,0,1,0,2189,A
1-PB2,509,2206,0,0,0,2206,A
1-PB2,510,0,2200,0,0,2200,T
1-PB2,511,0,1,2218,0,2219,G
1-PB2,512,2214,1,0,0,2215,A
1-PB2,513,2203,0,0,0,2203,A
1-PB2,514,1,0,2222,0,2223,G
1-PB2,515,0,2209,0,3,2212,T
1-PB2,516,0,2,2189,1,2192,G
1-PB2,517,1,3,2186,0,2190,G
1-PB2,518,2,0,2192,0,2194,G
1-PB2,519,2194,0,4,0,2198,A
1-PB2,520,2,0,2195,0,2197,G
1-PB2,521,1,3,0,2191,2195,C
1-PB2,522,1,0,0,2207,2208,C
1-PB2,523,2204,0,3,1,2208,A
1-PB2,524,0,1,2284,0,2285,G
1-PB2,525,0,1,2306,0,2307,G
1-PB2,526,2314,1,2,0,2317,A
1-PB2,527,0,2321,0,0,2321,T
1-PB2,528,2321,0,0,0,2321,A
1-PB2,529,0,1,0,2318,2319,C
1-PB2,530,0,2292,0,4,2296,T
1-PB2,531,2299,0,1,0,2300,A
1-PB2,532,2293,0,0,0,2293,A
1-PB2,533,1,0,0,2323,2324,C
1-PB2,534,2253,0,0,1,2254,A
1-PB2,535,0,2220,1,5,2226,T
1-PB2,536,2,1,0,2241,2244,C
1-PB2,537,2219,0,0,0,2219,A
1-PB2,538,4,2,2239,0,2245,G
1-PB2,539,2236,0,1,0,2237,A
1-PB2,540,2228,2,0,0,2230,A
1-PB2,541,0,2224,0,4,2228,T
1-PB2,542,3,0,0,2184,2187,C
1-PB2,543,2193,1,1,2,2197,A
1-PB2,544,0,0,0,2255,2255,C
1-PB2,545,2254,0,1,0,2255,A
1-PB2,546,2267,0,1,0,2268,A
1-PB2,547,1,2223,0,0,2224,T
1-PB2,548,1,2225,1,1,2228,T
1-PB2,549,2243,0,2,0,2245,A
1-PB2,550,2256,0,2,0,2258,A
1-PB2,551,1,0,0,2275,2276,C
1-PB2,552,2247,1,1,0,2249,A
1-PB2,553,2221,0,1,0,2222,A
1-PB2,554,0,2255,0,0,2255,T
1-PB2,555,2245,0,4,0,2249,A
1-PB2,556,2255,0,0,0,2255,A
1-PB2,557,1,0,0,2260,2261,C
1-PB2,558,0,2233,0,1,2234,T
1-PB2,559,2234,0,0,0,2234,A
1-PB2,560,2213,0,0,0,2213,A
1-PB2,561,2221,0,1,0,2222,A
1-PB2,562,1,1,2226,0,2228,G
1-PB2,563,2139,0,5,0,2144,A
1-PB2,564,1,3,2178,0,2182,G
1-PB2,565,2173,2,2,0,2177,A
1-PB2,566,2171,0,2,0,2173,A
1-PB2,567,2174,0,1,0,2175,A
1-PB2,568,2168,2,2,0,2172,A
1-PB2,569,2191,0,1,0,2192,A
1-PB2,570,2182,0,5,0,2187,A
1-PB2,571,0,0,2197,0,2197,G
1-PB2,572,2191,1,1,0,2193,A
1-PB2,573,2176,1,2,1,2180,A
1-PB2,574,0,1,2184,0,2185,G
1-PB2,575,2187,0,3,0,2190,A
1-PB2,576,2194,0,4,0,2198,A
1-PB2,577,0,1,0,2221,2222,C
1-PB2,578,1,2178,0,1,2180,T
1-PB2,579,3,0,0,2197,2200,C
1-PB2,580,0,0,0,2201,2201,C
1-PB2,581,2,0,2204,0,2206,G
1-PB2,582,2187,1,1,0,2189,A
1-PB2,583,1,0,2203,0,2204,G
1-PB2,584,2188,1,0,0,2189,A
1-PB2,585,0,2191,0,1,2192,T
1-PB2,586,0,2179,0,2,2181,T
1-PB2,587,0,0,2172,0,2172,G
1-PB2,588,0,0,0,2175,2175,C
1-PB2,589,2179,0,0,0,2179,A
1-PB2,590,2180,0,0,0,2180,A
1-PB2,591,2183,0,0,0,2183,A
1-PB2,592,2206,0,0,1,2207,A
1-PB2,593,0,2214,0,1,2215,T
1-PB2,594,1,2192,0,2,2195,T
1-PB2,595,0,2181,0,2,2183,T
1-PB2,596,3,0,0,2167,2170,C
1-PB2,597,0,2108,0,4,2112,T
1-PB2,598,3,2,0,2335,2340,C
1-PB2,599,2,1,0,2317,2320,C
1-PB2,600,5,0,0,2516,2521,C
1-PB2,601,1,2416,0,1,2418,T
1-PB2,602,0,2446,0,0,2446,T
1-PB2,603,0,0,2469,0,2469,G
1-PB2,604,2468,0,1,1,2470,A
1-PB2,605,0,2519,0,0,2519,T
1-PB2,606,0,5,2565,0,2570,G
1-PB2,607,0,1,2916,1,2918,G
1-PB2,608,0,2968,0,2,2970,T
1-PB2,609,0,2959,0,2,2961,T
1-PB2,610,3,0,3240,0,3243,G
1-PB2,611,1,0,0,3267,3268,C
1-PB2,612,3364,0,0,1,3365,A
1-PB2,613,1,3361,0,5,3367,T
1-PB2,614,3411,1,1,2,3415,A
1-PB2,615,1,1,0,3637,3639,C
1-PB2,616,4200,0,3,13,4216,A
1-PB2,617,0,4345,0,2,4347,T
1-PB2,618,1,0,4652,0,4653,G
1-PB2,619,0,4603,1,6,4610,T
1-PB2,620,0,4609,2,0,4611,T
1-PB2,621,4607,1,3,0,4611,A
1-PB2,622,0,6,4614,1,4621,G
1-PB2,623,4688,1,10,0,4699,A
1-PB2,624,0,3,4784,0,4787,G
1-PB2,625,4596,0,6,0,4602,A
1-PB2,626,0,0,4641,0,4641,G
1-PB2,627,4558,2,3,0,4563,A
1-PB2,628,4,4,4606,1,4615,G
1-PB2,629,4624,0,7,0,4631,A
1-PB2,630,4640,0,2,0,4642,A
1-PB2,631,2,0,0,4660,4662,C
1-PB2,632,0,4640,0,3,4643,T
1-PB2,633,1,4644,0,0,4645,T
1-PB2,634,2,0,4659,1,4662,G
1-PB2,635,1,4665,0,0,4666,T
1-PB2,636,4664,1,3,0,4668,A
1-PB2,637,1,7,0,4634,4642,C
1-PB2,638,1,3,4627,0,4631,G
1-PB2,639,4626,2,6,0,4634,A
1-PB2,640,4618,0,0,0,4618,A
1-PB2,641,4687,0,4,0,4691,A
1-PB2,642,4691,0,1,0,4692,A
1-PB2,643,4697,0,2,0,4699,A
1-PB2,644,1,1,0,4715,4717,C
1-PB2,645,4712,0,1,0,4713,A
1-PB2,646,4728,0,3,0,4731,A
1-PB2,647,0,0,4767,0,4767,G
1-PB2,648,4784,0,4,0,4788,A
1-PB2,649,1,4782,0,4,4787,T
1-PB2,650,0,4754,0,0,4754,T
1-PB2,651,1,4766,0,6,4773,T
1-PB2,652,5,0,0,4781,4786,C
1-PB2,653,0,4792,2,8,4802,T
1-PB2,654,4,0,0,4817,4821,C
1-PB2,655,4,2,0,4805,4811,C
1-PB2,656,4,2,0,4813,4819,C
1-PB2,657,4812,0,3,0,4815,A
1-PB2,658,3,0,4845,0,4848,G
1-PB2,659,1,4845,1,5,4852,T
1-PB2,660,0,4840,0,3,4843,T
1-PB2,661,0,0,4838,0,4838,G
1-PB2,662,3,3,0,4828,4834,C
1-PB2,663,2,4818,0,6,4826,T
1-PB2,664,0,4,4846,0,4850,G
1-PB2,665,1,0,4836,0,4837,G
1-PB2,666,1,2,0,4845,4848,C
1-PB2,667,3,3,4844,0,4850,G
1-PB2,668,3,3,4888,0,4894,G
1-PB2,669,4916,0,7,1,4924,A
1-PB2,670,4914,0,11,0,4925,A
1-PB2,671,0,1,0,4944,4945,C
1-PB2,672,4958,0,5,1,4964,A
1-PB2,673,4967,1,8,1,4977,A
1-PB2,674,1,0,5207,1,5209,G
1-PB2,675,0,2,0,5331,5333,C
1-PB2,676,5373,0,5,0,5378,A
1-PB2,677,2,0,6820,0,6822,G
1-PB2,678,1,6791,0,1,6793,T
1-PB2,679,6835,1,9,0,6845,A
1-PB2,680,1,6829,0,6,6836,T
1-PB2,681,6867,0,8,0,6875,A
1-PB2,682,1,6868,0,2,6871,T
1-PB2,683,6706,1,8,0,6715,A
1-PB2,684,1,7,0,6796,6804,C
1-PB2,685,6406,0,1,0,6407,A
1-PB2,686,1,6001,0,0,6002,T
1-PB2,687,1,5755,0,1,5757,T
1-PB2,688,2,2,5756,0,5760,G
1-PB2,689,5756,0,3,0,5759,A
1-PB2,690,5729,0,7,0,5736,A
1-PB2,691,1,0,5857,0,5858,G
1-PB2,692,0,5802,1,1,5804,T
1-PB2,693,0,5716,0,2,5718,T
1-PB2,694,1,5735,0,4,5740,T
1-PB2,695,0,5736,1,5,5742,T
1-PB2,696,5818,2,4,0,5824,A
1-PB2,697,2,3,0,5851,5856,C
1-PB2,698,5844,0,2,0,5846,A
1-PB2,699,0,5818,0,2,5820,T
1-PB2,700,0,5755,0,4,5759,T
1-PB2,701,0,5758,0,0,5758,T
1-PB2,702,1,9,5814,1,5825,G
1-PB2,703,5854,0,3,1,5858,A
1-PB2,704,1,0,0,5891,5892,C
1-PB2,705,1,5815,0,7,5823,T
1-PB2,706,6,1,0,5832,5839,C
1-PB2,707,5816,3,6,0,5825,A
1-PB2,708,15,9,5773,0,5797,G
1-PB2,709,2,5,5941,0,5948,G
1-PB2,710,1,2,5973,0,5976,G
1-PB2,711,5965,0,5,0,5970,A
1-PB2,712,5948,0,7,25,5980,A
1-PB2,713,0,5,0,5993,5998,C
1-PB2,714,1,0,6069,0,6070,G
1-PB2,715,0,6052,0,6,6058,T
1-PB2,716,2,0,6077,0,6079,G
1-PB2,717,0,6011,0,5,6016,T
1-PB2,718,0,5997,0,4,6001,T
1-PB2,719,1,5,5998,0,6004,G
1-PB2,720,1,6,5992,0,5999,G
1-PB2,721,5,3,6074,1,6083,G
1-PB2,722,6020,0,10,0,6030,A
1-PB2,723,5999,1,12,0,6012,A
1-PB2,724,2,2,0,6215,6219,C
1-PB2,725,6187,1,0,0,6188,A
1-PB2,726,6356,0,0,0,6356,A
1-PB2,727,6381,0,1,1,6383,A
1-PB2,728,1,6411,0,3,6415,T
1-PB2,729,0,2,6526,0,6528,G
1-PB2,730,0,6457,0,3,6460,T
1-PB2,731,6462,0,5,0,6467,A
1-PB2,732,2,2,0,6483,6487,C
1-PB2,733,6285,1,7,0,6293,A
1-PB2,734,1,1,0,6271,6273,C
1-PB2,735,2,6028,0,6,6036,T
1-PB2,736,6,3,2,6576,6587,C
1-PB2,737,5,0,0,6600,6605,C
1-PB2,738,6690,1,7,0,6698,A
1-PB2,739,0,4,6754,0,6758,G
1-PB2,740,1,3,6941,0,6945,G
1-PB2,741,0,6901,0,4,6905,T
1-PB2,742,2,8,6893,1,6904,G
1-PB2,743,1,2,6695,0,6698,G
1-PB2,744,6560,2,18,1,6581,A
1-PB2,745,1,7,6654,0,6662,G
1-PB2,746,0,6,6657,0,6663,G
1-PB2,747,6489,3,4,0,6496,A
1-PB2,748,1,2,6596,0,6599,G
1-PB2,749,0,6377,0,5,6382,T
1-PB2,750,1,6,6422,0,6429,G
1-PB2,751,6386,1,18,2,6407,A
1-PB2,752,2,5,6453,0,6460,G
1-PB2,753,2,2,6483,0,6487,G
1-PB2,754,6407,0,5,0,6412,A
1-PB2,755,6403,0,9,0,6412,A
1-PB2,756,0,6423,0,3,6426,T
1-PB2,757,0,4,6398,1,6403,G
1-PB2,758,6393,1,10,0,6404,A
1-PB2,759,0,3,0,6370,6373,C
1-PB2,760,1,3,6362,0,6366,G
1-PB2,761,6455,0,5,1,6461,A
1-PB2,762,2,6409,0,2,6413,T
1-PB2,763,3,0,6459,0,6462,G
1-PB2,764,0,6438,0,3,6441,T
1-PB2,765,1,6372,0,7,6380,T
1-PB2,766,2,11,6424,2,6439,G
1-PB2,767,6431,2,10,1,6444,A
1-PB2,768,2,3,1,6439,6445,C
1-PB2,769,4,0,0,6425,6429,C
1-PB2,770,6333,2,4,0,6339,A
1-PB2,771,6335,1,3,0,6339,A
1-PB2,772,6344,0,9,0,6353,A
1-PB2,773,1,0,6551,0,6552,G
1-PB2,774,1,3,0,6551,6555,C
1-PB2,775,4,1,0,6530,6535,C
1-PB2,776,1,6565,0,9,6575,T
1-PB2,777,6582,0,4,1,6587,A
1-PB2,778,6579,1,2,0,6582,A
1-PB2,779,0,6597,0,0,6597,T
1-PB2,780,0,6585,2,4,6591,T
1-PB2,781,6495,0,1,0,6496,A
1-PB2,782,0,6308,0,2,6310,T
1-PB2,783,0,6281,0,3,6284,T
1-PB2,784,0,1,6239,0,6240,G
1-PB2,785,0,5,0,6202,6207,C
1-PB2,786,7,3,6210,0,6220,G
1-PB2,787,0,0,6310,0,6310,G
1-PB2,788,1,1,0,6299,6301,C
1-PB2,789,6,4,0,6323,6333,C
1-PB2,790,6329,3,5,0,6337,A
1-PB2,791,2,2,6433,0,6437,G
1-PB2,792,3,7,6482,0,6492,G
1-PB2,793,6484,3,4,0,6491,A
1-PB2,794,6505,1,10,0,6516,A
1-PB2,795,0,2,0,6554,6556,C
1-PB2,796,6436,1,6,2,6445,A
1-PB2,797,0,6554,0,2,6556,T
1-PB2,798,6694,0,3,0,6697,A
1-PB2,799,2,1,6774,0,6777,G
1-PB2,800,1,6637,1,7,6646,T
1-PB2,801,6562,0,6,0,6568,A
1-PB2,802,6543,0,5,0,6548,A
1-PB2,803,0,6,6544,0,6550,G
1-PB2,804,6501,0,5,1,6507,A
1-PB2,805,6380,0,4,0,6384,A
1-PB2,806,0,5,6359,1,6365,G
1-PB2,807,6045,1,12,0,6058,A
1-PB2,808,1,4,6079,0,6084,G
1-PB2,809,3,2,0,6066,6071,C
1-PB2,810,2,6,0,6055,6063,C
1-PB2,811,3,2,6053,0,6058,G
1-PB2,812,4,2,0,6084,6090,C
1-PB2,813,6121,0,4,2,6127,A
1-PB2,814,2,2,6479,0,6483,G
1-PB2,815,0,6465,0,3,6468,T
1-PB2,816,6490,0,1,0,6491,A
1-PB2,817,0,6422,0,3,6425,T
1-PB2,818,3,6,0,6481,6490,C
1-PB2,819,6469,1,7,1,6478,A
1-PB2,820,0,1,6494,0,6495,G
1-PB2,821,5,2,0,6477,6484,C
1-PB2,822,6192,0,7,0,6199,A
1-PB2,823,1,3,6133,0,6137,G
1-PB2,824,6130,2,5,1,6138,A
1-PB2,825,0,6134,0,2,6136,T
1-PB2,826,4,1,0,6166,6171,C
1-PB2,827,7,2,0,6153,6162,C
1-PB2,828,6149,1,2,1,6153,A
1-PB2,829,1,0,0,6173,6174,C
1-PB2,830,0,6133,0,3,6136,T
1-PB2,831,6154,1,8,0,6163,A
1-PB2,832,2,1,6158,1,6162,G
1-PB2,833,0,3,0,6098,6101,C
1-PB2,834,6079,1,7,0,6087,A
1-PB2,835,1,6095,0,2,6098,T
1-PB2,836,6,3,0,6169,6178,C
1-PB2,837,1,6135,0,2,6138,T
1-PB2,838,1,6325,0,0,6326,T
1-PB2,839,0,6356,0,1,6357,T
1-PB2,840,6338,1,3,0,6342,A
1-PB2,841,1,6315,0,8,6324,T
1-PB2,842,1,6294,0,3,6298,T
1-PB2,843,2,5,6276,0,6283,G
1-PB2,844,2,3,6292,1,6298,G
1-PB2,845,6101,3,9,0,6113,A
1-PB2,846,1,3,6139,0,6143,G
1-PB2,847,5989,0,3,0,5992,A
1-PB2,848,0,5932,0,5,5937,T
1-PB2,849,0,0,6056,0,6056,G
1-PB2,850,2,6019,0,8,6029,T
1-PB2,851,5,1,6028,0,6034,G
1-PB2,852,0,1,1,6034,6036,C
1-PB2,853,8,2,1,6004,6015,C
1-PB2,854,6012,2,8,1,6023,A
1-PB2,855,1,3,0,6010,6014,C
1-PB2,856,5889,2,7,0,5898,A
1-PB2,857,3,1,5994,0,5998,G
1-PB2,858,0,1,0,5861,5862,C
1-PB2,859,5854,0,2,0,5856,A
1-PB2,860,0,1,0,5854,5855,C
1-PB2,861,5839,1,12,0,5852,A
1-PB2,862,2,2,0,5885,5889,C
1-PB2,863,5871,2,2,0,5875,A
1-PB2,864,5866,0,4,0,5870,A
1-PB2,865,5864,1,2,0,5867,A
1-PB2,866,0,5656,1,5,5662,T
1-PB2,867,0,5638,0,5,5643,T
1-PB2,868,0,2,5614,0,5616,G
1-PB2,869,2,2,5605,1,5610,G
1-PB2,870,4,18,0,5593,5615,C
1-PB2,871,4,7,5540,0,5551,G
1-PB2,872,6,4,5647,0,5657,G
1-PB2,873,1,5,5647,0,5653,G
1-PB2,874,5661,1,11,0,5673,A
1-PB2,875,0,0,0,5670,5670,C
1-PB2,876,5675,0,1,1,5677,A
1-PB2,877,5658,2,0,0,5660,A
1-PB2,878,5315,0,17,0,5332,A
1-PB2,879,1,4,5396,2,5403,G
1-PB2,880,5426,1,1,0,5428,A
1-PB2,881,1,5425,0,1,5427,T
1-PB2,882,3,5,5321,1,5330,G
1-PB2,883,2,3,5339,0,5344,G
1-PB2,884,0,5272,0,13,5285,T
1-PB2,885,1,4,5287,0,5292,G
1-PB2,886,1,5,5280,0,5286,G
1-PB2,887,5258,1,3,0,5262,A
1-PB2,888,0,3,0,5254,5257,C
1-PB2,889,5147,1,0,0,5148,A
1-PB2,890,1,5947,0,1,5949,T
1-PB2,891,0,5931,0,6,5937,T
1-PB2,892,5,1,0,5931,5937,C
1-PB2,893,1,5852,0,18,5871,T
1-PB2,894,0,5867,1,0,5868,T
1-PB2,895,5867,1,3,1,5872,A
1-PB2,896,0,5,5908,0,5913,G
1-PB2,897,5889,0,6,0,5895,A
1-PB2,898,0,2,1,5888,5891,C
1-PB2,899,4444,0,6,0,4450,A
1-PB2,900,2,5,4540,0,4547,G
1-PB2,901,4501,0,8,1,4510,A
1-PB2,902,4525,3,9,0,4537,A
1-PB2,903,1,3,0,4526,4530,C
1-PB2,904,3,0,0,4519,4522,C
1-PB2,905,5,2,0,4498,4505,C
1-PB2,906,2,8,4497,0,4507,G
1-PB2,907,4507,0,2,0,4509,A
1-PB2,908,1,0,0,4528,4529,C
1-PB2,909,0,4456,0,4,4460,T
1-PB2,910,1,4,4492,0,4497,G
1-PB2,911,4471,0,10,2,4483,A
1-PB2,912,4487,0,9,0,4496,A
1-PB2,913,1,6,4512,0,4519,G
1-PB2,914,4494,0,3,0,4497,A
1-PB2,915,4493,1,9,0,4503,A
1-PB2,916,0,1,0,4503,4504,C
1-PB2,917,4459,0,5,0,4464,A
1-PB2,918,4482,1,1,0,4484,A
1-PB2,919,1,1,4537,0,4539,G
1-PB2,920,1,1,0,4578,4580,C
1-PB2,921,0,4523,0,1,4524,T
1-PB2,922,0,0,4595,0,4595,G
1-PB2,923,0,4553,0,5,4558,T
1-PB2,924,1,4,4657,0,4662,G
1-PB2,925,0,3,4839,0,4842,G
1-PB2,926,4849,1,7,0,4857,A
1-PB2,927,0,4835,1,8,4844,T
1-PB2,928,4778,0,3,0,4781,A
1-PB2,929,0,4711,0,1,4712,T
1-PB2,930,4894,1,3,0,4898,A
1-PB2,931,1,4796,0,0,4797,T
1-PB2,932,2,1,4764,1,4768,G
1-PB2,933,1,1,0,4717,4719,C
1-PB2,934,4459,0,1,0,4460,A
1-PB2,935,4454,2,6,0,4462,A
1-PB2,936,0,5,4449,0,4454,G
1-PB2,937,1,2,4456,0,4459,G
1-PB2,938,0,2,0,4455,4457,C
1-PB2,939,0,4310,1,10,4321,T
1-PB2,940,3,0,4351,0,4354,G
1-PB2,941,1,1,0,4364,4366,C
1-PB2,942,4367,1,2,0,4370,A
1-PB2,943,4383,0,4,0,4387,A
1-PB2,944,0,4367,0,2,4369,T
1-PB2,945,0,3,4392,0,4395,G
1-PB2,946,1,5,4336,0,4342,G
1-PB2,947,1,2,4358,0,4361,G
1-PB2,948,4356,1,5,0,4362,A
1-PB2,949,1,4355,0,1,4357,T
1-PB2,950,0,4300,0,3,4303,T
1-PB2,951,0,4,4326,1,4331,G
1-PB2,952,4298,1,5,1,4305,A
1-PB2,953,3,3,4350,0,4356,G
1-PB2,954,4289,1,3,0,4293,A
1-PB2,955,4251,1,2,0,4254,A
1-PB2,956,0,4216,1,1,4218,T
1-PB2,957,3,2,0,4233,4238,C
1-PB2,958,4233,0,4,0,4237,A
1-PB2,959,0,0,4278,0,4278,G
1-PB2,960,0,2,0,4261,4263,C
1-PB2,961,1,4206,1,9,4217,T
1-PB2,962,8,0,0,4194,4202,C
1-PB2,963,4215,0,2,0,4217,A
1-PB2,964,1,4316,0,5,4322,T
1-PB2,965,2,2,0,4321,4325,C
1-PB2,966,5,0,0,4364,4369,C
1-PB2,967,0,4339,1,8,4348,T
1-PB2,968,2,4312,0,8,4322,T
1-PB2,969,0,4,0,4333,4337,C
1-PB2,970,4333,0,5,0,4338,A
1-PB2,971,2,1,4397,0,4400,G
1-PB2,972,4,5,0,4381,4390,C
1-PB2,973,1,4247,1,21,4270,T
1-PB2,974,0,4275,0,2,4277,T
1-PB2,975,1,4241,0,6,4248,T
1-PB2,976,1,3,4251,0,4255,G
1-PB2,977,1,0,4251,0,4252,G
1-PB2,978,0,4236,0,7,4243,T
1-PB2,979,1,9,4259,0,4269,G
1-PB2,980,2,5,4232,0,4239,G
1-PB2,981,3,0,4277,0,4280,G
1-PB2,982,0,4250,0,7,4257,T
1-PB2,983,1,4245,1,4,4251,T
1-PB2,984,0,4243,0,2,4245,T
1-PB2,985,4284,1,2,0,4287,A
1-PB2,986,0,1,1,4299,4301,C
1-PB2,987,4305,0,2,0,4307,A
1-PB2,988,0,4286,2,3,4291,T
1-PB2,989,5,4177,1,1,4184,T
1-PB2,990,0,4168,0,1,4169,T
1-PB2,991,4167,0,0,0,4167,A
1-PB2,992,4160,0,0,0,4160,A
1-PB2,993,4172,0,0,0,4172,A
1-PB2,994,4146,0,6,0,4152,A
1-PB2,995,6,3,4170,0,4179,G
1-PB2,996,4134,0,5,0,4139,A
1-PB2,997,4128,1,5,0,4134,A
1-PB2,998,1,0,0,4135,4136,C
1-PB2,999,4105,1,5,0,4111,A
1-PB2,1000,4115,0,4,0,4119,A
1-PB2,1001,1,0,4124,0,4125,G
1-PB2,1002,0,4,2,4114,4120,C
1-PB2,1003,1,4,4115,0,4120,G
1-PB2,1004,2,4,4126,0,4132,G
1-PB2,1005,2,2,4147,0,4151,G
1-PB2,1006,2,4121,0,11,4134,T
1-PB2,1007,5,1,0,4116,4122,C
1-PB2,1008,4133,0,5,1,4139,A
1-PB2,1009,1,4114,0,2,4117,T
1-PB2,1010,1,0,0,4145,4146,C
1-PB2,1011,4119,1,4,0,4124,A
1-PB2,1012,1,1,4285,0,4287,G
1-PB2,1013,1,4207,0,7,4215,T
1-PB2,1014,9,0,0,4214,4223,C
1-PB2,1015,4219,2,5,0,4226,A
1-PB2,1016,4236,0,6,0,4242,A
1-PB2,1017,4238,0,1,0,4239,A
1-PB2,1018,4230,0,3,0,4233,A
1-PB2,1019,4284,0,0,0,4284,A
1-PB2,1020,4268,0,7,1,4276,A
1-PB2,1021,1,1,4308,1,4311,G
1-PB2,1022,4272,0,5,0,4277,A
1-PB2,1023,4271,0,3,0,4274,A
1-PB2,1024,1,1,4277,0,4279,G
1-PB2,1025,4239,1,1,0,4241,A
1-PB2,1026,4115,0,17,1,4133,A
1-PB2,1027,1,2,4111,0,4114,G
1-PB2,1028,4091,0,3,0,4094,A
1-PB2,1029,1,3,4103,0,4107,G
1-PB2,1030,0,0,4241,1,4242,G
1-PB2,1031,0,4239,0,1,4240,T
1-PB2,1032,0,2,4316,0,4318,G
1-PB2,1033,0,2,0,4350,4352,C
1-PB2,1034,0,4341,1,9,4351,T
1-PB2,1035,0,4379,0,0,4379,T
1-PB2,1036,4369,0,2,0,4371,A
1-PB2,1037,0,2,0,4365,4367,C
1-PB2,1038,4298,0,3,0,4301,A
1-PB2,1039,1,6,4310,0,4317,G
1-PB2,1040,1,0,4305,0,4306,G
1-PB2,1041,1,0,0,4206,4207,C
1-PB2,1042,4151,0,1,0,4152,A
1-PB2,1043,4178,0,2,1,4181,A
1-PB2,1044,3,4278,0,6,4287,T
1-PB2,1045,5,0,0,4341,4346,C
1-PB2,1046,1,4303,2,5,4311,T
1-PB2,1047,2,3,0,4324,4329,C
1-PB2,1048,3,0,0,4319,4322,C
1-PB2,1049,4319,2,4,1,4326,A
1-PB2,1050,4317,0,2,0,4319,A
1-PB2,1051,4330,0,4,0,4334,A
1-PB2,1052,0,1,0,4368,4369,C
1-PB2,1053,4205,1,1,0,4207,A
1-PB2,1054,0,4160,2,2,4164,T
1-PB2,1055,0,4140,1,1,4142,T
1-PB2,1056,2,2,4239,0,4243,G
1-PB2,1057,4235,1,2,2,4240,A
1-PB2,1058,4308,0,4,0,4312,A
1-PB2,1059,4321,0,4,1,4326,A
1-PB2,1060,4317,1,3,0,4321,A
1-PB2,1061,0,4336,0,2,4338,T
1-PB2,1062,4331,0,6,0,4337,A
1-PB2,1063,4325,1,7,2,4335,A
1-PB2,1064,1,4,4430,0,4435,G
1-PB2,1065,4318,0,8,0,4326,A
1-PB2,1066,5,0,4513,1,4519,G
1-PB2,1067,0,4450,0,3,4453,T
1-PB2,1068,4500,0,3,0,4503,A
1-PB2,1069,0,0,0,4641,4641,C
1-PB2,1070,4584,0,7,1,4592,A
1-PB2,1071,1,4585,0,1,4587,T
1-PB2,1072,0,6,4594,1,4601,G
1-PB2,1073,4445,1,20,2,4468,A
1-PB2,1074,5,5,4523,0,4533,G
1-PB2,1075,1,8,4521,0,4530,G
1-PB2,1076,2,6,4753,0,4761,G
1-PB2,1077,2,2,4789,0,4793,G
1-PB2,1078,1,4692,0,3,4696,T
1-PB2,1079,4719,0,3,0,4722,A
1-PB2,1080,0,4690,0,3,4693,T
1-PB2,1081,3,4,4696,0,4703,G
1-PB2,1082,4685,2,4,0,4691,A
1-PB2,1083,0,1,4687,1,4689,G
1-PB2,1084,1,2,4639,0,4642,G
1-PB2,1085,4334,1,5,1,4341,A
1-PB2,1086,3,3,4465,0,4471,G
1-PB2,1087,1,4478,0,4,4483,T
1-PB2,1088,0,4655,1,4,4660,T
1-PB2,1089,9,0,0,4700,4709,C
1-PB2,1090,4704,1,6,1,4712,A
1-PB2,1091,0,1,0,4735,4736,C
1-PB2,1092,4706,0,2,0,4708,A
1-PB2,1093,4723,0,3,0,4726,A
1-PB2,1094,1,4716,1,2,4720,T
1-PB2,1095,1,7,4671,0,4679,G
1-PB2,1096,1,1,4713,0,4715,G
1-PB2,1097,1,4569,0,4,4574,T
1-PB2,1098,1,7,4575,0,4583,G
1-PB2,1099,1,9,4599,0,4609,G
1-PB2,1100,2,6,4581,0,4589,G
1-PB2,1101,1,5,4650,0,4656,G
1-PB2,1102,4612,1,1,0,4614,A
1-PB2,1103,4619,0,5,0,4624,A
1-PB2,1104,4601,1,2,0,4604,A
1-PB2,1105,4528,0,14,2,4544,A
1-PB2,1106,0,5,4602,0,4607,G
1-PB2,1107,4541,0,10,1,4552,A
1-PB2,1108,0,1,4572,0,4573,G
1-PB2,1109,1,3,0,4559,4563,C
1-PB2,1110,4534,1,2,0,4537,A
1-PB2,1111,4547,1,3,0,4551,A
1-PB2,1112,3,1,0,4707,4711,C
1-PB2,1113,4700,0,6,2,4708,A
1-PB2,1114,1,1,4788,0,4790,G
1-PB2,1115,1,1,1,4737,4740,C
1-PB2,1116,0,4720,0,4,4724,T
1-PB2,1117,4888,0,6,0,4894,A
1-PB2,1118,1,4884,1,1,4887,T
1-PB2,1119,4904,0,4,0,4908,A
1-PB2,1120,0,3,0,4907,4910,C
1-PB2,1121,0,4613,0,0,4613,T
1-PB2,1122,4657,0,3,0,4660,A
1-PB2,1123,4537,0,3,0,4540,A
1-PB2,1124,0,6,4558,0,4564,G
1-PB2,1125,4540,0,2,0,4542,A
1-PB2,1126,4354,0,0,0,4354,A
1-PB2,1127,4348,0,3,0,4351,A
1-PB2,1128,4330,0,4,0,4334,A
1-PB2,1129,0,1,4351,0,4352,G
1-PB2,1130,0,0,0,4334,4334,C
1-PB2,1131,4331,0,2,0,4333,A
1-PB2,1132,4339,0,6,0,4345,A
1-PB2,1133,3,0,1,4357,4361,C
1-PB2,1134,2,1,0,4358,4361,C
1-PB2,1135,4361,1,1,0,4363,A
1-PB2,1136,1,2,4393,1,4397,G
1-PB2,1137,4365,0,3,1,4369,A
1-PB2,1138,4363,2,7,0,4372,A
1-PB2,1139,1,4,4416,2,4423,G
1-PB2,1140,4398,0,5,0,4403,A
1-PB2,1141,0,4392,0,1,4393,T
1-PB2,1142,0,4351,0,3,4354,T
1-PB2,1143,2,4,4358,0,4364,G
1-PB2,1144,5,0,4455,0,4460,G
1-PB2,1145,1,4431,0,9,4441,T
1-PB2,1146,1,4426,0,5,4432,T
1-PB2,1147,6,1,0,4436,4443,C
1-PB2,1148,4458,0,3,0,4461,A
1-PB2,1149,3,1,4656,0,4660,G
1-PB2,1150,0,2,0,4677,4679,C
1-PB2,1151,0,4646,0,5,4651,T
1-PB2,1152,9,1,0,4698,4708,C
1-PB2,1153,4645,1,5,0,4651,A
1-PB2,1154,2,4695,1,2,4700,T
1-PB2,1155,4711,2,1,1,4715,A
1-PB2,1156,3,1,4739,0,4743,G
1-PB2,1157,0,4468,0,5,4473,T
1-PB2,1158,7,7,4485,0,4499,G
1-PB2,1159,4333,0,9,0,4342,A
1-PB2,1160,1,0,4435,0,4436,G
1-PB2,1161,1,4396,0,5,4402,T
1-PB2,1162,3,4,4389,0,4396,G
1-PB2,1163,0,6,4419,0,4425,G
1-PB2,1164,4400,0,2,0,4402,A
1-PB2,1165,4355,1,21,0,4377,A
1-PB2,1166,1,5,4421,1,4428,G
1-PB2,1167,4325,0,9,0,4334,A
1-PB2,1168,1,4,4375,0,4380,G
1-PB2,1169,4325,0,3,1,4329,A
1-PB2,1170,1,2,0,4325,4328,C
1-PB2,1171,3,9,4316,0,4328,G
1-PB2,1172,4273,0,3,0,4276,A
1-PB2,1173,4298,0,15,0,4313,A
1-PB2,1174,1,0,0,4329,4330,C
1-PB2,1175,4268,0,5,0,4273,A
1-PB2,1176,1,2,4540,0,4543,G
1-PB2,1177,1,4496,0,8,4505,T
1-PB2,1178,5,0,0,4493,4498,C
1-PB2,1179,4516,0,2,0,4518,A
1-PB2,1180,4512,0,5,0,4517,A
1-PB2,1181,0,4506,0,1,4507,T
1-PB2,1182,4503,0,2,0,4505,A
1-PB2,1183,1,1,4514,0,4516,G
1-PB2,1184,2,2,1,4487,4492,C
1-PB2,1185,2,5,0,4291,4298,C
1-PB2,1186,1,2,4277,0,4280,G
1-PB2,1187,4272,1,2,0,4275,A
1-PB2,1188,4292,0,5,1,4298,A
1-PB2,1189,1,0,4329,4,4334,G
1-PB2,1190,0,2,0,4425,4427,C
1-PB2,1191,4441,0,2,0,4443,A
1-PB2,1192,4436,0,5,0,4441,A
1-PB2,1193,0,4449,2,1,4452,T
1-PB2,1194,4469,0,2,0,4471,A
1-PB2,1195,4504,1,1,0,4506,A
1-PB2,1196,0,4494,0,3,4497,T
1-PB2,1197,5,4,0,4468,4477,C
1-PB2,1198,3,0,4431,0,4434,G
1-PB2,1199,0,4273,0,8,4281,T
1-PB2,1200,2,7,4268,0,4277,G
1-PB2,1201,2,1,4311,1,4315,G
1-PB2,1202,1,2,0,4304,4307,C
1-PB2,1203,8,4,0,4302,4314,C
1-PB2,1204,4260,0,3,1,4264,A
1-PB2,1205,0,4254,0,3,4257,T
1-PB2,1206,4,3,4274,0,4281,G
1-PB2,1207,3,1,4367,0,4371,G
1-PB2,1208,1,4315,0,2,4318,T
1-PB2,1209,2,0,4336,0,4338,G
1-PB2,1210,0,4140,0,4,4144,T
1-PB2,1211,1,4166,1,8,4176,T
1-PB2,1212,0,4180,0,6,4186,T
1-PB2,1213,0,4192,1,7,4200,T
1-PB2,1214,4,4,0,4287,4295,C
1-PB2,1215,4277,2,6,1,4286,A
1-PB2,1216,0,0,1,4701,4702,C
1-PB2,1217,4605,0,4,1,4610,A
1-PB2,1218,4748,0,3,1,4752,A
1-PB2,1219,0,3,4784,0,4787,G
1-PB2,1220,4704,1,12,0,4717,A
1-PB2,1221,460,4,4356,0,4820,G
1-PB2,1222,2,3,4876,0,4881,G
1-PB2,1223,4799,0,4,0,4803,A
1-PB2,1224,1,4834,1,2,4838,T
1-PB2,1225,1,4728,1,1,4731,T
1-PB2,1226,0,1,4715,0,4716,G
1-PB2,1227,2,4,0,4599,4605,C
1-PB2,1228,4641,0,7,1,4649,A
1-PB2,1229,1,4708,0,6,4715,T
1-PB2,1230,1,3,4990,0,4994,G
1-PB2,1231,5021,0,4,0,5025,A
1-PB2,1232,1,5064,0,0,5065,T
1-PB2,1233,5040,0,0,0,5040,A
1-PB2,1234,5027,0,3,0,5030,A
1-PB2,1235,5029,0,4,0,5033,A
1-PB2,1236,5048,0,7,1,5056,A
1-PB2,1237,0,0,5090,1,5091,G
1-PB2,1238,2,0,0,5236,5238,C
1-PB2,1239,5321,0,4,0,5325,A
1-PB2,1240,3,0,5525,0,5528,G
1-PB2,1241,0,5501,0,6,5507,T
1-PB2,1242,0,5509,1,0,5510,T
1-PB2,1243,5508,1,1,0,5510,A
1-PB2,1244,1,2,5549,0,5552,G
1-PB2,1245,5492,2,5,0,5499,A
1-PB2,1246,1,3,5513,0,5517,G
1-PB2,1247,0,4,5495,0,5499,G
1-PB2,1248,0,5265,0,2,5267,T
1-PB2,1249,3,10,5318,0,5331,G
1-PB2,1250,5325,1,11,0,5337,A
1-PB2,1251,1,5,1,5378,5385,C
1-PB2,1252,3,2,1,5379,5385,C
1-PB2,1253,3,5347,0,5,5355,T
1-PB2,1254,4,5,5391,0,5400,G
1-PB2,1255,5381,0,1,1,5383,A
1-PB2,1256,5396,1,0,0,5397,A
1-PB2,1257,0,5405,0,3,5408,T
1-PB2,1258,1,5450,2,4,5457,T
1-PB2,1259,2,5470,0,2,5474,T
1-PB2,1260,3,0,2,5483,5488,C
1-PB2,1261,3,0,5474,1,5478,G
1-PB2,1262,1,5464,0,11,5476,T
1-PB2,1263,2,0,1,5472,5475,C
1-PB2,1264,5480,0,0,0,5480,A
1-PB2,1265,5483,2,2,0,5487,A
1-PB2,1266,0,2,0,5480,5482,C
1-PB2,1267,5409,1,2,0,5412,A
1-PB2,1268,0,4,5528,0,5532,G
1-PB2,1269,5467,0,16,0,5483,A
1-PB2,1270,1,0,5529,0,5530,G
1-PB2,1271,1,2,0,5523,5526,C
1-PB2,1272,5496,0,3,9,5508,A
1-PB2,1273,5595,0,1,0,5596,A
1-PB2,1274,5593,0,1,0,5594,A
1-PB2,1275,1,5569,1,2,5573,T
1-PB2,1276,4,0,0,5591,5595,C
1-PB2,1277,5533,1,5,0,5539,A
1-PB2,1278,2,1,5550,0,5553,G
1-PB2,1279,2,5,0,5556,5563,C
1-PB2,1280,1,3,5572,0,5576,G
1-PB2,1281,2,2,5982,0,5986,G
1-PB2,1282,0,5941,0,3,5944,T
1-PB2,1283,1,5929,0,8,5938,T
1-PB2,1284,2,4,5944,1,5951,G
1-PB2,1285,5944,2,12,0,5958,A
1-PB2,1286,6021,1,9,1,6032,A
1-PB2,1287,1,3,0,6074,6078,C
1-PB2,1288,6,4,0,6049,6059,C
1-PB2,1289,4,4,0,6106,6114,C
1-PB2,1290,16,14,0,5835,5865,C
1-PB2,1291,5887,1,9,0,5897,A
1-PB2,1292,0,5930,0,5,5935,T
1-PB2,1293,1,2,5964,0,5967,G
1-PB2,1294,0,3,0,5996,5999,C
1-PB2,1295,5949,0,1,0,5950,A
1-PB2,1296,0,5887,0,3,5890,T
1-PB2,1297,4,0,0,5869,5873,C
1-PB2,1298,5813,1,6,0,5820,A
1-PB2,1299,3,2,5952,0,5957,G
1-PB2,1300,7,0,0,5987,5994,C
1-PB2,1301,0,5964,1,17,5982,T
1-PB2,1302,0,5991,0,2,5993,T
1-PB2,1303,1,5954,1,2,5958,T
1-PB2,1304,0,5972,1,1,5974,T
1-PB2,1305,5980,0,1,1,5982,A
1-PB2,1306,5972,0,3,0,5975,A
1-PB2,1307,2,5,5974,0,5981,G
1-PB2,1308,0,4,5930,0,5934,G
1-PB2,1309,3,3,0,5860,5866,C
1-PB2,1310,5834,1,1,0,5836,A
1-PB2,1311,1,5831,3,6,5841,T
1-PB2,1312,1,5872,0,2,5875,T
1-PB2,1313,1,5890,1,1,5893,T
1-PB2,1314,0,5903,0,4,5907,T
1-PB2,1315,5,0,1,5905,5911,C
1-PB2,1316,5883,1,4,0,5888,A
1-PB2,1317,3,5,5896,0,5904,G
1-PB2,1318,5867,0,6,0,5873,A
1-PB2,1319,5891,0,0,0,5891,A
1-PB2,1320,5861,0,5,0,5866,A
1-PB2,1321,3,1,5887,0,5891,G
1-PB2,1322,5957,0,8,2,5967,A
1-PB2,1323,0,5953,0,4,5957,T
1-PB2,1324,2,0,5956,0,5958,G
1-PB2,1325,0,3,0,5976,5979,C
1-PB2,1326,1,2,5991,0,5994,G
1-PB2,1327,5971,1,9,1,5982,A
1-PB2,1328,5977,1,1,0,5979,A
1-PB2,1329,5964,2,9,0,5975,A
1-PB2,1330,1,3,5990,0,5994,G
1-PB2,1331,2,5919,0,10,5931,T
1-PB2,1332,7,0,5916,0,5923,G
1-PB2,1333,0,2,0,5915,5917,C
1-PB2,1334,3,5903,1,13,5920,T
1-PB2,1335,0,5912,1,3,5916,T
1-PB2,1336,1,5924,0,2,5927,T
1-PB2,1337,2,5924,1,2,5929,T
1-PB2,1338,0,5911,1,6,5918,T
1-PB2,1339,6,1,0,5918,5925,C
1-PB2,1340,5915,0,6,1,5922,A
1-PB2,1341,5974,1,1,0,5976,A
1-PB2,1342,5942,0,0,2,5944,A
1-PB2,1343,5980,0,2,0,5982,A
1-PB2,1344,0,5984,0,0,5984,T
1-PB2,1345,1,5986,0,2,5989,T
1-PB2,1346,1,12,5990,0,6003,G
1-PB2,1347,0,13,5976,0,5989,G
1-PB2,1348,1,4,5988,0,5993,G
1-PB2,1349,3,3,6102,0,6108,G
1-PB2,1350,6026,1,8,1,6036,A
1-PB2,1351,5,1,6243,0,6249,G
1-PB2,1352,0,6235,0,3,6238,T
1-PB2,1353,1,6226,0,4,6231,T
1-PB2,1354,2,6,6250,4,6262,G
1-PB2,1355,6253,3,12,0,6268,A
1-PB2,1356,6289,0,17,1,6307,A
1-PB2,1357,2,1,0,6557,6560,C
1-PB2,1358,6470,0,6,0,6476,A
1-PB2,1359,1,6,0,6688,6695,C
1-PB2,1360,6565,2,4,0,6571,A
1-PB2,1361,2,6576,1,7,6586,T
1-PB2,1362,2,10,1,6600,6613,C
1-PB2,1363,0,8,6617,0,6625,G
1-PB2,1364,6656,0,9,0,6665,A
1-PB2,1365,1,2,1,6638,6642,C
1-PB2,1366,6387,0,2,1,6390,A
1-PB2,1367,2,0,6651,0,6653,G
1-PB2,1368,1,6450,0,8,6459,T
1-PB2,1369,1,0,6605,0,6606,G
1-PB2,1370,2,6560,1,10,6573,T
1-PB2,1371,2,5,6589,0,6596,G
1-PB2,1372,6577,0,14,0,6591,A
1-PB2,1373,2,6561,0,3,6566,T
1-PB2,1374,0,6,6587,0,6593,G
1-PB2,1375,5,8,6608,1,6622,G
1-PB2,1376,2,3,6535,0,6540,G
1-PB2,1377,6515,0,10,0,6525,A
1-PB2,1378,6458,0,9,0,6467,A
1-PB2,1379,0,6499,1,6,6506,T
1-PB2,1380,2,2,6590,0,6594,G
1-PB2,1381,6616,0,3,0,6619,A
1-PB2,1382,2,6644,1,1,6648,T
1-PB2,1383,0,6611,0,1,6612,T
1-PB2,1384,3,6,6554,1,6564,G
1-PB2,1385,1,3,6814,0,6818,G
1-PB2,1386,6772,1,10,0,6783,A
1-PB2,1387,0,1,6932,0,6933,G
1-PB2,1388,0,6831,0,8,6839,T
1-PB2,1389,6832,0,3,1,6836,A
1-PB2,1390,1,6863,0,7,6871,T
1-PB2,1391,0,6946,0,4,6950,T
1-PB2,1392,7042,0,3,0,7045,A
1-PB2,1393,1,5,1,7062,7069,C
1-PB2,1394,7,3,0,6952,6962,C
1-PB2,1395,6902,1,6,0,6909,A
1-PB2,1396,2,3,6978,0,6983,G
1-PB2,1397,7191,0,0,0,7191,A
1-PB2,1398,0,7137,0,2,7139,T
1-PB2,1399,7106,2,3,0,7111,A
1-PB2,1400,1,7023,1,6,7031,T
1-PB2,1401,2,14,6983,0,6999,G
1-PB2,1402,7020,0,9,0,7029,A
1-PB2,1403,2,0,0,7119,7121,C
1-PB2,1404,3,7042,0,10,7055,T
1-PB2,1405,5,0,0,7071,7076,C
1-PB2,1406,6,0,0,6973,6979,C
1-PB2,1407,7002,0,5,0,7007,A
1-PB2,1408,7042,1,8,1,7052,A
1-PB2,1409,1,0,7287,0,7288,G
1-PB2,1410,1,3,1,7250,7255,C
1-PB2,1411,7280,0,3,1,7284,A
1-PB2,1412,0,2,1,7284,7287,C
1-PB2,1413,7229,4,18,0,7251,A
1-PB2,1414,1,5,7275,1,7282,G
1-PB2,1415,7225,2,6,1,7234,A
1-PB2,1416,4,1,7332,0,7337,G
1-PB2,1417,7398,0,4,1,7403,A
1-PB2,1418,0,7202,0,6,7208,T
1-PB2,1419,2,4,7342,0,7348,G
1-PB2,1420,2,7293,2,11,7308,T
1-PB2,1421,7,4,1,7288,7300,C
1-PB2,1422,7349,1,8,0,7358,A
1-PB2,1423,7335,1,4,2,7342,A
1-PB2,1424,0,7318,1,1,7320,T
1-PB2,1425,2,7,7305,0,7314,G
1-PB2,1426,7187,0,6,0,7193,A
1-PB2,1427,2,6,7289,0,7297,G
1-PB2,1428,7149,2,14,0,7165,A
1-PB2,1429,1,3,7236,0,7240,G
1-PB2,1430,2,11,7779,1,7793,G
1-PB2,1431,7776,1,6,1,7784,A
1-PB2,1432,7818,0,9,1,7828,A
1-PB2,1433,1,7809,0,2,7812,T
1-PB2,1434,7801,0,4,0,7805,A
1-PB2,1435,7797,1,10,2,7810,A
1-PB2,1436,1,10,7787,1,7799,G
1-PB2,1437,7746,0,13,0,7759,A
1-PB2,1438,12,1,7776,0,7789,G
1-PB2,1439,3,7313,0,4,7320,T
1-PB2,1440,5,3,1,7343,7352,C
1-PB2,1441,7324,0,13,0,7337,A
1-PB2,1442,3,0,7414,1,7418,G
1-PB2,1443,2,1,0,7449,7452,C
1-PB2,1444,7439,0,0,0,7439,A
1-PB2,1445,7456,1,5,0,7462,A
1-PB2,1446,7434,0,5,1,7440,A
1-PB2,1447,7424,2,11,1,7438,A
1-PB2,1448,0,7457,0,1,7458,T
1-PB2,1449,2,9,7462,0,7473,G
1-PB2,1450,5,6,7465,0,7476,G
1-PB2,1451,4,1,7524,0,7529,G
1-PB2,1452,1,7406,1,9,7417,T
1-PB2,1453,3,0,7451,0,7454,G
1-PB2,1454,0,7412,0,8,7420,T
1-PB2,1455,2,3,7436,1,7442,G
1-PB2,1456,4,3,7579,0,7586,G
1-PB2,1457,7582,0,6,1,7589,A
1-PB2,1458,0,7537,0,3,7540,T
1-PB2,1459,2,13,7624,1,7640,G
1-PB2,1460,7591,0,5,0,7596,A
1-PB2,1461,7637,0,8,0,7645,A
1-PB2,1462,0,7622,0,3,7625,T
1-PB2,1463,7600,0,11,0,7611,A
1-PB2,1464,0,1,0,8376,8377,C
1-PB2,1465,3,8150,0,10,8163,T
1-PB2,1466,3,6,1,8335,8345,C
1-PB2,1467,7,2,0,8346,8355,C
1-PB2,1468,8291,0,7,0,8298,A
1-PB2,1469,6,0,8714,1,8721,G
1-PB2,1470,0,8667,0,6,8673,T
1-PB2,1471,8743,0,7,0,8750,A
1-PB2,1472,0,4,0,8789,8793,C
1-PB2,1473,7910,2,9,0,7921,A
1-PB2,1474,3,7,7971,0,7981,G
1-PB2,1475,7716,0,4,1,7721,A
1-PB2,1476,1,6,7784,0,7791,G
1-PB2,1477,7578,1,10,0,7589,A
1-PB2,1478,0,13,7386,0,7399,G
1-PB2,1479,2,8,7368,0,7378,G
1-PB2,1480,0,1,7375,0,7376,G
1-PB2,1481,1,7226,0,5,7232,T
1-PB2,1482,0,9,7232,0,7241,G
1-PB2,1483,0,2,7268,0,7270,G
1-PB2,1484,0,7194,0,5,7199,T
1-PB2,1485,4,3,7493,0,7500,G
1-PB2,1486,0,1,7519,0,7520,G
1-PB2,1487,1,7358,0,4,7363,T
1-PB2,1488,0,7351,1,5,7357,T
1-PB2,1489,7280,0,8,0,7288,A
1-PB2,1490,2,2,7366,0,7370,G
1-PB2,1491,2,3,1,7351,7357,C
1-PB2,1492,7308,0,4,1,7313,A
1-PB2,1493,0,7298,0,7,7305,T
1-PB2,1494,0,6940,0,0,6940,T
1-PB2,1495,0,2,6939,0,6941,G
1-PB2,1496,6920,3,4,0,6927,A
1-PB2,1497,0,6930,0,4,6934,T
1-PB2,1498,8,1,0,6954,6963,C
1-PB2,1499,5,6,6885,0,6896,G
1-PB2,1500,2,2,7072,0,7076,G
1-PB2,1501,0,7027,0,6,7033,T
1-PB2,1502,0,7024,0,5,7029,T
1-PB2,1503,0,7048,0,2,7050,T
1-PB2,1504,0,7049,1,4,7054,T
1-PB2,1505,0,7044,1,6,7051,T
1-PB2,1506,4,7,7053,0,7064,G
1-PB2,1507,6972,3,11,0,6986,A
1-PB2,1508,1,7,7053,0,7061,G
1-PB2,1509,6732,1,8,0,6741,A
1-PB2,1510,4,1,6804,0,6809,G
1-PB2,1511,1,6820,0,10,6831,T
1-PB2,1512,1,6784,0,8,6793,T
1-PB2,1513,6,3,0,6803,6812,C
1-PB2,1514,3,9,6812,0,6824,G
1-PB2,1515,6793,1,13,0,6807,A
1-PB2,1516,2,9,6823,0,6834,G
1-PB2,1517,6818,0,9,1,6828,A
1-PB2,1518,2,2,1,6822,6827,C
1-PB2,1519,5,1,0,6763,6769,C
1-PB2,1520,6703,0,4,2,6709,A
1-PB2,1521,6817,0,10,0,6827,A
1-PB2,1522,1,4,0,6833,6838,C
1-PB2,1523,2,0,6853,0,6855,G
1-PB2,1524,1,6800,0,5,6806,T
1-PB2,1525,2,7,6789,0,6798,G
1-PB2,1526,2,6,6862,0,6870,G
1-PB2,1527,1,4,6876,0,6881,G
1-PB2,1528,6809,0,7,2,6818,A
1-PB2,1529,6863,0,2,0,6865,A
1-PB2,1530,1,6573,1,7,6582,T
1-PB2,1531,1,1,6846,1,6849,G
1-PB2,1532,1,6809,1,3,6814,T
1-PB2,1533,6795,1,6,0,6802,A
1-PB2,1534,0,3,0,6561,6564,C
1-PB2,1535,2,6670,0,0,6672,T
1-PB2,1536,6893,1,1,1,6896,A
1-PB2,1537,1,6865,0,2,6868,T
1-PB2,1538,0,6773,0,6,6779,T
1-PB2,1539,6780,0,1,0,6781,A
1-PB2,1540,2,6150,1,6,6159,T
1-PB2,1541,1,2,0,6440,6443,C
1-PB2,1542,0,6357,0,11,6368,T
1-PB2,1543,4,1,0,6313,6318,C
1-PB2,1544,6,1,3,6317,6327,C
1-PB2,1545,0,6032,2,11,6045,T
1-PB2,1546,1,5,6069,0,6075,G
1-PB2,1547,5984,0,4,1,5989,A
1-PB2,1548,10,7,6017,0,6034,G
1-PB2,1549,0,1,6008,0,6009,G
1-PB2,1550,5377,1,17,0,5395,A
1-PB2,1551,3,5,5465,0,5473,G
1-PB2,1552,0,0,5420,0,5420,G
1-PB2,1553,2,5228,0,10,5240,T
1-PB2,1554,4,0,1,5262,5267,C
1-PB2,1555,5230,0,6,0,5236,A
1-PB2,1556,3,0,5313,0,5316,G
1-PB2,1557,1,5292,1,8,5302,T
1-PB2,1558,2,0,5297,1,5300,G
1-PB2,1559,5291,1,4,0,5296,A
1-PB2,1560,5096,0,5,0,5101,A
1-PB2,1561,5094,0,13,1,5108,A
1-PB2,1562,0,2,0,5118,5120,C
1-PB2,1563,5086,0,2,1,5089,A
1-PB2,1564,1,2,1,5080,5084,C
1-PB2,1565,4839,3,11,2,4855,A
1-PB2,1566,1,0,4886,0,4887,G
1-PB2,1567,1,3,4866,0,4870,G
1-PB2,1568,2,3,4893,0,4898,G
1-PB2,1569,4873,2,3,0,4878,A
1-PB2,1570,4807,2,4,0,4813,A
1-PB2,1571,0,4,0,4855,4859,C
1-PB2,1572,0,4778,1,2,4781,T
1-PB2,1573,1,3,4773,0,4777,G
1-PB2,1574,4724,2,8,0,4734,A
1-PB2,1575,2,5,4765,0,4772,G
1-PB2,1576,4658,0,5,0,4663,A
1-PB2,1577,2,4,4436,0,4442,G
1-PB2,1578,4430,0,4,0,4434,A
1-PB2,1579,0,0,1,4425,4426,C
1-PB2,1580,0,4228,0,2,4230,T
1-PB2,1581,2,3,4308,0,4313,G
1-PB2,1582,4287,2,9,0,4298,A
1-PB2,1583,0,1,1,4307,4309,C
1-PB2,1584,4276,0,3,0,4279,A
1-PB2,1585,4284,1,3,0,4288,A
1-PB2,1586,1,4265,0,1,4267,T
1-PB2,1587,4330,0,1,0,4331,A
1-PB2,1588,4328,0,5,0,4333,A
1-PB2,1589,0,1,0,4362,4363,C
1-PB2,1590,1,4033,0,4,4038,T
1-PB2,1591,0,3997,0,0,3997,T
1-PB2,1592,3950,0,1,0,3951,A
1-PB2,1593,0,3938,1,3,3942,T
1-PB2,1594,0,3908,0,7,3915,T
1-PB2,1595,3,2,0,3897,3902,C
1-PB2,1596,3597,1,1,0,3599,A
1-PB2,1597,0,3591,0,1,3592,T
1-PB2,1598,6,2,0,3433,3441,C
1-PB2,1599,2,0,3447,0,3449,G
1-PB2,1600,0,3458,0,5,3463,T
1-PB2,1601,3,1,1,3414,3419,C
1-PB2,1602,2,2,3417,0,3421,G
1-PB2,1603,3419,0,1,0,3420,A
1-PB2,1604,0,3423,0,4,3427,T
1-PB2,1605,1,2,3420,0,3423,G
1-PB2,1606,3409,0,4,0,3413,A
1-PB2,1607,1,3408,1,3,3413,T
1-PB2,1608,0,0,3401,0,3401,G
1-PB2,1609,0,3263,3,3,3269,T
1-PB2,1610,5,8,3230,0,3243,G
1-PB2,1611,0,0,3261,0,3261,G
1-PB2,1612,1,3,3244,0,3248,G
1-PB2,1613,3169,1,2,0,3172,A
1-PB2,1614,0,0,3181,0,3181,G
1-PB2,1615,2963,1,3,0,2967,A
1-PB2,1616,2,2900,0,0,2902,T
1-PB2,1617,0,2831,1,0,2832,T
1-PB2,1618,2817,1,9,0,2827,A
1-PB2,1619,2816,1,1,0,2818,A
1-PB2,1620,0,0,0,2795,2795,C
1-PB2,1621,3,2,2591,0,2596,G
1-PB2,1622,0,0,2616,0,2616,G
1-PB2,1623,0,2293,0,1,2294,T
1-PB2,1624,2,0,0,2275,2277,C
1-PB2,1625,5,1,0,2273,2279,C
1-PB2,1626,0,2167,0,2,2169,T
1-PB2,1627,2,3,2246,0,2251,G
1-PB2,1628,2242,0,2,0,2244,A
1-PB2,1629,0,0,2277,0,2277,G
1-PB2,1630,1,2275,0,0,2276,T
1-PB2,1631,3,0,0,2180,2183,C
1-PB2,1632,0,0,2185,0,2185,G
1-PB2,1633,3,1,2215,0,2219,G
1-PB2,1634,0,2204,1,3,2208,T
1-PB2,1635,0,2210,0,2,2212,T
1-PB2,1636,0,2209,2,0,2211,T
1-PB2,1637,0,2212,0,2,2214,T
1-PB2,1638,0,0,2281,0,2281,G
1-PB2,1639,1,0,2292,0,2293,G
1-PB2,1640,0,2303,0,0,2303,T
1-PB2,1641,2,2,0,2284,2288,C
1-PB2,1642,2226,0,2,0,2228,A
1-PB2,1643,2307,1,2,0,2310,A
1-PB2,1644,0,2308,0,0,2308,T
1-PB2,1645,2330,0,1,1,2332,A
1-PB2,1646,0,0,0,2397,2397,C
1-PB2,1647,0,0,0,2289,2289,C
1-PB2,1648,0,2281,7,1,2289,T
1-PB2,1649,2328,0,0,0,2328,A
1-PB2,1650,0,2329,0,2,2331,T
1-PB2,1651,2,0,0,2346,2348,C
1-PB2,1652,2255,1,1,0,2257,A
1-PB2,1653,2258,0,1,0,2259,A
1-PB2,1654,0,2254,1,1,2256,T
1-PB2,1655,0,1,2161,0,2162,G
1-PB2,1656,0,0,2164,0,2164,G
1-PB2,1657,2146,0,1,0,2147,A
1-PB2,1658,0,2108,0,1,2109,T
1-PB2,1659,1,3,0,2113,2117,C
1-PB2,1660,2116,0,1,0,2117,A
1-PB2,1661,1,2113,0,0,2114,T
1-PB2,1662,0,1,0,2123,2124,C
1-PB2,1663,2120,0,3,2,2125,A
1-PB2,1664,0,1,2137,0,2138,G
1-PB2,1665,2125,0,2,0,2127,A
1-PB2,1666,2126,0,1,1,2128,A
1-PB2,1667,2136,1,2,0,2139,A
1-PB2,1668,0,2147,0,0,2147,T
1-PB2,1669,0,2126,0,1,2127,T
1-PB2,1670,2,4,2117,0,2123,G
1-PB2,1671,0,3,2121,0,2124,G
1-PB2,1672,1,3,2116,0,2120,G
1-PB2,1673,2096,0,1,0,2097,A
1-PB2,1674,2100,0,4,0,2104,A
1-PB2,1675,3,0,2105,0,2108,G
1-PB2,1676,0,1,0,2101,2102,C
1-PB2,1677,0,2086,0,2,2088,T
1-PB2,1678,2094,0,0,0,2094,A
1-PB2,1679,0,2107,0,1,2108,T
1-PB2,1680,0,0,0,2114,2114,C
1-PB2,1681,2121,3,4,0,2128,A
1-PB2,1682,2131,0,1,0,2132,A
1-PB2,1683,2124,0,1,0,2125,A
1-PB2,1684,2138,0,0,0,2138,A
1-PB2,1685,0,2134,0,3,2137,T
1-PB2,1686,0,2138,0,1,2139,T
1-PB2,1687,2,1,0,2124,2127,C
1-PB2,1688,2122,0,1,0,2123,A
1-PB2,1689,2117,0,2,0,2119,A
1-PB2,1690,1,2121,0,3,2125,T
1-PB2,1691,0,0,2120,0,2120,G
1-PB2,1692,1,0,2140,0,2141,G
1-PB2,1693,0,2170,0,4,2174,T
1-PB2,1694,4,1,0,2182,2187,C
1-PB2,1695,0,2176,0,3,2179,T
1-PB2,1696,1,2,0,2197,2200,C
1-PB2,1697,2199,0,1,0,2200,A
1-PB2,1698,0,2,2209,0,2211,G
1-PB2,1699,2198,0,1,0,2199,A
1-PB2,1700,2214,0,1,0,2215,A
1-PB2,1701,0,2167,0,1,2168,T
1-PB2,1702,0,0,0,2134,2134,C
1-PB2,1703,1,0,0,2154,2155,C
1-PB2,1704,3,2126,0,5,2134,T
1-PB2,1705,1,0,2137,1,2139,G
1-PB2,1706,0,2,0,2144,2146,C
1-PB2,1707,2124,0,0,0,2124,A
1-PB2,1708,2169,0,2,0,2171,A
1-PB2,1709,0,2137,0,2,2139,T
1-PB2,1710,2,0,2191,0,2193,G
1-PB2,1711,0,2195,0,2,2197,T
1-PB2,1712,0,2101,0,0,2101,T
1-PB2,1713,2,1,2132,0,2135,G
1-PB2,1714,0,2127,0,2,2129,T
1-PB2,1715,2125,0,5,0,2130,A
1-PB2,1716,0,0,0,2129,2129,C
1-PB2,1717,2080,0,2,0,2082,A
1-PB2,1718,2103,0,3,0,2106,A
1-PB2,1719,0,2,0,2086,2088,C
1-PB2,1720,2032,0,2,0,2034,A
1-PB2,1721,2040,0,0,0,2040,A
1-PB2,1722,1993,0,1,0,1994,A
1-PB2,1723,1993,0,3,0,1996,A
1-PB2,1724,0,1994,0,1,1995,T
1-PB2,1725,1,1,1989,0,1991,G
1-PB2,1726,1,0,1999,0,2000,G
1-PB2,1727,1976,1,3,0,1980,A
1-PB2,1728,1996,0,1,0,1997,A
1-PB2,1729,0,1986,0,0,1986,T
1-PB2,1730,0,1975,0,1,1976,T
1-PB2,1731,0,1981,0,1,1982,T
1-PB2,1732,0,3,1986,0,1989,G
1-PB2,1733,1986,0,0,1,1987,A
1-PB2,1734,1986,0,1,1,1988,A
1-PB2,1735,1,0,0,1975,1976,C
1-PB2,1736,4,0,0,1950,1954,C
1-PB2,1737,1980,0,0,0,1980,A
1-PB2,1738,0,1996,0,2,1998,T
1-PB2,1739,1,1988,1,1,1991,T
1-PB2,1740,0,1994,0,2,1996,T
1-PB2,1741,4,0,0,1992,1996,C
1-PB2,1742,1997,0,3,0,2000,A
1-PB2,1743,2003,2,1,0,2006,A
1-PB2,1744,1,1988,0,0,1989,T
1-PB2,1745,1,0,0,2037,2038,C
1-PB2,1746,0,2009,0,2,2011,T
1-PB2,1747,1,2000,0,1,2002,T
1-PB2,1748,0,2009,0,0,2009,T
1-PB2,1749,2009,0,1,2,2012,A
1-PB2,1750,1,0,2016,0,2017,G
1-PB2,1751,0,2013,0,1,2014,T
1-PB2,1752,1,0,0,2049,2050,C
1-PB2,1753,2,2,0,2051,2055,C
1-PB2,1754,8,1,0,2029,2038,C
1-PB2,1755,6,0,0,2039,2045,C
1-PB2,1756,2042,0,0,0,2042,A
1-PB2,1757,2041,0,2,1,2044,A
1-PB2,1758,1,4,2088,0,2093,G
1-PB2,1759,0,0,2084,0,2084,G
1-PB2,1760,0,0,0,2086,2086,C
1-PB2,1761,1,1,0,2058,2060,C
1-PB2,1762,2064,0,2,0,2066,A
1-PB2,1763,0,2105,0,0,2105,T
1-PB2,1764,0,2109,0,0,2109,T
1-PB2,1765,2109,0,2,0,2111,A
1-PB2,1766,1,0,2106,0,2107,G
1-PB2,1767,2045,0,0,0,2045,A
1-PB2,1768,2135,0,5,0,2140,A
1-PB2,1769,1,1,2158,0,2160,G
1-PB2,1770,0,1,0,2166,2167,C
1-PB2,1771,0,0,0,2166,2166,C
1-PB2,1772,2138,0,1,0,2139,A
1-PB2,1773,2177,0,2,0,2179,A
1-PB2,1774,0,2185,0,0,2185,T
1-PB2,1775,2210,1,0,0,2211,A
1-PB2,1776,0,0,0,2221,2221,C
1-PB2,1777,2035,0,0,0,2035,A
1-PB2,1778,0,0,2044,0,2044,G
1-PB2,1779,0,1983,0,1,1984,T
1-PB2,1780,0,1,2011,0,2012,G
1-PB2,1781,2,1,2008,0,2011,G
1-PB2,1782,0,0,2017,0,2017,G
1-PB2,1783,0,1989,0,2,1991,T
1-PB2,1784,0,1970,0,1,1971,T
1-PB2,1785,0,1998,0,1,1999,T
1-PB2,1786,1,0,2009,0,2010,G
1-PB2,1787,0,2004,1,3,2008,T
1-PB2,1788,2,0,0,2005,2007,C
1-PB2,1789,1968,1,3,0,1972,A
1-PB2,1790,1,2,1974,0,1977,G
1-PB2,1791,1961,0,2,0,1963,A
1-PB2,1792,1964,0,0,0,1964,A
1-PB2,1793,0,2,0,1967,1969,C
1-PB2,1794,0,1914,1,1,1916,T
1-PB2,1795,0,0,0,1988,1988,C
1-PB2,1796,0,1990,0,0,1990,T
1-PB2,1797,2001,0,0,2,2003,A
1-PB2,1798,0,2006,0,2,2008,T
1-PB2,1799,0,1988,0,3,1991,T
1-PB2,1800,2,1,0,1989,1992,C
1-PB2,1801,3,0,0,1962,1965,C
1-PB2,1802,1960,0,2,0,1962,A
1-PB2,1803,1966,0,4,0,1970,A
1-PB2,1804,0,0,0,1968,1968,C
1-PB2,1805,1950,0,1,0,1951,A
1-PB2,1806,1949,0,0,0,1949,A
1-PB2,1807,1949,0,0,1,1950,A
1-PB2,1808,0,1961,0,1,1962,T
1-PB2,1809,2,5,1959,0,1966,G
1-PB2,1810,1936,0,4,0,1940,A
1-PB2,1811,0,1,1961,0,1962,G
1-PB2,1812,1935,1,3,0,1939,A
1-PB2,1813,1,0,1945,0,1946,G
1-PB2,1814,1936,0,6,0,1942,A
1-PB2,1815,0,0,0,1928,1928,C
1-PB2,1816,0,0,1961,0,1961,G
1-PB2,1817,0,1976,0,2,1978,T
1-PB2,1818,2004,0,2,0,2006,A
1-PB2,1819,2,0,1,2001,2004,C
1-PB2,1820,0,1986,0,1,1987,T
1-PB2,1821,0,1985,0,2,1987,T
1-PB2,1822,0,2,1978,0,1980,G
1-PB2,1823,0,0,1982,0,1982,G
1-PB2,1824,1,3,1988,0,1992,G
1-PB2,1825,1978,1,2,0,1981,A
1-PB2,1826,1,0,0,1989,1990,C
1-PB2,1827,2014,0,0,0,2014,A
1-PB2,1828,1,2014,0,2,2017,T
1-PB2,1829,0,2009,0,2,2011,T
1-PB2,1830,0,2020,0,1,2021,T
1-PB2,1831,0,2,2011,0,2013,G
1-PB2,1832,2010,0,1,0,2011,A
1-PB2,1833,0,0,0,2011,2011,C
1-PB2,1834,2009,0,1,0,2010,A
1-PB2,1835,1,3,0,2013,2017,C
1-PB2,1836,0,1,0,1982,1983,C
1-PB2,1837,2003,0,1,0,2004,A
1-PB2,1838,1,1,0,2022,2024,C
1-PB2,1839,1,2,0,2015,2018,C
1-PB2,1840,3,1,0,2020,2024,C
1-PB2,1841,2014,0,0,1,2015,A
1-PB2,1842,1,0,2060,0,2061,G
1-PB2,1843,2056,0,0,0,2056,A
1-PB2,1844,0,2155,0,0,2155,T
1-PB2,1845,2113,0,2,0,2115,A
1-PB2,1846,2099,0,5,0,2104,A
1-PB2,1847,0,2102,0,0,2102,T
1-PB2,1848,2095,0,2,0,2097,A
1-PB2,1849,2092,0,0,0,2092,A
1-PB2,1850,2071,0,0,0,2071,A
1-PB2,1851,0,0,2084,0,2084,G
1-PB2,1852,0,0,0,2066,2066,C
1-PB2,1853,0,1954,0,2,1956,T
1-PB2,1854,0,1957,0,1,1958,T
1-PB2,1855,1,0,0,1957,1958,C
1-PB2,1856,0,1930,0,3,1933,T
1-PB2,1857,0,0,0,1997,1997,C
1-PB2,1858,3,0,0,1994,1997,C
1-PB2,1859,3,0,0,2017,2020,C
1-PB2,1860,0,1991,0,3,1994,T
1-PB2,1861,0,1981,0,1,1982,T
1-PB2,1862,1,1988,0,3,1992,T
1-PB2,1863,0,1998,0,0,1998,T
1-PB2,1864,0,0,1992,0,1992,G
1-PB2,1865,0,2,0,1990,1992,C
1-PB2,1866,1950,0,3,0,1953,A
1-PB2,1867,1,0,1956,0,1957,G
1-PB2,1868,0,0,0,1958,1958,C
1-PB2,1869,0,1939,0,1,1940,T
1-PB2,1870,2,0,1947,0,1949,G
1-PB2,1871,0,1,0,1949,1950,C
1-PB2,1872,1,1924,0,8,1933,T
1-PB2,1873,0,1,0,1964,1965,C
1-PB2,1874,3,1,0,1978,1982,C
1-PB2,1875,1999,0,1,0,2000,A
1-PB2,1876,2,1,0,1999,2002,C
1-PB2,1877,0,0,1,1993,1994,C
1-PB2,1878,1974,0,1,0,1975,A
1-PB2,1879,1983,0,1,2,1986,A
1-PB2,1880,1974,0,3,0,1977,A
1-PB2,1881,0,0,2010,0,2010,G
1-PB2,1882,1,3,0,1996,2000,C
1-PB2,1883,1966,0,0,0,1966,A
1-PB2,1884,1977,1,0,0,1978,A
1-PB2,1885,1973,0,2,1,1976,A
1-PB2,1886,0,0,2002,0,2002,G
1-PB2,1887,1,1,0,2004,2006,C
1-PB2,1888,1987,0,5,0,1992,A
1-PB2,1889,0,0,2000,0,2000,G
1-PB2,1890,1980,0,2,0,1982,A
1-PB2,1891,2016,0,0,0,2016,A
1-PB2,1892,0,2011,0,2,2013,T
1-PB2,1893,1,1,2009,0,2011,G
1-PB2,1894,1,1,0,2008,2010,C
1-PB2,1895,1977,0,0,0,1977,A
1-PB2,1896,0,0,2002,0,2002,G
1-PB2,1897,0,2003,0,2,2005,T
1-PB2,1898,0,2077,0,3,2080,T
1-PB2,1899,3,0,0,2100,2103,C
1-PB2,1900,1,2052,0,1,2054,T
1-PB2,1901,1,0,0,2095,2096,C
1-PB2,1902,0,2077,0,6,2083,T
1-PB2,1903,0,2083,0,0,2083,T
1-PB2,1904,1,1,1,2095,2098,C
1-PB2,1905,2073,0,2,0,2075,A
1-PB2,1906,0,0,0,2076,2076,C
1-PB2,1907,0,2001,1,3,2005,T
1-PB2,1908,2,4,2026,0,2032,G
1-PB2,1909,2016,0,1,0,2017,A
1-PB2,1910,2,2,0,2087,2091,C
1-PB2,1911,0,2046,1,1,2048,T
1-PB2,1912,0,0,2074,0,2074,G
1-PB2,1913,0,2053,1,1,2055,T
1-PB2,1914,1,1,2078,0,2080,G
1-PB2,1915,2070,0,3,0,2073,A
1-PB2,1916,2095,0,0,0,2095,A
1-PB2,1917,0,2059,1,2,2062,T
1-PB2,1918,0,0,2067,0,2067,G
1-PB2,1919,0,1981,1,1,1983,T
1-PB2,1920,2,0,1986,0,1988,G
1-PB2,1921,1935,0,4,0,1939,A
1-PB2,1922,0,5,1953,0,1958,G
1-PB2,1923,0,1,1939,0,1940,G
1-PB2,1924,1,1,1931,0,1933,G
1-PB2,1925,0,0,1993,1,1994,G
1-PB2,1926,1989,0,0,0,1989,A
1-PB2,1927,0,1986,0,2,1988,T
1-PB2,1928,2,1,0,1990,1993,C
1-PB2,1929,1983,0,1,0,1984,A
1-PB2,1930,0,3,2020,0,2023,G
1-PB2,1931,1,1,2014,0,2016,G
1-PB2,1932,0,1,2020,0,2021,G
1-PB2,1933,2014,0,1,1,2016,A
1-PB2,1934,0,1896,0,0,1896,T
1-PB2,1935,1,0,1897,1,1899,G
1-PB2,1936,1887,0,1,0,1888,A
1-PB2,1937,0,0,1948,0,1948,G
1-PB2,1938,1937,0,2,0,1939,A
1-PB2,1939,1895,0,2,0,1897,A
1-PB2,1940,0,1932,0,1,1933,T
1-PB2,1941,1925,0,1,0,1926,A
1-PB2,1942,0,1,1,1963,1965,C
1-PB2,1943,0,1929,0,5,1934,T
1-PB2,1944,1,1927,0,2,1930,T
1-PB2,1945,2,2,1941,0,1945,G
1-PB2,1946,0,1876,0,2,1878,T
1-PB2,1947,1868,0,0,0,1868,A
1-PB2,1948,1857,0,2,0,1859,A
1-PB2,1949,2,2,1818,0,1822,G
1-PB2,1950,1,2,1833,0,1836,G
1-PB2,1951,1,2,1798,0,1801,G
1-PB2,1952,1,1,1796,0,1798,G
1-PB2,1953,2,2,0,1801,1805,C
1-PB2,1954,1798,0,0,0,1798,A
1-PB2,1955,1837,1,0,0,1838,A
1-PB2,1956,0,1842,0,3,1845,T
1-PB2,1957,0,1829,0,3,1832,T
1-PB2,1958,2,1,0,1894,1897,C
1-PB2,1959,0,1845,0,4,1849,T
1-PB2,1960,1,1,0,1884,1886,C
1-PB2,1961,2,3,0,1891,1896,C
1-PB2,1962,1,1877,0,2,1880,T
1-PB2,1963,0,1,1931,0,1932,G
1-PB2,1964,0,1877,0,2,1879,T
1-PB2,1965,1890,0,0,1,1891,A
1-PB2,1966,0,1886,1,4,1891,T
1-PB2,1967,0,1838,0,0,1838,T
1-PB2,1968,4,0,0,1846,1850,C
1-PB2,1969,1824,0,2,0,1826,A
1-PB2,1970,1858,0,3,0,1861,A
1-PB2,1971,0,0,0,1866,1866,C
1-PB2,1972,0,1825,0,0,1825,T
1-PB2,1973,1828,0,0,0,1828,A
1-PB2,1974,1,2,0,1893,1896,C
1-PB2,1975,1884,1,1,0,1886,A
1-PB2,1976,1886,0,2,0,1888,A
1-PB2,1977,0,1,0,1873,1874,C
1-PB2,1978,1853,1,1,0,1855,A
1-PB2,1979,1829,0,2,0,1831,A
1-PB2,1980,0,5,1837,0,1842,G
1-PB2,1981,1845,0,2,0,1847,A
1-PB2,1982,0,0,0,1855,1855,C
1-PB2,1983,3,0,0,1785,1788,C
1-PB2,1984,1796,0,0,0,1796,A
1-PB2,1985,0,1,0,1889,1890,C
1-PB2,1986,0,1884,0,0,1884,T
1-PB2,1987,1887,0,0,0,1887,A
1-PB2,1988,1887,0,0,0,1887,A
1-PB2,1989,1882,0,0,0,1882,A
1-PB2,1990,1870,0,6,0,1876,A
1-PB2,1991,0,0,1902,0,1902,G
1-PB2,1992,1881,0,4,1,1886,A
1-PB2,1993,0,2,0,1884,1886,C
1-PB2,1994,0,1813,1,4,1818,T
1-PB2,1995,1825,0,0,0,1825,A
1-PB2,1996,1823,0,1,0,1824,A
1-PB2,1997,0,1,0,1825,1826,C
1-PB2,1998,1819,0,0,0,1819,A
1-PB2,1999,1817,0,0,0,1817,A
1-PB2,2000,0,1782,0,0,1782,T
1-PB2,2001,0,1757,0,3,1760,T
1-PB2,2002,2,0,0,1784,1786,C
1-PB2,2003,0,1760,0,3,1763,T
1-PB2,2004,1,0,0,1784,1785,C
1-PB2,2005,1,1,1785,0,1787,G
1-PB2,2006,1,1,1787,0,1789,G
1-PB2,2007,1783,0,1,0,1784,A
1-PB2,2008,1782,0,0,0,1782,A
1-PB2,2009,1783,0,1,0,1784,A
1-PB2,2010,1779,0,4,0,1783,A
1-PB2,2011,0,0,1784,0,1784,G
1-PB2,2012,1779,0,1,0,1780,A
1-PB2,2013,0,1788,0,0,1788,T
1-PB2,2014,0,0,1779,0,1779,G
1-PB2,2015,0,1,0,1775,1776,C
1-PB2,2016,0,1,1,1779,1781,C
1-PB2,2017,2,3,1779,0,1784,G
1-PB2,2018,0,0,1779,0,1779,G
1-PB2,2019,0,2,0,1782,1784,C
1-PB2,2020,1791,1,0,0,1792,A
1-PB2,2021,0,0,0,1835,1835,C
1-PB2,2022,0,1820,0,0,1820,T
1-PB2,2023,0,1824,0,2,1826,T
1-PB2,2024,1,1830,0,0,1831,T
1-PB2,2025,1834,0,1,0,1835,A
1-PB2,2026,1847,0,1,0,1848,A
1-PB2,2027,0,1847,0,0,1847,T
1-PB2,2028,0,1837,0,1,1838,T
1-PB2,2029,0,1,1828,0,1829,G
1-PB2,2030,1766,0,1,1,1768,A
1-PB2,2031,1767,0,1,0,1768,A
1-PB2,2032,0,1,1765,0,1766,G
1-PB2,2033,1796,0,9,0,1805,A
1-PB2,2034,0,0,0,1803,1803,C
1-PB2,2035,1,1,0,1783,1785,C
1-PB2,2036,2,0,0,1796,1798,C
1-PB2,2037,1781,3,4,0,1788,A
1-PB2,2038,0,0,1844,0,1844,G
1-PB2,2039,1836,0,3,0,1839,A
1-PB2,2040,0,1848,0,1,1849,T
1-PB2,2041,1,1,1849,0,1851,G
1-PB2,2042,1808,0,1,0,1809,A
1-PB2,2043,1796,0,1,0,1797,A
1-PB2,2044,1807,0,2,1,1810,A
1-PB2,2045,0,0,1816,0,1816,G
1-PB2,2046,0,0,0,1804,1804,C
1-PB2,2047,1782,0,0,0,1782,A
1-PB2,2048,0,0,0,1810,1810,C
1-PB2,2049,1809,0,1,0,1810,A
1-PB2,2050,1,1793,0,1,1795,T
1-PB2,2051,1,1,0,1829,1831,C
1-PB2,2052,2,3,0,1826,1831,C
1-PB2,2053,1,0,1853,0,1854,G
1-PB2,2054,0,1,1856,0,1857,G
1-PB2,2055,1836,0,0,0,1836,A
1-PB2,2056,0,0,1853,0,1853,G
1-PB2,2057,1,1803,0,3,1807,T
1-PB2,2058,0,0,1806,0,1806,G
1-PB2,2059,0,4,1802,1,1807,G
1-PB2,2060,1772,0,2,0,1774,A
1-PB2,2061,0,0,1780,0,1780,G
1-PB2,2062,0,1739,0,3,1742,T
1-PB2,2063,2,0,0,1732,1734,C
1-PB2,2064,1,1,0,1733,1735,C
1-PB2,2065,2,0,1730,0,1732,G
1-PB2,2066,0,0,0,1729,1729,C
1-PB2,2067,1,1,0,1725,1727,C
1-PB2,2068,1,0,1795,0,1796,G
1-PB2,2069,0,1789,0,1,1790,T
1-PB2,2070,0,0,0,1805,1805,C
1-PB2,2071,0,1809,0,0,1809,T
1-PB2,2072,0,1806,0,2,1808,T
1-PB2,2073,0,2,1807,0,1809,G
1-PB2,2074,1783,0,2,0,1785,A
1-PB2,2075,0,1,1795,0,1796,G
1-PB2,2076,1776,0,5,0,1781,A
1-PB2,2077,0,5,1720,0,1725,G
1-PB2,2078,0,0,1724,0,1724,G
1-PB2,2079,0,0,1728,0,1728,G
1-PB2,2080,0,1708,0,3,1711,T
1-PB2,2081,0,1702,1,1,1704,T
1-PB2,2082,0,1722,0,7,1729,T
1-PB2,2083,0,0,0,1725,1725,C
1-PB2,2084,1,1723,0,2,1726,T
1-PB2,2085,6,3,0,1805,1814,C
1-PB2,2086,1812,0,1,0,1813,A
1-PB2,2087,0,1795,0,2,1797,T
1-PB2,2088,0,1787,0,0,1787,T
1-PB2,2089,1786,0,1,0,1787,A
1-PB2,2090,0,1789,0,1,1790,T
1-PB2,2091,1780,0,1,0,1781,A
1-PB2,2092,0,0,1801,0,1801,G
1-PB2,2093,0,0,1820,0,1820,G
1-PB2,2094,1,1683,0,1,1685,T
1-PB2,2095,1686,0,1,1,1688,A
1-PB2,2096,1667,0,3,0,1670,A
1-PB2,2097,1,2,1675,0,1678,G
1-PB2,2098,1,1,1683,0,1685,G
1-PB2,2099,1674,0,0,0,1674,A
1-PB2,2100,1653,0,2,0,1655,A
1-PB2,2101,1,1,1651,0,1653,G
1-PB2,2102,1624,1,5,0,1630,A
1-PB2,2103,0,0,0,1637,1637,C
1-PB2,2104,1623,0,1,1,1625,A
1-PB2,2105,1,0,1637,0,1638,G
1-PB2,2106,1622,0,5,0,1627,A
1-PB2,2107,1607,0,2,1,1610,A
1-PB2,2108,0,1,1622,0,1623,G
1-PB2,2109,1610,0,3,0,1613,A
1-PB2,2110,0,1622,0,0,1622,T
1-PB2,2111,1621,0,0,0,1621,A
1-PB2,2112,0,3,0,1607,1610,C
1-PB2,2113,0,1,1596,0,1597,G
1-PB2,2114,2,1,1642,0,1645,G
1-PB2,2115,1633,0,1,0,1634,A
1-PB2,2116,0,1,0,1630,1631,C
1-PB2,2117,0,0,0,1625,1625,C
1-PB2,2118,1602,0,1,0,1603,A
1-PB2,2119,0,1,1695,0,1696,G
1-PB2,2120,0,1,0,1693,1694,C
1-PB2,2121,1701,0,0,0,1701,A
1-PB2,2122,0,1690,1,1,1692,T
1-PB2,2123,0,1617,0,2,1619,T
1-PB2,2124,1625,0,1,0,1626,A
1-PB2,2125,1618,0,1,0,1619,A
1-PB2,2126,0,2,1630,0,1632,G
1-PB2,2127,0,2,0,1623,1625,C
1-PB2,2128,1506,0,2,0,1508,A
1-PB2,2129,1,1582,0,0,1583,T
1-PB2,2130,0,0,0,1583,1583,C
1-PB2,2131,1591,1,1,0,1593,A
1-PB2,2132,1592,0,0,0,1592,A
1-PB2,2133,0,1585,0,3,1588,T
1-PB2,2134,0,4,1589,0,1593,G
1-PB2,2135,1573,0,1,0,1574,A
1-PB2,2136,1569,0,1,0,1570,A
1-PB2,2137,1,0,0,1582,1583,C
1-PB2,2138,1,1457,1,1,1460,T
1-PB2,2139,0,0,1484,0,1484,G
1-PB2,2140,1472,0,1,0,1473,A
1-PB2,2141,1,1,1467,1,1470,G
1-PB2,2142,2,0,0,1453,1455,C
1-PB2,2143,1459,0,1,0,1460,A
1-PB2,2144,1499,1,1,0,1501,A
1-PB2,2145,0,1,0,1502,1503,C
1-PB2,2146,2,0,0,1483,1485,C
1-PB2,2147,0,1481,1,1,1483,T
1-PB2,2148,0,1465,0,2,1467,T
1-PB2,2149,1,1,1468,0,1470,G
1-PB2,2150,1,1,0,1473,1475,C
1-PB2,2151,1472,0,0,0,1472,A
1-PB2,2152,1473,0,0,0,1473,A
1-PB2,2153,1411,0,0,0,1411,A
1-PB2,2154,1397,1,4,0,1402,A
1-PB2,2155,1,1,1406,0,1408,G
1-PB2,2156,1,4,1406,0,1411,G
1-PB2,2157,1,0,1411,0,1412,G
1-PB2,2158,0,0,1407,0,1407,G
1-PB2,2159,1410,0,0,0,1410,A
1-PB2,2160,1413,0,0,0,1413,A
1-PB2,2161,1407,1,1,0,1409,A
1-PB2,2162,1423,0,6,0,1429,A
1-PB2,2163,0,3,1440,0,1443,G
1-PB2,2164,4,0,1427,0,1431,G
1-PB2,2165,0,0,0,1431,1431,C
1-PB2,2166,0,1408,0,2,1410,T
1-PB2,2167,1411,0,0,0,1411,A
1-PB2,2168,1411,0,0,0,1411,A
1-PB2,2169,0,1416,0,1,1417,T
1-PB2,2170,0,0,1444,0,1444,G
1-PB2,2171,1,1363,0,1,1365,T
1-PB2,2172,0,0,1347,0,1347,G
1-PB2,2173,1,1,0,1340,1342,C
1-PB2,2174,0,1327,0,1,1328,T
1-PB2,2175,1341,0,0,0,1341,A
1-PB2,2176,1335,0,0,0,1335,A
1-PB2,2177,0,1329,0,0,1329,T
1-PB2,2178,2,0,0,1318,1320,C
1-PB2,2179,1,3,1267,0,1271,G
1-PB2,2180,0,1,1276,0,1277,G
1-PB2,2181,1,0,1283,0,1284,G
1-PB2,2182,0,0,0,1278,1278,C
1-PB2,2183,1291,1,0,0,1292,A
1-PB2,2184,1290,0,1,0,1291,A
1-PB2,2185,0,0,1293,0,1293,G
1-PB2,2186,0,2,1296,0,1298,G
1-PB2,2187,1286,0,2,0,1288,A
1-PB2,2188,1,0,1292,0,1293,G
1-PB2,2189,1264,0,2,0,1266,A
1-PB2,2190,0,1,0,1262,1263,C
1-PB2,2191,0,0,1262,0,1262,G
1-PB2,2192,0,1259,0,0,1259,T
1-PB2,2193,0,3,1251,0,1254,G
1-PB2,2194,1,0,1274,0,1275,G
1-PB2,2195,0,1239,0,0,1239,T
1-PB2,2196,0,0,1255,0,1255,G
1-PB2,2197,0,1225,0,1,1226,T
1-PB2,2198,0,1220,1,0,1221,T
1-PB2,2199,0,1,1215,0,1216,G
1-PB2,2200,1,0,1221,0,1222,G
1-PB2,2201,0,1212,0,1,1213,T
1-PB2,2202,1204,0,0,0,1204,A
1-PB2,2203,1163,0,0,1,1164,A
1-PB2,2204,1,1132,0,0,1133,T
1-PB2,2205,0,1,1126,0,1127,G
1-PB2,2206,1124,0,0,0,1124,A
1-PB2,2207,1116,0,1,0,1117,A
1-PB2,2208,1116,0,2,0,1118,A
1-PB2,2209,0,0,0,1110,1110,C
1-PB2,2210,0,1,1107,0,1108,G
1-PB2,2211,1106,0,0,0,1106,A
1-PB2,2212,1106,0,0,0,1106,A
1-PB2,2213,1099,0,1,0,1100,A
1-PB2,2214,1107,0,1,0,1108,A
1-PB2,2215,0,0,0,1114,1114,C
1-PB2,2216,1,1,1100,0,1102,G
1-PB2,2217,0,2,1100,0,1102,G
1-PB2,2218,1,0,1110,0,1111,G
1-PB2,2219,1113,0,2,0,1115,A
1-PB2,2220,1,0,0,1126,1127,C
1-PB2,2221,0,1101,0,5,1106,T
1-PB2,2222,2,1,0,1154,1157,C
1-PB2,2223,0,1155,0,1,1156,T
1-PB2,2224,1155,0,1,0,1156,A
1-PB2,2225,0,0,1162,0,1162,G
1-PB2,2226,0,1,0,1137,1138,C
1-PB2,2227,1135,0,0,0,1135,A
1-PB2,2228,0,1130,0,0,1130,T
1-PB2,2229,1096,0,1,0,1097,A
1-PB2,2230,1,0,0,1118,1119,C
1-PB2,2231,0,949,0,1,950,T
1-PB2,2232,0,945,0,0,945,T
1-PB2,2233,929,0,0,0,929,A
1-PB2,2234,0,0,0,930,930,C
1-PB2,2235,0,917,0,1,918,T
1-PB2,2236,0,1,918,0,919,G
1-PB2,2237,895,0,1,0,896,A
1-PB2,2238,0,0,0,907,907,C
1-PB2,2239,825,1,3,0,829,A
1-PB2,2240,0,0,835,0,835,G
1-PB2,2241,0,1,0,830,831,C
1-PB2,2242,1,0,0,832,833,C
1-PB2,2243,826,0,0,0,826,A
1-PB2,2244,0,1,823,0,824,G
1-PB2,2245,818,0,1,0,819,A
1-PB2,2246,0,0,0,819,819,C
1-PB2,2247,777,0,0,0,777,A
1-PB2,2248,0,0,776,0,776,G
1-PB2,2249,0,1,0,719,720,C
1-PB2,2250,0,0,718,0,718,G
1-PB2,2251,720,0,1,0,721,A
1-PB2,2252,0,0,0,718,718,C
1-PB2,2253,1,0,0,713,714,C
1-PB2,2254,713,0,0,0,713,A
1-PB2,2255,714,0,0,0,714,A
1-PB2,2256,711,0,0,0,711,A
1-PB2,2257,713,0,0,0,713,A
1-PB2,2258,1,0,713,0,714,G
1-PB2,2259,674,0,0,0,674,A
1-PB2,2260,677,0,2,0,679,A
1-PB2,2261,0,668,0,0,668,T
1-PB2,2262,0,671,0,0,671,T
1-PB2,2263,0,1,0,672,673,C
1-PB2,2264,0,1,659,0,660,G
1-PB2,2265,0,1,660,0,661,G
1-PB2,2266,652,1,1,0,654,A
1-PB2,2267,0,631,0,0,631,T
1-PB2,2268,0,1,629,0,630,G
1-PB2,2269,0,0,625,0,625,G
1-PB2,2270,0,0,0,620,620,C
1-PB2,2271,0,0,0,617,617,C
1-PB2,2272,616,0,1,0,617,A
1-PB2,2273,0,613,0,2,615,T
1-PB2,2274,0,0,0,610,610,C
1-PB2,2275,613,0,1,0,614,A
1-PB2,2276,615,0,0,0,615,A
1-PB2,2277,0,600,0,0,600,T
1-PB2,2278,0,549,0,0,549,T
1-PB2,2279,531,0,0,0,531,A
1-PB2,2280,526,0,0,0,526,A
2-PB1,1,774,0,0,0,774,A
2-PB1,2,0,782,0,0,782,T
2-PB1,3,0,0,788,0,788,G
2-PB1,4,1,0,839,0,840,G
2-PB1,5,938,0,1,0,939,A
2-PB1,6,0,1016,0,0,1016,T
2-PB1,7,0,0,1021,0,1021,G
2-PB1,8,0,1021,0,4,1025,T
2-PB1,9,1,1,0,1119,1121,C
2-PB1,10,1128,0,0,0,1128,A
2-PB1,11,1160,0,1,1,1162,A
2-PB1,12,0,1161,0,3,1164,T
2-PB1,13,1,0,0,1187,1188,C
2-PB1,14,1,1,0,1260,1262,C
2-PB1,15,0,3,1277,0,1280,G
2-PB1,16,1431,0,1,0,1432,A
2-PB1,17,0,0,0,1466,1466,C
2-PB1,18,0,1452,0,6,1458,T
2-PB1,19,0,0,0,1713,1713,C
2-PB1,20,0,1711,0,2,1713,T
2-PB1,21,1724,1,1,0,1726,A
2-PB1,22,0,0,0,1733,1733,C
2-PB1,23,1,1735,0,0,1736,T
2-PB1,24,0,1,1965,0,1966,G
2-PB1,25,0,1976,0,2,1978,T
2-PB1,26,0,1978,0,2,1980,T
2-PB1,27,0,0,0,1973,1973,C
2-PB1,28,3,3,0,1967,1973,C
2-PB1,29,0,2314,0,2,2316,T
2-PB1,30,2355,0,0,0,2355,A
2-PB1,31,2345,0,0,0,2345,A
2-PB1,32,2362,0,4,0,2366,A
2-PB1,33,0,6,2361,0,2367,G
2-PB1,34,1,1,2381,0,2383,G
2-PB1,35,0,2400,0,2,2402,T
2-PB1,36,0,2406,1,0,2407,T
2-PB1,37,1,2,0,2406,2409,C
2-PB1,38,1,0,0,2406,2407,C
2-PB1,39,2413,0,2,0,2415,A
2-PB1,40,1,0,2434,0,2435,G
2-PB1,41,1,2,0,2440,2443,C
2-PB1,42,0,1,2452,0,2453,G
2-PB1,43,0,0,0,2460,2460,C
2-PB1,44,2468,0,0,0,2468,A
2-PB1,45,2471,0,0,0,2471,A
2-PB1,46,2464,0,2,0,2466,A
2-PB1,47,2479,0,0,0,2479,A
2-PB1,48,0,2501,0,1,2502,T
2-PB1,49,1,1,2613,0,2615,G
2-PB1,50,1,1,0,2627,2629,C
2-PB1,51,3,0,0,2638,2641,C
2-PB1,52,2640,1,5,0,2646,A
2-PB1,53,0,2654,0,0,2654,T
2-PB1,54,2814,0,1,0,2815,A
2-PB1,55,2817,0,3,0,2820,A
2-PB1,56,1,0,2923,0,2924,G
2-PB1,57,2,1,0,2919,2922,C
2-PB1,58,2901,0,0,0,2901,A
2-PB1,59,0,0,0,3022,3022,C
2-PB1,60,3014,1,4,1,3020,A
2-PB1,61,3171,0,3,0,3174,A
2-PB1,62,0,0,0,3190,3190,C
2-PB1,63,3165,0,2,0,3167,A
2-PB1,64,0,3200,0,1,3201,T
2-PB1,65,1,3164,0,2,3167,T
2-PB1,66,5,1,0,4233,4239,C
2-PB1,67,1,0,0,4248,4249,C
2-PB1,68,8,1,0,4271,4280,C
2-PB1,69,2,4304,0,15,4321,T
2-PB1,70,0,4299,0,1,4300,T
2-PB1,71,4656,0,0,0,4656,A
2-PB1,72,0,4679,0,5,4684,T
2-PB1,73,4791,1,0,0,4792,A
2-PB1,74,1,3,0,4843,4847,C
2-PB1,75,0,4579,0,17,4596,T
2-PB1,76,0,3,4611,0,4614,G
2-PB1,77,1,3,4608,1,4613,G
2-PB1,78,4583,0,3,0,4586,A
2-PB1,79,0,1,4596,1,4598,G
2-PB1,80,4513,2,9,0,4524,A
2-PB1,81,1,0,0,4480,4481,C
2-PB1,82,6,2,0,4785,4793,C
2-PB1,83,8,2,0,4825,4835,C
2-PB1,84,1,4826,0,5,4832,T
2-PB1,85,2,3,0,5217,5222,C
2-PB1,86,1,0,0,5222,5223,C
2-PB1,87,5256,0,4,0,5260,A
2-PB1,88,0,5264,0,3,5267,T
2-PB1,89,5258,0,2,0,5260,A
2-PB1,90,2,3,0,5272,5277,C
2-PB1,91,5154,0,7,0,5161,A
2-PB1,92,0,2,5369,0,5371,G
2-PB1,93,2,4,1,5415,5422,C
2-PB1,94,1,2,0,5356,5359,C
2-PB1,95,5359,0,9,0,5368,A
2-PB1,96,0,5367,0,7,5374,T
2-PB1,97,1,1,5373,0,5375,G
2-PB1,98,0,6,5599,0,5605,G
2-PB1,99,5630,1,2,0,5633,A
2-PB1,100,5662,0,5,0,5667,A
2-PB1,101,1,0,0,5662,5663,C
2-PB1,102,5595,0,12,0,5607,A
2-PB1,103,1,2,5720,0,5723,G
2-PB1,104,0,8,5780,1,5789,G
2-PB1,105,5786,1,9,0,5796,A
2-PB1,106,5833,0,2,0,5835,A
2-PB1,107,0,0,0,5871,5871,C
2-PB1,108,5795,1,8,0,5804,A
2-PB1,109,2,14,6473,0,6489,G
2-PB1,110,3,10,6442,0,6455,G
2-PB1,111,2,1,6566,0,6569,G
2-PB1,112,3,6528,0,8,6539,T
2-PB1,113,6515,0,7,0,6522,A
2-PB1,114,1,3,0,6558,6562,C
2-PB1,115,6774,1,5,0,6780,A
2-PB1,116,2,1,0,6978,6981,C
2-PB1,117,3,0,0,6907,6910,C
2-PB1,118,6651,0,6,1,6658,A
2-PB1,119,0,6634,0,1,6635,T
2-PB1,120,2,10,6592,0,6604,G
2-PB1,121,2,8,6616,0,6626,G
2-PB1,122,6606,0,10,0,6616,A
2-PB1,123,1,4,1,6624,6630,C
2-PB1,124,6455,2,6,0,6463,A
2-PB1,125,1,3,1,6550,6555,C
2-PB1,126,6478,1,4,0,6483,A
2-PB1,127,3,0,6613,0,6616,G
2-PB1,128,0,6583,0,13,6596,T
2-PB1,129,13,2,0,6763,6778,C
2-PB1,130,6751,1,8,0,6760,A
2-PB1,131,6820,0,10,0,6830,A
2-PB1,132,0,3,0,6829,6832,C
2-PB1,133,6787,0,9,0,6796,A
2-PB1,134,1,8,6887,0,6896,G
2-PB1,135,6756,1,13,1,6771,A
2-PB1,136,6752,0,11,0,6763,A
2-PB1,137,0,5,0,6745,6750,C
2-PB1,138,6588,0,7,0,6595,A
2-PB1,139,1,0,0,6790,6791,C
2-PB1,140,6747,0,10,1,6758,A
2-PB1,141,2,2,0,7058,7062,C
2-PB1,142,10,3,0,7048,7061,C
2-PB1,143,6996,0,4,0,7000,A
2-PB1,144,7086,3,3,0,7092,A
2-PB1,145,1,7256,1,3,7261,T
2-PB1,146,7492,0,6,0,7498,A
2-PB1,147,0,7475,1,2,7478,T
2-PB1,148,1,7314,0,5,7320,T
2-PB1,149,6,2,0,7343,7351,C
2-PB1,150,7096,1,7,0,7104,A
2-PB1,151,0,3,7105,0,7108,G
2-PB1,152,6995,1,7,0,7003,A
2-PB1,153,0,4,7049,1,7054,G
2-PB1,154,6785,0,5,2,6792,A
2-PB1,155,5,8,6646,2,6661,G
2-PB1,156,9,16,6608,0,6633,G
2-PB1,157,2,9,6883,0,6894,G
2-PB1,158,2,6,6892,0,6900,G
2-PB1,159,5,2,6938,0,6945,G
2-PB1,160,6926,0,10,0,6936,A
2-PB1,161,6940,0,10,1,6951,A
2-PB1,162,1,1,7004,0,7006,G
2-PB1,163,0,6935,1,4,6940,T
2-PB1,164,2,11,6872,0,6885,G
2-PB1,165,0,3,6845,1,6849,G
2-PB1,166,6816,2,18,0,6836,A
2-PB1,167,4,3,0,6884,6891,C
2-PB1,168,1,10,6897,1,6909,G
2-PB1,169,6954,0,8,0,6962,A
2-PB1,170,0,3,0,7003,7006,C
2-PB1,171,6957,0,3,0,6960,A
2-PB1,172,6970,1,4,0,6975,A
2-PB1,173,7011,2,8,2,7023,A
2-PB1,174,1,7140,1,2,7144,T
2-PB1,175,7162,0,4,0,7166,A
2-PB1,176,1,0,0,7184,7185,C
2-PB1,177,7049,1,10,0,7060,A
2-PB1,178,2,5,7104,0,7111,G
2-PB1,179,7044,1,3,0,7048,A
2-PB1,180,7105,0,2,0,7107,A
2-PB1,181,7104,0,2,0,7106,A
2-PB1,182,0,1,0,7127,7128,C
2-PB1,183,0,6986,1,3,6990,T
2-PB1,184,0,11,6969,0,6980,G
2-PB1,185,2,8,6936,0,6946,G
2-PB1,186,3,5,6936,0,6944,G
2-PB1,187,0,0,6961,0,6961,G
2-PB1,188,3,2,0,6934,6939,C
2-PB1,189,6909,0,6,0,6915,A
2-PB1,190,1,1,1,7164,7167,C
2-PB1,191,7,0,0,7129,7136,C
2-PB1,192,14,3,0,7120,7137,C
2-PB1,193,12,0,0,7163,7175,C
2-PB1,194,7182,0,9,0,7191,A
2-PB1,195,7265,1,6,0,7272,A
2-PB1,196,0,0,0,7254,7254,C
2-PB1,197,1,7209,2,8,7220,T
2-PB1,198,9,2,1,7242,7254,C
2-PB1,199,6942,0,4,0,6946,A
2-PB1,200,7074,1,5,0,7080,A
2-PB1,201,2,1,1,7072,7076,C
2-PB1,202,3,1,1,7020,7025,C
2-PB1,203,15,1,0,7004,7020,C
2-PB1,204,6948,1,2,0,6951,A
2-PB1,205,6991,1,1,0,6993,A
2-PB1,206,0,7000,0,2,7002,T
2-PB1,207,1,6997,0,2,7000,T
2-PB1,208,0,5,7030,0,7035,G
2-PB1,209,6928,0,12,0,6940,A
2-PB1,210,1,6912,3,13,6929,T
2-PB1,211,0,7,6904,0,6911,G
2-PB1,212,4,6,6989,1,7000,G
2-PB1,213,7067,0,14,0,7081,A
2-PB1,214,1,3,0,7105,7109,C
2-PB1,215,7,1,0,7051,7059,C
2-PB1,216,7049,0,7,1,7057,A
2-PB1,217,1,0,0,7210,7211,C
2-PB1,218,1,7183,0,3,7187,T
2-PB1,219,7302,2,6,0,7310,A
2-PB1,220,1,4,1,7370,7376,C
2-PB1,221,3,0,0,7277,7280,C
2-PB1,222,3,7124,1,9,7137,T
2-PB1,223,3,3,7175,0,7181,G
2-PB1,224,7126,1,6,1,7134,A
2-PB1,225,1,8,7195,1,7205,G
2-PB1,226,1,3,7165,0,7169,G
2-PB1,227,7102,3,0,0,7105,A
2-PB1,228,0,7037,0,3,7040,T
2-PB1,229,6904,0,3,0,6907,A
2-PB1,230,6900,0,8,0,6908,A
2-PB1,231,0,6905,0,6,6911,T
2-PB1,232,9,7,6903,0,6919,G
2-PB1,233,6905,0,8,0,6913,A
2-PB1,234,6833,0,6,1,6840,A
2-PB1,235,3,5,0,6836,6844,C
2-PB1,236,7,0,0,6691,6698,C
2-PB1,237,6697,2,6,0,6705,A
2-PB1,238,6705,0,3,0,6708,A
2-PB1,239,1,2,6756,0,6759,G
2-PB1,240,0,6762,0,0,6762,T
2-PB1,241,1,10,6731,0,6742,G
2-PB1,242,1,1,6833,2,6837,G
2-PB1,243,6797,0,14,1,6812,A
2-PB1,244,1,6786,1,1,6789,T
2-PB1,245,6792,0,5,0,6797,A
2-PB1,246,1,6842,0,5,6848,T
2-PB1,247,2,1,6868,0,6871,G
2-PB1,248,1,2,1,6861,6865,C
2-PB1,249,6840,1,8,3,6852,A
2-PB1,250,1,3,0,7050,7054,C
2-PB1,251,6896,1,0,0,6897,A
2-PB1,252,7028,2,10,1,7041,A
2-PB1,253,7026,1,10,0,7037,A
2-PB1,254,1,1,1,7045,7048,C
2-PB1,255,6808,0,6,0,6814,A
2-PB1,256,2,10,6906,0,6918,G
2-PB1,257,6832,0,10,1,6843,A
2-PB1,258,1,1,0,6876,6878,C
2-PB1,259,2,6582,1,2,6587,T
2-PB1,260,2,1,6760,0,6763,G
2-PB1,261,2,6635,1,9,6647,T
2-PB1,262,1,2,6934,1,6938,G
2-PB1,263,1,6909,1,6,6917,T
2-PB1,264,3,2,0,6931,6936,C
2-PB1,265,5,1,0,6917,6923,C
2-PB1,266,2,6842,1,9,6854,T
2-PB1,267,0,3,6847,0,6850,G
2-PB1,268,1,2,6849,0,6852,G
2-PB1,269,6698,0,5,0,6703,A
2-PB1,270,1,5,6824,0,6830,G
2-PB1,271,1,3,6512,1,6517,G
2-PB1,272,1,3,0,6519,6523,C
2-PB1,273,0,6489,0,2,6491,T
2-PB1,274,6495,1,3,1,6500,A
2-PB1,275,1,6484,0,16,6501,T
2-PB1,276,1,2,6490,0,6493,G
2-PB1,277,2,3,6482,0,6487,G
2-PB1,278,1,1,0,6477,6479,C
2-PB1,279,1,1,0,6362,6364,C
2-PB1,280,0,6270,3,7,6280,T
2-PB1,281,2,6634,0,6,6642,T
2-PB1,282,4,0,0,6654,6658,C
2-PB1,283,6,0,0,6665,6671,C
2-PB1,284,1,6668,0,6,6675,T
2-PB1,285,1,6644,0,4,6649,T
2-PB1,286,2,2,6656,1,6661,G
2-PB1,287,6654,4,4,0,6662,A
2-PB1,288,6676,1,5,2,6684,A
2-PB1,289,9,6,6669,0,6684,G
2-PB1,290,6264,0,5,0,6269,A
2-PB1,291,6324,0,7,2,6333,A
2-PB1,292,0,6306,0,2,6308,T
2-PB1,293,7,2,0,6304,6313,C
2-PB1,294,3,3,0,6287,6293,C
2-PB1,295,14,1,0,6289,6304,C
2-PB1,296,6325,0,6,0,6331,A
2-PB1,297,1,0,0,6360,6361,C
2-PB1,298,3,2,2,6347,6354,C
2-PB1,299,10,1,0,6361,6372,C
2-PB1,300,6235,0,20,4,6259,A
2-PB1,301,5,1,6294,0,6300,G
2-PB1,302,2,2,6316,0,6320,G
2-PB1,303,1,6304,0,3,6308,T
2-PB1,304,6353,0,0,1,6354,A
2-PB1,305,0,6280,0,5,6285,T
2-PB1,306,4,3,0,6301,6308,C
2-PB1,307,0,6282,0,7,6289,T
2-PB1,308,0,6277,1,3,6281,T
2-PB1,309,0,6249,0,3,6252,T
2-PB1,310,3,7,6216,0,6226,G
2-PB1,311,6122,2,12,0,6136,A
2-PB1,312,1,2,6150,1,6154,G
2-PB1,313,6023,0,9,0,6032,A
2-PB1,314,6063,1,3,0,6067,A
2-PB1,315,1,2,0,6118,6121,C
2-PB1,316,1,5988,1,9,5999,T
2-PB1,317,8,3,0,6008,6019,C
2-PB1,318,6010,0,5,2,6017,A
2-PB1,319,0,6003,0,6,6009,T
2-PB1,320,2,4,6037,0,6043,G
2-PB1,321,3,2,0,6170,6175,C
2-PB1,322,3,4,0,6160,6167,C
2-PB1,323,1,6129,1,6,6137,T
2-PB1,324,1,6024,0,8,6033,T
2-PB1,325,2,7,6056,1,6066,G
2-PB1,326,6096,0,5,1,6102,A
2-PB1,327,6097,0,7,0,6104,A
2-PB1,328,6091,0,12,0,6103,A
2-PB1,329,0,1,0,6150,6151,C
2-PB1,330,5937,0,3,0,5940,A
2-PB1,331,5974,1,2,0,5977,A
2-PB1,332,0,5971,0,2,5973,T
2-PB1,333,2,5,5965,0,5972,G
2-PB1,334,2,0,5948,0,5950,G
2-PB1,335,5817,1,12,2,5832,A
2-PB1,336,5827,0,10,1,5838,A
2-PB1,337,1,1,5834,1,5837,G
2-PB1,338,1,5,0,5839,5845,C
2-PB1,339,6,5,1,5779,5791,C
2-PB1,340,9,3,5858,0,5870,G
2-PB1,341,1,5826,0,4,5831,T
2-PB1,342,1,5824,0,12,5837,T
2-PB1,343,10,1,0,5881,5892,C
2-PB1,344,5902,1,4,0,5907,A
2-PB1,345,5973,0,10,0,5983,A
2-PB1,346,0,0,0,5976,5976,C
2-PB1,347,5986,3,12,1,6002,A
2-PB1,348,5,10,6027,0,6042,G
2-PB1,349,5904,1,17,0,5922,A
2-PB1,350,0,2,0,5929,5931,C
2-PB1,351,5922,2,6,0,5930,A
2-PB1,352,5948,0,8,0,5956,A
2-PB1,353,1,13,6006,0,6020,G
2-PB1,354,1,5,5941,0,5947,G
2-PB1,355,1,1,5969,0,5971,G
2-PB1,356,0,5837,0,3,5840,T
2-PB1,357,7,4,5835,0,5846,G
2-PB1,358,2,9,5820,1,5832,G
2-PB1,359,5834,1,10,0,5845,A
2-PB1,360,0,2,1,5854,5857,C
2-PB1,361,5686,1,3,0,5690,A
2-PB1,362,5813,1,6,0,5820,A
2-PB1,363,5806,0,5,0,5811,A
2-PB1,364,1,0,1,5816,5818,C
2-PB1,365,0,5749,2,4,5755,T
2-PB1,366,5777,0,2,0,5779,A
2-PB1,367,5809,2,9,2,5822,A
2-PB1,368,1,3,0,5847,5851,C
2-PB1,369,5,1,0,5836,5842,C
2-PB1,370,9,0,0,5833,5842,C
2-PB1,371,5648,1,0,0,5649,A
2-PB1,372,5635,1,13,1,5650,A
2-PB1,373,1,3,5634,0,5638,G
2-PB1,374,1,0,5639,0,5640,G
2-PB1,375,1,5628,0,6,5635,T
2-PB1,376,5,3,0,5592,5600,C
2-PB1,377,4,2,5581,0,5587,G
2-PB1,378,0,2,0,5575,5577,C
2-PB1,379,3,3,0,5588,5594,C
2-PB1,380,5596,0,8,0,5604,A
2-PB1,381,3,5,5742,0,5750,G
2-PB1,382,5840,0,12,0,5852,A
2-PB1,383,1,1,1,5888,5891,C
2-PB1,384,0,5842,0,3,5845,T
2-PB1,385,1,5816,2,3,5822,T
2-PB1,386,5826,0,3,0,5829,A
2-PB1,387,1,5853,0,7,5861,T
2-PB1,388,1,3,5861,0,5865,G
2-PB1,389,5833,0,2,0,5835,A
2-PB1,390,0,5698,2,4,5704,T
2-PB1,391,0,5480,0,3,5483,T
2-PB1,392,3,4,5461,0,5468,G
2-PB1,393,2,6,5462,0,5470,G
2-PB1,394,5553,0,7,0,5560,A
2-PB1,395,2,1,0,5558,5561,C
2-PB1,396,5477,1,0,0,5478,A
2-PB1,397,1,5414,1,2,5418,T
2-PB1,398,0,5477,1,0,5478,T
2-PB1,399,5538,0,1,0,5539,A
2-PB1,400,5517,0,3,1,5521,A
2-PB1,401,5519,1,8,1,5529,A
2-PB1,402,0,2,0,5534,5536,C
2-PB1,403,5412,0,2,0,5414,A
2-PB1,404,1,4,5464,2,5471,G
2-PB1,405,5413,0,7,0,5420,A
2-PB1,406,5420,0,7,1,5428,A
2-PB1,407,5426,0,3,0,5429,A
2-PB1,408,2,5359,1,2,5364,T
2-PB1,409,4,3,0,5387,5394,C
2-PB1,410,5350,1,6,0,5357,A
2-PB1,411,5379,0,5,1,5385,A
2-PB1,412,0,1,0,5371,5372,C
2-PB1,413,0,4,0,5327,5331,C
2-PB1,414,6,2,5332,0,5340,G
2-PB1,415,1,2,5330,0,5333,G
2-PB1,416,2,2,0,5349,5353,C
2-PB1,417,5339,0,5,1,5345,A
2-PB1,418,2,0,5348,2,5352,G
2-PB1,419,2,3,0,5399,5404,C
2-PB1,420,5391,0,7,1,5399,A
2-PB1,421,5403,2,8,0,5413,A
2-PB1,422,1,1,0,5428,5430,C
2-PB1,423,1,5382,0,3,5386,T
2-PB1,424,1,1,5657,0,5659,G
2-PB1,425,0,5,0,5653,5658,C
2-PB1,426,5655,2,1,0,5658,A
2-PB1,427,0,5651,1,4,5656,T
2-PB1,428,0,5563,1,1,5565,T
2-PB1,429,5929,1,6,1,5937,A
2-PB1,430,0,0,5942,0,5942,G
2-PB1,431,1,3,0,5909,5913,C
2-PB1,432,11,1,0,5896,5908,C
2-PB1,433,5688,0,9,0,5697,A
2-PB1,434,5737,0,2,0,5739,A
2-PB1,435,1,0,0,5775,5776,C
2-PB1,436,5780,1,5,0,5786,A
2-PB1,437,1,3,1,6018,6023,C
2-PB1,438,5,1,0,5540,5546,C
2-PB1,439,5519,0,7,0,5526,A
2-PB1,440,1,5519,0,4,5524,T
2-PB1,441,5535,1,3,0,5539,A
2-PB1,442,0,3,5542,0,5545,G
2-PB1,443,5469,1,3,0,5473,A
2-PB1,444,5393,3,3,0,5399,A
2-PB1,445,1,0,5457,0,5458,G
2-PB1,446,1,5183,1,2,5187,T
2-PB1,447,0,5197,0,3,5200,T
2-PB1,448,0,5209,0,1,5210,T
2-PB1,449,0,5210,1,3,5214,T
2-PB1,450,0,5221,0,1,5222,T
2-PB1,451,5201,0,2,0,5203,A
2-PB1,452,3,2,5193,0,5198,G
2-PB1,453,5161,0,4,0,5165,A
2-PB1,454,2,5143,0,7,5152,T
2-PB1,455,4,1,0,5055,5060,C
2-PB1,456,0,11,5055,0,5066,G
2-PB1,457,5063,1,5,1,5070,A
2-PB1,458,5070,1,5,0,5076,A
2-PB1,459,3,1,0,5107,5111,C
2-PB1,460,5,0,5099,0,5104,G
2-PB1,461,3,3,5385,0,5391,G
2-PB1,462,5371,0,6,0,5377,A
2-PB1,463,1,5363,0,8,5372,T
2-PB1,464,0,5351,1,2,5354,T
2-PB1,465,5367,0,11,0,5378,A
2-PB1,466,5367,1,17,0,5385,A
2-PB1,467,1,0,0,5416,5417,C
2-PB1,468,5348,1,1,0,5350,A
2-PB1,469,0,0,5415,0,5415,G
2-PB1,470,2,1,0,5179,5182,C
2-PB1,471,0,5150,0,1,5151,T
2-PB1,472,5162,0,5,0,5167,A
2-PB1,473,5166,0,4,0,5170,A
2-PB1,474,1,5164,0,0,5165,T
2-PB1,475,1,5,5226,0,5232,G
2-PB1,476,5184,0,1,0,5185,A
2-PB1,477,5213,0,4,0,5217,A
2-PB1,478,0,5094,0,2,5096,T
2-PB1,479,5,2,1,5105,5113,C
2-PB1,480,5101,2,12,0,5115,A
2-PB1,481,0,2,5107,1,5110,G
2-PB1,482,1,1,5115,1,5118,G
2-PB1,483,5102,0,10,0,5112,A
2-PB1,484,5009,0,5,1,5015,A
2-PB1,485,1,6,5295,1,5303,G
2-PB1,486,2,1,5323,0,5326,G
2-PB1,487,0,2,0,5322,5324,C
2-PB1,488,0,5310,0,8,5318,T
2-PB1,489,5333,0,0,0,5333,A
2-PB1,490,5335,0,14,1,5350,A
2-PB1,491,0,5351,0,1,5352,T
2-PB1,492,5345,1,1,0,5347,A
2-PB1,493,0,7,5373,0,5380,G
2-PB1,494,4896,0,1,0,4897,A
2-PB1,495,0,4836,0,4,4840,T
2-PB1,496,0,4826,0,7,4833,T
2-PB1,497,0,4831,1,1,4833,T
2-PB1,498,2,1,0,5020,5023,C
2-PB1,499,2,1,0,5017,5020,C
2-PB1,500,0,4987,2,10,4999,T
2-PB1,501,1,0,0,5017,5018,C
2-PB1,502,4993,0,5,6,5004,A
2-PB1,503,5025,0,7,0,5032,A
2-PB1,504,1,7,5064,0,5072,G
2-PB1,505,0,6,5136,0,5142,G
2-PB1,506,5134,1,3,0,5138,A
2-PB1,507,0,4938,0,0,4938,T
2-PB1,508,1,1,5003,0,5005,G
2-PB1,509,1,4965,2,6,4974,T
2-PB1,510,1,3,5030,0,5034,G
2-PB1,511,5006,2,10,0,5018,A
2-PB1,512,1,4996,0,2,4999,T
2-PB1,513,7,2,4975,0,4984,G
2-PB1,514,0,3,4944,0,4947,G
2-PB1,515,4942,0,10,0,4952,A
2-PB1,516,4952,1,6,0,4959,A
2-PB1,517,1,4859,1,2,4863,T
2-PB1,518,6,2,0,4895,4903,C
2-PB1,519,4836,0,3,0,4839,A
2-PB1,520,4849,0,3,0,4852,A
2-PB1,521,0,4843,0,0,4843,T
2-PB1,522,3,3,4917,0,4923,G
2-PB1,523,3,2,4946,0,4951,G
2-PB1,524,4911,3,10,0,4924,A
2-PB1,525,0,4920,0,2,4922,T
2-PB1,526,4918,1,0,0,4919,A
2-PB1,527,4902,0,3,0,4905,A
2-PB1,528,4908,0,5,0,4913,A
2-PB1,529,0,2,4995,0,4997,G
2-PB1,530,4919,1,18,0,4938,A
2-PB1,531,0,0,4914,0,4914,G
2-PB1,532,0,6,4894,0,4900,G
2-PB1,533,4856,0,6,0,4862,A
2-PB1,534,4856,0,3,0,4859,A
2-PB1,535,4873,1,3,1,4878,A
2-PB1,536,0,4880,1,1,4882,T
2-PB1,537,6,6,4955,0,4967,G
2-PB1,538,2,6,4956,1,4965,G
2-PB1,539,4874,0,13,1,4888,A
2-PB1,540,1,2,4945,0,4948,G
2-PB1,541,4887,0,5,0,4892,A
2-PB1,542,1,5000,1,6,5008,T
2-PB1,543,5012,0,5,0,5017,A
2-PB1,544,5067,0,6,2,5075,A
2-PB1,545,1,5,0,5082,5088,C
2-PB1,546,4962,0,3,0,4965,A
2-PB1,547,4980,1,7,0,4988,A
2-PB1,548,0,3,0,4968,4971,C
2-PB1,549,4916,4,9,3,4932,A
2-PB1,550,3,1,0,4930,4934,C
2-PB1,551,4822,1,8,0,4831,A
2-PB1,552,0,1,0,4908,4909,C
2-PB1,553,1,4811,1,6,4819,T
2-PB1,554,1,4810,0,2,4813,T
2-PB1,555,0,4784,0,4,4788,T
2-PB1,556,3,0,0,4805,4808,C
2-PB1,557,4805,1,4,0,4810,A
2-PB1,558,4829,0,1,0,4830,A
2-PB1,559,4816,0,4,0,4820,A
2-PB1,560,0,4,4934,0,4938,G
2-PB1,561,4853,0,2,1,4856,A
2-PB1,562,4848,2,1,0,4851,A
2-PB1,563,4874,0,0,0,4874,A
2-PB1,564,4867,1,8,0,4876,A
2-PB1,565,4862,1,14,1,4878,A
2-PB1,566,3,6,4905,0,4914,G
2-PB1,567,0,2,4909,0,4911,G
2-PB1,568,4810,0,5,1,4816,A
2-PB1,569,1,4,4948,0,4953,G
2-PB1,570,4901,2,12,1,4916,A
2-PB1,571,3,0,5157,0,5160,G
2-PB1,572,0,5123,0,3,5126,T
2-PB1,573,5134,1,1,1,5137,A
2-PB1,574,5137,1,15,1,5154,A
2-PB1,575,1,5,5128,0,5134,G
2-PB1,576,3,10,5164,1,5178,G
2-PB1,577,2,3,5156,1,5162,G
2-PB1,578,5050,2,14,0,5066,A
2-PB1,579,5,2,0,5106,5113,C
2-PB1,580,4941,0,9,1,4951,A
2-PB1,581,4975,0,6,0,4981,A
2-PB1,582,1,0,0,4966,4967,C
2-PB1,583,4969,2,4,0,4975,A
2-PB1,584,0,4900,0,10,4910,T
2-PB1,585,2,8,4859,1,4870,G
2-PB1,586,4885,0,9,0,4894,A
2-PB1,587,0,1,0,4881,4882,C
2-PB1,588,9,0,0,4808,4817,C
2-PB1,589,4822,0,2,0,4824,A
2-PB1,590,4837,0,6,0,4843,A
2-PB1,591,3,2,4870,0,4875,G
2-PB1,592,4872,0,0,0,4872,A
2-PB1,593,4871,0,3,0,4874,A
2-PB1,594,4833,0,5,0,4838,A
2-PB1,595,4825,0,4,0,4829,A
2-PB1,596,0,4812,1,0,4813,T
2-PB1,597,0,8,4819,1,4828,G
2-PB1,598,1,1,4831,0,4833,G
2-PB1,599,0,4751,0,9,4760,T
2-PB1,600,4,2,1,4726,4733,C
2-PB1,601,4748,0,5,0,4753,A
2-PB1,602,1,2,0,5073,5076,C
2-PB1,603,5170,0,4,0,5174,A
2-PB1,604,2,2,0,5203,5207,C
2-PB1,605,5180,0,7,0,5187,A
2-PB1,606,5384,0,4,0,5388,A
2-PB1,607,5330,0,7,0,5337,A
2-PB1,608,0,4,5754,1,5759,G
2-PB1,609,5728,2,6,0,5736,A
2-PB1,610,5784,0,8,0,5792,A
2-PB1,611,1,3,0,5966,5970,C
2-PB1,612,5806,0,3,1,5810,A
2-PB1,613,5848,1,4,1,5854,A
2-PB1,614,3,5801,1,3,5808,T
2-PB1,615,5745,0,10,1,5756,A
2-PB1,616,1,11,5770,0,5782,G
2-PB1,617,4,8,5539,1,5552,G
2-PB1,618,1,2,5562,1,5566,G
2-PB1,619,5531,1,1,1,5534,A
2-PB1,620,5464,2,6,0,5472,A
2-PB1,621,1,4,5546,0,5551,G
2-PB1,622,5511,0,6,0,5517,A
2-PB1,623,5548,1,0,0,5549,A
2-PB1,624,5553,0,4,0,5557,A
2-PB1,625,5578,0,4,1,5583,A
2-PB1,626,5733,1,5,0,5739,A
2-PB1,627,5763,0,7,2,5772,A
2-PB1,628,0,0,0,5777,5777,C
2-PB1,629,5765,0,3,0,5768,A
2-PB1,630,5753,0,4,0,5757,A
2-PB1,631,5735,1,8,0,5744,A
2-PB1,632,0,9,5863,0,5872,G
2-PB1,633,5847,0,5,0,5852,A
2-PB1,634,1,1,6145,2,6149,G
2-PB1,635,2,6055,0,3,6060,T
2-PB1,636,0,4,7059,1,7064,G
2-PB1,637,7053,1,15,1,7070,A
2-PB1,638,7098,0,5,0,7103,A
2-PB1,639,1,7191,0,2,7194,T
2-PB1,640,7199,0,5,0,7204,A
2-PB1,641,7169,0,22,0,7191,A
2-PB1,642,0,9,7194,0,7203,G
2-PB1,643,6951,2,11,1,6965,A
2-PB1,644,0,6,7030,1,7037,G
2-PB1,645,6595,1,14,0,6610,A
2-PB1,646,2,6,6656,0,6664,G
2-PB1,647,5,0,6656,0,6661,G
2-PB1,648,1,1,0,6679,6681,C
2-PB1,649,2,6656,0,3,6661,T
2-PB1,650,6850,1,5,0,6856,A
2-PB1,651,2,2,0,7206,7210,C
2-PB1,652,8,1,0,7232,7241,C
2-PB1,653,0,7258,0,10,7268,T
2-PB1,654,7581,0,2,1,7584,A
2-PB1,655,7575,1,3,1,7580,A
2-PB1,656,0,7582,0,7,7589,T
2-PB1,657,7562,0,4,0,7566,A
2-PB1,658,7550,1,1,0,7552,A
2-PB1,659,1,9,7557,1,7568,G
2-PB1,660,7217,1,8,1,7227,A
2-PB1,661,3,2,7337,1,7343,G
2-PB1,662,1,3,0,7371,7375,C
2-PB1,663,0,7238,1,12,7251,T
2-PB1,664,0,7264,0,2,7266,T
2-PB1,665,1,7275,0,3,7279,T
2-PB1,666,0,9,7274,0,7283,G
2-PB1,667,7394,0,14,1,7409,A
2-PB1,668,0,0,1,7447,7448,C
2-PB1,669,7397,0,4,0,7401,A
2-PB1,670,0,7381,0,9,7390,T
2-PB1,671,1,7334,0,3,7338,T
2-PB1,672,1,10,7461,0,7472,G
2-PB1,673,7455,0,9,1,7465,A
2-PB1,674,7460,1,18,2,7481,A
2-PB1,675,0,0,0,7512,7512,C
2-PB1,676,7445,1,7,0,7453,A
2-PB1,677,0,6,3,7438,7447,C
2-PB1,678,10,2,7428,0,7440,G
2-PB1,679,7449,1,12,0,7462,A
2-PB1,680,0,7450,0,7,7457,T
2-PB1,681,1,17,7656,0,7674,G
2-PB1,682,7672,2,14,1,7689,A
2-PB1,683,1,2,0,7720,7723,C
2-PB1,684,6,6,0,7688,7700,C
2-PB1,685,7704,1,6,2,7713,A
2-PB1,686,7802,1,5,0,7808,A
2-PB1,687,7790,4,8,0,7802,A
2-PB1,688,5,4,8024,0,8033,G
2-PB1,689,8100,0,7,0,8107,A
2-PB1,690,0,7951,0,10,7961,T
2-PB1,691,3,0,7964,0,7967,G
2-PB1,692,7,4,0,7929,7940,C
2-PB1,693,7903,0,14,2,7919,A
2-PB1,694,1,5,7995,0,8001,G
2-PB1,695,7828,1,8,2,7839,A
2-PB1,696,3,9,7897,0,7909,G
2-PB1,697,7605,0,10,0,7615,A
2-PB1,698,2,3,7621,0,7626,G
2-PB1,699,7502,1,21,2,7526,A
2-PB1,700,2,4,7550,0,7556,G
2-PB1,701,2,2,7526,0,7530,G
2-PB1,702,3,3,0,7537,7543,C
2-PB1,703,7475,2,6,1,7484,A
2-PB1,704,7497,0,3,0,7500,A
2-PB1,705,7559,1,3,0,7563,A
2-PB1,706,3,7559,0,2,7564,T
2-PB1,707,0,7549,0,2,7551,T
2-PB1,708,7571,0,6,1,7578,A
2-PB1,709,7569,0,2,1,7572,A
2-PB1,710,7578,0,16,1,7595,A
2-PB1,711,7622,0,1,0,7623,A
2-PB1,712,7625,0,4,2,7631,A
2-PB1,713,0,3,7634,1,7638,G
2-PB1,714,7569,2,5,1,7577,A
2-PB1,715,7516,1,10,0,7527,A
2-PB1,716,3,10,7613,0,7626,G
2-PB1,717,0,10,7776,0,7786,G
2-PB1,718,4,2,7796,0,7802,G
2-PB1,719,1,3,0,7825,7829,C
2-PB1,720,0,7809,1,13,7823,T
2-PB1,721,7904,0,5,0,7909,A
2-PB1,722,1,8034,2,12,8049,T
2-PB1,723,0,8045,0,4,8049,T
2-PB1,724,2,1,8086,0,8089,G
2-PB1,725,1,5,1,8005,8012,C
2-PB1,726,7738,1,11,0,7750,A
2-PB1,727,7745,0,15,0,7760,A
2-PB1,728,3,3,0,7733,7739,C
2-PB1,729,7737,1,5,1,7744,A
2-PB1,730,2,0,1,7735,7738,C
2-PB1,731,5,3,0,7530,7538,C
2-PB1,732,11,4,0,7525,7540,C
2-PB1,733,5,16,7488,0,7509,G
2-PB1,734,2,5,7511,1,7519,G
2-PB1,735,0,6,7530,0,7536,G
2-PB1,736,7532,2,7,1,7542,A
2-PB1,737,0,7489,1,4,7494,T
2-PB1,738,1,2,7536,0,7539,G
2-PB1,739,4,2,0,7499,7505,C
2-PB1,740,7630,1,7,0,7638,A
2-PB1,741,7766,0,6,0,7772,A
2-PB1,742,7868,1,2,1,7872,A
2-PB1,743,1,7872,0,2,7875,T
2-PB1,744,1,7884,0,3,7888,T
2-PB1,745,7818,2,7,0,7827,A
2-PB1,746,1,1,7836,0,7838,G
2-PB1,747,7737,0,21,1,7759,A
2-PB1,748,1,18,7804,0,7823,G
2-PB1,749,2,8,7624,0,7634,G
2-PB1,750,1,1,7871,0,7873,G
2-PB1,751,4,7800,0,11,7815,T
2-PB1,752,1,7793,0,9,7803,T
2-PB1,753,16,1,0,7808,7825,C
2-PB1,754,5,1,7922,0,7928,G
2-PB1,755,2,7892,1,10,7905,T
2-PB1,756,7,2,7907,0,7916,G
2-PB1,757,0,7905,1,3,7909,T
2-PB1,758,7841,0,2,0,7843,A
2-PB1,759,2,0,1,7808,7811,C
2-PB1,760,2,7343,1,12,7358,T
2-PB1,761,1,7393,0,0,7394,T
2-PB1,762,7,3,1,7343,7354,C
2-PB1,763,2,1,7300,1,7304,G
2-PB1,764,0,7287,1,5,7293,T
2-PB1,765,2,7259,0,13,7274,T
2-PB1,766,1,8,7249,0,7258,G
2-PB1,767,7249,0,3,0,7252,A
2-PB1,768,7239,0,9,0,7248,A
2-PB1,769,7330,0,4,1,7335,A
2-PB1,770,2,3,0,7360,7365,C
2-PB1,771,1,7265,0,4,7270,T
2-PB1,772,0,7241,0,0,7241,T
2-PB1,773,0,7261,0,1,7262,T
2-PB1,774,7374,0,9,0,7383,A
2-PB1,775,3,3,7407,0,7413,G
2-PB1,776,1,2,0,7440,7443,C
2-PB1,777,0,7413,1,7,7421,T
2-PB1,778,7316,3,3,0,7322,A
2-PB1,779,3,7,7290,0,7300,G
2-PB1,780,7264,1,9,0,7274,A
2-PB1,781,7279,0,10,0,7289,A
2-PB1,782,4,0,7311,0,7315,G
2-PB1,783,1,2,0,7180,7183,C
2-PB1,784,7172,0,3,0,7175,A
2-PB1,785,3,7107,0,3,7113,T
2-PB1,786,3,7123,0,3,7129,T
2-PB1,787,1,7119,0,1,7121,T
2-PB1,788,0,0,7151,0,7151,G
2-PB1,789,0,6,0,7125,7131,C
2-PB1,790,5,6,7126,1,7138,G
2-PB1,791,7121,0,2,0,7123,A
2-PB1,792,7089,0,1,0,7090,A
2-PB1,793,7103,1,2,0,7106,A
2-PB1,794,7308,0,4,0,7312,A
2-PB1,795,0,0,7425,0,7425,G
2-PB1,796,1,0,0,7431,7432,C
2-PB1,797,0,7432,0,15,7447,T
2-PB1,798,0,7439,0,2,7441,T
2-PB1,799,0,13,7446,0,7459,G
2-PB1,800,7433,1,7,0,7441,A
2-PB1,801,7436,1,11,0,7448,A
2-PB1,802,0,2,0,7497,7499,C
2-PB1,803,7230,1,9,1,7241,A
2-PB1,804,3,2,7918,0,7923,G
2-PB1,805,1,7830,0,7,7838,T
2-PB1,806,10,0,0,7857,7867,C
2-PB1,807,3,7840,1,11,7855,T
2-PB1,808,5,4,7857,0,7866,G
2-PB1,809,1,3,7878,0,7882,G
2-PB1,810,7876,1,10,0,7887,A
2-PB1,811,2,2,0,7931,7935,C
2-PB1,812,1,7659,0,10,7670,T
2-PB1,813,0,7122,0,7,7129,T
2-PB1,814,2,0,0,7115,7117,C
2-PB1,815,2,2,0,7110,7114,C
2-PB1,816,10,4,7135,0,7149,G
2-PB1,817,1,1,7187,0,7189,G
2-PB1,818,1,7102,1,4,7108,T
2-PB1,819,1,7094,0,7,7102,T
2-PB1,820,2,5,7070,1,7078,G
2-PB1,821,5,8,7130,0,7143,G
2-PB1,822,2,17,7181,0,7200,G
2-PB1,823,0,4,7208,0,7212,G
2-PB1,824,2,0,7231,1,7234,G
2-PB1,825,0,7139,0,2,7141,T
2-PB1,826,7134,1,1,0,7136,A
2-PB1,827,7189,2,5,0,7196,A
2-PB1,828,2,7185,0,5,7192,T
2-PB1,829,1,9,7212,0,7222,G
2-PB1,830,7110,0,2,0,7112,A
2-PB1,831,7028,0,12,0,7040,A
2-PB1,832,7045,0,8,1,7054,A
2-PB1,833,7038,0,7,1,7046,A
2-PB1,834,1,2,7030,0,7033,G
2-PB1,835,6957,1,5,0,6963,A
2-PB1,836,6889,0,14,0,6903,A
2-PB1,837,2,1,6936,0,6939,G
2-PB1,838,3,0,6908,0,6911,G
2-PB1,839,0,2,0,6911,6913,C
2-PB1,840,5,7,1,6895,6908,C
2-PB1,841,6927,0,2,1,6930,A
2-PB1,842,6916,0,7,0,6923,A
2-PB1,843,6925,1,5,0,6931,A
2-PB1,844,2,4,0,6939,6945,C
2-PB1,845,3,6901,0,12,6916,T
2-PB1,846,3,5,7026,1,7035,G
2-PB1,847,7,0,7005,0,7012,G
2-PB1,848,0,1,0,7018,7019,C
2-PB1,849,7034,1,5,0,7040,A
2-PB1,850,7015,0,2,0,7017,A
2-PB1,851,7038,0,4,0,7042,A
2-PB1,852,2,7054,0,1,7057,T
2-PB1,853,0,1,7065,0,7066,G
2-PB1,854,0,7022,0,8,7030,T
2-PB1,855,0,6807,1,5,6813,T
2-PB1,856,3,1,6821,0,6825,G
2-PB1,857,1,6789,0,9,6799,T
2-PB1,858,0,11,6823,0,6834,G
2-PB1,859,6825,1,2,1,6829,A
2-PB1,860,0,2,6875,0,6877,G
2-PB1,861,6848,1,8,1,6858,A
2-PB1,862,6807,1,6,1,6815,A
2-PB1,863,6801,1,8,0,6810,A
2-PB1,864,6835,1,2,0,6838,A
2-PB1,865,6870,0,7,0,6877,A
2-PB1,866,0,6844,1,2,6847,T
2-PB1,867,1,2,6836,0,6839,G
2-PB1,868,6828,1,7,0,6836,A
2-PB1,869,1,6729,2,7,6739,T
2-PB1,870,0,6,6808,0,6814,G
2-PB1,871,6810,1,11,0,6822,A
2-PB1,872,0,3,0,6909,6912,C
2-PB1,873,2,6879,0,2,6883,T
2-PB1,874,6860,0,5,0,6865,A
2-PB1,875,6930,0,5,1,6936,A
2-PB1,876,0,6923,0,0,6923,T
2-PB1,877,1,6994,0,7,7002,T
2-PB1,878,9,0,0,7052,7061,C
2-PB1,879,7024,1,13,3,7041,A
2-PB1,880,1,1,1,7069,7072,C
2-PB1,881,6956,0,4,0,6960,A
2-PB1,882,6951,0,13,0,6964,A
2-PB1,883,3,5,6998,0,7006,G
2-PB1,884,7118,0,19,2,7139,A
2-PB1,885,1,4,1,7119,7125,C
2-PB1,886,7042,0,14,0,7056,A
2-PB1,887,0,6,0,7035,7041,C
2-PB1,888,6947,0,12,1,6960,A
2-PB1,889,1,5,7010,0,7016,G
2-PB1,890,6933,3,17,0,6953,A
2-PB1,891,3,3,7008,0,7014,G
2-PB1,892,2,4,0,6955,6961,C
2-PB1,893,5,6753,0,26,6784,T
2-PB1,894,0,6876,1,0,6877,T
2-PB1,895,0,6854,1,6,6861,T
2-PB1,896,2,2,0,6909,6913,C
2-PB1,897,1,6889,0,10,6900,T
2-PB1,898,2,6835,0,8,6845,T
2-PB1,899,2,6831,0,13,6846,T
2-PB1,900,6,2,2,6834,6844,C
2-PB1,901,6835,0,12,0,6847,A
2-PB1,902,0,3,0,6881,6884,C
2-PB1,903,6774,0,3,0,6777,A
2-PB1,904,6810,2,3,0,6815,A
2-PB1,905,1,6867,3,5,6876,T
2-PB1,906,10,1,0,7003,7014,C
2-PB1,907,7038,0,1,0,7039,A
2-PB1,908,1,1,0,7093,7095,C
2-PB1,909,0,7009,0,10,7019,T
2-PB1,910,0,4,7081,0,7085,G
2-PB1,911,2,9,7038,0,7049,G
2-PB1,912,5,9,7311,0,7325,G
2-PB1,913,2,7,7290,0,7299,G
2-PB1,914,7165,1,12,0,7178,A
2-PB1,915,2,3,1,6853,6859,C
2-PB1,916,6936,0,8,1,6945,A
2-PB1,917,7457,1,3,0,7461,A
2-PB1,918,0,1,0,7553,7554,C
2-PB1,919,7512,1,5,0,7518,A
2-PB1,920,0,0,0,7507,7507,C
2-PB1,921,0,7091,1,11,7103,T
2-PB1,922,7131,0,9,1,7141,A
2-PB1,923,7105,0,17,0,7122,A
2-PB1,924,0,0,7202,0,7202,G
2-PB1,925,1,7127,0,5,7133,T
2-PB1,926,5,5,6531,0,6541,G
2-PB1,927,1,5,6465,0,6471,G
2-PB1,928,6442,0,7,0,6449,A
2-PB1,929,6467,1,10,0,6478,A
2-PB1,930,1,6440,0,4,6445,T
2-PB1,931,1,2,6436,1,6440,G
2-PB1,932,6432,1,3,0,6436,A
2-PB1,933,6302,0,3,0,6305,A
2-PB1,934,6359,0,7,0,6366,A
2-PB1,935,6419,0,2,0,6421,A
2-PB1,936,2,6355,0,1,6358,T
2-PB1,937,14,0,0,6363,6377,C
2-PB1,938,6367,1,3,0,6371,A
2-PB1,939,6354,1,3,0,6358,A
2-PB1,940,6346,0,9,0,6355,A
2-PB1,941,6353,1,3,0,6357,A
2-PB1,942,0,2,0,6387,6389,C
2-PB1,943,9,4,1,6330,6344,C
2-PB1,944,15,1,0,6316,6332,C
2-PB1,945,3,6269,2,5,6279,T
2-PB1,946,3,4,0,6324,6331,C
2-PB1,947,0,3,6328,0,6331,G
2-PB1,948,6326,1,3,0,6330,A
2-PB1,949,6342,0,1,0,6343,A
2-PB1,950,0,6331,0,3,6334,T
2-PB1,951,4,0,6368,0,6372,G
2-PB1,952,0,6303,1,9,6313,T
2-PB1,953,0,6288,0,7,6295,T
2-PB1,954,0,6291,1,11,6303,T
2-PB1,955,0,6301,0,1,6302,T
2-PB1,956,1,6289,1,4,6295,T
2-PB1,957,1,5,6279,0,6285,G
2-PB1,958,1,0,6272,1,6274,G
2-PB1,959,1,4,0,6251,6256,C
2-PB1,960,4,1,6195,0,6200,G
2-PB1,961,6182,1,3,0,6186,A
2-PB1,962,0,6360,0,2,6362,T
2-PB1,963,2,1,6596,0,6599,G
2-PB1,964,6912,0,3,0,6915,A
2-PB1,965,1,6946,0,8,6955,T
2-PB1,966,0,6945,2,1,6948,T
2-PB1,967,6988,1,13,0,7002,A
2-PB1,968,0,1,1,7005,7007,C
2-PB1,969,7029,0,7,0,7036,A
2-PB1,970,0,7000,0,8,7008,T
2-PB1,971,6559,0,4,1,6564,A
2-PB1,972,1,3,0,6615,6619,C
2-PB1,973,5861,0,5,2,5868,A
2-PB1,974,2,5823,2,5,5832,T
2-PB1,975,6,2,0,5805,5813,C
2-PB1,976,5800,3,6,0,5809,A
2-PB1,977,2,0,1,5809,5812,C
2-PB1,978,5749,1,2,1,5753,A
2-PB1,979,5756,0,2,0,5758,A
2-PB1,980,5726,0,7,0,5733,A
2-PB1,981,3,9,5480,1,5493,G
2-PB1,982,5792,0,3,0,5795,A
2-PB1,983,5798,1,12,0,5811,A
2-PB1,984,2,5802,1,7,5812,T
2-PB1,985,11,3,0,5794,5808,C
2-PB1,986,5797,0,8,0,5805,A
2-PB1,987,5835,2,4,0,5841,A
2-PB1,988,2,3,0,5855,5860,C
2-PB1,989,3,1,0,5848,5852,C
2-PB1,990,0,5397,0,8,5405,T
2-PB1,991,1,6,5442,0,5449,G
2-PB1,992,5392,1,9,1,5403,A
2-PB1,993,2,2,5431,0,5435,G
2-PB1,994,0,5394,0,4,5398,T
2-PB1,995,2,0,5258,0,5260,G
2-PB1,996,1,0,5548,0,5549,G
2-PB1,997,2,5507,0,6,5515,T
2-PB1,998,1,5503,0,7,5511,T
2-PB1,999,6,1,0,5516,5523,C
2-PB1,1000,5431,0,3,0,5434,A
2-PB1,1001,2,4,5545,0,5551,G
2-PB1,1002,5520,3,6,0,5529,A
2-PB1,1003,5524,1,2,0,5527,A
2-PB1,1004,5509,0,6,0,5515,A
2-PB1,1005,0,1,0,4885,4886,C
2-PB1,1006,4925,1,3,0,4929,A
2-PB1,1007,0,4905,0,4,4909,T
2-PB1,1008,2,2,0,4990,4994,C
2-PB1,1009,3,4,0,4994,5001,C
2-PB1,1010,0,4744,1,6,4751,T
2-PB1,1011,1,5,4755,0,4761,G
2-PB1,1012,4703,1,5,1,4710,A
2-PB1,1013,1,1,4774,0,4776,G
2-PB1,1014,2,3,0,4734,4739,C
2-PB1,1015,4552,2,3,1,4558,A
2-PB1,1016,0,4560,1,3,4564,T
2-PB1,1017,2,1,1,4517,4521,C
2-PB1,1018,3,0,4520,0,4523,G
2-PB1,1019,2,2,0,4653,4657,C
2-PB1,1020,4687,0,6,1,4694,A
2-PB1,1021,1,0,0,4905,4906,C
2-PB1,1022,9,3,0,4894,4906,C
2-PB1,1023,4907,0,6,1,4914,A
2-PB1,1024,4993,0,0,0,4993,A
2-PB1,1025,1,4989,0,1,4991,T
2-PB1,1026,4977,1,0,0,4978,A
2-PB1,1027,4981,0,6,0,4987,A
2-PB1,1028,1,4799,1,3,4804,T
2-PB1,1029,4,2,4842,0,4848,G
2-PB1,1030,1,4710,0,8,4719,T
2-PB1,1031,2,4670,0,9,4681,T
2-PB1,1032,5,1,0,4679,4685,C
2-PB1,1033,0,4638,0,9,4647,T
2-PB1,1034,6,1,0,4634,4641,C
2-PB1,1035,4650,1,2,0,4653,A
2-PB1,1036,4644,1,4,0,4649,A
2-PB1,1037,4658,1,5,1,4665,A
2-PB1,1038,1,1,0,4672,4674,C
2-PB1,1039,4648,0,1,0,4649,A
2-PB1,1040,4639,0,3,0,4642,A
2-PB1,1041,4614,0,5,1,4620,A
2-PB1,1042,4636,0,6,0,4642,A
2-PB1,1043,1,4696,1,4,4702,T
2-PB1,1044,3,7,4709,1,4720,G
2-PB1,1045,3,3,4708,0,4714,G
2-PB1,1046,1,3,1,4712,4717,C
2-PB1,1047,4692,1,8,1,4702,A
2-PB1,1048,4699,1,9,0,4709,A
2-PB1,1049,0,8,4754,0,4762,G
2-PB1,1050,4770,0,5,0,4775,A
2-PB1,1051,2,0,0,4781,4783,C
2-PB1,1052,0,4683,0,3,4686,T
2-PB1,1053,3,4,4786,0,4793,G
2-PB1,1054,1,5,4786,0,4792,G
2-PB1,1055,1,3,4823,0,4827,G
2-PB1,1056,4814,0,7,1,4822,A
2-PB1,1057,4815,0,1,0,4816,A
2-PB1,1058,4778,0,8,0,4786,A
2-PB1,1059,4772,0,8,0,4780,A
2-PB1,1060,2,8,4935,0,4945,G
2-PB1,1061,1,5,4939,0,4945,G
2-PB1,1062,4906,0,13,2,4921,A
2-PB1,1063,1,4872,0,7,4880,T
2-PB1,1064,4861,0,9,0,4870,A
2-PB1,1065,3,1,0,4871,4875,C
2-PB1,1066,4901,0,4,0,4905,A
2-PB1,1067,1,4891,1,2,4895,T
2-PB1,1068,1,2,4908,0,4911,G
2-PB1,1069,0,4798,1,6,4805,T
2-PB1,1070,0,4801,0,1,4802,T
2-PB1,1071,1,1,0,4787,4789,C
2-PB1,1072,4,8,4795,0,4807,G
2-PB1,1073,4784,1,9,0,4794,A
2-PB1,1074,2,8,4918,0,4928,G
2-PB1,1075,4841,0,8,1,4850,A
2-PB1,1076,2,1,4920,0,4923,G
2-PB1,1077,1,4882,0,1,4884,T
2-PB1,1078,4867,0,1,0,4868,A
2-PB1,1079,4944,1,14,0,4959,A
2-PB1,1080,2,5,4989,0,4996,G
2-PB1,1081,4965,0,16,0,4981,A
2-PB1,1082,4,7,5084,1,5096,G
2-PB1,1083,4632,1,300,0,4933,A
2-PB1,1084,4989,1,6,0,4996,A
2-PB1,1085,0,4942,0,0,4942,T
2-PB1,1086,0,3,4932,1,4936,G
2-PB1,1087,4921,1,8,0,4930,A
2-PB1,1088,4804,0,9,0,4813,A
2-PB1,1089,2,1,4840,1,4844,G
2-PB1,1090,2,1,0,4797,4800,C
2-PB1,1091,0,4713,0,2,4715,T
2-PB1,1092,5,1,0,4754,4760,C
2-PB1,1093,4,0,0,4770,4774,C
2-PB1,1094,1,2,4780,1,4784,G
2-PB1,1095,3,8,4787,0,4798,G
2-PB1,1096,4800,2,10,1,4813,A
2-PB1,1097,0,0,1,4885,4886,C
2-PB1,1098,4883,0,6,1,4890,A
2-PB1,1099,1,3,0,4949,4953,C
2-PB1,1100,4945,1,2,0,4948,A
2-PB1,1101,4957,1,4,0,4962,A
2-PB1,1102,4943,1,6,2,4952,A
2-PB1,1103,0,4981,0,2,4983,T
2-PB1,1104,4978,0,3,0,4981,A
2-PB1,1105,1,1,0,4969,4971,C
2-PB1,1106,7,2,0,4937,4946,C
2-PB1,1107,2,4854,1,9,4866,T
2-PB1,1108,3,0,4914,0,4917,G
2-PB1,1109,0,0,0,4932,4932,C
2-PB1,1110,4924,1,5,0,4930,A
2-PB1,1111,2,1,4926,0,4929,G
2-PB1,1112,4904,0,0,0,4904,A
2-PB1,1113,4905,0,1,0,4906,A
2-PB1,1114,4910,0,6,1,4917,A
2-PB1,1115,0,4913,0,1,4914,T
2-PB1,1116,1,0,4925,0,4926,G
2-PB1,1117,1,2,0,4892,4895,C
2-PB1,1118,1,4877,0,7,4885,T
2-PB1,1119,4957,2,3,0,4962,A
2-PB1,1120,1,1,4955,0,4957,G
2-PB1,1121,1,2,0,4947,4950,C
2-PB1,1122,4951,1,2,0,4954,A
2-PB1,1123,4934,0,6,0,4940,A
2-PB1,1124,1,1,4914,0,4916,G
2-PB1,1125,0,0,0,4901,4901,C
2-PB1,1126,4834,1,4,0,4839,A
2-PB1,1127,2,4959,0,2,4963,T
2-PB1,1128,0,4967,0,6,4973,T
2-PB1,1129,3,6,5134,0,5143,G
2-PB1,1130,5193,2,6,0,5201,A
2-PB1,1131,2,1,0,5189,5192,C
2-PB1,1132,0,0,0,5207,5207,C
2-PB1,1133,0,5051,0,16,5067,T
2-PB1,1134,5,1,5180,0,5186,G
2-PB1,1135,5196,0,5,0,5201,A
2-PB1,1136,5196,0,12,0,5208,A
2-PB1,1137,1,0,5295,0,5296,G
2-PB1,1138,0,5116,0,3,5119,T
2-PB1,1139,5164,0,1,0,5165,A
2-PB1,1140,0,5110,0,8,5118,T
2-PB1,1141,1,5100,0,5,5106,T
2-PB1,1142,0,5088,0,9,5097,T
2-PB1,1143,2,1,0,5040,5043,C
2-PB1,1144,5026,0,1,0,5027,A
2-PB1,1145,5024,0,1,0,5025,A
2-PB1,1146,1,4931,0,9,4941,T
2-PB1,1147,5,3,4974,0,4982,G
2-PB1,1148,4944,2,2,0,4948,A
2-PB1,1149,4977,0,4,0,4981,A
2-PB1,1150,0,4934,0,7,4941,T
2-PB1,1151,4,1,1,4993,4999,C
2-PB1,1152,4991,0,4,0,4995,A
2-PB1,1153,5015,1,6,0,5022,A
2-PB1,1154,0,2,1,5008,5011,C
2-PB1,1155,4981,0,9,1,4991,A
2-PB1,1156,4968,1,3,0,4972,A
2-PB1,1157,3,4,4973,0,4980,G
2-PB1,1158,0,3,5026,0,5029,G
2-PB1,1159,5008,1,5,0,5014,A
2-PB1,1160,4982,0,18,0,5000,A
2-PB1,1161,1,1,5013,0,5015,G
2-PB1,1162,4982,0,4,1,4987,A
2-PB1,1163,4993,0,3,0,4996,A
2-PB1,1164,4984,0,6,0,4990,A
2-PB1,1165,4975,1,6,0,4982,A
2-PB1,1166,2,4970,1,1,4974,T
2-PB1,1167,1,4919,0,1,4921,T
2-PB1,1168,1,3,4936,0,4940,G
2-PB1,1169,4900,3,7,1,4911,A
2-PB1,1170,1,3,4928,0,4932,G
2-PB1,1171,4916,1,7,0,4924,A
2-PB1,1172,4997,0,0,0,4997,A
2-PB1,1173,5083,0,2,0,5085,A
2-PB1,1174,5117,0,0,0,5117,A
2-PB1,1175,0,5114,0,0,5114,T
2-PB1,1176,5109,0,1,0,5110,A
2-PB1,1177,5104,3,7,0,5114,A
2-PB1,1178,3,4,5116,2,5125,G
2-PB1,1179,2,1,5121,0,5124,G
2-PB1,1180,2,0,0,5096,5098,C
2-PB1,1181,3,3,1,5076,5083,C
2-PB1,1182,1,5060,1,8,5070,T
2-PB1,1183,1,1,0,5893,5895,C
2-PB1,1184,0,5999,0,7,6006,T
2-PB1,1185,1,5986,1,8,5996,T
2-PB1,1186,3,2,0,6155,6160,C
2-PB1,1187,1,6120,1,10,6132,T
2-PB1,1188,6143,0,4,0,6147,A
2-PB1,1189,6140,0,8,1,6149,A
2-PB1,1190,0,6149,0,2,6151,T
2-PB1,1191,6180,0,2,0,6182,A
2-PB1,1192,4,1,6035,0,6040,G
2-PB1,1193,5501,1,2,0,5504,A
2-PB1,1194,0,5499,2,4,5505,T
2-PB1,1195,3,3,5395,0,5401,G
2-PB1,1196,0,0,5511,0,5511,G
2-PB1,1197,3,0,1,5502,5506,C
2-PB1,1198,5509,0,6,0,5515,A
2-PB1,1199,2,1,0,5519,5522,C
2-PB1,1200,5438,0,12,0,5450,A
2-PB1,1201,2,1,5645,0,5648,G
2-PB1,1202,1,1,1,5635,5638,C
2-PB1,1203,5635,1,10,2,5648,A
2-PB1,1204,0,5833,0,4,5837,T
2-PB1,1205,2,2,0,5800,5804,C
2-PB1,1206,5851,1,5,1,5858,A
2-PB1,1207,0,5843,1,8,5852,T
2-PB1,1208,1,5804,0,2,5807,T
2-PB1,1209,3,4,5771,1,5779,G
2-PB1,1210,5573,0,11,0,5584,A
2-PB1,1211,4,1,5760,0,5765,G
2-PB1,1212,0,6,0,5737,5743,C
2-PB1,1213,7,0,0,5644,5651,C
2-PB1,1214,5,2,0,5738,5745,C
2-PB1,1215,0,5655,1,11,5667,T
2-PB1,1216,1,3,6253,0,6257,G
2-PB1,1217,1,2,6412,0,6415,G
2-PB1,1218,6372,1,14,0,6387,A
2-PB1,1219,6735,0,2,0,6737,A
2-PB1,1220,2,6568,0,5,6575,T
2-PB1,1221,1,4,6818,0,6823,G
2-PB1,1222,6919,0,8,0,6927,A
2-PB1,1223,2,6971,1,4,6978,T
2-PB1,1224,2,5,6988,0,6995,G
2-PB1,1225,6917,1,4,1,6923,A
2-PB1,1226,0,6828,0,3,6831,T
2-PB1,1227,2,9,6833,2,6846,G
2-PB1,1228,1,8,6977,0,6986,G
2-PB1,1229,3,3,6999,1,7006,G
2-PB1,1230,1,0,0,6947,6948,C
2-PB1,1231,6955,0,8,1,6964,A
2-PB1,1232,0,7029,1,5,7035,T
2-PB1,1233,1,2,7294,0,7297,G
2-PB1,1234,0,7299,0,10,7309,T
2-PB1,1235,1,7337,0,4,7342,T
2-PB1,1236,9,1,1,7354,7365,C
2-PB1,1237,7292,1,13,1,7307,A
2-PB1,1238,7317,2,10,1,7330,A
2-PB1,1239,1,3,0,7325,7329,C
2-PB1,1240,7380,0,5,0,7385,A
2-PB1,1241,1,7400,0,2,7403,T
2-PB1,1242,2,3,7553,0,7558,G
2-PB1,1243,3,5,0,7543,7551,C
2-PB1,1244,0,7556,0,7,7563,T
2-PB1,1245,7610,0,44,0,7654,A
2-PB1,1246,7634,2,4,1,7641,A
2-PB1,1247,0,3,7870,0,7873,G
2-PB1,1248,1,7848,0,4,7853,T
2-PB1,1249,7827,0,4,1,7832,A
2-PB1,1250,1,5,1,7870,7877,C
2-PB1,1251,13,17,7848,0,7878,G
2-PB1,1252,1,0,8571,0,8572,G
2-PB1,1253,0,8544,2,6,8552,T
2-PB1,1254,0,8508,0,2,8510,T
2-PB1,1255,0,8499,2,10,8511,T
2-PB1,1256,0,8487,0,2,8489,T
2-PB1,1257,8482,1,8,0,8491,A
2-PB1,1258,5,7,8478,0,8490,G
2-PB1,1259,3,10,8451,0,8464,G
2-PB1,1260,8246,1,6,1,8254,A
2-PB1,1261,3,2,8192,0,8197,G
2-PB1,1262,1,8299,0,5,8305,T
2-PB1,1263,9,0,0,8325,8334,C
2-PB1,1264,1,8326,1,9,8337,T
2-PB1,1265,8,4,0,8339,8351,C
2-PB1,1266,4,6,8355,0,8365,G
2-PB1,1267,8729,1,2,0,8732,A
2-PB1,1268,0,8767,0,2,8769,T
2-PB1,1269,8807,0,2,0,8809,A
2-PB1,1270,3,2,0,8803,8808,C
2-PB1,1271,2,8625,0,20,8647,T
2-PB1,1272,1,9,8654,0,8664,G
2-PB1,1273,8641,2,11,0,8654,A
2-PB1,1274,8826,1,2,0,8829,A
2-PB1,1275,5,8821,0,11,8837,T
2-PB1,1276,4,1,0,8600,8605,C
2-PB1,1277,3,8553,0,16,8572,T
2-PB1,1278,1,8535,0,7,8543,T
2-PB1,1279,3,7,8562,0,8572,G
2-PB1,1280,2,6,8581,1,8590,G
2-PB1,1281,8532,1,15,2,8550,A
2-PB1,1282,0,4,0,8599,8603,C
2-PB1,1283,8421,0,2,0,8423,A
2-PB1,1284,8492,0,2,0,8494,A
2-PB1,1285,8535,1,8,1,8545,A
2-PB1,1286,8569,0,19,1,8589,A
2-PB1,1287,4,5,8761,0,8770,G
2-PB1,1288,8765,0,14,2,8781,A
2-PB1,1289,8762,1,16,1,8780,A
2-PB1,1290,8792,0,18,0,8810,A
2-PB1,1291,0,8787,0,5,8792,T
2-PB1,1292,8798,0,3,0,8801,A
2-PB1,1293,3,2,0,9140,9145,C
2-PB1,1294,9024,1,13,0,9038,A
2-PB1,1295,1,3,0,9091,9095,C
2-PB1,1296,5,4,1,8921,8931,C
2-PB1,1297,8886,0,3,3,8892,A
2-PB1,1298,9019,0,5,0,9024,A
2-PB1,1299,2,9,9372,0,9383,G
2-PB1,1300,9529,0,20,0,9549,A
2-PB1,1301,1,5,0,9642,9648,C
2-PB1,1302,9377,0,15,0,9392,A
2-PB1,1303,9743,1,17,0,9761,A
2-PB1,1304,2,16,1,9789,9808,C
2-PB1,1305,9990,9,12,1,10012,A
2-PB1,1306,0,10055,0,2,10057,T
2-PB1,1307,9941,2,3,0,9946,A
2-PB1,1308,1,4,0,10154,10159,C
2-PB1,1309,0,9752,1,8,9761,T
2-PB1,1310,0,7,9901,0,9908,G
2-PB1,1311,0,2,9896,0,9898,G
2-PB1,1312,0,9587,2,14,9603,T
2-PB1,1313,3,18,9546,1,9568,G
2-PB1,1314,3,10,9456,0,9469,G
2-PB1,1315,3,3,9521,0,9527,G
2-PB1,1316,9471,1,10,1,9483,A
2-PB1,1317,0,9300,1,6,9307,T
2-PB1,1318,7,17,9278,2,9304,G
2-PB1,1319,3,2,9287,0,9292,G
2-PB1,1320,2,1,9345,1,9349,G
2-PB1,1321,3,2,0,9473,9478,C
2-PB1,1322,2,9405,0,22,9429,T
2-PB1,1323,3,2,0,9539,9544,C
2-PB1,1324,4,3,1,9508,9516,C
2-PB1,1325,9519,0,4,0,9523,A
2-PB1,1326,9524,2,4,5,9535,A
2-PB1,1327,1,9473,0,8,9482,T
2-PB1,1328,5,3,2,9440,9450,C
2-PB1,1329,4,1,1,9384,9390,C
2-PB1,1330,1,9278,1,13,9293,T
2-PB1,1331,5,3,0,9281,9289,C
2-PB1,1332,5,3,0,9260,9268,C
2-PB1,1333,6,8,9261,0,9275,G
2-PB1,1334,9263,0,4,0,9267,A
2-PB1,1335,0,2,0,9269,9271,C
2-PB1,1336,3,11,9261,0,9275,G
2-PB1,1337,9357,0,4,1,9362,A
2-PB1,1338,1,9337,1,6,9345,T
2-PB1,1339,0,9362,0,4,9366,T
2-PB1,1340,0,9355,0,11,9366,T
2-PB1,1341,1,9372,0,2,9375,T
2-PB1,1342,2,0,9403,0,9405,G
2-PB1,1343,0,5,0,9482,9487,C
2-PB1,1344,9,9,1,9454,9473,C
2-PB1,1345,10,2,0,9850,9862,C
2-PB1,1346,1,9661,1,18,9681,T
2-PB1,1347,12,1,0,10100,10113,C
2-PB1,1348,10195,0,12,0,10207,A
2-PB1,1349,4,10255,0,6,10265,T
2-PB1,1350,10245,0,9,0,10254,A
2-PB1,1351,3,0,10360,0,10363,G
2-PB1,1352,2,10214,2,5,10223,T
2-PB1,1353,1,14,10269,0,10284,G
2-PB1,1354,9848,3,8,2,9861,A
2-PB1,1355,9860,2,6,0,9868,A
2-PB1,1356,0,9358,0,6,9364,T
2-PB1,1357,2,0,9349,0,9351,G
2-PB1,1358,1,5,0,9451,9457,C
2-PB1,1359,9479,1,13,0,9493,A
2-PB1,1360,5,6,0,9492,9503,C
2-PB1,1361,7,2,1,9391,9401,C
2-PB1,1362,9309,0,6,0,9315,A
2-PB1,1363,9310,1,3,0,9314,A
2-PB1,1364,9278,1,3,0,9282,A
2-PB1,1365,0,8971,2,11,8984,T
2-PB1,1366,10,1,0,9361,9372,C
2-PB1,1367,9361,0,4,0,9365,A
2-PB1,1368,0,9369,0,2,9371,T
2-PB1,1369,4,7,9383,0,9394,G
2-PB1,1370,9365,1,19,1,9386,A
2-PB1,1371,1,22,9470,0,9493,G
2-PB1,1372,1,5,9485,0,9491,G
2-PB1,1373,9,6,9535,0,9550,G
2-PB1,1374,9434,1,22,2,9459,A
2-PB1,1375,9601,0,14,0,9615,A
2-PB1,1376,0,9646,0,1,9647,T
2-PB1,1377,9654,2,5,0,9661,A
2-PB1,1378,0,8,0,9666,9674,C
2-PB1,1379,9652,0,8,0,9660,A
2-PB1,1380,9621,0,20,0,9641,A
2-PB1,1381,2,1,9604,0,9607,G
2-PB1,1382,1,5,0,9519,9525,C
2-PB1,1383,9448,0,9,0,9457,A
2-PB1,1384,3,7,9566,0,9576,G
2-PB1,1385,1,6,9579,0,9586,G
2-PB1,1386,9493,1,12,1,9507,A
2-PB1,1387,4,5,9595,0,9604,G
2-PB1,1388,1,9393,0,6,9400,T
2-PB1,1389,2,9,9563,0,9574,G
2-PB1,1390,1,4,9610,0,9615,G
2-PB1,1391,9583,0,14,0,9597,A
2-PB1,1392,0,9607,1,3,9611,T
2-PB1,1393,9422,1,3,0,9426,A
2-PB1,1394,0,4,9543,0,9547,G
2-PB1,1395,9632,1,8,0,9641,A
2-PB1,1396,1,9635,0,11,9647,T
2-PB1,1397,3,9587,1,1,9592,T
2-PB1,1398,5,4,2,9941,9952,C
2-PB1,1399,0,9875,0,3,9878,T
2-PB1,1400,9881,0,5,1,9887,A
2-PB1,1401,1,7,0,9863,9871,C
2-PB1,1402,9646,3,15,0,9664,A
2-PB1,1403,3,8,9659,0,9670,G
2-PB1,1404,1,12,9473,0,9486,G
2-PB1,1405,9577,0,14,0,9591,A
2-PB1,1406,4,1,0,9557,9562,C
2-PB1,1407,5,3,0,9226,9234,C
2-PB1,1408,4,9108,2,24,9138,T
2-PB1,1409,4,2,9184,1,9191,G
2-PB1,1410,1,3,1,9169,9174,C
2-PB1,1411,9181,0,4,1,9186,A
2-PB1,1412,9243,0,13,2,9258,A
2-PB1,1413,2,1,9309,0,9312,G
2-PB1,1414,1,9120,1,7,9129,T
2-PB1,1415,0,9109,0,4,9113,T
2-PB1,1416,8960,1,8,1,8970,A
2-PB1,1417,1,1,9022,2,9026,G
2-PB1,1418,2,8948,0,5,8955,T
2-PB1,1419,2,17,8918,0,8937,G
2-PB1,1420,3,7,8917,0,8927,G
2-PB1,1421,4,8,8979,1,8992,G
2-PB1,1422,8941,0,7,0,8948,A
2-PB1,1423,8994,2,1,0,8997,A
2-PB1,1424,1,8951,1,6,8959,T
2-PB1,1425,8,3,0,9002,9013,C
2-PB1,1426,9009,4,12,0,9025,A
2-PB1,1427,9048,1,8,0,9057,A
2-PB1,1428,1,3,0,9045,9049,C
2-PB1,1429,9017,0,8,0,9025,A
2-PB1,1430,0,8796,0,9,8805,T
2-PB1,1431,3,15,8829,0,8847,G
2-PB1,1432,8823,2,21,0,8846,A
2-PB1,1433,3,0,8950,0,8953,G
2-PB1,1434,1,1,1,8902,8905,C
2-PB1,1435,8880,0,6,0,8886,A
2-PB1,1436,8879,3,9,0,8891,A
2-PB1,1437,8881,1,5,0,8887,A
2-PB1,1438,8965,3,11,1,8980,A
2-PB1,1439,8982,0,6,0,8988,A
2-PB1,1440,3,2,8984,0,8989,G
2-PB1,1441,8858,0,5,0,8863,A
2-PB1,1442,8700,0,24,1,8725,A
2-PB1,1443,2,1,9177,0,9180,G
2-PB1,1444,1,9135,1,5,9142,T
2-PB1,1445,11,2,1,9173,9187,C
2-PB1,1446,15,1,1,9192,9209,C
2-PB1,1447,1,9136,0,8,9145,T
2-PB1,1448,9317,0,2,0,9319,A
2-PB1,1449,1,9284,1,4,9290,T
2-PB1,1450,9288,1,7,0,9296,A
2-PB1,1451,0,9281,0,5,9286,T
2-PB1,1452,9073,0,3,0,9076,A
2-PB1,1453,9073,3,12,1,9089,A
2-PB1,1454,9078,0,1,0,9079,A
2-PB1,1455,5,9063,0,1,9069,T
2-PB1,1456,8963,0,2,0,8965,A
2-PB1,1457,8910,0,5,0,8915,A
2-PB1,1458,8933,0,14,1,8948,A
2-PB1,1459,8968,0,9,1,8978,A
2-PB1,1460,2,0,1,9001,9004,C
2-PB1,1461,8488,0,8,0,8496,A
2-PB1,1462,1,18,8497,1,8517,G
2-PB1,1463,1,5,8485,2,8493,G
2-PB1,1464,0,8,8507,2,8517,G
2-PB1,1465,8488,3,10,1,8502,A
2-PB1,1466,2,9,0,8632,8643,C
2-PB1,1467,8567,0,4,0,8571,A
2-PB1,1468,0,8613,0,6,8619,T
2-PB1,1469,2,8607,1,12,8622,T
2-PB1,1470,2,8637,0,6,8645,T
2-PB1,1471,2,7,8653,0,8662,G
2-PB1,1472,8550,0,11,1,8562,A
2-PB1,1473,8612,0,5,0,8617,A
2-PB1,1474,1,8610,0,1,8612,T
2-PB1,1475,0,8399,2,6,8407,T
2-PB1,1476,6,3,0,8473,8482,C
2-PB1,1477,8391,1,3,0,8395,A
2-PB1,1478,4,1,0,8399,8404,C
2-PB1,1479,0,8410,0,2,8412,T
2-PB1,1480,8434,3,5,0,8442,A
2-PB1,1481,1,3,8444,0,8448,G
2-PB1,1482,2,3,1,8483,8489,C
2-PB1,1483,0,8359,2,11,8372,T
2-PB1,1484,0,8484,0,15,8499,T
2-PB1,1485,0,8453,1,3,8457,T
2-PB1,1486,1,8443,2,8,8454,T
2-PB1,1487,0,8427,0,6,8433,T
2-PB1,1488,0,8424,1,3,8428,T
2-PB1,1489,0,8409,0,1,8410,T
2-PB1,1490,8392,2,3,0,8397,A
2-PB1,1491,1,8367,0,3,8371,T
2-PB1,1492,6,3,0,8395,8404,C
2-PB1,1493,2,6,8481,0,8489,G
2-PB1,1494,8804,2,1,0,8807,A
2-PB1,1495,0,8848,0,0,8848,T
2-PB1,1496,8869,0,2,0,8871,A
2-PB1,1497,1,8923,0,17,8941,T
2-PB1,1498,3,9,8929,0,8941,G
2-PB1,1499,2,5,9020,0,9027,G
2-PB1,1500,9029,1,5,0,9035,A
2-PB1,1501,1,8950,0,8,8959,T
2-PB1,1502,0,8872,0,7,8879,T
2-PB1,1503,1,8586,0,2,8589,T
2-PB1,1504,4,0,8620,1,8625,G
2-PB1,1505,0,8584,0,5,8589,T
2-PB1,1506,0,9,8565,1,8575,G
2-PB1,1507,1,1,8575,0,8577,G
2-PB1,1508,4,6,0,8461,8471,C
2-PB1,1509,0,8483,0,3,8486,T
2-PB1,1510,8516,0,1,1,8518,A
2-PB1,1511,8608,1,2,0,8611,A
2-PB1,1512,0,8701,0,0,8701,T
2-PB1,1513,0,8681,0,2,8683,T
2-PB1,1514,1,8692,0,4,8697,T
2-PB1,1515,0,8700,0,7,8707,T
2-PB1,1516,8690,0,9,1,8700,A
2-PB1,1517,1,1,8797,0,8799,G
2-PB1,1518,1,2,0,8787,8790,C
2-PB1,1519,8782,0,4,0,8786,A
2-PB1,1520,1,8679,0,7,8687,T
2-PB1,1521,4,9,8573,1,8587,G
2-PB1,1522,7,8,8751,0,8766,G
2-PB1,1523,8700,1,13,0,8714,A
2-PB1,1524,0,1,8780,0,8781,G
2-PB1,1525,5,5,0,8706,8716,C
2-PB1,1526,1,8603,0,8,8612,T
2-PB1,1527,2,2,8684,0,8688,G
2-PB1,1528,0,7,0,8632,8639,C
2-PB1,1529,8,1,1,8617,8627,C
2-PB1,1530,11,1,0,8688,8700,C
2-PB1,1531,8477,1,9,1,8488,A
2-PB1,1532,1,0,9241,1,9243,G
2-PB1,1533,0,9216,1,7,9224,T
2-PB1,1534,0,9224,0,4,9228,T
2-PB1,1535,0,9239,1,2,9242,T
2-PB1,1536,1,9136,0,5,9142,T
2-PB1,1537,2,7,9102,0,9111,G
2-PB1,1538,1,15,9094,0,9110,G
2-PB1,1539,9021,0,8,0,9029,A
2-PB1,1540,0,1,9096,0,9097,G
2-PB1,1541,1,8190,0,9,8200,T
2-PB1,1542,4,2,8631,0,8637,G
2-PB1,1543,0,8604,2,10,8616,T
2-PB1,1544,12,4,0,8601,8617,C
2-PB1,1545,3,8596,1,20,8620,T
2-PB1,1546,5,1,8671,1,8678,G
2-PB1,1547,5,7,8791,0,8803,G
2-PB1,1548,8816,1,9,1,8827,A
2-PB1,1549,8837,0,13,0,8850,A
2-PB1,1550,2,8818,0,1,8821,T
2-PB1,1551,8211,1,2,0,8214,A
2-PB1,1552,8175,2,12,0,8189,A
2-PB1,1553,8176,1,18,1,8196,A
2-PB1,1554,1,6,1,8204,8212,C
2-PB1,1555,3,4,8126,1,8134,G
2-PB1,1556,7976,0,8,0,7984,A
2-PB1,1557,3,0,7983,0,7986,G
2-PB1,1558,1,7950,0,11,7962,T
2-PB1,1559,5,3,0,7986,7994,C
2-PB1,1560,7969,1,12,0,7982,A
2-PB1,1561,1,1,8119,0,8121,G
2-PB1,1562,1,2,0,8098,8101,C
2-PB1,1563,0,8098,0,4,8102,T
2-PB1,1564,7,3,8390,0,8400,G
2-PB1,1565,8321,0,9,2,8332,A
2-PB1,1566,0,8365,0,2,8367,T
2-PB1,1567,8357,1,3,0,8361,A
2-PB1,1568,2,8229,0,10,8241,T
2-PB1,1569,2,7,8268,0,8277,G
2-PB1,1570,7897,1,11,0,7909,A
2-PB1,1571,1,1,8090,0,8092,G
2-PB1,1572,7,4,2,8084,8097,C
2-PB1,1573,7580,1,3,0,7584,A
2-PB1,1574,0,7597,0,0,7597,T
2-PB1,1575,0,7575,0,7,7582,T
2-PB1,1576,1,6,7645,0,7652,G
2-PB1,1577,3,10,7940,1,7954,G
2-PB1,1578,7768,1,10,0,7779,A
2-PB1,1579,6,0,7829,0,7835,G
2-PB1,1580,0,7521,0,4,7525,T
2-PB1,1581,7485,0,9,0,7494,A
2-PB1,1582,7500,0,4,1,7505,A
2-PB1,1583,0,4,0,7569,7573,C
2-PB1,1584,7493,1,10,0,7504,A
2-PB1,1585,2,0,7683,0,7685,G
2-PB1,1586,1,6795,1,3,6800,T
2-PB1,1587,2,7,6892,0,6901,G
2-PB1,1588,6991,2,14,0,7007,A
2-PB1,1589,0,6979,0,6,6985,T
2-PB1,1590,6980,0,3,1,6984,A
2-PB1,1591,6980,1,8,0,6989,A
2-PB1,1592,6758,0,26,1,6785,A
2-PB1,1593,1,8,6871,0,6880,G
2-PB1,1594,6490,1,4,0,6495,A
2-PB1,1595,6485,0,11,0,6496,A
2-PB1,1596,1,0,0,6509,6510,C
2-PB1,1597,6240,1,8,0,6249,A
2-PB1,1598,6305,0,11,0,6316,A
2-PB1,1599,0,2,0,6350,6352,C
2-PB1,1600,6407,0,6,1,6414,A
2-PB1,1601,1,6385,28,2,6416,T
2-PB1,1602,3,7,6270,0,6280,G
2-PB1,1603,6266,0,12,0,6278,A
2-PB1,1604,0,6277,0,1,6278,T
2-PB1,1605,6191,0,7,0,6198,A
2-PB1,1606,6245,1,6,0,6252,A
2-PB1,1607,6190,1,4,1,6196,A
2-PB1,1608,2,1,1,6244,6248,C
2-PB1,1609,5952,0,2,0,5954,A
2-PB1,1610,5939,1,1,1,5942,A
2-PB1,1611,0,5797,2,9,5808,T
2-PB1,1612,2,7,5806,1,5816,G
2-PB1,1613,5969,1,5,0,5975,A
2-PB1,1614,2,0,0,6023,6025,C
2-PB1,1615,3,1,1,5917,5922,C
2-PB1,1616,2,5691,1,8,5702,T
2-PB1,1617,0,5580,0,2,5582,T
2-PB1,1618,1,6,5594,0,5601,G
2-PB1,1619,1,8,5616,1,5626,G
2-PB1,1620,5670,1,10,0,5681,A
2-PB1,1621,2,3,0,5675,5680,C
2-PB1,1622,2,2,0,5577,5581,C
2-PB1,1623,5513,2,6,2,5523,A
2-PB1,1624,2,0,5598,0,5600,G
2-PB1,1625,0,5,1,5614,5620,C
2-PB1,1626,5611,1,3,0,5615,A
2-PB1,1627,5617,1,5,0,5623,A
2-PB1,1628,2,1,0,5578,5581,C
2-PB1,1629,5525,0,2,0,5527,A
2-PB1,1630,3,1,5646,0,5650,G
2-PB1,1631,1,5,0,5646,5652,C
2-PB1,1632,2,3,0,5630,5635,C
2-PB1,1633,6,8,0,5603,5617,C
2-PB1,1634,5637,1,2,0,5640,A
2-PB1,1635,5621,1,6,0,5628,A
2-PB1,1636,5630,0,3,0,5633,A
2-PB1,1637,1,5620,0,4,5625,T
2-PB1,1638,1,2,5591,0,5594,G
2-PB1,1639,2,1,5518,0,5521,G
2-PB1,1640,2,2,0,5537,5541,C
2-PB1,1641,1,5469,0,10,5480,T
2-PB1,1642,2,0,1,5657,5660,C
2-PB1,1643,1,5616,0,10,5627,T
2-PB1,1644,2,1,1,5689,5693,C
2-PB1,1645,8,4,0,5677,5689,C
2-PB1,1646,5701,2,2,1,5706,A
2-PB1,1647,5716,0,3,1,5720,A
2-PB1,1648,1,5668,1,2,5672,T
2-PB1,1649,0,5620,1,1,5622,T
2-PB1,1650,0,1,5666,0,5667,G
2-PB1,1651,0,5526,0,3,5529,T
2-PB1,1652,1,5527,1,5,5534,T
2-PB1,1653,7,9,0,5535,5551,C
2-PB1,1654,5534,0,3,0,5537,A
2-PB1,1655,1,5518,0,9,5528,T
2-PB1,1656,2,2,1,5529,5534,C
2-PB1,1657,5550,0,3,0,5553,A
2-PB1,1658,5561,0,3,0,5564,A
2-PB1,1659,5562,0,4,0,5566,A
2-PB1,1660,2,3,5691,0,5696,G
2-PB1,1661,5671,0,5,0,5676,A
2-PB1,1662,0,5671,0,1,5672,T
2-PB1,1663,1,5691,0,0,5692,T
2-PB1,1664,5712,0,4,0,5716,A
2-PB1,1665,0,1,0,5810,5811,C
2-PB1,1666,5765,2,2,0,5769,A
2-PB1,1667,1,1,5859,1,5862,G
2-PB1,1668,5816,1,12,0,5829,A
2-PB1,1669,1,5890,0,0,5891,T
2-PB1,1670,5909,0,5,0,5914,A
2-PB1,1671,2,1,0,6297,6300,C
2-PB1,1672,6410,1,15,1,6427,A
2-PB1,1673,0,5,0,6881,6886,C
2-PB1,1674,6718,0,11,1,6730,A
2-PB1,1675,1,6775,0,3,6779,T
2-PB1,1676,6718,0,3,0,6721,A
2-PB1,1677,3,6689,0,4,6696,T
2-PB1,1678,6467,1,4,0,6472,A
2-PB1,1679,2,3,6476,0,6481,G
2-PB1,1680,4,0,6342,0,6346,G
2-PB1,1681,0,5946,1,9,5956,T
2-PB1,1682,4,2,5832,0,5838,G
2-PB1,1683,2,1,0,6098,6101,C
2-PB1,1684,6,2,1,6092,6101,C
2-PB1,1685,6181,1,4,0,6186,A
2-PB1,1686,0,6175,0,0,6175,T
2-PB1,1687,6183,3,5,0,6191,A
2-PB1,1688,0,8,6216,0,6224,G
2-PB1,1689,6042,1,9,0,6052,A
2-PB1,1690,0,5,6082,1,6088,G
2-PB1,1691,1,6,6084,1,6092,G
2-PB1,1692,5784,0,8,0,5792,A
2-PB1,1693,2,3,5817,0,5822,G
2-PB1,1694,5773,0,6,0,5779,A
2-PB1,1695,0,0,0,5803,5803,C
2-PB1,1696,5782,0,11,1,5794,A
2-PB1,1697,1,1,0,5872,5874,C
2-PB1,1698,5837,3,16,0,5856,A
2-PB1,1699,0,0,0,5881,5881,C
2-PB1,1700,5811,1,4,0,5816,A
2-PB1,1701,5830,1,13,0,5844,A
2-PB1,1702,5893,0,2,0,5895,A
2-PB1,1703,0,5885,1,2,5888,T
2-PB1,1704,4,0,0,5912,5916,C
2-PB1,1705,7,2,0,5905,5914,C
2-PB1,1706,5806,1,7,0,5814,A
2-PB1,1707,1,5,5822,0,5828,G
2-PB1,1708,5820,0,3,0,5823,A
2-PB1,1709,0,3,0,5886,5889,C
2-PB1,1710,0,11,5862,1,5874,G
2-PB1,1711,5805,1,6,0,5812,A
2-PB1,1712,1,3,5842,0,5846,G
2-PB1,1713,5837,1,3,1,5842,A
2-PB1,1714,5832,0,9,0,5841,A
2-PB1,1715,1,3,5868,1,5873,G
2-PB1,1716,5838,1,4,0,5843,A
2-PB1,1717,0,5821,0,5,5826,T
2-PB1,1718,2,1,1,5784,5788,C
2-PB1,1719,5800,1,2,0,5803,A
2-PB1,1720,0,5755,1,0,5756,T
2-PB1,1721,0,5739,0,1,5740,T
2-PB1,1722,1,2,0,5771,5774,C
2-PB1,1723,2,4,5771,0,5777,G
2-PB1,1724,5696,2,4,0,5702,A
2-PB1,1725,1,2,5731,0,5734,G
2-PB1,1726,5692,1,10,0,5703,A
2-PB1,1727,0,5877,0,0,5877,T
2-PB1,1728,5894,0,2,0,5896,A
2-PB1,1729,5903,0,2,0,5905,A
2-PB1,1730,5891,0,1,0,5892,A
2-PB1,1731,5802,1,6,0,5809,A
2-PB1,1732,5843,0,1,0,5844,A
2-PB1,1733,5846,1,16,0,5863,A
2-PB1,1734,5,3,5878,0,5886,G
2-PB1,1735,2,4,0,5884,5890,C
2-PB1,1736,0,5771,0,6,5777,T
2-PB1,1737,1,1,5795,0,5797,G
2-PB1,1738,0,5772,0,8,5780,T
2-PB1,1739,0,7,5743,0,5750,G
2-PB1,1740,1,5,5785,1,5792,G
2-PB1,1741,3,8,5849,0,5860,G
2-PB1,1742,5872,0,5,0,5877,A
2-PB1,1743,1,5827,0,2,5830,T
2-PB1,1744,6,3,0,5826,5835,C
2-PB1,1745,5842,0,5,1,5848,A
2-PB1,1746,5895,0,6,0,5901,A
2-PB1,1747,5935,1,5,1,5942,A
2-PB1,1748,1,1,0,5910,5912,C
2-PB1,1749,6,2,0,5887,5895,C
2-PB1,1750,13,3,1,5847,5864,C
2-PB1,1751,5846,2,5,0,5853,A
2-PB1,1752,5994,1,7,0,6002,A
2-PB1,1753,0,5972,0,0,5972,T
2-PB1,1754,2,2,0,5984,5988,C
2-PB1,1755,5906,0,5,0,5911,A
2-PB1,1756,5867,0,5,2,5874,A
2-PB1,1757,3,8,5951,1,5963,G
2-PB1,1758,2,4,5916,1,5923,G
2-PB1,1759,0,1,5941,0,5942,G
2-PB1,1760,0,5,0,5917,5922,C
2-PB1,1761,5808,1,7,0,5816,A
2-PB1,1762,0,4,6020,0,6024,G
2-PB1,1763,1,4,6075,3,6083,G
2-PB1,1764,6085,0,11,1,6097,A
2-PB1,1765,3,0,0,6160,6163,C
2-PB1,1766,1,6027,0,9,6037,T
2-PB1,1767,6175,3,0,0,6178,A
2-PB1,1768,0,6155,0,9,6164,T
2-PB1,1769,0,6163,0,5,6168,T
2-PB1,1770,1,6,6163,0,6170,G
2-PB1,1771,4,2,6210,0,6216,G
2-PB1,1772,0,6109,2,1,6112,T
2-PB1,1773,6109,1,0,0,6110,A
2-PB1,1774,1,5992,1,10,6004,T
2-PB1,1775,2,1,3,6019,6025,C
2-PB1,1776,5890,1,1,0,5892,A
2-PB1,1777,1,1,5945,0,5947,G
2-PB1,1778,5943,1,8,0,5952,A
2-PB1,1779,0,5913,0,2,5915,T
2-PB1,1780,2,10,5636,0,5648,G
2-PB1,1781,1,3,5624,0,5628,G
2-PB1,1782,7,9,5592,0,5608,G
2-PB1,1783,4,9,5607,2,5622,G
2-PB1,1784,1,3,5627,0,5631,G
2-PB1,1785,5609,0,8,1,5618,A
2-PB1,1786,2,2,0,5595,5599,C
2-PB1,1787,1,1,0,5552,5554,C
2-PB1,1788,5572,2,4,0,5578,A
2-PB1,1789,6099,1,2,0,6102,A
2-PB1,1790,6136,0,3,3,6142,A
2-PB1,1791,0,2,0,6279,6281,C
2-PB1,1792,0,6189,1,15,6205,T
2-PB1,1793,0,6182,1,4,6187,T
2-PB1,1794,6200,1,4,0,6205,A
2-PB1,1795,2,6200,2,1,6205,T
2-PB1,1796,6223,0,5,0,6228,A
2-PB1,1797,0,2,0,6234,6236,C
2-PB1,1798,5630,0,2,0,5632,A
2-PB1,1799,5666,1,3,0,5670,A
2-PB1,1800,0,5460,0,1,5461,T
2-PB1,1801,5580,0,1,0,5581,A
2-PB1,1802,1,5566,0,3,5570,T
2-PB1,1803,4,3,0,5559,5566,C
2-PB1,1804,7,2,1,5541,5551,C
2-PB1,1805,4,5,5543,0,5552,G
2-PB1,1806,3,3,5557,0,5563,G
2-PB1,1807,5554,0,2,1,5557,A
2-PB1,1808,5579,0,0,0,5579,A
2-PB1,1809,0,5573,0,1,5574,T
2-PB1,1810,2,2,0,5619,5623,C
2-PB1,1811,1,5580,1,12,5594,T
2-PB1,1812,0,5626,0,8,5634,T
2-PB1,1813,1,2,0,5631,5634,C
2-PB1,1814,5622,2,5,0,5629,A
2-PB1,1815,1,4,0,5653,5658,C
2-PB1,1816,5626,2,5,0,5633,A
2-PB1,1817,0,6141,0,10,6151,T
2-PB1,1818,4,2,0,6161,6167,C
2-PB1,1819,10,3,0,6147,6160,C
2-PB1,1820,7,4,0,6183,6194,C
2-PB1,1821,0,6178,1,12,6191,T
2-PB1,1822,2,4,6185,1,6192,G
2-PB1,1823,6180,0,3,0,6183,A
2-PB1,1824,6164,0,5,1,6170,A
2-PB1,1825,1,2,6190,0,6193,G
2-PB1,1826,1,5689,1,2,5693,T
2-PB1,1827,4,1,0,5706,5711,C
2-PB1,1828,0,5628,0,3,5631,T
2-PB1,1829,2,1,5816,0,5819,G
2-PB1,1830,0,1,0,5814,5815,C
2-PB1,1831,1,5784,1,6,5792,T
2-PB1,1832,0,5812,1,2,5815,T
2-PB1,1833,5815,0,0,0,5815,A
2-PB1,1834,5807,3,3,1,5814,A
2-PB1,1835,5836,0,6,1,5843,A
2-PB1,1836,2,2,5889,1,5894,G
2-PB1,1837,0,5770,1,4,5775,T
2-PB1,1838,0,8,5668,0,5676,G
2-PB1,1839,4,3,5652,0,5659,G
2-PB1,1840,2,7,5701,0,5710,G
2-PB1,1841,5651,0,15,0,5666,A
2-PB1,1842,3,4,5699,0,5706,G
2-PB1,1843,11,0,0,5668,5679,C
2-PB1,1844,0,5651,0,8,5659,T
2-PB1,1845,1,0,5676,0,5677,G
2-PB1,1846,5657,0,5,0,5662,A
2-PB1,1847,0,5651,0,1,5652,T
2-PB1,1848,3,8,5686,0,5697,G
2-PB1,1849,1,3,5734,0,5738,G
2-PB1,1850,5694,0,7,2,5703,A
2-PB1,1851,2,5685,0,6,5693,T
2-PB1,1852,1,5,5700,0,5706,G
2-PB1,1853,5657,2,8,0,5667,A
2-PB1,1854,1,9,5762,1,5773,G
2-PB1,1855,5736,1,5,0,5742,A
2-PB1,1856,5764,0,1,0,5765,A
2-PB1,1857,1,5738,0,1,5740,T
2-PB1,1858,0,5675,0,1,5676,T
2-PB1,1859,5699,1,0,0,5700,A
2-PB1,1860,1,5692,0,0,5693,T
2-PB1,1861,3,4,0,5685,5692,C
2-PB1,1862,2,6,5706,0,5714,G
2-PB1,1863,2,10,5648,0,5660,G
2-PB1,1864,0,3,5635,0,5638,G
2-PB1,1865,4,3,5648,0,5655,G
2-PB1,1866,5625,3,0,0,5628,A
2-PB1,1867,5630,0,12,0,5642,A
2-PB1,1868,0,4,5692,1,5697,G
2-PB1,1869,5740,0,9,0,5749,A
2-PB1,1870,1,0,1,5812,5814,C
2-PB1,1871,0,5701,0,4,5705,T
2-PB1,1872,0,5873,0,8,5881,T
2-PB1,1873,0,5881,0,6,5887,T
2-PB1,1874,2,0,5955,0,5957,G
2-PB1,1875,0,5951,0,5,5956,T
2-PB1,1876,5910,0,3,0,5913,A
2-PB1,1877,5903,0,7,0,5910,A
2-PB1,1878,0,5750,0,3,5753,T
2-PB1,1879,2,7,0,5792,5801,C
2-PB1,1880,3,1,0,5793,5797,C
2-PB1,1881,11,1,0,5710,5722,C
2-PB1,1882,11,3,0,5758,5772,C
2-PB1,1883,0,5730,0,12,5742,T
2-PB1,1884,6,4,5753,1,5764,G
2-PB1,1885,5740,2,2,0,5744,A
2-PB1,1886,5763,0,5,0,5768,A
2-PB1,1887,1,5779,0,5,5785,T
2-PB1,1888,5,1,0,5748,5754,C
2-PB1,1889,4,0,1,5726,5731,C
2-PB1,1890,7,2,0,5684,5693,C
2-PB1,1891,0,5648,1,15,5664,T
2-PB1,1892,1,5665,0,9,5675,T
2-PB1,1893,0,5648,0,7,5655,T
2-PB1,1894,0,0,5668,0,5668,G
2-PB1,1895,1,5639,2,5,5647,T
2-PB1,1896,6,2,0,5632,5640,C
2-PB1,1897,5557,0,9,0,5566,A
2-PB1,1898,1,1,5652,0,5654,G
2-PB1,1899,1,2,0,5649,5652,C
2-PB1,1900,3,0,0,5652,5655,C
2-PB1,1901,5665,0,2,1,5668,A
2-PB1,1902,0,5679,0,6,5685,T
2-PB1,1903,5681,0,3,0,5684,A
2-PB1,1904,5707,1,2,0,5710,A
2-PB1,1905,5693,0,9,0,5702,A
2-PB1,1906,7,4,5783,0,5794,G
2-PB1,1907,5616,0,3,0,5619,A
2-PB1,1908,5613,0,5,1,5619,A
2-PB1,1909,5626,0,9,0,5635,A
2-PB1,1910,0,5613,0,0,5613,T
2-PB1,1911,0,5598,0,1,5599,T
2-PB1,1912,2,4,5606,0,5612,G
2-PB1,1913,5537,0,13,1,5551,A
2-PB1,1914,1,1,5696,0,5698,G
2-PB1,1915,1,5646,0,7,5654,T
2-PB1,1916,4,1,0,5722,5727,C
2-PB1,1917,0,5697,0,7,5704,T
2-PB1,1918,6,0,5843,0,5849,G
2-PB1,1919,1,5842,0,3,5846,T
2-PB1,1920,5951,0,6,0,5957,A
2-PB1,1921,5934,1,6,0,5941,A
2-PB1,1922,5943,0,4,5,5952,A
2-PB1,1923,0,5,1,5968,5974,C
2-PB1,1924,5761,2,3,0,5766,A
2-PB1,1925,5944,0,4,0,5948,A
2-PB1,1926,0,5932,0,2,5934,T
2-PB1,1927,3,0,5891,0,5894,G
2-PB1,1928,0,5,0,5952,5957,C
2-PB1,1929,1,5834,0,13,5848,T
2-PB1,1930,3,1,6127,0,6131,G
2-PB1,1931,2,6104,1,2,6109,T
2-PB1,1932,6277,0,4,0,6281,A
2-PB1,1933,2,4,6287,0,6293,G
2-PB1,1934,0,6119,0,1,6120,T
2-PB1,1935,6078,0,3,0,6081,A
2-PB1,1936,6028,1,1,0,6030,A
2-PB1,1937,1,5978,0,5,5984,T
2-PB1,1938,2,4,5962,0,5968,G
2-PB1,1939,1,4,0,5877,5882,C
2-PB1,1940,2,2,1,5818,5823,C
2-PB1,1941,5704,0,6,0,5710,A
2-PB1,1942,1,0,5761,0,5762,G
2-PB1,1943,0,5,0,5918,5923,C
2-PB1,1944,4,8,0,5932,5944,C
2-PB1,1945,9,0,0,5925,5934,C
2-PB1,1946,5893,1,4,1,5899,A
2-PB1,1947,1,5890,0,5,5896,T
2-PB1,1948,1,5,5903,0,5909,G
2-PB1,1949,2,0,5912,0,5914,G
2-PB1,1950,1,5879,0,4,5884,T
2-PB1,1951,5,2,0,5817,5824,C
2-PB1,1952,7,2,0,5616,5625,C
2-PB1,1953,3,3,5687,1,5694,G
2-PB1,1954,6,2,5705,0,5713,G
2-PB1,1955,2,5,0,5674,5681,C
2-PB1,1956,7,1,0,5693,5701,C
2-PB1,1957,5720,0,0,4,5724,A
2-PB1,1958,5732,0,2,0,5734,A
2-PB1,1959,5738,0,3,0,5741,A
2-PB1,1960,5748,1,6,3,5758,A
2-PB1,1961,0,0,5917,0,5917,G
2-PB1,1962,0,5722,0,3,5725,T
2-PB1,1963,5760,0,1,0,5761,A
2-PB1,1964,0,5753,0,2,5755,T
2-PB1,1965,2,2,5760,2,5766,G
2-PB1,1966,5,8,5880,0,5893,G
2-PB1,1967,5823,0,3,0,5826,A
2-PB1,1968,5916,2,5,1,5924,A
2-PB1,1969,0,5883,0,2,5885,T
2-PB1,1970,5782,0,3,0,5785,A
2-PB1,1971,0,5773,0,4,5777,T
2-PB1,1972,0,3,5715,0,5718,G
2-PB1,1973,5718,2,8,0,5728,A
2-PB1,1974,0,5694,0,6,5700,T
2-PB1,1975,4,2,5528,0,5534,G
2-PB1,1976,2,3,1,5521,5527,C
2-PB1,1977,2,2,0,5471,5475,C
2-PB1,1978,1,0,5479,0,5480,G
2-PB1,1979,1,5465,0,4,5470,T
2-PB1,1980,0,5467,0,8,5475,T
2-PB1,1981,1,2,5480,0,5483,G
2-PB1,1982,4,0,0,5616,5620,C
2-PB1,1983,5614,0,9,0,5623,A
2-PB1,1984,5721,0,2,0,5723,A
2-PB1,1985,1,3,0,5748,5752,C
2-PB1,1986,1,5697,0,3,5701,T
2-PB1,1987,5757,0,3,0,5760,A
2-PB1,1988,2,1,0,5749,5752,C
2-PB1,1989,5746,1,7,0,5754,A
2-PB1,1990,2,3,0,5746,5751,C
2-PB1,1991,5529,0,2,0,5531,A
2-PB1,1992,0,2,0,6138,6140,C
2-PB1,1993,1,5996,1,2,6000,T
2-PB1,1994,6,1,0,6051,6058,C
2-PB1,1995,6,2,0,6052,6060,C
2-PB1,1996,1,5998,1,12,6012,T
2-PB1,1997,1,3,5996,0,6000,G
2-PB1,1998,5,2,5995,1,6003,G
2-PB1,1999,5990,1,2,0,5993,A
2-PB1,2000,0,5991,0,2,5993,T
2-PB1,2001,1,5275,1,5,5282,T
2-PB1,2002,3,0,0,5388,5391,C
2-PB1,2003,3,3,0,5331,5337,C
2-PB1,2004,6,0,0,5372,5378,C
2-PB1,2005,5382,1,2,0,5385,A
2-PB1,2006,5372,0,5,0,5377,A
2-PB1,2007,1,1,5401,0,5403,G
2-PB1,2008,5348,1,9,0,5358,A
2-PB1,2009,2,3,5353,0,5358,G
2-PB1,2010,1,3,5364,0,5368,G
2-PB1,2011,5264,0,4,0,5268,A
2-PB1,2012,5271,0,2,0,5273,A
2-PB1,2013,1,0,0,5283,5284,C
2-PB1,2014,7,2,0,5221,5230,C
2-PB1,2015,3,1,5318,0,5322,G
2-PB1,2016,1,2,0,5304,5307,C
2-PB1,2017,1,5271,0,7,5279,T
2-PB1,2018,11,1,0,5325,5337,C
2-PB1,2019,1,5294,0,2,5297,T
2-PB1,2020,5833,2,0,0,5835,A
2-PB1,2021,0,5814,0,8,5822,T
2-PB1,2022,0,5848,0,6,5854,T
2-PB1,2023,6,1,0,5891,5898,C
2-PB1,2024,0,5656,1,6,5663,T
2-PB1,2025,5677,0,3,0,5680,A
2-PB1,2026,5665,0,7,1,5673,A
2-PB1,2027,5691,0,4,0,5695,A
2-PB1,2028,0,1,0,5698,5699,C
2-PB1,2029,5134,0,2,1,5137,A
2-PB1,2030,0,0,0,5135,5135,C
2-PB1,2031,5027,0,4,0,5031,A
2-PB1,2032,5087,2,4,0,5093,A
2-PB1,2033,2,2,5119,1,5124,G
2-PB1,2034,1,3,0,5133,5137,C
2-PB1,2035,1,2,0,5141,5144,C
2-PB1,2036,5084,0,3,0,5087,A
2-PB1,2037,5079,0,1,1,5081,A
2-PB1,2038,5068,1,8,1,5078,A
2-PB1,2039,2,8,5147,0,5157,G
2-PB1,2040,1,5,5141,0,5147,G
2-PB1,2041,3,5,5054,0,5062,G
2-PB1,2042,1,2,5072,0,5075,G
2-PB1,2043,5045,0,4,0,5049,A
2-PB1,2044,5075,0,2,0,5077,A
2-PB1,2045,1,5070,2,1,5074,T
2-PB1,2046,0,5083,1,4,5088,T
2-PB1,2047,16,2,0,5112,5130,C
2-PB1,2048,0,5052,0,6,5058,T
2-PB1,2049,0,5064,0,1,5065,T
2-PB1,2050,1,1,5050,0,5052,G
2-PB1,2051,5028,1,8,0,5037,A
2-PB1,2052,0,5,5074,0,5079,G
2-PB1,2053,1,6,5066,0,5073,G
2-PB1,2054,5047,0,2,0,5049,A
2-PB1,2055,0,5008,0,0,5008,T
2-PB1,2056,3,6,5047,0,5056,G
2-PB1,2057,5048,1,8,0,5057,A
2-PB1,2058,5055,0,8,0,5063,A
2-PB1,2059,1,1,0,5086,5088,C
2-PB1,2060,5010,0,8,0,5018,A
2-PB1,2061,0,4,5124,0,5128,G
2-PB1,2062,5077,0,8,1,5086,A
2-PB1,2063,0,5077,0,5,5082,T
2-PB1,2064,0,0,5112,0,5112,G
2-PB1,2065,0,5245,0,7,5252,T
2-PB1,2066,5286,1,5,0,5292,A
2-PB1,2067,3,8,0,5265,5276,C
2-PB1,2068,2,1,0,5236,5239,C
2-PB1,2069,5153,1,1,0,5155,A
2-PB1,2070,1,2,5106,0,5109,G
2-PB1,2071,5031,0,3,0,5034,A
2-PB1,2072,5008,0,3,0,5011,A
2-PB1,2073,2,0,5053,1,5056,G
2-PB1,2074,0,4710,1,4,4715,T
2-PB1,2075,0,1,4738,0,4739,G
2-PB1,2076,1,4,0,4737,4742,C
2-PB1,2077,2,4732,0,10,4744,T
2-PB1,2078,4,0,4739,0,4743,G
2-PB1,2079,1,1,0,4714,4716,C
2-PB1,2080,4708,1,1,0,4710,A
2-PB1,2081,4724,0,4,0,4728,A
2-PB1,2082,0,2,0,4661,4663,C
2-PB1,2083,0,4628,1,7,4636,T
2-PB1,2084,0,4582,0,1,4583,T
2-PB1,2085,1,0,4588,0,4589,G
2-PB1,2086,1,4569,0,5,4575,T
2-PB1,2087,0,4570,0,1,4571,T
2-PB1,2088,5,2,0,4561,4568,C
2-PB1,2089,0,0,4558,0,4558,G
2-PB1,2090,4536,0,2,0,4538,A
2-PB1,2091,3,0,4537,0,4540,G
2-PB1,2092,4546,0,2,0,4548,A
2-PB1,2093,4545,0,1,0,4546,A
2-PB1,2094,4555,0,3,0,4558,A
2-PB1,2095,0,4552,0,2,4554,T
2-PB1,2096,0,4563,0,0,4563,T
2-PB1,2097,0,4555,2,3,4560,T
2-PB1,2098,3,4569,0,1,4573,T
2-PB1,2099,1,4557,0,7,4565,T
2-PB1,2100,2,2,0,4606,4610,C
2-PB1,2101,6,0,0,4579,4585,C
2-PB1,2102,14,1,0,4587,4602,C
2-PB1,2103,0,4590,0,6,4596,T
2-PB1,2104,4601,0,2,0,4603,A
2-PB1,2105,0,2,4647,0,4649,G
2-PB1,2106,0,4639,0,4,4643,T
2-PB1,2107,4704,1,3,0,4708,A
2-PB1,2108,1,0,4749,0,4750,G
2-PB1,2109,0,4680,0,3,4683,T
2-PB1,2110,0,4890,0,10,4900,T
2-PB1,2111,8,1,0,4937,4946,C
2-PB1,2112,5091,0,11,0,5102,A
2-PB1,2113,0,5102,0,3,5105,T
2-PB1,2114,5109,0,4,0,5113,A
2-PB1,2115,0,5113,1,4,5118,T
2-PB1,2116,4941,2,6,0,4949,A
2-PB1,2117,0,4,4927,1,4932,G
2-PB1,2118,0,3,4882,0,4885,G
2-PB1,2119,4282,0,13,1,4296,A
2-PB1,2120,1,3,4301,0,4305,G
2-PB1,2121,4000,1,4,0,4005,A
2-PB1,2122,2,0,0,4001,4003,C
2-PB1,2123,3,1,0,3848,3852,C
2-PB1,2124,1,3,3857,0,3861,G
2-PB1,2125,3845,1,1,0,3847,A
2-PB1,2126,0,3834,0,0,3834,T
2-PB1,2127,0,3832,0,0,3832,T
2-PB1,2128,0,3,3828,0,3831,G
2-PB1,2129,0,0,3845,0,3845,G
2-PB1,2130,3835,0,2,1,3838,A
2-PB1,2131,3842,0,1,0,3843,A
2-PB1,2132,0,3834,0,2,3836,T
2-PB1,2133,0,3862,0,0,3862,T
2-PB1,2134,1,3857,1,3,3862,T
2-PB1,2135,2,1,0,3870,3873,C
2-PB1,2136,1,3871,1,4,3877,T
2-PB1,2137,3854,0,4,0,3858,A
2-PB1,2138,3,1,3872,0,3876,G
2-PB1,2139,0,1,0,3864,3865,C
2-PB1,2140,3872,0,0,0,3872,A
2-PB1,2141,1,3862,1,0,3864,T
2-PB1,2142,3,0,3774,0,3777,G
2-PB1,2143,6,1,3921,0,3928,G
2-PB1,2144,1,3910,0,3,3914,T
2-PB1,2145,0,5,3906,0,3911,G
2-PB1,2146,1,0,3895,0,3896,G
2-PB1,2147,3848,0,10,0,3858,A
2-PB1,2148,1,1,3880,0,3882,G
2-PB1,2149,0,1,3870,1,3872,G
2-PB1,2150,2,2,0,3845,3849,C
2-PB1,2151,2,0,0,3829,3831,C
2-PB1,2152,3568,0,8,0,3576,A
2-PB1,2153,0,3558,0,3,3561,T
2-PB1,2154,1,1,3593,0,3595,G
2-PB1,2155,1,0,3633,0,3634,G
2-PB1,2156,1,3532,0,6,3539,T
2-PB1,2157,4,1,3607,0,3612,G
2-PB1,2158,0,3543,0,4,3547,T
2-PB1,2159,6,0,0,3521,3527,C
2-PB1,2160,1,3529,0,5,3535,T
2-PB1,2161,3492,0,3,0,3495,A
2-PB1,2162,1,4,3492,0,3497,G
2-PB1,2163,0,2,3410,0,3412,G
2-PB1,2164,0,0,3378,0,3378,G
2-PB1,2165,1,3,0,3284,3288,C
2-PB1,2166,4,0,1,3138,3143,C
2-PB1,2167,7,7,0,3088,3102,C
2-PB1,2168,1,0,3093,0,3094,G
2-PB1,2169,0,0,3103,1,3104,G
2-PB1,2170,3095,3,2,0,3100,A
2-PB1,2171,0,3101,0,1,3102,T
2-PB1,2172,0,2993,0,1,2994,T
2-PB1,2173,0,2,2974,0,2976,G
2-PB1,2174,2973,0,2,0,2975,A
2-PB1,2175,0,2983,0,2,2985,T
2-PB1,2176,1,0,2989,0,2990,G
2-PB1,2177,1,0,0,2973,2974,C
2-PB1,2178,1,1,0,2958,2960,C
2-PB1,2179,2931,0,3,0,2934,A
2-PB1,2180,0,2,2940,0,2942,G
2-PB1,2181,2933,0,0,0,2933,A
2-PB1,2182,2936,0,3,0,2939,A
2-PB1,2183,0,2936,0,2,2938,T
2-PB1,2184,1,2864,0,0,2865,T
2-PB1,2185,1,4,2863,0,2868,G
2-PB1,2186,2851,0,1,0,2852,A
2-PB1,2187,4,5,0,2849,2858,C
2-PB1,2188,0,2832,0,4,2836,T
2-PB1,2189,0,2816,1,3,2820,T
2-PB1,2190,1,1,0,2808,2810,C
2-PB1,2191,5,0,2813,0,2818,G
2-PB1,2192,2798,0,2,0,2800,A
2-PB1,2193,0,0,2748,0,2748,G
2-PB1,2194,1,2773,0,6,2780,T
2-PB1,2195,2,1,0,2783,2786,C
2-PB1,2196,0,2791,0,0,2791,T
2-PB1,2197,0,1,2788,0,2789,G
2-PB1,2198,0,3,2787,0,2790,G
2-PB1,2199,2784,0,0,0,2784,A
2-PB1,2200,2579,0,5,0,2584,A
2-PB1,2201,0,3,2593,0,2596,G
2-PB1,2202,0,0,2658,0,2658,G
2-PB1,2203,2653,0,3,0,2656,A
2-PB1,2204,0,2625,0,3,2628,T
2-PB1,2205,0,2640,0,2,2642,T
2-PB1,2206,2627,0,3,0,2630,A
2-PB1,2207,2621,1,8,0,2630,A
2-PB1,2208,0,0,2638,0,2638,G
2-PB1,2209,2621,0,0,0,2621,A
2-PB1,2210,2488,0,0,0,2488,A
2-PB1,2211,2,1,2253,0,2256,G
2-PB1,2212,2,2,2250,0,2254,G
2-PB1,2213,2249,1,1,0,2251,A
2-PB1,2214,2249,0,4,0,2253,A
2-PB1,2215,0,6,2248,0,2254,G
2-PB1,2216,2170,1,1,0,2172,A
2-PB1,2217,0,0,2178,0,2178,G
2-PB1,2218,0,2099,0,0,2099,T
2-PB1,2219,1,2079,0,1,2081,T
2-PB1,2220,2,1,0,2105,2108,C
2-PB1,2221,0,2036,0,5,2041,T
2-PB1,2222,1,0,0,2055,2056,C
2-PB1,2223,0,2038,0,2,2040,T
2-PB1,2224,0,0,2043,0,2043,G
2-PB1,2225,1979,3,3,0,1985,A
2-PB1,2226,0,1,1974,0,1975,G
2-PB1,2227,1940,0,1,0,1941,A
2-PB1,2228,0,1918,0,1,1919,T
2-PB1,2229,2,0,0,1826,1828,C
2-PB1,2230,1816,1,2,0,1819,A
2-PB1,2231,0,1796,0,2,1798,T
2-PB1,2232,0,1,1794,0,1795,G
2-PB1,2233,1767,0,0,0,1767,A
2-PB1,2234,0,0,1674,1,1675,G
2-PB1,2235,0,1,1689,0,1690,G
2-PB1,2236,1692,0,0,0,1692,A
2-PB1,2237,0,1691,0,3,1694,T
2-PB1,2238,1,1,0,1673,1675,C
2-PB1,2239,0,1591,0,1,1592,T
2-PB1,2240,0,0,1605,0,1605,G
2-PB1,2241,0,1598,0,3,1601,T
2-PB1,2242,0,1588,0,4,1592,T
2-PB1,2243,2,0,0,1574,1576,C
2-PB1,2244,1,0,0,1503,1504,C
2-PB1,2245,1505,0,4,0,1509,A
2-PB1,2246,1,1,1,1505,1508,C
2-PB1,2247,2,2,0,1434,1438,C
2-PB1,2248,1397,0,1,0,1398,A
2-PB1,2249,0,1280,2,2,1284,T
2-PB1,2250,0,1232,0,5,1237,T
2-PB1,2251,1,1,1236,0,1238,G
2-PB1,2252,1224,1,1,0,1226,A
2-PB1,2253,1216,0,4,0,1220,A
2-PB1,2254,1,0,1219,0,1220,G
2-PB1,2255,1025,0,1,0,1026,A
2-PB1,2256,1024,0,2,0,1026,A
2-PB1,2257,0,0,0,1015,1015,C
2-PB1,2258,0,974,0,1,975,T
2-PB1,2259,1,0,0,976,977,C
2-PB1,2260,930,0,1,0,931,A
2-PB1,2261,0,0,930,0,930,G
2-PB1,2262,925,0,1,0,926,A
2-PB1,2263,0,1,0,879,880,C
2-PB1,2264,0,2,864,0,866,G
2-PB1,2265,2,1,835,0,838,G
2-PB1,2266,0,1,0,833,834,C
2-PB1,2267,837,0,0,0,837,A
2-PB1,2268,829,1,3,0,833,A
2-PB1,2269,828,0,0,0,828,A
2-PB1,2270,821,0,1,0,822,A
2-PB1,2271,823,0,0,0,823,A
2-PB1,2272,0,809,0,0,809,T
2-PB1,2273,772,0,0,0,772,A
2-PB1,2274,773,0,0,0,773,A
3-PA,1,305,0,0,0,305,A
3-PA,2,0,307,0,0,307,T
3-PA,3,0,0,342,0,342,G
3-PA,4,0,0,348,0,348,G
3-PA,5,344,0,1,0,345,A
3-PA,6,342,0,3,0,345,A
3-PA,7,0,0,356,0,356,G
3-PA,8,379,0,1,0,380,A
3-PA,9,0,383,0,0,383,T
3-PA,10,0,382,1,0,383,T
3-PA,11,0,396,0,0,396,T
3-PA,12,0,396,0,0,396,T
3-PA,13,0,0,404,1,405,G
3-PA,14,0,406,0,0,406,T
3-PA,15,0,1,400,0,401,G
3-PA,16,0,0,0,415,415,C
3-PA,17,1,1,413,0,415,G
3-PA,18,453,0,2,0,455,A
3-PA,19,0,0,0,461,461,C
3-PA,20,462,0,0,0,462,A
3-PA,21,464,0,0,0,464,A
3-PA,22,0,478,0,0,478,T
3-PA,23,0,0,568,0,568,G
3-PA,24,0,1,0,586,587,C
3-PA,25,0,589,0,1,590,T
3-PA,26,0,588,0,2,590,T
3-PA,27,1,0,0,589,590,C
3-PA,28,599,0,1,0,600,A
3-PA,29,633,0,0,0,633,A
3-PA,30,0,0,0,645,645,C
3-PA,31,0,0,1,644,645,C
3-PA,32,0,0,0,644,644,C
3-PA,33,0,0,644,0,644,G
3-PA,34,644,0,2,0,646,A
3-PA,35,0,650,0,0,650,T
3-PA,36,0,0,656,0,656,G
3-PA,37,661,0,0,0,661,A
3-PA,38,0,673,0,0,673,T
3-PA,39,0,675,0,0,675,T
3-PA,40,0,0,682,0,682,G
3-PA,41,0,677,1,3,681,T
3-PA,42,0,1,0,680,681,C
3-PA,43,2,1,675,0,678,G
3-PA,44,681,0,0,0,681,A
3-PA,45,685,1,0,0,686,A
3-PA,46,0,0,0,688,688,C
3-PA,47,0,686,0,0,686,T
3-PA,48,0,691,0,0,691,T
3-PA,49,0,0,691,0,691,G
3-PA,50,0,1,0,689,690,C
3-PA,51,695,0,2,0,697,A
3-PA,52,0,0,707,0,707,G
3-PA,53,699,1,0,1,701,A
3-PA,54,704,0,1,0,705,A
3-PA,55,704,0,0,0,704,A
3-PA,56,709,0,1,0,710,A
3-PA,57,717,0,0,0,717,A
3-PA,58,0,0,723,0,723,G
3-PA,59,0,0,0,761,761,C
3-PA,60,764,0,1,0,765,A
3-PA,61,821,0,0,0,821,A
3-PA,62,0,826,0,0,826,T
3-PA,63,0,0,845,0,845,G
3-PA,64,859,0,0,1,860,A
3-PA,65,856,0,1,1,858,A
3-PA,66,863,0,3,0,866,A
3-PA,67,0,0,927,0,927,G
3-PA,68,967,0,0,0,967,A
3-PA,69,0,0,1161,0,1161,G
3-PA,70,0,1159,0,2,1161,T
3-PA,71,1167,0,1,0,1168,A
3-PA,72,1,1163,0,3,1167,T
3-PA,73,0,3,1161,0,1164,G
3-PA,74,2,6,1165,0,1173,G
3-PA,75,0,2,1161,0,1163,G
3-PA,76,0,0,1170,0,1170,G
3-PA,77,1143,0,2,0,1145,A
3-PA,78,2,0,1122,0,1124,G
3-PA,79,0,0,1140,0,1140,G
3-PA,80,1138,0,0,0,1138,A
3-PA,81,0,1150,0,0,1150,T
3-PA,82,0,0,0,1158,1158,C
3-PA,83,0,1155,0,0,1155,T
3-PA,84,0,0,1155,0,1155,G
3-PA,85,1154,0,1,0,1155,A
3-PA,86,1153,0,0,0,1153,A
3-PA,87,1160,0,0,0,1160,A
3-PA,88,1163,0,0,0,1163,A
3-PA,89,0,1161,0,0,1161,T
3-PA,90,1,1160,0,0,1161,T
3-PA,91,1,1,1157,0,1159,G
3-PA,92,1159,0,0,0,1159,A
3-PA,93,1157,0,2,0,1159,A
3-PA,94,1159,0,0,0,1159,A
3-PA,95,1,0,0,1161,1162,C
3-PA,96,0,0,1,1153,1154,C
3-PA,97,1184,0,0,0,1184,A
3-PA,98,1190,0,1,0,1191,A
3-PA,99,0,0,1,1197,1198,C
3-PA,100,1194,0,0,0,1194,A
3-PA,101,1202,0,0,0,1202,A
3-PA,102,1205,0,0,0,1205,A
3-PA,103,0,1212,0,1,1213,T
3-PA,104,0,1217,0,1,1218,T
3-PA,105,0,1215,0,1,1216,T
3-PA,106,0,0,1213,0,1213,G
3-PA,107,0,1,0,1221,1222,C
3-PA,108,1223,0,0,0,1223,A
3-PA,109,0,0,1277,0,1277,G
3-PA,110,0,0,0,1284,1284,C
3-PA,111,1350,1,0,0,1351,A
3-PA,112,1364,0,0,0,1364,A
3-PA,113,0,1380,0,1,1381,T
3-PA,114,1408,0,1,0,1409,A
3-PA,115,0,1411,0,2,1413,T
3-PA,116,0,0,1422,0,1422,G
3-PA,117,0,2,0,1422,1424,C
3-PA,118,1405,0,2,0,1407,A
3-PA,119,2,0,0,1430,1432,C
3-PA,120,0,1402,0,7,1409,T
3-PA,121,1,1,0,1768,1770,C
3-PA,122,1818,0,0,0,1818,A
3-PA,123,0,0,0,1879,1879,C
3-PA,124,0,1864,0,2,1866,T
3-PA,125,1,1862,0,0,1863,T
3-PA,126,2,1,1860,0,1863,G
3-PA,127,1,1,1883,0,1885,G
3-PA,128,1855,2,5,1,1863,A
3-PA,129,1,4,1911,0,1916,G
3-PA,130,1,0,1896,0,1897,G
3-PA,131,0,1807,0,3,1810,T
3-PA,132,0,0,1865,0,1865,G
3-PA,133,1,1863,0,1,1865,T
3-PA,134,0,0,1923,0,1923,G
3-PA,135,0,1919,2,6,1927,T
3-PA,136,0,1918,0,0,1918,T
3-PA,137,1,1909,1,2,1913,T
3-PA,138,2,1,0,1937,1940,C
3-PA,139,1934,0,3,0,1937,A
3-PA,140,0,1942,0,1,1943,T
3-PA,141,1,2,1990,0,1993,G
3-PA,142,1,1961,0,0,1962,T
3-PA,143,1978,0,1,0,1979,A
3-PA,144,0,1976,2,0,1978,T
3-PA,145,0,1977,0,0,1977,T
3-PA,146,1,1,0,1984,1986,C
3-PA,147,1973,0,2,0,1975,A
3-PA,148,0,0,2000,0,2000,G
3-PA,149,1994,0,0,0,1994,A
3-PA,150,0,1981,0,0,1981,T
3-PA,151,0,1978,0,1,1979,T
3-PA,152,0,1969,0,1,1970,T
3-PA,153,1,0,0,1973,1974,C
3-PA,154,1,1,0,2012,2014,C
3-PA,155,2014,0,1,0,2015,A
3-PA,156,0,2019,0,1,2020,T
3-PA,157,0,2003,0,2,2005,T
3-PA,158,1,2007,0,1,2009,T
3-PA,159,2,0,0,2005,2007,C
3-PA,160,2013,0,5,0,2018,A
3-PA,161,1,2086,0,3,2090,T
3-PA,162,0,0,0,2101,2101,C
3-PA,163,2097,0,3,0,2100,A
3-PA,164,2102,0,0,0,2102,A
3-PA,165,1,2108,0,1,2110,T
3-PA,166,0,7,2181,0,2188,G
3-PA,167,2188,0,3,0,2191,A
3-PA,168,2183,0,4,0,2187,A
3-PA,169,0,3,0,2185,2188,C
3-PA,170,2160,0,1,0,2161,A
3-PA,171,2166,0,3,0,2169,A
3-PA,172,0,2,2186,0,2188,G
3-PA,173,0,4,2172,0,2176,G
3-PA,174,0,0,0,2182,2182,C
3-PA,175,1,7,2170,0,2178,G
3-PA,176,2319,1,2,0,2322,A
3-PA,177,2323,0,3,1,2327,A
3-PA,178,0,2334,0,1,2335,T
3-PA,179,2,0,0,2384,2386,C
3-PA,180,2375,0,3,0,2378,A
3-PA,181,2380,1,2,0,2383,A
3-PA,182,0,2392,0,1,2393,T
3-PA,183,2385,0,2,1,2388,A
3-PA,184,5,0,2444,0,2449,G
3-PA,185,0,2434,0,1,2435,T
3-PA,186,1,2,2447,0,2450,G
3-PA,187,1,0,2460,0,2461,G
3-PA,188,0,2441,0,2,2443,T
3-PA,189,2444,0,1,0,2445,A
3-PA,190,1,3,2472,0,2476,G
3-PA,191,2469,0,1,0,2470,A
3-PA,192,2476,0,2,1,2479,A
3-PA,193,0,1,0,2474,2475,C
3-PA,194,0,2433,0,3,2436,T
3-PA,195,0,2429,0,1,2430,T
3-PA,196,0,1,2426,0,2427,G
3-PA,197,2419,1,3,0,2423,A
3-PA,198,0,2,0,2429,2431,C
3-PA,199,3,3,2400,0,2406,G
3-PA,200,2473,0,1,0,2474,A
3-PA,201,0,2505,0,2,2507,T
3-PA,202,1,1,0,2540,2542,C
3-PA,203,2,0,0,2567,2569,C
3-PA,204,2575,1,0,1,2577,A
3-PA,205,2577,0,0,0,2577,A
3-PA,206,2576,0,4,0,2580,A
3-PA,207,0,2582,0,1,2583,T
3-PA,208,2,0,2586,1,2589,G
3-PA,209,0,0,0,2559,2559,C
3-PA,210,2544,0,1,0,2545,A
3-PA,211,0,2,0,2642,2644,C
3-PA,212,0,2604,0,4,2608,T
3-PA,213,1,1,3044,1,3047,G
3-PA,214,0,3034,0,9,3043,T
3-PA,215,0,3039,0,3,3042,T
3-PA,216,3045,1,1,0,3047,A
3-PA,217,3032,0,3,1,3036,A
3-PA,218,3033,0,6,0,3039,A
3-PA,219,4,0,3055,0,3059,G
3-PA,220,1,0,0,3000,3001,C
3-PA,221,2968,0,1,0,2969,A
3-PA,222,0,3,0,2964,2967,C
3-PA,223,2751,0,3,1,2755,A
3-PA,224,0,2,2907,0,2909,G
3-PA,225,2896,0,0,0,2896,A
3-PA,226,0,2903,0,0,2903,T
3-PA,227,0,2896,0,1,2897,T
3-PA,228,0,2895,0,2,2897,T
3-PA,229,0,2,2909,0,2911,G
3-PA,230,2917,0,5,0,2922,A
3-PA,231,2924,1,3,0,2928,A
3-PA,232,2926,0,3,0,2929,A
3-PA,233,0,2829,0,2,2831,T
3-PA,234,2824,0,0,0,2824,A
3-PA,235,2867,0,1,0,2868,A
3-PA,236,1,2857,0,1,2859,T
3-PA,237,0,1,0,2875,2876,C
3-PA,238,0,2,2872,1,2875,G
3-PA,239,2849,0,4,0,2853,A
3-PA,240,2,4,2873,0,2879,G
3-PA,241,1,2,2914,0,2917,G
3-PA,242,0,0,2910,0,2910,G
3-PA,243,1,1,2913,0,2915,G
3-PA,244,2862,1,7,0,2870,A
3-PA,245,0,3,2895,1,2899,G
3-PA,246,2953,0,8,0,2961,A
3-PA,247,2,3,2985,1,2991,G
3-PA,248,2991,0,5,0,2996,A
3-PA,249,0,1,0,2993,2994,C
3-PA,250,2949,1,6,0,2956,A
3-PA,251,1,4,3008,1,3014,G
3-PA,252,3012,0,2,0,3014,A
3-PA,253,3075,0,1,0,3076,A
3-PA,254,1,0,0,3074,3075,C
3-PA,255,2965,2,1,0,2968,A
3-PA,256,2966,0,3,0,2969,A
3-PA,257,0,2955,0,3,2958,T
3-PA,258,1,3,3067,0,3071,G
3-PA,259,2,2,3073,0,3077,G
3-PA,260,0,1,0,3041,3042,C
3-PA,261,0,0,0,3052,3052,C
3-PA,262,0,3010,0,7,3017,T
3-PA,263,1,1,3123,0,3125,G
3-PA,264,0,2,3121,0,3123,G
3-PA,265,3121,0,5,0,3126,A
3-PA,266,0,2,1,3135,3138,C
3-PA,267,3014,1,3,0,3018,A
3-PA,268,0,0,3452,0,3452,G
3-PA,269,0,3446,0,0,3446,T
3-PA,270,3500,0,2,0,3502,A
3-PA,271,6,0,3501,0,3507,G
3-PA,272,0,3414,0,2,3416,T
3-PA,273,3428,0,1,1,3430,A
3-PA,274,3437,0,0,0,3437,A
3-PA,275,3419,1,3,0,3423,A
3-PA,276,1,0,0,3470,3471,C
3-PA,277,3138,2,0,0,3140,A
3-PA,278,3,1,3222,0,3226,G
3-PA,279,1,3181,0,4,3186,T
3-PA,280,3220,0,5,1,3226,A
3-PA,281,2,3208,0,3,3213,T
3-PA,282,1,0,0,3251,3252,C
3-PA,283,0,3240,0,6,3246,T
3-PA,284,2,1,3239,0,3242,G
3-PA,285,0,8,0,3238,3246,C
3-PA,286,3216,0,2,0,3218,A
3-PA,287,3182,1,7,1,3191,A
3-PA,288,0,1,0,3207,3208,C
3-PA,289,3190,0,4,0,3194,A
3-PA,290,0,2,0,3330,3332,C
3-PA,291,0,3272,0,0,3272,T
3-PA,292,3296,1,2,0,3299,A
3-PA,293,0,3,0,3290,3293,C
3-PA,294,1,3266,0,3,3270,T
3-PA,295,1,7,3258,0,3266,G
3-PA,296,1,2,3253,0,3256,G
3-PA,297,3213,1,3,1,3218,A
3-PA,298,0,1,3226,0,3227,G
3-PA,299,0,1,1,3127,3129,C
3-PA,300,0,3126,0,3,3129,T
3-PA,301,3,5,3115,2,3125,G
3-PA,302,0,5,3116,0,3121,G
3-PA,303,3107,2,1,0,3110,A
3-PA,304,3120,0,1,0,3121,A
3-PA,305,3104,0,4,0,3108,A
3-PA,306,3115,0,0,0,3115,A
3-PA,307,0,0,0,3115,3115,C
3-PA,308,3,2,0,3108,3113,C
3-PA,309,1,0,3119,1,3121,G
3-PA,310,3109,0,0,0,3109,A
3-PA,311,3098,0,2,0,3100,A
3-PA,312,0,0,3144,0,3144,G
3-PA,313,0,3129,1,0,3130,T
3-PA,314,0,3139,0,4,3143,T
3-PA,315,0,3132,1,3,3136,T
3-PA,316,1,1,0,3153,3155,C
3-PA,317,0,3164,0,1,3165,T
3-PA,318,3168,1,3,0,3172,A
3-PA,319,2,0,0,3161,3163,C
3-PA,320,4,0,0,3164,3168,C
3-PA,321,3138,0,3,0,3141,A
3-PA,322,1,3,3191,0,3195,G
3-PA,323,3190,0,4,0,3194,A
3-PA,324,0,3199,1,0,3200,T
3-PA,325,0,3189,0,2,3191,T
3-PA,326,0,3189,0,1,3190,T
3-PA,327,0,2,3239,0,3241,G
3-PA,328,0,3228,0,0,3228,T
3-PA,329,3227,1,2,0,3230,A
3-PA,330,0,3232,0,1,3233,T
3-PA,331,0,4,3184,0,3188,G
3-PA,332,3323,0,2,0,3325,A
3-PA,333,0,3307,0,3,3310,T
3-PA,334,1,3318,0,0,3319,T
3-PA,335,3329,2,1,0,3332,A
3-PA,336,1,0,0,3335,3336,C
3-PA,337,3322,1,2,1,3326,A
3-PA,338,3314,0,6,0,3320,A
3-PA,339,0,2,3332,0,3334,G
3-PA,340,0,1,3368,0,3369,G
3-PA,341,3183,0,1,0,3184,A
3-PA,342,0,1,3227,0,3228,G
3-PA,343,3212,1,13,0,3226,A
3-PA,344,3224,1,4,0,3229,A
3-PA,345,0,0,0,3237,3237,C
3-PA,346,3171,0,1,1,3173,A
3-PA,347,1,1,3179,0,3181,G
3-PA,348,3152,0,1,0,3153,A
3-PA,349,0,3103,0,3,3106,T
3-PA,350,0,3097,0,3,3100,T
3-PA,351,4,5,0,3069,3078,C
3-PA,352,3076,0,3,0,3079,A
3-PA,353,0,3057,0,2,3059,T
3-PA,354,2,3,0,3063,3068,C
3-PA,355,3,1,3066,0,3070,G
3-PA,356,3101,0,1,0,3102,A
3-PA,357,3096,0,0,1,3097,A
3-PA,358,3099,0,3,0,3102,A
3-PA,359,0,3100,0,4,3104,T
3-PA,360,0,3091,0,1,3092,T
3-PA,361,1,3,3092,0,3096,G
3-PA,362,0,4,3079,0,3083,G
3-PA,363,3021,1,6,0,3028,A
3-PA,364,3,1,3058,0,3062,G
3-PA,365,1,3062,0,2,3065,T
3-PA,366,1,1,3115,0,3117,G
3-PA,367,3118,0,5,0,3123,A
3-PA,368,1,0,0,3133,3134,C
3-PA,369,3144,0,0,0,3144,A
3-PA,370,3132,1,0,0,3133,A
3-PA,371,1,2,3204,0,3207,G
3-PA,372,2,1,3205,0,3208,G
3-PA,373,3157,1,6,0,3164,A
3-PA,374,0,3,3172,0,3175,G
3-PA,375,3075,2,8,0,3085,A
3-PA,376,0,0,3102,0,3102,G
3-PA,377,3042,1,11,1,3055,A
3-PA,378,3068,0,3,0,3071,A
3-PA,379,0,1,3182,0,3183,G
3-PA,380,1,3083,1,1,3086,T
3-PA,381,7,0,0,3123,3130,C
3-PA,382,4,0,0,3126,3130,C
3-PA,383,3139,0,2,0,3141,A
3-PA,384,0,1,0,3234,3235,C
3-PA,385,3326,0,1,0,3327,A
3-PA,386,0,3430,0,2,3432,T
3-PA,387,3470,0,0,0,3470,A
3-PA,388,0,3349,0,1,3350,T
3-PA,389,3313,0,1,0,3314,A
3-PA,390,0,3260,0,5,3265,T
3-PA,391,0,3237,0,2,3239,T
3-PA,392,3345,0,0,0,3345,A
3-PA,393,0,0,0,3318,3318,C
3-PA,394,3,0,0,3147,3150,C
3-PA,395,0,3083,1,5,3089,T
3-PA,396,0,3010,0,4,3014,T
3-PA,397,2,2,3034,0,3038,G
3-PA,398,3047,0,1,0,3048,A
3-PA,399,3048,0,1,0,3049,A
3-PA,400,3040,0,2,0,3042,A
3-PA,401,2908,1,5,0,2914,A
3-PA,402,1,0,2937,0,2938,G
3-PA,403,0,0,2942,0,2942,G
3-PA,404,1,1,0,2956,2958,C
3-PA,405,3,1,0,2957,2961,C
3-PA,406,2943,0,1,1,2945,A
3-PA,407,2946,0,3,0,2949,A
3-PA,408,0,2947,0,1,2948,T
3-PA,409,2953,0,1,0,2954,A
3-PA,410,2952,0,2,0,2954,A
3-PA,411,1,0,3009,1,3011,G
3-PA,412,2985,0,5,0,2990,A
3-PA,413,0,2981,0,0,2981,T
3-PA,414,1,2976,1,1,2979,T
3-PA,415,2978,0,0,1,2979,A
3-PA,416,2991,0,2,0,2993,A
3-PA,417,2988,0,0,0,2988,A
3-PA,418,0,3020,0,1,3021,T
3-PA,419,2,0,0,3025,3027,C
3-PA,420,0,2933,0,4,2937,T
3-PA,421,1,2,2966,0,2969,G
3-PA,422,2977,0,1,0,2978,A
3-PA,423,0,4,2999,0,3003,G
3-PA,424,3001,0,4,0,3005,A
3-PA,425,3023,0,1,0,3024,A
3-PA,426,0,0,0,3032,3032,C
3-PA,427,2999,0,6,0,3005,A
3-PA,428,1,1,0,3031,3033,C
3-PA,429,3024,0,3,0,3027,A
3-PA,430,1,1,0,3066,3068,C
3-PA,431,3038,0,6,0,3044,A
3-PA,432,0,3,0,3136,3139,C
3-PA,433,3100,0,0,1,3101,A
3-PA,434,0,3101,0,0,3101,T
3-PA,435,2,3063,1,5,3071,T
3-PA,436,5,0,0,3087,3092,C
3-PA,437,3061,2,3,0,3066,A
3-PA,438,2,0,0,3099,3101,C
3-PA,439,3054,0,0,0,3054,A
3-PA,440,0,3053,0,2,3055,T
3-PA,441,0,2947,0,3,2950,T
3-PA,442,1,2985,0,1,2987,T
3-PA,443,0,2970,0,4,2974,T
3-PA,444,2,2,0,3035,3039,C
3-PA,445,2,2999,0,4,3005,T
3-PA,446,4,1,0,3027,3032,C
3-PA,447,3007,0,2,0,3009,A
3-PA,448,1,3005,1,6,3013,T
3-PA,449,0,3027,0,1,3028,T
3-PA,450,1,0,0,3047,3048,C
3-PA,451,3014,0,1,0,3015,A
3-PA,452,0,1,1,3043,3045,C
3-PA,453,1,2994,0,1,2996,T
3-PA,454,1,4,3070,0,3075,G
3-PA,455,3,5,3066,0,3074,G
3-PA,456,1,2,3082,0,3085,G
3-PA,457,1,2,3092,0,3095,G
3-PA,458,3049,0,6,0,3055,A
3-PA,459,1,1,3090,0,3092,G
3-PA,460,4,0,3098,0,3102,G
3-PA,461,3069,0,4,0,3073,A
3-PA,462,3084,0,5,0,3089,A
3-PA,463,3037,0,2,1,3040,A
3-PA,464,0,2981,0,1,2982,T
3-PA,465,2,2,2982,0,2986,G
3-PA,466,1,1,2985,0,2987,G
3-PA,467,1,2,0,2987,2990,C
3-PA,468,1,1,0,2977,2979,C
3-PA,469,2981,1,1,0,2983,A
3-PA,470,0,0,0,2993,2993,C
3-PA,471,2987,0,1,0,2988,A
3-PA,472,3002,1,0,1,3004,A
3-PA,473,3003,0,2,0,3005,A
3-PA,474,0,3,3015,0,3018,G
3-PA,475,1,0,3012,0,3013,G
3-PA,476,0,2,0,3005,3007,C
3-PA,477,3014,1,2,0,3017,A
3-PA,478,1,0,3060,0,3061,G
3-PA,479,3050,0,4,0,3054,A
3-PA,480,1,0,0,3091,3092,C
3-PA,481,0,3066,0,3,3069,T
3-PA,482,3079,1,3,0,3083,A
3-PA,483,1,2,0,3059,3062,C
3-PA,484,3021,2,4,0,3027,A
3-PA,485,0,1,0,3039,3040,C
3-PA,486,0,2921,0,3,2924,T
3-PA,487,0,1,0,2963,2964,C
3-PA,488,0,2913,0,4,2917,T
3-PA,489,6,1,0,2871,2878,C
3-PA,490,1,3,2873,0,2877,G
3-PA,491,2865,0,1,0,2866,A
3-PA,492,0,0,0,2874,2874,C
3-PA,493,2,4,2872,0,2878,G
3-PA,494,2861,0,3,0,2864,A
3-PA,495,0,1,2875,1,2877,G
3-PA,496,1,3,2858,1,2863,G
3-PA,497,2844,0,2,0,2846,A
3-PA,498,2857,0,2,0,2859,A
3-PA,499,2852,0,4,0,2856,A
3-PA,500,1,0,2850,0,2851,G
3-PA,501,3,2,0,2845,2850,C
3-PA,502,2761,1,1,0,2763,A
3-PA,503,0,1,2802,0,2803,G
3-PA,504,3,3,2792,1,2799,G
3-PA,505,1,0,2807,0,2808,G
3-PA,506,0,0,0,2792,2792,C
3-PA,507,0,2773,0,1,2774,T
3-PA,508,2779,0,3,0,2782,A
3-PA,509,0,3,2863,0,2866,G
3-PA,510,2,0,3056,0,3058,G
3-PA,511,3074,0,1,1,3076,A
3-PA,512,0,2976,0,3,2979,T
3-PA,513,1,2922,0,2,2925,T
3-PA,514,2950,1,1,0,2952,A
3-PA,515,2957,0,3,0,2960,A
3-PA,516,2,3,2978,0,2983,G
3-PA,517,2956,0,8,0,2964,A
3-PA,518,1,0,0,2955,2956,C
3-PA,519,5,1,0,2696,2702,C
3-PA,520,2665,0,5,0,2670,A
3-PA,521,0,1,2692,1,2694,G
3-PA,522,0,0,2701,0,2701,G
3-PA,523,0,1,0,2719,2720,C
3-PA,524,0,2636,0,1,2637,T
3-PA,525,1,0,2729,0,2730,G
3-PA,526,0,2705,0,3,2708,T
3-PA,527,0,2701,0,1,2702,T
3-PA,528,0,2713,0,1,2714,T
3-PA,529,2708,0,2,0,2710,A
3-PA,530,0,0,0,2779,2779,C
3-PA,531,0,0,0,2711,2711,C
3-PA,532,2689,0,1,0,2690,A
3-PA,533,0,2688,0,2,2690,T
3-PA,534,2564,0,0,0,2564,A
3-PA,535,2567,1,3,1,2572,A
3-PA,536,0,2,2608,0,2610,G
3-PA,537,2606,1,0,0,2607,A
3-PA,538,1,1,0,2601,2603,C
3-PA,539,2510,0,0,0,2510,A
3-PA,540,2503,0,6,0,2509,A
3-PA,541,0,1,2531,0,2532,G
3-PA,542,2520,0,2,0,2522,A
3-PA,543,2529,0,0,0,2529,A
3-PA,544,2507,0,3,2,2512,A
3-PA,545,0,2450,0,3,2453,T
3-PA,546,1,4,2477,0,2482,G
3-PA,547,3,0,2484,0,2487,G
3-PA,548,2,2,0,2471,2475,C
3-PA,549,1,1,0,2480,2482,C
3-PA,550,2462,0,1,0,2463,A
3-PA,551,2513,0,1,0,2514,A
3-PA,552,0,0,0,2516,2516,C
3-PA,553,2507,0,2,0,2509,A
3-PA,554,1,0,2512,0,2513,G
3-PA,555,2443,1,2,0,2446,A
3-PA,556,1,0,2452,0,2453,G
3-PA,557,0,0,2464,0,2464,G
3-PA,558,1,0,0,2462,2463,C
3-PA,559,1,0,0,2471,2472,C
3-PA,560,0,2406,0,2,2408,T
3-PA,561,2,0,0,2427,2429,C
3-PA,562,0,2424,0,4,2428,T
3-PA,563,3,3,2430,0,2436,G
3-PA,564,0,2,2419,0,2421,G
3-PA,565,3,0,2368,0,2371,G
3-PA,566,2317,1,0,0,2318,A
3-PA,567,0,2201,0,3,2204,T
3-PA,568,0,2134,0,0,2134,T
3-PA,569,4,0,0,2379,2383,C
3-PA,570,0,0,0,2270,2270,C
3-PA,571,0,2188,0,1,2189,T
3-PA,572,1,2167,0,4,2172,T
3-PA,573,1,2172,0,0,2173,T
3-PA,574,2,0,0,2187,2189,C
3-PA,575,1,0,2197,0,2198,G
3-PA,576,0,2186,0,2,2188,T
3-PA,577,0,1,0,2190,2191,C
3-PA,578,2090,0,0,0,2090,A
3-PA,579,1,0,2411,0,2412,G
3-PA,580,0,2402,0,2,2404,T
3-PA,581,4,1,0,2401,2406,C
3-PA,582,2,4,0,2416,2422,C
3-PA,583,5,6,2426,0,2437,G
3-PA,584,2442,0,3,0,2445,A
3-PA,585,2445,0,0,1,2446,A
3-PA,586,2445,0,5,0,2450,A
3-PA,587,3,1,2471,0,2475,G
3-PA,588,2353,0,3,1,2357,A
3-PA,589,2,2,2398,1,2403,G
3-PA,590,1,1,2409,1,2412,G
3-PA,591,0,2,0,2413,2415,C
3-PA,592,3,1,2418,0,2422,G
3-PA,593,2420,0,1,0,2421,A
3-PA,594,2421,1,6,0,2428,A
3-PA,595,0,3,2457,0,2460,G
3-PA,596,2475,0,3,0,2478,A
3-PA,597,2473,0,0,0,2473,A
3-PA,598,2452,0,3,0,2455,A
3-PA,599,0,2,1,2476,2479,C
3-PA,600,2473,0,0,1,2474,A
3-PA,601,2479,0,0,0,2479,A
3-PA,602,0,2469,0,0,2469,T
3-PA,603,0,2469,0,0,2469,T
3-PA,604,1,3,2469,0,2473,G
3-PA,605,2457,0,2,0,2459,A
3-PA,606,2457,1,3,0,2461,A
3-PA,607,1,2,2463,0,2466,G
3-PA,608,2438,0,3,0,2441,A
3-PA,609,2447,0,0,0,2447,A
3-PA,610,2446,1,1,0,2448,A
3-PA,611,2454,0,2,0,2456,A
3-PA,612,2465,0,1,1,2467,A
3-PA,613,0,2467,0,1,2468,T
3-PA,614,1,2472,0,1,2474,T
3-PA,615,0,2480,0,0,2480,T
3-PA,616,1,3,2481,0,2485,G
3-PA,617,2475,1,1,0,2477,A
3-PA,618,2471,1,2,0,2474,A
3-PA,619,2497,0,1,0,2498,A
3-PA,620,1,2536,0,2,2539,T
3-PA,621,0,0,1,2850,2851,C
3-PA,622,2840,2,4,1,2847,A
3-PA,623,1,0,0,2917,2918,C
3-PA,624,2895,0,6,1,2902,A
3-PA,625,3,5,2993,0,3001,G
3-PA,626,2,6,3115,0,3123,G
3-PA,627,3179,0,6,1,3186,A
3-PA,628,3220,2,4,4,3230,A
3-PA,629,0,1,0,3260,3261,C
3-PA,630,0,3106,0,3,3109,T
3-PA,631,3378,0,1,0,3379,A
3-PA,632,0,3422,0,0,3422,T
3-PA,633,0,1,3561,0,3562,G
3-PA,634,1,0,0,3532,3533,C
3-PA,635,3,1,3486,1,3491,G
3-PA,636,0,3476,1,7,3484,T
3-PA,637,3460,0,2,0,3462,A
3-PA,638,2,3,3472,1,3478,G
3-PA,639,2,0,3470,0,3472,G
3-PA,640,0,0,0,3414,3414,C
3-PA,641,0,3357,0,3,3360,T
3-PA,642,0,3309,0,1,3310,T
3-PA,643,0,1,3299,0,3300,G
3-PA,644,2,4,0,3294,3300,C
3-PA,645,2,2,0,3301,3305,C
3-PA,646,0,4,3359,0,3363,G
3-PA,647,3378,0,6,1,3385,A
3-PA,648,0,0,1,3392,3393,C
3-PA,649,4,0,0,3401,3405,C
3-PA,650,3416,0,0,0,3416,A
3-PA,651,3411,0,1,0,3412,A
3-PA,652,3411,0,9,1,3421,A
3-PA,653,3,2,3486,0,3491,G
3-PA,654,0,3483,0,3,3486,T
3-PA,655,5,1,0,3478,3484,C
3-PA,656,0,3443,0,15,3458,T
3-PA,657,4,2,0,3485,3491,C
3-PA,658,2,2,0,3494,3498,C
3-PA,659,7,2,0,3508,3517,C
3-PA,660,3523,1,2,1,3527,A
3-PA,661,1,0,1,3545,3547,C
3-PA,662,4,1,0,3502,3507,C
3-PA,663,1,4,3528,1,3534,G
3-PA,664,3562,0,0,0,3562,A
3-PA,665,3571,0,2,0,3573,A
3-PA,666,0,1,0,3620,3621,C
3-PA,667,0,3576,0,10,3586,T
3-PA,668,0,3635,0,11,3646,T
3-PA,669,2,0,0,3722,3724,C
3-PA,670,0,3685,0,7,3692,T
3-PA,671,4,1,0,3714,3719,C
3-PA,672,3,1,0,3708,3712,C
3-PA,673,0,3654,0,5,3659,T
3-PA,674,1,1,3735,0,3737,G
3-PA,675,0,3,0,3727,3730,C
3-PA,676,1,1,0,3740,3742,C
3-PA,677,0,3721,0,3,3724,T
3-PA,678,0,3688,0,3,3691,T
3-PA,679,1,2,3696,0,3699,G
3-PA,680,3684,0,5,1,3690,A
3-PA,681,0,2,3740,1,3743,G
3-PA,682,3733,1,3,0,3737,A
3-PA,683,3769,1,1,0,3771,A
3-PA,684,1,3866,1,2,3870,T
3-PA,685,0,3878,0,1,3879,T
3-PA,686,0,3879,2,1,3882,T
3-PA,687,1,3885,0,2,3888,T
3-PA,688,3881,0,2,0,3883,A
3-PA,689,4,2,3885,0,3891,G
3-PA,690,3810,1,8,1,3820,A
3-PA,691,3,0,4000,0,4003,G
3-PA,692,3,1,0,3962,3966,C
3-PA,693,0,1,0,3985,3986,C
3-PA,694,2,4017,0,2,4021,T
3-PA,695,4212,3,1,0,4216,A
3-PA,696,0,4207,0,6,4213,T
3-PA,697,0,2,4254,0,4256,G
3-PA,698,1,4256,0,5,4262,T
3-PA,699,5,3,4266,0,4274,G
3-PA,700,0,4,4187,1,4192,G
3-PA,701,4145,0,6,0,4151,A
3-PA,702,0,4113,0,4,4117,T
3-PA,703,2,5,4033,0,4040,G
3-PA,704,2,3,4170,0,4175,G
3-PA,705,4168,1,0,0,4169,A
3-PA,706,3,4153,0,1,4157,T
3-PA,707,0,4150,0,3,4153,T
3-PA,708,5,3,0,4123,4131,C
3-PA,709,2,5,4128,1,4136,G
3-PA,710,4157,0,2,0,4159,A
3-PA,711,4151,0,6,1,4158,A
3-PA,712,0,2,0,4172,4174,C
3-PA,713,3,4,1,4020,4028,C
3-PA,714,1,4,4049,1,4055,G
3-PA,715,4052,0,3,0,4055,A
3-PA,716,4054,0,5,0,4059,A
3-PA,717,0,3,0,4111,4114,C
3-PA,718,1,4,4084,0,4089,G
3-PA,719,3,0,4231,0,4234,G
3-PA,720,0,1,1,4230,4232,C
3-PA,721,0,4215,0,11,4226,T
3-PA,722,4,1,4352,0,4357,G
3-PA,723,1,0,0,4374,4375,C
3-PA,724,4406,0,2,0,4408,A
3-PA,725,0,4390,0,6,4396,T
3-PA,726,1,4345,0,6,4352,T
3-PA,727,1,2,4367,0,4370,G
3-PA,728,4217,0,4,0,4221,A
3-PA,729,1,8,4286,0,4295,G
3-PA,730,0,8,4287,0,4295,G
3-PA,731,1,2,4251,0,4254,G
3-PA,732,1,1,0,4239,4241,C
3-PA,733,4204,1,2,0,4207,A
3-PA,734,4232,1,8,0,4241,A
3-PA,735,2,0,4271,0,4273,G
3-PA,736,0,2,0,4277,4279,C
3-PA,737,0,4280,0,14,4294,T
3-PA,738,0,4261,0,6,4267,T
3-PA,739,2,4276,0,7,4285,T
3-PA,740,2,0,0,4309,4311,C
3-PA,741,0,4286,1,7,4294,T
3-PA,742,2,0,0,4321,4323,C
3-PA,743,4293,0,4,0,4297,A
3-PA,744,4280,0,1,0,4281,A
3-PA,745,4275,0,0,0,4275,A
3-PA,746,0,4271,0,0,4271,T
3-PA,747,0,2,4455,0,4457,G
3-PA,748,0,4433,1,3,4437,T
3-PA,749,1,0,0,4482,4483,C
3-PA,750,3,4,0,4492,4499,C
3-PA,751,4505,1,1,0,4507,A
3-PA,752,4501,0,10,0,4511,A
3-PA,753,4503,0,5,0,4508,A
3-PA,754,2,2,4583,0,4587,G
3-PA,755,4541,0,2,0,4543,A
3-PA,756,4371,0,8,0,4379,A
3-PA,757,1,0,4421,0,4422,G
3-PA,758,0,4350,0,5,4355,T
3-PA,759,2,3,4362,0,4367,G
3-PA,760,4335,2,1,0,4338,A
3-PA,761,4326,1,9,0,4336,A
3-PA,762,0,4351,0,1,4352,T
3-PA,763,1,0,4301,0,4302,G
3-PA,764,3,1,0,4315,4319,C
3-PA,765,7,3,0,4306,4316,C
3-PA,766,3,1,0,4326,4330,C
3-PA,767,4345,0,1,1,4347,A
3-PA,768,4427,0,0,0,4427,A
3-PA,769,4444,0,0,0,4444,A
3-PA,770,1,4442,0,0,4443,T
3-PA,771,0,4437,0,0,4437,T
3-PA,772,2,1,4424,0,4427,G
3-PA,773,4406,0,4,0,4410,A
3-PA,774,4401,0,9,0,4410,A
3-PA,775,1,0,0,4435,4436,C
3-PA,776,2,1,0,4426,4429,C
3-PA,777,0,4353,1,5,4359,T
3-PA,778,0,4476,0,2,4478,T
3-PA,779,0,4483,0,2,4485,T
3-PA,780,1,4581,0,2,4584,T
3-PA,781,3,0,0,4607,4610,C
3-PA,782,1,4579,0,9,4589,T
3-PA,783,1,1,4619,0,4621,G
3-PA,784,4585,1,9,0,4595,A
3-PA,785,4656,0,3,0,4659,A
3-PA,786,0,4,4679,0,4683,G
3-PA,787,4598,1,3,0,4602,A
3-PA,788,0,1,0,4616,4617,C
3-PA,789,4535,0,4,1,4540,A
3-PA,790,4580,0,10,0,4590,A
3-PA,791,1,2,0,5116,5119,C
3-PA,792,5140,0,7,0,5147,A
3-PA,793,1,1,0,5137,5139,C
3-PA,794,5,0,0,5083,5088,C
3-PA,795,5056,2,4,1,5063,A
3-PA,796,5048,1,7,0,5056,A
3-PA,797,0,3,5064,0,5067,G
3-PA,798,5054,0,2,0,5056,A
3-PA,799,4,2,0,5056,5062,C
3-PA,800,2,2,0,4587,4591,C
3-PA,801,4549,0,6,1,4556,A
3-PA,802,4565,1,2,0,4568,A
3-PA,803,1,4578,0,4,4583,T
3-PA,804,4,1,1,4595,4601,C
3-PA,805,4575,0,0,0,4575,A
3-PA,806,4550,0,2,0,4552,A
3-PA,807,4562,0,3,2,4567,A
3-PA,808,0,0,0,4633,4633,C
3-PA,809,0,4568,0,1,4569,T
3-PA,810,1,4584,2,2,4589,T
3-PA,811,1,0,0,4610,4611,C
3-PA,812,5,0,0,4616,4621,C
3-PA,813,0,4,4641,0,4645,G
3-PA,814,4635,1,1,1,4638,A
3-PA,815,4643,0,4,0,4647,A
3-PA,816,1,4661,0,1,4663,T
3-PA,817,3,5,4582,0,4590,G
3-PA,818,2,6,4613,0,4621,G
3-PA,819,4634,1,1,0,4636,A
3-PA,820,2,1,0,4666,4669,C
3-PA,821,2,2,0,4651,4655,C
3-PA,822,0,4827,0,3,4830,T
3-PA,823,1,3,0,4995,4999,C
3-PA,824,4,2,0,5007,5013,C
3-PA,825,0,5003,0,3,5006,T
3-PA,826,2,5021,0,5,5028,T
3-PA,827,2,0,5235,0,5237,G
3-PA,828,1,5201,1,12,5215,T
3-PA,829,0,5191,1,1,5193,T
3-PA,830,5181,0,4,0,5185,A
3-PA,831,1,4995,0,1,4997,T
3-PA,832,1,1,0,4944,4946,C
3-PA,833,4805,0,3,0,4808,A
3-PA,834,1,0,4810,0,4811,G
3-PA,835,3,3,0,4802,4808,C
3-PA,836,2,1,4637,0,4640,G
3-PA,837,1,1,4818,0,4820,G
3-PA,838,0,4820,0,3,4823,T
3-PA,839,7,1,0,4812,4820,C
3-PA,840,3,0,1,4840,4844,C
3-PA,841,4850,0,1,0,4851,A
3-PA,842,4874,1,4,0,4879,A
3-PA,843,4866,0,7,0,4873,A
3-PA,844,0,4876,0,1,4877,T
3-PA,845,0,4851,0,1,4852,T
3-PA,846,4,0,0,4793,4797,C
3-PA,847,2,0,0,4760,4762,C
3-PA,848,1,4724,0,6,4731,T
3-PA,849,3,2,0,4781,4786,C
3-PA,850,4,2,0,4795,4801,C
3-PA,851,0,4753,0,7,4760,T
3-PA,852,1,2,4796,0,4799,G
3-PA,853,4783,1,2,0,4786,A
3-PA,854,0,4791,0,0,4791,T
3-PA,855,2,7,4733,0,4742,G
3-PA,856,0,3,4671,0,4674,G
3-PA,857,4645,0,9,2,4656,A
3-PA,858,1,4590,1,0,4592,T
3-PA,859,1,2,4603,0,4606,G
3-PA,860,0,1,0,4904,4905,C
3-PA,861,1,4857,1,3,4862,T
3-PA,862,0,4869,0,3,4872,T
3-PA,863,1,4884,0,2,4887,T
3-PA,864,4891,1,1,0,4893,A
3-PA,865,4909,0,1,0,4910,A
3-PA,866,4916,0,1,0,4917,A
3-PA,867,4927,1,0,0,4928,A
3-PA,868,1,4915,2,0,4918,T
3-PA,869,0,4401,4,2,4407,T
3-PA,870,4,5,4398,0,4407,G
3-PA,871,4369,0,9,0,4378,A
3-PA,872,0,2,4442,0,4444,G
3-PA,873,2,2,2,4430,4436,C
3-PA,874,4394,1,0,0,4395,A
3-PA,875,0,4522,0,4,4526,T
3-PA,876,2,4506,2,1,4511,T
3-PA,877,1,3,4501,1,4506,G
3-PA,878,4511,0,2,0,4513,A
3-PA,879,4450,3,16,1,4470,A
3-PA,880,13,6,4455,0,4474,G
3-PA,881,4362,1,6,0,4369,A
3-PA,882,0,0,0,4406,4406,C
3-PA,883,6,1,0,4353,4360,C
3-PA,884,6,1,0,4243,4250,C
3-PA,885,4200,1,4,1,4206,A
3-PA,886,4218,2,5,0,4225,A
3-PA,887,3,1,4247,0,4251,G
3-PA,888,0,4255,0,1,4256,T
3-PA,889,13,0,0,4248,4261,C
3-PA,890,4255,0,5,0,4260,A
3-PA,891,0,3,0,4250,4253,C
3-PA,892,2,4,4237,0,4243,G
3-PA,893,4302,0,5,0,4307,A
3-PA,894,4308,1,4,0,4313,A
3-PA,895,3,6,4436,0,4445,G
3-PA,896,1,1,4449,0,4451,G
3-PA,897,4406,1,7,0,4414,A
3-PA,898,2,1,4452,0,4455,G
3-PA,899,4434,3,7,0,4444,A
3-PA,900,4432,0,11,0,4443,A
3-PA,901,0,7,4442,0,4449,G
3-PA,902,4,2,4409,0,4415,G
3-PA,903,4,1,4421,0,4426,G
3-PA,904,4277,0,6,0,4283,A
3-PA,905,1,4270,0,7,4278,T
3-PA,906,3,1,0,4295,4299,C
3-PA,907,4,2,2,4650,4658,C
3-PA,908,10,0,0,4735,4745,C
3-PA,909,4798,1,4,0,4803,A
3-PA,910,0,4807,0,3,4810,T
3-PA,911,1,4802,0,4,4807,T
3-PA,912,4894,0,3,0,4897,A
3-PA,913,0,4875,0,5,4880,T
3-PA,914,4859,0,5,0,4864,A
3-PA,915,0,4836,0,6,4842,T
3-PA,916,4,7,4219,0,4230,G
3-PA,917,4195,0,4,0,4199,A
3-PA,918,1,4149,0,3,4153,T
3-PA,919,2,0,4174,0,4176,G
3-PA,920,0,2,3,4092,4097,C
3-PA,921,4,7,4086,0,4097,G
3-PA,922,4119,0,8,0,4127,A
3-PA,923,1,4098,0,3,4102,T
3-PA,924,4,0,0,4124,4128,C
3-PA,925,4130,0,0,0,4130,A
3-PA,926,4072,0,9,0,4081,A
3-PA,927,0,0,4105,0,4105,G
3-PA,928,0,4063,0,2,4065,T
3-PA,929,0,2,4090,0,4092,G
3-PA,930,0,1,0,4113,4114,C
3-PA,931,4090,0,8,0,4098,A
3-PA,932,1,4122,0,2,4125,T
3-PA,933,4117,0,0,0,4117,A
3-PA,934,4161,0,1,0,4162,A
3-PA,935,4157,0,1,0,4158,A
3-PA,936,4134,1,5,0,4140,A
3-PA,937,4137,2,1,2,4142,A
3-PA,938,1,2,0,4148,4151,C
3-PA,939,4093,0,1,0,4094,A
3-PA,940,0,4099,1,0,4100,T
3-PA,941,0,4099,0,3,4102,T
3-PA,942,3,0,0,4118,4121,C
3-PA,943,0,4050,1,4,4055,T
3-PA,944,0,4035,0,4,4039,T
3-PA,945,0,4047,1,0,4048,T
3-PA,946,1,7,4047,0,4055,G
3-PA,947,0,2,4053,0,4055,G
3-PA,948,4043,0,4,0,4047,A
3-PA,949,0,4019,1,3,4023,T
3-PA,950,1,0,4066,0,4067,G
3-PA,951,0,2,4120,0,4122,G
3-PA,952,4123,2,6,0,4131,A
3-PA,953,4122,0,5,2,4129,A
3-PA,954,4137,1,3,0,4141,A
3-PA,955,2,5,4161,0,4168,G
3-PA,956,4141,0,6,0,4147,A
3-PA,957,4606,0,6,0,4612,A
3-PA,958,2,1,0,4695,4698,C
3-PA,959,5,3,0,4681,4689,C
3-PA,960,0,4615,0,8,4623,T
3-PA,961,0,4728,0,0,4728,T
3-PA,962,4748,0,2,0,4750,A
3-PA,963,0,4757,0,0,4757,T
3-PA,964,4706,0,4,0,4710,A
3-PA,965,0,4773,1,1,4775,T
3-PA,966,4252,0,7,1,4260,A
3-PA,967,2,0,4281,0,4283,G
3-PA,968,1,4225,0,9,4235,T
3-PA,969,0,2,0,4210,4212,C
3-PA,970,4129,1,2,0,4132,A
3-PA,971,4130,2,5,0,4137,A
3-PA,972,4147,2,0,1,4150,A
3-PA,973,0,0,0,4169,4169,C
3-PA,974,2,0,0,4085,4087,C
3-PA,975,4032,0,3,0,4035,A
3-PA,976,0,0,0,4059,4059,C
3-PA,977,4042,0,10,1,4053,A
3-PA,978,0,1,0,4087,4088,C
3-PA,979,0,1,4088,0,4089,G
3-PA,980,4060,2,7,0,4069,A
3-PA,981,4075,1,3,0,4079,A
3-PA,982,4059,1,6,0,4066,A
3-PA,983,4057,0,9,0,4066,A
3-PA,984,0,4,4106,0,4110,G
3-PA,985,0,2,4052,0,4054,G
3-PA,986,0,1,4080,1,4082,G
3-PA,987,4045,0,7,1,4053,A
3-PA,988,4073,0,6,0,4079,A
3-PA,989,1,4070,0,0,4071,T
3-PA,990,4082,1,0,1,4084,A
3-PA,991,4087,0,1,1,4089,A
3-PA,992,4096,1,2,0,4099,A
3-PA,993,0,4076,1,1,4078,T
3-PA,994,0,4063,0,0,4063,T
3-PA,995,6,0,0,4103,4109,C
3-PA,996,4092,0,0,0,4092,A
3-PA,997,4097,1,3,0,4101,A
3-PA,998,4106,0,2,0,4108,A
3-PA,999,0,4099,0,7,4106,T
3-PA,1000,1,4118,0,1,4120,T
3-PA,1001,4132,1,1,0,4134,A
3-PA,1002,1,5,0,4132,4138,C
3-PA,1003,2,1,0,4134,4137,C
3-PA,1004,0,4093,0,6,4099,T
3-PA,1005,1,0,4118,0,4119,G
3-PA,1006,0,0,0,4141,4141,C
3-PA,1007,0,4137,0,2,4139,T
3-PA,1008,1,0,4212,0,4213,G
3-PA,1009,1,4206,0,3,4210,T
3-PA,1010,6,0,0,4204,4210,C
3-PA,1011,4205,1,1,0,4207,A
3-PA,1012,1,4200,0,3,4204,T
3-PA,1013,2,2,4198,0,4202,G
3-PA,1014,1,4,4199,0,4204,G
3-PA,1015,4200,0,2,0,4202,A
3-PA,1016,4285,0,7,2,4294,A
3-PA,1017,3,0,4281,0,4284,G
3-PA,1018,0,0,0,4259,4259,C
3-PA,1019,4247,3,5,0,4255,A
3-PA,1020,4255,1,6,0,4262,A
3-PA,1021,0,0,4311,0,4311,G
3-PA,1022,0,4306,1,3,4310,T
3-PA,1023,4303,1,0,0,4304,A
3-PA,1024,2,2,1,4312,4317,C
3-PA,1025,0,4196,0,9,4205,T
3-PA,1026,1,0,4227,0,4228,G
3-PA,1027,0,4195,0,7,4202,T
3-PA,1028,5,2,0,4206,4213,C
3-PA,1029,4178,0,6,0,4184,A
3-PA,1030,4,5,4228,0,4237,G
3-PA,1031,4216,0,0,1,4217,A
3-PA,1032,4218,0,2,0,4220,A
3-PA,1033,1,4317,0,3,4321,T
3-PA,1034,0,4273,5,2,4280,T
3-PA,1035,0,1,4267,0,4268,G
3-PA,1036,0,1,0,4250,4251,C
3-PA,1037,4226,1,12,1,4240,A
3-PA,1038,4,4,4255,0,4263,G
3-PA,1039,0,4,4210,0,4214,G
3-PA,1040,4255,0,6,0,4261,A
3-PA,1041,1,2,0,4308,4311,C
3-PA,1042,4167,0,1,0,4168,A
3-PA,1043,0,4223,1,6,4230,T
3-PA,1044,2,4226,0,1,4229,T
3-PA,1045,2,3,4251,0,4256,G
3-PA,1046,4261,0,3,1,4265,A
3-PA,1047,4262,0,3,2,4267,A
3-PA,1048,4249,0,4,0,4253,A
3-PA,1049,4220,0,3,1,4224,A
3-PA,1050,0,4164,0,1,4165,T
3-PA,1051,1,4,4198,0,4203,G
3-PA,1052,4148,0,4,0,4152,A
3-PA,1053,1,3,4181,0,4185,G
3-PA,1054,3,10,4168,0,4181,G
3-PA,1055,4129,0,1,0,4130,A
3-PA,1056,1,2,4164,1,4168,G
3-PA,1057,4158,1,1,0,4160,A
3-PA,1058,4151,0,7,0,4158,A
3-PA,1059,2,0,4196,0,4198,G
3-PA,1060,4144,1,4,0,4149,A
3-PA,1061,1,4147,2,0,4150,T
3-PA,1062,0,4132,0,6,4138,T
3-PA,1063,7,2,0,4137,4146,C
3-PA,1064,2,3,0,4147,4152,C
3-PA,1065,4147,0,3,0,4150,A
3-PA,1066,4135,1,5,0,4141,A
3-PA,1067,0,10,4128,1,4139,G
3-PA,1068,4025,0,2,0,4027,A
3-PA,1069,4144,0,1,0,4145,A
3-PA,1070,0,1,0,4187,4188,C
3-PA,1071,0,4182,0,5,4187,T
3-PA,1072,4205,0,0,0,4205,A
3-PA,1073,4198,1,3,0,4202,A
3-PA,1074,4182,0,7,1,4190,A
3-PA,1075,4198,0,4,2,4204,A
3-PA,1076,4163,1,1,2,4167,A
3-PA,1077,0,0,0,4215,4215,C
3-PA,1078,4195,1,2,0,4198,A
3-PA,1079,0,4156,0,1,4157,T
3-PA,1080,0,3,4206,1,4210,G
3-PA,1081,4213,3,4,0,4220,A
3-PA,1082,4210,1,9,1,4221,A
3-PA,1083,2,4,4262,0,4268,G
3-PA,1084,4247,0,0,0,4247,A
3-PA,1085,4255,0,4,0,4259,A
3-PA,1086,4216,1,8,0,4225,A
3-PA,1087,4214,0,6,0,4220,A
3-PA,1088,1,2,0,4253,4256,C
3-PA,1089,2,5,4221,0,4228,G
3-PA,1090,4236,1,6,0,4243,A
3-PA,1091,2,1,4260,0,4263,G
3-PA,1092,1,4222,1,8,4232,T
3-PA,1093,7,0,1,4343,4351,C
3-PA,1094,4362,0,2,1,4365,A
3-PA,1095,4450,0,5,0,4455,A
3-PA,1096,0,1,1,4467,4469,C
3-PA,1097,0,4452,1,6,4459,T
3-PA,1098,2,4,4541,0,4547,G
3-PA,1099,4519,1,5,0,4525,A
3-PA,1100,4534,0,5,1,4540,A
3-PA,1101,3,1,4543,1,4548,G
3-PA,1102,0,4426,0,3,4429,T
3-PA,1103,7,6,4421,0,4434,G
3-PA,1104,1,2,4395,0,4398,G
3-PA,1105,2,2,4401,0,4405,G
3-PA,1106,2,1,0,4423,4426,C
3-PA,1107,1,4336,0,7,4344,T
3-PA,1108,3,3,1,4393,4400,C
3-PA,1109,0,4364,0,2,4366,T
3-PA,1110,0,4382,0,4,4386,T
3-PA,1111,0,3,4587,0,4590,G
3-PA,1112,1,2,4641,0,4644,G
3-PA,1113,0,4599,0,6,4605,T
3-PA,1114,0,1,4598,0,4599,G
3-PA,1115,4559,0,7,1,4567,A
3-PA,1116,4660,0,6,0,4666,A
3-PA,1117,4640,0,5,1,4646,A
3-PA,1118,4680,0,2,2,4684,A
3-PA,1119,2,0,0,4722,4724,C
3-PA,1120,4627,0,5,0,4632,A
3-PA,1121,0,4629,0,6,4635,T
3-PA,1122,3,6,4606,0,4615,G
3-PA,1123,0,1,4755,0,4756,G
3-PA,1124,2,3,0,4784,4789,C
3-PA,1125,4772,1,12,6,4791,A
3-PA,1126,0,0,0,4882,4882,C
3-PA,1127,2,2,0,4883,4887,C
3-PA,1128,5007,1,3,0,5011,A
3-PA,1129,0,3,5125,0,5128,G
3-PA,1130,5094,1,10,1,5106,A
3-PA,1131,5,0,5197,0,5202,G
3-PA,1132,5192,0,7,0,5199,A
3-PA,1133,5240,0,10,1,5251,A
3-PA,1134,0,5,5290,0,5295,G
3-PA,1135,2,0,5260,0,5262,G
3-PA,1136,1,5266,1,2,5270,T
3-PA,1137,5190,0,3,0,5193,A
3-PA,1138,0,3,5192,0,5195,G
3-PA,1139,5209,0,7,1,5217,A
3-PA,1140,0,0,1,5297,5298,C
3-PA,1141,0,5241,1,6,5248,T
3-PA,1142,0,5235,0,3,5238,T
3-PA,1143,1,5233,0,2,5236,T
3-PA,1144,3,5,5244,0,5252,G
3-PA,1145,5239,2,8,0,5249,A
3-PA,1146,5257,0,1,1,5259,A
3-PA,1147,5259,1,2,1,5263,A
3-PA,1148,5233,1,3,2,5239,A
3-PA,1149,2,0,0,5436,5438,C
3-PA,1150,0,5389,0,5,5394,T
3-PA,1151,3,2,5489,0,5494,G
3-PA,1152,0,0,0,5495,5495,C
3-PA,1153,5482,0,6,3,5491,A
3-PA,1154,0,2,5500,0,5502,G
3-PA,1155,5447,1,7,1,5456,A
3-PA,1156,2,2,5823,0,5827,G
3-PA,1157,5822,0,5,0,5827,A
3-PA,1158,0,4,0,5820,5824,C
3-PA,1159,5816,1,3,2,5822,A
3-PA,1160,0,5758,0,3,5761,T
3-PA,1161,5765,0,6,0,5771,A
3-PA,1162,5746,0,8,2,5756,A
3-PA,1163,2,0,5773,0,5775,G
3-PA,1164,1,1,0,5763,5765,C
3-PA,1165,0,3,5635,0,5638,G
3-PA,1166,5811,0,4,1,5816,A
3-PA,1167,0,5768,0,1,5769,T
3-PA,1168,0,5778,1,2,5781,T
3-PA,1169,0,5773,1,7,5781,T
3-PA,1170,3,5,5813,0,5821,G
3-PA,1171,5834,1,6,0,5841,A
3-PA,1172,5841,1,9,0,5851,A
3-PA,1173,1,0,5896,0,5897,G
3-PA,1174,0,3,1,6127,6131,C
3-PA,1175,6067,0,2,0,6069,A
3-PA,1176,6751,0,1,0,6752,A
3-PA,1177,0,6770,0,1,6771,T
3-PA,1178,6808,0,3,0,6811,A
3-PA,1179,0,6846,0,12,6858,T
3-PA,1180,6,8,6871,1,6886,G
3-PA,1181,6975,1,12,0,6988,A
3-PA,1182,1,6981,0,10,6992,T
3-PA,1183,6774,0,3,1,6778,A
3-PA,1184,6,1,6794,0,6801,G
3-PA,1185,1,6537,0,5,6543,T
3-PA,1186,2,6,6524,0,6532,G
3-PA,1187,6517,0,9,0,6526,A
3-PA,1188,0,1,0,6499,6500,C
3-PA,1189,3,5,6463,0,6471,G
3-PA,1190,6523,0,3,0,6526,A
3-PA,1191,6523,0,12,1,6536,A
3-PA,1192,0,1,0,6641,6642,C
3-PA,1193,8,1,0,6632,6641,C
3-PA,1194,1,6594,0,14,6609,T
3-PA,1195,0,3,6884,1,6888,G
3-PA,1196,6844,1,5,1,6851,A
3-PA,1197,6888,0,5,1,6894,A
3-PA,1198,0,6890,1,3,6894,T
3-PA,1199,0,6829,0,2,6831,T
3-PA,1200,6829,1,3,1,6834,A
3-PA,1201,6730,0,7,0,6737,A
3-PA,1202,1,4,6776,0,6781,G
3-PA,1203,3,2,6778,0,6783,G
3-PA,1204,1,6649,2,12,6664,T
3-PA,1205,8,2,0,6647,6657,C
3-PA,1206,6679,1,0,1,6681,A
3-PA,1207,1,1,0,7073,7075,C
3-PA,1208,0,7069,0,17,7086,T
3-PA,1209,1,7104,0,4,7109,T
3-PA,1210,1,7113,0,7,7121,T
3-PA,1211,5,3,0,7095,7103,C
3-PA,1212,7085,0,22,0,7107,A
3-PA,1213,7118,0,4,1,7123,A
3-PA,1214,1,3,7228,0,7232,G
3-PA,1215,3,1,0,7232,7236,C
3-PA,1216,2,7048,0,3,7053,T
3-PA,1217,2,5,7298,1,7306,G
3-PA,1218,5,4,7330,0,7339,G
3-PA,1219,7508,0,13,0,7521,A
3-PA,1220,2,7635,0,1,7638,T
3-PA,1221,7621,0,5,0,7626,A
3-PA,1222,2,2,0,7707,7711,C
3-PA,1223,7591,1,11,2,7605,A
3-PA,1224,1,5,7727,0,7733,G
3-PA,1225,7681,2,11,0,7694,A
3-PA,1226,7589,0,5,0,7594,A
3-PA,1227,0,7513,1,2,7516,T
3-PA,1228,0,7,7584,0,7591,G
3-PA,1229,7511,2,11,0,7524,A
3-PA,1230,3,0,7694,0,7697,G
3-PA,1231,2,7629,0,5,7636,T
3-PA,1232,1,7594,1,7,7603,T
3-PA,1233,5,3,0,7756,7764,C
3-PA,1234,7812,1,5,0,7818,A
3-PA,1235,7826,1,2,1,7830,A
3-PA,1236,1,1,0,7824,7826,C
3-PA,1237,7733,0,4,0,7737,A
3-PA,1238,7728,1,4,0,7733,A
3-PA,1239,1,5,7792,0,7798,G
3-PA,1240,3,11,7865,0,7879,G
3-PA,1241,2,3,0,7964,7969,C
3-PA,1242,2,4,0,7926,7932,C
3-PA,1243,0,7859,0,13,7872,T
3-PA,1244,3,1,7964,0,7968,G
3-PA,1245,2,7949,0,8,7959,T
3-PA,1246,1,5,8044,0,8050,G
3-PA,1247,8041,1,8,1,8051,A
3-PA,1248,4,2,8058,0,8064,G
3-PA,1249,2,3,0,8036,8041,C
3-PA,1250,0,7940,0,4,7944,T
3-PA,1251,8204,1,9,1,8215,A
3-PA,1252,8217,0,7,1,8225,A
3-PA,1253,1,2,0,8264,8267,C
3-PA,1254,1,8196,0,3,8200,T
3-PA,1255,4,9,8240,2,8255,G
3-PA,1256,8225,2,5,0,8232,A
3-PA,1257,0,8246,0,2,8248,T
3-PA,1258,2,8249,0,3,8254,T
3-PA,1259,10,4,0,8277,8291,C
3-PA,1260,8541,2,8,1,8552,A
3-PA,1261,1,10,8837,0,8848,G
3-PA,1262,0,8808,0,9,8817,T
3-PA,1263,8,0,0,8812,8820,C
3-PA,1264,3,8739,0,13,8755,T
3-PA,1265,4,7,9197,0,9208,G
3-PA,1266,2,8,9204,0,9214,G
3-PA,1267,9218,1,7,1,9227,A
3-PA,1268,3,9229,0,4,9236,T
3-PA,1269,8836,0,7,0,8843,A
3-PA,1270,2,8,8839,1,8850,G
3-PA,1271,8708,0,16,0,8724,A
3-PA,1272,2,3,8792,0,8797,G
3-PA,1273,2,2,0,8784,8788,C
3-PA,1274,0,8571,0,4,8575,T
3-PA,1275,9,6,0,8633,8648,C
3-PA,1276,6,4,8662,0,8672,G
3-PA,1277,8686,0,5,0,8691,A
3-PA,1278,1,8702,0,0,8703,T
3-PA,1279,1,2,8671,0,8674,G
3-PA,1280,8853,4,5,0,8862,A
3-PA,1281,8853,1,10,0,8864,A
3-PA,1282,8912,0,3,1,8916,A
3-PA,1283,0,8897,2,1,8900,T
3-PA,1284,1,8859,0,2,8862,T
3-PA,1285,5,8,9024,0,9037,G
3-PA,1286,3,12,9024,0,9039,G
3-PA,1287,8970,3,10,0,8983,A
3-PA,1288,1,6,9016,0,9023,G
3-PA,1289,8860,1,11,0,8872,A
3-PA,1290,3,11,8990,0,9004,G
3-PA,1291,1,5,9104,0,9110,G
3-PA,1292,9184,1,7,1,9193,A
3-PA,1293,0,11,1,9203,9215,C
3-PA,1294,6,2,9140,0,9148,G
3-PA,1295,1,9157,0,0,9158,T
3-PA,1296,9242,0,7,0,9249,A
3-PA,1297,1,4,9335,0,9340,G
3-PA,1298,1,3,0,9482,9486,C
3-PA,1299,9,4,0,9348,9361,C
3-PA,1300,10,5,1,9340,9356,C
3-PA,1301,13,2,0,9427,9442,C
3-PA,1302,9450,2,6,0,9458,A
3-PA,1303,9918,1,4,0,9923,A
3-PA,1304,0,9897,1,9,9907,T
3-PA,1305,1,9855,1,2,9859,T
3-PA,1306,3,9,9824,2,9838,G
3-PA,1307,9597,2,16,0,9615,A
3-PA,1308,8,0,9697,0,9705,G
3-PA,1309,4,3,0,9659,9666,C
3-PA,1310,9633,3,3,0,9639,A
3-PA,1311,0,3,0,9897,9900,C
3-PA,1312,9648,1,3,0,9652,A
3-PA,1313,0,9989,0,11,10000,T
3-PA,1314,1,9990,0,10,10001,T
3-PA,1315,5,1,9994,1,10001,G
3-PA,1316,5,4,0,9987,9996,C
3-PA,1317,9968,0,11,0,9979,A
3-PA,1318,9984,0,11,2,9997,A
3-PA,1319,2,4,10006,0,10012,G
3-PA,1320,1,2,0,9944,9947,C
3-PA,1321,9945,1,2,0,9948,A
3-PA,1322,2,9716,1,7,9726,T
3-PA,1323,2,7,9758,0,9767,G
3-PA,1324,9709,2,7,0,9718,A
3-PA,1325,2,4,9806,0,9812,G
3-PA,1326,9773,1,11,0,9785,A
3-PA,1327,9782,2,7,0,9791,A
3-PA,1328,0,7,9753,0,9760,G
3-PA,1329,0,8,9843,0,9851,G
3-PA,1330,9845,2,16,0,9863,A
3-PA,1331,9846,1,9,0,9856,A
3-PA,1332,1,9865,1,2,9869,T
3-PA,1333,1,9875,0,0,9876,T
3-PA,1334,9956,0,0,0,9956,A
3-PA,1335,2,9996,0,7,10005,T
3-PA,1336,3,9982,0,5,9990,T
3-PA,1337,0,9975,1,12,9988,T
3-PA,1338,7,1,0,9917,9925,C
3-PA,1339,9882,2,6,0,9890,A
3-PA,1340,0,1,0,10177,10178,C
3-PA,1341,10125,0,13,0,10138,A
3-PA,1342,3,2,10254,0,10259,G
3-PA,1343,4,2,0,10245,10251,C
3-PA,1344,10205,4,9,0,10218,A
3-PA,1345,1,4,10287,2,10294,G
3-PA,1346,10236,0,11,1,10248,A
3-PA,1347,2,11,10317,0,10330,G
3-PA,1348,1,4,10380,0,10385,G
3-PA,1349,1,10131,1,8,10141,T
3-PA,1350,2,1,10342,0,10345,G
3-PA,1351,2,10258,0,13,10273,T
3-PA,1352,15,5,1,10249,10270,C
3-PA,1353,14,1,0,10374,10389,C
3-PA,1354,14,2,0,10357,10373,C
3-PA,1355,10517,2,5,1,10525,A
3-PA,1356,2,10649,0,13,10664,T
3-PA,1357,0,10579,0,10,10589,T
3-PA,1358,0,4,10672,1,10677,G
3-PA,1359,4,10485,0,7,10496,T
3-PA,1360,10349,1,8,1,10359,A
3-PA,1361,0,5,10341,0,10346,G
3-PA,1362,10050,2,16,0,10068,A
3-PA,1363,6,1,10150,0,10157,G
3-PA,1364,7,3,0,9980,9990,C
3-PA,1365,5,2,0,9840,9847,C
3-PA,1366,10073,1,7,0,10081,A
3-PA,1367,3,3,0,10092,10098,C
3-PA,1368,2,10041,0,2,10045,T
3-PA,1369,1,10,10033,0,10044,G
3-PA,1370,9992,2,1,0,9995,A
3-PA,1371,9815,2,20,0,9837,A
3-PA,1372,1,10152,1,4,10158,T
3-PA,1373,10302,3,5,0,10310,A
3-PA,1374,0,9,0,10451,10460,C
3-PA,1375,10179,1,8,0,10188,A
3-PA,1376,1,10249,0,4,10254,T
3-PA,1377,10143,0,10,0,10153,A
3-PA,1378,10232,0,8,0,10240,A
3-PA,1379,0,10226,0,2,10228,T
3-PA,1380,2,4,10072,0,10078,G
3-PA,1381,10003,0,3,1,10007,A
3-PA,1382,9810,0,15,0,9825,A
3-PA,1383,1,10,9860,0,9871,G
3-PA,1384,3,21,9862,0,9886,G
3-PA,1385,0,7,10029,3,10039,G
3-PA,1386,4,4,10069,1,10078,G
3-PA,1387,4,0,10198,0,10202,G
3-PA,1388,0,9997,0,7,10004,T
3-PA,1389,10083,0,6,1,10090,A
3-PA,1390,0,10160,1,4,10165,T
3-PA,1391,10385,1,14,1,10401,A
3-PA,1392,0,4,2,11488,11494,C
3-PA,1393,11109,1,2,0,11112,A
3-PA,1394,1,10860,1,7,10869,T
3-PA,1395,2,10703,0,8,10713,T
3-PA,1396,10585,0,2,0,10587,A
3-PA,1397,10847,0,10,0,10857,A
3-PA,1398,1,2,0,10854,10857,C
3-PA,1399,10685,2,3,1,10691,A
3-PA,1400,3,1,0,10686,10690,C
3-PA,1401,1,9407,0,10,9418,T
3-PA,1402,2,4,9814,0,9820,G
3-PA,1403,0,2,2,9783,9787,C
3-PA,1404,6,2,1,9766,9775,C
3-PA,1405,15,5,0,9798,9818,C
3-PA,1406,3,9533,0,11,9547,T
3-PA,1407,4,4,9959,1,9968,G
3-PA,1408,0,2,0,9979,9981,C
3-PA,1409,1,9899,0,16,9916,T
3-PA,1410,15,3,0,10220,10238,C
3-PA,1411,9905,0,2,0,9907,A
3-PA,1412,10003,0,7,0,10010,A
3-PA,1413,0,10033,0,2,10035,T
3-PA,1414,4,0,9993,1,9998,G
3-PA,1415,1,5,0,9996,10002,C
3-PA,1416,9744,0,5,1,9750,A
3-PA,1417,1,9706,1,16,9724,T
3-PA,1418,5,3,0,9707,9715,C
3-PA,1419,7,1,0,9785,9793,C
3-PA,1420,2,9407,0,8,9417,T
3-PA,1421,3,1,9655,0,9659,G
3-PA,1422,0,9585,1,16,9602,T
3-PA,1423,1,4,9572,0,9577,G
3-PA,1424,3,1,0,9580,9584,C
3-PA,1425,9442,2,13,0,9457,A
3-PA,1426,1,0,9568,0,9569,G
3-PA,1427,0,1,0,9564,9565,C
3-PA,1428,9424,1,1,0,9426,A
3-PA,1429,9412,0,5,1,9418,A
3-PA,1430,0,9008,0,6,9014,T
3-PA,1431,1,9,9019,0,9029,G
3-PA,1432,3,7,9025,1,9036,G
3-PA,1433,9025,0,13,0,9038,A
3-PA,1434,3,5,1,9030,9039,C
3-PA,1435,3,4,8916,0,8923,G
3-PA,1436,9085,0,2,0,9087,A
3-PA,1437,2,9066,0,7,9075,T
3-PA,1438,1,9059,0,5,9065,T
3-PA,1439,1,9037,1,5,9044,T
3-PA,1440,1,9039,0,4,9044,T
3-PA,1441,7,2,0,9038,9047,C
3-PA,1442,9049,0,9,0,9058,A
3-PA,1443,9085,1,3,0,9089,A
3-PA,1444,1,2,1,9102,9106,C
3-PA,1445,0,8870,0,8,8878,T
3-PA,1446,8855,0,2,1,8858,A
3-PA,1447,8860,0,2,0,8862,A
3-PA,1448,2,8906,2,4,8914,T
3-PA,1449,0,8848,0,8,8856,T
3-PA,1450,7,4,0,8902,8913,C
3-PA,1451,4,5,0,8893,8902,C
3-PA,1452,6,4,0,8888,8898,C
3-PA,1453,8896,0,3,1,8900,A
3-PA,1454,0,9032,0,14,9046,T
3-PA,1455,4,7,9074,0,9085,G
3-PA,1456,9061,2,6,0,9069,A
3-PA,1457,1,9030,1,3,9035,T
3-PA,1458,8999,0,7,0,9006,A
3-PA,1459,8987,0,17,0,9004,A
3-PA,1460,3,1,9000,0,9004,G
3-PA,1461,5,1,0,8976,8982,C
3-PA,1462,8954,0,4,0,8958,A
3-PA,1463,8627,0,10,0,8637,A
3-PA,1464,3,1,8801,0,8805,G
3-PA,1465,1,8717,0,6,8724,T
3-PA,1466,4,2,8708,0,8714,G
3-PA,1467,6,7,0,8688,8701,C
3-PA,1468,8588,3,15,0,8606,A
3-PA,1469,2,8,8773,0,8783,G
3-PA,1470,8734,3,9,0,8746,A
3-PA,1471,8898,1,7,0,8906,A
3-PA,1472,5,2,0,8900,8907,C
3-PA,1473,0,8600,0,5,8605,T
3-PA,1474,8679,0,1,0,8680,A
3-PA,1475,8664,1,6,2,8673,A
3-PA,1476,8651,0,22,6,8679,A
3-PA,1477,1,4,8692,0,8697,G
3-PA,1478,8224,0,17,1,8242,A
3-PA,1479,2,47,8247,0,8296,G
3-PA,1480,2,9,8003,0,8014,G
3-PA,1481,0,3,7998,1,8002,G
3-PA,1482,7881,1,10,0,7892,A
3-PA,1483,7719,1,14,1,7735,A
3-PA,1484,1,7,7737,0,7745,G
3-PA,1485,0,3,7720,0,7723,G
3-PA,1486,1,4,0,7716,7721,C
3-PA,1487,4,4,7711,0,7719,G
3-PA,1488,7666,0,7,0,7673,A
3-PA,1489,7688,0,2,0,7690,A
3-PA,1490,7685,1,4,0,7690,A
3-PA,1491,7704,3,1,0,7708,A
3-PA,1492,7716,1,10,3,7730,A
3-PA,1493,0,4,0,7731,7735,C
3-PA,1494,3,2,0,7667,7672,C
3-PA,1495,7641,0,3,0,7644,A
3-PA,1496,7737,0,3,1,7741,A
3-PA,1497,1,7742,1,2,7746,T
3-PA,1498,3,7734,0,2,7739,T
3-PA,1499,1,7790,0,0,7791,T
3-PA,1500,7838,1,5,2,7846,A
3-PA,1501,0,7829,1,1,7831,T
3-PA,1502,7800,2,3,0,7805,A
3-PA,1503,1,7780,0,3,7784,T
3-PA,1504,1,6,7705,0,7712,G
3-PA,1505,4,10,7614,0,7628,G
3-PA,1506,7605,0,1,0,7606,A
3-PA,1507,0,7566,0,6,7572,T
3-PA,1508,1,7477,1,2,7481,T
3-PA,1509,9,5,0,7467,7481,C
3-PA,1510,7536,1,5,1,7543,A
3-PA,1511,0,7632,1,9,7642,T
3-PA,1512,8,0,0,7652,7660,C
3-PA,1513,7667,0,8,0,7675,A
3-PA,1514,0,7571,0,3,7574,T
3-PA,1515,7539,0,4,0,7543,A
3-PA,1516,7529,0,8,0,7537,A
3-PA,1517,7520,1,13,1,7535,A
3-PA,1518,0,8,7511,0,7519,G
3-PA,1519,3,8,7334,0,7345,G
3-PA,1520,2,6,7256,1,7265,G
3-PA,1521,7175,1,9,0,7185,A
3-PA,1522,7091,0,17,2,7110,A
3-PA,1523,2,7,7139,0,7148,G
3-PA,1524,7093,2,9,1,7105,A
3-PA,1525,0,7079,0,3,7082,T
3-PA,1526,3,0,0,7066,7069,C
3-PA,1527,3,6876,0,10,6889,T
3-PA,1528,8,1,1,7118,7128,C
3-PA,1529,7101,0,1,1,7103,A
3-PA,1530,0,7092,0,2,7094,T
3-PA,1531,3,7097,0,1,7101,T
3-PA,1532,0,7010,0,2,7012,T
3-PA,1533,6965,0,3,0,6968,A
3-PA,1534,6973,0,13,0,6986,A
3-PA,1535,0,10,6978,0,6988,G
3-PA,1536,1,6,7089,2,7098,G
3-PA,1537,6643,2,3,0,6648,A
3-PA,1538,6656,1,8,3,6668,A
3-PA,1539,3,6661,3,4,6671,T
3-PA,1540,2,9,6734,0,6745,G
3-PA,1541,6959,2,9,0,6970,A
3-PA,1542,1,4,0,6960,6965,C
3-PA,1543,6923,2,12,2,6939,A
3-PA,1544,0,4,1,6930,6935,C
3-PA,1545,6685,3,8,1,6697,A
3-PA,1546,3,2,6768,0,6773,G
3-PA,1547,6723,0,14,0,6737,A
3-PA,1548,1,4,0,6671,6676,C
3-PA,1549,4,0,6624,0,6628,G
3-PA,1550,1,6157,1,9,6168,T
3-PA,1551,2,6,6203,0,6211,G
3-PA,1552,2,0,6256,0,6258,G
3-PA,1553,1,6250,1,4,6256,T
3-PA,1554,6242,0,2,0,6244,A
3-PA,1555,6120,0,4,0,6124,A
3-PA,1556,6139,0,0,0,6139,A
3-PA,1557,0,6110,0,5,6115,T
3-PA,1558,0,6032,1,2,6035,T
3-PA,1559,0,6027,1,2,6030,T
3-PA,1560,0,5945,0,0,5945,T
3-PA,1561,0,0,5941,0,5941,G
3-PA,1562,0,5886,0,3,5889,T
3-PA,1563,1,12,5869,0,5882,G
3-PA,1564,5839,0,7,1,5847,A
3-PA,1565,1,1,5872,0,5874,G
3-PA,1566,1,1,0,5819,5821,C
3-PA,1567,5840,1,2,0,5843,A
3-PA,1568,1,5826,1,5,5833,T
3-PA,1569,1,5,5840,0,5846,G
3-PA,1570,1,8,5881,0,5890,G
3-PA,1571,5886,1,4,0,5891,A
3-PA,1572,0,1,5917,0,5918,G
3-PA,1573,0,5814,2,5,5821,T
3-PA,1574,0,5708,5,16,5729,T
3-PA,1575,1,5786,1,4,5792,T
3-PA,1576,0,5781,0,9,5790,T
3-PA,1577,8,1,0,5801,5810,C
3-PA,1578,1,5749,0,8,5758,T
3-PA,1579,2,1,0,5755,5758,C
3-PA,1580,0,5599,0,11,5610,T
3-PA,1581,4,0,1,5605,5610,C
3-PA,1582,5605,0,2,1,5608,A
3-PA,1583,1,1,1,5593,5596,C
3-PA,1584,1,5475,1,3,5480,T
3-PA,1585,0,10,5496,1,5507,G
3-PA,1586,5500,0,4,0,5504,A
3-PA,1587,4,1,1,5527,5533,C
3-PA,1588,8,0,1,5503,5512,C
3-PA,1589,8,7,1,5459,5475,C
3-PA,1590,2,2,5448,0,5452,G
3-PA,1591,5419,0,9,0,5428,A
3-PA,1592,0,4,5466,0,5470,G
3-PA,1593,5473,1,3,0,5477,A
3-PA,1594,2,0,0,5349,5351,C
3-PA,1595,0,5252,1,8,5261,T
3-PA,1596,2,5013,0,3,5018,T
3-PA,1597,1,9,5008,0,5018,G
3-PA,1598,4970,1,12,0,4983,A
3-PA,1599,3,2,5025,0,5030,G
3-PA,1600,2,3,1,4990,4996,C
3-PA,1601,7,1,0,4825,4833,C
3-PA,1602,4891,1,3,1,4896,A
3-PA,1603,1,5,0,4888,4894,C
3-PA,1604,4890,1,3,1,4895,A
3-PA,1605,0,4891,0,2,4893,T
3-PA,1606,4850,0,2,0,4852,A
3-PA,1607,4816,1,5,0,4822,A
3-PA,1608,4790,0,5,2,4797,A
3-PA,1609,0,4763,2,1,4766,T
3-PA,1610,1,3,4753,0,4757,G
3-PA,1611,3,3,4413,0,4419,G
3-PA,1612,1,1,4404,0,4406,G
3-PA,1613,4293,1,7,0,4301,A
3-PA,1614,4,2,4361,0,4367,G
3-PA,1615,4318,1,4,0,4323,A
3-PA,1616,4283,2,2,0,4287,A
3-PA,1617,4309,1,6,1,4317,A
3-PA,1618,0,4305,2,0,4307,T
3-PA,1619,4295,0,0,0,4295,A
3-PA,1620,3,0,0,4283,4286,C
3-PA,1621,0,3161,1,3,3165,T
3-PA,1622,2,1,3188,0,3191,G
3-PA,1623,1,2704,0,5,2710,T
3-PA,1624,1,0,2823,0,2824,G
3-PA,1625,0,2784,0,1,2785,T
3-PA,1626,0,1,1,2532,2534,C
3-PA,1627,2,2,0,2503,2507,C
3-PA,1628,1,2449,0,3,2453,T
3-PA,1629,0,2480,0,0,2480,T
3-PA,1630,0,2,2509,0,2511,G
3-PA,1631,2496,0,5,0,2501,A
3-PA,1632,0,1,2579,0,2580,G
3-PA,1633,2429,0,4,0,2433,A
3-PA,1634,1,2438,0,0,2439,T
3-PA,1635,2387,0,4,0,2391,A
3-PA,1636,0,1,2444,0,2445,G
3-PA,1637,0,3,2459,0,2462,G
3-PA,1638,2438,0,5,0,2443,A
3-PA,1639,0,1,2456,0,2457,G
3-PA,1640,2400,1,8,0,2409,A
3-PA,1641,0,2391,0,1,2392,T
3-PA,1642,2409,0,0,0,2409,A
3-PA,1643,0,2403,0,2,2405,T
3-PA,1644,1,0,2434,0,2435,G
3-PA,1645,0,2388,0,0,2388,T
3-PA,1646,1,2377,0,0,2378,T
3-PA,1647,2447,0,1,0,2448,A
3-PA,1648,1,0,1,2439,2441,C
3-PA,1649,0,2409,0,2,2411,T
3-PA,1650,2432,0,0,0,2432,A
3-PA,1651,2401,0,3,0,2404,A
3-PA,1652,0,0,2440,0,2440,G
3-PA,1653,2404,1,2,0,2407,A
3-PA,1654,2361,0,2,0,2363,A
3-PA,1655,0,1,2315,0,2316,G
3-PA,1656,0,2341,0,0,2341,T
3-PA,1657,0,0,2370,0,2370,G
3-PA,1658,1,0,1,2376,2378,C
3-PA,1659,0,0,0,2381,2381,C
3-PA,1660,2381,1,0,0,2382,A
3-PA,1661,0,2355,0,0,2355,T
3-PA,1662,2352,0,1,0,2353,A
3-PA,1663,1,0,2356,2,2359,G
3-PA,1664,2,0,2344,0,2346,G
3-PA,1665,0,2,0,2338,2340,C
3-PA,1666,0,3,0,2308,2311,C
3-PA,1667,2323,1,0,0,2324,A
3-PA,1668,2325,0,1,0,2326,A
3-PA,1669,2319,1,0,0,2320,A
3-PA,1670,0,2376,0,1,2377,T
3-PA,1671,0,2369,0,1,2370,T
3-PA,1672,0,2358,0,1,2359,T
3-PA,1673,3,1,0,2366,2370,C
3-PA,1674,2360,0,1,0,2361,A
3-PA,1675,2376,0,5,0,2381,A
3-PA,1676,1,1,2404,0,2406,G
3-PA,1677,0,1,2394,0,2395,G
3-PA,1678,1,1,0,2410,2412,C
3-PA,1679,3,2,0,2357,2362,C
3-PA,1680,4,2,2363,0,2369,G
3-PA,1681,2448,0,5,0,2453,A
3-PA,1682,0,2462,1,1,2464,T
3-PA,1683,0,1,2517,0,2518,G
3-PA,1684,0,2517,0,1,2518,T
3-PA,1685,0,2591,0,7,2598,T
3-PA,1686,4,0,0,2608,2612,C
3-PA,1687,0,2604,1,10,2615,T
3-PA,1688,0,2636,0,3,2639,T
3-PA,1689,1,1,2666,0,2668,G
3-PA,1690,0,2608,0,2,2610,T
3-PA,1691,2610,1,3,0,2614,A
3-PA,1692,0,2549,0,5,2554,T
3-PA,1693,0,0,2555,0,2555,G
3-PA,1694,0,2458,0,2,2460,T
3-PA,1695,0,1,2455,0,2456,G
3-PA,1696,2422,1,7,0,2430,A
3-PA,1697,3,1,2452,0,2456,G
3-PA,1698,0,3,2455,1,2459,G
3-PA,1699,2454,0,3,0,2457,A
3-PA,1700,0,2,0,2456,2458,C
3-PA,1701,2443,0,0,0,2443,A
3-PA,1702,2442,0,4,1,2447,A
3-PA,1703,2447,1,5,0,2453,A
3-PA,1704,0,7,0,2454,2461,C
3-PA,1705,1,2,2454,0,2457,G
3-PA,1706,1,2,2481,0,2484,G
3-PA,1707,2440,0,1,0,2441,A
3-PA,1708,2446,1,3,0,2450,A
3-PA,1709,1,0,0,2481,2482,C
3-PA,1710,2467,0,2,0,2469,A
3-PA,1711,0,2467,1,2,2470,T
3-PA,1712,1,1,0,2465,2467,C
3-PA,1713,2467,1,0,0,2468,A
3-PA,1714,2472,0,0,0,2472,A
3-PA,1715,2406,1,4,0,2411,A
3-PA,1716,1,2,2436,0,2439,G
3-PA,1717,2,2,2452,0,2456,G
3-PA,1718,0,2427,0,2,2429,T
3-PA,1719,6,0,0,2426,2432,C
3-PA,1720,2430,0,2,1,2433,A
3-PA,1721,2462,0,1,0,2463,A
3-PA,1722,2450,0,3,1,2454,A
3-PA,1723,2473,0,0,0,2473,A
3-PA,1724,0,2482,0,0,2482,T
3-PA,1725,1,3,2506,0,2510,G
3-PA,1726,2479,0,2,0,2481,A
3-PA,1727,2466,0,5,0,2471,A
3-PA,1728,2479,1,6,0,2486,A
3-PA,1729,0,2491,0,0,2491,T
3-PA,1730,2,5,2508,0,2515,G
3-PA,1731,0,0,2523,0,2523,G
3-PA,1732,2,4,2507,0,2513,G
3-PA,1733,0,0,2535,0,2535,G
3-PA,1734,2499,0,1,0,2500,A
3-PA,1735,2520,0,2,0,2522,A
3-PA,1736,0,2522,0,1,2523,T
3-PA,1737,1,2,2540,0,2543,G
3-PA,1738,1,2,2567,0,2570,G
3-PA,1739,2520,1,13,0,2534,A
3-PA,1740,2,0,2592,0,2594,G
3-PA,1741,2564,0,8,0,2572,A
3-PA,1742,0,2531,0,2,2533,T
3-PA,1743,2,0,2539,0,2541,G
3-PA,1744,2498,0,7,0,2505,A
3-PA,1745,0,3,2525,0,2528,G
3-PA,1746,2519,0,4,0,2523,A
3-PA,1747,1,1,0,2471,2473,C
3-PA,1748,2,0,2463,0,2465,G
3-PA,1749,0,2451,1,1,2453,T
3-PA,1750,0,2449,0,1,2450,T
3-PA,1751,0,0,2462,0,2462,G
3-PA,1752,0,1,0,2449,2450,C
3-PA,1753,1,1,0,2463,2465,C
3-PA,1754,0,2452,0,1,2453,T
3-PA,1755,0,0,0,2529,2529,C
3-PA,1756,3,0,0,2542,2545,C
3-PA,1757,0,2536,1,4,2541,T
3-PA,1758,2,2543,0,1,2546,T
3-PA,1759,1,1,1,2555,2558,C
3-PA,1760,2540,0,0,0,2540,A
3-PA,1761,1,0,2541,0,2542,G
3-PA,1762,0,2516,2,3,2521,T
3-PA,1763,3,0,0,2547,2550,C
3-PA,1764,2486,1,3,0,2490,A
3-PA,1765,0,0,0,2611,2611,C
3-PA,1766,0,2590,0,3,2593,T
3-PA,1767,2,0,0,2611,2613,C
3-PA,1768,2,0,0,2618,2620,C
3-PA,1769,2626,1,3,0,2630,A
3-PA,1770,2,0,2631,0,2633,G
3-PA,1771,1,0,0,2641,2642,C
3-PA,1772,2611,0,0,0,2611,A
3-PA,1773,0,0,2631,1,2632,G
3-PA,1774,2493,0,4,0,2497,A
3-PA,1775,1,2486,1,1,2489,T
3-PA,1776,2,0,0,2489,2491,C
3-PA,1777,0,2,2484,0,2486,G
3-PA,1778,2480,1,2,0,2483,A
3-PA,1779,0,6,2503,0,2509,G
3-PA,1780,2483,0,7,0,2490,A
3-PA,1781,1,1,2524,0,2526,G
3-PA,1782,0,0,1,2488,2489,C
3-PA,1783,2489,0,4,0,2493,A
3-PA,1784,0,2508,0,1,2509,T
3-PA,1785,0,3,2565,0,2568,G
3-PA,1786,2601,0,1,0,2602,A
3-PA,1787,0,2588,0,1,2589,T
3-PA,1788,1,2583,0,1,2585,T
3-PA,1789,1,1,2581,0,2583,G
3-PA,1790,2551,0,3,0,2554,A
3-PA,1791,2544,0,2,0,2546,A
3-PA,1792,2,0,2565,0,2567,G
3-PA,1793,0,3,0,2542,2545,C
3-PA,1794,2,0,0,2512,2514,C
3-PA,1795,0,0,2509,0,2509,G
3-PA,1796,2500,0,0,0,2500,A
3-PA,1797,0,0,2534,0,2534,G
3-PA,1798,0,2524,0,1,2525,T
3-PA,1799,5,0,0,2518,2523,C
3-PA,1800,2,0,0,2518,2520,C
3-PA,1801,0,2510,0,1,2511,T
3-PA,1802,5,3,0,2560,2568,C
3-PA,1803,1,0,2568,0,2569,G
3-PA,1804,1,0,2688,0,2689,G
3-PA,1805,0,2682,0,1,2683,T
3-PA,1806,1,2650,0,0,2651,T
3-PA,1807,2662,0,0,1,2663,A
3-PA,1808,2654,0,1,0,2655,A
3-PA,1809,2668,0,3,0,2671,A
3-PA,1810,3,4,2727,0,2734,G
3-PA,1811,2683,1,4,0,2688,A
3-PA,1812,0,1,2693,0,2694,G
3-PA,1813,2563,0,1,0,2564,A
3-PA,1814,2565,0,1,0,2566,A
3-PA,1815,2580,0,3,0,2583,A
3-PA,1816,0,2,2614,1,2617,G
3-PA,1817,2607,1,5,1,2614,A
3-PA,1818,0,0,0,2613,2613,C
3-PA,1819,2547,0,4,0,2551,A
3-PA,1820,0,2549,0,4,2553,T
3-PA,1821,0,1,2550,0,2551,G
3-PA,1822,2593,1,6,0,2600,A
3-PA,1823,0,0,0,2605,2605,C
3-PA,1824,1,1,0,2581,2583,C
3-PA,1825,2559,2,1,1,2563,A
3-PA,1826,2561,0,1,0,2562,A
3-PA,1827,2552,0,3,0,2555,A
3-PA,1828,0,3,2575,0,2578,G
3-PA,1829,2553,0,1,0,2554,A
3-PA,1830,0,0,2581,0,2581,G
3-PA,1831,0,2527,0,4,2531,T
3-PA,1832,0,2532,1,0,2533,T
3-PA,1833,1,2522,0,1,2524,T
3-PA,1834,0,2535,0,0,2535,T
3-PA,1835,0,2526,0,0,2526,T
3-PA,1836,0,2540,0,2,2542,T
3-PA,1837,0,4,2534,0,2538,G
3-PA,1838,2500,0,4,0,2504,A
3-PA,1839,2,1,2548,0,2551,G
3-PA,1840,2546,0,1,0,2547,A
3-PA,1841,2541,0,0,0,2541,A
3-PA,1842,0,2547,0,2,2549,T
3-PA,1843,2550,1,1,0,2552,A
3-PA,1844,2644,0,1,0,2645,A
3-PA,1845,2658,0,1,1,2660,A
3-PA,1846,1,2658,0,0,2659,T
3-PA,1847,2,0,0,2686,2688,C
3-PA,1848,2654,0,3,0,2657,A
3-PA,1849,0,1,2661,0,2662,G
3-PA,1850,2653,0,1,0,2654,A
3-PA,1851,2663,1,5,0,2669,A
3-PA,1852,0,0,2696,0,2696,G
3-PA,1853,0,0,0,2622,2622,C
3-PA,1854,2605,1,4,0,2610,A
3-PA,1855,0,2607,0,2,2609,T
3-PA,1856,0,3,2610,0,2613,G
3-PA,1857,2,1,2659,0,2662,G
3-PA,1858,0,1,0,2649,2650,C
3-PA,1859,5,0,0,2749,2754,C
3-PA,1860,5,0,0,2745,2750,C
3-PA,1861,2815,1,1,0,2817,A
3-PA,1862,0,2810,1,1,2812,T
3-PA,1863,0,2811,0,0,2811,T
3-PA,1864,0,4,2821,2,2827,G
3-PA,1865,0,5,2821,0,2826,G
3-PA,1866,1,4,2782,1,2788,G
3-PA,1867,2,3,2794,0,2799,G
3-PA,1868,2650,1,3,0,2654,A
3-PA,1869,1,0,2726,0,2727,G
3-PA,1870,0,2674,1,3,2678,T
3-PA,1871,0,1,0,2756,2757,C
3-PA,1872,1,2,0,2891,2894,C
3-PA,1873,8,2,0,2898,2908,C
3-PA,1874,7,2,1,2899,2909,C
3-PA,1875,3,1,0,2903,2907,C
3-PA,1876,2905,0,3,0,2908,A
3-PA,1877,2906,0,3,0,2909,A
3-PA,1878,0,3,2912,0,2915,G
3-PA,1879,0,2,2856,0,2858,G
3-PA,1880,1,3,2866,0,2870,G
3-PA,1881,2565,2,4,0,2571,A
3-PA,1882,0,0,2621,0,2621,G
3-PA,1883,0,2621,0,2,2623,T
3-PA,1884,0,0,2629,0,2629,G
3-PA,1885,0,3,2660,0,2663,G
3-PA,1886,2635,1,2,0,2638,A
3-PA,1887,2650,0,2,1,2653,A
3-PA,1888,0,2,2647,1,2650,G
3-PA,1889,2621,1,0,1,2623,A
3-PA,1890,2623,0,2,0,2625,A
3-PA,1891,1,4,2599,0,2604,G
3-PA,1892,1,1,2620,0,2622,G
3-PA,1893,0,2612,0,2,2614,T
3-PA,1894,1,2584,1,0,2586,T
3-PA,1895,0,0,1,2595,2596,C
3-PA,1896,2,0,0,2599,2601,C
3-PA,1897,2598,0,0,0,2598,A
3-PA,1898,0,2604,0,1,2605,T
3-PA,1899,1,2584,0,4,2589,T
3-PA,1900,1,1,2604,0,2606,G
3-PA,1901,0,3,2584,0,2587,G
3-PA,1902,2,0,2594,0,2596,G
3-PA,1903,2582,2,4,0,2588,A
3-PA,1904,2580,0,0,0,2580,A
3-PA,1905,2581,0,4,1,2586,A
3-PA,1906,0,0,2680,0,2680,G
3-PA,1907,0,2673,0,1,2674,T
3-PA,1908,1,1,0,2735,2737,C
3-PA,1909,0,2705,0,0,2705,T
3-PA,1910,0,1,2719,0,2720,G
3-PA,1911,0,2722,0,2,2724,T
3-PA,1912,2712,0,2,0,2714,A
3-PA,1913,3,1,2720,0,2724,G
3-PA,1914,0,2,2697,1,2700,G
3-PA,1915,2591,0,3,0,2594,A
3-PA,1916,1,0,0,2600,2601,C
3-PA,1917,0,2528,0,6,2534,T
3-PA,1918,4,0,0,2708,2712,C
3-PA,1919,1,2706,0,1,2708,T
3-PA,1920,2715,1,1,0,2717,A
3-PA,1921,0,2717,0,0,2717,T
3-PA,1922,0,2689,0,2,2691,T
3-PA,1923,4,2,2729,0,2735,G
3-PA,1924,4,0,2724,0,2728,G
3-PA,1925,0,0,0,2719,2719,C
3-PA,1926,1,2707,0,1,2709,T
3-PA,1927,2491,0,0,0,2491,A
3-PA,1928,2516,0,0,0,2516,A
3-PA,1929,1,0,2540,0,2541,G
3-PA,1930,0,2544,0,1,2545,T
3-PA,1931,5,1,0,2532,2538,C
3-PA,1932,2478,0,3,0,2481,A
3-PA,1933,0,1,2591,0,2592,G
3-PA,1934,0,2587,0,2,2589,T
3-PA,1935,2714,0,2,0,2716,A
3-PA,1936,0,2714,0,3,2717,T
3-PA,1937,1,2751,0,2,2754,T
3-PA,1938,3,1,0,2755,2759,C
3-PA,1939,2739,1,1,0,2741,A
3-PA,1940,2733,0,2,0,2735,A
3-PA,1941,0,2742,1,1,2744,T
3-PA,1942,2630,0,2,0,2632,A
3-PA,1943,1,0,2663,0,2664,G
3-PA,1944,0,1,0,2607,2608,C
3-PA,1945,1,1,0,2614,2616,C
3-PA,1946,1,2546,0,1,2548,T
3-PA,1947,0,0,2660,0,2660,G
3-PA,1948,1,2653,0,3,2657,T
3-PA,1949,2668,0,1,0,2669,A
3-PA,1950,0,2669,0,5,2674,T
3-PA,1951,2,2,2607,0,2611,G
3-PA,1952,0,0,0,2617,2617,C
3-PA,1953,2560,0,2,0,2562,A
3-PA,1954,1,2535,0,1,2537,T
3-PA,1955,1,0,0,2543,2544,C
3-PA,1956,2464,1,0,0,2465,A
3-PA,1957,1,2,0,2502,2505,C
3-PA,1958,3,0,0,2481,2484,C
3-PA,1959,2471,1,2,0,2474,A
3-PA,1960,1,0,0,2498,2499,C
3-PA,1961,2457,0,0,0,2457,A
3-PA,1962,2465,0,0,0,2465,A
3-PA,1963,0,2464,0,1,2465,T
3-PA,1964,0,2468,0,0,2468,T
3-PA,1965,1,0,2453,1,2455,G
3-PA,1966,0,0,2439,0,2439,G
3-PA,1967,2429,1,3,0,2433,A
3-PA,1968,2431,0,5,0,2436,A
3-PA,1969,0,2,2422,0,2424,G
3-PA,1970,1,2,2444,0,2447,G
3-PA,1971,2430,0,1,0,2431,A
3-PA,1972,0,2428,0,2,2430,T
3-PA,1973,0,2430,0,6,2436,T
3-PA,1974,0,2426,2,2,2430,T
3-PA,1975,0,2426,0,1,2427,T
3-PA,1976,2,1,0,2426,2429,C
3-PA,1977,2419,0,4,0,2423,A
3-PA,1978,0,1,2414,0,2415,G
3-PA,1979,2,2,0,2383,2387,C
3-PA,1980,0,0,2378,1,2379,G
3-PA,1981,0,1,2385,0,2386,G
3-PA,1982,2373,0,3,0,2376,A
3-PA,1983,0,0,2422,0,2422,G
3-PA,1984,0,2427,0,1,2428,T
3-PA,1985,5,0,0,2456,2461,C
3-PA,1986,2461,1,2,0,2464,A
3-PA,1987,2467,0,4,1,2472,A
3-PA,1988,0,5,2475,0,2480,G
3-PA,1989,2470,0,0,0,2470,A
3-PA,1990,2459,0,0,0,2459,A
3-PA,1991,2455,1,3,0,2459,A
3-PA,1992,2397,0,3,0,2400,A
3-PA,1993,1,2,0,2398,2401,C
3-PA,1994,0,2341,0,1,2342,T
3-PA,1995,1,0,2368,0,2369,G
3-PA,1996,0,1,0,2361,2362,C
3-PA,1997,1,2346,0,7,2354,T
3-PA,1998,4,3,0,2355,2362,C
3-PA,1999,1,2,0,2353,2356,C
3-PA,2000,0,2390,0,2,2392,T
3-PA,2001,0,2393,0,4,2397,T
3-PA,2002,0,1,2392,0,2393,G
3-PA,2003,0,2388,0,2,2390,T
3-PA,2004,0,2356,0,2,2358,T
3-PA,2005,1,0,2389,0,2390,G
3-PA,2006,0,2368,0,3,2371,T
3-PA,2007,0,2363,2,1,2366,T
3-PA,2008,2,1,0,2362,2365,C
3-PA,2009,2312,0,2,1,2315,A
3-PA,2010,1,1,2337,0,2339,G
3-PA,2011,0,0,2343,0,2343,G
3-PA,2012,1,1,0,2386,2388,C
3-PA,2013,0,2370,1,4,2375,T
3-PA,2014,3,1,0,2493,2497,C
3-PA,2015,0,2471,0,1,2472,T
3-PA,2016,0,2472,0,0,2472,T
3-PA,2017,2470,0,7,0,2477,A
3-PA,2018,1,5,2464,0,2470,G
3-PA,2019,1,3,2425,0,2429,G
3-PA,2020,1,2,2410,1,2414,G
3-PA,2021,2344,0,3,0,2347,A
3-PA,2022,0,1,0,2342,2343,C
3-PA,2023,2179,0,1,0,2180,A
3-PA,2024,2220,0,2,1,2223,A
3-PA,2025,1,0,0,2248,2249,C
3-PA,2026,2,0,0,2232,2234,C
3-PA,2027,0,2229,1,3,2233,T
3-PA,2028,2,2,0,2227,2231,C
3-PA,2029,0,0,2229,0,2229,G
3-PA,2030,2235,0,0,0,2235,A
3-PA,2031,2251,0,2,0,2253,A
3-PA,2032,0,0,0,2255,2255,C
3-PA,2033,2,0,0,2185,2187,C
3-PA,2034,2,2131,0,2,2135,T
3-PA,2035,0,3,2131,0,2134,G
3-PA,2036,3,4,2120,0,2127,G
3-PA,2037,1,1,2128,0,2130,G
3-PA,2038,2131,0,3,0,2134,A
3-PA,2039,1,0,0,2150,2151,C
3-PA,2040,0,0,0,2135,2135,C
3-PA,2041,0,2104,0,3,2107,T
3-PA,2042,0,2106,0,2,2108,T
3-PA,2043,1,2104,0,1,2106,T
3-PA,2044,1,5,2113,0,2119,G
3-PA,2045,2128,0,1,0,2129,A
3-PA,2046,1,2123,0,2,2126,T
3-PA,2047,4,0,0,2141,2145,C
3-PA,2048,1,2073,0,3,2077,T
3-PA,2049,0,2072,0,1,2073,T
3-PA,2050,1,2,2067,0,2070,G
3-PA,2051,1,4,2056,0,2061,G
3-PA,2052,0,4,2064,0,2068,G
3-PA,2053,0,7,2095,0,2102,G
3-PA,2054,2,3,2060,1,2066,G
3-PA,2055,0,0,2085,0,2085,G
3-PA,2056,0,1,0,2086,2087,C
3-PA,2057,0,2084,0,0,2084,T
3-PA,2058,2178,0,1,0,2179,A
3-PA,2059,0,2178,0,0,2178,T
3-PA,2060,2184,0,0,0,2184,A
3-PA,2061,1,2181,0,0,2182,T
3-PA,2062,0,1,2090,0,2091,G
3-PA,2063,2081,0,0,0,2081,A
3-PA,2064,2050,0,1,0,2051,A
3-PA,2065,0,1,2044,0,2045,G
3-PA,2066,0,0,0,2091,2091,C
3-PA,2067,1952,1,0,0,1953,A
3-PA,2068,2038,0,0,1,2039,A
3-PA,2069,0,2033,0,1,2034,T
3-PA,2070,1,2030,0,0,2031,T
3-PA,2071,0,1,2044,0,2045,G
3-PA,2072,2015,0,5,1,2021,A
3-PA,2073,0,0,2020,0,2020,G
3-PA,2074,0,3,2013,1,2017,G
3-PA,2075,1917,1,2,0,1920,A
3-PA,2076,0,2,1951,1,1954,G
3-PA,2077,0,1798,0,2,1800,T
3-PA,2078,0,1,1800,0,1801,G
3-PA,2079,1,2,0,1806,1809,C
3-PA,2080,3,0,0,1802,1805,C
3-PA,2081,1,1800,0,0,1801,T
3-PA,2082,0,1,1828,0,1829,G
3-PA,2083,1828,0,0,0,1828,A
3-PA,2084,0,1839,0,0,1839,T
3-PA,2085,0,1768,0,0,1768,T
3-PA,2086,1762,1,0,0,1763,A
3-PA,2087,1758,0,3,0,1761,A
3-PA,2088,0,1747,0,1,1748,T
3-PA,2089,1,4,1740,0,1745,G
3-PA,2090,1733,1,1,0,1735,A
3-PA,2091,1,1705,0,1,1707,T
3-PA,2092,1,0,0,1706,1707,C
3-PA,2093,3,0,0,1674,1677,C
3-PA,2094,1,1,0,1682,1684,C
3-PA,2095,0,1662,0,5,1667,T
3-PA,2096,0,2,1673,0,1675,G
3-PA,2097,0,2,1679,0,1681,G
3-PA,2098,0,0,1695,0,1695,G
3-PA,2099,0,1673,0,3,1676,T
3-PA,2100,0,1598,0,1,1599,T
3-PA,2101,0,1600,0,0,1600,T
3-PA,2102,0,1589,0,0,1589,T
3-PA,2103,2,1,1595,0,1598,G
3-PA,2104,0,1,1,1596,1598,C
3-PA,2105,0,1572,0,2,1574,T
3-PA,2106,3,1,0,1573,1577,C
3-PA,2107,1521,0,0,0,1521,A
3-PA,2108,1523,0,0,0,1523,A
3-PA,2109,0,1526,0,0,1526,T
3-PA,2110,1,1,1523,0,1525,G
3-PA,2111,1,0,0,1512,1513,C
3-PA,2112,0,0,1480,0,1480,G
3-PA,2113,0,1481,0,3,1484,T
3-PA,2114,1,0,0,1481,1482,C
3-PA,2115,0,1469,0,1,1470,T
3-PA,2116,0,1470,0,1,1471,T
3-PA,2117,1,1,1457,0,1459,G
3-PA,2118,0,1,1460,0,1461,G
3-PA,2119,0,1460,1,2,1463,T
3-PA,2120,1,1443,0,0,1444,T
3-PA,2121,0,0,0,1429,1429,C
3-PA,2122,1417,0,0,0,1417,A
3-PA,2123,1424,0,1,0,1425,A
3-PA,2124,1,1,0,1421,1423,C
3-PA,2125,0,1406,0,1,1407,T
3-PA,2126,3,1,0,1401,1405,C
3-PA,2127,4,4,0,1327,1335,C
3-PA,2128,2,1325,0,3,1330,T
3-PA,2129,0,1327,1,1,1329,T
3-PA,2130,0,0,0,1326,1326,C
3-PA,2131,1,0,0,1324,1325,C
3-PA,2132,0,1286,0,1,1287,T
3-PA,2133,1,1,1281,0,1283,G
3-PA,2134,1280,0,3,0,1283,A
3-PA,2135,0,0,0,1260,1260,C
3-PA,2136,1199,0,0,0,1199,A
3-PA,2137,0,1,0,1148,1149,C
3-PA,2138,1121,0,0,0,1121,A
3-PA,2139,0,1104,0,0,1104,T
3-PA,2140,0,0,1101,0,1101,G
3-PA,2141,0,0,0,1102,1102,C
3-PA,2142,1077,0,0,0,1077,A
3-PA,2143,0,1070,0,1,1071,T
3-PA,2144,0,1053,0,0,1053,T
3-PA,2145,1050,0,1,0,1051,A
3-PA,2146,1033,0,1,0,1034,A
3-PA,2147,1040,0,0,0,1040,A
3-PA,2148,1030,0,2,0,1032,A
3-PA,2149,0,1021,0,0,1021,T
3-PA,2150,795,0,0,0,795,A
3-PA,2151,0,0,791,0,791,G
4-HA,1,1703,0,0,0,1703,A
4-HA,2,0,1712,0,0,1712,T
4-HA,3,0,0,1753,0,1753,G
4-HA,4,1754,0,3,0,1757,A
4-HA,5,1781,1,2,0,1784,A
4-HA,6,1,2,1927,0,1930,G
4-HA,7,1924,1,4,0,1929,A
4-HA,8,0,3,0,2104,2107,C
4-HA,9,0,2121,0,1,2122,T
4-HA,10,2172,0,2,0,2174,A
4-HA,11,0,2287,0,1,2288,T
4-HA,12,1,3,0,2293,2297,C
4-HA,13,2295,0,0,0,2295,A
4-HA,14,0,2302,0,1,2303,T
4-HA,15,0,2309,1,1,2311,T
4-HA,16,2,0,2514,0,2516,G
4-HA,17,0,0,0,2534,2534,C
4-HA,18,0,2538,0,2,2540,T
4-HA,19,0,2542,0,1,2543,T
4-HA,20,0,2546,0,0,2546,T
4-HA,21,2,5,2702,0,2709,G
4-HA,22,2705,1,3,0,2709,A
4-HA,23,0,0,2791,0,2791,G
4-HA,24,0,0,0,2815,2815,C
4-HA,25,1,2812,0,3,2816,T
4-HA,26,3047,0,2,0,3049,A
4-HA,27,1,1,0,3103,3105,C
4-HA,28,3164,0,3,0,3167,A
4-HA,29,0,3397,0,2,3399,T
4-HA,30,0,3366,0,3,3369,T
4-HA,31,1,0,0,3434,3435,C
4-HA,32,0,3418,1,1,3420,T
4-HA,33,3494,0,0,0,3494,A
4-HA,34,0,3501,0,4,3505,T
4-HA,35,0,1,3509,0,3510,G
4-HA,36,0,3503,1,9,3513,T
4-HA,37,2,1,0,3495,3498,C
4-HA,38,2,3472,0,8,3482,T
4-HA,39,2,6,3479,1,3488,G
4-HA,40,0,0,3487,0,3487,G
4-HA,41,0,3470,0,2,3472,T
4-HA,42,0,3466,0,1,3467,T
4-HA,43,0,3463,0,1,3464,T
4-HA,44,0,3468,0,0,3468,T
4-HA,45,3,0,0,3457,3460,C
4-HA,46,1,0,3451,0,3452,G
4-HA,47,1,1,0,3530,3532,C
4-HA,48,0,3484,0,14,3498,T
4-HA,49,3,1,0,3537,3541,C
4-HA,50,3541,0,0,0,3541,A
4-HA,51,3553,0,3,0,3556,A
4-HA,52,3544,0,0,0,3544,A
4-HA,53,3543,0,1,0,3544,A
4-HA,54,3552,0,3,2,3557,A
4-HA,55,2,2,0,3576,3580,C
4-HA,56,0,3554,0,2,3556,T
4-HA,57,0,3578,0,0,3578,T
4-HA,58,2,0,0,3576,3578,C
4-HA,59,0,1,0,3582,3583,C
4-HA,60,0,3572,0,2,3574,T
4-HA,61,2,3,3609,1,3615,G
4-HA,62,0,3,3623,0,3626,G
4-HA,63,3626,2,0,0,3628,A
4-HA,64,3674,0,2,0,3676,A
4-HA,65,3692,0,1,0,3693,A
4-HA,66,0,3738,1,1,3740,T
4-HA,67,1,2,3763,1,3767,G
4-HA,68,3761,0,6,0,3767,A
4-HA,69,0,0,0,3815,3815,C
4-HA,70,3802,0,4,0,3806,A
4-HA,71,3803,0,5,1,3809,A
4-HA,72,1,3,0,3890,3894,C
4-HA,73,3856,0,3,0,3859,A
4-HA,74,0,0,3887,0,3887,G
4-HA,75,1,2,0,3868,3871,C
4-HA,76,3869,0,8,0,3877,A
4-HA,77,0,1,0,4003,4004,C
4-HA,78,3,3,3968,0,3974,G
4-HA,79,2,3,4008,0,4013,G
4-HA,80,0,0,0,4023,4023,C
4-HA,81,3997,0,3,0,4000,A
4-HA,82,4051,0,4,1,4056,A
4-HA,83,1,1,0,4080,4082,C
4-HA,84,3,1,4108,0,4112,G
4-HA,85,0,0,0,4130,4130,C
4-HA,86,0,4063,1,12,4076,T
4-HA,87,1,0,4112,0,4113,G
4-HA,88,1,4094,0,4,4099,T
4-HA,89,0,3,4225,0,4228,G
4-HA,90,0,1,0,4299,4300,C
4-HA,91,4,1,0,4358,4363,C
4-HA,92,0,4318,1,4,4323,T
4-HA,93,0,4302,0,1,4303,T
4-HA,94,1,2,4326,0,4329,G
4-HA,95,0,3,4335,0,4338,G
4-HA,96,1,1,4403,0,4405,G
4-HA,97,1,3,0,4400,4404,C
4-HA,98,4334,0,4,1,4339,A
4-HA,99,1,1,0,4385,4387,C
4-HA,100,3,1,1,4322,4327,C
4-HA,101,4749,2,3,0,4754,A
4-HA,102,0,4761,0,1,4762,T
4-HA,103,1,0,4732,0,4733,G
4-HA,104,1,0,0,4750,4751,C
4-HA,105,4673,0,5,0,4678,A
4-HA,106,2,1,5063,0,5066,G
4-HA,107,0,5067,0,4,5071,T
4-HA,108,5103,2,5,0,5110,A
4-HA,109,0,0,0,5089,5089,C
4-HA,110,3,3,0,4854,4860,C
4-HA,111,4888,0,3,0,4891,A
4-HA,112,4890,0,0,1,4891,A
4-HA,113,4902,0,0,0,4902,A
4-HA,114,1,4,0,4926,4931,C
4-HA,115,6,2,4721,0,4729,G
4-HA,116,0,7,4807,0,4814,G
4-HA,117,4788,2,3,0,4793,A
4-HA,118,4815,1,9,0,4825,A
4-HA,119,0,1,0,4840,4841,C
4-HA,120,1,1,4832,0,4834,G
4-HA,121,4914,1,4,0,4919,A
4-HA,122,1,4921,0,2,4924,T
4-HA,123,4974,0,9,0,4983,A
4-HA,124,2,0,5013,0,5015,G
4-HA,125,1,4933,1,2,4937,T
4-HA,126,1,5,4950,0,4956,G
4-HA,127,4943,0,5,1,4949,A
4-HA,128,4959,1,6,0,4966,A
4-HA,129,4971,0,6,0,4977,A
4-HA,130,4927,2,3,1,4933,A
4-HA,131,0,0,0,4978,4978,C
4-HA,132,4950,0,3,0,4953,A
4-HA,133,4958,2,7,0,4967,A
4-HA,134,0,4950,0,3,4953,T
4-HA,135,4,0,0,4960,4964,C
4-HA,136,4965,1,2,0,4968,A
4-HA,137,0,1,0,5001,5002,C
4-HA,138,3,5,4994,1,5003,G
4-HA,139,4966,1,3,0,4970,A
4-HA,140,4952,0,2,0,4954,A
4-HA,141,0,4957,0,2,4959,T
4-HA,142,2,15,4963,0,4980,G
4-HA,143,5014,2,7,2,5025,A
4-HA,144,3,2,0,5012,5017,C
4-HA,145,12,0,0,5019,5031,C
4-HA,146,5082,0,3,1,5086,A
4-HA,147,5104,0,0,0,5104,A
4-HA,148,5100,1,4,0,5105,A
4-HA,149,1,5108,0,0,5109,T
4-HA,150,0,5100,0,3,5103,T
4-HA,151,0,1,5129,1,5131,G
4-HA,152,5100,0,6,0,5106,A
4-HA,153,5121,0,11,1,5133,A
4-HA,154,0,1,5167,0,5168,G
4-HA,155,0,5109,0,0,5109,T
4-HA,156,0,5305,0,2,5307,T
4-HA,157,5350,1,0,0,5351,A
4-HA,158,2,0,0,5378,5380,C
4-HA,159,1,5390,0,1,5392,T
4-HA,160,5383,0,5,0,5388,A
4-HA,161,5488,1,6,1,5496,A
4-HA,162,0,5495,0,0,5495,T
4-HA,163,0,0,5491,1,5492,G
4-HA,164,0,1,0,5723,5724,C
4-HA,165,1,5658,0,1,5660,T
4-HA,166,5671,0,3,1,5675,A
4-HA,167,1,0,0,5660,5661,C
4-HA,168,1,5634,0,2,5637,T
4-HA,169,1,7,5659,0,5667,G
4-HA,170,5568,1,9,0,5578,A
4-HA,171,1,1,5624,0,5626,G
4-HA,172,0,0,0,5628,5628,C
4-HA,173,1,5466,0,6,5473,T
4-HA,174,4,4,5656,0,5664,G
4-HA,175,0,2,5805,0,5807,G
4-HA,176,1,5799,0,4,5804,T
4-HA,177,1,5810,0,5,5816,T
4-HA,178,6,1,0,5784,5791,C
4-HA,179,5767,1,6,0,5774,A
4-HA,180,2,5,5783,0,5790,G
4-HA,181,5781,1,6,0,5788,A
4-HA,182,1,2,5956,0,5959,G
4-HA,183,0,5867,0,8,5875,T
4-HA,184,1,5779,0,2,5782,T
4-HA,185,9,2,0,5824,5835,C
4-HA,186,3,5,0,5847,5855,C
4-HA,187,1,5798,0,9,5808,T
4-HA,188,2,0,2,5875,5879,C
4-HA,189,5864,1,6,0,5871,A
4-HA,190,5860,0,4,1,5865,A
4-HA,191,0,1,0,5906,5907,C
4-HA,192,5766,2,4,0,5772,A
4-HA,193,2,5,5924,1,5932,G
4-HA,194,0,0,5933,1,5934,G
4-HA,195,0,5903,0,3,5906,T
4-HA,196,3,1,5917,0,5921,G
4-HA,197,5916,0,6,2,5924,A
4-HA,198,5929,0,3,0,5932,A
4-HA,199,6150,0,7,0,6157,A
4-HA,200,0,6126,1,0,6127,T
4-HA,201,6177,1,6,0,6184,A
4-HA,202,1,6086,1,1,6089,T
4-HA,203,1,2,6069,0,6072,G
4-HA,204,1,5,0,6111,6117,C
4-HA,205,5,7,6095,1,6108,G
4-HA,206,6096,1,4,1,6102,A
4-HA,207,0,2,0,6113,6115,C
4-HA,208,5988,0,1,0,5989,A
4-HA,209,2,1,6416,0,6419,G
4-HA,210,0,6373,0,12,6385,T
4-HA,211,5,1,0,6436,6442,C
4-HA,212,11,3,0,6439,6453,C
4-HA,213,1,6392,0,12,6405,T
4-HA,214,5,0,0,6552,6557,C
4-HA,215,6546,2,0,0,6548,A
4-HA,216,0,6537,0,6,6543,T
4-HA,217,2,3,1,6550,6556,C
4-HA,218,6181,0,8,0,6189,A
4-HA,219,3,6,6220,0,6229,G
4-HA,220,6159,1,4,1,6165,A
4-HA,221,1,6157,0,2,6160,T
4-HA,222,2,1,0,6214,6217,C
4-HA,223,6,0,0,6126,6132,C
4-HA,224,0,6135,0,3,6138,T
4-HA,225,0,6133,0,3,6136,T
4-HA,226,3,2,6134,0,6139,G
4-HA,227,6136,3,5,0,6144,A
4-HA,228,0,6113,1,2,6116,T
4-HA,229,1,2,6144,0,6147,G
4-HA,230,1,5,6120,1,6127,G
4-HA,231,6064,0,7,0,6071,A
4-HA,232,1,4,6098,1,6104,G
4-HA,233,6079,1,2,0,6082,A
4-HA,234,6116,1,2,1,6120,A
4-HA,235,6112,0,7,0,6119,A
4-HA,236,6113,2,7,0,6122,A
4-HA,237,2,0,0,6176,6178,C
4-HA,238,1,6078,0,1,6080,T
4-HA,239,3,2,6104,0,6109,G
4-HA,240,1,4,0,6091,6096,C
4-HA,241,6086,1,5,0,6092,A
4-HA,242,0,4,3,6288,6295,C
4-HA,243,6270,2,6,0,6278,A
4-HA,244,1,1,0,7155,7157,C
4-HA,245,3,7128,0,2,7133,T
4-HA,246,7227,0,9,0,7236,A
4-HA,247,7216,0,9,0,7225,A
4-HA,248,2,7262,0,0,7264,T
4-HA,249,7218,1,10,1,7230,A
4-HA,250,0,5,7231,0,7236,G
4-HA,251,7040,0,7,0,7047,A
4-HA,252,0,6915,0,1,6916,T
4-HA,253,0,1,6411,0,6412,G
4-HA,254,0,1,0,6469,6470,C
4-HA,255,1,6404,0,7,6412,T
4-HA,256,9,1,1,6897,6908,C
4-HA,257,0,6884,0,1,6885,T
4-HA,258,7082,0,0,0,7082,A
4-HA,259,0,7075,0,4,7079,T
4-HA,260,1,7023,0,2,7026,T
4-HA,261,5,10,7093,0,7108,G
4-HA,262,1,4,7041,0,7046,G
4-HA,263,1,4,7066,0,7071,G
4-HA,264,6893,0,13,0,6906,A
4-HA,265,3,5,6777,0,6785,G
4-HA,266,6578,1,16,0,6595,A
4-HA,267,3,0,0,7124,7127,C
4-HA,268,7,0,0,7231,7238,C
4-HA,269,16,0,0,7247,7263,C
4-HA,270,0,7215,1,13,7229,T
4-HA,271,3,1,1,7346,7351,C
4-HA,272,7310,0,1,1,7312,A
4-HA,273,3,2,7824,0,7829,G
4-HA,274,0,7797,0,11,7808,T
4-HA,275,4,2,7863,0,7869,G
4-HA,276,2,7566,1,6,7575,T
4-HA,277,2,9,7518,1,7530,G
4-HA,278,7509,3,8,0,7520,A
4-HA,279,1,7499,0,7,7507,T
4-HA,280,2,7,7406,2,7417,G
4-HA,281,4,0,7417,1,7422,G
4-HA,282,0,5,0,7292,7297,C
4-HA,283,3,7288,0,11,7302,T
4-HA,284,1,7261,0,6,7268,T
4-HA,285,4,1,0,7278,7283,C
4-HA,286,4,6,1,7273,7284,C
4-HA,287,7297,3,2,1,7303,A
4-HA,288,7315,1,4,0,7320,A
4-HA,289,7323,0,0,1,7324,A
4-HA,290,7375,1,0,0,7376,A
4-HA,291,0,7402,0,0,7402,T
4-HA,292,7394,0,2,0,7396,A
4-HA,293,7381,0,8,0,7389,A
4-HA,294,3,6,7432,1,7442,G
4-HA,295,7491,1,2,1,7495,A
4-HA,296,7523,0,5,0,7528,A
4-HA,297,7514,0,4,0,7518,A
4-HA,298,1,7509,1,2,7513,T
4-HA,299,1,15,7489,1,7506,G
4-HA,300,1,7,7462,1,7471,G
4-HA,301,5,11,7443,0,7459,G
4-HA,302,7452,0,11,0,7463,A
4-HA,303,1,2,0,7527,7530,C
4-HA,304,6,1,0,7525,7532,C
4-HA,305,0,7614,0,20,7634,T
4-HA,306,0,7637,0,4,7641,T
4-HA,307,0,7639,1,2,7642,T
4-HA,308,0,7684,0,1,7685,T
4-HA,309,1,7670,0,3,7674,T
4-HA,310,2,2,7726,1,7731,G
4-HA,311,0,7713,1,7,7721,T
4-HA,312,0,7639,1,9,7649,T
4-HA,313,9,8,7651,0,7668,G
4-HA,314,7547,0,11,1,7559,A
4-HA,315,7595,0,8,0,7603,A
4-HA,316,0,4,0,7611,7615,C
4-HA,317,5,1,7563,0,7569,G
4-HA,318,3,5,0,7671,7679,C
4-HA,319,7651,0,12,1,7664,A
4-HA,320,8,0,7694,0,7702,G
4-HA,321,0,2,0,7714,7716,C
4-HA,322,7688,1,6,0,7695,A
4-HA,323,7696,0,4,2,7702,A
4-HA,324,7665,1,13,0,7679,A
4-HA,325,2,3,7990,0,7995,G
4-HA,326,4,1,0,7990,7995,C
4-HA,327,6,2,0,7954,7962,C
4-HA,328,0,7952,1,7,7960,T
4-HA,329,7937,2,8,0,7947,A
4-HA,330,3,3,0,8013,8019,C
4-HA,331,7999,0,7,0,8006,A
4-HA,332,6,1,8019,0,8026,G
4-HA,333,1,3,0,7945,7949,C
4-HA,334,7744,0,2,1,7747,A
4-HA,335,7815,0,3,0,7818,A
4-HA,336,2,0,0,8185,8187,C
4-HA,337,0,8163,0,3,8166,T
4-HA,338,6,2,8176,0,8184,G
4-HA,339,0,8080,0,15,8095,T
4-HA,340,1,8082,1,5,8089,T
4-HA,341,8117,1,4,0,8122,A
4-HA,342,1,2,0,8714,8717,C
4-HA,343,6,0,0,8736,8742,C
4-HA,344,18,2,0,8909,8929,C
4-HA,345,1,8490,1,13,8505,T
4-HA,346,0,8492,0,6,8498,T
4-HA,347,8538,0,0,0,8538,A
4-HA,348,0,8515,1,2,8518,T
4-HA,349,1,2,8512,0,8515,G
4-HA,350,8462,0,17,0,8479,A
4-HA,351,0,7700,0,3,7703,T
4-HA,352,0,1,7808,0,7809,G
4-HA,353,0,7567,1,1,7569,T
4-HA,354,0,1,7559,0,7560,G
4-HA,355,3,6,0,7553,7562,C
4-HA,356,7,2,0,7545,7554,C
4-HA,357,2,4,7692,0,7698,G
4-HA,358,4,2,7783,0,7789,G
4-HA,359,7777,1,3,1,7782,A
4-HA,360,0,7785,1,1,7787,T
4-HA,361,0,7639,0,4,7643,T
4-HA,362,7690,2,5,0,7697,A
4-HA,363,2,7670,0,4,7676,T
4-HA,364,3,1,7670,0,7674,G
4-HA,365,3,5,0,7662,7670,C
4-HA,366,5,2,0,7572,7579,C
4-HA,367,4,7552,0,5,7561,T
4-HA,368,12,1,0,8017,8030,C
4-HA,369,5,2,0,8097,8104,C
4-HA,370,20,0,0,8121,8141,C
4-HA,371,1,8072,0,9,8082,T
4-HA,372,0,8095,0,4,8099,T
4-HA,373,8065,0,3,1,8069,A
4-HA,374,0,4,8299,0,8303,G
4-HA,375,2,5,8299,0,8306,G
4-HA,376,0,8152,0,9,8161,T
4-HA,377,10,3,0,7883,7896,C
4-HA,378,7801,1,12,1,7815,A
4-HA,379,6,2,0,8023,8031,C
4-HA,380,0,8029,0,2,8031,T
4-HA,381,8010,0,3,0,8013,A
4-HA,382,8,1,8009,0,8018,G
4-HA,383,0,7858,0,3,7861,T
4-HA,384,1,7795,1,5,7802,T
4-HA,385,1,2,7899,1,7903,G
4-HA,386,2,2,0,7893,7897,C
4-HA,387,3,0,0,7904,7907,C
4-HA,388,2,7758,2,30,7792,T
4-HA,389,4,1,0,7837,7842,C
4-HA,390,8085,0,3,0,8088,A
4-HA,391,1,8082,1,4,8088,T
4-HA,392,3,3,0,8097,8103,C
4-HA,393,6,10,1,8071,8088,C
4-HA,394,7,10,8008,0,8025,G
4-HA,395,7,2,8060,0,8069,G
4-HA,396,0,7,0,8090,8097,C
4-HA,397,8164,1,9,0,8174,A
4-HA,398,4,0,1,8295,8300,C
4-HA,399,8061,1,9,0,8071,A
4-HA,400,1,4,0,8124,8129,C
4-HA,401,0,8113,0,17,8130,T
4-HA,402,5,4,8200,0,8209,G
4-HA,403,3,4,8302,0,8309,G
4-HA,404,8202,1,15,1,8219,A
4-HA,405,4,1,8330,0,8335,G
4-HA,406,0,8214,1,1,8216,T
4-HA,407,0,8150,0,4,8154,T
4-HA,408,0,8156,0,1,8157,T
4-HA,409,8117,1,5,0,8123,A
4-HA,410,8140,0,12,0,8152,A
4-HA,411,2,1,0,8195,8198,C
4-HA,412,8015,1,0,0,8016,A
4-HA,413,8031,1,10,0,8042,A
4-HA,414,1,7975,0,0,7976,T
4-HA,415,1,4,7958,0,7963,G
4-HA,416,7942,1,10,1,7954,A
4-HA,417,7909,1,15,1,7926,A
4-HA,418,7947,2,12,2,7963,A
4-HA,419,0,2,7991,0,7993,G
4-HA,420,1,2,1,8057,8061,C
4-HA,421,1,8014,2,12,8029,T
4-HA,422,1,8024,0,3,8028,T
4-HA,423,8,3,0,8108,8119,C
4-HA,424,8134,1,6,0,8141,A
4-HA,425,8143,1,1,1,8146,A
4-HA,426,1,8144,1,5,8151,T
4-HA,427,1,8128,0,6,8135,T
4-HA,428,1,8,8312,1,8322,G
4-HA,429,0,8,8389,2,8399,G
4-HA,430,8390,1,12,0,8403,A
4-HA,431,5,9,0,8403,8417,C
4-HA,432,2,8315,1,11,8329,T
4-HA,433,3,3,8342,0,8348,G
4-HA,434,2,6,8367,1,8376,G
4-HA,435,8333,0,9,1,8343,A
4-HA,436,6,1,8382,0,8389,G
4-HA,437,0,8154,1,15,8170,T
4-HA,438,11,3,0,8053,8067,C
4-HA,439,8175,1,4,1,8181,A
4-HA,440,2,0,0,8217,8219,C
4-HA,441,1,8164,0,9,8174,T
4-HA,442,7,3,1,8189,8200,C
4-HA,443,8087,0,1,1,8089,A
4-HA,444,8151,1,2,0,8154,A
4-HA,445,8111,1,5,0,8117,A
4-HA,446,8130,0,10,1,8141,A
4-HA,447,0,5,1,8185,8191,C
4-HA,448,1,7,8071,0,8079,G
4-HA,449,3,5,8229,0,8237,G
4-HA,450,8200,0,10,0,8210,A
4-HA,451,8195,1,13,0,8209,A
4-HA,452,0,4,0,8231,8235,C
4-HA,453,8167,0,9,1,8177,A
4-HA,454,8258,1,10,1,8270,A
4-HA,455,0,2,8346,0,8348,G
4-HA,456,0,1,0,8351,8352,C
4-HA,457,1,8253,1,21,8276,T
4-HA,458,8,2,0,8336,8346,C
4-HA,459,0,8245,0,14,8259,T
4-HA,460,3,0,8270,0,8273,G
4-HA,461,1,0,0,8289,8290,C
4-HA,462,2,8253,0,20,8275,T
4-HA,463,3,8202,0,6,8211,T
4-HA,464,1,2,8345,0,8348,G
4-HA,465,2,3,0,8340,8345,C
4-HA,466,8336,2,5,0,8343,A
4-HA,467,0,8247,0,4,8251,T
4-HA,468,8209,0,3,0,8212,A
4-HA,469,8210,0,13,3,8226,A
4-HA,470,0,5,8230,0,8235,G
4-HA,471,0,5,8220,3,8228,G
4-HA,472,8146,2,4,0,8152,A
4-HA,473,7864,2,11,0,7877,A
4-HA,474,7946,1,11,2,7960,A
4-HA,475,0,8345,2,4,8351,T
4-HA,476,11,0,0,8456,8467,C
4-HA,477,1,8484,0,1,8486,T
4-HA,478,8473,0,3,0,8476,A
4-HA,479,8453,0,4,2,8459,A
4-HA,480,1,8458,0,1,8460,T
4-HA,481,8446,1,7,0,8454,A
4-HA,482,8450,3,6,0,8459,A
4-HA,483,0,3,0,8530,8533,C
4-HA,484,8117,0,1,1,8119,A
4-HA,485,3,0,8182,0,8185,G
4-HA,486,1,8075,2,2,8080,T
4-HA,487,1,8266,0,8,8275,T
4-HA,488,0,8279,1,0,8280,T
4-HA,489,1,4,0,8559,8564,C
4-HA,490,0,8543,0,10,8553,T
4-HA,491,0,8600,1,2,8603,T
4-HA,492,1,8596,0,4,8601,T
4-HA,493,8538,0,2,0,8540,A
4-HA,494,3,2,8553,0,8558,G
4-HA,495,1,8513,0,2,8516,T
4-HA,496,8458,1,5,4,8468,A
4-HA,497,1,4,8491,0,8496,G
4-HA,498,8228,0,5,1,8234,A
4-HA,499,0,8249,0,5,8254,T
4-HA,500,2,8201,0,3,8206,T
4-HA,501,1,9,8396,0,8406,G
4-HA,502,8399,0,6,0,8405,A
4-HA,503,8399,2,4,0,8405,A
4-HA,504,1,8411,0,3,8415,T
4-HA,505,2,8275,0,3,8280,T
4-HA,506,1,10,8380,2,8393,G
4-HA,507,5,1,8391,0,8397,G
4-HA,508,1,8401,1,13,8416,T
4-HA,509,2,8356,0,11,8369,T
4-HA,510,2,9,8212,0,8223,G
4-HA,511,8214,0,11,1,8226,A
4-HA,512,0,3,1,8213,8217,C
4-HA,513,10,1,1,8179,8191,C
4-HA,514,19,4,0,8170,8193,C
4-HA,515,8155,0,7,2,8164,A
4-HA,516,0,6,0,8275,8281,C
4-HA,517,0,8270,2,3,8275,T
4-HA,518,0,8265,0,3,8268,T
4-HA,519,8287,0,1,0,8288,A
4-HA,520,8246,1,2,0,8249,A
4-HA,521,8242,0,1,1,8244,A
4-HA,522,8324,1,4,0,8329,A
4-HA,523,1,8492,0,3,8496,T
4-HA,524,0,8440,0,5,8445,T
4-HA,525,10,2,0,8465,8477,C
4-HA,526,8445,1,5,1,8452,A
4-HA,527,8454,1,4,0,8459,A
4-HA,528,8476,2,2,0,8480,A
4-HA,529,1,8476,0,1,8478,T
4-HA,530,8718,1,0,1,8720,A
4-HA,531,4,1,0,8719,8724,C
4-HA,532,7,4,0,8500,8511,C
4-HA,533,16,1,0,8496,8513,C
4-HA,534,8462,3,10,1,8476,A
4-HA,535,4,1,8912,0,8917,G
4-HA,536,5,2,0,8943,8950,C
4-HA,537,8918,0,6,0,8924,A
4-HA,538,0,8894,1,9,8904,T
4-HA,539,1,8702,0,6,8709,T
4-HA,540,5,17,9007,0,9029,G
4-HA,541,9043,1,10,0,9054,A
4-HA,542,9040,1,13,1,9055,A
4-HA,543,1,6,0,9058,9065,C
4-HA,544,4,3,8776,0,8783,G
4-HA,545,0,8815,2,7,8824,T
4-HA,546,3,8,8846,0,8857,G
4-HA,547,8848,0,13,0,8861,A
4-HA,548,2,2,0,8882,8886,C
4-HA,549,0,8521,0,10,8531,T
4-HA,550,8785,1,2,0,8788,A
4-HA,551,0,8779,0,7,8786,T
4-HA,552,7,1,8829,0,8837,G
4-HA,553,3,5,0,8820,8828,C
4-HA,554,5,3,0,8651,8659,C
4-HA,555,8647,0,5,1,8653,A
4-HA,556,8651,0,1,0,8652,A
4-HA,557,8800,1,10,2,8813,A
4-HA,558,1,1,0,8855,8857,C
4-HA,559,8585,1,1,0,8587,A
4-HA,560,8622,0,6,0,8628,A
4-HA,561,1,8520,1,4,8526,T
4-HA,562,4,18,8517,1,8540,G
4-HA,563,8519,2,8,0,8529,A
4-HA,564,8531,2,10,1,8544,A
4-HA,565,0,2,0,8285,8287,C
4-HA,566,8339,0,4,2,8345,A
4-HA,567,8397,0,4,0,8401,A
4-HA,568,2,8378,2,1,8383,T
4-HA,569,0,8384,0,1,8385,T
4-HA,570,1,8413,0,2,8416,T
4-HA,571,2,10,8381,0,8393,G
4-HA,572,8397,3,9,0,8409,A
4-HA,573,2,2,2,8402,8408,C
4-HA,574,8394,0,4,0,8398,A
4-HA,575,8403,0,3,0,8406,A
4-HA,576,8525,1,3,0,8529,A
4-HA,577,0,8598,0,2,8600,T
4-HA,578,0,8528,0,3,8531,T
4-HA,579,3,1,8649,0,8653,G
4-HA,580,4,8625,0,6,8635,T
4-HA,581,8658,2,7,0,8667,A
4-HA,582,1,2,0,8852,8855,C
4-HA,583,8823,1,2,1,8827,A
4-HA,584,0,8961,1,1,8963,T
4-HA,585,0,8789,0,9,8798,T
4-HA,586,0,8752,2,0,8754,T
4-HA,587,3,12,8691,0,8706,G
4-HA,588,0,15,8663,1,8679,G
4-HA,589,3,16,8672,0,8691,G
4-HA,590,3,17,8687,0,8707,G
4-HA,591,2,11,8556,0,8569,G
4-HA,592,4,2,8772,3,8781,G
4-HA,593,2,8651,1,14,8668,T
4-HA,594,1,8691,0,8,8700,T
4-HA,595,6,3,0,8678,8687,C
4-HA,596,8707,0,15,0,8722,A
4-HA,597,4,3,1,8755,8763,C
4-HA,598,4,0,1,8747,8752,C
4-HA,599,8756,1,6,1,8764,A
4-HA,600,0,2,0,8817,8819,C
4-HA,601,3,3,0,8687,8693,C
4-HA,602,12,3,0,8612,8627,C
4-HA,603,6,8,8632,1,8647,G
4-HA,604,2,6,9096,0,9104,G
4-HA,605,3,1,9096,0,9100,G
4-HA,606,0,9050,0,4,9054,T
4-HA,607,9057,0,5,0,9062,A
4-HA,608,1,6,0,9002,9009,C
4-HA,609,10,14,8886,1,8911,G
4-HA,610,1,7,9020,1,9029,G
4-HA,611,9050,0,7,0,9057,A
4-HA,612,0,3,0,9036,9039,C
4-HA,613,8502,0,3,0,8505,A
4-HA,614,8512,0,5,1,8518,A
4-HA,615,1,8523,0,4,8528,T
4-HA,616,0,12,8630,0,8642,G
4-HA,617,8629,2,13,1,8645,A
4-HA,618,3,3,0,8625,8631,C
4-HA,619,4,2,0,8518,8524,C
4-HA,620,8520,1,2,0,8523,A
4-HA,621,8500,2,5,0,8507,A
4-HA,622,8627,1,4,0,8632,A
4-HA,623,0,8615,0,2,8617,T
4-HA,624,2,1,0,8729,8732,C
4-HA,625,0,8116,1,15,8132,T
4-HA,626,0,8081,2,3,8086,T
4-HA,627,5,0,0,8182,8187,C
4-HA,628,7,6,0,8203,8216,C
4-HA,629,1,8144,1,7,8153,T
4-HA,630,6,3,8247,0,8256,G
4-HA,631,1,8083,0,5,8089,T
4-HA,632,8171,0,4,0,8175,A
4-HA,633,1,8092,1,6,8100,T
4-HA,634,4,1,8164,0,8169,G
4-HA,635,1,3,0,8210,8214,C
4-HA,636,1,8104,0,9,8114,T
4-HA,637,12,7,0,8127,8146,C
4-HA,638,8138,3,13,0,8154,A
4-HA,639,8110,2,6,2,8120,A
4-HA,640,3,2,8172,0,8177,G
4-HA,641,1,4,0,8197,8202,C
4-HA,642,8204,0,3,0,8207,A
4-HA,643,0,8097,0,3,8100,T
4-HA,644,10,2,0,8085,8097,C
4-HA,645,8069,1,8,0,8078,A
4-HA,646,1,5,8157,0,8163,G
4-HA,647,0,6,8151,0,8157,G
4-HA,648,8159,3,1,0,8163,A
4-HA,649,8084,0,12,0,8096,A
4-HA,650,0,5,8203,0,8208,G
4-HA,651,8158,1,5,0,8164,A
4-HA,652,8285,1,8,0,8294,A
4-HA,653,2,8364,0,8,8374,T
4-HA,654,10,1,0,8367,8378,C
4-HA,655,8296,0,6,1,8303,A
4-HA,656,0,4,0,8306,8310,C
4-HA,657,8258,0,20,0,8278,A
4-HA,658,3,1,8463,0,8467,G
4-HA,659,1,8279,0,7,8287,T
4-HA,660,9,2,0,8350,8361,C
4-HA,661,1,8152,2,12,8167,T
4-HA,662,10,0,0,8511,8521,C
4-HA,663,0,8532,0,6,8538,T
4-HA,664,8644,0,3,0,8647,A
4-HA,665,2,0,0,8617,8619,C
4-HA,666,4,4,0,8611,8619,C
4-HA,667,8442,0,3,3,8448,A
4-HA,668,8465,1,4,0,8470,A
4-HA,669,8412,0,3,2,8417,A
4-HA,670,8421,1,3,0,8425,A
4-HA,671,4,0,8412,0,8416,G
4-HA,672,8204,0,4,1,8209,A
4-HA,673,8166,2,9,1,8178,A
4-HA,674,9,1,8195,0,8205,G
4-HA,675,2,2,0,8205,8209,C
4-HA,676,6,8,0,8218,8232,C
4-HA,677,8230,0,8,1,8239,A
4-HA,678,8273,4,8,1,8286,A
4-HA,679,2,1,0,8273,8276,C
4-HA,680,8255,4,1,0,8260,A
4-HA,681,8263,2,0,5,8270,A
4-HA,682,8250,1,11,0,8262,A
4-HA,683,0,1,0,8504,8505,C
4-HA,684,0,8394,0,9,8403,T
4-HA,685,3,0,8456,0,8459,G
4-HA,686,0,8434,0,3,8437,T
4-HA,687,8441,0,5,1,8447,A
4-HA,688,8460,0,9,0,8469,A
4-HA,689,0,8375,0,5,8380,T
4-HA,690,6,2,0,8506,8514,C
4-HA,691,1,5,1,8492,8499,C
4-HA,692,8,6,0,8312,8326,C
4-HA,693,2,5,8335,0,8342,G
4-HA,694,8298,0,2,0,8300,A
4-HA,695,8321,0,0,0,8321,A
4-HA,696,1,8343,0,0,8344,T
4-HA,697,8337,1,0,0,8338,A
4-HA,698,0,8293,0,4,8297,T
4-HA,699,6,7,0,8233,8246,C
4-HA,700,6,6,8213,0,8225,G
4-HA,701,0,0,8499,0,8499,G
4-HA,702,8507,4,5,0,8516,A
4-HA,703,0,8591,0,2,8593,T
4-HA,704,47,2,2,8555,8606,C
4-HA,705,0,8589,0,14,8603,T
4-HA,706,8568,1,10,0,8579,A
4-HA,707,3,12,8606,0,8621,G
4-HA,708,8660,1,15,0,8676,A
4-HA,709,2,3,0,8629,8634,C
4-HA,710,8,2,2,8347,8359,C
4-HA,711,13,2,0,8334,8349,C
4-HA,712,8286,2,8,1,8297,A
4-HA,713,2,6,8915,0,8923,G
4-HA,714,8896,2,10,2,8910,A
4-HA,715,3,1,9052,1,9057,G
4-HA,716,0,8988,0,0,8988,T
4-HA,717,8937,0,2,0,8939,A
4-HA,718,8916,0,18,2,8936,A
4-HA,719,3,12,9121,0,9136,G
4-HA,720,2,9,9216,0,9227,G
4-HA,721,9084,3,2,0,9089,A
4-HA,722,8306,1,11,1,8319,A
4-HA,723,0,8275,0,2,8277,T
4-HA,724,8154,0,154,0,8308,A
4-HA,725,1,8250,2,15,8268,T
4-HA,726,3,4,0,8381,8388,C
4-HA,727,12,5,0,8350,8367,C
4-HA,728,13,0,0,8157,8170,C
4-HA,729,1,8040,1,4,8046,T
4-HA,730,8097,0,1,0,8098,A
4-HA,731,2,0,8117,1,8120,G
4-HA,732,8,2,0,8129,8139,C
4-HA,733,7904,0,5,0,7909,A
4-HA,734,3,8,8143,0,8154,G
4-HA,735,8021,0,3,0,8024,A
4-HA,736,8041,2,3,0,8046,A
4-HA,737,0,8033,1,2,8036,T
4-HA,738,8009,0,5,1,8015,A
4-HA,739,8038,0,14,1,8053,A
4-HA,740,5,0,8064,0,8069,G
4-HA,741,1,2,0,8098,8101,C
4-HA,742,8101,1,2,0,8104,A
4-HA,743,1,7831,1,14,7847,T
4-HA,744,2,3,0,8396,8401,C
4-HA,745,0,8383,0,3,8386,T
4-HA,746,8428,3,2,0,8433,A
4-HA,747,0,8408,1,6,8415,T
4-HA,748,2,8330,1,2,8335,T
4-HA,749,3,13,8406,0,8422,G
4-HA,750,1,6,8363,1,8371,G
4-HA,751,8352,1,11,0,8364,A
4-HA,752,2,1,0,8342,8345,C
4-HA,753,7622,1,1,0,7624,A
4-HA,754,7844,0,1,0,7845,A
4-HA,755,0,8303,1,3,8307,T
4-HA,756,8396,1,6,0,8403,A
4-HA,757,1,0,8494,0,8495,G
4-HA,758,1,8376,0,4,8381,T
4-HA,759,8369,1,1,1,8372,A
4-HA,760,8366,0,4,3,8373,A
4-HA,761,8434,2,1,1,8438,A
4-HA,762,8496,1,11,1,8509,A
4-HA,763,0,4,0,8587,8591,C
4-HA,764,5,1,0,8107,8113,C
4-HA,765,3,10,8063,2,8078,G
4-HA,766,4,11,8098,1,8114,G
4-HA,767,1,11,8218,1,8231,G
4-HA,768,8189,0,4,0,8193,A
4-HA,769,0,9,8298,0,8307,G
4-HA,770,8371,1,15,0,8387,A
4-HA,771,0,2,0,8383,8385,C
4-HA,772,8343,0,8,12,8363,A
4-HA,773,1,8369,0,3,8373,T
4-HA,774,8405,1,5,1,8412,A
4-HA,775,0,3,0,8572,8575,C
4-HA,776,1,8470,0,9,8480,T
4-HA,777,0,8544,2,4,8550,T
4-HA,778,0,8578,0,7,8585,T
4-HA,779,0,8538,1,2,8541,T
4-HA,780,2,13,8625,0,8640,G
4-HA,781,8632,0,9,2,8643,A
4-HA,782,0,8633,1,9,8643,T
4-HA,783,2,8814,0,4,8820,T
4-HA,784,8745,1,0,0,8746,A
4-HA,785,8780,3,1,0,8784,A
4-HA,786,1,1,1,8874,8877,C
4-HA,787,8824,2,8,0,8834,A
4-HA,788,7,2,9204,1,9214,G
4-HA,789,0,4,0,9158,9162,C
4-HA,790,9159,0,3,1,9163,A
4-HA,791,0,4,0,9226,9230,C
4-HA,792,9102,3,20,3,9128,A
4-HA,793,2,15,9256,0,9273,G
4-HA,794,0,5,9225,0,9230,G
4-HA,795,2,7,9568,1,9578,G
4-HA,796,9488,2,8,0,9498,A
4-HA,797,9499,1,19,0,9519,A
4-HA,798,0,9497,0,5,9502,T
4-HA,799,7,0,0,9561,9568,C
4-HA,800,1,9607,0,6,9614,T
4-HA,801,9632,0,0,2,9634,A
4-HA,802,9569,0,5,0,9574,A
4-HA,803,1,9548,0,2,9551,T
4-HA,804,0,9180,0,9,9189,T
4-HA,805,5,0,9263,0,9268,G
4-HA,806,4,2,0,9499,9505,C
4-HA,807,1,9714,1,12,9728,T
4-HA,808,20,2,1,10027,10050,C
4-HA,809,4,1,0,10034,10039,C
4-HA,810,1,10012,0,6,10019,T
4-HA,811,10058,1,3,0,10062,A
4-HA,812,1,23,10036,1,10061,G
4-HA,813,1,23,10138,0,10162,G
4-HA,814,2,5,10144,0,10151,G
4-HA,815,6,3,10024,0,10033,G
4-HA,816,0,9739,0,3,9742,T
4-HA,817,0,9629,1,5,9635,T
4-HA,818,9651,1,4,0,9656,A
4-HA,819,1,2,0,9807,9810,C
4-HA,820,1,9770,1,11,9783,T
4-HA,821,1,9809,0,8,9818,T
4-HA,822,8,3,1,9796,9808,C
4-HA,823,9725,1,6,1,9733,A
4-HA,824,9741,0,5,0,9746,A
4-HA,825,9743,0,7,1,9751,A
4-HA,826,9837,0,4,0,9841,A
4-HA,827,1,9827,1,0,9829,T
4-HA,828,9718,1,4,1,9724,A
4-HA,829,0,3,1,9718,9722,C
4-HA,830,7,6,9672,1,9686,G
4-HA,831,9669,1,5,1,9676,A
4-HA,832,9688,0,9,0,9697,A
4-HA,833,1,1,9850,0,9852,G
4-HA,834,0,9810,0,9,9819,T
4-HA,835,1,9,9872,1,9883,G
4-HA,836,2,5,9898,0,9905,G
4-HA,837,2,8,9939,0,9949,G
4-HA,838,9932,0,14,0,9946,A
4-HA,839,9934,1,6,0,9941,A
4-HA,840,9948,0,6,0,9954,A
4-HA,841,9894,0,19,0,9913,A
4-HA,842,0,1,10159,1,10161,G
4-HA,843,1,6,0,10128,10135,C
4-HA,844,2,9973,0,16,9991,T
4-HA,845,18,3,0,10126,10147,C
4-HA,846,10169,0,11,0,10180,A
4-HA,847,10291,1,4,1,10297,A
4-HA,848,2,10285,1,2,10290,T
4-HA,849,10392,1,1,0,10394,A
4-HA,850,10395,1,5,0,10401,A
4-HA,851,2,10106,0,7,10115,T
4-HA,852,3,12,10111,0,10126,G
4-HA,853,9971,2,14,1,9988,A
4-HA,854,2,6,10301,0,10309,G
4-HA,855,10292,2,6,1,10301,A
4-HA,856,3,10161,1,10,10175,T
4-HA,857,16,4,1,10408,10429,C
4-HA,858,10369,1,9,0,10379,A
4-HA,859,1,3,10576,1,10581,G
4-HA,860,10559,2,7,0,10568,A
4-HA,861,3,10547,0,7,10557,T
4-HA,862,9,1,10530,0,10540,G
4-HA,863,2,7,0,10303,10312,C
4-HA,864,10327,2,15,0,10344,A
4-HA,865,2,3,21,10530,10556,C
4-HA,866,11,2,0,10384,10397,C
4-HA,867,20,2,1,10398,10421,C
4-HA,868,10230,2,3,2,10237,A
4-HA,869,0,10203,0,3,10206,T
4-HA,870,1,10222,0,7,10230,T
4-HA,871,2,10,10327,0,10339,G
4-HA,872,5,2,10296,1,10304,G
4-HA,873,2,2,0,10310,10314,C
4-HA,874,10087,0,2,0,10089,A
4-HA,875,10044,1,9,0,10054,A
4-HA,876,10255,0,2,1,10258,A
4-HA,877,0,10272,0,2,10274,T
4-HA,878,5,1,10263,0,10269,G
4-HA,879,7,0,0,10251,10258,C
4-HA,880,10106,0,6,0,10112,A
4-HA,881,10432,0,3,0,10435,A
4-HA,882,1,10415,0,7,10423,T
4-HA,883,2,10507,1,2,10512,T
4-HA,884,9,3,0,10534,10546,C
4-HA,885,1,10282,0,11,10294,T
4-HA,886,1,7,10415,1,10424,G
4-HA,887,10383,2,6,0,10391,A
4-HA,888,10439,1,2,0,10442,A
4-HA,889,0,10439,0,8,10447,T
4-HA,890,2,1,10235,0,10238,G
4-HA,891,2,5,0,10262,10269,C
4-HA,892,10248,1,2,1,10252,A
4-HA,893,0,10222,1,12,10235,T
4-HA,894,5,3,0,10247,10255,C
4-HA,895,10190,3,6,0,10199,A
4-HA,896,1,0,0,10678,10679,C
4-HA,897,2,10584,1,17,10604,T
4-HA,898,9,0,0,10649,10658,C
4-HA,899,7,0,0,10616,10623,C
4-HA,900,10714,2,2,0,10718,A
4-HA,901,10694,0,3,1,10698,A
4-HA,902,10666,1,10,1,10678,A
4-HA,903,2,10161,0,2,10165,T
4-HA,904,3,5,10244,0,10252,G
4-HA,905,1,4,10262,0,10267,G
4-HA,906,10286,3,8,0,10297,A
4-HA,907,10225,1,33,0,10259,A
4-HA,908,4,0,10277,0,10281,G
4-HA,909,2,4,1,10137,10144,C
4-HA,910,10110,2,3,0,10115,A
4-HA,911,1,10131,0,6,10138,T
4-HA,912,2,10089,0,5,10096,T
4-HA,913,7,4,1,10458,10470,C
4-HA,914,4,3,0,10422,10429,C
4-HA,915,16,1,0,10409,10426,C
4-HA,916,10436,1,7,0,10444,A
4-HA,917,10573,0,3,18,10594,A
4-HA,918,1,10754,0,11,10766,T
4-HA,919,3,16,10733,0,10752,G
4-HA,920,10722,2,11,2,10737,A
4-HA,921,0,7,0,10723,10730,C
4-HA,922,10356,0,3,0,10359,A
4-HA,923,10373,2,4,0,10379,A
4-HA,924,10356,3,11,4,10374,A
4-HA,925,1,0,0,10447,10448,C
4-HA,926,5,4,0,10290,10299,C
4-HA,927,10052,0,2,0,10054,A
4-HA,928,1,10051,1,13,10066,T
4-HA,929,5,10032,0,9,10046,T
4-HA,930,9,2,0,10101,10112,C
4-HA,931,4,1,0,10119,10124,C
4-HA,932,10096,0,3,0,10099,A
4-HA,933,10097,0,1,0,10098,A
4-HA,934,10050,0,6,1,10057,A
4-HA,935,10277,2,2,1,10282,A
4-HA,936,0,10185,1,5,10191,T
4-HA,937,2,0,10260,1,10263,G
4-HA,938,1,10206,0,3,10210,T
4-HA,939,10254,0,7,0,10261,A
4-HA,940,10234,0,8,0,10242,A
4-HA,941,10241,1,8,0,10250,A
4-HA,942,0,3,0,10294,10297,C
4-HA,943,10042,2,8,0,10052,A
4-HA,944,2,9,10166,1,10178,G
4-HA,945,1,6,10181,1,10189,G
4-HA,946,10321,1,25,1,10348,A
4-HA,947,1,10319,0,14,10334,T
4-HA,948,8,2,0,10378,10388,C
4-HA,949,10435,3,21,0,10459,A
4-HA,950,1,3,0,10794,10798,C
4-HA,951,10750,1,6,1,10758,A
4-HA,952,1,11034,0,2,11037,T
4-HA,953,10666,2,5,0,10673,A
4-HA,954,4,2,0,10578,10584,C
4-HA,955,10,9,10212,0,10231,G
4-HA,956,4,10,10266,0,10280,G
4-HA,957,4,10,10151,0,10165,G
4-HA,958,9,3,10171,1,10184,G
4-HA,959,2,1,0,9878,9881,C
4-HA,960,8,7,1,9826,9842,C
4-HA,961,1,9537,2,20,9560,T
4-HA,962,2,1,10431,0,10434,G
4-HA,963,2,10415,1,25,10443,T
4-HA,964,9,0,0,10509,10518,C
4-HA,965,8,6,2,10479,10495,C
4-HA,966,15,8,0,10458,10481,C
4-HA,967,10389,3,9,2,10403,A
4-HA,968,1,1,10510,0,10512,G
4-HA,969,10452,0,6,0,10458,A
4-HA,970,1,10430,0,1,10432,T
4-HA,971,9249,0,5,0,9254,A
4-HA,972,0,9027,1,6,9034,T
4-HA,973,4,1,9061,0,9066,G
4-HA,974,1,9021,0,7,9029,T
4-HA,975,3,8838,0,4,8845,T
4-HA,976,8912,1,4,0,8917,A
4-HA,977,8778,1,7,0,8786,A
4-HA,978,1,11,8905,0,8917,G
4-HA,979,2,2,2,8891,8897,C
4-HA,980,8661,0,2,1,8664,A
4-HA,981,8658,1,14,0,8673,A
4-HA,982,8599,1,6,0,8606,A
4-HA,983,8619,0,10,1,8630,A
4-HA,984,0,3,1,8627,8631,C
4-HA,985,8494,1,2,0,8497,A
4-HA,986,0,2,0,8591,8593,C
4-HA,987,0,8326,2,7,8335,T
4-HA,988,8,1,1,8408,8418,C
4-HA,989,4,8384,2,8,8398,T
4-HA,990,1,5,8488,0,8494,G
4-HA,991,8453,0,3,0,8456,A
4-HA,992,8426,1,2,0,8429,A
4-HA,993,8445,1,7,0,8453,A
4-HA,994,2,8350,1,3,8356,T
4-HA,995,1,8169,0,3,8173,T
4-HA,996,2,6,8226,0,8234,G
4-HA,997,2,2,8202,1,8207,G
4-HA,998,2,7,1,8218,8228,C
4-HA,999,8131,1,2,0,8134,A
4-HA,1000,8155,1,5,0,8161,A
4-HA,1001,2,2,0,8170,8174,C
4-HA,1002,8136,1,11,0,8148,A
4-HA,1003,2,11,8245,0,8258,G
4-HA,1004,4,8,8165,0,8177,G
4-HA,1005,3,4,8113,0,8120,G
4-HA,1006,8095,0,10,0,8105,A
4-HA,1007,0,8071,1,5,8077,T
4-HA,1008,1,0,8094,0,8095,G
4-HA,1009,4,5,1,8066,8076,C
4-HA,1010,0,2,8092,0,8094,G
4-HA,1011,8167,2,6,0,8175,A
4-HA,1012,7976,1,6,0,7983,A
4-HA,1013,8049,0,7,0,8056,A
4-HA,1014,0,7917,0,4,7921,T
4-HA,1015,6,0,8039,0,8045,G
4-HA,1016,1,8028,0,7,8036,T
4-HA,1017,8006,0,7,0,8013,A
4-HA,1018,2,4,0,7997,8003,C
4-HA,1019,10,4,0,7908,7922,C
4-HA,1020,7692,1,4,0,7697,A
4-HA,1021,1,5,7701,0,7707,G
4-HA,1022,7338,1,4,0,7343,A
4-HA,1023,5,5,7432,1,7443,G
4-HA,1024,7171,1,4,0,7176,A
4-HA,1025,7170,1,7,0,7178,A
4-HA,1026,7177,3,18,0,7198,A
4-HA,1027,1,3,0,7171,7175,C
4-HA,1028,7132,0,2,0,7134,A
4-HA,1029,7251,0,1,0,7252,A
4-HA,1030,7228,0,6,1,7235,A
4-HA,1031,2,0,0,7300,7302,C
4-HA,1032,0,7197,0,5,7202,T
4-HA,1033,7058,0,8,0,7066,A
4-HA,1034,0,7,7097,0,7104,G
4-HA,1035,6991,1,19,0,7011,A
4-HA,1036,1,3,7204,0,7208,G
4-HA,1037,6,0,7164,0,7170,G
4-HA,1038,1,3,0,6957,6961,C
4-HA,1039,6961,0,4,2,6967,A
4-HA,1040,0,6908,1,4,6913,T
4-HA,1041,6973,0,4,0,6977,A
4-HA,1042,1,6958,0,6,6965,T
4-HA,1043,1,6909,0,0,6910,T
4-HA,1044,0,6903,0,7,6910,T
4-HA,1045,3,8,6550,0,6561,G
4-HA,1046,0,2,6577,0,6579,G
4-HA,1047,0,6,0,6527,6533,C
4-HA,1048,3,3,6531,1,6538,G
4-HA,1049,1,0,0,6459,6460,C
4-HA,1050,6391,0,2,0,6393,A
4-HA,1051,6470,0,1,0,6471,A
4-HA,1052,1,6433,1,2,6437,T
4-HA,1053,4,2,0,6445,6451,C
4-HA,1054,0,1,6463,0,6464,G
4-HA,1055,1,5,0,6412,6418,C
4-HA,1056,2,14,6432,0,6448,G
4-HA,1057,4,2,6474,0,6480,G
4-HA,1058,3,0,6506,0,6509,G
4-HA,1059,0,6478,0,7,6485,T
4-HA,1060,0,6376,0,5,6381,T
4-HA,1061,3,6362,2,7,6374,T
4-HA,1062,13,1,0,6364,6378,C
4-HA,1063,6392,2,3,0,6397,A
4-HA,1064,0,6395,0,4,6399,T
4-HA,1065,6378,1,9,0,6388,A
4-HA,1066,1,2,6444,0,6447,G
4-HA,1067,6106,1,2,0,6109,A
4-HA,1068,6118,1,3,0,6122,A
4-HA,1069,6102,0,3,0,6105,A
4-HA,1070,6103,0,8,2,6113,A
4-HA,1071,0,6064,0,3,6067,T
4-HA,1072,0,7,6137,0,6144,G
4-HA,1073,1,1,6159,0,6161,G
4-HA,1074,0,6069,0,1,6070,T
4-HA,1075,0,5840,2,2,5844,T
4-HA,1076,1,10,5832,0,5843,G
4-HA,1077,1,2,5820,0,5823,G
4-HA,1078,1,3,5862,0,5866,G
4-HA,1079,5712,1,14,1,5728,A
4-HA,1080,6,7,5784,0,5797,G
4-HA,1081,0,5,5603,4,5612,G
4-HA,1082,4,4,5798,0,5806,G
4-HA,1083,5762,0,9,1,5772,A
4-HA,1084,5867,0,11,0,5878,A
4-HA,1085,0,5848,0,9,5857,T
4-HA,1086,1,5,5886,0,5892,G
4-HA,1087,3,2,5991,1,5997,G
4-HA,1088,0,5918,0,7,5925,T
4-HA,1089,1,5,5901,0,5907,G
4-HA,1090,4,0,5868,0,5872,G
4-HA,1091,5744,1,14,0,5759,A
4-HA,1092,0,5765,0,4,5769,T
4-HA,1093,0,6,5818,0,5824,G
4-HA,1094,1,2,5899,0,5902,G
4-HA,1095,1,5769,0,5,5775,T
4-HA,1096,0,5587,2,4,5593,T
4-HA,1097,2,6,5582,2,5592,G
4-HA,1098,2,0,5705,0,5707,G
4-HA,1099,0,5692,0,3,5695,T
4-HA,1100,5699,1,1,0,5701,A
4-HA,1101,6,1,0,5374,5381,C
4-HA,1102,4,3,5428,0,5435,G
4-HA,1103,1,1,5644,0,5646,G
4-HA,1104,0,5622,1,13,5636,T
4-HA,1105,0,5641,0,3,5644,T
4-HA,1106,1,5605,0,7,5613,T
4-HA,1107,1,4,0,5522,5527,C
4-HA,1108,5487,2,14,0,5503,A
4-HA,1109,2,2,5499,0,5503,G
4-HA,1110,2,0,5480,0,5482,G
4-HA,1111,1,1,0,5480,5482,C
4-HA,1112,5251,0,2,1,5254,A
4-HA,1113,0,5322,0,3,5325,T
4-HA,1114,3,2,0,5333,5338,C
4-HA,1115,5358,2,2,0,5362,A
4-HA,1116,5362,0,0,0,5362,A
4-HA,1117,5361,1,1,0,5363,A
4-HA,1118,5387,2,1,0,5390,A
4-HA,1119,0,5388,2,1,5391,T
4-HA,1120,1,5347,1,3,5352,T
4-HA,1121,5,2,0,5374,5381,C
4-HA,1122,1,5316,0,3,5320,T
4-HA,1123,0,0,5344,0,5344,G
4-HA,1124,5271,2,10,2,5285,A
4-HA,1125,1,9,5343,1,5354,G
4-HA,1126,1,1,5350,0,5352,G
4-HA,1127,0,5,5377,0,5382,G
4-HA,1128,5348,2,0,0,5350,A
4-HA,1129,5342,0,1,1,5344,A
4-HA,1130,0,1,5317,0,5318,G
4-HA,1131,5401,1,6,1,5409,A
4-HA,1132,1,1,5481,0,5483,G
4-HA,1133,0,4,5489,0,5493,G
4-HA,1134,5467,1,9,0,5477,A
4-HA,1135,0,6,0,5473,5479,C
4-HA,1136,5402,1,4,0,5407,A
4-HA,1137,5392,2,11,1,5406,A
4-HA,1138,4,0,5418,0,5422,G
4-HA,1139,1,1,0,5425,5427,C
4-HA,1140,5320,0,6,0,5326,A
4-HA,1141,3,0,5347,0,5350,G
4-HA,1142,2,3,0,5309,5314,C
4-HA,1143,5318,0,4,0,5322,A
4-HA,1144,3,2,5374,0,5379,G
4-HA,1145,5315,1,6,0,5322,A
4-HA,1146,0,5439,2,9,5450,T
4-HA,1147,3,3,0,5509,5515,C
4-HA,1148,1,5403,0,15,5419,T
4-HA,1149,10,6,0,5496,5512,C
4-HA,1150,5496,0,0,0,5496,A
4-HA,1151,5492,1,1,0,5494,A
4-HA,1152,5487,1,2,0,5490,A
4-HA,1153,5372,0,12,0,5384,A
4-HA,1154,2,1,5393,0,5396,G
4-HA,1155,1,2,0,5252,5255,C
4-HA,1156,5237,0,3,0,5240,A
4-HA,1157,0,1,0,5354,5355,C
4-HA,1158,0,5256,1,9,5266,T
4-HA,1159,6,0,0,5297,5303,C
4-HA,1160,5295,0,2,0,5297,A
4-HA,1161,5385,0,5,1,5391,A
4-HA,1162,0,1,5392,0,5393,G
4-HA,1163,0,1,0,5375,5376,C
4-HA,1164,5321,1,6,0,5328,A
4-HA,1165,1,1,5355,0,5357,G
4-HA,1166,1,2,0,5234,5237,C
4-HA,1167,5216,1,1,0,5218,A
4-HA,1168,5219,0,1,1,5221,A
4-HA,1169,2,5176,2,8,5188,T
4-HA,1170,1,1,0,5074,5076,C
4-HA,1171,1,8,5085,0,5094,G
4-HA,1172,5073,0,9,0,5082,A
4-HA,1173,1,5056,0,6,5063,T
4-HA,1174,6,1,0,5047,5054,C
4-HA,1175,5027,1,3,1,5032,A
4-HA,1176,5130,0,7,3,5140,A
4-HA,1177,5148,0,2,1,5151,A
4-HA,1178,0,5129,0,4,5133,T
4-HA,1179,5,0,0,5158,5163,C
4-HA,1180,5045,1,5,0,5051,A
4-HA,1181,5112,1,2,0,5115,A
4-HA,1182,1,5099,0,6,5106,T
4-HA,1183,2,6,5117,0,5125,G
4-HA,1184,3,2,5084,1,5090,G
4-HA,1185,0,0,5025,0,5025,G
4-HA,1186,5016,0,3,1,5020,A
4-HA,1187,5013,0,14,1,5028,A
4-HA,1188,1,3,5128,0,5132,G
4-HA,1189,2,2,0,5144,5148,C
4-HA,1190,0,5076,0,7,5083,T
4-HA,1191,2,2,5363,0,5367,G
4-HA,1192,5351,0,5,0,5356,A
4-HA,1193,5354,0,8,3,5365,A
4-HA,1194,1,5366,0,1,5368,T
4-HA,1195,5236,0,0,1,5237,A
4-HA,1196,0,0,5237,0,5237,G
4-HA,1197,4717,0,12,0,4729,A
4-HA,1198,1,4759,1,3,4764,T
4-HA,1199,0,4766,0,4,4770,T
4-HA,1200,0,4,4781,0,4785,G
4-HA,1201,4760,0,7,0,4767,A
4-HA,1202,0,4755,0,2,4757,T
4-HA,1203,3,6,1,4765,4775,C
4-HA,1204,6,5,4764,0,4775,G
4-HA,1205,5,5,4772,0,4782,G
4-HA,1206,3,2,4788,0,4793,G
4-HA,1207,4768,0,4,2,4774,A
4-HA,1208,4787,1,3,0,4791,A
4-HA,1209,4730,0,8,1,4739,A
4-HA,1210,4768,0,5,0,4773,A
4-HA,1211,1,1,2,4780,4784,C
4-HA,1212,3,2,0,4774,4779,C
4-HA,1213,4719,0,7,0,4726,A
4-HA,1214,4718,0,4,2,4724,A
4-HA,1215,1,3,0,4718,4722,C
4-HA,1216,2,5,4746,0,4753,G
4-HA,1217,4728,1,4,0,4733,A
4-HA,1218,3,2,4742,0,4747,G
4-HA,1219,4734,1,6,0,4741,A
4-HA,1220,4739,0,1,0,4740,A
4-HA,1221,4738,0,9,0,4747,A
4-HA,1222,0,4761,0,3,4764,T
4-HA,1223,3,4742,0,7,4752,T
4-HA,1224,3,0,0,4792,4795,C
4-HA,1225,4,3,1,4769,4777,C
4-HA,1226,4761,0,2,4,4767,A
4-HA,1227,0,4724,1,5,4730,T
4-HA,1228,6,0,0,4751,4757,C
4-HA,1229,4714,0,3,0,4717,A
4-HA,1230,0,1,4734,1,4736,G
4-HA,1231,4703,1,0,1,4705,A
4-HA,1232,0,4712,0,4,4716,T
4-HA,1233,3,4659,0,1,4663,T
4-HA,1234,0,5,4715,0,4720,G
4-HA,1235,4718,1,2,0,4721,A
4-HA,1236,4719,0,0,0,4719,A
4-HA,1237,4728,1,6,0,4735,A
4-HA,1238,4718,3,0,0,4721,A
4-HA,1239,4658,0,16,0,4674,A
4-HA,1240,0,6,4677,0,4683,G
4-HA,1241,4659,1,7,1,4668,A
4-HA,1242,4693,1,2,0,4696,A
4-HA,1243,0,4624,0,3,4627,T
4-HA,1244,0,4617,0,5,4622,T
4-HA,1245,7,0,0,4645,4652,C
4-HA,1246,0,4638,0,5,4643,T
4-HA,1247,4,2,0,4626,4632,C
4-HA,1248,4625,0,6,0,4631,A
4-HA,1249,1,3,4634,0,4638,G
4-HA,1250,4602,1,0,0,4603,A
4-HA,1251,4579,0,7,0,4586,A
4-HA,1252,0,1,4684,0,4685,G
4-HA,1253,3,4626,0,5,4634,T
4-HA,1254,1,4,1,4619,4625,C
4-HA,1255,3,1,4630,0,4634,G
4-HA,1256,4638,0,5,0,4643,A
4-HA,1257,4627,2,10,1,4640,A
4-HA,1258,0,11,4624,0,4635,G
4-HA,1259,2,3,4637,0,4642,G
4-HA,1260,2,4,4634,0,4640,G
4-HA,1261,4479,1,11,0,4491,A
4-HA,1262,1,2,4489,0,4492,G
4-HA,1263,0,4,4455,0,4459,G
4-HA,1264,4878,0,4,0,4882,A
4-HA,1265,1,4886,0,2,4889,T
4-HA,1266,0,4889,0,1,4890,T
4-HA,1267,8,0,0,4892,4900,C
4-HA,1268,4799,0,21,1,4821,A
4-HA,1269,1,6,4828,0,4835,G
4-HA,1270,1,3,4832,0,4836,G
4-HA,1271,4784,1,5,0,4790,A
4-HA,1272,2,0,0,4776,4778,C
4-HA,1273,2,2,0,4258,4262,C
4-HA,1274,1,4216,1,2,4220,T
4-HA,1275,2,4027,0,200,4229,T
4-HA,1276,0,4,4263,0,4267,G
4-HA,1277,4247,1,7,0,4255,A
4-HA,1278,0,0,4363,0,4363,G
4-HA,1279,4267,2,1,1,4271,A
4-HA,1280,3772,0,2,0,3774,A
4-HA,1281,3719,0,8,0,3727,A
4-HA,1282,1,3670,0,1,3672,T
4-HA,1283,3853,1,3,0,3857,A
4-HA,1284,0,3823,0,3,3826,T
4-HA,1285,0,0,3832,0,3832,G
4-HA,1286,2,3811,0,3,3816,T
4-HA,1287,0,3675,0,4,3679,T
4-HA,1288,0,1,3698,0,3699,G
4-HA,1289,3652,1,4,0,3657,A
4-HA,1290,0,5,3778,0,3783,G
4-HA,1291,0,3,3769,0,3772,G
4-HA,1292,3687,1,4,0,3692,A
4-HA,1293,0,2,0,3825,3827,C
4-HA,1294,3771,0,3,0,3774,A
4-HA,1295,2,1,0,3926,3929,C
4-HA,1296,4,0,0,3910,3914,C
4-HA,1297,3933,0,1,0,3934,A
4-HA,1298,4040,1,1,1,4043,A
4-HA,1299,4013,0,6,0,4019,A
4-HA,1300,4071,0,1,0,4072,A
4-HA,1301,1,4076,0,2,4079,T
4-HA,1302,3954,0,1,0,3955,A
4-HA,1303,1,3,3989,0,3993,G
4-HA,1304,3871,0,5,0,3876,A
4-HA,1305,0,3892,1,8,3901,T
4-HA,1306,4,0,0,3931,3935,C
4-HA,1307,0,3833,2,10,3845,T
4-HA,1308,6,0,0,3963,3969,C
4-HA,1309,1,3953,1,6,3961,T
4-HA,1310,0,6,4038,0,4044,G
4-HA,1311,2,2,4122,1,4127,G
4-HA,1312,0,4102,1,5,4108,T
4-HA,1313,5,2,0,4100,4107,C
4-HA,1314,4140,0,4,0,4144,A
4-HA,1315,1,4141,0,4,4146,T
4-HA,1316,4155,0,1,0,4156,A
4-HA,1317,6,0,0,4137,4143,C
4-HA,1318,4002,0,3,0,4005,A
4-HA,1319,4040,0,4,0,4044,A
4-HA,1320,0,2,0,3942,3944,C
4-HA,1321,0,1,3947,0,3948,G
4-HA,1322,0,1,0,3940,3941,C
4-HA,1323,1,5,3922,0,3928,G
4-HA,1324,0,6,3938,0,3944,G
4-HA,1325,3905,1,5,0,3911,A
4-HA,1326,1,1,4016,0,4018,G
4-HA,1327,1,0,1,4016,4018,C
4-HA,1328,1,3989,1,7,3998,T
4-HA,1329,0,4011,0,11,4022,T
4-HA,1330,1,2,0,4050,4053,C
4-HA,1331,0,4062,0,2,4064,T
4-HA,1332,0,4055,0,7,4062,T
4-HA,1333,0,2,4054,0,4056,G
4-HA,1334,2,4029,0,7,4038,T
4-HA,1335,1,3945,1,0,3947,T
4-HA,1336,3,0,4020,0,4023,G
4-HA,1337,1,2,0,4023,4026,C
4-HA,1338,3,1,0,4000,4004,C
4-HA,1339,4,0,0,4030,4034,C
4-HA,1340,3,3994,2,12,4011,T
4-HA,1341,1,2,4037,0,4040,G
4-HA,1342,0,1,4054,0,4055,G
4-HA,1343,4033,0,6,0,4039,A
4-HA,1344,1,4,4061,0,4066,G
4-HA,1345,3953,1,5,0,3959,A
4-HA,1346,3982,1,7,0,3990,A
4-HA,1347,1,1,0,4068,4070,C
4-HA,1348,4,0,0,4058,4062,C
4-HA,1349,4045,0,6,0,4051,A
4-HA,1350,4230,0,5,0,4235,A
4-HA,1351,0,4,0,4253,4257,C
4-HA,1352,4288,0,4,0,4292,A
4-HA,1353,1,4274,0,7,4282,T
4-HA,1354,4266,0,6,0,4272,A
4-HA,1355,1,8,0,4353,4362,C
4-HA,1356,4244,1,1,0,4246,A
4-HA,1357,4237,0,2,1,4240,A
4-HA,1358,1,4242,0,2,4245,T
4-HA,1359,0,4063,0,0,4063,T
4-HA,1360,2,7,4138,0,4147,G
4-HA,1361,4163,0,5,0,4168,A
4-HA,1362,0,4141,0,7,4148,T
4-HA,1363,2,0,0,4196,4198,C
4-HA,1364,0,4105,0,6,4111,T
4-HA,1365,4162,1,0,0,4163,A
4-HA,1366,4149,0,2,0,4151,A
4-HA,1367,0,1,0,4156,4157,C
4-HA,1368,1,4119,0,2,4122,T
4-HA,1369,0,3,4070,0,4073,G
4-HA,1370,4099,0,2,0,4101,A
4-HA,1371,0,2,0,4112,4114,C
4-HA,1372,0,4091,0,3,4094,T
4-HA,1373,5,1,0,4107,4113,C
4-HA,1374,4090,0,6,0,4096,A
4-HA,1375,3,3,4198,1,4205,G
4-HA,1376,4203,1,3,0,4207,A
4-HA,1377,4201,0,0,0,4201,A
4-HA,1378,4209,0,3,0,4212,A
4-HA,1379,4,4160,0,4,4168,T
4-HA,1380,0,5,4226,0,4231,G
4-HA,1381,4209,2,10,0,4221,A
4-HA,1382,4228,0,8,0,4236,A
4-HA,1383,1,0,0,4231,4232,C
4-HA,1384,4148,0,3,0,4151,A
4-HA,1385,4145,0,4,0,4149,A
4-HA,1386,4145,2,7,1,4155,A
4-HA,1387,1,1,0,4177,4179,C
4-HA,1388,0,4125,0,2,4127,T
4-HA,1389,1,0,4168,0,4169,G
4-HA,1390,0,4110,0,6,4116,T
4-HA,1391,0,4103,0,2,4105,T
4-HA,1392,0,4110,0,3,4113,T
4-HA,1393,0,3,4118,0,4121,G
4-HA,1394,4110,0,3,1,4114,A
4-HA,1395,4126,0,1,0,4127,A
4-HA,1396,4089,0,2,1,4092,A
4-HA,1397,4090,0,1,2,4093,A
4-HA,1398,4062,1,5,1,4069,A
4-HA,1399,4084,0,1,2,4087,A
4-HA,1400,0,1,0,4118,4119,C
4-HA,1401,4110,0,0,0,4110,A
4-HA,1402,4107,0,0,0,4107,A
4-HA,1403,4087,0,7,0,4094,A
4-HA,1404,1,4,4121,0,4126,G
4-HA,1405,4145,1,3,0,4149,A
4-HA,1406,4127,0,10,1,4138,A
4-HA,1407,1,1,4138,0,4140,G
4-HA,1408,5,3,0,4136,4144,C
4-HA,1409,4118,1,7,0,4126,A
4-HA,1410,4162,0,3,0,4165,A
4-HA,1411,2,0,0,4173,4175,C
4-HA,1412,0,4137,0,0,4137,T
4-HA,1413,0,3,4171,0,4174,G
4-HA,1414,4112,0,7,0,4119,A
4-HA,1415,0,14,4188,0,4202,G
4-HA,1416,3,2,4199,0,4204,G
4-HA,1417,3,4,4207,1,4215,G
4-HA,1418,4200,2,5,1,4208,A
4-HA,1419,4186,0,4,0,4190,A
4-HA,1420,4167,1,12,0,4180,A
4-HA,1421,4237,1,2,0,4240,A
4-HA,1422,0,4219,1,0,4220,T
4-HA,1423,2,2,4267,0,4271,G
4-HA,1424,1,3,1,4254,4259,C
4-HA,1425,0,4204,0,3,4207,T
4-HA,1426,0,0,4225,0,4225,G
4-HA,1427,4201,0,6,0,4207,A
4-HA,1428,0,3,4521,0,4524,G
4-HA,1429,0,1,4603,0,4604,G
4-HA,1430,4547,0,1,0,4548,A
4-HA,1431,0,4549,0,3,4552,T
4-HA,1432,4498,0,7,2,4507,A
4-HA,1433,0,4492,0,9,4501,T
4-HA,1434,2,5,4544,0,4551,G
4-HA,1435,1,5,4584,0,4590,G
4-HA,1436,2,2,4581,0,4585,G
4-HA,1437,1,0,0,4345,4346,C
4-HA,1438,4222,0,0,0,4222,A
4-HA,1439,4226,1,1,0,4228,A
4-HA,1440,0,4224,0,6,4230,T
4-HA,1441,1,4,4254,0,4259,G
4-HA,1442,3,0,4261,0,4264,G
4-HA,1443,0,4187,0,1,4188,T
4-HA,1444,0,4088,0,0,4088,T
4-HA,1445,0,0,4113,0,4113,G
4-HA,1446,0,4183,0,4,4187,T
4-HA,1447,1,4180,1,4,4186,T
4-HA,1448,0,4180,0,5,4185,T
4-HA,1449,3,0,0,4216,4219,C
4-HA,1450,4212,0,1,0,4213,A
4-HA,1451,4231,0,2,1,4234,A
4-HA,1452,4226,1,1,0,4228,A
4-HA,1453,4303,0,1,0,4304,A
4-HA,1454,0,4280,0,0,4280,T
4-HA,1455,4231,1,3,0,4235,A
4-HA,1456,0,4251,0,2,4253,T
4-HA,1457,4242,0,6,0,4248,A
4-HA,1458,1,2,0,4318,4321,C
4-HA,1459,3,0,1,4298,4302,C
4-HA,1460,4286,0,5,1,4292,A
4-HA,1461,0,2,0,4319,4321,C
4-HA,1462,4310,1,2,0,4313,A
4-HA,1463,4328,0,2,1,4331,A
4-HA,1464,4336,2,2,1,4341,A
4-HA,1465,0,4340,0,0,4340,T
4-HA,1466,2,0,4382,0,4384,G
4-HA,1467,0,4329,1,2,4332,T
4-HA,1468,1,12,4382,0,4395,G
4-HA,1469,4402,1,5,0,4408,A
4-HA,1470,0,0,0,4404,4404,C
4-HA,1471,4333,0,2,0,4335,A
4-HA,1472,4339,1,4,0,4344,A
4-HA,1473,0,4440,0,1,4441,T
4-HA,1474,2,0,4482,0,4484,G
4-HA,1475,3,0,0,4431,4434,C
4-HA,1476,2,1,0,4448,4451,C
4-HA,1477,1,4391,2,13,4407,T
4-HA,1478,1,1,4669,0,4671,G
4-HA,1479,0,1,1,4679,4681,C
4-HA,1480,4678,1,1,0,4680,A
4-HA,1481,0,4678,0,2,4680,T
4-HA,1482,4542,0,4,0,4546,A
4-HA,1483,1,4,4599,0,4604,G
4-HA,1484,0,1,4582,0,4583,G
4-HA,1485,4562,1,4,0,4567,A
4-HA,1486,1,4553,0,2,4556,T
4-HA,1487,3,1,1,4291,4296,C
4-HA,1488,4306,1,1,0,4308,A
4-HA,1489,4328,1,2,0,4331,A
4-HA,1490,1,4309,0,1,4311,T
4-HA,1491,5,0,0,4327,4332,C
4-HA,1492,4233,0,5,0,4238,A
4-HA,1493,0,0,4283,0,4283,G
4-HA,1494,4284,3,1,1,4289,A
4-HA,1495,4297,0,3,0,4300,A
4-HA,1496,4286,1,6,0,4293,A
4-HA,1497,0,4270,0,1,4271,T
4-HA,1498,1,3,4248,0,4252,G
4-HA,1499,0,5,4273,0,4278,G
4-HA,1500,4270,0,3,0,4273,A
4-HA,1501,4305,0,3,0,4308,A
4-HA,1502,1,2,0,4307,4310,C
4-HA,1503,0,4245,0,4,4249,T
4-HA,1504,0,4272,0,2,4274,T
4-HA,1505,4268,0,7,0,4275,A
4-HA,1506,1,4265,1,3,4270,T
4-HA,1507,0,5,4272,1,4278,G
4-HA,1508,4261,1,12,0,4274,A
4-HA,1509,0,1,0,4272,4273,C
4-HA,1510,1,2,0,4219,4222,C
4-HA,1511,4211,0,2,1,4214,A
4-HA,1512,1,1,0,4340,4342,C
4-HA,1513,1,0,4491,0,4492,G
4-HA,1514,4619,1,3,0,4623,A
4-HA,1515,6,4701,0,0,4707,T
4-HA,1516,1,1,4944,0,4946,G
4-HA,1517,0,4907,0,5,4912,T
4-HA,1518,5149,1,7,0,5157,A
4-HA,1519,1,5152,0,2,5155,T
4-HA,1520,5149,1,4,0,5154,A
4-HA,1521,0,2,0,5136,5138,C
4-HA,1522,4595,0,4,0,4599,A
4-HA,1523,1,2,4648,0,4651,G
4-HA,1524,4308,0,4,0,4312,A
4-HA,1525,0,2,4235,0,4237,G
4-HA,1526,4211,0,1,0,4212,A
4-HA,1527,0,3914,0,4,3918,T
4-HA,1528,0,2,3906,0,3908,G
4-HA,1529,3902,0,3,0,3905,A
4-HA,1530,3875,2,20,0,3897,A
4-HA,1531,3,2,3992,0,3997,G
4-HA,1532,2,2,0,3902,3906,C
4-HA,1533,3894,0,1,0,3895,A
4-HA,1534,0,3888,0,6,3894,T
4-HA,1535,1,3874,0,3,3878,T
4-HA,1536,3910,1,0,0,3911,A
4-HA,1537,3905,1,2,0,3908,A
4-HA,1538,3904,1,4,1,3910,A
4-HA,1539,0,1,0,3909,3910,C
4-HA,1540,3756,0,1,0,3757,A
4-HA,1541,3768,1,3,0,3772,A
4-HA,1542,1,1,0,3758,3760,C
4-HA,1543,1,2,0,3743,3746,C
4-HA,1544,5,1,3737,0,3743,G
4-HA,1545,1,0,3813,1,3815,G
4-HA,1546,1,3825,0,8,3834,T
4-HA,1547,0,3810,0,3,3813,T
4-HA,1548,4,5,0,3804,3813,C
4-HA,1549,3,0,0,3825,3828,C
4-HA,1550,3801,0,10,0,3811,A
4-HA,1551,0,1,3894,0,3895,G
4-HA,1552,3880,0,5,0,3885,A
4-HA,1553,0,3869,0,4,3873,T
4-HA,1554,4,0,0,3703,3707,C
4-HA,1555,3683,0,2,0,3685,A
4-HA,1556,3696,1,7,0,3704,A
4-HA,1557,0,9,3694,0,3703,G
4-HA,1558,0,2,3689,0,3691,G
4-HA,1559,0,3,3689,0,3692,G
4-HA,1560,3507,0,5,0,3512,A
4-HA,1561,0,0,3566,0,3566,G
4-HA,1562,0,3564,0,5,3569,T
4-HA,1563,0,3558,0,5,3563,T
4-HA,1564,0,6,3586,0,3592,G
4-HA,1565,3542,0,9,0,3551,A
4-HA,1566,1,0,3586,0,3587,G
4-HA,1567,0,0,0,3580,3580,C
4-HA,1568,0,3541,1,4,3546,T
4-HA,1569,1,0,3550,0,3551,G
4-HA,1570,3518,0,1,2,3521,A
4-HA,1571,3513,0,8,0,3521,A
4-HA,1572,0,0,3537,0,3537,G
4-HA,1573,1,3470,1,3,3475,T
4-HA,1574,2,0,0,3472,3474,C
4-HA,1575,3407,1,1,0,3409,A
4-HA,1576,0,2,3409,0,3411,G
4-HA,1577,0,6,3388,0,3394,G
4-HA,1578,0,1,3311,0,3312,G
4-HA,1579,0,3460,0,4,3464,T
4-HA,1580,3470,0,2,2,3474,A
4-HA,1581,1,0,0,3465,3466,C
4-HA,1582,3446,0,2,0,3448,A
4-HA,1583,3443,0,1,0,3444,A
4-HA,1584,3435,0,4,0,3439,A
4-HA,1585,0,3,3462,0,3465,G
4-HA,1586,3361,1,2,0,3364,A
4-HA,1587,0,3197,1,15,3213,T
4-HA,1588,0,3169,1,1,3171,T
4-HA,1589,0,3,3167,0,3170,G
4-HA,1590,1,1,3163,0,3165,G
4-HA,1591,3148,0,6,0,3154,A
4-HA,1592,0,3166,0,6,3172,T
4-HA,1593,2,1,1,3149,3153,C
4-HA,1594,3,1,0,3083,3087,C
4-HA,1595,0,3036,1,1,3038,T
4-HA,1596,3062,0,1,0,3063,A
4-HA,1597,0,3067,0,3,3070,T
4-HA,1598,0,1,3062,0,3063,G
4-HA,1599,1,3,3050,0,3054,G
4-HA,1600,2974,0,3,0,2977,A
4-HA,1601,0,2959,1,7,2967,T
4-HA,1602,0,2932,0,4,2936,T
4-HA,1603,0,2918,0,9,2927,T
4-HA,1604,1,2,0,2935,2938,C
4-HA,1605,5,0,0,2926,2931,C
4-HA,1606,0,2881,0,6,2887,T
4-HA,1607,0,2885,0,1,2886,T
4-HA,1608,1,2858,0,2,2861,T
4-HA,1609,0,0,2889,0,2889,G
4-HA,1610,0,2,0,2875,2877,C
4-HA,1611,8,2,0,2869,2879,C
4-HA,1612,2830,1,0,0,2831,A
4-HA,1613,0,2816,0,2,2818,T
4-HA,1614,2842,0,0,0,2842,A
4-HA,1615,2,2833,0,4,2839,T
4-HA,1616,3,0,0,2833,2836,C
4-HA,1617,2832,0,4,0,2836,A
4-HA,1618,0,2779,0,7,2786,T
4-HA,1619,0,0,2804,0,2804,G
4-HA,1620,0,2789,1,3,2793,T
4-HA,1621,0,2758,0,2,2760,T
4-HA,1622,0,2752,0,4,2756,T
4-HA,1623,0,2677,0,4,2681,T
4-HA,1624,0,2672,0,6,2678,T
4-HA,1625,0,2674,0,1,2675,T
4-HA,1626,1,1,2685,0,2687,G
4-HA,1627,0,1,0,2679,2680,C
4-HA,1628,0,2591,0,4,2595,T
4-HA,1629,1,2592,0,3,2596,T
4-HA,1630,0,2592,0,2,2594,T
4-HA,1631,0,0,2655,0,2655,G
4-HA,1632,2,2652,0,3,2657,T
4-HA,1633,0,0,2653,0,2653,G
4-HA,1634,0,2658,0,2,2660,T
4-HA,1635,1,2600,1,3,2605,T
4-HA,1636,1,0,2636,0,2637,G
4-HA,1637,1,1,0,2623,2625,C
4-HA,1638,0,2610,0,14,2624,T
4-HA,1639,0,2645,0,0,2645,T
4-HA,1640,0,2489,0,0,2489,T
4-HA,1641,1,4,2502,0,2507,G
4-HA,1642,0,2507,1,2,2510,T
4-HA,1643,0,2488,0,4,2492,T
4-HA,1644,1,4,2487,0,2492,G
4-HA,1645,0,2,2445,0,2447,G
4-HA,1646,1,1,2436,0,2438,G
4-HA,1647,1,1,2453,0,2455,G
4-HA,1648,0,2371,0,6,2377,T
4-HA,1649,1,2352,1,0,2354,T
4-HA,1650,8,4,0,2315,2327,C
4-HA,1651,2293,0,2,0,2295,A
4-HA,1652,1,2325,0,3,2329,T
4-HA,1653,4,0,0,2317,2321,C
4-HA,1654,2319,0,5,0,2324,A
4-HA,1655,0,2254,0,1,2255,T
4-HA,1656,1,0,2234,0,2235,G
4-HA,1657,0,2184,0,4,2188,T
4-HA,1658,1,2,2159,0,2162,G
4-HA,1659,0,0,2098,0,2098,G
4-HA,1660,2,1,2094,0,2097,G
4-HA,1661,1,0,0,2047,2048,C
4-HA,1662,4,1,0,1984,1989,C
4-HA,1663,3,1910,0,1,1914,T
4-HA,1664,0,0,1931,0,1931,G
4-HA,1665,0,2,0,1930,1932,C
4-HA,1666,5,0,1,1927,1933,C
4-HA,1667,1926,0,1,0,1927,A
4-HA,1668,1905,0,0,1,1906,A
4-HA,1669,1897,1,1,0,1899,A
4-HA,1670,1908,0,0,0,1908,A
4-HA,1671,1908,0,0,0,1908,A
4-HA,1672,1,0,1902,0,1903,G
4-HA,1673,0,0,1841,0,1841,G
4-HA,1674,1,1,0,1806,1808,C
4-HA,1675,1806,0,0,0,1806,A
4-HA,1676,1819,0,2,0,1821,A
4-HA,1677,0,4,0,1823,1827,C
4-HA,1678,1820,0,0,0,1820,A
4-HA,1679,0,1816,0,2,1818,T
4-HA,1680,0,1796,0,1,1797,T
4-HA,1681,1741,0,2,0,1743,A
4-HA,1682,2,0,1725,0,1727,G
4-HA,1683,0,1,1731,0,1732,G
4-HA,1684,0,1660,0,3,1663,T
4-HA,1685,0,0,1555,0,1555,G
4-HA,1686,0,0,0,1472,1472,C
4-HA,1687,1454,0,2,0,1456,A
4-HA,1688,1449,1,4,0,1454,A
4-HA,1689,0,1,0,1449,1450,C
4-HA,1690,1432,0,0,0,1432,A
4-HA,1691,0,1405,0,0,1405,T
4-HA,1692,0,1327,0,4,1331,T
4-HA,1693,0,1327,0,3,1330,T
4-HA,1694,0,0,1329,0,1329,G
4-HA,1695,0,2,0,1320,1322,C
4-HA,1696,1318,0,2,0,1320,A
4-HA,1697,2,1227,1,1,1231,T
4-HA,1698,0,1184,0,1,1185,T
4-HA,1699,0,1144,0,0,1144,T
4-HA,1700,0,0,1142,0,1142,G
4-HA,1701,1076,0,0,0,1076,A
5-NP,1,5269,0,0,0,5269,A
5-NP,2,0,5299,0,0,5299,T
5-NP,3,0,0,5272,0,5272,G
5-NP,4,2,1,5282,0,5285,G
5-NP,5,1,0,0,5324,5325,C
5-NP,6,18,1,5413,0,5432,G
5-NP,7,2,5654,0,13,5669,T
5-NP,8,3,0,0,5753,5756,C
5-NP,9,1,3,0,5762,5766,C
5-NP,10,9,2,0,5769,5780,C
5-NP,11,5786,2,5,0,5793,A
5-NP,12,5780,1,3,1,5785,A
5-NP,13,2,11,5830,0,5843,G
5-NP,14,2,2,6002,0,6006,G
5-NP,15,1,0,0,6040,6041,C
5-NP,16,6055,1,7,0,6063,A
5-NP,17,0,3,1,6119,6123,C
5-NP,18,4,1,0,6135,6140,C
5-NP,19,6178,0,1,1,6180,A
5-NP,20,6160,0,0,0,6160,A
5-NP,21,6183,0,4,1,6188,A
5-NP,22,1,5,0,6206,6212,C
5-NP,23,5,2,6220,0,6227,G
5-NP,24,0,0,6863,0,6863,G
5-NP,25,1,6842,0,13,6856,T
5-NP,26,10,0,1,7504,7515,C
5-NP,27,0,7466,0,13,7479,T
5-NP,28,0,7598,1,4,7603,T
5-NP,29,7627,0,5,0,7632,A
5-NP,30,1,7623,0,4,7628,T
5-NP,31,1,18,7685,1,7705,G
5-NP,32,7658,1,9,0,7668,A
5-NP,33,7476,1,11,1,7489,A
5-NP,34,0,0,0,7527,7527,C
5-NP,35,7207,2,2,0,7211,A
5-NP,36,3,0,7801,0,7804,G
5-NP,37,7728,0,5,1,7734,A
5-NP,38,1,7744,0,3,7748,T
5-NP,39,2,5,7779,0,7786,G
5-NP,40,3,5,7773,1,7782,G
5-NP,41,7779,1,17,0,7797,A
5-NP,42,7825,1,8,0,7834,A
5-NP,43,7860,1,12,1,7874,A
5-NP,44,2,3,0,8115,8120,C
5-NP,45,0,7902,1,3,7906,T
5-NP,46,2,3,8025,0,8030,G
5-NP,47,7940,0,19,1,7960,A
5-NP,48,2,7950,4,16,7972,T
5-NP,49,0,11,7990,1,8002,G
5-NP,50,1,17,7977,0,7995,G
5-NP,51,5,9,7978,1,7993,G
5-NP,52,2,7,8013,0,8022,G
5-NP,53,7908,0,9,0,7917,A
5-NP,54,1,7935,1,3,7940,T
5-NP,55,5,1,0,7965,7971,C
5-NP,56,4,2,7992,0,7998,G
5-NP,57,1,0,0,8092,8093,C
5-NP,58,6,2,0,8111,8119,C
5-NP,59,8092,3,4,4,8103,A
5-NP,60,0,4,8237,0,8241,G
5-NP,61,8185,1,5,1,8192,A
5-NP,62,8304,2,4,1,8311,A
5-NP,63,0,8304,0,3,8307,T
5-NP,64,4,0,8296,0,8300,G
5-NP,65,1,5,0,8390,8396,C
5-NP,66,8319,0,6,1,8326,A
5-NP,67,8475,2,16,1,8494,A
5-NP,68,3,0,0,8484,8487,C
5-NP,69,7,8391,2,6,8406,T
5-NP,70,2,6,8493,0,8501,G
5-NP,71,8504,0,16,1,8521,A
5-NP,72,3,2,9077,0,9082,G
5-NP,73,9014,0,9,0,9023,A
5-NP,74,0,8941,0,3,8944,T
5-NP,75,0,8966,1,1,8968,T
5-NP,76,8896,1,9,0,8906,A
5-NP,77,4,20,8915,2,8941,G
5-NP,78,5,6,8888,0,8899,G
5-NP,79,3,1,8908,0,8912,G
5-NP,80,0,1,2,8729,8732,C
5-NP,81,8591,0,4,0,8595,A
5-NP,82,0,8616,1,13,8630,T
5-NP,83,4,2,0,8654,8660,C
5-NP,84,7,3,2,8666,8678,C
5-NP,85,2,1,8758,0,8761,G
5-NP,86,0,8727,0,8,8735,T
5-NP,87,10,5,0,8717,8732,C
5-NP,88,8,7,8748,0,8763,G
5-NP,89,2,4,8778,2,8786,G
5-NP,90,2,0,8845,0,8847,G
5-NP,91,8762,1,5,1,8769,A
5-NP,92,8780,2,23,0,8805,A
5-NP,93,1,2,8868,0,8871,G
5-NP,94,8753,0,10,0,8763,A
5-NP,95,1,8818,1,1,8821,T
5-NP,96,1,6,8877,0,8884,G
5-NP,97,8821,1,18,0,8840,A
5-NP,98,0,8862,0,1,8863,T
5-NP,99,1,8807,0,1,8809,T
5-NP,100,4,6,8821,0,8831,G
5-NP,101,8812,3,11,1,8827,A
5-NP,102,1,8803,0,8,8812,T
5-NP,103,7,9,8802,2,8820,G
5-NP,104,10,8,9118,0,9136,G
5-NP,105,9047,3,11,3,9064,A
5-NP,106,9142,2,4,0,9148,A
5-NP,107,0,9126,0,1,9127,T
5-NP,108,0,9138,0,6,9144,T
5-NP,109,0,15,9140,0,9155,G
5-NP,110,4,9,9106,0,9119,G
5-NP,111,2,5,9144,0,9151,G
5-NP,112,9063,0,16,0,9079,A
5-NP,113,1,7,8875,2,8885,G
5-NP,114,2,1,8818,1,8822,G
5-NP,115,0,9450,0,6,9456,T
5-NP,116,1,9487,0,4,9492,T
5-NP,117,9,0,1,9524,9534,C
5-NP,118,1,9511,1,6,9519,T
5-NP,119,9726,0,11,0,9737,A
5-NP,120,0,2,0,9750,9752,C
5-NP,121,10067,1,4,1,10073,A
5-NP,122,0,10100,0,6,10106,T
5-NP,123,5,4,0,9826,9835,C
5-NP,124,12,0,0,9825,9837,C
5-NP,125,9850,1,2,0,9853,A
5-NP,126,10042,0,2,0,10044,A
5-NP,127,10023,0,3,0,10026,A
5-NP,128,1,9928,0,3,9932,T
5-NP,129,12,2,9946,0,9960,G
5-NP,130,2,9726,0,16,9744,T
5-NP,131,4,6,9785,0,9795,G
5-NP,132,2,2,2,9800,9806,C
5-NP,133,9776,2,8,0,9786,A
5-NP,134,1,4,0,9795,9800,C
5-NP,135,0,9624,3,9,9636,T
5-NP,136,1,12,10161,0,10174,G
5-NP,137,10324,2,6,1,10333,A
5-NP,138,10501,2,12,0,10515,A
5-NP,139,1,0,1,10692,10694,C
5-NP,140,0,10582,2,22,10606,T
5-NP,141,4,10631,0,6,10641,T
5-NP,142,10672,1,2,1,10676,A
5-NP,143,10633,1,8,0,10642,A
5-NP,144,10696,0,17,0,10713,A
5-NP,145,1,2,0,10746,10749,C
5-NP,146,0,10272,1,10,10283,T
5-NP,147,5,0,0,10356,10361,C
5-NP,148,10244,0,9,2,10255,A
5-NP,149,2,0,10340,1,10343,G
5-NP,150,0,10321,0,13,10334,T
5-NP,151,10,15,10407,0,10432,G
5-NP,152,10469,4,19,1,10493,A
5-NP,153,4,10522,0,13,10539,T
5-NP,154,10,8,0,10571,10589,C
5-NP,155,10667,0,3,1,10671,A
5-NP,156,2,10617,1,13,10633,T
5-NP,157,6,6,10644,0,10656,G
5-NP,158,10624,2,16,0,10642,A
5-NP,159,10584,3,22,3,10612,A
5-NP,160,1,8,10550,0,10559,G
5-NP,161,3,7,10451,0,10461,G
5-NP,162,10244,1,15,0,10260,A
5-NP,163,1,1,0,10481,10483,C
5-NP,164,9,9,10561,0,10579,G
5-NP,165,18,1,10642,0,10661,G
5-NP,166,2,10636,0,9,10647,T
5-NP,167,2,10579,0,7,10588,T
5-NP,168,3,3,10586,0,10592,G
5-NP,169,11811,2,22,0,11835,A
5-NP,170,1,11810,1,17,11829,T
5-NP,171,8,1,1,11841,11851,C
5-NP,172,10,8,0,11843,11861,C
5-NP,173,11719,2,13,2,11736,A
5-NP,174,2,8,11777,0,11787,G
5-NP,175,11738,2,10,0,11750,A
5-NP,176,11768,2,16,0,11786,A
5-NP,177,1,3,0,11879,11883,C
5-NP,178,10939,0,8,0,10947,A
5-NP,179,2,2,11133,0,11137,G
5-NP,180,2,4,1,11127,11134,C
5-NP,181,5,11093,1,4,11103,T
5-NP,182,1,11169,0,9,11179,T
5-NP,183,6,13,11165,0,11184,G
5-NP,184,11248,5,18,1,11272,A
5-NP,185,3,2,0,11334,11339,C
5-NP,186,11234,1,9,1,11245,A
5-NP,187,11310,1,6,0,11317,A
5-NP,188,3,11254,0,9,11266,T
5-NP,189,11240,2,6,0,11248,A
5-NP,190,0,6,11341,2,11349,G
5-NP,191,11238,1,12,1,11252,A
5-NP,192,1,10,11344,0,11355,G
5-NP,193,11233,1,5,1,11240,A
5-NP,194,11455,1,4,0,11460,A
5-NP,195,11449,2,9,3,11463,A
5-NP,196,11747,1,5,3,11756,A
5-NP,197,0,11766,0,3,11769,T
5-NP,198,5,21,11737,0,11763,G
5-NP,199,5,3,11731,0,11739,G
5-NP,200,2,11680,0,6,11688,T
5-NP,201,11370,3,6,8,11387,A
5-NP,202,3,2,0,11529,11534,C
5-NP,203,2,11520,0,17,11539,T
5-NP,204,5,1,0,11748,11754,C
5-NP,205,2,11395,1,22,11420,T
5-NP,206,14,1,0,11559,11574,C
5-NP,207,4,11511,1,14,11530,T
5-NP,208,4,2,11632,0,11638,G
5-NP,209,0,6,1,11636,11643,C
5-NP,210,1,11537,1,28,11567,T
5-NP,211,1,11504,1,9,11515,T
5-NP,212,0,11522,0,4,11526,T
5-NP,213,0,11366,1,3,11370,T
5-NP,214,2,4,11437,0,11443,G
5-NP,215,11320,3,15,27,11365,A
5-NP,216,1,11351,2,11,11365,T
5-NP,217,2,8,11362,1,11373,G
5-NP,218,11279,2,21,0,11302,A
5-NP,219,11329,0,9,2,11340,A
5-NP,220,11341,1,11,1,11354,A
5-NP,221,0,7,11386,0,11393,G
5-NP,222,11364,2,23,0,11389,A
5-NP,223,11350,1,15,1,11367,A
5-NP,224,1,8,11507,0,11516,G
5-NP,225,4,10,11970,0,11984,G
5-NP,226,12013,0,14,0,12027,A
5-NP,227,12145,4,13,0,12162,A
5-NP,228,1,12135,0,1,12137,T
5-NP,229,12149,2,7,0,12158,A
5-NP,230,12121,2,6,2,12131,A
5-NP,231,12172,2,9,1,12184,A
5-NP,232,0,12180,2,5,12187,T
5-NP,233,12218,1,7,0,12226,A
5-NP,234,1,0,0,12228,12229,C
5-NP,235,5,1,0,11974,11980,C
5-NP,236,2,11905,0,13,11920,T
5-NP,237,2,9,11948,0,11959,G
5-NP,238,1,5,12157,1,12164,G
5-NP,239,12179,1,5,0,12185,A
5-NP,240,12118,1,13,0,12132,A
5-NP,241,4,19,12320,0,12343,G
5-NP,242,12254,2,16,1,12273,A
5-NP,243,12229,0,16,2,12247,A
5-NP,244,3,9,1,12206,12219,C
5-NP,245,12156,2,22,1,12181,A
5-NP,246,4,3,1,12529,12537,C
5-NP,247,11,2,0,12315,12328,C
5-NP,248,17,1,1,12298,12317,C
5-NP,249,13,1,1,12306,12321,C
5-NP,250,12145,0,14,2,12161,A
5-NP,251,0,2,12187,0,12189,G
5-NP,252,3,1,0,12146,12150,C
5-NP,253,1,1,12167,2,12171,G
5-NP,254,5,4,1,12170,12180,C
5-NP,255,4,10,12014,0,12028,G
5-NP,256,13,10,12147,1,12171,G
5-NP,257,6,10,12088,1,12105,G
5-NP,258,0,5,12219,0,12224,G
5-NP,259,12221,1,3,0,12225,A
5-NP,260,12209,1,7,0,12217,A
5-NP,261,12162,3,29,1,12195,A
5-NP,262,1,4,12221,0,12226,G
5-NP,263,12184,0,15,0,12199,A
5-NP,264,1,12116,0,6,12123,T
5-NP,265,7,2,0,12073,12082,C
5-NP,266,15,2,1,12007,12025,C
5-NP,267,23,2,0,12050,12075,C
5-NP,268,12127,1,6,1,12135,A
5-NP,269,12128,1,5,1,12135,A
5-NP,270,1,7,12209,0,12217,G
5-NP,271,12154,0,3,2,12159,A
5-NP,272,12255,0,4,1,12260,A
5-NP,273,12232,1,4,1,12238,A
5-NP,274,12251,2,9,1,12263,A
5-NP,275,2,3,0,12356,12361,C
5-NP,276,2,12210,4,5,12221,T
5-NP,277,3,8,12251,2,12264,G
5-NP,278,3,8,12221,0,12232,G
5-NP,279,11995,2,32,1,12030,A
5-NP,280,5,8,12053,1,12067,G
5-NP,281,4,8,12213,0,12225,G
5-NP,282,3,0,12525,1,12529,G
5-NP,283,5,4,2,13523,13534,C
5-NP,284,7,4,0,13462,13473,C
5-NP,285,22,4,1,13564,13591,C
5-NP,286,15165,1,10,0,15176,A
5-NP,287,0,15243,1,9,15253,T
5-NP,288,16170,0,6,1,16177,A
5-NP,289,1,16181,0,3,16185,T
5-NP,290,15920,0,13,1,15934,A
5-NP,291,19,3,1,16052,16075,C
5-NP,292,14393,5,12,1,14411,A
5-NP,293,4,7,14656,1,14668,G
5-NP,294,4,21,14604,0,14629,G
5-NP,295,13050,3,11,2,13066,A
5-NP,296,7,16,13265,0,13288,G
5-NP,297,12380,3,28,0,12411,A
5-NP,298,0,2,12642,0,12644,G
5-NP,299,1,12571,1,1,12574,T
5-NP,300,12484,3,7,1,12495,A
5-NP,301,0,7,12513,1,12521,G
5-NP,302,12269,0,26,2,12297,A
5-NP,303,2,12292,1,10,12305,T
5-NP,304,3,7,12280,0,12290,G
5-NP,305,2,6,12377,0,12385,G
5-NP,306,12319,0,5,0,12324,A
5-NP,307,12246,0,4,0,12250,A
5-NP,308,12205,0,2,0,12207,A
5-NP,309,12269,2,14,1,12286,A
5-NP,310,1,12274,0,3,12278,T
5-NP,311,3,10,12385,1,12399,G
5-NP,312,1,5,12376,1,12383,G
5-NP,313,12322,7,20,0,12349,A
5-NP,314,1,12277,0,15,12293,T
5-NP,315,4,10,12300,1,12315,G
5-NP,316,12294,0,19,0,12313,A
5-NP,317,6,15,12350,1,12372,G
5-NP,318,3,11,12300,1,12315,G
5-NP,319,17,17,12314,0,12348,G
5-NP,320,12336,3,14,0,12353,A
5-NP,321,12389,2,9,1,12401,A
5-NP,322,2,5,0,12469,12476,C
5-NP,323,2,12391,2,28,12423,T
5-NP,324,13,11,1,12509,12534,C
5-NP,325,7,4,12517,0,12528,G
5-NP,326,2,12509,1,30,12542,T
5-NP,327,6,1,2,12576,12585,C
5-NP,328,9,2,1,13218,13230,C
5-NP,329,0,13097,0,20,13117,T
5-NP,330,1,13147,3,16,13167,T
5-NP,331,0,13125,0,19,13144,T
5-NP,332,13163,1,14,0,13178,A
5-NP,333,1,13113,0,17,13131,T
5-NP,334,4,14,13112,1,13131,G
5-NP,335,13167,3,22,0,13192,A
5-NP,336,6,0,0,13169,13175,C
5-NP,337,12837,1,1,1,12840,A
5-NP,338,12854,1,4,0,12859,A
5-NP,339,12872,1,9,0,12882,A
5-NP,340,1,5,13349,0,13355,G
5-NP,341,13291,2,9,0,13302,A
5-NP,342,13313,0,19,0,13332,A
5-NP,343,1,8,13741,0,13750,G
5-NP,344,13769,2,14,0,13785,A
5-NP,345,13799,1,17,0,13817,A
5-NP,346,13810,1,5,1,13817,A
5-NP,347,0,13797,0,18,13815,T
5-NP,348,13769,0,10,0,13779,A
5-NP,349,13563,3,25,0,13591,A
5-NP,350,3,12,13644,1,13660,G
5-NP,351,0,2,13631,0,13633,G
5-NP,352,3,12,0,13435,13450,C
5-NP,353,3,14,13439,1,13457,G
5-NP,354,13424,2,17,1,13444,A
5-NP,355,13582,0,5,1,13588,A
5-NP,356,1,13573,1,10,13585,T
5-NP,357,8,1,0,13614,13623,C
5-NP,358,2,13572,1,10,13585,T
5-NP,359,5,8,13577,0,13590,G
5-NP,360,3,2,13530,1,13536,G
5-NP,361,1,8,1,13580,13590,C
5-NP,362,12,2,13583,0,13597,G
5-NP,363,1,5,1,13561,13568,C
5-NP,364,19,2,1,13490,13512,C
5-NP,365,13563,0,14,0,13577,A
5-NP,366,13715,1,12,1,13729,A
5-NP,367,2,0,13947,1,13950,G
5-NP,368,0,7,0,13923,13930,C
5-NP,369,11,6,1,14042,14060,C
5-NP,370,14083,1,15,5,14104,A
5-NP,371,14264,1,17,0,14282,A
5-NP,372,2,2,1,14393,14398,C
5-NP,373,14388,0,9,0,14397,A
5-NP,374,14569,0,10,0,14579,A
5-NP,375,1,14481,0,4,14486,T
5-NP,376,4,10,14605,1,14620,G
5-NP,377,8,2,14597,0,14607,G
5-NP,378,1,14406,1,14,14422,T
5-NP,379,5,10,14429,0,14444,G
5-NP,380,14292,2,16,0,14310,A
5-NP,381,3,11,14526,1,14541,G
5-NP,382,2,14,14539,0,14555,G
5-NP,383,14561,1,8,0,14570,A
5-NP,384,0,15321,0,5,15326,T
5-NP,385,6,4,15312,0,15322,G
5-NP,386,2,7,8,15321,15338,C
5-NP,387,3,15332,2,23,15360,T
5-NP,388,15423,4,7,0,15434,A
5-NP,389,4,3,1,15632,15640,C
5-NP,390,15324,1,4,1,15330,A
5-NP,391,2,15266,1,24,15293,T
5-NP,392,4,1,0,15183,15188,C
5-NP,393,2,14315,0,13,14330,T
5-NP,394,6,8,14801,0,14815,G
5-NP,395,2,2,15085,1,15090,G
5-NP,396,0,15043,0,30,15073,T
5-NP,397,14,8,1,15035,15058,C
5-NP,398,0,14845,0,27,14872,T
5-NP,399,15044,2,4,0,15050,A
5-NP,400,15067,0,8,1,15076,A
5-NP,401,2,2,0,15184,15188,C
5-NP,402,1,15062,0,41,15104,T
5-NP,403,16,1,1,15142,15160,C
5-NP,404,14917,3,10,1,14931,A
5-NP,405,2,5,0,15442,15449,C
5-NP,406,15462,1,12,0,15475,A
5-NP,407,1,15517,0,17,15535,T
5-NP,408,15283,1,6,2,15292,A
5-NP,409,15316,1,12,1,15330,A
5-NP,410,2,15337,0,4,15343,T
5-NP,411,4,15,15488,0,15507,G
5-NP,412,15352,0,2,0,15354,A
5-NP,413,0,15168,4,9,15181,T
5-NP,414,0,14797,0,17,14814,T
5-NP,415,1,14775,3,23,14802,T
5-NP,416,3,10,14711,1,14725,G
5-NP,417,13,3,14752,0,14768,G
5-NP,418,2,4,1,14752,14759,C
5-NP,419,14692,1,9,0,14702,A
5-NP,420,0,14627,0,15,14642,T
5-NP,421,2,14559,5,25,14591,T
5-NP,422,8,0,0,14603,14611,C
5-NP,423,4,6,2,14628,14640,C
5-NP,424,14923,1,6,0,14930,A
5-NP,425,14921,0,7,0,14928,A
5-NP,426,1,14905,1,4,14911,T
5-NP,427,3,14896,1,13,14913,T
5-NP,428,3,14877,1,7,14888,T
5-NP,429,0,15,14994,0,15009,G
5-NP,430,14956,1,13,3,14973,A
5-NP,431,15004,3,13,1,15021,A
5-NP,432,3,15061,0,3,15067,T
5-NP,433,1,8,14841,1,14851,G
5-NP,434,15341,1,16,1,15359,A
5-NP,435,1,15372,2,16,15391,T
5-NP,436,4,3,15434,1,15442,G
5-NP,437,4,5,0,15781,15790,C
5-NP,438,15749,1,21,1,15772,A
5-NP,439,16386,1,23,0,16410,A
5-NP,440,0,8,1,16414,16423,C
5-NP,441,16591,4,6,0,16601,A
5-NP,442,1,16951,0,7,16959,T
5-NP,443,16500,6,13,0,16519,A
5-NP,444,3,15,0,16764,16782,C
5-NP,445,7,7,0,16746,16760,C
5-NP,446,16219,1,17,0,16237,A
5-NP,447,0,9,16401,1,16411,G
5-NP,448,15828,1,26,1,15856,A
5-NP,449,3,23,16236,0,16262,G
5-NP,450,5,5,16068,1,16079,G
5-NP,451,15887,5,29,1,15922,A
5-NP,452,0,7,0,16039,16046,C
5-NP,453,15802,0,12,1,15815,A
5-NP,454,15764,2,37,1,15804,A
5-NP,455,2,24,15847,0,15873,G
5-NP,456,15487,0,47,4,15538,A
5-NP,457,4,1,15720,0,15725,G
5-NP,458,1,3,0,15496,15500,C
5-NP,459,1,15250,2,52,15305,T
5-NP,460,16,0,2,15427,15445,C
5-NP,461,2,15347,2,33,15384,T
5-NP,462,4,15452,1,4,15461,T
5-NP,463,1,3,15519,1,15524,G
5-NP,464,4,15402,1,11,15418,T
5-NP,465,3,15388,1,9,15401,T
5-NP,466,20,14,1,15309,15344,C
5-NP,467,6,33,15268,0,15307,G
5-NP,468,15568,1,3,1,15573,A
5-NP,469,15525,0,3,0,15528,A
5-NP,470,3,4,1,15641,15649,C
5-NP,471,3,15573,0,24,15600,T
5-NP,472,7,13,15816,0,15836,G
5-NP,473,3,15,15893,1,15912,G
5-NP,474,15917,0,17,0,15934,A
5-NP,475,15929,0,27,2,15958,A
5-NP,476,3,15906,2,5,15916,T
5-NP,477,2,21,15760,0,15783,G
5-NP,478,0,12,15790,0,15802,G
5-NP,479,15836,1,27,0,15864,A
5-NP,480,1,15929,0,11,15941,T
5-NP,481,9,8,0,15832,15849,C
5-NP,482,10,11,0,15775,15796,C
5-NP,483,33,3,1,15853,15890,C
5-NP,484,15969,1,8,0,15978,A
5-NP,485,2,11,16082,2,16097,G
5-NP,486,16020,1,3,1,16025,A
5-NP,487,16003,0,6,0,16009,A
5-NP,488,0,15740,2,3,15745,T
5-NP,489,6,5,15914,0,15925,G
5-NP,490,1,15750,0,11,15762,T
5-NP,491,11,0,15799,0,15810,G
5-NP,492,2,10,1,15787,15800,C
5-NP,493,3,15633,0,30,15666,T
5-NP,494,21,0,0,16515,16536,C
5-NP,495,3,16393,1,18,16415,T
5-NP,496,7,3,0,16962,16972,C
5-NP,497,1,16932,1,10,16944,T
5-NP,498,1,7,16885,0,16893,G
5-NP,499,16953,1,29,2,16985,A
5-NP,500,0,16882,0,7,16889,T
5-NP,501,2,3,16872,0,16877,G
5-NP,502,2,4,0,16823,16829,C
5-NP,503,15992,1,18,1,16012,A
5-NP,504,7,22,16321,0,16350,G
5-NP,505,6,9,15918,1,15934,G
5-NP,506,7,2,16081,1,16091,G
5-NP,507,9,7,0,16028,16044,C
5-NP,508,5,15918,0,29,15952,T
5-NP,509,15,6,1,15973,15995,C
5-NP,510,4,24,16012,0,16040,G
5-NP,511,16224,1,16,2,16243,A
5-NP,512,2,2,0,16242,16246,C
5-NP,513,4,15810,0,36,15850,T
5-NP,514,10,2,1,16516,16529,C
5-NP,515,6,16283,1,30,16320,T
5-NP,516,15,5,2,18275,18297,C
5-NP,517,16,5,0,18300,18321,C
5-NP,518,28,4,1,18301,18334,C
5-NP,519,3,18291,1,13,18308,T
5-NP,520,18121,2,3,1,18127,A
5-NP,521,3,10,18126,0,18139,G
5-NP,522,18108,2,4,1,18115,A
5-NP,523,17394,2,20,0,17416,A
5-NP,524,3,17,17355,0,17375,G
5-NP,525,6,3,16734,0,16743,G
5-NP,526,3,16320,0,19,16342,T
5-NP,527,17,2,0,16314,16333,C
5-NP,528,13,7,0,16350,16370,C
5-NP,529,10,12,16322,2,16346,G
5-NP,530,0,12,16441,0,16453,G
5-NP,531,16333,2,23,0,16358,A
5-NP,532,3,3,16581,0,16587,G
5-NP,533,4,3,0,16602,16609,C
5-NP,534,1,16279,1,36,16317,T
5-NP,535,4,1,16340,0,16345,G
5-NP,536,3,3,2,16353,16361,C
5-NP,537,16289,6,47,1,16343,A
5-NP,538,11,9,16380,1,16401,G
5-NP,539,2,5,16415,1,16423,G
5-NP,540,1,16365,0,15,16381,T
5-NP,541,6,3,16120,0,16129,G
5-NP,542,3,8,0,16216,16227,C
5-NP,543,6,16163,2,24,16195,T
5-NP,544,8,2,16233,1,16244,G
5-NP,545,1,6,1,16196,16204,C
5-NP,546,16350,3,13,2,16368,A
5-NP,547,1,2,16616,0,16619,G
5-NP,548,2,16372,0,13,16387,T
5-NP,549,26,2,5,16432,16465,C
5-NP,550,16438,1,10,2,16451,A
5-NP,551,16457,2,13,1,16473,A
5-NP,552,16400,2,39,3,16444,A
5-NP,553,3,5,16540,0,16548,G
5-NP,554,3,15,16595,1,16614,G
5-NP,555,16411,4,5,0,16420,A
5-NP,556,16231,0,11,1,16243,A
5-NP,557,3,16207,0,4,16214,T
5-NP,558,14,9,2,16162,16187,C
5-NP,559,7,21,16172,0,16200,G
5-NP,560,11,9,16592,0,16612,G
5-NP,561,11,15,16616,2,16644,G
5-NP,562,16525,1,23,1,16550,A
5-NP,563,7,7,1,16551,16566,C
5-NP,564,16303,1,12,2,16318,A
5-NP,565,16609,1,13,1,16624,A
5-NP,566,2,16647,0,3,16652,T
5-NP,567,4,12,16736,1,16753,G
5-NP,568,7,1,17117,0,17125,G
5-NP,569,4,16754,0,13,16771,T
5-NP,570,17,10,16829,2,16858,G
5-NP,571,16808,2,25,3,16838,A
5-NP,572,3,16733,0,17,16753,T
5-NP,573,3,15,16759,0,16777,G
5-NP,574,4,25,16833,2,16864,G
5-NP,575,16758,3,18,2,16781,A
5-NP,576,16742,1,11,1,16755,A
5-NP,577,0,1,0,16747,16748,C
5-NP,578,0,15968,1,12,15981,T
5-NP,579,3,12,16736,0,16751,G
5-NP,580,16662,0,21,1,16684,A
5-NP,581,7,16664,1,4,16676,T
5-NP,582,16,4,0,16741,16761,C
5-NP,583,16334,1,6,1,16342,A
5-NP,584,5,11,16730,1,16747,G
5-NP,585,16640,2,3,2,16647,A
5-NP,586,16655,2,8,0,16665,A
5-NP,587,4,16668,0,1,16673,T
5-NP,588,5,10,16037,0,16052,G
5-NP,589,3,2,16271,0,16276,G
5-NP,590,2,16224,0,21,16247,T
5-NP,591,18,3,1,16206,16228,C
5-NP,592,16218,1,2,2,16223,A
5-NP,593,15984,5,15,0,16004,A
5-NP,594,16023,2,11,0,16036,A
5-NP,595,1,8,0,16038,16047,C
5-NP,596,8,23,15964,2,15997,G
5-NP,597,1,18,15966,0,15985,G
5-NP,598,4,21,15759,0,15784,G
5-NP,599,7,19,15815,1,15842,G
5-NP,600,7,11,15846,1,15865,G
5-NP,601,15824,2,33,0,15859,A
5-NP,602,2,15640,1,31,15674,T
5-NP,603,15,2,1,15656,15674,C
5-NP,604,15718,1,20,1,15740,A
5-NP,605,15758,4,21,0,15783,A
5-NP,606,1,10,1,15567,15579,C
5-NP,607,6,7,15474,0,15487,G
5-NP,608,15392,2,8,1,15403,A
5-NP,609,5,15344,0,6,15355,T
5-NP,610,13,5,0,15367,15385,C
5-NP,611,4,12,15402,0,15418,G
5-NP,612,15375,1,4,0,15380,A
5-NP,613,15322,1,3,1,15327,A
5-NP,614,15352,0,4,1,15357,A
5-NP,615,1,15623,1,1,15626,T
5-NP,616,3,15632,0,10,15645,T
5-NP,617,1,15592,1,11,15605,T
5-NP,618,2,15679,1,4,15686,T
5-NP,619,1,15737,0,2,15740,T
5-NP,620,6,17,15703,0,15726,G
5-NP,621,0,17,15726,0,15743,G
5-NP,622,15525,2,30,2,15559,A
5-NP,623,1,6,15756,1,15764,G
5-NP,624,15291,3,19,3,15316,A
5-NP,625,3,9,16146,0,16158,G
5-NP,626,4,0,16208,1,16213,G
5-NP,627,1,16145,1,17,16164,T
5-NP,628,3,19,16204,1,16227,G
5-NP,629,16119,3,36,1,16159,A
5-NP,630,3,14,16269,0,16286,G
5-NP,631,16177,4,24,2,16207,A
5-NP,632,16179,0,10,0,16189,A
5-NP,633,1,16111,0,1,16113,T
5-NP,634,3,37,15277,0,15317,G
5-NP,635,4,9,15072,1,15086,G
5-NP,636,3,6,15101,0,15110,G
5-NP,637,5,15,0,15033,15053,C
5-NP,638,4,6,15070,0,15080,G
5-NP,639,5,7,15166,0,15178,G
5-NP,640,15135,2,3,0,15140,A
5-NP,641,15158,1,7,0,15166,A
5-NP,642,15405,3,7,1,15416,A
5-NP,643,15445,1,24,4,15474,A
5-NP,644,2,3,0,15582,15587,C
5-NP,645,15509,5,6,0,15520,A
5-NP,646,15476,3,19,1,15499,A
5-NP,647,2,7,15502,0,15511,G
5-NP,648,14919,3,11,0,14933,A
5-NP,649,14996,0,11,0,15007,A
5-NP,650,1,4,15450,0,15455,G
5-NP,651,0,15403,0,3,15406,T
5-NP,652,4,0,16315,0,16319,G
5-NP,653,3,3,1,16208,16215,C
5-NP,654,1,16172,2,40,16215,T
5-NP,655,0,16290,0,12,16302,T
5-NP,656,16498,0,3,0,16501,A
5-NP,657,2,16502,0,9,16513,T
5-NP,658,1,10,16574,1,16586,G
5-NP,659,16014,1,33,0,16048,A
5-NP,660,8,17,16130,0,16155,G
5-NP,661,14976,3,21,0,15000,A
5-NP,662,0,8,15132,0,15140,G
5-NP,663,15020,2,13,2,15037,A
5-NP,664,15182,0,10,0,15192,A
5-NP,665,0,15022,0,9,15031,T
5-NP,666,3,0,15253,0,15256,G
5-NP,667,3,15148,1,16,15168,T
5-NP,668,8,2,15202,0,15212,G
5-NP,669,5,15,2,15140,15162,C
5-NP,670,15097,1,12,0,15110,A
5-NP,671,15101,5,35,2,15143,A
5-NP,672,3,3,0,15078,15084,C
5-NP,673,14905,1,2,0,14908,A
5-NP,674,1,14979,2,11,14993,T
5-NP,675,2,14743,2,19,14766,T
5-NP,676,6,1,1,14794,14802,C
5-NP,677,1,14721,0,9,14731,T
5-NP,678,2,14714,0,4,14720,T
5-NP,679,14751,3,5,2,14761,A
5-NP,680,14646,1,8,1,14656,A
5-NP,681,14661,2,16,0,14679,A
5-NP,682,3,6,14681,1,14691,G
5-NP,683,2,7,14639,0,14648,G
5-NP,684,14516,1,20,0,14537,A
5-NP,685,14507,0,6,0,14513,A
5-NP,686,14478,0,8,0,14486,A
5-NP,687,14800,0,5,1,14806,A
5-NP,688,0,14752,1,8,14761,T
5-NP,689,1,14736,0,6,14743,T
5-NP,690,2,14808,1,4,14815,T
5-NP,691,6,2,2,14826,14836,C
5-NP,692,14832,1,4,0,14837,A
5-NP,693,14823,0,5,1,14829,A
5-NP,694,14796,2,20,1,14819,A
5-NP,695,2,4,0,15020,15026,C
5-NP,696,14720,2,3,0,14725,A
5-NP,697,0,1,15053,0,15054,G
5-NP,698,1,3,0,15023,15027,C
5-NP,699,3,14978,1,16,14998,T
5-NP,700,6,3,15311,0,15320,G
5-NP,701,2,8,1,15287,15298,C
5-NP,702,15403,3,24,4,15434,A
5-NP,703,2,9,1,15423,15435,C
5-NP,704,15279,2,8,1,15290,A
5-NP,705,15363,1,18,1,15383,A
5-NP,706,14914,1,18,2,14935,A
5-NP,707,0,17,15646,0,15663,G
5-NP,708,15491,3,43,2,15539,A
5-NP,709,40,2,15593,1,15636,G
5-NP,710,3,7,1,15558,15569,C
5-NP,711,15582,1,4,1,15588,A
5-NP,712,16146,1,15,2,16164,A
5-NP,713,2,16131,1,11,16145,T
5-NP,714,6,17,16173,1,16197,G
5-NP,715,25,3,16273,1,16302,G
5-NP,716,6,15541,3,17,15567,T
5-NP,717,18,16,15569,0,15603,G
5-NP,718,4,13,15713,0,15730,G
5-NP,719,15693,2,20,0,15715,A
5-NP,720,1,15629,0,25,15655,T
5-NP,721,14,2,1,15160,15177,C
5-NP,722,15212,3,12,0,15227,A
5-NP,723,15373,0,8,1,15382,A
5-NP,724,0,4,15456,0,15460,G
5-NP,725,2,15286,1,13,15302,T
5-NP,726,1,17,15323,2,15343,G
5-NP,727,15030,3,45,0,15078,A
5-NP,728,1,17,15177,0,15195,G
5-NP,729,15082,7,39,2,15130,A
5-NP,730,1,6,15174,0,15181,G
5-NP,731,15042,0,16,1,15059,A
5-NP,732,14736,2,0,0,14738,A
5-NP,733,14825,3,17,3,14848,A
5-NP,734,5,4,14941,1,14951,G
5-NP,735,0,14897,1,5,14903,T
5-NP,736,19,5,1,14866,14891,C
5-NP,737,5,12,14806,0,14823,G
5-NP,738,20,9,14819,0,14848,G
5-NP,739,14830,1,21,1,14853,A
5-NP,740,14929,1,12,0,14942,A
5-NP,741,1,2,0,15015,15018,C
5-NP,742,15,6,1,14852,14874,C
5-NP,743,22,4,2,14866,14894,C
5-NP,744,14793,0,20,1,14814,A
5-NP,745,4,13,14855,0,14872,G
5-NP,746,3,9,14883,0,14895,G
5-NP,747,14806,2,5,0,14813,A
5-NP,748,14786,3,4,1,14794,A
5-NP,749,14744,1,18,2,14765,A
5-NP,750,1,2,0,14847,14850,C
5-NP,751,20,1,14809,0,14830,G
5-NP,752,3,2,0,14795,14800,C
5-NP,753,0,14730,1,13,14744,T
5-NP,754,3,10,14746,2,14761,G
5-NP,755,14629,1,16,2,14648,A
5-NP,756,2,10,14965,0,14977,G
5-NP,757,14976,1,14,0,14991,A
5-NP,758,2,14959,1,6,14968,T
5-NP,759,12,24,3,14788,14827,C
5-NP,760,7,4,14846,0,14857,G
5-NP,761,14855,3,6,0,14864,A
5-NP,762,14809,3,12,3,14827,A
5-NP,763,4,3,14897,0,14904,G
5-NP,764,14937,0,5,0,14942,A
5-NP,765,4,14753,0,9,14766,T
5-NP,766,7,0,0,14989,14996,C
5-NP,767,3,14939,0,25,14967,T
5-NP,768,4,2,1,15055,15062,C
5-NP,769,15103,1,6,0,15110,A
5-NP,770,3,15095,2,4,15104,T
5-NP,771,15139,0,1,0,15140,A
5-NP,772,0,15059,2,8,15069,T
5-NP,773,1,14940,2,5,14948,T
5-NP,774,1,14892,0,9,14902,T
5-NP,775,2,14697,0,6,14705,T
5-NP,776,1,14731,1,0,14733,T
5-NP,777,14761,2,5,0,14768,A
5-NP,778,3,4,14771,1,14779,G
5-NP,779,4,11,0,14769,14784,C
5-NP,780,14698,1,7,0,14706,A
5-NP,781,14605,4,13,1,14623,A
5-NP,782,4,10,15219,1,15234,G
5-NP,783,15170,2,10,0,15182,A
5-NP,784,0,15223,1,3,15227,T
5-NP,785,4,8,0,15367,15379,C
5-NP,786,2,15263,5,25,15295,T
5-NP,787,6,3,15843,1,15853,G
5-NP,788,3,8,1,15890,15902,C
5-NP,789,15905,1,9,0,15915,A
5-NP,790,0,16109,0,3,16112,T
5-NP,791,2,15475,0,14,15491,T
5-NP,792,5,8,16818,0,16831,G
5-NP,793,17160,4,10,1,17175,A
5-NP,794,1,17209,1,6,17217,T
5-NP,795,17280,0,11,1,17292,A
5-NP,796,1,16788,2,14,16805,T
5-NP,797,6,16689,1,6,16702,T
5-NP,798,4,24,16813,1,16842,G
5-NP,799,16583,1,24,0,16608,A
5-NP,800,4,12,16807,0,16823,G
5-NP,801,15719,3,32,0,15754,A
5-NP,802,3,18,15497,1,15519,G
5-NP,803,5,15,15744,1,15765,G
5-NP,804,15668,2,24,1,15695,A
5-NP,805,3,15652,2,22,15679,T
5-NP,806,13,3,0,15752,15768,C
5-NP,807,15660,4,30,0,15694,A
5-NP,808,1,3,15771,0,15775,G
5-NP,809,2,15671,0,16,15689,T
5-NP,810,1,15557,0,9,15567,T
5-NP,811,4,4,15600,2,15610,G
5-NP,812,7,3,0,15455,15465,C
5-NP,813,0,15373,0,30,15403,T
5-NP,814,28,6,1,15517,15552,C
5-NP,815,15588,3,12,0,15603,A
5-NP,816,2,7,0,15599,15608,C
5-NP,817,15557,1,5,2,15565,A
5-NP,818,15676,2,9,0,15687,A
5-NP,819,15718,1,1,0,15720,A
5-NP,820,0,15657,1,8,15666,T
5-NP,821,14,3,0,15722,15739,C
5-NP,822,2,15634,3,18,15657,T
5-NP,823,3,15614,2,4,15623,T
5-NP,824,6,3,15667,0,15676,G
5-NP,825,4,9,0,15668,15681,C
5-NP,826,9,10,0,15927,15946,C
5-NP,827,0,15863,2,13,15878,T
5-NP,828,15961,1,12,1,15975,A
5-NP,829,5,4,1,15939,15949,C
5-NP,830,12,6,1,15907,15926,C
5-NP,831,3,15850,3,29,15885,T
5-NP,832,7,0,16146,1,16154,G
5-NP,833,7,6,1,16069,16083,C
5-NP,834,5,1,1,16136,16143,C
5-NP,835,1,15777,3,21,15802,T
5-NP,836,8,5,16004,1,16018,G
5-NP,837,1,15855,4,21,15881,T
5-NP,838,10,5,16038,2,16055,G
5-NP,839,6,10,1,16150,16167,C
5-NP,840,12,1,16411,0,16424,G
5-NP,841,3,16113,0,6,16122,T
5-NP,842,16072,2,7,0,16081,A
5-NP,843,0,16075,0,14,16089,T
5-NP,844,4,18,16046,0,16068,G
5-NP,845,4,10,16780,0,16794,G
5-NP,846,16718,4,27,0,16749,A
5-NP,847,1,4,0,16465,16470,C
5-NP,848,14,1,1,16443,16459,C
5-NP,849,3,16119,1,30,16153,T
5-NP,850,11,1,17064,0,17076,G
5-NP,851,6,8,1,17085,17100,C
5-NP,852,17117,4,22,1,17144,A
5-NP,853,2,0,17448,0,17450,G
5-NP,854,0,16399,1,5,16405,T
5-NP,855,17128,1,5,1,17135,A
5-NP,856,1,17008,2,35,17046,T
5-NP,857,10,5,4,16952,16971,C
5-NP,858,10,5,0,16994,17009,C
5-NP,859,15945,1,9,0,15955,A
5-NP,860,4,4,16038,1,16047,G
5-NP,861,1,15966,0,8,15975,T
5-NP,862,6,27,16154,0,16187,G
5-NP,863,2,9,16093,0,16104,G
5-NP,864,3,4,15783,0,15790,G
5-NP,865,3,15730,2,21,15756,T
5-NP,866,15714,1,11,0,15726,A
5-NP,867,14,5,1,15725,15745,C
5-NP,868,50,18,15610,0,15678,G
5-NP,869,15609,1,13,1,15624,A
5-NP,870,5,4,0,15610,15619,C
5-NP,871,2,15082,1,13,15098,T
5-NP,872,3,15122,1,7,15133,T
5-NP,873,7,9,2,15084,15102,C
5-NP,874,6,11,15108,1,15126,G
5-NP,875,15107,1,10,0,15118,A
5-NP,876,15123,1,3,1,15128,A
5-NP,877,15161,0,5,1,15167,A
5-NP,878,15145,1,0,1,15147,A
5-NP,879,15069,0,30,0,15099,A
5-NP,880,1,7,15143,1,15152,G
5-NP,881,15065,1,39,0,15105,A
5-NP,882,3,22,15243,1,15269,G
5-NP,883,8,13,15340,0,15361,G
5-NP,884,1,6,15408,0,15415,G
5-NP,885,15394,0,34,0,15428,A
5-NP,886,1,15405,0,17,15423,T
5-NP,887,15545,0,12,1,15558,A
5-NP,888,0,15523,2,9,15534,T
5-NP,889,2,15532,2,3,15539,T
5-NP,890,11,2,1,15680,15694,C
5-NP,891,6,3,0,15520,15529,C
5-NP,892,0,15263,1,3,15267,T
5-NP,893,3,15256,1,5,15265,T
5-NP,894,5,6,15412,0,15423,G
5-NP,895,6,3,15554,0,15563,G
5-NP,896,0,15390,1,9,15400,T
5-NP,897,2,20,15310,0,15332,G
5-NP,898,6,7,15186,0,15199,G
5-NP,899,7,5,15878,0,15890,G
5-NP,900,15856,3,8,1,15868,A
5-NP,901,15890,0,15,0,15905,A
5-NP,902,2,15891,6,2,15901,T
5-NP,903,15576,1,14,0,15591,A
5-NP,904,8,16,15560,0,15584,G
5-NP,905,15438,2,30,0,15470,A
5-NP,906,4,5,0,15420,15429,C
5-NP,907,23,2,0,15230,15255,C
5-NP,908,27,0,0,14534,14561,C
5-NP,909,3,14643,2,33,14681,T
5-NP,910,0,14670,0,9,14679,T
5-NP,911,2,14687,0,11,14700,T
5-NP,912,10,4,0,14702,14716,C
5-NP,913,14669,0,5,0,14674,A
5-NP,914,14662,2,5,1,14670,A
5-NP,915,14622,0,7,1,14630,A
5-NP,916,0,5,0,14631,14636,C
5-NP,917,2,14094,1,7,14104,T
5-NP,918,13954,2,4,0,13960,A
5-NP,919,1,2,0,14128,14131,C
5-NP,920,0,13978,1,22,14001,T
5-NP,921,2,13962,2,11,13977,T
5-NP,922,6,4,0,14061,14071,C
5-NP,923,14008,0,5,0,14013,A
5-NP,924,14004,0,4,0,14008,A
5-NP,925,13918,1,3,1,13923,A
5-NP,926,13919,0,10,0,13929,A
5-NP,927,0,13766,1,5,13772,T
5-NP,928,13440,1,9,1,13451,A
5-NP,929,1,3,13684,0,13688,G
5-NP,930,0,7,0,13725,13732,C
5-NP,931,18,6,0,13907,13931,C
5-NP,932,13940,0,6,0,13946,A
5-NP,933,13977,0,15,0,13992,A
5-NP,934,14456,0,6,0,14462,A
5-NP,935,2,14470,0,1,14473,T
5-NP,936,14544,1,7,1,14553,A
5-NP,937,1,14527,1,7,14536,T
5-NP,938,14158,3,12,1,14174,A
5-NP,939,2,3,0,14204,14209,C
5-NP,940,13618,0,16,0,13634,A
5-NP,941,6,1,14003,0,14010,G
5-NP,942,1,2,0,13916,13919,C
5-NP,943,2,13294,5,23,13324,T
5-NP,944,3,13429,1,4,13437,T
5-NP,945,13480,0,2,0,13482,A
5-NP,946,13486,0,4,0,13490,A
5-NP,947,0,13454,0,5,13459,T
5-NP,948,12,0,0,13456,13468,C
5-NP,949,12745,0,16,1,12762,A
5-NP,950,3,12,12858,2,12875,G
5-NP,951,12859,2,15,0,12876,A
5-NP,952,5,1,0,12945,12951,C
5-NP,953,9,0,0,12770,12779,C
5-NP,954,1,12509,1,18,12529,T
5-NP,955,12637,0,7,0,12644,A
5-NP,956,12624,1,7,1,12633,A
5-NP,957,3,3,0,12701,12707,C
5-NP,958,3,9,12691,0,12703,G
5-NP,959,12305,1,6,1,12313,A
5-NP,960,1,7,12342,2,12352,G
5-NP,961,12144,1,14,2,12161,A
5-NP,962,12245,1,2,1,12249,A
5-NP,963,3,12206,1,12,12222,T
5-NP,964,8,1,1,12052,12062,C
5-NP,965,7,7,0,12054,12068,C
5-NP,966,11582,1,21,1,11605,A
5-NP,967,3,4,11652,0,11659,G
5-NP,968,2,4,0,11656,11662,C
5-NP,969,11742,3,4,0,11749,A
5-NP,970,2,2,0,11781,11785,C
5-NP,971,11500,2,14,0,11516,A
5-NP,972,2,6,0,11530,11538,C
5-NP,973,11488,1,5,4,11498,A
5-NP,974,11489,0,26,2,11517,A
5-NP,975,0,8,11530,1,11539,G
5-NP,976,11229,2,21,0,11252,A
5-NP,977,0,0,11316,0,11316,G
5-NP,978,0,10895,0,5,10900,T
5-NP,979,16,2,0,10820,10838,C
5-NP,980,10739,1,23,1,10764,A
5-NP,981,4,2,10739,0,10745,G
5-NP,982,4,2,0,10712,10718,C
5-NP,983,3,10531,0,11,10545,T
5-NP,984,3,8,10530,1,10542,G
5-NP,985,2,2,10548,0,10552,G
5-NP,986,0,10377,0,7,10384,T
5-NP,987,3,1,10434,0,10438,G
5-NP,988,3,10220,0,15,10238,T
5-NP,989,5,8,10169,0,10182,G
5-NP,990,1,2,10137,0,10140,G
5-NP,991,9972,0,21,3,9996,A
5-NP,992,0,10044,0,4,10048,T
5-NP,993,1,8,9232,0,9241,G
5-NP,994,2,2,9080,1,9085,G
5-NP,995,1,3,0,9010,9014,C
5-NP,996,8762,0,11,0,8773,A
5-NP,997,2,8728,42,8,8780,T
5-NP,998,5,3,8641,0,8649,G
5-NP,999,1,5,0,8695,8701,C
5-NP,1000,10,2,0,8697,8709,C
5-NP,1001,8603,0,4,0,8607,A
5-NP,1002,3,8519,1,8,8531,T
5-NP,1003,2,8187,0,3,8192,T
5-NP,1004,8,0,0,8217,8225,C
5-NP,1005,2,7919,0,9,7930,T
5-NP,1006,2,2,7878,0,7882,G
5-NP,1007,0,1,0,7854,7855,C
5-NP,1008,0,6934,1,9,6944,T
5-NP,1009,0,0,7009,0,7009,G
5-NP,1010,0,2,0,6567,6569,C
5-NP,1011,6552,0,0,0,6552,A
5-NP,1012,0,6537,0,2,6539,T
5-NP,1013,1,6360,0,1,6362,T
5-NP,1014,1,6343,0,5,6349,T
5-NP,1015,1,4,6350,1,6356,G
5-NP,1016,6333,0,3,0,6336,A
5-NP,1017,6311,1,12,0,6324,A
5-NP,1018,0,3,6418,0,6421,G
5-NP,1019,6423,0,2,1,6426,A
5-NP,1020,1,6386,2,1,6390,T
5-NP,1021,1,6377,0,1,6379,T
5-NP,1022,0,6388,0,2,6390,T
5-NP,1023,6391,2,2,0,6395,A
5-NP,1024,6390,2,4,0,6396,A
5-NP,1025,0,4,6402,2,6408,G
5-NP,1026,6367,0,9,0,6376,A
5-NP,1027,0,6383,1,3,6387,T
5-NP,1028,0,6208,0,4,6212,T
5-NP,1029,1,0,6261,0,6262,G
5-NP,1030,1,6258,0,4,6263,T
5-NP,1031,0,6251,0,3,6254,T
5-NP,1032,6247,1,3,0,6251,A
5-NP,1033,6271,1,4,0,6276,A
5-NP,1034,1,1,6286,0,6288,G
5-NP,1035,1,3,0,6298,6302,C
5-NP,1036,0,6119,0,16,6135,T
5-NP,1037,0,6156,0,3,6159,T
5-NP,1038,3,1,0,6191,6195,C
5-NP,1039,6200,1,7,0,6208,A
5-NP,1040,1,6186,1,3,6191,T
5-NP,1041,2,0,0,6217,6219,C
5-NP,1042,6136,0,4,0,6140,A
5-NP,1043,3,2,6144,1,6150,G
5-NP,1044,6038,1,6,0,6045,A
5-NP,1045,0,8,6100,0,6108,G
5-NP,1046,2,8,6159,0,6169,G
5-NP,1047,12,9,6145,0,6166,G
5-NP,1048,6173,0,5,0,6178,A
5-NP,1049,2,1,0,6179,6182,C
5-NP,1050,6169,1,2,0,6172,A
5-NP,1051,6157,1,1,0,6159,A
5-NP,1052,1,5,5758,0,5764,G
5-NP,1053,5937,0,7,0,5944,A
5-NP,1054,1,0,6013,0,6014,G
5-NP,1055,1,6013,0,4,6018,T
5-NP,1056,5933,0,9,0,5942,A
5-NP,1057,1,5899,0,14,5914,T
5-NP,1058,2,1,0,5888,5891,C
5-NP,1059,1,5811,0,12,5824,T
5-NP,1060,8,0,0,5880,5888,C
5-NP,1061,4,0,0,5691,5695,C
5-NP,1062,2,5544,0,2,5548,T
5-NP,1063,4,3,0,5526,5533,C
5-NP,1064,6,4,5508,0,5518,G
5-NP,1065,3,10,5564,0,5577,G
5-NP,1066,1,10,5553,0,5564,G
5-NP,1067,1,3,5533,0,5537,G
5-NP,1068,6,5,5550,0,5561,G
5-NP,1069,5445,0,2,0,5447,A
5-NP,1070,5456,0,4,0,5460,A
5-NP,1071,5469,1,7,0,5477,A
5-NP,1072,0,1,0,5526,5527,C
5-NP,1073,1,5479,1,3,5484,T
5-NP,1074,1,0,5516,0,5517,G
5-NP,1075,1,5440,0,15,5456,T
5-NP,1076,7,4,1,5456,5468,C
5-NP,1077,5542,1,3,0,5546,A
5-NP,1078,5531,1,3,0,5535,A
5-NP,1079,1,1,0,5502,5504,C
5-NP,1080,7,3,0,5290,5300,C
5-NP,1081,5354,0,3,0,5357,A
5-NP,1082,0,2,5393,0,5395,G
5-NP,1083,5368,1,8,0,5377,A
5-NP,1084,0,2,5402,0,5404,G
5-NP,1085,0,5,5435,0,5440,G
5-NP,1086,5215,2,6,0,5223,A
5-NP,1087,0,1,5333,0,5334,G
5-NP,1088,0,5286,1,2,5289,T
5-NP,1089,5287,1,10,0,5298,A
5-NP,1090,4,1,0,5285,5290,C
5-NP,1091,5180,0,3,0,5183,A
5-NP,1092,5180,0,4,0,5184,A
5-NP,1093,5092,1,1,0,5094,A
5-NP,1094,0,5035,0,0,5035,T
5-NP,1095,1,4992,0,3,4996,T
5-NP,1096,0,0,4850,0,4850,G
5-NP,1097,0,2,0,4792,4794,C
5-NP,1098,0,4771,1,15,4787,T
5-NP,1099,3,4763,0,4,4770,T
5-NP,1100,3,1,0,4784,4788,C
5-NP,1101,4788,1,2,0,4791,A
5-NP,1102,4804,0,2,0,4806,A
5-NP,1103,4808,1,1,0,4810,A
5-NP,1104,1,4807,0,3,4811,T
5-NP,1105,0,6,4810,0,4816,G
5-NP,1106,4692,1,12,0,4705,A
5-NP,1107,0,2,4755,0,4757,G
5-NP,1108,4746,0,20,0,4766,A
5-NP,1109,4754,0,5,0,4759,A
5-NP,1110,3,0,0,4763,4766,C
5-NP,1111,4712,0,3,0,4715,A
5-NP,1112,0,4702,0,1,4703,T
5-NP,1113,0,5,4749,0,4754,G
5-NP,1114,0,0,4770,1,4771,G
5-NP,1115,4743,1,5,0,4749,A
5-NP,1116,0,4643,0,3,4646,T
5-NP,1117,4586,0,3,0,4589,A
5-NP,1118,4807,1,1,0,4809,A
5-NP,1119,1,4706,0,0,4707,T
5-NP,1120,4681,0,0,0,4681,A
5-NP,1121,0,4652,0,3,4655,T
5-NP,1122,3,7,4218,0,4228,G
5-NP,1123,1,3,4113,0,4117,G
5-NP,1124,0,1,4082,0,4083,G
5-NP,1125,4068,0,1,0,4069,A
5-NP,1126,0,4055,0,1,4056,T
5-NP,1127,3,0,0,3003,3006,C
5-NP,1128,2,4,3001,0,3007,G
5-NP,1129,2997,1,7,0,3005,A
5-NP,1130,1,0,3006,0,3007,G
5-NP,1131,3,2,0,2978,2983,C
5-NP,1132,2949,0,2,0,2951,A
5-NP,1133,0,0,0,3049,3049,C
5-NP,1134,0,2980,0,1,2981,T
5-NP,1135,4,1,0,2996,3001,C
5-NP,1136,2,2978,0,7,2987,T
5-NP,1137,0,2948,0,1,2949,T
5-NP,1138,0,7,2938,1,2946,G
5-NP,1139,2920,0,4,0,2924,A
5-NP,1140,2937,0,1,0,2938,A
5-NP,1141,0,0,0,2930,2930,C
5-NP,1142,0,2117,1,2,2120,T
5-NP,1143,1,2,2128,0,2131,G
5-NP,1144,2014,0,7,0,2021,A
5-NP,1145,0,0,2036,0,2036,G
5-NP,1146,2032,0,4,0,2036,A
5-NP,1147,2003,0,1,0,2004,A
5-NP,1148,0,1,2009,0,2010,G
5-NP,1149,1,1,0,1918,1920,C
5-NP,1150,3,1,1919,0,1923,G
5-NP,1151,0,4,1930,0,1934,G
5-NP,1152,2,0,1875,0,1877,G
5-NP,1153,0,1851,0,1,1852,T
5-NP,1154,1786,0,1,0,1787,A
5-NP,1155,1,0,1,1781,1783,C
5-NP,1156,1,1401,0,1,1403,T
5-NP,1157,0,1,1378,0,1379,G
5-NP,1158,0,1,1338,0,1339,G
5-NP,1159,0,0,1323,0,1323,G
5-NP,1160,0,1,0,1297,1298,C
5-NP,1161,1,1,0,1146,1148,C
5-NP,1162,1164,1,0,1,1166,A
5-NP,1163,1,1160,0,1,1162,T
5-NP,1164,1164,0,0,0,1164,A
5-NP,1165,1163,0,1,0,1164,A
5-NP,1166,0,1,1138,0,1139,G
5-NP,1167,1,2,1161,0,1164,G
5-NP,1168,1129,0,3,0,1132,A
5-NP,1169,1,1,0,1134,1136,C
5-NP,1170,3,0,0,1137,1140,C
5-NP,1171,1138,0,0,0,1138,A
5-NP,1172,0,0,1139,0,1139,G
5-NP,1173,1085,1,1,0,1087,A
5-NP,1174,1112,0,1,0,1113,A
5-NP,1175,0,0,1120,0,1120,G
5-NP,1176,1,1112,0,0,1113,T
5-NP,1177,0,0,1117,0,1117,G
5-NP,1178,0,3,1126,0,1129,G
5-NP,1179,1124,1,3,0,1128,A
5-NP,1180,0,0,1131,0,1131,G
5-NP,1181,0,1,1088,0,1089,G
5-NP,1182,1091,0,0,0,1091,A
5-NP,1183,1098,0,1,0,1099,A
5-NP,1184,1104,0,1,0,1105,A
5-NP,1185,0,1,0,1117,1118,C
5-NP,1186,1109,0,1,0,1110,A
5-NP,1187,0,0,0,1139,1139,C
5-NP,1188,0,1123,0,1,1124,T
5-NP,1189,1165,0,0,0,1165,A
5-NP,1190,1164,0,0,0,1164,A
5-NP,1191,0,1162,0,1,1163,T
5-NP,1192,0,0,0,1172,1172,C
5-NP,1193,1158,0,0,0,1158,A
5-NP,1194,1175,0,0,0,1175,A
5-NP,1195,0,0,0,1178,1178,C
5-NP,1196,1138,0,3,0,1141,A
5-NP,1197,0,0,1139,0,1139,G
5-NP,1198,1086,0,3,0,1089,A
5-NP,1199,1,1,1106,0,1108,G
5-NP,1200,0,0,1101,0,1101,G
5-NP,1201,0,0,1101,0,1101,G
5-NP,1202,0,1,0,1104,1105,C
5-NP,1203,1,0,0,1096,1097,C
5-NP,1204,0,1072,0,1,1073,T
5-NP,1205,0,0,0,1083,1083,C
5-NP,1206,0,0,0,1083,1083,C
5-NP,1207,1,0,1083,0,1084,G
5-NP,1208,1,0,0,1082,1083,C
5-NP,1209,1075,0,1,0,1076,A
5-NP,1210,0,0,1131,0,1131,G
5-NP,1211,1,0,1126,0,1127,G
5-NP,1212,0,1,0,1129,1130,C
5-NP,1213,1,0,0,1140,1141,C
5-NP,1214,1118,0,0,0,1118,A
5-NP,1215,1126,0,1,0,1127,A
5-NP,1216,1136,0,0,0,1136,A
5-NP,1217,0,1,0,1144,1145,C
5-NP,1218,0,0,0,1149,1149,C
5-NP,1219,1056,0,2,0,1058,A
5-NP,1220,0,1,1073,1,1075,G
5-NP,1221,0,1065,0,2,1067,T
5-NP,1222,1,0,1071,0,1072,G
5-NP,1223,0,1071,0,1,1072,T
5-NP,1224,0,0,1063,0,1063,G
5-NP,1225,0,0,0,1068,1068,C
5-NP,1226,1053,0,0,0,1053,A
5-NP,1227,1065,1,2,0,1068,A
5-NP,1228,0,0,0,1060,1060,C
5-NP,1229,0,0,0,1060,1060,C
5-NP,1230,1,1046,0,1,1048,T
5-NP,1231,1039,0,0,0,1039,A
5-NP,1232,0,0,2,1038,1040,C
5-NP,1233,0,0,1042,0,1042,G
5-NP,1234,0,1034,0,0,1034,T
5-NP,1235,0,1045,0,1,1046,T
5-NP,1236,0,1023,0,0,1023,T
5-NP,1237,0,1007,0,0,1007,T
5-NP,1238,1,0,0,1008,1009,C
5-NP,1239,0,991,0,0,991,T
5-NP,1240,1,1,1020,0,1022,G
5-NP,1241,0,1013,0,1,1014,T
5-NP,1242,1020,0,0,1,1021,A
5-NP,1243,1,0,0,1028,1029,C
5-NP,1244,1018,0,0,0,1018,A
5-NP,1245,1017,0,0,0,1017,A
5-NP,1246,1021,0,0,0,1021,A
5-NP,1247,0,0,1020,0,1020,G
5-NP,1248,1013,0,0,1,1014,A
5-NP,1249,974,0,0,0,974,A
5-NP,1250,967,0,2,0,969,A
5-NP,1251,0,0,0,973,973,C
5-NP,1252,1,0,0,950,951,C
5-NP,1253,0,939,0,2,941,T
5-NP,1254,1,0,0,948,949,C
5-NP,1255,0,0,0,949,949,C
5-NP,1256,1,0,0,947,948,C
5-NP,1257,947,0,1,0,948,A
5-NP,1258,0,945,0,1,946,T
5-NP,1259,0,945,0,1,946,T
5-NP,1260,0,946,0,0,946,T
5-NP,1261,0,0,943,0,943,G
5-NP,1262,939,0,0,0,939,A
5-NP,1263,942,0,0,1,943,A
5-NP,1264,943,0,0,0,943,A
5-NP,1265,934,0,2,0,936,A
5-NP,1266,0,0,949,0,949,G
5-NP,1267,0,937,0,3,940,T
5-NP,1268,1,0,1,938,940,C
5-NP,1269,942,0,2,0,944,A
5-NP,1270,952,0,1,0,953,A
5-NP,1271,0,1,0,952,953,C
5-NP,1272,2,0,0,957,959,C
5-NP,1273,955,1,0,0,956,A
5-NP,1274,1,962,0,1,964,T
5-NP,1275,0,1,0,954,955,C
5-NP,1276,946,0,3,0,949,A
5-NP,1277,0,951,0,0,951,T
5-NP,1278,0,1,949,0,950,G
5-NP,1279,1,0,943,0,944,G
5-NP,1280,0,1,0,943,944,C
5-NP,1281,921,0,0,0,921,A
5-NP,1282,1,0,920,0,921,G
5-NP,1283,1,0,0,918,919,C
5-NP,1284,922,0,0,0,922,A
5-NP,1285,0,917,0,1,918,T
5-NP,1286,0,915,0,0,915,T
5-NP,1287,0,1,0,913,914,C
5-NP,1288,904,0,1,0,905,A
5-NP,1289,0,0,0,915,915,C
5-NP,1290,0,915,0,0,915,T
5-NP,1291,0,0,916,0,916,G
5-NP,1292,0,0,912,0,912,G
5-NP,1293,909,0,1,0,910,A
5-NP,1294,909,0,2,0,911,A
5-NP,1295,917,0,1,1,919,A
5-NP,1296,0,907,0,0,907,T
5-NP,1297,908,0,0,0,908,A
5-NP,1298,0,1,0,905,906,C
5-NP,1299,1,1,880,0,882,G
5-NP,1300,1,2,879,0,882,G
5-NP,1301,869,0,0,0,869,A
5-NP,1302,848,0,4,0,852,A
5-NP,1303,0,0,859,1,860,G
5-NP,1304,0,0,865,0,865,G
5-NP,1305,869,0,0,0,869,A
5-NP,1306,866,0,2,0,868,A
5-NP,1307,0,2,867,0,869,G
5-NP,1308,864,0,0,0,864,A
5-NP,1309,863,0,0,0,863,A
5-NP,1310,0,0,0,886,886,C
5-NP,1311,0,872,0,1,873,T
5-NP,1312,0,889,0,0,889,T
5-NP,1313,1,0,0,877,878,C
5-NP,1314,876,0,11,0,887,A
5-NP,1315,0,0,890,0,890,G
5-NP,1316,882,0,1,0,883,A
5-NP,1317,0,0,0,892,892,C
5-NP,1318,884,0,0,0,884,A
5-NP,1319,0,862,0,0,862,T
5-NP,1320,0,0,861,0,861,G
5-NP,1321,847,0,0,0,847,A
5-NP,1322,0,1,855,0,856,G
5-NP,1323,0,0,852,0,852,G
5-NP,1324,1,0,847,0,848,G
5-NP,1325,0,0,0,849,849,C
5-NP,1326,844,0,1,0,845,A
5-NP,1327,2,3,842,0,847,G
5-NP,1328,840,1,0,0,841,A
5-NP,1329,852,0,1,0,853,A
5-NP,1330,853,0,2,0,855,A
5-NP,1331,1,847,0,0,848,T
5-NP,1332,2,1,0,845,848,C
5-NP,1333,843,0,1,0,844,A
5-NP,1334,0,849,0,0,849,T
5-NP,1335,852,0,0,0,852,A
5-NP,1336,847,1,0,0,848,A
5-NP,1337,0,2,857,0,859,G
5-NP,1338,846,0,0,0,846,A
5-NP,1339,854,0,0,0,854,A
5-NP,1340,0,835,0,0,835,T
5-NP,1341,0,0,839,0,839,G
5-NP,1342,834,0,0,0,834,A
5-NP,1343,0,834,0,0,834,T
5-NP,1344,2,0,834,0,836,G
5-NP,1345,0,0,834,0,834,G
5-NP,1346,802,0,1,1,804,A
5-NP,1347,801,0,0,2,803,A
5-NP,1348,0,0,786,0,786,G
5-NP,1349,0,0,814,0,814,G
5-NP,1350,0,801,0,0,801,T
5-NP,1351,2,0,797,0,799,G
5-NP,1352,0,0,0,790,790,C
5-NP,1353,796,0,1,0,797,A
5-NP,1354,796,0,1,0,797,A
5-NP,1355,796,0,0,0,796,A
5-NP,1356,812,0,0,0,812,A
5-NP,1357,0,0,0,809,809,C
5-NP,1358,0,0,0,800,800,C
5-NP,1359,782,0,1,0,783,A
5-NP,1360,0,0,789,0,789,G
5-NP,1361,788,0,1,0,789,A
5-NP,1362,782,1,0,0,783,A
5-NP,1363,0,0,790,0,790,G
5-NP,1364,781,0,0,0,781,A
5-NP,1365,758,0,2,0,760,A
5-NP,1366,0,0,779,0,779,G
5-NP,1367,0,767,0,1,768,T
5-NP,1368,0,0,773,0,773,G
5-NP,1369,0,761,0,1,762,T
5-NP,1370,1,0,0,770,771,C
5-NP,1371,768,1,0,0,769,A
5-NP,1372,0,780,0,0,780,T
5-NP,1373,1,777,0,1,779,T
5-NP,1374,1,0,0,781,782,C
5-NP,1375,3,0,0,768,771,C
5-NP,1376,1,0,765,0,766,G
5-NP,1377,0,3,770,0,773,G
5-NP,1378,0,0,768,0,768,G
5-NP,1379,0,1,766,0,767,G
5-NP,1380,1,1,761,0,763,G
5-NP,1381,734,0,1,0,735,A
5-NP,1382,0,1,739,0,740,G
5-NP,1383,1,1,739,0,741,G
5-NP,1384,1,1,740,0,742,G
5-NP,1385,0,0,742,0,742,G
5-NP,1386,732,0,1,0,733,A
5-NP,1387,0,0,740,0,740,G
5-NP,1388,0,731,0,1,732,T
5-NP,1389,0,723,0,1,724,T
5-NP,1390,0,734,0,2,736,T
5-NP,1391,0,730,0,0,730,T
5-NP,1392,2,1,0,728,731,C
5-NP,1393,0,0,729,0,729,G
5-NP,1394,721,0,2,0,723,A
5-NP,1395,1,0,730,0,731,G
5-NP,1396,0,0,0,711,711,C
5-NP,1397,0,706,1,3,710,T
5-NP,1398,0,0,0,721,721,C
5-NP,1399,0,715,0,2,717,T
5-NP,1400,0,0,0,718,718,C
5-NP,1401,718,0,0,0,718,A
5-NP,1402,0,1,727,0,728,G
5-NP,1403,728,0,3,0,731,A
5-NP,1404,2,0,0,718,720,C
5-NP,1405,0,0,718,0,718,G
5-NP,1406,709,0,1,0,710,A
5-NP,1407,0,0,707,1,708,G
5-NP,1408,702,0,1,0,703,A
5-NP,1409,700,0,0,0,700,A
5-NP,1410,0,0,701,0,701,G
5-NP,1411,1,1,691,0,693,G
5-NP,1412,0,0,0,690,690,C
5-NP,1413,693,0,0,0,693,A
5-NP,1414,690,0,3,0,693,A
5-NP,1415,0,0,0,697,697,C
5-NP,1416,0,0,692,1,693,G
5-NP,1417,696,0,0,0,696,A
5-NP,1418,693,0,0,0,693,A
5-NP,1419,0,1,0,688,689,C
5-NP,1420,0,0,0,682,682,C
5-NP,1421,0,0,0,678,678,C
5-NP,1422,0,0,679,1,680,G
5-NP,1423,681,0,0,0,681,A
5-NP,1424,0,679,0,2,681,T
5-NP,1425,0,1,0,671,672,C
5-NP,1426,0,1,673,0,674,G
5-NP,1427,0,670,0,0,670,T
5-NP,1428,0,0,669,0,669,G
5-NP,1429,0,0,0,662,662,C
5-NP,1430,1,0,0,666,667,C
5-NP,1431,1,0,0,671,672,C
5-NP,1432,0,662,0,0,662,T
5-NP,1433,0,0,0,710,710,C
5-NP,1434,0,710,0,1,711,T
5-NP,1435,0,711,1,1,713,T
5-NP,1436,0,714,0,0,714,T
5-NP,1437,0,707,0,1,708,T
5-NP,1438,0,0,719,0,719,G
5-NP,1439,716,0,1,0,717,A
5-NP,1440,0,711,0,1,712,T
5-NP,1441,711,0,0,0,711,A
5-NP,1442,0,594,0,0,594,T
5-NP,1443,0,0,603,0,603,G
5-NP,1444,597,0,1,0,598,A
5-NP,1445,0,0,608,0,608,G
5-NP,1446,0,602,0,1,603,T
5-NP,1447,593,0,0,0,593,A
5-NP,1448,595,0,0,0,595,A
5-NP,1449,0,595,0,1,596,T
5-NP,1450,0,0,590,0,590,G
5-NP,1451,592,0,1,0,593,A
5-NP,1452,533,0,0,0,533,A
5-NP,1453,0,0,530,0,530,G
5-NP,1454,0,0,489,0,489,G
5-NP,1455,489,0,1,0,490,A
5-NP,1456,0,483,0,3,486,T
5-NP,1457,0,0,0,488,488,C
5-NP,1458,0,481,0,0,481,T
5-NP,1459,0,483,0,0,483,T
5-NP,1460,483,0,0,0,483,A
5-NP,1461,0,485,0,0,485,T
5-NP,1462,0,480,0,0,480,T
5-NP,1463,0,476,0,0,476,T
5-NP,1464,0,0,0,463,463,C
5-NP,1465,2,444,0,0,446,T
5-NP,1466,0,446,0,0,446,T
5-NP,1467,1,0,0,446,447,C
5-NP,1468,1,0,442,0,443,G
5-NP,1469,0,0,443,0,443,G
5-NP,1470,434,0,0,0,434,A
5-NP,1471,0,0,443,0,443,G
5-NP,1472,437,0,0,0,437,A
5-NP,1473,0,0,0,430,430,C
5-NP,1474,412,0,0,0,412,A
5-NP,1475,412,0,0,0,412,A
5-NP,1476,0,411,0,1,412,T
5-NP,1477,0,0,412,0,412,G
5-NP,1478,0,0,0,412,412,C
5-NP,1479,396,1,1,0,398,A
5-NP,1480,0,0,400,0,400,G
5-NP,1481,396,0,0,1,397,A
5-NP,1482,364,0,1,0,365,A
5-NP,1483,0,0,366,0,366,G
5-NP,1484,240,0,0,0,240,A
5-NP,1485,0,0,237,0,237,G
5-NP,1486,0,226,0,0,226,T
5-NP,1487,225,0,0,0,225,A
5-NP,1488,0,0,0,221,221,C
5-NP,1489,0,0,209,0,209,G
5-NP,1490,209,0,1,0,210,A
5-NP,1491,0,0,0,207,207,C
5-NP,1492,147,0,0,0,147,A
5-NP,1493,148,0,0,0,148,A
5-NP,1494,0,128,0,0,128,T
5-NP,1495,0,125,0,0,125,T
5-NP,1496,125,0,0,0,125,A
5-NP,1497,119,0,0,0,119,A
6-NA,1,262,0,0,0,262,A
6-NA,2,0,262,0,0,262,T
6-NA,3,0,0,261,0,261,G
6-NA,4,262,0,3,0,265,A
6-NA,5,284,0,0,0,284,A
6-NA,6,0,286,0,0,286,T
6-NA,7,0,0,0,286,286,C
6-NA,8,0,0,0,286,286,C
6-NA,9,286,1,0,0,287,A
6-NA,10,303,0,0,0,303,A
6-NA,11,301,0,0,0,301,A
6-NA,12,0,316,0,0,316,T
6-NA,13,0,0,0,318,318,C
6-NA,14,319,0,0,0,319,A
6-NA,15,324,0,0,0,324,A
6-NA,16,324,0,1,0,325,A
6-NA,17,351,0,0,0,351,A
6-NA,18,0,0,399,0,399,G
6-NA,19,416,0,1,0,417,A
6-NA,20,0,425,0,0,425,T
6-NA,21,426,0,0,0,426,A
6-NA,22,432,0,0,0,432,A
6-NA,23,0,433,0,0,433,T
6-NA,24,433,0,0,1,434,A
6-NA,25,438,0,1,0,439,A
6-NA,26,1,0,0,452,453,C
6-NA,27,0,0,459,0,459,G
6-NA,28,458,1,0,0,459,A
6-NA,29,0,458,0,2,460,T
6-NA,30,0,463,0,0,463,T
6-NA,31,0,0,462,0,462,G
6-NA,32,2,0,486,0,488,G
6-NA,33,0,0,0,494,494,C
6-NA,34,0,491,0,0,491,T
6-NA,35,0,0,0,507,507,C
6-NA,36,0,509,0,0,509,T
6-NA,37,0,1,524,0,525,G
6-NA,38,0,522,0,0,522,T
6-NA,39,0,522,0,0,522,T
6-NA,40,0,545,0,0,545,T
6-NA,41,0,0,0,554,554,C
6-NA,42,0,545,0,2,547,T
6-NA,43,1,1,0,557,559,C
6-NA,44,0,552,0,0,552,T
6-NA,45,0,0,0,568,568,C
6-NA,46,562,0,0,0,562,A
6-NA,47,0,0,0,587,587,C
6-NA,48,0,0,0,588,588,C
6-NA,49,586,0,0,0,586,A
6-NA,50,0,593,0,1,594,T
6-NA,51,0,606,0,0,606,T
6-NA,52,0,613,0,0,613,T
6-NA,53,0,0,0,632,632,C
6-NA,54,0,0,0,631,631,C
6-NA,55,634,0,0,0,634,A
6-NA,56,0,0,0,666,666,C
6-NA,57,659,0,1,0,660,A
6-NA,58,708,0,1,0,709,A
6-NA,59,0,706,0,0,706,T
6-NA,60,736,0,1,0,737,A
6-NA,61,0,740,0,0,740,T
6-NA,62,0,0,730,0,730,G
6-NA,63,1,0,1,728,730,C
6-NA,64,0,729,0,1,730,T
6-NA,65,0,730,0,0,730,T
6-NA,66,0,0,0,729,729,C
6-NA,67,0,723,0,0,723,T
6-NA,68,0,724,0,1,725,T
6-NA,69,0,0,0,718,718,C
6-NA,70,718,0,2,0,720,A
6-NA,71,0,725,0,0,725,T
6-NA,72,0,0,716,0,716,G
6-NA,73,0,0,0,724,724,C
6-NA,74,722,0,0,0,722,A
6-NA,75,722,0,0,0,722,A
6-NA,76,724,0,0,0,724,A
6-NA,77,0,737,0,0,737,T
6-NA,78,0,737,0,0,737,T
6-NA,79,0,0,738,0,738,G
6-NA,80,0,0,0,742,742,C
6-NA,81,2,0,0,741,743,C
6-NA,82,747,1,1,1,750,A
6-NA,83,0,753,0,0,753,T
6-NA,84,0,0,0,828,828,C
6-NA,85,0,828,0,0,828,T
6-NA,86,0,822,0,0,822,T
6-NA,87,1,0,855,0,856,G
6-NA,88,856,0,0,0,856,A
6-NA,89,0,867,0,0,867,T
6-NA,90,864,0,1,0,865,A
6-NA,91,864,0,0,0,864,A
6-NA,92,0,0,0,1024,1024,C
6-NA,93,0,1004,0,1,1005,T
6-NA,94,1017,0,0,0,1017,A
6-NA,95,0,0,0,1065,1065,C
6-NA,96,0,1043,0,0,1043,T
6-NA,97,0,1,1069,0,1070,G
6-NA,98,0,1069,0,3,1072,T
6-NA,99,1069,1,0,0,1070,A
6-NA,100,1072,0,2,0,1074,A
6-NA,101,0,0,0,1034,1034,C
6-NA,102,1014,0,0,0,1014,A
6-NA,103,0,1012,0,1,1013,T
6-NA,104,0,989,0,0,989,T
6-NA,105,0,0,991,0,991,G
6-NA,106,0,0,0,988,988,C
6-NA,107,994,0,2,0,996,A
6-NA,108,0,999,1,2,1002,T
6-NA,109,0,1001,0,0,1001,T
6-NA,110,0,1001,0,0,1001,T
6-NA,111,1,0,0,996,997,C
6-NA,112,997,0,0,0,997,A
6-NA,113,997,0,3,1,1001,A
6-NA,114,0,0,1004,0,1004,G
6-NA,115,1,0,0,1012,1013,C
6-NA,116,1010,0,0,1,1011,A
6-NA,117,1064,0,0,0,1064,A
6-NA,118,0,1078,0,0,1078,T
6-NA,119,1075,0,1,0,1076,A
6-NA,120,0,1076,0,0,1076,T
6-NA,121,0,1,1095,1,1097,G
6-NA,122,1086,0,0,0,1086,A
6-NA,123,1110,0,0,0,1110,A
6-NA,124,1,1106,0,0,1107,T
6-NA,125,0,1110,0,1,1111,T
6-NA,126,2,0,0,1100,1102,C
6-NA,127,1097,0,0,0,1097,A
6-NA,128,1105,0,2,0,1107,A
6-NA,129,0,3,0,1108,1111,C
6-NA,130,0,1089,0,8,1097,T
6-NA,131,0,2,0,1088,1090,C
6-NA,132,1,0,0,1095,1096,C
6-NA,133,1,0,0,1125,1126,C
6-NA,134,1,0,0,1129,1130,C
6-NA,135,1,0,0,1136,1137,C
6-NA,136,4,0,0,1140,1144,C
6-NA,137,2,0,0,1147,1149,C
6-NA,138,1147,0,0,2,1149,A
6-NA,139,1142,0,0,0,1142,A
6-NA,140,1147,0,1,0,1148,A
6-NA,141,0,0,0,1163,1163,C
6-NA,142,1148,0,0,0,1148,A
6-NA,143,1167,0,2,0,1169,A
6-NA,144,0,0,0,1168,1168,C
6-NA,145,1,0,0,1165,1166,C
6-NA,146,1196,0,0,0,1196,A
6-NA,147,1198,0,0,0,1198,A
6-NA,148,0,1,1214,0,1215,G
6-NA,149,0,1217,0,2,1219,T
6-NA,150,1,2,1210,0,1213,G
6-NA,151,1234,0,0,1,1235,A
6-NA,152,2,1226,0,0,1228,T
6-NA,153,0,0,1224,0,1224,G
6-NA,154,0,0,0,1226,1226,C
6-NA,155,0,1207,0,5,1212,T
6-NA,156,0,0,1295,0,1295,G
6-NA,157,2,1274,0,2,1278,T
6-NA,158,0,0,1275,0,1275,G
6-NA,159,0,1276,0,2,1278,T
6-NA,160,0,2,1265,1,1268,G
6-NA,161,1267,0,1,0,1268,A
6-NA,162,1286,0,2,0,1288,A
6-NA,163,7,0,0,1277,1284,C
6-NA,164,2,0,0,1276,1278,C
6-NA,165,1248,1,1,0,1250,A
6-NA,166,1251,0,1,0,1252,A
6-NA,167,0,0,0,1308,1308,C
6-NA,168,1304,0,3,0,1307,A
6-NA,169,1311,0,0,0,1311,A
6-NA,170,0,1312,0,0,1312,T
6-NA,171,1313,0,1,0,1314,A
6-NA,172,1315,0,2,0,1317,A
6-NA,173,2,1309,0,0,1311,T
6-NA,174,1303,0,3,0,1306,A
6-NA,175,0,0,1312,0,1312,G
6-NA,176,1258,0,1,0,1259,A
6-NA,177,1267,0,0,0,1267,A
6-NA,178,1262,0,0,0,1262,A
6-NA,179,0,0,1260,0,1260,G
6-NA,180,1293,0,1,0,1294,A
6-NA,181,1289,0,0,0,1289,A
6-NA,182,1352,0,3,0,1355,A
6-NA,183,0,0,0,1365,1365,C
6-NA,184,1356,0,1,0,1357,A
6-NA,185,2,1376,0,0,1378,T
6-NA,186,1391,0,0,0,1391,A
6-NA,187,1395,0,1,0,1396,A
6-NA,188,0,0,0,1428,1428,C
6-NA,189,1397,0,0,0,1397,A
6-NA,190,0,1,1447,0,1448,G
6-NA,191,1407,0,3,0,1410,A
6-NA,192,0,0,1423,0,1423,G
6-NA,193,1427,0,2,0,1429,A
6-NA,194,0,1487,0,0,1487,T
6-NA,195,1476,0,0,0,1476,A
6-NA,196,0,0,1507,0,1507,G
6-NA,197,0,1494,0,3,1497,T
6-NA,198,0,1,1529,1,1531,G
6-NA,199,0,1520,0,2,1522,T
6-NA,200,1518,0,0,0,1518,A
6-NA,201,0,1514,0,0,1514,T
6-NA,202,1,0,0,1509,1510,C
6-NA,203,0,1472,0,3,1475,T
6-NA,204,0,2,1510,0,1512,G
6-NA,205,1509,0,3,0,1512,A
6-NA,206,0,1,0,1506,1507,C
6-NA,207,1,0,0,1503,1504,C
6-NA,208,1494,0,0,0,1494,A
6-NA,209,1502,0,2,0,1504,A
6-NA,210,0,0,0,1533,1533,C
6-NA,211,1525,0,3,0,1528,A
6-NA,212,0,1,0,1592,1593,C
6-NA,213,0,2,0,1568,1570,C
6-NA,214,1606,0,1,0,1607,A
6-NA,215,0,4,0,1667,1671,C
6-NA,216,0,1,1,1666,1668,C
6-NA,217,1681,0,1,0,1682,A
6-NA,218,1,1671,0,2,1674,T
6-NA,219,1660,0,1,0,1661,A
6-NA,220,0,4,1674,0,1678,G
6-NA,221,1630,0,2,0,1632,A
6-NA,222,1,1,1669,0,1671,G
6-NA,223,1634,0,0,0,1634,A
6-NA,224,1596,0,1,0,1597,A
6-NA,225,1,3,1612,0,1616,G
6-NA,226,1,1,1611,0,1613,G
6-NA,227,1613,0,1,1,1615,A
6-NA,228,1619,0,0,0,1619,A
6-NA,229,1616,1,1,0,1618,A
6-NA,230,0,1609,0,0,1609,T
6-NA,231,1590,0,0,0,1590,A
6-NA,232,1,1584,0,0,1585,T
6-NA,233,1,0,1582,0,1583,G
6-NA,234,0,1,0,1593,1594,C
6-NA,235,1,0,0,1577,1578,C
6-NA,236,2,0,0,1578,1580,C
6-NA,237,3,0,0,1583,1586,C
6-NA,238,1589,0,0,0,1589,A
6-NA,239,1625,0,0,0,1625,A
6-NA,240,1628,0,0,0,1628,A
6-NA,241,0,0,0,1637,1637,C
6-NA,242,0,1627,0,0,1627,T
6-NA,243,1615,0,2,0,1617,A
6-NA,244,0,1,1621,0,1622,G
6-NA,245,0,0,0,1627,1627,C
6-NA,246,1621,1,0,0,1622,A
6-NA,247,0,3,1637,0,1640,G
6-NA,248,1627,0,1,0,1628,A
6-NA,249,1699,0,2,0,1701,A
6-NA,250,1,1696,0,0,1697,T
6-NA,251,1702,0,1,0,1703,A
6-NA,252,1,1,0,1707,1709,C
6-NA,253,1691,0,1,0,1692,A
6-NA,254,0,2,1690,0,1692,G
6-NA,255,1696,0,1,0,1697,A
6-NA,256,1675,0,0,0,1675,A
6-NA,257,1672,0,1,0,1673,A
6-NA,258,0,1632,0,0,1632,T
6-NA,259,0,1621,0,2,1623,T
6-NA,260,2,4,1629,0,1635,G
6-NA,261,2,0,1628,0,1630,G
6-NA,262,0,1633,0,3,1636,T
6-NA,263,2,1,0,1628,1631,C
6-NA,264,1623,0,0,0,1623,A
6-NA,265,1632,0,2,0,1634,A
6-NA,266,1631,0,4,0,1635,A
6-NA,267,0,0,1649,0,1649,G
6-NA,268,0,1,0,1654,1655,C
6-NA,269,1,1,0,1643,1645,C
6-NA,270,0,0,1649,0,1649,G
6-NA,271,0,1,0,1661,1662,C
6-NA,272,1662,0,1,0,1663,A
6-NA,273,1688,0,0,0,1688,A
6-NA,274,0,1683,0,0,1683,T
6-NA,275,0,0,1703,0,1703,G
6-NA,276,1,1679,1,2,1683,T
6-NA,277,2,2,1681,0,1685,G
6-NA,278,1720,1,2,0,1723,A
6-NA,279,0,0,0,1733,1733,C
6-NA,280,1721,1,1,1,1724,A
6-NA,281,0,1757,0,1,1758,T
6-NA,282,0,1742,0,1,1743,T
6-NA,283,1737,1,3,0,1741,A
6-NA,284,1,0,0,1737,1738,C
6-NA,285,1717,1,3,0,1721,A
6-NA,286,1,1,1743,0,1745,G
6-NA,287,0,1,1745,0,1746,G
6-NA,288,1735,0,1,0,1736,A
6-NA,289,0,1715,0,0,1715,T
6-NA,290,0,1704,0,0,1704,T
6-NA,291,0,1704,0,2,1706,T
6-NA,292,2,0,1706,0,1708,G
6-NA,293,0,2,0,1701,1703,C
6-NA,294,1707,1,5,0,1713,A
6-NA,295,0,0,0,1719,1719,C
6-NA,296,2,1,0,1701,1704,C
6-NA,297,0,1696,0,4,1700,T
6-NA,298,0,1699,0,3,1702,T
6-NA,299,0,1715,0,0,1715,T
6-NA,300,0,1708,0,0,1708,T
6-NA,301,0,1752,0,0,1752,T
6-NA,302,0,0,0,1759,1759,C
6-NA,303,0,1747,0,2,1749,T
6-NA,304,1747,0,1,0,1748,A
6-NA,305,1734,0,5,0,1739,A
6-NA,306,0,1,1765,0,1766,G
6-NA,307,2,0,1762,2,1766,G
6-NA,308,1748,1,2,0,1751,A
6-NA,309,0,1,0,1761,1762,C
6-NA,310,1739,0,0,0,1739,A
6-NA,311,1750,0,0,0,1750,A
6-NA,312,0,1734,1,0,1735,T
6-NA,313,0,1741,0,1,1742,T
6-NA,314,2,2,0,1768,1772,C
6-NA,315,0,2,1769,0,1771,G
6-NA,316,1768,0,0,0,1768,A
6-NA,317,0,1767,0,0,1767,T
6-NA,318,0,1760,0,2,1762,T
6-NA,319,1754,0,3,0,1757,A
6-NA,320,1,0,1766,0,1767,G
6-NA,321,2,0,1781,0,1783,G
6-NA,322,2,0,0,1780,1782,C
6-NA,323,0,1759,0,1,1760,T
6-NA,324,1,1776,0,1,1778,T
6-NA,325,0,1782,1,1,1784,T
6-NA,326,0,2,0,1793,1795,C
6-NA,327,1,1,0,1790,1792,C
6-NA,328,1,1,1783,0,1785,G
6-NA,329,1,1,0,1790,1792,C
6-NA,330,0,1767,0,2,1769,T
6-NA,331,0,1,1830,0,1831,G
6-NA,332,0,0,1833,0,1833,G
6-NA,333,0,1831,0,4,1835,T
6-NA,334,0,3,1838,1,1842,G
6-NA,335,0,2,1820,0,1822,G
6-NA,336,0,3,1831,0,1834,G
6-NA,337,2,2,1836,0,1840,G
6-NA,338,1836,0,1,0,1837,A
6-NA,339,0,0,0,1871,1871,C
6-NA,340,1828,0,0,0,1828,A
6-NA,341,0,1820,0,1,1821,T
6-NA,342,1,0,0,1834,1835,C
6-NA,343,0,1825,0,1,1826,T
6-NA,344,0,2,1829,0,1831,G
6-NA,345,1,1,1833,0,1835,G
6-NA,346,1,0,1844,1,1846,G
6-NA,347,0,1845,1,0,1846,T
6-NA,348,0,3,1820,0,1823,G
6-NA,349,1803,2,7,0,1812,A
6-NA,350,0,0,0,1902,1902,C
6-NA,351,1898,0,0,0,1898,A
6-NA,352,2087,0,1,0,2088,A
6-NA,353,0,2,2136,1,2139,G
6-NA,354,2123,1,3,1,2128,A
6-NA,355,0,2,2276,0,2278,G
6-NA,356,2372,0,1,0,2373,A
6-NA,357,2654,0,1,1,2656,A
6-NA,358,0,0,0,3839,3839,C
6-NA,359,4,0,0,4250,4254,C
6-NA,360,1,4254,0,2,4257,T
6-NA,361,0,4296,0,1,4297,T
6-NA,362,4298,0,1,1,4300,A
6-NA,363,0,4312,0,2,4314,T
6-NA,364,0,1,4672,0,4673,G
6-NA,365,0,4698,0,6,4704,T
6-NA,366,3,0,4838,0,4841,G
6-NA,367,0,4795,1,4,4800,T
6-NA,368,1,1,1,4781,4784,C
6-NA,369,4847,0,6,43,4896,A
6-NA,370,1,4895,0,8,4904,T
6-NA,371,2,0,4885,0,4887,G
6-NA,372,0,6,0,4906,4912,C
6-NA,373,3,4,4886,0,4893,G
6-NA,374,5654,1,2,0,5657,A
6-NA,375,0,5649,0,4,5653,T
6-NA,376,5,2,0,5810,5817,C
6-NA,377,1,0,0,5833,5834,C
6-NA,378,0,6023,0,10,6033,T
6-NA,379,7,8,6134,1,6150,G
6-NA,380,6147,1,4,1,6153,A
6-NA,381,1,1,1,6170,6173,C
6-NA,382,6161,0,4,0,6165,A
6-NA,383,6104,1,9,0,6114,A
6-NA,384,5,0,6516,0,6521,G
6-NA,385,1,6508,0,6,6515,T
6-NA,386,2,0,6637,0,6639,G
6-NA,387,0,6619,1,12,6632,T
6-NA,388,0,6622,0,5,6627,T
6-NA,389,6629,1,5,1,6636,A
6-NA,390,2,6612,0,15,6629,T
6-NA,391,5,0,0,6790,6795,C
6-NA,392,6812,0,0,1,6813,A
6-NA,393,6774,0,1,0,6775,A
6-NA,394,1,6743,0,4,6748,T
6-NA,395,0,6726,0,7,6733,T
6-NA,396,2,6731,0,4,6737,T
6-NA,397,2,3,6761,0,6766,G
6-NA,398,1,2,0,7308,7311,C
6-NA,399,5,1,0,7288,7294,C
6-NA,400,8,2,1,7307,7318,C
6-NA,401,1,7300,0,15,7316,T
6-NA,402,0,7321,0,8,7329,T
6-NA,403,3,8,7467,0,7478,G
6-NA,404,1,12,7477,0,7490,G
6-NA,405,7545,0,13,0,7558,A
6-NA,406,0,0,0,7566,7566,C
6-NA,407,7399,1,9,0,7409,A
6-NA,408,2,9,7664,0,7675,G
6-NA,409,2,6,7637,0,7645,G
6-NA,410,4,4,7999,0,8007,G
6-NA,411,7967,6,18,0,7991,A
6-NA,412,7977,1,15,0,7993,A
6-NA,413,0,3,0,8022,8025,C
6-NA,414,7980,0,4,3,7987,A
6-NA,415,8959,1,8,0,8968,A
6-NA,416,4,0,0,9076,9080,C
6-NA,417,9032,2,13,2,9049,A
6-NA,418,0,0,1,9139,9140,C
6-NA,419,0,9000,1,6,9007,T
6-NA,420,9095,0,7,2,9104,A
6-NA,421,9089,0,7,0,9096,A
6-NA,422,9102,2,14,0,9118,A
6-NA,423,0,2,0,9133,9135,C
6-NA,424,8648,1,3,2,8654,A
6-NA,425,8669,4,5,1,8679,A
6-NA,426,2,5,0,8669,8676,C
6-NA,427,1,1,8690,0,8692,G
6-NA,428,1,8652,0,8,8661,T
6-NA,429,4,1,8645,1,8651,G
6-NA,430,1,5,0,8698,8704,C
6-NA,431,8714,3,10,0,8727,A
6-NA,432,1,8728,2,2,8733,T
6-NA,433,0,8737,0,4,8741,T
6-NA,434,9,0,0,8877,8886,C
6-NA,435,9028,1,3,1,9033,A
6-NA,436,9049,2,8,0,9059,A
6-NA,437,9068,2,7,0,9077,A
6-NA,438,1,9098,1,4,9104,T
6-NA,439,2,15,9054,0,9071,G
6-NA,440,9240,1,17,1,9259,A
6-NA,441,1,1,0,9295,9297,C
6-NA,442,9266,1,5,1,9273,A
6-NA,443,0,2,0,9402,9404,C
6-NA,444,9258,2,13,0,9273,A
6-NA,445,0,0,11591,0,11591,G
6-NA,446,0,11596,0,8,11604,T
6-NA,447,11759,1,7,0,11767,A
6-NA,448,1,7,0,11782,11790,C
6-NA,449,6,0,11703,0,11709,G
6-NA,450,0,12151,1,14,12166,T
6-NA,451,5,6,12178,0,12189,G
6-NA,452,12182,2,10,0,12194,A
6-NA,453,0,12276,0,1,12277,T
6-NA,454,10735,0,12,1,10748,A
6-NA,455,2,5,10715,2,10724,G
6-NA,456,3,17,10633,0,10653,G
6-NA,457,10688,0,16,0,10704,A
6-NA,458,1,3,2,10881,10887,C
6-NA,459,4,6,0,10531,10541,C
6-NA,460,21,2,0,10666,10689,C
6-NA,461,29,0,1,10668,10698,C
6-NA,462,0,10765,2,11,10778,T
6-NA,463,0,10992,1,4,10997,T
6-NA,464,11062,0,6,1,11069,A
6-NA,465,0,11048,0,1,11049,T
6-NA,466,6,6,1,11035,11048,C
6-NA,467,13,8,10904,0,10925,G
6-NA,468,8,16,10869,1,10894,G
6-NA,469,10891,2,11,0,10904,A
6-NA,470,3,5,1,10989,10998,C
6-NA,471,12,4,0,10904,10920,C
6-NA,472,20,3,1,11544,11568,C
6-NA,473,0,11539,0,11,11550,T
6-NA,474,11693,0,0,0,11693,A
6-NA,475,1,11698,2,5,11706,T
6-NA,476,3,11732,0,6,11741,T
6-NA,477,0,9,11734,0,11743,G
6-NA,478,11753,1,12,0,11766,A
6-NA,479,3,11682,0,6,11691,T
6-NA,480,0,10,11724,1,11735,G
6-NA,481,11190,3,8,2,11203,A
6-NA,482,11207,3,13,0,11223,A
6-NA,483,0,11196,0,6,11202,T
6-NA,484,1,17,11370,0,11388,G
6-NA,485,11435,3,16,3,11457,A
6-NA,486,0,0,11639,0,11639,G
6-NA,487,4,11549,2,12,11567,T
6-NA,488,0,11574,0,2,11576,T
6-NA,489,11610,1,14,1,11626,A
6-NA,490,1,11,11638,0,11650,G
6-NA,491,0,0,11700,0,11700,G
6-NA,492,1,11616,0,11,11628,T
6-NA,493,4,4,11560,0,11568,G
6-NA,494,5,11389,0,21,11415,T
6-NA,495,1,11342,1,15,11359,T
6-NA,496,14,2,1,11477,11494,C
6-NA,497,12,2,1,11554,11569,C
6-NA,498,1,11513,0,18,11532,T
6-NA,499,0,11504,2,14,11520,T
6-NA,500,1,11466,4,13,11484,T
6-NA,501,0,11485,0,5,11490,T
6-NA,502,4,2,0,11521,11527,C
6-NA,503,11493,0,5,0,11498,A
6-NA,504,0,11735,0,4,11739,T
6-NA,505,4,1,0,11742,11747,C
6-NA,506,0,11558,1,11,11570,T
6-NA,507,2,20,11533,0,11555,G
6-NA,508,6,24,11470,0,11500,G
6-NA,509,4,11,11489,1,11505,G
6-NA,510,3,17,11633,0,11653,G
6-NA,511,11653,2,9,0,11664,A
6-NA,512,3,3,0,11771,11777,C
6-NA,513,8,3,0,11596,11607,C
6-NA,514,11733,3,12,1,11749,A
6-NA,515,11750,1,11,2,11764,A
6-NA,516,0,2,11778,0,11780,G
6-NA,517,3,2,0,11798,11803,C
6-NA,518,11750,1,7,0,11758,A
6-NA,519,11834,1,15,1,11851,A
6-NA,520,2,1,11938,0,11941,G
6-NA,521,1,11830,0,7,11838,T
6-NA,522,3,0,12173,2,12178,G
6-NA,523,2,12057,0,13,12072,T
6-NA,524,5,9,12384,0,12398,G
6-NA,525,2,2,1,12384,12389,C
6-NA,526,12350,3,9,3,12365,A
6-NA,527,3,12491,1,5,12500,T
6-NA,528,12202,0,5,1,12208,A
6-NA,529,3,2,12591,0,12596,G
6-NA,530,2,2,0,12550,12554,C
6-NA,531,12183,0,16,0,12199,A
6-NA,532,0,12156,0,7,12163,T
6-NA,533,1,14,11775,2,11792,G
6-NA,534,0,2,12401,0,12403,G
6-NA,535,0,12407,2,31,12440,T
6-NA,536,11,8,1,12278,12298,C
6-NA,537,13,5,0,12289,12307,C
6-NA,538,12074,1,24,0,12099,A
6-NA,539,3,3,12372,0,12378,G
6-NA,540,0,4,0,12373,12377,C
6-NA,541,1,12298,1,11,12311,T
6-NA,542,8,5,1,12354,12368,C
6-NA,543,11960,2,5,0,11967,A
6-NA,544,12061,0,13,0,12074,A
6-NA,545,1,1,12132,0,12134,G
6-NA,546,0,12118,2,9,12129,T
6-NA,547,2,12030,1,5,12038,T
6-NA,548,3,1,12038,0,12042,G
6-NA,549,5,11979,3,9,11996,T
6-NA,550,12,2,1,11986,12001,C
6-NA,551,12026,1,19,1,12047,A
6-NA,552,2,1,0,12097,12100,C
6-NA,553,4,9,12050,0,12063,G
6-NA,554,12213,3,8,1,12225,A
6-NA,555,1,12251,2,11,12265,T
6-NA,556,2,4,12469,0,12475,G
6-NA,557,6,5,12539,0,12550,G
6-NA,558,12519,2,22,0,12543,A
6-NA,559,12540,0,24,1,12565,A
6-NA,560,12641,1,14,0,12656,A
6-NA,561,12600,2,26,2,12630,A
6-NA,562,4,3,12747,0,12754,G
6-NA,563,3,5,0,12664,12672,C
6-NA,564,12608,2,20,0,12630,A
6-NA,565,1,12579,0,8,12588,T
6-NA,566,3,11,12654,0,12668,G
6-NA,567,5,2,12683,0,12690,G
6-NA,568,1,3,0,12814,12818,C
6-NA,569,0,12725,0,17,12742,T
6-NA,570,5,2,12801,1,12809,G
6-NA,571,6,3,0,12715,12724,C
6-NA,572,12766,1,6,2,12775,A
6-NA,573,2,13248,0,5,13255,T
6-NA,574,3,4,13274,0,13281,G
6-NA,575,3,13249,0,8,13260,T
6-NA,576,0,13500,1,18,13519,T
6-NA,577,0,13473,1,16,13490,T
6-NA,578,3,0,14365,1,14369,G
6-NA,579,1,14295,1,16,14313,T
6-NA,580,14301,2,11,0,14314,A
6-NA,581,1,14358,0,5,14364,T
6-NA,582,13986,1,12,2,14001,A
6-NA,583,14050,4,10,0,14064,A
6-NA,584,0,5,0,13965,13970,C
6-NA,585,8,16,13747,0,13771,G
6-NA,586,2,16,13794,0,13812,G
6-NA,587,3,22,13431,0,13456,G
6-NA,588,3,10,13479,1,13493,G
6-NA,589,3,9,13517,1,13530,G
6-NA,590,13436,2,29,0,13467,A
6-NA,591,2,13496,0,4,13502,T
6-NA,592,1,10,13534,1,13546,G
6-NA,593,13598,5,26,0,13629,A
6-NA,594,2,13682,0,4,13688,T
6-NA,595,13621,0,7,0,13628,A
6-NA,596,13775,2,5,1,13783,A
6-NA,597,13775,0,11,2,13788,A
6-NA,598,13777,0,10,0,13787,A
6-NA,599,13818,3,12,2,13835,A
6-NA,600,0,13814,1,1,13816,T
6-NA,601,7,1,13795,1,13804,G
6-NA,602,2,7,0,13756,13765,C
6-NA,603,13689,1,10,1,13701,A
6-NA,604,13763,1,16,0,13780,A
6-NA,605,5,1,0,13923,13929,C
6-NA,606,1,13854,1,9,13865,T
6-NA,607,4,3,13904,0,13911,G
6-NA,608,5,2,0,13900,13907,C
6-NA,609,0,13907,0,7,13914,T
6-NA,610,13926,0,18,0,13944,A
6-NA,611,7,3,13963,0,13973,G
6-NA,612,4,3,1,14056,14064,C
6-NA,613,3,14015,2,26,14046,T
6-NA,614,0,13974,1,11,13986,T
6-NA,615,9,5,0,14150,14164,C
6-NA,616,14217,1,4,0,14222,A
6-NA,617,2,14227,1,2,14232,T
6-NA,618,1,14247,1,9,14258,T
6-NA,619,1,14330,1,7,14339,T
6-NA,620,14376,0,5,0,14381,A
6-NA,621,2,8,1,14478,14489,C
6-NA,622,14386,2,9,0,14397,A
6-NA,623,14514,0,15,0,14529,A
6-NA,624,0,14397,0,5,14402,T
6-NA,625,4,28,14286,1,14319,G
6-NA,626,7,8,14266,4,14285,G
6-NA,627,4,8,14272,1,14285,G
6-NA,628,14155,4,24,1,14184,A
6-NA,629,6,7,14517,0,14530,G
6-NA,630,4,5,14623,0,14632,G
6-NA,631,6,9,0,15613,15628,C
6-NA,632,1,15567,2,39,15609,T
6-NA,633,1,15776,1,3,15781,T
6-NA,634,1,3,15943,0,15947,G
6-NA,635,0,15949,1,8,15958,T
6-NA,636,16217,0,19,0,16236,A
6-NA,637,5,3,16334,1,16343,G
6-NA,638,15892,0,30,0,15922,A
6-NA,639,2,15941,2,5,15950,T
6-NA,640,14513,0,12,0,14525,A
6-NA,641,3,2,14535,1,14541,G
6-NA,642,1,14384,1,17,14403,T
6-NA,643,3,1,14018,0,14022,G
6-NA,644,1,14709,1,20,14731,T
6-NA,645,1,14709,2,15,14727,T
6-NA,646,2,3,14996,1,15002,G
6-NA,647,5,14932,1,28,14966,T
6-NA,648,1,14947,0,16,14964,T
6-NA,649,0,14979,2,22,15003,T
6-NA,650,10,5,1,14692,14708,C
6-NA,651,14627,1,16,1,14645,A
6-NA,652,0,14575,0,15,14590,T
6-NA,653,3,20,14566,1,14590,G
6-NA,654,4,1,15562,0,15567,G
6-NA,655,3,15392,1,18,15414,T
6-NA,656,13,2,0,15349,15364,C
6-NA,657,16,5,0,15382,15403,C
6-NA,658,15470,0,11,1,15482,A
6-NA,659,15579,2,8,1,15590,A
6-NA,660,15583,2,17,1,15603,A
6-NA,661,0,9,15670,1,15680,G
6-NA,662,15595,6,14,1,15616,A
6-NA,663,14920,1,14,0,14935,A
6-NA,664,14939,1,23,0,14963,A
6-NA,665,5,14915,4,6,14930,T
6-NA,666,14,2,0,15507,15523,C
6-NA,667,8,3,0,15496,15507,C
6-NA,668,0,15376,1,20,15397,T
6-NA,669,9,4,1,15457,15471,C
6-NA,670,15378,4,28,1,15411,A
6-NA,671,4,10,15536,1,15551,G
6-NA,672,4,25,15499,0,15528,G
6-NA,673,15935,2,15,0,15952,A
6-NA,674,0,12,0,15941,15953,C
6-NA,675,18,6,1,15597,15622,C
6-NA,676,23,2,1,15639,15665,C
6-NA,677,15660,1,20,1,15682,A
6-NA,678,1,9,15711,1,15722,G
6-NA,679,1,21,15738,1,15761,G
6-NA,680,15592,5,19,1,15617,A
6-NA,681,2,1,15913,0,15916,G
6-NA,682,2,15502,1,20,15525,T
6-NA,683,15,4,1,15575,15595,C
6-NA,684,15565,1,18,2,15586,A
6-NA,685,6,12,15678,0,15696,G
6-NA,686,15594,1,18,1,15614,A
6-NA,687,15628,1,6,0,15635,A
6-NA,688,1,15568,1,6,15576,T
6-NA,689,4,2,15653,0,15659,G
6-NA,690,4,12,1,15618,15635,C
6-NA,691,4,3,15730,0,15737,G
6-NA,692,2,15647,2,15,15666,T
6-NA,693,1,15685,2,10,15698,T
6-NA,694,1,15566,0,9,15576,T
6-NA,695,5,10,15726,0,15741,G
6-NA,696,1,15772,0,11,15784,T
6-NA,697,15783,1,5,0,15789,A
6-NA,698,5,15677,0,14,15696,T
6-NA,699,9,4,0,15678,15691,C
6-NA,700,15613,2,4,1,15620,A
6-NA,701,15637,0,5,3,15645,A
6-NA,702,1,15644,1,6,15652,T
6-NA,703,2,11,15637,2,15652,G
6-NA,704,8,18,15645,0,15671,G
6-NA,705,15898,0,11,2,15911,A
6-NA,706,15917,1,26,1,15945,A
6-NA,707,3,2,0,16080,16085,C
6-NA,708,0,16102,2,22,16126,T
6-NA,709,0,16075,0,7,16082,T
6-NA,710,2,0,16748,0,16750,G
6-NA,711,2,16752,0,9,16763,T
6-NA,712,16714,2,15,0,16731,A
6-NA,713,2,2,0,17010,17014,C
6-NA,714,16462,3,20,3,16488,A
6-NA,715,6,0,17796,2,17804,G
6-NA,716,0,17669,1,8,17678,T
6-NA,717,18450,0,14,2,18466,A
6-NA,718,13,3,18540,0,18556,G
6-NA,719,4,18018,2,7,18031,T
6-NA,720,17977,0,14,1,17992,A
6-NA,721,17983,1,5,1,17990,A
6-NA,722,3,17867,1,5,17876,T
6-NA,723,9,31,17930,0,17970,G
6-NA,724,17276,3,14,0,17293,A
6-NA,725,1,3,1,17505,17510,C
6-NA,726,1,16811,1,15,16828,T
6-NA,727,5,7,16919,1,16932,G
6-NA,728,16816,5,35,1,16857,A
6-NA,729,0,16919,0,17,16936,T
6-NA,730,8,27,16916,0,16951,G
6-NA,731,9,14,16778,0,16801,G
6-NA,732,4,16,16815,1,16836,G
6-NA,733,16399,1,27,2,16429,A
6-NA,734,3,3,16492,0,16498,G
6-NA,735,1,16347,1,11,16360,T
6-NA,736,7,1,16392,0,16400,G
6-NA,737,1,3,3,16563,16570,C
6-NA,738,4,16506,1,32,16543,T
6-NA,739,6,16501,0,10,16517,T
6-NA,740,7,5,2,16536,16550,C
6-NA,741,16477,0,34,0,16511,A
6-NA,742,4,10,16585,1,16600,G
6-NA,743,4,23,16586,0,16613,G
6-NA,744,16572,2,5,1,16580,A
6-NA,745,16386,1,12,0,16399,A
6-NA,746,16236,2,7,5,16250,A
6-NA,747,16330,0,38,1,16369,A
6-NA,748,7,0,16469,0,16476,G
6-NA,749,2,0,0,16480,16482,C
6-NA,750,1,16356,2,9,16368,T
6-NA,751,4,9,16355,1,16369,G
6-NA,752,16261,3,21,0,16285,A
6-NA,753,1,16503,0,6,16510,T
6-NA,754,16593,2,14,0,16609,A
6-NA,755,4,2,0,17586,17592,C
6-NA,756,1,17435,2,11,17449,T
6-NA,757,17470,0,3,0,17473,A
6-NA,758,17466,3,14,4,17487,A
6-NA,759,17483,2,5,0,17490,A
6-NA,760,18086,3,10,0,18099,A
6-NA,761,0,18083,0,3,18086,T
6-NA,762,18062,2,6,0,18070,A
6-NA,763,6,2,0,18158,18166,C
6-NA,764,2,17208,2,17,17229,T
6-NA,765,17532,0,5,0,17537,A
6-NA,766,1,17387,2,29,17419,T
6-NA,767,4,18319,2,14,18339,T
6-NA,768,20,6,0,18494,18520,C
6-NA,769,17922,1,4,0,17927,A
6-NA,770,1,17895,2,17,17915,T
6-NA,771,1,17838,0,5,17844,T
6-NA,772,12,18,17932,0,17962,G
6-NA,773,17665,3,31,1,17700,A
6-NA,774,5,15,17689,3,17712,G
6-NA,775,2,16,17665,0,17683,G
6-NA,776,16702,3,23,1,16729,A
6-NA,777,3,19,17129,0,17151,G
6-NA,778,6,26,17145,2,17179,G
6-NA,779,3,14,17200,0,17217,G
6-NA,780,3,9,17239,1,17252,G
6-NA,781,17114,1,25,2,17142,A
6-NA,782,17176,3,12,3,17194,A
6-NA,783,17122,2,20,2,17146,A
6-NA,784,17112,1,19,0,17132,A
6-NA,785,3,17155,1,5,17164,T
6-NA,786,19,8,0,16988,17015,C
6-NA,787,3,4,17181,2,17190,G
6-NA,788,0,17129,3,9,17141,T
6-NA,789,1,17100,1,19,17121,T
6-NA,790,17,3,0,17149,17169,C
6-NA,791,17176,3,3,1,17183,A
6-NA,792,1,18553,1,11,18566,T
6-NA,793,18524,2,6,0,18532,A
6-NA,794,3,2,1,18637,18643,C
6-NA,795,1,18557,2,20,18580,T
6-NA,796,18515,2,18,0,18535,A
6-NA,797,9,3,18503,0,18515,G
6-NA,798,2,6,1,18497,18506,C
6-NA,799,18519,0,14,1,18534,A
6-NA,800,2,2,0,18590,18594,C
6-NA,801,17582,0,6,3,17591,A
6-NA,802,1,17956,2,10,17969,T
6-NA,803,2,17846,2,10,17860,T
6-NA,804,4,1,19241,1,19247,G
6-NA,805,2,19142,1,22,19167,T
6-NA,806,31,9,7,19112,19159,C
6-NA,807,19105,5,35,3,19148,A
6-NA,808,7,6,19167,0,19180,G
6-NA,809,6,12,19192,0,19210,G
6-NA,810,19082,4,11,2,19099,A
6-NA,811,18736,0,27,0,18763,A
6-NA,812,5,2,18996,0,19003,G
6-NA,813,1,17778,1,11,17791,T
6-NA,814,3,6,17884,1,17894,G
6-NA,815,2,9,0,17866,17877,C
6-NA,816,0,17778,2,28,17808,T
6-NA,817,15,10,0,17891,17916,C
6-NA,818,17819,1,19,0,17839,A
6-NA,819,9,4,17981,1,17995,G
6-NA,820,7,8,12,17944,17971,C
6-NA,821,17896,0,18,1,17915,A
6-NA,822,4,17910,1,8,17923,T
6-NA,823,16,2,18611,0,18629,G
6-NA,824,4,18587,1,20,18612,T
6-NA,825,22,7,0,18562,18591,C
6-NA,826,9,6,18593,0,18608,G
6-NA,827,18498,1,14,0,18513,A
6-NA,828,1,14,18412,1,18428,G
6-NA,829,2,25,18407,1,18435,G
6-NA,830,18208,1,27,1,18237,A
6-NA,831,9,2,18484,2,18497,G
6-NA,832,0,17773,0,12,17785,T
6-NA,833,10,5,17799,1,17815,G
6-NA,834,5,14,3,18034,18056,C
6-NA,835,4,17950,3,25,17982,T
6-NA,836,25,2,0,18090,18117,C
6-NA,837,11,4,0,18160,18175,C
6-NA,838,7,18187,0,15,18209,T
6-NA,839,7,1,18275,0,18283,G
6-NA,840,1,4,0,18084,18089,C
6-NA,841,1,17926,0,21,17948,T
6-NA,842,18168,3,13,0,18184,A
6-NA,843,0,17771,2,18,17791,T
6-NA,844,10,3,1,17928,17942,C
6-NA,845,13,0,0,17884,17897,C
6-NA,846,7,17807,1,26,17841,T
6-NA,847,7,4,1,17941,17953,C
6-NA,848,5,10,17932,1,17948,G
6-NA,849,18100,1,8,0,18109,A
6-NA,850,1,18119,0,26,18146,T
6-NA,851,18143,1,5,1,18150,A
6-NA,852,1,18047,1,7,18056,T
6-NA,853,6,5,14,18018,18043,C
6-NA,854,8,0,0,18005,18013,C
6-NA,855,1,17831,3,25,17860,T
6-NA,856,6,10,17943,2,17961,G
6-NA,857,1,3,18051,0,18055,G
6-NA,858,1,18267,4,20,18292,T
6-NA,859,4,2,18273,0,18279,G
6-NA,860,2,18111,1,32,18146,T
6-NA,861,30,10,1,18095,18136,C
6-NA,862,18090,1,21,1,18113,A
6-NA,863,6,7,18132,0,18145,G
6-NA,864,18084,9,22,1,18116,A
6-NA,865,1,17913,0,10,17924,T
6-NA,866,1,2,17940,1,17944,G
6-NA,867,1,17592,1,14,17608,T
6-NA,868,2,2,17615,9,17628,G
6-NA,869,5,17518,4,31,17558,T
6-NA,870,12,5,0,17598,17615,C
6-NA,871,5,17547,3,33,17588,T
6-NA,872,6,1,17607,3,17617,G
6-NA,873,2,10,0,17585,17597,C
6-NA,874,17570,9,13,1,17593,A
6-NA,875,1,12,17617,0,17630,G
6-NA,876,17064,4,28,2,17098,A
6-NA,877,3,6,17190,10,17209,G
6-NA,878,17160,1,24,0,17185,A
6-NA,879,6,6,0,17283,17295,C
6-NA,880,17286,3,21,0,17310,A
6-NA,881,17375,9,20,0,17404,A
6-NA,882,2,5,0,17501,17508,C
6-NA,883,7,17469,2,14,17492,T
6-NA,884,3,7,17493,2,17505,G
6-NA,885,3,9,17438,0,17450,G
6-NA,886,17339,2,24,1,17366,A
6-NA,887,17342,1,19,0,17362,A
6-NA,888,16857,2,18,0,16877,A
6-NA,889,9,10,17193,1,17213,G
6-NA,890,3,2,17118,0,17123,G
6-NA,891,6,1,1,17075,17083,C
6-NA,892,2,16916,0,45,16963,T
6-NA,893,16,4,0,17413,17433,C
6-NA,894,10,3,0,17611,17624,C
6-NA,895,17704,1,7,0,17712,A
6-NA,896,17671,2,10,0,17683,A
6-NA,897,0,17704,1,3,17708,T
6-NA,898,16902,1,22,1,16926,A
6-NA,899,5,9,16852,0,16866,G
6-NA,900,4,1,16853,1,16859,G
6-NA,901,5,10,0,16849,16864,C
6-NA,902,17,5,0,16402,16424,C
6-NA,903,17,5,2,16217,16241,C
6-NA,904,16357,1,5,0,16363,A
6-NA,905,3,16450,0,27,16480,T
6-NA,906,7,3,2,16524,16536,C
6-NA,907,21,6,16570,0,16597,G
6-NA,908,0,16486,2,10,16498,T
6-NA,909,16069,1,14,0,16084,A
6-NA,910,2,3,16487,0,16492,G
6-NA,911,16456,2,26,1,16485,A
6-NA,912,1,16564,0,5,16570,T
6-NA,913,16171,0,2,0,16173,A
6-NA,914,0,15957,0,2,15959,T
6-NA,915,15940,0,5,0,15945,A
6-NA,916,15903,2,11,1,15917,A
6-NA,917,16336,2,13,0,16351,A
6-NA,918,3,2,1,16767,16773,C
6-NA,919,16103,0,6,1,16110,A
6-NA,920,2,16052,1,5,16060,T
6-NA,921,15874,0,5,0,15879,A
6-NA,922,15869,0,18,0,15887,A
6-NA,923,15848,1,27,2,15878,A
6-NA,924,3,15,16037,0,16055,G
6-NA,925,4,10,16241,0,16255,G
6-NA,926,15470,2,11,1,15484,A
6-NA,927,7,15275,1,16,15299,T
6-NA,928,10,9,1,15374,15394,C
6-NA,929,15453,1,24,0,15478,A
6-NA,930,1,15483,1,20,15505,T
6-NA,931,15431,1,16,0,15448,A
6-NA,932,2,2,15579,0,15583,G
6-NA,933,2,2,0,15269,15273,C
6-NA,934,14893,0,2,0,14895,A
6-NA,935,2,14315,0,14,14331,T
6-NA,936,3,14378,1,2,14384,T
6-NA,937,2,0,14859,1,14862,G
6-NA,938,4,14853,1,15,14873,T
6-NA,939,2,15074,2,31,15109,T
6-NA,940,1,15095,2,17,15115,T
6-NA,941,11,2,0,15048,15061,C
6-NA,942,11,6,1,15109,15127,C
6-NA,943,15323,4,7,0,15334,A
6-NA,944,6,1,15571,0,15578,G
6-NA,945,1,15519,0,27,15547,T
6-NA,946,0,14939,1,6,14946,T
6-NA,947,14980,2,5,2,14989,A
6-NA,948,4,14720,1,7,14732,T
6-NA,949,7,2,14714,0,14723,G
6-NA,950,4,14573,1,14,14592,T
6-NA,951,5,1,14666,1,14673,G
6-NA,952,2,14196,1,15,14214,T
6-NA,953,9,1,14634,3,14647,G
6-NA,954,2,14577,0,31,14610,T
6-NA,955,1,14493,1,19,14514,T
6-NA,956,18,6,0,14504,14528,C
6-NA,957,14370,1,27,1,14399,A
6-NA,958,6,11,14488,1,14506,G
6-NA,959,4,14,14467,0,14485,G
6-NA,960,14322,0,13,0,14335,A
6-NA,961,19,5,0,14372,14396,C
6-NA,962,0,13788,1,9,13798,T
6-NA,963,0,13817,0,5,13822,T
6-NA,964,4,2,14391,0,14397,G
6-NA,965,1,14393,0,20,14414,T
6-NA,966,2,14357,2,15,14376,T
6-NA,967,2,12,14237,0,14251,G
6-NA,968,0,11,14197,0,14208,G
6-NA,969,14116,5,43,0,14164,A
6-NA,970,1,12,14218,0,14231,G
6-NA,971,14175,1,23,0,14199,A
6-NA,972,1,1,0,14193,14195,C
6-NA,973,13659,3,13,0,13675,A
6-NA,974,1,4,0,13729,13734,C
6-NA,975,13755,4,19,7,13785,A
6-NA,976,0,5,1,13823,13829,C
6-NA,977,11,4,0,13714,13729,C
6-NA,978,24,6,0,13736,13766,C
6-NA,979,13701,1,15,2,13719,A
6-NA,980,4,9,13786,0,13799,G
6-NA,981,13779,0,4,2,13785,A
6-NA,982,13857,1,8,1,13867,A
6-NA,983,13752,1,1,0,13754,A
6-NA,984,13696,0,10,2,13708,A
6-NA,985,13606,0,7,0,13613,A
6-NA,986,13694,1,11,1,13707,A
6-NA,987,2,2,1,13746,13751,C
6-NA,988,5,22,13694,0,13721,G
6-NA,989,13652,2,15,1,13670,A
6-NA,990,0,2,0,13666,13668,C
6-NA,991,13602,1,13,0,13616,A
6-NA,992,3,6,13724,0,13733,G
6-NA,993,4,3,2,14149,14158,C
6-NA,994,3,14048,1,27,14079,T
6-NA,995,13,1,1,14178,14193,C
6-NA,996,7,5,0,14201,14213,C
6-NA,997,14208,2,22,0,14232,A
6-NA,998,2,2,14386,1,14391,G
6-NA,999,3,6,0,14384,14393,C
6-NA,1000,14286,2,11,1,14300,A
6-NA,1001,1,5,14299,1,14306,G
6-NA,1002,1,13556,2,23,13582,T
6-NA,1003,13588,1,12,0,13601,A
6-NA,1004,1,2,13609,0,13612,G
6-NA,1005,2,4,1,13614,13621,C
6-NA,1006,8,2,0,13633,13643,C
6-NA,1007,13420,1,7,2,13430,A
6-NA,1008,1,13383,1,18,13403,T
6-NA,1009,0,13400,1,4,13405,T
6-NA,1010,6,0,13775,0,13781,G
6-NA,1011,2,13640,1,16,13659,T
6-NA,1012,0,13629,1,15,13645,T
6-NA,1013,7,13588,0,4,13599,T
6-NA,1014,5,11,13421,1,13438,G
6-NA,1015,4,7,13576,0,13587,G
6-NA,1016,13475,4,13,0,13492,A
6-NA,1017,4,13569,0,8,13581,T
6-NA,1018,10,3,0,13622,13635,C
6-NA,1019,8,6,1,13312,13327,C
6-NA,1020,11,13318,0,15,13344,T
6-NA,1021,13345,0,19,1,13365,A
6-NA,1022,13392,4,8,2,13406,A
6-NA,1023,2,7,0,13647,13656,C
6-NA,1024,13306,1,6,0,13313,A
6-NA,1025,13509,1,7,0,13517,A
6-NA,1026,0,13473,0,6,13479,T
6-NA,1027,0,4,13641,1,13646,G
6-NA,1028,13561,4,18,2,13585,A
6-NA,1029,13442,3,44,1,13490,A
6-NA,1030,8,4,13577,0,13589,G
6-NA,1031,13444,0,23,3,13470,A
6-NA,1032,13019,2,22,4,13047,A
6-NA,1033,2,9,13093,0,13104,G
6-NA,1034,6,2,13115,0,13123,G
6-NA,1035,1,12867,1,14,12883,T
6-NA,1036,2,18,12788,1,12809,G
6-NA,1037,3,4,13290,1,13298,G
6-NA,1038,1,13209,0,17,13227,T
6-NA,1039,29,4,0,13100,13133,C
6-NA,1040,13173,1,6,1,13181,A
6-NA,1041,2,13099,0,14,13115,T
6-NA,1042,0,18,13091,1,13110,G
6-NA,1043,2,10,13224,0,13236,G
6-NA,1044,13063,1,20,1,13085,A
6-NA,1045,7,0,13554,3,13564,G
6-NA,1046,0,12952,0,9,12961,T
6-NA,1047,4,5,12960,0,12969,G
6-NA,1048,12910,11,13,1,12935,A
6-NA,1049,12944,1,8,0,12953,A
6-NA,1050,12947,1,41,0,12989,A
6-NA,1051,2,6,13052,0,13060,G
6-NA,1052,5,6,12917,0,12928,G
6-NA,1053,4,3,0,12863,12870,C
6-NA,1054,1,12334,1,20,12356,T
6-NA,1055,6,5,12379,0,12390,G
6-NA,1056,5,8,12364,0,12377,G
6-NA,1057,2,3,12479,0,12484,G
6-NA,1058,7,4,0,12504,12515,C
6-NA,1059,7,3,0,12504,12514,C
6-NA,1060,2,12313,0,19,12334,T
6-NA,1061,0,12343,2,4,12349,T
6-NA,1062,0,12354,0,2,12356,T
6-NA,1063,1,5,12404,0,12410,G
6-NA,1064,12363,0,18,0,12381,A
6-NA,1065,1,12240,0,10,12251,T
6-NA,1066,2,5,12001,0,12008,G
6-NA,1067,11771,5,10,1,11787,A
6-NA,1068,3,11834,0,9,11846,T
6-NA,1069,3,5,11876,1,11885,G
6-NA,1070,2,6,12062,0,12070,G
6-NA,1071,12031,1,10,0,12042,A
6-NA,1072,11989,0,10,2,12001,A
6-NA,1073,12027,0,17,1,12045,A
6-NA,1074,0,12023,0,4,12027,T
6-NA,1075,4,7,12067,0,12078,G
6-NA,1076,12047,2,15,0,12064,A
6-NA,1077,3,7,0,12037,12047,C
6-NA,1078,14,4,12081,0,12099,G
6-NA,1079,2,11750,0,11,11763,T
6-NA,1080,5,1,11906,0,11912,G
6-NA,1081,1,11873,0,8,11882,T
6-NA,1082,4,14,11872,0,11890,G
6-NA,1083,1,5,11972,0,11978,G
6-NA,1084,11819,2,15,0,11836,A
6-NA,1085,1,11821,0,9,11831,T
6-NA,1086,7,16,11762,0,11785,G
6-NA,1087,8,8,11753,0,11769,G
6-NA,1088,3,6,11840,0,11849,G
6-NA,1089,11745,2,11,1,11759,A
6-NA,1090,11725,3,16,1,11745,A
6-NA,1091,2,14,11730,0,11746,G
6-NA,1092,11545,2,14,1,11562,A
6-NA,1093,11539,4,6,2,11551,A
6-NA,1094,2,6,0,11506,11514,C
6-NA,1095,5,14,11431,0,11450,G
6-NA,1096,11390,2,15,0,11407,A
6-NA,1097,3,11169,0,10,11182,T
6-NA,1098,13,5,0,11211,11229,C
6-NA,1099,11219,2,16,0,11237,A
6-NA,1100,12,6,11289,0,11307,G
6-NA,1101,2,5,2,11250,11259,C
6-NA,1102,5,13,11270,0,11288,G
6-NA,1103,11220,2,7,0,11229,A
6-NA,1104,3,2,11239,0,11244,G
6-NA,1105,11194,0,12,0,11206,A
6-NA,1106,11246,2,6,1,11255,A
6-NA,1107,3,0,11320,0,11323,G
6-NA,1108,0,11214,1,5,11220,T
6-NA,1109,18,7,0,11131,11156,C
6-NA,1110,11141,0,7,0,11148,A
6-NA,1111,5,4,0,11496,11505,C
6-NA,1112,2,2,11532,0,11536,G
6-NA,1113,7,0,0,11526,11533,C
6-NA,1114,0,11426,1,8,11435,T
6-NA,1115,0,11478,0,3,11481,T
6-NA,1116,11274,2,12,1,11289,A
6-NA,1117,2,19,11649,1,11671,G
6-NA,1118,3,9,11637,0,11649,G
6-NA,1119,2,2,11948,0,11952,G
6-NA,1120,2,11061,0,6,11069,T
6-NA,1121,11013,1,9,1,11024,A
6-NA,1122,1,10982,0,5,10988,T
6-NA,1123,3,8,10976,0,10987,G
6-NA,1124,10949,1,16,4,10970,A
6-NA,1125,10937,0,4,0,10941,A
6-NA,1126,10380,3,17,0,10400,A
6-NA,1127,2,3,0,10399,10404,C
6-NA,1128,5,2,0,10025,10032,C
6-NA,1129,4,9729,0,12,9745,T
6-NA,1130,1,9711,1,11,9724,T
6-NA,1131,7,2,0,9722,9731,C
6-NA,1132,9724,0,5,0,9729,A
6-NA,1133,9743,4,3,0,9750,A
6-NA,1134,9734,2,8,1,9745,A
6-NA,1135,2,1,9827,0,9830,G
6-NA,1136,1,9558,0,17,9576,T
6-NA,1137,16,2,0,9617,9635,C
6-NA,1138,9825,6,5,1,9837,A
6-NA,1139,1,9836,0,8,9845,T
6-NA,1140,1,9833,0,7,9841,T
6-NA,1141,3,0,9846,0,9849,G
6-NA,1142,9803,1,10,0,9814,A
6-NA,1143,9812,1,17,1,9831,A
6-NA,1144,1,6,9824,0,9831,G
6-NA,1145,3,1,9785,0,9789,G
6-NA,1146,1,5,0,9738,9744,C
6-NA,1147,1,9381,1,4,9387,T
6-NA,1148,5,4,9456,1,9466,G
6-NA,1149,8,1,9740,0,9749,G
6-NA,1150,1,9715,2,19,9737,T
6-NA,1151,14,1,1,9689,9705,C
6-NA,1152,10,2,1,9638,9651,C
6-NA,1153,9630,2,13,0,9645,A
6-NA,1154,9711,0,10,0,9721,A
6-NA,1155,2,2,4,9781,9789,C
6-NA,1156,7,4,0,9751,9762,C
6-NA,1157,15,1,0,9704,9720,C
6-NA,1158,3,9071,0,10,9084,T
6-NA,1159,9099,0,1,0,9100,A
6-NA,1160,9074,1,11,0,9086,A
6-NA,1161,3,0,9173,0,9176,G
6-NA,1162,1,9094,0,9,9104,T
6-NA,1163,18,0,0,9031,9049,C
6-NA,1164,11,2,1,8851,8865,C
6-NA,1165,8818,0,5,1,8824,A
6-NA,1166,8796,1,4,1,8802,A
6-NA,1167,8804,0,2,0,8806,A
6-NA,1168,1,8802,1,9,8813,T
6-NA,1169,0,8798,2,3,8803,T
6-NA,1170,1,0,8737,0,8738,G
6-NA,1171,0,5,0,8669,8674,C
6-NA,1172,8635,4,10,1,8650,A
6-NA,1173,0,2,8702,0,8704,G
6-NA,1174,8678,0,4,0,8682,A
6-NA,1175,2,8852,0,0,8854,T
6-NA,1176,8857,0,2,1,8860,A
6-NA,1177,8804,2,5,0,8811,A
6-NA,1178,8804,2,11,0,8817,A
6-NA,1179,1,8767,1,0,8769,T
6-NA,1180,8716,2,12,2,8732,A
6-NA,1181,0,9,8737,0,8746,G
6-NA,1182,2,1,8636,0,8639,G
6-NA,1183,4,1,0,8598,8603,C
6-NA,1184,8179,1,3,0,8183,A
6-NA,1185,8265,1,13,0,8279,A
6-NA,1186,3,2,8347,0,8352,G
6-NA,1187,0,8280,0,15,8295,T
6-NA,1188,11,0,0,8297,8308,C
6-NA,1189,8292,0,5,3,8300,A
6-NA,1190,0,8257,1,9,8267,T
6-NA,1191,8266,0,8,0,8274,A
6-NA,1192,2,0,8305,0,8307,G
6-NA,1193,1,8271,0,4,8276,T
6-NA,1194,1,7813,0,6,7820,T
6-NA,1195,4,8,7619,0,7631,G
6-NA,1196,7546,2,16,0,7564,A
6-NA,1197,1,4,0,7559,7564,C
6-NA,1198,7384,0,6,0,7390,A
6-NA,1199,1,0,7464,1,7466,G
6-NA,1200,7243,0,15,0,7258,A
6-NA,1201,3,3,7568,0,7574,G
6-NA,1202,1,3,7577,0,7581,G
6-NA,1203,1,7495,1,11,7508,T
6-NA,1204,7456,0,1,0,7457,A
6-NA,1205,7439,2,6,0,7447,A
6-NA,1206,0,7447,0,1,7448,T
6-NA,1207,7393,0,13,0,7406,A
6-NA,1208,4,1,7071,0,7076,G
6-NA,1209,0,1,6720,0,6721,G
6-NA,1210,1,5448,0,3,5452,T
6-NA,1211,8,2,0,5364,5374,C
6-NA,1212,6,2,1,5271,5280,C
6-NA,1213,2,4,5274,0,5280,G
6-NA,1214,2,2,5306,0,5310,G
6-NA,1215,2,5268,0,1,5271,T
6-NA,1216,0,5252,0,1,5253,T
6-NA,1217,5110,0,0,0,5110,A
6-NA,1218,0,4914,0,4,4918,T
6-NA,1219,1,4898,0,1,4900,T
6-NA,1220,3,1,0,4904,4908,C
6-NA,1221,0,4385,0,6,4391,T
6-NA,1222,1,6,4394,0,4401,G
6-NA,1223,2,0,4394,0,4396,G
6-NA,1224,1,4351,0,6,4358,T
6-NA,1225,4349,0,0,0,4349,A
6-NA,1226,0,4235,0,9,4244,T
6-NA,1227,0,4238,0,11,4249,T
6-NA,1228,0,4235,0,7,4242,T
6-NA,1229,2,4276,0,9,4287,T
6-NA,1230,2,0,1,4302,4305,C
6-NA,1231,0,4202,0,7,4209,T
6-NA,1232,0,0,1,4235,4236,C
6-NA,1233,0,4207,1,1,4209,T
6-NA,1234,0,1,4318,1,4320,G
6-NA,1235,1,4319,0,3,4323,T
6-NA,1236,0,4283,1,3,4287,T
6-NA,1237,0,1,4292,1,4294,G
6-NA,1238,4248,1,1,0,4250,A
6-NA,1239,4250,3,9,0,4262,A
6-NA,1240,0,1,4326,0,4327,G
6-NA,1241,3,1,4302,0,4306,G
6-NA,1242,0,1,0,4300,4301,C
6-NA,1243,4228,0,2,0,4230,A
6-NA,1244,4219,0,11,0,4230,A
6-NA,1245,4238,0,7,0,4245,A
6-NA,1246,4242,0,12,0,4254,A
6-NA,1247,1,0,4268,0,4269,G
6-NA,1248,0,2,0,4245,4247,C
6-NA,1249,0,4191,1,4,4196,T
6-NA,1250,2,0,4263,0,4265,G
6-NA,1251,0,1,0,4252,4253,C
6-NA,1252,4267,1,1,0,4269,A
6-NA,1253,0,4253,1,4,4258,T
6-NA,1254,2,1,0,4240,4243,C
6-NA,1255,4239,0,2,0,4241,A
6-NA,1256,4244,0,2,0,4246,A
6-NA,1257,0,4238,0,0,4238,T
6-NA,1258,3,1,0,4231,4235,C
6-NA,1259,3,2,4174,0,4179,G
6-NA,1260,3,1,4302,0,4306,G
6-NA,1261,1,4285,2,4,4292,T
6-NA,1262,0,1,4336,0,4337,G
6-NA,1263,1,0,0,4387,4388,C
6-NA,1264,1,4330,1,20,4352,T
6-NA,1265,0,4426,0,5,4431,T
6-NA,1266,0,4419,0,12,4431,T
6-NA,1267,0,4461,0,1,4462,T
6-NA,1268,4494,0,4,0,4498,A
6-NA,1269,1,4283,0,4,4288,T
6-NA,1270,2,0,4295,0,4297,G
6-NA,1271,0,4235,0,5,4240,T
6-NA,1272,1,2,4182,0,4185,G
6-NA,1273,0,6,4282,0,4288,G
6-NA,1274,4188,1,3,1,4193,A
6-NA,1275,1,0,4273,0,4274,G
6-NA,1276,0,4252,0,2,4254,T
6-NA,1277,1,4217,1,2,4221,T
6-NA,1278,6,1,4272,0,4279,G
6-NA,1279,4257,0,8,0,4265,A
6-NA,1280,0,4268,0,2,4270,T
6-NA,1281,4249,0,2,1,4252,A
6-NA,1282,4113,0,6,0,4119,A
6-NA,1283,0,9,4169,0,4178,G
6-NA,1284,1,7,4105,0,4113,G
6-NA,1285,7,3,4065,0,4075,G
6-NA,1286,1,2,4083,0,4086,G
6-NA,1287,4006,0,6,0,4012,A
6-NA,1288,4009,0,6,0,4015,A
6-NA,1289,1,0,4063,0,4064,G
6-NA,1290,4053,0,0,0,4053,A
6-NA,1291,4053,1,2,1,4057,A
6-NA,1292,4009,1,1,0,4011,A
6-NA,1293,3935,2,6,0,3943,A
6-NA,1294,0,0,3950,0,3950,G
6-NA,1295,3892,2,9,0,3903,A
6-NA,1296,0,1,3904,0,3905,G
6-NA,1297,0,2,3899,0,3901,G
6-NA,1298,3850,1,4,0,3855,A
6-NA,1299,3856,1,1,0,3858,A
6-NA,1300,3878,1,5,1,3885,A
6-NA,1301,0,0,0,3911,3911,C
6-NA,1302,0,3890,0,7,3897,T
6-NA,1303,0,0,3910,0,3910,G
6-NA,1304,3890,0,1,0,3891,A
6-NA,1305,3885,0,6,0,3891,A
6-NA,1306,1,0,3943,0,3944,G
6-NA,1307,0,3900,0,7,3907,T
6-NA,1308,5,0,0,3960,3965,C
6-NA,1309,0,3949,0,6,3955,T
6-NA,1310,0,3924,0,2,3926,T
6-NA,1311,1,1,3927,0,3929,G
6-NA,1312,2,3911,1,3,3917,T
6-NA,1313,1,2,3899,0,3902,G
6-NA,1314,1,3,3897,0,3901,G
6-NA,1315,3858,0,5,0,3863,A
6-NA,1316,1,1,0,3902,3904,C
6-NA,1317,4,1,0,3811,3816,C
6-NA,1318,0,3816,0,3,3819,T
6-NA,1319,1,2,0,3833,3836,C
6-NA,1320,3857,0,0,0,3857,A
6-NA,1321,3858,1,2,0,3861,A
6-NA,1322,3850,0,3,0,3853,A
6-NA,1323,2,0,0,3930,3932,C
6-NA,1324,3841,1,0,0,3842,A
6-NA,1325,3,1,3989,0,3993,G
6-NA,1326,0,3934,0,3,3937,T
6-NA,1327,3936,1,3,0,3940,A
6-NA,1328,0,3956,0,0,3956,T
6-NA,1329,1,3893,0,2,3896,T
6-NA,1330,0,0,3944,0,3944,G
6-NA,1331,0,3924,0,7,3931,T
6-NA,1332,0,3759,1,4,3764,T
6-NA,1333,1,0,3772,0,3773,G
6-NA,1334,1,3475,0,4,3480,T
6-NA,1335,2,0,3492,0,3494,G
6-NA,1336,2,3471,0,5,3478,T
6-NA,1337,1,3430,2,2,3435,T
6-NA,1338,0,3440,0,5,3445,T
6-NA,1339,0,3358,0,1,3359,T
6-NA,1340,0,0,3370,0,3370,G
6-NA,1341,1,3363,4,0,3368,T
6-NA,1342,2,6,3337,0,3345,G
6-NA,1343,1,0,3341,0,3342,G
6-NA,1344,0,3,0,3296,3299,C
6-NA,1345,3292,0,5,0,3297,A
6-NA,1346,1,1,0,3332,3334,C
6-NA,1347,3,0,0,3320,3323,C
6-NA,1348,0,3309,0,7,3316,T
6-NA,1349,1,0,0,3343,3344,C
6-NA,1350,3337,1,7,0,3345,A
6-NA,1351,1,7,3394,0,3402,G
6-NA,1352,2,0,3421,1,3424,G
6-NA,1353,0,3394,1,8,3403,T
6-NA,1354,3390,0,2,0,3392,A
6-NA,1355,0,7,0,3247,3254,C
6-NA,1356,3288,0,3,0,3291,A
6-NA,1357,1,3279,1,5,3286,T
6-NA,1358,3208,0,7,0,3215,A
6-NA,1359,0,3203,0,2,3205,T
6-NA,1360,2,12,2968,0,2982,G
6-NA,1361,1,1,2987,0,2989,G
6-NA,1362,2963,1,2,0,2966,A
6-NA,1363,2942,0,3,0,2945,A
6-NA,1364,0,0,0,2923,2923,C
6-NA,1365,2461,0,2,0,2463,A
6-NA,1366,0,0,2471,0,2471,G
6-NA,1367,0,1,2464,0,2465,G
6-NA,1368,0,0,0,2482,2482,C
6-NA,1369,0,2459,1,2,2462,T
6-NA,1370,7,1,0,2335,2343,C
6-NA,1371,2338,0,2,0,2340,A
6-NA,1372,0,2340,0,3,2343,T
6-NA,1373,0,2,2345,0,2347,G
6-NA,1374,1,1,2349,0,2351,G
6-NA,1375,0,0,0,2255,2255,C
6-NA,1376,1,0,0,2255,2256,C
6-NA,1377,0,2128,0,2,2130,T
6-NA,1378,1,0,2134,0,2135,G
6-NA,1379,2124,0,2,0,2126,A
6-NA,1380,0,2129,0,1,2130,T
6-NA,1381,0,1,2100,0,2101,G
6-NA,1382,0,3,2052,0,2055,G
6-NA,1383,1,2,1959,0,1962,G
6-NA,1384,0,0,1963,0,1963,G
6-NA,1385,0,0,0,1923,1923,C
6-NA,1386,0,3,1913,0,1916,G
6-NA,1387,3,0,1909,0,1912,G
6-NA,1388,1895,0,2,0,1897,A
6-NA,1389,0,3,0,1888,1891,C
6-NA,1390,1891,0,1,0,1892,A
6-NA,1391,0,1857,0,4,1861,T
6-NA,1392,1,0,0,1836,1837,C
6-NA,1393,1826,0,2,0,1828,A
6-NA,1394,1831,0,0,0,1831,A
6-NA,1395,0,1814,0,2,1816,T
6-NA,1396,0,0,0,1781,1781,C
6-NA,1397,0,1738,0,1,1739,T
6-NA,1398,4,2,0,1466,1472,C
6-NA,1399,1462,0,3,0,1465,A
6-NA,1400,0,1446,0,2,1448,T
6-NA,1401,0,0,1452,0,1452,G
6-NA,1402,1,0,0,1438,1439,C
6-NA,1403,1,0,0,1383,1384,C
6-NA,1404,0,1211,0,2,1213,T
6-NA,1405,1202,0,1,0,1203,A
6-NA,1406,0,1199,0,0,1199,T
6-NA,1407,1190,0,1,0,1191,A
6-NA,1408,0,1185,0,0,1185,T
6-NA,1409,1071,0,0,0,1071,A
6-NA,1410,1016,0,0,0,1016,A
7-M,1,334,0,0,0,334,A
7-M,2,0,335,0,0,335,T
7-M,3,0,0,336,0,336,G
7-M,4,339,0,0,0,339,A
7-M,5,1,1,366,0,368,G
7-M,6,0,0,0,389,389,C
7-M,7,0,0,0,411,411,C
7-M,8,0,536,0,0,536,T
7-M,9,0,541,0,1,542,T
7-M,10,1,0,0,543,544,C
7-M,11,0,541,1,0,542,T
7-M,12,561,0,0,0,561,A
7-M,13,560,0,2,0,562,A
7-M,14,0,0,0,561,561,C
7-M,15,0,0,0,560,560,C
7-M,16,0,0,561,0,561,G
7-M,17,559,0,0,0,559,A
7-M,18,0,0,568,0,568,G
7-M,19,1,0,586,0,587,G
7-M,20,0,589,0,0,589,T
7-M,21,2,0,0,587,589,C
7-M,22,0,1,591,0,592,G
7-M,23,604,0,0,0,604,A
7-M,24,609,0,0,0,609,A
7-M,25,611,1,1,1,614,A
7-M,26,0,1,0,666,667,C
7-M,27,1,0,676,1,678,G
7-M,28,0,681,0,0,681,T
7-M,29,693,0,0,0,693,A
7-M,30,0,698,0,0,698,T
7-M,31,0,0,709,0,709,G
7-M,32,0,709,0,0,709,T
7-M,33,0,773,0,1,774,T
7-M,34,3,0,0,806,809,C
7-M,35,0,806,0,0,806,T
7-M,36,1,0,0,853,854,C
7-M,37,0,850,0,1,851,T
7-M,38,1,0,0,900,901,C
7-M,39,0,903,0,0,903,T
7-M,40,905,0,0,0,905,A
7-M,41,0,905,0,1,906,T
7-M,42,0,0,0,905,905,C
7-M,43,2,0,906,0,908,G
7-M,44,0,909,0,0,909,T
7-M,45,0,903,0,2,905,T
7-M,46,1,0,0,926,927,C
7-M,47,0,1,0,950,951,C
7-M,48,947,0,2,0,949,A
7-M,49,0,950,0,3,953,T
7-M,50,1,1,0,951,953,C
7-M,51,952,0,1,0,953,A
7-M,52,0,0,964,0,964,G
7-M,53,1,2,955,0,958,G
7-M,54,0,1,0,966,967,C
7-M,55,1,0,0,956,957,C
7-M,56,1,0,0,956,957,C
7-M,57,1,0,0,998,999,C
7-M,58,0,0,0,994,994,C
7-M,59,0,981,0,3,984,T
7-M,60,2,1,0,992,995,C
7-M,61,995,0,0,0,995,A
7-M,62,997,0,1,0,998,A
7-M,63,1012,0,0,0,1012,A
7-M,64,0,0,1028,0,1028,G
7-M,65,0,2,0,1033,1035,C
7-M,66,0,0,0,1024,1024,C
7-M,67,1,1,1019,0,1021,G
7-M,68,1018,0,2,0,1020,A
7-M,69,0,0,1024,0,1024,G
7-M,70,1025,0,0,0,1025,A
7-M,71,1,1028,0,1,1030,T
7-M,72,0,1,0,1013,1014,C
7-M,73,2,0,1021,0,1023,G
7-M,74,0,3,0,1025,1028,C
7-M,75,1,0,1028,0,1029,G
7-M,76,1,1,0,1030,1032,C
7-M,77,1033,0,2,0,1035,A
7-M,78,0,1,1037,0,1038,G
7-M,79,1026,0,0,0,1026,A
7-M,80,0,0,1128,0,1128,G
7-M,81,1125,0,2,0,1127,A
7-M,82,0,0,0,1140,1140,C
7-M,83,0,1139,0,1,1140,T
7-M,84,0,1134,0,1,1135,T
7-M,85,0,0,1146,0,1146,G
7-M,86,1148,0,0,0,1148,A
7-M,87,1143,0,4,0,1147,A
7-M,88,0,1,1150,0,1151,G
7-M,89,1102,0,0,0,1102,A
7-M,90,0,1114,0,1,1115,T
7-M,91,1,0,1112,0,1113,G
7-M,92,0,1113,0,3,1116,T
7-M,93,0,0,0,1117,1117,C
7-M,94,0,1109,0,2,1111,T
7-M,95,0,1116,0,0,1116,T
7-M,96,0,1110,0,1,1111,T
7-M,97,0,1,1112,0,1113,G
7-M,98,0,0,0,1110,1110,C
7-M,99,0,1099,0,1,1100,T
7-M,100,0,2,1108,0,1110,G
7-M,101,1,0,1107,0,1108,G
7-M,102,2,1,1135,0,1138,G
7-M,103,1129,0,2,0,1131,A
7-M,104,1134,0,1,0,1135,A
7-M,105,1131,0,3,0,1134,A
7-M,106,1137,0,1,0,1138,A
7-M,107,1151,0,0,0,1151,A
7-M,108,0,0,0,1157,1157,C
7-M,109,1155,0,2,0,1157,A
7-M,110,0,0,0,1160,1160,C
7-M,111,1146,0,0,0,1146,A
7-M,112,0,1,1173,0,1174,G
7-M,113,1186,1,0,0,1187,A
7-M,114,0,1220,0,1,1221,T
7-M,115,1,0,0,1240,1241,C
7-M,116,0,1229,0,0,1229,T
7-M,117,0,1230,0,0,1230,T
7-M,118,1,0,1229,0,1230,G
7-M,119,1225,0,1,0,1226,A
7-M,120,1,1,1235,0,1237,G
7-M,121,1,0,1225,0,1226,G
7-M,122,2,0,0,1220,1222,C
7-M,123,0,1209,0,1,1210,T
7-M,124,2,0,0,1372,1374,C
7-M,125,0,1364,0,1,1365,T
7-M,126,1,0,0,1383,1384,C
7-M,127,1380,0,4,0,1384,A
7-M,128,0,1386,0,2,1388,T
7-M,129,0,2,1385,1,1388,G
7-M,130,0,1,1384,0,1385,G
7-M,131,1370,0,1,0,1371,A
7-M,132,1375,0,4,0,1379,A
7-M,133,1,1305,0,0,1306,T
7-M,134,0,1,1366,0,1367,G
7-M,135,0,0,1450,0,1450,G
7-M,136,0,0,0,1457,1457,C
7-M,137,0,1451,0,1,1452,T
7-M,138,1456,0,1,0,1457,A
7-M,139,1454,0,0,0,1454,A
7-M,140,1467,0,1,0,1468,A
7-M,141,1,1,1501,0,1503,G
7-M,142,1492,1,2,0,1495,A
7-M,143,0,0,0,1485,1485,C
7-M,144,1415,0,1,0,1416,A
7-M,145,1412,0,2,0,1414,A
7-M,146,0,2,1467,0,1469,G
7-M,147,1469,0,3,0,1472,A
7-M,148,0,1,0,1472,1473,C
7-M,149,1,0,0,1468,1469,C
7-M,150,1461,0,2,0,1463,A
7-M,151,1476,0,2,1,1479,A
7-M,152,0,1489,0,1,1490,T
7-M,153,0,1492,0,1,1493,T
7-M,154,1,1,0,1507,1509,C
7-M,155,0,1472,0,2,1474,T
7-M,156,0,0,1485,0,1485,G
7-M,157,0,1472,1,3,1476,T
7-M,158,1,0,0,1476,1477,C
7-M,159,1482,0,2,0,1484,A
7-M,160,2,0,0,1519,1521,C
7-M,161,3,0,0,1519,1522,C
7-M,162,0,1506,0,3,1509,T
7-M,163,0,0,0,1522,1522,C
7-M,164,1,1512,0,2,1515,T
7-M,165,0,2,1566,0,1568,G
7-M,166,1570,0,2,0,1572,A
7-M,167,0,0,0,1584,1584,C
7-M,168,0,1578,0,0,1578,T
7-M,169,1551,0,2,0,1553,A
7-M,170,1547,0,1,0,1548,A
7-M,171,0,1,1556,0,1557,G
7-M,172,0,1,1552,0,1553,G
7-M,173,0,1,1550,0,1551,G
7-M,174,1,2,1547,1,1551,G
7-M,175,1583,0,1,0,1584,A
7-M,176,0,1583,1,0,1584,T
7-M,177,0,1581,0,1,1582,T
7-M,178,0,1592,0,0,1592,T
7-M,179,0,1589,0,0,1589,T
7-M,180,1,3,1584,0,1588,G
7-M,181,1,3,1581,0,1585,G
7-M,182,0,0,1592,0,1592,G
7-M,183,1,0,1599,0,1600,G
7-M,184,0,1571,1,3,1575,T
7-M,185,0,1572,0,1,1573,T
7-M,186,0,1574,0,0,1574,T
7-M,187,0,0,1611,0,1611,G
7-M,188,1,1610,0,1,1612,T
7-M,189,0,0,1626,0,1626,G
7-M,190,1,1621,0,2,1624,T
7-M,191,0,1615,0,4,1619,T
7-M,192,0,0,0,1625,1625,C
7-M,193,1625,0,2,0,1627,A
7-M,194,0,0,0,1669,1669,C
7-M,195,0,0,1667,0,1667,G
7-M,196,0,0,0,1663,1663,C
7-M,197,0,1634,0,3,1637,T
7-M,198,3,0,0,1699,1702,C
7-M,199,1702,0,5,0,1707,A
7-M,200,1,0,0,1721,1722,C
7-M,201,1,0,0,1718,1719,C
7-M,202,1,0,1722,0,1723,G
7-M,203,0,1710,0,3,1713,T
7-M,204,1,0,1723,0,1724,G
7-M,205,0,4,0,1726,1730,C
7-M,206,0,0,0,1729,1729,C
7-M,207,0,0,0,1736,1736,C
7-M,208,1700,0,3,0,1703,A
7-M,209,0,0,1727,1,1728,G
7-M,210,0,1725,0,0,1725,T
7-M,211,1,3,1724,0,1728,G
7-M,212,1741,1,3,0,1745,A
7-M,213,0,0,1743,0,1743,G
7-M,214,0,2,0,1735,1737,C
7-M,215,0,1,1741,0,1742,G
7-M,216,1728,1,1,0,1730,A
7-M,217,0,1,1758,0,1759,G
7-M,218,1,0,1758,0,1759,G
7-M,219,1746,0,2,0,1748,A
7-M,220,0,0,0,1785,1785,C
7-M,221,0,1761,0,3,1764,T
7-M,222,0,0,1770,0,1770,G
7-M,223,0,0,0,1767,1767,C
7-M,224,1775,0,1,0,1776,A
7-M,225,0,0,1816,0,1816,G
7-M,226,0,0,0,1796,1796,C
7-M,227,1,0,1811,0,1812,G
7-M,228,0,1805,0,0,1805,T
7-M,229,1774,0,4,1,1779,A
7-M,230,0,4,1772,0,1776,G
7-M,231,1774,1,1,0,1776,A
7-M,232,0,1,1,1780,1782,C
7-M,233,2,1,1786,0,1789,G
7-M,234,0,0,0,1779,1779,C
7-M,235,1,1736,0,2,1739,T
7-M,236,0,1734,0,0,1734,T
7-M,237,0,1716,0,2,1718,T
7-M,238,0,1,1773,0,1774,G
7-M,239,0,1770,0,2,1772,T
7-M,240,1,1,0,1767,1769,C
7-M,241,1,0,0,1771,1772,C
7-M,242,1772,0,0,0,1772,A
7-M,243,1771,0,0,0,1771,A
7-M,244,1767,1,0,1,1769,A
7-M,245,1775,0,1,0,1776,A
7-M,246,0,1775,0,0,1775,T
7-M,247,1,0,1759,0,1760,G
7-M,248,1,1,0,1751,1753,C
7-M,249,2,1,0,1746,1749,C
7-M,250,2,0,0,1775,1777,C
7-M,251,2,1764,0,3,1769,T
7-M,252,1,0,0,1862,1863,C
7-M,253,1864,0,3,0,1867,A
7-M,254,1885,0,1,0,1886,A
7-M,255,0,1894,1,1,1896,T
7-M,256,0,1,1911,0,1912,G
7-M,257,2,3,1912,0,1917,G
7-M,258,1,0,1931,0,1932,G
7-M,259,1903,0,2,0,1905,A
7-M,260,1913,0,1,0,1914,A
7-M,261,0,1860,0,1,1861,T
7-M,262,0,3,1856,0,1859,G
7-M,263,0,3,1848,0,1851,G
7-M,264,1818,1,2,0,1821,A
7-M,265,0,1,1826,0,1827,G
7-M,266,1808,0,0,0,1808,A
7-M,267,0,0,0,1790,1790,C
7-M,268,0,0,0,1877,1877,C
7-M,269,3,2,0,1890,1895,C
7-M,270,1915,0,1,0,1916,A
7-M,271,1918,1,1,1,1921,A
7-M,272,1922,0,1,0,1923,A
7-M,273,1,1923,0,1,1925,T
7-M,274,1980,0,1,0,1981,A
7-M,275,1981,0,1,0,1982,A
7-M,276,0,1,0,1930,1931,C
7-M,277,1906,1,0,0,1907,A
7-M,278,0,1901,0,1,1902,T
7-M,279,2,2,1929,0,1933,G
7-M,280,0,2,1935,0,1937,G
7-M,281,1940,0,0,0,1940,A
7-M,282,0,0,0,1939,1939,C
7-M,283,1883,0,0,0,1883,A
7-M,284,1894,0,0,0,1894,A
7-M,285,1886,0,2,0,1888,A
7-M,286,1,0,1915,0,1916,G
7-M,287,0,0,0,1955,1955,C
7-M,288,1923,0,0,0,1923,A
7-M,289,1,0,1965,0,1966,G
7-M,290,0,1963,0,0,1963,T
7-M,291,0,1961,1,0,1962,T
7-M,292,1981,0,1,0,1982,A
7-M,293,1961,0,3,1,1965,A
7-M,294,1978,1,3,0,1982,A
7-M,295,0,0,0,2019,2019,C
7-M,296,0,1944,0,0,1944,T
7-M,297,0,0,2221,0,2221,G
7-M,298,0,2192,0,1,2193,T
7-M,299,2215,0,3,0,2218,A
7-M,300,0,2212,0,1,2213,T
7-M,301,2189,0,2,0,2191,A
7-M,302,1,2,2194,1,2198,G
7-M,303,0,2,2186,0,2188,G
7-M,304,2168,0,3,1,2172,A
7-M,305,2176,0,1,0,2177,A
7-M,306,2037,1,1,0,2039,A
7-M,307,0,2,0,2108,2110,C
7-M,308,0,2093,0,0,2093,T
7-M,309,0,2100,0,2,2102,T
7-M,310,2095,0,0,0,2095,A
7-M,311,2085,0,6,0,2091,A
7-M,312,0,0,2104,0,2104,G
7-M,313,2067,0,2,0,2069,A
7-M,314,0,2,2085,0,2087,G
7-M,315,0,4,2087,0,2091,G
7-M,316,1,1,2091,0,2093,G
7-M,317,2061,0,7,0,2068,A
7-M,318,0,2,2107,0,2109,G
7-M,319,2115,0,2,0,2117,A
7-M,320,0,2119,0,0,2119,T
7-M,321,2114,0,2,0,2116,A
7-M,322,2126,0,1,0,2127,A
7-M,323,0,0,0,2142,2142,C
7-M,324,1,0,2116,0,2117,G
7-M,325,0,2117,0,5,2122,T
7-M,326,0,2106,0,0,2106,T
7-M,327,4,0,0,2123,2127,C
7-M,328,5,2,0,2109,2116,C
7-M,329,2121,0,3,0,2124,A
7-M,330,0,2122,1,0,2123,T
7-M,331,0,2,2109,0,2111,G
7-M,332,0,2,2102,0,2104,G
7-M,333,1,4,2113,0,2118,G
7-M,334,0,3,2126,0,2129,G
7-M,335,0,2,0,2121,2123,C
7-M,336,2,0,0,2102,2104,C
7-M,337,2109,0,1,0,2110,A
7-M,338,2132,0,1,0,2133,A
7-M,339,2125,1,0,1,2127,A
7-M,340,0,3,2147,0,2150,G
7-M,341,2155,0,2,0,2157,A
7-M,342,2141,3,1,0,2145,A
7-M,343,2149,0,1,0,2150,A
7-M,344,0,2148,0,0,2148,T
7-M,345,2137,0,2,0,2139,A
7-M,346,2,0,2150,1,2153,G
7-M,347,0,0,0,2150,2150,C
7-M,348,0,2124,0,2,2126,T
7-M,349,0,0,0,2131,2131,C
7-M,350,0,2114,0,1,2115,T
7-M,351,2,0,0,2206,2208,C
7-M,352,2211,0,0,0,2211,A
7-M,353,0,1,2212,0,2213,G
7-M,354,0,2180,0,2,2182,T
7-M,355,0,2221,0,0,2221,T
7-M,356,2229,0,0,0,2229,A
7-M,357,1,2236,0,0,2237,T
7-M,358,0,2220,1,0,2221,T
7-M,359,1,2,0,2233,2236,C
7-M,360,0,2152,0,2,2154,T
7-M,361,0,0,2173,0,2173,G
7-M,362,0,2,0,2161,2163,C
7-M,363,0,2138,0,3,2141,T
7-M,364,0,3,2144,0,2147,G
7-M,365,1,0,2139,0,2140,G
7-M,366,0,2138,0,5,2143,T
7-M,367,2,0,2139,0,2141,G
7-M,368,1,2,0,2130,2133,C
7-M,369,2135,0,4,0,2139,A
7-M,370,0,0,0,2136,2136,C
7-M,371,0,2117,0,0,2117,T
7-M,372,0,2153,0,3,2156,T
7-M,373,1,0,2150,0,2151,G
7-M,374,1,0,0,2136,2137,C
7-M,375,1,0,0,2147,2148,C
7-M,376,2132,1,2,0,2135,A
7-M,377,1,0,2141,0,2142,G
7-M,378,0,2140,0,2,2142,T
7-M,379,0,2128,0,0,2128,T
7-M,380,1,1,2142,0,2144,G
7-M,381,0,1,1,2118,2120,C
7-M,382,2117,0,6,0,2123,A
7-M,383,0,2121,0,1,2122,T
7-M,384,0,6,2102,1,2109,G
7-M,385,2,1,2138,0,2141,G
7-M,386,0,0,2157,0,2157,G
7-M,387,0,0,0,2174,2174,C
7-M,388,2,0,0,2213,2215,C
7-M,389,1,2199,0,4,2204,T
7-M,390,0,1,0,2247,2248,C
7-M,391,2377,1,1,0,2379,A
7-M,392,1,2387,0,0,2388,T
7-M,393,2466,0,2,0,2468,A
7-M,394,0,2421,0,0,2421,T
7-M,395,2385,0,2,0,2387,A
7-M,396,0,0,0,2555,2555,C
7-M,397,2423,0,0,0,2423,A
7-M,398,2450,0,2,0,2452,A
7-M,399,0,2425,0,0,2425,T
7-M,400,2294,0,2,0,2296,A
7-M,401,0,2,2329,0,2331,G
7-M,402,2,2,2291,0,2295,G
7-M,403,2278,0,2,0,2280,A
7-M,404,2,2276,0,0,2278,T
7-M,405,0,0,2115,0,2115,G
7-M,406,0,3,2115,0,2118,G
7-M,407,0,3,2112,0,2115,G
7-M,408,0,3,2131,0,2134,G
7-M,409,1,1,2132,0,2134,G
7-M,410,1,0,3,2119,2123,C
7-M,411,0,2093,0,1,2094,T
7-M,412,0,0,2100,0,2100,G
7-M,413,0,2106,0,0,2106,T
7-M,414,2115,0,1,1,2117,A
7-M,415,2110,0,0,0,2110,A
7-M,416,0,0,1,2126,2127,C
7-M,417,2,0,0,2098,2100,C
7-M,418,2082,1,0,0,2083,A
7-M,419,1,0,0,2085,2086,C
7-M,420,0,2077,0,1,2078,T
7-M,421,0,0,2095,0,2095,G
7-M,422,2075,0,0,0,2075,A
7-M,423,2072,0,1,0,2073,A
7-M,424,0,0,2081,0,2081,G
7-M,425,0,2052,1,3,2056,T
7-M,426,0,0,2056,0,2056,G
7-M,427,0,0,2069,0,2069,G
7-M,428,0,2,0,2072,2074,C
7-M,429,2074,1,1,0,2076,A
7-M,430,1,2054,1,3,2059,T
7-M,431,0,2063,0,0,2063,T
7-M,432,0,2058,0,0,2058,T
7-M,433,4,1,2115,0,2120,G
7-M,434,3,0,2114,0,2117,G
7-M,435,1,3,1,2101,2106,C
7-M,436,1,0,1,2111,2113,C
7-M,437,1,2090,0,3,2094,T
7-M,438,1,1,2190,2,2194,G
7-M,439,0,2,2208,0,2210,G
7-M,440,0,2217,0,0,2217,T
7-M,441,2221,0,3,0,2224,A
7-M,442,0,2123,0,1,2124,T
7-M,443,2,0,2156,0,2158,G
7-M,444,0,2165,0,0,2165,T
7-M,445,0,2,2159,0,2161,G
7-M,446,0,2,0,2161,2163,C
7-M,447,2068,0,2,0,2070,A
7-M,448,2064,0,3,0,2067,A
7-M,449,0,0,0,2093,2093,C
7-M,450,2089,0,2,0,2091,A
7-M,451,0,2097,0,0,2097,T
7-M,452,1,0,2061,0,2062,G
7-M,453,0,2003,0,1,2004,T
7-M,454,2,2,1996,0,2000,G
7-M,455,1982,0,1,0,1983,A
7-M,456,0,0,2000,0,2000,G
7-M,457,0,0,0,1998,1998,C
7-M,458,1940,0,2,0,1942,A
7-M,459,0,0,1948,0,1948,G
7-M,460,1933,0,7,0,1940,A
7-M,461,0,1930,0,2,1932,T
7-M,462,1,1933,0,0,1934,T
7-M,463,1,1,1936,0,1938,G
7-M,464,1,1,0,1939,1941,C
7-M,465,0,1926,0,3,1929,T
7-M,466,0,2,1928,0,1930,G
7-M,467,1926,0,2,0,1928,A
7-M,468,0,0,0,2061,2061,C
7-M,469,0,2050,1,1,2052,T
7-M,470,3,0,0,2050,2053,C
7-M,471,0,0,0,2055,2055,C
7-M,472,4,0,0,2054,2058,C
7-M,473,2046,0,2,0,2048,A
7-M,474,1,0,2066,0,2067,G
7-M,475,0,1,0,2050,2051,C
7-M,476,2069,0,1,0,2070,A
7-M,477,0,1,1,2063,2065,C
7-M,478,1901,0,0,0,1901,A
7-M,479,0,1,1932,0,1933,G
7-M,480,0,0,1942,0,1942,G
7-M,481,0,1927,0,3,1930,T
7-M,482,4,0,0,1986,1990,C
7-M,483,0,1942,0,2,1944,T
7-M,484,1,1,0,1956,1958,C
7-M,485,1945,0,4,0,1949,A
7-M,486,0,1948,0,0,1948,T
7-M,487,1954,0,0,0,1954,A
7-M,488,1,0,1904,0,1905,G
7-M,489,1,0,1879,0,1880,G
7-M,490,1,0,0,1883,1884,C
7-M,491,1784,0,1,0,1785,A
7-M,492,0,1,1761,0,1762,G
7-M,493,1775,0,1,0,1776,A
7-M,494,0,1781,0,0,1781,T
7-M,495,4,0,1784,0,1788,G
7-M,496,1,2,1773,0,1776,G
7-M,497,0,1750,0,2,1752,T
7-M,498,1,0,1761,0,1762,G
7-M,499,0,0,1768,0,1768,G
7-M,500,1,1,0,1776,1778,C
7-M,501,1757,0,0,0,1757,A
7-M,502,1758,0,0,0,1758,A
7-M,503,0,0,0,1777,1777,C
7-M,504,1783,0,3,0,1786,A
7-M,505,1789,0,2,0,1791,A
7-M,506,1,0,0,1788,1789,C
7-M,507,0,1,0,1770,1771,C
7-M,508,1751,1,2,0,1754,A
7-M,509,1755,0,0,0,1755,A
7-M,510,0,1749,0,2,1751,T
7-M,511,0,0,0,1767,1767,C
7-M,512,2,1,0,1735,1738,C
7-M,513,1719,0,0,0,1719,A
7-M,514,0,1715,0,1,1716,T
7-M,515,0,1716,0,1,1717,T
7-M,516,1722,0,0,0,1722,A
7-M,517,1728,0,0,0,1728,A
7-M,518,0,1728,0,0,1728,T
7-M,519,1712,0,1,0,1713,A
7-M,520,1708,0,1,0,1709,A
7-M,521,1668,1,0,0,1669,A
7-M,522,1687,0,4,0,1691,A
7-M,523,0,1,0,1735,1736,C
7-M,524,1737,0,1,0,1738,A
7-M,525,1,1729,0,2,1732,T
7-M,526,0,2,1740,0,1742,G
7-M,527,1723,0,2,0,1725,A
7-M,528,2,3,1750,0,1755,G
7-M,529,1734,0,4,0,1738,A
7-M,530,1741,0,2,0,1743,A
7-M,531,0,0,0,1753,1753,C
7-M,532,1688,0,1,0,1689,A
7-M,533,2,1,1716,0,1719,G
7-M,534,1687,0,2,0,1689,A
7-M,535,1690,1,2,0,1693,A
7-M,536,0,1683,0,0,1683,T
7-M,537,1,2,1688,0,1691,G
7-M,538,1,0,1683,0,1684,G
7-M,539,1,1673,0,1,1675,T
7-M,540,0,1607,0,2,1609,T
7-M,541,0,1646,0,0,1646,T
7-M,542,0,1650,0,0,1650,T
7-M,543,1,0,1675,0,1676,G
7-M,544,1,0,1677,0,1678,G
7-M,545,1,0,0,1648,1649,C
7-M,546,0,1,0,1662,1663,C
7-M,547,1597,0,3,0,1600,A
7-M,548,0,1,1661,0,1662,G
7-M,549,2,0,0,1656,1658,C
7-M,550,1675,0,0,0,1675,A
7-M,551,0,0,0,1717,1717,C
7-M,552,0,1698,1,0,1699,T
7-M,553,1704,1,0,0,1705,A
7-M,554,0,0,1,1714,1715,C
7-M,555,1744,0,1,0,1745,A
7-M,556,0,0,1773,0,1773,G
7-M,557,1,0,0,1702,1703,C
7-M,558,0,1675,0,1,1676,T
7-M,559,1683,0,0,0,1683,A
7-M,560,1643,0,0,0,1643,A
7-M,561,0,1,1668,0,1669,G
7-M,562,0,0,1681,0,1681,G
7-M,563,1,0,0,1683,1684,C
7-M,564,0,1576,0,0,1576,T
7-M,565,1578,0,0,0,1578,A
7-M,566,0,1568,0,1,1569,T
7-M,567,0,0,1572,0,1572,G
7-M,568,2,1,1580,0,1583,G
7-M,569,1525,0,5,0,1530,A
7-M,570,2,0,1537,0,1539,G
7-M,571,0,1,0,1506,1507,C
7-M,572,1500,0,1,0,1501,A
7-M,573,1493,0,0,1,1494,A
7-M,574,1491,0,2,0,1493,A
7-M,575,1,1509,0,1,1511,T
7-M,576,0,1,1499,0,1500,G
7-M,577,0,0,1489,0,1489,G
7-M,578,0,0,0,1479,1479,C
7-M,579,0,1466,0,2,1468,T
7-M,580,1,1,1483,0,1485,G
7-M,581,0,2,1499,0,1501,G
7-M,582,1509,0,0,0,1509,A
7-M,583,1,1501,0,1,1503,T
7-M,584,0,0,0,1496,1496,C
7-M,585,1492,1,2,0,1495,A
7-M,586,1518,0,0,1,1519,A
7-M,587,0,1,1521,0,1522,G
7-M,588,0,1514,1,1,1516,T
7-M,589,0,3,1510,0,1513,G
7-M,590,1458,0,4,0,1462,A
7-M,591,0,1,1482,0,1483,G
7-M,592,0,0,0,1473,1473,C
7-M,593,1476,0,0,0,1476,A
7-M,594,0,1,1484,1,1486,G
7-M,595,0,0,1473,0,1473,G
7-M,596,0,1,0,1471,1472,C
7-M,597,1467,0,0,0,1467,A
7-M,598,1,0,1491,0,1492,G
7-M,599,1,0,0,1486,1487,C
7-M,600,0,0,1491,0,1491,G
7-M,601,0,0,1486,0,1486,G
7-M,602,1479,0,2,0,1481,A
7-M,603,1,0,1497,0,1498,G
7-M,604,0,0,1533,0,1533,G
7-M,605,1,0,0,1531,1532,C
7-M,606,0,1,0,1536,1537,C
7-M,607,1525,0,0,0,1525,A
7-M,608,0,1517,0,1,1518,T
7-M,609,0,1,1535,0,1536,G
7-M,610,0,0,1535,0,1535,G
7-M,611,1518,2,2,0,1522,A
7-M,612,0,0,1540,0,1540,G
7-M,613,1487,0,0,0,1487,A
7-M,614,0,1527,0,1,1528,T
7-M,615,0,1517,0,1,1518,T
7-M,616,0,1,1528,0,1529,G
7-M,617,0,1,0,1525,1526,C
7-M,618,0,1525,0,0,1525,T
7-M,619,1536,0,0,0,1536,A
7-M,620,0,0,1535,0,1535,G
7-M,621,0,1524,0,1,1525,T
7-M,622,1,0,0,1521,1522,C
7-M,623,1468,0,2,0,1470,A
7-M,624,0,1,1492,0,1493,G
7-M,625,0,0,1490,0,1490,G
7-M,626,0,0,0,1493,1493,C
7-M,627,0,0,0,1495,1495,C
7-M,628,1492,0,2,0,1494,A
7-M,629,0,0,1514,0,1514,G
7-M,630,0,0,1515,0,1515,G
7-M,631,0,0,0,1512,1512,C
7-M,632,1519,0,2,0,1521,A
7-M,633,1,0,1514,0,1515,G
7-M,634,1507,0,4,0,1511,A
7-M,635,0,1509,0,0,1509,T
7-M,636,0,1,1522,0,1523,G
7-M,637,1,0,1558,0,1559,G
7-M,638,0,1531,0,1,1532,T
7-M,639,0,1,1529,0,1530,G
7-M,640,0,0,0,1528,1528,C
7-M,641,1521,0,0,0,1521,A
7-M,642,1,0,1551,0,1552,G
7-M,643,0,0,1547,0,1547,G
7-M,644,2,0,0,1544,1546,C
7-M,645,1545,2,1,0,1548,A
7-M,646,1512,0,3,0,1515,A
7-M,647,0,1500,0,0,1500,T
7-M,648,1,2,1502,0,1505,G
7-M,649,1493,0,4,0,1497,A
7-M,650,0,1,1507,1,1509,G
7-M,651,1451,2,5,0,1458,A
7-M,652,0,0,1478,0,1478,G
7-M,653,0,1,0,1496,1497,C
7-M,654,0,3,0,1507,1510,C
7-M,655,1521,0,1,0,1522,A
7-M,656,0,1521,0,1,1522,T
7-M,657,0,1517,0,0,1517,T
7-M,658,1,1,1513,0,1515,G
7-M,659,0,1,1510,0,1511,G
7-M,660,0,2,1510,0,1512,G
7-M,661,1519,0,1,0,1520,A
7-M,662,0,0,0,1507,1507,C
7-M,663,0,1448,0,0,1448,T
7-M,664,2,1,1,1455,1459,C
7-M,665,1472,0,0,0,1472,A
7-M,666,0,1529,0,0,1529,T
7-M,667,1,0,0,1528,1529,C
7-M,668,1,1,0,1527,1529,C
7-M,669,0,1516,0,1,1517,T
7-M,670,1519,0,0,0,1519,A
7-M,671,1,0,1537,0,1538,G
7-M,672,0,1688,0,2,1690,T
7-M,673,1,1668,0,0,1669,T
7-M,674,2,0,0,1661,1663,C
7-M,675,0,1,0,1627,1628,C
7-M,676,1626,0,0,0,1626,A
7-M,677,0,1,1667,0,1668,G
7-M,678,0,1665,0,1,1666,T
7-M,679,1659,0,0,0,1659,A
7-M,680,0,0,0,1656,1656,C
7-M,681,1,1380,0,1,1382,T
7-M,682,1,0,1450,0,1451,G
7-M,683,0,0,1490,0,1490,G
7-M,684,0,1492,0,1,1493,T
7-M,685,1,1,0,1492,1494,C
7-M,686,0,1465,0,2,1467,T
7-M,687,1465,0,0,0,1465,A
7-M,688,1465,0,0,0,1465,A
7-M,689,0,2,1477,0,1479,G
7-M,690,1444,0,1,0,1445,A
7-M,691,0,1,1425,0,1426,G
7-M,692,1336,0,1,0,1337,A
7-M,693,1,1341,0,0,1342,T
7-M,694,0,2,1332,0,1334,G
7-M,695,1328,0,4,0,1332,A
7-M,696,0,1324,0,3,1327,T
7-M,697,1,0,0,1332,1333,C
7-M,698,0,1305,0,0,1305,T
7-M,699,0,1307,0,1,1308,T
7-M,700,0,1,0,1314,1315,C
7-M,701,0,1307,0,3,1310,T
7-M,702,1,1309,0,1,1311,T
7-M,703,0,1,1312,0,1313,G
7-M,704,1304,0,1,1,1306,A
7-M,705,1305,0,0,0,1305,A
7-M,706,1296,0,0,1,1297,A
7-M,707,1303,0,0,1,1304,A
7-M,708,0,1313,0,0,1313,T
7-M,709,0,1327,0,0,1327,T
7-M,710,0,1326,0,1,1327,T
7-M,711,0,0,1324,0,1324,G
7-M,712,1,0,0,1326,1327,C
7-M,713,1321,0,2,0,1323,A
7-M,714,0,1,1334,0,1335,G
7-M,715,1332,1,2,0,1335,A
7-M,716,1,0,0,1383,1384,C
7-M,717,0,0,0,1379,1379,C
7-M,718,0,1384,0,0,1384,T
7-M,719,1414,0,0,0,1414,A
7-M,720,0,1413,0,3,1416,T
7-M,721,1,0,0,1411,1412,C
7-M,722,1408,0,1,0,1409,A
7-M,723,0,0,1407,0,1407,G
7-M,724,1392,0,1,0,1393,A
7-M,725,1349,0,1,0,1350,A
7-M,726,1352,0,0,0,1352,A
7-M,727,1,0,1,1359,1361,C
7-M,728,1,3,1371,0,1375,G
7-M,729,1366,1,0,1,1368,A
7-M,730,1364,0,0,0,1364,A
7-M,731,0,1364,0,0,1364,T
7-M,732,0,0,1357,0,1357,G
7-M,733,0,5,1361,0,1366,G
7-M,734,2,1,1371,0,1374,G
7-M,735,1,0,1362,0,1363,G
7-M,736,0,0,1380,0,1380,G
7-M,737,0,1337,0,2,1339,T
7-M,738,1,0,1341,0,1342,G
7-M,739,0,0,0,1339,1339,C
7-M,740,1345,0,0,0,1345,A
7-M,741,1,1,1359,0,1361,G
7-M,742,1340,0,0,1,1341,A
7-M,743,0,1326,0,4,1330,T
7-M,744,0,0,1316,0,1316,G
7-M,745,0,0,1,1310,1311,C
7-M,746,1308,0,0,0,1308,A
7-M,747,1306,0,1,1,1308,A
7-M,748,0,0,0,1322,1322,C
7-M,749,1,3,1321,0,1325,G
7-M,750,1333,0,0,0,1333,A
7-M,751,0,1332,0,1,1333,T
7-M,752,0,1329,0,1,1330,T
7-M,753,0,0,0,1336,1336,C
7-M,754,1328,0,2,0,1330,A
7-M,755,1319,0,1,1,1321,A
7-M,756,0,0,1329,0,1329,G
7-M,757,0,1312,0,0,1312,T
7-M,758,1,2,1294,0,1297,G
7-M,759,1278,0,3,0,1281,A
7-M,760,0,1,0,1275,1276,C
7-M,761,0,0,0,1270,1270,C
7-M,762,2,1,0,1284,1287,C
7-M,763,1,0,1293,0,1294,G
7-M,764,0,7,0,1290,1297,C
7-M,765,0,1294,1,2,1297,T
7-M,766,0,1302,1,0,1303,T
7-M,767,0,0,1304,0,1304,G
7-M,768,0,1300,0,4,1304,T
7-M,769,0,1298,0,0,1298,T
7-M,770,1,0,1298,0,1299,G
7-M,771,0,1272,0,0,1272,T
7-M,772,0,1252,0,0,1252,T
7-M,773,2,0,1257,0,1259,G
7-M,774,0,0,0,1250,1250,C
7-M,775,0,0,0,1251,1251,C
7-M,776,1,0,1256,0,1257,G
7-M,777,0,0,0,1242,1242,C
7-M,778,0,4,1250,0,1254,G
7-M,779,1257,1,0,0,1258,A
7-M,780,1260,0,0,0,1260,A
7-M,781,0,1275,0,2,1277,T
7-M,782,1275,0,0,2,1277,A
7-M,783,2,1295,1,1,1299,T
7-M,784,1,0,0,1331,1332,C
7-M,785,1331,1,0,0,1332,A
7-M,786,0,1330,0,0,1330,T
7-M,787,1,1320,0,0,1321,T
7-M,788,0,1,1319,0,1320,G
7-M,789,3,2,1305,0,1310,G
7-M,790,2,0,1312,0,1314,G
7-M,791,1305,0,1,0,1306,A
7-M,792,0,1298,0,5,1303,T
7-M,793,0,0,0,1264,1264,C
7-M,794,1,1269,0,1,1271,T
7-M,795,0,1262,0,0,1262,T
7-M,796,1,0,1280,0,1281,G
7-M,797,0,0,0,1281,1281,C
7-M,798,1291,0,0,0,1291,A
7-M,799,1,0,0,1288,1289,C
7-M,800,1,1267,0,0,1268,T
7-M,801,0,1269,0,0,1269,T
7-M,802,0,1,1276,0,1277,G
7-M,803,1289,0,3,0,1292,A
7-M,804,0,1309,0,0,1309,T
7-M,805,1267,0,0,0,1267,A
7-M,806,0,1261,1,2,1264,T
7-M,807,0,1246,0,0,1246,T
7-M,808,1,0,1259,0,1260,G
7-M,809,1,1240,1,1,1243,T
7-M,810,0,1,1240,0,1241,G
7-M,811,0,1,1239,0,1240,G
7-M,812,1215,0,2,0,1217,A
7-M,813,0,1225,0,0,1225,T
7-M,814,1,1220,0,2,1223,T
7-M,815,1,1,0,1218,1220,C
7-M,816,0,1221,0,2,1223,T
7-M,817,0,1205,0,2,1207,T
7-M,818,1,1,1203,0,1205,G
7-M,819,1187,0,1,0,1188,A
7-M,820,1,1191,0,1,1193,T
7-M,821,1,0,0,1189,1190,C
7-M,822,1,0,1191,0,1192,G
7-M,823,0,1194,0,1,1195,T
7-M,824,1,0,0,1191,1192,C
7-M,825,0,1190,0,0,1190,T
7-M,826,0,1197,0,0,1197,T
7-M,827,0,1197,0,1,1198,T
7-M,828,0,1198,0,0,1198,T
7-M,829,0,1202,0,2,1204,T
7-M,830,0,1200,0,2,1202,T
7-M,831,0,1197,0,2,1199,T
7-M,832,1,0,0,1201,1202,C
7-M,833,1194,0,0,0,1194,A
7-M,834,1202,0,0,0,1202,A
7-M,835,1201,0,1,0,1202,A
7-M,836,0,1202,0,1,1203,T
7-M,837,1,0,1200,0,1201,G
7-M,838,1,0,0,1201,1202,C
7-M,839,2,0,1206,0,1208,G
7-M,840,0,1251,0,0,1251,T
7-M,841,1,0,0,1249,1250,C
7-M,842,0,1248,0,1,1249,T
7-M,843,1256,1,0,0,1257,A
7-M,844,0,1252,0,1,1253,T
7-M,845,0,0,0,1248,1248,C
7-M,846,0,3,1240,0,1243,G
7-M,847,1231,0,0,0,1231,A
7-M,848,0,0,0,1238,1238,C
7-M,849,0,1202,0,0,1202,T
7-M,850,0,0,0,1246,1246,C
7-M,851,1,1243,0,2,1246,T
7-M,852,0,1244,0,2,1246,T
7-M,853,1,1,0,1250,1252,C
7-M,854,1246,0,0,0,1246,A
7-M,855,1249,0,1,0,1250,A
7-M,856,1244,0,1,1,1246,A
7-M,857,0,0,0,1245,1245,C
7-M,858,1239,0,1,0,1240,A
7-M,859,1,0,0,1174,1175,C
7-M,860,0,1,1144,0,1145,G
7-M,861,1,0,1206,0,1207,G
7-M,862,0,1,0,1220,1221,C
7-M,863,2,1,0,1228,1231,C
7-M,864,0,1228,0,2,1230,T
7-M,865,0,1236,0,1,1237,T
7-M,866,1238,1,0,0,1239,A
7-M,867,1251,0,0,0,1251,A
7-M,868,1242,0,1,0,1243,A
7-M,869,1235,0,2,0,1237,A
7-M,870,0,0,1215,0,1215,G
7-M,871,1032,0,2,0,1034,A
7-M,872,0,0,1029,0,1029,G
7-M,873,0,1,1027,0,1028,G
7-M,874,0,0,0,1035,1035,C
7-M,875,1,0,0,1022,1023,C
7-M,876,0,0,0,1030,1030,C
7-M,877,0,1032,0,2,1034,T
7-M,878,2,1039,0,0,1041,T
7-M,879,0,0,0,1047,1047,C
7-M,880,1,1044,0,1,1046,T
7-M,881,1047,0,0,0,1047,A
7-M,882,0,0,0,1044,1044,C
7-M,883,0,1,1004,0,1005,G
7-M,884,0,0,1012,0,1012,G
7-M,885,987,0,0,0,987,A
7-M,886,985,0,0,0,985,A
7-M,887,2,2,970,0,974,G
7-M,888,1,3,977,0,981,G
7-M,889,964,0,1,0,965,A
7-M,890,0,0,982,0,982,G
7-M,891,0,975,0,1,976,T
7-M,892,996,0,0,0,996,A
7-M,893,0,0,0,981,981,C
7-M,894,0,0,0,980,980,C
7-M,895,0,959,0,1,960,T
7-M,896,0,0,967,0,967,G
7-M,897,924,0,0,0,924,A
7-M,898,0,0,959,0,959,G
7-M,899,0,918,0,0,918,T
7-M,900,2,0,0,920,922,C
7-M,901,0,902,0,0,902,T
7-M,902,896,0,1,1,898,A
7-M,903,1,898,0,1,900,T
7-M,904,1,0,904,0,905,G
7-M,905,878,0,4,0,882,A
7-M,906,0,2,888,0,890,G
7-M,907,0,0,808,0,808,G
7-M,908,0,0,808,0,808,G
7-M,909,799,0,0,0,799,A
7-M,910,789,0,1,0,790,A
7-M,911,1,0,792,0,793,G
7-M,912,788,0,0,0,788,A
7-M,913,795,0,0,0,795,A
7-M,914,0,786,0,0,786,T
7-M,915,784,0,0,0,784,A
7-M,916,0,781,0,0,781,T
7-M,917,0,5,2,766,773,C
7-M,918,0,0,774,0,774,G
7-M,919,772,0,0,0,772,A
7-M,920,764,0,0,0,764,A
7-M,921,765,0,0,0,765,A
7-M,922,0,0,755,0,755,G
7-M,923,0,1,768,0,769,G
7-M,924,762,0,0,0,762,A
7-M,925,763,0,0,0,763,A
7-M,926,0,0,0,763,763,C
7-M,927,750,0,0,0,750,A
7-M,928,0,0,757,0,757,G
7-M,929,0,0,0,758,758,C
7-M,930,756,0,1,0,757,A
7-M,931,0,1,753,0,754,G
7-M,932,697,0,2,0,699,A
7-M,933,706,0,0,0,706,A
7-M,934,0,704,0,0,704,T
7-M,935,0,0,690,0,690,G
7-M,936,0,0,0,686,686,C
7-M,937,0,637,0,3,640,T
7-M,938,0,0,646,0,646,G
7-M,939,0,638,0,0,638,T
7-M,940,0,2,635,0,637,G
7-M,941,0,0,636,0,636,G
7-M,942,629,0,1,0,630,A
7-M,943,0,627,0,0,627,T
7-M,944,1,0,606,0,607,G
7-M,945,0,0,0,593,593,C
7-M,946,0,579,0,0,579,T
7-M,947,0,0,577,0,577,G
7-M,948,576,0,1,0,577,A
7-M,949,0,1,0,566,567,C
7-M,950,1,1,562,0,564,G
7-M,951,558,0,0,0,558,A
7-M,952,0,1,0,560,561,C
7-M,953,546,0,1,0,547,A
7-M,954,0,0,546,0,546,G
7-M,955,0,544,0,2,546,T
7-M,956,1,0,0,544,545,C
7-M,957,541,0,2,0,543,A
7-M,958,0,531,0,1,532,T
7-M,959,0,531,0,1,532,T
7-M,960,1,526,0,1,528,T
7-M,961,0,528,0,0,528,T
7-M,962,0,0,527,0,527,G
7-M,963,0,498,0,0,498,T
7-M,964,0,0,0,496,496,C
7-M,965,464,0,1,0,465,A
7-M,966,1,0,466,0,467,G
7-M,967,0,0,0,465,465,C
7-M,968,465,0,0,0,465,A
7-M,969,0,464,0,0,464,T
7-M,970,436,0,0,0,436,A
7-M,971,0,0,434,0,434,G
7-M,972,426,0,0,0,426,A
7-M,973,0,0,425,0,425,G
7-M,974,0,420,1,0,421,T
7-M,975,0,284,0,0,284,T
7-M,976,0,0,278,0,278,G
7-M,977,0,0,278,0,278,G
7-M,978,272,0,0,0,272,A
7-M,979,0,0,272,0,272,G
7-M,980,0,194,0,0,194,T
7-M,981,185,0,0,0,185,A
7-M,982,183,0,0,0,183,A
8-NS,1,603,0,0,0,603,A
8-NS,2,0,608,0,0,608,T
8-NS,3,0,0,648,0,648,G
8-NS,4,0,1,687,1,689,G
8-NS,5,745,0,0,0,745,A
8-NS,6,0,1451,0,1,1452,T
8-NS,7,0,1456,0,0,1456,T
8-NS,8,0,0,0,1518,1518,C
8-NS,9,1,0,0,1516,1517,C
8-NS,10,1525,0,2,0,1527,A
8-NS,11,1535,0,1,0,1536,A
8-NS,12,1,0,0,1531,1532,C
8-NS,13,1539,1,2,0,1542,A
8-NS,14,0,0,0,1567,1567,C
8-NS,15,0,1563,0,2,1565,T
8-NS,16,3,0,1724,0,1727,G
8-NS,17,0,1726,0,3,1729,T
8-NS,18,1,0,1737,0,1738,G
8-NS,19,0,1737,0,7,1744,T
8-NS,20,2,0,0,1742,1744,C
8-NS,21,1746,0,1,0,1747,A
8-NS,22,1752,0,1,0,1753,A
8-NS,23,0,0,1788,0,1788,G
8-NS,24,2,1817,0,3,1822,T
8-NS,25,0,1826,0,3,1829,T
8-NS,26,0,1839,0,0,1839,T
8-NS,27,1,1,0,1838,1840,C
8-NS,28,1,1,1,1846,1849,C
8-NS,29,1848,1,0,0,1849,A
8-NS,30,0,1,1869,0,1870,G
8-NS,31,2,0,1876,0,1878,G
8-NS,32,1,1878,0,1,1880,T
8-NS,33,1872,1,3,0,1876,A
8-NS,34,0,1,1890,0,1891,G
8-NS,35,1886,0,2,0,1888,A
8-NS,36,0,1890,0,3,1893,T
8-NS,37,2,1886,0,0,1888,T
8-NS,38,1,0,1912,0,1913,G
8-NS,39,0,3,0,1907,1910,C
8-NS,40,0,1910,0,4,1914,T
8-NS,41,0,1924,0,2,1926,T
8-NS,42,0,1938,0,2,1940,T
8-NS,43,2,1,1,1974,1978,C
8-NS,44,0,1965,1,2,1968,T
8-NS,45,0,1966,0,0,1966,T
8-NS,46,0,1968,0,2,1970,T
8-NS,47,0,2,1965,0,1967,G
8-NS,48,1,0,1961,0,1962,G
8-NS,49,1,1,0,1975,1977,C
8-NS,50,1965,0,1,0,1966,A
8-NS,51,0,1975,0,0,1975,T
8-NS,52,1979,0,0,0,1979,A
8-NS,53,0,2007,0,2,2009,T
8-NS,54,0,1,0,2016,2017,C
8-NS,55,3,3,0,2015,2021,C
8-NS,56,3,5,2003,0,2011,G
8-NS,57,0,0,2023,1,2024,G
8-NS,58,2027,0,0,0,2027,A
8-NS,59,2027,0,2,0,2029,A
8-NS,60,2042,0,1,0,2043,A
8-NS,61,0,1,0,2061,2062,C
8-NS,62,2035,1,2,0,2038,A
8-NS,63,2031,0,2,1,2034,A
8-NS,64,0,1,2137,0,2138,G
8-NS,65,0,2143,0,1,2144,T
8-NS,66,0,2132,0,1,2133,T
8-NS,67,4,2,2128,0,2134,G
8-NS,68,1,2132,0,3,2136,T
8-NS,69,2131,0,2,0,2133,A
8-NS,70,0,3,2147,1,2151,G
8-NS,71,2268,0,4,0,2272,A
8-NS,72,0,1,0,2298,2299,C
8-NS,73,3,0,0,2247,2250,C
8-NS,74,2253,0,1,0,2254,A
8-NS,75,2263,1,0,0,2264,A
8-NS,76,1,6,2359,0,2366,G
8-NS,77,2358,1,2,0,2361,A
8-NS,78,2373,0,5,0,2378,A
8-NS,79,0,2,0,2375,2377,C
8-NS,80,0,2291,1,1,2293,T
8-NS,81,0,2,2319,0,2321,G
8-NS,82,2304,1,5,0,2310,A
8-NS,83,0,1,2379,0,2380,G
8-NS,84,0,2365,0,2,2367,T
8-NS,85,0,1,2328,1,2330,G
8-NS,86,2326,0,3,1,2330,A
8-NS,87,1,2324,0,1,2326,T
8-NS,88,0,1,2354,0,2355,G
8-NS,89,3,2,0,2382,2387,C
8-NS,90,1,0,0,2379,2380,C
8-NS,91,4,0,0,2389,2393,C
8-NS,92,4,1,0,2364,2369,C
8-NS,93,2384,0,0,0,2384,A
8-NS,94,1,2421,0,1,2423,T
8-NS,95,0,2451,0,4,2455,T
8-NS,96,2,0,0,2471,2473,C
8-NS,97,1,2,0,2441,2444,C
8-NS,98,0,2430,0,7,2437,T
8-NS,99,1,2415,0,3,2419,T
8-NS,100,1,1,2419,0,2421,G
8-NS,101,2406,0,0,2,2408,A
8-NS,102,1,2411,0,1,2413,T
8-NS,103,1,0,0,2398,2399,C
8-NS,104,1,1,2388,0,2390,G
8-NS,105,0,0,2405,0,2405,G
8-NS,106,0,1,0,2414,2415,C
8-NS,107,1,2408,0,3,2412,T
8-NS,108,0,2416,0,1,2417,T
8-NS,109,1,4,0,2415,2420,C
8-NS,110,1,0,2424,0,2425,G
8-NS,111,1,1,0,2426,2428,C
8-NS,112,0,0,0,2430,2430,C
8-NS,113,0,1,2434,0,2435,G
8-NS,114,2401,0,0,0,2401,A
8-NS,115,0,0,2506,0,2506,G
8-NS,116,2510,1,1,0,2512,A
8-NS,117,0,2519,0,0,2519,T
8-NS,118,3,1,0,2517,2521,C
8-NS,119,2511,0,2,0,2513,A
8-NS,120,1,0,2525,0,2526,G
8-NS,121,2521,1,0,0,2522,A
8-NS,122,2,0,2524,0,2526,G
8-NS,123,2,0,2559,0,2561,G
8-NS,124,0,2533,0,5,2538,T
8-NS,125,1,0,1,2683,2685,C
8-NS,126,2,1,0,2692,2695,C
8-NS,127,1,2,0,2706,2709,C
8-NS,128,0,2710,0,2,2712,T
8-NS,129,2715,0,1,0,2716,A
8-NS,130,2696,3,5,0,2704,A
8-NS,131,1,6,2740,1,2748,G
8-NS,132,2,10,2738,0,2750,G
8-NS,133,0,1,2721,0,2722,G
8-NS,134,4,3,2623,0,2630,G
8-NS,135,2607,0,1,0,2608,A
8-NS,136,2599,0,2,0,2601,A
8-NS,137,2,2,2612,0,2616,G
8-NS,138,2672,1,4,0,2677,A
8-NS,139,0,1,2709,1,2711,G
8-NS,140,1,0,2700,0,2701,G
8-NS,141,1,1,0,2684,2686,C
8-NS,142,2673,1,4,1,2679,A
8-NS,143,2697,0,1,0,2698,A
8-NS,144,0,2701,0,1,2702,T
8-NS,145,2727,0,0,0,2727,A
8-NS,146,0,0,0,2778,2778,C
8-NS,147,0,2647,0,1,2648,T
8-NS,148,1,1,0,2654,2656,C
8-NS,149,1,2608,1,2,2612,T
8-NS,150,1,2,0,2632,2635,C
8-NS,151,1,3,2673,0,2677,G
8-NS,152,0,1,2806,0,2807,G
8-NS,153,0,2803,0,0,2803,T
8-NS,154,3,0,0,2811,2814,C
8-NS,155,0,2790,0,0,2790,T
8-NS,156,2788,13,3,0,2804,A
8-NS,157,1,3,2805,0,2809,G
8-NS,158,2803,1,3,0,2807,A
8-NS,159,0,2,0,2887,2889,C
8-NS,160,2825,0,3,0,2828,A
8-NS,161,0,2767,0,1,2768,T
8-NS,162,1,1,0,2767,2769,C
8-NS,163,2770,0,0,0,2770,A
8-NS,164,2763,3,1,1,2768,A
8-NS,165,2748,0,2,0,2750,A
8-NS,166,2,0,2755,0,2757,G
8-NS,167,0,0,0,2761,2761,C
8-NS,168,2707,1,3,0,2711,A
8-NS,169,1,0,2730,0,2731,G
8-NS,170,0,1,0,2717,2718,C
8-NS,171,0,1,0,2731,2732,C
8-NS,172,2739,0,2,0,2741,A
8-NS,173,1,0,0,2779,2780,C
8-NS,174,2,0,0,2774,2776,C
8-NS,175,6,0,0,2787,2793,C
8-NS,176,2818,16,6,0,2840,A
8-NS,177,0,2839,0,2,2841,T
8-NS,178,1,0,2844,0,2845,G
8-NS,179,1,2823,0,7,2831,T
8-NS,180,1,2806,0,5,2812,T
8-NS,181,3,1,2789,0,2793,G
8-NS,182,1,1,2772,0,2774,G
8-NS,183,2763,0,4,1,2768,A
8-NS,184,2758,2,0,0,2760,A
8-NS,185,2677,0,8,0,2685,A
8-NS,186,1,0,2706,0,2707,G
8-NS,187,0,1,0,2704,2705,C
8-NS,188,2691,0,2,0,2693,A
8-NS,189,2692,0,3,1,2696,A
8-NS,190,2678,0,0,0,2678,A
8-NS,191,0,2711,0,1,2712,T
8-NS,192,0,2718,0,1,2719,T
8-NS,193,0,0,2786,0,2786,G
8-NS,194,0,2790,0,1,2791,T
8-NS,195,2762,1,3,0,2766,A
8-NS,196,0,1,2769,0,2770,G
8-NS,197,2763,0,1,0,2764,A
8-NS,198,2756,0,3,0,2759,A
8-NS,199,2757,0,1,0,2758,A
8-NS,200,2738,0,1,0,2739,A
8-NS,201,1,1,2757,0,2759,G
8-NS,202,2699,0,2,0,2701,A
8-NS,203,0,2703,0,2,2705,T
8-NS,204,0,2704,0,1,2705,T
8-NS,205,1,1,0,2716,2718,C
8-NS,206,0,2707,0,1,2708,T
8-NS,207,1,1,2722,0,2724,G
8-NS,208,2716,1,1,0,2718,A
8-NS,209,2712,1,1,0,2714,A
8-NS,210,2700,0,6,0,2706,A
8-NS,211,0,0,2728,0,2728,G
8-NS,212,2722,0,1,0,2723,A
8-NS,213,2712,0,12,0,2724,A
8-NS,214,1,2,2747,0,2750,G
8-NS,215,2760,0,4,0,2764,A
8-NS,216,2777,0,2,0,2779,A
8-NS,217,1,2777,1,0,2779,T
8-NS,218,4,0,0,2809,2813,C
8-NS,219,0,2809,0,3,2812,T
8-NS,220,0,0,2823,0,2823,G
8-NS,221,2820,0,2,1,2823,A
8-NS,222,0,2822,0,0,2822,T
8-NS,223,3,1,2797,0,2801,G
8-NS,224,2749,1,3,1,2754,A
8-NS,225,0,3,2757,0,2760,G
8-NS,226,1,2,2758,0,2761,G
8-NS,227,0,1,0,2755,2756,C
8-NS,228,2759,0,0,0,2759,A
8-NS,229,0,1,0,2874,2875,C
8-NS,230,1,2855,0,4,2860,T
8-NS,231,0,2873,2,0,2875,T
8-NS,232,2906,0,1,0,2907,A
8-NS,233,2911,0,2,0,2913,A
8-NS,234,2903,0,0,0,2903,A
8-NS,235,2899,0,4,0,2903,A
8-NS,236,0,2900,0,0,2900,T
8-NS,237,0,6,2909,0,2915,G
8-NS,238,2888,0,2,0,2890,A
8-NS,239,2,0,0,2894,2896,C
8-NS,240,5,1,0,2878,2884,C
8-NS,241,2890,2,0,0,2892,A
8-NS,242,1,2871,0,4,2876,T
8-NS,243,0,1,2966,0,2967,G
8-NS,244,2,0,2996,0,2998,G
8-NS,245,1,3012,0,2,3015,T
8-NS,246,2,1,0,3152,3155,C
8-NS,247,0,3134,0,6,3140,T
8-NS,248,7,1,0,3196,3204,C
8-NS,249,4,3,0,3194,3201,C
8-NS,250,3212,0,3,0,3215,A
8-NS,251,0,0,0,3237,3237,C
8-NS,252,3185,1,1,0,3187,A
8-NS,253,0,3,0,3199,3202,C
8-NS,254,1,1,0,3170,3172,C
8-NS,255,0,3029,0,1,3030,T
8-NS,256,0,1,3039,0,3040,G
8-NS,257,0,2,0,3016,3018,C
8-NS,258,1,2993,0,3,2997,T
8-NS,259,1,3010,0,1,3012,T
8-NS,260,1,2,0,2984,2987,C
8-NS,261,2,2,2994,0,2998,G
8-NS,262,0,0,0,2997,2997,C
8-NS,263,1,1,2993,0,2995,G
8-NS,264,3161,0,8,0,3169,A
8-NS,265,0,3161,0,1,3162,T
8-NS,266,3298,0,1,0,3299,A
8-NS,267,0,1,0,3316,3317,C
8-NS,268,3298,0,0,0,3298,A
8-NS,269,0,3413,0,1,3414,T
8-NS,270,3391,0,1,0,3392,A
8-NS,271,3408,0,3,0,3411,A
8-NS,272,1,2,0,3408,3411,C
8-NS,273,0,3265,0,3,3268,T
8-NS,274,0,3,3314,0,3317,G
8-NS,275,3236,1,3,0,3240,A
8-NS,276,0,0,0,3270,3270,C
8-NS,277,3241,1,5,0,3247,A
8-NS,278,0,3203,0,0,3203,T
8-NS,279,2,5,3194,1,3202,G
8-NS,280,3203,1,2,0,3206,A
8-NS,281,1,1,4,3328,3334,C
8-NS,282,0,3313,0,5,3318,T
8-NS,283,3389,0,0,0,3389,A
8-NS,284,0,3366,2,3,3371,T
8-NS,285,0,3342,0,1,3343,T
8-NS,286,0,4,3340,0,3344,G
8-NS,287,3315,3,3,0,3321,A
8-NS,288,1,2,3309,1,3313,G
8-NS,289,0,0,3301,0,3301,G
8-NS,290,3213,0,0,0,3213,A
8-NS,291,3227,0,4,0,3231,A
8-NS,292,0,3155,0,0,3155,T
8-NS,293,0,3142,0,3,3145,T
8-NS,294,1,1,3219,1,3222,G
8-NS,295,0,3215,0,2,3217,T
8-NS,296,5,2,1,3209,3217,C
8-NS,297,3219,0,3,0,3222,A
8-NS,298,3234,0,2,0,3236,A
8-NS,299,2,2,3230,0,3234,G
8-NS,300,3241,0,0,0,3241,A
8-NS,301,3245,0,1,0,3246,A
8-NS,302,3247,1,2,0,3250,A
8-NS,303,1,0,0,3251,3252,C
8-NS,304,1,3184,0,1,3186,T
8-NS,305,0,2,3259,0,3261,G
8-NS,306,0,1,3296,1,3298,G
8-NS,307,1,3311,0,1,3313,T
8-NS,308,0,3303,0,5,3308,T
8-NS,309,6,2,0,3263,3271,C
8-NS,310,3297,0,1,0,3298,A
8-NS,311,0,3337,1,4,3342,T
8-NS,312,1,2,3368,0,3371,G
8-NS,313,0,0,0,3394,3394,C
8-NS,314,0,3331,1,5,3337,T
8-NS,315,3281,0,2,0,3283,A
8-NS,316,3331,0,1,0,3332,A
8-NS,317,0,3353,0,0,3353,T
8-NS,318,1,1,3354,0,3356,G
8-NS,319,0,2,0,3370,3372,C
8-NS,320,5,2,0,3314,3321,C
8-NS,321,8,0,0,3292,3300,C
8-NS,322,3280,1,6,0,3287,A
8-NS,323,3315,1,1,0,3317,A
8-NS,324,0,0,3345,0,3345,G
8-NS,325,2,1,0,3333,3336,C
8-NS,326,3314,0,2,0,3316,A
8-NS,327,0,1,3345,0,3346,G
8-NS,328,3320,1,2,0,3323,A
8-NS,329,3321,0,7,1,3329,A
8-NS,330,3317,0,7,0,3324,A
8-NS,331,0,0,3420,0,3420,G
8-NS,332,0,3381,0,2,3383,T
8-NS,333,1,5,3360,1,3367,G
8-NS,334,0,2,3383,0,3385,G
8-NS,335,3371,0,7,0,3378,A
8-NS,336,3346,1,9,0,3356,A
8-NS,337,1,2,3358,1,3362,G
8-NS,338,0,5,3362,1,3368,G
8-NS,339,3362,0,2,0,3364,A
8-NS,340,0,0,0,3359,3359,C
8-NS,341,5,1,0,3322,3328,C
8-NS,342,0,3313,0,2,3315,T
8-NS,343,3,1,0,3383,3387,C
8-NS,344,0,3384,1,5,3390,T
8-NS,345,0,3391,0,2,3393,T
8-NS,346,0,3394,0,1,3395,T
8-NS,347,0,1,3372,0,3373,G
8-NS,348,0,0,0,3436,3436,C
8-NS,349,3402,0,3,0,3405,A
8-NS,350,1,3392,0,0,3393,T
8-NS,351,1,3,0,3397,3401,C
8-NS,352,3448,0,1,1,3450,A
8-NS,353,1,3,3572,0,3576,G
8-NS,354,3565,0,2,1,3568,A
8-NS,355,3559,0,10,0,3569,A
8-NS,356,0,3559,0,1,3560,T
8-NS,357,1,2,3549,0,3552,G
8-NS,358,3,3,3565,0,3571,G
8-NS,359,3573,0,6,0,3579,A
8-NS,360,5,1,0,3564,3570,C
8-NS,361,1,4,0,3459,3464,C
8-NS,362,3399,0,2,0,3401,A
8-NS,363,1,1,3443,1,3446,G
8-NS,364,5,1,3430,0,3436,G
8-NS,365,1,0,0,3443,3444,C
8-NS,366,3429,1,0,0,3430,A
8-NS,367,3470,1,5,0,3476,A
8-NS,368,1,3458,0,1,3460,T
8-NS,369,1,1,0,3469,3471,C
8-NS,370,3466,2,4,0,3472,A
8-NS,371,0,3460,0,2,3462,T
8-NS,372,3,3,3415,0,3421,G
8-NS,373,3,2,3435,0,3440,G
8-NS,374,3425,0,4,0,3429,A
8-NS,375,2,0,3478,0,3480,G
8-NS,376,3403,0,0,0,3403,A
8-NS,377,3405,1,4,0,3410,A
8-NS,378,3410,1,3,0,3414,A
8-NS,379,3399,0,3,1,3403,A
8-NS,380,3416,1,6,0,3423,A
8-NS,381,0,0,0,3448,3448,C
8-NS,382,3417,2,2,0,3421,A
8-NS,383,0,3402,0,2,3404,T
8-NS,384,2,4,0,3368,3374,C
8-NS,385,3363,0,2,0,3365,A
8-NS,386,0,3381,0,4,3385,T
8-NS,387,0,0,3401,0,3401,G
8-NS,388,1,3401,0,3,3405,T
8-NS,389,0,3367,0,2,3369,T
8-NS,390,0,3,3353,3,3359,G
8-NS,391,3348,0,5,0,3353,A
8-NS,392,3342,0,3,0,3345,A
8-NS,393,3326,0,7,0,3333,A
8-NS,394,0,0,3359,0,3359,G
8-NS,395,1,0,0,3342,3343,C
8-NS,396,1,7,3339,0,3347,G
8-NS,397,3346,1,1,0,3348,A
8-NS,398,3351,4,0,0,3355,A
8-NS,399,0,3342,1,1,3344,T
8-NS,400,0,3333,1,4,3338,T
8-NS,401,1,3342,0,1,3344,T
8-NS,402,3,7,0,3350,3360,C
8-NS,403,3332,1,4,0,3337,A
8-NS,404,1,1,3363,0,3365,G
8-NS,405,0,3337,0,6,3343,T
8-NS,406,1,0,3342,0,3343,G
8-NS,407,3,3320,0,5,3328,T
8-NS,408,1,1,3340,0,3342,G
8-NS,409,3368,0,0,0,3368,A
8-NS,410,0,3339,0,2,3341,T
8-NS,411,1,3356,0,2,3359,T
8-NS,412,0,3354,0,1,3355,T
8-NS,413,1,3352,0,2,3355,T
8-NS,414,0,3354,1,0,3355,T
8-NS,415,1,5,3344,0,3350,G
8-NS,416,1,1,3299,0,3301,G
8-NS,417,1,2,1,3306,3310,C
8-NS,418,2,2,0,3311,3315,C
8-NS,419,2,5,3327,1,3335,G
8-NS,420,3468,0,1,0,3469,A
8-NS,421,0,0,0,3543,3543,C
8-NS,422,0,3549,0,0,3549,T
8-NS,423,3554,0,3,0,3557,A
8-NS,424,0,1,3560,0,3561,G
8-NS,425,3544,3,8,0,3555,A
8-NS,426,1,4,3589,0,3594,G
8-NS,427,3577,1,6,0,3584,A
8-NS,428,1,1,0,3745,3747,C
8-NS,429,3,0,0,3644,3647,C
8-NS,430,3543,0,4,0,3547,A
8-NS,431,0,3832,0,0,3832,T
8-NS,432,3815,0,6,0,3821,A
8-NS,433,1,1,4189,0,4191,G
8-NS,434,1,4157,0,3,4161,T
8-NS,435,4139,0,0,0,4139,A
8-NS,436,0,4128,1,9,4138,T
8-NS,437,0,4002,0,3,4005,T
8-NS,438,4136,1,0,0,4137,A
8-NS,439,0,6,0,4140,4146,C
8-NS,440,0,3924,0,5,3929,T
8-NS,441,3922,0,0,0,3922,A
8-NS,442,3514,0,4,1,3519,A
8-NS,443,2,6,3542,0,3550,G
8-NS,444,0,4,3538,0,3542,G
8-NS,445,0,2,3548,0,3550,G
8-NS,446,0,0,0,3527,3527,C
8-NS,447,0,3445,1,7,3453,T
8-NS,448,1,3449,0,7,3457,T
8-NS,449,1,3505,0,5,3511,T
8-NS,450,1,1,0,3536,3538,C
8-NS,451,3579,0,5,0,3584,A
8-NS,452,1,4,2,3591,3598,C
8-NS,453,1,2,0,3556,3559,C
8-NS,454,5,2,3556,0,3563,G
8-NS,455,3541,0,2,0,3543,A
8-NS,456,3538,6,4,1,3549,A
8-NS,457,1,0,3570,0,3571,G
8-NS,458,3498,0,6,1,3505,A
8-NS,459,1,4,3531,0,3536,G
8-NS,460,1,4,3462,0,3467,G
8-NS,461,1,12,3480,0,3493,G
8-NS,462,3472,1,8,0,3481,A
8-NS,463,1,0,3492,0,3493,G
8-NS,464,1,1,0,3473,3475,C
8-NS,465,3465,0,4,0,3469,A
8-NS,466,3468,0,4,0,3472,A
8-NS,467,0,3470,1,1,3472,T
8-NS,468,1,3443,0,2,3446,T
8-NS,469,0,0,3465,1,3466,G
8-NS,470,0,3407,0,2,3409,T
8-NS,471,0,3404,0,0,3404,T
8-NS,472,2,0,3410,0,3412,G
8-NS,473,0,0,3407,0,3407,G
8-NS,474,1,2,0,3403,3406,C
8-NS,475,4,3,3400,0,3407,G
8-NS,476,3405,1,2,0,3408,A
8-NS,477,3429,2,2,0,3433,A
8-NS,478,3434,0,3,1,3438,A
8-NS,479,0,3454,0,3,3457,T
8-NS,480,4,3,0,3444,3451,C
8-NS,481,0,3414,0,8,3422,T
8-NS,482,3,2,0,3441,3446,C
8-NS,483,3459,0,4,0,3463,A
8-NS,484,0,1,0,3482,3483,C
8-NS,485,1,0,0,3471,3472,C
8-NS,486,3432,1,1,0,3434,A
8-NS,487,0,3392,0,5,3397,T
8-NS,488,0,3384,0,2,3386,T
8-NS,489,1,1,3388,0,3390,G
8-NS,490,1,2,0,3379,3382,C
8-NS,491,0,1,0,3386,3387,C
8-NS,492,0,3373,0,9,3382,T
8-NS,493,0,3371,1,1,3373,T
8-NS,494,1,3,0,3394,3398,C
8-NS,495,0,3369,0,9,3378,T
8-NS,496,0,3372,0,5,3377,T
8-NS,497,0,3446,0,1,3447,T
8-NS,498,0,3417,0,2,3419,T
8-NS,499,3,0,0,3431,3434,C
8-NS,500,1,2,0,3416,3419,C
8-NS,501,3391,1,6,0,3398,A
8-NS,502,2,1,3443,0,3446,G
8-NS,503,1,4,3416,0,3421,G
8-NS,504,3499,1,4,0,3504,A
8-NS,505,0,1,0,3513,3514,C
8-NS,506,3545,0,3,0,3548,A
8-NS,507,0,3573,0,1,3574,T
8-NS,508,3570,1,7,0,3578,A
8-NS,509,0,3,0,3912,3915,C
8-NS,510,0,3898,0,3,3901,T
8-NS,511,3875,1,4,0,3880,A
8-NS,512,1,3861,0,3,3865,T
8-NS,513,0,3719,0,2,3721,T
8-NS,514,1,1,3714,0,3716,G
8-NS,515,3543,0,4,0,3547,A
8-NS,516,0,0,3562,0,3562,G
8-NS,517,3,1,3532,0,3536,G
8-NS,518,3109,0,0,0,3109,A
8-NS,519,0,3115,0,3,3118,T
8-NS,520,0,0,3119,0,3119,G
8-NS,521,0,3102,0,4,3106,T
8-NS,522,6,1,0,3110,3117,C
8-NS,523,3122,0,6,0,3128,A
8-NS,524,3125,0,0,0,3125,A
8-NS,525,3120,2,0,0,3122,A
8-NS,526,3107,0,0,0,3107,A
8-NS,527,3118,2,0,0,3120,A
8-NS,528,2,3097,0,1,3100,T
8-NS,529,0,0,3105,0,3105,G
8-NS,530,0,2,0,3126,3128,C
8-NS,531,3129,0,0,0,3129,A
8-NS,532,3142,0,1,0,3143,A
8-NS,533,0,3149,0,0,3149,T
8-NS,534,0,3148,2,0,3150,T
8-NS,535,0,4,3134,0,3138,G
8-NS,536,0,5,3115,0,3120,G
8-NS,537,3,3,3115,0,3121,G
8-NS,538,1,0,3153,0,3154,G
8-NS,539,0,3096,0,4,3100,T
8-NS,540,0,2,0,3149,3151,C
8-NS,541,3,1,0,3141,3145,C
8-NS,542,1,3134,1,8,3144,T
8-NS,543,1,0,0,3180,3181,C
8-NS,544,3184,6,1,0,3191,A
8-NS,545,1,3185,0,2,3188,T
8-NS,546,1,0,0,3206,3207,C
8-NS,547,3,1,3179,0,3183,G
8-NS,548,2,1,3171,0,3174,G
8-NS,549,3129,0,5,0,3134,A
8-NS,550,0,8,3123,0,3131,G
8-NS,551,2,4,3155,0,3161,G
8-NS,552,3116,1,0,0,3117,A
8-NS,553,1,0,0,3132,3133,C
8-NS,554,2,3109,0,7,3118,T
8-NS,555,0,3117,0,3,3120,T
8-NS,556,0,4,3137,1,3142,G
8-NS,557,3122,1,3,2,3128,A
8-NS,558,3121,0,4,0,3125,A
8-NS,559,1,3114,0,1,3116,T
8-NS,560,0,2,3043,0,3045,G
8-NS,561,0,0,3092,1,3093,G
8-NS,562,3024,1,4,0,3029,A
8-NS,563,3054,0,6,0,3060,A
8-NS,564,0,3230,0,0,3230,T
8-NS,565,0,0,3252,0,3252,G
8-NS,566,3259,0,2,0,3261,A
8-NS,567,0,3260,0,1,3261,T
8-NS,568,3249,0,5,0,3254,A
8-NS,569,3272,0,6,0,3278,A
8-NS,570,2,1,0,3243,3246,C
8-NS,571,3171,0,0,0,3171,A
8-NS,572,1,2,0,3197,3200,C
8-NS,573,2860,0,4,0,2864,A
8-NS,574,1,1,2954,0,2956,G
8-NS,575,0,2908,0,3,2911,T
8-NS,576,0,2901,0,3,2904,T
8-NS,577,2,1,0,2906,2909,C
8-NS,578,2,2,2883,0,2887,G
8-NS,579,2873,1,4,0,2878,A
8-NS,580,1,0,2882,0,2883,G
8-NS,581,0,2835,0,10,2845,T
8-NS,582,3,0,0,2861,2864,C
8-NS,583,0,2773,0,4,2777,T
8-NS,584,4,0,0,2818,2822,C
8-NS,585,1,2815,0,1,2817,T
8-NS,586,2821,0,1,0,2822,A
8-NS,587,2827,0,0,0,2827,A
8-NS,588,2812,0,0,0,2812,A
8-NS,589,2839,0,2,0,2841,A
8-NS,590,2843,0,0,0,2843,A
8-NS,591,0,2809,0,1,2810,T
8-NS,592,1,1,0,2853,2855,C
8-NS,593,0,2823,0,3,2826,T
8-NS,594,2849,2,1,0,2852,A
8-NS,595,0,0,0,2843,2843,C
8-NS,596,2837,0,6,0,2843,A
8-NS,597,1,1,2845,0,2847,G
8-NS,598,2764,1,0,0,2765,A
8-NS,599,2,3,2790,0,2795,G
8-NS,600,2794,1,6,0,2801,A
8-NS,601,0,2743,0,4,2747,T
8-NS,602,0,2756,0,0,2756,T
8-NS,603,5,2,0,2740,2747,C
8-NS,604,1,2,2756,0,2759,G
8-NS,605,4,1,0,2759,2764,C
8-NS,606,0,2752,1,3,2756,T
8-NS,607,1,2749,0,4,2754,T
8-NS,608,0,1,2731,0,2732,G
8-NS,609,0,1,2762,0,2763,G
8-NS,610,2759,0,2,1,2762,A
8-NS,611,0,0,2765,0,2765,G
8-NS,612,2720,0,1,0,2721,A
8-NS,613,2701,1,5,0,2707,A
8-NS,614,2,0,2788,0,2790,G
8-NS,615,0,1,0,2791,2792,C
8-NS,616,2798,1,3,0,2802,A
8-NS,617,2,1,2879,1,2883,G
8-NS,618,0,2855,0,1,2856,T
8-NS,619,2882,0,3,0,2885,A
8-NS,620,2883,1,2,0,2886,A
8-NS,621,0,2885,0,1,2886,T
8-NS,622,0,2,2900,0,2902,G
8-NS,623,2748,1,4,0,2753,A
8-NS,624,1,2,2824,0,2827,G
8-NS,625,2779,0,4,0,2783,A
8-NS,626,2685,0,2,0,2687,A
8-NS,627,0,2677,0,0,2677,T
8-NS,628,2,2,2631,0,2635,G
8-NS,629,1,5,2628,0,2634,G
8-NS,630,1,8,2606,0,2615,G
8-NS,631,3,1,2602,0,2606,G
8-NS,632,1,2,2609,1,2613,G
8-NS,633,2550,1,3,0,2554,A
8-NS,634,2,1,0,2573,2576,C
8-NS,635,2,0,0,2582,2584,C
8-NS,636,1,2553,0,9,2563,T
8-NS,637,1,1,0,2580,2582,C
8-NS,638,2,0,0,2592,2594,C
8-NS,639,2609,1,0,0,2610,A
8-NS,640,0,0,1,2602,2603,C
8-NS,641,0,2563,1,1,2565,T
8-NS,642,1,2552,0,2,2555,T
8-NS,643,2516,0,0,1,2517,A
8-NS,644,2,1,0,2553,2556,C
8-NS,645,1,2529,0,3,2533,T
8-NS,646,3,4,0,2529,2536,C
8-NS,647,0,1,0,2488,2489,C
8-NS,648,2492,0,1,1,2494,A
8-NS,649,2513,0,1,1,2515,A
8-NS,650,2504,1,1,0,2506,A
8-NS,651,2516,0,2,0,2518,A
8-NS,652,0,1,0,2523,2524,C
8-NS,653,2429,1,2,0,2432,A
8-NS,654,0,1,2443,0,2444,G
8-NS,655,2422,0,1,0,2423,A
8-NS,656,2420,0,1,1,2422,A
8-NS,657,2423,0,5,0,2428,A
8-NS,658,0,4,0,2424,2428,C
8-NS,659,1,2,2428,0,2431,G
8-NS,660,2,0,2421,0,2423,G
8-NS,661,1,2,2423,1,2427,G
8-NS,662,2424,0,3,0,2427,A
8-NS,663,2411,0,3,0,2414,A
8-NS,664,2404,0,5,1,2410,A
8-NS,665,0,2409,0,0,2409,T
8-NS,666,0,1,2441,0,2442,G
8-NS,667,1,1,2432,0,2434,G
8-NS,668,0,2,0,2414,2416,C
8-NS,669,1,1,2419,0,2421,G
8-NS,670,2399,0,4,0,2403,A
8-NS,671,1,2,2410,0,2413,G
8-NS,672,2412,0,0,0,2412,A
8-NS,673,2412,0,1,0,2413,A
8-NS,674,0,0,0,2429,2429,C
8-NS,675,2390,0,1,0,2391,A
8-NS,676,5,1,2387,0,2393,G
8-NS,677,0,3,0,2386,2389,C
8-NS,678,0,2377,0,4,2381,T
8-NS,679,2379,0,2,0,2381,A
8-NS,680,0,0,2366,0,2366,G
8-NS,681,0,0,2373,1,2374,G
8-NS,682,2,2358,0,4,2364,T
8-NS,683,1,0,0,2321,2322,C
8-NS,684,2335,0,1,0,2336,A
8-NS,685,2332,0,1,0,2333,A
8-NS,686,2319,0,1,0,2320,A
8-NS,687,2346,0,1,0,2347,A
8-NS,688,2,0,2356,0,2358,G
8-NS,689,0,2303,1,2,2306,T
8-NS,690,0,2301,0,2,2303,T
8-NS,691,0,2298,0,2,2300,T
8-NS,692,0,1,2310,0,2311,G
8-NS,693,2302,0,4,1,2307,A
8-NS,694,2308,0,2,0,2310,A
8-NS,695,1,1,2324,0,2326,G
8-NS,696,2276,1,4,0,2281,A
8-NS,697,1,1,2311,0,2313,G
8-NS,698,2297,0,3,0,2300,A
8-NS,699,0,2307,0,0,2307,T
8-NS,700,2312,0,2,0,2314,A
8-NS,701,2299,0,1,0,2300,A
8-NS,702,0,0,2299,0,2299,G
8-NS,703,2140,1,3,0,2144,A
8-NS,704,0,2152,1,0,2153,T
8-NS,705,3,1,2160,0,2164,G
8-NS,706,0,1,2159,0,2160,G
8-NS,707,0,3,0,2155,2158,C
8-NS,708,0,2140,0,1,2141,T
8-NS,709,2153,0,1,0,2154,A
8-NS,710,2151,0,0,0,2151,A
8-NS,711,0,2166,0,0,2166,T
8-NS,712,0,2162,0,0,2162,T
8-NS,713,0,2,2164,0,2166,G
8-NS,714,2130,0,0,0,2130,A
8-NS,715,2124,0,3,0,2127,A
8-NS,716,0,2,2130,0,2132,G
8-NS,717,2128,0,2,0,2130,A
8-NS,718,2111,0,3,0,2114,A
8-NS,719,1,0,2152,0,2153,G
8-NS,720,0,2115,0,0,2115,T
8-NS,721,0,1,2112,0,2113,G
8-NS,722,2073,0,3,1,2077,A
8-NS,723,0,2,2108,0,2110,G
8-NS,724,2101,1,7,0,2109,A
8-NS,725,1,0,0,2098,2099,C
8-NS,726,2090,0,1,0,2091,A
8-NS,727,0,0,0,2090,2090,C
8-NS,728,1985,0,4,1,1990,A
8-NS,729,0,1,2110,0,2111,G
8-NS,730,2124,0,2,0,2126,A
8-NS,731,0,2103,0,7,2110,T
8-NS,732,0,2092,0,1,2093,T
8-NS,733,2088,1,1,0,2090,A
8-NS,734,2076,0,2,0,2078,A
8-NS,735,1,4,1787,0,1792,G
8-NS,736,1798,0,3,0,1801,A
8-NS,737,1803,0,5,0,1808,A
8-NS,738,0,0,0,1817,1817,C
8-NS,739,1750,1,2,0,1753,A
8-NS,740,1781,0,0,0,1781,A
8-NS,741,0,0,0,1779,1779,C
8-NS,742,1,1769,0,0,1770,T
8-NS,743,0,1,1800,0,1801,G
8-NS,744,1796,0,2,0,1798,A
8-NS,745,1796,0,3,0,1799,A
8-NS,746,1799,1,1,0,1801,A
8-NS,747,1766,0,1,0,1767,A
8-NS,748,0,1758,0,3,1761,T
8-NS,749,1693,0,2,0,1695,A
8-NS,750,0,0,1714,0,1714,G
8-NS,751,0,1,0,1707,1708,C
8-NS,752,0,1674,0,2,1676,T
8-NS,753,0,1679,0,2,1681,T
8-NS,754,0,1660,0,2,1662,T
8-NS,755,0,3,1670,0,1673,G
8-NS,756,1675,0,0,0,1675,A
8-NS,757,1677,0,3,0,1680,A
8-NS,758,0,0,0,1691,1691,C
8-NS,759,1643,0,0,0,1643,A
8-NS,760,1654,0,2,0,1656,A
8-NS,761,1660,0,0,0,1660,A
8-NS,762,0,1659,0,2,1661,T
8-NS,763,1657,0,1,0,1658,A
8-NS,764,1638,0,1,1,1640,A
8-NS,765,0,0,0,1635,1635,C
8-NS,766,1636,1,0,0,1637,A
8-NS,767,0,1613,0,0,1613,T
8-NS,768,0,1588,0,1,1589,T
8-NS,769,2,1,0,1570,1573,C
8-NS,770,1566,1,1,0,1568,A
8-NS,771,0,1558,1,3,1562,T
8-NS,772,1,0,1561,0,1562,G
8-NS,773,1,0,0,1522,1523,C
8-NS,774,1505,0,0,0,1505,A
8-NS,775,1498,0,3,1,1502,A
8-NS,776,1,0,1499,0,1500,G
8-NS,777,0,1,0,1549,1550,C
8-NS,778,1514,1,2,1,1518,A
8-NS,779,0,1525,0,3,1528,T
8-NS,780,0,1527,0,1,1528,T
8-NS,781,1528,1,2,0,1531,A
8-NS,782,0,0,0,1527,1527,C
8-NS,783,1516,0,0,0,1516,A
8-NS,784,1493,0,5,0,1498,A
8-NS,785,1,0,0,1493,1494,C
8-NS,786,0,1256,0,2,1258,T
8-NS,787,1,0,1249,0,1250,G
8-NS,788,0,0,0,1232,1232,C
8-NS,789,0,1189,0,3,1192,T
8-NS,790,0,0,1198,0,1198,G
8-NS,791,0,1169,0,3,1172,T
8-NS,792,0,1172,0,1,1173,T
8-NS,793,0,1177,0,0,1177,T
8-NS,794,0,0,1162,0,1162,G
8-NS,795,1164,0,1,0,1165,A
8-NS,796,1137,0,1,0,1138,A
8-NS,797,0,0,1147,0,1147,G
8-NS,798,0,1132,0,0,1132,T
8-NS,799,1,0,1071,0,1072,G
8-NS,800,0,1,1087,0,1088,G
8-NS,801,1090,0,0,0,1090,A
8-NS,802,1086,0,7,0,1093,A
8-NS,803,0,0,0,1092,1092,C
8-NS,804,1059,1,1,0,1061,A
8-NS,805,2,0,1058,0,1060,G
8-NS,806,0,1,1041,0,1042,G
8-NS,807,1012,0,0,0,1012,A
8-NS,808,1,0,1034,0,1035,G
8-NS,809,906,0,2,0,908,A
8-NS,810,0,903,0,1,904,T
8-NS,811,896,0,4,0,900,A
8-NS,812,887,0,5,0,892,A
8-NS,813,0,0,894,0,894,G
8-NS,814,804,0,0,0,804,A
8-NS,815,801,1,0,0,802,A
8-NS,816,0,0,0,798,798,C
8-NS,817,0,680,0,1,681,T
8-NS,818,0,674,0,0,674,T
8-NS,819,0,673,0,1,674,T
8-NS,820,0,0,0,674,674,C
8-NS,821,0,663,0,2,665,T
8-NS,822,3,0,0,652,655,C
8-NS,823,629,0,0,0,629,A
8-NS,824,0,625,0,1,626,T
8-NS,825,0,612,0,0,612,T
8-NS,826,1,611,0,0,612,T
8-NS,827,0,2,0,605,607,C
8-NS,828,575,0,0,0,575,A
8-NS,829,0,0,573,0,573,G
8-NS,830,0,1,0,572,573,C
8-NS,831,0,541,0,0,541,T
8-NS,832,0,535,1,0,536,T
8-NS,833,524,0,0,0,524,A
8-NS,834,0,522,0,0,522,T
8-NS,835,0,520,0,0,520,T
8-NS,836,1,516,0,0,517,T
8-NS,837,502,0,0,0,502,A
8-NS,838,487,0,1,0,488,A
8-NS,839,0,470,0,0,470,T
8-NS,840,0,0,470,0,470,G
8-NS,841,450,0,0,0,450,A
8-NS,842,0,405,0,0,405,T
8-NS,843,397,0,0,0,397,A
8-NS,844,396,0,0,0,396,A
8-NS,845,396,0,1,0,397,A
8-NS,846,393,0,0,0,393,A
8-NS,847,393,0,2,0,395,A
8-NS,848,386,0,0,1,387,A
8-NS,849,0,0,0,385,385,C
8-NS,850,330,0,0,0,330,A
8-NS,851,0,0,0,330,330,C
8-NS,852,1,0,0,314,315,C
8-NS,853,0,0,0,300,300,C
8-NS,854,0,291,0,0,291,T
8-NS,855,0,281,0,0,281,T
8-NS,856,0,0,280,0,280,G
8-NS,857,0,264,0,0,264,T
8-NS,858,0,258,0,0,258,T
8-NS,859,0,254,0,0,254,T
8-NS,860,0,0,0,110,110,C
8-NS,861,0,79,0,0,79,T
8-NS,862,65,0,0,0,65,A
8-NS,863,0,0,0,64,64,C
