Gene,Position,A,T,G,C,Coverage,Consensus
1-PB2,1,51,0,0,0,51,A
1-PB2,2,0,51,0,0,51,T
1-PB2,3,0,0,54,0,54,G
1-PB2,4,0,0,54,0,54,G
1-PB2,5,54,0,0,0,54,A
1-PB2,6,54,0,0,0,54,A
1-PB2,7,54,0,0,0,54,A
1-PB2,8,0,0,59,0,59,G
1-PB2,9,60,0,0,0,60,A
1-PB2,10,60,0,0,0,60,A
1-PB2,11,0,61,0,0,61,T
1-PB2,12,61,0,0,0,61,A
1-PB2,13,61,0,0,0,61,A
1-PB2,14,60,0,0,0,60,A
1-PB2,15,61,0,0,0,61,A
1-PB2,16,0,2,64,0,66,G
1-PB2,17,67,0,0,0,67,A
1-PB2,18,68,0,0,0,68,A
1-PB2,19,0,0,0,68,68,C
1-PB2,20,0,68,0,0,68,T
1-PB2,21,68,0,0,0,68,A
1-PB2,22,0,0,0,68,68,C
1-PB2,23,0,1,67,0,68,G
1-PB2,24,0,1,66,0,67,G
1-PB2,25,68,0,0,0,68,A
1-PB2,26,70,0,0,0,70,A
1-PB2,27,0,70,0,0,70,T
1-PB2,28,0,0,0,71,71,C
1-PB2,29,0,71,0,0,71,T
1-PB2,30,1,1,70,0,72,G
1-PB2,31,72,0,0,0,72,A
1-PB2,32,0,72,0,0,72,T
1-PB2,33,0,0,72,0,72,G
1-PB2,34,0,73,0,0,73,T
1-PB2,35,0,0,0,72,72,C
1-PB2,36,0,0,73,0,73,G
1-PB2,37,0,0,0,73,73,C
1-PB2,38,73,0,0,0,73,A
1-PB2,39,0,0,76,0,76,G
1-PB2,40,0,76,0,0,76,T
1-PB2,41,0,0,0,77,77,C
1-PB2,42,0,77,0,0,77,T
1-PB2,43,0,0,0,76,76,C
1-PB2,44,0,1,75,0,76,G
1-PB2,45,0,0,0,76,76,C
1-PB2,46,76,0,0,0,76,A
1-PB2,47,0,0,0,79,79,C
1-PB2,48,0,77,0,0,77,T
1-PB2,49,0,0,0,83,83,C
1-PB2,50,0,0,83,0,83,G
1-PB2,51,0,0,0,83,83,C
1-PB2,52,0,1,82,0,83,G
1-PB2,53,84,0,0,0,84,A
1-PB2,54,0,0,86,0,86,G
1-PB2,55,89,0,1,0,90,A
1-PB2,56,0,90,0,0,90,T
1-PB2,57,91,0,0,0,91,A
1-PB2,58,0,0,0,91,91,C
1-PB2,59,1,91,0,0,92,T
1-PB2,60,0,0,94,0,94,G
1-PB2,61,94,0,0,0,94,A
1-PB2,62,0,0,0,94,94,C
1-PB2,63,95,0,0,0,95,A
1-PB2,64,95,0,0,0,95,A
1-PB2,65,97,0,0,0,97,A
1-PB2,66,100,0,0,0,100,A
1-PB2,67,100,0,0,0,100,A
1-PB2,68,0,0,0,101,101,C
1-PB2,69,1,0,0,99,100,C
1-PB2,70,104,0,0,0,104,A
1-PB2,71,0,1,0,104,105,C
1-PB2,72,105,0,0,0,105,A
1-PB2,73,0,0,110,0,110,G
1-PB2,74,0,109,0,1,110,T
1-PB2,75,0,1,112,0,113,G
1-PB2,76,0,1,113,0,114,G
1-PB2,77,114,0,1,0,115,A
1-PB2,78,0,0,0,120,120,C
1-PB2,79,0,0,0,119,119,C
1-PB2,80,120,0,0,0,120,A
1-PB2,81,0,120,0,0,120,T
1-PB2,82,119,0,0,0,119,A
1-PB2,83,0,119,0,0,119,T
1-PB2,84,0,1,118,0,119,G
1-PB2,85,0,0,119,0,119,G
1-PB2,86,0,0,0,120,120,C
1-PB2,87,1,0,0,117,118,C
1-PB2,88,118,0,0,0,118,A
1-PB2,89,0,136,0,0,136,T
1-PB2,90,136,0,0,0,136,A
1-PB2,91,140,0,1,1,142,A
1-PB2,92,0,144,0,0,144,T
1-PB2,93,0,145,0,0,145,T
1-PB2,94,146,0,0,0,146,A
1-PB2,95,144,0,0,0,144,A
1-PB2,96,0,0,152,0,152,G
1-PB2,97,152,0,0,0,152,A
1-PB2,98,150,0,0,0,150,A
1-PB2,99,0,0,158,0,158,G
1-PB2,100,0,156,0,0,156,T
1-PB2,101,155,0,1,0,156,A
1-PB2,102,0,0,0,157,157,C
1-PB2,103,159,0,0,0,159,A
1-PB2,104,0,0,0,163,163,C
1-PB2,105,162,0,0,0,162,A
1-PB2,106,0,166,0,0,166,T
1-PB2,107,1,0,0,166,167,C
1-PB2,108,0,0,169,0,169,G
1-PB2,109,0,1,166,0,167,G
1-PB2,110,0,2,167,0,169,G
1-PB2,111,0,1,170,0,171,G
1-PB2,112,170,0,1,0,171,A
1-PB2,113,0,3,170,0,173,G
1-PB2,114,169,0,0,1,170,A
1-PB2,115,0,0,0,175,175,C
1-PB2,116,175,0,0,0,175,A
1-PB2,117,1,0,174,0,175,G
1-PB2,118,0,0,182,0,182,G
1-PB2,119,182,1,0,0,183,A
1-PB2,120,185,0,0,0,185,A
1-PB2,121,182,0,1,0,183,A
1-PB2,122,185,0,0,0,185,A
1-PB2,123,0,0,186,0,186,G
1-PB2,124,185,0,0,0,185,A
1-PB2,125,185,0,1,0,186,A
1-PB2,126,0,0,0,187,187,C
1-PB2,127,0,0,0,186,186,C
1-PB2,128,0,0,0,185,185,C
1-PB2,129,0,0,186,0,186,G
1-PB2,130,0,187,0,0,187,T
1-PB2,131,1,0,0,187,188,C
1-PB2,132,190,0,0,0,190,A
1-PB2,133,0,0,0,191,191,C
1-PB2,134,0,190,0,0,190,T
1-PB2,135,0,191,0,0,191,T
1-PB2,136,190,0,0,0,190,A
1-PB2,137,0,0,197,0,197,G
1-PB2,138,0,0,195,0,195,G
1-PB2,139,196,0,0,0,196,A
1-PB2,140,0,196,0,0,196,T
1-PB2,141,0,0,198,0,198,G
1-PB2,142,203,0,0,0,203,A
1-PB2,143,203,0,0,0,203,A
1-PB2,144,202,0,1,0,203,A
1-PB2,145,0,203,0,0,203,T
1-PB2,146,0,2,203,0,205,G
1-PB2,147,0,0,206,0,206,G
1-PB2,148,205,0,0,0,205,A
1-PB2,149,0,206,0,0,206,T
1-PB2,150,0,0,205,0,205,G
1-PB2,151,204,0,0,0,204,A
1-PB2,152,0,204,0,0,204,T
1-PB2,153,0,0,205,0,205,G
1-PB2,154,0,0,205,0,205,G
1-PB2,155,1,1,0,202,204,C
1-PB2,156,204,0,0,0,204,A
1-PB2,157,205,0,0,0,205,A
1-PB2,158,0,205,0,0,205,T
1-PB2,159,0,0,213,0,213,G
1-PB2,160,212,0,1,0,213,A
1-PB2,161,213,0,0,0,213,A
1-PB2,162,212,0,0,0,212,A
1-PB2,163,0,213,0,0,213,T
1-PB2,164,215,0,0,0,215,A
1-PB2,165,1,0,0,217,218,C
1-PB2,166,1,0,0,214,215,C
1-PB2,167,0,0,0,217,217,C
1-PB2,168,212,0,0,0,212,A
1-PB2,169,212,0,0,0,212,A
1-PB2,170,1,211,0,0,212,T
1-PB2,171,1,0,0,211,212,C
1-PB2,172,212,0,0,0,212,A
1-PB2,173,0,0,0,215,215,C
1-PB2,174,0,212,0,0,212,T
1-PB2,175,1,0,212,0,213,G
1-PB2,176,0,0,0,213,213,C
1-PB2,177,0,213,0,0,213,T
1-PB2,178,0,3,212,0,215,G
1-PB2,179,214,0,1,0,215,A
1-PB2,180,0,0,0,216,216,C
1-PB2,181,216,0,0,0,216,A
1-PB2,182,215,0,0,0,215,A
1-PB2,183,215,0,0,0,215,A
1-PB2,184,215,0,2,0,217,A
1-PB2,185,0,0,221,0,221,G
1-PB2,186,0,2,218,0,220,G
1-PB2,187,220,0,0,0,220,A
1-PB2,188,0,220,0,0,220,T
1-PB2,189,220,0,0,0,220,A
1-PB2,190,222,0,0,0,222,A
1-PB2,191,0,0,0,229,229,C
1-PB2,192,229,0,0,0,229,A
1-PB2,193,1,0,228,0,229,G
1-PB2,194,227,0,0,0,227,A
1-PB2,195,228,0,0,0,228,A
1-PB2,196,228,0,0,0,228,A
1-PB2,197,0,226,0,0,226,T
1-PB2,198,0,1,226,0,227,G
1-PB2,199,0,0,231,0,231,G
1-PB2,200,0,227,0,0,227,T
1-PB2,201,0,226,0,1,227,T
1-PB2,202,0,0,0,225,225,C
1-PB2,203,3,0,0,224,227,C
1-PB2,204,226,0,1,0,227,A
1-PB2,205,0,0,226,0,226,G
1-PB2,206,225,0,2,0,227,A
1-PB2,207,0,2,225,0,227,G
1-PB2,208,225,0,0,0,225,A
1-PB2,209,0,0,228,0,228,G
1-PB2,210,228,0,0,0,228,A
1-PB2,211,228,1,0,0,229,A
1-PB2,212,228,0,2,0,230,A
1-PB2,213,0,228,0,0,228,T
1-PB2,214,0,2,227,1,230,G
1-PB2,215,228,1,0,0,229,A
1-PB2,216,229,0,0,0,229,A
1-PB2,217,0,0,0,228,228,C
1-PB2,218,226,0,0,0,226,A
1-PB2,219,226,0,0,0,226,A
1-PB2,220,0,0,230,0,230,G
1-PB2,221,0,0,232,0,232,G
1-PB2,222,233,0,0,0,233,A
1-PB2,223,0,0,0,231,231,C
1-PB2,224,230,0,0,0,230,A
1-PB2,225,229,0,0,0,229,A
1-PB2,226,239,0,1,0,240,A
1-PB2,227,0,0,0,242,242,C
1-PB2,228,0,237,0,0,237,T
1-PB2,229,1,0,0,241,242,C
1-PB2,230,0,237,0,0,237,T
1-PB2,231,239,0,0,0,239,A
1-PB2,232,0,238,0,0,238,T
1-PB2,233,1,1,238,0,240,G
1-PB2,234,0,2,247,0,249,G
1-PB2,235,242,0,0,0,242,A
1-PB2,236,0,0,248,0,248,G
1-PB2,237,0,247,0,1,248,T
1-PB2,238,248,0,0,0,248,A
1-PB2,239,248,0,1,0,249,A
1-PB2,240,248,0,0,0,248,A
1-PB2,241,248,0,0,0,248,A
1-PB2,242,1,248,0,0,249,T
1-PB2,243,0,2,247,0,249,G
1-PB2,244,244,0,2,0,246,A
1-PB2,245,0,1,247,0,248,G
1-PB2,246,0,247,0,1,248,T
1-PB2,247,0,1,244,0,245,G
1-PB2,248,249,0,0,0,249,A
1-PB2,249,0,248,0,0,248,T
1-PB2,250,0,1,248,0,249,G
1-PB2,251,0,0,0,249,249,C
1-PB2,252,0,248,0,0,248,T
1-PB2,253,1,2,249,0,252,G
1-PB2,254,0,0,255,0,255,G
1-PB2,255,256,0,0,0,256,A
1-PB2,256,0,255,0,1,256,T
1-PB2,257,1,0,0,255,256,C
1-PB2,258,255,0,0,0,255,A
1-PB2,259,0,1,259,0,260,G
1-PB2,260,259,0,0,0,259,A
1-PB2,261,0,260,0,0,260,T
1-PB2,262,256,0,1,0,257,A
1-PB2,263,0,1,260,0,261,G
1-PB2,264,257,1,1,0,259,A
1-PB2,265,0,0,265,0,265,G
1-PB2,266,0,263,0,0,263,T
1-PB2,267,0,1,259,0,260,G
1-PB2,268,255,0,1,0,256,A
1-PB2,269,0,257,0,0,257,T
1-PB2,270,0,0,256,0,256,G
1-PB2,271,1,0,265,0,266,G
1-PB2,272,0,262,0,1,263,T
1-PB2,273,262,0,0,0,262,A
1-PB2,274,0,258,0,1,259,T
1-PB2,275,3,0,0,252,255,C
1-PB2,276,264,0,0,0,264,A
1-PB2,277,0,1,0,265,266,C
1-PB2,278,0,0,0,264,264,C
1-PB2,279,0,257,0,1,258,T
1-PB2,280,0,255,0,1,256,T
1-PB2,281,0,256,0,0,256,T
1-PB2,282,0,0,256,0,256,G
1-PB2,283,0,0,257,0,257,G
1-PB2,284,0,0,0,259,259,C
1-PB2,285,0,257,0,1,258,T
1-PB2,286,0,0,260,0,260,G
1-PB2,287,0,259,0,0,259,T
1-PB2,288,260,0,0,0,260,A
1-PB2,289,259,0,2,0,261,A
1-PB2,290,1,0,0,259,260,C
1-PB2,291,256,0,1,0,257,A
1-PB2,292,0,253,0,1,254,T
1-PB2,293,0,1,250,0,251,G
1-PB2,294,0,0,257,0,257,G
1-PB2,295,0,254,0,1,255,T
1-PB2,296,1,0,254,0,255,G
1-PB2,297,0,1,255,0,256,G
1-PB2,298,254,0,1,0,255,A
1-PB2,299,252,0,2,0,254,A
1-PB2,300,0,254,0,0,254,T
1-PB2,301,253,0,0,0,253,A
1-PB2,302,0,3,253,0,256,G
1-PB2,303,255,0,0,0,255,A
1-PB2,304,253,0,1,0,254,A
1-PB2,305,254,0,0,0,254,A
1-PB2,306,0,249,0,0,249,T
1-PB2,307,1,0,248,0,249,G
1-PB2,308,0,1,249,0,250,G
1-PB2,309,249,0,0,0,249,A
1-PB2,310,0,0,0,253,253,C
1-PB2,311,1,0,0,251,252,C
1-PB2,312,0,0,0,253,253,C
1-PB2,313,0,0,252,0,252,G
1-PB2,314,0,254,0,0,254,T
1-PB2,315,0,1,258,0,259,G
1-PB2,316,261,0,0,0,261,A
1-PB2,317,0,0,0,261,261,C
1-PB2,318,259,0,1,0,260,A
1-PB2,319,259,0,0,0,259,A
1-PB2,320,0,0,261,0,261,G
1-PB2,321,0,261,0,0,261,T
1-PB2,322,261,0,1,0,262,A
1-PB2,323,0,0,0,263,263,C
1-PB2,324,0,0,259,0,259,G
1-PB2,325,0,0,268,0,268,G
1-PB2,326,0,266,0,0,266,T
1-PB2,327,0,0,0,269,269,C
1-PB2,328,3,0,0,264,267,C
1-PB2,329,265,0,0,0,265,A
1-PB2,330,0,267,0,0,267,T
1-PB2,331,0,267,0,0,267,T
1-PB2,332,277,0,0,0,277,A
1-PB2,333,0,0,0,275,275,C
1-PB2,334,1,0,0,267,268,C
1-PB2,335,0,0,0,269,269,C
1-PB2,336,261,0,1,0,262,A
1-PB2,337,268,0,0,0,268,A
1-PB2,338,267,0,1,0,268,A
1-PB2,339,266,1,0,0,267,A
1-PB2,340,0,1,267,0,268,G
1-PB2,341,0,255,0,0,255,T
1-PB2,342,0,1,261,0,262,G
1-PB2,343,0,262,0,0,262,T
1-PB2,344,261,1,0,0,262,A
1-PB2,345,0,0,0,262,262,C
1-PB2,346,258,1,0,1,260,A
1-PB2,347,259,1,0,0,260,A
1-PB2,348,1,1,258,0,260,G
1-PB2,349,257,0,0,1,258,A
1-PB2,350,0,0,0,259,259,C
1-PB2,351,0,251,0,0,251,T
1-PB2,352,0,258,0,0,258,T
1-PB2,353,257,0,0,1,258,A
1-PB2,354,0,257,0,1,258,T
1-PB2,355,0,257,0,0,257,T
1-PB2,356,1,253,0,1,255,T
1-PB2,357,3,0,0,250,253,C
1-PB2,358,0,1,252,0,253,G
1-PB2,359,251,1,0,1,253,A
1-PB2,360,0,0,0,252,252,C
1-PB2,361,251,0,0,0,251,A
1-PB2,362,251,0,0,0,251,A
1-PB2,363,246,0,0,1,247,A
1-PB2,364,0,0,250,0,250,G
1-PB2,365,0,250,0,0,250,T
1-PB2,366,2,0,0,248,250,C
1-PB2,367,1,0,249,0,250,G
1-PB2,368,249,0,0,1,250,A
1-PB2,369,250,0,0,0,250,A
1-PB2,370,249,0,1,0,250,A
1-PB2,371,0,1,258,0,259,G
1-PB2,372,0,0,260,0,260,G
1-PB2,373,0,255,0,0,255,T
1-PB2,374,0,254,0,0,254,T
1-PB2,375,254,0,0,0,254,A
1-PB2,376,254,0,0,0,254,A
1-PB2,377,254,0,0,0,254,A
1-PB2,378,258,0,0,0,258,A
1-PB2,379,0,0,0,261,261,C
1-PB2,380,257,0,0,0,257,A
1-PB2,381,0,257,0,0,257,T
1-PB2,382,0,0,258,0,258,G
1-PB2,383,0,1,259,0,260,G
1-PB2,384,259,0,1,0,260,A
1-PB2,385,261,0,0,0,261,A
1-PB2,386,0,0,0,270,270,C
1-PB2,387,1,0,0,269,270,C
1-PB2,388,0,265,0,2,267,T
1-PB2,389,0,263,0,0,263,T
1-PB2,390,0,265,0,0,265,T
1-PB2,391,1,0,265,0,266,G
1-PB2,392,0,0,269,0,269,G
1-PB2,393,0,0,0,271,271,C
1-PB2,394,1,0,0,265,266,C
1-PB2,395,1,0,0,265,266,C
1-PB2,396,1,252,0,2,255,T
1-PB2,397,0,0,257,0,257,G
1-PB2,398,0,255,0,1,256,T
1-PB2,399,0,257,0,0,257,T
1-PB2,400,0,0,0,258,258,C
1-PB2,401,254,0,0,0,254,A
1-PB2,402,0,255,0,0,255,T
1-PB2,403,0,254,0,0,254,T
1-PB2,404,0,257,0,1,258,T
1-PB2,405,0,258,0,0,258,T
1-PB2,406,254,0,0,0,254,A
1-PB2,407,0,1,252,0,253,G
1-PB2,408,254,0,0,0,254,A
1-PB2,409,254,0,0,0,254,A
1-PB2,410,253,0,0,0,253,A
1-PB2,411,0,253,0,1,254,T
1-PB2,412,1,0,0,252,253,C
1-PB2,413,252,0,0,0,252,A
1-PB2,414,253,0,0,0,253,A
1-PB2,415,0,0,253,0,253,G
1-PB2,416,0,253,0,1,254,T
1-PB2,417,4,0,0,249,253,C
1-PB2,418,256,0,0,0,256,A
1-PB2,419,256,0,0,0,256,A
1-PB2,420,1,0,255,0,256,G
1-PB2,421,256,0,2,0,258,A
1-PB2,422,0,257,0,0,257,T
1-PB2,423,260,0,0,0,260,A
1-PB2,424,0,1,0,256,257,C
1-PB2,425,0,0,258,0,258,G
1-PB2,426,1,1,0,261,263,C
1-PB2,427,257,0,1,0,258,A
1-PB2,428,0,0,264,0,264,G
1-PB2,429,264,0,0,0,264,A
1-PB2,430,265,0,1,0,266,A
1-PB2,431,0,1,274,0,275,G
1-PB2,432,271,0,1,0,272,A
1-PB2,433,0,0,273,0,273,G
1-PB2,434,0,271,0,0,271,T
1-PB2,435,272,0,0,0,272,A
1-PB2,436,0,3,270,0,273,G
1-PB2,437,280,0,0,0,280,A
1-PB2,438,0,0,0,293,293,C
1-PB2,439,289,0,0,0,289,A
1-PB2,440,0,285,0,0,285,T
1-PB2,441,285,0,0,0,285,A
1-PB2,442,281,0,0,0,281,A
1-PB2,443,281,0,0,0,281,A
1-PB2,444,0,0,0,283,283,C
1-PB2,445,0,0,0,278,278,C
1-PB2,446,1,0,0,275,276,C
1-PB2,447,0,258,0,0,258,T
1-PB2,448,0,1,258,0,259,G
1-PB2,449,0,0,260,0,260,G
1-PB2,450,0,259,0,0,259,T
1-PB2,451,5,0,0,252,257,C
1-PB2,452,261,0,0,0,261,A
1-PB2,453,0,258,0,1,259,T
1-PB2,454,0,0,260,0,260,G
1-PB2,455,0,0,0,260,260,C
1-PB2,456,259,0,0,0,259,A
1-PB2,457,0,0,261,0,261,G
1-PB2,458,255,0,1,0,256,A
1-PB2,459,0,0,0,259,259,C
1-PB2,460,0,0,0,257,257,C
1-PB2,461,0,251,0,1,252,T
1-PB2,462,1,0,1,249,251,C
1-PB2,463,252,0,0,0,252,A
1-PB2,464,0,0,253,0,253,G
1-PB2,465,0,252,0,1,253,T
1-PB2,466,0,0,254,0,254,G
1-PB2,467,0,0,0,252,252,C
1-PB2,468,3,0,0,248,251,C
1-PB2,469,251,0,0,0,251,A
1-PB2,470,250,0,0,0,250,A
1-PB2,471,248,0,1,0,249,A
1-PB2,472,0,1,248,0,249,G
1-PB2,473,244,0,1,0,245,A
1-PB2,474,0,2,245,0,247,G
1-PB2,475,0,1,245,0,246,G
1-PB2,476,0,0,0,248,248,C
1-PB2,477,248,0,0,0,248,A
1-PB2,478,0,1,0,247,248,C
1-PB2,479,248,0,0,0,248,A
1-PB2,480,251,0,0,0,251,A
1-PB2,481,0,1,250,0,251,G
1-PB2,482,249,0,2,0,251,A
1-PB2,483,0,247,0,0,247,T
1-PB2,484,0,0,246,0,246,G
1-PB2,485,0,246,0,0,246,T
1-PB2,486,245,0,0,0,245,A
1-PB2,487,244,0,0,0,244,A
1-PB2,488,0,245,0,1,246,T
1-PB2,489,0,237,0,0,237,T
1-PB2,490,237,0,1,0,238,A
1-PB2,491,0,233,0,0,233,T
1-PB2,492,0,1,233,0,234,G
1-PB2,493,0,1,233,0,234,G
1-PB2,494,229,0,0,0,229,A
1-PB2,495,227,0,0,0,227,A
1-PB2,496,0,0,227,0,227,G
1-PB2,497,0,227,0,0,227,T
1-PB2,498,0,226,0,0,226,T
1-PB2,499,0,0,228,0,228,G
1-PB2,500,0,228,0,1,229,T
1-PB2,501,0,228,0,0,228,T
1-PB2,502,0,227,0,1,228,T
1-PB2,503,0,227,0,0,227,T
1-PB2,504,0,227,0,1,228,T
1-PB2,505,1,0,0,227,228,C
1-PB2,506,1,0,0,225,226,C
1-PB2,507,1,0,1,224,226,C
1-PB2,508,224,0,0,0,224,A
1-PB2,509,223,1,0,0,224,A
1-PB2,510,0,225,0,0,225,T
1-PB2,511,0,1,225,0,226,G
1-PB2,512,225,0,0,0,225,A
1-PB2,513,224,0,0,0,224,A
1-PB2,514,0,0,224,0,224,G
1-PB2,515,0,225,0,0,225,T
1-PB2,516,0,1,220,1,222,G
1-PB2,517,0,1,222,0,223,G
1-PB2,518,0,0,224,0,224,G
1-PB2,519,224,0,0,0,224,A
1-PB2,520,0,0,225,0,225,G
1-PB2,521,0,0,0,224,224,C
1-PB2,522,0,0,0,225,225,C
1-PB2,523,226,0,1,0,227,A
1-PB2,524,0,0,239,0,239,G
1-PB2,525,0,0,239,0,239,G
1-PB2,526,239,0,1,0,240,A
1-PB2,527,0,236,0,1,237,T
1-PB2,528,243,0,0,0,243,A
1-PB2,529,0,0,0,241,241,C
1-PB2,530,0,241,0,0,241,T
1-PB2,531,240,0,0,0,240,A
1-PB2,532,238,0,0,0,238,A
1-PB2,533,0,0,0,239,239,C
1-PB2,534,234,0,0,0,234,A
1-PB2,535,0,229,0,0,229,T
1-PB2,536,0,0,0,232,232,C
1-PB2,537,231,0,0,0,231,A
1-PB2,538,0,0,236,0,236,G
1-PB2,539,237,0,0,0,237,A
1-PB2,540,236,0,0,0,236,A
1-PB2,541,0,234,0,1,235,T
1-PB2,542,2,1,0,231,234,C
1-PB2,543,235,0,0,0,235,A
1-PB2,544,0,0,0,237,237,C
1-PB2,545,239,0,0,0,239,A
1-PB2,546,241,0,0,0,241,A
1-PB2,547,0,239,0,0,239,T
1-PB2,548,0,238,0,0,238,T
1-PB2,549,242,0,0,0,242,A
1-PB2,550,244,0,0,0,244,A
1-PB2,551,0,0,0,244,244,C
1-PB2,552,244,0,0,0,244,A
1-PB2,553,241,0,0,0,241,A
1-PB2,554,0,242,0,0,242,T
1-PB2,555,242,0,1,0,243,A
1-PB2,556,244,0,0,0,244,A
1-PB2,557,0,0,0,243,243,C
1-PB2,558,0,242,0,0,242,T
1-PB2,559,240,0,0,0,240,A
1-PB2,560,239,0,0,0,239,A
1-PB2,561,239,0,0,0,239,A
1-PB2,562,0,0,239,0,239,G
1-PB2,563,239,0,0,0,239,A
1-PB2,564,0,0,242,0,242,G
1-PB2,565,241,0,0,0,241,A
1-PB2,566,241,0,0,0,241,A
1-PB2,567,239,0,0,0,239,A
1-PB2,568,240,0,0,0,240,A
1-PB2,569,238,0,1,0,239,A
1-PB2,570,239,0,0,0,239,A
1-PB2,571,0,0,243,0,243,G
1-PB2,572,243,0,0,0,243,A
1-PB2,573,240,0,0,0,240,A
1-PB2,574,0,1,239,0,240,G
1-PB2,575,240,0,0,0,240,A
1-PB2,576,242,0,0,0,242,A
1-PB2,577,0,0,0,243,243,C
1-PB2,578,0,236,0,1,237,T
1-PB2,579,2,0,0,237,239,C
1-PB2,580,2,1,0,237,240,C
1-PB2,581,0,2,239,0,241,G
1-PB2,582,239,0,1,0,240,A
1-PB2,583,0,0,239,0,239,G
1-PB2,584,235,0,1,0,236,A
1-PB2,585,0,234,0,0,234,T
1-PB2,586,0,229,0,0,229,T
1-PB2,587,2,1,225,0,228,G
1-PB2,588,0,0,0,228,228,C
1-PB2,589,229,0,0,0,229,A
1-PB2,590,230,0,0,0,230,A
1-PB2,591,229,0,0,0,229,A
1-PB2,592,232,0,0,0,232,A
1-PB2,593,0,231,0,0,231,T
1-PB2,594,0,228,0,2,230,T
1-PB2,595,0,227,0,2,229,T
1-PB2,596,0,0,0,230,230,C
1-PB2,597,0,226,0,1,227,T
1-PB2,598,0,0,0,239,239,C
1-PB2,599,0,0,0,240,240,C
1-PB2,600,3,0,0,244,247,C
1-PB2,601,0,247,0,0,247,T
1-PB2,602,0,250,0,0,250,T
1-PB2,603,0,0,249,0,249,G
1-PB2,604,248,0,1,0,249,A
1-PB2,605,0,257,0,0,257,T
1-PB2,606,0,0,257,0,257,G
1-PB2,607,0,0,266,0,266,G
1-PB2,608,0,267,0,0,267,T
1-PB2,609,0,267,0,0,267,T
1-PB2,610,0,0,275,0,275,G
1-PB2,611,0,1,0,274,275,C
1-PB2,612,277,0,1,0,278,A
1-PB2,613,0,277,0,0,277,T
1-PB2,614,279,0,0,0,279,A
1-PB2,615,0,0,0,287,287,C
1-PB2,616,300,0,0,1,301,A
1-PB2,617,0,301,0,0,301,T
1-PB2,618,0,0,317,0,317,G
1-PB2,619,0,310,0,0,310,T
1-PB2,620,0,309,0,0,309,T
1-PB2,621,312,0,0,0,312,A
1-PB2,622,0,3,311,0,314,G
1-PB2,623,312,0,0,0,312,A
1-PB2,624,0,0,317,0,317,G
1-PB2,625,296,0,2,0,298,A
1-PB2,626,0,2,292,1,295,G
1-PB2,627,291,0,0,0,291,A
1-PB2,628,0,1,292,0,293,G
1-PB2,629,291,0,1,0,292,A
1-PB2,630,293,0,0,0,293,A
1-PB2,631,0,1,0,292,293,C
1-PB2,632,0,291,0,0,291,T
1-PB2,633,0,292,0,0,292,T
1-PB2,634,0,0,293,0,293,G
1-PB2,635,0,294,0,0,294,T
1-PB2,636,293,1,0,0,294,A
1-PB2,637,0,3,0,290,293,C
1-PB2,638,1,0,292,0,293,G
1-PB2,639,293,0,1,0,294,A
1-PB2,640,292,0,0,0,292,A
1-PB2,641,297,0,0,0,297,A
1-PB2,642,298,0,0,0,298,A
1-PB2,643,297,0,0,0,297,A
1-PB2,644,0,0,0,297,297,C
1-PB2,645,298,0,0,0,298,A
1-PB2,646,298,0,0,0,298,A
1-PB2,647,0,3,301,0,304,G
1-PB2,648,305,0,0,0,305,A
1-PB2,649,0,305,0,0,305,T
1-PB2,650,0,304,0,0,304,T
1-PB2,651,0,302,0,2,304,T
1-PB2,652,2,0,0,302,304,C
1-PB2,653,0,304,0,1,305,T
1-PB2,654,3,0,0,301,304,C
1-PB2,655,1,0,0,303,304,C
1-PB2,656,1,0,0,307,308,C
1-PB2,657,307,0,1,0,308,A
1-PB2,658,0,0,311,0,311,G
1-PB2,659,0,313,0,0,313,T
1-PB2,660,1,312,0,0,313,T
1-PB2,661,0,0,313,0,313,G
1-PB2,662,0,0,0,311,311,C
1-PB2,663,1,310,0,0,311,T
1-PB2,664,0,0,312,1,313,G
1-PB2,665,0,0,310,0,310,G
1-PB2,666,0,0,0,309,309,C
1-PB2,667,0,0,313,0,313,G
1-PB2,668,0,3,315,0,318,G
1-PB2,669,316,0,0,0,316,A
1-PB2,670,317,0,1,0,318,A
1-PB2,671,0,0,0,319,319,C
1-PB2,672,316,0,0,0,316,A
1-PB2,673,318,0,0,0,318,A
1-PB2,674,1,0,326,0,327,G
1-PB2,675,0,1,0,330,331,C
1-PB2,676,335,0,0,0,335,A
1-PB2,677,0,0,385,0,385,G
1-PB2,678,0,385,0,1,386,T
1-PB2,679,386,0,2,0,388,A
1-PB2,680,0,388,0,0,388,T
1-PB2,681,389,0,0,0,389,A
1-PB2,682,0,388,0,0,388,T
1-PB2,683,375,0,0,0,375,A
1-PB2,684,0,0,0,377,377,C
1-PB2,685,361,0,0,0,361,A
1-PB2,686,0,344,0,0,344,T
1-PB2,687,0,335,0,0,335,T
1-PB2,688,0,2,335,0,337,G
1-PB2,689,338,0,0,0,338,A
1-PB2,690,336,0,0,0,336,A
1-PB2,691,0,0,344,0,344,G
1-PB2,692,0,342,0,0,342,T
1-PB2,693,0,343,0,0,343,T
1-PB2,694,0,342,1,0,343,T
1-PB2,695,0,343,0,0,343,T
1-PB2,696,345,0,0,0,345,A
1-PB2,697,0,0,0,345,345,C
1-PB2,698,344,0,0,0,344,A
1-PB2,699,0,343,0,0,343,T
1-PB2,700,0,343,1,0,344,T
1-PB2,701,0,346,0,0,346,T
1-PB2,702,0,5,343,1,349,G
1-PB2,703,351,0,0,0,351,A
1-PB2,704,0,0,0,350,350,C
1-PB2,705,0,350,0,0,350,T
1-PB2,706,0,0,0,345,345,C
1-PB2,707,343,0,0,0,343,A
1-PB2,708,0,1,338,0,339,G
1-PB2,709,0,1,342,0,343,G
1-PB2,710,0,4,339,0,343,G
1-PB2,711,343,0,0,0,343,A
1-PB2,712,342,0,1,0,343,A
1-PB2,713,1,0,0,342,343,C
1-PB2,714,0,1,344,0,345,G
1-PB2,715,0,344,0,0,344,T
1-PB2,716,0,0,345,0,345,G
1-PB2,717,0,342,0,1,343,T
1-PB2,718,0,344,0,0,344,T
1-PB2,719,0,0,346,0,346,G
1-PB2,720,0,1,343,0,344,G
1-PB2,721,0,3,346,0,349,G
1-PB2,722,344,0,3,0,347,A
1-PB2,723,345,0,0,1,346,A
1-PB2,724,1,0,0,347,348,C
1-PB2,725,347,0,0,0,347,A
1-PB2,726,359,0,1,0,360,A
1-PB2,727,359,0,0,0,359,A
1-PB2,728,0,362,0,0,362,T
1-PB2,729,1,0,364,0,365,G
1-PB2,730,0,361,0,0,361,T
1-PB2,731,360,0,1,0,361,A
1-PB2,732,0,0,0,361,361,C
1-PB2,733,352,0,0,0,352,A
1-PB2,734,5,0,0,345,350,C
1-PB2,735,0,340,0,1,341,T
1-PB2,736,2,0,0,353,355,C
1-PB2,737,0,0,0,354,354,C
1-PB2,738,357,0,1,0,358,A
1-PB2,739,0,1,358,0,359,G
1-PB2,740,0,2,366,0,368,G
1-PB2,741,0,368,0,0,368,T
1-PB2,742,0,1,365,0,366,G
1-PB2,743,0,1,359,0,360,G
1-PB2,744,358,0,1,0,359,A
1-PB2,745,0,1,358,0,359,G
1-PB2,746,0,2,357,0,359,G
1-PB2,747,345,0,0,0,345,A
1-PB2,748,0,0,346,0,346,G
1-PB2,749,0,341,0,0,341,T
1-PB2,750,0,1,339,0,340,G
1-PB2,751,340,0,1,1,342,A
1-PB2,752,0,0,345,0,345,G
1-PB2,753,0,0,343,0,343,G
1-PB2,754,341,0,0,0,341,A
1-PB2,755,340,0,0,0,340,A
1-PB2,756,0,344,0,0,344,T
1-PB2,757,0,0,341,0,341,G
1-PB2,758,342,0,0,0,342,A
1-PB2,759,0,0,0,339,339,C
1-PB2,760,1,2,337,0,340,G
1-PB2,761,342,0,0,0,342,A
1-PB2,762,0,347,0,0,347,T
1-PB2,763,0,0,350,0,350,G
1-PB2,764,0,347,0,0,347,T
1-PB2,765,0,344,0,0,344,T
1-PB2,766,1,6,340,0,347,G
1-PB2,767,346,0,1,0,347,A
1-PB2,768,0,1,0,345,346,C
1-PB2,769,1,1,0,344,346,C
1-PB2,770,342,0,0,0,342,A
1-PB2,771,342,2,0,0,344,A
1-PB2,772,343,0,0,0,343,A
1-PB2,773,1,0,354,0,355,G
1-PB2,774,0,0,0,355,355,C
1-PB2,775,0,0,0,354,354,C
1-PB2,776,0,350,0,0,350,T
1-PB2,777,351,1,0,0,352,A
1-PB2,778,354,0,0,0,354,A
1-PB2,779,0,352,0,0,352,T
1-PB2,780,0,352,0,0,352,T
1-PB2,781,344,0,0,0,344,A
1-PB2,782,0,340,0,0,340,T
1-PB2,783,0,340,0,0,340,T
1-PB2,784,1,0,338,0,339,G
1-PB2,785,0,0,0,332,332,C
1-PB2,786,1,0,335,0,336,G
1-PB2,787,1,0,345,0,346,G
1-PB2,788,0,0,0,345,345,C
1-PB2,789,2,0,0,343,345,C
1-PB2,790,345,0,0,0,345,A
1-PB2,791,0,0,350,0,350,G
1-PB2,792,0,1,350,0,351,G
1-PB2,793,352,0,0,0,352,A
1-PB2,794,353,0,0,0,353,A
1-PB2,795,1,1,0,352,354,C
1-PB2,796,349,0,1,0,350,A
1-PB2,797,0,352,0,0,352,T
1-PB2,798,357,0,0,0,357,A
1-PB2,799,0,0,358,0,358,G
1-PB2,800,0,355,0,0,355,T
1-PB2,801,353,0,0,0,353,A
1-PB2,802,353,0,0,1,354,A
1-PB2,803,0,0,353,0,353,G
1-PB2,804,352,0,1,0,353,A
1-PB2,805,348,0,0,0,348,A
1-PB2,806,0,1,350,0,351,G
1-PB2,807,339,0,2,0,341,A
1-PB2,808,0,1,344,0,345,G
1-PB2,809,0,1,0,344,345,C
1-PB2,810,2,0,0,342,344,C
1-PB2,811,1,0,344,0,345,G
1-PB2,812,0,0,0,347,347,C
1-PB2,813,348,0,0,0,348,A
1-PB2,814,0,1,374,0,375,G
1-PB2,815,0,376,0,0,376,T
1-PB2,816,376,0,0,0,376,A
1-PB2,817,0,373,0,0,373,T
1-PB2,818,2,0,0,374,376,C
1-PB2,819,373,0,1,0,374,A
1-PB2,820,0,0,375,0,375,G
1-PB2,821,2,1,0,371,374,C
1-PB2,822,361,0,0,0,361,A
1-PB2,823,0,0,355,0,355,G
1-PB2,824,355,0,1,0,356,A
1-PB2,825,1,353,0,0,354,T
1-PB2,826,0,0,0,357,357,C
1-PB2,827,0,0,0,357,357,C
1-PB2,828,355,0,0,0,355,A
1-PB2,829,0,0,0,354,354,C
1-PB2,830,0,355,0,0,355,T
1-PB2,831,353,0,2,0,355,A
1-PB2,832,0,0,353,0,353,G
1-PB2,833,1,0,0,350,351,C
1-PB2,834,352,0,0,0,352,A
1-PB2,835,0,347,0,2,349,T
1-PB2,836,0,0,0,354,354,C
1-PB2,837,0,351,0,0,351,T
1-PB2,838,0,352,1,0,353,T
1-PB2,839,0,353,0,0,353,T
1-PB2,840,351,0,0,0,351,A
1-PB2,841,0,353,0,0,353,T
1-PB2,842,0,348,0,0,348,T
1-PB2,843,0,0,348,0,348,G
1-PB2,844,0,0,347,0,347,G
1-PB2,845,338,0,1,0,339,A
1-PB2,846,0,1,339,0,340,G
1-PB2,847,336,0,0,0,336,A
1-PB2,848,0,333,0,0,333,T
1-PB2,849,0,0,337,0,337,G
1-PB2,850,0,333,0,1,334,T
1-PB2,851,0,0,335,0,335,G
1-PB2,852,0,0,0,335,335,C
1-PB2,853,0,1,0,332,333,C
1-PB2,854,333,0,0,0,333,A
1-PB2,855,0,1,0,331,332,C
1-PB2,856,329,0,1,0,330,A
1-PB2,857,0,0,341,0,341,G
1-PB2,858,0,0,0,332,332,C
1-PB2,859,331,0,1,0,332,A
1-PB2,860,0,0,0,333,333,C
1-PB2,861,331,0,1,0,332,A
1-PB2,862,0,0,0,332,332,C
1-PB2,863,331,0,0,0,331,A
1-PB2,864,331,0,0,0,331,A
1-PB2,865,331,0,0,0,331,A
1-PB2,866,0,322,0,0,322,T
1-PB2,867,0,320,0,0,320,T
1-PB2,868,0,0,318,0,318,G
1-PB2,869,0,0,318,0,318,G
1-PB2,870,0,0,0,318,318,C
1-PB2,871,0,0,317,0,317,G
1-PB2,872,0,1,318,0,319,G
1-PB2,873,0,2,320,0,322,G
1-PB2,874,319,0,0,0,319,A
1-PB2,875,1,1,0,319,321,C
1-PB2,876,321,0,1,0,322,A
1-PB2,877,325,0,0,0,325,A
1-PB2,878,0,0,324,0,324,G
1-PB2,879,0,1,322,0,323,G
1-PB2,880,323,0,0,0,323,A
1-PB2,881,0,314,0,0,314,T
1-PB2,882,0,0,302,0,302,G
1-PB2,883,0,0,304,0,304,G
1-PB2,884,0,300,0,0,300,T
1-PB2,885,1,1,296,0,298,G
1-PB2,886,0,1,298,0,299,G
1-PB2,887,290,0,0,0,290,A
1-PB2,888,0,0,0,290,290,C
1-PB2,889,280,0,1,0,281,A
1-PB2,890,0,298,0,0,298,T
1-PB2,891,0,292,0,0,292,T
1-PB2,892,1,0,0,289,290,C
1-PB2,893,0,281,0,0,281,T
1-PB2,894,0,282,0,0,282,T
1-PB2,895,282,0,1,0,283,A
1-PB2,896,0,0,281,0,281,G
1-PB2,897,272,0,6,0,278,A
1-PB2,898,0,0,0,278,278,C
1-PB2,899,205,0,1,0,206,A
1-PB2,900,0,0,206,0,206,G
1-PB2,901,204,0,0,0,204,A
1-PB2,902,205,0,0,0,205,A
1-PB2,903,0,0,0,206,206,C
1-PB2,904,1,0,0,203,204,C
1-PB2,905,1,0,0,206,207,C
1-PB2,906,0,2,205,0,207,G
1-PB2,907,207,0,0,0,207,A
1-PB2,908,1,0,0,206,207,C
1-PB2,909,0,198,0,0,198,T
1-PB2,910,0,0,197,0,197,G
1-PB2,911,194,0,0,0,194,A
1-PB2,912,194,0,0,0,194,A
1-PB2,913,0,2,195,0,197,G
1-PB2,914,194,0,1,0,195,A
1-PB2,915,197,0,0,0,197,A
1-PB2,916,0,0,0,196,196,C
1-PB2,917,195,0,0,0,195,A
1-PB2,918,193,0,0,0,193,A
1-PB2,919,0,0,198,0,198,G
1-PB2,920,1,0,0,196,197,C
1-PB2,921,0,193,0,0,193,T
1-PB2,922,0,3,193,0,196,G
1-PB2,923,0,197,0,0,197,T
1-PB2,924,0,0,198,0,198,G
1-PB2,925,0,0,203,0,203,G
1-PB2,926,205,0,0,0,205,A
1-PB2,927,0,204,0,0,204,T
1-PB2,928,199,0,0,0,199,A
1-PB2,929,0,197,0,0,197,T
1-PB2,930,205,0,1,0,206,A
1-PB2,931,0,201,0,0,201,T
1-PB2,932,0,2,198,0,200,G
1-PB2,933,0,0,0,200,200,C
1-PB2,934,194,0,0,0,194,A
1-PB2,935,193,0,0,0,193,A
1-PB2,936,0,0,192,0,192,G
1-PB2,937,0,0,192,0,192,G
1-PB2,938,0,0,0,193,193,C
1-PB2,939,0,190,0,0,190,T
1-PB2,940,0,0,191,0,191,G
1-PB2,941,0,0,0,191,191,C
1-PB2,942,191,0,0,0,191,A
1-PB2,943,190,0,0,0,190,A
1-PB2,944,0,189,0,0,189,T
1-PB2,945,0,0,192,0,192,G
1-PB2,946,0,0,190,0,190,G
1-PB2,947,0,0,190,0,190,G
1-PB2,948,191,0,0,0,191,A
1-PB2,949,0,191,0,0,191,T
1-PB2,950,0,187,0,0,187,T
1-PB2,951,0,2,187,0,189,G
1-PB2,952,187,0,2,0,189,A
1-PB2,953,0,1,189,0,190,G
1-PB2,954,187,0,1,0,188,A
1-PB2,955,186,0,0,0,186,A
1-PB2,956,0,186,0,0,186,T
1-PB2,957,1,0,0,188,189,C
1-PB2,958,186,0,0,0,186,A
1-PB2,959,0,0,188,0,188,G
1-PB2,960,0,1,0,187,188,C
1-PB2,961,0,187,0,0,187,T
1-PB2,962,2,0,0,182,184,C
1-PB2,963,184,0,0,0,184,A
1-PB2,964,0,190,0,0,190,T
1-PB2,965,1,1,0,189,191,C
1-PB2,966,0,0,0,198,198,C
1-PB2,967,0,194,0,1,195,T
1-PB2,968,1,193,0,0,194,T
1-PB2,969,0,0,0,195,195,C
1-PB2,970,196,0,0,0,196,A
1-PB2,971,0,0,198,0,198,G
1-PB2,972,0,0,0,197,197,C
1-PB2,973,0,195,0,0,195,T
1-PB2,974,0,194,0,0,194,T
1-PB2,975,0,190,0,0,190,T
1-PB2,976,0,1,191,0,192,G
1-PB2,977,0,0,192,0,192,G
1-PB2,978,0,193,0,0,193,T
1-PB2,979,0,0,193,0,193,G
1-PB2,980,0,2,190,0,192,G
1-PB2,981,0,0,196,0,196,G
1-PB2,982,0,194,0,0,194,T
1-PB2,983,0,192,0,0,192,T
1-PB2,984,0,192,0,0,192,T
1-PB2,985,195,0,0,0,195,A
1-PB2,986,0,0,0,195,195,C
1-PB2,987,196,0,0,0,196,A
1-PB2,988,0,194,0,0,194,T
1-PB2,989,0,195,0,0,195,T
1-PB2,990,0,194,0,0,194,T
1-PB2,991,192,0,0,0,192,A
1-PB2,992,193,0,0,0,193,A
1-PB2,993,193,0,0,0,193,A
1-PB2,994,191,0,0,0,191,A
1-PB2,995,0,0,192,0,192,G
1-PB2,996,191,0,0,0,191,A
1-PB2,997,191,0,0,0,191,A
1-PB2,998,0,0,0,190,190,C
1-PB2,999,189,0,0,0,189,A
1-PB2,1000,190,0,0,0,190,A
1-PB2,1001,0,0,188,0,188,G
1-PB2,1002,1,0,0,184,185,C
1-PB2,1003,0,2,186,0,188,G
1-PB2,1004,0,1,188,0,189,G
1-PB2,1005,0,0,186,0,186,G
1-PB2,1006,0,187,0,1,188,T
1-PB2,1007,1,0,0,188,189,C
1-PB2,1008,187,0,0,0,187,A
1-PB2,1009,1,187,0,0,188,T
1-PB2,1010,0,0,0,189,189,C
1-PB2,1011,188,1,0,0,189,A
1-PB2,1012,0,0,195,0,195,G
1-PB2,1013,0,193,0,0,193,T
1-PB2,1014,1,0,0,192,193,C
1-PB2,1015,192,0,1,0,193,A
1-PB2,1016,196,0,0,0,196,A
1-PB2,1017,195,0,0,0,195,A
1-PB2,1018,195,0,0,0,195,A
1-PB2,1019,196,0,0,0,196,A
1-PB2,1020,196,0,0,0,196,A
1-PB2,1021,0,1,196,0,197,G
1-PB2,1022,196,0,0,0,196,A
1-PB2,1023,196,0,0,0,196,A
1-PB2,1024,0,0,195,0,195,G
1-PB2,1025,197,0,0,0,197,A
1-PB2,1026,185,0,0,0,185,A
1-PB2,1027,0,0,187,0,187,G
1-PB2,1028,186,0,0,0,186,A
1-PB2,1029,0,0,185,0,185,G
1-PB2,1030,0,0,189,0,189,G
1-PB2,1031,0,188,0,0,188,T
1-PB2,1032,0,0,189,0,189,G
1-PB2,1033,0,0,0,188,188,C
1-PB2,1034,0,189,0,1,190,T
1-PB2,1035,0,191,0,0,191,T
1-PB2,1036,191,0,0,0,191,A
1-PB2,1037,0,0,0,190,190,C
1-PB2,1038,190,0,0,0,190,A
1-PB2,1039,0,0,193,0,193,G
1-PB2,1040,0,1,190,0,191,G
1-PB2,1041,0,0,0,190,190,C
1-PB2,1042,186,0,0,0,186,A
1-PB2,1043,192,0,0,0,192,A
1-PB2,1044,0,193,0,1,194,T
1-PB2,1045,0,0,0,195,195,C
1-PB2,1046,0,198,0,0,198,T
1-PB2,1047,0,0,0,196,196,C
1-PB2,1048,0,0,0,195,195,C
1-PB2,1049,195,0,0,0,195,A
1-PB2,1050,195,0,0,0,195,A
1-PB2,1051,195,0,0,0,195,A
1-PB2,1052,0,0,0,196,196,C
1-PB2,1053,191,0,0,0,191,A
1-PB2,1054,0,190,0,0,190,T
1-PB2,1055,0,194,0,0,194,T
1-PB2,1056,0,0,198,0,198,G
1-PB2,1057,200,0,0,0,200,A
1-PB2,1058,204,0,0,0,204,A
1-PB2,1059,203,0,0,0,203,A
1-PB2,1060,200,0,0,0,200,A
1-PB2,1061,0,201,0,0,201,T
1-PB2,1062,197,0,1,0,198,A
1-PB2,1063,198,0,1,0,199,A
1-PB2,1064,0,0,204,0,204,G
1-PB2,1065,197,0,0,0,197,A
1-PB2,1066,0,0,200,0,200,G
1-PB2,1067,0,199,0,0,199,T
1-PB2,1068,197,0,1,0,198,A
1-PB2,1069,0,0,0,201,201,C
1-PB2,1070,200,0,0,0,200,A
1-PB2,1071,0,200,0,0,200,T
1-PB2,1072,0,0,201,0,201,G
1-PB2,1073,193,0,1,0,194,A
1-PB2,1074,0,0,196,0,196,G
1-PB2,1075,0,1,195,0,196,G
1-PB2,1076,0,1,195,0,196,G
1-PB2,1077,0,0,197,0,197,G
1-PB2,1078,0,194,0,0,194,T
1-PB2,1079,196,0,0,0,196,A
1-PB2,1080,0,195,0,0,195,T
1-PB2,1081,0,0,196,0,196,G
1-PB2,1082,194,0,0,0,194,A
1-PB2,1083,0,0,194,0,194,G
1-PB2,1084,0,0,190,0,190,G
1-PB2,1085,184,0,0,0,184,A
1-PB2,1086,0,0,184,0,184,G
1-PB2,1087,0,184,0,0,184,T
1-PB2,1088,0,187,0,0,187,T
1-PB2,1089,1,0,0,183,184,C
1-PB2,1090,184,1,2,0,187,A
1-PB2,1091,0,0,0,187,187,C
1-PB2,1092,185,0,0,0,185,A
1-PB2,1093,192,0,1,0,193,A
1-PB2,1094,0,191,0,0,191,T
1-PB2,1095,0,0,183,0,183,G
1-PB2,1096,0,0,183,0,183,G
1-PB2,1097,0,181,0,0,181,T
1-PB2,1098,0,1,180,0,181,G
1-PB2,1099,0,0,183,0,183,G
1-PB2,1100,0,0,183,0,183,G
1-PB2,1101,0,2,184,0,186,G
1-PB2,1102,183,0,1,0,184,A
1-PB2,1103,184,0,0,0,184,A
1-PB2,1104,183,0,0,0,183,A
1-PB2,1105,184,0,1,0,185,A
1-PB2,1106,0,0,185,0,185,G
1-PB2,1107,187,0,0,0,187,A
1-PB2,1108,0,0,187,0,187,G
1-PB2,1109,0,0,0,187,187,C
1-PB2,1110,185,0,0,0,185,A
1-PB2,1111,183,0,1,0,184,A
1-PB2,1112,0,0,0,195,195,C
1-PB2,1113,195,0,0,0,195,A
1-PB2,1114,0,0,198,0,198,G
1-PB2,1115,0,0,0,197,197,C
1-PB2,1116,0,196,0,0,196,T
1-PB2,1117,198,0,0,0,198,A
1-PB2,1118,0,197,0,0,197,T
1-PB2,1119,201,0,0,0,201,A
1-PB2,1120,0,0,0,201,201,C
1-PB2,1121,0,188,0,0,188,T
1-PB2,1122,187,0,0,0,187,A
1-PB2,1123,186,0,0,0,186,A
1-PB2,1124,0,1,187,0,188,G
1-PB2,1125,186,0,0,0,186,A
1-PB2,1126,181,0,0,0,181,A
1-PB2,1127,182,0,0,0,182,A
1-PB2,1128,182,0,0,0,182,A
1-PB2,1129,0,0,185,0,185,G
1-PB2,1130,2,0,0,181,183,C
1-PB2,1131,184,0,0,0,184,A
1-PB2,1132,183,0,0,0,183,A
1-PB2,1133,0,0,0,180,180,C
1-PB2,1134,0,0,0,182,182,C
1-PB2,1135,180,0,0,0,180,A
1-PB2,1136,0,0,184,0,184,G
1-PB2,1137,183,0,0,0,183,A
1-PB2,1138,183,0,0,0,183,A
1-PB2,1139,0,0,186,0,186,G
1-PB2,1140,185,0,0,0,185,A
1-PB2,1141,0,184,0,1,185,T
1-PB2,1142,0,186,0,1,187,T
1-PB2,1143,0,0,189,0,189,G
1-PB2,1144,0,0,191,0,191,G
1-PB2,1145,0,190,0,1,191,T
1-PB2,1146,0,192,0,0,192,T
1-PB2,1147,0,1,0,192,193,C
1-PB2,1148,194,0,0,0,194,A
1-PB2,1149,0,0,202,0,202,G
1-PB2,1150,0,0,1,202,203,C
1-PB2,1151,0,204,0,0,204,T
1-PB2,1152,0,0,0,205,205,C
1-PB2,1153,201,0,0,0,201,A
1-PB2,1154,0,202,0,0,202,T
1-PB2,1155,199,1,1,0,201,A
1-PB2,1156,0,0,201,0,201,G
1-PB2,1157,1,190,0,1,192,T
1-PB2,1158,0,1,193,0,194,G
1-PB2,1159,192,0,0,0,192,A
1-PB2,1160,0,0,194,0,194,G
1-PB2,1161,0,193,0,1,194,T
1-PB2,1162,0,1,191,0,192,G
1-PB2,1163,0,0,193,0,193,G
1-PB2,1164,194,0,0,0,194,A
1-PB2,1165,193,0,0,0,193,A
1-PB2,1166,0,0,193,0,193,G
1-PB2,1167,193,0,0,0,193,A
1-PB2,1168,0,1,195,0,196,G
1-PB2,1169,196,0,0,0,196,A
1-PB2,1170,0,1,0,193,194,C
1-PB2,1171,1,0,194,0,195,G
1-PB2,1172,193,0,0,0,193,A
1-PB2,1173,195,0,0,0,195,A
1-PB2,1174,1,0,0,194,195,C
1-PB2,1175,195,0,0,0,195,A
1-PB2,1176,0,0,205,0,205,G
1-PB2,1177,0,201,0,1,202,T
1-PB2,1178,1,0,0,203,204,C
1-PB2,1179,207,0,0,0,207,A
1-PB2,1180,204,0,0,0,204,A
1-PB2,1181,0,203,0,0,203,T
1-PB2,1182,207,0,0,0,207,A
1-PB2,1183,0,0,206,0,206,G
1-PB2,1184,0,1,0,201,202,C
1-PB2,1185,0,0,0,195,195,C
1-PB2,1186,0,0,197,0,197,G
1-PB2,1187,195,0,0,0,195,A
1-PB2,1188,194,0,0,0,194,A
1-PB2,1189,0,1,198,2,201,G
1-PB2,1190,0,0,0,206,206,C
1-PB2,1191,207,0,0,0,207,A
1-PB2,1192,211,0,0,0,211,A
1-PB2,1193,1,211,0,0,212,T
1-PB2,1194,212,0,0,0,212,A
1-PB2,1195,212,0,0,0,212,A
1-PB2,1196,0,212,0,0,212,T
1-PB2,1197,0,0,0,210,210,C
1-PB2,1198,0,1,207,0,208,G
1-PB2,1199,0,203,0,0,203,T
1-PB2,1200,0,0,202,0,202,G
1-PB2,1201,0,0,200,0,200,G
1-PB2,1202,1,0,0,201,202,C
1-PB2,1203,0,1,0,200,201,C
1-PB2,1204,201,0,0,0,201,A
1-PB2,1205,0,198,0,0,198,T
1-PB2,1206,0,0,200,0,200,G
1-PB2,1207,0,0,201,0,201,G
1-PB2,1208,0,202,0,0,202,T
1-PB2,1209,0,0,202,0,202,G
1-PB2,1210,0,197,0,0,197,T
1-PB2,1211,0,201,1,0,202,T
1-PB2,1212,0,203,0,0,203,T
1-PB2,1213,0,204,0,0,204,T
1-PB2,1214,0,0,0,209,209,C
1-PB2,1215,209,0,2,0,211,A
1-PB2,1216,0,0,0,217,217,C
1-PB2,1217,215,0,0,0,215,A
1-PB2,1218,217,0,0,0,217,A
1-PB2,1219,0,0,218,0,218,G
1-PB2,1220,215,0,0,0,215,A
1-PB2,1221,8,0,209,0,217,G
1-PB2,1222,0,0,217,0,217,G
1-PB2,1223,215,0,0,0,215,A
1-PB2,1224,0,216,1,0,217,T
1-PB2,1225,0,213,0,0,213,T
1-PB2,1226,0,1,213,0,214,G
1-PB2,1227,0,0,0,209,209,C
1-PB2,1228,212,0,1,0,213,A
1-PB2,1229,0,214,0,0,214,T
1-PB2,1230,0,0,228,0,228,G
1-PB2,1231,230,0,0,0,230,A
1-PB2,1232,0,231,0,0,231,T
1-PB2,1233,229,0,0,0,229,A
1-PB2,1234,230,0,0,0,230,A
1-PB2,1235,229,0,0,0,229,A
1-PB2,1236,227,0,2,0,229,A
1-PB2,1237,0,0,231,0,231,G
1-PB2,1238,0,1,0,233,234,C
1-PB2,1239,240,0,0,0,240,A
1-PB2,1240,0,0,253,0,253,G
1-PB2,1241,0,252,0,1,253,T
1-PB2,1242,0,250,0,0,250,T
1-PB2,1243,252,0,0,0,252,A
1-PB2,1244,0,1,262,0,263,G
1-PB2,1245,259,0,0,0,259,A
1-PB2,1246,0,0,263,0,263,G
1-PB2,1247,0,0,262,0,262,G
1-PB2,1248,0,254,0,0,254,T
1-PB2,1249,0,1,254,0,255,G
1-PB2,1250,257,0,0,0,257,A
1-PB2,1251,0,1,0,253,254,C
1-PB2,1252,0,0,0,258,258,C
1-PB2,1253,0,243,0,0,243,T
1-PB2,1254,0,2,245,0,247,G
1-PB2,1255,243,0,0,0,243,A
1-PB2,1256,245,0,0,0,245,A
1-PB2,1257,0,244,0,0,244,T
1-PB2,1258,0,242,0,1,243,T
1-PB2,1259,0,245,0,0,245,T
1-PB2,1260,1,0,0,242,243,C
1-PB2,1261,2,0,242,0,244,G
1-PB2,1262,0,244,0,0,244,T
1-PB2,1263,0,0,0,244,244,C
1-PB2,1264,244,0,0,0,244,A
1-PB2,1265,248,0,0,0,248,A
1-PB2,1266,0,0,0,248,248,C
1-PB2,1267,245,0,0,0,245,A
1-PB2,1268,0,2,249,0,251,G
1-PB2,1269,251,0,0,0,251,A
1-PB2,1270,0,0,252,0,252,G
1-PB2,1271,1,0,0,253,254,C
1-PB2,1272,254,0,0,0,254,A
1-PB2,1273,255,0,0,0,255,A
1-PB2,1274,257,0,0,0,257,A
1-PB2,1275,0,253,0,0,253,T
1-PB2,1276,2,0,0,253,255,C
1-PB2,1277,253,0,0,0,253,A
1-PB2,1278,0,0,253,0,253,G
1-PB2,1279,1,0,0,253,254,C
1-PB2,1280,0,0,254,0,254,G
1-PB2,1281,0,1,265,0,266,G
1-PB2,1282,0,266,0,0,266,T
1-PB2,1283,0,266,0,0,266,T
1-PB2,1284,0,1,265,0,266,G
1-PB2,1285,266,0,1,0,267,A
1-PB2,1286,271,0,0,0,271,A
1-PB2,1287,0,0,0,275,275,C
1-PB2,1288,0,0,0,274,274,C
1-PB2,1289,1,0,0,276,277,C
1-PB2,1290,1,0,0,275,276,C
1-PB2,1291,276,0,0,1,277,A
1-PB2,1292,0,280,0,0,280,T
1-PB2,1293,1,0,279,1,281,G
1-PB2,1294,1,0,0,282,283,C
1-PB2,1295,278,0,0,0,278,A
1-PB2,1296,0,276,0,0,276,T
1-PB2,1297,0,0,0,274,274,C
1-PB2,1298,275,0,0,0,275,A
1-PB2,1299,0,1,283,0,284,G
1-PB2,1300,0,0,0,281,281,C
1-PB2,1301,0,281,0,0,281,T
1-PB2,1302,0,280,0,0,280,T
1-PB2,1303,0,279,0,1,280,T
1-PB2,1304,0,280,0,0,280,T
1-PB2,1305,282,0,0,0,282,A
1-PB2,1306,281,0,0,0,281,A
1-PB2,1307,0,1,282,0,283,G
1-PB2,1308,0,0,283,0,283,G
1-PB2,1309,0,0,0,284,284,C
1-PB2,1310,284,0,0,0,284,A
1-PB2,1311,0,284,0,0,284,T
1-PB2,1312,0,280,0,0,280,T
1-PB2,1313,0,282,0,0,282,T
1-PB2,1314,0,282,0,1,283,T
1-PB2,1315,1,0,0,281,282,C
1-PB2,1316,279,0,2,0,281,A
1-PB2,1317,0,0,282,0,282,G
1-PB2,1318,281,0,0,0,281,A
1-PB2,1319,277,0,0,0,277,A
1-PB2,1320,282,0,0,0,282,A
1-PB2,1321,0,0,283,0,283,G
1-PB2,1322,284,0,0,0,284,A
1-PB2,1323,0,284,0,0,284,T
1-PB2,1324,1,0,283,0,284,G
1-PB2,1325,0,0,0,281,281,C
1-PB2,1326,0,1,279,0,280,G
1-PB2,1327,278,0,1,1,280,A
1-PB2,1328,280,0,0,0,280,A
1-PB2,1329,279,0,0,0,279,A
1-PB2,1330,0,0,279,0,279,G
1-PB2,1331,0,278,0,0,278,T
1-PB2,1332,0,0,276,0,276,G
1-PB2,1333,0,0,0,276,276,C
1-PB2,1334,0,273,0,2,275,T
1-PB2,1335,0,277,0,0,277,T
1-PB2,1336,0,275,0,0,275,T
1-PB2,1337,0,276,0,0,276,T
1-PB2,1338,0,274,0,0,274,T
1-PB2,1339,1,0,0,275,276,C
1-PB2,1340,276,0,1,0,277,A
1-PB2,1341,279,0,0,0,279,A
1-PB2,1342,276,0,1,0,277,A
1-PB2,1343,279,0,0,0,279,A
1-PB2,1344,0,273,0,1,274,T
1-PB2,1345,0,277,0,0,277,T
1-PB2,1346,0,0,278,0,278,G
1-PB2,1347,0,0,278,0,278,G
1-PB2,1348,0,2,275,0,277,G
1-PB2,1349,0,4,279,0,283,G
1-PB2,1350,288,0,0,0,288,A
1-PB2,1351,0,0,296,0,296,G
1-PB2,1352,0,295,0,0,295,T
1-PB2,1353,0,295,1,0,296,T
1-PB2,1354,0,3,295,1,299,G
1-PB2,1355,299,0,0,0,299,A
1-PB2,1356,299,0,1,0,300,A
1-PB2,1357,0,5,0,298,303,C
1-PB2,1358,298,1,1,0,300,A
1-PB2,1359,0,0,0,314,314,C
1-PB2,1360,304,0,3,1,308,A
1-PB2,1361,0,307,0,0,307,T
1-PB2,1362,1,0,0,304,305,C
1-PB2,1363,0,1,306,0,307,G
1-PB2,1364,308,0,0,0,308,A
1-PB2,1365,0,0,0,308,308,C
1-PB2,1366,290,0,5,0,295,A
1-PB2,1367,0,0,303,0,303,G
1-PB2,1368,0,297,0,1,298,T
1-PB2,1369,0,1,297,0,298,G
1-PB2,1370,0,294,0,0,294,T
1-PB2,1371,1,0,292,0,293,G
1-PB2,1372,296,0,0,0,296,A
1-PB2,1373,0,295,0,0,295,T
1-PB2,1374,1,3,293,0,297,G
1-PB2,1375,0,1,295,0,296,G
1-PB2,1376,0,1,295,0,296,G
1-PB2,1377,291,0,2,0,293,A
1-PB2,1378,292,0,0,0,292,A
1-PB2,1379,0,288,0,0,288,T
1-PB2,1380,0,1,292,0,293,G
1-PB2,1381,288,0,0,0,288,A
1-PB2,1382,0,288,0,0,288,T
1-PB2,1383,0,289,0,0,289,T
1-PB2,1384,0,1,287,0,288,G
1-PB2,1385,0,2,291,0,293,G
1-PB2,1386,287,0,1,1,289,A
1-PB2,1387,0,0,299,0,299,G
1-PB2,1388,0,293,0,0,293,T
1-PB2,1389,296,0,0,0,296,A
1-PB2,1390,0,296,0,0,296,T
1-PB2,1391,0,304,0,0,304,T
1-PB2,1392,306,0,1,0,307,A
1-PB2,1393,0,0,0,305,305,C
1-PB2,1394,0,1,0,299,300,C
1-PB2,1395,295,0,1,0,296,A
1-PB2,1396,1,2,293,1,297,G
1-PB2,1397,301,0,0,0,301,A
1-PB2,1398,0,301,0,0,301,T
1-PB2,1399,297,0,0,0,297,A
1-PB2,1400,0,292,0,0,292,T
1-PB2,1401,0,1,291,0,292,G
1-PB2,1402,294,0,0,0,294,A
1-PB2,1403,0,1,0,292,293,C
1-PB2,1404,0,296,0,1,297,T
1-PB2,1405,0,0,0,296,296,C
1-PB2,1406,2,0,0,294,296,C
1-PB2,1407,296,0,0,0,296,A
1-PB2,1408,297,0,0,0,297,A
1-PB2,1409,0,0,307,0,307,G
1-PB2,1410,1,0,0,303,304,C
1-PB2,1411,307,0,0,0,307,A
1-PB2,1412,0,1,0,305,306,C
1-PB2,1413,304,0,0,0,304,A
1-PB2,1414,16,1,290,0,307,G
1-PB2,1415,299,0,1,0,300,A
1-PB2,1416,0,1,305,0,306,G
1-PB2,1417,304,0,0,0,304,A
1-PB2,1418,0,295,0,0,295,T
1-PB2,1419,0,0,302,0,302,G
1-PB2,1420,0,300,0,0,300,T
1-PB2,1421,3,0,0,296,299,C
1-PB2,1422,300,0,1,0,301,A
1-PB2,1423,302,0,0,2,304,A
1-PB2,1424,0,301,0,0,301,T
1-PB2,1425,0,1,303,0,304,G
1-PB2,1426,300,0,0,0,300,A
1-PB2,1427,0,2,302,0,304,G
1-PB2,1428,302,0,0,0,302,A
1-PB2,1429,0,0,301,0,301,G
1-PB2,1430,0,3,316,0,319,G
1-PB2,1431,318,0,1,0,319,A
1-PB2,1432,318,0,1,0,319,A
1-PB2,1433,0,320,0,0,320,T
1-PB2,1434,318,0,0,0,318,A
1-PB2,1435,315,0,1,0,316,A
1-PB2,1436,0,1,314,0,315,G
1-PB2,1437,313,0,0,0,313,A
1-PB2,1438,0,0,320,0,320,G
1-PB2,1439,0,305,0,0,305,T
1-PB2,1440,3,0,0,302,305,C
1-PB2,1441,306,0,0,0,306,A
1-PB2,1442,0,0,312,0,312,G
1-PB2,1443,0,0,0,322,322,C
1-PB2,1444,322,0,0,0,322,A
1-PB2,1445,322,0,0,0,322,A
1-PB2,1446,322,0,0,0,322,A
1-PB2,1447,321,1,0,0,322,A
1-PB2,1448,0,322,0,0,322,T
1-PB2,1449,0,3,321,0,324,G
1-PB2,1450,0,1,323,1,325,G
1-PB2,1451,0,1,324,1,326,G
1-PB2,1452,0,319,0,1,320,T
1-PB2,1453,0,0,319,0,319,G
1-PB2,1454,0,318,0,1,319,T
1-PB2,1455,0,0,321,0,321,G
1-PB2,1456,1,0,326,0,327,G
1-PB2,1457,325,1,0,0,326,A
1-PB2,1458,0,325,0,0,325,T
1-PB2,1459,0,2,326,0,328,G
1-PB2,1460,329,0,0,0,329,A
1-PB2,1461,326,0,1,0,327,A
1-PB2,1462,0,328,0,0,328,T
1-PB2,1463,328,0,0,0,328,A
1-PB2,1464,0,0,0,338,338,C
1-PB2,1465,0,335,0,0,335,T
1-PB2,1466,1,0,0,338,339,C
1-PB2,1467,2,0,0,338,340,C
1-PB2,1468,343,0,0,0,343,A
1-PB2,1469,0,0,351,0,351,G
1-PB2,1470,0,349,0,0,349,T
1-PB2,1471,356,0,1,0,357,A
1-PB2,1472,0,1,0,356,357,C
1-PB2,1473,332,0,1,0,333,A
1-PB2,1474,0,1,333,0,334,G
1-PB2,1475,321,1,0,0,322,A
1-PB2,1476,1,0,327,0,328,G
1-PB2,1477,322,0,0,0,322,A
1-PB2,1478,0,0,316,0,316,G
1-PB2,1479,0,0,317,0,317,G
1-PB2,1480,0,0,320,0,320,G
1-PB2,1481,0,317,0,0,317,T
1-PB2,1482,2,2,316,0,320,G
1-PB2,1483,0,0,321,0,321,G
1-PB2,1484,0,320,0,0,320,T
1-PB2,1485,0,0,329,0,329,G
1-PB2,1486,0,0,331,0,331,G
1-PB2,1487,1,326,0,1,328,T
1-PB2,1488,0,327,0,1,328,T
1-PB2,1489,325,0,0,0,325,A
1-PB2,1490,1,0,326,0,327,G
1-PB2,1491,0,0,0,330,330,C
1-PB2,1492,330,0,0,0,330,A
1-PB2,1493,0,329,0,0,329,T
1-PB2,1494,0,309,0,2,311,T
1-PB2,1495,0,0,311,0,311,G
1-PB2,1496,310,0,0,0,310,A
1-PB2,1497,0,311,0,0,311,T
1-PB2,1498,0,0,0,312,312,C
1-PB2,1499,0,0,313,0,313,G
1-PB2,1500,0,0,319,0,319,G
1-PB2,1501,0,317,0,0,317,T
1-PB2,1502,0,319,0,0,319,T
1-PB2,1503,0,320,0,0,320,T
1-PB2,1504,0,318,0,1,319,T
1-PB2,1505,0,318,0,0,318,T
1-PB2,1506,1,2,315,0,318,G
1-PB2,1507,321,1,0,0,322,A
1-PB2,1508,0,1,322,0,323,G
1-PB2,1509,307,0,1,0,308,A
1-PB2,1510,0,0,309,0,309,G
1-PB2,1511,0,308,0,0,308,T
1-PB2,1512,0,307,0,1,308,T
1-PB2,1513,2,0,0,307,309,C
1-PB2,1514,0,2,307,0,309,G
1-PB2,1515,309,0,0,0,309,A
1-PB2,1516,0,1,310,0,311,G
1-PB2,1517,310,0,1,0,311,A
1-PB2,1518,0,0,0,310,310,C
1-PB2,1519,1,0,0,303,304,C
1-PB2,1520,304,0,0,0,304,A
1-PB2,1521,308,0,0,0,308,A
1-PB2,1522,0,0,0,309,309,C
1-PB2,1523,0,0,309,0,309,G
1-PB2,1524,0,305,0,0,305,T
1-PB2,1525,0,1,304,0,305,G
1-PB2,1526,0,1,309,0,310,G
1-PB2,1527,0,1,308,0,309,G
1-PB2,1528,305,0,2,0,307,A
1-PB2,1529,309,0,1,0,310,A
1-PB2,1530,0,304,0,0,304,T
1-PB2,1531,0,0,317,0,317,G
1-PB2,1532,0,315,0,0,315,T
1-PB2,1533,317,0,0,0,317,A
1-PB2,1534,0,316,0,0,316,T
1-PB2,1535,0,311,0,0,311,T
1-PB2,1536,310,0,0,0,310,A
1-PB2,1537,0,310,0,0,310,T
1-PB2,1538,0,305,0,0,305,T
1-PB2,1539,303,0,0,0,303,A
1-PB2,1540,0,277,0,1,278,T
1-PB2,1541,0,0,0,289,289,C
1-PB2,1542,0,288,0,0,288,T
1-PB2,1543,0,0,0,288,288,C
1-PB2,1544,1,0,0,288,289,C
1-PB2,1545,0,288,0,0,288,T
1-PB2,1546,0,1,289,0,290,G
1-PB2,1547,290,0,0,0,290,A
1-PB2,1548,0,2,287,0,289,G
1-PB2,1549,0,0,289,0,289,G
1-PB2,1550,273,0,0,0,273,A
1-PB2,1551,0,0,274,0,274,G
1-PB2,1552,0,0,273,0,273,G
1-PB2,1553,0,252,0,1,253,T
1-PB2,1554,0,0,0,255,255,C
1-PB2,1555,252,0,0,0,252,A
1-PB2,1556,0,0,255,0,255,G
1-PB2,1557,0,254,0,0,254,T
1-PB2,1558,0,2,253,0,255,G
1-PB2,1559,254,0,1,0,255,A
1-PB2,1560,252,0,0,0,252,A
1-PB2,1561,249,0,1,0,250,A
1-PB2,1562,0,1,0,252,253,C
1-PB2,1563,252,0,0,0,252,A
1-PB2,1564,0,0,0,251,251,C
1-PB2,1565,244,0,0,0,244,A
1-PB2,1566,0,1,245,0,246,G
1-PB2,1567,0,0,246,0,246,G
1-PB2,1568,0,3,249,0,252,G
1-PB2,1569,250,0,1,0,251,A
1-PB2,1570,252,0,0,0,252,A
1-PB2,1571,0,1,0,255,256,C
1-PB2,1572,0,255,0,0,255,T
1-PB2,1573,1,2,251,0,254,G
1-PB2,1574,255,0,0,0,255,A
1-PB2,1575,0,1,257,0,258,G
1-PB2,1576,253,0,0,0,253,A
1-PB2,1577,0,0,248,0,248,G
1-PB2,1578,244,0,0,0,244,A
1-PB2,1579,0,0,0,245,245,C
1-PB2,1580,0,236,0,0,236,T
1-PB2,1581,0,3,234,0,237,G
1-PB2,1582,236,0,0,0,236,A
1-PB2,1583,0,0,0,239,239,C
1-PB2,1584,238,0,1,0,239,A
1-PB2,1585,238,0,0,0,238,A
1-PB2,1586,0,238,0,0,238,T
1-PB2,1587,239,0,0,0,239,A
1-PB2,1588,240,0,0,0,240,A
1-PB2,1589,0,0,0,242,242,C
1-PB2,1590,0,229,0,0,229,T
1-PB2,1591,0,229,0,0,229,T
1-PB2,1592,227,0,0,0,227,A
1-PB2,1593,0,228,0,0,228,T
1-PB2,1594,0,228,0,0,228,T
1-PB2,1595,1,0,0,225,226,C
1-PB2,1596,217,0,0,2,219,A
1-PB2,1597,0,219,0,0,219,T
1-PB2,1598,1,0,0,214,215,C
1-PB2,1599,0,0,215,0,215,G
1-PB2,1600,0,217,0,0,217,T
1-PB2,1601,0,0,0,212,212,C
1-PB2,1602,1,1,210,0,212,G
1-PB2,1603,212,0,0,0,212,A
1-PB2,1604,0,212,0,0,212,T
1-PB2,1605,0,0,211,0,211,G
1-PB2,1606,212,0,0,0,212,A
1-PB2,1607,0,212,0,0,212,T
1-PB2,1608,0,0,211,0,211,G
1-PB2,1609,0,210,0,0,210,T
1-PB2,1610,1,0,209,0,210,G
1-PB2,1611,0,0,213,0,213,G
1-PB2,1612,0,1,212,0,213,G
1-PB2,1613,212,0,1,0,213,A
1-PB2,1614,0,1,213,0,214,G
1-PB2,1615,205,0,1,0,206,A
1-PB2,1616,0,204,0,0,204,T
1-PB2,1617,0,203,0,0,203,T
1-PB2,1618,203,0,0,0,203,A
1-PB2,1619,201,0,0,0,201,A
1-PB2,1620,0,0,0,199,199,C
1-PB2,1621,0,0,194,0,194,G
1-PB2,1622,0,0,197,0,197,G
1-PB2,1623,0,193,0,0,193,T
1-PB2,1624,0,0,0,192,192,C
1-PB2,1625,1,0,0,193,194,C
1-PB2,1626,0,176,0,0,176,T
1-PB2,1627,0,1,176,0,177,G
1-PB2,1628,176,0,0,0,176,A
1-PB2,1629,0,0,176,0,176,G
1-PB2,1630,0,177,0,0,177,T
1-PB2,1631,2,0,0,172,174,C
1-PB2,1632,1,2,169,0,172,G
1-PB2,1633,0,4,172,0,176,G
1-PB2,1634,0,174,0,0,174,T
1-PB2,1635,0,174,0,1,175,T
1-PB2,1636,0,174,0,0,174,T
1-PB2,1637,0,175,0,0,175,T
1-PB2,1638,0,0,172,0,172,G
1-PB2,1639,0,0,177,0,177,G
1-PB2,1640,0,176,0,1,177,T
1-PB2,1641,0,0,0,175,175,C
1-PB2,1642,174,0,0,0,174,A
1-PB2,1643,180,0,0,0,180,A
1-PB2,1644,1,179,0,0,180,T
1-PB2,1645,184,0,0,0,184,A
1-PB2,1646,0,0,0,187,187,C
1-PB2,1647,0,0,0,184,184,C
1-PB2,1648,0,183,2,0,185,T
1-PB2,1649,186,0,0,0,186,A
1-PB2,1650,1,186,0,1,188,T
1-PB2,1651,0,0,0,187,187,C
1-PB2,1652,182,0,1,0,183,A
1-PB2,1653,181,0,0,0,181,A
1-PB2,1654,0,181,0,0,181,T
1-PB2,1655,0,0,178,0,178,G
1-PB2,1656,0,0,179,0,179,G
1-PB2,1657,178,0,0,0,178,A
1-PB2,1658,0,178,0,0,178,T
1-PB2,1659,0,0,0,177,177,C
1-PB2,1660,177,0,0,0,177,A
1-PB2,1661,0,178,0,0,178,T
1-PB2,1662,0,0,0,177,177,C
1-PB2,1663,177,0,1,0,178,A
1-PB2,1664,0,0,178,0,178,G
1-PB2,1665,177,0,0,0,177,A
1-PB2,1666,177,0,0,0,177,A
1-PB2,1667,178,0,0,0,178,A
1-PB2,1668,0,180,0,0,180,T
1-PB2,1669,0,178,0,0,178,T
1-PB2,1670,1,0,177,0,178,G
1-PB2,1671,0,0,178,0,178,G
1-PB2,1672,1,1,175,0,177,G
1-PB2,1673,177,0,0,0,177,A
1-PB2,1674,174,0,0,0,174,A
1-PB2,1675,0,0,174,0,174,G
1-PB2,1676,0,0,0,175,175,C
1-PB2,1677,0,173,0,2,175,T
1-PB2,1678,0,0,177,0,177,G
1-PB2,1679,1,174,0,1,176,T
1-PB2,1680,0,0,0,175,175,C
1-PB2,1681,175,0,0,0,175,A
1-PB2,1682,174,1,0,0,175,A
1-PB2,1683,174,0,0,1,175,A
1-PB2,1684,176,0,0,0,176,A
1-PB2,1685,0,178,0,0,178,T
1-PB2,1686,0,173,0,0,173,T
1-PB2,1687,1,0,0,173,174,C
1-PB2,1688,172,0,1,0,173,A
1-PB2,1689,174,0,0,0,174,A
1-PB2,1690,0,174,0,0,174,T
1-PB2,1691,0,0,174,0,174,G
1-PB2,1692,0,0,177,0,177,G
1-PB2,1693,0,176,0,0,176,T
1-PB2,1694,2,0,0,175,177,C
1-PB2,1695,0,176,0,0,176,T
1-PB2,1696,0,0,0,178,178,C
1-PB2,1697,178,0,0,0,178,A
1-PB2,1698,0,2,177,0,179,G
1-PB2,1699,180,0,0,0,180,A
1-PB2,1700,179,0,0,0,179,A
1-PB2,1701,0,178,0,0,178,T
1-PB2,1702,0,0,0,178,178,C
1-PB2,1703,2,0,0,167,169,C
1-PB2,1704,0,168,0,0,168,T
1-PB2,1705,0,1,166,0,167,G
1-PB2,1706,0,0,0,168,168,C
1-PB2,1707,166,0,1,0,167,A
1-PB2,1708,171,0,0,0,171,A
1-PB2,1709,0,167,0,0,167,T
1-PB2,1710,0,1,167,0,168,G
1-PB2,1711,0,172,0,0,172,T
1-PB2,1712,0,163,0,0,163,T
1-PB2,1713,0,0,167,0,167,G
1-PB2,1714,1,164,0,0,165,T
1-PB2,1715,164,0,0,0,164,A
1-PB2,1716,0,0,1,164,165,C
1-PB2,1717,162,0,0,0,162,A
1-PB2,1718,162,0,1,0,163,A
1-PB2,1719,0,0,0,162,162,C
1-PB2,1720,161,0,0,0,161,A
1-PB2,1721,158,0,0,0,158,A
1-PB2,1722,159,0,0,0,159,A
1-PB2,1723,159,0,0,0,159,A
1-PB2,1724,0,160,0,0,160,T
1-PB2,1725,0,0,159,0,159,G
1-PB2,1726,0,0,159,0,159,G
1-PB2,1727,157,0,0,0,157,A
1-PB2,1728,157,0,0,0,157,A
1-PB2,1729,0,157,0,0,157,T
1-PB2,1730,0,157,0,0,157,T
1-PB2,1731,0,157,0,0,157,T
1-PB2,1732,0,2,155,0,157,G
1-PB2,1733,157,0,0,0,157,A
1-PB2,1734,156,0,0,0,156,A
1-PB2,1735,0,0,0,155,155,C
1-PB2,1736,0,0,0,149,149,C
1-PB2,1737,150,0,0,0,150,A
1-PB2,1738,0,152,0,0,152,T
1-PB2,1739,1,149,0,0,150,T
1-PB2,1740,0,151,0,0,151,T
1-PB2,1741,1,0,0,150,151,C
1-PB2,1742,150,0,0,0,150,A
1-PB2,1743,151,0,0,0,151,A
1-PB2,1744,0,152,0,0,152,T
1-PB2,1745,1,0,0,152,153,C
1-PB2,1746,0,151,0,0,151,T
1-PB2,1747,0,150,0,1,151,T
1-PB2,1748,0,152,0,0,152,T
1-PB2,1749,152,0,0,0,152,A
1-PB2,1750,0,0,152,0,152,G
1-PB2,1751,0,151,0,0,151,T
1-PB2,1752,0,0,0,151,151,C
1-PB2,1753,1,0,0,150,151,C
1-PB2,1754,0,0,0,148,148,C
1-PB2,1755,0,0,0,150,150,C
1-PB2,1756,147,0,1,0,148,A
1-PB2,1757,146,0,1,0,147,A
1-PB2,1758,0,0,152,0,152,G
1-PB2,1759,0,0,151,0,151,G
1-PB2,1760,0,0,0,151,151,C
1-PB2,1761,1,0,0,150,151,C
1-PB2,1762,151,0,0,0,151,A
1-PB2,1763,0,151,0,0,151,T
1-PB2,1764,0,151,0,0,151,T
1-PB2,1765,152,0,0,0,152,A
1-PB2,1766,0,0,152,0,152,G
1-PB2,1767,147,1,0,0,148,A
1-PB2,1768,153,0,0,0,153,A
1-PB2,1769,0,0,153,0,153,G
1-PB2,1770,0,0,0,154,154,C
1-PB2,1771,0,0,0,152,152,C
1-PB2,1772,153,0,0,1,154,A
1-PB2,1773,156,0,1,0,157,A
1-PB2,1774,0,157,0,0,157,T
1-PB2,1775,156,0,0,0,156,A
1-PB2,1776,0,0,0,159,159,C
1-PB2,1777,149,0,0,0,149,A
1-PB2,1778,0,0,151,0,151,G
1-PB2,1779,0,147,0,0,147,T
1-PB2,1780,0,0,148,0,148,G
1-PB2,1781,0,0,148,0,148,G
1-PB2,1782,0,0,147,0,147,G
1-PB2,1783,0,149,0,0,149,T
1-PB2,1784,0,144,0,0,144,T
1-PB2,1785,0,143,0,0,143,T
1-PB2,1786,0,0,147,0,147,G
1-PB2,1787,0,147,0,0,147,T
1-PB2,1788,0,0,0,147,147,C
1-PB2,1789,144,0,0,0,144,A
1-PB2,1790,0,0,144,0,144,G
1-PB2,1791,142,0,0,0,142,A
1-PB2,1792,142,0,0,0,142,A
1-PB2,1793,0,0,0,142,142,C
1-PB2,1794,0,135,0,1,136,T
1-PB2,1795,1,0,0,138,139,C
1-PB2,1796,0,140,0,0,140,T
1-PB2,1797,141,0,0,0,141,A
1-PB2,1798,0,140,0,0,140,T
1-PB2,1799,0,141,0,0,141,T
1-PB2,1800,1,0,0,138,139,C
1-PB2,1801,0,1,0,139,140,C
1-PB2,1802,140,0,0,0,140,A
1-PB2,1803,140,0,1,0,141,A
1-PB2,1804,0,0,0,142,142,C
1-PB2,1805,143,0,0,0,143,A
1-PB2,1806,144,0,0,0,144,A
1-PB2,1807,143,0,0,1,144,A
1-PB2,1808,0,146,0,0,146,T
1-PB2,1809,0,0,146,0,146,G
1-PB2,1810,144,0,1,0,145,A
1-PB2,1811,0,0,144,0,144,G
1-PB2,1812,139,0,1,0,140,A
1-PB2,1813,0,0,142,0,142,G
1-PB2,1814,144,0,0,0,144,A
1-PB2,1815,0,0,0,144,144,C
1-PB2,1816,0,0,144,0,144,G
1-PB2,1817,0,143,0,0,143,T
1-PB2,1818,143,0,0,0,143,A
1-PB2,1819,0,0,0,143,143,C
1-PB2,1820,0,142,0,0,142,T
1-PB2,1821,0,142,0,0,142,T
1-PB2,1822,0,2,139,0,141,G
1-PB2,1823,0,0,138,0,138,G
1-PB2,1824,0,0,139,0,139,G
1-PB2,1825,139,0,0,0,139,A
1-PB2,1826,0,0,0,140,140,C
1-PB2,1827,142,0,0,0,142,A
1-PB2,1828,0,146,0,0,146,T
1-PB2,1829,0,146,0,0,146,T
1-PB2,1830,0,148,0,0,148,T
1-PB2,1831,0,2,146,0,148,G
1-PB2,1832,150,0,0,0,150,A
1-PB2,1833,0,0,0,150,150,C
1-PB2,1834,149,0,0,0,149,A
1-PB2,1835,1,0,2,146,149,C
1-PB2,1836,0,0,0,148,148,C
1-PB2,1837,146,0,1,0,147,A
1-PB2,1838,0,0,0,156,156,C
1-PB2,1839,0,0,0,154,154,C
1-PB2,1840,1,0,0,154,155,C
1-PB2,1841,154,0,0,0,154,A
1-PB2,1842,0,1,157,0,158,G
1-PB2,1843,158,0,0,0,158,A
1-PB2,1844,0,164,0,0,164,T
1-PB2,1845,164,0,1,0,165,A
1-PB2,1846,165,0,0,1,166,A
1-PB2,1847,0,165,0,0,165,T
1-PB2,1848,164,0,0,0,164,A
1-PB2,1849,163,0,0,0,163,A
1-PB2,1850,161,0,0,0,161,A
1-PB2,1851,0,0,164,0,164,G
1-PB2,1852,0,0,0,164,164,C
1-PB2,1853,0,155,0,0,155,T
1-PB2,1854,0,152,0,0,152,T
1-PB2,1855,1,0,0,152,153,C
1-PB2,1856,0,154,0,0,154,T
1-PB2,1857,0,0,0,160,160,C
1-PB2,1858,0,0,0,159,159,C
1-PB2,1859,0,0,0,159,159,C
1-PB2,1860,0,158,0,0,158,T
1-PB2,1861,0,158,0,0,158,T
1-PB2,1862,0,159,0,0,159,T
1-PB2,1863,0,159,0,0,159,T
1-PB2,1864,0,0,159,0,159,G
1-PB2,1865,0,0,0,161,161,C
1-PB2,1866,157,0,1,0,158,A
1-PB2,1867,0,0,158,0,158,G
1-PB2,1868,0,0,0,159,159,C
1-PB2,1869,0,157,0,0,157,T
1-PB2,1870,0,0,158,0,158,G
1-PB2,1871,0,0,0,158,158,C
1-PB2,1872,0,158,0,0,158,T
1-PB2,1873,0,1,0,157,158,C
1-PB2,1874,0,0,0,161,161,C
1-PB2,1875,159,0,0,0,159,A
1-PB2,1876,0,0,0,161,161,C
1-PB2,1877,3,0,0,158,161,C
1-PB2,1878,161,0,0,0,161,A
1-PB2,1879,163,0,1,0,164,A
1-PB2,1880,164,0,0,0,164,A
1-PB2,1881,0,0,165,0,165,G
1-PB2,1882,0,0,0,165,165,C
1-PB2,1883,163,0,0,0,163,A
1-PB2,1884,164,0,0,0,164,A
1-PB2,1885,163,0,0,0,163,A
1-PB2,1886,0,1,164,0,165,G
1-PB2,1887,0,0,0,167,167,C
1-PB2,1888,166,0,0,0,166,A
1-PB2,1889,0,0,167,0,167,G
1-PB2,1890,166,0,0,0,166,A
1-PB2,1891,168,0,1,0,169,A
1-PB2,1892,0,169,0,0,169,T
1-PB2,1893,0,0,169,0,169,G
1-PB2,1894,0,0,0,169,169,C
1-PB2,1895,164,0,1,0,165,A
1-PB2,1896,0,1,168,0,169,G
1-PB2,1897,0,169,0,0,169,T
1-PB2,1898,0,170,0,0,170,T
1-PB2,1899,1,0,0,170,171,C
1-PB2,1900,0,168,0,0,168,T
1-PB2,1901,1,0,0,171,172,C
1-PB2,1902,0,173,0,0,173,T
1-PB2,1903,0,173,0,0,173,T
1-PB2,1904,1,0,0,172,173,C
1-PB2,1905,172,0,0,0,172,A
1-PB2,1906,0,0,0,173,173,C
1-PB2,1907,0,171,0,0,171,T
1-PB2,1908,0,0,173,0,173,G
1-PB2,1909,174,0,0,0,174,A
1-PB2,1910,1,0,0,177,178,C
1-PB2,1911,0,174,0,0,174,T
1-PB2,1912,1,0,176,0,177,G
1-PB2,1913,0,177,0,0,177,T
1-PB2,1914,0,0,178,0,178,G
1-PB2,1915,178,0,0,0,178,A
1-PB2,1916,179,0,0,0,179,A
1-PB2,1917,0,178,0,0,178,T
1-PB2,1918,0,0,179,0,179,G
1-PB2,1919,0,174,0,0,174,T
1-PB2,1920,0,0,174,0,174,G
1-PB2,1921,172,0,1,0,173,A
1-PB2,1922,0,0,173,0,173,G
1-PB2,1923,0,1,169,0,170,G
1-PB2,1924,0,0,171,0,171,G
1-PB2,1925,0,0,175,0,175,G
1-PB2,1926,174,0,0,0,174,A
1-PB2,1927,0,174,0,0,174,T
1-PB2,1928,0,0,0,174,174,C
1-PB2,1929,170,0,0,0,170,A
1-PB2,1930,0,0,174,0,174,G
1-PB2,1931,0,1,172,0,173,G
1-PB2,1932,0,0,174,0,174,G
1-PB2,1933,175,0,0,0,175,A
1-PB2,1934,0,160,0,0,160,T
1-PB2,1935,0,0,164,0,164,G
1-PB2,1936,162,0,0,0,162,A
1-PB2,1937,0,1,166,0,167,G
1-PB2,1938,165,0,0,0,165,A
1-PB2,1939,164,0,0,0,164,A
1-PB2,1940,0,166,0,0,166,T
1-PB2,1941,166,0,0,0,166,A
1-PB2,1942,0,0,0,169,169,C
1-PB2,1943,0,163,0,1,164,T
1-PB2,1944,0,166,0,0,166,T
1-PB2,1945,0,0,169,0,169,G
1-PB2,1946,0,165,0,0,165,T
1-PB2,1947,164,0,0,0,164,A
1-PB2,1948,163,0,0,0,163,A
1-PB2,1949,0,0,162,0,162,G
1-PB2,1950,1,1,161,0,163,G
1-PB2,1951,0,0,161,0,161,G
1-PB2,1952,1,0,159,0,160,G
1-PB2,1953,0,0,0,161,161,C
1-PB2,1954,161,0,0,0,161,A
1-PB2,1955,164,0,1,0,165,A
1-PB2,1956,0,164,0,0,164,T
1-PB2,1957,0,165,0,0,165,T
1-PB2,1958,0,0,0,168,168,C
1-PB2,1959,0,164,0,1,165,T
1-PB2,1960,0,1,0,166,167,C
1-PB2,1961,1,0,0,166,167,C
1-PB2,1962,1,164,0,0,165,T
1-PB2,1963,0,0,170,0,170,G
1-PB2,1964,0,169,0,0,169,T
1-PB2,1965,168,0,1,0,169,A
1-PB2,1966,0,167,1,0,168,T
1-PB2,1967,0,164,0,1,165,T
1-PB2,1968,1,0,0,166,167,C
1-PB2,1969,166,0,0,0,166,A
1-PB2,1970,167,0,0,0,167,A
1-PB2,1971,1,0,0,166,167,C
1-PB2,1972,0,164,1,0,165,T
1-PB2,1973,165,0,0,0,165,A
1-PB2,1974,0,0,0,169,169,C
1-PB2,1975,167,0,0,0,167,A
1-PB2,1976,166,1,0,0,167,A
1-PB2,1977,0,0,0,165,165,C
1-PB2,1978,164,0,0,0,164,A
1-PB2,1979,162,0,0,0,162,A
1-PB2,1980,0,0,164,0,164,G
1-PB2,1981,162,0,1,1,164,A
1-PB2,1982,1,0,0,163,164,C
1-PB2,1983,1,0,0,155,156,C
1-PB2,1984,157,0,0,0,157,A
1-PB2,1985,0,0,0,162,162,C
1-PB2,1986,0,160,0,0,160,T
1-PB2,1987,162,0,0,0,162,A
1-PB2,1988,160,0,0,0,160,A
1-PB2,1989,161,0,0,0,161,A
1-PB2,1990,162,0,0,0,162,A
1-PB2,1991,0,0,164,0,164,G
1-PB2,1992,163,0,0,0,163,A
1-PB2,1993,0,0,0,166,166,C
1-PB2,1994,0,162,0,0,162,T
1-PB2,1995,164,0,0,0,164,A
1-PB2,1996,164,0,0,0,164,A
1-PB2,1997,0,0,0,165,165,C
1-PB2,1998,165,0,0,0,165,A
1-PB2,1999,165,0,0,0,165,A
1-PB2,2000,0,161,0,0,161,T
1-PB2,2001,0,161,0,0,161,T
1-PB2,2002,0,0,0,165,165,C
1-PB2,2003,0,162,0,0,162,T
1-PB2,2004,1,0,0,163,164,C
1-PB2,2005,0,0,164,0,164,G
1-PB2,2006,0,1,162,0,163,G
1-PB2,2007,164,0,0,0,164,A
1-PB2,2008,164,0,0,0,164,A
1-PB2,2009,163,0,0,0,163,A
1-PB2,2010,161,0,0,0,161,A
1-PB2,2011,1,0,163,0,164,G
1-PB2,2012,164,0,0,0,164,A
1-PB2,2013,0,163,0,0,163,T
1-PB2,2014,0,0,163,0,163,G
1-PB2,2015,0,0,0,161,161,C
1-PB2,2016,1,0,0,161,162,C
1-PB2,2017,0,0,162,0,162,G
1-PB2,2018,0,0,161,0,161,G
1-PB2,2019,0,0,0,161,161,C
1-PB2,2020,162,0,0,0,162,A
1-PB2,2021,0,0,0,163,163,C
1-PB2,2022,0,162,0,0,162,T
1-PB2,2023,0,161,0,1,162,T
1-PB2,2024,0,161,0,0,161,T
1-PB2,2025,162,0,0,0,162,A
1-PB2,2026,161,0,0,0,161,A
1-PB2,2027,0,163,0,0,163,T
1-PB2,2028,0,163,0,0,163,T
1-PB2,2029,0,2,160,0,162,G
1-PB2,2030,159,0,0,0,159,A
1-PB2,2031,160,0,0,0,160,A
1-PB2,2032,0,1,159,0,160,G
1-PB2,2033,160,0,1,0,161,A
1-PB2,2034,0,0,0,160,160,C
1-PB2,2035,2,0,0,160,162,C
1-PB2,2036,0,0,0,160,160,C
1-PB2,2037,159,0,0,0,159,A
1-PB2,2038,0,0,162,0,162,G
1-PB2,2039,162,0,0,0,162,A
1-PB2,2040,0,163,0,0,163,T
1-PB2,2041,0,1,163,0,164,G
1-PB2,2042,160,0,0,0,160,A
1-PB2,2043,158,0,0,0,158,A
1-PB2,2044,159,0,0,0,159,A
1-PB2,2045,0,0,159,0,159,G
1-PB2,2046,0,0,0,156,156,C
1-PB2,2047,150,0,0,0,150,A
1-PB2,2048,0,0,0,151,151,C
1-PB2,2049,149,0,1,0,150,A
1-PB2,2050,0,150,0,0,150,T
1-PB2,2051,1,0,0,147,148,C
1-PB2,2052,0,0,0,151,151,C
1-PB2,2053,0,0,152,0,152,G
1-PB2,2054,0,0,151,0,151,G
1-PB2,2055,147,0,0,0,147,A
1-PB2,2056,0,0,149,0,149,G
1-PB2,2057,0,145,0,0,145,T
1-PB2,2058,0,0,148,0,148,G
1-PB2,2059,0,0,147,0,147,G
1-PB2,2060,145,0,0,0,145,A
1-PB2,2061,0,0,144,0,144,G
1-PB2,2062,0,140,0,0,140,T
1-PB2,2063,2,0,0,137,139,C
1-PB2,2064,0,0,0,138,138,C
1-PB2,2065,0,0,136,0,136,G
1-PB2,2066,0,0,0,137,137,C
1-PB2,2067,0,0,0,136,136,C
1-PB2,2068,0,0,139,0,139,G
1-PB2,2069,0,138,0,1,139,T
1-PB2,2070,1,0,0,140,141,C
1-PB2,2071,0,140,0,0,140,T
1-PB2,2072,0,142,0,0,142,T
1-PB2,2073,0,0,141,0,141,G
1-PB2,2074,141,0,0,0,141,A
1-PB2,2075,0,0,142,0,142,G
1-PB2,2076,140,0,0,0,140,A
1-PB2,2077,0,1,133,0,134,G
1-PB2,2078,0,0,132,1,133,G
1-PB2,2079,0,0,133,0,133,G
1-PB2,2080,0,132,0,1,133,T
1-PB2,2081,0,132,0,0,132,T
1-PB2,2082,0,135,0,0,135,T
1-PB2,2083,0,0,0,135,135,C
1-PB2,2084,0,134,0,0,134,T
1-PB2,2085,2,0,0,137,139,C
1-PB2,2086,139,0,0,0,139,A
1-PB2,2087,0,140,0,0,140,T
1-PB2,2088,0,138,0,0,138,T
1-PB2,2089,140,0,0,0,140,A
1-PB2,2090,0,139,0,0,139,T
1-PB2,2091,139,0,0,0,139,A
1-PB2,2092,0,1,138,0,139,G
1-PB2,2093,0,0,141,0,141,G
1-PB2,2094,0,135,0,0,135,T
1-PB2,2095,135,0,0,0,135,A
1-PB2,2096,135,0,0,0,135,A
1-PB2,2097,0,1,134,0,135,G
1-PB2,2098,0,0,136,0,136,G
1-PB2,2099,134,0,0,0,134,A
1-PB2,2100,132,0,0,0,132,A
1-PB2,2101,0,2,129,0,131,G
1-PB2,2102,128,0,0,0,128,A
1-PB2,2103,0,0,0,130,130,C
1-PB2,2104,128,0,0,0,128,A
1-PB2,2105,0,0,128,0,128,G
1-PB2,2106,125,0,2,0,127,A
1-PB2,2107,132,0,0,0,132,A
1-PB2,2108,0,1,131,0,132,G
1-PB2,2109,131,0,0,0,131,A
1-PB2,2110,0,130,0,0,130,T
1-PB2,2111,129,0,0,0,129,A
1-PB2,2112,0,0,0,129,129,C
1-PB2,2113,0,2,127,0,129,G
1-PB2,2114,0,0,128,0,128,G
1-PB2,2115,127,0,1,0,128,A
1-PB2,2116,0,0,0,125,125,C
1-PB2,2117,0,0,0,127,127,C
1-PB2,2118,123,0,0,0,123,A
1-PB2,2119,0,0,126,0,126,G
1-PB2,2120,0,0,0,125,125,C
1-PB2,2121,124,0,0,0,124,A
1-PB2,2122,0,124,0,0,124,T
1-PB2,2123,0,120,0,0,120,T
1-PB2,2124,119,0,0,0,119,A
1-PB2,2125,120,0,0,0,120,A
1-PB2,2126,0,0,119,0,119,G
1-PB2,2127,0,0,0,117,117,C
1-PB2,2128,109,0,0,0,109,A
1-PB2,2129,0,109,0,0,109,T
1-PB2,2130,1,0,0,108,109,C
1-PB2,2131,109,0,0,0,109,A
1-PB2,2132,109,0,0,0,109,A
1-PB2,2133,0,108,0,0,108,T
1-PB2,2134,0,1,108,0,109,G
1-PB2,2135,107,0,0,0,107,A
1-PB2,2136,108,0,0,0,108,A
1-PB2,2137,0,0,0,110,110,C
1-PB2,2138,0,107,0,0,107,T
1-PB2,2139,0,0,110,0,110,G
1-PB2,2140,109,0,1,0,110,A
1-PB2,2141,1,0,109,0,110,G
1-PB2,2142,0,110,0,0,110,T
1-PB2,2143,110,0,0,0,110,A
1-PB2,2144,109,0,1,0,110,A
1-PB2,2145,0,0,0,111,111,C
1-PB2,2146,0,0,0,110,110,C
1-PB2,2147,0,109,0,0,109,T
1-PB2,2148,0,106,0,0,106,T
1-PB2,2149,0,0,107,0,107,G
1-PB2,2150,0,0,0,107,107,C
1-PB2,2151,107,0,0,0,107,A
1-PB2,2152,107,0,0,0,107,A
1-PB2,2153,105,0,0,0,105,A
1-PB2,2154,104,0,0,0,104,A
1-PB2,2155,0,1,104,0,105,G
1-PB2,2156,0,0,104,0,104,G
1-PB2,2157,0,0,104,0,104,G
1-PB2,2158,0,0,104,0,104,G
1-PB2,2159,104,0,0,0,104,A
1-PB2,2160,103,0,1,0,104,A
1-PB2,2161,103,0,0,0,103,A
1-PB2,2162,105,0,0,0,105,A
1-PB2,2163,0,0,108,0,108,G
1-PB2,2164,0,0,108,0,108,G
1-PB2,2165,0,0,0,107,107,C
1-PB2,2166,0,105,0,0,105,T
1-PB2,2167,106,0,0,0,106,A
1-PB2,2168,106,0,0,0,106,A
1-PB2,2169,0,106,0,0,106,T
1-PB2,2170,0,0,107,0,107,G
1-PB2,2171,0,103,0,0,103,T
1-PB2,2172,0,0,102,0,102,G
1-PB2,2173,1,0,0,102,103,C
1-PB2,2174,0,102,0,1,103,T
1-PB2,2175,103,0,0,0,103,A
1-PB2,2176,102,0,0,0,102,A
1-PB2,2177,0,102,0,0,102,T
1-PB2,2178,93,0,0,1,94,A
1-PB2,2179,0,0,96,0,96,G
1-PB2,2180,0,0,96,0,96,G
1-PB2,2181,0,0,96,0,96,G
1-PB2,2182,0,0,0,95,95,C
1-PB2,2183,91,0,0,0,91,A
1-PB2,2184,94,0,0,0,94,A
1-PB2,2185,0,0,94,0,94,G
1-PB2,2186,0,0,93,0,93,G
1-PB2,2187,92,0,0,0,92,A
1-PB2,2188,0,0,90,0,90,G
1-PB2,2189,89,0,0,0,89,A
1-PB2,2190,1,0,0,88,89,C
1-PB2,2191,0,0,89,0,89,G
1-PB2,2192,0,88,0,0,88,T
1-PB2,2193,0,0,87,0,87,G
1-PB2,2194,0,0,88,0,88,G
1-PB2,2195,0,86,0,0,86,T
1-PB2,2196,1,0,85,0,86,G
1-PB2,2197,0,84,0,0,84,T
1-PB2,2198,0,83,0,0,83,T
1-PB2,2199,0,0,83,0,83,G
1-PB2,2200,0,0,83,0,83,G
1-PB2,2201,0,82,0,0,82,T
1-PB2,2202,82,0,0,0,82,A
1-PB2,2203,81,0,0,0,81,A
1-PB2,2204,0,79,0,0,79,T
1-PB2,2205,0,1,78,0,79,G
1-PB2,2206,78,0,0,0,78,A
1-PB2,2207,77,0,0,0,77,A
1-PB2,2208,77,0,0,0,77,A
1-PB2,2209,0,0,0,77,77,C
1-PB2,2210,0,0,76,0,76,G
1-PB2,2211,74,0,0,0,74,A
1-PB2,2212,74,0,0,0,74,A
1-PB2,2213,74,0,0,0,74,A
1-PB2,2214,74,0,0,0,74,A
1-PB2,2215,0,0,0,74,74,C
1-PB2,2216,0,0,74,0,74,G
1-PB2,2217,0,0,75,0,75,G
1-PB2,2218,0,1,74,0,75,G
1-PB2,2219,75,0,0,0,75,A
1-PB2,2220,0,0,0,77,77,C
1-PB2,2221,0,76,0,0,76,T
1-PB2,2222,1,0,0,76,77,C
1-PB2,2223,0,77,0,0,77,T
1-PB2,2224,78,0,0,0,78,A
1-PB2,2225,0,0,78,0,78,G
1-PB2,2226,0,0,0,79,79,C
1-PB2,2227,79,0,0,0,79,A
1-PB2,2228,0,79,0,0,79,T
1-PB2,2229,77,0,0,0,77,A
1-PB2,2230,0,0,0,79,79,C
1-PB2,2231,0,70,0,1,71,T
1-PB2,2232,0,71,0,0,71,T
1-PB2,2233,70,0,0,0,70,A
1-PB2,2234,0,0,0,70,70,C
1-PB2,2235,0,69,0,0,69,T
1-PB2,2236,0,0,69,0,69,G
1-PB2,2237,68,0,1,0,69,A
1-PB2,2238,0,0,0,69,69,C
1-PB2,2239,65,0,0,0,65,A
1-PB2,2240,0,0,65,0,65,G
1-PB2,2241,0,0,0,65,65,C
1-PB2,2242,0,0,0,65,65,C
1-PB2,2243,64,0,1,0,65,A
1-PB2,2244,0,0,64,0,64,G
1-PB2,2245,63,0,1,0,64,A
1-PB2,2246,0,0,0,64,64,C
1-PB2,2247,64,0,0,0,64,A
1-PB2,2248,0,0,63,0,63,G
1-PB2,2249,0,0,0,59,59,C
1-PB2,2250,0,0,58,0,58,G
1-PB2,2251,57,1,0,0,58,A
1-PB2,2252,0,0,0,57,57,C
1-PB2,2253,0,1,0,56,57,C
1-PB2,2254,56,0,0,0,56,A
1-PB2,2255,56,0,0,0,56,A
1-PB2,2256,56,0,0,0,56,A
1-PB2,2257,56,0,0,0,56,A
1-PB2,2258,0,0,56,0,56,G
1-PB2,2259,55,0,0,0,55,A
1-PB2,2260,55,0,0,0,55,A
1-PB2,2261,1,53,0,0,54,T
1-PB2,2262,0,54,0,0,54,T
1-PB2,2263,1,0,0,54,55,C
1-PB2,2264,0,0,53,0,53,G
1-PB2,2265,0,0,53,0,53,G
1-PB2,2266,54,0,0,0,54,A
1-PB2,2267,0,54,0,0,54,T
1-PB2,2268,0,1,53,0,54,G
1-PB2,2269,0,0,54,0,54,G
1-PB2,2270,0,0,0,52,52,C
1-PB2,2271,0,0,0,53,53,C
1-PB2,2272,53,0,0,0,53,A
1-PB2,2273,0,53,0,0,53,T
1-PB2,2274,1,0,0,52,53,C
1-PB2,2275,53,0,0,0,53,A
1-PB2,2276,51,1,0,0,52,A
1-PB2,2277,0,52,0,0,52,T
1-PB2,2278,0,51,0,0,51,T
1-PB2,2279,49,0,0,0,49,A
1-PB2,2280,48,0,0,0,48,A
2-PB1,1,65,0,0,0,65,A
2-PB1,2,0,66,0,0,66,T
2-PB1,3,0,0,69,0,69,G
2-PB1,4,0,0,70,0,70,G
2-PB1,5,75,0,0,0,75,A
2-PB1,6,0,81,0,0,81,T
2-PB1,7,0,0,84,0,84,G
2-PB1,8,0,84,0,0,84,T
2-PB1,9,0,0,0,93,93,C
2-PB1,10,93,0,0,0,93,A
2-PB1,11,97,0,0,0,97,A
2-PB1,12,0,97,0,0,97,T
2-PB1,13,0,0,0,100,100,C
2-PB1,14,0,1,0,102,103,C
2-PB1,15,0,0,108,0,108,G
2-PB1,16,114,0,0,0,114,A
2-PB1,17,0,0,0,118,118,C
2-PB1,18,0,118,0,0,118,T
2-PB1,19,0,0,0,138,138,C
2-PB1,20,0,138,0,0,138,T
2-PB1,21,142,0,0,0,142,A
2-PB1,22,0,0,0,143,143,C
2-PB1,23,0,143,0,0,143,T
2-PB1,24,0,0,165,0,165,G
2-PB1,25,0,165,0,0,165,T
2-PB1,26,0,165,0,0,165,T
2-PB1,27,0,0,0,164,164,C
2-PB1,28,0,0,0,164,164,C
2-PB1,29,0,187,0,0,187,T
2-PB1,30,188,0,0,0,188,A
2-PB1,31,189,0,0,0,189,A
2-PB1,32,192,0,0,0,192,A
2-PB1,33,0,1,190,0,191,G
2-PB1,34,0,2,192,0,194,G
2-PB1,35,0,194,0,1,195,T
2-PB1,36,0,194,0,0,194,T
2-PB1,37,3,0,0,191,194,C
2-PB1,38,0,0,0,194,194,C
2-PB1,39,193,0,0,0,193,A
2-PB1,40,0,0,195,0,195,G
2-PB1,41,0,0,0,195,195,C
2-PB1,42,0,0,197,0,197,G
2-PB1,43,0,0,0,197,197,C
2-PB1,44,198,0,0,0,198,A
2-PB1,45,198,0,0,0,198,A
2-PB1,46,198,0,0,0,198,A
2-PB1,47,199,1,0,0,200,A
2-PB1,48,0,200,0,0,200,T
2-PB1,49,0,0,210,0,210,G
2-PB1,50,0,0,0,211,211,C
2-PB1,51,0,0,0,213,213,C
2-PB1,52,216,0,0,0,216,A
2-PB1,53,0,216,0,0,216,T
2-PB1,54,230,0,0,0,230,A
2-PB1,55,228,0,1,0,229,A
2-PB1,56,0,0,245,0,245,G
2-PB1,57,0,0,0,245,245,C
2-PB1,58,243,0,1,0,244,A
2-PB1,59,0,0,0,259,259,C
2-PB1,60,259,0,0,0,259,A
2-PB1,61,280,0,0,0,280,A
2-PB1,62,0,1,0,279,280,C
2-PB1,63,278,1,0,0,279,A
2-PB1,64,0,283,0,0,283,T
2-PB1,65,0,284,0,0,284,T
2-PB1,66,2,0,0,343,345,C
2-PB1,67,0,0,0,345,345,C
2-PB1,68,1,0,0,349,350,C
2-PB1,69,0,353,0,0,353,T
2-PB1,70,0,351,0,0,351,T
2-PB1,71,379,0,0,0,379,A
2-PB1,72,0,379,0,0,379,T
2-PB1,73,382,0,0,0,382,A
2-PB1,74,0,0,0,390,390,C
2-PB1,75,0,381,0,0,381,T
2-PB1,76,0,2,384,0,386,G
2-PB1,77,0,1,387,0,388,G
2-PB1,78,386,0,0,0,386,A
2-PB1,79,3,2,381,0,386,G
2-PB1,80,384,0,0,0,384,A
2-PB1,81,0,386,0,0,386,T
2-PB1,82,1,0,0,403,404,C
2-PB1,83,0,0,0,401,401,C
2-PB1,84,0,402,0,1,403,T
2-PB1,85,0,0,0,433,433,C
2-PB1,86,0,0,1,434,435,C
2-PB1,87,440,0,0,0,440,A
2-PB1,88,0,439,0,1,440,T
2-PB1,89,438,0,1,0,439,A
2-PB1,90,0,0,0,444,444,C
2-PB1,91,436,0,0,0,436,A
2-PB1,92,0,0,453,0,453,G
2-PB1,93,0,0,0,451,451,C
2-PB1,94,2,0,0,449,451,C
2-PB1,95,453,0,0,0,453,A
2-PB1,96,0,451,0,0,451,T
2-PB1,97,0,3,448,0,451,G
2-PB1,98,0,2,470,0,472,G
2-PB1,99,469,0,2,0,471,A
2-PB1,100,473,0,2,0,475,A
2-PB1,101,0,0,0,473,473,C
2-PB1,102,467,0,1,0,468,A
2-PB1,103,0,0,480,0,480,G
2-PB1,104,0,6,481,0,487,G
2-PB1,105,488,0,1,0,489,A
2-PB1,106,485,0,0,0,485,A
2-PB1,107,0,1,0,488,489,C
2-PB1,108,489,0,0,0,489,A
2-PB1,109,0,2,531,0,533,G
2-PB1,110,0,3,530,0,533,G
2-PB1,111,1,1,539,0,541,G
2-PB1,112,0,539,0,1,540,T
2-PB1,113,540,0,0,0,540,A
2-PB1,114,1,0,0,539,540,C
2-PB1,115,559,0,0,0,559,A
2-PB1,116,0,0,0,571,571,C
2-PB1,117,3,0,0,564,567,C
2-PB1,118,552,0,0,0,552,A
2-PB1,119,0,551,0,0,551,T
2-PB1,120,0,2,548,0,550,G
2-PB1,121,0,1,554,0,555,G
2-PB1,122,554,0,0,0,554,A
2-PB1,123,1,0,0,553,554,C
2-PB1,124,547,1,0,0,548,A
2-PB1,125,0,2,0,559,561,C
2-PB1,126,559,0,1,0,560,A
2-PB1,127,0,0,570,0,570,G
2-PB1,128,0,570,0,0,570,T
2-PB1,129,2,0,0,578,580,C
2-PB1,130,583,0,0,0,583,A
2-PB1,131,591,0,0,0,591,A
2-PB1,132,1,0,0,592,593,C
2-PB1,133,593,0,0,0,593,A
2-PB1,134,0,3,592,0,595,G
2-PB1,135,592,0,0,0,592,A
2-PB1,136,591,1,2,0,594,A
2-PB1,137,0,0,0,594,594,C
2-PB1,138,580,0,0,0,580,A
2-PB1,139,0,0,0,606,606,C
2-PB1,140,602,0,0,0,602,A
2-PB1,141,1,1,0,631,633,C
2-PB1,142,1,0,1,632,634,C
2-PB1,143,631,0,0,0,631,A
2-PB1,144,632,0,0,0,632,A
2-PB1,145,0,641,0,1,642,T
2-PB1,146,664,0,0,0,664,A
2-PB1,147,0,664,0,0,664,T
2-PB1,148,0,650,2,0,652,T
2-PB1,149,7,0,0,650,657,C
2-PB1,150,648,0,1,0,649,A
2-PB1,151,1,5,646,0,652,G
2-PB1,152,641,0,0,1,642,A
2-PB1,153,0,4,645,0,649,G
2-PB1,154,635,1,1,1,638,A
2-PB1,155,0,0,630,0,630,G
2-PB1,156,0,1,625,0,626,G
2-PB1,157,0,2,649,0,651,G
2-PB1,158,0,1,646,0,647,G
2-PB1,159,0,3,650,0,653,G
2-PB1,160,652,0,1,0,653,A
2-PB1,161,652,0,1,0,653,A
2-PB1,162,0,0,660,0,660,G
2-PB1,163,0,657,1,0,658,T
2-PB1,164,0,6,651,0,657,G
2-PB1,165,0,1,656,0,657,G
2-PB1,166,659,0,0,0,659,A
2-PB1,167,1,0,0,659,660,C
2-PB1,168,0,4,658,0,662,G
2-PB1,169,665,1,0,0,666,A
2-PB1,170,2,0,0,674,676,C
2-PB1,171,671,0,0,0,671,A
2-PB1,172,672,0,0,0,672,A
2-PB1,173,677,0,0,0,677,A
2-PB1,174,0,687,0,0,687,T
2-PB1,175,687,0,2,0,689,A
2-PB1,176,1,0,0,691,692,C
2-PB1,177,686,0,0,0,686,A
2-PB1,178,0,6,683,0,689,G
2-PB1,179,689,0,0,0,689,A
2-PB1,180,689,0,1,1,691,A
2-PB1,181,693,0,1,0,694,A
2-PB1,182,0,0,0,694,694,C
2-PB1,183,0,683,0,0,683,T
2-PB1,184,0,1,683,0,684,G
2-PB1,185,0,2,682,0,684,G
2-PB1,186,0,2,674,0,676,G
2-PB1,187,1,2,675,0,678,G
2-PB1,188,2,0,0,677,679,C
2-PB1,189,682,0,0,0,682,A
2-PB1,190,1,0,0,697,698,C
2-PB1,191,0,0,0,695,695,C
2-PB1,192,2,0,0,695,697,C
2-PB1,193,3,1,0,694,698,C
2-PB1,194,699,0,0,0,699,A
2-PB1,195,704,0,0,0,704,A
2-PB1,196,0,0,0,699,699,C
2-PB1,197,0,700,0,1,701,T
2-PB1,198,3,0,0,704,707,C
2-PB1,199,686,0,0,0,686,A
2-PB1,200,698,0,3,0,701,A
2-PB1,201,3,0,1,697,701,C
2-PB1,202,3,0,0,692,695,C
2-PB1,203,1,0,0,697,698,C
2-PB1,204,697,0,0,0,697,A
2-PB1,205,698,0,0,0,698,A
2-PB1,206,0,697,0,0,697,T
2-PB1,207,0,700,0,0,700,T
2-PB1,208,0,2,699,0,701,G
2-PB1,209,694,0,0,0,694,A
2-PB1,210,1,690,0,0,691,T
2-PB1,211,0,4,690,0,694,G
2-PB1,212,1,5,691,0,697,G
2-PB1,213,705,0,0,0,705,A
2-PB1,214,0,1,0,713,714,C
2-PB1,215,4,0,0,707,711,C
2-PB1,216,707,0,0,0,707,A
2-PB1,217,1,0,0,721,722,C
2-PB1,218,0,722,0,0,722,T
2-PB1,219,731,0,1,0,732,A
2-PB1,220,3,0,0,731,734,C
2-PB1,221,1,0,0,723,724,C
2-PB1,222,0,720,0,0,720,T
2-PB1,223,0,0,723,0,723,G
2-PB1,224,721,0,1,0,722,A
2-PB1,225,1,3,728,0,732,G
2-PB1,226,0,3,725,0,728,G
2-PB1,227,725,0,1,0,726,A
2-PB1,228,0,718,0,1,719,T
2-PB1,229,712,0,0,0,712,A
2-PB1,230,709,0,3,0,712,A
2-PB1,231,0,715,0,1,716,T
2-PB1,232,0,10,711,0,721,G
2-PB1,233,721,0,0,0,721,A
2-PB1,234,719,1,1,0,721,A
2-PB1,235,0,0,0,722,722,C
2-PB1,236,3,0,0,704,707,C
2-PB1,237,713,0,0,0,713,A
2-PB1,238,712,2,0,0,714,A
2-PB1,239,0,1,719,0,720,G
2-PB1,240,0,721,0,0,721,T
2-PB1,241,0,1,721,0,722,G
2-PB1,242,0,3,728,0,731,G
2-PB1,243,724,0,2,0,726,A
2-PB1,244,0,727,0,0,727,T
2-PB1,245,726,0,0,0,726,A
2-PB1,246,0,741,1,0,742,T
2-PB1,247,1,0,741,0,742,G
2-PB1,248,0,1,0,740,741,C
2-PB1,249,741,0,1,0,742,A
2-PB1,250,0,1,0,763,764,C
2-PB1,251,746,0,1,1,748,A
2-PB1,252,764,0,0,0,764,A
2-PB1,253,766,0,0,0,766,A
2-PB1,254,0,0,0,768,768,C
2-PB1,255,749,0,0,0,749,A
2-PB1,256,1,3,758,0,762,G
2-PB1,257,761,0,0,0,761,A
2-PB1,258,0,0,0,759,759,C
2-PB1,259,1,733,0,1,735,T
2-PB1,260,0,0,754,0,754,G
2-PB1,261,0,740,0,3,743,T
2-PB1,262,0,0,779,0,779,G
2-PB1,263,0,773,0,3,776,T
2-PB1,264,10,0,0,768,778,C
2-PB1,265,1,0,0,780,781,C
2-PB1,266,0,770,0,3,773,T
2-PB1,267,2,1,768,0,771,G
2-PB1,268,0,1,767,1,769,G
2-PB1,269,754,0,1,0,755,A
2-PB1,270,0,1,765,0,766,G
2-PB1,271,0,2,748,0,750,G
2-PB1,272,2,1,0,751,754,C
2-PB1,273,0,747,0,1,748,T
2-PB1,274,753,0,0,0,753,A
2-PB1,275,0,747,0,4,751,T
2-PB1,276,1,0,749,0,750,G
2-PB1,277,1,0,751,0,752,G
2-PB1,278,0,2,0,751,753,C
2-PB1,279,2,0,0,745,747,C
2-PB1,280,0,738,0,1,739,T
2-PB1,281,1,767,0,1,769,T
2-PB1,282,3,0,0,769,772,C
2-PB1,283,2,0,0,771,773,C
2-PB1,284,0,771,0,1,772,T
2-PB1,285,0,772,0,0,772,T
2-PB1,286,0,2,773,0,775,G
2-PB1,287,777,0,0,0,777,A
2-PB1,288,777,0,0,0,777,A
2-PB1,289,0,3,775,0,778,G
2-PB1,290,752,0,0,1,753,A
2-PB1,291,757,0,0,0,757,A
2-PB1,292,1,756,0,0,757,T
2-PB1,293,3,0,0,756,759,C
2-PB1,294,1,0,0,756,757,C
2-PB1,295,3,0,0,757,760,C
2-PB1,296,759,0,1,0,760,A
2-PB1,297,1,0,0,765,766,C
2-PB1,298,2,2,0,759,763,C
2-PB1,299,5,0,0,763,768,C
2-PB1,300,763,0,0,0,763,A
2-PB1,301,0,2,770,0,772,G
2-PB1,302,0,1,775,0,776,G
2-PB1,303,0,773,0,0,773,T
2-PB1,304,779,0,0,0,779,A
2-PB1,305,0,777,0,0,777,T
2-PB1,306,0,1,0,781,782,C
2-PB1,307,0,775,0,1,776,T
2-PB1,308,0,774,0,0,774,T
2-PB1,309,0,771,0,0,771,T
2-PB1,310,0,5,766,0,771,G
2-PB1,311,763,0,1,0,764,A
2-PB1,312,0,2,761,0,763,G
2-PB1,313,760,0,1,0,761,A
2-PB1,314,759,1,5,0,765,A
2-PB1,315,0,0,0,766,766,C
2-PB1,316,0,758,1,0,759,T
2-PB1,317,5,1,0,753,759,C
2-PB1,318,759,0,0,0,759,A
2-PB1,319,0,758,0,1,759,T
2-PB1,320,0,0,760,0,760,G
2-PB1,321,2,0,0,768,770,C
2-PB1,322,2,0,0,764,766,C
2-PB1,323,1,767,0,2,770,T
2-PB1,324,0,760,0,2,762,T
2-PB1,325,0,2,761,0,763,G
2-PB1,326,765,0,3,0,768,A
2-PB1,327,767,0,0,0,767,A
2-PB1,328,765,0,0,2,767,A
2-PB1,329,1,0,0,771,772,C
2-PB1,330,746,0,0,0,746,A
2-PB1,331,750,0,0,0,750,A
2-PB1,332,0,750,0,2,752,T
2-PB1,333,1,1,749,0,751,G
2-PB1,334,1,3,747,0,751,G
2-PB1,335,742,0,1,0,743,A
2-PB1,336,738,0,2,0,740,A
2-PB1,337,0,0,740,0,740,G
2-PB1,338,0,0,0,744,744,C
2-PB1,339,2,1,0,737,740,C
2-PB1,340,0,1,742,0,743,G
2-PB1,341,0,743,0,0,743,T
2-PB1,342,0,741,0,4,745,T
2-PB1,343,6,0,0,743,749,C
2-PB1,344,747,0,2,0,749,A
2-PB1,345,755,0,0,0,755,A
2-PB1,346,0,0,0,755,755,C
2-PB1,347,743,0,2,0,745,A
2-PB1,348,0,5,745,0,750,G
2-PB1,349,735,0,5,0,740,A
2-PB1,350,0,1,0,737,738,C
2-PB1,351,739,0,0,0,739,A
2-PB1,352,742,1,1,0,744,A
2-PB1,353,0,6,740,0,746,G
2-PB1,354,0,0,734,1,735,G
2-PB1,355,0,2,743,0,745,G
2-PB1,356,0,728,0,2,730,T
2-PB1,357,1,1,725,0,727,G
2-PB1,358,0,6,715,0,721,G
2-PB1,359,721,0,1,0,722,A
2-PB1,360,1,0,0,723,724,C
2-PB1,361,712,0,0,0,712,A
2-PB1,362,719,0,1,0,720,A
2-PB1,363,720,0,1,0,721,A
2-PB1,364,1,0,0,719,720,C
2-PB1,365,0,716,0,0,716,T
2-PB1,366,718,0,0,0,718,A
2-PB1,367,725,0,0,0,725,A
2-PB1,368,1,0,0,728,729,C
2-PB1,369,3,0,0,726,729,C
2-PB1,370,2,0,0,723,725,C
2-PB1,371,706,0,0,0,706,A
2-PB1,372,705,0,1,0,706,A
2-PB1,373,0,1,707,0,708,G
2-PB1,374,0,1,712,0,713,G
2-PB1,375,0,708,0,1,709,T
2-PB1,376,8,0,0,694,702,C
2-PB1,377,0,1,701,0,702,G
2-PB1,378,0,0,0,699,699,C
2-PB1,379,2,0,0,705,707,C
2-PB1,380,706,0,0,0,706,A
2-PB1,381,0,3,715,0,718,G
2-PB1,382,726,1,0,0,727,A
2-PB1,383,1,0,0,726,727,C
2-PB1,384,0,719,0,1,720,T
2-PB1,385,0,719,0,0,719,T
2-PB1,386,718,0,0,0,718,A
2-PB1,387,0,718,0,1,719,T
2-PB1,388,0,3,716,0,719,G
2-PB1,389,721,0,1,0,722,A
2-PB1,390,0,711,0,0,711,T
2-PB1,391,0,682,0,0,682,T
2-PB1,392,0,2,678,0,680,G
2-PB1,393,0,2,677,0,679,G
2-PB1,394,683,0,1,0,684,A
2-PB1,395,0,0,0,685,685,C
2-PB1,396,675,0,1,0,676,A
2-PB1,397,0,672,0,0,672,T
2-PB1,398,0,677,0,1,678,T
2-PB1,399,686,0,0,0,686,A
2-PB1,400,685,0,0,0,685,A
2-PB1,401,681,0,0,0,681,A
2-PB1,402,0,0,0,683,683,C
2-PB1,403,671,0,1,0,672,A
2-PB1,404,0,3,674,0,677,G
2-PB1,405,673,0,0,0,673,A
2-PB1,406,671,0,1,0,672,A
2-PB1,407,671,0,0,0,671,A
2-PB1,408,0,660,0,0,660,T
2-PB1,409,4,1,0,664,669,C
2-PB1,410,667,0,0,0,667,A
2-PB1,411,666,0,2,0,668,A
2-PB1,412,0,1,0,666,667,C
2-PB1,413,3,0,0,656,659,C
2-PB1,414,2,1,660,0,663,G
2-PB1,415,0,1,665,1,667,G
2-PB1,416,1,0,0,667,668,C
2-PB1,417,668,0,0,1,669,A
2-PB1,418,0,0,670,0,670,G
2-PB1,419,3,0,1,666,670,C
2-PB1,420,673,0,1,0,674,A
2-PB1,421,673,0,1,0,674,A
2-PB1,422,1,0,0,679,680,C
2-PB1,423,1,669,0,1,671,T
2-PB1,424,0,0,699,0,699,G
2-PB1,425,0,0,0,699,699,C
2-PB1,426,695,1,2,0,698,A
2-PB1,427,0,699,0,1,700,T
2-PB1,428,0,695,0,0,695,T
2-PB1,429,722,1,0,0,723,A
2-PB1,430,0,0,720,0,720,G
2-PB1,431,0,0,0,718,718,C
2-PB1,432,1,0,0,714,715,C
2-PB1,433,691,1,0,0,692,A
2-PB1,434,696,0,1,0,697,A
2-PB1,435,1,0,1,693,695,C
2-PB1,436,696,0,0,0,696,A
2-PB1,437,1,0,0,713,714,C
2-PB1,438,2,0,0,673,675,C
2-PB1,439,670,0,0,0,670,A
2-PB1,440,0,671,0,1,672,T
2-PB1,441,675,0,0,0,675,A
2-PB1,442,0,3,671,0,674,G
2-PB1,443,665,0,2,0,667,A
2-PB1,444,664,0,0,0,664,A
2-PB1,445,1,1,663,0,665,G
2-PB1,446,0,647,0,0,647,T
2-PB1,447,2,646,1,0,649,T
2-PB1,448,0,646,0,1,647,T
2-PB1,449,1,651,0,0,652,T
2-PB1,450,0,650,0,0,650,T
2-PB1,451,646,0,0,0,646,A
2-PB1,452,0,2,643,0,645,G
2-PB1,453,637,0,1,0,638,A
2-PB1,454,0,641,0,0,641,T
2-PB1,455,3,0,0,631,634,C
2-PB1,456,1,3,633,0,637,G
2-PB1,457,635,0,0,0,635,A
2-PB1,458,634,0,1,0,635,A
2-PB1,459,1,0,0,644,645,C
2-PB1,460,0,2,643,0,645,G
2-PB1,461,0,1,667,0,668,G
2-PB1,462,670,0,2,0,672,A
2-PB1,463,0,670,0,0,670,T
2-PB1,464,0,672,0,1,673,T
2-PB1,465,672,0,2,0,674,A
2-PB1,466,674,0,0,0,674,A
2-PB1,467,0,0,0,681,681,C
2-PB1,468,670,0,3,0,673,A
2-PB1,469,0,0,684,0,684,G
2-PB1,470,0,0,0,661,661,C
2-PB1,471,0,656,0,0,656,T
2-PB1,472,657,0,1,0,658,A
2-PB1,473,657,1,0,0,658,A
2-PB1,474,0,658,0,0,658,T
2-PB1,475,0,4,664,0,668,G
2-PB1,476,668,0,0,1,669,A
2-PB1,477,668,0,0,0,668,A
2-PB1,478,0,652,0,0,652,T
2-PB1,479,2,0,0,656,658,C
2-PB1,480,656,1,2,0,659,A
2-PB1,481,1,2,656,0,659,G
2-PB1,482,0,0,658,0,658,G
2-PB1,483,651,0,1,0,652,A
2-PB1,484,641,1,0,0,642,A
2-PB1,485,0,2,659,0,661,G
2-PB1,486,1,2,661,0,664,G
2-PB1,487,0,0,0,663,663,C
2-PB1,488,1,658,0,0,659,T
2-PB1,489,658,0,0,0,658,A
2-PB1,490,659,1,0,0,660,A
2-PB1,491,0,658,0,0,658,T
2-PB1,492,656,0,2,0,658,A
2-PB1,493,0,2,657,0,659,G
2-PB1,494,611,0,0,0,611,A
2-PB1,495,0,605,0,1,606,T
2-PB1,496,0,602,0,2,604,T
2-PB1,497,0,603,0,0,603,T
2-PB1,498,1,0,0,618,619,C
2-PB1,499,2,0,0,622,624,C
2-PB1,500,0,620,0,2,622,T
2-PB1,501,3,0,0,621,624,C
2-PB1,502,622,0,0,0,622,A
2-PB1,503,623,0,0,0,623,A
2-PB1,504,0,2,622,0,624,G
2-PB1,505,2,1,628,0,631,G
2-PB1,506,633,0,0,0,633,A
2-PB1,507,0,615,0,0,615,T
2-PB1,508,0,0,619,0,619,G
2-PB1,509,0,612,0,0,612,T
2-PB1,510,1,2,612,0,615,G
2-PB1,511,612,0,1,0,613,A
2-PB1,512,0,614,0,0,614,T
2-PB1,513,1,2,609,0,612,G
2-PB1,514,0,6,598,0,604,G
2-PB1,515,605,0,0,0,605,A
2-PB1,516,603,0,1,0,604,A
2-PB1,517,0,595,0,0,595,T
2-PB1,518,3,1,0,595,599,C
2-PB1,519,598,0,1,0,599,A
2-PB1,520,601,0,0,0,601,A
2-PB1,521,0,601,0,0,601,T
2-PB1,522,0,0,601,0,601,G
2-PB1,523,0,5,595,0,600,G
2-PB1,524,598,0,2,0,600,A
2-PB1,525,0,593,0,1,594,T
2-PB1,526,596,0,0,0,596,A
2-PB1,527,596,0,0,0,596,A
2-PB1,528,598,0,1,0,599,A
2-PB1,529,0,0,605,0,605,G
2-PB1,530,604,0,0,0,604,A
2-PB1,531,0,2,600,0,602,G
2-PB1,532,1,1,596,0,598,G
2-PB1,533,592,0,0,0,592,A
2-PB1,534,591,0,0,0,591,A
2-PB1,535,593,0,0,0,593,A
2-PB1,536,0,588,0,0,588,T
2-PB1,537,1,2,603,0,606,G
2-PB1,538,0,3,603,0,606,G
2-PB1,539,592,0,1,0,593,A
2-PB1,540,0,1,595,0,596,G
2-PB1,541,587,0,2,0,589,A
2-PB1,542,0,602,0,0,602,T
2-PB1,543,598,0,0,0,598,A
2-PB1,544,606,0,0,0,606,A
2-PB1,545,0,0,0,608,608,C
2-PB1,546,598,1,0,0,599,A
2-PB1,547,602,0,0,0,602,A
2-PB1,548,0,0,0,602,602,C
2-PB1,549,594,0,1,0,595,A
2-PB1,550,0,0,0,593,593,C
2-PB1,551,579,0,2,0,581,A
2-PB1,552,0,0,0,582,582,C
2-PB1,553,0,574,0,0,574,T
2-PB1,554,0,573,0,0,573,T
2-PB1,555,0,571,0,1,572,T
2-PB1,556,2,0,0,573,575,C
2-PB1,557,576,0,0,0,576,A
2-PB1,558,576,0,0,1,577,A
2-PB1,559,578,0,1,0,579,A
2-PB1,560,0,3,586,0,589,G
2-PB1,561,581,0,0,0,581,A
2-PB1,562,581,0,1,0,582,A
2-PB1,563,582,0,0,0,582,A
2-PB1,564,582,0,0,0,582,A
2-PB1,565,576,0,3,0,579,A
2-PB1,566,0,1,581,0,582,G
2-PB1,567,0,3,580,0,583,G
2-PB1,568,573,0,1,0,574,A
2-PB1,569,0,3,578,0,581,G
2-PB1,570,578,0,1,0,579,A
2-PB1,571,0,0,604,0,604,G
2-PB1,572,0,603,0,0,603,T
2-PB1,573,605,0,0,0,605,A
2-PB1,574,607,0,1,0,608,A
2-PB1,575,0,2,610,0,612,G
2-PB1,576,1,0,618,0,619,G
2-PB1,577,0,4,611,0,615,G
2-PB1,578,609,0,1,0,610,A
2-PB1,579,0,0,0,613,613,C
2-PB1,580,596,0,1,0,597,A
2-PB1,581,600,0,1,0,601,A
2-PB1,582,1,0,0,600,601,C
2-PB1,583,598,0,0,0,598,A
2-PB1,584,0,588,0,1,589,T
2-PB1,585,0,9,577,1,587,G
2-PB1,586,590,0,2,0,592,A
2-PB1,587,1,0,0,588,589,C
2-PB1,588,2,1,0,576,579,C
2-PB1,589,576,0,2,0,578,A
2-PB1,590,574,0,1,0,575,A
2-PB1,591,0,2,574,0,576,G
2-PB1,592,574,0,0,0,574,A
2-PB1,593,576,0,0,0,576,A
2-PB1,594,570,0,1,0,571,A
2-PB1,595,567,1,0,0,568,A
2-PB1,596,0,568,0,0,568,T
2-PB1,597,0,2,566,0,568,G
2-PB1,598,1,0,572,0,573,G
2-PB1,599,0,564,0,2,566,T
2-PB1,600,5,0,0,562,567,C
2-PB1,601,569,0,0,0,569,A
2-PB1,602,0,0,0,597,597,C
2-PB1,603,598,0,0,0,598,A
2-PB1,604,1,0,0,598,599,C
2-PB1,605,597,2,0,0,599,A
2-PB1,606,605,0,0,0,605,A
2-PB1,607,599,0,1,0,600,A
2-PB1,608,0,5,630,0,635,G
2-PB1,609,634,0,0,0,634,A
2-PB1,610,636,0,1,0,637,A
2-PB1,611,0,1,0,648,649,C
2-PB1,612,643,1,0,0,644,A
2-PB1,613,646,0,3,0,649,A
2-PB1,614,0,645,0,0,645,T
2-PB1,615,641,0,0,0,641,A
2-PB1,616,0,2,641,0,643,G
2-PB1,617,1,0,623,0,624,G
2-PB1,618,0,4,617,0,621,G
2-PB1,619,625,0,0,0,625,A
2-PB1,620,610,0,2,0,612,A
2-PB1,621,0,0,619,0,619,G
2-PB1,622,619,0,0,0,619,A
2-PB1,623,617,0,1,0,618,A
2-PB1,624,620,0,1,0,621,A
2-PB1,625,625,0,1,0,626,A
2-PB1,626,631,0,2,0,633,A
2-PB1,627,634,0,0,0,634,A
2-PB1,628,0,0,0,634,634,C
2-PB1,629,631,0,1,0,632,A
2-PB1,630,632,0,0,0,632,A
2-PB1,631,629,0,2,0,631,A
2-PB1,632,0,2,640,0,642,G
2-PB1,633,639,0,1,0,640,A
2-PB1,634,0,0,652,0,652,G
2-PB1,635,0,638,0,2,640,T
2-PB1,636,1,4,651,0,656,G
2-PB1,637,653,0,2,0,655,A
2-PB1,638,656,0,0,0,656,A
2-PB1,639,0,665,0,0,665,T
2-PB1,640,666,0,0,0,666,A
2-PB1,641,666,0,0,0,666,A
2-PB1,642,1,4,662,0,667,G
2-PB1,643,654,0,1,0,655,A
2-PB1,644,631,0,0,0,631,A
2-PB1,645,636,0,2,0,638,A
2-PB1,646,0,0,641,0,641,G
2-PB1,647,0,0,643,0,643,G
2-PB1,648,0,2,0,637,639,C
2-PB1,649,0,635,0,0,635,T
2-PB1,650,648,0,0,0,648,A
2-PB1,651,1,0,0,676,677,C
2-PB1,652,0,0,0,681,681,C
2-PB1,653,0,688,0,0,688,T
2-PB1,654,712,0,0,0,712,A
2-PB1,655,713,0,0,0,713,A
2-PB1,656,0,713,0,0,713,T
2-PB1,657,708,0,1,0,709,A
2-PB1,658,706,0,1,0,707,A
2-PB1,659,0,4,704,0,708,G
2-PB1,660,684,0,1,0,685,A
2-PB1,661,0,0,694,0,694,G
2-PB1,662,0,0,0,690,690,C
2-PB1,663,0,668,0,2,670,T
2-PB1,664,1,670,0,1,672,T
2-PB1,665,0,675,0,1,676,T
2-PB1,666,0,1,678,0,679,G
2-PB1,667,692,0,1,0,693,A
2-PB1,668,1,0,0,694,695,C
2-PB1,669,684,1,1,0,686,A
2-PB1,670,0,679,0,3,682,T
2-PB1,671,0,671,0,2,673,T
2-PB1,672,0,7,679,0,686,G
2-PB1,673,680,0,2,0,682,A
2-PB1,674,685,0,0,0,685,A
2-PB1,675,0,0,0,685,685,C
2-PB1,676,674,1,0,0,675,A
2-PB1,677,0,1,0,675,676,C
2-PB1,678,0,5,667,0,672,G
2-PB1,679,675,0,2,0,677,A
2-PB1,680,0,694,0,0,694,T
2-PB1,681,0,11,691,0,702,G
2-PB1,682,698,1,2,0,701,A
2-PB1,683,1,0,0,697,698,C
2-PB1,684,5,0,0,696,701,C
2-PB1,685,700,0,1,0,701,A
2-PB1,686,706,2,2,1,711,A
2-PB1,687,710,0,1,1,712,A
2-PB1,688,0,3,736,0,739,G
2-PB1,689,746,0,1,0,747,A
2-PB1,690,0,734,0,0,734,T
2-PB1,691,1,0,733,0,734,G
2-PB1,692,1,1,0,733,735,C
2-PB1,693,731,0,1,0,732,A
2-PB1,694,0,5,735,1,741,G
2-PB1,695,730,0,1,0,731,A
2-PB1,696,1,4,729,0,734,G
2-PB1,697,720,0,0,0,720,A
2-PB1,698,0,1,723,0,724,G
2-PB1,699,713,1,0,0,714,A
2-PB1,700,1,2,710,1,714,G
2-PB1,701,0,2,710,0,712,G
2-PB1,702,0,2,0,712,714,C
2-PB1,703,705,0,1,0,706,A
2-PB1,704,711,0,0,0,711,A
2-PB1,705,713,0,1,0,714,A
2-PB1,706,0,713,0,1,714,T
2-PB1,707,0,714,0,0,714,T
2-PB1,708,716,1,0,0,717,A
2-PB1,709,715,0,1,0,716,A
2-PB1,710,721,0,0,0,721,A
2-PB1,711,721,0,0,0,721,A
2-PB1,712,722,0,0,0,722,A
2-PB1,713,0,2,723,0,725,G
2-PB1,714,717,0,0,0,717,A
2-PB1,715,717,0,0,0,717,A
2-PB1,716,0,3,725,0,728,G
2-PB1,717,0,0,742,0,742,G
2-PB1,718,0,0,742,0,742,G
2-PB1,719,3,1,0,744,748,C
2-PB1,720,0,746,0,1,747,T
2-PB1,721,753,0,0,0,753,A
2-PB1,722,0,761,0,0,761,T
2-PB1,723,0,766,0,0,766,T
2-PB1,724,0,0,765,0,765,G
2-PB1,725,1,1,0,756,758,C
2-PB1,726,745,0,0,0,745,A
2-PB1,727,746,0,0,0,746,A
2-PB1,728,0,0,1,742,743,C
2-PB1,729,742,0,0,1,743,A
2-PB1,730,1,0,0,740,741,C
2-PB1,731,2,2,1,720,725,C
2-PB1,732,3,0,0,724,727,C
2-PB1,733,1,1,725,0,727,G
2-PB1,734,0,3,722,0,725,G
2-PB1,735,1,2,724,0,727,G
2-PB1,736,727,0,0,0,727,A
2-PB1,737,0,721,0,1,722,T
2-PB1,738,0,0,723,0,723,G
2-PB1,739,0,0,0,718,718,C
2-PB1,740,727,0,1,0,728,A
2-PB1,741,742,0,0,0,742,A
2-PB1,742,751,0,0,0,751,A
2-PB1,743,0,749,0,1,750,T
2-PB1,744,0,749,0,0,749,T
2-PB1,745,740,0,0,0,740,A
2-PB1,746,0,1,739,0,740,G
2-PB1,747,730,0,1,0,731,A
2-PB1,748,0,3,734,0,737,G
2-PB1,749,0,4,725,0,729,G
2-PB1,750,1,0,739,1,741,G
2-PB1,751,0,737,0,0,737,T
2-PB1,752,0,731,0,4,735,T
2-PB1,753,4,8,0,718,730,C
2-PB1,754,0,0,735,0,735,G
2-PB1,755,0,732,0,2,734,T
2-PB1,756,1,0,733,0,734,G
2-PB1,757,0,733,0,0,733,T
2-PB1,758,723,0,0,0,723,A
2-PB1,759,1,0,0,719,720,C
2-PB1,760,0,671,0,1,672,T
2-PB1,761,0,674,0,0,674,T
2-PB1,762,1,0,0,669,670,C
2-PB1,763,0,0,661,0,661,G
2-PB1,764,0,659,0,2,661,T
2-PB1,765,0,653,0,0,653,T
2-PB1,766,0,5,655,0,660,G
2-PB1,767,658,0,1,0,659,A
2-PB1,768,659,1,0,0,660,A
2-PB1,769,661,0,1,0,662,A
2-PB1,770,0,0,0,667,667,C
2-PB1,771,0,654,0,1,655,T
2-PB1,772,0,647,0,0,647,T
2-PB1,773,0,649,0,0,649,T
2-PB1,774,657,0,0,1,658,A
2-PB1,775,0,0,659,0,659,G
2-PB1,776,0,0,0,662,662,C
2-PB1,777,0,662,0,0,662,T
2-PB1,778,655,1,0,0,656,A
2-PB1,779,0,0,653,0,653,G
2-PB1,780,654,1,0,0,655,A
2-PB1,781,650,0,1,0,651,A
2-PB1,782,0,0,652,0,652,G
2-PB1,783,0,0,0,643,643,C
2-PB1,784,642,0,0,0,642,A
2-PB1,785,0,630,0,1,631,T
2-PB1,786,0,635,0,1,636,T
2-PB1,787,0,637,0,0,637,T
2-PB1,788,0,0,637,0,637,G
2-PB1,789,1,0,0,639,640,C
2-PB1,790,0,3,636,0,639,G
2-PB1,791,640,0,1,0,641,A
2-PB1,792,636,0,2,0,638,A
2-PB1,793,637,0,0,0,637,A
2-PB1,794,644,0,0,0,644,A
2-PB1,795,6,0,644,0,650,G
2-PB1,796,0,1,0,650,651,C
2-PB1,797,1,647,1,0,649,T
2-PB1,798,0,650,0,1,651,T
2-PB1,799,1,7,643,0,651,G
2-PB1,800,648,0,0,0,648,A
2-PB1,801,651,0,2,0,653,A
2-PB1,802,0,1,0,655,656,C
2-PB1,803,631,0,0,0,631,A
2-PB1,804,0,0,680,0,680,G
2-PB1,805,0,667,0,1,668,T
2-PB1,806,2,0,0,664,666,C
2-PB1,807,0,667,0,1,668,T
2-PB1,808,0,3,662,0,665,G
2-PB1,809,0,4,666,0,670,G
2-PB1,810,668,0,0,0,668,A
2-PB1,811,0,0,0,667,667,C
2-PB1,812,0,643,0,3,646,T
2-PB1,813,0,615,0,0,615,T
2-PB1,814,0,1,0,614,615,C
2-PB1,815,3,0,0,610,613,C
2-PB1,816,0,1,618,0,619,G
2-PB1,817,1,0,621,0,622,G
2-PB1,818,0,615,0,0,615,T
2-PB1,819,0,613,0,0,613,T
2-PB1,820,0,2,607,0,609,G
2-PB1,821,1,1,611,0,613,G
2-PB1,822,0,0,612,0,612,G
2-PB1,823,0,2,610,0,612,G
2-PB1,824,0,0,610,0,610,G
2-PB1,825,0,605,0,1,606,T
2-PB1,826,603,0,0,0,603,A
2-PB1,827,610,0,1,0,611,A
2-PB1,828,0,610,0,0,610,T
2-PB1,829,0,5,604,0,609,G
2-PB1,830,604,0,0,0,604,A
2-PB1,831,590,0,1,0,591,A
2-PB1,832,590,0,2,0,592,A
2-PB1,833,587,0,0,0,587,A
2-PB1,834,1,3,582,0,586,G
2-PB1,835,580,0,0,0,580,A
2-PB1,836,574,0,0,1,575,A
2-PB1,837,0,1,575,0,576,G
2-PB1,838,1,1,571,0,573,G
2-PB1,839,0,0,0,568,568,C
2-PB1,840,1,0,0,569,570,C
2-PB1,841,570,1,0,0,571,A
2-PB1,842,570,0,0,0,570,A
2-PB1,843,572,0,0,0,572,A
2-PB1,844,1,0,0,574,575,C
2-PB1,845,0,574,0,1,575,T
2-PB1,846,1,1,578,0,580,G
2-PB1,847,1,0,579,0,580,G
2-PB1,848,0,1,0,577,578,C
2-PB1,849,580,0,0,0,580,A
2-PB1,850,578,0,1,0,579,A
2-PB1,851,582,0,0,0,582,A
2-PB1,852,0,581,0,0,581,T
2-PB1,853,0,0,582,0,582,G
2-PB1,854,0,579,0,1,580,T
2-PB1,855,0,554,0,0,554,T
2-PB1,856,0,0,557,0,557,G
2-PB1,857,0,557,0,2,559,T
2-PB1,858,0,3,555,0,558,G
2-PB1,859,555,0,2,0,557,A
2-PB1,860,0,2,559,0,561,G
2-PB1,861,557,0,0,0,557,A
2-PB1,862,555,0,0,0,555,A
2-PB1,863,554,0,0,0,554,A
2-PB1,864,555,1,0,0,556,A
2-PB1,865,558,0,0,0,558,A
2-PB1,866,0,556,0,0,556,T
2-PB1,867,0,5,554,0,559,G
2-PB1,868,560,0,0,0,560,A
2-PB1,869,1,548,0,0,549,T
2-PB1,870,0,4,547,0,551,G
2-PB1,871,551,0,0,0,551,A
2-PB1,872,0,1,0,552,553,C
2-PB1,873,0,549,0,1,550,T
2-PB1,874,546,1,0,0,547,A
2-PB1,875,553,0,0,0,553,A
2-PB1,876,0,551,0,1,552,T
2-PB1,877,0,560,0,1,561,T
2-PB1,878,2,0,0,563,565,C
2-PB1,879,558,0,0,0,558,A
2-PB1,880,0,0,0,561,561,C
2-PB1,881,547,0,1,0,548,A
2-PB1,882,548,0,0,0,548,A
2-PB1,883,0,1,549,0,550,G
2-PB1,884,543,0,0,0,543,A
2-PB1,885,0,0,0,545,545,C
2-PB1,886,543,0,1,0,544,A
2-PB1,887,0,0,0,544,544,C
2-PB1,888,538,0,1,0,539,A
2-PB1,889,0,1,538,0,539,G
2-PB1,890,534,0,2,0,536,A
2-PB1,891,0,1,543,0,544,G
2-PB1,892,0,0,0,544,544,C
2-PB1,893,0,528,0,2,530,T
2-PB1,894,0,530,0,0,530,T
2-PB1,895,0,531,0,0,531,T
2-PB1,896,5,0,0,524,529,C
2-PB1,897,0,526,0,2,528,T
2-PB1,898,0,524,0,0,524,T
2-PB1,899,0,522,0,0,522,T
2-PB1,900,2,0,0,523,525,C
2-PB1,901,520,1,1,0,522,A
2-PB1,902,1,1,0,522,524,C
2-PB1,903,516,0,0,0,516,A
2-PB1,904,517,0,0,0,517,A
2-PB1,905,1,522,0,0,523,T
2-PB1,906,5,0,0,528,533,C
2-PB1,907,528,0,0,0,528,A
2-PB1,908,0,1,0,528,529,C
2-PB1,909,0,526,0,0,526,T
2-PB1,910,0,1,526,0,527,G
2-PB1,911,0,3,519,0,522,G
2-PB1,912,0,1,536,0,537,G
2-PB1,913,0,2,535,0,537,G
2-PB1,914,525,0,1,0,526,A
2-PB1,915,0,0,0,498,498,C
2-PB1,916,510,0,0,0,510,A
2-PB1,917,536,0,0,0,536,A
2-PB1,918,1,0,0,540,541,C
2-PB1,919,536,0,0,0,536,A
2-PB1,920,0,0,0,536,536,C
2-PB1,921,0,515,0,0,515,T
2-PB1,922,518,0,0,0,518,A
2-PB1,923,516,0,0,0,516,A
2-PB1,924,0,0,518,0,518,G
2-PB1,925,0,511,0,1,512,T
2-PB1,926,0,2,478,0,480,G
2-PB1,927,0,0,471,0,471,G
2-PB1,928,468,0,1,0,469,A
2-PB1,929,465,0,3,0,468,A
2-PB1,930,0,468,0,0,468,T
2-PB1,931,0,3,463,0,466,G
2-PB1,932,466,0,1,0,467,A
2-PB1,933,457,0,0,0,457,A
2-PB1,934,461,0,0,0,461,A
2-PB1,935,466,0,0,1,467,A
2-PB1,936,0,464,0,1,465,T
2-PB1,937,4,1,0,461,466,C
2-PB1,938,465,0,1,0,466,A
2-PB1,939,462,1,1,0,464,A
2-PB1,940,460,0,1,0,461,A
2-PB1,941,465,0,0,0,465,A
2-PB1,942,0,0,0,468,468,C
2-PB1,943,0,1,0,461,462,C
2-PB1,944,1,0,0,452,453,C
2-PB1,945,0,455,0,0,455,T
2-PB1,946,1,0,0,454,455,C
2-PB1,947,0,1,454,0,455,G
2-PB1,948,455,0,0,0,455,A
2-PB1,949,452,0,0,0,452,A
2-PB1,950,0,456,0,0,456,T
2-PB1,951,0,1,460,0,461,G
2-PB1,952,0,452,0,1,453,T
2-PB1,953,0,446,0,0,446,T
2-PB1,954,0,447,0,0,447,T
2-PB1,955,0,449,0,0,449,T
2-PB1,956,0,448,0,0,448,T
2-PB1,957,1,0,444,0,445,G
2-PB1,958,0,0,442,0,442,G
2-PB1,959,1,0,0,442,443,C
2-PB1,960,0,2,437,0,439,G
2-PB1,961,438,0,0,0,438,A
2-PB1,962,0,444,0,0,444,T
2-PB1,963,1,1,458,0,460,G
2-PB1,964,474,0,0,0,474,A
2-PB1,965,0,476,0,1,477,T
2-PB1,966,0,476,0,0,476,T
2-PB1,967,473,0,2,0,475,A
2-PB1,968,1,0,0,478,479,C
2-PB1,969,480,0,0,0,480,A
2-PB1,970,0,482,0,0,482,T
2-PB1,971,454,0,0,0,454,A
2-PB1,972,0,0,0,455,455,C
2-PB1,973,397,0,0,0,397,A
2-PB1,974,0,395,0,0,395,T
2-PB1,975,3,0,0,391,394,C
2-PB1,976,390,0,0,0,390,A
2-PB1,977,1,0,0,389,390,C
2-PB1,978,384,0,0,0,384,A
2-PB1,979,384,0,0,0,384,A
2-PB1,980,382,0,1,0,383,A
2-PB1,981,0,0,373,0,373,G
2-PB1,982,383,0,0,0,383,A
2-PB1,983,383,0,0,0,383,A
2-PB1,984,0,384,0,0,384,T
2-PB1,985,3,0,0,375,378,C
2-PB1,986,378,0,1,0,379,A
2-PB1,987,382,0,1,0,383,A
2-PB1,988,0,0,0,384,384,C
2-PB1,989,0,0,0,385,385,C
2-PB1,990,0,360,0,0,360,T
2-PB1,991,0,4,360,0,364,G
2-PB1,992,364,0,0,0,364,A
2-PB1,993,0,0,365,0,365,G
2-PB1,994,0,361,0,0,361,T
2-PB1,995,0,2,345,0,347,G
2-PB1,996,0,0,360,0,360,G
2-PB1,997,0,351,0,0,351,T
2-PB1,998,0,351,0,0,351,T
2-PB1,999,2,0,0,347,349,C
2-PB1,1000,342,0,0,0,342,A
2-PB1,1001,0,0,345,0,345,G
2-PB1,1002,345,0,1,0,346,A
2-PB1,1003,347,0,0,0,347,A
2-PB1,1004,346,0,0,0,346,A
2-PB1,1005,0,0,0,298,298,C
2-PB1,1006,302,0,0,0,302,A
2-PB1,1007,0,299,0,0,299,T
2-PB1,1008,0,0,1,299,300,C
2-PB1,1009,0,0,0,301,301,C
2-PB1,1010,0,285,0,0,285,T
2-PB1,1011,0,3,284,0,287,G
2-PB1,1012,281,0,1,0,282,A
2-PB1,1013,0,0,283,0,283,G
2-PB1,1014,0,0,0,279,279,C
2-PB1,1015,266,0,0,0,266,A
2-PB1,1016,0,266,0,0,266,T
2-PB1,1017,0,1,0,262,263,C
2-PB1,1018,0,0,263,0,263,G
2-PB1,1019,0,0,0,274,274,C
2-PB1,1020,275,0,1,0,276,A
2-PB1,1021,0,0,0,285,285,C
2-PB1,1022,2,1,0,281,284,C
2-PB1,1023,285,0,0,0,285,A
2-PB1,1024,290,0,1,0,291,A
2-PB1,1025,0,288,0,0,288,T
2-PB1,1026,289,0,0,0,289,A
2-PB1,1027,292,0,0,0,292,A
2-PB1,1028,0,282,0,0,282,T
2-PB1,1029,1,0,283,0,284,G
2-PB1,1030,0,278,0,0,278,T
2-PB1,1031,0,275,0,1,276,T
2-PB1,1032,1,0,0,273,274,C
2-PB1,1033,0,270,0,0,270,T
2-PB1,1034,2,0,0,271,273,C
2-PB1,1035,273,0,0,0,273,A
2-PB1,1036,273,0,0,0,273,A
2-PB1,1037,272,0,2,0,274,A
2-PB1,1038,0,0,0,274,274,C
2-PB1,1039,274,0,0,0,274,A
2-PB1,1040,271,0,0,0,271,A
2-PB1,1041,272,0,0,0,272,A
2-PB1,1042,275,0,0,0,275,A
2-PB1,1043,0,279,0,1,280,T
2-PB1,1044,0,2,279,0,281,G
2-PB1,1045,1,1,278,0,280,G
2-PB1,1046,1,1,0,276,278,C
2-PB1,1047,279,0,0,0,279,A
2-PB1,1048,278,0,0,0,278,A
2-PB1,1049,0,2,277,0,279,G
2-PB1,1050,280,0,0,0,280,A
2-PB1,1051,0,0,0,278,278,C
2-PB1,1052,0,276,0,0,276,T
2-PB1,1053,0,1,280,0,281,G
2-PB1,1054,0,0,281,0,281,G
2-PB1,1055,1,1,281,0,283,G
2-PB1,1056,283,0,1,0,284,A
2-PB1,1057,283,0,0,0,283,A
2-PB1,1058,282,0,1,0,283,A
2-PB1,1059,282,1,0,0,283,A
2-PB1,1060,0,1,295,0,296,G
2-PB1,1061,0,1,293,1,295,G
2-PB1,1062,294,0,1,0,295,A
2-PB1,1063,0,292,0,0,292,T
2-PB1,1064,291,0,1,0,292,A
2-PB1,1065,0,0,0,291,291,C
2-PB1,1066,295,0,0,0,295,A
2-PB1,1067,0,296,0,1,297,T
2-PB1,1068,0,0,300,0,300,G
2-PB1,1069,0,295,0,0,295,T
2-PB1,1070,0,295,0,0,295,T
2-PB1,1071,1,0,1,293,295,C
2-PB1,1072,0,1,294,0,295,G
2-PB1,1073,292,0,1,0,293,A
2-PB1,1074,0,1,296,0,297,G
2-PB1,1075,292,0,1,0,293,A
2-PB1,1076,0,0,296,0,296,G
2-PB1,1077,0,295,0,0,295,T
2-PB1,1078,292,0,0,0,292,A
2-PB1,1079,293,0,0,0,293,A
2-PB1,1080,0,3,292,0,295,G
2-PB1,1081,293,0,1,0,294,A
2-PB1,1082,0,0,298,0,298,G
2-PB1,1083,289,0,0,0,289,A
2-PB1,1084,287,0,1,0,288,A
2-PB1,1085,0,285,0,1,286,T
2-PB1,1086,1,1,282,0,284,G
2-PB1,1087,287,0,0,0,287,A
2-PB1,1088,285,0,1,0,286,A
2-PB1,1089,0,0,283,0,283,G
2-PB1,1090,0,0,0,284,284,C
2-PB1,1091,0,282,0,0,282,T
2-PB1,1092,3,1,0,281,285,C
2-PB1,1093,1,1,0,283,285,C
2-PB1,1094,0,1,284,0,285,G
2-PB1,1095,0,2,287,0,289,G
2-PB1,1096,286,0,0,0,286,A
2-PB1,1097,0,0,1,287,288,C
2-PB1,1098,286,0,1,0,287,A
2-PB1,1099,0,0,0,291,291,C
2-PB1,1100,290,0,0,0,290,A
2-PB1,1101,289,0,1,0,290,A
2-PB1,1102,290,1,1,0,292,A
2-PB1,1103,0,292,0,0,292,T
2-PB1,1104,291,1,0,0,292,A
2-PB1,1105,0,0,0,293,293,C
2-PB1,1106,0,0,0,293,293,C
2-PB1,1107,0,290,0,1,291,T
2-PB1,1108,1,0,291,0,292,G
2-PB1,1109,0,0,0,290,290,C
2-PB1,1110,293,0,0,0,293,A
2-PB1,1111,0,0,295,0,295,G
2-PB1,1112,292,0,1,0,293,A
2-PB1,1113,292,1,0,0,293,A
2-PB1,1114,293,0,0,0,293,A
2-PB1,1115,0,292,0,0,292,T
2-PB1,1116,1,0,291,0,292,G
2-PB1,1117,0,0,0,293,293,C
2-PB1,1118,0,294,0,0,294,T
2-PB1,1119,296,0,0,0,296,A
2-PB1,1120,0,1,294,0,295,G
2-PB1,1121,0,0,0,296,296,C
2-PB1,1122,296,0,0,0,296,A
2-PB1,1123,290,0,2,0,292,A
2-PB1,1124,0,0,293,0,293,G
2-PB1,1125,1,0,0,293,294,C
2-PB1,1126,291,0,0,0,291,A
2-PB1,1127,0,295,0,0,295,T
2-PB1,1128,0,297,0,0,297,T
2-PB1,1129,0,2,303,0,305,G
2-PB1,1130,304,0,2,0,306,A
2-PB1,1131,1,0,0,308,309,C
2-PB1,1132,1,0,0,302,303,C
2-PB1,1133,0,298,0,0,298,T
2-PB1,1134,0,1,300,0,301,G
2-PB1,1135,302,0,1,0,303,A
2-PB1,1136,300,0,2,0,302,A
2-PB1,1137,0,0,309,1,310,G
2-PB1,1138,0,301,0,0,301,T
2-PB1,1139,302,0,0,0,302,A
2-PB1,1140,0,299,0,0,299,T
2-PB1,1141,0,300,0,0,300,T
2-PB1,1142,0,300,0,1,301,T
2-PB1,1143,3,0,0,293,296,C
2-PB1,1144,294,0,0,0,294,A
2-PB1,1145,295,0,0,0,295,A
2-PB1,1146,0,290,0,0,290,T
2-PB1,1147,0,1,291,0,292,G
2-PB1,1148,289,1,0,0,290,A
2-PB1,1149,290,0,0,0,290,A
2-PB1,1150,0,288,0,0,288,T
2-PB1,1151,2,0,0,289,291,C
2-PB1,1152,290,0,0,0,290,A
2-PB1,1153,292,0,0,0,292,A
2-PB1,1154,0,0,0,291,291,C
2-PB1,1155,290,1,0,0,291,A
2-PB1,1156,292,0,0,0,292,A
2-PB1,1157,0,0,292,0,292,G
2-PB1,1158,0,0,300,0,300,G
2-PB1,1159,299,0,0,0,299,A
2-PB1,1160,297,0,0,0,297,A
2-PB1,1161,0,2,296,0,298,G
2-PB1,1162,300,0,0,0,300,A
2-PB1,1163,300,0,1,0,301,A
2-PB1,1164,299,0,0,0,299,A
2-PB1,1165,300,0,0,0,300,A
2-PB1,1166,0,298,0,0,298,T
2-PB1,1167,0,300,0,0,300,T
2-PB1,1168,1,4,298,0,303,G
2-PB1,1169,299,0,1,0,300,A
2-PB1,1170,0,1,300,0,301,G
2-PB1,1171,300,0,0,0,300,A
2-PB1,1172,304,0,0,0,304,A
2-PB1,1173,306,0,0,0,306,A
2-PB1,1174,309,0,0,0,309,A
2-PB1,1175,0,309,0,0,309,T
2-PB1,1176,309,0,0,0,309,A
2-PB1,1177,309,0,0,0,309,A
2-PB1,1178,0,1,306,0,307,G
2-PB1,1179,1,0,307,0,308,G
2-PB1,1180,0,0,0,305,305,C
2-PB1,1181,0,0,0,300,300,C
2-PB1,1182,0,300,0,0,300,T
2-PB1,1183,1,0,0,322,323,C
2-PB1,1184,0,328,0,0,328,T
2-PB1,1185,0,331,0,0,331,T
2-PB1,1186,0,0,0,337,337,C
2-PB1,1187,0,333,0,0,333,T
2-PB1,1188,337,0,0,0,337,A
2-PB1,1189,337,0,0,0,337,A
2-PB1,1190,0,337,1,0,338,T
2-PB1,1191,335,0,0,0,335,A
2-PB1,1192,0,0,333,0,333,G
2-PB1,1193,305,0,0,0,305,A
2-PB1,1194,0,303,1,0,304,T
2-PB1,1195,1,4,296,0,301,G
2-PB1,1196,0,0,304,0,304,G
2-PB1,1197,0,0,0,299,299,C
2-PB1,1198,302,0,1,0,303,A
2-PB1,1199,0,0,0,305,305,C
2-PB1,1200,297,0,1,0,298,A
2-PB1,1201,0,0,307,0,307,G
2-PB1,1202,0,0,0,305,305,C
2-PB1,1203,302,0,0,0,302,A
2-PB1,1204,0,312,0,1,313,T
2-PB1,1205,1,0,0,310,311,C
2-PB1,1206,311,0,0,0,311,A
2-PB1,1207,0,309,0,1,310,T
2-PB1,1208,0,308,0,0,308,T
2-PB1,1209,0,3,306,0,309,G
2-PB1,1210,300,0,0,0,300,A
2-PB1,1211,0,0,301,0,301,G
2-PB1,1212,0,1,0,300,301,C
2-PB1,1213,0,0,0,293,293,C
2-PB1,1214,2,0,0,298,300,C
2-PB1,1215,0,301,0,0,301,T
2-PB1,1216,0,1,343,0,344,G
2-PB1,1217,0,1,350,0,351,G
2-PB1,1218,353,0,0,0,353,A
2-PB1,1219,377,0,0,0,377,A
2-PB1,1220,0,369,0,0,369,T
2-PB1,1221,0,1,396,0,397,G
2-PB1,1222,411,0,1,0,412,A
2-PB1,1223,0,415,0,2,417,T
2-PB1,1224,0,1,416,0,417,G
2-PB1,1225,412,0,1,1,414,A
2-PB1,1226,0,409,0,0,409,T
2-PB1,1227,0,2,407,0,409,G
2-PB1,1228,0,1,412,0,413,G
2-PB1,1229,1,2,411,0,414,G
2-PB1,1230,0,0,0,410,410,C
2-PB1,1231,408,0,0,0,408,A
2-PB1,1232,0,416,0,0,416,T
2-PB1,1233,0,0,437,0,437,G
2-PB1,1234,0,438,0,0,438,T
2-PB1,1235,0,446,0,0,446,T
2-PB1,1236,3,0,0,443,446,C
2-PB1,1237,445,0,0,0,445,A
2-PB1,1238,446,0,0,0,446,A
2-PB1,1239,0,0,0,448,448,C
2-PB1,1240,449,0,0,0,449,A
2-PB1,1241,0,451,0,0,451,T
2-PB1,1242,0,0,455,0,455,G
2-PB1,1243,0,0,0,456,456,C
2-PB1,1244,0,456,0,0,456,T
2-PB1,1245,464,0,0,0,464,A
2-PB1,1246,462,0,1,0,463,A
2-PB1,1247,0,3,473,0,476,G
2-PB1,1248,0,475,0,0,475,T
2-PB1,1249,474,0,0,0,474,A
2-PB1,1250,0,0,0,476,476,C
2-PB1,1251,0,3,486,0,489,G
2-PB1,1252,0,0,521,0,521,G
2-PB1,1253,0,521,0,0,521,T
2-PB1,1254,0,519,0,0,519,T
2-PB1,1255,0,517,0,0,517,T
2-PB1,1256,0,514,0,0,514,T
2-PB1,1257,513,0,0,0,513,A
2-PB1,1258,0,1,513,0,514,G
2-PB1,1259,0,4,510,0,514,G
2-PB1,1260,505,0,1,0,506,A
2-PB1,1261,0,0,505,0,505,G
2-PB1,1262,0,522,0,0,522,T
2-PB1,1263,1,0,0,525,526,C
2-PB1,1264,0,525,0,2,527,T
2-PB1,1265,2,2,0,523,527,C
2-PB1,1266,4,2,522,0,528,G
2-PB1,1267,556,0,1,0,557,A
2-PB1,1268,0,558,0,0,558,T
2-PB1,1269,562,0,1,0,563,A
2-PB1,1270,0,0,0,562,562,C
2-PB1,1271,0,552,0,0,552,T
2-PB1,1272,1,4,547,0,552,G
2-PB1,1273,549,0,0,0,549,A
2-PB1,1274,561,0,0,0,561,A
2-PB1,1275,0,560,0,0,560,T
2-PB1,1276,6,0,0,540,546,C
2-PB1,1277,0,545,0,0,545,T
2-PB1,1278,1,543,0,1,545,T
2-PB1,1279,0,1,545,0,546,G
2-PB1,1280,0,0,546,0,546,G
2-PB1,1281,543,0,1,0,544,A
2-PB1,1282,1,0,0,545,546,C
2-PB1,1283,541,0,0,0,541,A
2-PB1,1284,545,0,1,0,546,A
2-PB1,1285,550,0,0,0,550,A
2-PB1,1286,547,0,4,1,552,A
2-PB1,1287,0,0,568,0,568,G
2-PB1,1288,568,0,2,0,570,A
2-PB1,1289,567,0,0,1,568,A
2-PB1,1290,564,0,4,0,568,A
2-PB1,1291,0,568,0,0,568,T
2-PB1,1292,571,0,0,0,571,A
2-PB1,1293,0,0,1,591,592,C
2-PB1,1294,588,0,0,1,589,A
2-PB1,1295,0,0,0,595,595,C
2-PB1,1296,2,0,0,581,583,C
2-PB1,1297,579,0,2,0,581,A
2-PB1,1298,594,0,0,0,594,A
2-PB1,1299,0,3,611,0,614,G
2-PB1,1300,626,0,0,0,626,A
2-PB1,1301,0,0,0,630,630,C
2-PB1,1302,615,0,0,0,615,A
2-PB1,1303,637,0,2,1,640,A
2-PB1,1304,0,0,0,642,642,C
2-PB1,1305,652,0,3,0,655,A
2-PB1,1306,0,658,0,0,658,T
2-PB1,1307,648,0,1,1,650,A
2-PB1,1308,0,1,0,660,661,C
2-PB1,1309,0,645,1,0,646,T
2-PB1,1310,0,1,655,0,656,G
2-PB1,1311,0,1,656,0,657,G
2-PB1,1312,1,643,0,0,644,T
2-PB1,1313,0,1,643,0,644,G
2-PB1,1314,0,0,638,0,638,G
2-PB1,1315,0,2,639,0,641,G
2-PB1,1316,641,0,0,0,641,A
2-PB1,1317,0,630,0,1,631,T
2-PB1,1318,1,1,628,0,630,G
2-PB1,1319,0,1,629,0,630,G
2-PB1,1320,0,1,629,0,630,G
2-PB1,1321,1,0,1,637,639,C
2-PB1,1322,0,632,0,3,635,T
2-PB1,1323,2,1,0,637,640,C
2-PB1,1324,2,2,0,633,637,C
2-PB1,1325,635,0,1,0,636,A
2-PB1,1326,638,0,0,0,638,A
2-PB1,1327,0,640,0,0,640,T
2-PB1,1328,1,0,0,636,637,C
2-PB1,1329,0,1,0,632,633,C
2-PB1,1330,0,629,0,1,630,T
2-PB1,1331,4,0,0,626,630,C
2-PB1,1332,1,2,0,624,627,C
2-PB1,1333,0,2,626,0,628,G
2-PB1,1334,628,0,1,0,629,A
2-PB1,1335,0,2,0,628,630,C
2-PB1,1336,0,3,626,0,629,G
2-PB1,1337,635,1,0,1,637,A
2-PB1,1338,0,636,0,0,636,T
2-PB1,1339,0,633,0,0,633,T
2-PB1,1340,0,632,0,1,633,T
2-PB1,1341,0,636,0,0,636,T
2-PB1,1342,0,1,637,0,638,G
2-PB1,1343,0,1,1,642,644,C
2-PB1,1344,3,0,0,646,649,C
2-PB1,1345,1,1,0,672,674,C
2-PB1,1346,0,660,0,3,663,T
2-PB1,1347,6,0,0,687,693,C
2-PB1,1348,699,0,0,0,699,A
2-PB1,1349,0,703,0,0,703,T
2-PB1,1350,701,0,1,1,703,A
2-PB1,1351,0,0,715,0,715,G
2-PB1,1352,0,706,0,0,706,T
2-PB1,1353,0,5,708,0,713,G
2-PB1,1354,696,0,2,0,698,A
2-PB1,1355,696,0,3,0,699,A
2-PB1,1356,0,675,0,1,676,T
2-PB1,1357,0,2,676,0,678,G
2-PB1,1358,0,0,0,685,685,C
2-PB1,1359,683,0,0,1,684,A
2-PB1,1360,2,1,0,687,690,C
2-PB1,1361,3,0,0,682,685,C
2-PB1,1362,681,1,0,0,682,A
2-PB1,1363,682,0,0,0,682,A
2-PB1,1364,679,0,0,0,679,A
2-PB1,1365,1,662,0,0,663,T
2-PB1,1366,7,0,1,686,694,C
2-PB1,1367,693,1,1,0,695,A
2-PB1,1368,0,694,0,0,694,T
2-PB1,1369,0,1,695,0,696,G
2-PB1,1370,696,0,2,0,698,A
2-PB1,1371,0,2,692,0,694,G
2-PB1,1372,0,3,694,0,697,G
2-PB1,1373,0,3,698,0,701,G
2-PB1,1374,699,0,0,0,699,A
2-PB1,1375,703,0,2,0,705,A
2-PB1,1376,0,705,1,0,706,T
2-PB1,1377,710,0,0,0,710,A
2-PB1,1378,0,0,0,713,713,C
2-PB1,1379,713,0,0,0,713,A
2-PB1,1380,715,0,1,0,716,A
2-PB1,1381,0,1,713,0,714,G
2-PB1,1382,0,1,0,706,707,C
2-PB1,1383,699,1,0,0,700,A
2-PB1,1384,0,2,709,0,711,G
2-PB1,1385,0,5,707,0,712,G
2-PB1,1386,704,0,4,0,708,A
2-PB1,1387,0,0,713,0,713,G
2-PB1,1388,0,704,1,0,705,T
2-PB1,1389,0,1,713,0,714,G
2-PB1,1390,12,1,707,1,721,G
2-PB1,1391,714,0,0,1,715,A
2-PB1,1392,0,717,0,0,717,T
2-PB1,1393,708,0,0,0,708,A
2-PB1,1394,1,1,711,0,713,G
2-PB1,1395,716,0,1,0,717,A
2-PB1,1396,0,721,0,0,721,T
2-PB1,1397,1,716,0,0,717,T
2-PB1,1398,1,0,0,751,752,C
2-PB1,1399,0,746,0,0,746,T
2-PB1,1400,747,0,0,0,747,A
2-PB1,1401,0,0,0,746,746,C
2-PB1,1402,737,0,1,1,739,A
2-PB1,1403,0,3,741,0,744,G
2-PB1,1404,0,4,727,0,731,G
2-PB1,1405,731,0,0,0,731,A
2-PB1,1406,2,1,1,726,730,C
2-PB1,1407,2,0,0,714,716,C
2-PB1,1408,0,707,0,1,708,T
2-PB1,1409,0,1,714,0,715,G
2-PB1,1410,0,0,0,711,711,C
2-PB1,1411,711,1,0,0,712,A
2-PB1,1412,714,0,1,0,715,A
2-PB1,1413,0,0,725,0,725,G
2-PB1,1414,0,711,0,0,711,T
2-PB1,1415,0,712,0,1,713,T
2-PB1,1416,700,2,0,0,702,A
2-PB1,1417,0,1,706,0,707,G
2-PB1,1418,0,700,0,1,701,T
2-PB1,1419,1,0,700,0,701,G
2-PB1,1420,1,2,699,0,702,G
2-PB1,1421,0,3,705,0,708,G
2-PB1,1422,705,0,1,0,706,A
2-PB1,1423,709,0,0,0,709,A
2-PB1,1424,0,705,1,0,706,T
2-PB1,1425,5,1,0,705,711,C
2-PB1,1426,713,0,0,0,713,A
2-PB1,1427,712,0,1,0,713,A
2-PB1,1428,0,1,0,709,710,C
2-PB1,1429,712,0,0,0,712,A
2-PB1,1430,0,701,0,0,701,T
2-PB1,1431,1,9,688,0,698,G
2-PB1,1432,698,0,5,0,703,A
2-PB1,1433,0,0,718,0,718,G
2-PB1,1434,0,0,0,713,713,C
2-PB1,1435,714,0,0,0,714,A
2-PB1,1436,714,0,0,0,714,A
2-PB1,1437,711,0,1,1,713,A
2-PB1,1438,714,0,0,0,714,A
2-PB1,1439,714,0,0,0,714,A
2-PB1,1440,0,2,713,0,715,G
2-PB1,1441,709,0,0,0,709,A
2-PB1,1442,699,0,0,0,699,A
2-PB1,1443,0,0,723,0,723,G
2-PB1,1444,0,720,0,1,721,T
2-PB1,1445,4,0,0,724,728,C
2-PB1,1446,3,0,0,728,731,C
2-PB1,1447,0,726,0,1,727,T
2-PB1,1448,736,0,1,0,737,A
2-PB1,1449,1,739,0,0,740,T
2-PB1,1450,741,0,0,0,741,A
2-PB1,1451,0,741,1,0,742,T
2-PB1,1452,744,0,0,0,744,A
2-PB1,1453,740,0,2,0,742,A
2-PB1,1454,741,0,0,0,741,A
2-PB1,1455,0,740,0,0,740,T
2-PB1,1456,730,0,0,0,730,A
2-PB1,1457,717,0,3,0,720,A
2-PB1,1458,728,0,0,0,728,A
2-PB1,1459,726,0,0,0,726,A
2-PB1,1460,0,0,0,728,728,C
2-PB1,1461,693,0,1,0,694,A
2-PB1,1462,0,2,695,0,697,G
2-PB1,1463,0,3,687,0,690,G
2-PB1,1464,0,5,683,0,688,G
2-PB1,1465,691,0,3,0,694,A
2-PB1,1466,1,0,0,689,690,C
2-PB1,1467,682,0,1,0,683,A
2-PB1,1468,0,691,0,0,691,T
2-PB1,1469,0,688,1,2,691,T
2-PB1,1470,0,688,1,1,690,T
2-PB1,1471,0,5,687,0,692,G
2-PB1,1472,689,0,0,0,689,A
2-PB1,1473,686,0,0,0,686,A
2-PB1,1474,0,691,0,0,691,T
2-PB1,1475,1,677,0,0,678,T
2-PB1,1476,3,1,0,675,679,C
2-PB1,1477,675,0,1,0,676,A
2-PB1,1478,0,0,0,677,677,C
2-PB1,1479,0,674,0,1,675,T
2-PB1,1480,678,0,0,0,678,A
2-PB1,1481,0,0,681,0,681,G
2-PB1,1482,0,0,0,677,677,C
2-PB1,1483,0,668,0,3,671,T
2-PB1,1484,0,673,0,1,674,T
2-PB1,1485,0,671,0,0,671,T
2-PB1,1486,0,671,0,1,672,T
2-PB1,1487,0,672,1,1,674,T
2-PB1,1488,0,670,0,1,671,T
2-PB1,1489,0,670,0,0,670,T
2-PB1,1490,670,0,0,0,670,A
2-PB1,1491,0,664,1,0,665,T
2-PB1,1492,1,1,0,668,670,C
2-PB1,1493,0,1,675,0,676,G
2-PB1,1494,702,0,0,0,702,A
2-PB1,1495,0,704,0,0,704,T
2-PB1,1496,697,0,1,0,698,A
2-PB1,1497,0,712,0,0,712,T
2-PB1,1498,2,5,707,0,714,G
2-PB1,1499,0,3,713,0,716,G
2-PB1,1500,719,0,0,0,719,A
2-PB1,1501,0,708,1,3,712,T
2-PB1,1502,0,709,0,2,711,T
2-PB1,1503,0,689,0,1,690,T
2-PB1,1504,0,0,689,0,689,G
2-PB1,1505,0,688,0,0,688,T
2-PB1,1506,0,4,679,0,683,G
2-PB1,1507,1,1,686,0,688,G
2-PB1,1508,1,0,0,683,684,C
2-PB1,1509,0,682,0,0,682,T
2-PB1,1510,682,0,1,0,683,A
2-PB1,1511,688,0,0,0,688,A
2-PB1,1512,0,692,1,1,694,T
2-PB1,1513,0,692,0,0,692,T
2-PB1,1514,0,692,1,0,693,T
2-PB1,1515,0,691,0,0,691,T
2-PB1,1516,693,0,0,0,693,A
2-PB1,1517,0,2,694,0,696,G
2-PB1,1518,1,1,0,694,696,C
2-PB1,1519,694,0,0,0,694,A
2-PB1,1520,0,686,1,0,687,T
2-PB1,1521,0,2,682,0,684,G
2-PB1,1522,0,3,690,0,693,G
2-PB1,1523,688,0,1,0,689,A
2-PB1,1524,0,0,693,0,693,G
2-PB1,1525,1,0,0,688,689,C
2-PB1,1526,0,678,1,2,681,T
2-PB1,1527,1,0,686,0,687,G
2-PB1,1528,1,0,0,683,684,C
2-PB1,1529,5,0,0,681,686,C
2-PB1,1530,3,0,0,688,691,C
2-PB1,1531,677,0,0,0,677,A
2-PB1,1532,1,1,725,0,727,G
2-PB1,1533,0,722,0,0,722,T
2-PB1,1534,0,721,0,0,721,T
2-PB1,1535,0,723,0,0,723,T
2-PB1,1536,1,717,0,1,719,T
2-PB1,1537,0,3,717,0,720,G
2-PB1,1538,1,5,714,0,720,G
2-PB1,1539,718,0,0,0,718,A
2-PB1,1540,0,0,715,0,715,G
2-PB1,1541,0,675,0,0,675,T
2-PB1,1542,669,0,2,0,671,A
2-PB1,1543,0,693,0,1,694,T
2-PB1,1544,2,0,0,693,695,C
2-PB1,1545,0,694,0,0,694,T
2-PB1,1546,1,4,704,0,709,G
2-PB1,1547,0,5,710,0,715,G
2-PB1,1548,713,1,0,0,714,A
2-PB1,1549,718,0,0,0,718,A
2-PB1,1550,0,717,0,1,718,T
2-PB1,1551,704,0,0,0,704,A
2-PB1,1552,704,0,1,0,705,A
2-PB1,1553,702,0,0,0,702,A
2-PB1,1554,2,0,0,708,710,C
2-PB1,1555,0,2,695,0,697,G
2-PB1,1556,688,0,1,0,689,A
2-PB1,1557,0,0,689,0,689,G
2-PB1,1558,0,687,0,1,688,T
2-PB1,1559,3,0,0,691,694,C
2-PB1,1560,692,0,1,0,693,A
2-PB1,1561,0,1,708,0,709,G
2-PB1,1562,0,0,0,708,708,C
2-PB1,1563,0,707,0,0,707,T
2-PB1,1564,1,2,725,0,728,G
2-PB1,1565,722,0,1,0,723,A
2-PB1,1566,0,728,0,0,728,T
2-PB1,1567,730,0,1,0,731,A
2-PB1,1568,0,716,0,1,717,T
2-PB1,1569,1,4,721,0,726,G
2-PB1,1570,701,0,1,0,702,A
2-PB1,1571,1,0,712,0,713,G
2-PB1,1572,1,1,1,714,717,C
2-PB1,1573,684,0,0,0,684,A
2-PB1,1574,0,684,0,2,686,T
2-PB1,1575,1,684,0,0,685,T
2-PB1,1576,2,1,687,0,690,G
2-PB1,1577,0,4,708,0,712,G
2-PB1,1578,701,0,2,0,703,A
2-PB1,1579,0,1,704,0,705,G
2-PB1,1580,0,680,0,3,683,T
2-PB1,1581,684,0,0,0,684,A
2-PB1,1582,680,1,1,0,682,A
2-PB1,1583,0,1,0,683,684,C
2-PB1,1584,678,0,0,0,678,A
2-PB1,1585,0,1,687,0,688,G
2-PB1,1586,0,649,0,1,650,T
2-PB1,1587,0,1,658,0,659,G
2-PB1,1588,670,0,2,0,672,A
2-PB1,1589,0,670,0,0,670,T
2-PB1,1590,672,0,1,0,673,A
2-PB1,1591,672,0,1,0,673,A
2-PB1,1592,660,0,0,0,660,A
2-PB1,1593,1,4,660,0,665,G
2-PB1,1594,640,0,0,0,640,A
2-PB1,1595,640,0,2,0,642,A
2-PB1,1596,0,1,0,643,644,C
2-PB1,1597,629,0,0,0,629,A
2-PB1,1598,630,0,3,0,633,A
2-PB1,1599,0,0,0,639,639,C
2-PB1,1600,643,0,0,0,643,A
2-PB1,1601,0,641,2,0,643,T
2-PB1,1602,0,2,639,0,641,G
2-PB1,1603,636,0,1,1,638,A
2-PB1,1604,0,639,0,0,639,T
2-PB1,1605,633,0,0,1,634,A
2-PB1,1606,637,0,0,0,637,A
2-PB1,1607,637,0,3,0,640,A
2-PB1,1608,0,0,0,645,645,C
2-PB1,1609,624,0,0,0,624,A
2-PB1,1610,622,0,0,0,622,A
2-PB1,1611,0,611,1,2,614,T
2-PB1,1612,0,4,615,0,619,G
2-PB1,1613,635,0,1,0,636,A
2-PB1,1614,1,0,0,641,642,C
2-PB1,1615,4,1,0,635,640,C
2-PB1,1616,0,623,0,1,624,T
2-PB1,1617,0,608,0,0,608,T
2-PB1,1618,0,3,605,0,608,G
2-PB1,1619,1,3,608,0,612,G
2-PB1,1620,621,0,0,0,621,A
2-PB1,1621,0,0,0,615,615,C
2-PB1,1622,2,0,1,610,613,C
2-PB1,1623,600,1,0,0,601,A
2-PB1,1624,0,0,605,1,606,G
2-PB1,1625,0,0,0,607,607,C
2-PB1,1626,605,0,2,0,607,A
2-PB1,1627,607,1,0,0,608,A
2-PB1,1628,0,0,0,607,607,C
2-PB1,1629,600,0,0,0,600,A
2-PB1,1630,0,0,620,0,620,G
2-PB1,1631,0,1,0,619,620,C
2-PB1,1632,3,0,0,623,626,C
2-PB1,1633,4,0,0,615,619,C
2-PB1,1634,618,0,0,0,618,A
2-PB1,1635,617,0,0,0,617,A
2-PB1,1636,616,0,1,0,617,A
2-PB1,1637,0,618,0,0,618,T
2-PB1,1638,1,1,611,0,613,G
2-PB1,1639,0,0,611,0,611,G
2-PB1,1640,0,0,0,613,613,C
2-PB1,1641,0,611,0,0,611,T
2-PB1,1642,2,0,0,628,630,C
2-PB1,1643,0,628,0,1,629,T
2-PB1,1644,1,0,0,632,633,C
2-PB1,1645,5,0,0,632,637,C
2-PB1,1646,637,0,0,0,637,A
2-PB1,1647,637,0,1,0,638,A
2-PB1,1648,0,638,0,0,638,T
2-PB1,1649,0,631,0,2,633,T
2-PB1,1650,0,2,635,0,637,G
2-PB1,1651,0,621,0,1,622,T
2-PB1,1652,0,624,0,2,626,T
2-PB1,1653,9,1,0,616,626,C
2-PB1,1654,623,0,0,0,623,A
2-PB1,1655,0,622,0,2,624,T
2-PB1,1656,4,0,0,619,623,C
2-PB1,1657,626,1,0,0,627,A
2-PB1,1658,627,0,0,0,627,A
2-PB1,1659,622,1,1,0,624,A
2-PB1,1660,0,1,637,0,638,G
2-PB1,1661,637,1,0,0,638,A
2-PB1,1662,0,635,0,1,636,T
2-PB1,1663,0,633,0,0,633,T
2-PB1,1664,632,0,1,0,633,A
2-PB1,1665,0,0,0,645,645,C
2-PB1,1666,640,0,2,0,642,A
2-PB1,1667,0,1,650,0,651,G
2-PB1,1668,649,1,1,0,651,A
2-PB1,1669,0,655,0,0,655,T
2-PB1,1670,658,0,0,0,658,A
2-PB1,1671,0,2,0,700,702,C
2-PB1,1672,717,0,3,0,720,A
2-PB1,1673,0,1,0,760,761,C
2-PB1,1674,737,0,1,0,738,A
2-PB1,1675,0,746,0,0,746,T
2-PB1,1676,747,0,0,0,747,A
2-PB1,1677,0,744,0,0,744,T
2-PB1,1678,732,1,0,0,733,A
2-PB1,1679,0,3,736,0,739,G
2-PB1,1680,0,2,725,0,727,G
2-PB1,1681,0,697,0,2,699,T
2-PB1,1682,0,0,683,0,683,G
2-PB1,1683,0,0,0,717,717,C
2-PB1,1684,1,0,0,718,719,C
2-PB1,1685,726,0,1,0,727,A
2-PB1,1686,0,725,0,0,725,T
2-PB1,1687,725,1,0,0,726,A
2-PB1,1688,2,2,724,0,728,G
2-PB1,1689,707,0,1,0,708,A
2-PB1,1690,1,0,715,0,716,G
2-PB1,1691,0,0,719,0,719,G
2-PB1,1692,693,0,0,0,693,A
2-PB1,1693,0,4,688,0,692,G
2-PB1,1694,689,0,0,0,689,A
2-PB1,1695,2,2,0,692,696,C
2-PB1,1696,692,1,0,0,693,A
2-PB1,1697,0,0,0,702,702,C
2-PB1,1698,699,0,1,0,700,A
2-PB1,1699,1,0,0,699,700,C
2-PB1,1700,696,0,0,0,696,A
2-PB1,1701,699,0,0,0,699,A
2-PB1,1702,708,0,0,0,708,A
2-PB1,1703,0,708,0,0,708,T
2-PB1,1704,0,0,0,710,710,C
2-PB1,1705,2,0,0,707,709,C
2-PB1,1706,705,0,0,0,705,A
2-PB1,1707,0,3,704,0,707,G
2-PB1,1708,704,0,0,0,704,A
2-PB1,1709,0,0,0,706,706,C
2-PB1,1710,0,2,701,0,703,G
2-PB1,1711,696,0,0,0,696,A
2-PB1,1712,0,1,694,0,695,G
2-PB1,1713,694,0,0,0,694,A
2-PB1,1714,693,0,1,1,695,A
2-PB1,1715,0,1,696,0,697,G
2-PB1,1716,694,0,1,0,695,A
2-PB1,1717,0,691,0,0,691,T
2-PB1,1718,8,0,0,683,691,C
2-PB1,1719,693,0,1,0,694,A
2-PB1,1720,0,690,0,1,691,T
2-PB1,1721,0,689,0,0,689,T
2-PB1,1722,7,1,1,682,691,C
2-PB1,1723,0,0,691,0,691,G
2-PB1,1724,684,0,0,0,684,A
2-PB1,1725,0,2,686,0,688,G
2-PB1,1726,683,1,0,0,684,A
2-PB1,1727,0,692,0,2,694,T
2-PB1,1728,696,0,0,0,696,A
2-PB1,1729,696,0,1,0,697,A
2-PB1,1730,694,1,1,0,696,A
2-PB1,1731,0,2,699,0,701,G
2-PB1,1732,696,0,2,0,698,A
2-PB1,1733,678,0,0,0,678,A
2-PB1,1734,0,0,678,0,678,G
2-PB1,1735,0,0,0,683,683,C
2-PB1,1736,0,669,0,0,669,T
2-PB1,1737,0,0,670,0,670,G
2-PB1,1738,0,665,0,1,666,T
2-PB1,1739,0,3,658,0,661,G
2-PB1,1740,0,1,656,1,658,G
2-PB1,1741,1,5,661,1,668,G
2-PB1,1742,671,0,0,0,671,A
2-PB1,1743,0,667,0,0,667,T
2-PB1,1744,1,0,0,662,663,C
2-PB1,1745,661,0,0,0,661,A
2-PB1,1746,658,0,0,1,659,A
2-PB1,1747,660,1,0,0,661,A
2-PB1,1748,1,0,0,663,664,C
2-PB1,1749,1,1,0,661,663,C
2-PB1,1750,2,1,0,656,659,C
2-PB1,1751,657,0,0,1,658,A
2-PB1,1752,668,0,0,0,668,A
2-PB1,1753,0,665,0,1,666,T
2-PB1,1754,3,0,0,663,666,C
2-PB1,1755,664,0,0,0,664,A
2-PB1,1756,655,1,1,0,657,A
2-PB1,1757,0,1,666,0,667,G
2-PB1,1758,0,1,661,1,663,G
2-PB1,1759,0,1,660,0,661,G
2-PB1,1760,0,1,0,661,662,C
2-PB1,1761,648,1,1,0,650,A
2-PB1,1762,0,0,667,1,668,G
2-PB1,1763,0,2,667,0,669,G
2-PB1,1764,671,0,2,0,673,A
2-PB1,1765,1,0,0,686,687,C
2-PB1,1766,1,671,0,0,672,T
2-PB1,1767,686,0,0,0,686,A
2-PB1,1768,0,685,0,0,685,T
2-PB1,1769,0,685,0,0,685,T
2-PB1,1770,0,3,686,0,689,G
2-PB1,1771,0,2,676,2,680,G
2-PB1,1772,0,669,0,0,669,T
2-PB1,1773,666,0,0,0,666,A
2-PB1,1774,0,662,0,0,662,T
2-PB1,1775,2,0,1,660,663,C
2-PB1,1776,652,0,0,0,652,A
2-PB1,1777,0,2,651,0,653,G
2-PB1,1778,653,2,1,0,656,A
2-PB1,1779,0,647,0,2,649,T
2-PB1,1780,1,0,622,0,623,G
2-PB1,1781,1,1,617,0,619,G
2-PB1,1782,3,2,616,0,621,G
2-PB1,1783,0,1,626,0,627,G
2-PB1,1784,1,3,625,0,629,G
2-PB1,1785,625,0,1,0,626,A
2-PB1,1786,1,0,0,622,623,C
2-PB1,1787,2,1,0,623,626,C
2-PB1,1788,626,0,1,0,627,A
2-PB1,1789,673,0,0,0,673,A
2-PB1,1790,673,0,0,0,673,A
2-PB1,1791,0,0,0,687,687,C
2-PB1,1792,0,682,0,0,682,T
2-PB1,1793,0,681,0,0,681,T
2-PB1,1794,679,1,1,0,681,A
2-PB1,1795,1,678,0,0,679,T
2-PB1,1796,680,0,1,0,681,A
2-PB1,1797,0,0,0,680,680,C
2-PB1,1798,631,0,1,0,632,A
2-PB1,1799,633,0,1,0,634,A
2-PB1,1800,0,609,0,1,610,T
2-PB1,1801,618,0,1,0,619,A
2-PB1,1802,0,614,0,1,615,T
2-PB1,1803,2,1,0,616,619,C
2-PB1,1804,2,1,0,613,616,C
2-PB1,1805,1,1,617,0,619,G
2-PB1,1806,0,1,615,0,616,G
2-PB1,1807,615,0,0,0,615,A
2-PB1,1808,618,0,0,0,618,A
2-PB1,1809,0,619,0,1,620,T
2-PB1,1810,0,0,0,619,619,C
2-PB1,1811,0,621,0,3,624,T
2-PB1,1812,0,626,1,0,627,T
2-PB1,1813,4,0,0,621,625,C
2-PB1,1814,624,0,0,0,624,A
2-PB1,1815,0,0,0,624,624,C
2-PB1,1816,624,0,0,0,624,A
2-PB1,1817,0,664,0,0,664,T
2-PB1,1818,1,1,0,662,664,C
2-PB1,1819,2,0,0,658,660,C
2-PB1,1820,1,0,0,659,660,C
2-PB1,1821,0,659,0,2,661,T
2-PB1,1822,0,2,657,0,659,G
2-PB1,1823,659,0,0,0,659,A
2-PB1,1824,659,0,0,0,659,A
2-PB1,1825,0,0,660,0,660,G
2-PB1,1826,0,627,0,0,627,T
2-PB1,1827,2,0,0,626,628,C
2-PB1,1828,0,623,0,0,623,T
2-PB1,1829,0,1,640,1,642,G
2-PB1,1830,2,0,0,639,641,C
2-PB1,1831,0,639,0,1,640,T
2-PB1,1832,0,640,0,0,640,T
2-PB1,1833,639,0,0,0,639,A
2-PB1,1834,635,0,2,0,637,A
2-PB1,1835,639,0,3,0,642,A
2-PB1,1836,0,0,645,0,645,G
2-PB1,1837,0,639,1,0,640,T
2-PB1,1838,0,0,624,0,624,G
2-PB1,1839,0,1,625,0,626,G
2-PB1,1840,0,3,618,0,621,G
2-PB1,1841,619,0,0,0,619,A
2-PB1,1842,0,0,626,0,626,G
2-PB1,1843,1,0,0,627,628,C
2-PB1,1844,1,614,0,1,616,T
2-PB1,1845,0,3,618,0,621,G
2-PB1,1846,620,1,0,0,621,A
2-PB1,1847,0,622,0,0,622,T
2-PB1,1848,1,3,618,0,622,G
2-PB1,1849,0,2,621,0,623,G
2-PB1,1850,621,0,1,0,622,A
2-PB1,1851,0,619,0,0,619,T
2-PB1,1852,1,3,614,1,619,G
2-PB1,1853,619,0,0,0,619,A
2-PB1,1854,0,2,620,0,622,G
2-PB1,1855,620,0,1,0,621,A
2-PB1,1856,622,0,1,0,623,A
2-PB1,1857,0,618,0,0,618,T
2-PB1,1858,0,612,0,0,612,T
2-PB1,1859,613,1,0,0,614,A
2-PB1,1860,3,607,0,0,610,T
2-PB1,1861,1,0,0,613,614,C
2-PB1,1862,0,1,617,0,618,G
2-PB1,1863,0,3,610,0,613,G
2-PB1,1864,1,1,612,0,614,G
2-PB1,1865,0,2,611,0,613,G
2-PB1,1866,614,0,0,0,614,A
2-PB1,1867,616,0,3,0,619,A
2-PB1,1868,2,3,622,0,627,G
2-PB1,1869,626,0,1,0,627,A
2-PB1,1870,2,1,0,630,633,C
2-PB1,1871,0,622,0,0,622,T
2-PB1,1872,1,638,0,2,641,T
2-PB1,1873,0,640,0,0,640,T
2-PB1,1874,0,1,642,0,643,G
2-PB1,1875,0,645,0,0,645,T
2-PB1,1876,640,0,0,0,640,A
2-PB1,1877,638,1,0,0,639,A
2-PB1,1878,0,630,0,1,631,T
2-PB1,1879,2,0,0,634,636,C
2-PB1,1880,0,0,0,635,635,C
2-PB1,1881,5,0,0,631,636,C
2-PB1,1882,0,0,0,635,635,C
2-PB1,1883,0,628,1,3,632,T
2-PB1,1884,0,0,632,0,632,G
2-PB1,1885,631,0,0,0,631,A
2-PB1,1886,636,0,0,1,637,A
2-PB1,1887,1,632,0,1,634,T
2-PB1,1888,5,1,0,630,636,C
2-PB1,1889,0,0,0,631,631,C
2-PB1,1890,0,1,1,615,617,C
2-PB1,1891,0,619,0,1,620,T
2-PB1,1892,0,619,0,0,619,T
2-PB1,1893,0,617,0,2,619,T
2-PB1,1894,0,0,618,0,618,G
2-PB1,1895,0,614,0,1,615,T
2-PB1,1896,6,0,0,611,617,C
2-PB1,1897,610,0,1,1,612,A
2-PB1,1898,3,2,621,0,626,G
2-PB1,1899,0,0,0,620,620,C
2-PB1,1900,2,0,0,621,623,C
2-PB1,1901,622,1,0,0,623,A
2-PB1,1902,0,620,0,0,620,T
2-PB1,1903,622,0,0,0,622,A
2-PB1,1904,621,0,0,0,621,A
2-PB1,1905,621,0,1,0,622,A
2-PB1,1906,0,0,629,0,629,G
2-PB1,1907,607,0,0,0,607,A
2-PB1,1908,606,0,1,0,607,A
2-PB1,1909,611,0,0,0,611,A
2-PB1,1910,0,608,0,0,608,T
2-PB1,1911,0,605,0,0,605,T
2-PB1,1912,0,6,602,0,608,G
2-PB1,1913,605,0,0,0,605,A
2-PB1,1914,597,0,1,0,598,A
2-PB1,1915,0,619,0,0,619,T
2-PB1,1916,2,0,0,623,625,C
2-PB1,1917,0,624,0,0,624,T
2-PB1,1918,0,0,641,0,641,G
2-PB1,1919,0,640,0,1,641,T
2-PB1,1920,648,0,0,0,648,A
2-PB1,1921,644,0,0,0,644,A
2-PB1,1922,645,0,0,1,646,A
2-PB1,1923,1,1,0,651,653,C
2-PB1,1924,634,0,0,0,634,A
2-PB1,1925,642,0,1,0,643,A
2-PB1,1926,0,649,0,0,649,T
2-PB1,1927,0,0,649,0,649,G
2-PB1,1928,0,2,0,645,647,C
2-PB1,1929,0,639,0,2,641,T
2-PB1,1930,0,0,663,0,663,G
2-PB1,1931,0,661,0,2,663,T
2-PB1,1932,671,0,1,0,672,A
2-PB1,1933,0,1,672,0,673,G
2-PB1,1934,0,654,0,1,655,T
2-PB1,1935,648,0,0,0,648,A
2-PB1,1936,647,0,0,0,647,A
2-PB1,1937,0,643,0,0,643,T
2-PB1,1938,0,0,642,0,642,G
2-PB1,1939,2,0,0,632,634,C
2-PB1,1940,2,0,0,623,625,C
2-PB1,1941,613,0,1,0,614,A
2-PB1,1942,0,2,613,0,615,G
2-PB1,1943,0,1,0,626,627,C
2-PB1,1944,1,0,0,625,626,C
2-PB1,1945,2,0,0,625,627,C
2-PB1,1946,622,0,1,0,623,A
2-PB1,1947,0,622,0,0,622,T
2-PB1,1948,0,3,615,0,618,G
2-PB1,1949,0,0,621,0,621,G
2-PB1,1950,0,620,0,0,620,T
2-PB1,1951,5,0,0,607,612,C
2-PB1,1952,0,0,0,598,598,C
2-PB1,1953,0,3,610,0,613,G
2-PB1,1954,0,0,615,0,615,G
2-PB1,1955,0,0,0,607,607,C
2-PB1,1956,3,1,0,610,614,C
2-PB1,1957,612,0,1,0,613,A
2-PB1,1958,614,0,1,0,615,A
2-PB1,1959,610,0,0,0,610,A
2-PB1,1960,607,0,1,0,608,A
2-PB1,1961,0,0,622,0,622,G
2-PB1,1962,0,613,0,0,613,T
2-PB1,1963,614,0,0,0,614,A
2-PB1,1964,0,616,0,1,617,T
2-PB1,1965,0,2,614,0,616,G
2-PB1,1966,0,2,630,0,632,G
2-PB1,1967,626,0,1,0,627,A
2-PB1,1968,634,0,2,0,636,A
2-PB1,1969,1,628,0,1,630,T
2-PB1,1970,621,0,1,0,622,A
2-PB1,1971,0,620,0,0,620,T
2-PB1,1972,1,2,612,0,615,G
2-PB1,1973,614,0,2,0,616,A
2-PB1,1974,0,614,0,0,614,T
2-PB1,1975,0,0,603,0,603,G
2-PB1,1976,0,0,0,599,599,C
2-PB1,1977,1,0,0,592,593,C
2-PB1,1978,0,0,597,0,597,G
2-PB1,1979,0,599,0,0,599,T
2-PB1,1980,0,598,0,1,599,T
2-PB1,1981,0,0,603,0,603,G
2-PB1,1982,0,0,0,607,607,C
2-PB1,1983,610,0,0,0,610,A
2-PB1,1984,618,0,1,0,619,A
2-PB1,1985,1,0,0,621,622,C
2-PB1,1986,0,616,0,2,618,T
2-PB1,1987,618,1,1,0,620,A
2-PB1,1988,0,1,0,619,620,C
2-PB1,1989,617,0,1,0,618,A
2-PB1,1990,0,0,0,619,619,C
2-PB1,1991,605,0,0,0,605,A
2-PB1,1992,1,0,0,647,648,C
2-PB1,1993,0,636,0,0,636,T
2-PB1,1994,3,0,0,637,640,C
2-PB1,1995,2,0,0,643,645,C
2-PB1,1996,0,636,0,2,638,T
2-PB1,1997,0,0,635,0,635,G
2-PB1,1998,0,4,630,0,634,G
2-PB1,1999,634,0,0,0,634,A
2-PB1,2000,0,633,0,0,633,T
2-PB1,2001,0,572,1,0,573,T
2-PB1,2002,2,0,0,576,578,C
2-PB1,2003,1,0,0,567,568,C
2-PB1,2004,2,1,0,571,574,C
2-PB1,2005,571,1,1,0,573,A
2-PB1,2006,572,0,0,0,572,A
2-PB1,2007,0,0,573,0,573,G
2-PB1,2008,566,0,0,1,567,A
2-PB1,2009,0,0,570,0,570,G
2-PB1,2010,0,3,566,0,569,G
2-PB1,2011,562,0,1,0,563,A
2-PB1,2012,565,0,0,0,565,A
2-PB1,2013,0,0,0,563,563,C
2-PB1,2014,0,1,0,559,560,C
2-PB1,2015,0,0,567,0,567,G
2-PB1,2016,0,1,0,564,565,C
2-PB1,2017,0,564,0,0,564,T
2-PB1,2018,4,0,0,563,567,C
2-PB1,2019,0,565,0,0,565,T
2-PB1,2020,593,1,0,0,594,A
2-PB1,2021,0,595,0,1,596,T
2-PB1,2022,0,604,0,0,604,T
2-PB1,2023,4,0,0,596,600,C
2-PB1,2024,0,584,0,2,586,T
2-PB1,2025,585,0,0,0,585,A
2-PB1,2026,586,0,0,0,586,A
2-PB1,2027,586,0,0,0,586,A
2-PB1,2028,0,1,0,586,587,C
2-PB1,2029,547,0,1,0,548,A
2-PB1,2030,0,0,0,546,546,C
2-PB1,2031,543,0,1,0,544,A
2-PB1,2032,542,0,5,0,547,A
2-PB1,2033,0,0,553,0,553,G
2-PB1,2034,1,0,0,551,552,C
2-PB1,2035,4,0,0,551,555,C
2-PB1,2036,550,0,0,0,550,A
2-PB1,2037,549,0,2,0,551,A
2-PB1,2038,550,0,0,0,550,A
2-PB1,2039,1,2,558,0,561,G
2-PB1,2040,0,1,557,0,558,G
2-PB1,2041,0,1,552,0,553,G
2-PB1,2042,1,3,549,0,553,G
2-PB1,2043,548,0,0,0,548,A
2-PB1,2044,548,0,2,0,550,A
2-PB1,2045,0,548,0,0,548,T
2-PB1,2046,0,548,0,1,549,T
2-PB1,2047,3,0,0,552,555,C
2-PB1,2048,0,550,0,0,550,T
2-PB1,2049,0,548,0,0,548,T
2-PB1,2050,0,1,548,0,549,G
2-PB1,2051,546,0,0,0,546,A
2-PB1,2052,0,1,545,0,546,G
2-PB1,2053,0,2,544,0,546,G
2-PB1,2054,542,0,0,0,542,A
2-PB1,2055,0,538,0,1,539,T
2-PB1,2056,0,4,543,0,547,G
2-PB1,2057,547,1,0,0,548,A
2-PB1,2058,548,0,1,0,549,A
2-PB1,2059,1,0,0,549,550,C
2-PB1,2060,544,0,1,1,546,A
2-PB1,2061,0,1,552,0,553,G
2-PB1,2062,552,0,0,0,552,A
2-PB1,2063,0,552,0,0,552,T
2-PB1,2064,1,1,551,1,554,G
2-PB1,2065,0,552,0,2,554,T
2-PB1,2066,558,0,0,0,558,A
2-PB1,2067,1,0,0,556,557,C
2-PB1,2068,3,0,0,548,551,C
2-PB1,2069,541,0,0,1,542,A
2-PB1,2070,0,2,537,0,539,G
2-PB1,2071,529,0,1,0,530,A
2-PB1,2072,526,0,1,0,527,A
2-PB1,2073,0,0,531,0,531,G
2-PB1,2074,0,492,0,0,492,T
2-PB1,2075,0,1,492,0,493,G
2-PB1,2076,0,0,0,492,492,C
2-PB1,2077,0,489,0,0,489,T
2-PB1,2078,1,0,489,0,490,G
2-PB1,2079,0,0,0,489,489,C
2-PB1,2080,489,0,0,0,489,A
2-PB1,2081,488,0,1,0,489,A
2-PB1,2082,0,0,0,482,482,C
2-PB1,2083,0,478,0,2,480,T
2-PB1,2084,0,474,0,0,474,T
2-PB1,2085,0,0,473,0,473,G
2-PB1,2086,0,472,0,0,472,T
2-PB1,2087,0,471,0,1,472,T
2-PB1,2088,3,0,0,469,472,C
2-PB1,2089,1,5,463,0,469,G
2-PB1,2090,471,0,0,0,471,A
2-PB1,2091,0,2,466,0,468,G
2-PB1,2092,468,0,0,0,468,A
2-PB1,2093,469,0,0,0,469,A
2-PB1,2094,471,0,1,0,472,A
2-PB1,2095,0,469,0,0,469,T
2-PB1,2096,0,468,0,1,469,T
2-PB1,2097,0,469,0,1,470,T
2-PB1,2098,0,469,0,1,470,T
2-PB1,2099,0,468,0,0,468,T
2-PB1,2100,3,0,0,465,468,C
2-PB1,2101,1,0,0,467,468,C
2-PB1,2102,4,0,0,464,468,C
2-PB1,2103,0,470,0,0,470,T
2-PB1,2104,468,0,1,0,469,A
2-PB1,2105,1,0,472,0,473,G
2-PB1,2106,1,473,0,0,474,T
2-PB1,2107,476,0,0,0,476,A
2-PB1,2108,0,0,477,0,477,G
2-PB1,2109,0,468,0,0,468,T
2-PB1,2110,0,475,0,1,476,T
2-PB1,2111,9,0,1,469,479,C
2-PB1,2112,494,0,0,0,494,A
2-PB1,2113,0,495,0,0,495,T
2-PB1,2114,493,0,1,0,494,A
2-PB1,2115,0,492,0,0,492,T
2-PB1,2116,473,0,2,0,475,A
2-PB1,2117,1,0,478,0,479,G
2-PB1,2118,0,2,471,0,473,G
2-PB1,2119,430,0,0,0,430,A
2-PB1,2120,0,1,429,0,430,G
2-PB1,2121,404,0,1,0,405,A
2-PB1,2122,0,0,0,403,403,C
2-PB1,2123,2,0,0,386,388,C
2-PB1,2124,0,0,386,0,386,G
2-PB1,2125,384,0,0,0,384,A
2-PB1,2126,0,384,0,0,384,T
2-PB1,2127,0,381,0,0,381,T
2-PB1,2128,0,2,378,0,380,G
2-PB1,2129,0,3,378,0,381,G
2-PB1,2130,379,0,1,0,380,A
2-PB1,2131,381,0,1,0,382,A
2-PB1,2132,0,382,0,0,382,T
2-PB1,2133,0,385,0,0,385,T
2-PB1,2134,0,386,0,0,386,T
2-PB1,2135,1,0,0,386,387,C
2-PB1,2136,0,387,0,0,387,T
2-PB1,2137,388,0,0,0,388,A
2-PB1,2138,0,0,392,0,392,G
2-PB1,2139,0,0,0,390,390,C
2-PB1,2140,390,0,0,0,390,A
2-PB1,2141,0,389,0,0,389,T
2-PB1,2142,0,2,389,0,391,G
2-PB1,2143,0,1,396,0,397,G
2-PB1,2144,0,391,0,1,392,T
2-PB1,2145,0,2,392,0,394,G
2-PB1,2146,1,1,392,0,394,G
2-PB1,2147,383,1,1,0,385,A
2-PB1,2148,0,1,386,0,387,G
2-PB1,2149,0,0,384,0,384,G
2-PB1,2150,1,0,0,384,385,C
2-PB1,2151,2,0,0,381,383,C
2-PB1,2152,361,0,1,0,362,A
2-PB1,2153,0,362,0,0,362,T
2-PB1,2154,0,1,365,0,366,G
2-PB1,2155,0,0,367,0,367,G
2-PB1,2156,0,353,0,0,353,T
2-PB1,2157,0,0,346,0,346,G
2-PB1,2158,0,342,0,0,342,T
2-PB1,2159,4,0,0,335,339,C
2-PB1,2160,0,339,1,0,340,T
2-PB1,2161,333,0,0,0,333,A
2-PB1,2162,0,1,333,0,334,G
2-PB1,2163,0,1,324,0,325,G
2-PB1,2164,0,0,321,0,321,G
2-PB1,2165,1,0,0,313,314,C
2-PB1,2166,1,0,0,301,302,C
2-PB1,2167,4,0,0,296,300,C
2-PB1,2168,1,0,298,0,299,G
2-PB1,2169,1,0,299,0,300,G
2-PB1,2170,300,0,0,0,300,A
2-PB1,2171,0,299,0,0,299,T
2-PB1,2172,0,285,0,0,285,T
2-PB1,2173,0,1,280,0,281,G
2-PB1,2174,279,0,0,0,279,A
2-PB1,2175,0,280,0,0,280,T
2-PB1,2176,0,1,280,0,281,G
2-PB1,2177,0,0,0,272,272,C
2-PB1,2178,0,0,0,272,272,C
2-PB1,2179,269,0,0,0,269,A
2-PB1,2180,0,0,269,0,269,G
2-PB1,2181,267,0,0,0,267,A
2-PB1,2182,269,0,0,0,269,A
2-PB1,2183,0,269,0,0,269,T
2-PB1,2184,0,265,0,0,265,T
2-PB1,2185,0,1,264,0,265,G
2-PB1,2186,266,0,0,0,266,A
2-PB1,2187,0,0,0,266,266,C
2-PB1,2188,0,263,0,0,263,T
2-PB1,2189,0,261,0,0,261,T
2-PB1,2190,1,1,0,257,259,C
2-PB1,2191,0,0,260,0,260,G
2-PB1,2192,259,0,0,0,259,A
2-PB1,2193,0,0,256,0,256,G
2-PB1,2194,0,256,0,1,257,T
2-PB1,2195,4,0,0,254,258,C
2-PB1,2196,0,258,0,0,258,T
2-PB1,2197,0,0,258,0,258,G
2-PB1,2198,0,0,258,0,258,G
2-PB1,2199,258,0,0,0,258,A
2-PB1,2200,243,0,1,0,244,A
2-PB1,2201,0,0,247,0,247,G
2-PB1,2202,0,0,249,0,249,G
2-PB1,2203,249,0,1,0,250,A
2-PB1,2204,0,246,0,1,247,T
2-PB1,2205,0,248,0,0,248,T
2-PB1,2206,247,0,0,0,247,A
2-PB1,2207,247,0,0,0,247,A
2-PB1,2208,0,0,247,0,247,G
2-PB1,2209,244,0,0,0,244,A
2-PB1,2210,225,0,0,0,225,A
2-PB1,2211,0,0,207,0,207,G
2-PB1,2212,1,0,206,0,207,G
2-PB1,2213,205,0,1,0,206,A
2-PB1,2214,206,0,0,0,206,A
2-PB1,2215,0,1,204,0,205,G
2-PB1,2216,197,0,0,0,197,A
2-PB1,2217,0,1,196,0,197,G
2-PB1,2218,1,192,0,0,193,T
2-PB1,2219,0,194,0,0,194,T
2-PB1,2220,0,0,0,193,193,C
2-PB1,2221,0,184,0,1,185,T
2-PB1,2222,1,0,0,184,185,C
2-PB1,2223,0,186,0,0,186,T
2-PB1,2224,0,0,184,0,184,G
2-PB1,2225,179,0,0,0,179,A
2-PB1,2226,0,0,178,0,178,G
2-PB1,2227,175,0,0,0,175,A
2-PB1,2228,0,172,0,0,172,T
2-PB1,2229,2,0,0,165,167,C
2-PB1,2230,168,0,1,0,169,A
2-PB1,2231,0,168,0,0,168,T
2-PB1,2232,0,0,167,0,167,G
2-PB1,2233,167,0,0,0,167,A
2-PB1,2234,163,0,0,0,163,A
2-PB1,2235,0,0,161,0,161,G
2-PB1,2236,158,0,0,0,158,A
2-PB1,2237,0,157,0,0,157,T
2-PB1,2238,1,0,0,155,156,C
2-PB1,2239,0,147,0,0,147,T
2-PB1,2240,1,1,144,0,146,G
2-PB1,2241,0,146,0,0,146,T
2-PB1,2242,0,145,0,1,146,T
2-PB1,2243,1,0,0,145,146,C
2-PB1,2244,0,0,0,140,140,C
2-PB1,2245,137,0,0,0,137,A
2-PB1,2246,2,0,0,137,139,C
2-PB1,2247,0,0,0,133,133,C
2-PB1,2248,130,0,0,0,130,A
2-PB1,2249,0,126,0,0,126,T
2-PB1,2250,0,115,0,0,115,T
2-PB1,2251,0,0,115,0,115,G
2-PB1,2252,114,0,0,0,114,A
2-PB1,2253,113,1,0,0,114,A
2-PB1,2254,0,0,113,0,113,G
2-PB1,2255,101,0,0,0,101,A
2-PB1,2256,100,0,0,0,100,A
2-PB1,2257,1,0,0,98,99,C
2-PB1,2258,0,94,0,0,94,T
2-PB1,2259,2,0,0,91,93,C
2-PB1,2260,90,0,0,0,90,A
2-PB1,2261,0,0,90,0,90,G
2-PB1,2262,90,0,0,0,90,A
2-PB1,2263,0,0,0,88,88,C
2-PB1,2264,0,0,88,0,88,G
2-PB1,2265,0,0,86,0,86,G
2-PB1,2266,0,0,0,86,86,C
2-PB1,2267,85,0,0,0,85,A
2-PB1,2268,85,0,0,0,85,A
2-PB1,2269,83,0,0,0,83,A
2-PB1,2270,83,0,0,0,83,A
2-PB1,2271,83,0,0,0,83,A
2-PB1,2272,0,82,0,0,82,T
2-PB1,2273,79,0,0,0,79,A
2-PB1,2274,79,0,0,0,79,A
3-PA,1,32,0,0,0,32,A
3-PA,2,0,32,0,0,32,T
3-PA,3,0,0,38,0,38,G
3-PA,4,0,0,39,0,39,G
3-PA,5,39,0,0,0,39,A
3-PA,6,39,0,0,0,39,A
3-PA,7,0,0,39,0,39,G
3-PA,8,40,0,0,0,40,A
3-PA,9,0,41,0,0,41,T
3-PA,10,0,41,0,0,41,T
3-PA,11,0,41,0,0,41,T
3-PA,12,0,40,0,0,40,T
3-PA,13,0,0,42,0,42,G
3-PA,14,0,40,0,0,40,T
3-PA,15,0,0,42,0,42,G
3-PA,16,0,0,0,44,44,C
3-PA,17,0,1,43,0,44,G
3-PA,18,50,0,0,0,50,A
3-PA,19,0,0,0,53,53,C
3-PA,20,53,0,0,0,53,A
3-PA,21,54,0,0,0,54,A
3-PA,22,0,56,0,0,56,T
3-PA,23,0,0,64,0,64,G
3-PA,24,0,0,0,68,68,C
3-PA,25,0,68,0,0,68,T
3-PA,26,0,68,0,0,68,T
3-PA,27,0,0,0,68,68,C
3-PA,28,70,0,0,0,70,A
3-PA,29,75,0,0,0,75,A
3-PA,30,0,0,0,76,76,C
3-PA,31,0,0,0,75,75,C
3-PA,32,1,0,0,74,75,C
3-PA,33,0,0,75,0,75,G
3-PA,34,76,0,0,0,76,A
3-PA,35,0,76,0,0,76,T
3-PA,36,0,0,76,0,76,G
3-PA,37,75,0,0,0,75,A
3-PA,38,0,77,0,0,77,T
3-PA,39,0,78,0,0,78,T
3-PA,40,0,0,78,0,78,G
3-PA,41,0,78,0,1,79,T
3-PA,42,1,0,0,77,78,C
3-PA,43,0,3,75,0,78,G
3-PA,44,80,0,0,0,80,A
3-PA,45,80,0,0,0,80,A
3-PA,46,0,0,0,82,82,C
3-PA,47,0,81,0,0,81,T
3-PA,48,0,82,0,0,82,T
3-PA,49,0,0,82,0,82,G
3-PA,50,0,0,0,84,84,C
3-PA,51,84,0,0,0,84,A
3-PA,52,0,0,86,0,86,G
3-PA,53,85,0,0,0,85,A
3-PA,54,85,0,0,0,85,A
3-PA,55,86,0,0,0,86,A
3-PA,56,87,0,0,0,87,A
3-PA,57,87,0,0,0,87,A
3-PA,58,0,0,87,0,87,G
3-PA,59,0,0,0,89,89,C
3-PA,60,88,0,0,0,88,A
3-PA,61,98,0,0,0,98,A
3-PA,62,0,98,0,0,98,T
3-PA,63,0,1,102,0,103,G
3-PA,64,103,0,0,0,103,A
3-PA,65,104,0,0,0,104,A
3-PA,66,103,0,2,0,105,A
3-PA,67,0,0,114,0,114,G
3-PA,68,117,0,0,0,117,A
3-PA,69,0,0,137,0,137,G
3-PA,70,1,138,0,0,139,T
3-PA,71,138,0,0,0,138,A
3-PA,72,0,139,0,0,139,T
3-PA,73,0,0,138,0,138,G
3-PA,74,0,0,136,0,136,G
3-PA,75,0,0,137,0,137,G
3-PA,76,0,0,137,0,137,G
3-PA,77,134,0,0,0,134,A
3-PA,78,1,0,134,0,135,G
3-PA,79,0,2,131,0,133,G
3-PA,80,133,0,0,0,133,A
3-PA,81,0,135,0,0,135,T
3-PA,82,0,0,0,135,135,C
3-PA,83,0,134,0,0,134,T
3-PA,84,0,3,131,0,134,G
3-PA,85,134,0,0,0,134,A
3-PA,86,135,0,0,0,135,A
3-PA,87,133,0,1,0,134,A
3-PA,88,135,0,0,0,135,A
3-PA,89,0,135,0,0,135,T
3-PA,90,0,135,0,0,135,T
3-PA,91,0,2,134,0,136,G
3-PA,92,137,0,0,0,137,A
3-PA,93,137,0,0,0,137,A
3-PA,94,136,0,0,0,136,A
3-PA,95,1,0,0,138,139,C
3-PA,96,140,0,0,0,140,A
3-PA,97,140,0,0,0,140,A
3-PA,98,140,0,0,0,140,A
3-PA,99,1,0,0,138,139,C
3-PA,100,140,0,0,0,140,A
3-PA,101,139,0,1,0,140,A
3-PA,102,140,0,0,0,140,A
3-PA,103,0,141,0,0,141,T
3-PA,104,0,140,0,0,140,T
3-PA,105,0,141,0,0,141,T
3-PA,106,0,0,141,0,141,G
3-PA,107,0,0,0,141,141,C
3-PA,108,140,0,0,0,140,A
3-PA,109,0,0,148,0,148,G
3-PA,110,0,0,0,149,149,C
3-PA,111,153,0,0,0,153,A
3-PA,112,156,0,0,0,156,A
3-PA,113,0,158,0,0,158,T
3-PA,114,160,0,0,0,160,A
3-PA,115,0,160,0,0,160,T
3-PA,116,0,0,162,0,162,G
3-PA,117,0,1,0,161,162,C
3-PA,118,161,0,0,0,161,A
3-PA,119,0,0,0,163,163,C
3-PA,120,0,160,0,1,161,T
3-PA,121,2,0,0,195,197,C
3-PA,122,195,1,0,0,196,A
3-PA,123,0,0,0,203,203,C
3-PA,124,0,202,0,0,202,T
3-PA,125,0,203,0,0,203,T
3-PA,126,0,1,202,0,203,G
3-PA,127,0,1,203,1,205,G
3-PA,128,203,1,0,0,204,A
3-PA,129,0,0,209,0,209,G
3-PA,130,0,0,206,0,206,G
3-PA,131,0,202,0,0,202,T
3-PA,132,0,0,203,0,203,G
3-PA,133,0,204,0,0,204,T
3-PA,134,0,0,208,0,208,G
3-PA,135,0,209,0,0,209,T
3-PA,136,0,208,0,0,208,T
3-PA,137,0,208,0,0,208,T
3-PA,138,1,0,0,210,211,C
3-PA,139,211,0,0,0,211,A
3-PA,140,0,211,0,0,211,T
3-PA,141,0,0,213,0,213,G
3-PA,142,0,211,0,0,211,T
3-PA,143,213,0,0,0,213,A
3-PA,144,0,211,0,1,212,T
3-PA,145,0,212,0,0,212,T
3-PA,146,1,0,0,211,212,C
3-PA,147,211,0,0,0,211,A
3-PA,148,0,0,214,0,214,G
3-PA,149,214,0,0,0,214,A
3-PA,150,0,212,0,0,212,T
3-PA,151,0,211,0,0,211,T
3-PA,152,0,211,0,0,211,T
3-PA,153,0,0,0,210,210,C
3-PA,154,2,0,0,211,213,C
3-PA,155,213,0,0,0,213,A
3-PA,156,0,214,0,0,214,T
3-PA,157,0,211,0,1,212,T
3-PA,158,0,213,0,0,213,T
3-PA,159,1,0,0,214,215,C
3-PA,160,213,0,3,0,216,A
3-PA,161,1,221,0,0,222,T
3-PA,162,1,0,0,220,221,C
3-PA,163,221,0,0,0,221,A
3-PA,164,222,0,0,0,222,A
3-PA,165,0,222,0,0,222,T
3-PA,166,0,3,223,0,226,G
3-PA,167,225,0,1,0,226,A
3-PA,168,226,0,0,0,226,A
3-PA,169,0,0,0,223,223,C
3-PA,170,223,0,2,0,225,A
3-PA,171,227,0,0,0,227,A
3-PA,172,0,1,227,0,228,G
3-PA,173,0,0,229,0,229,G
3-PA,174,0,0,0,229,229,C
3-PA,175,1,3,223,0,227,G
3-PA,176,234,0,0,0,234,A
3-PA,177,237,0,0,0,237,A
3-PA,178,0,237,0,0,237,T
3-PA,179,2,0,0,235,237,C
3-PA,180,235,0,0,0,235,A
3-PA,181,235,0,0,0,235,A
3-PA,182,0,237,0,0,237,T
3-PA,183,236,0,0,0,236,A
3-PA,184,0,0,240,0,240,G
3-PA,185,0,238,0,0,238,T
3-PA,186,0,1,238,0,239,G
3-PA,187,0,0,238,0,238,G
3-PA,188,0,236,0,1,237,T
3-PA,189,238,0,0,0,238,A
3-PA,190,0,2,236,0,238,G
3-PA,191,236,0,0,0,236,A
3-PA,192,238,0,0,0,238,A
3-PA,193,0,0,0,239,239,C
3-PA,194,0,232,0,1,233,T
3-PA,195,0,230,0,0,230,T
3-PA,196,0,2,227,0,229,G
3-PA,197,228,0,2,0,230,A
3-PA,198,0,0,0,229,229,C
3-PA,199,0,2,226,0,228,G
3-PA,200,231,0,0,0,231,A
3-PA,201,0,236,0,0,236,T
3-PA,202,0,0,0,237,237,C
3-PA,203,2,0,0,238,240,C
3-PA,204,242,0,0,0,242,A
3-PA,205,242,0,1,0,243,A
3-PA,206,245,0,0,0,245,A
3-PA,207,0,244,0,1,245,T
3-PA,208,0,0,247,0,247,G
3-PA,209,0,0,0,246,246,C
3-PA,210,245,0,0,0,245,A
3-PA,211,1,0,0,245,246,C
3-PA,212,0,245,0,0,245,T
3-PA,213,0,0,273,0,273,G
3-PA,214,0,272,0,0,272,T
3-PA,215,0,272,0,1,273,T
3-PA,216,274,0,0,0,274,A
3-PA,217,275,0,0,0,275,A
3-PA,218,273,0,0,0,273,A
3-PA,219,0,1,277,0,278,G
3-PA,220,0,0,0,275,275,C
3-PA,221,272,0,1,0,273,A
3-PA,222,0,0,0,271,271,C
3-PA,223,258,0,0,0,258,A
3-PA,224,0,1,273,0,274,G
3-PA,225,273,0,0,0,273,A
3-PA,226,0,269,0,0,269,T
3-PA,227,0,270,0,0,270,T
3-PA,228,0,270,0,0,270,T
3-PA,229,0,1,270,0,271,G
3-PA,230,269,0,1,0,270,A
3-PA,231,269,0,0,0,269,A
3-PA,232,271,0,0,1,272,A
3-PA,233,0,266,0,0,266,T
3-PA,234,265,0,0,0,265,A
3-PA,235,268,0,0,0,268,A
3-PA,236,0,269,0,0,269,T
3-PA,237,1,0,0,268,269,C
3-PA,238,0,1,269,0,270,G
3-PA,239,270,0,0,0,270,A
3-PA,240,0,1,271,0,272,G
3-PA,241,0,1,276,0,277,G
3-PA,242,0,0,276,0,276,G
3-PA,243,0,3,274,0,277,G
3-PA,244,274,0,1,0,275,A
3-PA,245,0,3,275,0,278,G
3-PA,246,278,0,2,0,280,A
3-PA,247,0,3,279,0,282,G
3-PA,248,281,0,1,0,282,A
3-PA,249,0,0,0,282,282,C
3-PA,250,276,0,0,0,276,A
3-PA,251,0,2,282,0,284,G
3-PA,252,284,0,0,0,284,A
3-PA,253,288,0,0,0,288,A
3-PA,254,0,0,0,288,288,C
3-PA,255,280,0,0,0,280,A
3-PA,256,281,0,0,0,281,A
3-PA,257,0,280,0,1,281,T
3-PA,258,0,1,296,0,297,G
3-PA,259,0,0,295,1,296,G
3-PA,260,0,0,0,294,294,C
3-PA,261,2,0,0,293,295,C
3-PA,262,0,294,0,0,294,T
3-PA,263,0,0,301,0,301,G
3-PA,264,0,0,303,0,303,G
3-PA,265,304,0,1,0,305,A
3-PA,266,0,0,0,307,307,C
3-PA,267,296,0,1,0,297,A
3-PA,268,0,0,341,0,341,G
3-PA,269,0,341,0,0,341,T
3-PA,270,343,0,1,0,344,A
3-PA,271,1,0,343,0,344,G
3-PA,272,0,339,0,0,339,T
3-PA,273,341,0,0,0,341,A
3-PA,274,339,0,1,0,340,A
3-PA,275,343,0,1,1,345,A
3-PA,276,0,0,0,347,347,C
3-PA,277,321,0,0,0,321,A
3-PA,278,0,0,324,0,324,G
3-PA,279,0,323,0,0,323,T
3-PA,280,327,0,0,0,327,A
3-PA,281,0,326,0,0,326,T
3-PA,282,0,0,0,329,329,C
3-PA,283,0,329,0,1,330,T
3-PA,284,0,0,332,0,332,G
3-PA,285,1,0,0,331,332,C
3-PA,286,328,0,0,0,328,A
3-PA,287,333,0,0,0,333,A
3-PA,288,0,1,0,335,336,C
3-PA,289,336,0,0,0,336,A
3-PA,290,0,0,0,345,345,C
3-PA,291,0,343,0,0,343,T
3-PA,292,343,0,0,0,343,A
3-PA,293,0,0,0,342,342,C
3-PA,294,0,340,0,0,340,T
3-PA,295,2,1,337,1,341,G
3-PA,296,0,2,340,0,342,G
3-PA,297,336,0,1,0,337,A
3-PA,298,0,0,340,0,340,G
3-PA,299,0,0,0,336,336,C
3-PA,300,0,333,0,0,333,T
3-PA,301,1,0,332,0,333,G
3-PA,302,0,0,335,0,335,G
3-PA,303,331,1,0,0,332,A
3-PA,304,336,0,0,0,336,A
3-PA,305,335,0,0,0,335,A
3-PA,306,333,1,1,0,335,A
3-PA,307,0,0,0,335,335,C
3-PA,308,1,0,0,335,336,C
3-PA,309,0,0,336,0,336,G
3-PA,310,337,0,0,0,337,A
3-PA,311,335,0,0,0,335,A
3-PA,312,0,0,342,0,342,G
3-PA,313,0,337,0,2,339,T
3-PA,314,0,341,0,0,341,T
3-PA,315,0,341,0,1,342,T
3-PA,316,3,0,0,339,342,C
3-PA,317,0,341,0,0,341,T
3-PA,318,340,0,0,0,340,A
3-PA,319,0,0,0,340,340,C
3-PA,320,2,0,0,338,340,C
3-PA,321,335,0,0,0,335,A
3-PA,322,0,2,334,0,336,G
3-PA,323,335,0,0,0,335,A
3-PA,324,1,0,0,332,333,C
3-PA,325,0,346,0,0,346,T
3-PA,326,0,346,0,0,346,T
3-PA,327,0,0,349,0,349,G
3-PA,328,0,348,0,0,348,T
3-PA,329,349,0,0,0,349,A
3-PA,330,0,350,0,0,350,T
3-PA,331,0,3,340,0,343,G
3-PA,332,354,0,0,0,354,A
3-PA,333,0,351,0,0,351,T
3-PA,334,1,350,0,0,351,T
3-PA,335,351,0,0,0,351,A
3-PA,336,0,0,0,348,348,C
3-PA,337,346,0,2,0,348,A
3-PA,338,348,0,0,0,348,A
3-PA,339,0,0,347,0,347,G
3-PA,340,0,1,356,0,357,G
3-PA,341,343,0,0,0,343,A
3-PA,342,0,0,348,0,348,G
3-PA,343,348,0,0,0,348,A
3-PA,344,347,0,2,0,349,A
3-PA,345,0,0,0,349,349,C
3-PA,346,347,0,0,0,347,A
3-PA,347,0,0,348,0,348,G
3-PA,348,347,0,0,0,347,A
3-PA,349,0,350,0,0,350,T
3-PA,350,0,348,0,0,348,T
3-PA,351,3,1,0,340,344,C
3-PA,352,1,0,342,0,343,G
3-PA,353,0,344,0,0,344,T
3-PA,354,3,0,0,340,343,C
3-PA,355,0,3,341,0,344,G
3-PA,356,346,0,0,0,346,A
3-PA,357,345,0,0,0,345,A
3-PA,358,346,0,0,0,346,A
3-PA,359,0,342,0,0,342,T
3-PA,360,0,344,0,0,344,T
3-PA,361,1,0,342,0,343,G
3-PA,362,0,2,339,0,341,G
3-PA,363,0,2,340,0,342,G
3-PA,364,0,0,342,0,342,G
3-PA,365,0,341,0,2,343,T
3-PA,366,1,1,346,0,348,G
3-PA,367,349,0,0,0,349,A
3-PA,368,0,0,0,348,348,C
3-PA,369,349,0,0,0,349,A
3-PA,370,348,0,1,0,349,A
3-PA,371,0,0,355,0,355,G
3-PA,372,1,1,353,0,355,G
3-PA,373,348,0,1,0,349,A
3-PA,374,1,1,352,0,354,G
3-PA,375,349,0,0,0,349,A
3-PA,376,0,0,349,0,349,G
3-PA,377,344,0,0,0,344,A
3-PA,378,340,0,0,0,340,A
3-PA,379,2,0,345,0,347,G
3-PA,380,0,340,0,0,340,T
3-PA,381,4,0,0,334,338,C
3-PA,382,0,1,0,335,336,C
3-PA,383,334,0,1,0,335,A
3-PA,384,0,1,0,341,342,C
3-PA,385,348,0,0,0,348,A
3-PA,386,0,353,0,0,353,T
3-PA,387,360,0,0,0,360,A
3-PA,388,0,353,0,0,353,T
3-PA,389,348,0,0,0,348,A
3-PA,390,0,344,0,0,344,T
3-PA,391,0,345,0,0,345,T
3-PA,392,353,0,0,0,353,A
3-PA,393,1,0,0,350,351,C
3-PA,394,1,0,0,328,329,C
3-PA,395,0,323,1,0,324,T
3-PA,396,0,315,0,1,316,T
3-PA,397,1,0,316,0,317,G
3-PA,398,319,0,0,0,319,A
3-PA,399,317,0,0,0,317,A
3-PA,400,317,0,1,0,318,A
3-PA,401,306,0,0,0,306,A
3-PA,402,0,1,308,0,309,G
3-PA,403,1,0,310,0,311,G
3-PA,404,1,0,0,307,308,C
3-PA,405,1,0,0,311,312,C
3-PA,406,311,0,0,0,311,A
3-PA,407,311,0,1,0,312,A
3-PA,408,0,313,0,0,313,T
3-PA,409,313,0,0,0,313,A
3-PA,410,313,0,0,0,313,A
3-PA,411,0,2,318,0,320,G
3-PA,412,317,0,0,0,317,A
3-PA,413,0,317,0,0,317,T
3-PA,414,0,318,0,0,318,T
3-PA,415,317,0,0,0,317,A
3-PA,416,317,0,0,0,317,A
3-PA,417,317,0,0,0,317,A
3-PA,418,0,319,0,1,320,T
3-PA,419,1,0,0,320,321,C
3-PA,420,0,305,0,0,305,T
3-PA,421,1,2,304,0,307,G
3-PA,422,307,0,0,0,307,A
3-PA,423,0,1,311,0,312,G
3-PA,424,311,0,2,0,313,A
3-PA,425,311,0,1,0,312,A
3-PA,426,0,0,0,313,313,C
3-PA,427,310,0,0,0,310,A
3-PA,428,0,0,0,313,313,C
3-PA,429,312,0,0,0,312,A
3-PA,430,0,0,0,312,312,C
3-PA,431,308,0,0,0,308,A
3-PA,432,0,0,1,318,319,C
3-PA,433,316,0,0,0,316,A
3-PA,434,0,317,0,0,317,T
3-PA,435,0,317,0,0,317,T
3-PA,436,1,0,0,316,317,C
3-PA,437,318,0,0,0,318,A
3-PA,438,1,0,0,320,321,C
3-PA,439,314,0,0,0,314,A
3-PA,440,0,317,0,0,317,T
3-PA,441,0,312,0,0,312,T
3-PA,442,0,313,0,0,313,T
3-PA,443,0,313,0,0,313,T
3-PA,444,1,0,0,318,319,C
3-PA,445,1,315,0,0,316,T
3-PA,446,2,0,0,320,322,C
3-PA,447,325,0,0,0,325,A
3-PA,448,0,327,0,0,327,T
3-PA,449,0,330,0,0,330,T
3-PA,450,0,0,0,331,331,C
3-PA,451,329,0,0,0,329,A
3-PA,452,0,0,0,331,331,C
3-PA,453,0,327,0,0,327,T
3-PA,454,2,1,328,0,331,G
3-PA,455,0,2,327,0,329,G
3-PA,456,0,0,331,0,331,G
3-PA,457,1,0,333,0,334,G
3-PA,458,333,0,0,0,333,A
3-PA,459,0,0,331,0,331,G
3-PA,460,1,1,331,0,333,G
3-PA,461,329,0,2,0,331,A
3-PA,462,332,0,0,0,332,A
3-PA,463,329,0,0,0,329,A
3-PA,464,0,324,0,0,324,T
3-PA,465,1,2,322,0,325,G
3-PA,466,1,1,324,0,326,G
3-PA,467,0,0,0,323,323,C
3-PA,468,1,0,0,323,324,C
3-PA,469,322,0,1,0,323,A
3-PA,470,0,0,0,324,324,C
3-PA,471,322,0,1,0,323,A
3-PA,472,322,2,0,0,324,A
3-PA,473,324,0,0,0,324,A
3-PA,474,0,1,330,0,331,G
3-PA,475,0,0,330,0,330,G
3-PA,476,0,0,0,326,326,C
3-PA,477,329,0,0,0,329,A
3-PA,478,0,3,330,0,333,G
3-PA,479,332,0,0,0,332,A
3-PA,480,1,0,0,331,332,C
3-PA,481,0,333,0,0,333,T
3-PA,482,333,0,0,0,333,A
3-PA,483,0,0,0,335,335,C
3-PA,484,337,0,0,0,337,A
3-PA,485,0,0,0,337,337,C
3-PA,486,0,325,0,0,325,T
3-PA,487,0,0,0,324,324,C
3-PA,488,0,320,0,0,320,T
3-PA,489,1,0,0,314,315,C
3-PA,490,0,4,314,0,318,G
3-PA,491,316,0,0,0,316,A
3-PA,492,0,0,0,314,314,C
3-PA,493,0,0,318,0,318,G
3-PA,494,313,0,0,0,313,A
3-PA,495,2,1,310,0,313,G
3-PA,496,0,1,313,0,314,G
3-PA,497,312,0,1,0,313,A
3-PA,498,318,0,0,0,318,A
3-PA,499,318,0,1,0,319,A
3-PA,500,1,0,319,0,320,G
3-PA,501,0,0,0,320,320,C
3-PA,502,319,0,0,0,319,A
3-PA,503,0,1,322,0,323,G
3-PA,504,3,0,320,0,323,G
3-PA,505,0,1,326,0,327,G
3-PA,506,0,0,0,326,326,C
3-PA,507,0,324,0,1,325,T
3-PA,508,324,0,1,0,325,A
3-PA,509,0,0,330,0,330,G
3-PA,510,0,1,349,0,350,G
3-PA,511,349,0,0,0,349,A
3-PA,512,0,341,0,0,341,T
3-PA,513,0,340,0,0,340,T
3-PA,514,341,0,0,0,341,A
3-PA,515,342,0,0,0,342,A
3-PA,516,0,1,342,0,343,G
3-PA,517,342,0,1,0,343,A
3-PA,518,2,0,0,341,343,C
3-PA,519,0,0,0,318,318,C
3-PA,520,314,0,0,0,314,A
3-PA,521,0,2,318,0,320,G
3-PA,522,0,0,320,0,320,G
3-PA,523,0,0,0,322,322,C
3-PA,524,0,316,0,0,316,T
3-PA,525,0,0,322,0,322,G
3-PA,526,0,318,1,1,320,T
3-PA,527,0,320,0,0,320,T
3-PA,528,0,321,0,0,321,T
3-PA,529,322,0,1,0,323,A
3-PA,530,1,0,0,329,330,C
3-PA,531,3,0,0,321,324,C
3-PA,532,322,0,0,0,322,A
3-PA,533,0,320,0,0,320,T
3-PA,534,314,0,0,0,314,A
3-PA,535,316,0,1,0,317,A
3-PA,536,0,0,322,0,322,G
3-PA,537,323,0,0,0,323,A
3-PA,538,0,0,0,322,322,C
3-PA,539,313,0,0,0,313,A
3-PA,540,312,0,1,0,313,A
3-PA,541,0,0,318,0,318,G
3-PA,542,314,0,2,0,316,A
3-PA,543,316,0,0,0,316,A
3-PA,544,314,0,0,0,314,A
3-PA,545,0,304,0,0,304,T
3-PA,546,0,3,304,0,307,G
3-PA,547,1,0,304,0,305,G
3-PA,548,0,0,0,304,304,C
3-PA,549,0,0,0,304,304,C
3-PA,550,301,0,0,0,301,A
3-PA,551,305,0,0,0,305,A
3-PA,552,0,0,0,306,306,C
3-PA,553,306,0,0,0,306,A
3-PA,554,0,0,305,0,305,G
3-PA,555,299,0,1,0,300,A
3-PA,556,0,1,298,0,299,G
3-PA,557,1,0,301,0,302,G
3-PA,558,1,0,0,301,302,C
3-PA,559,1,0,0,301,302,C
3-PA,560,0,299,0,0,299,T
3-PA,561,1,0,0,298,299,C
3-PA,562,0,299,0,0,299,T
3-PA,563,0,2,299,0,301,G
3-PA,564,0,1,303,0,304,G
3-PA,565,0,3,298,0,301,G
3-PA,566,299,0,0,0,299,A
3-PA,567,0,292,0,0,292,T
3-PA,568,0,288,0,1,289,T
3-PA,569,0,0,0,315,315,C
3-PA,570,1,0,0,308,309,C
3-PA,571,0,295,0,0,295,T
3-PA,572,0,296,0,0,296,T
3-PA,573,0,296,0,0,296,T
3-PA,574,4,1,0,292,297,C
3-PA,575,1,0,295,0,296,G
3-PA,576,0,296,0,0,296,T
3-PA,577,0,0,0,298,298,C
3-PA,578,291,0,0,0,291,A
3-PA,579,0,0,320,0,320,G
3-PA,580,0,318,0,1,319,T
3-PA,581,1,0,0,318,319,C
3-PA,582,1,2,0,319,322,C
3-PA,583,0,1,321,0,322,G
3-PA,584,321,0,1,0,322,A
3-PA,585,321,0,0,0,321,A
3-PA,586,321,0,0,0,321,A
3-PA,587,0,0,325,0,325,G
3-PA,588,310,0,1,0,311,A
3-PA,589,0,1,313,0,314,G
3-PA,590,0,0,313,0,313,G
3-PA,591,0,1,0,314,315,C
3-PA,592,0,2,312,0,314,G
3-PA,593,315,0,0,0,315,A
3-PA,594,314,0,0,0,314,A
3-PA,595,0,1,317,0,318,G
3-PA,596,319,0,0,0,319,A
3-PA,597,318,0,1,0,319,A
3-PA,598,316,0,1,0,317,A
3-PA,599,0,0,0,317,317,C
3-PA,600,316,0,0,0,316,A
3-PA,601,317,0,1,0,318,A
3-PA,602,0,319,0,0,319,T
3-PA,603,0,316,0,1,317,T
3-PA,604,0,1,315,0,316,G
3-PA,605,314,0,0,0,314,A
3-PA,606,317,0,0,0,317,A
3-PA,607,0,0,317,0,317,G
3-PA,608,317,0,0,0,317,A
3-PA,609,314,0,0,0,314,A
3-PA,610,314,0,0,0,314,A
3-PA,611,316,0,1,0,317,A
3-PA,612,320,0,0,0,320,A
3-PA,613,0,322,0,0,322,T
3-PA,614,0,321,0,0,321,T
3-PA,615,0,323,0,0,323,T
3-PA,616,1,0,324,0,325,G
3-PA,617,325,0,0,0,325,A
3-PA,618,325,0,0,0,325,A
3-PA,619,323,0,0,0,323,A
3-PA,620,0,331,0,0,331,T
3-PA,621,2,0,0,346,348,C
3-PA,622,348,0,0,0,348,A
3-PA,623,0,0,0,355,355,C
3-PA,624,352,0,0,0,352,A
3-PA,625,0,1,356,0,357,G
3-PA,626,0,4,359,0,363,G
3-PA,627,371,0,0,0,371,A
3-PA,628,373,0,0,0,373,A
3-PA,629,0,0,0,374,374,C
3-PA,630,0,357,0,1,358,T
3-PA,631,375,0,0,0,375,A
3-PA,632,0,375,0,0,375,T
3-PA,633,1,0,383,0,384,G
3-PA,634,1,0,0,380,381,C
3-PA,635,2,1,376,0,379,G
3-PA,636,0,373,0,0,373,T
3-PA,637,369,0,0,0,369,A
3-PA,638,0,2,368,0,370,G
3-PA,639,0,0,368,0,368,G
3-PA,640,0,0,0,361,361,C
3-PA,641,0,354,0,0,354,T
3-PA,642,0,352,0,0,352,T
3-PA,643,1,0,352,0,353,G
3-PA,644,1,1,0,351,353,C
3-PA,645,0,1,1,348,350,C
3-PA,646,3,6,347,0,356,G
3-PA,647,355,0,0,0,355,A
3-PA,648,0,0,0,358,358,C
3-PA,649,2,0,0,357,359,C
3-PA,650,359,0,0,0,359,A
3-PA,651,361,0,0,0,361,A
3-PA,652,360,0,0,0,360,A
3-PA,653,0,0,365,0,365,G
3-PA,654,0,361,0,1,362,T
3-PA,655,1,0,0,364,365,C
3-PA,656,0,366,0,0,366,T
3-PA,657,1,0,0,367,368,C
3-PA,658,0,0,0,367,367,C
3-PA,659,1,0,0,365,366,C
3-PA,660,369,0,0,0,369,A
3-PA,661,1,0,0,372,373,C
3-PA,662,2,0,0,366,368,C
3-PA,663,0,1,368,0,369,G
3-PA,664,372,0,0,0,372,A
3-PA,665,368,0,1,0,369,A
3-PA,666,0,2,0,375,377,C
3-PA,667,0,365,0,0,365,T
3-PA,668,0,368,1,2,371,T
3-PA,669,2,0,0,373,375,C
3-PA,670,1,371,0,0,372,T
3-PA,671,2,0,0,373,375,C
3-PA,672,1,0,0,372,373,C
3-PA,673,0,372,0,0,372,T
3-PA,674,0,0,381,0,381,G
3-PA,675,0,0,1,376,377,C
3-PA,676,1,1,0,379,381,C
3-PA,677,0,375,0,0,375,T
3-PA,678,0,373,0,1,374,T
3-PA,679,0,2,371,0,373,G
3-PA,680,372,0,0,0,372,A
3-PA,681,0,1,374,0,375,G
3-PA,682,376,0,0,0,376,A
3-PA,683,375,0,0,0,375,A
3-PA,684,0,386,0,0,386,T
3-PA,685,0,386,0,0,386,T
3-PA,686,0,388,0,0,388,T
3-PA,687,0,387,0,0,387,T
3-PA,688,387,0,0,0,387,A
3-PA,689,2,2,384,0,388,G
3-PA,690,387,0,1,0,388,A
3-PA,691,1,1,399,0,401,G
3-PA,692,0,0,0,398,398,C
3-PA,693,1,0,0,395,396,C
3-PA,694,1,400,0,0,401,T
3-PA,695,419,0,0,0,419,A
3-PA,696,1,419,0,0,420,T
3-PA,697,0,1,422,0,423,G
3-PA,698,0,422,0,1,423,T
3-PA,699,1,0,425,0,426,G
3-PA,700,0,1,421,0,422,G
3-PA,701,420,0,0,0,420,A
3-PA,702,0,417,0,0,417,T
3-PA,703,1,2,411,0,414,G
3-PA,704,0,2,418,0,420,G
3-PA,705,419,1,0,0,420,A
3-PA,706,0,418,0,0,418,T
3-PA,707,0,420,0,0,420,T
3-PA,708,4,0,0,412,416,C
3-PA,709,2,7,405,0,414,G
3-PA,710,414,0,2,0,416,A
3-PA,711,415,0,0,0,415,A
3-PA,712,0,0,0,420,420,C
3-PA,713,2,0,0,407,409,C
3-PA,714,1,2,407,0,410,G
3-PA,715,413,0,0,0,413,A
3-PA,716,414,0,0,0,414,A
3-PA,717,0,1,0,414,415,C
3-PA,718,0,3,410,0,413,G
3-PA,719,0,0,422,0,422,G
3-PA,720,0,0,0,429,429,C
3-PA,721,0,427,0,0,427,T
3-PA,722,0,0,441,0,441,G
3-PA,723,0,0,0,441,441,C
3-PA,724,442,0,0,0,442,A
3-PA,725,0,440,0,0,440,T
3-PA,726,0,438,0,1,439,T
3-PA,727,1,0,438,0,439,G
3-PA,728,431,0,1,0,432,A
3-PA,729,0,2,434,0,436,G
3-PA,730,0,0,435,0,435,G
3-PA,731,0,0,427,0,427,G
3-PA,732,2,1,0,424,427,C
3-PA,733,423,0,0,0,423,A
3-PA,734,422,0,1,0,423,A
3-PA,735,0,1,424,0,425,G
3-PA,736,0,1,0,423,424,C
3-PA,737,0,421,0,0,421,T
3-PA,738,0,416,0,0,416,T
3-PA,739,0,419,0,0,419,T
3-PA,740,2,0,0,422,424,C
3-PA,741,0,422,0,1,423,T
3-PA,742,3,0,0,420,423,C
3-PA,743,420,0,0,0,420,A
3-PA,744,419,0,0,0,419,A
3-PA,745,418,0,0,0,418,A
3-PA,746,1,420,0,0,421,T
3-PA,747,0,0,432,0,432,G
3-PA,748,0,431,0,0,431,T
3-PA,749,0,0,0,433,433,C
3-PA,750,0,0,0,433,433,C
3-PA,751,432,0,0,0,432,A
3-PA,752,433,0,0,0,433,A
3-PA,753,433,0,1,0,434,A
3-PA,754,0,0,444,0,444,G
3-PA,755,442,0,0,0,442,A
3-PA,756,433,0,1,0,434,A
3-PA,757,0,0,439,0,439,G
3-PA,758,0,429,1,0,430,T
3-PA,759,0,5,426,0,431,G
3-PA,760,429,0,0,1,430,A
3-PA,761,433,0,0,0,433,A
3-PA,762,0,436,0,0,436,T
3-PA,763,0,1,430,0,431,G
3-PA,764,1,0,0,429,430,C
3-PA,765,3,0,1,426,430,C
3-PA,766,4,0,0,426,430,C
3-PA,767,431,0,0,0,431,A
3-PA,768,432,0,1,0,433,A
3-PA,769,431,1,0,0,432,A
3-PA,770,0,433,0,0,433,T
3-PA,771,0,431,0,0,431,T
3-PA,772,0,1,433,0,434,G
3-PA,773,428,1,0,1,430,A
3-PA,774,443,0,0,0,443,A
3-PA,775,1,0,0,441,442,C
3-PA,776,3,0,0,440,443,C
3-PA,777,0,434,0,2,436,T
3-PA,778,0,439,0,0,439,T
3-PA,779,0,440,0,2,442,T
3-PA,780,0,450,0,0,450,T
3-PA,781,1,0,0,449,450,C
3-PA,782,0,447,0,0,447,T
3-PA,783,0,1,445,0,446,G
3-PA,784,444,0,0,0,444,A
3-PA,785,443,0,0,0,443,A
3-PA,786,0,2,444,0,446,G
3-PA,787,437,0,1,0,438,A
3-PA,788,0,0,0,438,438,C
3-PA,789,435,0,0,0,435,A
3-PA,790,437,0,1,0,438,A
3-PA,791,0,0,0,465,465,C
3-PA,792,466,0,0,0,466,A
3-PA,793,0,0,0,466,466,C
3-PA,794,4,0,0,458,462,C
3-PA,795,457,0,2,0,459,A
3-PA,796,460,0,0,0,460,A
3-PA,797,0,0,458,0,458,G
3-PA,798,461,0,0,0,461,A
3-PA,799,0,0,0,461,461,C
3-PA,800,2,0,0,420,422,C
3-PA,801,419,0,0,0,419,A
3-PA,802,421,0,0,0,421,A
3-PA,803,0,420,0,0,420,T
3-PA,804,2,1,0,418,421,C
3-PA,805,418,1,1,0,420,A
3-PA,806,420,0,0,0,420,A
3-PA,807,418,0,0,0,418,A
3-PA,808,0,1,0,420,421,C
3-PA,809,0,415,0,0,415,T
3-PA,810,0,421,0,0,421,T
3-PA,811,1,0,0,421,422,C
3-PA,812,0,0,0,419,419,C
3-PA,813,1,3,419,0,423,G
3-PA,814,422,0,0,0,422,A
3-PA,815,421,0,1,0,422,A
3-PA,816,0,425,0,0,425,T
3-PA,817,0,0,419,0,419,G
3-PA,818,0,0,419,0,419,G
3-PA,819,425,0,0,0,425,A
3-PA,820,1,0,0,424,425,C
3-PA,821,2,0,0,422,424,C
3-PA,822,0,432,0,0,432,T
3-PA,823,1,0,0,439,440,C
3-PA,824,0,1,0,439,440,C
3-PA,825,0,436,0,0,436,T
3-PA,826,0,447,0,0,447,T
3-PA,827,0,0,459,0,459,G
3-PA,828,0,458,1,0,459,T
3-PA,829,0,453,0,1,454,T
3-PA,830,454,0,2,0,456,A
3-PA,831,0,443,0,1,444,T
3-PA,832,3,0,0,438,441,C
3-PA,833,432,0,0,0,432,A
3-PA,834,0,0,430,0,430,G
3-PA,835,0,0,0,431,431,C
3-PA,836,0,0,418,0,418,G
3-PA,837,0,1,426,0,427,G
3-PA,838,0,431,0,0,431,T
3-PA,839,2,1,0,428,431,C
3-PA,840,4,1,0,428,433,C
3-PA,841,435,0,0,0,435,A
3-PA,842,434,0,0,0,434,A
3-PA,843,433,0,0,0,433,A
3-PA,844,0,433,0,0,433,T
3-PA,845,0,433,0,0,433,T
3-PA,846,2,1,0,428,431,C
3-PA,847,3,1,0,421,425,C
3-PA,848,0,423,0,0,423,T
3-PA,849,2,0,0,424,426,C
3-PA,850,1,0,0,428,429,C
3-PA,851,0,421,0,0,421,T
3-PA,852,0,2,426,0,428,G
3-PA,853,427,0,0,0,427,A
3-PA,854,0,428,0,0,428,T
3-PA,855,0,2,420,0,422,G
3-PA,856,0,2,413,0,415,G
3-PA,857,413,0,1,0,414,A
3-PA,858,1,408,0,0,409,T
3-PA,859,0,0,412,0,412,G
3-PA,860,0,0,0,417,417,C
3-PA,861,0,414,0,1,415,T
3-PA,862,0,414,0,1,415,T
3-PA,863,0,417,0,0,417,T
3-PA,864,416,0,0,0,416,A
3-PA,865,417,0,1,0,418,A
3-PA,866,418,0,0,0,418,A
3-PA,867,420,0,0,0,420,A
3-PA,868,0,421,0,0,421,T
3-PA,869,0,384,0,0,384,T
3-PA,870,2,3,378,0,383,G
3-PA,871,383,0,0,0,383,A
3-PA,872,0,0,383,0,383,G
3-PA,873,0,0,0,384,384,C
3-PA,874,382,0,0,0,382,A
3-PA,875,1,381,0,1,383,T
3-PA,876,0,382,0,0,382,T
3-PA,877,0,2,383,0,385,G
3-PA,878,386,0,0,0,386,A
3-PA,879,381,0,1,0,382,A
3-PA,880,0,1,381,0,382,G
3-PA,881,372,1,1,0,374,A
3-PA,882,1,0,0,376,377,C
3-PA,883,2,0,0,374,376,C
3-PA,884,0,0,0,370,370,C
3-PA,885,366,0,0,0,366,A
3-PA,886,369,0,0,0,369,A
3-PA,887,0,0,370,0,370,G
3-PA,888,0,369,1,2,372,T
3-PA,889,3,0,0,367,370,C
3-PA,890,371,0,0,0,371,A
3-PA,891,0,0,0,371,371,C
3-PA,892,0,2,369,0,371,G
3-PA,893,373,0,0,0,373,A
3-PA,894,375,0,0,0,375,A
3-PA,895,0,0,388,0,388,G
3-PA,896,0,2,388,0,390,G
3-PA,897,390,0,0,0,390,A
3-PA,898,0,1,392,0,393,G
3-PA,899,394,0,0,0,394,A
3-PA,900,392,0,0,0,392,A
3-PA,901,0,2,392,0,394,G
3-PA,902,0,1,389,0,390,G
3-PA,903,2,1,390,0,393,G
3-PA,904,383,0,1,0,384,A
3-PA,905,0,379,0,1,380,T
3-PA,906,0,0,0,384,384,C
3-PA,907,2,0,0,406,408,C
3-PA,908,0,0,0,417,417,C
3-PA,909,424,0,0,0,424,A
3-PA,910,0,424,0,0,424,T
3-PA,911,0,423,0,0,423,T
3-PA,912,428,0,0,0,428,A
3-PA,913,0,428,0,1,429,T
3-PA,914,428,0,1,0,429,A
3-PA,915,0,427,0,0,427,T
3-PA,916,0,2,385,0,387,G
3-PA,917,386,0,2,0,388,A
3-PA,918,0,385,0,0,385,T
3-PA,919,0,0,388,0,388,G
3-PA,920,0,0,0,383,383,C
3-PA,921,0,2,377,0,379,G
3-PA,922,381,0,0,0,381,A
3-PA,923,0,381,0,0,381,T
3-PA,924,2,0,0,379,381,C
3-PA,925,377,0,1,0,378,A
3-PA,926,381,0,0,0,381,A
3-PA,927,0,0,383,0,383,G
3-PA,928,0,382,0,0,382,T
3-PA,929,0,1,384,0,385,G
3-PA,930,1,0,0,386,387,C
3-PA,931,385,0,2,0,387,A
3-PA,932,0,388,0,0,388,T
3-PA,933,386,0,0,1,387,A
3-PA,934,390,0,0,0,390,A
3-PA,935,391,0,0,0,391,A
3-PA,936,386,0,0,0,386,A
3-PA,937,387,0,1,0,388,A
3-PA,938,0,0,0,390,390,C
3-PA,939,389,0,0,0,389,A
3-PA,940,0,389,0,0,389,T
3-PA,941,0,393,0,0,393,T
3-PA,942,1,0,0,394,395,C
3-PA,943,0,374,0,0,374,T
3-PA,944,0,372,0,1,373,T
3-PA,945,0,373,0,0,373,T
3-PA,946,0,2,370,0,372,G
3-PA,947,0,1,374,0,375,G
3-PA,948,372,0,0,0,372,A
3-PA,949,0,371,0,0,371,T
3-PA,950,0,1,376,0,377,G
3-PA,951,0,1,382,0,383,G
3-PA,952,384,0,0,0,384,A
3-PA,953,384,0,0,0,384,A
3-PA,954,384,0,1,0,385,A
3-PA,955,0,3,389,0,392,G
3-PA,956,386,0,2,0,388,A
3-PA,957,428,0,1,0,429,A
3-PA,958,0,0,0,443,443,C
3-PA,959,1,0,0,443,444,C
3-PA,960,0,440,0,0,440,T
3-PA,961,0,446,0,1,447,T
3-PA,962,450,0,0,0,450,A
3-PA,963,0,450,1,0,451,T
3-PA,964,452,0,1,0,453,A
3-PA,965,0,454,0,0,454,T
3-PA,966,427,0,0,0,427,A
3-PA,967,0,0,434,0,434,G
3-PA,968,1,429,0,0,430,T
3-PA,969,0,0,0,430,430,C
3-PA,970,425,1,1,0,427,A
3-PA,971,426,0,0,0,426,A
3-PA,972,425,0,1,0,426,A
3-PA,973,0,0,0,428,428,C
3-PA,974,0,1,0,420,421,C
3-PA,975,421,0,0,0,421,A
3-PA,976,0,1,0,422,423,C
3-PA,977,421,0,1,0,422,A
3-PA,978,1,1,0,421,423,C
3-PA,979,0,3,422,0,425,G
3-PA,980,419,1,2,0,422,A
3-PA,981,419,0,1,0,420,A
3-PA,982,420,0,0,0,420,A
3-PA,983,419,0,1,0,420,A
3-PA,984,0,2,417,0,419,G
3-PA,985,0,1,410,0,411,G
3-PA,986,0,4,414,0,418,G
3-PA,987,413,1,1,0,415,A
3-PA,988,415,0,0,0,415,A
3-PA,989,0,413,0,0,413,T
3-PA,990,412,0,0,0,412,A
3-PA,991,414,0,0,0,414,A
3-PA,992,414,0,0,0,414,A
3-PA,993,0,407,0,0,407,T
3-PA,994,0,408,0,0,408,T
3-PA,995,2,0,0,410,412,C
3-PA,996,412,0,0,0,412,A
3-PA,997,414,0,0,0,414,A
3-PA,998,415,0,0,0,415,A
3-PA,999,0,413,0,0,413,T
3-PA,1000,0,413,0,0,413,T
3-PA,1001,414,0,0,0,414,A
3-PA,1002,0,0,0,414,414,C
3-PA,1003,0,0,0,412,412,C
3-PA,1004,0,400,0,0,400,T
3-PA,1005,0,0,401,0,401,G
3-PA,1006,0,0,0,406,406,C
3-PA,1007,0,404,0,2,406,T
3-PA,1008,0,0,414,0,414,G
3-PA,1009,0,414,0,0,414,T
3-PA,1010,2,0,0,410,412,C
3-PA,1011,412,0,0,0,412,A
3-PA,1012,0,413,0,1,414,T
3-PA,1013,0,2,410,0,412,G
3-PA,1014,1,0,412,0,413,G
3-PA,1015,411,0,1,0,412,A
3-PA,1016,422,0,0,0,422,A
3-PA,1017,0,0,418,0,418,G
3-PA,1018,0,0,0,423,423,C
3-PA,1019,420,0,1,0,421,A
3-PA,1020,425,0,0,0,425,A
3-PA,1021,0,0,426,0,426,G
3-PA,1022,0,426,0,0,426,T
3-PA,1023,423,0,0,0,423,A
3-PA,1024,1,0,0,424,425,C
3-PA,1025,0,418,0,0,418,T
3-PA,1026,0,0,422,0,422,G
3-PA,1027,0,418,0,1,419,T
3-PA,1028,5,0,0,418,423,C
3-PA,1029,418,0,0,0,418,A
3-PA,1030,1,3,420,0,424,G
3-PA,1031,421,0,0,0,421,A
3-PA,1032,423,0,0,0,423,A
3-PA,1033,0,433,0,1,434,T
3-PA,1034,0,432,0,0,432,T
3-PA,1035,2,0,429,0,431,G
3-PA,1036,2,0,0,430,432,C
3-PA,1037,429,0,0,0,429,A
3-PA,1038,0,2,429,0,431,G
3-PA,1039,0,2,428,0,430,G
3-PA,1040,434,0,0,0,434,A
3-PA,1041,0,0,0,439,439,C
3-PA,1042,428,0,0,0,428,A
3-PA,1043,0,432,0,0,432,T
3-PA,1044,0,433,0,0,433,T
3-PA,1045,0,6,430,0,436,G
3-PA,1046,439,0,0,0,439,A
3-PA,1047,439,0,0,0,439,A
3-PA,1048,439,0,0,0,439,A
3-PA,1049,435,0,2,0,437,A
3-PA,1050,0,431,0,1,432,T
3-PA,1051,0,2,438,0,440,G
3-PA,1052,440,0,1,0,441,A
3-PA,1053,0,0,444,0,444,G
3-PA,1054,0,5,439,0,444,G
3-PA,1055,443,0,0,0,443,A
3-PA,1056,0,1,445,0,446,G
3-PA,1057,448,0,0,0,448,A
3-PA,1058,449,0,0,0,449,A
3-PA,1059,0,0,447,0,447,G
3-PA,1060,0,1,436,0,437,G
3-PA,1061,0,453,0,0,453,T
3-PA,1062,0,450,0,2,452,T
3-PA,1063,0,1,0,453,454,C
3-PA,1064,0,0,0,453,453,C
3-PA,1065,456,0,0,0,456,A
3-PA,1066,453,0,0,0,453,A
3-PA,1067,0,1,461,0,462,G
3-PA,1068,0,3,469,0,472,G
3-PA,1069,467,0,0,0,467,A
3-PA,1070,0,0,0,469,469,C
3-PA,1071,0,468,0,1,469,T
3-PA,1072,469,0,0,0,469,A
3-PA,1073,467,0,0,0,467,A
3-PA,1074,468,0,2,0,470,A
3-PA,1075,471,0,1,0,472,A
3-PA,1076,467,0,0,0,467,A
3-PA,1077,0,0,0,464,464,C
3-PA,1078,464,0,0,0,464,A
3-PA,1079,0,458,0,0,458,T
3-PA,1080,1,1,460,0,462,G
3-PA,1081,463,0,0,0,463,A
3-PA,1082,465,0,1,0,466,A
3-PA,1083,0,3,465,0,468,G
3-PA,1084,464,0,0,0,464,A
3-PA,1085,467,0,0,0,467,A
3-PA,1086,463,0,0,0,463,A
3-PA,1087,462,0,1,0,463,A
3-PA,1088,0,0,0,465,465,C
3-PA,1089,0,5,459,0,464,G
3-PA,1090,462,1,0,0,463,A
3-PA,1091,0,0,466,0,466,G
3-PA,1092,0,467,0,0,467,T
3-PA,1093,4,2,0,472,478,C
3-PA,1094,476,0,0,0,476,A
3-PA,1095,487,0,0,0,487,A
3-PA,1096,0,0,0,488,488,C
3-PA,1097,0,483,0,0,483,T
3-PA,1098,0,3,493,0,496,G
3-PA,1099,491,0,0,0,491,A
3-PA,1100,487,0,3,0,490,A
3-PA,1101,0,1,493,0,494,G
3-PA,1102,0,490,0,0,490,T
3-PA,1103,0,2,487,0,489,G
3-PA,1104,0,2,482,0,484,G
3-PA,1105,1,1,487,0,489,G
3-PA,1106,0,0,0,486,486,C
3-PA,1107,1,487,0,0,488,T
3-PA,1108,2,0,0,484,486,C
3-PA,1109,0,485,0,2,487,T
3-PA,1110,0,488,0,0,488,T
3-PA,1111,0,0,498,0,498,G
3-PA,1112,0,1,496,0,497,G
3-PA,1113,0,495,0,0,495,T
3-PA,1114,0,2,493,0,495,G
3-PA,1115,492,0,0,0,492,A
3-PA,1116,495,0,3,0,498,A
3-PA,1117,491,1,1,0,493,A
3-PA,1118,490,0,2,1,493,A
3-PA,1119,1,0,0,496,497,C
3-PA,1120,492,0,0,0,492,A
3-PA,1121,0,492,0,0,492,T
3-PA,1122,0,1,493,0,494,G
3-PA,1123,0,0,497,0,497,G
3-PA,1124,0,2,0,498,500,C
3-PA,1125,496,0,0,0,496,A
3-PA,1126,1,0,1,500,502,C
3-PA,1127,0,0,0,504,504,C
3-PA,1128,507,0,0,0,507,A
3-PA,1129,0,7,509,0,516,G
3-PA,1130,514,0,0,0,514,A
3-PA,1131,2,1,515,0,518,G
3-PA,1132,514,0,1,0,515,A
3-PA,1133,516,0,0,0,516,A
3-PA,1134,0,1,516,0,517,G
3-PA,1135,0,1,517,0,518,G
3-PA,1136,0,514,0,1,515,T
3-PA,1137,509,0,0,0,509,A
3-PA,1138,1,4,506,0,511,G
3-PA,1139,506,0,0,0,506,A
3-PA,1140,1,0,0,507,508,C
3-PA,1141,0,496,1,0,497,T
3-PA,1142,0,500,0,0,500,T
3-PA,1143,0,501,0,0,501,T
3-PA,1144,1,4,497,0,502,G
3-PA,1145,500,0,1,0,501,A
3-PA,1146,503,0,0,0,503,A
3-PA,1147,504,0,0,0,504,A
3-PA,1148,500,0,1,0,501,A
3-PA,1149,0,0,0,509,509,C
3-PA,1150,0,510,0,0,510,T
3-PA,1151,0,1,515,0,516,G
3-PA,1152,0,0,0,514,514,C
3-PA,1153,514,0,0,0,514,A
3-PA,1154,0,0,517,0,517,G
3-PA,1155,515,0,0,0,515,A
3-PA,1156,0,1,536,0,537,G
3-PA,1157,535,0,0,0,535,A
3-PA,1158,0,0,0,538,538,C
3-PA,1159,536,0,2,0,538,A
3-PA,1160,0,533,0,0,533,T
3-PA,1161,534,0,0,0,534,A
3-PA,1162,530,0,1,0,531,A
3-PA,1163,0,0,531,0,531,G
3-PA,1164,0,0,0,531,531,C
3-PA,1165,0,2,520,0,522,G
3-PA,1166,532,0,0,0,532,A
3-PA,1167,0,524,0,0,524,T
3-PA,1168,0,521,0,0,521,T
3-PA,1169,0,523,0,0,523,T
3-PA,1170,0,0,528,0,528,G
3-PA,1171,529,0,0,0,529,A
3-PA,1172,529,0,0,0,529,A
3-PA,1173,0,1,528,0,529,G
3-PA,1174,0,0,0,531,531,C
3-PA,1175,526,0,1,0,527,A
3-PA,1176,566,0,0,0,566,A
3-PA,1177,0,567,0,0,567,T
3-PA,1178,567,0,0,0,567,A
3-PA,1179,0,567,1,0,568,T
3-PA,1180,2,10,561,0,573,G
3-PA,1181,577,0,1,0,578,A
3-PA,1182,1,578,0,1,580,T
3-PA,1183,561,0,1,0,562,A
3-PA,1184,0,1,565,0,566,G
3-PA,1185,0,539,0,0,539,T
3-PA,1186,0,4,534,0,538,G
3-PA,1187,537,0,0,1,538,A
3-PA,1188,0,0,0,535,535,C
3-PA,1189,0,6,528,0,534,G
3-PA,1190,539,0,0,0,539,A
3-PA,1191,536,0,1,0,537,A
3-PA,1192,1,0,0,536,537,C
3-PA,1193,1,0,0,539,540,C
3-PA,1194,0,535,0,1,536,T
3-PA,1195,0,1,556,0,557,G
3-PA,1196,553,0,0,0,553,A
3-PA,1197,555,0,0,0,555,A
3-PA,1198,0,555,0,0,555,T
3-PA,1199,0,552,0,0,552,T
3-PA,1200,550,0,0,0,550,A
3-PA,1201,543,0,0,0,543,A
3-PA,1202,0,0,544,0,544,G
3-PA,1203,1,2,539,0,542,G
3-PA,1204,0,537,0,2,539,T
3-PA,1205,4,0,0,534,538,C
3-PA,1206,542,0,0,0,542,A
3-PA,1207,1,0,0,567,568,C
3-PA,1208,0,562,0,2,564,T
3-PA,1209,0,567,0,0,567,T
3-PA,1210,0,568,0,2,570,T
3-PA,1211,0,0,0,569,569,C
3-PA,1212,566,1,1,0,568,A
3-PA,1213,563,0,0,0,563,A
3-PA,1214,0,0,573,0,573,G
3-PA,1215,0,0,0,574,574,C
3-PA,1216,0,563,0,1,564,T
3-PA,1217,0,0,577,0,577,G
3-PA,1218,0,3,574,0,577,G
3-PA,1219,588,0,0,0,588,A
3-PA,1220,0,594,0,0,594,T
3-PA,1221,595,0,0,0,595,A
3-PA,1222,0,0,0,598,598,C
3-PA,1223,576,0,0,0,576,A
3-PA,1224,1,4,574,1,580,G
3-PA,1225,578,0,0,0,578,A
3-PA,1226,564,0,1,0,565,A
3-PA,1227,0,560,0,0,560,T
3-PA,1228,0,2,558,0,560,G
3-PA,1229,555,0,0,0,555,A
3-PA,1230,0,1,562,0,563,G
3-PA,1231,0,556,0,0,556,T
3-PA,1232,0,556,0,0,556,T
3-PA,1233,5,0,0,559,564,C
3-PA,1234,565,1,1,0,567,A
3-PA,1235,567,0,0,0,567,A
3-PA,1236,1,0,0,564,565,C
3-PA,1237,560,0,0,0,560,A
3-PA,1238,561,1,0,0,562,A
3-PA,1239,0,2,554,0,556,G
3-PA,1240,0,2,559,0,561,G
3-PA,1241,0,0,0,566,566,C
3-PA,1242,0,0,0,566,566,C
3-PA,1243,0,564,0,1,565,T
3-PA,1244,0,1,567,0,568,G
3-PA,1245,0,566,0,0,566,T
3-PA,1246,1,3,568,0,572,G
3-PA,1247,573,0,0,0,573,A
3-PA,1248,0,0,570,0,570,G
3-PA,1249,0,0,0,566,566,C
3-PA,1250,0,561,0,3,564,T
3-PA,1251,574,0,1,0,575,A
3-PA,1252,574,0,1,0,575,A
3-PA,1253,1,0,0,571,572,C
3-PA,1254,0,569,0,1,570,T
3-PA,1255,0,1,570,0,571,G
3-PA,1256,563,0,1,0,564,A
3-PA,1257,1,567,0,0,568,T
3-PA,1258,0,566,0,1,567,T
3-PA,1259,3,0,0,568,571,C
3-PA,1260,574,0,0,0,574,A
3-PA,1261,1,0,575,0,576,G
3-PA,1262,0,579,0,0,579,T
3-PA,1263,5,0,0,575,580,C
3-PA,1264,1,570,0,1,572,T
3-PA,1265,0,2,589,0,591,G
3-PA,1266,0,2,590,0,592,G
3-PA,1267,596,0,0,0,596,A
3-PA,1268,0,594,0,1,595,T
3-PA,1269,578,0,0,0,578,A
3-PA,1270,0,1,575,0,576,G
3-PA,1271,579,0,0,0,579,A
3-PA,1272,0,0,582,0,582,G
3-PA,1273,0,0,0,578,578,C
3-PA,1274,0,560,0,1,561,T
3-PA,1275,0,560,0,1,561,T
3-PA,1276,0,1,562,0,563,G
3-PA,1277,559,1,2,0,562,A
3-PA,1278,0,563,0,0,563,T
3-PA,1279,0,2,556,0,558,G
3-PA,1280,566,0,0,0,566,A
3-PA,1281,564,0,1,0,565,A
3-PA,1282,568,0,0,0,568,A
3-PA,1283,0,567,0,0,567,T
3-PA,1284,1,565,0,0,566,T
3-PA,1285,0,4,567,0,571,G
3-PA,1286,1,4,566,0,571,G
3-PA,1287,571,0,0,0,571,A
3-PA,1288,1,1,571,0,573,G
3-PA,1289,563,0,4,0,567,A
3-PA,1290,0,0,570,0,570,G
3-PA,1291,0,2,572,0,574,G
3-PA,1292,577,0,1,0,578,A
3-PA,1293,1,0,0,576,577,C
3-PA,1294,1,0,572,0,573,G
3-PA,1295,0,572,0,1,573,T
3-PA,1296,577,0,0,0,577,A
3-PA,1297,0,0,577,0,577,G
3-PA,1298,2,0,0,578,580,C
3-PA,1299,4,0,0,567,571,C
3-PA,1300,2,0,0,572,574,C
3-PA,1301,4,0,0,566,570,C
3-PA,1302,566,0,0,0,566,A
3-PA,1303,576,0,0,0,576,A
3-PA,1304,0,575,0,1,576,T
3-PA,1305,0,575,0,0,575,T
3-PA,1306,0,4,573,1,578,G
3-PA,1307,568,0,1,0,569,A
3-PA,1308,0,0,573,0,573,G
3-PA,1309,1,2,0,569,572,C
3-PA,1310,567,0,0,0,567,A
3-PA,1311,0,0,0,579,579,C
3-PA,1312,566,0,0,0,566,A
3-PA,1313,1,576,0,1,578,T
3-PA,1314,0,577,0,0,577,T
3-PA,1315,0,0,577,0,577,G
3-PA,1316,2,0,0,575,577,C
3-PA,1317,575,0,0,0,575,A
3-PA,1318,575,1,0,0,576,A
3-PA,1319,0,0,578,0,578,G
3-PA,1320,1,0,0,571,572,C
3-PA,1321,573,0,0,0,573,A
3-PA,1322,0,561,0,0,561,T
3-PA,1323,0,4,558,0,562,G
3-PA,1324,562,0,0,0,562,A
3-PA,1325,0,2,558,0,560,G
3-PA,1326,557,0,4,0,561,A
3-PA,1327,555,0,1,0,556,A
3-PA,1328,0,1,556,0,557,G
3-PA,1329,0,2,556,0,558,G
3-PA,1330,555,0,0,0,555,A
3-PA,1331,558,0,0,0,558,A
3-PA,1332,0,559,1,0,560,T
3-PA,1333,0,556,0,0,556,T
3-PA,1334,563,0,0,0,563,A
3-PA,1335,0,564,0,1,565,T
3-PA,1336,0,566,0,0,566,T
3-PA,1337,0,569,0,0,569,T
3-PA,1338,3,0,0,559,562,C
3-PA,1339,561,0,0,0,561,A
3-PA,1340,0,1,0,570,571,C
3-PA,1341,569,1,0,0,570,A
3-PA,1342,1,0,573,0,574,G
3-PA,1343,0,0,0,573,573,C
3-PA,1344,568,1,0,0,569,A
3-PA,1345,0,2,571,0,573,G
3-PA,1346,568,0,0,0,568,A
3-PA,1347,0,2,570,0,572,G
3-PA,1348,0,0,571,1,572,G
3-PA,1349,0,560,0,0,560,T
3-PA,1350,0,0,566,0,566,G
3-PA,1351,0,556,0,1,557,T
3-PA,1352,0,2,0,555,557,C
3-PA,1353,3,1,1,562,567,C
3-PA,1354,2,0,1,561,564,C
3-PA,1355,574,0,1,0,575,A
3-PA,1356,0,577,0,1,578,T
3-PA,1357,0,570,0,0,570,T
3-PA,1358,0,0,570,0,570,G
3-PA,1359,0,564,0,0,564,T
3-PA,1360,556,0,1,0,557,A
3-PA,1361,0,1,557,0,558,G
3-PA,1362,542,0,3,0,545,A
3-PA,1363,2,0,541,0,543,G
3-PA,1364,0,0,0,538,538,C
3-PA,1365,1,0,0,527,528,C
3-PA,1366,535,0,1,0,536,A
3-PA,1367,0,0,0,538,538,C
3-PA,1368,0,527,0,2,529,T
3-PA,1369,0,6,521,0,527,G
3-PA,1370,528,0,0,0,528,A
3-PA,1371,515,0,0,0,515,A
3-PA,1372,0,523,0,0,523,T
3-PA,1373,525,0,0,0,525,A
3-PA,1374,0,0,0,528,528,C
3-PA,1375,511,0,0,0,511,A
3-PA,1376,1,510,0,0,511,T
3-PA,1377,508,0,0,0,508,A
3-PA,1378,515,0,0,0,515,A
3-PA,1379,0,514,0,0,514,T
3-PA,1380,0,1,509,0,510,G
3-PA,1381,506,0,2,0,508,A
3-PA,1382,504,0,0,0,504,A
3-PA,1383,0,2,507,0,509,G
3-PA,1384,0,0,501,0,501,G
3-PA,1385,0,0,503,0,503,G
3-PA,1386,0,4,504,0,508,G
3-PA,1387,1,0,506,0,507,G
3-PA,1388,0,497,1,1,499,T
3-PA,1389,498,0,2,0,500,A
3-PA,1390,0,499,0,0,499,T
3-PA,1391,511,0,1,0,512,A
3-PA,1392,0,0,0,555,555,C
3-PA,1393,537,0,0,0,537,A
3-PA,1394,0,524,0,0,524,T
3-PA,1395,0,523,0,0,523,T
3-PA,1396,514,1,0,0,515,A
3-PA,1397,526,0,0,0,526,A
3-PA,1398,0,2,0,525,527,C
3-PA,1399,518,0,0,0,518,A
3-PA,1400,0,0,0,512,512,C
3-PA,1401,0,456,0,0,456,T
3-PA,1402,0,0,466,0,466,G
3-PA,1403,2,0,1,466,469,C
3-PA,1404,3,0,0,462,465,C
3-PA,1405,0,0,1,467,468,C
3-PA,1406,0,450,0,0,450,T
3-PA,1407,1,0,460,0,461,G
3-PA,1408,1,0,0,461,462,C
3-PA,1409,0,465,0,0,465,T
3-PA,1410,4,0,0,470,474,C
3-PA,1411,458,0,0,0,458,A
3-PA,1412,459,1,1,0,461,A
3-PA,1413,0,461,0,0,461,T
3-PA,1414,0,0,461,0,461,G
3-PA,1415,0,0,0,460,460,C
3-PA,1416,444,0,0,0,444,A
3-PA,1417,0,445,0,0,445,T
3-PA,1418,1,0,0,441,442,C
3-PA,1419,1,0,0,442,443,C
3-PA,1420,0,432,0,1,433,T
3-PA,1421,0,0,449,0,449,G
3-PA,1422,0,446,0,0,446,T
3-PA,1423,0,0,445,0,445,G
3-PA,1424,1,2,0,443,446,C
3-PA,1425,442,0,0,0,442,A
3-PA,1426,0,0,443,0,443,G
3-PA,1427,0,0,0,446,446,C
3-PA,1428,438,0,0,0,438,A
3-PA,1429,441,0,0,0,441,A
3-PA,1430,0,429,0,0,429,T
3-PA,1431,0,1,426,0,427,G
3-PA,1432,0,2,422,0,424,G
3-PA,1433,427,0,0,0,427,A
3-PA,1434,0,0,0,426,426,C
3-PA,1435,0,2,428,0,430,G
3-PA,1436,436,0,0,0,436,A
3-PA,1437,0,438,0,0,438,T
3-PA,1438,0,435,0,0,435,T
3-PA,1439,0,431,0,0,431,T
3-PA,1440,1,432,0,1,434,T
3-PA,1441,0,0,0,434,434,C
3-PA,1442,435,0,0,0,435,A
3-PA,1443,435,0,0,0,435,A
3-PA,1444,0,0,0,433,433,C
3-PA,1445,0,426,0,0,426,T
3-PA,1446,426,0,0,0,426,A
3-PA,1447,426,0,0,0,426,A
3-PA,1448,0,426,0,0,426,T
3-PA,1449,0,427,0,0,427,T
3-PA,1450,2,0,0,426,428,C
3-PA,1451,1,0,0,422,423,C
3-PA,1452,1,0,0,422,423,C
3-PA,1453,421,1,0,0,422,A
3-PA,1454,0,429,0,0,429,T
3-PA,1455,0,0,431,0,431,G
3-PA,1456,431,0,0,0,431,A
3-PA,1457,1,427,0,0,428,T
3-PA,1458,426,0,0,0,426,A
3-PA,1459,422,0,0,0,422,A
3-PA,1460,0,0,422,0,422,G
3-PA,1461,0,0,0,424,424,C
3-PA,1462,423,0,0,0,423,A
3-PA,1463,413,0,0,0,413,A
3-PA,1464,0,1,420,0,421,G
3-PA,1465,1,413,0,0,414,T
3-PA,1466,0,0,416,0,416,G
3-PA,1467,0,0,0,414,414,C
3-PA,1468,411,0,0,0,411,A
3-PA,1469,0,2,417,0,419,G
3-PA,1470,421,0,0,0,421,A
3-PA,1471,425,0,1,0,426,A
3-PA,1472,0,0,0,426,426,C
3-PA,1473,0,413,0,1,414,T
3-PA,1474,422,0,0,0,422,A
3-PA,1475,419,0,0,0,419,A
3-PA,1476,420,0,0,0,420,A
3-PA,1477,0,1,420,0,421,G
3-PA,1478,403,0,0,0,403,A
3-PA,1479,0,1,403,0,404,G
3-PA,1480,0,1,397,0,398,G
3-PA,1481,0,2,399,0,401,G
3-PA,1482,395,0,0,0,395,A
3-PA,1483,390,0,2,0,392,A
3-PA,1484,0,0,391,0,391,G
3-PA,1485,0,0,388,0,388,G
3-PA,1486,0,1,0,386,387,C
3-PA,1487,2,3,384,0,389,G
3-PA,1488,385,0,1,0,386,A
3-PA,1489,386,0,1,0,387,A
3-PA,1490,387,0,0,0,387,A
3-PA,1491,388,0,0,0,388,A
3-PA,1492,384,0,0,2,386,A
3-PA,1493,1,0,0,387,388,C
3-PA,1494,0,0,0,385,385,C
3-PA,1495,384,0,0,0,384,A
3-PA,1496,389,0,0,0,389,A
3-PA,1497,0,388,0,0,388,T
3-PA,1498,0,386,0,0,386,T
3-PA,1499,0,390,0,0,390,T
3-PA,1500,387,0,0,0,387,A
3-PA,1501,0,388,0,0,388,T
3-PA,1502,388,0,1,0,389,A
3-PA,1503,0,388,0,0,388,T
3-PA,1504,0,0,387,0,387,G
3-PA,1505,0,1,380,0,381,G
3-PA,1506,382,0,0,0,382,A
3-PA,1507,0,379,0,0,379,T
3-PA,1508,0,376,0,0,376,T
3-PA,1509,1,2,0,374,377,C
3-PA,1510,377,0,0,0,377,A
3-PA,1511,0,378,0,1,379,T
3-PA,1512,1,0,0,379,380,C
3-PA,1513,380,0,1,0,381,A
3-PA,1514,0,377,0,0,377,T
3-PA,1515,377,0,0,0,377,A
3-PA,1516,377,0,0,0,377,A
3-PA,1517,376,0,0,0,376,A
3-PA,1518,0,0,374,0,374,G
3-PA,1519,0,1,367,0,368,G
3-PA,1520,1,3,360,0,364,G
3-PA,1521,359,0,1,0,360,A
3-PA,1522,358,0,1,0,359,A
3-PA,1523,1,0,359,0,360,G
3-PA,1524,359,0,0,0,359,A
3-PA,1525,0,358,0,0,358,T
3-PA,1526,0,0,1,357,358,C
3-PA,1527,0,351,0,0,351,T
3-PA,1528,1,0,0,360,361,C
3-PA,1529,360,0,0,0,360,A
3-PA,1530,0,358,0,0,358,T
3-PA,1531,1,355,2,0,358,T
3-PA,1532,0,352,0,0,352,T
3-PA,1533,352,0,0,0,352,A
3-PA,1534,351,0,0,0,351,A
3-PA,1535,0,0,352,0,352,G
3-PA,1536,0,1,350,1,352,G
3-PA,1537,332,0,0,0,332,A
3-PA,1538,332,0,0,0,332,A
3-PA,1539,0,331,0,0,331,T
3-PA,1540,0,3,327,0,330,G
3-PA,1541,336,0,0,0,336,A
3-PA,1542,0,1,0,333,334,C
3-PA,1543,332,0,0,0,332,A
3-PA,1544,0,0,0,331,331,C
3-PA,1545,320,0,0,0,320,A
3-PA,1546,0,1,321,0,322,G
3-PA,1547,321,0,0,0,321,A
3-PA,1548,0,0,0,315,315,C
3-PA,1549,0,0,311,0,311,G
3-PA,1550,0,296,0,0,296,T
3-PA,1551,0,1,292,0,293,G
3-PA,1552,0,0,300,0,300,G
3-PA,1553,0,299,0,0,299,T
3-PA,1554,300,0,0,0,300,A
3-PA,1555,294,0,0,0,294,A
3-PA,1556,295,0,0,0,295,A
3-PA,1557,0,293,0,1,294,T
3-PA,1558,0,289,0,0,289,T
3-PA,1559,0,287,1,0,288,T
3-PA,1560,0,285,0,1,286,T
3-PA,1561,0,0,285,0,285,G
3-PA,1562,0,283,0,0,283,T
3-PA,1563,0,8,275,0,283,G
3-PA,1564,279,0,0,0,279,A
3-PA,1565,0,0,277,0,277,G
3-PA,1566,1,0,0,271,272,C
3-PA,1567,274,0,0,0,274,A
3-PA,1568,0,273,0,0,273,T
3-PA,1569,0,1,273,0,274,G
3-PA,1570,0,0,276,0,276,G
3-PA,1571,275,0,0,0,275,A
3-PA,1572,1,0,275,0,276,G
3-PA,1573,0,268,0,0,268,T
3-PA,1574,0,262,1,2,265,T
3-PA,1575,0,266,0,1,267,T
3-PA,1576,0,268,0,0,268,T
3-PA,1577,1,0,0,267,268,C
3-PA,1578,1,264,0,0,265,T
3-PA,1579,3,0,0,259,262,C
3-PA,1580,0,251,0,1,252,T
3-PA,1581,1,0,0,251,252,C
3-PA,1582,252,0,0,0,252,A
3-PA,1583,0,0,0,252,252,C
3-PA,1584,0,245,0,0,245,T
3-PA,1585,0,1,244,0,245,G
3-PA,1586,245,0,0,0,245,A
3-PA,1587,1,0,0,245,246,C
3-PA,1588,0,0,0,247,247,C
3-PA,1589,1,0,0,246,247,C
3-PA,1590,0,1,245,0,246,G
3-PA,1591,246,0,0,0,246,A
3-PA,1592,0,3,241,0,244,G
3-PA,1593,245,0,0,0,245,A
3-PA,1594,0,0,0,239,239,C
3-PA,1595,0,238,0,0,238,T
3-PA,1596,0,235,0,0,235,T
3-PA,1597,0,2,233,0,235,G
3-PA,1598,234,0,0,0,234,A
3-PA,1599,0,1,234,0,235,G
3-PA,1600,0,0,0,232,232,C
3-PA,1601,2,0,0,223,225,C
3-PA,1602,222,1,1,0,224,A
3-PA,1603,1,2,0,221,224,C
3-PA,1604,224,0,0,0,224,A
3-PA,1605,0,224,0,0,224,T
3-PA,1606,222,0,0,0,222,A
3-PA,1607,216,0,0,0,216,A
3-PA,1608,215,0,0,0,215,A
3-PA,1609,0,214,0,0,214,T
3-PA,1610,0,1,210,0,211,G
3-PA,1611,0,1,191,0,192,G
3-PA,1612,0,0,187,0,187,G
3-PA,1613,187,0,0,0,187,A
3-PA,1614,0,0,175,0,175,G
3-PA,1615,173,0,0,0,173,A
3-PA,1616,170,0,0,0,170,A
3-PA,1617,170,0,0,0,170,A
3-PA,1618,0,168,0,0,168,T
3-PA,1619,165,0,0,0,165,A
3-PA,1620,0,0,0,166,166,C
3-PA,1621,0,89,0,0,89,T
3-PA,1622,0,0,88,0,88,G
3-PA,1623,0,62,0,0,62,T
3-PA,1624,0,0,63,0,63,G
3-PA,1625,0,59,0,0,59,T
3-PA,1626,0,0,0,43,43,C
3-PA,1627,0,0,0,39,39,C
3-PA,1628,0,37,0,0,37,T
3-PA,1629,0,36,0,0,36,T
3-PA,1630,0,0,35,0,35,G
3-PA,1631,34,0,0,0,34,A
3-PA,1632,0,0,35,0,35,G
3-PA,1633,34,0,0,0,34,A
3-PA,1634,0,33,0,0,33,T
3-PA,1635,34,0,0,0,34,A
3-PA,1636,0,0,35,0,35,G
3-PA,1637,0,0,35,0,35,G
3-PA,1638,34,0,0,0,34,A
3-PA,1639,0,1,34,0,35,G
3-PA,1640,34,0,0,0,34,A
3-PA,1641,0,34,0,0,34,T
3-PA,1642,34,0,0,0,34,A
3-PA,1643,0,34,0,0,34,T
3-PA,1644,0,0,36,0,36,G
3-PA,1645,0,35,0,0,35,T
3-PA,1646,0,34,0,0,34,T
3-PA,1647,35,0,0,0,35,A
3-PA,1648,1,0,0,34,35,C
3-PA,1649,0,34,0,0,34,T
3-PA,1650,35,0,0,0,35,A
3-PA,1651,35,0,0,0,35,A
3-PA,1652,0,0,36,0,36,G
3-PA,1653,33,0,0,0,33,A
3-PA,1654,34,0,0,0,34,A
3-PA,1655,0,0,33,0,33,G
3-PA,1656,0,37,0,0,37,T
3-PA,1657,0,0,36,0,36,G
3-PA,1658,0,0,0,37,37,C
3-PA,1659,0,0,0,37,37,C
3-PA,1660,37,0,0,0,37,A
3-PA,1661,0,36,0,0,36,T
3-PA,1662,36,0,0,0,36,A
3-PA,1663,0,0,35,0,35,G
3-PA,1664,0,0,35,0,35,G
3-PA,1665,0,0,0,35,35,C
3-PA,1666,0,0,0,34,34,C
3-PA,1667,35,0,0,0,35,A
3-PA,1668,35,0,0,0,35,A
3-PA,1669,34,0,0,0,34,A
3-PA,1670,0,36,0,0,36,T
3-PA,1671,0,36,0,0,36,T
3-PA,1672,0,36,0,0,36,T
3-PA,1673,0,0,0,36,36,C
3-PA,1674,35,0,0,0,35,A
3-PA,1675,35,0,0,0,35,A
3-PA,1676,0,0,35,0,35,G
3-PA,1677,0,0,35,0,35,G
3-PA,1678,0,0,0,35,35,C
3-PA,1679,0,0,0,34,34,C
3-PA,1680,1,0,33,0,34,G
3-PA,1681,36,0,0,0,36,A
3-PA,1682,0,36,0,0,36,T
3-PA,1683,0,0,38,0,38,G
3-PA,1684,0,38,0,0,38,T
3-PA,1685,0,40,0,1,41,T
3-PA,1686,0,0,0,41,41,C
3-PA,1687,0,40,0,0,40,T
3-PA,1688,0,41,0,0,41,T
3-PA,1689,0,0,41,0,41,G
3-PA,1690,0,40,0,0,40,T
3-PA,1691,41,0,0,0,41,A
3-PA,1692,0,41,0,0,41,T
3-PA,1693,0,0,41,0,41,G
3-PA,1694,0,41,0,0,41,T
3-PA,1695,0,0,41,0,41,G
3-PA,1696,40,0,0,0,40,A
3-PA,1697,0,0,41,0,41,G
3-PA,1698,0,0,41,0,41,G
3-PA,1699,41,0,0,0,41,A
3-PA,1700,0,0,0,41,41,C
3-PA,1701,41,0,0,0,41,A
3-PA,1702,40,0,0,0,40,A
3-PA,1703,40,0,0,0,40,A
3-PA,1704,0,0,0,40,40,C
3-PA,1705,0,0,40,0,40,G
3-PA,1706,0,0,41,0,41,G
3-PA,1707,40,0,0,0,40,A
3-PA,1708,41,0,0,0,41,A
3-PA,1709,0,0,0,42,42,C
3-PA,1710,41,0,1,0,42,A
3-PA,1711,0,42,0,0,42,T
3-PA,1712,0,0,0,41,41,C
3-PA,1713,42,0,0,0,42,A
3-PA,1714,42,0,0,0,42,A
3-PA,1715,42,0,0,0,42,A
3-PA,1716,0,0,42,0,42,G
3-PA,1717,0,0,43,0,43,G
3-PA,1718,0,42,0,0,42,T
3-PA,1719,0,0,0,43,43,C
3-PA,1720,43,0,0,0,43,A
3-PA,1721,43,0,0,0,43,A
3-PA,1722,42,0,1,0,43,A
3-PA,1723,43,0,0,0,43,A
3-PA,1724,0,43,0,0,43,T
3-PA,1725,0,0,44,0,44,G
3-PA,1726,42,0,0,0,42,A
3-PA,1727,43,0,0,0,43,A
3-PA,1728,43,0,0,0,43,A
3-PA,1729,0,42,0,1,43,T
3-PA,1730,0,0,46,0,46,G
3-PA,1731,0,0,46,0,46,G
3-PA,1732,0,1,45,0,46,G
3-PA,1733,0,1,45,0,46,G
3-PA,1734,46,0,0,0,46,A
3-PA,1735,46,0,0,0,46,A
3-PA,1736,0,46,0,0,46,T
3-PA,1737,0,0,47,0,47,G
3-PA,1738,0,0,46,0,46,G
3-PA,1739,46,0,0,0,46,A
3-PA,1740,0,0,47,0,47,G
3-PA,1741,46,0,0,0,46,A
3-PA,1742,0,46,0,0,46,T
3-PA,1743,0,0,46,0,46,G
3-PA,1744,46,0,0,0,46,A
3-PA,1745,0,0,46,0,46,G
3-PA,1746,47,0,0,0,47,A
3-PA,1747,0,0,0,47,47,C
3-PA,1748,1,0,46,0,47,G
3-PA,1749,0,47,0,0,47,T
3-PA,1750,0,47,0,0,47,T
3-PA,1751,0,0,46,0,46,G
3-PA,1752,0,0,0,46,46,C
3-PA,1753,0,0,0,47,47,C
3-PA,1754,0,45,0,0,45,T
3-PA,1755,0,0,0,45,45,C
3-PA,1756,0,0,0,47,47,C
3-PA,1757,0,47,0,0,47,T
3-PA,1758,0,47,0,0,47,T
3-PA,1759,0,0,0,48,48,C
3-PA,1760,47,0,0,0,47,A
3-PA,1761,0,0,47,0,47,G
3-PA,1762,0,47,0,0,47,T
3-PA,1763,0,1,0,46,47,C
3-PA,1764,46,0,0,0,46,A
3-PA,1765,0,0,0,48,48,C
3-PA,1766,0,48,0,0,48,T
3-PA,1767,0,0,0,48,48,C
3-PA,1768,0,1,0,48,49,C
3-PA,1769,47,0,0,0,47,A
3-PA,1770,0,0,47,0,47,G
3-PA,1771,0,0,0,46,46,C
3-PA,1772,45,0,0,0,45,A
3-PA,1773,0,0,46,0,46,G
3-PA,1774,44,0,0,0,44,A
3-PA,1775,0,43,0,0,43,T
3-PA,1776,2,0,0,41,43,C
3-PA,1777,0,0,44,0,44,G
3-PA,1778,43,0,0,0,43,A
3-PA,1779,1,0,43,0,44,G
3-PA,1780,44,0,0,0,44,A
3-PA,1781,0,0,44,0,44,G
3-PA,1782,0,0,0,43,43,C
3-PA,1783,42,0,0,0,42,A
3-PA,1784,0,42,0,0,42,T
3-PA,1785,0,1,41,0,42,G
3-PA,1786,42,0,0,0,42,A
3-PA,1787,0,42,0,0,42,T
3-PA,1788,0,42,0,0,42,T
3-PA,1789,1,0,41,0,42,G
3-PA,1790,42,0,0,0,42,A
3-PA,1791,43,0,0,0,43,A
3-PA,1792,0,0,43,0,43,G
3-PA,1793,0,0,0,42,42,C
3-PA,1794,0,0,0,42,42,C
3-PA,1795,0,0,42,0,42,G
3-PA,1796,42,0,0,0,42,A
3-PA,1797,0,0,42,0,42,G
3-PA,1798,0,42,0,0,42,T
3-PA,1799,0,0,0,43,43,C
3-PA,1800,0,0,0,42,42,C
3-PA,1801,0,42,0,0,42,T
3-PA,1802,0,0,0,43,43,C
3-PA,1803,0,0,43,0,43,G
3-PA,1804,1,0,43,0,44,G
3-PA,1805,0,44,0,0,44,T
3-PA,1806,0,45,0,0,45,T
3-PA,1807,44,1,0,0,45,A
3-PA,1808,45,0,0,0,45,A
3-PA,1809,45,0,0,0,45,A
3-PA,1810,0,1,45,0,46,G
3-PA,1811,44,0,0,0,44,A
3-PA,1812,0,1,43,0,44,G
3-PA,1813,44,0,0,0,44,A
3-PA,1814,44,0,0,0,44,A
3-PA,1815,44,0,0,0,44,A
3-PA,1816,0,0,43,0,43,G
3-PA,1817,43,0,0,1,44,A
3-PA,1818,0,0,0,44,44,C
3-PA,1819,42,0,0,0,42,A
3-PA,1820,0,42,0,0,42,T
3-PA,1821,0,0,42,0,42,G
3-PA,1822,42,0,0,0,42,A
3-PA,1823,0,0,0,42,42,C
3-PA,1824,1,0,0,41,42,C
3-PA,1825,40,0,0,0,40,A
3-PA,1826,43,0,0,0,43,A
3-PA,1827,42,0,0,0,42,A
3-PA,1828,0,0,42,0,42,G
3-PA,1829,42,0,0,0,42,A
3-PA,1830,1,0,42,0,43,G
3-PA,1831,0,41,1,0,42,T
3-PA,1832,0,40,0,0,40,T
3-PA,1833,1,40,0,0,41,T
3-PA,1834,0,42,0,0,42,T
3-PA,1835,0,42,0,0,42,T
3-PA,1836,0,42,0,0,42,T
3-PA,1837,0,0,42,0,42,G
3-PA,1838,42,0,0,0,42,A
3-PA,1839,0,0,42,0,42,G
3-PA,1840,42,0,0,0,42,A
3-PA,1841,41,0,0,0,41,A
3-PA,1842,0,41,1,0,42,T
3-PA,1843,42,0,0,0,42,A
3-PA,1844,41,0,0,0,41,A
3-PA,1845,0,0,40,0,40,G
3-PA,1846,1,42,0,0,43,T
3-PA,1847,1,0,0,42,43,C
3-PA,1848,43,0,0,0,43,A
3-PA,1849,0,1,44,0,45,G
3-PA,1850,45,0,0,0,45,A
3-PA,1851,45,0,0,0,45,A
3-PA,1852,0,0,45,0,45,G
3-PA,1853,0,0,0,45,45,C
3-PA,1854,44,0,0,0,44,A
3-PA,1855,0,44,0,0,44,T
3-PA,1856,0,0,44,0,44,G
3-PA,1857,0,0,44,0,44,G
3-PA,1858,0,0,0,43,43,C
3-PA,1859,0,0,0,44,44,C
3-PA,1860,0,0,0,44,44,C
3-PA,1861,44,0,0,0,44,A
3-PA,1862,1,43,0,0,44,T
3-PA,1863,0,44,0,0,44,T
3-PA,1864,0,0,43,0,43,G
3-PA,1865,0,1,42,0,43,G
3-PA,1866,0,0,42,0,42,G
3-PA,1867,0,0,42,0,42,G
3-PA,1868,40,0,0,0,40,A
3-PA,1869,0,0,41,0,41,G
3-PA,1870,0,40,0,0,40,T
3-PA,1871,0,0,1,41,42,C
3-PA,1872,0,0,0,42,42,C
3-PA,1873,0,0,0,41,41,C
3-PA,1874,0,0,0,41,41,C
3-PA,1875,1,0,0,40,41,C
3-PA,1876,40,0,0,0,40,A
3-PA,1877,40,0,0,0,40,A
3-PA,1878,0,0,41,0,41,G
3-PA,1879,0,0,40,0,40,G
3-PA,1880,0,0,41,0,41,G
3-PA,1881,36,0,1,0,37,A
3-PA,1882,0,0,38,0,38,G
3-PA,1883,0,38,0,0,38,T
3-PA,1884,1,0,37,0,38,G
3-PA,1885,0,1,37,0,38,G
3-PA,1886,38,0,0,0,38,A
3-PA,1887,38,0,0,0,38,A
3-PA,1888,0,0,38,0,38,G
3-PA,1889,38,0,0,0,38,A
3-PA,1890,38,0,0,0,38,A
3-PA,1891,0,0,38,0,38,G
3-PA,1892,0,0,37,0,37,G
3-PA,1893,0,37,0,0,37,T
3-PA,1894,0,37,0,0,37,T
3-PA,1895,1,0,0,37,38,C
3-PA,1896,0,0,0,38,38,C
3-PA,1897,38,0,0,0,38,A
3-PA,1898,0,38,0,0,38,T
3-PA,1899,1,37,0,0,38,T
3-PA,1900,0,0,39,0,39,G
3-PA,1901,0,0,39,0,39,G
3-PA,1902,0,0,39,0,39,G
3-PA,1903,39,0,0,0,39,A
3-PA,1904,37,0,0,1,38,A
3-PA,1905,38,0,0,0,38,A
3-PA,1906,0,0,38,0,38,G
3-PA,1907,0,38,0,0,38,T
3-PA,1908,0,0,0,39,39,C
3-PA,1909,0,38,0,1,39,T
3-PA,1910,0,0,39,0,39,G
3-PA,1911,0,39,0,0,39,T
3-PA,1912,39,0,0,0,39,A
3-PA,1913,0,1,38,0,39,G
3-PA,1914,0,0,38,0,38,G
3-PA,1915,37,0,0,0,37,A
3-PA,1916,0,0,0,37,37,C
3-PA,1917,0,37,0,0,37,T
3-PA,1918,0,0,0,37,37,C
3-PA,1919,0,37,0,0,37,T
3-PA,1920,37,0,0,0,37,A
3-PA,1921,0,37,0,0,37,T
3-PA,1922,0,37,0,0,37,T
3-PA,1923,0,0,37,0,37,G
3-PA,1924,0,0,37,0,37,G
3-PA,1925,0,0,0,37,37,C
3-PA,1926,0,37,0,0,37,T
3-PA,1927,34,0,0,0,34,A
3-PA,1928,34,0,0,0,34,A
3-PA,1929,0,0,34,0,34,G
3-PA,1930,0,34,0,0,34,T
3-PA,1931,0,0,0,33,33,C
3-PA,1932,31,0,0,0,31,A
3-PA,1933,0,0,31,0,31,G
3-PA,1934,0,32,0,0,32,T
3-PA,1935,33,0,0,0,33,A
3-PA,1936,0,33,0,0,33,T
3-PA,1937,0,35,0,0,35,T
3-PA,1938,0,0,0,35,35,C
3-PA,1939,35,0,0,0,35,A
3-PA,1940,35,0,0,0,35,A
3-PA,1941,0,35,0,0,35,T
3-PA,1942,33,0,0,0,33,A
3-PA,1943,0,0,34,0,34,G
3-PA,1944,0,0,0,32,32,C
3-PA,1945,0,0,0,33,33,C
3-PA,1946,0,32,0,0,32,T
3-PA,1947,0,0,33,0,33,G
3-PA,1948,0,33,0,0,33,T
3-PA,1949,33,0,0,0,33,A
3-PA,1950,0,33,0,0,33,T
3-PA,1951,0,0,32,0,32,G
3-PA,1952,0,0,0,31,31,C
3-PA,1953,30,0,0,0,30,A
3-PA,1954,0,29,0,0,29,T
3-PA,1955,0,0,0,28,28,C
3-PA,1956,29,0,0,0,29,A
3-PA,1957,0,0,0,29,29,C
3-PA,1958,0,0,0,28,28,C
3-PA,1959,28,0,0,0,28,A
3-PA,1960,0,0,0,28,28,C
3-PA,1961,28,0,0,0,28,A
3-PA,1962,28,0,0,0,28,A
3-PA,1963,0,28,0,0,28,T
3-PA,1964,0,28,0,0,28,T
3-PA,1965,0,0,28,0,28,G
3-PA,1966,0,0,28,0,28,G
3-PA,1967,28,0,0,0,28,A
3-PA,1968,28,0,0,0,28,A
3-PA,1969,0,0,28,0,28,G
3-PA,1970,0,0,28,0,28,G
3-PA,1971,27,0,0,0,27,A
3-PA,1972,0,28,0,0,28,T
3-PA,1973,0,28,0,0,28,T
3-PA,1974,0,28,0,0,28,T
3-PA,1975,0,27,0,0,27,T
3-PA,1976,0,0,0,27,27,C
3-PA,1977,26,0,0,0,26,A
3-PA,1978,0,0,26,0,26,G
3-PA,1979,0,0,0,26,26,C
3-PA,1980,0,0,25,0,25,G
3-PA,1981,0,0,25,0,25,G
3-PA,1982,24,0,0,0,24,A
3-PA,1983,0,0,24,0,24,G
3-PA,1984,0,24,0,0,24,T
3-PA,1985,0,0,0,24,24,C
3-PA,1986,24,0,0,0,24,A
3-PA,1987,24,0,0,0,24,A
3-PA,1988,0,0,24,0,24,G
3-PA,1989,24,0,0,0,24,A
3-PA,1990,24,0,0,0,24,A
3-PA,1991,24,0,0,0,24,A
3-PA,1992,24,0,0,0,24,A
3-PA,1993,0,0,0,24,24,C
3-PA,1994,0,24,0,0,24,T
3-PA,1995,0,0,24,0,24,G
3-PA,1996,0,0,0,24,24,C
3-PA,1997,0,24,0,0,24,T
3-PA,1998,0,0,0,24,24,C
3-PA,1999,0,0,0,24,24,C
3-PA,2000,0,23,0,0,23,T
3-PA,2001,0,23,0,0,23,T
3-PA,2002,0,0,23,0,23,G
3-PA,2003,0,23,0,0,23,T
3-PA,2004,0,23,0,0,23,T
3-PA,2005,0,0,23,0,23,G
3-PA,2006,0,23,0,0,23,T
3-PA,2007,0,22,0,0,22,T
3-PA,2008,0,0,0,22,22,C
3-PA,2009,20,0,0,0,20,A
3-PA,2010,0,0,20,0,20,G
3-PA,2011,0,0,20,0,20,G
3-PA,2012,0,0,0,20,20,C
3-PA,2013,0,20,0,0,20,T
3-PA,2014,0,0,0,21,21,C
3-PA,2015,0,21,0,0,21,T
3-PA,2016,0,21,0,0,21,T
3-PA,2017,21,0,0,0,21,A
3-PA,2018,0,0,21,0,21,G
3-PA,2019,0,0,20,0,20,G
3-PA,2020,0,0,20,0,20,G
3-PA,2021,15,0,0,0,15,A
3-PA,2022,0,0,0,15,15,C
3-PA,2023,12,0,0,0,12,A
3-PA,2024,12,0,0,0,12,A
3-PA,2025,0,0,0,12,12,C
3-PA,2026,0,0,0,12,12,C
3-PA,2027,0,12,0,0,12,T
3-PA,2028,0,0,0,12,12,C
3-PA,2029,0,0,12,0,12,G
3-PA,2030,12,0,0,0,12,A
3-PA,2031,12,0,0,0,12,A
3-PA,2032,0,0,0,13,13,C
3-PA,2033,0,0,0,13,13,C
3-PA,2034,0,12,0,0,12,T
3-PA,2035,0,0,12,0,12,G
3-PA,2036,0,0,12,0,12,G
3-PA,2037,0,0,12,0,12,G
3-PA,2038,12,0,0,0,12,A
3-PA,2039,0,0,0,12,12,C
3-PA,2040,0,0,0,12,12,C
3-PA,2041,0,11,0,0,11,T
3-PA,2042,0,11,0,0,11,T
3-PA,2043,0,11,0,0,11,T
3-PA,2044,0,0,10,0,10,G
3-PA,2045,10,0,0,0,10,A
3-PA,2046,0,10,0,0,10,T
3-PA,2047,0,0,0,10,10,C
3-PA,2048,0,10,0,0,10,T
3-PA,2049,0,10,0,0,10,T
3-PA,2050,0,0,10,0,10,G
3-PA,2051,0,0,10,0,10,G
3-PA,2052,0,0,10,0,10,G
3-PA,2053,0,0,10,0,10,G
3-PA,2054,0,0,10,0,10,G
3-PA,2055,0,0,11,0,11,G
3-PA,2056,0,0,0,11,11,C
3-PA,2057,0,11,0,0,11,T
3-PA,2058,12,0,0,0,12,A
3-PA,2059,0,12,0,0,12,T
3-PA,2060,12,0,0,0,12,A
3-PA,2061,0,12,0,0,12,T
3-PA,2062,0,0,12,0,12,G
3-PA,2063,12,0,0,0,12,A
3-PA,2064,12,0,0,0,12,A
3-PA,2065,0,0,12,0,12,G
3-PA,2066,0,0,0,12,12,C
3-PA,2067,11,0,0,0,11,A
3-PA,2068,11,0,0,0,11,A
3-PA,2069,0,11,0,0,11,T
3-PA,2070,0,11,0,0,11,T
3-PA,2071,0,0,11,0,11,G
3-PA,2072,11,0,0,0,11,A
3-PA,2073,0,0,11,0,11,G
3-PA,2074,0,0,11,0,11,G
3-PA,2075,11,0,0,0,11,A
3-PA,2076,0,0,11,0,11,G
3-PA,2077,0,11,0,0,11,T
3-PA,2078,0,0,11,0,11,G
3-PA,2079,0,0,0,11,11,C
3-PA,2080,0,0,0,11,11,C
3-PA,2081,0,11,0,0,11,T
3-PA,2082,0,0,11,0,11,G
3-PA,2083,11,0,0,0,11,A
3-PA,2084,0,11,0,0,11,T
3-PA,2085,0,11,0,0,11,T
3-PA,2086,11,0,0,0,11,A
3-PA,2087,11,0,0,0,11,A
3-PA,2088,0,10,0,0,10,T
3-PA,2089,0,0,10,0,10,G
3-PA,2090,10,0,0,0,10,A
3-PA,2091,0,11,0,0,11,T
3-PA,2092,0,0,0,11,11,C
3-PA,2093,0,0,0,10,10,C
3-PA,2094,0,0,0,11,11,C
3-PA,2095,0,11,0,0,11,T
3-PA,2096,0,1,10,0,11,G
3-PA,2097,0,0,11,0,11,G
3-PA,2098,0,0,11,0,11,G
3-PA,2099,0,11,0,0,11,T
3-PA,2100,0,11,0,0,11,T
3-PA,2101,0,11,0,0,11,T
3-PA,2102,0,10,0,0,10,T
3-PA,2103,0,0,10,0,10,G
3-PA,2104,0,0,0,10,10,C
3-PA,2105,0,10,0,0,10,T
3-PA,2106,0,0,0,10,10,C
3-PA,2107,10,0,0,0,10,A
3-PA,2108,10,0,0,0,10,A
3-PA,2109,0,10,0,0,10,T
3-PA,2110,0,0,10,0,10,G
3-PA,2111,0,0,0,9,9,C
3-PA,2112,0,0,9,0,9,G
3-PA,2113,0,9,0,0,9,T
3-PA,2114,0,0,0,9,9,C
3-PA,2115,0,9,0,0,9,T
3-PA,2116,0,9,0,0,9,T
3-PA,2117,0,0,9,0,9,G
3-PA,2118,0,0,9,0,9,G
3-PA,2119,0,9,0,0,9,T
3-PA,2120,0,9,0,0,9,T
3-PA,2121,0,0,0,9,9,C
3-PA,2122,9,0,0,0,9,A
3-PA,2123,9,0,0,0,9,A
3-PA,2124,0,0,0,9,9,C
3-PA,2125,0,9,0,0,9,T
3-PA,2126,0,0,0,9,9,C
3-PA,2127,0,0,0,8,8,C
3-PA,2128,0,8,0,0,8,T
3-PA,2129,0,8,0,0,8,T
3-PA,2130,0,0,0,8,8,C
3-PA,2131,0,0,0,7,7,C
3-PA,2132,0,7,0,0,7,T
3-PA,2133,0,0,7,0,7,G
3-PA,2134,7,0,0,0,7,A
3-PA,2135,0,0,0,7,7,C
3-PA,2136,7,0,0,0,7,A
3-PA,2137,0,0,0,7,7,C
3-PA,2138,7,0,0,0,7,A
3-PA,2139,0,7,0,0,7,T
3-PA,2140,0,0,7,0,7,G
3-PA,2141,0,0,0,7,7,C
3-PA,2142,7,0,0,0,7,A
3-PA,2143,0,7,0,0,7,T
3-PA,2144,0,7,0,0,7,T
3-PA,2145,7,0,0,0,7,A
3-PA,2146,7,0,0,0,7,A
3-PA,2147,7,0,0,0,7,A
3-PA,2148,7,0,0,0,7,A
3-PA,2149,0,7,0,0,7,T
3-PA,2150,7,0,0,0,7,A
3-PA,2151,0,0,7,0,7,G
4-HA,1,89,0,0,0,89,A
4-HA,2,0,95,0,0,95,T
4-HA,3,0,0,100,0,100,G
4-HA,4,99,0,0,0,99,A
4-HA,5,101,0,1,0,102,A
4-HA,6,0,1,104,0,105,G
4-HA,7,104,0,0,0,104,A
4-HA,8,0,0,0,115,115,C
4-HA,9,0,117,0,2,119,T
4-HA,10,122,1,0,0,123,A
4-HA,11,0,127,0,0,127,T
4-HA,12,0,0,0,128,128,C
4-HA,13,129,0,0,0,129,A
4-HA,14,0,129,0,0,129,T
4-HA,15,0,129,0,0,129,T
4-HA,16,0,0,142,0,142,G
4-HA,17,0,0,0,143,143,C
4-HA,18,0,145,0,0,145,T
4-HA,19,0,145,0,0,145,T
4-HA,20,0,146,0,0,146,T
4-HA,21,0,0,158,0,158,G
4-HA,22,161,0,0,0,161,A
4-HA,23,0,0,170,0,170,G
4-HA,24,0,0,0,170,170,C
4-HA,25,0,171,0,0,171,T
4-HA,26,188,0,1,0,189,A
4-HA,27,0,0,0,191,191,C
4-HA,28,190,0,0,0,190,A
4-HA,29,0,207,0,2,209,T
4-HA,30,0,209,0,0,209,T
4-HA,31,0,0,0,217,217,C
4-HA,32,0,216,0,0,216,T
4-HA,33,220,0,0,0,220,A
4-HA,34,0,222,0,1,223,T
4-HA,35,2,0,222,0,224,G
4-HA,36,0,223,0,0,223,T
4-HA,37,0,1,0,223,224,C
4-HA,38,1,220,0,1,222,T
4-HA,39,1,3,217,0,221,G
4-HA,40,0,0,222,0,222,G
4-HA,41,0,223,0,0,223,T
4-HA,42,0,223,0,0,223,T
4-HA,43,0,223,0,0,223,T
4-HA,44,0,223,0,0,223,T
4-HA,45,0,0,0,222,222,C
4-HA,46,2,1,219,0,222,G
4-HA,47,0,0,0,223,223,C
4-HA,48,0,220,0,0,220,T
4-HA,49,1,0,0,226,227,C
4-HA,50,227,0,0,0,227,A
4-HA,51,229,0,0,0,229,A
4-HA,52,226,0,0,0,226,A
4-HA,53,229,0,0,0,229,A
4-HA,54,230,0,0,0,230,A
4-HA,55,0,0,0,234,234,C
4-HA,56,0,234,0,0,234,T
4-HA,57,0,238,0,0,238,T
4-HA,58,0,0,0,238,238,C
4-HA,59,0,0,0,238,238,C
4-HA,60,0,237,0,0,237,T
4-HA,61,0,0,240,0,240,G
4-HA,62,1,0,241,0,242,G
4-HA,63,242,0,0,0,242,A
4-HA,64,247,0,0,0,247,A
4-HA,65,247,0,0,0,247,A
4-HA,66,0,247,0,0,247,T
4-HA,67,0,1,249,0,250,G
4-HA,68,249,0,1,0,250,A
4-HA,69,0,0,0,254,254,C
4-HA,70,253,0,0,0,253,A
4-HA,71,255,0,0,0,255,A
4-HA,72,0,0,0,258,258,C
4-HA,73,257,0,0,0,257,A
4-HA,74,0,0,263,0,263,G
4-HA,75,0,0,0,262,262,C
4-HA,76,262,0,0,0,262,A
4-HA,77,0,0,0,269,269,C
4-HA,78,0,1,268,1,270,G
4-HA,79,0,0,273,0,273,G
4-HA,80,0,0,0,271,271,C
4-HA,81,270,0,0,0,270,A
4-HA,82,277,0,2,0,279,A
4-HA,83,1,0,0,284,285,C
4-HA,84,1,0,286,0,287,G
4-HA,85,0,0,0,289,289,C
4-HA,86,0,285,0,0,285,T
4-HA,87,1,1,287,0,289,G
4-HA,88,0,287,0,0,287,T
4-HA,89,0,0,300,0,300,G
4-HA,90,0,0,0,305,305,C
4-HA,91,3,0,0,304,307,C
4-HA,92,0,309,0,0,309,T
4-HA,93,0,310,0,0,310,T
4-HA,94,0,1,309,0,310,G
4-HA,95,0,0,312,0,312,G
4-HA,96,1,0,317,0,318,G
4-HA,97,0,0,0,318,318,C
4-HA,98,318,0,0,0,318,A
4-HA,99,0,0,0,323,323,C
4-HA,100,2,0,0,316,318,C
4-HA,101,340,0,0,0,340,A
4-HA,102,0,340,0,0,340,T
4-HA,103,0,0,340,0,340,G
4-HA,104,0,0,0,340,340,C
4-HA,105,327,0,1,0,328,A
4-HA,106,0,1,351,0,352,G
4-HA,107,0,351,0,1,352,T
4-HA,108,354,0,0,0,354,A
4-HA,109,0,0,0,353,353,C
4-HA,110,0,0,0,345,345,C
4-HA,111,347,0,0,0,347,A
4-HA,112,345,0,0,0,345,A
4-HA,113,346,0,0,0,346,A
4-HA,114,0,3,0,344,347,C
4-HA,115,0,0,341,0,341,G
4-HA,116,0,1,355,0,356,G
4-HA,117,355,0,0,0,355,A
4-HA,118,355,0,0,0,355,A
4-HA,119,0,0,0,354,354,C
4-HA,120,353,0,0,0,353,A
4-HA,121,358,0,0,0,358,A
4-HA,122,0,359,0,0,359,T
4-HA,123,362,0,1,0,363,A
4-HA,124,0,1,362,0,363,G
4-HA,125,0,361,0,0,361,T
4-HA,126,0,6,355,0,361,G
4-HA,127,357,0,1,0,358,A
4-HA,128,360,0,0,0,360,A
4-HA,129,362,0,0,0,362,A
4-HA,130,362,0,0,1,363,A
4-HA,131,0,0,0,372,372,C
4-HA,132,369,0,0,0,369,A
4-HA,133,369,0,0,0,369,A
4-HA,134,0,367,0,1,368,T
4-HA,135,0,1,0,367,368,C
4-HA,136,369,0,0,0,369,A
4-HA,137,0,1,0,371,372,C
4-HA,138,0,0,373,0,373,G
4-HA,139,369,0,1,0,370,A
4-HA,140,367,0,3,0,370,A
4-HA,141,0,370,0,1,371,T
4-HA,142,0,4,368,0,372,G
4-HA,143,371,0,4,0,375,A
4-HA,144,0,0,0,374,374,C
4-HA,145,1,0,0,373,374,C
4-HA,146,381,0,0,0,381,A
4-HA,147,382,0,0,0,382,A
4-HA,148,381,0,0,0,381,A
4-HA,149,0,382,0,0,382,T
4-HA,150,0,381,0,1,382,T
4-HA,151,0,3,380,0,383,G
4-HA,152,382,0,0,0,382,A
4-HA,153,378,0,1,0,379,A
4-HA,154,0,1,383,0,384,G
4-HA,155,0,382,0,0,382,T
4-HA,156,1,391,0,0,392,T
4-HA,157,394,0,0,0,394,A
4-HA,158,0,0,0,396,396,C
4-HA,159,0,398,0,0,398,T
4-HA,160,396,0,1,0,397,A
4-HA,161,404,0,1,0,405,A
4-HA,162,0,406,0,0,406,T
4-HA,163,1,0,406,0,407,G
4-HA,164,0,0,0,416,416,C
4-HA,165,0,415,0,0,415,T
4-HA,166,415,0,1,0,416,A
4-HA,167,1,1,0,415,417,C
4-HA,168,0,415,0,1,416,T
4-HA,169,0,1,417,0,418,G
4-HA,170,411,0,0,0,411,A
4-HA,171,0,0,416,0,416,G
4-HA,172,0,0,0,412,412,C
4-HA,173,0,405,0,0,405,T
4-HA,174,0,4,412,0,416,G
4-HA,175,0,1,421,0,422,G
4-HA,176,0,420,0,2,422,T
4-HA,177,0,420,0,0,420,T
4-HA,178,2,0,0,420,422,C
4-HA,179,417,0,0,0,417,A
4-HA,180,0,4,410,0,414,G
4-HA,181,417,0,0,0,417,A
4-HA,182,0,0,421,0,421,G
4-HA,183,0,420,0,1,421,T
4-HA,184,0,418,0,0,418,T
4-HA,185,2,0,0,417,419,C
4-HA,186,0,0,0,420,420,C
4-HA,187,0,416,0,2,418,T
4-HA,188,0,0,0,422,422,C
4-HA,189,422,0,0,0,422,A
4-HA,190,422,0,0,0,422,A
4-HA,191,0,0,0,427,427,C
4-HA,192,417,0,1,0,418,A
4-HA,193,0,3,422,0,425,G
4-HA,194,0,0,423,0,423,G
4-HA,195,0,422,0,1,423,T
4-HA,196,0,5,421,0,426,G
4-HA,197,422,0,0,0,422,A
4-HA,198,423,0,1,0,424,A
4-HA,199,434,0,0,0,434,A
4-HA,200,0,432,0,0,432,T
4-HA,201,435,0,0,0,435,A
4-HA,202,0,427,0,0,427,T
4-HA,203,0,0,428,0,428,G
4-HA,204,0,1,1,429,431,C
4-HA,205,0,3,426,0,429,G
4-HA,206,431,0,0,0,431,A
4-HA,207,1,0,0,429,430,C
4-HA,208,423,0,0,0,423,A
4-HA,209,1,0,448,0,449,G
4-HA,210,0,446,0,0,446,T
4-HA,211,1,0,0,456,457,C
4-HA,212,1,0,0,457,458,C
4-HA,213,0,454,0,0,454,T
4-HA,214,1,0,0,467,468,C
4-HA,215,467,0,0,0,467,A
4-HA,216,0,464,0,1,465,T
4-HA,217,1,0,0,466,467,C
4-HA,218,445,0,1,0,446,A
4-HA,219,0,0,450,0,450,G
4-HA,220,445,0,0,0,445,A
4-HA,221,0,445,0,0,445,T
4-HA,222,2,0,0,447,449,C
4-HA,223,0,0,0,444,444,C
4-HA,224,0,442,0,0,442,T
4-HA,225,0,444,0,0,444,T
4-HA,226,0,0,444,0,444,G
4-HA,227,446,1,0,0,447,A
4-HA,228,0,443,0,0,443,T
4-HA,229,0,1,448,0,449,G
4-HA,230,0,1,449,0,450,G
4-HA,231,446,0,0,0,446,A
4-HA,232,0,1,445,0,446,G
4-HA,233,442,0,0,0,442,A
4-HA,234,0,1,437,0,438,G
4-HA,235,439,0,0,0,439,A
4-HA,236,442,0,0,0,442,A
4-HA,237,0,0,0,445,445,C
4-HA,238,0,438,0,1,439,T
4-HA,239,0,0,459,2,461,G
4-HA,240,0,0,0,459,459,C
4-HA,241,461,0,2,0,463,A
4-HA,242,0,0,0,475,475,C
4-HA,243,473,0,0,0,473,A
4-HA,244,0,0,0,518,518,C
4-HA,245,0,519,0,0,519,T
4-HA,246,526,0,0,0,526,A
4-HA,247,525,0,0,0,525,A
4-HA,248,0,526,0,0,526,T
4-HA,249,524,1,0,0,525,A
4-HA,250,0,1,523,1,525,G
4-HA,251,523,0,0,0,523,A
4-HA,252,0,517,0,0,517,T
4-HA,253,0,1,495,0,496,G
4-HA,254,0,1,0,498,499,C
4-HA,255,0,493,0,0,493,T
4-HA,256,4,0,0,522,526,C
4-HA,257,0,525,0,2,527,T
4-HA,258,536,0,0,0,536,A
4-HA,259,0,535,0,0,535,T
4-HA,260,0,532,0,0,532,T
4-HA,261,1,1,535,0,537,G
4-HA,262,0,1,533,0,534,G
4-HA,263,1,1,530,0,532,G
4-HA,264,517,0,0,0,517,A
4-HA,265,0,4,506,0,510,G
4-HA,266,499,1,1,0,501,A
4-HA,267,0,0,1,523,524,C
4-HA,268,2,0,0,527,529,C
4-HA,269,2,0,0,530,532,C
4-HA,270,0,533,0,0,533,T
4-HA,271,1,0,0,545,546,C
4-HA,272,547,0,0,0,547,A
4-HA,273,488,1,51,0,540,A
4-HA,274,0,557,0,1,558,T
4-HA,275,1,2,556,1,560,G
4-HA,276,0,558,1,2,561,T
4-HA,277,0,2,559,0,561,G
4-HA,278,555,2,1,0,558,A
4-HA,279,0,559,1,0,560,T
4-HA,280,1,5,548,0,554,G
4-HA,281,2,0,555,0,557,G
4-HA,282,0,0,0,552,552,C
4-HA,283,0,552,0,0,552,T
4-HA,284,0,551,0,2,553,T
4-HA,285,1,0,0,550,551,C
4-HA,286,0,1,0,549,550,C
4-HA,287,555,0,1,0,556,A
4-HA,288,555,0,1,0,556,A
4-HA,289,553,0,1,1,555,A
4-HA,290,552,0,0,1,553,A
4-HA,291,0,558,0,0,558,T
4-HA,292,559,0,1,0,560,A
4-HA,293,559,0,1,0,560,A
4-HA,294,0,2,558,0,560,G
4-HA,295,563,0,2,0,565,A
4-HA,296,568,0,0,0,568,A
4-HA,297,565,0,0,0,565,A
4-HA,298,0,563,0,0,563,T
4-HA,299,0,1,562,0,563,G
4-HA,300,1,2,564,0,567,G
4-HA,301,0,1,563,0,564,G
4-HA,302,567,0,0,0,567,A
4-HA,303,1,1,0,569,571,C
4-HA,304,3,0,0,567,570,C
4-HA,305,1,583,0,0,584,T
4-HA,306,0,577,0,3,580,T
4-HA,307,1,577,1,1,580,T
4-HA,308,0,587,0,0,587,T
4-HA,309,0,587,0,0,587,T
4-HA,310,0,2,587,0,589,G
4-HA,311,0,588,0,0,588,T
4-HA,312,0,582,0,0,582,T
4-HA,313,5,5,573,0,583,G
4-HA,314,577,1,0,0,578,A
4-HA,315,577,1,0,0,578,A
4-HA,316,0,2,0,578,580,C
4-HA,317,0,2,574,0,576,G
4-HA,318,1,0,0,581,582,C
4-HA,319,580,0,1,0,581,A
4-HA,320,2,0,584,0,586,G
4-HA,321,0,1,0,588,589,C
4-HA,322,587,0,2,0,589,A
4-HA,323,587,0,2,0,589,A
4-HA,324,590,0,1,0,591,A
4-HA,325,1,1,613,0,615,G
4-HA,326,0,1,0,614,615,C
4-HA,327,2,0,0,615,617,C
4-HA,328,0,615,0,1,616,T
4-HA,329,613,0,0,0,613,A
4-HA,330,0,0,0,621,621,C
4-HA,331,620,0,0,0,620,A
4-HA,332,0,0,621,0,621,G
4-HA,333,0,0,0,621,621,C
4-HA,334,597,0,0,0,597,A
4-HA,335,602,0,0,0,602,A
4-HA,336,0,0,0,622,622,C
4-HA,337,1,614,0,0,615,T
4-HA,338,2,1,611,0,614,G
4-HA,339,0,608,0,1,609,T
4-HA,340,0,607,0,0,607,T
4-HA,341,612,0,0,0,612,A
4-HA,342,0,0,0,645,645,C
4-HA,343,1,0,0,644,645,C
4-HA,344,3,0,0,651,654,C
4-HA,345,0,631,0,1,632,T
4-HA,346,0,628,0,1,629,T
4-HA,347,633,0,0,0,633,A
4-HA,348,0,634,0,0,634,T
4-HA,349,2,0,631,0,633,G
4-HA,350,628,0,0,0,628,A
4-HA,351,1,591,0,1,593,T
4-HA,352,0,0,595,0,595,G
4-HA,353,0,588,0,0,588,T
4-HA,354,1,1,585,0,587,G
4-HA,355,0,1,0,589,590,C
4-HA,356,1,0,0,586,587,C
4-HA,357,1,1,599,0,601,G
4-HA,358,0,7,610,0,617,G
4-HA,359,617,0,0,0,617,A
4-HA,360,0,617,0,1,618,T
4-HA,361,0,606,0,0,606,T
4-HA,362,610,0,0,0,610,A
4-HA,363,0,609,0,0,609,T
4-HA,364,0,1,610,0,611,G
4-HA,365,2,1,0,608,611,C
4-HA,366,0,0,0,611,611,C
4-HA,367,0,607,0,1,608,T
4-HA,368,2,0,0,628,630,C
4-HA,369,3,0,0,632,635,C
4-HA,370,3,0,0,634,637,C
4-HA,371,0,633,0,0,633,T
4-HA,372,0,634,0,0,634,T
4-HA,373,635,0,0,0,635,A
4-HA,374,1,3,648,0,652,G
4-HA,375,0,1,650,1,652,G
4-HA,376,0,646,0,0,646,T
4-HA,377,8,0,0,632,640,C
4-HA,378,634,0,1,0,635,A
4-HA,379,0,0,0,648,648,C
4-HA,380,0,647,0,0,647,T
4-HA,381,647,0,0,0,647,A
4-HA,382,2,0,645,0,647,G
4-HA,383,0,635,0,2,637,T
4-HA,384,0,631,0,0,631,T
4-HA,385,0,0,641,0,641,G
4-HA,386,0,0,0,638,638,C
4-HA,387,2,0,0,635,637,C
4-HA,388,0,629,0,2,631,T
4-HA,389,6,0,0,625,631,C
4-HA,390,644,0,0,0,644,A
4-HA,391,0,645,0,1,646,T
4-HA,392,0,0,0,648,648,C
4-HA,393,1,1,0,647,649,C
4-HA,394,1,3,637,0,641,G
4-HA,395,1,0,641,0,642,G
4-HA,396,0,0,0,641,641,C
4-HA,397,644,0,0,0,644,A
4-HA,398,1,0,0,655,656,C
4-HA,399,642,0,0,0,642,A
4-HA,400,0,0,0,645,645,C
4-HA,401,0,643,0,0,643,T
4-HA,402,0,1,651,0,652,G
4-HA,403,0,0,658,0,658,G
4-HA,404,656,0,1,0,657,A
4-HA,405,0,0,662,0,662,G
4-HA,406,0,648,0,0,648,T
4-HA,407,0,643,0,0,643,T
4-HA,408,0,649,0,0,649,T
4-HA,409,646,0,0,0,646,A
4-HA,410,649,0,0,0,649,A
4-HA,411,0,0,0,660,660,C
4-HA,412,643,0,0,0,643,A
4-HA,413,644,0,2,0,646,A
4-HA,414,0,647,0,0,647,T
4-HA,415,0,3,646,0,649,G
4-HA,416,646,0,1,1,648,A
4-HA,417,640,7,0,0,647,A
4-HA,418,645,0,1,0,646,A
4-HA,419,0,0,654,0,654,G
4-HA,420,0,1,0,653,654,C
4-HA,421,0,652,0,0,652,T
4-HA,422,0,651,0,1,652,T
4-HA,423,1,0,0,653,654,C
4-HA,424,661,0,0,0,661,A
4-HA,425,663,0,0,0,663,A
4-HA,426,0,664,0,0,664,T
4-HA,427,0,659,0,2,661,T
4-HA,428,0,3,671,0,674,G
4-HA,429,0,3,675,0,678,G
4-HA,430,677,1,0,0,678,A
4-HA,431,1,0,0,678,679,C
4-HA,432,0,674,0,0,674,T
4-HA,433,0,0,679,0,679,G
4-HA,434,0,3,676,2,681,G
4-HA,435,680,0,0,0,680,A
4-HA,436,1,0,685,0,686,G
4-HA,437,0,672,0,3,675,T
4-HA,438,8,1,0,665,674,C
4-HA,439,682,0,0,0,682,A
4-HA,440,0,0,0,682,682,C
4-HA,441,0,678,0,2,680,T
4-HA,442,4,0,0,678,682,C
4-HA,443,678,0,1,0,679,A
4-HA,444,679,0,1,0,680,A
4-HA,445,682,0,1,0,683,A
4-HA,446,685,0,0,0,685,A
4-HA,447,0,0,0,685,685,C
4-HA,448,0,1,678,0,679,G
4-HA,449,0,2,686,0,688,G
4-HA,450,685,1,0,0,686,A
4-HA,451,688,0,0,0,688,A
4-HA,452,0,0,0,686,686,C
4-HA,453,682,0,1,1,684,A
4-HA,454,690,0,0,0,690,A
4-HA,455,0,0,700,0,700,G
4-HA,456,0,0,0,701,701,C
4-HA,457,0,685,0,4,689,T
4-HA,458,2,0,0,692,694,C
4-HA,459,2,686,0,0,688,T
4-HA,460,0,4,687,0,691,G
4-HA,461,0,0,0,691,691,C
4-HA,462,0,690,0,0,690,T
4-HA,463,0,696,0,0,696,T
4-HA,464,1,0,702,0,703,G
4-HA,465,0,1,0,709,710,C
4-HA,466,709,0,0,0,709,A
4-HA,467,0,708,0,0,708,T
4-HA,468,709,0,1,0,710,A
4-HA,469,708,0,1,0,709,A
4-HA,470,0,1,708,0,709,G
4-HA,471,0,3,707,0,710,G
4-HA,472,687,0,1,0,688,A
4-HA,473,0,0,681,0,681,G
4-HA,474,676,1,1,0,678,A
4-HA,475,0,702,0,0,702,T
4-HA,476,2,0,0,709,711,C
4-HA,477,0,713,0,0,713,T
4-HA,478,715,0,0,0,715,A
4-HA,479,716,0,0,0,716,A
4-HA,480,0,714,0,1,715,T
4-HA,481,713,0,1,0,714,A
4-HA,482,710,0,0,0,710,A
4-HA,483,2,0,0,710,712,C
4-HA,484,692,0,0,0,692,A
4-HA,485,0,0,696,0,696,G
4-HA,486,0,674,0,7,681,T
4-HA,487,0,695,0,1,696,T
4-HA,488,0,700,1,0,701,T
4-HA,489,1,0,0,711,712,C
4-HA,490,0,712,0,0,712,T
4-HA,491,0,713,1,0,714,T
4-HA,492,0,713,0,0,713,T
4-HA,493,705,0,0,0,705,A
4-HA,494,0,0,705,0,705,G
4-HA,495,0,705,0,0,705,T
4-HA,496,693,0,0,0,693,A
4-HA,497,0,2,698,0,700,G
4-HA,498,680,0,2,0,682,A
4-HA,499,0,682,0,0,682,T
4-HA,500,0,677,0,0,677,T
4-HA,501,0,3,689,0,692,G
4-HA,502,686,0,1,0,687,A
4-HA,503,686,0,0,0,686,A
4-HA,504,0,691,0,0,691,T
4-HA,505,0,682,0,0,682,T
4-HA,506,0,1,685,0,686,G
4-HA,507,0,0,689,0,689,G
4-HA,508,1,689,0,1,691,T
4-HA,509,2,687,0,0,689,T
4-HA,510,0,3,677,0,680,G
4-HA,511,677,0,1,0,678,A
4-HA,512,1,0,0,679,680,C
4-HA,513,2,0,0,674,676,C
4-HA,514,1,0,0,674,675,C
4-HA,515,672,0,0,0,672,A
4-HA,516,0,0,0,678,678,C
4-HA,517,0,675,0,1,676,T
4-HA,518,0,674,0,0,674,T
4-HA,519,676,0,0,0,676,A
4-HA,520,678,0,0,0,678,A
4-HA,521,680,0,0,0,680,A
4-HA,522,684,0,2,0,686,A
4-HA,523,0,695,0,0,695,T
4-HA,524,0,696,0,0,696,T
4-HA,525,7,0,0,688,695,C
4-HA,526,687,0,1,0,688,A
4-HA,527,687,0,0,0,687,A
4-HA,528,694,0,0,0,694,A
4-HA,529,0,692,0,0,692,T
4-HA,530,706,0,0,0,706,A
4-HA,531,2,0,0,701,703,C
4-HA,532,2,0,0,694,696,C
4-HA,533,1,1,0,694,696,C
4-HA,534,696,0,0,0,696,A
4-HA,535,0,1,717,0,718,G
4-HA,536,0,1,0,720,721,C
4-HA,537,714,1,1,0,716,A
4-HA,538,0,711,0,2,713,T
4-HA,539,0,690,0,2,692,T
4-HA,540,1,4,706,0,711,G
4-HA,541,711,0,1,0,712,A
4-HA,542,715,0,0,0,715,A
4-HA,543,0,0,0,715,715,C
4-HA,544,0,1,698,0,699,G
4-HA,545,0,703,0,2,705,T
4-HA,546,0,3,704,0,707,G
4-HA,547,709,0,0,0,709,A
4-HA,548,0,0,0,709,709,C
4-HA,549,0,684,0,0,684,T
4-HA,550,693,0,0,0,693,A
4-HA,551,1,687,0,0,688,T
4-HA,552,1,0,693,0,694,G
4-HA,553,1,0,0,692,693,C
4-HA,554,4,0,0,686,690,C
4-HA,555,688,0,2,0,690,A
4-HA,556,689,0,0,0,689,A
4-HA,557,688,0,0,1,689,A
4-HA,558,0,0,0,695,695,C
4-HA,559,677,0,0,0,677,A
4-HA,560,677,1,1,0,679,A
4-HA,561,0,668,0,0,668,T
4-HA,562,1,8,658,0,667,G
4-HA,563,669,0,1,0,670,A
4-HA,564,667,0,0,2,669,A
4-HA,565,0,0,0,656,656,C
4-HA,566,660,0,0,0,660,A
4-HA,567,672,0,0,0,672,A
4-HA,568,0,669,0,0,669,T
4-HA,569,0,672,0,0,672,T
4-HA,570,1,668,0,3,672,T
4-HA,571,0,7,665,0,672,G
4-HA,572,669,1,1,0,671,A
4-HA,573,0,1,0,671,672,C
4-HA,574,669,0,0,0,669,A
4-HA,575,671,0,0,0,671,A
4-HA,576,678,0,0,0,678,A
4-HA,577,0,681,0,1,682,T
4-HA,578,0,677,0,0,677,T
4-HA,579,0,0,683,0,683,G
4-HA,580,0,678,0,1,679,T
4-HA,581,683,1,0,0,684,A
4-HA,582,0,0,0,698,698,C
4-HA,583,693,1,1,0,695,A
4-HA,584,0,708,0,0,708,T
4-HA,585,0,699,0,0,699,T
4-HA,586,0,697,1,0,698,T
4-HA,587,1,1,691,0,693,G
4-HA,588,1,4,687,0,692,G
4-HA,589,0,2,691,1,694,G
4-HA,590,1,2,688,1,692,G
4-HA,591,0,4,670,0,674,G
4-HA,592,0,0,690,0,690,G
4-HA,593,0,668,0,2,670,T
4-HA,594,0,665,0,0,665,T
4-HA,595,3,0,0,665,668,C
4-HA,596,671,0,1,0,672,A
4-HA,597,1,0,0,673,674,C
4-HA,598,2,0,0,672,674,C
4-HA,599,675,0,1,0,676,A
4-HA,600,1,0,0,679,680,C
4-HA,601,1,0,0,668,669,C
4-HA,602,1,0,0,668,669,C
4-HA,603,0,1,670,0,671,G
4-HA,604,1,1,697,0,699,G
4-HA,605,0,0,700,0,700,G
4-HA,606,0,697,0,2,699,T
4-HA,607,699,0,0,0,699,A
4-HA,608,1,1,0,693,695,C
4-HA,609,3,2,679,0,684,G
4-HA,610,0,0,690,0,690,G
4-HA,611,691,0,0,0,691,A
4-HA,612,1,0,0,687,688,C
4-HA,613,662,0,0,0,662,A
4-HA,614,662,0,1,0,663,A
4-HA,615,0,663,0,0,663,T
4-HA,616,0,10,662,0,672,G
4-HA,617,672,0,1,0,673,A
4-HA,618,2,0,0,672,674,C
4-HA,619,5,0,0,660,665,C
4-HA,620,670,0,0,0,670,A
4-HA,621,667,1,1,0,669,A
4-HA,622,680,0,0,0,680,A
4-HA,623,1,675,0,0,676,T
4-HA,624,6,0,0,676,682,C
4-HA,625,0,641,0,1,642,T
4-HA,626,0,644,0,0,644,T
4-HA,627,2,0,0,648,650,C
4-HA,628,1,0,0,648,649,C
4-HA,629,0,654,0,0,654,T
4-HA,630,0,1,657,0,658,G
4-HA,631,0,648,0,0,648,T
4-HA,632,655,0,0,0,655,A
4-HA,633,0,653,0,2,655,T
4-HA,634,0,0,662,0,662,G
4-HA,635,3,0,0,656,659,C
4-HA,636,0,654,0,2,656,T
4-HA,637,3,0,0,652,655,C
4-HA,638,654,0,0,0,654,A
4-HA,639,652,0,1,0,653,A
4-HA,640,0,0,656,0,656,G
4-HA,641,0,0,1,660,661,C
4-HA,642,661,0,1,0,662,A
4-HA,643,0,652,0,0,652,T
4-HA,644,1,0,0,653,654,C
4-HA,645,653,0,2,0,655,A
4-HA,646,0,1,660,0,661,G
4-HA,647,1,2,658,0,661,G
4-HA,648,658,0,1,0,659,A
4-HA,649,653,0,1,0,654,A
4-HA,650,1,1,683,0,685,G
4-HA,651,683,0,1,0,684,A
4-HA,652,685,0,1,0,686,A
4-HA,653,0,689,0,1,690,T
4-HA,654,4,0,0,686,690,C
4-HA,655,683,1,0,0,684,A
4-HA,656,0,0,0,682,682,C
4-HA,657,676,0,0,0,676,A
4-HA,658,1,1,693,0,695,G
4-HA,659,0,676,0,1,677,T
4-HA,660,4,0,1,671,676,C
4-HA,661,0,675,0,1,676,T
4-HA,662,3,0,0,691,694,C
4-HA,663,0,696,0,1,697,T
4-HA,664,705,1,0,0,706,A
4-HA,665,1,1,0,703,705,C
4-HA,666,0,1,0,703,704,C
4-HA,667,688,0,0,0,688,A
4-HA,668,689,0,1,0,690,A
4-HA,669,687,0,0,1,688,A
4-HA,670,685,0,1,0,686,A
4-HA,671,0,2,697,0,699,G
4-HA,672,681,0,0,0,681,A
4-HA,673,679,0,1,0,680,A
4-HA,674,2,0,683,0,685,G
4-HA,675,0,0,0,685,685,C
4-HA,676,0,0,0,684,684,C
4-HA,677,682,1,0,0,683,A
4-HA,678,678,6,3,0,687,A
4-HA,679,0,1,0,687,688,C
4-HA,680,687,0,0,0,687,A
4-HA,681,679,0,0,5,684,A
4-HA,682,686,0,2,0,688,A
4-HA,683,0,0,0,709,709,C
4-HA,684,0,702,0,0,702,T
4-HA,685,0,0,710,0,710,G
4-HA,686,0,709,0,0,709,T
4-HA,687,704,1,1,0,706,A
4-HA,688,711,0,0,0,711,A
4-HA,689,0,706,0,1,707,T
4-HA,690,3,0,0,705,708,C
4-HA,691,1,0,0,704,705,C
4-HA,692,2,0,0,692,694,C
4-HA,693,5,4,688,0,697,G
4-HA,694,696,0,0,0,696,A
4-HA,695,698,0,0,0,698,A
4-HA,696,0,699,0,0,699,T
4-HA,697,693,0,0,0,693,A
4-HA,698,0,693,0,1,694,T
4-HA,699,3,0,0,684,687,C
4-HA,700,0,1,689,0,690,G
4-HA,701,1,2,696,0,699,G
4-HA,702,699,1,2,0,702,A
4-HA,703,0,707,0,3,710,T
4-HA,704,0,0,0,708,708,C
4-HA,705,0,707,0,0,707,T
4-HA,706,708,0,0,0,708,A
4-HA,707,0,4,707,0,711,G
4-HA,708,712,0,3,0,715,A
4-HA,709,0,0,0,718,718,C
4-HA,710,0,0,0,697,697,C
4-HA,711,3,1,1,698,703,C
4-HA,712,692,0,1,0,693,A
4-HA,713,0,3,713,0,716,G
4-HA,714,714,0,2,0,716,A
4-HA,715,0,0,723,1,724,G
4-HA,716,0,722,0,0,722,T
4-HA,717,715,0,0,0,715,A
4-HA,718,716,0,0,0,716,A
4-HA,719,0,1,735,0,736,G
4-HA,720,0,2,740,0,742,G
4-HA,721,726,0,1,0,727,A
4-HA,722,681,0,1,0,682,A
4-HA,723,0,683,0,1,684,T
4-HA,724,689,0,0,1,690,A
4-HA,725,0,687,1,2,690,T
4-HA,726,3,0,0,696,699,C
4-HA,727,2,0,0,697,699,C
4-HA,728,2,1,0,679,682,C
4-HA,729,0,676,0,1,677,T
4-HA,730,677,1,1,0,679,A
4-HA,731,0,0,678,0,678,G
4-HA,732,1,0,0,678,679,C
4-HA,733,659,0,1,0,660,A
4-HA,734,0,3,672,0,675,G
4-HA,735,662,0,0,0,662,A
4-HA,736,664,0,0,0,664,A
4-HA,737,0,665,0,0,665,T
4-HA,738,666,0,0,0,666,A
4-HA,739,670,0,0,0,670,A
4-HA,740,0,1,673,0,674,G
4-HA,741,1,1,0,673,675,C
4-HA,742,674,0,0,0,674,A
4-HA,743,0,655,2,1,658,T
4-HA,744,1,0,0,686,687,C
4-HA,745,1,685,0,0,686,T
4-HA,746,699,2,0,0,701,A
4-HA,747,0,703,0,0,703,T
4-HA,748,0,702,0,0,702,T
4-HA,749,1,3,702,0,706,G
4-HA,750,0,4,698,0,702,G
4-HA,751,700,0,1,0,701,A
4-HA,752,0,0,0,699,699,C
4-HA,753,665,0,0,0,665,A
4-HA,754,672,0,2,0,674,A
4-HA,755,0,690,0,0,690,T
4-HA,756,688,0,0,0,688,A
4-HA,757,0,1,690,0,691,G
4-HA,758,0,686,0,0,686,T
4-HA,759,686,0,0,0,686,A
4-HA,760,688,0,0,0,688,A
4-HA,761,688,0,0,1,689,A
4-HA,762,693,0,1,0,694,A
4-HA,763,0,0,0,695,695,C
4-HA,764,1,0,0,671,672,C
4-HA,765,1,1,665,0,667,G
4-HA,766,1,3,665,0,669,G
4-HA,767,0,1,667,0,668,G
4-HA,768,672,1,0,0,673,A
4-HA,769,0,5,672,0,677,G
4-HA,770,679,0,3,0,682,A
4-HA,771,0,1,0,683,684,C
4-HA,772,683,0,0,2,685,A
4-HA,773,0,685,0,1,686,T
4-HA,774,683,0,1,1,685,A
4-HA,775,1,0,1,692,694,C
4-HA,776,0,688,0,2,690,T
4-HA,777,0,693,0,1,694,T
4-HA,778,1,693,0,1,695,T
4-HA,779,0,688,0,0,688,T
4-HA,780,0,2,687,0,689,G
4-HA,781,686,0,3,1,690,A
4-HA,782,0,689,1,1,691,T
4-HA,783,0,696,0,1,697,T
4-HA,784,691,0,1,0,692,A
4-HA,785,694,0,0,0,694,A
4-HA,786,2,2,0,695,699,C
4-HA,787,690,0,2,0,692,A
4-HA,788,0,0,720,0,720,G
4-HA,789,0,0,0,713,713,C
4-HA,790,708,1,0,0,709,A
4-HA,791,0,0,0,713,713,C
4-HA,792,704,0,3,0,707,A
4-HA,793,1,0,713,0,714,G
4-HA,794,1,2,709,0,712,G
4-HA,795,0,6,724,0,730,G
4-HA,796,722,0,0,0,722,A
4-HA,797,710,0,0,0,710,A
4-HA,798,0,712,0,2,714,T
4-HA,799,2,1,0,716,719,C
4-HA,800,1,714,0,1,716,T
4-HA,801,716,0,2,0,718,A
4-HA,802,712,0,0,0,712,A
4-HA,803,0,705,0,2,707,T
4-HA,804,0,684,0,0,684,T
4-HA,805,0,0,685,0,685,G
4-HA,806,2,0,0,713,715,C
4-HA,807,0,723,1,1,725,T
4-HA,808,7,0,0,733,740,C
4-HA,809,0,1,0,739,740,C
4-HA,810,0,739,0,0,739,T
4-HA,811,738,0,0,0,738,A
4-HA,812,0,2,736,0,738,G
4-HA,813,0,2,738,0,740,G
4-HA,814,0,0,739,0,739,G
4-HA,815,0,1,732,0,733,G
4-HA,816,0,722,0,0,722,T
4-HA,817,0,717,0,0,717,T
4-HA,818,718,0,0,0,718,A
4-HA,819,1,0,0,730,731,C
4-HA,820,0,719,0,2,721,T
4-HA,821,1,725,0,1,727,T
4-HA,822,2,0,0,722,724,C
4-HA,823,722,0,0,0,722,A
4-HA,824,724,0,2,0,726,A
4-HA,825,726,0,0,0,726,A
4-HA,826,728,0,0,1,729,A
4-HA,827,0,731,0,0,731,T
4-HA,828,723,0,0,0,723,A
4-HA,829,0,0,0,722,722,C
4-HA,830,2,3,715,0,720,G
4-HA,831,722,0,1,0,723,A
4-HA,832,722,0,1,0,723,A
4-HA,833,0,0,730,0,730,G
4-HA,834,0,726,0,1,727,T
4-HA,835,1,3,729,0,733,G
4-HA,836,1,4,728,0,733,G
4-HA,837,1,4,731,0,736,G
4-HA,838,730,0,1,0,731,A
4-HA,839,733,0,0,0,733,A
4-HA,840,736,0,1,0,737,A
4-HA,841,730,0,2,1,733,A
4-HA,842,0,1,742,0,743,G
4-HA,843,2,1,0,735,738,C
4-HA,844,0,735,0,1,736,T
4-HA,845,3,0,0,735,738,C
4-HA,846,738,0,1,0,739,A
4-HA,847,741,0,0,0,741,A
4-HA,848,0,741,0,0,741,T
4-HA,849,754,0,0,0,754,A
4-HA,850,755,0,0,0,755,A
4-HA,851,0,740,0,1,741,T
4-HA,852,1,3,737,0,741,G
4-HA,853,735,0,0,0,735,A
4-HA,854,0,4,746,0,750,G
4-HA,855,751,0,0,0,751,A
4-HA,856,0,747,0,1,748,T
4-HA,857,2,0,0,752,754,C
4-HA,858,750,1,1,0,752,A
4-HA,859,0,1,766,0,767,G
4-HA,860,767,0,0,1,768,A
4-HA,861,0,765,0,0,765,T
4-HA,862,0,1,765,0,766,G
4-HA,863,0,1,0,749,750,C
4-HA,864,749,1,2,0,752,A
4-HA,865,0,0,0,763,763,C
4-HA,866,0,0,0,763,763,C
4-HA,867,1,0,0,761,762,C
4-HA,868,751,0,0,0,751,A
4-HA,869,1,741,1,0,743,T
4-HA,870,0,742,0,0,742,T
4-HA,871,2,2,746,0,750,G
4-HA,872,0,2,744,0,746,G
4-HA,873,0,0,0,745,745,C
4-HA,874,733,0,1,0,734,A
4-HA,875,729,0,1,0,730,A
4-HA,876,738,0,0,0,738,A
4-HA,877,0,739,0,0,739,T
4-HA,878,0,3,737,0,740,G
4-HA,879,0,0,0,738,738,C
4-HA,880,726,0,1,0,727,A
4-HA,881,735,0,0,0,735,A
4-HA,882,0,735,0,1,736,T
4-HA,883,0,735,0,2,737,T
4-HA,884,5,0,0,733,738,C
4-HA,885,0,728,0,0,728,T
4-HA,886,0,1,729,0,730,G
4-HA,887,730,0,0,0,730,A
4-HA,888,734,0,0,0,734,A
4-HA,889,0,737,0,0,737,T
4-HA,890,2,0,720,0,722,G
4-HA,891,0,1,0,722,723,C
4-HA,892,719,0,0,0,719,A
4-HA,893,0,718,0,1,719,T
4-HA,894,5,1,0,711,717,C
4-HA,895,707,1,2,0,710,A
4-HA,896,1,0,0,723,724,C
4-HA,897,0,722,0,1,723,T
4-HA,898,3,1,0,724,728,C
4-HA,899,2,1,0,718,721,C
4-HA,900,728,0,1,0,729,A
4-HA,901,725,1,1,0,727,A
4-HA,902,727,0,0,0,727,A
4-HA,903,0,695,0,1,696,T
4-HA,904,0,1,697,0,698,G
4-HA,905,0,3,697,0,700,G
4-HA,906,702,0,0,0,702,A
4-HA,907,697,0,1,0,698,A
4-HA,908,0,1,700,0,701,G
4-HA,909,0,0,0,691,691,C
4-HA,910,680,0,0,0,680,A
4-HA,911,0,684,0,1,685,T
4-HA,912,0,691,0,0,691,T
4-HA,913,0,0,0,706,706,C
4-HA,914,2,0,0,698,700,C
4-HA,915,1,1,1,699,702,C
4-HA,916,699,0,1,0,700,A
4-HA,917,707,0,0,4,711,A
4-HA,918,0,716,0,3,719,T
4-HA,919,0,8,713,0,721,G
4-HA,920,717,0,2,0,719,A
4-HA,921,1,0,0,719,720,C
4-HA,922,697,0,3,0,700,A
4-HA,923,700,0,0,0,700,A
4-HA,924,703,0,0,0,703,A
4-HA,925,0,0,0,703,703,C
4-HA,926,4,0,0,691,695,C
4-HA,927,670,0,1,0,671,A
4-HA,928,0,674,1,0,675,T
4-HA,929,1,676,0,0,677,T
4-HA,930,4,2,0,676,682,C
4-HA,931,1,0,0,682,683,C
4-HA,932,682,0,0,0,682,A
4-HA,933,680,0,0,0,680,A
4-HA,934,681,0,0,0,681,A
4-HA,935,687,0,0,1,688,A
4-HA,936,1,686,0,0,687,T
4-HA,937,0,1,686,0,687,G
4-HA,938,0,679,0,1,680,T
4-HA,939,0,678,0,0,678,T
4-HA,940,692,0,0,0,692,A
4-HA,941,686,0,0,1,687,A
4-HA,942,1,0,0,688,689,C
4-HA,943,682,0,1,0,683,A
4-HA,944,0,3,682,0,685,G
4-HA,945,0,0,683,0,683,G
4-HA,946,686,0,1,0,687,A
4-HA,947,0,691,0,1,692,T
4-HA,948,2,1,0,692,695,C
4-HA,949,694,0,1,0,695,A
4-HA,950,2,1,0,706,709,C
4-HA,951,705,0,1,0,706,A
4-HA,952,0,722,0,0,722,T
4-HA,953,708,0,1,0,709,A
4-HA,954,0,0,0,703,703,C
4-HA,955,2,2,676,0,680,G
4-HA,956,0,1,674,0,675,G
4-HA,957,0,4,663,0,667,G
4-HA,958,0,2,658,2,662,G
4-HA,959,2,0,0,642,644,C
4-HA,960,1,0,0,646,647,C
4-HA,961,0,619,0,0,619,T
4-HA,962,0,0,648,0,648,G
4-HA,963,0,646,0,0,646,T
4-HA,964,2,0,0,648,650,C
4-HA,965,2,2,0,644,648,C
4-HA,966,3,1,0,643,647,C
4-HA,967,638,0,2,0,640,A
4-HA,968,0,0,645,0,645,G
4-HA,969,640,0,1,0,641,A
4-HA,970,0,643,0,0,643,T
4-HA,971,568,0,0,0,568,A
4-HA,972,1,562,0,0,563,T
4-HA,973,1,0,564,0,565,G
4-HA,974,0,567,0,0,567,T
4-HA,975,0,551,0,0,551,T
4-HA,976,554,0,0,0,554,A
4-HA,977,539,0,0,0,539,A
4-HA,978,0,4,539,0,543,G
4-HA,979,0,0,0,544,544,C
4-HA,980,533,0,0,0,533,A
4-HA,981,531,0,1,0,532,A
4-HA,982,530,0,0,0,530,A
4-HA,983,531,0,0,0,531,A
4-HA,984,0,1,1,531,533,C
4-HA,985,528,0,0,0,528,A
4-HA,986,0,0,0,532,532,C
4-HA,987,1,513,0,0,514,T
4-HA,988,1,0,0,519,520,C
4-HA,989,0,514,1,0,515,T
4-HA,990,0,2,516,0,518,G
4-HA,991,520,0,0,0,520,A
4-HA,992,519,0,0,0,519,A
4-HA,993,520,0,1,0,521,A
4-HA,994,0,515,0,0,515,T
4-HA,995,0,511,0,0,511,T
4-HA,996,0,1,514,0,515,G
4-HA,997,2,3,508,0,513,G
4-HA,998,0,1,0,514,515,C
4-HA,999,511,0,0,0,511,A
4-HA,1000,508,0,0,0,508,A
4-HA,1001,0,0,0,511,511,C
4-HA,1002,503,0,2,0,505,A
4-HA,1003,0,1,508,0,509,G
4-HA,1004,0,2,504,0,506,G
4-HA,1005,0,2,505,0,507,G
4-HA,1006,501,0,2,0,503,A
4-HA,1007,0,502,0,0,502,T
4-HA,1008,0,1,502,0,503,G
4-HA,1009,1,1,0,499,501,C
4-HA,1010,1,0,503,0,504,G
4-HA,1011,510,1,0,0,511,A
4-HA,1012,503,0,0,0,503,A
4-HA,1013,505,0,1,0,506,A
4-HA,1014,0,496,1,0,497,T
4-HA,1015,1,1,500,0,502,G
4-HA,1016,0,500,0,0,500,T
4-HA,1017,498,1,1,0,500,A
4-HA,1018,2,1,0,496,499,C
4-HA,1019,2,0,0,487,489,C
4-HA,1020,484,0,0,0,484,A
4-HA,1021,0,2,485,0,487,G
4-HA,1022,477,0,0,0,477,A
4-HA,1023,0,2,483,0,485,G
4-HA,1024,477,0,0,0,477,A
4-HA,1025,476,0,0,0,476,A
4-HA,1026,474,0,1,0,475,A
4-HA,1027,1,0,1,472,474,C
4-HA,1028,471,0,0,0,471,A
4-HA,1029,475,0,0,0,475,A
4-HA,1030,471,0,1,0,472,A
4-HA,1031,0,0,0,475,475,C
4-HA,1032,0,471,0,0,471,T
4-HA,1033,465,0,0,0,465,A
4-HA,1034,0,1,464,0,465,G
4-HA,1035,463,0,0,0,463,A
4-HA,1036,0,0,466,0,466,G
4-HA,1037,1,0,465,0,466,G
4-HA,1038,1,1,0,453,455,C
4-HA,1039,460,0,0,0,460,A
4-HA,1040,0,456,0,0,456,T
4-HA,1041,456,0,1,0,457,A
4-HA,1042,0,454,0,0,454,T
4-HA,1043,1,449,0,0,450,T
4-HA,1044,0,449,0,0,449,T
4-HA,1045,0,0,422,0,422,G
4-HA,1046,0,1,417,0,418,G
4-HA,1047,1,1,0,416,418,C
4-HA,1048,1,0,415,0,416,G
4-HA,1049,0,0,0,413,413,C
4-HA,1050,407,1,0,0,408,A
4-HA,1051,411,0,0,0,411,A
4-HA,1052,0,409,0,0,409,T
4-HA,1053,0,0,0,412,412,C
4-HA,1054,0,0,408,0,408,G
4-HA,1055,0,0,0,406,406,C
4-HA,1056,8,2,397,0,407,G
4-HA,1057,0,0,407,0,407,G
4-HA,1058,0,0,411,0,411,G
4-HA,1059,0,402,0,2,404,T
4-HA,1060,0,397,0,0,397,T
4-HA,1061,0,394,0,0,394,T
4-HA,1062,2,0,0,391,393,C
4-HA,1063,392,0,1,0,393,A
4-HA,1064,0,391,0,1,392,T
4-HA,1065,392,0,0,0,392,A
4-HA,1066,0,2,395,0,397,G
4-HA,1067,378,0,0,0,378,A
4-HA,1068,379,0,0,0,379,A
4-HA,1069,381,0,0,0,381,A
4-HA,1070,381,0,0,1,382,A
4-HA,1071,0,385,0,0,385,T
4-HA,1072,0,2,382,0,384,G
4-HA,1073,0,0,386,0,386,G
4-HA,1074,0,377,0,0,377,T
4-HA,1075,0,363,0,0,363,T
4-HA,1076,1,0,363,0,364,G
4-HA,1077,0,0,353,1,354,G
4-HA,1078,0,1,351,0,352,G
4-HA,1079,348,0,0,0,348,A
4-HA,1080,0,0,351,0,351,G
4-HA,1081,0,1,341,0,342,G
4-HA,1082,0,0,344,0,344,G
4-HA,1083,344,0,0,0,344,A
4-HA,1084,346,0,0,0,346,A
4-HA,1085,0,343,0,0,343,T
4-HA,1086,0,1,344,0,345,G
4-HA,1087,0,0,352,0,352,G
4-HA,1088,0,346,0,0,346,T
4-HA,1089,0,0,345,0,345,G
4-HA,1090,0,0,345,0,345,G
4-HA,1091,335,0,0,0,335,A
4-HA,1092,1,336,0,0,337,T
4-HA,1093,1,1,338,0,340,G
4-HA,1094,0,0,341,0,341,G
4-HA,1095,0,330,0,0,330,T
4-HA,1096,0,320,0,0,320,T
4-HA,1097,0,0,317,0,317,G
4-HA,1098,0,0,328,0,328,G
4-HA,1099,0,328,0,0,328,T
4-HA,1100,326,0,0,0,326,A
4-HA,1101,0,1,0,307,308,C
4-HA,1102,1,1,312,0,314,G
4-HA,1103,0,0,318,0,318,G
4-HA,1104,0,319,0,0,319,T
4-HA,1105,0,317,0,0,317,T
4-HA,1106,0,313,0,1,314,T
4-HA,1107,1,0,0,313,314,C
4-HA,1108,311,0,0,0,311,A
4-HA,1109,0,2,310,0,312,G
4-HA,1110,0,1,310,0,311,G
4-HA,1111,1,0,0,308,309,C
4-HA,1112,297,0,0,0,297,A
4-HA,1113,0,299,0,1,300,T
4-HA,1114,0,0,0,297,297,C
4-HA,1115,298,0,0,0,298,A
4-HA,1116,298,0,0,0,298,A
4-HA,1117,298,0,0,0,298,A
4-HA,1118,297,0,0,0,297,A
4-HA,1119,0,297,0,0,297,T
4-HA,1120,0,296,0,0,296,T
4-HA,1121,2,0,0,294,296,C
4-HA,1122,0,289,0,0,289,T
4-HA,1123,0,1,288,0,289,G
4-HA,1124,290,0,0,0,290,A
4-HA,1125,287,0,0,0,287,A
4-HA,1126,0,0,290,0,290,G
4-HA,1127,0,2,290,0,292,G
4-HA,1128,291,0,1,0,292,A
4-HA,1129,291,0,1,0,292,A
4-HA,1130,0,1,288,0,289,G
4-HA,1131,291,0,1,0,292,A
4-HA,1132,0,2,293,0,295,G
4-HA,1133,0,2,296,0,298,G
4-HA,1134,297,0,2,0,299,A
4-HA,1135,1,0,0,297,298,C
4-HA,1136,290,0,2,0,292,A
4-HA,1137,289,0,0,0,289,A
4-HA,1138,0,0,291,0,291,G
4-HA,1139,0,0,0,291,291,C
4-HA,1140,285,0,1,0,286,A
4-HA,1141,0,0,284,0,284,G
4-HA,1142,0,0,0,284,284,C
4-HA,1143,283,0,0,0,283,A
4-HA,1144,0,1,288,0,289,G
4-HA,1145,288,0,1,0,289,A
4-HA,1146,0,295,0,0,295,T
4-HA,1147,1,0,0,294,295,C
4-HA,1148,0,292,0,1,293,T
4-HA,1149,0,0,0,296,296,C
4-HA,1150,293,1,0,0,294,A
4-HA,1151,292,0,1,0,293,A
4-HA,1152,293,0,0,0,293,A
4-HA,1153,284,0,5,0,289,A
4-HA,1154,0,1,290,0,291,G
4-HA,1155,0,0,0,284,284,C
4-HA,1156,281,0,0,0,281,A
4-HA,1157,0,0,1,285,286,C
4-HA,1158,0,282,0,0,282,T
4-HA,1159,1,1,0,281,283,C
4-HA,1160,283,0,0,0,283,A
4-HA,1161,285,0,1,0,286,A
4-HA,1162,0,1,286,0,287,G
4-HA,1163,0,0,0,286,286,C
4-HA,1164,284,0,0,0,284,A
4-HA,1165,0,0,286,0,286,G
4-HA,1166,0,0,0,284,284,C
4-HA,1167,281,0,0,0,281,A
4-HA,1168,282,0,0,0,282,A
4-HA,1169,0,282,0,0,282,T
4-HA,1170,3,0,0,272,275,C
4-HA,1171,0,0,272,0,272,G
4-HA,1172,278,0,0,0,278,A
4-HA,1173,0,277,0,0,277,T
4-HA,1174,2,0,0,272,274,C
4-HA,1175,272,0,0,0,272,A
4-HA,1176,280,0,0,0,280,A
4-HA,1177,280,0,1,0,281,A
4-HA,1178,0,279,0,0,279,T
4-HA,1179,2,0,0,279,281,C
4-HA,1180,274,1,0,0,275,A
4-HA,1181,279,0,0,0,279,A
4-HA,1182,0,279,0,0,279,T
4-HA,1183,0,2,275,0,277,G
4-HA,1184,0,0,279,0,279,G
4-HA,1185,1,0,272,0,273,G
4-HA,1186,273,0,1,0,274,A
4-HA,1187,272,0,0,0,272,A
4-HA,1188,0,0,276,0,276,G
4-HA,1189,2,0,0,275,277,C
4-HA,1190,0,270,0,0,270,T
4-HA,1191,0,2,273,0,275,G
4-HA,1192,274,0,1,0,275,A
4-HA,1193,274,0,2,0,276,A
4-HA,1194,0,277,0,1,278,T
4-HA,1195,272,0,0,0,272,A
4-HA,1196,0,1,272,0,273,G
4-HA,1197,248,0,0,0,248,A
4-HA,1198,0,246,0,0,246,T
4-HA,1199,0,250,0,0,250,T
4-HA,1200,0,2,247,0,249,G
4-HA,1201,251,0,0,0,251,A
4-HA,1202,0,251,0,0,251,T
4-HA,1203,2,0,0,248,250,C
4-HA,1204,0,2,247,0,249,G
4-HA,1205,0,2,249,0,251,G
4-HA,1206,0,1,249,0,250,G
4-HA,1207,249,0,0,0,249,A
4-HA,1208,249,0,0,0,249,A
4-HA,1209,247,0,0,0,247,A
4-HA,1210,248,0,1,0,249,A
4-HA,1211,0,0,0,251,251,C
4-HA,1212,0,0,0,251,251,C
4-HA,1213,250,0,0,0,250,A
4-HA,1214,250,0,0,0,250,A
4-HA,1215,0,0,0,250,250,C
4-HA,1216,1,2,247,0,250,G
4-HA,1217,251,1,0,0,252,A
4-HA,1218,0,1,251,0,252,G
4-HA,1219,254,0,0,0,254,A
4-HA,1220,253,0,0,0,253,A
4-HA,1221,251,0,0,0,251,A
4-HA,1222,0,247,1,0,248,T
4-HA,1223,0,249,0,0,249,T
4-HA,1224,3,0,0,247,250,C
4-HA,1225,0,0,0,248,248,C
4-HA,1226,248,0,0,0,248,A
4-HA,1227,0,248,0,0,248,T
4-HA,1228,2,0,0,245,247,C
4-HA,1229,245,0,0,0,245,A
4-HA,1230,0,0,243,0,243,G
4-HA,1231,241,0,0,0,241,A
4-HA,1232,0,243,0,0,243,T
4-HA,1233,0,239,0,0,239,T
4-HA,1234,0,1,244,0,245,G
4-HA,1235,244,0,0,0,244,A
4-HA,1236,245,0,0,0,245,A
4-HA,1237,247,0,0,0,247,A
4-HA,1238,243,0,0,0,243,A
4-HA,1239,240,0,2,0,242,A
4-HA,1240,1,2,242,0,245,G
4-HA,1241,242,0,0,0,242,A
4-HA,1242,244,0,0,0,244,A
4-HA,1243,0,239,0,0,239,T
4-HA,1244,1,238,0,0,239,T
4-HA,1245,2,0,0,238,240,C
4-HA,1246,0,236,0,0,236,T
4-HA,1247,0,0,0,236,236,C
4-HA,1248,235,0,0,0,235,A
4-HA,1249,0,0,236,0,236,G
4-HA,1250,232,0,1,0,233,A
4-HA,1251,229,0,1,0,230,A
4-HA,1252,0,0,232,0,232,G
4-HA,1253,0,229,0,2,231,T
4-HA,1254,2,0,0,227,229,C
4-HA,1255,0,1,228,0,229,G
4-HA,1256,230,0,0,0,230,A
4-HA,1257,229,0,0,0,229,A
4-HA,1258,0,0,230,0,230,G
4-HA,1259,0,0,231,0,231,G
4-HA,1260,0,1,227,0,228,G
4-HA,1261,219,0,2,0,221,A
4-HA,1262,0,0,225,0,225,G
4-HA,1263,223,0,1,0,224,A
4-HA,1264,238,0,0,0,238,A
4-HA,1265,0,240,0,0,240,T
4-HA,1266,1,238,0,0,239,T
4-HA,1267,2,0,0,237,239,C
4-HA,1268,235,0,1,0,236,A
4-HA,1269,0,1,237,0,238,G
4-HA,1270,0,2,236,0,238,G
4-HA,1271,237,0,1,0,238,A
4-HA,1272,0,0,0,239,239,C
4-HA,1273,1,0,0,217,218,C
4-HA,1274,0,213,0,1,214,T
4-HA,1275,0,213,0,5,218,T
4-HA,1276,0,0,221,0,221,G
4-HA,1277,221,0,0,0,221,A
4-HA,1278,0,2,230,0,232,G
4-HA,1279,228,0,0,0,228,A
4-HA,1280,207,0,0,0,207,A
4-HA,1281,207,0,0,0,207,A
4-HA,1282,0,203,0,0,203,T
4-HA,1283,207,0,0,0,207,A
4-HA,1284,0,204,0,0,204,T
4-HA,1285,0,0,206,0,206,G
4-HA,1286,0,206,0,0,206,T
4-HA,1287,0,202,0,0,202,T
4-HA,1288,0,0,201,0,201,G
4-HA,1289,202,0,0,0,202,A
4-HA,1290,0,0,201,0,201,G
4-HA,1291,1,1,196,0,198,G
4-HA,1292,192,0,1,0,193,A
4-HA,1293,1,0,0,200,201,C
4-HA,1294,196,0,2,0,198,A
4-HA,1295,0,0,0,202,202,C
4-HA,1296,0,0,0,200,200,C
4-HA,1297,202,0,0,0,202,A
4-HA,1298,205,0,1,0,206,A
4-HA,1299,207,0,0,0,207,A
4-HA,1300,210,0,0,0,210,A
4-HA,1301,0,209,0,0,209,T
4-HA,1302,200,0,0,0,200,A
4-HA,1303,0,0,203,0,203,G
4-HA,1304,196,0,0,0,196,A
4-HA,1305,0,201,0,1,202,T
4-HA,1306,0,0,0,201,201,C
4-HA,1307,0,199,0,0,199,T
4-HA,1308,1,0,0,203,204,C
4-HA,1309,0,205,0,0,205,T
4-HA,1310,1,1,207,0,209,G
4-HA,1311,0,0,217,0,217,G
4-HA,1312,0,212,0,0,212,T
4-HA,1313,0,0,0,213,213,C
4-HA,1314,212,0,1,0,213,A
4-HA,1315,0,214,0,0,214,T
4-HA,1316,213,0,0,0,213,A
4-HA,1317,0,0,0,213,213,C
4-HA,1318,213,0,0,0,213,A
4-HA,1319,212,0,0,0,212,A
4-HA,1320,0,0,0,203,203,C
4-HA,1321,0,0,203,0,203,G
4-HA,1322,2,0,0,199,201,C
4-HA,1323,0,1,201,0,202,G
4-HA,1324,0,0,203,0,203,G
4-HA,1325,202,0,0,0,202,A
4-HA,1326,0,0,206,0,206,G
4-HA,1327,0,0,0,207,207,C
4-HA,1328,0,203,0,0,203,T
4-HA,1329,0,207,0,0,207,T
4-HA,1330,0,0,0,208,208,C
4-HA,1331,1,209,0,0,210,T
4-HA,1332,0,209,0,1,210,T
4-HA,1333,0,0,211,0,211,G
4-HA,1334,1,208,0,1,210,T
4-HA,1335,0,208,0,0,208,T
4-HA,1336,0,0,212,0,212,G
4-HA,1337,1,0,0,211,212,C
4-HA,1338,0,0,0,209,209,C
4-HA,1339,0,0,0,211,211,C
4-HA,1340,1,210,0,0,211,T
4-HA,1341,0,0,212,0,212,G
4-HA,1342,0,1,211,0,212,G
4-HA,1343,211,0,0,0,211,A
4-HA,1344,0,2,212,0,214,G
4-HA,1345,210,0,0,0,210,A
4-HA,1346,216,0,1,0,217,A
4-HA,1347,1,0,0,221,222,C
4-HA,1348,3,0,0,219,222,C
4-HA,1349,221,0,0,0,221,A
4-HA,1350,227,0,0,0,227,A
4-HA,1351,0,1,0,225,226,C
4-HA,1352,226,0,0,0,226,A
4-HA,1353,0,225,0,1,226,T
4-HA,1354,226,0,0,0,226,A
4-HA,1355,0,0,0,234,234,C
4-HA,1356,229,0,0,0,229,A
4-HA,1357,231,0,0,0,231,A
4-HA,1358,0,231,0,0,231,T
4-HA,1359,0,225,0,0,225,T
4-HA,1360,0,6,222,0,228,G
4-HA,1361,226,0,0,0,226,A
4-HA,1362,0,226,0,0,226,T
4-HA,1363,0,0,0,226,226,C
4-HA,1364,0,223,0,0,223,T
4-HA,1365,223,0,0,0,223,A
4-HA,1366,224,0,0,0,224,A
4-HA,1367,0,0,0,225,225,C
4-HA,1368,0,223,0,0,223,T
4-HA,1369,0,2,219,1,222,G
4-HA,1370,219,1,2,0,222,A
4-HA,1371,0,0,0,221,221,C
4-HA,1372,0,219,0,0,219,T
4-HA,1373,1,2,0,217,220,C
4-HA,1374,219,0,0,0,219,A
4-HA,1375,0,0,224,0,224,G
4-HA,1376,223,0,0,0,223,A
4-HA,1377,222,0,0,0,222,A
4-HA,1378,222,0,0,0,222,A
4-HA,1379,0,222,0,0,222,T
4-HA,1380,1,1,220,0,222,G
4-HA,1381,219,0,1,0,220,A
4-HA,1382,221,0,0,0,221,A
4-HA,1383,0,0,0,221,221,C
4-HA,1384,218,0,1,0,219,A
4-HA,1385,218,0,1,0,219,A
4-HA,1386,219,0,0,0,219,A
4-HA,1387,0,0,0,222,222,C
4-HA,1388,0,221,0,0,221,T
4-HA,1389,1,0,222,0,223,G
4-HA,1390,0,217,0,0,217,T
4-HA,1391,0,222,0,0,222,T
4-HA,1392,0,221,0,0,221,T
4-HA,1393,1,1,221,0,223,G
4-HA,1394,223,0,0,0,223,A
4-HA,1395,222,0,0,0,222,A
4-HA,1396,222,0,0,0,222,A
4-HA,1397,222,0,0,0,222,A
4-HA,1398,220,0,0,0,220,A
4-HA,1399,221,0,1,0,222,A
4-HA,1400,0,0,0,221,221,C
4-HA,1401,222,0,0,0,222,A
4-HA,1402,220,0,0,0,220,A
4-HA,1403,221,0,0,0,221,A
4-HA,1404,0,1,216,0,217,G
4-HA,1405,219,0,0,0,219,A
4-HA,1406,219,0,0,0,219,A
4-HA,1407,0,0,220,0,220,G
4-HA,1408,0,0,0,219,219,C
4-HA,1409,217,0,0,0,217,A
4-HA,1410,0,0,216,0,216,G
4-HA,1411,0,0,0,218,218,C
4-HA,1412,0,218,0,0,218,T
4-HA,1413,1,2,219,0,222,G
4-HA,1414,220,0,0,0,220,A
4-HA,1415,0,1,219,0,220,G
4-HA,1416,0,0,219,0,219,G
4-HA,1417,0,1,218,0,219,G
4-HA,1418,220,0,0,0,220,A
4-HA,1419,218,0,0,0,218,A
4-HA,1420,215,0,0,0,215,A
4-HA,1421,218,0,0,0,218,A
4-HA,1422,0,218,0,0,218,T
4-HA,1423,0,0,219,0,219,G
4-HA,1424,0,0,0,217,217,C
4-HA,1425,0,217,0,0,217,T
4-HA,1426,0,1,215,0,216,G
4-HA,1427,215,0,1,0,216,A
4-HA,1428,0,0,222,0,222,G
4-HA,1429,0,0,223,0,223,G
4-HA,1430,224,0,0,0,224,A
4-HA,1431,0,223,0,0,223,T
4-HA,1432,221,0,0,0,221,A
4-HA,1433,0,221,0,1,222,T
4-HA,1434,0,2,221,0,223,G
4-HA,1435,0,1,224,0,225,G
4-HA,1436,0,0,226,0,226,G
4-HA,1437,0,0,0,217,217,C
4-HA,1438,208,0,0,0,208,A
4-HA,1439,210,0,0,0,210,A
4-HA,1440,0,209,0,0,209,T
4-HA,1441,0,0,211,0,211,G
4-HA,1442,0,0,213,0,213,G
4-HA,1443,0,211,0,0,211,T
4-HA,1444,0,204,0,0,204,T
4-HA,1445,0,1,202,0,203,G
4-HA,1446,0,204,0,0,204,T
4-HA,1447,0,203,0,0,203,T
4-HA,1448,0,204,0,0,204,T
4-HA,1449,1,0,0,203,204,C
4-HA,1450,201,0,0,0,201,A
4-HA,1451,201,0,0,0,201,A
4-HA,1452,201,0,0,0,201,A
4-HA,1453,203,1,0,0,204,A
4-HA,1454,0,203,0,0,203,T
4-HA,1455,203,0,0,0,203,A
4-HA,1456,1,204,1,0,206,T
4-HA,1457,204,0,0,0,204,A
4-HA,1458,0,0,0,208,208,C
4-HA,1459,1,0,0,208,209,C
4-HA,1460,204,0,1,0,205,A
4-HA,1461,0,0,0,208,208,C
4-HA,1462,207,0,0,0,207,A
4-HA,1463,209,0,0,0,209,A
4-HA,1464,207,0,0,0,207,A
4-HA,1465,0,206,1,0,207,T
4-HA,1466,0,0,210,0,210,G
4-HA,1467,1,206,1,0,208,T
4-HA,1468,0,0,211,0,211,G
4-HA,1469,211,0,0,0,211,A
4-HA,1470,0,0,0,212,212,C
4-HA,1471,209,0,1,0,210,A
4-HA,1472,211,0,0,0,211,A
4-HA,1473,0,217,0,0,217,T
4-HA,1474,1,0,219,0,220,G
4-HA,1475,0,0,0,220,220,C
4-HA,1476,0,0,0,218,218,C
4-HA,1477,0,218,0,0,218,T
4-HA,1478,0,0,230,0,230,G
4-HA,1479,0,0,0,229,229,C
4-HA,1480,228,0,0,0,228,A
4-HA,1481,0,229,0,0,229,T
4-HA,1482,220,0,0,0,220,A
4-HA,1483,0,0,220,0,220,G
4-HA,1484,0,1,218,0,219,G
4-HA,1485,216,0,0,0,216,A
4-HA,1486,0,213,0,1,214,T
4-HA,1487,1,0,0,204,205,C
4-HA,1488,203,0,0,0,203,A
4-HA,1489,204,0,0,0,204,A
4-HA,1490,0,205,0,0,205,T
4-HA,1491,2,0,0,202,204,C
4-HA,1492,204,0,0,0,204,A
4-HA,1493,0,0,205,0,205,G
4-HA,1494,207,0,0,0,207,A
4-HA,1495,208,0,0,0,208,A
4-HA,1496,207,0,0,0,207,A
4-HA,1497,0,206,0,0,206,T
4-HA,1498,0,0,204,0,204,G
4-HA,1499,0,2,204,0,206,G
4-HA,1500,205,0,0,0,205,A
4-HA,1501,206,0,0,0,206,A
4-HA,1502,0,0,0,207,207,C
4-HA,1503,0,203,0,1,204,T
4-HA,1504,0,208,0,0,208,T
4-HA,1505,208,0,0,0,208,A
4-HA,1506,0,207,0,0,207,T
4-HA,1507,0,2,204,0,206,G
4-HA,1508,204,0,1,0,205,A
4-HA,1509,0,0,0,205,205,C
4-HA,1510,0,1,0,203,204,C
4-HA,1511,202,0,0,0,202,A
4-HA,1512,0,0,0,208,208,C
4-HA,1513,0,0,212,0,212,G
4-HA,1514,214,0,0,0,214,A
4-HA,1515,0,222,0,0,222,T
4-HA,1516,1,0,229,0,230,G
4-HA,1517,0,229,0,0,229,T
4-HA,1518,234,0,0,0,234,A
4-HA,1519,0,233,0,1,234,T
4-HA,1520,233,0,0,0,233,A
4-HA,1521,0,0,0,233,233,C
4-HA,1522,214,0,0,0,214,A
4-HA,1523,0,1,215,0,216,G
4-HA,1524,204,0,1,0,205,A
4-HA,1525,0,1,201,0,202,G
4-HA,1526,201,0,0,0,201,A
4-HA,1527,0,191,0,0,191,T
4-HA,1528,0,1,187,0,188,G
4-HA,1529,188,0,0,0,188,A
4-HA,1530,187,0,0,0,187,A
4-HA,1531,0,0,193,0,193,G
4-HA,1532,0,0,0,189,189,C
4-HA,1533,189,1,0,0,190,A
4-HA,1534,0,192,0,0,192,T
4-HA,1535,0,189,0,0,189,T
4-HA,1536,191,0,0,0,191,A
4-HA,1537,190,0,0,0,190,A
4-HA,1538,189,0,0,0,189,A
4-HA,1539,0,0,0,191,191,C
4-HA,1540,187,0,0,0,187,A
4-HA,1541,187,0,0,0,187,A
4-HA,1542,1,0,0,186,187,C
4-HA,1543,0,0,0,185,185,C
4-HA,1544,0,0,185,0,185,G
4-HA,1545,0,0,186,0,186,G
4-HA,1546,0,186,0,1,187,T
4-HA,1547,0,185,0,0,185,T
4-HA,1548,0,0,0,187,187,C
4-HA,1549,0,0,0,187,187,C
4-HA,1550,186,0,1,0,187,A
4-HA,1551,0,0,189,0,189,G
4-HA,1552,186,0,2,0,188,A
4-HA,1553,0,187,0,0,187,T
4-HA,1554,2,0,0,178,180,C
4-HA,1555,178,0,0,0,178,A
4-HA,1556,178,0,0,0,178,A
4-HA,1557,0,0,178,0,178,G
4-HA,1558,0,1,176,0,177,G
4-HA,1559,0,1,175,0,176,G
4-HA,1560,165,0,1,0,166,A
4-HA,1561,0,0,168,0,168,G
4-HA,1562,0,167,0,1,168,T
4-HA,1563,0,168,0,0,168,T
4-HA,1564,0,0,168,0,168,G
4-HA,1565,0,162,0,0,162,T
4-HA,1566,0,0,171,0,171,G
4-HA,1567,0,0,0,171,171,C
4-HA,1568,0,171,0,0,171,T
4-HA,1569,0,0,171,0,171,G
4-HA,1570,170,0,0,0,170,A
4-HA,1571,169,0,0,0,169,A
4-HA,1572,0,0,170,0,170,G
4-HA,1573,0,162,0,0,162,T
4-HA,1574,1,0,0,159,160,C
4-HA,1575,162,0,0,0,162,A
4-HA,1576,0,0,162,0,162,G
4-HA,1577,0,0,160,0,160,G
4-HA,1578,0,1,153,0,154,G
4-HA,1579,0,157,0,0,157,T
4-HA,1580,157,0,0,0,157,A
4-HA,1581,0,0,0,157,157,C
4-HA,1582,156,0,0,0,156,A
4-HA,1583,156,0,0,0,156,A
4-HA,1584,153,0,0,0,153,A
4-HA,1585,0,0,152,0,152,G
4-HA,1586,146,0,0,0,146,A
4-HA,1587,0,142,0,0,142,T
4-HA,1588,0,137,0,0,137,T
4-HA,1589,0,0,137,0,137,G
4-HA,1590,0,1,138,0,139,G
4-HA,1591,140,0,0,0,140,A
4-HA,1592,0,139,0,0,139,T
4-HA,1593,0,0,0,140,140,C
4-HA,1594,0,0,0,136,136,C
4-HA,1595,0,132,0,0,132,T
4-HA,1596,135,0,0,0,135,A
4-HA,1597,0,135,0,0,135,T
4-HA,1598,0,0,134,0,134,G
4-HA,1599,0,0,137,0,137,G
4-HA,1600,136,0,0,0,136,A
4-HA,1601,0,135,0,1,136,T
4-HA,1602,0,135,0,0,135,T
4-HA,1603,0,134,0,0,134,T
4-HA,1604,1,0,0,133,134,C
4-HA,1605,2,0,0,128,130,C
4-HA,1606,0,126,0,0,126,T
4-HA,1607,0,121,0,0,121,T
4-HA,1608,0,121,0,0,121,T
4-HA,1609,1,0,121,0,122,G
4-HA,1610,0,0,0,123,123,C
4-HA,1611,0,0,0,120,120,C
4-HA,1612,119,0,0,0,119,A
4-HA,1613,0,119,0,0,119,T
4-HA,1614,118,0,0,0,118,A
4-HA,1615,0,118,0,0,118,T
4-HA,1616,1,0,0,116,117,C
4-HA,1617,116,0,0,0,116,A
4-HA,1618,0,114,0,0,114,T
4-HA,1619,0,0,114,0,114,G
4-HA,1620,0,112,1,0,113,T
4-HA,1621,0,110,0,1,111,T
4-HA,1622,0,111,0,0,111,T
4-HA,1623,0,109,0,0,109,T
4-HA,1624,0,109,0,0,109,T
4-HA,1625,0,109,0,0,109,T
4-HA,1626,0,0,107,0,107,G
4-HA,1627,0,0,0,106,106,C
4-HA,1628,0,105,0,0,105,T
4-HA,1629,0,104,0,0,104,T
4-HA,1630,0,105,0,0,105,T
4-HA,1631,0,0,107,0,107,G
4-HA,1632,0,107,0,0,107,T
4-HA,1633,1,0,106,0,107,G
4-HA,1634,0,107,0,0,107,T
4-HA,1635,0,104,0,0,104,T
4-HA,1636,0,0,105,0,105,G
4-HA,1637,0,0,0,105,105,C
4-HA,1638,0,105,0,0,105,T
4-HA,1639,0,107,0,0,107,T
4-HA,1640,0,100,0,0,100,T
4-HA,1641,0,1,100,0,101,G
4-HA,1642,0,100,0,0,100,T
4-HA,1643,0,100,0,0,100,T
4-HA,1644,0,1,99,0,100,G
4-HA,1645,0,0,100,0,100,G
4-HA,1646,0,1,98,0,99,G
4-HA,1647,0,0,100,0,100,G
4-HA,1648,0,96,0,0,96,T
4-HA,1649,0,96,0,0,96,T
4-HA,1650,1,0,0,96,97,C
4-HA,1651,96,0,0,0,96,A
4-HA,1652,0,96,0,0,96,T
4-HA,1653,1,0,0,96,97,C
4-HA,1654,95,0,0,0,95,A
4-HA,1655,0,94,0,0,94,T
4-HA,1656,0,0,94,0,94,G
4-HA,1657,0,91,0,0,91,T
4-HA,1658,0,0,90,0,90,G
4-HA,1659,0,0,85,0,85,G
4-HA,1660,0,0,85,0,85,G
4-HA,1661,0,0,0,83,83,C
4-HA,1662,0,0,0,82,82,C
4-HA,1663,0,78,0,1,79,T
4-HA,1664,0,0,80,0,80,G
4-HA,1665,0,0,0,80,80,C
4-HA,1666,1,0,0,79,80,C
4-HA,1667,79,1,0,0,80,A
4-HA,1668,77,0,0,0,77,A
4-HA,1669,77,0,0,0,77,A
4-HA,1670,77,0,0,0,77,A
4-HA,1671,77,0,0,0,77,A
4-HA,1672,0,0,76,1,77,G
4-HA,1673,0,0,75,0,75,G
4-HA,1674,0,0,0,72,72,C
4-HA,1675,73,0,0,0,73,A
4-HA,1676,74,0,0,0,74,A
4-HA,1677,0,0,0,74,74,C
4-HA,1678,74,0,0,0,74,A
4-HA,1679,0,73,0,0,73,T
4-HA,1680,0,73,0,0,73,T
4-HA,1681,68,0,0,0,68,A
4-HA,1682,0,1,67,0,68,G
4-HA,1683,0,0,68,0,68,G
4-HA,1684,0,65,0,0,65,T
4-HA,1685,0,0,64,0,64,G
4-HA,1686,0,0,0,63,63,C
4-HA,1687,61,0,0,0,61,A
4-HA,1688,59,0,1,0,60,A
4-HA,1689,0,0,0,60,60,C
4-HA,1690,59,0,0,0,59,A
4-HA,1691,0,57,0,0,57,T
4-HA,1692,0,55,0,0,55,T
4-HA,1693,0,54,0,1,55,T
4-HA,1694,0,0,55,0,55,G
4-HA,1695,0,0,0,55,55,C
4-HA,1696,55,0,0,0,55,A
4-HA,1697,0,52,0,0,52,T
4-HA,1698,0,51,0,0,51,T
4-HA,1699,0,50,0,0,50,T
4-HA,1700,0,0,50,0,50,G
4-HA,1701,47,0,0,0,47,A
5-NP,1,290,0,0,0,290,A
5-NP,2,0,290,0,0,290,T
5-NP,3,0,0,289,0,289,G
5-NP,4,0,0,294,0,294,G
5-NP,5,1,0,0,295,296,C
5-NP,6,0,0,301,0,301,G
5-NP,7,0,308,0,0,308,T
5-NP,8,0,0,0,314,314,C
5-NP,9,0,0,0,314,314,C
5-NP,10,0,0,0,317,317,C
5-NP,11,316,1,0,0,317,A
5-NP,12,313,0,1,0,314,A
5-NP,13,0,3,316,0,319,G
5-NP,14,0,0,328,0,328,G
5-NP,15,0,0,0,326,326,C
5-NP,16,328,0,0,0,328,A
5-NP,17,1,0,0,332,333,C
5-NP,18,2,0,0,331,333,C
5-NP,19,337,0,0,0,337,A
5-NP,20,337,0,0,0,337,A
5-NP,21,335,1,0,0,336,A
5-NP,22,0,2,0,336,338,C
5-NP,23,2,2,337,0,341,G
5-NP,24,0,0,377,0,377,G
5-NP,25,0,378,0,0,378,T
5-NP,26,2,0,0,400,402,C
5-NP,27,0,398,0,3,401,T
5-NP,28,0,407,0,0,407,T
5-NP,29,404,0,1,0,405,A
5-NP,30,0,408,0,0,408,T
5-NP,31,0,3,407,0,410,G
5-NP,32,407,0,1,0,408,A
5-NP,33,405,0,1,0,406,A
5-NP,34,0,0,0,407,407,C
5-NP,35,400,0,0,0,400,A
5-NP,36,0,0,435,0,435,G
5-NP,37,433,0,0,0,433,A
5-NP,38,0,433,0,0,433,T
5-NP,39,0,3,429,0,432,G
5-NP,40,0,1,433,0,434,G
5-NP,41,433,0,2,0,435,A
5-NP,42,433,0,0,0,433,A
5-NP,43,434,0,2,0,436,A
5-NP,44,0,0,0,448,448,C
5-NP,45,0,439,0,0,439,T
5-NP,46,0,2,444,0,446,G
5-NP,47,443,0,0,0,443,A
5-NP,48,0,443,0,2,445,T
5-NP,49,0,0,444,0,444,G
5-NP,50,0,4,440,0,444,G
5-NP,51,1,2,443,0,446,G
5-NP,52,0,2,448,0,450,G
5-NP,53,447,0,0,0,447,A
5-NP,54,0,446,0,1,447,T
5-NP,55,3,0,0,445,448,C
5-NP,56,0,0,448,0,448,G
5-NP,57,0,0,0,460,460,C
5-NP,58,0,0,0,459,459,C
5-NP,59,462,0,0,0,462,A
5-NP,60,0,3,463,0,466,G
5-NP,61,469,0,0,0,469,A
5-NP,62,483,0,0,0,483,A
5-NP,63,0,482,0,0,482,T
5-NP,64,0,0,483,0,483,G
5-NP,65,1,1,0,486,488,C
5-NP,66,485,0,0,0,485,A
5-NP,67,488,0,1,0,489,A
5-NP,68,1,2,0,487,490,C
5-NP,69,0,485,0,0,485,T
5-NP,70,0,3,483,0,486,G
5-NP,71,492,0,1,0,493,A
5-NP,72,0,2,525,0,527,G
5-NP,73,523,0,0,0,523,A
5-NP,74,0,523,0,0,523,T
5-NP,75,0,523,0,0,523,T
5-NP,76,521,0,1,1,523,A
5-NP,77,0,1,523,0,524,G
5-NP,78,0,1,522,0,523,G
5-NP,79,0,1,521,0,522,G
5-NP,80,0,1,0,520,521,C
5-NP,81,516,0,0,0,516,A
5-NP,82,0,513,0,3,516,T
5-NP,83,0,0,0,513,513,C
5-NP,84,0,0,0,515,515,C
5-NP,85,0,0,516,0,516,G
5-NP,86,0,514,0,0,514,T
5-NP,87,2,0,0,512,514,C
5-NP,88,0,2,514,0,516,G
5-NP,89,0,2,514,0,516,G
5-NP,90,2,2,516,0,520,G
5-NP,91,515,1,0,0,516,A
5-NP,92,517,0,0,0,517,A
5-NP,93,0,1,520,0,521,G
5-NP,94,517,0,0,0,517,A
5-NP,95,0,527,0,0,527,T
5-NP,96,0,3,526,0,529,G
5-NP,97,532,0,2,0,534,A
5-NP,98,0,536,0,0,536,T
5-NP,99,0,530,0,1,531,T
5-NP,100,1,0,532,0,533,G
5-NP,101,532,0,0,0,532,A
5-NP,102,1,530,0,1,532,T
5-NP,103,0,1,531,0,532,G
5-NP,104,0,4,527,0,531,G
5-NP,105,0,1,523,0,524,G
5-NP,106,550,0,1,0,551,A
5-NP,107,0,552,0,1,553,T
5-NP,108,0,552,0,0,552,T
5-NP,109,0,2,559,0,561,G
5-NP,110,0,1,559,0,560,G
5-NP,111,1,3,556,0,560,G
5-NP,112,561,0,0,0,561,A
5-NP,113,12,1,541,0,554,G
5-NP,114,552,0,1,0,553,A
5-NP,115,0,560,0,0,560,T
5-NP,116,0,561,0,0,561,T
5-NP,117,0,0,0,560,560,C
5-NP,118,0,559,0,0,559,T
5-NP,119,561,0,0,0,561,A
5-NP,120,1,0,0,568,569,C
5-NP,121,585,0,1,1,587,A
5-NP,122,0,590,0,0,590,T
5-NP,123,0,0,0,588,588,C
5-NP,124,0,0,0,588,588,C
5-NP,125,589,0,0,0,589,A
5-NP,126,601,0,0,0,601,A
5-NP,127,601,0,0,0,601,A
5-NP,128,0,597,0,0,597,T
5-NP,129,0,0,599,0,599,G
5-NP,130,0,590,0,1,591,T
5-NP,131,0,0,600,0,600,G
5-NP,132,0,0,0,601,601,C
5-NP,133,600,0,0,0,600,A
5-NP,134,0,0,0,602,602,C
5-NP,135,0,599,0,1,600,T
5-NP,136,0,2,612,0,614,G
5-NP,137,627,0,1,0,628,A
5-NP,138,636,0,0,0,636,A
5-NP,139,0,0,0,650,650,C
5-NP,140,0,646,0,0,646,T
5-NP,141,0,650,0,2,652,T
5-NP,142,653,0,1,0,654,A
5-NP,143,650,2,1,0,653,A
5-NP,144,658,0,0,0,658,A
5-NP,145,0,0,0,661,661,C
5-NP,146,0,641,0,1,642,T
5-NP,147,4,0,0,643,647,C
5-NP,148,640,0,0,0,640,A
5-NP,149,0,0,648,0,648,G
5-NP,150,0,644,0,2,646,T
5-NP,151,0,3,649,0,652,G
5-NP,152,655,0,2,0,657,A
5-NP,153,0,659,0,0,659,T
5-NP,154,3,0,0,661,664,C
5-NP,155,665,0,0,0,665,A
5-NP,156,0,660,0,2,662,T
5-NP,157,0,3,658,0,661,G
5-NP,158,659,0,0,0,659,A
5-NP,159,655,0,3,0,658,A
5-NP,160,1,5,653,0,659,G
5-NP,161,0,4,651,0,655,G
5-NP,162,0,0,659,0,659,G
5-NP,163,1,0,0,645,646,C
5-NP,164,0,1,652,0,653,G
5-NP,165,0,1,657,0,658,G
5-NP,166,1,655,0,0,656,T
5-NP,167,0,656,0,0,656,T
5-NP,168,0,5,655,0,660,G
5-NP,169,717,0,2,0,719,A
5-NP,170,0,715,0,0,715,T
5-NP,171,2,0,0,711,713,C
5-NP,172,1,1,0,715,717,C
5-NP,173,711,0,0,0,711,A
5-NP,174,0,2,713,0,715,G
5-NP,175,712,0,0,0,712,A
5-NP,176,713,0,1,0,714,A
5-NP,177,0,0,0,715,715,C
5-NP,178,672,0,1,0,673,A
5-NP,179,1,0,675,0,676,G
5-NP,180,0,0,0,674,674,C
5-NP,181,0,678,0,0,678,T
5-NP,182,0,679,0,0,679,T
5-NP,183,0,3,677,0,680,G
5-NP,184,681,0,1,0,682,A
5-NP,185,0,0,0,690,690,C
5-NP,186,683,0,0,0,683,A
5-NP,187,686,0,0,0,686,A
5-NP,188,0,686,0,0,686,T
5-NP,189,679,0,1,0,680,A
5-NP,190,0,3,681,0,684,G
5-NP,191,685,0,2,0,687,A
5-NP,192,1,3,683,0,687,G
5-NP,193,681,0,0,1,682,A
5-NP,194,693,1,0,0,694,A
5-NP,195,694,0,0,0,694,A
5-NP,196,706,0,0,0,706,A
5-NP,197,0,706,0,0,706,T
5-NP,198,0,6,698,0,704,G
5-NP,199,1,3,700,0,704,G
5-NP,200,0,704,0,1,705,T
5-NP,201,688,0,1,0,689,A
5-NP,202,0,0,0,699,699,C
5-NP,203,0,702,0,1,703,T
5-NP,204,3,0,0,701,704,C
5-NP,205,0,686,1,2,689,T
5-NP,206,1,0,0,723,724,C
5-NP,207,0,725,1,0,726,T
5-NP,208,1,2,726,0,729,G
5-NP,209,0,0,0,730,730,C
5-NP,210,0,723,0,1,724,T
5-NP,211,0,722,0,1,723,T
5-NP,212,0,723,0,2,725,T
5-NP,213,0,711,0,0,711,T
5-NP,214,0,0,717,0,717,G
5-NP,215,703,0,1,13,717,A
5-NP,216,0,715,0,1,716,T
5-NP,217,0,3,713,0,716,G
5-NP,218,712,1,1,0,714,A
5-NP,219,712,0,0,0,712,A
5-NP,220,716,0,0,0,716,A
5-NP,221,0,1,719,0,720,G
5-NP,222,714,0,2,0,716,A
5-NP,223,715,0,1,0,716,A
5-NP,224,0,2,727,0,729,G
5-NP,225,0,3,749,0,752,G
5-NP,226,754,0,1,0,755,A
5-NP,227,756,0,2,0,758,A
5-NP,228,0,757,0,0,757,T
5-NP,229,758,0,0,0,758,A
5-NP,230,756,0,0,0,756,A
5-NP,231,758,0,0,0,758,A
5-NP,232,0,762,0,0,762,T
5-NP,233,761,0,0,0,761,A
5-NP,234,1,0,0,759,760,C
5-NP,235,0,0,0,737,737,C
5-NP,236,0,733,1,0,734,T
5-NP,237,0,1,733,0,734,G
5-NP,238,0,3,738,0,741,G
5-NP,239,741,0,0,0,741,A
5-NP,240,741,0,0,0,741,A
5-NP,241,0,6,742,0,748,G
5-NP,242,746,0,1,0,747,A
5-NP,243,746,0,0,0,746,A
5-NP,244,0,0,0,746,746,C
5-NP,245,747,0,0,0,747,A
5-NP,246,1,0,0,759,760,C
5-NP,247,1,0,0,751,752,C
5-NP,248,2,0,0,752,754,C
5-NP,249,0,2,0,750,752,C
5-NP,250,749,0,1,0,750,A
5-NP,251,1,0,749,0,750,G
5-NP,252,0,0,0,751,751,C
5-NP,253,0,1,751,0,752,G
5-NP,254,1,1,1,751,754,C
5-NP,255,0,0,741,1,742,G
5-NP,256,0,2,755,0,757,G
5-NP,257,0,2,752,0,754,G
5-NP,258,0,3,752,0,755,G
5-NP,259,751,0,1,0,752,A
5-NP,260,749,0,1,0,750,A
5-NP,261,745,0,2,0,747,A
5-NP,262,0,2,747,0,749,G
5-NP,263,744,0,2,0,746,A
5-NP,264,0,746,0,0,746,T
5-NP,265,0,0,0,745,745,C
5-NP,266,1,0,0,739,740,C
5-NP,267,3,3,0,744,750,C
5-NP,268,752,0,1,0,753,A
5-NP,269,751,0,0,0,751,A
5-NP,270,0,3,749,0,752,G
5-NP,271,753,0,0,0,753,A
5-NP,272,753,0,0,0,753,A
5-NP,273,755,0,0,0,755,A
5-NP,274,756,0,0,0,756,A
5-NP,275,2,0,0,753,755,C
5-NP,276,0,746,0,0,746,T
5-NP,277,0,1,743,0,744,G
5-NP,278,0,5,740,0,745,G
5-NP,279,0,3,742,0,745,G
5-NP,280,1,2,741,0,744,G
5-NP,281,0,3,736,0,739,G
5-NP,282,1,0,755,0,756,G
5-NP,283,2,2,0,804,808,C
5-NP,284,2,0,0,803,805,C
5-NP,285,6,0,0,808,814,C
5-NP,286,907,0,0,0,907,A
5-NP,287,0,908,0,0,908,T
5-NP,288,956,0,0,0,956,A
5-NP,289,0,953,1,1,955,T
5-NP,290,943,0,1,0,944,A
5-NP,291,0,0,0,949,949,C
5-NP,292,881,0,2,0,883,A
5-NP,293,0,0,895,0,895,G
5-NP,294,0,5,890,0,895,G
5-NP,295,816,0,1,0,817,A
5-NP,296,1,5,819,0,825,G
5-NP,297,783,0,0,0,783,A
5-NP,298,0,0,799,0,799,G
5-NP,299,0,799,0,0,799,T
5-NP,300,790,0,1,0,791,A
5-NP,301,3,2,789,0,794,G
5-NP,302,777,0,1,0,778,A
5-NP,303,0,778,0,1,779,T
5-NP,304,0,4,775,0,779,G
5-NP,305,0,4,778,0,782,G
5-NP,306,782,0,0,0,782,A
5-NP,307,781,0,0,0,781,A
5-NP,308,777,0,0,0,777,A
5-NP,309,784,0,0,0,784,A
5-NP,310,0,778,0,0,778,T
5-NP,311,0,1,793,0,794,G
5-NP,312,0,7,785,0,792,G
5-NP,313,789,0,0,0,789,A
5-NP,314,0,782,0,1,783,T
5-NP,315,0,0,785,0,785,G
5-NP,316,784,0,3,0,787,A
5-NP,317,0,0,788,0,788,G
5-NP,318,0,2,781,0,783,G
5-NP,319,1,3,786,0,790,G
5-NP,320,788,0,3,0,791,A
5-NP,321,791,0,0,0,791,A
5-NP,322,0,0,0,797,797,C
5-NP,323,0,797,1,1,799,T
5-NP,324,5,0,0,804,809,C
5-NP,325,0,0,812,0,812,G
5-NP,326,0,804,0,1,805,T
5-NP,327,3,0,0,798,801,C
5-NP,328,1,0,0,837,838,C
5-NP,329,0,831,0,1,832,T
5-NP,330,0,836,0,0,836,T
5-NP,331,0,836,0,0,836,T
5-NP,332,840,0,0,0,840,A
5-NP,333,0,835,0,0,835,T
5-NP,334,0,6,831,1,838,G
5-NP,335,834,0,1,0,835,A
5-NP,336,1,1,0,831,833,C
5-NP,337,821,0,1,0,822,A
5-NP,338,821,0,0,0,821,A
5-NP,339,824,1,0,0,825,A
5-NP,340,0,3,845,0,848,G
5-NP,341,846,0,1,0,847,A
5-NP,342,847,0,2,0,849,A
5-NP,343,0,4,861,0,865,G
5-NP,344,864,0,1,0,865,A
5-NP,345,865,0,3,0,868,A
5-NP,346,867,0,2,0,869,A
5-NP,347,0,867,0,0,867,T
5-NP,348,869,0,0,0,869,A
5-NP,349,855,0,1,1,857,A
5-NP,350,0,3,863,0,866,G
5-NP,351,0,1,864,0,865,G
5-NP,352,0,2,0,859,861,C
5-NP,353,1,10,845,0,856,G
5-NP,354,854,1,0,0,855,A
5-NP,355,860,0,1,0,861,A
5-NP,356,0,864,0,0,864,T
5-NP,357,2,0,0,861,863,C
5-NP,358,0,859,0,0,859,T
5-NP,359,0,4,855,0,859,G
5-NP,360,0,1,863,0,864,G
5-NP,361,0,2,0,860,862,C
5-NP,362,0,0,864,0,864,G
5-NP,363,0,3,0,860,863,C
5-NP,364,3,0,0,846,849,C
5-NP,365,853,0,2,0,855,A
5-NP,366,860,0,0,0,860,A
5-NP,367,0,0,874,0,874,G
5-NP,368,2,0,1,868,871,C
5-NP,369,1,1,0,872,874,C
5-NP,370,870,0,2,0,872,A
5-NP,371,880,0,1,0,881,A
5-NP,372,0,0,0,883,883,C
5-NP,373,883,0,1,0,884,A
5-NP,374,893,0,1,0,894,A
5-NP,375,0,887,0,2,889,T
5-NP,376,1,4,895,0,900,G
5-NP,377,0,0,904,0,904,G
5-NP,378,0,894,0,1,895,T
5-NP,379,0,1,892,1,894,G
5-NP,380,890,0,2,0,892,A
5-NP,381,0,7,902,0,909,G
5-NP,382,0,2,905,0,907,G
5-NP,383,908,0,0,0,908,A
5-NP,384,0,961,0,0,961,T
5-NP,385,0,1,959,0,960,G
5-NP,386,0,1,0,959,960,C
5-NP,387,0,957,1,0,958,T
5-NP,388,962,1,0,0,963,A
5-NP,389,1,1,0,969,971,C
5-NP,390,959,1,0,0,960,A
5-NP,391,0,955,1,2,958,T
5-NP,392,1,0,0,953,954,C
5-NP,393,0,919,0,1,920,T
5-NP,394,0,1,940,0,941,G
5-NP,395,0,0,953,1,954,G
5-NP,396,1,948,0,2,951,T
5-NP,397,4,0,0,945,949,C
5-NP,398,1,930,1,0,932,T
5-NP,399,931,0,5,0,936,A
5-NP,400,936,0,0,0,936,A
5-NP,401,0,0,0,945,945,C
5-NP,402,0,935,0,4,939,T
5-NP,403,5,0,0,933,938,C
5-NP,404,917,0,1,0,918,A
5-NP,405,2,0,0,951,953,C
5-NP,406,952,1,0,0,953,A
5-NP,407,1,954,0,0,955,T
5-NP,408,938,0,1,0,939,A
5-NP,409,949,0,0,0,949,A
5-NP,410,0,949,1,0,950,T
5-NP,411,0,6,952,0,958,G
5-NP,412,949,0,0,0,949,A
5-NP,413,0,938,0,0,938,T
5-NP,414,0,919,1,1,921,T
5-NP,415,0,922,0,1,923,T
5-NP,416,1,4,911,1,917,G
5-NP,417,0,2,913,0,915,G
5-NP,418,2,1,0,914,917,C
5-NP,419,908,0,1,0,909,A
5-NP,420,0,907,0,1,908,T
5-NP,421,0,903,0,2,905,T
5-NP,422,4,0,0,903,907,C
5-NP,423,4,0,0,909,913,C
5-NP,424,920,0,0,0,920,A
5-NP,425,923,0,1,0,924,A
5-NP,426,0,916,0,0,916,T
5-NP,427,0,924,0,1,925,T
5-NP,428,0,923,0,0,923,T
5-NP,429,0,9,925,0,934,G
5-NP,430,927,0,2,0,929,A
5-NP,431,929,0,1,0,930,A
5-NP,432,0,939,0,1,940,T
5-NP,433,0,4,928,0,932,G
5-NP,434,955,0,0,0,955,A
5-NP,435,0,958,0,0,958,T
5-NP,436,3,1,959,0,963,G
5-NP,437,1,0,0,980,981,C
5-NP,438,978,1,2,1,982,A
5-NP,439,1018,0,3,1,1022,A
5-NP,440,3,0,0,1020,1023,C
5-NP,441,1035,0,0,1,1036,A
5-NP,442,0,1050,0,1,1051,T
5-NP,443,1031,0,1,0,1032,A
5-NP,444,2,0,0,1044,1046,C
5-NP,445,7,1,0,1035,1043,C
5-NP,446,1014,1,1,0,1016,A
5-NP,447,2,5,1020,0,1027,G
5-NP,448,1005,0,1,1,1007,A
5-NP,449,1,4,1015,0,1020,G
5-NP,450,1,0,1016,0,1017,G
5-NP,451,1009,0,0,0,1009,A
5-NP,452,0,1,0,1013,1014,C
5-NP,453,991,0,0,1,992,A
5-NP,454,985,0,1,0,986,A
5-NP,455,0,4,985,0,989,G
5-NP,456,971,2,1,0,974,A
5-NP,457,0,1,988,0,989,G
5-NP,458,1,0,0,988,989,C
5-NP,459,0,984,0,0,984,T
5-NP,460,4,0,0,981,985,C
5-NP,461,0,985,0,1,986,T
5-NP,462,0,995,0,0,995,T
5-NP,463,1,3,996,0,1000,G
5-NP,464,0,991,0,1,992,T
5-NP,465,0,989,0,1,990,T
5-NP,466,7,0,0,983,990,C
5-NP,467,0,12,974,0,986,G
5-NP,468,1002,0,0,0,1002,A
5-NP,469,1000,0,1,0,1001,A
5-NP,470,1,0,0,1001,1002,C
5-NP,471,0,1000,0,0,1000,T
5-NP,472,0,2,1017,0,1019,G
5-NP,473,0,6,1015,0,1021,G
5-NP,474,1025,0,0,0,1025,A
5-NP,475,1021,1,4,0,1026,A
5-NP,476,0,1027,0,0,1027,T
5-NP,477,1,3,1010,0,1014,G
5-NP,478,0,4,1020,0,1024,G
5-NP,479,1030,0,2,0,1032,A
5-NP,480,1,1031,0,0,1032,T
5-NP,481,3,2,0,1027,1032,C
5-NP,482,6,1,0,1027,1034,C
5-NP,483,2,2,0,1041,1045,C
5-NP,484,1043,0,0,0,1043,A
5-NP,485,0,4,1050,0,1054,G
5-NP,486,1049,0,0,0,1049,A
5-NP,487,1046,0,0,0,1046,A
5-NP,488,0,1038,0,1,1039,T
5-NP,489,0,0,1050,0,1050,G
5-NP,490,0,1041,0,1,1042,T
5-NP,491,0,1,1048,0,1049,G
5-NP,492,1,0,0,1048,1049,C
5-NP,493,0,1042,0,2,1044,T
5-NP,494,7,0,0,1097,1104,C
5-NP,495,0,1096,0,1,1097,T
5-NP,496,7,1,0,1123,1131,C
5-NP,497,0,1127,0,0,1127,T
5-NP,498,1,6,1122,0,1129,G
5-NP,499,1136,0,2,0,1138,A
5-NP,500,0,1136,0,0,1136,T
5-NP,501,1,1,1130,0,1132,G
5-NP,502,0,0,0,1138,1138,C
5-NP,503,1095,0,0,0,1095,A
5-NP,504,0,2,1117,0,1119,G
5-NP,505,0,2,1106,0,1108,G
5-NP,506,0,0,1116,0,1116,G
5-NP,507,1,0,0,1116,1117,C
5-NP,508,0,1101,0,3,1104,T
5-NP,509,3,0,0,1110,1113,C
5-NP,510,0,6,1108,0,1114,G
5-NP,511,1119,0,1,0,1120,A
5-NP,512,1,0,0,1118,1119,C
5-NP,513,1,1095,0,3,1099,T
5-NP,514,4,0,0,1140,1144,C
5-NP,515,0,1132,0,0,1132,T
5-NP,516,4,0,0,1248,1252,C
5-NP,517,5,0,0,1252,1257,C
5-NP,518,8,0,0,1251,1259,C
5-NP,519,0,1254,0,2,1256,T
5-NP,520,1247,0,0,0,1247,A
5-NP,521,0,2,1251,0,1253,G
5-NP,522,1230,0,18,0,1248,A
5-NP,523,1223,0,0,0,1223,A
5-NP,524,0,3,1221,0,1224,G
5-NP,525,0,1,1198,0,1199,G
5-NP,526,0,1184,0,1,1185,T
5-NP,527,4,0,0,1181,1185,C
5-NP,528,2,0,0,1182,1184,C
5-NP,529,1,6,1176,0,1183,G
5-NP,530,0,1,1187,0,1188,G
5-NP,531,1184,0,3,0,1187,A
5-NP,532,0,0,1203,0,1203,G
5-NP,533,0,0,0,1202,1202,C
5-NP,534,0,1190,0,1,1191,T
5-NP,535,1,1,1190,0,1192,G
5-NP,536,0,0,0,1195,1195,C
5-NP,537,1191,0,3,1,1195,A
5-NP,538,1,3,1203,0,1207,G
5-NP,539,1,0,1206,0,1207,G
5-NP,540,0,1202,0,2,1204,T
5-NP,541,0,1,1194,0,1195,G
5-NP,542,1,0,0,1193,1194,C
5-NP,543,0,1184,0,3,1187,T
5-NP,544,3,2,1180,0,1185,G
5-NP,545,1,1,0,1186,1188,C
5-NP,546,1194,1,0,0,1195,A
5-NP,547,0,2,1209,0,1211,G
5-NP,548,1,1197,1,0,1199,T
5-NP,549,6,0,0,1189,1195,C
5-NP,550,1200,0,0,0,1200,A
5-NP,551,1199,0,2,0,1201,A
5-NP,552,1194,1,1,0,1196,A
5-NP,553,0,1,1209,0,1210,G
5-NP,554,0,5,1202,0,1207,G
5-NP,555,1197,0,1,0,1198,A
5-NP,556,1189,0,0,0,1189,A
5-NP,557,0,1185,0,1,1186,T
5-NP,558,10,0,0,1182,1192,C
5-NP,559,0,2,1191,0,1193,G
5-NP,560,1,3,1215,0,1219,G
5-NP,561,0,5,1213,0,1218,G
5-NP,562,1212,1,0,0,1213,A
5-NP,563,0,0,1,1214,1215,C
5-NP,564,1197,7,1,0,1205,A
5-NP,565,1225,0,0,0,1225,A
5-NP,566,0,1233,0,0,1233,T
5-NP,567,0,5,1232,0,1237,G
5-NP,568,0,3,1259,0,1262,G
5-NP,569,0,1238,0,0,1238,T
5-NP,570,0,3,1243,0,1246,G
5-NP,571,1239,0,2,0,1241,A
5-NP,572,0,1233,1,2,1236,T
5-NP,573,0,2,1236,0,1238,G
5-NP,574,0,8,1229,0,1237,G
5-NP,575,1237,1,1,0,1239,A
5-NP,576,1239,0,0,0,1239,A
5-NP,577,3,0,0,1234,1237,C
5-NP,578,0,1204,0,0,1204,T
5-NP,579,1,7,1246,0,1254,G
5-NP,580,1253,0,0,0,1253,A
5-NP,581,0,1254,0,0,1254,T
5-NP,582,15,0,0,1242,1257,C
5-NP,583,1229,0,0,0,1229,A
5-NP,584,0,6,1256,1,1263,G
5-NP,585,1253,0,0,0,1253,A
5-NP,586,1257,0,1,0,1258,A
5-NP,587,0,1253,0,0,1253,T
5-NP,588,1,5,1226,0,1232,G
5-NP,589,0,0,1251,1,1252,G
5-NP,590,0,1248,0,2,1250,T
5-NP,591,17,0,0,1235,1252,C
5-NP,592,1253,0,0,0,1253,A
5-NP,593,1240,0,0,0,1240,A
5-NP,594,1241,0,1,0,1242,A
5-NP,595,1,1,0,1244,1246,C
5-NP,596,1,3,1241,0,1245,G
5-NP,597,2,1,1244,0,1247,G
5-NP,598,2,1,1239,0,1242,G
5-NP,599,1,6,1235,0,1242,G
5-NP,600,1224,1,1,0,1226,A
5-NP,601,1238,0,2,0,1240,A
5-NP,602,0,1239,0,1,1240,T
5-NP,603,6,0,0,1233,1239,C
5-NP,604,1240,0,0,0,1240,A
5-NP,605,1242,0,2,0,1244,A
5-NP,606,0,0,0,1240,1240,C
5-NP,607,0,9,1226,0,1235,G
5-NP,608,1229,0,0,0,1229,A
5-NP,609,0,1228,0,1,1229,T
5-NP,610,6,1,0,1220,1227,C
5-NP,611,0,5,1223,0,1228,G
5-NP,612,1226,0,0,0,1226,A
5-NP,613,1224,0,1,0,1225,A
5-NP,614,1225,1,1,0,1227,A
5-NP,615,0,1240,0,1,1241,T
5-NP,616,0,1239,0,0,1239,T
5-NP,617,0,1232,1,1,1234,T
5-NP,618,0,1246,0,0,1246,T
5-NP,619,0,1244,0,0,1244,T
5-NP,620,1,4,1245,0,1250,G
5-NP,621,1,6,1238,0,1245,G
5-NP,622,1234,1,3,0,1238,A
5-NP,623,1,2,1245,0,1248,G
5-NP,624,1230,0,1,0,1231,A
5-NP,625,0,3,1281,0,1284,G
5-NP,626,1,0,1290,0,1291,G
5-NP,627,0,1281,0,2,1283,T
5-NP,628,0,4,1287,0,1291,G
5-NP,629,1286,0,2,0,1288,A
5-NP,630,0,5,1283,0,1288,G
5-NP,631,1285,0,4,0,1289,A
5-NP,632,1283,1,1,0,1285,A
5-NP,633,1,1281,0,0,1282,T
5-NP,634,0,7,1229,0,1236,G
5-NP,635,1,4,1223,0,1228,G
5-NP,636,0,1,1225,0,1226,G
5-NP,637,2,2,0,1214,1218,C
5-NP,638,0,3,1212,0,1215,G
5-NP,639,0,5,1217,1,1223,G
5-NP,640,1214,0,0,0,1214,A
5-NP,641,1215,0,1,0,1216,A
5-NP,642,1243,0,0,0,1243,A
5-NP,643,1241,0,4,0,1245,A
5-NP,644,2,0,0,1248,1250,C
5-NP,645,1247,0,0,0,1247,A
5-NP,646,1239,0,1,0,1240,A
5-NP,647,0,2,1243,0,1245,G
5-NP,648,1193,1,1,0,1195,A
5-NP,649,1199,0,1,0,1200,A
5-NP,650,0,0,1227,0,1227,G
5-NP,651,0,1225,0,2,1227,T
5-NP,652,2,2,1275,0,1279,G
5-NP,653,0,1,0,1271,1272,C
5-NP,654,0,1261,1,7,1269,T
5-NP,655,0,1271,0,2,1273,T
5-NP,656,1278,0,0,0,1278,A
5-NP,657,0,1275,0,2,1277,T
5-NP,658,0,5,1276,0,1281,G
5-NP,659,1248,0,3,0,1251,A
5-NP,660,0,2,1251,0,1253,G
5-NP,661,1192,0,1,1,1194,A
5-NP,662,0,2,1197,0,1199,G
5-NP,663,1198,0,0,0,1198,A
5-NP,664,1214,0,0,0,1214,A
5-NP,665,0,1201,0,0,1201,T
5-NP,666,0,0,1208,0,1208,G
5-NP,667,0,1201,0,3,1204,T
5-NP,668,1,0,1201,0,1202,G
5-NP,669,4,0,0,1196,1200,C
5-NP,670,1199,0,2,0,1201,A
5-NP,671,1206,0,1,0,1207,A
5-NP,672,0,0,0,1202,1202,C
5-NP,673,1181,1,1,0,1183,A
5-NP,674,0,1180,1,0,1181,T
5-NP,675,0,1176,0,2,1178,T
5-NP,676,4,0,0,1179,1183,C
5-NP,677,1,1181,0,1,1183,T
5-NP,678,0,1178,0,0,1178,T
5-NP,679,1178,1,0,0,1179,A
5-NP,680,1173,0,1,0,1174,A
5-NP,681,1170,0,4,1,1175,A
5-NP,682,0,1,1181,0,1182,G
5-NP,683,0,5,1175,0,1180,G
5-NP,684,1172,0,2,0,1174,A
5-NP,685,1171,0,1,0,1172,A
5-NP,686,1173,0,0,0,1173,A
5-NP,687,1195,1,0,0,1196,A
5-NP,688,0,1189,1,0,1190,T
5-NP,689,0,1192,0,0,1192,T
5-NP,690,0,1193,0,1,1194,T
5-NP,691,8,0,1,1186,1195,C
5-NP,692,1192,0,3,0,1195,A
5-NP,693,1195,0,0,0,1195,A
5-NP,694,1195,1,2,0,1198,A
5-NP,695,1,0,0,1204,1205,C
5-NP,696,1194,1,0,0,1195,A
5-NP,697,0,2,1219,0,1221,G
5-NP,698,0,0,1,1221,1222,C
5-NP,699,0,1210,0,4,1214,T
5-NP,700,2,1,1229,0,1232,G
5-NP,701,0,0,0,1233,1233,C
5-NP,702,1239,1,0,0,1240,A
5-NP,703,1,0,0,1241,1242,C
5-NP,704,1229,0,1,0,1230,A
5-NP,705,1233,0,2,0,1235,A
5-NP,706,1210,0,1,0,1211,A
5-NP,707,0,5,1231,0,1236,G
5-NP,708,1229,0,4,0,1233,A
5-NP,709,1,0,1225,0,1226,G
5-NP,710,0,2,0,1222,1224,C
5-NP,711,1228,0,0,0,1228,A
5-NP,712,1249,0,1,0,1250,A
5-NP,713,0,1248,1,0,1249,T
5-NP,714,0,6,1254,0,1260,G
5-NP,715,0,2,1260,0,1262,G
5-NP,716,1,1226,1,2,1230,T
5-NP,717,2,2,1231,0,1235,G
5-NP,718,0,7,1230,0,1237,G
5-NP,719,1238,1,1,0,1240,A
5-NP,720,0,1239,0,1,1240,T
5-NP,721,10,1,0,1199,1210,C
5-NP,722,1215,0,0,0,1215,A
5-NP,723,1220,0,0,1,1221,A
5-NP,724,0,1,1224,0,1225,G
5-NP,725,0,1213,1,0,1214,T
5-NP,726,0,7,1209,0,1216,G
5-NP,727,1195,0,3,0,1198,A
5-NP,728,0,7,1197,0,1204,G
5-NP,729,1198,1,3,0,1202,A
5-NP,730,1,5,1196,0,1202,G
5-NP,731,1193,0,1,0,1194,A
5-NP,732,1172,1,2,0,1175,A
5-NP,733,1179,0,1,1,1181,A
5-NP,734,1,2,1181,0,1184,G
5-NP,735,0,1181,0,1,1182,T
5-NP,736,12,3,0,1163,1178,C
5-NP,737,0,1,1171,1,1173,G
5-NP,738,1,4,1170,0,1175,G
5-NP,739,1174,0,0,1,1175,A
5-NP,740,1180,0,1,0,1181,A
5-NP,741,1,0,0,1182,1183,C
5-NP,742,2,0,1,1173,1176,C
5-NP,743,2,1,0,1180,1183,C
5-NP,744,1177,0,1,0,1178,A
5-NP,745,1,2,1177,0,1180,G
5-NP,746,1,7,1174,0,1182,G
5-NP,747,1178,0,1,0,1179,A
5-NP,748,1176,1,1,0,1178,A
5-NP,749,1176,0,0,1,1177,A
5-NP,750,0,3,0,1178,1181,C
5-NP,751,0,0,1171,0,1171,G
5-NP,752,1,0,0,1172,1173,C
5-NP,753,0,1168,0,1,1169,T
5-NP,754,2,7,1166,0,1175,G
5-NP,755,1171,0,3,0,1174,A
5-NP,756,1,6,1180,0,1187,G
5-NP,757,1186,0,1,0,1187,A
5-NP,758,0,1185,0,1,1186,T
5-NP,759,5,0,0,1165,1170,C
5-NP,760,2,2,1165,0,1169,G
5-NP,761,1171,0,1,0,1172,A
5-NP,762,1171,0,2,0,1173,A
5-NP,763,0,4,1171,0,1175,G
5-NP,764,1173,0,1,0,1174,A
5-NP,765,0,1171,0,0,1171,T
5-NP,766,4,1,0,1191,1196,C
5-NP,767,0,1190,0,1,1191,T
5-NP,768,5,0,0,1208,1213,C
5-NP,769,1214,0,0,0,1214,A
5-NP,770,0,1216,0,0,1216,T
5-NP,771,1213,0,0,0,1213,A
5-NP,772,0,1211,0,0,1211,T
5-NP,773,0,1203,0,0,1203,T
5-NP,774,0,1197,0,0,1197,T
5-NP,775,0,1193,0,0,1193,T
5-NP,776,0,1194,1,1,1196,T
5-NP,777,1191,0,2,0,1193,A
5-NP,778,24,1,1167,0,1192,G
5-NP,779,0,0,0,1190,1190,C
5-NP,780,1181,0,1,0,1182,A
5-NP,781,1183,0,2,0,1185,A
5-NP,782,0,5,1219,0,1224,G
5-NP,783,1221,1,1,0,1223,A
5-NP,784,0,1222,0,2,1224,T
5-NP,785,0,0,0,1235,1235,C
5-NP,786,1,1226,0,4,1231,T
5-NP,787,1,2,1253,0,1256,G
5-NP,788,1,0,0,1254,1255,C
5-NP,789,1258,0,0,0,1258,A
5-NP,790,0,1269,0,0,1269,T
5-NP,791,0,1228,0,0,1228,T
5-NP,792,1,2,1291,0,1294,G
5-NP,793,1315,0,1,0,1316,A
5-NP,794,0,1312,0,1,1313,T
5-NP,795,1316,1,1,0,1318,A
5-NP,796,0,1292,0,0,1292,T
5-NP,797,0,1280,0,0,1280,T
5-NP,798,0,12,1283,0,1295,G
5-NP,799,1281,0,0,0,1281,A
5-NP,800,0,4,1282,0,1286,G
5-NP,801,1226,0,1,0,1227,A
5-NP,802,0,4,1200,0,1204,G
5-NP,803,0,8,1212,0,1220,G
5-NP,804,1216,0,1,0,1217,A
5-NP,805,0,1217,0,0,1217,T
5-NP,806,6,0,0,1212,1218,C
5-NP,807,1210,0,0,0,1210,A
5-NP,808,0,0,1216,0,1216,G
5-NP,809,0,1212,0,0,1212,T
5-NP,810,0,1201,0,1,1202,T
5-NP,811,2,2,1192,0,1196,G
5-NP,812,2,0,0,1176,1178,C
5-NP,813,0,1180,0,1,1181,T
5-NP,814,7,0,0,1182,1189,C
5-NP,815,1186,0,1,0,1187,A
5-NP,816,1,1,0,1184,1186,C
5-NP,817,1177,0,0,0,1177,A
5-NP,818,1180,0,1,0,1181,A
5-NP,819,1183,1,0,0,1184,A
5-NP,820,0,1185,0,0,1185,T
5-NP,821,8,2,0,1179,1189,C
5-NP,822,0,1181,0,2,1183,T
5-NP,823,1,1181,0,0,1182,T
5-NP,824,2,3,1182,0,1187,G
5-NP,825,1,0,0,1186,1187,C
5-NP,826,2,0,1,1198,1201,C
5-NP,827,0,1190,0,2,1192,T
5-NP,828,1192,0,1,0,1193,A
5-NP,829,0,0,0,1195,1195,C
5-NP,830,3,0,0,1190,1193,C
5-NP,831,0,1188,0,0,1188,T
5-NP,832,0,0,1199,1,1200,G
5-NP,833,1,2,0,1195,1198,C
5-NP,834,1,1,0,1197,1199,C
5-NP,835,1,1173,0,1,1175,T
5-NP,836,0,0,1206,0,1206,G
5-NP,837,0,1202,0,1,1203,T
5-NP,838,2,2,1214,1,1219,G
5-NP,839,2,0,0,1218,1220,C
5-NP,840,2,1,1234,0,1237,G
5-NP,841,0,1218,0,0,1218,T
5-NP,842,1213,1,2,0,1216,A
5-NP,843,0,1216,0,0,1216,T
5-NP,844,2,6,1212,0,1220,G
5-NP,845,1,5,1234,0,1240,G
5-NP,846,1233,0,1,0,1234,A
5-NP,847,4,2,0,1205,1211,C
5-NP,848,2,1,0,1205,1208,C
5-NP,849,0,1180,1,2,1183,T
5-NP,850,0,0,1236,1,1237,G
5-NP,851,0,2,0,1235,1237,C
5-NP,852,1233,0,1,0,1234,A
5-NP,853,1,2,1259,0,1262,G
5-NP,854,0,1208,0,1,1209,T
5-NP,855,1243,0,0,0,1243,A
5-NP,856,1,1237,0,4,1242,T
5-NP,857,3,0,0,1235,1238,C
5-NP,858,2,0,0,1238,1240,C
5-NP,859,1175,0,0,0,1175,A
5-NP,860,0,0,1178,1,1179,G
5-NP,861,0,1172,0,0,1172,T
5-NP,862,0,5,1173,0,1178,G
5-NP,863,0,3,1169,0,1172,G
5-NP,864,2,2,1150,0,1154,G
5-NP,865,0,1148,0,1,1149,T
5-NP,866,1142,0,0,0,1142,A
5-NP,867,0,0,0,1139,1139,C
5-NP,868,0,13,1121,0,1134,G
5-NP,869,1130,0,0,0,1130,A
5-NP,870,0,1,0,1131,1132,C
5-NP,871,0,1095,0,2,1097,T
5-NP,872,0,1098,0,0,1098,T
5-NP,873,0,2,0,1086,1088,C
5-NP,874,2,2,1087,0,1091,G
5-NP,875,1092,0,0,0,1092,A
5-NP,876,1090,0,2,0,1092,A
5-NP,877,1092,1,0,1,1094,A
5-NP,878,1093,0,1,0,1094,A
5-NP,879,1094,0,0,0,1094,A
5-NP,880,0,1,1092,0,1093,G
5-NP,881,1091,0,0,0,1091,A
5-NP,882,0,6,1086,0,1092,G
5-NP,883,2,2,1086,1,1091,G
5-NP,884,1,2,1088,0,1091,G
5-NP,885,1095,0,1,1,1097,A
5-NP,886,1,1096,0,0,1097,T
5-NP,887,1105,0,0,0,1105,A
5-NP,888,0,1104,0,1,1105,T
5-NP,889,0,1103,0,0,1103,T
5-NP,890,6,0,0,1104,1110,C
5-NP,891,1,0,0,1106,1107,C
5-NP,892,0,1089,0,1,1090,T
5-NP,893,0,1089,0,0,1089,T
5-NP,894,0,4,1096,0,1100,G
5-NP,895,1,0,1100,0,1101,G
5-NP,896,0,1087,0,1,1088,T
5-NP,897,1,3,1078,0,1082,G
5-NP,898,0,1,1071,0,1072,G
5-NP,899,1,6,1095,0,1102,G
5-NP,900,1099,0,2,0,1101,A
5-NP,901,1102,0,0,0,1102,A
5-NP,902,0,1101,0,0,1101,T
5-NP,903,1082,1,0,0,1083,A
5-NP,904,0,3,1077,0,1080,G
5-NP,905,1067,0,2,0,1069,A
5-NP,906,4,0,0,1066,1070,C
5-NP,907,3,0,0,1058,1061,C
5-NP,908,2,0,0,1024,1026,C
5-NP,909,1,1023,1,0,1025,T
5-NP,910,0,1022,0,0,1022,T
5-NP,911,1,1026,0,0,1027,T
5-NP,912,4,0,0,1028,1032,C
5-NP,913,1029,0,0,0,1029,A
5-NP,914,1026,0,0,0,1026,A
5-NP,915,1025,0,0,0,1025,A
5-NP,916,2,6,0,1011,1019,C
5-NP,917,0,988,0,0,988,T
5-NP,918,974,0,1,0,975,A
5-NP,919,1,0,0,985,986,C
5-NP,920,0,977,0,2,979,T
5-NP,921,0,978,0,0,978,T
5-NP,922,4,1,0,978,983,C
5-NP,923,980,0,0,0,980,A
5-NP,924,980,0,0,0,980,A
5-NP,925,977,0,0,0,977,A
5-NP,926,977,0,0,0,977,A
5-NP,927,0,972,0,0,972,T
5-NP,928,953,0,0,0,953,A
5-NP,929,1,2,963,0,966,G
5-NP,930,4,0,0,962,966,C
5-NP,931,2,0,0,977,979,C
5-NP,932,980,0,1,0,981,A
5-NP,933,982,0,1,0,983,A
5-NP,934,1003,0,0,0,1003,A
5-NP,935,0,1007,0,0,1007,T
5-NP,936,1009,0,1,0,1010,A
5-NP,937,0,1006,0,1,1007,T
5-NP,938,986,0,0,0,986,A
5-NP,939,0,1,0,985,986,C
5-NP,940,961,0,0,0,961,A
5-NP,941,0,0,976,0,976,G
5-NP,942,1,0,0,974,975,C
5-NP,943,0,930,0,0,930,T
5-NP,944,0,937,0,0,937,T
5-NP,945,937,0,1,0,938,A
5-NP,946,935,0,1,1,937,A
5-NP,947,0,934,0,3,937,T
5-NP,948,5,1,0,930,936,C
5-NP,949,888,0,1,0,889,A
5-NP,950,0,5,889,0,894,G
5-NP,951,892,0,1,0,893,A
5-NP,952,1,0,0,893,894,C
5-NP,953,4,0,0,882,886,C
5-NP,954,0,867,0,0,867,T
5-NP,955,872,0,0,0,872,A
5-NP,956,873,0,1,0,874,A
5-NP,957,2,1,0,874,877,C
5-NP,958,0,3,874,0,877,G
5-NP,959,854,0,1,0,855,A
5-NP,960,0,1,850,0,851,G
5-NP,961,842,0,0,0,842,A
5-NP,962,844,1,1,0,846,A
5-NP,963,0,847,0,0,847,T
5-NP,964,5,0,2,826,833,C
5-NP,965,3,0,0,825,828,C
5-NP,966,811,0,1,0,812,A
5-NP,967,0,0,819,0,819,G
5-NP,968,1,0,0,818,819,C
5-NP,969,825,0,0,1,826,A
5-NP,970,1,1,0,822,824,C
5-NP,971,805,0,1,0,806,A
5-NP,972,0,0,0,808,808,C
5-NP,973,803,0,1,0,804,A
5-NP,974,812,0,1,0,813,A
5-NP,975,1,1,810,0,812,G
5-NP,976,795,0,1,0,796,A
5-NP,977,0,0,802,0,802,G
5-NP,978,0,772,0,0,772,T
5-NP,979,6,0,0,761,767,C
5-NP,980,760,0,1,0,761,A
5-NP,981,1,0,755,0,756,G
5-NP,982,0,0,0,757,757,C
5-NP,983,0,744,0,0,744,T
5-NP,984,0,0,744,0,744,G
5-NP,985,0,2,745,0,747,G
5-NP,986,0,736,0,2,738,T
5-NP,987,1,1,738,0,740,G
5-NP,988,0,734,0,1,735,T
5-NP,989,0,2,730,0,732,G
5-NP,990,0,0,729,0,729,G
5-NP,991,717,0,1,0,718,A
5-NP,992,0,716,0,1,717,T
5-NP,993,0,7,669,0,676,G
5-NP,994,0,0,672,0,672,G
5-NP,995,1,0,0,667,668,C
5-NP,996,654,0,0,0,654,A
5-NP,997,0,655,0,0,655,T
5-NP,998,0,0,648,0,648,G
5-NP,999,1,0,1,649,651,C
5-NP,1000,4,1,0,648,653,C
5-NP,1001,652,0,0,0,652,A
5-NP,1002,0,644,0,2,646,T
5-NP,1003,0,633,0,0,633,T
5-NP,1004,2,0,0,636,638,C
5-NP,1005,0,621,0,1,622,T
5-NP,1006,0,1,619,0,620,G
5-NP,1007,1,0,0,622,623,C
5-NP,1008,0,588,0,0,588,T
5-NP,1009,0,0,591,0,591,G
5-NP,1010,0,0,2,563,565,C
5-NP,1011,566,0,0,0,566,A
5-NP,1012,0,562,0,1,563,T
5-NP,1013,0,553,0,1,554,T
5-NP,1014,5,9,0,539,553,C
5-NP,1015,0,3,548,0,551,G
5-NP,1016,548,0,1,0,549,A
5-NP,1017,549,0,1,0,550,A
5-NP,1018,0,4,549,0,553,G
5-NP,1019,556,0,1,0,557,A
5-NP,1020,0,552,0,0,552,T
5-NP,1021,0,554,0,0,554,T
5-NP,1022,0,553,0,0,553,T
5-NP,1023,552,0,0,0,552,A
5-NP,1024,550,0,2,0,552,A
5-NP,1025,0,0,551,0,551,G
5-NP,1026,552,0,0,0,552,A
5-NP,1027,0,541,0,1,542,T
5-NP,1028,0,532,0,0,532,T
5-NP,1029,1,0,531,0,532,G
5-NP,1030,0,533,0,1,534,T
5-NP,1031,0,534,0,0,534,T
5-NP,1032,533,0,1,0,534,A
5-NP,1033,536,0,1,0,537,A
5-NP,1034,1,0,536,0,537,G
5-NP,1035,0,0,0,537,537,C
5-NP,1036,0,515,0,4,519,T
5-NP,1037,0,522,0,1,523,T
5-NP,1038,3,0,0,517,520,C
5-NP,1039,524,0,0,0,524,A
5-NP,1040,0,521,0,1,522,T
5-NP,1041,2,0,0,520,522,C
5-NP,1042,515,0,0,0,515,A
5-NP,1043,0,1,517,0,518,G
5-NP,1044,511,0,0,0,511,A
5-NP,1045,0,1,511,0,512,G
5-NP,1046,0,5,506,0,511,G
5-NP,1047,0,2,511,0,513,G
5-NP,1048,510,0,4,0,514,A
5-NP,1049,0,0,0,513,513,C
5-NP,1050,514,0,1,0,515,A
5-NP,1051,518,0,0,0,518,A
5-NP,1052,515,0,0,0,515,A
5-NP,1053,515,0,2,0,517,A
5-NP,1054,0,0,519,0,519,G
5-NP,1055,0,511,1,2,514,T
5-NP,1056,513,0,0,0,513,A
5-NP,1057,0,508,0,1,509,T
5-NP,1058,2,0,0,507,509,C
5-NP,1059,0,507,0,0,507,T
5-NP,1060,2,0,0,506,508,C
5-NP,1061,2,0,0,502,504,C
5-NP,1062,0,496,0,0,496,T
5-NP,1063,5,1,0,489,495,C
5-NP,1064,0,0,494,0,494,G
5-NP,1065,0,0,498,0,498,G
5-NP,1066,0,2,496,0,498,G
5-NP,1067,0,1,494,0,495,G
5-NP,1068,0,3,489,0,492,G
5-NP,1069,476,0,0,0,476,A
5-NP,1070,478,0,1,0,479,A
5-NP,1071,479,0,1,0,480,A
5-NP,1072,1,0,0,478,479,C
5-NP,1073,0,472,0,1,473,T
5-NP,1074,0,0,475,0,475,G
5-NP,1075,0,465,1,1,467,T
5-NP,1076,6,0,0,464,470,C
5-NP,1077,475,0,1,0,476,A
5-NP,1078,474,0,1,0,475,A
5-NP,1079,0,0,0,477,477,C
5-NP,1080,0,477,0,0,477,T
5-NP,1081,467,0,1,0,468,A
5-NP,1082,0,0,469,0,469,G
5-NP,1083,451,0,1,0,452,A
5-NP,1084,0,0,452,0,452,G
5-NP,1085,0,1,449,0,450,G
5-NP,1086,420,0,1,0,421,A
5-NP,1087,0,1,430,0,431,G
5-NP,1088,0,424,0,0,424,T
5-NP,1089,424,0,0,0,424,A
5-NP,1090,0,0,0,423,423,C
5-NP,1091,420,0,1,0,421,A
5-NP,1092,421,0,0,0,421,A
5-NP,1093,418,0,0,0,418,A
5-NP,1094,1,414,0,0,415,T
5-NP,1095,0,406,0,0,406,T
5-NP,1096,0,0,391,0,391,G
5-NP,1097,0,0,0,387,387,C
5-NP,1098,0,380,0,1,381,T
5-NP,1099,0,385,0,0,385,T
5-NP,1100,1,0,0,384,385,C
5-NP,1101,383,0,2,0,385,A
5-NP,1102,387,0,0,0,387,A
5-NP,1103,388,0,0,0,388,A
5-NP,1104,0,388,0,0,388,T
5-NP,1105,0,1,388,0,389,G
5-NP,1106,378,0,2,0,380,A
5-NP,1107,0,4,379,0,383,G
5-NP,1108,381,0,3,0,384,A
5-NP,1109,383,0,0,0,383,A
5-NP,1110,0,0,0,382,382,C
5-NP,1111,376,1,0,0,377,A
5-NP,1112,0,375,0,0,375,T
5-NP,1113,0,0,379,0,379,G
5-NP,1114,0,0,382,0,382,G
5-NP,1115,381,0,0,0,381,A
5-NP,1116,0,365,0,0,365,T
5-NP,1117,363,0,1,0,364,A
5-NP,1118,385,0,0,0,385,A
5-NP,1119,0,375,0,0,375,T
5-NP,1120,374,0,0,0,374,A
5-NP,1121,0,367,0,0,367,T
5-NP,1122,0,0,339,0,339,G
5-NP,1123,0,0,330,0,330,G
5-NP,1124,0,1,324,0,325,G
5-NP,1125,324,0,0,0,324,A
5-NP,1126,0,323,0,0,323,T
5-NP,1127,1,0,0,259,260,C
5-NP,1128,0,0,259,0,259,G
5-NP,1129,257,0,2,0,259,A
5-NP,1130,0,0,259,0,259,G
5-NP,1131,1,0,0,258,259,C
5-NP,1132,256,0,0,0,256,A
5-NP,1133,1,0,0,264,265,C
5-NP,1134,1,258,0,1,260,T
5-NP,1135,2,0,0,262,264,C
5-NP,1136,0,263,0,0,263,T
5-NP,1137,0,261,0,0,261,T
5-NP,1138,0,1,260,0,261,G
5-NP,1139,260,1,0,0,261,A
5-NP,1140,260,0,1,0,261,A
5-NP,1141,0,0,0,261,261,C
5-NP,1142,0,217,0,0,217,T
5-NP,1143,0,0,219,0,219,G
5-NP,1144,212,0,1,0,213,A
5-NP,1145,0,0,214,0,214,G
5-NP,1146,218,0,0,1,219,A
5-NP,1147,214,0,1,0,215,A
5-NP,1148,0,0,215,0,215,G
5-NP,1149,0,1,1,211,213,C
5-NP,1150,43,0,169,0,212,G
5-NP,1151,0,0,215,0,215,G
5-NP,1152,0,0,208,0,208,G
5-NP,1153,0,210,0,0,210,T
5-NP,1154,202,0,0,0,202,A
5-NP,1155,0,0,0,202,202,C
5-NP,1156,0,173,0,0,173,T
5-NP,1157,0,1,168,0,169,G
5-NP,1158,0,0,164,0,164,G
5-NP,1159,0,0,162,0,162,G
5-NP,1160,0,1,0,162,163,C
5-NP,1161,0,0,0,148,148,C
5-NP,1162,149,0,0,0,149,A
5-NP,1163,0,149,0,0,149,T
5-NP,1164,149,0,0,0,149,A
5-NP,1165,148,0,0,0,148,A
5-NP,1166,0,0,146,0,146,G
5-NP,1167,0,1,150,0,151,G
5-NP,1168,150,0,0,0,150,A
5-NP,1169,0,0,0,148,148,C
5-NP,1170,2,0,0,148,150,C
5-NP,1171,150,0,0,0,150,A
5-NP,1172,0,1,149,0,150,G
5-NP,1173,0,2,150,0,152,G
5-NP,1174,152,0,0,0,152,A
5-NP,1175,0,0,154,0,154,G
5-NP,1176,0,150,0,0,150,T
5-NP,1177,0,0,150,0,150,G
5-NP,1178,0,1,148,0,149,G
5-NP,1179,150,0,0,0,150,A
5-NP,1180,0,0,150,0,150,G
5-NP,1181,0,0,150,0,150,G
5-NP,1182,149,0,0,0,149,A
5-NP,1183,150,0,0,0,150,A
5-NP,1184,149,0,0,0,149,A
5-NP,1185,0,0,0,150,150,C
5-NP,1186,146,0,1,0,147,A
5-NP,1187,0,0,1,149,150,C
5-NP,1188,0,149,0,0,149,T
5-NP,1189,150,0,0,0,150,A
5-NP,1190,150,0,0,0,150,A
5-NP,1191,0,150,0,0,150,T
5-NP,1192,0,0,0,154,154,C
5-NP,1193,149,0,1,0,150,A
5-NP,1194,153,0,0,0,153,A
5-NP,1195,0,1,0,153,154,C
5-NP,1196,148,0,0,0,148,A
5-NP,1197,0,0,148,0,148,G
5-NP,1198,144,0,0,0,144,A
5-NP,1199,0,0,145,0,145,G
5-NP,1200,0,0,144,0,144,G
5-NP,1201,1,0,143,0,144,G
5-NP,1202,0,0,0,145,145,C
5-NP,1203,1,0,0,142,143,C
5-NP,1204,0,139,0,0,139,T
5-NP,1205,0,0,0,144,144,C
5-NP,1206,0,0,0,145,145,C
5-NP,1207,1,0,144,0,145,G
5-NP,1208,0,0,0,145,145,C
5-NP,1209,145,0,0,0,145,A
5-NP,1210,0,0,148,0,148,G
5-NP,1211,0,0,150,0,150,G
5-NP,1212,0,1,0,149,150,C
5-NP,1213,1,0,0,149,150,C
5-NP,1214,149,0,0,0,149,A
5-NP,1215,149,0,0,0,149,A
5-NP,1216,148,0,0,0,148,A
5-NP,1217,0,0,0,149,149,C
5-NP,1218,0,0,0,150,150,C
5-NP,1219,143,0,0,0,143,A
5-NP,1220,0,0,146,0,146,G
5-NP,1221,0,145,0,0,145,T
5-NP,1222,0,0,148,0,148,G
5-NP,1223,0,147,0,0,147,T
5-NP,1224,0,0,146,0,146,G
5-NP,1225,0,0,0,148,148,C
5-NP,1226,145,0,0,0,145,A
5-NP,1227,145,0,0,0,145,A
5-NP,1228,0,0,0,145,145,C
5-NP,1229,1,0,0,141,142,C
5-NP,1230,0,143,0,0,143,T
5-NP,1231,140,0,0,0,140,A
5-NP,1232,0,0,0,138,138,C
5-NP,1233,0,0,140,0,140,G
5-NP,1234,0,140,0,0,140,T
5-NP,1235,0,140,0,0,140,T
5-NP,1236,0,136,0,0,136,T
5-NP,1237,0,136,0,0,136,T
5-NP,1238,1,0,0,135,136,C
5-NP,1239,0,133,0,0,133,T
5-NP,1240,1,0,136,0,137,G
5-NP,1241,0,136,0,0,136,T
5-NP,1242,136,0,1,0,137,A
5-NP,1243,0,0,0,138,138,C
5-NP,1244,133,0,0,0,133,A
5-NP,1245,133,0,1,0,134,A
5-NP,1246,133,0,0,0,133,A
5-NP,1247,0,0,136,0,136,G
5-NP,1248,136,0,0,0,136,A
5-NP,1249,134,0,0,0,134,A
5-NP,1250,134,0,0,1,135,A
5-NP,1251,0,0,0,135,135,C
5-NP,1252,1,0,0,134,135,C
5-NP,1253,0,135,0,0,135,T
5-NP,1254,0,0,0,134,134,C
5-NP,1255,0,0,0,135,135,C
5-NP,1256,2,0,0,132,134,C
5-NP,1257,134,0,0,0,134,A
5-NP,1258,0,133,0,0,133,T
5-NP,1259,0,133,0,0,133,T
5-NP,1260,0,134,0,0,134,T
5-NP,1261,0,0,133,0,133,G
5-NP,1262,133,0,1,0,134,A
5-NP,1263,133,0,0,0,133,A
5-NP,1264,133,0,0,0,133,A
5-NP,1265,133,0,0,0,133,A
5-NP,1266,0,0,136,0,136,G
5-NP,1267,0,135,0,0,135,T
5-NP,1268,3,0,0,132,135,C
5-NP,1269,134,1,0,0,135,A
5-NP,1270,136,0,0,0,136,A
5-NP,1271,0,0,0,136,136,C
5-NP,1272,2,0,0,135,137,C
5-NP,1273,137,0,0,0,137,A
5-NP,1274,0,138,0,0,138,T
5-NP,1275,0,0,0,136,136,C
5-NP,1276,135,0,0,0,135,A
5-NP,1277,0,137,0,0,137,T
5-NP,1278,0,0,137,0,137,G
5-NP,1279,0,0,137,0,137,G
5-NP,1280,0,0,0,137,137,C
5-NP,1281,136,0,0,0,136,A
5-NP,1282,0,1,136,0,137,G
5-NP,1283,0,0,0,136,136,C
5-NP,1284,138,0,0,0,138,A
5-NP,1285,0,138,0,0,138,T
5-NP,1286,0,137,0,0,137,T
5-NP,1287,0,0,0,137,137,C
5-NP,1288,136,0,0,0,136,A
5-NP,1289,0,0,0,138,138,C
5-NP,1290,0,135,0,0,135,T
5-NP,1291,0,0,136,0,136,G
5-NP,1292,0,1,136,0,137,G
5-NP,1293,136,0,0,0,136,A
5-NP,1294,135,0,0,0,135,A
5-NP,1295,135,0,0,0,135,A
5-NP,1296,0,135,0,0,135,T
5-NP,1297,134,0,0,0,134,A
5-NP,1298,0,0,0,134,134,C
5-NP,1299,0,0,132,0,132,G
5-NP,1300,0,0,131,0,131,G
5-NP,1301,130,0,0,0,130,A
5-NP,1302,0,0,132,0,132,G
5-NP,1303,0,1,131,0,132,G
5-NP,1304,0,0,132,0,132,G
5-NP,1305,132,0,1,0,133,A
5-NP,1306,133,0,0,0,133,A
5-NP,1307,0,2,131,0,133,G
5-NP,1308,133,0,0,0,133,A
5-NP,1309,135,0,0,0,135,A
5-NP,1310,0,1,0,133,134,C
5-NP,1311,0,133,0,1,134,T
5-NP,1312,0,136,0,0,136,T
5-NP,1313,0,0,0,136,136,C
5-NP,1314,134,0,2,0,136,A
5-NP,1315,0,0,136,0,136,G
5-NP,1316,133,0,1,0,134,A
5-NP,1317,0,0,0,134,134,C
5-NP,1318,135,0,0,0,135,A
5-NP,1319,0,129,0,0,129,T
5-NP,1320,0,1,127,0,128,G
5-NP,1321,121,0,0,0,121,A
5-NP,1322,0,3,120,0,123,G
5-NP,1323,0,1,122,0,123,G
5-NP,1324,0,0,121,0,121,G
5-NP,1325,0,0,0,121,121,C
5-NP,1326,121,0,0,0,121,A
5-NP,1327,0,0,122,0,122,G
5-NP,1328,122,0,0,0,122,A
5-NP,1329,122,0,0,0,122,A
5-NP,1330,122,0,0,0,122,A
5-NP,1331,0,123,0,0,123,T
5-NP,1332,1,0,0,122,123,C
5-NP,1333,123,0,0,0,123,A
5-NP,1334,0,122,0,0,122,T
5-NP,1335,121,0,0,0,121,A
5-NP,1336,122,1,0,0,123,A
5-NP,1337,0,0,125,0,125,G
5-NP,1338,124,0,0,0,124,A
5-NP,1339,124,0,0,0,124,A
5-NP,1340,0,122,0,0,122,T
5-NP,1341,1,1,119,0,121,G
5-NP,1342,121,0,0,0,121,A
5-NP,1343,0,120,0,0,120,T
5-NP,1344,0,0,121,0,121,G
5-NP,1345,0,0,120,0,120,G
5-NP,1346,116,0,0,0,116,A
5-NP,1347,114,0,0,0,114,A
5-NP,1348,0,0,109,0,109,G
5-NP,1349,0,0,112,0,112,G
5-NP,1350,0,111,0,0,111,T
5-NP,1351,0,0,111,0,111,G
5-NP,1352,1,0,0,110,111,C
5-NP,1353,110,0,0,0,110,A
5-NP,1354,110,0,0,0,110,A
5-NP,1355,111,0,0,0,111,A
5-NP,1356,114,0,0,0,114,A
5-NP,1357,1,0,0,111,112,C
5-NP,1358,0,0,0,114,114,C
5-NP,1359,112,0,0,0,112,A
5-NP,1360,0,0,112,0,112,G
5-NP,1361,112,0,0,0,112,A
5-NP,1362,112,0,0,0,112,A
5-NP,1363,0,0,112,0,112,G
5-NP,1364,110,0,0,0,110,A
5-NP,1365,110,0,0,0,110,A
5-NP,1366,0,0,112,0,112,G
5-NP,1367,0,112,0,0,112,T
5-NP,1368,0,0,111,0,111,G
5-NP,1369,0,112,0,0,112,T
5-NP,1370,2,0,0,110,112,C
5-NP,1371,112,0,0,0,112,A
5-NP,1372,0,111,0,0,111,T
5-NP,1373,0,112,0,0,112,T
5-NP,1374,0,0,0,113,113,C
5-NP,1375,0,0,0,109,109,C
5-NP,1376,0,0,108,0,108,G
5-NP,1377,0,0,110,0,110,G
5-NP,1378,0,0,109,0,109,G
5-NP,1379,0,0,110,0,110,G
5-NP,1380,0,1,109,0,110,G
5-NP,1381,109,0,0,0,109,A
5-NP,1382,1,0,109,0,110,G
5-NP,1383,0,0,110,0,110,G
5-NP,1384,0,1,108,0,109,G
5-NP,1385,0,1,109,0,110,G
5-NP,1386,111,0,0,0,111,A
5-NP,1387,0,1,111,0,112,G
5-NP,1388,0,111,0,0,111,T
5-NP,1389,0,111,0,0,111,T
5-NP,1390,0,111,0,0,111,T
5-NP,1391,0,110,0,0,110,T
5-NP,1392,0,0,0,109,109,C
5-NP,1393,0,0,108,1,109,G
5-NP,1394,109,0,0,0,109,A
5-NP,1395,0,0,110,0,110,G
5-NP,1396,0,0,0,108,108,C
5-NP,1397,0,109,0,0,109,T
5-NP,1398,0,0,0,109,109,C
5-NP,1399,0,109,0,0,109,T
5-NP,1400,1,0,0,108,109,C
5-NP,1401,109,0,0,0,109,A
5-NP,1402,0,0,108,0,108,G
5-NP,1403,108,0,1,0,109,A
5-NP,1404,0,0,0,109,109,C
5-NP,1405,0,0,108,0,108,G
5-NP,1406,105,0,0,0,105,A
5-NP,1407,0,1,103,0,104,G
5-NP,1408,104,0,0,0,104,A
5-NP,1409,102,1,0,0,103,A
5-NP,1410,0,1,103,0,104,G
5-NP,1411,0,0,102,0,102,G
5-NP,1412,0,0,0,101,101,C
5-NP,1413,102,0,0,0,102,A
5-NP,1414,102,0,0,0,102,A
5-NP,1415,0,0,0,103,103,C
5-NP,1416,0,0,102,0,102,G
5-NP,1417,102,0,0,0,102,A
5-NP,1418,101,0,0,0,101,A
5-NP,1419,0,0,0,102,102,C
5-NP,1420,1,0,0,100,101,C
5-NP,1421,1,0,0,100,101,C
5-NP,1422,0,0,100,0,100,G
5-NP,1423,99,1,0,0,100,A
5-NP,1424,0,101,0,0,101,T
5-NP,1425,0,0,0,99,99,C
5-NP,1426,0,1,99,0,100,G
5-NP,1427,0,99,0,0,99,T
5-NP,1428,0,0,99,0,99,G
5-NP,1429,0,0,0,100,100,C
5-NP,1430,1,0,0,99,100,C
5-NP,1431,2,0,0,96,98,C
5-NP,1432,0,97,0,0,97,T
5-NP,1433,0,0,0,103,103,C
5-NP,1434,0,103,0,0,103,T
5-NP,1435,0,101,1,0,102,T
5-NP,1436,0,102,0,0,102,T
5-NP,1437,0,99,0,0,99,T
5-NP,1438,12,0,88,0,100,G
5-NP,1439,99,0,0,0,99,A
5-NP,1440,0,99,0,0,99,T
5-NP,1441,97,0,0,0,97,A
5-NP,1442,0,66,0,0,66,T
5-NP,1443,0,0,65,0,65,G
5-NP,1444,64,0,0,0,64,A
5-NP,1445,0,0,65,0,65,G
5-NP,1446,0,64,0,0,64,T
5-NP,1447,62,0,0,0,62,A
5-NP,1448,62,0,0,0,62,A
5-NP,1449,0,62,0,0,62,T
5-NP,1450,0,1,61,0,62,G
5-NP,1451,60,0,2,0,62,A
5-NP,1452,55,0,0,0,55,A
5-NP,1453,0,0,54,0,54,G
5-NP,1454,0,1,53,0,54,G
5-NP,1455,54,0,0,0,54,A
5-NP,1456,0,52,0,0,52,T
5-NP,1457,0,0,0,53,53,C
5-NP,1458,0,52,0,0,52,T
5-NP,1459,0,52,0,0,52,T
5-NP,1460,52,0,0,0,52,A
5-NP,1461,0,52,0,0,52,T
5-NP,1462,0,51,0,0,51,T
5-NP,1463,0,51,0,0,51,T
5-NP,1464,0,0,0,49,49,C
5-NP,1465,0,47,0,0,47,T
5-NP,1466,0,47,0,0,47,T
5-NP,1467,1,0,0,46,47,C
5-NP,1468,0,0,47,0,47,G
5-NP,1469,0,0,47,0,47,G
5-NP,1470,47,0,0,0,47,A
5-NP,1471,0,0,47,0,47,G
5-NP,1472,46,0,1,0,47,A
5-NP,1473,0,0,0,47,47,C
5-NP,1474,46,0,0,0,46,A
5-NP,1475,46,0,0,0,46,A
5-NP,1476,0,46,0,0,46,T
5-NP,1477,1,0,45,0,46,G
5-NP,1478,0,0,0,46,46,C
5-NP,1479,46,0,0,0,46,A
5-NP,1480,0,0,46,0,46,G
5-NP,1481,42,0,0,3,45,A
5-NP,1482,43,0,0,0,43,A
5-NP,1483,0,0,43,0,43,G
5-NP,1484,29,0,0,0,29,A
5-NP,1485,0,0,26,0,26,G
5-NP,1486,0,22,0,0,22,T
5-NP,1487,22,0,0,0,22,A
5-NP,1488,0,0,0,22,22,C
5-NP,1489,0,0,17,0,17,G
5-NP,1490,15,0,0,0,15,A
5-NP,1491,0,0,0,14,14,C
5-NP,1492,8,0,0,0,8,A
5-NP,1493,8,0,0,0,8,A
5-NP,1494,0,8,0,0,8,T
5-NP,1495,0,7,0,0,7,T
5-NP,1496,7,0,0,0,7,A
5-NP,1497,7,0,0,0,7,A
6-NA,1,16,0,0,0,16,A
6-NA,2,0,16,0,0,16,T
6-NA,3,0,0,17,0,17,G
6-NA,4,17,0,0,0,17,A
6-NA,5,17,0,0,0,17,A
6-NA,6,0,17,0,0,17,T
6-NA,7,0,0,0,17,17,C
6-NA,8,0,0,0,17,17,C
6-NA,9,17,0,0,0,17,A
6-NA,10,19,0,0,0,19,A
6-NA,11,20,0,0,0,20,A
6-NA,12,0,20,0,0,20,T
6-NA,13,0,0,0,20,20,C
6-NA,14,20,0,0,0,20,A
6-NA,15,21,0,0,0,21,A
6-NA,16,21,0,0,0,21,A
6-NA,17,22,0,0,0,22,A
6-NA,18,0,0,23,0,23,G
6-NA,19,24,0,0,0,24,A
6-NA,20,0,24,0,0,24,T
6-NA,21,24,0,0,0,24,A
6-NA,22,25,0,0,0,25,A
6-NA,23,0,25,0,0,25,T
6-NA,24,27,0,0,0,27,A
6-NA,25,27,0,0,0,27,A
6-NA,26,0,0,0,30,30,C
6-NA,27,0,0,31,0,31,G
6-NA,28,31,0,0,0,31,A
6-NA,29,0,31,0,0,31,T
6-NA,30,0,31,0,0,31,T
6-NA,31,0,0,31,0,31,G
6-NA,32,0,0,33,0,33,G
6-NA,33,0,0,0,33,33,C
6-NA,34,0,33,0,0,33,T
6-NA,35,0,0,0,36,36,C
6-NA,36,0,36,0,0,36,T
6-NA,37,0,0,37,0,37,G
6-NA,38,0,37,0,0,37,T
6-NA,39,0,37,0,0,37,T
6-NA,40,0,37,0,0,37,T
6-NA,41,0,0,0,37,37,C
6-NA,42,0,37,0,0,37,T
6-NA,43,0,0,0,37,37,C
6-NA,44,0,37,0,0,37,T
6-NA,45,0,0,0,38,38,C
6-NA,46,38,0,0,0,38,A
6-NA,47,0,0,0,39,39,C
6-NA,48,0,0,0,39,39,C
6-NA,49,39,0,0,0,39,A
6-NA,50,0,39,0,0,39,T
6-NA,51,0,39,0,0,39,T
6-NA,52,0,40,0,0,40,T
6-NA,53,0,0,0,41,41,C
6-NA,54,0,0,0,41,41,C
6-NA,55,42,0,0,0,42,A
6-NA,56,0,0,0,44,44,C
6-NA,57,43,0,1,0,44,A
6-NA,58,50,0,0,0,50,A
6-NA,59,0,50,0,0,50,T
6-NA,60,52,0,0,0,52,A
6-NA,61,0,52,0,0,52,T
6-NA,62,1,0,50,0,51,G
6-NA,63,0,0,0,51,51,C
6-NA,64,0,51,0,0,51,T
6-NA,65,0,49,0,0,49,T
6-NA,66,0,0,0,49,49,C
6-NA,67,0,49,0,0,49,T
6-NA,68,0,49,0,0,49,T
6-NA,69,0,0,0,47,47,C
6-NA,70,47,0,0,0,47,A
6-NA,71,0,47,0,0,47,T
6-NA,72,0,0,47,0,47,G
6-NA,73,0,0,0,47,47,C
6-NA,74,47,0,0,0,47,A
6-NA,75,48,0,0,0,48,A
6-NA,76,48,0,0,0,48,A
6-NA,77,0,48,0,0,48,T
6-NA,78,0,48,0,0,48,T
6-NA,79,0,0,48,0,48,G
6-NA,80,0,0,0,48,48,C
6-NA,81,0,0,0,47,47,C
6-NA,82,48,0,0,0,48,A
6-NA,83,0,48,0,0,48,T
6-NA,84,0,0,0,54,54,C
6-NA,85,0,55,0,0,55,T
6-NA,86,0,55,0,0,55,T
6-NA,87,0,0,59,0,59,G
6-NA,88,59,0,0,0,59,A
6-NA,89,0,60,0,0,60,T
6-NA,90,60,0,0,0,60,A
6-NA,91,61,0,0,0,61,A
6-NA,92,0,0,0,68,68,C
6-NA,93,0,69,0,0,69,T
6-NA,94,71,0,0,0,71,A
6-NA,95,0,0,0,73,73,C
6-NA,96,0,72,0,0,72,T
6-NA,97,0,0,73,0,73,G
6-NA,98,0,73,0,0,73,T
6-NA,99,72,0,0,0,72,A
6-NA,100,72,0,0,1,73,A
6-NA,101,0,0,0,71,71,C
6-NA,102,71,0,0,0,71,A
6-NA,103,0,72,0,0,72,T
6-NA,104,0,68,0,2,70,T
6-NA,105,0,1,68,1,70,G
6-NA,106,0,0,0,70,70,C
6-NA,107,70,0,0,0,70,A
6-NA,108,0,70,0,0,70,T
6-NA,109,0,70,0,0,70,T
6-NA,110,0,70,0,0,70,T
6-NA,111,0,0,0,69,69,C
6-NA,112,69,0,0,0,69,A
6-NA,113,67,0,1,0,68,A
6-NA,114,0,0,69,0,69,G
6-NA,115,0,0,0,69,69,C
6-NA,116,69,0,0,0,69,A
6-NA,117,70,0,0,0,70,A
6-NA,118,0,70,0,0,70,T
6-NA,119,70,0,0,0,70,A
6-NA,120,0,70,0,1,71,T
6-NA,121,0,0,71,0,71,G
6-NA,122,72,0,0,0,72,A
6-NA,123,76,0,0,0,76,A
6-NA,124,0,75,0,0,75,T
6-NA,125,0,75,0,0,75,T
6-NA,126,0,0,0,74,74,C
6-NA,127,74,0,0,0,74,A
6-NA,128,75,0,0,0,75,A
6-NA,129,0,0,0,75,75,C
6-NA,130,0,73,0,1,74,T
6-NA,131,0,0,0,75,75,C
6-NA,132,0,0,0,73,73,C
6-NA,133,0,0,0,76,76,C
6-NA,134,0,0,0,76,76,C
6-NA,135,0,0,0,76,76,C
6-NA,136,0,0,0,77,77,C
6-NA,137,0,0,0,76,76,C
6-NA,138,76,0,0,0,76,A
6-NA,139,75,0,1,0,76,A
6-NA,140,76,0,0,0,76,A
6-NA,141,0,0,0,76,76,C
6-NA,142,73,0,0,0,73,A
6-NA,143,74,0,0,0,74,A
6-NA,144,0,0,0,74,74,C
6-NA,145,0,0,0,75,75,C
6-NA,146,77,0,0,0,77,A
6-NA,147,77,0,0,0,77,A
6-NA,148,0,0,78,0,78,G
6-NA,149,0,77,0,0,77,T
6-NA,150,0,0,78,0,78,G
6-NA,151,78,0,0,0,78,A
6-NA,152,0,77,0,0,77,T
6-NA,153,0,0,78,0,78,G
6-NA,154,0,0,0,78,78,C
6-NA,155,0,78,0,0,78,T
6-NA,156,0,1,85,0,86,G
6-NA,157,0,84,0,0,84,T
6-NA,158,0,0,86,0,86,G
6-NA,159,0,85,0,0,85,T
6-NA,160,0,1,84,0,85,G
6-NA,161,85,0,0,0,85,A
6-NA,162,85,0,0,0,85,A
6-NA,163,0,0,0,85,85,C
6-NA,164,0,0,0,87,87,C
6-NA,165,85,0,0,0,85,A
6-NA,166,85,0,0,0,85,A
6-NA,167,0,0,0,89,89,C
6-NA,168,90,0,0,0,90,A
6-NA,169,91,0,0,0,91,A
6-NA,170,0,90,0,0,90,T
6-NA,171,91,0,0,0,91,A
6-NA,172,91,0,0,0,91,A
6-NA,173,0,90,0,0,90,T
6-NA,174,90,0,0,0,90,A
6-NA,175,0,0,91,0,91,G
6-NA,176,88,0,0,0,88,A
6-NA,177,88,0,0,0,88,A
6-NA,178,86,0,1,0,87,A
6-NA,179,0,2,86,0,88,G
6-NA,180,89,0,0,0,89,A
6-NA,181,89,0,0,0,89,A
6-NA,182,93,0,0,0,93,A
6-NA,183,0,0,0,93,93,C
6-NA,184,93,0,0,0,93,A
6-NA,185,0,94,0,0,94,T
6-NA,186,96,0,0,0,96,A
6-NA,187,96,0,0,0,96,A
6-NA,188,0,0,0,97,97,C
6-NA,189,96,0,0,0,96,A
6-NA,190,0,0,99,0,99,G
6-NA,191,97,0,0,0,97,A
6-NA,192,0,1,98,0,99,G
6-NA,193,99,0,0,0,99,A
6-NA,194,0,100,0,0,100,T
6-NA,195,99,0,0,0,99,A
6-NA,196,0,0,102,0,102,G
6-NA,197,0,101,0,0,101,T
6-NA,198,0,0,102,0,102,G
6-NA,199,0,100,0,0,100,T
6-NA,200,101,0,0,0,101,A
6-NA,201,0,102,0,0,102,T
6-NA,202,0,0,0,102,102,C
6-NA,203,0,102,0,0,102,T
6-NA,204,0,0,106,0,106,G
6-NA,205,105,0,0,0,105,A
6-NA,206,0,0,0,105,105,C
6-NA,207,0,0,0,105,105,C
6-NA,208,105,0,0,0,105,A
6-NA,209,108,0,0,0,108,A
6-NA,210,0,0,0,109,109,C
6-NA,211,108,0,0,0,108,A
6-NA,212,0,0,0,114,114,C
6-NA,213,0,0,0,113,113,C
6-NA,214,118,0,0,0,118,A
6-NA,215,1,0,0,124,125,C
6-NA,216,0,0,0,126,126,C
6-NA,217,126,0,0,0,126,A
6-NA,218,0,127,0,0,127,T
6-NA,219,126,0,0,0,126,A
6-NA,220,0,1,127,0,128,G
6-NA,221,124,0,0,0,124,A
6-NA,222,0,0,126,0,126,G
6-NA,223,124,0,0,0,124,A
6-NA,224,121,0,0,0,121,A
6-NA,225,0,1,121,0,122,G
6-NA,226,0,0,122,0,122,G
6-NA,227,123,0,0,0,123,A
6-NA,228,123,0,0,0,123,A
6-NA,229,123,0,0,0,123,A
6-NA,230,0,121,0,1,122,T
6-NA,231,124,0,0,0,124,A
6-NA,232,0,123,0,0,123,T
6-NA,233,0,0,120,0,120,G
6-NA,234,0,2,0,119,121,C
6-NA,235,0,0,0,121,121,C
6-NA,236,0,0,0,120,120,C
6-NA,237,0,0,0,121,121,C
6-NA,238,122,0,0,0,122,A
6-NA,239,122,0,0,0,122,A
6-NA,240,122,0,0,0,122,A
6-NA,241,0,121,0,0,121,T
6-NA,242,0,120,0,1,121,T
6-NA,243,123,0,0,0,123,A
6-NA,244,0,0,124,0,124,G
6-NA,245,0,0,0,123,123,C
6-NA,246,124,0,0,0,124,A
6-NA,247,0,2,124,0,126,G
6-NA,248,125,0,0,0,125,A
6-NA,249,128,0,0,0,128,A
6-NA,250,0,128,0,0,128,T
6-NA,251,127,0,0,0,127,A
6-NA,252,0,0,0,127,127,C
6-NA,253,126,0,0,0,126,A
6-NA,254,0,0,126,0,126,G
6-NA,255,127,0,0,0,127,A
6-NA,256,124,0,0,0,124,A
6-NA,257,124,0,0,0,124,A
6-NA,258,0,120,0,0,120,T
6-NA,259,0,121,0,0,121,T
6-NA,260,0,1,119,0,120,G
6-NA,261,0,0,119,0,119,G
6-NA,262,0,119,0,0,119,T
6-NA,263,0,0,0,120,120,C
6-NA,264,119,0,0,0,119,A
6-NA,265,119,0,0,0,119,A
6-NA,266,118,0,1,0,119,A
6-NA,267,0,0,120,0,120,G
6-NA,268,0,0,0,122,122,C
6-NA,269,0,0,0,122,122,C
6-NA,270,0,0,122,0,122,G
6-NA,271,0,1,0,121,122,C
6-NA,272,122,0,0,0,122,A
6-NA,273,123,0,0,0,123,A
6-NA,274,0,123,0,0,123,T
6-NA,275,0,0,122,0,122,G
6-NA,276,0,0,0,119,119,C
6-NA,277,0,1,118,0,119,G
6-NA,278,121,0,0,0,121,A
6-NA,279,0,0,0,120,120,C
6-NA,280,119,0,0,0,119,A
6-NA,281,0,127,0,0,127,T
6-NA,282,0,124,0,0,124,T
6-NA,283,127,0,0,0,127,A
6-NA,284,0,0,0,127,127,C
6-NA,285,126,0,0,0,126,A
6-NA,286,0,0,125,0,125,G
6-NA,287,0,2,123,0,125,G
6-NA,288,127,0,0,0,127,A
6-NA,289,0,126,0,0,126,T
6-NA,290,0,123,0,0,123,T
6-NA,291,0,124,0,0,124,T
6-NA,292,1,0,123,0,124,G
6-NA,293,0,0,0,122,122,C
6-NA,294,124,0,0,0,124,A
6-NA,295,0,0,0,125,125,C
6-NA,296,1,0,0,122,123,C
6-NA,297,0,123,0,0,123,T
6-NA,298,0,124,0,0,124,T
6-NA,299,0,124,0,0,124,T
6-NA,300,0,124,0,0,124,T
6-NA,301,0,127,0,0,127,T
6-NA,302,1,0,0,127,128,C
6-NA,303,0,127,0,1,128,T
6-NA,304,127,0,0,0,127,A
6-NA,305,128,0,0,0,128,A
6-NA,306,0,2,130,0,132,G
6-NA,307,0,0,131,0,131,G
6-NA,308,132,0,0,0,132,A
6-NA,309,0,0,0,131,131,C
6-NA,310,131,0,0,0,131,A
6-NA,311,131,0,0,0,131,A
6-NA,312,0,130,0,0,130,T
6-NA,313,0,131,0,0,131,T
6-NA,314,4,0,0,127,131,C
6-NA,315,0,2,128,0,130,G
6-NA,316,129,0,0,0,129,A
6-NA,317,0,129,0,1,130,T
6-NA,318,0,129,0,0,129,T
6-NA,319,128,0,0,0,128,A
6-NA,320,0,0,131,0,131,G
6-NA,321,0,0,130,0,130,G
6-NA,322,0,0,0,130,130,C
6-NA,323,0,125,0,1,126,T
6-NA,324,0,126,0,1,127,T
6-NA,325,0,127,0,0,127,T
6-NA,326,0,0,0,126,126,C
6-NA,327,0,0,0,127,127,C
6-NA,328,0,0,128,0,128,G
6-NA,329,1,0,0,127,128,C
6-NA,330,0,127,0,0,127,T
6-NA,331,0,0,131,0,131,G
6-NA,332,0,0,130,0,130,G
6-NA,333,0,131,0,0,131,T
6-NA,334,0,0,132,0,132,G
6-NA,335,0,0,130,0,130,G
6-NA,336,0,0,131,0,131,G
6-NA,337,0,0,132,0,132,G
6-NA,338,131,0,0,0,131,A
6-NA,339,0,0,0,134,134,C
6-NA,340,129,0,0,0,129,A
6-NA,341,0,129,0,0,129,T
6-NA,342,1,0,0,128,129,C
6-NA,343,0,127,0,1,128,T
6-NA,344,0,0,128,0,128,G
6-NA,345,0,0,127,0,127,G
6-NA,346,0,0,128,0,128,G
6-NA,347,0,125,0,0,125,T
6-NA,348,0,1,118,0,119,G
6-NA,349,120,0,0,0,120,A
6-NA,350,0,0,0,122,122,C
6-NA,351,123,0,0,0,123,A
6-NA,352,122,0,0,0,122,A
6-NA,353,1,0,123,0,124,G
6-NA,354,123,0,0,0,123,A
6-NA,355,0,1,124,1,126,G
6-NA,356,126,0,0,0,126,A
6-NA,357,134,0,0,0,134,A
6-NA,358,0,0,0,155,155,C
6-NA,359,0,0,0,159,159,C
6-NA,360,0,158,0,0,158,T
6-NA,361,0,159,0,0,159,T
6-NA,362,159,0,0,0,159,A
6-NA,363,0,160,0,0,160,T
6-NA,364,0,0,166,0,166,G
6-NA,365,0,168,0,0,168,T
6-NA,366,0,0,167,0,167,G
6-NA,367,0,163,0,1,164,T
6-NA,368,1,0,0,162,163,C
6-NA,369,161,2,0,1,164,A
6-NA,370,0,165,0,0,165,T
6-NA,371,0,2,163,0,165,G
6-NA,372,1,0,0,164,165,C
6-NA,373,0,1,163,0,164,G
6-NA,374,181,0,0,0,181,A
6-NA,375,0,183,0,0,183,T
6-NA,376,0,0,0,189,189,C
6-NA,377,1,0,0,189,190,C
6-NA,378,0,189,0,0,189,T
6-NA,379,0,2,187,0,189,G
6-NA,380,189,0,1,0,190,A
6-NA,381,0,0,0,191,191,C
6-NA,382,190,0,0,0,190,A
6-NA,383,187,0,0,0,187,A
6-NA,384,0,0,196,0,196,G
6-NA,385,0,194,0,0,194,T
6-NA,386,0,0,197,0,197,G
6-NA,387,0,195,0,0,195,T
6-NA,388,0,195,0,0,195,T
6-NA,389,195,0,0,0,195,A
6-NA,390,0,195,0,0,195,T
6-NA,391,0,1,0,196,197,C
6-NA,392,197,0,0,0,197,A
6-NA,393,194,0,0,0,194,A
6-NA,394,0,190,0,0,190,T
6-NA,395,0,189,0,0,189,T
6-NA,396,0,189,0,0,189,T
6-NA,397,0,0,190,0,190,G
6-NA,398,2,0,0,194,196,C
6-NA,399,0,0,0,197,197,C
6-NA,400,0,0,0,197,197,C
6-NA,401,0,194,0,1,195,T
6-NA,402,0,197,0,0,197,T
6-NA,403,0,0,198,0,198,G
6-NA,404,0,2,198,0,200,G
6-NA,405,200,0,0,0,200,A
6-NA,406,0,0,0,200,200,C
6-NA,407,193,0,0,0,193,A
6-NA,408,0,1,199,0,200,G
6-NA,409,0,2,202,0,204,G
6-NA,410,0,1,209,0,210,G
6-NA,411,215,0,0,0,215,A
6-NA,412,212,0,0,0,212,A
6-NA,413,0,0,0,212,212,C
6-NA,414,206,0,0,0,206,A
6-NA,415,229,0,0,0,229,A
6-NA,416,0,1,0,233,234,C
6-NA,417,234,0,0,0,234,A
6-NA,418,0,0,0,240,240,C
6-NA,419,0,236,0,0,236,T
6-NA,420,237,0,0,0,237,A
6-NA,421,234,0,1,0,235,A
6-NA,422,236,0,0,0,236,A
6-NA,423,0,0,0,236,236,C
6-NA,424,228,0,0,0,228,A
6-NA,425,228,0,0,0,228,A
6-NA,426,1,0,0,226,227,C
6-NA,427,0,0,227,0,227,G
6-NA,428,0,226,0,0,226,T
6-NA,429,0,0,225,0,225,G
6-NA,430,0,0,0,227,227,C
6-NA,431,228,0,0,0,228,A
6-NA,432,0,226,0,1,227,T
6-NA,433,0,229,0,0,229,T
6-NA,434,0,0,0,233,233,C
6-NA,435,234,0,0,0,234,A
6-NA,436,234,0,0,0,234,A
6-NA,437,236,0,0,0,236,A
6-NA,438,0,238,0,0,238,T
6-NA,439,0,1,237,0,238,G
6-NA,440,243,0,0,0,243,A
6-NA,441,0,0,0,243,243,C
6-NA,442,241,1,0,0,242,A
6-NA,443,0,0,0,247,247,C
6-NA,444,244,0,0,0,244,A
6-NA,445,0,0,294,0,294,G
6-NA,446,0,295,0,0,295,T
6-NA,447,298,0,0,1,299,A
6-NA,448,0,0,0,299,299,C
6-NA,449,0,1,296,0,297,G
6-NA,450,0,314,0,0,314,T
6-NA,451,0,0,316,0,316,G
6-NA,452,319,0,0,0,319,A
6-NA,453,0,320,0,0,320,T
6-NA,454,295,0,0,0,295,A
6-NA,455,0,1,292,0,293,G
6-NA,456,0,0,292,0,292,G
6-NA,457,296,0,0,0,296,A
6-NA,458,0,0,0,299,299,C
6-NA,459,2,0,0,290,292,C
6-NA,460,0,1,0,295,296,C
6-NA,461,0,0,0,295,295,C
6-NA,462,0,300,0,0,300,T
6-NA,463,0,305,0,0,305,T
6-NA,464,307,0,0,0,307,A
6-NA,465,0,308,0,0,308,T
6-NA,466,0,1,0,305,306,C
6-NA,467,0,0,301,0,301,G
6-NA,468,0,3,299,1,303,G
6-NA,469,301,0,0,0,301,A
6-NA,470,1,1,0,305,307,C
6-NA,471,1,0,0,302,303,C
6-NA,472,1,0,0,315,316,C
6-NA,473,0,316,0,3,319,T
6-NA,474,323,0,0,0,323,A
6-NA,475,0,322,0,1,323,T
6-NA,476,0,322,0,0,322,T
6-NA,477,0,1,321,0,322,G
6-NA,478,319,0,0,0,319,A
6-NA,479,0,316,0,0,316,T
6-NA,480,0,0,316,0,316,G
6-NA,481,308,0,0,0,308,A
6-NA,482,307,0,0,0,307,A
6-NA,483,0,307,0,0,307,T
6-NA,484,0,0,313,0,313,G
6-NA,485,310,0,2,0,312,A
6-NA,486,0,1,318,0,319,G
6-NA,487,0,318,0,0,318,T
6-NA,488,0,320,0,0,320,T
6-NA,489,321,0,0,0,321,A
6-NA,490,0,2,316,0,318,G
6-NA,491,0,1,319,0,320,G
6-NA,492,0,317,0,0,317,T
6-NA,493,0,1,317,0,318,G
6-NA,494,0,318,0,1,319,T
6-NA,495,0,319,0,0,319,T
6-NA,496,2,0,0,320,322,C
6-NA,497,1,0,0,322,323,C
6-NA,498,0,319,0,2,321,T
6-NA,499,0,318,0,2,320,T
6-NA,500,0,320,0,0,320,T
6-NA,501,0,321,0,0,321,T
6-NA,502,1,0,0,319,320,C
6-NA,503,321,0,0,0,321,A
6-NA,504,0,325,0,0,325,T
6-NA,505,1,0,0,324,325,C
6-NA,506,0,322,0,1,323,T
6-NA,507,0,0,321,0,321,G
6-NA,508,0,0,323,0,323,G
6-NA,509,0,2,321,0,323,G
6-NA,510,311,0,1,0,312,A
6-NA,511,318,0,0,0,318,A
6-NA,512,1,0,0,322,323,C
6-NA,513,4,0,0,318,322,C
6-NA,514,322,0,0,0,322,A
6-NA,515,325,0,0,0,325,A
6-NA,516,0,0,326,0,326,G
6-NA,517,0,0,0,327,327,C
6-NA,518,328,0,0,0,328,A
6-NA,519,323,0,0,0,323,A
6-NA,520,0,1,324,0,325,G
6-NA,521,0,324,0,1,325,T
6-NA,522,0,0,332,0,332,G
6-NA,523,0,327,0,1,328,T
6-NA,524,0,0,335,0,335,G
6-NA,525,2,0,0,335,337,C
6-NA,526,336,0,0,0,336,A
6-NA,527,0,340,0,0,340,T
6-NA,528,338,0,0,0,338,A
6-NA,529,0,0,344,0,344,G
6-NA,530,0,0,0,346,346,C
6-NA,531,343,0,0,0,343,A
6-NA,532,0,342,0,0,342,T
6-NA,533,0,1,335,0,336,G
6-NA,534,0,0,365,0,365,G
6-NA,535,0,363,0,1,364,T
6-NA,536,1,0,0,364,365,C
6-NA,537,0,0,0,370,370,C
6-NA,538,377,0,1,0,378,A
6-NA,539,0,0,405,1,406,G
6-NA,540,0,0,0,412,412,C
6-NA,541,0,413,0,0,413,T
6-NA,542,4,1,0,406,411,C
6-NA,543,408,0,0,0,408,A
6-NA,544,416,0,2,0,418,A
6-NA,545,0,1,419,0,420,G
6-NA,546,0,448,0,0,448,T
6-NA,547,0,444,0,1,445,T
6-NA,548,0,0,446,0,446,G
6-NA,549,0,446,0,0,446,T
6-NA,550,4,0,0,443,447,C
6-NA,551,448,0,0,0,448,A
6-NA,552,1,0,0,451,452,C
6-NA,553,0,0,450,0,450,G
6-NA,554,467,0,0,0,467,A
6-NA,555,0,468,0,0,468,T
6-NA,556,1,2,478,0,481,G
6-NA,557,0,5,473,0,478,G
6-NA,558,475,0,0,0,475,A
6-NA,559,480,0,0,0,480,A
6-NA,560,485,0,0,0,485,A
6-NA,561,485,0,1,0,486,A
6-NA,562,0,0,505,0,505,G
6-NA,563,0,0,0,497,497,C
6-NA,564,497,0,1,0,498,A
6-NA,565,0,499,0,2,501,T
6-NA,566,0,2,506,0,508,G
6-NA,567,0,0,513,0,513,G
6-NA,568,0,0,0,522,522,C
6-NA,569,1,520,1,0,522,T
6-NA,570,0,2,524,0,526,G
6-NA,571,1,0,0,525,526,C
6-NA,572,529,0,0,0,529,A
6-NA,573,1,560,0,0,561,T
6-NA,574,0,2,560,0,562,G
6-NA,575,0,570,0,1,571,T
6-NA,576,0,587,1,0,588,T
6-NA,577,1,583,0,2,586,T
6-NA,578,1,0,634,0,635,G
6-NA,579,0,634,0,0,634,T
6-NA,580,636,0,0,0,636,A
6-NA,581,0,641,0,0,641,T
6-NA,582,634,0,1,0,635,A
6-NA,583,633,0,0,0,633,A
6-NA,584,0,0,0,631,631,C
6-NA,585,1,0,627,0,628,G
6-NA,586,0,1,631,0,632,G
6-NA,587,1,1,616,0,618,G
6-NA,588,0,2,616,0,618,G
6-NA,589,0,2,618,0,620,G
6-NA,590,620,1,0,0,621,A
6-NA,591,0,624,0,0,624,T
6-NA,592,0,3,624,0,627,G
6-NA,593,629,0,2,0,631,A
6-NA,594,0,630,0,0,630,T
6-NA,595,628,0,0,0,628,A
6-NA,596,674,0,0,0,674,A
6-NA,597,676,1,1,0,678,A
6-NA,598,680,0,0,0,680,A
6-NA,599,682,0,1,0,683,A
6-NA,600,0,682,0,0,682,T
6-NA,601,0,0,677,0,677,G
6-NA,602,0,2,0,677,679,C
6-NA,603,678,0,0,0,678,A
6-NA,604,683,0,0,0,683,A
6-NA,605,0,0,0,689,689,C
6-NA,606,0,689,0,0,689,T
6-NA,607,0,1,693,0,694,G
6-NA,608,1,0,0,692,693,C
6-NA,609,0,692,0,2,694,T
6-NA,610,694,0,1,0,695,A
6-NA,611,0,1,694,0,695,G
6-NA,612,0,0,0,708,708,C
6-NA,613,0,707,0,2,709,T
6-NA,614,0,705,0,2,707,T
6-NA,615,3,0,0,712,715,C
6-NA,616,722,0,0,0,722,A
6-NA,617,0,722,0,1,723,T
6-NA,618,0,725,0,1,726,T
6-NA,619,0,732,0,0,732,T
6-NA,620,732,0,0,0,732,A
6-NA,621,0,1,0,747,748,C
6-NA,622,742,0,1,0,743,A
6-NA,623,746,0,0,0,746,A
6-NA,624,0,741,0,0,741,T
6-NA,625,0,2,739,0,741,G
6-NA,626,3,2,737,0,742,G
6-NA,627,0,1,739,0,740,G
6-NA,628,739,0,0,0,739,A
6-NA,629,0,3,759,0,762,G
6-NA,630,1,0,765,0,766,G
6-NA,631,1,0,0,810,811,C
6-NA,632,0,812,0,1,813,T
6-NA,633,0,824,0,0,824,T
6-NA,634,0,0,840,0,840,G
6-NA,635,0,839,0,0,839,T
6-NA,636,848,0,4,0,852,A
6-NA,637,0,3,855,0,858,G
6-NA,638,848,0,0,0,848,A
6-NA,639,0,850,0,1,851,T
6-NA,640,815,0,0,0,815,A
6-NA,641,0,0,818,0,818,G
6-NA,642,0,804,0,1,805,T
6-NA,643,0,0,799,0,799,G
6-NA,644,0,843,0,2,845,T
6-NA,645,0,844,0,0,844,T
6-NA,646,0,2,859,0,861,G
6-NA,647,0,854,0,5,859,T
6-NA,648,0,856,0,1,857,T
6-NA,649,1,858,0,0,859,T
6-NA,650,6,0,0,842,848,C
6-NA,651,843,0,0,0,843,A
6-NA,652,1,841,0,0,842,T
6-NA,653,0,1,846,0,847,G
6-NA,654,1,0,895,0,896,G
6-NA,655,0,866,0,0,866,T
6-NA,656,6,0,0,849,855,C
6-NA,657,3,0,0,856,859,C
6-NA,658,862,1,0,0,863,A
6-NA,659,870,0,0,0,870,A
6-NA,660,868,0,0,0,868,A
6-NA,661,0,3,871,1,875,G
6-NA,662,870,0,1,0,871,A
6-NA,663,856,0,1,0,857,A
6-NA,664,862,0,0,0,862,A
6-NA,665,0,858,0,1,859,T
6-NA,666,2,0,0,892,894,C
6-NA,667,2,0,0,892,894,C
6-NA,668,0,890,0,1,891,T
6-NA,669,1,1,0,888,890,C
6-NA,670,887,0,3,0,890,A
6-NA,671,0,1,903,0,904,G
6-NA,672,1,3,901,1,906,G
6-NA,673,923,0,2,0,925,A
6-NA,674,0,2,0,930,932,C
6-NA,675,4,1,0,917,922,C
6-NA,676,3,0,0,914,917,C
6-NA,677,916,0,4,0,920,A
6-NA,678,1,0,922,0,923,G
6-NA,679,1,6,921,0,928,G
6-NA,680,926,1,0,1,928,A
6-NA,681,1,1,927,0,929,G
6-NA,682,0,914,0,1,915,T
6-NA,683,7,0,0,906,913,C
6-NA,684,911,0,0,1,912,A
6-NA,685,0,3,916,0,919,G
6-NA,686,917,0,1,0,918,A
6-NA,687,921,0,0,0,921,A
6-NA,688,1,918,0,1,920,T
6-NA,689,0,1,913,0,914,G
6-NA,690,0,0,0,911,911,C
6-NA,691,902,0,0,0,902,A
6-NA,692,0,927,1,2,930,T
6-NA,693,0,930,0,0,930,T
6-NA,694,0,930,0,0,930,T
6-NA,695,0,2,939,0,941,G
6-NA,696,1,942,0,0,943,T
6-NA,697,945,0,0,0,945,A
6-NA,698,0,941,0,0,941,T
6-NA,699,4,0,0,947,951,C
6-NA,700,949,0,0,0,949,A
6-NA,701,947,0,0,0,947,A
6-NA,702,0,949,0,0,949,T
6-NA,703,1,5,941,0,947,G
6-NA,704,0,5,942,0,947,G
6-NA,705,955,0,0,0,955,A
6-NA,706,952,0,1,0,953,A
6-NA,707,1,0,0,963,964,C
6-NA,708,0,962,0,2,964,T
6-NA,709,0,960,0,0,960,T
6-NA,710,0,1,1005,0,1006,G
6-NA,711,0,1003,0,2,1005,T
6-NA,712,1004,0,0,0,1004,A
6-NA,713,0,1,0,1012,1013,C
6-NA,714,990,0,1,0,991,A
6-NA,715,0,0,1049,0,1049,G
6-NA,716,0,1045,0,0,1045,T
6-NA,717,1087,0,0,0,1087,A
6-NA,718,0,2,1092,0,1094,G
6-NA,719,0,1069,0,2,1071,T
6-NA,720,1069,0,1,0,1070,A
6-NA,721,1073,0,0,0,1073,A
6-NA,722,0,1068,0,0,1068,T
6-NA,723,1,12,1059,0,1072,G
6-NA,724,1053,1,0,0,1054,A
6-NA,725,0,1,0,1068,1069,C
6-NA,726,0,1034,0,0,1034,T
6-NA,727,0,1,1034,0,1035,G
6-NA,728,1031,1,4,0,1036,A
6-NA,729,0,1042,0,1,1043,T
6-NA,730,0,1,1039,1,1041,G
6-NA,731,0,1,1032,0,1033,G
6-NA,732,2,1,1030,0,1033,G
6-NA,733,1004,0,9,0,1013,A
6-NA,734,1,1,1013,0,1015,G
6-NA,735,0,1012,0,1,1013,T
6-NA,736,1,2,1015,0,1018,G
6-NA,737,2,0,0,1019,1021,C
6-NA,738,0,1012,0,2,1014,T
6-NA,739,1,1016,0,1,1018,T
6-NA,740,0,0,0,1011,1011,C
6-NA,741,5,2,1003,0,1010,G
6-NA,742,0,1,1026,0,1027,G
6-NA,743,1,4,1022,0,1027,G
6-NA,744,1022,0,0,0,1022,A
6-NA,745,1018,0,0,0,1018,A
6-NA,746,1016,0,0,1,1017,A
6-NA,747,1021,0,2,0,1023,A
6-NA,748,1,0,1027,1,1029,G
6-NA,749,0,1,0,1026,1027,C
6-NA,750,0,1023,0,0,1023,T
6-NA,751,0,6,1016,0,1022,G
6-NA,752,1019,0,3,0,1022,A
6-NA,753,0,1036,0,0,1036,T
6-NA,754,1034,0,2,0,1036,A
6-NA,755,1,0,0,1101,1102,C
6-NA,756,0,1092,0,0,1092,T
6-NA,757,1097,0,0,0,1097,A
6-NA,758,1098,0,2,0,1100,A
6-NA,759,1096,0,1,0,1097,A
6-NA,760,1126,0,1,0,1127,A
6-NA,761,0,1129,0,1,1130,T
6-NA,762,1125,1,2,0,1128,A
6-NA,763,0,0,0,1130,1130,C
6-NA,764,0,1079,0,0,1079,T
6-NA,765,1089,0,2,0,1091,A
6-NA,766,0,1088,0,2,1090,T
6-NA,767,0,1157,0,1,1158,T
6-NA,768,8,1,0,1164,1173,C
6-NA,769,1162,0,1,0,1163,A
6-NA,770,0,1159,0,1,1160,T
6-NA,771,0,1160,0,1,1161,T
6-NA,772,1143,0,0,0,1143,A
6-NA,773,1146,0,1,1,1148,A
6-NA,774,0,6,1149,0,1155,G
6-NA,775,1,7,1150,0,1158,G
6-NA,776,1095,2,1,1,1099,A
6-NA,777,0,3,1106,0,1109,G
6-NA,778,0,4,1106,1,1111,G
6-NA,779,0,4,1109,0,1113,G
6-NA,780,0,7,1107,0,1114,G
6-NA,781,1110,0,2,0,1112,A
6-NA,782,1107,1,5,0,1113,A
6-NA,783,1110,0,0,1,1111,A
6-NA,784,1102,1,0,1,1104,A
6-NA,785,0,1108,0,0,1108,T
6-NA,786,6,1,0,1090,1097,C
6-NA,787,2,0,1112,0,1114,G
6-NA,788,0,1105,0,0,1105,T
6-NA,789,0,1105,0,0,1105,T
6-NA,790,4,0,0,1101,1105,C
6-NA,791,1077,1,0,1,1079,A
6-NA,792,0,1176,0,0,1176,T
6-NA,793,1175,0,0,1,1176,A
6-NA,794,0,0,1,1178,1179,C
6-NA,795,0,1175,0,0,1175,T
6-NA,796,1174,0,0,0,1174,A
6-NA,797,1,1,1170,0,1172,G
6-NA,798,1,0,0,1168,1169,C
6-NA,799,1169,0,2,1,1172,A
6-NA,800,1,0,0,1177,1178,C
6-NA,801,1124,0,1,0,1125,A
6-NA,802,0,1258,0,0,1258,T
6-NA,803,0,1256,0,1,1257,T
6-NA,804,0,0,1329,1,1330,G
6-NA,805,0,1322,0,0,1322,T
6-NA,806,6,0,0,1316,1322,C
6-NA,807,1319,0,1,0,1320,A
6-NA,808,0,2,1324,0,1326,G
6-NA,809,0,2,1323,0,1325,G
6-NA,810,1321,0,0,0,1321,A
6-NA,811,1305,0,6,0,1311,A
6-NA,812,2,1,1319,0,1322,G
6-NA,813,0,1265,0,0,1265,T
6-NA,814,2,2,1259,0,1263,G
6-NA,815,1,1,0,1267,1269,C
6-NA,816,1,1263,0,0,1264,T
6-NA,817,5,1,0,1263,1269,C
6-NA,818,1264,0,0,0,1264,A
6-NA,819,1,1,1280,0,1282,G
6-NA,820,2,0,2,1280,1284,C
6-NA,821,1276,0,0,0,1276,A
6-NA,822,0,1279,0,1,1280,T
6-NA,823,3,0,1321,0,1324,G
6-NA,824,1,1328,0,0,1329,T
6-NA,825,7,1,0,1319,1327,C
6-NA,826,1,4,1321,0,1326,G
6-NA,827,1315,2,0,0,1317,A
6-NA,828,2,2,1311,0,1315,G
6-NA,829,0,4,1309,0,1313,G
6-NA,830,1300,0,2,0,1302,A
6-NA,831,0,0,1311,0,1311,G
6-NA,832,0,1292,0,2,1294,T
6-NA,833,0,0,1294,0,1294,G
6-NA,834,2,0,0,1303,1305,C
6-NA,835,1,1300,0,1,1302,T
6-NA,836,7,1,0,1312,1320,C
6-NA,837,5,0,1,1317,1323,C
6-NA,838,1,1320,0,1,1322,T
6-NA,839,0,2,1323,0,1325,G
6-NA,840,0,1,0,1319,1320,C
6-NA,841,2,1306,0,0,1308,T
6-NA,842,1318,0,0,0,1318,A
6-NA,843,0,1308,0,0,1308,T
6-NA,844,3,0,0,1318,1321,C
6-NA,845,7,0,0,1305,1312,C
6-NA,846,0,1304,0,2,1306,T
6-NA,847,4,0,0,1317,1321,C
6-NA,848,0,5,1309,0,1314,G
6-NA,849,1332,0,0,0,1332,A
6-NA,850,0,1328,0,1,1329,T
6-NA,851,1318,1,1,0,1320,A
6-NA,852,0,1324,0,2,1326,T
6-NA,853,7,1,1,1314,1323,C
6-NA,854,2,1,0,1312,1315,C
6-NA,855,0,1302,0,1,1303,T
6-NA,856,1,2,1303,0,1306,G
6-NA,857,1,1,1304,0,1306,G
6-NA,858,1,1324,0,0,1325,T
6-NA,859,1,3,1320,0,1324,G
6-NA,860,0,1317,1,1,1319,T
6-NA,861,18,0,0,1301,1319,C
6-NA,862,1311,0,1,1,1313,A
6-NA,863,0,3,1314,0,1317,G
6-NA,864,1312,0,0,0,1312,A
6-NA,865,0,1302,0,1,1303,T
6-NA,866,1,2,1302,0,1305,G
6-NA,867,0,1289,0,1,1290,T
6-NA,868,1,0,1288,0,1289,G
6-NA,869,0,1288,0,1,1289,T
6-NA,870,6,1,1,1288,1296,C
6-NA,871,0,1294,0,2,1296,T
6-NA,872,1,0,1293,0,1294,G
6-NA,873,2,0,0,1295,1297,C
6-NA,874,1288,0,5,0,1293,A
6-NA,875,0,3,1295,0,1298,G
6-NA,876,1273,0,1,0,1274,A
6-NA,877,1,5,1275,0,1281,G
6-NA,878,1277,0,1,0,1278,A
6-NA,879,0,1,0,1285,1286,C
6-NA,880,1277,0,1,0,1278,A
6-NA,881,1277,0,0,0,1277,A
6-NA,882,1,0,0,1305,1306,C
6-NA,883,0,1301,0,1,1302,T
6-NA,884,0,0,1299,0,1299,G
6-NA,885,1,4,1290,0,1295,G
6-NA,886,1291,0,2,0,1293,A
6-NA,887,1291,0,1,0,1292,A
6-NA,888,1266,3,2,0,1271,A
6-NA,889,0,1,1292,0,1293,G
6-NA,890,0,0,1286,0,1286,G
6-NA,891,1,0,0,1290,1291,C
6-NA,892,0,1287,0,0,1287,T
6-NA,893,6,0,1,1304,1311,C
6-NA,894,10,0,0,1304,1314,C
6-NA,895,1315,1,0,0,1316,A
6-NA,896,1314,0,0,0,1314,A
6-NA,897,0,1314,0,2,1316,T
6-NA,898,1280,1,0,0,1281,A
6-NA,899,1,2,1272,0,1275,G
6-NA,900,3,3,1269,0,1275,G
6-NA,901,0,1,0,1282,1283,C
6-NA,902,6,0,0,1249,1255,C
6-NA,903,0,1,0,1237,1238,C
6-NA,904,1245,1,0,0,1246,A
6-NA,905,1,1258,0,2,1261,T
6-NA,906,3,1,0,1256,1260,C
6-NA,907,1,0,1264,0,1265,G
6-NA,908,0,1261,0,0,1261,T
6-NA,909,1245,0,1,0,1246,A
6-NA,910,0,2,1265,0,1267,G
6-NA,911,1271,0,0,0,1271,A
6-NA,912,1,1277,0,1,1279,T
6-NA,913,1264,0,0,0,1264,A
6-NA,914,0,1251,1,0,1252,T
6-NA,915,1259,0,0,0,1259,A
6-NA,916,1251,1,1,1,1254,A
6-NA,917,1276,0,2,2,1280,A
6-NA,918,0,1,0,1307,1308,C
6-NA,919,1276,0,0,0,1276,A
6-NA,920,0,1269,0,0,1269,T
6-NA,921,1259,0,1,0,1260,A
6-NA,922,1259,0,1,0,1260,A
6-NA,923,1259,0,3,0,1262,A
6-NA,924,1,6,1267,0,1274,G
6-NA,925,0,4,1275,0,1279,G
6-NA,926,1235,0,3,0,1238,A
6-NA,927,2,1227,0,1,1230,T
6-NA,928,10,1,0,1226,1237,C
6-NA,929,1245,0,0,0,1245,A
6-NA,930,1,1243,0,1,1245,T
6-NA,931,1241,0,3,0,1244,A
6-NA,932,1,0,1256,0,1257,G
6-NA,933,1,1,0,1229,1231,C
6-NA,934,1209,0,0,0,1209,A
6-NA,935,0,1184,1,1,1186,T
6-NA,936,0,1199,0,0,1199,T
6-NA,937,0,0,1223,1,1224,G
6-NA,938,1,1223,0,0,1224,T
6-NA,939,0,1241,0,1,1242,T
6-NA,940,0,1241,0,3,1244,T
6-NA,941,6,0,1,1227,1234,C
6-NA,942,1,2,0,1236,1239,C
6-NA,943,1251,0,2,0,1253,A
6-NA,944,1,1,1265,0,1267,G
6-NA,945,0,1261,0,0,1261,T
6-NA,946,0,1236,0,1,1237,T
6-NA,947,1244,0,1,0,1245,A
6-NA,948,0,1239,0,1,1240,T
6-NA,949,0,1,1242,0,1243,G
6-NA,950,0,1222,0,1,1223,T
6-NA,951,0,1,1230,0,1231,G
6-NA,952,0,1205,0,3,1208,T
6-NA,953,1,1,1228,0,1230,G
6-NA,954,0,1225,0,3,1228,T
6-NA,955,1,1222,1,1,1225,T
6-NA,956,11,2,1,1210,1224,C
6-NA,957,1216,0,0,0,1216,A
6-NA,958,0,3,1223,1,1227,G
6-NA,959,0,9,1213,0,1222,G
6-NA,960,1211,0,0,0,1211,A
6-NA,961,1,0,0,1219,1220,C
6-NA,962,0,1185,0,1,1186,T
6-NA,963,0,1187,0,1,1188,T
6-NA,964,0,0,1215,0,1215,G
6-NA,965,1,1210,0,2,1213,T
6-NA,966,4,1208,0,1,1213,T
6-NA,967,0,1,1206,0,1207,G
6-NA,968,0,2,1203,0,1205,G
6-NA,969,1208,0,2,0,1210,A
6-NA,970,0,9,1203,0,1212,G
6-NA,971,1200,0,1,0,1201,A
6-NA,972,2,0,0,1192,1194,C
6-NA,973,1169,0,1,0,1170,A
6-NA,974,2,0,0,1170,1172,C
6-NA,975,1176,0,4,0,1180,A
6-NA,976,1,1,0,1176,1178,C
6-NA,977,5,0,0,1170,1175,C
6-NA,978,4,1,0,1175,1180,C
6-NA,979,1182,1,1,0,1184,A
6-NA,980,1,1,1185,0,1187,G
6-NA,981,1181,1,1,0,1183,A
6-NA,982,1188,0,1,0,1189,A
6-NA,983,1179,0,1,0,1180,A
6-NA,984,1182,0,0,0,1182,A
6-NA,985,1172,0,0,0,1172,A
6-NA,986,1168,1,0,0,1169,A
6-NA,987,0,0,0,1174,1174,C
6-NA,988,0,9,1161,0,1170,G
6-NA,989,1168,0,2,0,1170,A
6-NA,990,0,0,0,1169,1169,C
6-NA,991,1165,0,3,0,1168,A
6-NA,992,0,1,1173,0,1174,G
6-NA,993,0,0,0,1207,1207,C
6-NA,994,0,1199,0,3,1202,T
6-NA,995,5,0,0,1203,1208,C
6-NA,996,6,1,0,1206,1213,C
6-NA,997,1214,0,2,0,1216,A
6-NA,998,1,2,1224,0,1227,G
6-NA,999,0,1,1,1227,1229,C
6-NA,1000,1220,0,1,0,1221,A
6-NA,1001,0,1,1220,0,1221,G
6-NA,1002,1,1190,0,2,1193,T
6-NA,1003,1199,0,0,0,1199,A
6-NA,1004,1,1,1191,0,1193,G
6-NA,1005,0,0,0,1193,1193,C
6-NA,1006,4,2,1,1193,1200,C
6-NA,1007,1181,0,1,0,1182,A
6-NA,1008,0,1177,0,1,1178,T
6-NA,1009,0,1176,0,0,1176,T
6-NA,1010,0,0,1203,2,1205,G
6-NA,1011,0,1200,0,0,1200,T
6-NA,1012,0,1198,0,1,1199,T
6-NA,1013,1,1194,0,4,1199,T
6-NA,1014,0,3,1190,0,1193,G
6-NA,1015,0,3,1202,0,1205,G
6-NA,1016,1195,0,1,0,1196,A
6-NA,1017,0,1200,0,1,1201,T
6-NA,1018,7,0,0,1192,1199,C
6-NA,1019,4,0,0,1177,1181,C
6-NA,1020,0,1176,0,2,1178,T
6-NA,1021,1175,0,3,0,1178,A
6-NA,1022,1180,0,0,0,1180,A
6-NA,1023,2,0,0,1201,1203,C
6-NA,1024,1185,1,1,0,1187,A
6-NA,1025,1200,0,1,0,1201,A
6-NA,1026,0,1201,0,0,1201,T
6-NA,1027,0,7,1211,0,1218,G
6-NA,1028,1213,0,2,0,1215,A
6-NA,1029,1202,0,6,1,1209,A
6-NA,1030,0,1,1215,0,1216,G
6-NA,1031,1210,0,1,0,1211,A
6-NA,1032,1181,0,3,0,1184,A
6-NA,1033,0,1,1187,1,1189,G
6-NA,1034,0,1,1191,0,1192,G
6-NA,1035,0,1181,0,1,1182,T
6-NA,1036,0,2,1182,0,1184,G
6-NA,1037,1,1,1209,0,1211,G
6-NA,1038,0,1203,0,3,1206,T
6-NA,1039,10,0,1,1184,1195,C
6-NA,1040,1196,0,0,0,1196,A
6-NA,1041,0,1193,0,0,1193,T
6-NA,1042,3,6,1187,0,1196,G
6-NA,1043,0,5,1201,0,1206,G
6-NA,1044,1190,0,2,0,1192,A
6-NA,1045,0,0,1233,0,1233,G
6-NA,1046,0,1190,0,0,1190,T
6-NA,1047,3,7,1187,0,1197,G
6-NA,1048,1196,0,0,0,1196,A
6-NA,1049,1190,0,1,0,1191,A
6-NA,1050,1187,0,3,1,1191,A
6-NA,1051,0,2,1201,0,1203,G
6-NA,1052,0,2,1194,0,1196,G
6-NA,1053,2,0,0,1190,1192,C
6-NA,1054,0,1165,0,0,1165,T
6-NA,1055,0,1,1163,0,1164,G
6-NA,1056,0,0,1170,0,1170,G
6-NA,1057,1,1,1182,0,1184,G
6-NA,1058,0,1,0,1170,1171,C
6-NA,1059,2,0,0,1179,1181,C
6-NA,1060,0,1166,2,4,1172,T
6-NA,1061,0,1172,0,0,1172,T
6-NA,1062,0,1175,0,0,1175,T
6-NA,1063,0,1,1177,1,1179,G
6-NA,1064,1175,1,1,0,1177,A
6-NA,1065,0,1172,0,0,1172,T
6-NA,1066,0,2,1157,0,1159,G
6-NA,1067,1146,0,3,0,1149,A
6-NA,1068,0,1148,0,2,1150,T
6-NA,1069,1,4,1153,0,1158,G
6-NA,1070,0,3,1171,0,1174,G
6-NA,1071,1171,0,0,0,1171,A
6-NA,1072,1168,1,2,0,1171,A
6-NA,1073,1172,0,0,0,1172,A
6-NA,1074,0,1173,0,0,1173,T
6-NA,1075,2,2,1180,0,1184,G
6-NA,1076,1181,0,2,0,1183,A
6-NA,1077,0,0,0,1180,1180,C
6-NA,1078,2,1,1184,0,1187,G
6-NA,1079,2,1158,1,1,1162,T
6-NA,1080,1,0,1171,0,1172,G
6-NA,1081,0,1170,0,0,1170,T
6-NA,1082,4,3,1164,0,1171,G
6-NA,1083,0,4,1171,0,1175,G
6-NA,1084,1160,0,4,1,1165,A
6-NA,1085,0,1170,0,0,1170,T
6-NA,1086,0,5,1163,1,1169,G
6-NA,1087,3,2,1160,0,1165,G
6-NA,1088,0,5,1168,0,1173,G
6-NA,1089,1166,1,0,0,1167,A
6-NA,1090,1159,0,4,0,1163,A
6-NA,1091,0,4,1164,0,1168,G
6-NA,1092,1157,1,1,0,1159,A
6-NA,1093,1158,1,1,0,1160,A
6-NA,1094,1,1,0,1148,1150,C
6-NA,1095,0,6,1139,0,1145,G
6-NA,1096,1141,0,0,0,1141,A
6-NA,1097,0,1128,0,0,1128,T
6-NA,1098,2,0,0,1126,1128,C
6-NA,1099,1125,0,2,1,1128,A
6-NA,1100,0,0,1133,0,1133,G
6-NA,1101,0,1,0,1126,1127,C
6-NA,1102,2,4,1122,0,1128,G
6-NA,1103,1125,0,2,0,1127,A
6-NA,1104,0,1,1129,0,1130,G
6-NA,1105,1130,0,1,0,1131,A
6-NA,1106,1131,0,1,0,1132,A
6-NA,1107,0,0,1140,0,1140,G
6-NA,1108,0,1131,0,1,1132,T
6-NA,1109,5,0,2,1117,1124,C
6-NA,1110,1124,0,0,0,1124,A
6-NA,1111,1,0,0,1144,1145,C
6-NA,1112,0,0,1148,0,1148,G
6-NA,1113,1,0,0,1143,1144,C
6-NA,1114,0,1144,0,0,1144,T
6-NA,1115,0,1147,0,0,1147,T
6-NA,1116,1132,0,3,0,1135,A
6-NA,1117,0,4,1162,0,1166,G
6-NA,1118,0,6,1156,0,1162,G
6-NA,1119,0,2,1181,0,1183,G
6-NA,1120,0,1128,0,4,1132,T
6-NA,1121,1127,1,0,0,1128,A
6-NA,1122,0,1124,0,0,1124,T
6-NA,1123,0,2,1123,0,1125,G
6-NA,1124,1119,1,0,0,1120,A
6-NA,1125,1119,0,0,0,1119,A
6-NA,1126,1093,0,1,1,1095,A
6-NA,1127,0,0,0,1078,1078,C
6-NA,1128,4,0,0,1021,1025,C
6-NA,1129,1,914,0,3,918,T
6-NA,1130,0,917,1,0,918,T
6-NA,1131,0,0,0,918,918,C
6-NA,1132,919,0,0,0,919,A
6-NA,1133,922,0,0,0,922,A
6-NA,1134,918,0,2,0,920,A
6-NA,1135,0,0,931,0,931,G
6-NA,1136,0,912,0,1,913,T
6-NA,1137,11,0,0,900,911,C
6-NA,1138,923,0,0,0,923,A
6-NA,1139,0,927,0,1,928,T
6-NA,1140,0,929,0,1,930,T
6-NA,1141,0,2,928,0,930,G
6-NA,1142,926,0,2,0,928,A
6-NA,1143,930,1,1,0,932,A
6-NA,1144,0,0,927,0,927,G
6-NA,1145,0,0,923,0,923,G
6-NA,1146,0,0,1,923,924,C
6-NA,1147,1,894,0,2,897,T
6-NA,1148,0,2,902,0,904,G
6-NA,1149,0,1,922,1,924,G
6-NA,1150,0,925,0,1,926,T
6-NA,1151,4,0,0,921,925,C
6-NA,1152,6,0,0,913,919,C
6-NA,1153,917,0,0,0,917,A
6-NA,1154,926,0,1,0,927,A
6-NA,1155,0,1,0,929,930,C
6-NA,1156,3,0,0,913,916,C
6-NA,1157,3,0,0,906,909,C
6-NA,1158,0,869,0,0,869,T
6-NA,1159,866,0,1,0,867,A
6-NA,1160,866,1,1,0,868,A
6-NA,1161,0,2,872,0,874,G
6-NA,1162,0,866,0,3,869,T
6-NA,1163,8,0,0,859,867,C
6-NA,1164,3,1,0,850,854,C
6-NA,1165,854,0,0,0,854,A
6-NA,1166,853,0,1,0,854,A
6-NA,1167,853,0,0,0,853,A
6-NA,1168,0,853,0,0,853,T
6-NA,1169,0,853,0,0,853,T
6-NA,1170,0,0,852,1,853,G
6-NA,1171,0,0,0,844,844,C
6-NA,1172,841,0,0,0,841,A
6-NA,1173,0,0,843,0,843,G
6-NA,1174,841,1,1,0,843,A
6-NA,1175,0,865,0,0,865,T
6-NA,1176,861,0,0,0,861,A
6-NA,1177,860,0,0,0,860,A
6-NA,1178,860,0,1,0,861,A
6-NA,1179,1,855,0,0,856,T
6-NA,1180,848,0,1,0,849,A
6-NA,1181,0,2,851,0,853,G
6-NA,1182,2,2,847,0,851,G
6-NA,1183,2,0,0,849,851,C
6-NA,1184,819,0,0,0,819,A
6-NA,1185,822,0,1,0,823,A
6-NA,1186,0,0,832,0,832,G
6-NA,1187,0,832,0,0,832,T
6-NA,1188,11,1,0,821,833,C
6-NA,1189,833,0,3,0,836,A
6-NA,1190,0,839,0,0,839,T
6-NA,1191,838,0,2,0,840,A
6-NA,1192,0,1,845,0,846,G
6-NA,1193,0,844,0,0,844,T
6-NA,1194,0,818,0,2,820,T
6-NA,1195,0,7,802,0,809,G
6-NA,1196,804,1,0,0,805,A
6-NA,1197,2,0,0,804,806,C
6-NA,1198,792,0,2,0,794,A
6-NA,1199,0,0,802,0,802,G
6-NA,1200,793,0,0,0,793,A
6-NA,1201,0,3,815,0,818,G
6-NA,1202,0,0,821,0,821,G
6-NA,1203,1,818,0,1,820,T
6-NA,1204,819,0,1,0,820,A
6-NA,1205,814,0,0,0,814,A
6-NA,1206,1,818,0,0,819,T
6-NA,1207,819,0,0,0,819,A
6-NA,1208,0,4,805,0,809,G
6-NA,1209,0,1,794,0,795,G
6-NA,1210,1,746,0,0,747,T
6-NA,1211,5,0,0,739,744,C
6-NA,1212,3,2,0,725,730,C
6-NA,1213,1,3,728,0,732,G
6-NA,1214,0,0,731,0,731,G
6-NA,1215,0,726,1,3,730,T
6-NA,1216,0,727,0,1,728,T
6-NA,1217,720,0,0,0,720,A
6-NA,1218,0,713,0,0,713,T
6-NA,1219,0,711,0,0,711,T
6-NA,1220,3,0,0,711,714,C
6-NA,1221,0,682,0,2,684,T
6-NA,1222,0,4,682,0,686,G
6-NA,1223,1,1,685,0,687,G
6-NA,1224,0,687,0,0,687,T
6-NA,1225,686,0,0,0,686,A
6-NA,1226,0,680,0,0,680,T
6-NA,1227,0,679,0,3,682,T
6-NA,1228,1,677,0,3,681,T
6-NA,1229,0,683,0,0,683,T
6-NA,1230,3,1,0,678,682,C
6-NA,1231,0,668,0,1,669,T
6-NA,1232,0,0,0,670,670,C
6-NA,1233,0,663,0,0,663,T
6-NA,1234,0,0,665,0,665,G
6-NA,1235,0,665,0,1,666,T
6-NA,1236,0,663,0,0,663,T
6-NA,1237,0,1,663,0,664,G
6-NA,1238,655,0,0,0,655,A
6-NA,1239,656,0,1,0,657,A
6-NA,1240,0,1,661,0,662,G
6-NA,1241,0,0,658,0,658,G
6-NA,1242,0,0,0,661,661,C
6-NA,1243,652,0,1,0,653,A
6-NA,1244,649,0,0,1,650,A
6-NA,1245,652,0,0,0,652,A
6-NA,1246,653,0,1,0,654,A
6-NA,1247,0,0,657,0,657,G
6-NA,1248,0,0,0,654,654,C
6-NA,1249,0,649,0,0,649,T
6-NA,1250,0,0,658,0,658,G
6-NA,1251,0,1,0,656,657,C
6-NA,1252,660,0,0,0,660,A
6-NA,1253,0,654,0,2,656,T
6-NA,1254,1,0,0,651,652,C
6-NA,1255,651,0,1,0,652,A
6-NA,1256,652,0,0,0,652,A
6-NA,1257,0,652,0,0,652,T
6-NA,1258,4,1,0,647,652,C
6-NA,1259,1,1,643,0,645,G
6-NA,1260,0,0,651,0,651,G
6-NA,1261,0,653,0,0,653,T
6-NA,1262,1,1,652,0,654,G
6-NA,1263,1,2,0,657,660,C
6-NA,1264,0,652,0,3,655,T
6-NA,1265,0,662,0,3,665,T
6-NA,1266,0,663,0,2,665,T
6-NA,1267,0,675,0,0,675,T
6-NA,1268,676,0,0,1,677,A
6-NA,1269,0,654,0,0,654,T
6-NA,1270,1,1,655,0,657,G
6-NA,1271,0,642,0,2,644,T
6-NA,1272,1,2,630,0,633,G
6-NA,1273,0,4,637,0,641,G
6-NA,1274,618,0,1,0,619,A
6-NA,1275,0,0,626,0,626,G
6-NA,1276,0,623,0,1,624,T
6-NA,1277,0,613,0,1,614,T
6-NA,1278,0,3,620,0,623,G
6-NA,1279,618,0,1,0,619,A
6-NA,1280,0,618,0,0,618,T
6-NA,1281,613,0,0,0,613,A
6-NA,1282,585,1,3,0,589,A
6-NA,1283,0,3,592,0,595,G
6-NA,1284,0,2,590,0,592,G
6-NA,1285,0,4,577,0,581,G
6-NA,1286,0,2,580,0,582,G
6-NA,1287,568,0,1,0,569,A
6-NA,1288,566,1,1,0,568,A
6-NA,1289,0,1,571,0,572,G
6-NA,1290,569,0,1,0,570,A
6-NA,1291,567,0,0,0,567,A
6-NA,1292,558,0,0,0,558,A
6-NA,1293,554,0,1,0,555,A
6-NA,1294,0,2,555,0,557,G
6-NA,1295,549,0,1,0,550,A
6-NA,1296,0,1,552,0,553,G
6-NA,1297,1,1,550,0,552,G
6-NA,1298,544,0,0,0,544,A
6-NA,1299,542,0,2,0,544,A
6-NA,1300,545,0,0,0,545,A
6-NA,1301,0,0,0,550,550,C
6-NA,1302,1,548,0,0,549,T
6-NA,1303,2,2,546,0,550,G
6-NA,1304,545,1,2,0,548,A
6-NA,1305,546,1,0,0,547,A
6-NA,1306,0,0,551,0,551,G
6-NA,1307,0,544,0,4,548,T
6-NA,1308,4,0,0,549,553,C
6-NA,1309,0,545,1,0,546,T
6-NA,1310,0,540,0,0,540,T
6-NA,1311,0,0,544,0,544,G
6-NA,1312,0,540,2,0,542,T
6-NA,1313,1,5,536,0,542,G
6-NA,1314,0,3,534,0,537,G
6-NA,1315,524,0,0,0,524,A
6-NA,1316,0,0,0,524,524,C
6-NA,1317,499,0,0,0,499,A
6-NA,1318,0,501,0,1,502,T
6-NA,1319,2,0,0,498,500,C
6-NA,1320,0,2,498,0,500,G
6-NA,1321,512,0,0,0,512,A
6-NA,1322,512,0,0,0,512,A
6-NA,1323,0,0,0,514,514,C
6-NA,1324,506,0,0,0,506,A
6-NA,1325,0,0,532,0,532,G
6-NA,1326,0,523,0,1,524,T
6-NA,1327,528,0,0,0,528,A
6-NA,1328,0,529,0,0,529,T
6-NA,1329,0,506,0,0,506,T
6-NA,1330,1,0,505,0,506,G
6-NA,1331,0,506,1,1,508,T
6-NA,1332,0,493,1,2,496,T
6-NA,1333,1,1,492,0,494,G
6-NA,1334,1,444,0,0,445,T
6-NA,1335,1,0,443,0,444,G
6-NA,1336,0,442,1,2,445,T
6-NA,1337,1,436,0,1,438,T
6-NA,1338,1,437,0,0,438,T
6-NA,1339,0,430,0,0,430,T
6-NA,1340,1,0,431,0,432,G
6-NA,1341,1,427,0,0,428,T
6-NA,1342,0,1,425,0,426,G
6-NA,1343,0,0,429,0,429,G
6-NA,1344,1,1,0,421,423,C
6-NA,1345,417,0,0,0,417,A
6-NA,1346,1,0,0,422,423,C
6-NA,1347,0,0,0,423,423,C
6-NA,1348,0,421,0,0,421,T
6-NA,1349,2,0,0,420,422,C
6-NA,1350,418,0,0,0,418,A
6-NA,1351,0,0,425,0,425,G
6-NA,1352,0,0,425,0,425,G
6-NA,1353,1,425,0,0,426,T
6-NA,1354,426,0,0,0,426,A
6-NA,1355,1,0,0,416,417,C
6-NA,1356,414,0,1,0,415,A
6-NA,1357,0,413,0,1,414,T
6-NA,1358,408,0,0,0,408,A
6-NA,1359,0,405,0,0,405,T
6-NA,1360,0,1,379,0,380,G
6-NA,1361,0,1,378,0,379,G
6-NA,1362,373,0,0,0,373,A
6-NA,1363,370,0,0,0,370,A
6-NA,1364,0,0,0,368,368,C
6-NA,1365,314,0,0,0,314,A
6-NA,1366,0,0,313,0,313,G
6-NA,1367,0,0,310,0,310,G
6-NA,1368,0,0,0,311,311,C
6-NA,1369,0,309,0,0,309,T
6-NA,1370,3,1,0,292,296,C
6-NA,1371,294,0,0,0,294,A
6-NA,1372,0,295,0,0,295,T
6-NA,1373,0,0,293,0,293,G
6-NA,1374,0,2,291,0,293,G
6-NA,1375,0,1,0,283,284,C
6-NA,1376,0,0,0,278,278,C
6-NA,1377,0,267,0,0,267,T
6-NA,1378,0,0,267,0,267,G
6-NA,1379,265,0,0,0,265,A
6-NA,1380,1,264,0,0,265,T
6-NA,1381,0,1,259,0,260,G
6-NA,1382,0,2,254,0,256,G
6-NA,1383,0,1,237,0,238,G
6-NA,1384,0,0,235,0,235,G
6-NA,1385,0,0,0,231,231,C
6-NA,1386,0,2,229,0,231,G
6-NA,1387,0,1,227,0,228,G
6-NA,1388,226,0,0,0,226,A
6-NA,1389,0,0,0,225,225,C
6-NA,1390,220,0,0,0,220,A
6-NA,1391,0,218,0,0,218,T
6-NA,1392,1,0,0,214,215,C
6-NA,1393,209,0,1,0,210,A
6-NA,1394,213,0,0,0,213,A
6-NA,1395,0,212,0,0,212,T
6-NA,1396,1,0,0,208,209,C
6-NA,1397,0,201,0,0,201,T
6-NA,1398,4,0,0,171,175,C
6-NA,1399,173,0,0,0,173,A
6-NA,1400,0,171,0,0,171,T
6-NA,1401,0,0,171,0,171,G
6-NA,1402,0,0,0,167,167,C
6-NA,1403,0,0,0,162,162,C
6-NA,1404,0,145,1,0,146,T
6-NA,1405,146,0,0,0,146,A
6-NA,1406,0,145,0,0,145,T
6-NA,1407,143,0,0,0,143,A
6-NA,1408,0,143,0,0,143,T
6-NA,1409,131,0,0,0,131,A
6-NA,1410,126,0,0,0,126,A
7-M,1,22,0,0,0,22,A
7-M,2,0,22,0,0,22,T
7-M,3,0,0,22,0,22,G
7-M,4,22,0,0,0,22,A
7-M,5,0,0,21,0,21,G
7-M,6,0,0,0,24,24,C
7-M,7,0,0,0,25,25,C
7-M,8,0,27,0,0,27,T
7-M,9,0,27,0,0,27,T
7-M,10,0,0,0,26,26,C
7-M,11,0,28,0,0,28,T
7-M,12,28,0,0,0,28,A
7-M,13,28,0,0,0,28,A
7-M,14,0,0,0,27,27,C
7-M,15,0,0,0,28,28,C
7-M,16,0,0,28,0,28,G
7-M,17,27,0,0,0,27,A
7-M,18,0,0,31,0,31,G
7-M,19,0,0,33,0,33,G
7-M,20,0,33,0,0,33,T
7-M,21,0,0,0,33,33,C
7-M,22,0,0,33,0,33,G
7-M,23,32,0,0,0,32,A
7-M,24,32,0,0,0,32,A
7-M,25,32,0,0,0,32,A
7-M,26,0,0,0,40,40,C
7-M,27,0,0,39,0,39,G
7-M,28,0,40,0,0,40,T
7-M,29,38,0,0,0,38,A
7-M,30,0,40,0,0,40,T
7-M,31,0,0,40,0,40,G
7-M,32,0,40,0,0,40,T
7-M,33,0,43,0,0,43,T
7-M,34,0,0,0,43,43,C
7-M,35,0,42,0,0,42,T
7-M,36,0,0,0,45,45,C
7-M,37,0,45,0,0,45,T
7-M,38,1,0,0,47,48,C
7-M,39,0,48,0,0,48,T
7-M,40,49,0,0,0,49,A
7-M,41,0,49,0,0,49,T
7-M,42,0,0,0,50,50,C
7-M,43,0,0,50,0,50,G
7-M,44,0,54,0,0,54,T
7-M,45,0,53,0,0,53,T
7-M,46,0,0,0,55,55,C
7-M,47,0,0,0,55,55,C
7-M,48,55,0,0,0,55,A
7-M,49,0,55,0,0,55,T
7-M,50,0,0,0,56,56,C
7-M,51,56,0,0,0,56,A
7-M,52,0,0,55,1,56,G
7-M,53,0,0,55,0,55,G
7-M,54,0,0,0,55,55,C
7-M,55,1,0,0,53,54,C
7-M,56,0,0,0,55,55,C
7-M,57,0,0,0,59,59,C
7-M,58,0,0,0,58,58,C
7-M,59,0,58,0,0,58,T
7-M,60,0,0,0,58,58,C
7-M,61,57,0,0,0,57,A
7-M,62,59,0,0,0,59,A
7-M,63,59,0,0,0,59,A
7-M,64,0,0,60,0,60,G
7-M,65,0,0,0,61,61,C
7-M,66,0,0,0,60,60,C
7-M,67,0,0,59,0,59,G
7-M,68,61,0,0,0,61,A
7-M,69,0,2,59,0,61,G
7-M,70,61,0,0,0,61,A
7-M,71,0,60,0,0,60,T
7-M,72,1,1,0,59,61,C
7-M,73,1,0,57,0,58,G
7-M,74,0,0,0,60,60,C
7-M,75,0,0,61,0,61,G
7-M,76,0,0,0,61,61,C
7-M,77,59,0,0,0,59,A
7-M,78,0,0,61,0,61,G
7-M,79,61,0,0,0,61,A
7-M,80,0,0,65,0,65,G
7-M,81,66,0,0,0,66,A
7-M,82,0,0,0,69,69,C
7-M,83,0,70,0,0,70,T
7-M,84,0,69,0,0,69,T
7-M,85,0,0,70,0,70,G
7-M,86,71,0,0,0,71,A
7-M,87,70,0,1,0,71,A
7-M,88,0,0,70,0,70,G
7-M,89,70,0,0,0,70,A
7-M,90,0,73,0,0,73,T
7-M,91,0,0,75,0,75,G
7-M,92,0,75,0,0,75,T
7-M,93,0,0,0,75,75,C
7-M,94,0,75,0,0,75,T
7-M,95,0,75,0,0,75,T
7-M,96,0,74,0,0,74,T
7-M,97,0,0,75,0,75,G
7-M,98,0,0,0,75,75,C
7-M,99,0,75,0,0,75,T
7-M,100,0,0,75,0,75,G
7-M,101,0,0,78,0,78,G
7-M,102,0,0,78,0,78,G
7-M,103,78,0,0,0,78,A
7-M,104,77,0,0,0,77,A
7-M,105,79,0,0,0,79,A
7-M,106,79,0,0,0,79,A
7-M,107,81,0,0,0,81,A
7-M,108,0,0,0,81,81,C
7-M,109,79,0,1,0,80,A
7-M,110,0,0,0,81,81,C
7-M,111,79,0,0,0,79,A
7-M,112,0,0,80,0,80,G
7-M,113,80,0,0,0,80,A
7-M,114,0,81,0,0,81,T
7-M,115,1,0,0,80,81,C
7-M,116,0,81,0,0,81,T
7-M,117,0,81,0,0,81,T
7-M,118,0,0,80,0,80,G
7-M,119,81,0,0,0,81,A
7-M,120,0,0,81,0,81,G
7-M,121,0,0,79,0,79,G
7-M,122,0,0,0,81,81,C
7-M,123,0,80,0,0,80,T
7-M,124,0,0,0,84,84,C
7-M,125,0,83,0,0,83,T
7-M,126,2,0,0,82,84,C
7-M,127,84,0,0,0,84,A
7-M,128,0,85,0,0,85,T
7-M,129,0,1,84,0,85,G
7-M,130,0,0,85,0,85,G
7-M,131,85,0,0,0,85,A
7-M,132,84,0,0,0,84,A
7-M,133,0,82,0,0,82,T
7-M,134,0,0,82,0,82,G
7-M,135,0,0,82,0,82,G
7-M,136,0,0,0,84,84,C
7-M,137,0,83,0,0,83,T
7-M,138,83,0,1,0,84,A
7-M,139,80,0,0,0,80,A
7-M,140,81,0,1,0,82,A
7-M,141,0,1,83,0,84,G
7-M,142,81,0,1,0,82,A
7-M,143,0,0,0,82,82,C
7-M,144,81,0,0,0,81,A
7-M,145,80,0,0,0,80,A
7-M,146,0,0,81,0,81,G
7-M,147,82,0,0,0,82,A
7-M,148,0,0,0,82,82,C
7-M,149,0,0,0,81,81,C
7-M,150,82,0,0,0,82,A
7-M,151,81,0,0,0,81,A
7-M,152,0,82,0,0,82,T
7-M,153,0,82,0,0,82,T
7-M,154,1,0,0,82,83,C
7-M,155,0,83,0,0,83,T
7-M,156,0,0,82,0,82,G
7-M,157,0,83,0,0,83,T
7-M,158,1,0,0,82,83,C
7-M,159,83,0,0,0,83,A
7-M,160,0,0,0,88,88,C
7-M,161,0,0,0,88,88,C
7-M,162,0,88,0,0,88,T
7-M,163,0,0,0,88,88,C
7-M,164,0,89,0,0,89,T
7-M,165,0,0,90,0,90,G
7-M,166,90,0,0,0,90,A
7-M,167,0,0,0,89,89,C
7-M,168,0,88,0,0,88,T
7-M,169,87,0,0,0,87,A
7-M,170,87,0,0,0,87,A
7-M,171,0,0,89,0,89,G
7-M,172,0,0,89,0,89,G
7-M,173,0,1,88,0,89,G
7-M,174,0,1,90,0,91,G
7-M,175,91,0,0,0,91,A
7-M,176,0,91,0,0,91,T
7-M,177,0,90,0,0,90,T
7-M,178,0,89,0,0,89,T
7-M,179,0,89,0,0,89,T
7-M,180,0,0,88,0,88,G
7-M,181,0,0,89,0,89,G
7-M,182,0,0,89,0,89,G
7-M,183,0,0,90,0,90,G
7-M,184,0,90,0,0,90,T
7-M,185,0,90,0,0,90,T
7-M,186,0,90,0,0,90,T
7-M,187,0,0,93,0,93,G
7-M,188,0,92,0,0,92,T
7-M,189,0,0,93,0,93,G
7-M,190,0,93,0,0,93,T
7-M,191,0,91,0,0,91,T
7-M,192,1,0,0,90,91,C
7-M,193,92,0,0,0,92,A
7-M,194,0,0,0,92,92,C
7-M,195,0,0,92,0,92,G
7-M,196,0,0,0,93,93,C
7-M,197,0,89,0,0,89,T
7-M,198,0,0,0,90,90,C
7-M,199,90,0,0,0,90,A
7-M,200,0,0,0,91,91,C
7-M,201,0,0,0,91,91,C
7-M,202,0,0,91,0,91,G
7-M,203,0,92,0,0,92,T
7-M,204,0,0,93,0,93,G
7-M,205,0,0,0,92,92,C
7-M,206,0,0,0,92,92,C
7-M,207,1,0,0,94,95,C
7-M,208,94,0,0,0,94,A
7-M,209,0,0,97,0,97,G
7-M,210,0,96,0,1,97,T
7-M,211,0,1,97,0,98,G
7-M,212,100,0,0,0,100,A
7-M,213,0,0,100,0,100,G
7-M,214,0,1,0,98,99,C
7-M,215,0,0,100,0,100,G
7-M,216,99,0,0,0,99,A
7-M,217,0,1,99,0,100,G
7-M,218,0,0,101,0,101,G
7-M,219,99,0,0,1,100,A
7-M,220,0,0,0,100,100,C
7-M,221,0,100,0,0,100,T
7-M,222,0,1,99,0,100,G
7-M,223,0,1,0,99,100,C
7-M,224,101,0,0,0,101,A
7-M,225,0,0,103,0,103,G
7-M,226,0,0,0,104,104,C
7-M,227,0,0,104,0,104,G
7-M,228,0,104,0,0,104,T
7-M,229,104,0,0,0,104,A
7-M,230,0,0,103,0,103,G
7-M,231,104,0,0,0,104,A
7-M,232,0,0,0,105,105,C
7-M,233,0,0,105,0,105,G
7-M,234,0,0,0,104,104,C
7-M,235,0,103,0,0,103,T
7-M,236,0,103,0,0,103,T
7-M,237,0,100,0,1,101,T
7-M,238,0,0,105,0,105,G
7-M,239,0,105,0,0,105,T
7-M,240,2,0,0,103,105,C
7-M,241,0,0,0,105,105,C
7-M,242,104,0,0,0,104,A
7-M,243,105,0,0,0,105,A
7-M,244,105,0,0,0,105,A
7-M,245,105,0,0,0,105,A
7-M,246,0,105,0,0,105,T
7-M,247,0,0,103,0,103,G
7-M,248,0,0,0,103,103,C
7-M,249,0,0,0,103,103,C
7-M,250,0,0,0,103,103,C
7-M,251,0,101,0,1,102,T
7-M,252,0,0,0,103,103,C
7-M,253,101,1,0,0,102,A
7-M,254,104,0,0,0,104,A
7-M,255,1,104,0,0,105,T
7-M,256,0,0,104,0,104,G
7-M,257,0,0,105,0,105,G
7-M,258,0,0,106,0,106,G
7-M,259,105,0,0,0,105,A
7-M,260,105,0,0,0,105,A
7-M,261,0,103,0,0,103,T
7-M,262,0,3,100,0,103,G
7-M,263,1,1,101,0,103,G
7-M,264,101,0,0,0,101,A
7-M,265,1,0,100,0,101,G
7-M,266,100,0,0,0,100,A
7-M,267,1,0,0,98,99,C
7-M,268,0,0,0,100,100,C
7-M,269,0,0,0,102,102,C
7-M,270,105,0,0,0,105,A
7-M,271,105,0,0,0,105,A
7-M,272,104,0,0,0,104,A
7-M,273,0,105,0,0,105,T
7-M,274,110,0,0,0,110,A
7-M,275,110,0,0,0,110,A
7-M,276,0,0,0,105,105,C
7-M,277,105,0,0,0,105,A
7-M,278,0,106,0,0,106,T
7-M,279,0,0,106,0,106,G
7-M,280,0,0,106,0,106,G
7-M,281,107,0,0,0,107,A
7-M,282,0,0,0,107,107,C
7-M,283,103,0,0,0,103,A
7-M,284,104,0,0,0,104,A
7-M,285,104,0,0,0,104,A
7-M,286,0,0,105,0,105,G
7-M,287,0,0,0,110,110,C
7-M,288,110,0,0,0,110,A
7-M,289,0,0,110,0,110,G
7-M,290,0,110,0,0,110,T
7-M,291,0,110,0,0,110,T
7-M,292,111,0,0,0,111,A
7-M,293,111,0,0,0,111,A
7-M,294,110,0,1,0,111,A
7-M,295,0,0,0,111,111,C
7-M,296,0,108,0,0,108,T
7-M,297,0,0,120,0,120,G
7-M,298,0,118,0,0,118,T
7-M,299,119,0,0,0,119,A
7-M,300,0,119,0,0,119,T
7-M,301,117,0,0,0,117,A
7-M,302,0,1,116,0,117,G
7-M,303,107,0,0,0,107,A
7-M,304,107,0,0,0,107,A
7-M,305,107,0,0,0,107,A
7-M,306,105,0,1,0,106,A
7-M,307,0,0,0,107,107,C
7-M,308,0,105,0,0,105,T
7-M,309,0,105,0,0,105,T
7-M,310,104,0,1,0,105,A
7-M,311,104,0,0,0,104,A
7-M,312,0,0,105,0,105,G
7-M,313,105,0,0,0,105,A
7-M,314,0,0,105,0,105,G
7-M,315,0,2,105,0,107,G
7-M,316,0,0,109,0,109,G
7-M,317,109,0,1,0,110,A
7-M,318,0,0,111,0,111,G
7-M,319,110,0,1,0,111,A
7-M,320,0,111,0,0,111,T
7-M,321,110,0,0,0,110,A
7-M,322,113,0,0,0,113,A
7-M,323,0,0,0,112,112,C
7-M,324,0,0,113,0,113,G
7-M,325,0,114,0,0,114,T
7-M,326,0,114,0,0,114,T
7-M,327,0,0,0,113,113,C
7-M,328,1,0,0,110,111,C
7-M,329,113,0,0,0,113,A
7-M,330,0,113,0,0,113,T
7-M,331,0,1,109,0,110,G
7-M,332,0,1,110,0,111,G
7-M,333,0,0,110,0,110,G
7-M,334,0,1,110,0,111,G
7-M,335,0,0,0,112,112,C
7-M,336,0,0,0,111,111,C
7-M,337,110,0,1,0,111,A
7-M,338,112,0,0,0,112,A
7-M,339,112,0,0,0,112,A
7-M,340,0,1,111,0,112,G
7-M,341,110,0,0,0,110,A
7-M,342,111,0,0,0,111,A
7-M,343,109,0,0,0,109,A
7-M,344,0,109,0,0,109,T
7-M,345,109,0,0,0,109,A
7-M,346,0,0,110,0,110,G
7-M,347,0,0,0,110,110,C
7-M,348,0,109,0,0,109,T
7-M,349,0,0,0,109,109,C
7-M,350,0,107,0,0,107,T
7-M,351,0,0,0,110,110,C
7-M,352,110,0,0,0,110,A
7-M,353,0,0,108,0,108,G
7-M,354,0,106,0,0,106,T
7-M,355,0,110,0,0,110,T
7-M,356,110,0,0,0,110,A
7-M,357,0,110,0,0,110,T
7-M,358,0,109,0,0,109,T
7-M,359,2,0,0,109,111,C
7-M,360,0,108,0,0,108,T
7-M,361,0,0,107,0,107,G
7-M,362,1,0,0,106,107,C
7-M,363,0,106,0,1,107,T
7-M,364,0,0,108,0,108,G
7-M,365,0,0,109,0,109,G
7-M,366,0,108,0,0,108,T
7-M,367,0,0,108,0,108,G
7-M,368,0,0,0,108,108,C
7-M,369,108,0,0,0,108,A
7-M,370,0,0,0,111,111,C
7-M,371,0,109,0,0,109,T
7-M,372,0,111,0,0,111,T
7-M,373,0,0,108,1,109,G
7-M,374,0,0,0,107,107,C
7-M,375,0,0,0,109,109,C
7-M,376,110,0,0,0,110,A
7-M,377,0,0,109,0,109,G
7-M,378,0,110,0,0,110,T
7-M,379,0,110,0,0,110,T
7-M,380,0,0,110,0,110,G
7-M,381,0,0,0,111,111,C
7-M,382,110,0,0,0,110,A
7-M,383,0,111,0,0,111,T
7-M,384,0,0,109,0,109,G
7-M,385,0,1,110,0,111,G
7-M,386,0,0,116,0,116,G
7-M,387,0,0,0,116,116,C
7-M,388,0,0,0,120,120,C
7-M,389,0,121,0,0,121,T
7-M,390,0,0,0,122,122,C
7-M,391,126,0,2,0,128,A
7-M,392,0,129,0,0,129,T
7-M,393,132,0,0,0,132,A
7-M,394,0,127,0,0,127,T
7-M,395,127,0,0,0,127,A
7-M,396,0,0,0,132,132,C
7-M,397,127,0,1,0,128,A
7-M,398,127,0,0,0,127,A
7-M,399,0,125,0,0,125,T
7-M,400,120,0,0,0,120,A
7-M,401,0,0,122,0,122,G
7-M,402,0,0,122,0,122,G
7-M,403,122,0,0,0,122,A
7-M,404,0,122,0,0,122,T
7-M,405,0,0,117,0,117,G
7-M,406,0,0,117,0,117,G
7-M,407,0,0,113,0,113,G
7-M,408,0,0,117,0,117,G
7-M,409,0,0,117,0,117,G
7-M,410,0,0,0,117,117,C
7-M,411,0,116,0,1,117,T
7-M,412,0,0,118,0,118,G
7-M,413,0,119,0,0,119,T
7-M,414,119,0,0,0,119,A
7-M,415,119,0,0,0,119,A
7-M,416,0,0,0,122,122,C
7-M,417,1,0,0,118,119,C
7-M,418,117,0,0,0,117,A
7-M,419,0,0,0,120,120,C
7-M,420,0,119,0,1,120,T
7-M,421,0,0,121,0,121,G
7-M,422,122,0,0,0,122,A
7-M,423,122,0,0,0,122,A
7-M,424,0,0,123,0,123,G
7-M,425,0,122,0,1,123,T
7-M,426,0,0,123,0,123,G
7-M,427,0,0,122,0,122,G
7-M,428,0,0,0,124,124,C
7-M,429,123,0,0,0,123,A
7-M,430,0,122,0,0,122,T
7-M,431,0,121,0,0,121,T
7-M,432,0,121,0,0,121,T
7-M,433,0,3,119,0,122,G
7-M,434,0,1,121,0,122,G
7-M,435,0,0,0,121,121,C
7-M,436,0,1,0,121,122,C
7-M,437,0,122,0,0,122,T
7-M,438,0,0,130,0,130,G
7-M,439,0,0,130,0,130,G
7-M,440,0,130,0,0,130,T
7-M,441,131,0,0,0,131,A
7-M,442,0,126,0,0,126,T
7-M,443,0,0,135,0,135,G
7-M,444,0,135,0,0,135,T
7-M,445,0,0,135,0,135,G
7-M,446,0,0,0,134,134,C
7-M,447,134,0,0,0,134,A
7-M,448,133,0,0,0,133,A
7-M,449,0,0,0,135,135,C
7-M,450,135,0,0,0,135,A
7-M,451,0,135,0,1,136,T
7-M,452,0,1,134,0,135,G
7-M,453,0,131,0,2,133,T
7-M,454,0,2,131,0,133,G
7-M,455,131,0,1,0,132,A
7-M,456,0,0,132,0,132,G
7-M,457,0,0,0,132,132,C
7-M,458,129,0,0,0,129,A
7-M,459,0,0,128,0,128,G
7-M,460,127,0,0,0,127,A
7-M,461,0,126,0,0,126,T
7-M,462,0,127,0,0,127,T
7-M,463,0,0,126,0,126,G
7-M,464,0,0,0,127,127,C
7-M,465,0,126,0,0,126,T
7-M,466,0,0,127,0,127,G
7-M,467,125,0,0,0,125,A
7-M,468,0,0,0,129,129,C
7-M,469,0,129,0,0,129,T
7-M,470,2,0,0,125,127,C
7-M,471,0,1,0,128,129,C
7-M,472,1,0,0,127,128,C
7-M,473,129,0,0,0,129,A
7-M,474,0,0,129,0,129,G
7-M,475,0,0,0,128,128,C
7-M,476,129,0,0,0,129,A
7-M,477,0,0,0,127,127,C
7-M,478,126,0,0,0,126,A
7-M,479,1,0,126,0,127,G
7-M,480,0,1,126,0,127,G
7-M,481,0,126,0,0,126,T
7-M,482,0,0,0,127,127,C
7-M,483,0,125,0,0,125,T
7-M,484,0,0,0,126,126,C
7-M,485,122,0,0,0,122,A
7-M,486,1,120,0,1,122,T
7-M,487,122,0,1,0,123,A
7-M,488,0,1,122,0,123,G
7-M,489,0,0,122,0,122,G
7-M,490,1,0,0,120,121,C
7-M,491,120,0,0,0,120,A
7-M,492,0,2,117,0,119,G
7-M,493,119,0,1,0,120,A
7-M,494,0,120,0,0,120,T
7-M,495,0,0,120,0,120,G
7-M,496,0,0,119,0,119,G
7-M,497,0,118,0,1,119,T
7-M,498,0,0,117,0,117,G
7-M,499,0,0,119,0,119,G
7-M,500,0,1,0,118,119,C
7-M,501,117,0,0,0,117,A
7-M,502,116,0,0,0,116,A
7-M,503,0,0,0,118,118,C
7-M,504,120,0,0,0,120,A
7-M,505,120,0,0,0,120,A
7-M,506,0,0,0,121,121,C
7-M,507,0,0,0,119,119,C
7-M,508,117,1,0,0,118,A
7-M,509,117,0,0,0,117,A
7-M,510,0,117,0,1,118,T
7-M,511,0,0,0,118,118,C
7-M,512,0,0,0,116,116,C
7-M,513,116,0,0,0,116,A
7-M,514,0,116,0,0,116,T
7-M,515,0,117,0,0,117,T
7-M,516,117,0,0,0,117,A
7-M,517,115,0,0,0,115,A
7-M,518,0,116,0,0,116,T
7-M,519,113,0,0,0,113,A
7-M,520,113,0,0,0,113,A
7-M,521,111,0,0,0,111,A
7-M,522,111,0,0,0,111,A
7-M,523,0,0,0,115,115,C
7-M,524,116,0,0,0,116,A
7-M,525,0,116,0,0,116,T
7-M,526,0,1,115,0,116,G
7-M,527,115,0,0,0,115,A
7-M,528,0,1,116,0,117,G
7-M,529,118,0,0,0,118,A
7-M,530,119,0,0,0,119,A
7-M,531,0,0,0,119,119,C
7-M,532,117,0,0,0,117,A
7-M,533,0,0,118,0,118,G
7-M,534,118,0,0,0,118,A
7-M,535,118,0,0,0,118,A
7-M,536,0,118,0,0,118,T
7-M,537,0,0,119,0,119,G
7-M,538,0,0,119,0,119,G
7-M,539,0,118,0,1,119,T
7-M,540,0,113,0,1,114,T
7-M,541,0,115,0,1,116,T
7-M,542,0,117,0,0,117,T
7-M,543,0,1,116,0,117,G
7-M,544,0,0,117,0,117,G
7-M,545,0,0,0,117,117,C
7-M,546,0,0,0,115,115,C
7-M,547,112,0,1,0,113,A
7-M,548,0,0,113,0,113,G
7-M,549,0,0,0,112,112,C
7-M,550,113,1,1,0,115,A
7-M,551,0,1,0,119,120,C
7-M,552,0,116,0,0,116,T
7-M,553,118,0,0,0,118,A
7-M,554,0,0,0,118,118,C
7-M,555,119,0,0,0,119,A
7-M,556,0,0,123,0,123,G
7-M,557,0,0,0,116,116,C
7-M,558,0,116,0,0,116,T
7-M,559,115,0,0,0,115,A
7-M,560,113,0,0,0,113,A
7-M,561,0,1,115,0,116,G
7-M,562,0,0,116,0,116,G
7-M,563,0,1,0,115,116,C
7-M,564,0,111,0,0,111,T
7-M,565,111,0,0,0,111,A
7-M,566,0,109,0,0,109,T
7-M,567,0,1,109,0,110,G
7-M,568,0,0,113,0,113,G
7-M,569,107,0,0,0,107,A
7-M,570,0,0,110,0,110,G
7-M,571,0,0,0,108,108,C
7-M,572,108,0,0,0,108,A
7-M,573,108,0,0,0,108,A
7-M,574,108,0,0,0,108,A
7-M,575,0,110,0,0,110,T
7-M,576,0,0,109,0,109,G
7-M,577,0,0,109,0,109,G
7-M,578,0,0,0,108,108,C
7-M,579,0,109,0,0,109,T
7-M,580,0,0,110,0,110,G
7-M,581,0,1,110,0,111,G
7-M,582,110,0,0,0,110,A
7-M,583,0,110,0,0,110,T
7-M,584,0,0,0,108,108,C
7-M,585,111,0,0,0,111,A
7-M,586,112,0,0,0,112,A
7-M,587,0,0,111,0,111,G
7-M,588,0,111,0,0,111,T
7-M,589,0,1,111,1,113,G
7-M,590,110,0,0,0,110,A
7-M,591,0,0,110,0,110,G
7-M,592,0,0,0,111,111,C
7-M,593,110,0,0,0,110,A
7-M,594,0,0,109,0,109,G
7-M,595,0,0,109,0,109,G
7-M,596,0,0,0,110,110,C
7-M,597,109,0,0,0,109,A
7-M,598,0,0,110,0,110,G
7-M,599,0,0,0,110,110,C
7-M,600,0,0,110,0,110,G
7-M,601,0,0,109,0,109,G
7-M,602,108,1,0,0,109,A
7-M,603,0,0,112,0,112,G
7-M,604,0,0,112,0,112,G
7-M,605,0,0,0,111,111,C
7-M,606,0,0,0,112,112,C
7-M,607,109,0,0,0,109,A
7-M,608,0,109,0,0,109,T
7-M,609,0,1,110,0,111,G
7-M,610,0,0,112,0,112,G
7-M,611,111,0,0,0,111,A
7-M,612,0,0,113,0,113,G
7-M,613,109,0,0,0,109,A
7-M,614,0,111,0,0,111,T
7-M,615,0,113,0,1,114,T
7-M,616,0,0,114,0,114,G
7-M,617,0,0,0,114,114,C
7-M,618,0,114,0,0,114,T
7-M,619,114,0,0,0,114,A
7-M,620,0,0,115,0,115,G
7-M,621,0,114,0,0,114,T
7-M,622,1,0,0,114,115,C
7-M,623,114,0,0,0,114,A
7-M,624,0,0,116,0,116,G
7-M,625,0,0,116,0,116,G
7-M,626,1,0,0,115,116,C
7-M,627,0,0,0,113,113,C
7-M,628,114,0,0,0,114,A
7-M,629,0,0,117,0,117,G
7-M,630,0,0,118,0,118,G
7-M,631,0,0,0,118,118,C
7-M,632,118,0,0,0,118,A
7-M,633,0,0,119,0,119,G
7-M,634,118,0,0,0,118,A
7-M,635,0,119,0,0,119,T
7-M,636,0,0,122,0,122,G
7-M,637,0,0,121,0,121,G
7-M,638,0,118,0,0,118,T
7-M,639,0,0,119,0,119,G
7-M,640,0,0,0,118,118,C
7-M,641,119,0,0,0,119,A
7-M,642,0,2,117,0,119,G
7-M,643,0,0,120,0,120,G
7-M,644,0,0,0,118,118,C
7-M,645,116,0,0,0,116,A
7-M,646,117,0,0,0,117,A
7-M,647,0,118,0,0,118,T
7-M,648,0,2,116,0,118,G
7-M,649,117,0,0,0,117,A
7-M,650,0,0,117,0,117,G
7-M,651,113,0,0,0,113,A
7-M,652,0,0,113,0,113,G
7-M,653,0,0,0,114,114,C
7-M,654,0,0,0,117,117,C
7-M,655,118,0,0,0,118,A
7-M,656,0,117,0,0,117,T
7-M,657,0,117,0,0,117,T
7-M,658,0,0,116,0,116,G
7-M,659,0,0,116,0,116,G
7-M,660,0,0,115,0,115,G
7-M,661,116,0,0,0,116,A
7-M,662,0,0,0,116,116,C
7-M,663,0,115,0,0,115,T
7-M,664,2,0,0,111,113,C
7-M,665,113,0,0,0,113,A
7-M,666,0,120,0,0,120,T
7-M,667,0,0,0,119,119,C
7-M,668,0,0,0,118,118,C
7-M,669,0,120,0,0,120,T
7-M,670,120,0,0,0,120,A
7-M,671,0,0,123,0,123,G
7-M,672,0,130,0,0,130,T
7-M,673,0,126,0,1,127,T
7-M,674,0,0,0,128,128,C
7-M,675,0,0,0,127,127,C
7-M,676,126,0,0,0,126,A
7-M,677,0,0,127,0,127,G
7-M,678,0,127,0,0,127,T
7-M,679,126,0,0,0,126,A
7-M,680,0,0,0,127,127,C
7-M,681,0,116,0,0,116,T
7-M,682,0,1,119,0,120,G
7-M,683,0,1,122,0,123,G
7-M,684,0,123,0,0,123,T
7-M,685,1,0,0,123,124,C
7-M,686,0,121,0,0,121,T
7-M,687,120,0,0,0,120,A
7-M,688,120,0,0,0,120,A
7-M,689,1,0,120,1,122,G
7-M,690,119,0,0,0,119,A
7-M,691,0,0,117,0,117,G
7-M,692,111,0,0,0,111,A
7-M,693,0,110,0,1,111,T
7-M,694,0,1,109,0,110,G
7-M,695,111,0,0,0,111,A
7-M,696,0,109,0,0,109,T
7-M,697,1,0,0,110,111,C
7-M,698,0,109,0,0,109,T
7-M,699,0,109,0,0,109,T
7-M,700,0,0,0,109,109,C
7-M,701,0,108,0,0,108,T
7-M,702,0,109,0,0,109,T
7-M,703,0,0,110,0,110,G
7-M,704,110,0,0,0,110,A
7-M,705,110,0,0,0,110,A
7-M,706,110,0,0,0,110,A
7-M,707,110,0,0,0,110,A
7-M,708,0,109,0,0,109,T
7-M,709,0,111,0,1,112,T
7-M,710,0,110,0,0,110,T
7-M,711,0,0,109,0,109,G
7-M,712,0,0,0,110,110,C
7-M,713,110,0,1,0,111,A
7-M,714,0,0,111,0,111,G
7-M,715,111,0,0,0,111,A
7-M,716,0,1,0,115,116,C
7-M,717,0,0,0,116,116,C
7-M,718,0,116,0,0,116,T
7-M,719,118,0,0,0,118,A
7-M,720,0,120,0,0,120,T
7-M,721,0,0,0,120,120,C
7-M,722,119,0,0,0,119,A
7-M,723,0,0,120,0,120,G
7-M,724,120,0,0,0,120,A
7-M,725,119,0,0,0,119,A
7-M,726,119,0,0,0,119,A
7-M,727,0,0,0,118,118,C
7-M,728,0,0,117,0,117,G
7-M,729,116,0,0,0,116,A
7-M,730,113,0,0,0,113,A
7-M,731,0,115,0,0,115,T
7-M,732,2,0,114,0,116,G
7-M,733,0,0,115,0,115,G
7-M,734,0,0,116,0,116,G
7-M,735,0,0,116,0,116,G
7-M,736,0,0,117,0,117,G
7-M,737,0,115,0,0,115,T
7-M,738,0,0,115,0,115,G
7-M,739,0,0,0,114,114,C
7-M,740,113,0,1,0,114,A
7-M,741,0,0,115,0,115,G
7-M,742,113,0,0,0,113,A
7-M,743,0,112,0,0,112,T
7-M,744,0,1,113,0,114,G
7-M,745,0,0,0,112,112,C
7-M,746,113,0,0,0,113,A
7-M,747,110,0,1,0,111,A
7-M,748,0,0,0,114,114,C
7-M,749,0,0,114,0,114,G
7-M,750,114,0,0,0,114,A
7-M,751,0,113,0,0,113,T
7-M,752,0,113,0,0,113,T
7-M,753,0,0,0,116,116,C
7-M,754,110,0,0,0,110,A
7-M,755,110,0,1,0,111,A
7-M,756,0,0,112,0,112,G
7-M,757,0,110,0,0,110,T
7-M,758,0,2,105,0,107,G
7-M,759,109,0,0,0,109,A
7-M,760,0,0,0,109,109,C
7-M,761,0,0,0,108,108,C
7-M,762,0,0,0,110,110,C
7-M,763,0,1,108,0,109,G
7-M,764,0,0,0,110,110,C
7-M,765,0,109,0,0,109,T
7-M,766,0,109,0,0,109,T
7-M,767,0,0,110,0,110,G
7-M,768,0,112,0,0,112,T
7-M,769,0,111,0,0,111,T
7-M,770,0,1,110,0,111,G
7-M,771,0,108,0,0,108,T
7-M,772,0,108,0,0,108,T
7-M,773,0,0,108,0,108,G
7-M,774,0,0,0,108,108,C
7-M,775,0,0,0,106,106,C
7-M,776,0,0,108,0,108,G
7-M,777,0,0,0,108,108,C
7-M,778,0,0,109,0,109,G
7-M,779,107,0,0,0,107,A
7-M,780,108,0,0,0,108,A
7-M,781,0,109,0,0,109,T
7-M,782,110,0,0,0,110,A
7-M,783,0,112,0,0,112,T
7-M,784,0,0,0,111,111,C
7-M,785,111,0,0,0,111,A
7-M,786,0,112,0,0,112,T
7-M,787,0,110,0,0,110,T
7-M,788,0,1,109,0,110,G
7-M,789,1,0,106,1,108,G
7-M,790,0,0,110,0,110,G
7-M,791,109,0,0,0,109,A
7-M,792,0,107,0,0,107,T
7-M,793,1,0,0,105,106,C
7-M,794,0,106,0,0,106,T
7-M,795,0,104,0,2,106,T
7-M,796,0,0,109,0,109,G
7-M,797,0,0,0,109,109,C
7-M,798,109,0,0,0,109,A
7-M,799,0,0,0,108,108,C
7-M,800,0,108,0,0,108,T
7-M,801,0,109,0,0,109,T
7-M,802,0,0,109,0,109,G
7-M,803,109,0,0,0,109,A
7-M,804,0,112,0,0,112,T
7-M,805,112,0,0,0,112,A
7-M,806,0,111,0,0,111,T
7-M,807,0,111,0,0,111,T
7-M,808,1,0,110,0,111,G
7-M,809,0,110,0,0,110,T
7-M,810,0,0,108,0,108,G
7-M,811,0,0,108,0,108,G
7-M,812,105,0,0,0,105,A
7-M,813,0,101,0,0,101,T
7-M,814,0,102,0,0,102,T
7-M,815,0,0,0,102,102,C
7-M,816,0,101,0,0,101,T
7-M,817,0,101,0,0,101,T
7-M,818,0,0,101,0,101,G
7-M,819,100,0,0,0,100,A
7-M,820,0,100,0,0,100,T
7-M,821,0,0,0,101,101,C
7-M,822,0,0,100,0,100,G
7-M,823,0,102,0,0,102,T
7-M,824,0,0,0,102,102,C
7-M,825,1,100,0,1,102,T
7-M,826,0,101,0,0,101,T
7-M,827,0,102,0,0,102,T
7-M,828,0,102,0,0,102,T
7-M,829,0,102,0,0,102,T
7-M,830,0,101,0,0,101,T
7-M,831,0,101,0,0,101,T
7-M,832,0,0,0,102,102,C
7-M,833,101,0,0,0,101,A
7-M,834,102,0,0,0,102,A
7-M,835,102,0,0,0,102,A
7-M,836,0,101,0,0,101,T
7-M,837,0,0,100,0,100,G
7-M,838,0,0,0,101,101,C
7-M,839,1,0,100,0,101,G
7-M,840,0,101,0,0,101,T
7-M,841,0,0,0,101,101,C
7-M,842,0,100,0,0,100,T
7-M,843,100,0,0,0,100,A
7-M,844,0,100,0,0,100,T
7-M,845,0,0,0,99,99,C
7-M,846,0,0,100,0,100,G
7-M,847,99,0,1,0,100,A
7-M,848,0,0,0,100,100,C
7-M,849,0,98,0,1,99,T
7-M,850,1,0,0,101,102,C
7-M,851,0,100,0,1,101,T
7-M,852,0,101,0,0,101,T
7-M,853,0,0,0,101,101,C
7-M,854,100,0,1,0,101,A
7-M,855,102,0,0,0,102,A
7-M,856,102,0,0,0,102,A
7-M,857,0,0,0,101,101,C
7-M,858,101,0,0,0,101,A
7-M,859,0,0,0,97,97,C
7-M,860,0,2,92,0,94,G
7-M,861,0,0,95,0,95,G
7-M,862,0,0,0,97,97,C
7-M,863,1,0,0,97,98,C
7-M,864,0,97,0,1,98,T
7-M,865,0,98,0,0,98,T
7-M,866,99,0,0,0,99,A
7-M,867,99,0,0,0,99,A
7-M,868,99,0,0,0,99,A
7-M,869,97,0,0,0,97,A
7-M,870,0,0,95,0,95,G
7-M,871,80,0,0,0,80,A
7-M,872,0,0,79,0,79,G
7-M,873,0,0,79,0,79,G
7-M,874,1,0,0,77,78,C
7-M,875,0,0,0,77,77,C
7-M,876,0,0,0,79,79,C
7-M,877,0,79,0,0,79,T
7-M,878,0,79,0,0,79,T
7-M,879,0,0,0,78,78,C
7-M,880,0,78,0,0,78,T
7-M,881,82,0,0,0,82,A
7-M,882,0,1,0,81,82,C
7-M,883,0,0,80,0,80,G
7-M,884,0,0,79,0,79,G
7-M,885,77,0,0,0,77,A
7-M,886,73,0,2,0,75,A
7-M,887,0,0,74,0,74,G
7-M,888,0,0,74,0,74,G
7-M,889,74,0,0,0,74,A
7-M,890,0,0,77,0,77,G
7-M,891,0,76,0,0,76,T
7-M,892,75,0,0,0,75,A
7-M,893,1,0,0,74,75,C
7-M,894,1,0,0,75,76,C
7-M,895,0,76,0,0,76,T
7-M,896,0,0,75,0,75,G
7-M,897,74,0,0,0,74,A
7-M,898,0,0,76,0,76,G
7-M,899,0,73,0,0,73,T
7-M,900,0,0,0,75,75,C
7-M,901,0,74,0,0,74,T
7-M,902,72,0,0,1,73,A
7-M,903,0,72,0,0,72,T
7-M,904,0,0,71,0,71,G
7-M,905,70,0,0,0,70,A
7-M,906,0,0,70,0,70,G
7-M,907,0,0,65,0,65,G
7-M,908,0,0,66,0,66,G
7-M,909,66,0,0,0,66,A
7-M,910,65,0,0,0,65,A
7-M,911,0,0,66,0,66,G
7-M,912,63,0,0,0,63,A
7-M,913,64,0,0,0,64,A
7-M,914,0,64,0,0,64,T
7-M,915,60,0,0,0,60,A
7-M,916,0,60,0,0,60,T
7-M,917,0,0,0,58,58,C
7-M,918,0,1,57,0,58,G
7-M,919,58,0,0,0,58,A
7-M,920,58,0,0,0,58,A
7-M,921,58,0,0,0,58,A
7-M,922,0,0,58,0,58,G
7-M,923,0,0,58,0,58,G
7-M,924,58,0,0,0,58,A
7-M,925,57,0,1,0,58,A
7-M,926,0,0,0,58,58,C
7-M,927,54,0,0,0,54,A
7-M,928,0,0,54,0,54,G
7-M,929,1,0,0,53,54,C
7-M,930,54,0,0,0,54,A
7-M,931,0,0,54,0,54,G
7-M,932,50,0,0,0,50,A
7-M,933,52,0,0,0,52,A
7-M,934,0,52,0,0,52,T
7-M,935,0,0,51,0,51,G
7-M,936,0,0,0,51,51,C
7-M,937,0,46,0,0,46,T
7-M,938,0,0,47,0,47,G
7-M,939,0,47,0,0,47,T
7-M,940,0,0,46,0,46,G
7-M,941,0,0,46,0,46,G
7-M,942,44,0,0,0,44,A
7-M,943,0,44,0,0,44,T
7-M,944,0,0,44,0,44,G
7-M,945,0,0,0,44,44,C
7-M,946,0,43,0,0,43,T
7-M,947,0,0,43,0,43,G
7-M,948,43,0,0,0,43,A
7-M,949,0,0,0,43,43,C
7-M,950,0,0,43,0,43,G
7-M,951,41,0,0,0,41,A
7-M,952,0,0,0,40,40,C
7-M,953,39,0,0,0,39,A
7-M,954,0,0,39,0,39,G
7-M,955,0,39,0,0,39,T
7-M,956,0,0,0,39,39,C
7-M,957,39,0,0,0,39,A
7-M,958,0,39,0,0,39,T
7-M,959,0,38,0,0,38,T
7-M,960,0,37,0,0,37,T
7-M,961,0,37,0,0,37,T
7-M,962,0,0,38,0,38,G
7-M,963,0,36,0,0,36,T
7-M,964,0,0,0,36,36,C
7-M,965,34,0,0,0,34,A
7-M,966,0,0,34,0,34,G
7-M,967,0,0,0,34,34,C
7-M,968,34,0,0,0,34,A
7-M,969,0,34,0,0,34,T
7-M,970,34,0,0,0,34,A
7-M,971,0,0,34,0,34,G
7-M,972,33,0,0,0,33,A
7-M,973,0,0,33,0,33,G
7-M,974,0,32,0,0,32,T
7-M,975,0,26,0,0,26,T
7-M,976,1,0,25,0,26,G
7-M,977,0,0,27,0,27,G
7-M,978,27,0,0,0,27,A
7-M,979,0,0,27,0,27,G
7-M,980,0,17,0,0,17,T
7-M,981,15,0,0,0,15,A
7-M,982,15,0,0,0,15,A
8-NS,1,53,0,0,0,53,A
8-NS,2,0,53,0,0,53,T
8-NS,3,0,0,57,0,57,G
8-NS,4,0,1,58,0,59,G
8-NS,5,60,0,0,0,60,A
8-NS,6,0,96,0,0,96,T
8-NS,7,0,98,0,0,98,T
8-NS,8,0,0,0,100,100,C
8-NS,9,0,0,0,99,99,C
8-NS,10,98,0,1,0,99,A
8-NS,11,100,0,0,0,100,A
8-NS,12,0,0,0,102,102,C
8-NS,13,101,0,0,0,101,A
8-NS,14,0,0,0,103,103,C
8-NS,15,0,103,0,0,103,T
8-NS,16,0,0,111,0,111,G
8-NS,17,0,112,0,0,112,T
8-NS,18,0,0,112,0,112,G
8-NS,19,0,112,0,0,112,T
8-NS,20,1,0,0,111,112,C
8-NS,21,111,0,0,0,111,A
8-NS,22,112,0,0,0,112,A
8-NS,23,0,0,118,0,118,G
8-NS,24,0,120,0,0,120,T
8-NS,25,0,122,0,0,122,T
8-NS,26,0,123,0,0,123,T
8-NS,27,2,0,0,120,122,C
8-NS,28,0,0,0,124,124,C
8-NS,29,124,0,0,0,124,A
8-NS,30,0,2,126,0,128,G
8-NS,31,0,0,130,0,130,G
8-NS,32,0,129,0,1,130,T
8-NS,33,130,0,0,0,130,A
8-NS,34,0,0,133,0,133,G
8-NS,35,132,0,0,0,132,A
8-NS,36,0,130,0,2,132,T
8-NS,37,0,133,0,0,133,T
8-NS,38,0,0,134,0,134,G
8-NS,39,1,0,0,132,133,C
8-NS,40,0,133,0,0,133,T
8-NS,41,0,132,0,0,132,T
8-NS,42,0,133,0,0,133,T
8-NS,43,0,0,1,134,135,C
8-NS,44,0,135,0,0,135,T
8-NS,45,0,135,0,0,135,T
8-NS,46,0,135,0,0,135,T
8-NS,47,0,1,137,0,138,G
8-NS,48,0,0,141,0,141,G
8-NS,49,0,1,0,140,141,C
8-NS,50,141,0,0,0,141,A
8-NS,51,0,140,0,0,140,T
8-NS,52,142,0,0,0,142,A
8-NS,53,0,144,0,0,144,T
8-NS,54,1,0,0,143,144,C
8-NS,55,1,0,0,144,145,C
8-NS,56,1,1,143,0,145,G
8-NS,57,0,0,146,0,146,G
8-NS,58,146,0,0,0,146,A
8-NS,59,146,0,0,0,146,A
8-NS,60,147,0,0,0,147,A
8-NS,61,0,0,0,150,150,C
8-NS,62,150,0,0,0,150,A
8-NS,63,150,0,0,0,150,A
8-NS,64,0,0,153,0,153,G
8-NS,65,0,152,0,1,153,T
8-NS,66,0,152,0,1,153,T
8-NS,67,0,0,154,0,154,G
8-NS,68,0,153,0,0,153,T
8-NS,69,153,0,0,0,153,A
8-NS,70,0,1,153,0,154,G
8-NS,71,160,0,0,0,160,A
8-NS,72,0,0,0,159,159,C
8-NS,73,2,0,0,154,156,C
8-NS,74,157,0,0,0,157,A
8-NS,75,158,0,1,0,159,A
8-NS,76,0,0,168,0,168,G
8-NS,77,168,0,0,0,168,A
8-NS,78,169,0,0,0,169,A
8-NS,79,0,0,0,170,170,C
8-NS,80,0,167,0,0,167,T
8-NS,81,0,1,168,0,169,G
8-NS,82,169,0,1,0,170,A
8-NS,83,0,0,176,0,176,G
8-NS,84,0,175,0,1,176,T
8-NS,85,0,0,175,0,175,G
8-NS,86,175,0,0,0,175,A
8-NS,87,0,174,0,0,174,T
8-NS,88,0,0,175,0,175,G
8-NS,89,0,0,0,176,176,C
8-NS,90,1,0,0,172,173,C
8-NS,91,0,0,0,177,177,C
8-NS,92,1,0,0,173,174,C
8-NS,93,175,0,0,0,175,A
8-NS,94,0,177,0,0,177,T
8-NS,95,0,181,0,0,181,T
8-NS,96,0,0,0,184,184,C
8-NS,97,0,0,0,182,182,C
8-NS,98,0,182,0,0,182,T
8-NS,99,0,179,0,0,179,T
8-NS,100,0,3,176,0,179,G
8-NS,101,179,0,0,0,179,A
8-NS,102,0,179,0,0,179,T
8-NS,103,0,0,0,179,179,C
8-NS,104,0,3,173,0,176,G
8-NS,105,0,0,176,0,176,G
8-NS,106,0,0,0,176,176,C
8-NS,107,0,174,0,0,174,T
8-NS,108,0,176,0,0,176,T
8-NS,109,0,0,0,175,175,C
8-NS,110,0,0,177,0,177,G
8-NS,111,0,1,0,176,177,C
8-NS,112,1,0,0,176,177,C
8-NS,113,0,0,175,2,177,G
8-NS,114,177,0,0,0,177,A
8-NS,115,0,0,187,0,187,G
8-NS,116,188,0,0,0,188,A
8-NS,117,0,188,0,0,188,T
8-NS,118,1,0,0,187,188,C
8-NS,119,184,0,1,0,185,A
8-NS,120,0,1,186,0,187,G
8-NS,121,186,0,1,1,188,A
8-NS,122,0,1,189,0,190,G
8-NS,123,0,1,191,0,192,G
8-NS,124,1,191,0,0,192,T
8-NS,125,1,0,0,202,203,C
8-NS,126,0,0,0,204,204,C
8-NS,127,0,0,0,203,203,C
8-NS,128,0,203,0,1,204,T
8-NS,129,206,0,0,0,206,A
8-NS,130,204,0,1,0,205,A
8-NS,131,0,0,209,0,209,G
8-NS,132,0,0,207,0,207,G
8-NS,133,2,0,207,0,209,G
8-NS,134,0,1,202,0,203,G
8-NS,135,204,0,0,0,204,A
8-NS,136,204,0,0,0,204,A
8-NS,137,0,0,202,1,203,G
8-NS,138,204,1,0,0,205,A
8-NS,139,0,1,208,0,209,G
8-NS,140,0,0,210,0,210,G
8-NS,141,0,0,0,209,209,C
8-NS,142,207,0,0,0,207,A
8-NS,143,207,0,0,0,207,A
8-NS,144,0,209,0,0,209,T
8-NS,145,210,0,0,0,210,A
8-NS,146,1,0,0,212,213,C
8-NS,147,0,210,0,0,210,T
8-NS,148,1,0,0,209,210,C
8-NS,149,0,208,0,0,208,T
8-NS,150,0,0,0,210,210,C
8-NS,151,0,2,209,1,212,G
8-NS,152,0,0,223,0,223,G
8-NS,153,0,221,0,0,221,T
8-NS,154,3,0,0,221,224,C
8-NS,155,0,224,0,0,224,T
8-NS,156,226,0,0,0,226,A
8-NS,157,0,0,226,0,226,G
8-NS,158,225,0,0,0,225,A
8-NS,159,0,0,0,230,230,C
8-NS,160,226,0,1,1,228,A
8-NS,161,0,228,0,1,229,T
8-NS,162,0,0,0,229,229,C
8-NS,163,228,0,0,0,228,A
8-NS,164,228,0,0,0,228,A
8-NS,165,227,0,0,0,227,A
8-NS,166,0,0,227,0,227,G
8-NS,167,0,0,0,228,228,C
8-NS,168,228,0,0,0,228,A
8-NS,169,0,0,229,0,229,G
8-NS,170,0,0,0,228,228,C
8-NS,171,2,0,0,225,227,C
8-NS,172,228,0,1,0,229,A
8-NS,173,0,0,0,232,232,C
8-NS,174,1,0,0,230,231,C
8-NS,175,1,0,1,231,233,C
8-NS,176,232,0,1,0,233,A
8-NS,177,0,239,0,0,239,T
8-NS,178,0,0,240,0,240,G
8-NS,179,0,239,0,0,239,T
8-NS,180,0,239,0,0,239,T
8-NS,181,0,2,237,0,239,G
8-NS,182,0,1,239,0,240,G
8-NS,183,242,0,0,0,242,A
8-NS,184,239,0,1,0,240,A
8-NS,185,235,0,1,0,236,A
8-NS,186,0,0,240,0,240,G
8-NS,187,0,0,0,240,240,C
8-NS,188,237,0,0,0,237,A
8-NS,189,239,0,0,0,239,A
8-NS,190,238,0,0,0,238,A
8-NS,191,0,239,0,0,239,T
8-NS,192,0,239,0,0,239,T
8-NS,193,0,0,242,0,242,G
8-NS,194,0,243,0,0,243,T
8-NS,195,241,0,0,0,241,A
8-NS,196,0,0,242,0,242,G
8-NS,197,243,0,0,0,243,A
8-NS,198,240,0,0,1,241,A
8-NS,199,243,0,0,0,243,A
8-NS,200,242,0,1,0,243,A
8-NS,201,0,0,243,0,243,G
8-NS,202,236,0,0,0,236,A
8-NS,203,0,236,0,0,236,T
8-NS,204,0,235,0,0,235,T
8-NS,205,1,0,0,234,235,C
8-NS,206,0,235,0,0,235,T
8-NS,207,0,1,234,0,235,G
8-NS,208,234,0,0,0,234,A
8-NS,209,232,0,0,0,232,A
8-NS,210,234,0,0,0,234,A
8-NS,211,0,1,235,0,236,G
8-NS,212,238,0,0,0,238,A
8-NS,213,237,0,1,0,238,A
8-NS,214,0,1,239,0,240,G
8-NS,215,239,1,0,0,240,A
8-NS,216,239,0,0,0,239,A
8-NS,217,0,235,0,1,236,T
8-NS,218,0,0,0,241,241,C
8-NS,219,0,241,0,0,241,T
8-NS,220,0,0,246,0,246,G
8-NS,221,243,0,0,0,243,A
8-NS,222,0,244,0,1,245,T
8-NS,223,1,1,243,0,245,G
8-NS,224,243,0,0,0,243,A
8-NS,225,0,1,244,0,245,G
8-NS,226,0,0,246,0,246,G
8-NS,227,0,0,0,248,248,C
8-NS,228,250,0,0,0,250,A
8-NS,229,0,0,0,255,255,C
8-NS,230,0,254,0,0,254,T
8-NS,231,0,255,0,0,255,T
8-NS,232,256,0,0,0,256,A
8-NS,233,256,0,0,0,256,A
8-NS,234,257,0,1,0,258,A
8-NS,235,258,0,0,0,258,A
8-NS,236,0,258,0,0,258,T
8-NS,237,0,1,258,0,259,G
8-NS,238,260,0,0,0,260,A
8-NS,239,1,0,0,259,260,C
8-NS,240,2,0,0,255,257,C
8-NS,241,257,0,0,0,257,A
8-NS,242,0,257,0,0,257,T
8-NS,243,0,0,261,0,261,G
8-NS,244,0,0,261,0,261,G
8-NS,245,0,263,0,1,264,T
8-NS,246,0,0,0,274,274,C
8-NS,247,0,273,0,1,274,T
8-NS,248,1,0,0,276,277,C
8-NS,249,0,0,0,278,278,C
8-NS,250,277,0,0,0,277,A
8-NS,251,0,0,0,279,279,C
8-NS,252,274,0,0,0,274,A
8-NS,253,0,0,0,288,288,C
8-NS,254,1,0,0,285,286,C
8-NS,255,0,280,0,0,280,T
8-NS,256,0,0,282,0,282,G
8-NS,257,0,0,0,281,281,C
8-NS,258,0,280,0,0,280,T
8-NS,259,0,281,0,0,281,T
8-NS,260,1,5,0,273,279,C
8-NS,261,1,0,278,0,279,G
8-NS,262,0,0,0,276,276,C
8-NS,263,2,3,272,0,277,G
8-NS,264,285,1,0,0,286,A
8-NS,265,0,282,0,1,283,T
8-NS,266,290,1,0,0,291,A
8-NS,267,0,0,0,291,291,C
8-NS,268,291,0,0,0,291,A
8-NS,269,0,295,0,0,295,T
8-NS,270,296,0,0,0,296,A
8-NS,271,296,0,0,0,296,A
8-NS,272,1,0,0,294,295,C
8-NS,273,0,290,0,0,290,T
8-NS,274,0,2,293,0,295,G
8-NS,275,286,0,0,0,286,A
8-NS,276,0,0,0,289,289,C
8-NS,277,286,0,1,0,287,A
8-NS,278,0,289,1,0,290,T
8-NS,279,0,0,291,0,291,G
8-NS,280,287,0,0,0,287,A
8-NS,281,3,0,0,294,297,C
8-NS,282,0,296,0,0,296,T
8-NS,283,299,0,1,0,300,A
8-NS,284,0,300,0,0,300,T
8-NS,285,0,296,0,0,296,T
8-NS,286,0,0,298,0,298,G
8-NS,287,298,0,0,0,298,A
8-NS,288,0,1,300,0,301,G
8-NS,289,0,0,300,0,300,G
8-NS,290,294,0,1,0,295,A
8-NS,291,294,0,3,0,297,A
8-NS,292,0,293,0,0,293,T
8-NS,293,0,294,0,1,295,T
8-NS,294,1,1,293,0,295,G
8-NS,295,1,295,0,1,297,T
8-NS,296,2,0,0,295,297,C
8-NS,297,294,0,1,0,295,A
8-NS,298,295,0,1,0,296,A
8-NS,299,0,3,295,0,298,G
8-NS,300,298,0,0,0,298,A
8-NS,301,295,0,1,0,296,A
8-NS,302,293,0,3,0,296,A
8-NS,303,0,0,0,294,294,C
8-NS,304,0,290,0,0,290,T
8-NS,305,0,1,292,0,293,G
8-NS,306,0,1,300,0,301,G
8-NS,307,0,300,0,1,301,T
8-NS,308,0,300,0,0,300,T
8-NS,309,1,0,0,299,300,C
8-NS,310,297,0,2,0,299,A
8-NS,311,0,303,0,0,303,T
8-NS,312,1,0,302,0,303,G
8-NS,313,0,0,0,303,303,C
8-NS,314,0,301,0,0,301,T
8-NS,315,297,0,1,0,298,A
8-NS,316,304,0,1,0,305,A
8-NS,317,0,306,0,0,306,T
8-NS,318,0,0,308,0,308,G
8-NS,319,0,0,0,305,305,C
8-NS,320,2,0,0,304,306,C
8-NS,321,1,0,0,303,304,C
8-NS,322,305,1,0,0,306,A
8-NS,323,309,0,0,0,309,A
8-NS,324,0,0,311,0,311,G
8-NS,325,0,0,0,309,309,C
8-NS,326,309,0,0,0,309,A
8-NS,327,0,2,311,0,313,G
8-NS,328,312,0,0,0,312,A
8-NS,329,311,0,0,0,311,A
8-NS,330,312,0,0,0,312,A
8-NS,331,0,0,316,0,316,G
8-NS,332,0,310,0,0,310,T
8-NS,333,0,0,311,0,311,G
8-NS,334,0,1,310,0,311,G
8-NS,335,313,0,0,0,313,A
8-NS,336,309,0,1,0,310,A
8-NS,337,0,2,310,0,312,G
8-NS,338,1,2,313,0,316,G
8-NS,339,314,0,0,1,315,A
8-NS,340,0,0,0,312,312,C
8-NS,341,0,1,0,306,307,C
8-NS,342,0,308,0,0,308,T
8-NS,343,0,0,0,308,308,C
8-NS,344,0,310,0,0,310,T
8-NS,345,0,311,0,0,311,T
8-NS,346,0,309,0,0,309,T
8-NS,347,0,0,304,1,305,G
8-NS,348,0,0,0,308,308,C
8-NS,349,306,0,0,1,307,A
8-NS,350,0,307,0,1,308,T
8-NS,351,2,0,0,305,307,C
8-NS,352,309,0,0,0,309,A
8-NS,353,0,2,319,0,321,G
8-NS,354,320,0,0,0,320,A
8-NS,355,319,0,1,0,320,A
8-NS,356,0,319,0,0,319,T
8-NS,357,0,2,311,0,313,G
8-NS,358,0,0,313,0,313,G
8-NS,359,310,0,1,0,311,A
8-NS,360,1,0,0,312,313,C
8-NS,361,0,0,0,304,304,C
8-NS,362,295,0,0,0,295,A
8-NS,363,0,2,293,0,295,G
8-NS,364,0,0,293,0,293,G
8-NS,365,0,1,0,295,296,C
8-NS,366,292,0,0,0,292,A
8-NS,367,297,0,0,0,297,A
8-NS,368,0,296,0,0,296,T
8-NS,369,0,0,0,296,296,C
8-NS,370,298,0,0,0,298,A
8-NS,371,0,297,0,0,297,T
8-NS,372,0,1,293,0,294,G
8-NS,373,0,1,293,0,294,G
8-NS,374,293,0,0,0,293,A
8-NS,375,0,1,297,0,298,G
8-NS,376,290,0,1,0,291,A
8-NS,377,290,0,0,0,290,A
8-NS,378,289,0,0,0,289,A
8-NS,379,289,0,1,0,290,A
8-NS,380,291,0,1,0,292,A
8-NS,381,0,0,0,293,293,C
8-NS,382,290,0,0,0,290,A
8-NS,383,1,289,0,1,291,T
8-NS,384,1,0,0,285,286,C
8-NS,385,287,0,0,0,287,A
8-NS,386,0,288,0,0,288,T
8-NS,387,0,0,287,0,287,G
8-NS,388,0,287,0,0,287,T
8-NS,389,0,286,1,0,287,T
8-NS,390,0,0,288,0,288,G
8-NS,391,287,0,0,0,287,A
8-NS,392,288,0,1,0,289,A
8-NS,393,288,0,0,0,288,A
8-NS,394,0,0,289,0,289,G
8-NS,395,0,0,0,282,282,C
8-NS,396,0,2,279,0,281,G
8-NS,397,283,0,0,0,283,A
8-NS,398,282,0,0,0,282,A
8-NS,399,0,284,0,0,284,T
8-NS,400,0,277,0,8,285,T
8-NS,401,0,284,0,0,284,T
8-NS,402,3,0,0,281,284,C
8-NS,403,277,0,0,0,277,A
8-NS,404,0,3,274,0,277,G
8-NS,405,0,283,0,0,283,T
8-NS,406,0,0,283,0,283,G
8-NS,407,0,280,1,1,282,T
8-NS,408,0,1,284,0,285,G
8-NS,409,285,0,0,0,285,A
8-NS,410,0,284,0,1,285,T
8-NS,411,0,285,0,0,285,T
8-NS,412,0,285,0,0,285,T
8-NS,413,0,286,0,0,286,T
8-NS,414,0,286,0,0,286,T
8-NS,415,0,1,278,0,279,G
8-NS,416,280,0,1,0,281,A
8-NS,417,0,0,0,281,281,C
8-NS,418,5,2,0,270,277,C
8-NS,419,0,2,273,0,275,G
8-NS,420,291,0,0,1,292,A
8-NS,421,2,1,0,297,300,C
8-NS,422,0,299,0,0,299,T
8-NS,423,299,0,1,0,300,A
8-NS,424,0,2,299,0,301,G
8-NS,425,301,0,0,0,301,A
8-NS,426,0,2,300,0,302,G
8-NS,427,303,0,0,0,303,A
8-NS,428,0,0,0,310,310,C
8-NS,429,2,1,0,295,298,C
8-NS,430,287,0,0,0,287,A
8-NS,431,0,302,0,0,302,T
8-NS,432,301,0,0,0,301,A
8-NS,433,0,0,325,0,325,G
8-NS,434,0,324,0,0,324,T
8-NS,435,324,0,0,0,324,A
8-NS,436,0,321,0,2,323,T
8-NS,437,0,313,1,0,314,T
8-NS,438,322,0,0,0,322,A
8-NS,439,0,0,0,323,323,C
8-NS,440,0,315,0,0,315,T
8-NS,441,315,0,0,0,315,A
8-NS,442,290,0,1,0,291,A
8-NS,443,0,2,292,0,294,G
8-NS,444,0,2,288,0,290,G
8-NS,445,0,0,289,0,289,G
8-NS,446,0,0,0,282,282,C
8-NS,447,0,280,0,4,284,T
8-NS,448,0,282,0,1,283,T
8-NS,449,0,284,0,1,285,T
8-NS,450,3,0,0,285,288,C
8-NS,451,294,0,0,0,294,A
8-NS,452,0,0,0,294,294,C
8-NS,453,1,0,0,290,291,C
8-NS,454,0,1,290,0,291,G
8-NS,455,291,0,0,0,291,A
8-NS,456,289,2,0,0,291,A
8-NS,457,0,0,291,0,291,G
8-NS,458,290,0,0,0,290,A
8-NS,459,0,0,290,0,290,G
8-NS,460,0,1,286,0,287,G
8-NS,461,0,2,284,0,286,G
8-NS,462,287,0,1,0,288,A
8-NS,463,0,0,285,0,285,G
8-NS,464,2,1,0,281,284,C
8-NS,465,285,0,0,0,285,A
8-NS,466,284,0,1,0,285,A
8-NS,467,0,285,0,0,285,T
8-NS,468,0,284,0,0,284,T
8-NS,469,0,0,285,0,285,G
8-NS,470,0,282,0,0,282,T
8-NS,471,0,281,0,0,281,T
8-NS,472,0,1,282,0,283,G
8-NS,473,0,1,280,0,281,G
8-NS,474,0,0,0,283,283,C
8-NS,475,1,0,280,0,281,G
8-NS,476,282,0,0,0,282,A
8-NS,477,281,0,0,0,281,A
8-NS,478,283,0,0,0,283,A
8-NS,479,0,285,0,0,285,T
8-NS,480,2,0,0,283,285,C
8-NS,481,0,281,0,0,281,T
8-NS,482,0,0,0,282,282,C
8-NS,483,283,1,0,0,284,A
8-NS,484,0,0,0,283,283,C
8-NS,485,1,1,1,279,282,C
8-NS,486,280,0,0,0,280,A
8-NS,487,0,278,0,0,278,T
8-NS,488,0,270,0,0,270,T
8-NS,489,1,0,271,0,272,G
8-NS,490,0,0,0,266,266,C
8-NS,491,4,0,0,266,270,C
8-NS,492,0,268,0,2,270,T
8-NS,493,0,268,0,1,269,T
8-NS,494,0,0,0,271,271,C
8-NS,495,0,269,0,0,269,T
8-NS,496,0,265,0,1,266,T
8-NS,497,0,270,0,0,270,T
8-NS,498,0,268,0,2,270,T
8-NS,499,4,0,0,265,269,C
8-NS,500,1,0,0,267,268,C
8-NS,501,266,1,1,0,268,A
8-NS,502,0,3,267,0,270,G
8-NS,503,0,3,265,0,268,G
8-NS,504,274,0,0,0,274,A
8-NS,505,1,0,0,274,275,C
8-NS,506,277,0,0,0,277,A
8-NS,507,0,277,0,0,277,T
8-NS,508,276,0,1,0,277,A
8-NS,509,0,0,0,298,298,C
8-NS,510,0,296,0,1,297,T
8-NS,511,288,0,1,0,289,A
8-NS,512,0,287,0,0,287,T
8-NS,513,0,278,0,0,278,T
8-NS,514,0,0,279,0,279,G
8-NS,515,273,0,1,0,274,A
8-NS,516,0,0,275,0,275,G
8-NS,517,0,2,270,0,272,G
8-NS,518,247,0,0,0,247,A
8-NS,519,0,244,0,1,245,T
8-NS,520,0,0,244,0,244,G
8-NS,521,0,239,0,0,239,T
8-NS,522,0,0,0,240,240,C
8-NS,523,242,0,0,0,242,A
8-NS,524,241,0,0,0,241,A
8-NS,525,242,0,0,0,242,A
8-NS,526,241,0,0,0,241,A
8-NS,527,242,0,0,0,242,A
8-NS,528,0,243,0,0,243,T
8-NS,529,0,0,241,0,241,G
8-NS,530,0,0,0,241,241,C
8-NS,531,240,0,1,0,241,A
8-NS,532,241,0,0,0,241,A
8-NS,533,0,240,0,0,240,T
8-NS,534,0,241,0,0,241,T
8-NS,535,0,1,237,0,238,G
8-NS,536,0,0,236,0,236,G
8-NS,537,0,0,234,0,234,G
8-NS,538,0,0,236,0,236,G
8-NS,539,0,234,0,0,234,T
8-NS,540,2,0,0,235,237,C
8-NS,541,1,0,0,234,235,C
8-NS,542,0,235,0,1,236,T
8-NS,543,0,0,0,242,242,C
8-NS,544,240,0,0,0,240,A
8-NS,545,0,240,0,0,240,T
8-NS,546,2,1,0,235,238,C
8-NS,547,1,2,232,0,235,G
8-NS,548,2,0,231,0,233,G
8-NS,549,233,0,0,0,233,A
8-NS,550,0,0,233,0,233,G
8-NS,551,0,1,233,0,234,G
8-NS,552,231,0,0,0,231,A
8-NS,553,0,0,0,230,230,C
8-NS,554,0,230,0,0,230,T
8-NS,555,0,228,0,1,229,T
8-NS,556,0,6,224,0,230,G
8-NS,557,228,0,0,0,228,A
8-NS,558,228,0,0,0,228,A
8-NS,559,0,229,0,0,229,T
8-NS,560,0,0,227,0,227,G
8-NS,561,0,0,232,0,232,G
8-NS,562,226,0,0,0,226,A
8-NS,563,227,0,1,0,228,A
8-NS,564,0,234,0,0,234,T
8-NS,565,0,2,229,0,231,G
8-NS,566,232,0,0,0,232,A
8-NS,567,0,233,0,0,233,T
8-NS,568,233,0,0,0,233,A
8-NS,569,233,0,0,0,233,A
8-NS,570,0,0,0,231,231,C
8-NS,571,228,0,0,0,228,A
8-NS,572,0,0,0,232,232,C
8-NS,573,212,0,0,0,212,A
8-NS,574,1,1,217,0,219,G
8-NS,575,0,217,0,0,217,T
8-NS,576,0,217,0,1,218,T
8-NS,577,3,0,0,214,217,C
8-NS,578,0,0,216,0,216,G
8-NS,579,214,0,0,0,214,A
8-NS,580,0,0,215,0,215,G
8-NS,581,0,209,0,0,209,T
8-NS,582,2,1,0,207,210,C
8-NS,583,0,200,0,0,200,T
8-NS,584,0,0,0,202,202,C
8-NS,585,0,202,0,1,203,T
8-NS,586,203,0,0,0,203,A
8-NS,587,201,0,1,0,202,A
8-NS,588,202,0,0,0,202,A
8-NS,589,202,0,0,0,202,A
8-NS,590,203,0,0,0,203,A
8-NS,591,0,199,0,0,199,T
8-NS,592,1,0,0,198,199,C
8-NS,593,0,198,0,0,198,T
8-NS,594,200,0,0,0,200,A
8-NS,595,0,0,0,201,201,C
8-NS,596,201,0,0,0,201,A
8-NS,597,1,0,200,0,201,G
8-NS,598,194,0,0,0,194,A
8-NS,599,1,2,191,0,194,G
8-NS,600,199,0,0,0,199,A
8-NS,601,0,194,0,1,195,T
8-NS,602,0,194,0,0,194,T
8-NS,603,2,1,0,190,193,C
8-NS,604,0,0,192,0,192,G
8-NS,605,0,0,0,191,191,C
8-NS,606,1,189,0,0,190,T
8-NS,607,0,191,0,0,191,T
8-NS,608,0,0,187,0,187,G
8-NS,609,0,1,190,0,191,G
8-NS,610,190,0,0,0,190,A
8-NS,611,0,0,190,0,190,G
8-NS,612,189,0,0,0,189,A
8-NS,613,188,0,0,0,188,A
8-NS,614,0,0,188,0,188,G
8-NS,615,0,1,0,191,192,C
8-NS,616,190,0,0,0,190,A
8-NS,617,0,0,191,0,191,G
8-NS,618,0,191,0,0,191,T
8-NS,619,191,0,0,0,191,A
8-NS,620,192,0,0,0,192,A
8-NS,621,0,191,0,0,191,T
8-NS,622,0,4,190,0,194,G
8-NS,623,189,0,0,0,189,A
8-NS,624,0,1,190,0,191,G
8-NS,625,188,0,0,0,188,A
8-NS,626,185,0,0,0,185,A
8-NS,627,0,185,0,0,185,T
8-NS,628,0,1,182,0,183,G
8-NS,629,0,0,186,0,186,G
8-NS,630,0,0,184,0,184,G
8-NS,631,0,1,181,0,182,G
8-NS,632,0,0,182,0,182,G
8-NS,633,175,0,1,0,176,A
8-NS,634,0,0,0,181,181,C
8-NS,635,1,0,0,178,179,C
8-NS,636,0,175,0,0,175,T
8-NS,637,1,0,0,172,173,C
8-NS,638,0,0,0,175,175,C
8-NS,639,173,0,0,0,173,A
8-NS,640,0,168,0,1,169,T
8-NS,641,0,171,0,0,171,T
8-NS,642,0,171,0,0,171,T
8-NS,643,172,0,1,0,173,A
8-NS,644,0,0,0,176,176,C
8-NS,645,0,174,0,0,174,T
8-NS,646,1,2,0,172,175,C
8-NS,647,0,0,0,176,176,C
8-NS,648,173,0,0,0,173,A
8-NS,649,175,0,0,0,175,A
8-NS,650,173,0,0,0,173,A
8-NS,651,173,0,0,1,174,A
8-NS,652,0,0,0,173,173,C
8-NS,653,173,0,0,0,173,A
8-NS,654,0,0,173,0,173,G
8-NS,655,174,0,0,0,174,A
8-NS,656,173,0,0,0,173,A
8-NS,657,173,0,0,0,173,A
8-NS,658,0,1,0,173,174,C
8-NS,659,0,0,173,0,173,G
8-NS,660,0,0,176,0,176,G
8-NS,661,0,0,177,0,177,G
8-NS,662,174,0,0,0,174,A
8-NS,663,176,1,0,0,177,A
8-NS,664,177,0,1,0,178,A
8-NS,665,0,178,0,0,178,T
8-NS,666,0,0,180,0,180,G
8-NS,667,1,0,178,0,179,G
8-NS,668,0,3,0,173,176,C
8-NS,669,0,3,174,0,177,G
8-NS,670,175,1,1,0,177,A
8-NS,671,0,1,176,0,177,G
8-NS,672,176,0,0,0,176,A
8-NS,673,177,0,0,0,177,A
8-NS,674,0,0,0,177,177,C
8-NS,675,176,0,0,0,176,A
8-NS,676,0,0,176,0,176,G
8-NS,677,0,0,0,176,176,C
8-NS,678,0,175,0,0,175,T
8-NS,679,175,0,0,0,175,A
8-NS,680,0,0,177,0,177,G
8-NS,681,0,0,178,0,178,G
8-NS,682,0,175,0,0,175,T
8-NS,683,1,0,0,174,175,C
8-NS,684,173,0,0,0,173,A
8-NS,685,173,0,0,0,173,A
8-NS,686,173,0,0,0,173,A
8-NS,687,174,0,1,0,175,A
8-NS,688,0,0,175,0,175,G
8-NS,689,0,167,0,0,167,T
8-NS,690,0,163,0,1,164,T
8-NS,691,0,167,0,0,167,T
8-NS,692,0,2,164,0,166,G
8-NS,693,167,0,0,0,167,A
8-NS,694,166,0,0,0,166,A
8-NS,695,0,2,165,0,167,G
8-NS,696,161,0,0,0,161,A
8-NS,697,0,0,161,0,161,G
8-NS,698,161,0,0,0,161,A
8-NS,699,0,159,0,1,160,T
8-NS,700,160,0,1,0,161,A
8-NS,701,161,0,0,0,161,A
8-NS,702,0,0,161,0,161,G
8-NS,703,151,0,1,0,152,A
8-NS,704,0,152,0,0,152,T
8-NS,705,0,0,153,0,153,G
8-NS,706,0,1,153,0,154,G
8-NS,707,0,0,0,153,153,C
8-NS,708,0,154,0,0,154,T
8-NS,709,153,0,0,0,153,A
8-NS,710,154,0,0,0,154,A
8-NS,711,0,154,0,0,154,T
8-NS,712,0,154,0,0,154,T
8-NS,713,1,0,154,0,155,G
8-NS,714,152,0,0,0,152,A
8-NS,715,152,0,0,0,152,A
8-NS,716,0,2,149,0,151,G
8-NS,717,150,0,0,0,150,A
8-NS,718,149,0,0,0,149,A
8-NS,719,0,0,150,0,150,G
8-NS,720,0,143,1,0,144,T
8-NS,721,0,0,146,0,146,G
8-NS,722,145,0,0,0,145,A
8-NS,723,0,0,146,0,146,G
8-NS,724,145,0,1,0,146,A
8-NS,725,0,0,0,143,143,C
8-NS,726,142,0,0,0,142,A
8-NS,727,1,0,0,141,142,C
8-NS,728,134,0,0,0,134,A
8-NS,729,0,1,137,0,138,G
8-NS,730,138,0,0,0,138,A
8-NS,731,0,136,0,1,137,T
8-NS,732,0,138,0,0,138,T
8-NS,733,135,0,0,0,135,A
8-NS,734,134,0,0,0,134,A
8-NS,735,133,0,0,0,133,A
8-NS,736,135,0,0,0,135,A
8-NS,737,135,0,0,0,135,A
8-NS,738,1,0,0,129,130,C
8-NS,739,125,0,0,0,125,A
8-NS,740,126,0,0,0,126,A
8-NS,741,1,0,0,125,126,C
8-NS,742,0,124,0,0,124,T
8-NS,743,0,0,128,0,128,G
8-NS,744,129,0,0,0,129,A
8-NS,745,130,0,1,0,131,A
8-NS,746,130,0,0,0,130,A
8-NS,747,129,0,0,0,129,A
8-NS,748,0,128,0,0,128,T
8-NS,749,127,0,0,0,127,A
8-NS,750,0,0,128,0,128,G
8-NS,751,0,1,0,127,128,C
8-NS,752,0,127,0,0,127,T
8-NS,753,0,125,0,0,125,T
8-NS,754,0,126,0,0,126,T
8-NS,755,0,0,126,0,126,G
8-NS,756,127,0,0,0,127,A
8-NS,757,126,0,1,0,127,A
8-NS,758,0,0,0,126,126,C
8-NS,759,122,0,0,0,122,A
8-NS,760,121,0,0,0,121,A
8-NS,761,122,0,0,0,122,A
8-NS,762,0,122,0,0,122,T
8-NS,763,121,0,0,1,122,A
8-NS,764,120,0,0,0,120,A
8-NS,765,0,0,0,119,119,C
8-NS,766,118,0,0,0,118,A
8-NS,767,0,115,0,0,115,T
8-NS,768,0,115,0,0,115,T
8-NS,769,1,0,0,113,114,C
8-NS,770,115,0,0,0,115,A
8-NS,771,0,114,0,0,114,T
8-NS,772,0,1,113,0,114,G
8-NS,773,0,0,0,114,114,C
8-NS,774,111,0,0,0,111,A
8-NS,775,110,0,1,0,111,A
8-NS,776,0,0,113,0,113,G
8-NS,777,0,0,0,112,112,C
8-NS,778,107,0,0,0,107,A
8-NS,779,0,105,0,1,106,T
8-NS,780,0,104,0,0,104,T
8-NS,781,104,0,0,0,104,A
8-NS,782,0,0,0,104,104,C
8-NS,783,101,0,0,0,101,A
8-NS,784,0,0,87,0,87,G
8-NS,785,0,0,0,87,87,C
8-NS,786,0,87,0,0,87,T
8-NS,787,0,0,87,0,87,G
8-NS,788,0,0,0,84,84,C
8-NS,789,0,83,0,0,83,T
8-NS,790,0,0,83,0,83,G
8-NS,791,0,82,0,0,82,T
8-NS,792,0,80,0,1,81,T
8-NS,793,0,82,0,0,82,T
8-NS,794,0,1,80,0,81,G
8-NS,795,78,0,2,0,80,A
8-NS,796,77,0,0,0,77,A
8-NS,797,0,0,76,0,76,G
8-NS,798,0,74,0,1,75,T
8-NS,799,1,0,69,0,70,G
8-NS,800,0,0,72,0,72,G
8-NS,801,72,0,0,0,72,A
8-NS,802,72,0,0,0,72,A
8-NS,803,0,1,0,71,72,C
8-NS,804,67,0,0,0,67,A
8-NS,805,1,0,67,0,68,G
8-NS,806,0,0,66,0,66,G
8-NS,807,65,0,0,0,65,A
8-NS,808,0,0,65,0,65,G
8-NS,809,58,0,0,0,58,A
8-NS,810,0,57,0,0,57,T
8-NS,811,56,0,0,0,56,A
8-NS,812,55,0,0,0,55,A
8-NS,813,0,0,55,0,55,G
8-NS,814,53,0,0,0,53,A
8-NS,815,54,0,0,0,54,A
8-NS,816,0,0,0,54,54,C
8-NS,817,0,45,0,0,45,T
8-NS,818,0,44,0,0,44,T
8-NS,819,0,44,0,0,44,T
8-NS,820,0,0,0,44,44,C
8-NS,821,0,41,0,0,41,T
8-NS,822,0,0,0,41,41,C
8-NS,823,38,0,0,0,38,A
8-NS,824,0,38,0,0,38,T
8-NS,825,0,37,0,1,38,T
8-NS,826,0,37,0,0,37,T
8-NS,827,0,0,0,37,37,C
8-NS,828,34,0,0,0,34,A
8-NS,829,0,0,34,0,34,G
8-NS,830,0,0,0,34,34,C
8-NS,831,1,29,0,0,30,T
8-NS,832,0,30,0,0,30,T
8-NS,833,28,0,0,0,28,A
8-NS,834,0,27,0,1,28,T
8-NS,835,0,26,0,1,27,T
8-NS,836,0,25,0,0,25,T
8-NS,837,25,0,0,0,25,A
8-NS,838,25,0,0,0,25,A
8-NS,839,0,24,0,0,24,T
8-NS,840,0,0,24,0,24,G
8-NS,841,23,0,0,0,23,A
8-NS,842,0,22,0,0,22,T
8-NS,843,22,0,0,0,22,A
8-NS,844,22,0,0,0,22,A
8-NS,845,22,0,0,0,22,A
8-NS,846,22,0,0,0,22,A
8-NS,847,21,0,0,0,21,A
8-NS,848,21,0,0,0,21,A
8-NS,849,0,0,0,21,21,C
8-NS,850,17,0,0,0,17,A
8-NS,851,0,0,0,17,17,C
8-NS,852,0,0,1,15,16,C
8-NS,853,0,0,0,16,16,C
8-NS,854,0,15,0,0,15,T
8-NS,855,0,13,0,0,13,T
8-NS,856,0,0,13,0,13,G
8-NS,857,0,12,0,0,12,T
8-NS,858,0,12,0,0,12,T
8-NS,859,0,11,0,0,11,T
8-NS,860,0,0,0,4,4,C
8-NS,861,0,4,0,0,4,T
8-NS,862,3,0,0,0,3,A
8-NS,863,0,0,0,3,3,C
