Gene,Position,A,T,G,C,Coverage,Consensus
1-PB2,1,642,0,0,0,642,A
1-PB2,2,0,642,0,0,642,T
1-PB2,3,0,0,649,0,649,G
1-PB2,4,0,0,647,0,647,G
1-PB2,5,648,1,1,0,650,A
1-PB2,6,652,0,0,0,652,A
1-PB2,7,650,0,0,0,650,A
1-PB2,8,0,1,747,0,748,G
1-PB2,9,744,0,2,0,746,A
1-PB2,10,751,0,0,0,751,A
1-PB2,11,0,771,0,0,771,T
1-PB2,12,767,0,0,0,767,A
1-PB2,13,773,0,0,0,773,A
1-PB2,14,772,0,1,0,773,A
1-PB2,15,773,0,1,0,774,A
1-PB2,16,0,2,807,0,809,G
1-PB2,17,806,0,0,0,806,A
1-PB2,18,809,0,0,0,809,A
1-PB2,19,0,0,0,826,826,C
1-PB2,20,0,829,0,0,829,T
1-PB2,21,836,0,0,0,836,A
1-PB2,22,0,1,0,840,841,C
1-PB2,23,0,4,834,0,838,G
1-PB2,24,0,2,855,0,857,G
1-PB2,25,862,0,0,0,862,A
1-PB2,26,881,0,0,0,881,A
1-PB2,27,0,884,0,0,884,T
1-PB2,28,2,0,0,884,886,C
1-PB2,29,0,886,1,2,889,T
1-PB2,30,1,3,892,0,896,G
1-PB2,31,897,0,0,0,897,A
1-PB2,32,0,906,0,0,906,T
1-PB2,33,0,0,907,0,907,G
1-PB2,34,0,930,0,1,931,T
1-PB2,35,2,0,0,922,924,C
1-PB2,36,0,0,920,1,921,G
1-PB2,37,0,0,0,927,927,C
1-PB2,38,921,0,1,0,922,A
1-PB2,39,0,0,979,0,979,G
1-PB2,40,0,978,0,1,979,T
1-PB2,41,2,0,0,985,987,C
1-PB2,42,0,983,0,0,983,T
1-PB2,43,1,0,0,988,989,C
1-PB2,44,1,0,985,0,986,G
1-PB2,45,0,0,0,986,986,C
1-PB2,46,987,0,0,0,987,A
1-PB2,47,0,1,0,1006,1007,C
1-PB2,48,0,991,0,2,993,T
1-PB2,49,2,1,0,1023,1026,C
1-PB2,50,0,0,1033,0,1033,G
1-PB2,51,0,1,0,1031,1032,C
1-PB2,52,0,1,1032,0,1033,G
1-PB2,53,1029,1,0,0,1030,A
1-PB2,54,0,0,1038,0,1038,G
1-PB2,55,1059,0,0,0,1059,A
1-PB2,56,0,1053,0,0,1053,T
1-PB2,57,1059,0,0,0,1059,A
1-PB2,58,0,0,0,1054,1054,C
1-PB2,59,0,1045,0,3,1048,T
1-PB2,60,1,3,1058,0,1062,G
1-PB2,61,1063,0,1,0,1064,A
1-PB2,62,0,0,0,1079,1079,C
1-PB2,63,1081,0,0,0,1081,A
1-PB2,64,1067,0,0,0,1067,A
1-PB2,65,1079,0,2,0,1081,A
1-PB2,66,1103,0,0,0,1103,A
1-PB2,67,1105,0,1,0,1106,A
1-PB2,68,0,1,0,1113,1114,C
1-PB2,69,4,0,0,1111,1115,C
1-PB2,70,1144,1,2,0,1147,A
1-PB2,71,0,0,0,1165,1165,C
1-PB2,72,1155,0,0,0,1155,A
1-PB2,73,0,0,1185,0,1185,G
1-PB2,74,0,1166,0,1,1167,T
1-PB2,75,0,1,1206,0,1207,G
1-PB2,76,1,1,1211,0,1213,G
1-PB2,77,1202,0,4,0,1206,A
1-PB2,78,1,1,0,1268,1270,C
1-PB2,79,4,0,0,1252,1256,C
1-PB2,80,1267,0,1,0,1268,A
1-PB2,81,0,1266,0,0,1266,T
1-PB2,82,1249,0,0,0,1249,A
1-PB2,83,0,1244,0,0,1244,T
1-PB2,84,0,1,1236,0,1237,G
1-PB2,85,1,0,1249,0,1250,G
1-PB2,86,0,0,0,1247,1247,C
1-PB2,87,0,1,0,1226,1227,C
1-PB2,88,1215,0,0,0,1215,A
1-PB2,89,0,1312,0,0,1312,T
1-PB2,90,1313,1,0,0,1314,A
1-PB2,91,1363,0,1,0,1364,A
1-PB2,92,0,1369,0,0,1369,T
1-PB2,93,0,1357,0,0,1357,T
1-PB2,94,1367,1,0,0,1368,A
1-PB2,95,1372,0,1,0,1373,A
1-PB2,96,0,1,1417,0,1418,G
1-PB2,97,1413,0,1,0,1414,A
1-PB2,98,1383,0,1,0,1384,A
1-PB2,99,0,0,1459,0,1459,G
1-PB2,100,0,1425,0,0,1425,T
1-PB2,101,1445,0,0,0,1445,A
1-PB2,102,0,0,0,1448,1448,C
1-PB2,103,1444,0,0,0,1444,A
1-PB2,104,0,0,0,1502,1502,C
1-PB2,105,1491,0,0,0,1491,A
1-PB2,106,0,1491,0,2,1493,T
1-PB2,107,3,1,0,1499,1503,C
1-PB2,108,2,2,1473,0,1477,G
1-PB2,109,0,5,1460,0,1465,G
1-PB2,110,0,3,1467,0,1470,G
1-PB2,111,0,3,1465,0,1468,G
1-PB2,112,1470,0,0,0,1470,A
1-PB2,113,0,1,1468,0,1469,G
1-PB2,114,1467,0,2,0,1469,A
1-PB2,115,0,0,0,1476,1476,C
1-PB2,116,1475,0,2,0,1477,A
1-PB2,117,0,1,1497,0,1498,G
1-PB2,118,0,2,1521,0,1523,G
1-PB2,119,1522,0,3,0,1525,A
1-PB2,120,1529,1,2,0,1532,A
1-PB2,121,1536,0,0,0,1536,A
1-PB2,122,1534,0,0,0,1534,A
1-PB2,123,1,2,1537,0,1540,G
1-PB2,124,1526,0,3,0,1529,A
1-PB2,125,1530,0,2,0,1532,A
1-PB2,126,0,0,0,1530,1530,C
1-PB2,127,1,0,0,1517,1518,C
1-PB2,128,4,2,0,1519,1525,C
1-PB2,129,1,0,1527,0,1528,G
1-PB2,130,0,1522,0,0,1522,T
1-PB2,131,1,2,0,1524,1527,C
1-PB2,132,1536,0,0,0,1536,A
1-PB2,133,0,0,0,1561,1561,C
1-PB2,134,0,1553,0,1,1554,T
1-PB2,135,0,1559,0,0,1559,T
1-PB2,136,1557,0,0,0,1557,A
1-PB2,137,0,0,1589,0,1589,G
1-PB2,138,0,1,1588,1,1590,G
1-PB2,139,1586,0,1,0,1587,A
1-PB2,140,0,1581,0,2,1583,T
1-PB2,141,0,5,1603,0,1608,G
1-PB2,142,1612,0,0,0,1612,A
1-PB2,143,1617,0,2,0,1619,A
1-PB2,144,1625,0,1,0,1626,A
1-PB2,145,0,1626,0,1,1627,T
1-PB2,146,1,4,1632,0,1637,G
1-PB2,147,1,0,1650,0,1651,G
1-PB2,148,1641,0,0,0,1641,A
1-PB2,149,0,1641,0,1,1642,T
1-PB2,150,0,0,1633,0,1633,G
1-PB2,151,1600,0,2,0,1602,A
1-PB2,152,0,1611,0,3,1614,T
1-PB2,153,1,5,1616,0,1622,G
1-PB2,154,0,0,1632,0,1632,G
1-PB2,155,0,0,1,1614,1615,C
1-PB2,156,1605,0,1,0,1606,A
1-PB2,157,1622,0,0,0,1622,A
1-PB2,158,1,1626,0,0,1627,T
1-PB2,159,0,7,1681,0,1688,G
1-PB2,160,1696,0,0,0,1696,A
1-PB2,161,1688,0,0,0,1688,A
1-PB2,162,1692,0,4,0,1696,A
1-PB2,163,0,1709,0,2,1711,T
1-PB2,164,1718,1,0,0,1719,A
1-PB2,165,0,0,0,1750,1750,C
1-PB2,166,0,0,0,1731,1731,C
1-PB2,167,0,0,0,1740,1740,C
1-PB2,168,1727,0,0,0,1727,A
1-PB2,169,1716,0,1,0,1717,A
1-PB2,170,0,1716,0,2,1718,T
1-PB2,171,5,0,0,1722,1727,C
1-PB2,172,1714,0,0,0,1714,A
1-PB2,173,0,1,0,1761,1762,C
1-PB2,174,0,1739,0,0,1739,T
1-PB2,175,0,0,1741,0,1741,G
1-PB2,176,0,0,0,1740,1740,C
1-PB2,177,1,1731,0,5,1737,T
1-PB2,178,1,2,1752,0,1755,G
1-PB2,179,1754,0,1,0,1755,A
1-PB2,180,0,0,0,1772,1772,C
1-PB2,181,1775,0,1,0,1776,A
1-PB2,182,1739,0,0,0,1739,A
1-PB2,183,1743,0,5,0,1748,A
1-PB2,184,1740,0,2,0,1742,A
1-PB2,185,0,3,1771,0,1774,G
1-PB2,186,0,2,1769,0,1771,G
1-PB2,187,1752,0,4,0,1756,A
1-PB2,188,0,1761,0,1,1762,T
1-PB2,189,1760,0,3,0,1763,A
1-PB2,190,1779,0,2,0,1781,A
1-PB2,191,2,0,0,1801,1803,C
1-PB2,192,1804,0,0,0,1804,A
1-PB2,193,0,3,1806,0,1809,G
1-PB2,194,1787,0,1,0,1788,A
1-PB2,195,1783,0,2,0,1785,A
1-PB2,196,1786,0,1,0,1787,A
1-PB2,197,0,1782,0,0,1782,T
1-PB2,198,0,0,1786,0,1786,G
1-PB2,199,0,1,1800,0,1801,G
1-PB2,200,0,1785,0,2,1787,T
1-PB2,201,0,1780,0,0,1780,T
1-PB2,202,1,0,0,1784,1785,C
1-PB2,203,2,2,0,1781,1785,C
1-PB2,204,0,1,1802,0,1803,G
1-PB2,205,1,4,1796,0,1801,G
1-PB2,206,1793,0,1,0,1794,A
1-PB2,207,1,4,1797,0,1802,G
1-PB2,208,1767,1,2,0,1770,A
1-PB2,209,5,2,1806,0,1813,G
1-PB2,210,1808,1,3,0,1812,A
1-PB2,211,1809,0,2,1,1812,A
1-PB2,212,1818,0,1,0,1819,A
1-PB2,213,0,1807,0,0,1807,T
1-PB2,214,1,9,1815,0,1825,G
1-PB2,215,1829,0,5,0,1834,A
1-PB2,216,1820,0,1,0,1821,A
1-PB2,217,1,0,0,1831,1832,C
1-PB2,218,1795,0,0,0,1795,A
1-PB2,219,1803,0,1,0,1804,A
1-PB2,220,0,2,1827,0,1829,G
1-PB2,221,1,1,1852,0,1854,G
1-PB2,222,1855,0,1,0,1856,A
1-PB2,223,0,1,0,1852,1853,C
1-PB2,224,1855,0,1,0,1856,A
1-PB2,225,1855,0,1,0,1856,A
1-PB2,226,1941,0,0,0,1941,A
1-PB2,227,0,0,0,1970,1970,C
1-PB2,228,0,1942,0,2,1944,T
1-PB2,229,1,1,0,1981,1983,C
1-PB2,230,0,1948,0,0,1948,T
1-PB2,231,1957,0,2,0,1959,A
1-PB2,232,0,1950,0,1,1951,T
1-PB2,233,1,0,1951,0,1952,G
1-PB2,234,1,1,2007,1,2010,G
1-PB2,235,1923,0,3,0,1926,A
1-PB2,236,2,0,1941,0,1943,G
1-PB2,237,0,1946,0,0,1946,T
1-PB2,238,1922,0,1,0,1923,A
1-PB2,239,1932,0,2,1,1935,A
1-PB2,240,1921,0,1,0,1922,A
1-PB2,241,1921,0,2,0,1923,A
1-PB2,242,0,1912,0,0,1912,T
1-PB2,243,1,3,1889,1,1894,G
1-PB2,244,1863,0,1,0,1864,A
1-PB2,245,6,0,1857,0,1863,G
1-PB2,246,1,1830,1,3,1835,T
1-PB2,247,0,4,1840,0,1844,G
1-PB2,248,1891,0,0,0,1891,A
1-PB2,249,0,1912,0,2,1914,T
1-PB2,250,0,1,1918,0,1919,G
1-PB2,251,0,0,0,1902,1902,C
1-PB2,252,0,1895,0,2,1897,T
1-PB2,253,1,1,1961,0,1963,G
1-PB2,254,1,4,1948,0,1953,G
1-PB2,255,1974,0,2,0,1976,A
1-PB2,256,0,1981,0,3,1984,T
1-PB2,257,3,0,2,1983,1988,C
1-PB2,258,1996,1,2,0,1999,A
1-PB2,259,2,1,2060,0,2063,G
1-PB2,260,2056,0,4,0,2060,A
1-PB2,261,1,2061,0,0,2062,T
1-PB2,262,1996,0,1,0,1997,A
1-PB2,263,1,2,2058,0,2061,G
1-PB2,264,2036,0,4,0,2040,A
1-PB2,265,0,1,2074,0,2075,G
1-PB2,266,1,2028,0,0,2029,T
1-PB2,267,0,3,2028,0,2031,G
1-PB2,268,1988,1,2,0,1991,A
1-PB2,269,1,1983,0,3,1987,T
1-PB2,270,1,9,2003,1,2014,G
1-PB2,271,0,0,2063,1,2064,G
1-PB2,272,0,2024,0,0,2024,T
1-PB2,273,2037,1,0,0,2038,A
1-PB2,274,0,2005,0,2,2007,T
1-PB2,275,4,0,0,2007,2011,C
1-PB2,276,2044,0,1,0,2045,A
1-PB2,277,0,1,0,2095,2096,C
1-PB2,278,1,4,0,2083,2088,C
1-PB2,279,0,2042,0,0,2042,T
1-PB2,280,0,2019,0,1,2020,T
1-PB2,281,0,2017,0,0,2017,T
1-PB2,282,0,2,2057,0,2059,G
1-PB2,283,0,1,2048,0,2049,G
1-PB2,284,2,0,0,2077,2079,C
1-PB2,285,0,2040,1,4,2045,T
1-PB2,286,0,0,2054,1,2055,G
1-PB2,287,0,2052,1,0,2053,T
1-PB2,288,2058,0,0,0,2058,A
1-PB2,289,2069,0,1,0,2070,A
1-PB2,290,0,0,0,2067,2067,C
1-PB2,291,2032,0,0,0,2032,A
1-PB2,292,0,2025,1,0,2026,T
1-PB2,293,1,1,2004,0,2006,G
1-PB2,294,1,1,2045,1,2048,G
1-PB2,295,0,2022,0,2,2024,T
1-PB2,296,1,1,2023,1,2026,G
1-PB2,297,1,3,2048,0,2052,G
1-PB2,298,2043,0,2,0,2045,A
1-PB2,299,2060,0,4,0,2064,A
1-PB2,300,0,2062,0,0,2062,T
1-PB2,301,2054,0,3,0,2057,A
1-PB2,302,0,0,2093,0,2093,G
1-PB2,303,2067,0,1,1,2069,A
1-PB2,304,2071,0,0,0,2071,A
1-PB2,305,2066,0,1,0,2067,A
1-PB2,306,0,2018,0,2,2020,T
1-PB2,307,1,5,2021,0,2027,G
1-PB2,308,1,3,2022,0,2026,G
1-PB2,309,2024,0,2,0,2026,A
1-PB2,310,0,0,0,2044,2044,C
1-PB2,311,0,0,0,2035,2035,C
1-PB2,312,4,0,0,2027,2031,C
1-PB2,313,3,0,2039,0,2042,G
1-PB2,314,0,2042,0,1,2043,T
1-PB2,315,1,1,2085,0,2087,G
1-PB2,316,2088,1,2,0,2091,A
1-PB2,317,0,2,0,2109,2111,C
1-PB2,318,2097,0,12,0,2109,A
1-PB2,319,2093,0,6,0,2099,A
1-PB2,320,0,0,2172,0,2172,G
1-PB2,321,2,2150,0,1,2153,T
1-PB2,322,2159,0,0,0,2159,A
1-PB2,323,0,1,0,2135,2136,C
1-PB2,324,2,7,2082,0,2091,G
1-PB2,325,0,0,2138,0,2138,G
1-PB2,326,0,2123,0,2,2125,T
1-PB2,327,2,0,0,2144,2146,C
1-PB2,328,1,0,0,2151,2152,C
1-PB2,329,2112,0,2,0,2114,A
1-PB2,330,1,2129,0,1,2131,T
1-PB2,331,0,2131,0,1,2132,T
1-PB2,332,2225,0,0,0,2225,A
1-PB2,333,0,1,0,2231,2232,C
1-PB2,334,2,0,0,2183,2185,C
1-PB2,335,6,0,0,2180,2186,C
1-PB2,336,2155,0,2,0,2157,A
1-PB2,337,2164,0,0,0,2164,A
1-PB2,338,2164,0,1,0,2165,A
1-PB2,339,2158,0,1,1,2160,A
1-PB2,340,0,0,2182,0,2182,G
1-PB2,341,0,2078,0,0,2078,T
1-PB2,342,2,0,2146,0,2148,G
1-PB2,343,0,2146,0,2,2148,T
1-PB2,344,2150,0,0,0,2150,A
1-PB2,345,0,0,0,2154,2154,C
1-PB2,346,2147,0,0,0,2147,A
1-PB2,347,2151,0,3,0,2154,A
1-PB2,348,0,1,2168,0,2169,G
1-PB2,349,2137,0,1,2,2140,A
1-PB2,350,0,0,0,2155,2155,C
1-PB2,351,0,2121,0,5,2126,T
1-PB2,352,0,2144,0,0,2144,T
1-PB2,353,2149,0,1,0,2150,A
1-PB2,354,0,2144,0,1,2145,T
1-PB2,355,0,2141,0,2,2143,T
1-PB2,356,2,2120,0,0,2122,T
1-PB2,357,6,1,0,2117,2124,C
1-PB2,358,1,4,2115,0,2120,G
1-PB2,359,2106,0,4,0,2110,A
1-PB2,360,0,1,0,2112,2113,C
1-PB2,361,2097,0,1,0,2098,A
1-PB2,362,2089,0,1,0,2090,A
1-PB2,363,2090,0,1,0,2091,A
1-PB2,364,0,1,2110,0,2111,G
1-PB2,365,0,2099,0,0,2099,T
1-PB2,366,4,1,0,2115,2120,C
1-PB2,367,1,3,2116,0,2120,G
1-PB2,368,2101,0,0,0,2101,A
1-PB2,369,2098,0,3,0,2101,A
1-PB2,370,2107,0,0,0,2107,A
1-PB2,371,2,1,2175,0,2178,G
1-PB2,372,0,0,2207,0,2207,G
1-PB2,373,0,2182,0,0,2182,T
1-PB2,374,0,2190,0,3,2193,T
1-PB2,375,2183,0,0,0,2183,A
1-PB2,376,2189,0,1,0,2190,A
1-PB2,377,2190,0,1,0,2191,A
1-PB2,378,2212,0,1,0,2213,A
1-PB2,379,0,0,0,2239,2239,C
1-PB2,380,2180,0,0,0,2180,A
1-PB2,381,0,2152,0,0,2152,T
1-PB2,382,0,0,2154,0,2154,G
1-PB2,383,1,3,2154,0,2158,G
1-PB2,384,2162,0,3,0,2165,A
1-PB2,385,2170,0,2,0,2172,A
1-PB2,386,0,0,0,2246,2246,C
1-PB2,387,3,0,0,2265,2268,C
1-PB2,388,0,2256,1,3,2260,T
1-PB2,389,0,2255,0,2,2257,T
1-PB2,390,2,2260,0,5,2267,T
1-PB2,391,0,3,2254,0,2257,G
1-PB2,392,0,6,2262,0,2268,G
1-PB2,393,1,2,0,2246,2249,C
1-PB2,394,1,0,0,2243,2244,C
1-PB2,395,3,6,0,2236,2245,C
1-PB2,396,0,2189,0,0,2189,T
1-PB2,397,0,0,2223,0,2223,G
1-PB2,398,0,2213,0,4,2217,T
1-PB2,399,0,2217,0,1,2218,T
1-PB2,400,6,1,0,2207,2214,C
1-PB2,401,2202,0,1,0,2203,A
1-PB2,402,0,2195,0,1,2196,T
1-PB2,403,0,2205,0,0,2205,T
1-PB2,404,0,2206,0,0,2206,T
1-PB2,405,0,2206,0,0,2206,T
1-PB2,406,2181,0,2,0,2183,A
1-PB2,407,1,1,2179,0,2181,G
1-PB2,408,2177,1,0,0,2178,A
1-PB2,409,2188,0,0,0,2188,A
1-PB2,410,2185,0,1,0,2186,A
1-PB2,411,0,2159,0,1,2160,T
1-PB2,412,5,0,0,2165,2170,C
1-PB2,413,2174,0,0,0,2174,A
1-PB2,414,2175,0,1,1,2177,A
1-PB2,415,0,0,2204,0,2204,G
1-PB2,416,0,2180,0,0,2180,T
1-PB2,417,5,0,0,2194,2199,C
1-PB2,418,2210,0,0,0,2210,A
1-PB2,419,2224,0,6,0,2230,A
1-PB2,420,3,1,2227,0,2231,G
1-PB2,421,2220,0,6,0,2226,A
1-PB2,422,0,2227,0,0,2227,T
1-PB2,423,2247,0,0,0,2247,A
1-PB2,424,0,4,0,2228,2232,C
1-PB2,425,1,0,2241,0,2242,G
1-PB2,426,1,0,0,2272,2273,C
1-PB2,427,2250,2,2,0,2254,A
1-PB2,428,2,0,2281,0,2283,G
1-PB2,429,2267,0,1,0,2268,A
1-PB2,430,2282,0,3,0,2285,A
1-PB2,431,0,7,2309,0,2316,G
1-PB2,432,2264,0,7,0,2271,A
1-PB2,433,0,1,2288,0,2289,G
1-PB2,434,1,2267,0,0,2268,T
1-PB2,435,2263,0,4,0,2267,A
1-PB2,436,0,6,2303,0,2309,G
1-PB2,437,2310,0,2,0,2312,A
1-PB2,438,0,0,0,2380,2380,C
1-PB2,439,2333,0,1,0,2334,A
1-PB2,440,0,2297,0,0,2297,T
1-PB2,441,2281,0,0,0,2281,A
1-PB2,442,2269,0,0,1,2270,A
1-PB2,443,2270,0,1,0,2271,A
1-PB2,444,1,1,0,2302,2304,C
1-PB2,445,3,1,0,2258,2262,C
1-PB2,446,2,0,0,2245,2247,C
1-PB2,447,0,2104,0,1,2105,T
1-PB2,448,0,2,2121,0,2123,G
1-PB2,449,1,0,2154,0,2155,G
1-PB2,450,0,2144,0,2,2146,T
1-PB2,451,5,1,0,2146,2152,C
1-PB2,452,2160,0,0,0,2160,A
1-PB2,453,1,2151,0,3,2155,T
1-PB2,454,0,0,2165,0,2165,G
1-PB2,455,0,0,1,2166,2167,C
1-PB2,456,2156,0,1,0,2157,A
1-PB2,457,0,3,2173,0,2176,G
1-PB2,458,2114,0,2,0,2116,A
1-PB2,459,1,0,0,2162,2163,C
1-PB2,460,3,0,0,2157,2160,C
1-PB2,461,1,2095,0,2,2098,T
1-PB2,462,0,0,0,2123,2123,C
1-PB2,463,2092,0,0,1,2093,A
1-PB2,464,1,0,2132,0,2133,G
1-PB2,465,1,2128,0,1,2130,T
1-PB2,466,1,0,2140,0,2141,G
1-PB2,467,0,2,0,2126,2128,C
1-PB2,468,4,1,0,2101,2106,C
1-PB2,469,2109,1,0,0,2110,A
1-PB2,470,2110,0,0,0,2110,A
1-PB2,471,2103,0,3,1,2107,A
1-PB2,472,1,2,2101,0,2104,G
1-PB2,473,2045,0,2,0,2047,A
1-PB2,474,0,3,2053,0,2056,G
1-PB2,475,2,3,2042,1,2048,G
1-PB2,476,1,0,0,2043,2044,C
1-PB2,477,2049,0,2,0,2051,A
1-PB2,478,1,1,1,2056,2059,C
1-PB2,479,2057,0,3,0,2060,A
1-PB2,480,2096,0,2,0,2098,A
1-PB2,481,0,2,2120,0,2122,G
1-PB2,482,2151,1,2,0,2154,A
1-PB2,483,0,2137,0,0,2137,T
1-PB2,484,0,0,2142,0,2142,G
1-PB2,485,0,2123,0,3,2126,T
1-PB2,486,2139,0,3,0,2142,A
1-PB2,487,2143,0,0,1,2144,A
1-PB2,488,0,2158,0,1,2159,T
1-PB2,489,0,2053,0,0,2053,T
1-PB2,490,2047,0,1,0,2048,A
1-PB2,491,0,2001,0,0,2001,T
1-PB2,492,2,1,2001,0,2004,G
1-PB2,493,0,0,1999,0,1999,G
1-PB2,494,1977,0,2,1,1980,A
1-PB2,495,1976,0,1,0,1977,A
1-PB2,496,0,0,1977,0,1977,G
1-PB2,497,0,1967,0,0,1967,T
1-PB2,498,0,1981,0,0,1981,T
1-PB2,499,0,1,1986,0,1987,G
1-PB2,500,0,1974,1,1,1976,T
1-PB2,501,0,1964,0,3,1967,T
1-PB2,502,0,1973,0,1,1974,T
1-PB2,503,0,1973,0,1,1974,T
1-PB2,504,0,1971,0,3,1974,T
1-PB2,505,0,0,0,1978,1978,C
1-PB2,506,3,0,1,1974,1978,C
1-PB2,507,5,1,0,1990,1996,C
1-PB2,508,1991,0,0,0,1991,A
1-PB2,509,1994,0,1,0,1995,A
1-PB2,510,0,1999,0,1,2000,T
1-PB2,511,1,1,2016,0,2018,G
1-PB2,512,2011,0,1,0,2012,A
1-PB2,513,1999,0,4,0,2003,A
1-PB2,514,0,0,2036,0,2036,G
1-PB2,515,1,1994,0,1,1996,T
1-PB2,516,0,1,1996,0,1997,G
1-PB2,517,0,0,1992,0,1992,G
1-PB2,518,1,1,1980,0,1982,G
1-PB2,519,1987,0,4,0,1991,A
1-PB2,520,0,0,1984,0,1984,G
1-PB2,521,0,1,0,1967,1968,C
1-PB2,522,0,1,0,1988,1989,C
1-PB2,523,1977,0,2,0,1979,A
1-PB2,524,1,0,2015,0,2016,G
1-PB2,525,3,0,2035,0,2038,G
1-PB2,526,2048,1,1,0,2050,A
1-PB2,527,0,2034,0,1,2035,T
1-PB2,528,2027,0,3,0,2030,A
1-PB2,529,2,0,0,2022,2024,C
1-PB2,530,0,2016,0,3,2019,T
1-PB2,531,2027,0,1,0,2028,A
1-PB2,532,2016,0,1,0,2017,A
1-PB2,533,0,0,0,2022,2022,C
1-PB2,534,1982,0,0,0,1982,A
1-PB2,535,0,1953,0,1,1954,T
1-PB2,536,2,1,0,1960,1963,C
1-PB2,537,1937,0,2,0,1939,A
1-PB2,538,0,5,1947,0,1952,G
1-PB2,539,1957,0,0,1,1958,A
1-PB2,540,1955,1,1,0,1957,A
1-PB2,541,0,1950,0,2,1952,T
1-PB2,542,3,1,0,1920,1924,C
1-PB2,543,1925,0,3,0,1928,A
1-PB2,544,0,0,0,1981,1981,C
1-PB2,545,1972,0,0,1,1973,A
1-PB2,546,1993,0,0,0,1993,A
1-PB2,547,0,1969,1,3,1973,T
1-PB2,548,0,1969,0,1,1970,T
1-PB2,549,1983,0,0,0,1983,A
1-PB2,550,1988,0,2,0,1990,A
1-PB2,551,1,0,0,2007,2008,C
1-PB2,552,1984,0,0,0,1984,A
1-PB2,553,1962,0,2,0,1964,A
1-PB2,554,0,1987,0,0,1987,T
1-PB2,555,1979,0,0,0,1979,A
1-PB2,556,1976,0,3,1,1980,A
1-PB2,557,0,0,0,1988,1988,C
1-PB2,558,0,1969,0,1,1970,T
1-PB2,559,1971,0,1,0,1972,A
1-PB2,560,1957,0,0,1,1958,A
1-PB2,561,1961,0,3,0,1964,A
1-PB2,562,0,1,1968,0,1969,G
1-PB2,563,1934,0,2,0,1936,A
1-PB2,564,0,4,1952,0,1956,G
1-PB2,565,1950,0,0,0,1950,A
1-PB2,566,1946,0,4,0,1950,A
1-PB2,567,1954,0,1,0,1955,A
1-PB2,568,1955,0,0,0,1955,A
1-PB2,569,1965,0,3,1,1969,A
1-PB2,570,1956,0,1,0,1957,A
1-PB2,571,1,0,1968,0,1969,G
1-PB2,572,1972,0,1,0,1973,A
1-PB2,573,1941,0,4,0,1945,A
1-PB2,574,0,3,1940,0,1943,G
1-PB2,575,1952,0,0,0,1952,A
1-PB2,576,1951,0,0,0,1951,A
1-PB2,577,1,0,0,1959,1960,C
1-PB2,578,0,1909,0,5,1914,T
1-PB2,579,2,2,0,1942,1946,C
1-PB2,580,0,0,0,1951,1951,C
1-PB2,581,2,3,1949,0,1954,G
1-PB2,582,1953,1,2,0,1956,A
1-PB2,583,0,2,1955,0,1957,G
1-PB2,584,1955,0,0,0,1955,A
1-PB2,585,0,1934,0,0,1934,T
1-PB2,586,0,1928,0,3,1931,T
1-PB2,587,1,0,1923,0,1924,G
1-PB2,588,0,0,0,1923,1923,C
1-PB2,589,1935,0,0,2,1937,A
1-PB2,590,1939,0,0,0,1939,A
1-PB2,591,1936,0,0,0,1936,A
1-PB2,592,1940,1,0,0,1941,A
1-PB2,593,0,1915,0,0,1915,T
1-PB2,594,0,1894,0,0,1894,T
1-PB2,595,0,1881,0,0,1881,T
1-PB2,596,3,0,0,1886,1889,C
1-PB2,597,1,1859,0,2,1862,T
1-PB2,598,8,0,0,1968,1976,C
1-PB2,599,2,0,0,1990,1992,C
1-PB2,600,3,0,0,2109,2112,C
1-PB2,601,1,2075,0,2,2078,T
1-PB2,602,0,2096,0,1,2097,T
1-PB2,603,0,1,2108,0,2109,G
1-PB2,604,2099,0,3,0,2102,A
1-PB2,605,0,2138,0,1,2139,T
1-PB2,606,0,3,2176,0,2179,G
1-PB2,607,2,1,2370,0,2373,G
1-PB2,608,0,2400,0,4,2404,T
1-PB2,609,0,2390,1,2,2393,T
1-PB2,610,0,1,2539,0,2540,G
1-PB2,611,0,1,0,2556,2557,C
1-PB2,612,2623,0,2,0,2625,A
1-PB2,613,0,2620,0,2,2622,T
1-PB2,614,2640,0,2,2,2644,A
1-PB2,615,0,0,0,2761,2761,C
1-PB2,616,3026,0,0,4,3030,A
1-PB2,617,0,3129,0,4,3133,T
1-PB2,618,4,1,3285,0,3290,G
1-PB2,619,1,3246,0,0,3247,T
1-PB2,620,1,3248,0,2,3251,T
1-PB2,621,3224,0,4,0,3228,A
1-PB2,622,0,1,3222,0,3223,G
1-PB2,623,3262,0,3,0,3265,A
1-PB2,624,2,1,3285,3,3291,G
1-PB2,625,3144,0,8,0,3152,A
1-PB2,626,0,3,3157,0,3160,G
1-PB2,627,3111,0,8,0,3119,A
1-PB2,628,1,9,3132,0,3142,G
1-PB2,629,3152,0,4,0,3156,A
1-PB2,630,3152,0,0,0,3152,A
1-PB2,631,0,0,0,3193,3193,C
1-PB2,632,0,3159,0,3,3162,T
1-PB2,633,0,3157,0,0,3157,T
1-PB2,634,0,2,3167,0,3169,G
1-PB2,635,0,3164,0,1,3165,T
1-PB2,636,3161,0,0,0,3161,A
1-PB2,637,1,2,0,3141,3144,C
1-PB2,638,0,9,3129,0,3138,G
1-PB2,639,3151,0,0,0,3151,A
1-PB2,640,3152,0,0,0,3152,A
1-PB2,641,3196,0,1,0,3197,A
1-PB2,642,3192,0,1,0,3193,A
1-PB2,643,3220,0,1,2,3223,A
1-PB2,644,0,0,0,3232,3232,C
1-PB2,645,3238,0,2,0,3240,A
1-PB2,646,3242,0,1,0,3243,A
1-PB2,647,0,7,3250,0,3257,G
1-PB2,648,3259,0,1,0,3260,A
1-PB2,649,1,3264,0,6,3271,T
1-PB2,650,0,3243,0,5,3248,T
1-PB2,651,5,2,0,3220,3227,C
1-PB2,652,3,2,0,3275,3280,C
1-PB2,653,0,3331,1,7,3339,T
1-PB2,654,2,2,0,3357,3361,C
1-PB2,655,2,0,0,3350,3352,C
1-PB2,656,1,1,0,3366,3368,C
1-PB2,657,3364,0,0,0,3364,A
1-PB2,658,1,0,3402,0,3403,G
1-PB2,659,0,3401,0,1,3402,T
1-PB2,660,0,3378,0,1,3379,T
1-PB2,661,3,1,3373,0,3377,G
1-PB2,662,5,3,0,3350,3358,C
1-PB2,663,0,3351,0,1,3352,T
1-PB2,664,0,2,3365,1,3368,G
1-PB2,665,2,0,3362,0,3364,G
1-PB2,666,3,1,0,3357,3361,C
1-PB2,667,0,1,3371,0,3372,G
1-PB2,668,0,2,3402,1,3405,G
1-PB2,669,3413,0,0,0,3413,A
1-PB2,670,3409,0,1,0,3410,A
1-PB2,671,0,1,0,3409,3410,C
1-PB2,672,3427,0,3,0,3430,A
1-PB2,673,3429,0,4,0,3433,A
1-PB2,674,1,1,3585,0,3587,G
1-PB2,675,0,1,0,3635,3636,C
1-PB2,676,3668,0,0,0,3668,A
1-PB2,677,0,0,4493,0,4493,G
1-PB2,678,0,4457,0,4,4461,T
1-PB2,679,4496,0,10,0,4506,A
1-PB2,680,0,4511,1,5,4517,T
1-PB2,681,4528,0,4,0,4532,A
1-PB2,682,1,4512,0,3,4516,T
1-PB2,683,4441,1,1,0,4443,A
1-PB2,684,4,1,0,4479,4484,C
1-PB2,685,4255,0,1,0,4256,A
1-PB2,686,0,3962,0,3,3965,T
1-PB2,687,0,3842,0,2,3844,T
1-PB2,688,1,4,3840,0,3845,G
1-PB2,689,3830,0,1,0,3831,A
1-PB2,690,3830,0,6,1,3837,A
1-PB2,691,1,3,3886,0,3890,G
1-PB2,692,1,3871,0,4,3876,T
1-PB2,693,0,3858,2,4,3864,T
1-PB2,694,0,3856,0,5,3861,T
1-PB2,695,0,3865,0,0,3865,T
1-PB2,696,3890,1,3,1,3895,A
1-PB2,697,0,1,0,3922,3923,C
1-PB2,698,3919,0,1,0,3920,A
1-PB2,699,0,3897,0,2,3899,T
1-PB2,700,1,3861,0,1,3863,T
1-PB2,701,0,3875,0,0,3875,T
1-PB2,702,0,8,3920,0,3928,G
1-PB2,703,3929,0,2,0,3931,A
1-PB2,704,1,0,0,3956,3957,C
1-PB2,705,1,3926,0,11,3938,T
1-PB2,706,6,1,0,3932,3939,C
1-PB2,707,3931,1,0,0,3932,A
1-PB2,708,1,6,3880,0,3887,G
1-PB2,709,1,3,3986,0,3990,G
1-PB2,710,2,10,4002,0,4014,G
1-PB2,711,4007,0,3,0,4010,A
1-PB2,712,4007,0,5,0,4012,A
1-PB2,713,0,0,0,4021,4021,C
1-PB2,714,4,1,4042,0,4047,G
1-PB2,715,0,4031,0,2,4033,T
1-PB2,716,0,3,4072,0,4075,G
1-PB2,717,0,4025,1,5,4031,T
1-PB2,718,0,4028,0,1,4029,T
1-PB2,719,1,3,4041,0,4045,G
1-PB2,720,1,2,4045,0,4048,G
1-PB2,721,0,14,4055,0,4069,G
1-PB2,722,4049,0,4,0,4053,A
1-PB2,723,4020,0,3,1,4024,A
1-PB2,724,2,0,0,4106,4108,C
1-PB2,725,4077,1,1,1,4080,A
1-PB2,726,4208,0,1,0,4209,A
1-PB2,727,4237,0,3,0,4240,A
1-PB2,728,0,4251,0,1,4252,T
1-PB2,729,3,2,4305,0,4310,G
1-PB2,730,0,4268,0,1,4269,T
1-PB2,731,4286,0,2,0,4288,A
1-PB2,732,0,1,0,4295,4296,C
1-PB2,733,4210,0,3,0,4213,A
1-PB2,734,0,1,0,4214,4215,C
1-PB2,735,2,4065,0,7,4074,T
1-PB2,736,8,1,1,4351,4361,C
1-PB2,737,5,0,0,4371,4376,C
1-PB2,738,4452,1,4,0,4457,A
1-PB2,739,0,1,4497,0,4498,G
1-PB2,740,0,2,4587,0,4589,G
1-PB2,741,1,4544,0,2,4547,T
1-PB2,742,3,2,4580,0,4585,G
1-PB2,743,1,8,4392,0,4401,G
1-PB2,744,4324,0,5,0,4329,A
1-PB2,745,1,3,4347,1,4352,G
1-PB2,746,2,5,4350,1,4358,G
1-PB2,747,4271,0,9,0,4280,A
1-PB2,748,0,0,4327,0,4327,G
1-PB2,749,0,4191,0,2,4193,T
1-PB2,750,0,3,4226,1,4230,G
1-PB2,751,4214,1,8,0,4223,A
1-PB2,752,3,5,4231,0,4239,G
1-PB2,753,1,8,4252,0,4261,G
1-PB2,754,4221,0,3,1,4225,A
1-PB2,755,4218,0,5,0,4223,A
1-PB2,756,0,4203,0,3,4206,T
1-PB2,757,1,6,4174,0,4181,G
1-PB2,758,4164,1,4,0,4169,A
1-PB2,759,1,4,1,4152,4158,C
1-PB2,760,3,3,4153,0,4159,G
1-PB2,761,4188,0,0,0,4188,A
1-PB2,762,0,4148,0,3,4151,T
1-PB2,763,0,0,4179,0,4179,G
1-PB2,764,0,4170,0,4,4174,T
1-PB2,765,0,4131,0,0,4131,T
1-PB2,766,1,18,4135,0,4154,G
1-PB2,767,4122,1,7,0,4130,A
1-PB2,768,1,0,0,4137,4138,C
1-PB2,769,8,1,1,4128,4138,C
1-PB2,770,4087,1,1,0,4089,A
1-PB2,771,4104,0,2,0,4106,A
1-PB2,772,4097,0,7,0,4104,A
1-PB2,773,1,2,4176,0,4179,G
1-PB2,774,1,2,0,4172,4175,C
1-PB2,775,5,0,0,4157,4162,C
1-PB2,776,0,4196,0,5,4201,T
1-PB2,777,4206,0,0,1,4207,A
1-PB2,778,4199,0,4,0,4203,A
1-PB2,779,0,4211,0,2,4213,T
1-PB2,780,1,4215,0,0,4216,T
1-PB2,781,4137,1,1,1,4140,A
1-PB2,782,0,4021,0,4,4025,T
1-PB2,783,0,3999,0,0,3999,T
1-PB2,784,0,1,3988,0,3989,G
1-PB2,785,3,5,0,3946,3954,C
1-PB2,786,2,1,3954,0,3957,G
1-PB2,787,3,0,4031,0,4034,G
1-PB2,788,2,2,0,4014,4018,C
1-PB2,789,2,1,0,4057,4060,C
1-PB2,790,4058,0,3,1,4062,A
1-PB2,791,1,8,4122,0,4131,G
1-PB2,792,1,15,4149,1,4166,G
1-PB2,793,4152,0,2,0,4154,A
1-PB2,794,4171,1,6,0,4178,A
1-PB2,795,0,1,0,4215,4216,C
1-PB2,796,4119,1,6,0,4126,A
1-PB2,797,0,4182,0,1,4183,T
1-PB2,798,4237,0,4,0,4241,A
1-PB2,799,1,0,4291,0,4292,G
1-PB2,800,0,4208,0,2,4210,T
1-PB2,801,4163,0,4,0,4167,A
1-PB2,802,4147,2,3,1,4153,A
1-PB2,803,1,6,4148,0,4155,G
1-PB2,804,4112,0,3,0,4115,A
1-PB2,805,4025,0,3,0,4028,A
1-PB2,806,1,7,4004,0,4012,G
1-PB2,807,3873,0,16,0,3889,A
1-PB2,808,1,1,3891,0,3893,G
1-PB2,809,2,0,0,3872,3874,C
1-PB2,810,2,0,0,3868,3870,C
1-PB2,811,3,0,3886,0,3889,G
1-PB2,812,1,2,0,3897,3900,C
1-PB2,813,3926,0,3,1,3930,A
1-PB2,814,3,1,4187,0,4191,G
1-PB2,815,0,4163,0,3,4166,T
1-PB2,816,4187,0,1,0,4188,A
1-PB2,817,0,4147,0,3,4150,T
1-PB2,818,6,1,0,4202,4209,C
1-PB2,819,4202,0,4,1,4207,A
1-PB2,820,3,0,4198,0,4201,G
1-PB2,821,2,4,0,4181,4187,C
1-PB2,822,3982,0,2,0,3984,A
1-PB2,823,1,4,3897,0,3902,G
1-PB2,824,3903,0,2,0,3905,A
1-PB2,825,0,3898,0,2,3900,T
1-PB2,826,6,1,0,3915,3922,C
1-PB2,827,5,0,0,3914,3919,C
1-PB2,828,3893,0,2,0,3895,A
1-PB2,829,3,2,0,3917,3922,C
1-PB2,830,0,3911,0,3,3914,T
1-PB2,831,3924,0,6,0,3930,A
1-PB2,832,2,1,3895,0,3898,G
1-PB2,833,2,1,0,3852,3855,C
1-PB2,834,3846,0,1,0,3847,A
1-PB2,835,0,3856,1,3,3860,T
1-PB2,836,5,2,0,3898,3905,C
1-PB2,837,1,3890,1,2,3894,T
1-PB2,838,0,3996,0,5,4001,T
1-PB2,839,1,4014,0,4,4019,T
1-PB2,840,4011,1,0,0,4012,A
1-PB2,841,0,4000,0,3,4003,T
1-PB2,842,1,3997,0,1,3999,T
1-PB2,843,1,3,3990,0,3994,G
1-PB2,844,0,8,3992,2,4002,G
1-PB2,845,3891,0,9,0,3900,A
1-PB2,846,1,3,3910,0,3914,G
1-PB2,847,3853,0,5,0,3858,A
1-PB2,848,0,3801,0,2,3803,T
1-PB2,849,0,1,3899,0,3900,G
1-PB2,850,0,3886,0,3,3889,T
1-PB2,851,1,2,3882,0,3885,G
1-PB2,852,0,0,0,3890,3890,C
1-PB2,853,7,1,0,3858,3866,C
1-PB2,854,3842,0,4,0,3846,A
1-PB2,855,0,3,0,3855,3858,C
1-PB2,856,3798,0,1,0,3799,A
1-PB2,857,0,1,3848,0,3849,G
1-PB2,858,1,0,0,3711,3712,C
1-PB2,859,3698,0,4,0,3702,A
1-PB2,860,0,1,0,3701,3702,C
1-PB2,861,3675,0,10,0,3685,A
1-PB2,862,0,1,0,3712,3713,C
1-PB2,863,3699,0,0,0,3699,A
1-PB2,864,3694,0,2,0,3696,A
1-PB2,865,3690,0,1,0,3691,A
1-PB2,866,1,3574,0,1,3576,T
1-PB2,867,0,3575,0,0,3575,T
1-PB2,868,0,2,3553,0,3555,G
1-PB2,869,0,2,3527,0,3529,G
1-PB2,870,2,2,0,3521,3525,C
1-PB2,871,0,3,3499,1,3503,G
1-PB2,872,1,4,3547,0,3552,G
1-PB2,873,1,6,3535,0,3542,G
1-PB2,874,3485,0,2,0,3487,A
1-PB2,875,0,2,0,3515,3517,C
1-PB2,876,3539,0,3,1,3543,A
1-PB2,877,3550,0,3,0,3553,A
1-PB2,878,1,4,3525,0,3530,G
1-PB2,879,3,0,3605,0,3608,G
1-PB2,880,3507,0,8,0,3515,A
1-PB2,881,0,3382,0,1,3383,T
1-PB2,882,1,4,3337,0,3342,G
1-PB2,883,1,0,3382,0,3383,G
1-PB2,884,1,3234,0,6,3241,T
1-PB2,885,2,6,3366,0,3374,G
1-PB2,886,0,3,3333,1,3337,G
1-PB2,887,3175,0,8,0,3183,A
1-PB2,888,0,1,0,3228,3229,C
1-PB2,889,3168,1,2,0,3171,A
1-PB2,890,0,3653,0,2,3655,T
1-PB2,891,0,3649,0,0,3649,T
1-PB2,892,11,2,0,3590,3603,C
1-PB2,893,1,3601,1,3,3606,T
1-PB2,894,1,3611,0,2,3614,T
1-PB2,895,3583,1,1,0,3585,A
1-PB2,896,1,5,3599,0,3605,G
1-PB2,897,3578,0,4,1,3583,A
1-PB2,898,0,1,0,3585,3586,C
1-PB2,899,2831,0,1,0,2832,A
1-PB2,900,0,3,2889,0,2892,G
1-PB2,901,2863,0,2,0,2865,A
1-PB2,902,2885,1,2,0,2888,A
1-PB2,903,3,1,0,2824,2828,C
1-PB2,904,1,2,0,2903,2906,C
1-PB2,905,5,0,1,2910,2916,C
1-PB2,906,2,3,2879,0,2884,G
1-PB2,907,2877,0,2,0,2879,A
1-PB2,908,0,16,0,2916,2932,C
1-PB2,909,0,2891,0,1,2892,T
1-PB2,910,2,1,2908,0,2911,G
1-PB2,911,2861,0,7,0,2868,A
1-PB2,912,2919,1,5,0,2925,A
1-PB2,913,1,6,2914,0,2921,G
1-PB2,914,2890,0,3,0,2893,A
1-PB2,915,2916,0,2,0,2918,A
1-PB2,916,0,0,0,2886,2886,C
1-PB2,917,2897,0,2,0,2899,A
1-PB2,918,2919,0,5,0,2924,A
1-PB2,919,1,0,2917,0,2918,G
1-PB2,920,0,1,0,2937,2938,C
1-PB2,921,1,2946,0,3,2950,T
1-PB2,922,2,0,3005,0,3007,G
1-PB2,923,1,2970,0,0,2971,T
1-PB2,924,1,5,3068,0,3074,G
1-PB2,925,0,3,3176,1,3180,G
1-PB2,926,3121,0,4,0,3125,A
1-PB2,927,0,3147,0,1,3148,T
1-PB2,928,3134,0,1,0,3135,A
1-PB2,929,0,3092,0,1,3093,T
1-PB2,930,3206,0,0,0,3206,A
1-PB2,931,0,3134,0,1,3135,T
1-PB2,932,0,0,3112,2,3114,G
1-PB2,933,0,1,0,3058,3059,C
1-PB2,934,2957,1,0,0,2958,A
1-PB2,935,2966,1,6,0,2973,A
1-PB2,936,0,4,2967,0,2971,G
1-PB2,937,0,1,2985,0,2986,G
1-PB2,938,2,2,0,2947,2951,C
1-PB2,939,2,2893,0,6,2901,T
1-PB2,940,0,0,2944,0,2944,G
1-PB2,941,0,1,0,2921,2922,C
1-PB2,942,2942,0,3,0,2945,A
1-PB2,943,2949,1,5,1,2956,A
1-PB2,944,0,2924,0,2,2926,T
1-PB2,945,0,14,2922,0,2936,G
1-PB2,946,0,4,2927,0,2931,G
1-PB2,947,0,2,2942,0,2944,G
1-PB2,948,2874,1,11,0,2886,A
1-PB2,949,0,2884,0,0,2884,T
1-PB2,950,0,2898,0,1,2899,T
1-PB2,951,0,6,2882,0,2888,G
1-PB2,952,2876,1,6,0,2883,A
1-PB2,953,1,4,2924,0,2929,G
1-PB2,954,2910,0,0,0,2910,A
1-PB2,955,2897,0,0,0,2897,A
1-PB2,956,1,2812,0,0,2813,T
1-PB2,957,7,0,0,2853,2860,C
1-PB2,958,2866,0,2,0,2868,A
1-PB2,959,0,1,2886,0,2887,G
1-PB2,960,2,1,0,2856,2859,C
1-PB2,961,0,2843,1,10,2854,T
1-PB2,962,5,1,0,2853,2859,C
1-PB2,963,2854,0,0,0,2854,A
1-PB2,964,0,2928,0,1,2929,T
1-PB2,965,2,0,0,2947,2949,C
1-PB2,966,4,1,0,2979,2984,C
1-PB2,967,0,2942,0,6,2948,T
1-PB2,968,1,2917,0,6,2924,T
1-PB2,969,2,0,0,2921,2923,C
1-PB2,970,2926,0,4,0,2930,A
1-PB2,971,0,1,2989,0,2990,G
1-PB2,972,2,3,0,2959,2964,C
1-PB2,973,0,2927,0,4,2931,T
1-PB2,974,0,2951,0,1,2952,T
1-PB2,975,0,2924,0,0,2924,T
1-PB2,976,1,6,2910,1,2918,G
1-PB2,977,0,0,2922,0,2922,G
1-PB2,978,0,2870,0,1,2871,T
1-PB2,979,1,5,2942,0,2948,G
1-PB2,980,0,2,2907,0,2909,G
1-PB2,981,0,0,2960,0,2960,G
1-PB2,982,0,2906,0,8,2914,T
1-PB2,983,0,2945,0,2,2947,T
1-PB2,984,0,2950,0,0,2950,T
1-PB2,985,2960,1,1,0,2962,A
1-PB2,986,0,1,0,2988,2989,C
1-PB2,987,2992,0,0,0,2992,A
1-PB2,988,0,2966,0,0,2966,T
1-PB2,989,0,2908,0,0,2908,T
1-PB2,990,0,2916,0,1,2917,T
1-PB2,991,2911,0,1,0,2912,A
1-PB2,992,2906,0,2,0,2908,A
1-PB2,993,2917,0,2,0,2919,A
1-PB2,994,2887,0,8,0,2895,A
1-PB2,995,0,2,2915,0,2917,G
1-PB2,996,2894,0,2,0,2896,A
1-PB2,997,2889,0,2,0,2891,A
1-PB2,998,1,1,0,2902,2904,C
1-PB2,999,2894,0,0,0,2894,A
1-PB2,1000,2882,0,1,0,2883,A
1-PB2,1001,0,0,2876,0,2876,G
1-PB2,1002,2,4,0,2892,2898,C
1-PB2,1003,0,6,2888,0,2894,G
1-PB2,1004,1,2,2884,0,2887,G
1-PB2,1005,1,2,2898,0,2901,G
1-PB2,1006,0,2871,0,1,2872,T
1-PB2,1007,7,1,0,2884,2892,C
1-PB2,1008,2890,0,4,0,2894,A
1-PB2,1009,1,2868,0,5,2874,T
1-PB2,1010,2,0,0,2910,2912,C
1-PB2,1011,2898,0,1,0,2899,A
1-PB2,1012,0,1,2942,0,2943,G
1-PB2,1013,0,2865,0,3,2868,T
1-PB2,1014,7,0,0,2888,2895,C
1-PB2,1015,2889,0,2,0,2891,A
1-PB2,1016,2901,0,1,0,2902,A
1-PB2,1017,2911,0,0,0,2911,A
1-PB2,1018,2912,0,1,0,2913,A
1-PB2,1019,2936,0,0,0,2936,A
1-PB2,1020,2921,0,13,0,2934,A
1-PB2,1021,2,3,2948,0,2953,G
1-PB2,1022,2932,0,4,0,2936,A
1-PB2,1023,2942,0,2,0,2944,A
1-PB2,1024,0,3,2941,0,2944,G
1-PB2,1025,2919,0,0,1,2920,A
1-PB2,1026,2852,0,10,0,2862,A
1-PB2,1027,0,1,2850,0,2851,G
1-PB2,1028,2847,1,1,0,2849,A
1-PB2,1029,1,0,2844,0,2845,G
1-PB2,1030,0,0,2905,0,2905,G
1-PB2,1031,0,2885,0,0,2885,T
1-PB2,1032,2,1,2971,0,2974,G
1-PB2,1033,0,0,0,3004,3004,C
1-PB2,1034,0,3015,0,4,3019,T
1-PB2,1035,0,3030,0,1,3031,T
1-PB2,1036,3029,0,0,0,3029,A
1-PB2,1037,0,2,0,3030,3032,C
1-PB2,1038,3004,0,4,0,3008,A
1-PB2,1039,0,1,3018,0,3019,G
1-PB2,1040,0,3,2987,1,2991,G
1-PB2,1041,7,1,0,2916,2924,C
1-PB2,1042,2912,0,1,0,2913,A
1-PB2,1043,2925,0,2,0,2927,A
1-PB2,1044,0,2990,0,4,2994,T
1-PB2,1045,2,0,0,3018,3020,C
1-PB2,1046,0,2995,0,4,2999,T
1-PB2,1047,4,1,0,3005,3010,C
1-PB2,1048,3,1,0,3003,3007,C
1-PB2,1049,3018,1,0,1,3020,A
1-PB2,1050,3015,0,0,0,3015,A
1-PB2,1051,3019,0,2,1,3022,A
1-PB2,1052,0,2,0,3028,3030,C
1-PB2,1053,2954,0,0,0,2954,A
1-PB2,1054,0,2928,0,1,2929,T
1-PB2,1055,0,2917,0,0,2917,T
1-PB2,1056,1,6,2935,0,2942,G
1-PB2,1057,2937,0,4,0,2941,A
1-PB2,1058,2973,0,2,0,2975,A
1-PB2,1059,2975,0,2,0,2977,A
1-PB2,1060,2965,0,0,0,2965,A
1-PB2,1061,0,2976,0,1,2977,T
1-PB2,1062,2979,0,2,0,2981,A
1-PB2,1063,2970,0,4,0,2974,A
1-PB2,1064,1,3,3022,0,3026,G
1-PB2,1065,2984,0,5,0,2989,A
1-PB2,1066,3,1,3092,0,3096,G
1-PB2,1067,0,3046,0,0,3046,T
1-PB2,1068,3088,0,2,0,3090,A
1-PB2,1069,0,0,0,3163,3163,C
1-PB2,1070,3141,0,5,1,3147,A
1-PB2,1071,0,3125,0,5,3130,T
1-PB2,1072,4,1,3140,0,3145,G
1-PB2,1073,3062,1,7,1,3071,A
1-PB2,1074,0,5,3105,1,3111,G
1-PB2,1075,3,6,3111,0,3120,G
1-PB2,1076,2,3,3249,0,3254,G
1-PB2,1077,4,2,3274,0,3280,G
1-PB2,1078,0,3167,0,1,3168,T
1-PB2,1079,3229,0,0,0,3229,A
1-PB2,1080,0,3190,0,7,3197,T
1-PB2,1081,1,5,3204,0,3210,G
1-PB2,1082,3209,0,4,3,3216,A
1-PB2,1083,0,2,3188,0,3190,G
1-PB2,1084,0,4,3147,0,3151,G
1-PB2,1085,2987,0,1,0,2988,A
1-PB2,1086,3,0,3042,0,3045,G
1-PB2,1087,0,3064,0,3,3067,T
1-PB2,1088,0,3163,0,1,3164,T
1-PB2,1089,5,2,0,3170,3177,C
1-PB2,1090,3163,0,1,0,3164,A
1-PB2,1091,0,1,0,3188,3189,C
1-PB2,1092,3172,0,1,0,3173,A
1-PB2,1093,3172,1,2,0,3175,A
1-PB2,1094,0,3180,0,3,3183,T
1-PB2,1095,1,6,3121,0,3128,G
1-PB2,1096,0,2,3142,0,3144,G
1-PB2,1097,1,3049,1,4,3055,T
1-PB2,1098,0,7,3075,0,3082,G
1-PB2,1099,1,5,3072,0,3078,G
1-PB2,1100,1,4,3072,0,3077,G
1-PB2,1101,4,4,3096,0,3104,G
1-PB2,1102,3091,0,1,0,3092,A
1-PB2,1103,3099,0,3,0,3102,A
1-PB2,1104,3092,0,0,0,3092,A
1-PB2,1105,3010,0,6,0,3016,A
1-PB2,1106,2,5,3049,0,3056,G
1-PB2,1107,3015,0,7,0,3022,A
1-PB2,1108,1,0,3033,0,3034,G
1-PB2,1109,1,1,0,3019,3021,C
1-PB2,1110,3017,1,2,0,3020,A
1-PB2,1111,3018,0,0,0,3018,A
1-PB2,1112,0,2,0,3111,3113,C
1-PB2,1113,3109,0,2,0,3111,A
1-PB2,1114,1,0,3154,0,3155,G
1-PB2,1115,0,1,0,3116,3117,C
1-PB2,1116,0,3138,0,2,3140,T
1-PB2,1117,3228,0,1,0,3229,A
1-PB2,1118,0,3232,1,1,3234,T
1-PB2,1119,3251,1,1,0,3253,A
1-PB2,1120,1,3,0,3245,3249,C
1-PB2,1121,0,3067,0,1,3068,T
1-PB2,1122,3080,0,0,0,3080,A
1-PB2,1123,3003,0,3,0,3006,A
1-PB2,1124,1,3,3004,0,3008,G
1-PB2,1125,2995,0,2,0,2997,A
1-PB2,1126,2896,0,2,0,2898,A
1-PB2,1127,2902,0,2,0,2904,A
1-PB2,1128,2855,0,6,0,2861,A
1-PB2,1129,0,1,2876,0,2877,G
1-PB2,1130,0,0,0,2859,2859,C
1-PB2,1131,2857,1,2,0,2860,A
1-PB2,1132,2858,1,0,0,2859,A
1-PB2,1133,0,0,0,2857,2857,C
1-PB2,1134,1,2,0,2854,2857,C
1-PB2,1135,2874,0,1,0,2875,A
1-PB2,1136,0,4,2891,0,2895,G
1-PB2,1137,2884,0,0,0,2884,A
1-PB2,1138,2875,0,2,0,2877,A
1-PB2,1139,0,4,2924,0,2928,G
1-PB2,1140,2917,0,2,0,2919,A
1-PB2,1141,0,2896,0,2,2898,T
1-PB2,1142,0,2894,0,1,2895,T
1-PB2,1143,1,2,2910,0,2913,G
1-PB2,1144,0,0,2961,0,2961,G
1-PB2,1145,0,2919,0,4,2923,T
1-PB2,1146,2,2917,0,2,2921,T
1-PB2,1147,3,0,0,2929,2932,C
1-PB2,1148,2984,0,3,1,2988,A
1-PB2,1149,1,0,3090,1,3092,G
1-PB2,1150,4,1,0,3113,3118,C
1-PB2,1151,0,3110,0,4,3114,T
1-PB2,1152,5,1,0,3116,3122,C
1-PB2,1153,3089,0,0,0,3089,A
1-PB2,1154,2,3093,0,0,3095,T
1-PB2,1155,3087,1,2,0,3090,A
1-PB2,1156,0,1,3112,0,3113,G
1-PB2,1157,0,2920,0,4,2924,T
1-PB2,1158,0,5,2936,0,2941,G
1-PB2,1159,2816,1,4,0,2821,A
1-PB2,1160,5,1,2860,0,2866,G
1-PB2,1161,0,2839,0,2,2841,T
1-PB2,1162,1,2,2850,0,2853,G
1-PB2,1163,1,1,2854,0,2856,G
1-PB2,1164,2857,1,0,0,2858,A
1-PB2,1165,2825,0,8,1,2834,A
1-PB2,1166,0,3,2844,0,2847,G
1-PB2,1167,2785,0,1,0,2786,A
1-PB2,1168,1,5,2790,0,2796,G
1-PB2,1169,2766,0,4,0,2770,A
1-PB2,1170,2,2,0,2760,2764,C
1-PB2,1171,1,7,2757,2,2767,G
1-PB2,1172,2708,0,0,0,2708,A
1-PB2,1173,2714,2,4,0,2720,A
1-PB2,1174,0,1,0,2729,2730,C
1-PB2,1175,2707,0,0,0,2707,A
1-PB2,1176,1,0,2826,0,2827,G
1-PB2,1177,0,2797,0,5,2802,T
1-PB2,1178,5,2,0,2806,2813,C
1-PB2,1179,2840,0,1,0,2841,A
1-PB2,1180,2821,0,1,1,2823,A
1-PB2,1181,1,2792,0,3,2796,T
1-PB2,1182,2815,0,4,0,2819,A
1-PB2,1183,0,0,2807,0,2807,G
1-PB2,1184,0,0,0,2787,2787,C
1-PB2,1185,2,0,0,2683,2685,C
1-PB2,1186,0,0,2664,0,2664,G
1-PB2,1187,2646,0,0,0,2646,A
1-PB2,1188,2646,0,3,0,2649,A
1-PB2,1189,1,0,2670,1,2672,G
1-PB2,1190,0,2,0,2739,2741,C
1-PB2,1191,2741,0,0,0,2741,A
1-PB2,1192,2729,0,3,0,2732,A
1-PB2,1193,0,2737,0,1,2738,T
1-PB2,1194,2754,0,3,0,2757,A
1-PB2,1195,2782,0,2,0,2784,A
1-PB2,1196,1,2766,0,1,2768,T
1-PB2,1197,6,3,0,2742,2751,C
1-PB2,1198,2,0,2736,0,2738,G
1-PB2,1199,0,2657,0,2,2659,T
1-PB2,1200,0,4,2674,0,2678,G
1-PB2,1201,1,2,2668,0,2671,G
1-PB2,1202,1,1,0,2666,2668,C
1-PB2,1203,4,1,0,2663,2668,C
1-PB2,1204,2659,0,1,0,2660,A
1-PB2,1205,1,2642,0,3,2646,T
1-PB2,1206,4,3,2664,0,2671,G
1-PB2,1207,0,0,2708,0,2708,G
1-PB2,1208,1,2604,0,2,2607,T
1-PB2,1209,0,0,2687,0,2687,G
1-PB2,1210,0,2580,1,3,2584,T
1-PB2,1211,0,2611,0,5,2616,T
1-PB2,1212,0,2625,1,1,2627,T
1-PB2,1213,1,2636,0,4,2641,T
1-PB2,1214,2,2,0,2702,2706,C
1-PB2,1215,2703,1,2,0,2706,A
1-PB2,1216,0,1,0,3011,3012,C
1-PB2,1217,2968,0,0,1,2969,A
1-PB2,1218,3027,0,2,1,3030,A
1-PB2,1219,0,4,3052,0,3056,G
1-PB2,1220,3020,0,2,0,3022,A
1-PB2,1221,312,4,2766,0,3082,G
1-PB2,1222,0,6,3123,0,3129,G
1-PB2,1223,3094,0,3,0,3097,A
1-PB2,1224,0,3116,0,4,3120,T
1-PB2,1225,0,3088,0,0,3088,T
1-PB2,1226,0,0,3096,0,3096,G
1-PB2,1227,2,2,0,3030,3034,C
1-PB2,1228,3075,0,4,1,3080,A
1-PB2,1229,1,3120,0,3,3124,T
1-PB2,1230,0,8,3279,0,3287,G
1-PB2,1231,3299,0,1,0,3300,A
1-PB2,1232,0,3341,0,0,3341,T
1-PB2,1233,3321,1,1,0,3323,A
1-PB2,1234,3322,1,3,0,3326,A
1-PB2,1235,3325,0,1,0,3326,A
1-PB2,1236,3322,0,23,0,3345,A
1-PB2,1237,0,0,3332,0,3332,G
1-PB2,1238,0,2,0,3436,3438,C
1-PB2,1239,3546,0,0,0,3546,A
1-PB2,1240,0,0,3699,1,3700,G
1-PB2,1241,0,3693,0,0,3693,T
1-PB2,1242,1,3705,0,0,3706,T
1-PB2,1243,3706,1,0,0,3707,A
1-PB2,1244,0,1,3750,0,3751,G
1-PB2,1245,3718,0,3,0,3721,A
1-PB2,1246,1,4,3718,0,3723,G
1-PB2,1247,0,2,3694,0,3696,G
1-PB2,1248,0,3503,0,6,3509,T
1-PB2,1249,0,14,3556,0,3570,G
1-PB2,1250,3589,1,3,0,3593,A
1-PB2,1251,0,2,0,3612,3614,C
1-PB2,1252,2,0,0,3641,3643,C
1-PB2,1253,0,3615,0,6,3621,T
1-PB2,1254,1,4,3652,1,3658,G
1-PB2,1255,3641,0,0,0,3641,A
1-PB2,1256,3639,0,1,0,3640,A
1-PB2,1257,0,3659,0,2,3661,T
1-PB2,1258,0,3717,0,4,3721,T
1-PB2,1259,0,3729,0,0,3729,T
1-PB2,1260,4,0,0,3726,3730,C
1-PB2,1261,2,1,3732,0,3735,G
1-PB2,1262,1,3721,0,5,3727,T
1-PB2,1263,6,1,0,3731,3738,C
1-PB2,1264,3743,0,4,0,3747,A
1-PB2,1265,3735,0,1,0,3736,A
1-PB2,1266,0,1,0,3746,3747,C
1-PB2,1267,3702,0,2,0,3704,A
1-PB2,1268,0,5,3754,0,3759,G
1-PB2,1269,3707,0,5,0,3712,A
1-PB2,1270,2,0,3724,0,3726,G
1-PB2,1271,0,0,0,3747,3747,C
1-PB2,1272,3748,0,2,0,3750,A
1-PB2,1273,3806,0,3,0,3809,A
1-PB2,1274,3804,0,3,0,3807,A
1-PB2,1275,0,3792,0,2,3794,T
1-PB2,1276,5,0,0,3805,3810,C
1-PB2,1277,3771,0,3,0,3774,A
1-PB2,1278,4,1,3769,0,3774,G
1-PB2,1279,1,2,0,3785,3788,C
1-PB2,1280,2,3,3801,0,3806,G
1-PB2,1281,0,1,4048,0,4049,G
1-PB2,1282,0,4021,0,3,4024,T
1-PB2,1283,0,4038,0,1,4039,T
1-PB2,1284,1,10,4028,0,4039,G
1-PB2,1285,4043,0,4,0,4047,A
1-PB2,1286,4062,0,5,0,4067,A
1-PB2,1287,2,1,0,4105,4108,C
1-PB2,1288,4,1,0,4069,4074,C
1-PB2,1289,9,1,0,4124,4134,C
1-PB2,1290,7,0,0,3985,3992,C
1-PB2,1291,4019,0,2,0,4021,A
1-PB2,1292,0,4030,0,4,4034,T
1-PB2,1293,1,0,4041,1,4043,G
1-PB2,1294,2,2,0,4062,4066,C
1-PB2,1295,4039,1,1,0,4041,A
1-PB2,1296,1,4007,0,3,4011,T
1-PB2,1297,8,2,0,4004,4014,C
1-PB2,1298,3977,0,2,0,3979,A
1-PB2,1299,0,1,4047,0,4048,G
1-PB2,1300,1,2,0,4073,4076,C
1-PB2,1301,0,4083,0,5,4088,T
1-PB2,1302,0,4094,1,2,4097,T
1-PB2,1303,0,4081,0,1,4082,T
1-PB2,1304,0,4084,0,0,4084,T
1-PB2,1305,4079,1,1,0,4081,A
1-PB2,1306,4065,0,3,1,4069,A
1-PB2,1307,1,6,4054,1,4062,G
1-PB2,1308,4,2,4026,0,4032,G
1-PB2,1309,0,1,0,4027,4028,C
1-PB2,1310,4013,0,2,0,4015,A
1-PB2,1311,1,4039,0,2,4042,T
1-PB2,1312,0,4070,0,0,4070,T
1-PB2,1313,1,4079,0,0,4080,T
1-PB2,1314,1,4072,0,4,4077,T
1-PB2,1315,9,1,0,4099,4109,C
1-PB2,1316,4094,0,3,0,4097,A
1-PB2,1317,0,6,4091,1,4098,G
1-PB2,1318,4074,0,2,2,4078,A
1-PB2,1319,4077,0,1,0,4078,A
1-PB2,1320,4069,0,3,0,4072,A
1-PB2,1321,2,4,4077,0,4083,G
1-PB2,1322,4107,0,3,0,4110,A
1-PB2,1323,0,4098,0,1,4099,T
1-PB2,1324,1,0,4113,0,4114,G
1-PB2,1325,1,2,0,4101,4104,C
1-PB2,1326,0,10,4109,0,4119,G
1-PB2,1327,4097,0,5,0,4102,A
1-PB2,1328,4117,0,1,0,4118,A
1-PB2,1329,4126,0,1,0,4127,A
1-PB2,1330,2,2,4140,0,4144,G
1-PB2,1331,0,4075,0,2,4077,T
1-PB2,1332,5,1,4094,0,4100,G
1-PB2,1333,0,1,0,4061,4062,C
1-PB2,1334,0,4082,0,3,4085,T
1-PB2,1335,0,4101,0,2,4103,T
1-PB2,1336,0,4127,0,1,4128,T
1-PB2,1337,0,4124,0,2,4126,T
1-PB2,1338,0,4106,0,2,4108,T
1-PB2,1339,11,2,0,4115,4128,C
1-PB2,1340,4118,0,2,0,4120,A
1-PB2,1341,4132,0,1,0,4133,A
1-PB2,1342,4132,0,2,0,4134,A
1-PB2,1343,4153,1,1,0,4155,A
1-PB2,1344,0,4154,0,2,4156,T
1-PB2,1345,0,4159,0,0,4159,T
1-PB2,1346,1,8,4158,0,4167,G
1-PB2,1347,1,7,4128,0,4136,G
1-PB2,1348,0,3,4143,0,4146,G
1-PB2,1349,2,2,4226,0,4230,G
1-PB2,1350,4222,0,8,0,4230,A
1-PB2,1351,0,0,4333,0,4333,G
1-PB2,1352,0,4327,0,4,4331,T
1-PB2,1353,0,4329,0,0,4329,T
1-PB2,1354,2,6,4345,0,4353,G
1-PB2,1355,4336,0,5,0,4341,A
1-PB2,1356,4341,0,17,0,4358,A
1-PB2,1357,0,1,0,4508,4509,C
1-PB2,1358,4423,0,5,0,4428,A
1-PB2,1359,0,1,0,4572,4573,C
1-PB2,1360,4492,0,2,0,4494,A
1-PB2,1361,0,4496,0,4,4500,T
1-PB2,1362,2,3,0,4524,4529,C
1-PB2,1363,2,13,4513,1,4529,G
1-PB2,1364,4554,0,1,1,4556,A
1-PB2,1365,1,1,0,4535,4537,C
1-PB2,1366,4398,0,1,0,4399,A
1-PB2,1367,3,0,4560,0,4563,G
1-PB2,1368,1,4413,0,8,4422,T
1-PB2,1369,3,3,4534,0,4540,G
1-PB2,1370,1,4495,0,4,4500,T
1-PB2,1371,2,6,4520,0,4528,G
1-PB2,1372,4507,0,10,0,4517,A
1-PB2,1373,0,4460,0,5,4465,T
1-PB2,1374,0,7,4477,0,4484,G
1-PB2,1375,0,4,4485,0,4489,G
1-PB2,1376,0,6,4415,0,4421,G
1-PB2,1377,4377,0,2,0,4379,A
1-PB2,1378,4323,1,1,0,4325,A
1-PB2,1379,0,4345,0,1,4346,T
1-PB2,1380,5,6,4384,0,4395,G
1-PB2,1381,4402,0,3,0,4405,A
1-PB2,1382,0,4392,0,0,4392,T
1-PB2,1383,0,4358,0,3,4361,T
1-PB2,1384,1,5,4339,0,4345,G
1-PB2,1385,1,5,4468,0,4474,G
1-PB2,1386,4444,0,9,0,4453,A
1-PB2,1387,0,1,4514,0,4515,G
1-PB2,1388,0,4468,0,2,4470,T
1-PB2,1389,4500,0,2,0,4502,A
1-PB2,1390,0,4525,0,8,4533,T
1-PB2,1391,0,4589,1,1,4591,T
1-PB2,1392,4642,0,6,0,4648,A
1-PB2,1393,4,3,0,4656,4663,C
1-PB2,1394,3,1,0,4600,4604,C
1-PB2,1395,4584,0,4,0,4588,A
1-PB2,1396,2,4,4602,1,4609,G
1-PB2,1397,4717,0,7,0,4724,A
1-PB2,1398,0,4704,0,1,4705,T
1-PB2,1399,4639,0,1,0,4640,A
1-PB2,1400,0,4596,0,2,4598,T
1-PB2,1401,1,17,4565,0,4583,G
1-PB2,1402,4608,0,9,0,4617,A
1-PB2,1403,0,1,1,4659,4661,C
1-PB2,1404,1,4647,0,3,4651,T
1-PB2,1405,6,0,0,4634,4640,C
1-PB2,1406,5,3,0,4611,4619,C
1-PB2,1407,4647,0,4,0,4651,A
1-PB2,1408,4666,0,3,2,4671,A
1-PB2,1409,1,1,4783,0,4785,G
1-PB2,1410,0,1,0,4771,4772,C
1-PB2,1411,4748,2,7,0,4757,A
1-PB2,1412,0,2,0,4775,4777,C
1-PB2,1413,4712,0,6,1,4719,A
1-PB2,1414,0,2,4731,0,4733,G
1-PB2,1415,4703,0,5,0,4708,A
1-PB2,1416,0,5,4752,0,4757,G
1-PB2,1417,4759,0,3,0,4762,A
1-PB2,1418,1,4610,0,4,4615,T
1-PB2,1419,2,3,4697,0,4702,G
1-PB2,1420,0,4658,0,12,4670,T
1-PB2,1421,12,1,0,4680,4693,C
1-PB2,1422,4694,0,9,0,4703,A
1-PB2,1423,4684,0,3,0,4687,A
1-PB2,1424,0,4674,0,3,4677,T
1-PB2,1425,1,5,4678,0,4684,G
1-PB2,1426,4601,0,4,0,4605,A
1-PB2,1427,0,3,4632,0,4635,G
1-PB2,1428,4577,0,5,0,4582,A
1-PB2,1429,1,3,4587,0,4591,G
1-PB2,1430,2,4,4811,0,4817,G
1-PB2,1431,4807,0,0,0,4807,A
1-PB2,1432,4815,0,5,0,4820,A
1-PB2,1433,0,4814,0,1,4815,T
1-PB2,1434,4810,0,4,0,4814,A
1-PB2,1435,4806,0,10,1,4817,A
1-PB2,1436,1,6,4798,0,4805,G
1-PB2,1437,4767,0,4,0,4771,A
1-PB2,1438,2,1,4787,0,4790,G
1-PB2,1439,1,4492,1,2,4496,T
1-PB2,1440,14,1,0,4509,4524,C
1-PB2,1441,4516,0,5,0,4521,A
1-PB2,1442,7,0,4536,0,4543,G
1-PB2,1443,3,1,0,4557,4561,C
1-PB2,1444,4574,0,0,1,4575,A
1-PB2,1445,4584,0,4,0,4588,A
1-PB2,1446,4562,0,2,0,4564,A
1-PB2,1447,4554,1,6,0,4561,A
1-PB2,1448,0,4571,0,1,4572,T
1-PB2,1449,1,5,4592,0,4598,G
1-PB2,1450,2,5,4578,0,4585,G
1-PB2,1451,1,3,4606,0,4610,G
1-PB2,1452,1,4533,0,8,4542,T
1-PB2,1453,2,0,4595,0,4597,G
1-PB2,1454,0,4551,0,3,4554,T
1-PB2,1455,2,5,4591,0,4598,G
1-PB2,1456,1,2,4668,0,4671,G
1-PB2,1457,4643,0,3,0,4646,A
1-PB2,1458,0,4632,1,2,4635,T
1-PB2,1459,3,11,4703,2,4719,G
1-PB2,1460,4673,0,6,0,4679,A
1-PB2,1461,4706,0,5,2,4713,A
1-PB2,1462,0,4676,0,9,4685,T
1-PB2,1463,4651,0,1,0,4652,A
1-PB2,1464,0,2,0,5033,5035,C
1-PB2,1465,2,4904,0,3,4909,T
1-PB2,1466,6,0,0,4972,4978,C
1-PB2,1467,2,3,0,4995,5000,C
1-PB2,1468,4989,1,5,0,4995,A
1-PB2,1469,3,2,5210,1,5216,G
1-PB2,1470,0,5184,0,5,5189,T
1-PB2,1471,5220,1,3,0,5224,A
1-PB2,1472,0,0,0,5250,5250,C
1-PB2,1473,4832,0,6,0,4838,A
1-PB2,1474,0,2,4874,1,4877,G
1-PB2,1475,4735,0,9,0,4744,A
1-PB2,1476,1,3,4782,1,4787,G
1-PB2,1477,4590,1,10,1,4602,A
1-PB2,1478,1,5,4506,0,4512,G
1-PB2,1479,1,3,4488,0,4492,G
1-PB2,1480,1,0,4505,0,4506,G
1-PB2,1481,0,4376,0,6,4382,T
1-PB2,1482,1,4,4425,0,4430,G
1-PB2,1483,0,1,4459,0,4460,G
1-PB2,1484,1,4391,0,0,4392,T
1-PB2,1485,3,9,4563,0,4575,G
1-PB2,1486,0,1,4573,0,4574,G
1-PB2,1487,0,4447,0,4,4451,T
1-PB2,1488,1,4456,0,5,4462,T
1-PB2,1489,4403,0,3,0,4406,A
1-PB2,1490,0,2,4420,0,4422,G
1-PB2,1491,2,1,0,4398,4401,C
1-PB2,1492,4396,0,1,0,4397,A
1-PB2,1493,0,4385,0,0,4385,T
1-PB2,1494,0,4166,0,2,4168,T
1-PB2,1495,2,5,4162,1,4170,G
1-PB2,1496,4131,0,2,0,4133,A
1-PB2,1497,0,4134,0,6,4140,T
1-PB2,1498,7,3,0,4155,4165,C
1-PB2,1499,1,9,4123,0,4133,G
1-PB2,1500,3,0,4221,0,4224,G
1-PB2,1501,0,4182,1,2,4185,T
1-PB2,1502,0,4205,0,1,4206,T
1-PB2,1503,0,4199,0,0,4199,T
1-PB2,1504,0,4215,0,1,4216,T
1-PB2,1505,0,4213,0,5,4218,T
1-PB2,1506,2,9,4214,0,4225,G
1-PB2,1507,4210,0,4,0,4214,A
1-PB2,1508,2,11,4198,0,4211,G
1-PB2,1509,4023,1,10,0,4034,A
1-PB2,1510,0,2,4089,0,4091,G
1-PB2,1511,0,4078,1,5,4084,T
1-PB2,1512,1,4062,0,0,4063,T
1-PB2,1513,17,2,0,4068,4087,C
1-PB2,1514,1,5,4088,1,4095,G
1-PB2,1515,4098,0,5,1,4104,A
1-PB2,1516,2,7,4108,0,4117,G
1-PB2,1517,4089,0,6,0,4095,A
1-PB2,1518,1,0,0,4096,4097,C
1-PB2,1519,3,3,0,4066,4072,C
1-PB2,1520,4037,0,2,0,4039,A
1-PB2,1521,4078,0,6,1,4085,A
1-PB2,1522,1,0,0,4125,4126,C
1-PB2,1523,4,1,4131,0,4136,G
1-PB2,1524,0,4090,0,1,4091,T
1-PB2,1525,0,6,4088,1,4095,G
1-PB2,1526,1,2,4099,1,4103,G
1-PB2,1527,1,3,4111,0,4115,G
1-PB2,1528,4071,0,8,0,4079,A
1-PB2,1529,4090,0,0,0,4090,A
1-PB2,1530,0,3974,0,2,3976,T
1-PB2,1531,2,0,4154,0,4156,G
1-PB2,1532,1,4122,0,1,4124,T
1-PB2,1533,4148,1,1,0,4150,A
1-PB2,1534,1,4148,0,0,4149,T
1-PB2,1535,0,4111,0,1,4112,T
1-PB2,1536,4181,0,1,0,4182,A
1-PB2,1537,0,4148,0,2,4150,T
1-PB2,1538,0,4106,0,2,4108,T
1-PB2,1539,4086,0,2,0,4088,A
1-PB2,1540,0,3705,0,5,3710,T
1-PB2,1541,6,1,0,3934,3941,C
1-PB2,1542,0,3888,0,5,3893,T
1-PB2,1543,7,0,0,3942,3949,C
1-PB2,1544,2,0,0,3954,3956,C
1-PB2,1545,0,3861,0,5,3866,T
1-PB2,1546,0,2,3886,1,3889,G
1-PB2,1547,3849,1,4,0,3854,A
1-PB2,1548,0,2,3866,0,3868,G
1-PB2,1549,0,3,3849,0,3852,G
1-PB2,1550,3468,0,3,0,3471,A
1-PB2,1551,2,2,3517,0,3521,G
1-PB2,1552,0,1,3506,0,3507,G
1-PB2,1553,0,3373,0,3,3376,T
1-PB2,1554,9,1,0,3389,3399,C
1-PB2,1555,3372,0,6,1,3379,A
1-PB2,1556,1,0,3422,0,3423,G
1-PB2,1557,1,3414,0,0,3415,T
1-PB2,1558,3,4,3416,0,3423,G
1-PB2,1559,3412,0,4,0,3416,A
1-PB2,1560,3299,0,0,0,3299,A
1-PB2,1561,3307,0,8,0,3315,A
1-PB2,1562,0,2,0,3324,3326,C
1-PB2,1563,3288,0,2,1,3291,A
1-PB2,1564,0,0,0,3310,3310,C
1-PB2,1565,3185,0,8,0,3193,A
1-PB2,1566,0,1,3212,0,3213,G
1-PB2,1567,0,6,3199,1,3206,G
1-PB2,1568,0,5,3260,0,3265,G
1-PB2,1569,3233,0,2,0,3235,A
1-PB2,1570,3197,0,3,0,3200,A
1-PB2,1571,2,0,0,3230,3232,C
1-PB2,1572,0,3173,1,3,3177,T
1-PB2,1573,2,2,3189,0,3193,G
1-PB2,1574,3154,0,5,0,3159,A
1-PB2,1575,0,2,3178,0,3180,G
1-PB2,1576,3117,2,6,1,3126,A
1-PB2,1577,0,5,2960,0,2965,G
1-PB2,1578,2936,0,8,0,2944,A
1-PB2,1579,1,1,0,2933,2935,C
1-PB2,1580,0,2877,1,1,2879,T
1-PB2,1581,1,10,2923,0,2934,G
1-PB2,1582,2896,0,8,0,2904,A
1-PB2,1583,1,0,0,2935,2936,C
1-PB2,1584,2917,0,3,0,2920,A
1-PB2,1585,2911,0,1,0,2912,A
1-PB2,1586,0,2912,0,2,2914,T
1-PB2,1587,2947,0,0,0,2947,A
1-PB2,1588,2945,0,0,0,2945,A
1-PB2,1589,0,1,1,2979,2981,C
1-PB2,1590,0,2827,1,4,2832,T
1-PB2,1591,0,2810,0,0,2810,T
1-PB2,1592,2778,0,0,0,2778,A
1-PB2,1593,2,2773,0,1,2776,T
1-PB2,1594,0,2762,0,3,2765,T
1-PB2,1595,5,3,0,2744,2752,C
1-PB2,1596,2623,1,0,0,2624,A
1-PB2,1597,1,2612,0,2,2615,T
1-PB2,1598,1,0,0,2553,2554,C
1-PB2,1599,1,0,2555,0,2556,G
1-PB2,1600,0,2562,1,1,2564,T
1-PB2,1601,4,1,0,2550,2555,C
1-PB2,1602,1,3,2549,0,2553,G
1-PB2,1603,2556,0,0,0,2556,A
1-PB2,1604,0,2557,0,2,2559,T
1-PB2,1605,1,3,2568,0,2572,G
1-PB2,1606,2580,0,3,0,2583,A
1-PB2,1607,0,2573,0,1,2574,T
1-PB2,1608,0,1,2576,0,2577,G
1-PB2,1609,0,2477,0,3,2480,T
1-PB2,1610,4,4,2469,0,2477,G
1-PB2,1611,1,0,2481,0,2482,G
1-PB2,1612,0,3,2490,0,2493,G
1-PB2,1613,2438,1,1,0,2440,A
1-PB2,1614,1,1,2442,1,2445,G
1-PB2,1615,2291,1,1,0,2293,A
1-PB2,1616,0,2269,0,0,2269,T
1-PB2,1617,1,2214,0,0,2215,T
1-PB2,1618,2207,2,0,0,2209,A
1-PB2,1619,2202,1,4,0,2207,A
1-PB2,1620,1,3,0,2188,2192,C
1-PB2,1621,0,4,2100,0,2104,G
1-PB2,1622,0,1,2144,0,2145,G
1-PB2,1623,0,2018,0,3,2021,T
1-PB2,1624,8,1,0,2008,2017,C
1-PB2,1625,3,0,0,2013,2016,C
1-PB2,1626,0,1953,0,1,1954,T
1-PB2,1627,0,4,1969,0,1973,G
1-PB2,1628,1949,0,1,1,1951,A
1-PB2,1629,0,1,1976,0,1977,G
1-PB2,1630,1,1959,0,1,1961,T
1-PB2,1631,2,2,0,1893,1897,C
1-PB2,1632,0,4,1898,0,1902,G
1-PB2,1633,1,1,1914,0,1916,G
1-PB2,1634,0,1904,0,1,1905,T
1-PB2,1635,0,1920,0,0,1920,T
1-PB2,1636,0,1912,0,2,1914,T
1-PB2,1637,0,1913,0,0,1913,T
1-PB2,1638,1,1,1958,1,1961,G
1-PB2,1639,0,0,1971,0,1971,G
1-PB2,1640,0,1937,0,2,1939,T
1-PB2,1641,8,1,0,1964,1973,C
1-PB2,1642,1945,0,1,0,1946,A
1-PB2,1643,2000,0,1,0,2001,A
1-PB2,1644,0,2008,0,0,2008,T
1-PB2,1645,2005,0,0,0,2005,A
1-PB2,1646,0,1,0,2059,2060,C
1-PB2,1647,1,0,0,1983,1984,C
1-PB2,1648,1,1967,0,4,1972,T
1-PB2,1649,2002,0,1,0,2003,A
1-PB2,1650,0,2002,2,3,2007,T
1-PB2,1651,2,2,0,2006,2010,C
1-PB2,1652,1954,0,0,0,1954,A
1-PB2,1653,1945,0,1,0,1946,A
1-PB2,1654,0,1944,0,0,1944,T
1-PB2,1655,0,5,1881,0,1886,G
1-PB2,1656,2,2,1879,0,1883,G
1-PB2,1657,1853,0,0,0,1853,A
1-PB2,1658,0,1823,0,2,1825,T
1-PB2,1659,2,0,0,1822,1824,C
1-PB2,1660,1826,0,2,0,1828,A
1-PB2,1661,0,1828,1,1,1830,T
1-PB2,1662,1,2,0,1827,1830,C
1-PB2,1663,1829,0,0,2,1831,A
1-PB2,1664,0,1,1832,1,1834,G
1-PB2,1665,1828,0,4,0,1832,A
1-PB2,1666,1831,0,0,0,1831,A
1-PB2,1667,1839,0,2,0,1841,A
1-PB2,1668,0,1844,0,0,1844,T
1-PB2,1669,0,1829,0,1,1830,T
1-PB2,1670,0,3,1813,1,1817,G
1-PB2,1671,0,1,1807,0,1808,G
1-PB2,1672,1,2,1815,0,1818,G
1-PB2,1673,1809,1,2,0,1812,A
1-PB2,1674,1805,0,2,0,1807,A
1-PB2,1675,3,0,1795,0,1798,G
1-PB2,1676,0,0,0,1795,1795,C
1-PB2,1677,0,1801,0,1,1802,T
1-PB2,1678,1,0,1808,0,1809,G
1-PB2,1679,0,1808,0,0,1808,T
1-PB2,1680,1,0,0,1808,1809,C
1-PB2,1681,1824,0,0,0,1824,A
1-PB2,1682,1813,0,2,0,1815,A
1-PB2,1683,1817,0,0,0,1817,A
1-PB2,1684,1839,0,1,0,1840,A
1-PB2,1685,0,1841,1,0,1842,T
1-PB2,1686,0,1837,0,1,1838,T
1-PB2,1687,5,0,0,1831,1836,C
1-PB2,1688,1818,0,0,0,1818,A
1-PB2,1689,1820,0,1,0,1821,A
1-PB2,1690,1,1813,0,2,1816,T
1-PB2,1691,0,5,1817,0,1822,G
1-PB2,1692,1,0,1853,0,1854,G
1-PB2,1693,1,1874,0,0,1875,T
1-PB2,1694,5,0,0,1886,1891,C
1-PB2,1695,0,1885,0,3,1888,T
1-PB2,1696,1,2,0,1892,1895,C
1-PB2,1697,1894,0,0,0,1894,A
1-PB2,1698,0,2,1909,0,1911,G
1-PB2,1699,1902,0,3,0,1905,A
1-PB2,1700,1924,0,0,0,1924,A
1-PB2,1701,0,1881,0,1,1882,T
1-PB2,1702,3,3,0,1823,1829,C
1-PB2,1703,4,0,0,1859,1863,C
1-PB2,1704,1,1858,0,2,1861,T
1-PB2,1705,2,0,1841,1,1844,G
1-PB2,1706,1,0,0,1859,1860,C
1-PB2,1707,1855,0,2,0,1857,A
1-PB2,1708,1886,0,2,0,1888,A
1-PB2,1709,0,1853,0,1,1854,T
1-PB2,1710,0,0,1898,0,1898,G
1-PB2,1711,0,1913,0,0,1913,T
1-PB2,1712,0,1856,0,1,1857,T
1-PB2,1713,0,0,1873,0,1873,G
1-PB2,1714,0,1860,0,3,1863,T
1-PB2,1715,1873,0,1,0,1874,A
1-PB2,1716,0,2,0,1874,1876,C
1-PB2,1717,1839,0,2,0,1841,A
1-PB2,1718,1849,1,2,0,1852,A
1-PB2,1719,0,0,0,1820,1820,C
1-PB2,1720,1777,0,1,0,1778,A
1-PB2,1721,1768,0,0,0,1768,A
1-PB2,1722,1744,0,0,0,1744,A
1-PB2,1723,1740,0,0,0,1740,A
1-PB2,1724,0,1743,0,0,1743,T
1-PB2,1725,0,1,1739,0,1740,G
1-PB2,1726,0,2,1745,0,1747,G
1-PB2,1727,1735,0,3,0,1738,A
1-PB2,1728,1753,0,0,0,1753,A
1-PB2,1729,0,1752,0,0,1752,T
1-PB2,1730,0,1742,1,0,1743,T
1-PB2,1731,0,1741,0,1,1742,T
1-PB2,1732,1,6,1732,0,1739,G
1-PB2,1733,1745,0,1,0,1746,A
1-PB2,1734,1728,1,3,0,1732,A
1-PB2,1735,1,1,0,1732,1734,C
1-PB2,1736,4,2,0,1714,1720,C
1-PB2,1737,1740,0,0,0,1740,A
1-PB2,1738,0,1773,0,3,1776,T
1-PB2,1739,0,1769,0,1,1770,T
1-PB2,1740,0,1765,0,1,1766,T
1-PB2,1741,5,1,0,1769,1775,C
1-PB2,1742,1775,0,1,0,1776,A
1-PB2,1743,1771,0,0,0,1771,A
1-PB2,1744,0,1771,0,2,1773,T
1-PB2,1745,2,1,0,1814,1817,C
1-PB2,1746,0,1796,0,2,1798,T
1-PB2,1747,0,1777,0,1,1778,T
1-PB2,1748,0,1799,0,0,1799,T
1-PB2,1749,1805,0,2,0,1807,A
1-PB2,1750,2,0,1791,0,1793,G
1-PB2,1751,0,1791,0,3,1794,T
1-PB2,1752,1,1,0,1834,1836,C
1-PB2,1753,2,0,0,1831,1833,C
1-PB2,1754,3,1,0,1806,1810,C
1-PB2,1755,1,0,0,1819,1820,C
1-PB2,1756,1818,0,0,0,1818,A
1-PB2,1757,1816,0,2,0,1818,A
1-PB2,1758,1,2,1851,0,1854,G
1-PB2,1759,0,0,1829,0,1829,G
1-PB2,1760,0,1,0,1829,1830,C
1-PB2,1761,1,0,0,1822,1823,C
1-PB2,1762,1818,0,2,0,1820,A
1-PB2,1763,0,1844,0,1,1845,T
1-PB2,1764,0,1846,0,1,1847,T
1-PB2,1765,1859,0,0,0,1859,A
1-PB2,1766,2,1,1857,0,1860,G
1-PB2,1767,1806,0,5,0,1811,A
1-PB2,1768,1865,0,1,0,1866,A
1-PB2,1769,0,0,1896,0,1896,G
1-PB2,1770,0,1,0,1891,1892,C
1-PB2,1771,3,1,1,1903,1908,C
1-PB2,1772,1891,0,0,0,1891,A
1-PB2,1773,1904,0,0,0,1904,A
1-PB2,1774,0,1915,0,0,1915,T
1-PB2,1775,1936,0,1,0,1937,A
1-PB2,1776,0,0,0,1946,1946,C
1-PB2,1777,1779,0,1,0,1780,A
1-PB2,1778,0,0,1795,0,1795,G
1-PB2,1779,1,1762,0,1,1764,T
1-PB2,1780,0,3,1773,0,1776,G
1-PB2,1781,0,2,1777,0,1779,G
1-PB2,1782,0,0,1774,0,1774,G
1-PB2,1783,0,1741,0,4,1745,T
1-PB2,1784,0,1740,0,2,1742,T
1-PB2,1785,0,1758,0,0,1758,T
1-PB2,1786,2,1,1775,0,1778,G
1-PB2,1787,0,1763,0,3,1766,T
1-PB2,1788,4,1,0,1764,1769,C
1-PB2,1789,1747,0,2,0,1749,A
1-PB2,1790,0,2,1744,0,1746,G
1-PB2,1791,1729,0,2,0,1731,A
1-PB2,1792,1732,0,0,0,1732,A
1-PB2,1793,0,0,0,1736,1736,C
1-PB2,1794,0,1687,0,2,1689,T
1-PB2,1795,3,0,0,1728,1731,C
1-PB2,1796,0,1738,0,1,1739,T
1-PB2,1797,1755,0,0,0,1755,A
1-PB2,1798,0,1757,0,1,1758,T
1-PB2,1799,1,1737,1,2,1741,T
1-PB2,1800,4,0,0,1737,1741,C
1-PB2,1801,0,0,0,1744,1744,C
1-PB2,1802,1736,0,1,0,1737,A
1-PB2,1803,1726,0,1,0,1727,A
1-PB2,1804,0,0,0,1731,1731,C
1-PB2,1805,1714,0,1,0,1715,A
1-PB2,1806,1726,0,0,0,1726,A
1-PB2,1807,1719,0,0,0,1719,A
1-PB2,1808,0,1719,0,0,1719,T
1-PB2,1809,1,3,1727,0,1731,G
1-PB2,1810,1705,0,3,0,1708,A
1-PB2,1811,0,0,1729,0,1729,G
1-PB2,1812,1715,0,4,0,1719,A
1-PB2,1813,0,2,1711,0,1713,G
1-PB2,1814,1709,0,2,0,1711,A
1-PB2,1815,0,0,0,1706,1706,C
1-PB2,1816,1,0,1724,0,1725,G
1-PB2,1817,0,1737,0,0,1737,T
1-PB2,1818,1767,0,0,0,1767,A
1-PB2,1819,1,0,0,1784,1785,C
1-PB2,1820,0,1775,0,0,1775,T
1-PB2,1821,0,1780,0,3,1783,T
1-PB2,1822,0,2,1761,0,1763,G
1-PB2,1823,0,4,1755,0,1759,G
1-PB2,1824,0,3,1755,0,1758,G
1-PB2,1825,1745,0,4,0,1749,A
1-PB2,1826,0,1,0,1763,1764,C
1-PB2,1827,1775,0,0,0,1775,A
1-PB2,1828,0,1786,0,0,1786,T
1-PB2,1829,0,1784,1,0,1785,T
1-PB2,1830,0,1791,0,0,1791,T
1-PB2,1831,1,6,1779,0,1786,G
1-PB2,1832,1790,0,2,0,1792,A
1-PB2,1833,0,0,0,1794,1794,C
1-PB2,1834,1790,0,2,0,1792,A
1-PB2,1835,1,1,0,1800,1802,C
1-PB2,1836,2,0,0,1749,1751,C
1-PB2,1837,1774,0,2,0,1776,A
1-PB2,1838,0,0,0,1784,1784,C
1-PB2,1839,0,1,1,1791,1793,C
1-PB2,1840,8,1,1,1789,1799,C
1-PB2,1841,1783,0,2,0,1785,A
1-PB2,1842,0,0,1804,0,1804,G
1-PB2,1843,1803,0,0,0,1803,A
1-PB2,1844,0,1859,0,2,1861,T
1-PB2,1845,1841,0,2,0,1843,A
1-PB2,1846,1799,0,3,0,1802,A
1-PB2,1847,1,1796,0,0,1797,T
1-PB2,1848,1796,0,0,0,1796,A
1-PB2,1849,1787,0,0,0,1787,A
1-PB2,1850,1760,0,0,0,1760,A
1-PB2,1851,0,1,1759,0,1760,G
1-PB2,1852,0,0,0,1750,1750,C
1-PB2,1853,0,1667,0,1,1668,T
1-PB2,1854,0,1669,0,4,1673,T
1-PB2,1855,1,0,0,1684,1685,C
1-PB2,1856,0,1666,1,1,1668,T
1-PB2,1857,4,0,0,1701,1705,C
1-PB2,1858,5,1,0,1702,1708,C
1-PB2,1859,0,1,0,1713,1714,C
1-PB2,1860,0,1712,1,3,1716,T
1-PB2,1861,0,1699,0,2,1701,T
1-PB2,1862,0,1703,0,5,1708,T
1-PB2,1863,0,1705,0,0,1705,T
1-PB2,1864,0,0,1710,0,1710,G
1-PB2,1865,1,1,0,1706,1708,C
1-PB2,1866,1680,0,1,0,1681,A
1-PB2,1867,0,0,1678,0,1678,G
1-PB2,1868,2,0,1,1671,1674,C
1-PB2,1869,0,1678,0,0,1678,T
1-PB2,1870,1,0,1677,0,1678,G
1-PB2,1871,1,0,1,1676,1678,C
1-PB2,1872,0,1660,0,0,1660,T
1-PB2,1873,4,0,0,1698,1702,C
1-PB2,1874,1,0,0,1717,1718,C
1-PB2,1875,1717,0,2,0,1719,A
1-PB2,1876,0,0,0,1731,1731,C
1-PB2,1877,3,0,0,1732,1735,C
1-PB2,1878,1730,0,0,0,1730,A
1-PB2,1879,1737,0,0,0,1737,A
1-PB2,1880,1733,0,1,0,1734,A
1-PB2,1881,2,1,1743,0,1746,G
1-PB2,1882,0,0,0,1739,1739,C
1-PB2,1883,1723,1,0,0,1724,A
1-PB2,1884,1729,0,1,0,1730,A
1-PB2,1885,1719,0,1,1,1721,A
1-PB2,1886,0,0,1744,0,1744,G
1-PB2,1887,1,0,0,1750,1751,C
1-PB2,1888,1736,0,1,0,1737,A
1-PB2,1889,0,0,1755,0,1755,G
1-PB2,1890,1727,0,2,0,1729,A
1-PB2,1891,1756,0,1,0,1757,A
1-PB2,1892,0,1763,0,0,1763,T
1-PB2,1893,1,0,1762,0,1763,G
1-PB2,1894,0,0,0,1764,1764,C
1-PB2,1895,1739,0,2,0,1741,A
1-PB2,1896,0,0,1754,0,1754,G
1-PB2,1897,0,1754,0,2,1756,T
1-PB2,1898,1,1805,0,1,1807,T
1-PB2,1899,4,0,1,1819,1824,C
1-PB2,1900,0,1792,0,4,1796,T
1-PB2,1901,3,0,0,1833,1836,C
1-PB2,1902,0,1827,0,2,1829,T
1-PB2,1903,0,1827,0,1,1828,T
1-PB2,1904,2,1,0,1833,1836,C
1-PB2,1905,1810,0,1,0,1811,A
1-PB2,1906,0,0,0,1823,1823,C
1-PB2,1907,0,1752,0,1,1753,T
1-PB2,1908,0,3,1796,2,1801,G
1-PB2,1909,1774,0,3,0,1777,A
1-PB2,1910,0,0,0,1859,1859,C
1-PB2,1911,0,1830,0,1,1831,T
1-PB2,1912,0,0,1853,0,1853,G
1-PB2,1913,1,1818,0,0,1819,T
1-PB2,1914,0,1,1855,0,1856,G
1-PB2,1915,1843,0,3,0,1846,A
1-PB2,1916,1858,0,2,0,1860,A
1-PB2,1917,0,1824,0,1,1825,T
1-PB2,1918,0,0,1828,0,1828,G
1-PB2,1919,0,1763,0,2,1765,T
1-PB2,1920,0,4,1770,0,1774,G
1-PB2,1921,1735,0,2,0,1737,A
1-PB2,1922,1,3,1747,0,1751,G
1-PB2,1923,1,3,1730,0,1734,G
1-PB2,1924,1,3,1727,0,1731,G
1-PB2,1925,1,5,1821,0,1827,G
1-PB2,1926,1829,0,0,1,1830,A
1-PB2,1927,0,1808,0,0,1808,T
1-PB2,1928,1,0,0,1830,1831,C
1-PB2,1929,1824,0,5,0,1829,A
1-PB2,1930,0,2,1864,0,1866,G
1-PB2,1931,0,0,1861,0,1861,G
1-PB2,1932,1,4,1864,0,1869,G
1-PB2,1933,1856,0,1,0,1857,A
1-PB2,1934,0,1742,1,1,1744,T
1-PB2,1935,1,5,1759,0,1765,G
1-PB2,1936,1757,0,1,0,1758,A
1-PB2,1937,0,3,1839,0,1842,G
1-PB2,1938,1825,1,1,0,1827,A
1-PB2,1939,1792,0,0,0,1792,A
1-PB2,1940,0,1827,0,0,1827,T
1-PB2,1941,1812,0,3,0,1815,A
1-PB2,1942,2,1,0,1854,1857,C
1-PB2,1943,0,1852,0,1,1853,T
1-PB2,1944,0,1849,0,2,1851,T
1-PB2,1945,0,0,1867,0,1867,G
1-PB2,1946,0,1812,0,1,1813,T
1-PB2,1947,1805,0,1,0,1806,A
1-PB2,1948,1796,0,0,0,1796,A
1-PB2,1949,1,2,1781,0,1784,G
1-PB2,1950,0,5,1769,1,1775,G
1-PB2,1951,1,2,1755,0,1758,G
1-PB2,1952,0,0,1749,0,1749,G
1-PB2,1953,1,1,2,1775,1779,C
1-PB2,1954,1774,0,2,0,1776,A
1-PB2,1955,1803,1,1,0,1805,A
1-PB2,1956,0,1808,0,1,1809,T
1-PB2,1957,0,1809,0,2,1811,T
1-PB2,1958,5,0,0,1865,1870,C
1-PB2,1959,1,1835,0,3,1839,T
1-PB2,1960,6,2,0,1869,1877,C
1-PB2,1961,0,1,0,1870,1871,C
1-PB2,1962,0,1856,0,4,1860,T
1-PB2,1963,1,2,1906,0,1909,G
1-PB2,1964,0,1862,1,2,1865,T
1-PB2,1965,1884,0,0,0,1884,A
1-PB2,1966,0,1874,0,3,1877,T
1-PB2,1967,0,1850,0,3,1853,T
1-PB2,1968,2,0,0,1876,1878,C
1-PB2,1969,1849,0,1,0,1850,A
1-PB2,1970,1876,0,1,0,1877,A
1-PB2,1971,1,0,0,1894,1895,C
1-PB2,1972,0,1857,1,1,1859,T
1-PB2,1973,1865,0,1,0,1866,A
1-PB2,1974,2,1,0,1932,1935,C
1-PB2,1975,1935,0,2,0,1937,A
1-PB2,1976,1933,0,1,0,1934,A
1-PB2,1977,1,0,0,1935,1936,C
1-PB2,1978,1915,0,0,0,1915,A
1-PB2,1979,1913,0,3,0,1916,A
1-PB2,1980,1,4,1910,1,1916,G
1-PB2,1981,1912,0,3,0,1915,A
1-PB2,1982,1,0,0,1927,1928,C
1-PB2,1983,1,1,0,1882,1884,C
1-PB2,1984,1876,0,3,0,1879,A
1-PB2,1985,1,3,0,1957,1961,C
1-PB2,1986,0,1959,0,0,1959,T
1-PB2,1987,1959,0,1,0,1960,A
1-PB2,1988,1952,0,0,0,1952,A
1-PB2,1989,1959,0,0,0,1959,A
1-PB2,1990,1959,0,1,0,1960,A
1-PB2,1991,0,3,1981,0,1984,G
1-PB2,1992,1966,0,1,0,1967,A
1-PB2,1993,0,2,0,1977,1979,C
1-PB2,1994,0,1918,0,2,1920,T
1-PB2,1995,1924,0,0,0,1924,A
1-PB2,1996,1922,1,1,0,1924,A
1-PB2,1997,0,0,0,1933,1933,C
1-PB2,1998,1923,0,0,0,1923,A
1-PB2,1999,1916,0,0,0,1916,A
1-PB2,2000,0,1888,0,0,1888,T
1-PB2,2001,0,1892,1,1,1894,T
1-PB2,2002,3,0,0,1900,1903,C
1-PB2,2003,0,1887,0,1,1888,T
1-PB2,2004,5,0,0,1906,1911,C
1-PB2,2005,2,2,1907,0,1911,G
1-PB2,2006,0,3,1909,0,1912,G
1-PB2,2007,1904,0,5,0,1909,A
1-PB2,2008,1910,0,0,0,1910,A
1-PB2,2009,1907,0,0,0,1907,A
1-PB2,2010,1906,0,1,0,1907,A
1-PB2,2011,0,1,1904,0,1905,G
1-PB2,2012,1904,0,1,0,1905,A
1-PB2,2013,0,1912,0,0,1912,T
1-PB2,2014,0,2,1915,0,1917,G
1-PB2,2015,0,0,0,1904,1904,C
1-PB2,2016,0,1,1,1903,1905,C
1-PB2,2017,0,1,1912,0,1913,G
1-PB2,2018,1,2,1893,0,1896,G
1-PB2,2019,0,0,0,1911,1911,C
1-PB2,2020,1904,0,3,0,1907,A
1-PB2,2021,0,2,0,1958,1960,C
1-PB2,2022,0,1959,0,4,1963,T
1-PB2,2023,0,1958,0,0,1958,T
1-PB2,2024,0,1961,0,1,1962,T
1-PB2,2025,1966,0,0,0,1966,A
1-PB2,2026,1974,0,4,0,1978,A
1-PB2,2027,1,1968,0,0,1969,T
1-PB2,2028,0,1969,0,1,1970,T
1-PB2,2029,0,1,1968,0,1969,G
1-PB2,2030,1919,1,2,0,1922,A
1-PB2,2031,1907,0,2,0,1909,A
1-PB2,2032,2,2,1906,0,1910,G
1-PB2,2033,1924,0,0,0,1924,A
1-PB2,2034,0,0,0,1943,1943,C
1-PB2,2035,7,0,1,1926,1934,C
1-PB2,2036,1,0,0,1934,1935,C
1-PB2,2037,1937,0,1,1,1939,A
1-PB2,2038,0,0,1982,0,1982,G
1-PB2,2039,1978,0,2,0,1980,A
1-PB2,2040,0,1987,0,1,1988,T
1-PB2,2041,0,4,1980,0,1984,G
1-PB2,2042,1942,0,1,0,1943,A
1-PB2,2043,1940,0,0,0,1940,A
1-PB2,2044,1955,0,1,0,1956,A
1-PB2,2045,1,0,1958,0,1959,G
1-PB2,2046,0,0,0,1964,1964,C
1-PB2,2047,1932,0,0,0,1932,A
1-PB2,2048,0,0,0,1968,1968,C
1-PB2,2049,1981,0,0,0,1981,A
1-PB2,2050,0,1959,0,0,1959,T
1-PB2,2051,2,0,0,1993,1995,C
1-PB2,2052,1,3,0,1993,1997,C
1-PB2,2053,2,2,2000,0,2004,G
1-PB2,2054,0,4,2012,0,2016,G
1-PB2,2055,1998,0,0,0,1998,A
1-PB2,2056,1,0,2022,0,2023,G
1-PB2,2057,0,1966,0,2,1968,T
1-PB2,2058,0,0,1984,0,1984,G
1-PB2,2059,0,2,1984,0,1986,G
1-PB2,2060,1951,1,2,0,1954,A
1-PB2,2061,0,0,1971,0,1971,G
1-PB2,2062,0,1926,0,0,1926,T
1-PB2,2063,6,0,0,1916,1922,C
1-PB2,2064,2,0,0,1913,1915,C
1-PB2,2065,1,1,1922,0,1924,G
1-PB2,2066,1,1,0,1919,1921,C
1-PB2,2067,5,0,0,1906,1911,C
1-PB2,2068,0,0,1964,1,1965,G
1-PB2,2069,1,1951,0,1,1953,T
1-PB2,2070,3,2,0,1972,1977,C
1-PB2,2071,2,1963,0,4,1969,T
1-PB2,2072,0,1983,0,1,1984,T
1-PB2,2073,0,4,1981,0,1985,G
1-PB2,2074,1965,0,2,0,1967,A
1-PB2,2075,1,0,1979,0,1980,G
1-PB2,2076,1952,1,5,0,1958,A
1-PB2,2077,1,2,1912,0,1915,G
1-PB2,2078,1,1,1908,0,1910,G
1-PB2,2079,0,0,1903,0,1903,G
1-PB2,2080,0,1887,0,2,1889,T
1-PB2,2081,0,1887,0,3,1890,T
1-PB2,2082,0,1920,0,2,1922,T
1-PB2,2083,1,1,0,1911,1913,C
1-PB2,2084,0,1912,0,3,1915,T
1-PB2,2085,4,0,0,1954,1958,C
1-PB2,2086,1938,0,0,0,1938,A
1-PB2,2087,0,1914,0,4,1918,T
1-PB2,2088,3,0,0,1868,1871,C
1-PB2,2089,1900,0,0,0,1900,A
1-PB2,2090,0,1917,0,0,1917,T
1-PB2,2091,1925,0,3,0,1928,A
1-PB2,2092,1,2,1943,0,1946,G
1-PB2,2093,1,0,1965,0,1966,G
1-PB2,2094,0,1914,0,0,1914,T
1-PB2,2095,1920,0,1,0,1921,A
1-PB2,2096,1902,1,3,0,1906,A
1-PB2,2097,0,0,1911,1,1912,G
1-PB2,2098,0,1,1920,0,1921,G
1-PB2,2099,1903,0,0,0,1903,A
1-PB2,2100,1871,0,3,0,1874,A
1-PB2,2101,0,3,1866,0,1869,G
1-PB2,2102,1830,0,4,0,1834,A
1-PB2,2103,0,0,0,1845,1845,C
1-PB2,2104,1837,0,3,0,1840,A
1-PB2,2105,2,0,1840,0,1842,G
1-PB2,2106,1837,0,1,0,1838,A
1-PB2,2107,1818,0,2,0,1820,A
1-PB2,2108,1,1,1837,0,1839,G
1-PB2,2109,1841,0,2,0,1843,A
1-PB2,2110,0,1837,0,0,1837,T
1-PB2,2111,1821,1,0,0,1822,A
1-PB2,2112,0,1,0,1822,1823,C
1-PB2,2113,2,2,1805,0,1809,G
1-PB2,2114,0,4,1853,0,1857,G
1-PB2,2115,1831,0,0,0,1831,A
1-PB2,2116,1,0,0,1817,1818,C
1-PB2,2117,2,1,0,1806,1809,C
1-PB2,2118,1794,1,5,0,1800,A
1-PB2,2119,0,0,1865,0,1865,G
1-PB2,2120,0,0,0,1870,1870,C
1-PB2,2121,1867,0,0,0,1867,A
1-PB2,2122,0,1868,0,0,1868,T
1-PB2,2123,0,1787,0,0,1787,T
1-PB2,2124,1782,2,0,0,1784,A
1-PB2,2125,1780,0,1,0,1781,A
1-PB2,2126,0,1,1784,0,1785,G
1-PB2,2127,0,0,0,1782,1782,C
1-PB2,2128,1670,0,1,0,1671,A
1-PB2,2129,0,1700,0,0,1700,T
1-PB2,2130,3,0,0,1697,1700,C
1-PB2,2131,1702,0,4,0,1706,A
1-PB2,2132,1705,0,0,0,1705,A
1-PB2,2133,0,1706,0,0,1706,T
1-PB2,2134,0,6,1709,0,1715,G
1-PB2,2135,1701,0,1,0,1702,A
1-PB2,2136,1697,0,1,0,1698,A
1-PB2,2137,1,0,0,1724,1725,C
1-PB2,2138,1,1607,0,1,1609,T
1-PB2,2139,0,3,1674,0,1677,G
1-PB2,2140,1662,0,3,0,1665,A
1-PB2,2141,1,0,1658,0,1659,G
1-PB2,2142,1,1658,0,1,1660,T
1-PB2,2143,1654,0,0,0,1654,A
1-PB2,2144,1656,0,0,0,1656,A
1-PB2,2145,1,0,0,1660,1661,C
1-PB2,2146,2,0,0,1626,1628,C
1-PB2,2147,0,1608,0,4,1612,T
1-PB2,2148,0,1541,0,0,1541,T
1-PB2,2149,0,0,1549,0,1549,G
1-PB2,2150,0,0,1,1539,1540,C
1-PB2,2151,1548,0,0,0,1548,A
1-PB2,2152,1538,0,3,0,1541,A
1-PB2,2153,1503,0,1,0,1504,A
1-PB2,2154,1469,1,5,0,1475,A
1-PB2,2155,0,1,1482,0,1483,G
1-PB2,2156,0,2,1488,0,1490,G
1-PB2,2157,0,1,1490,0,1491,G
1-PB2,2158,0,4,1488,0,1492,G
1-PB2,2159,1490,0,0,1,1491,A
1-PB2,2160,1491,0,1,0,1492,A
1-PB2,2161,1491,0,0,0,1491,A
1-PB2,2162,1493,0,4,0,1497,A
1-PB2,2163,1,0,1496,0,1497,G
1-PB2,2164,0,0,1493,0,1493,G
1-PB2,2165,2,0,0,1476,1478,C
1-PB2,2166,0,1478,0,1,1479,T
1-PB2,2167,1487,0,0,0,1487,A
1-PB2,2168,1487,1,0,0,1488,A
1-PB2,2169,0,1477,0,0,1477,T
1-PB2,2170,1,0,1500,0,1501,G
1-PB2,2171,1,1455,0,3,1459,T
1-PB2,2172,1,1,1448,0,1450,G
1-PB2,2173,0,0,0,1442,1442,C
1-PB2,2174,0,1432,0,3,1435,T
1-PB2,2175,1445,0,2,0,1447,A
1-PB2,2176,1445,0,0,0,1445,A
1-PB2,2177,0,1431,0,0,1431,T
1-PB2,2178,3,0,0,1430,1433,C
1-PB2,2179,1,2,1382,0,1385,G
1-PB2,2180,1,1,1384,0,1386,G
1-PB2,2181,0,0,1374,0,1374,G
1-PB2,2182,0,0,0,1380,1380,C
1-PB2,2183,1380,0,0,0,1380,A
1-PB2,2184,1371,0,1,0,1372,A
1-PB2,2185,1,1,1366,0,1368,G
1-PB2,2186,0,2,1372,0,1374,G
1-PB2,2187,1366,0,2,0,1368,A
1-PB2,2188,0,0,1373,0,1373,G
1-PB2,2189,1322,0,2,0,1324,A
1-PB2,2190,0,0,0,1335,1335,C
1-PB2,2191,0,0,1329,0,1329,G
1-PB2,2192,0,1321,0,1,1322,T
1-PB2,2193,0,0,1318,0,1318,G
1-PB2,2194,0,0,1347,0,1347,G
1-PB2,2195,1,1299,1,1,1302,T
1-PB2,2196,2,0,1311,0,1313,G
1-PB2,2197,1,1284,0,0,1285,T
1-PB2,2198,0,1270,0,1,1271,T
1-PB2,2199,0,2,1264,0,1266,G
1-PB2,2200,0,0,1267,0,1267,G
1-PB2,2201,0,1256,1,1,1258,T
1-PB2,2202,1231,0,0,0,1231,A
1-PB2,2203,1195,0,0,0,1195,A
1-PB2,2204,0,1160,0,0,1160,T
1-PB2,2205,0,1,1133,0,1134,G
1-PB2,2206,1138,0,0,0,1138,A
1-PB2,2207,1129,0,2,0,1131,A
1-PB2,2208,1125,0,4,0,1129,A
1-PB2,2209,0,0,0,1118,1118,C
1-PB2,2210,0,1,1119,0,1120,G
1-PB2,2211,1119,0,0,0,1119,A
1-PB2,2212,1117,0,2,0,1119,A
1-PB2,2213,1114,0,0,0,1114,A
1-PB2,2214,1111,0,0,0,1111,A
1-PB2,2215,0,3,0,1120,1123,C
1-PB2,2216,0,2,1111,0,1113,G
1-PB2,2217,0,0,1109,0,1109,G
1-PB2,2218,0,1,1111,0,1112,G
1-PB2,2219,1095,0,3,0,1098,A
1-PB2,2220,1,0,0,1118,1119,C
1-PB2,2221,0,1101,0,2,1103,T
1-PB2,2222,0,0,0,1135,1135,C
1-PB2,2223,0,1138,0,1,1139,T
1-PB2,2224,1136,0,0,0,1136,A
1-PB2,2225,0,1,1138,0,1139,G
1-PB2,2226,0,1,0,1110,1111,C
1-PB2,2227,1109,0,2,0,1111,A
1-PB2,2228,1,1112,0,0,1113,T
1-PB2,2229,1069,0,0,0,1069,A
1-PB2,2230,0,0,0,1090,1090,C
1-PB2,2231,0,967,0,0,967,T
1-PB2,2232,0,967,0,0,967,T
1-PB2,2233,939,0,1,0,940,A
1-PB2,2234,0,0,1,942,943,C
1-PB2,2235,0,934,0,2,936,T
1-PB2,2236,0,0,932,0,932,G
1-PB2,2237,895,1,0,0,896,A
1-PB2,2238,0,0,0,906,906,C
1-PB2,2239,824,0,0,0,824,A
1-PB2,2240,2,0,835,0,837,G
1-PB2,2241,0,0,0,825,825,C
1-PB2,2242,2,0,0,825,827,C
1-PB2,2243,823,0,1,0,824,A
1-PB2,2244,0,0,817,0,817,G
1-PB2,2245,812,0,1,0,813,A
1-PB2,2246,0,0,0,814,814,C
1-PB2,2247,746,0,1,0,747,A
1-PB2,2248,0,0,748,0,748,G
1-PB2,2249,1,0,0,684,685,C
1-PB2,2250,0,1,694,0,695,G
1-PB2,2251,686,0,1,0,687,A
1-PB2,2252,0,0,0,681,681,C
1-PB2,2253,0,0,0,676,676,C
1-PB2,2254,684,0,0,0,684,A
1-PB2,2255,673,0,1,1,675,A
1-PB2,2256,678,0,0,0,678,A
1-PB2,2257,675,0,0,0,675,A
1-PB2,2258,0,0,675,0,675,G
1-PB2,2259,656,0,0,0,656,A
1-PB2,2260,655,0,0,0,655,A
1-PB2,2261,0,641,0,0,641,T
1-PB2,2262,0,647,0,0,647,T
1-PB2,2263,2,0,0,655,657,C
1-PB2,2264,1,0,636,0,637,G
1-PB2,2265,0,0,635,0,635,G
1-PB2,2266,634,0,1,0,635,A
1-PB2,2267,0,612,0,1,613,T
1-PB2,2268,0,0,612,0,612,G
1-PB2,2269,0,0,601,0,601,G
1-PB2,2270,1,0,0,596,597,C
1-PB2,2271,5,0,0,603,608,C
1-PB2,2272,608,0,0,0,608,A
1-PB2,2273,0,607,0,1,608,T
1-PB2,2274,0,0,0,608,608,C
1-PB2,2275,609,0,0,0,609,A
1-PB2,2276,611,0,0,0,611,A
1-PB2,2277,0,602,0,0,602,T
1-PB2,2278,0,555,0,0,555,T
1-PB2,2279,533,0,0,0,533,A
1-PB2,2280,528,0,0,0,528,A
2-PB1,1,204,0,0,0,204,A
2-PB1,2,0,201,0,0,201,T
2-PB1,3,0,0,204,0,204,G
2-PB1,4,0,0,223,0,223,G
2-PB1,5,259,0,0,0,259,A
2-PB1,6,0,275,0,1,276,T
2-PB1,7,0,0,282,0,282,G
2-PB1,8,0,282,0,0,282,T
2-PB1,9,1,1,0,303,305,C
2-PB1,10,309,0,0,0,309,A
2-PB1,11,326,0,0,0,326,A
2-PB1,12,0,328,0,0,328,T
2-PB1,13,0,0,0,328,328,C
2-PB1,14,0,0,0,355,355,C
2-PB1,15,0,0,362,0,362,G
2-PB1,16,421,0,1,0,422,A
2-PB1,17,0,0,0,427,427,C
2-PB1,18,0,427,0,2,429,T
2-PB1,19,1,0,0,485,486,C
2-PB1,20,0,482,0,0,482,T
2-PB1,21,488,0,0,0,488,A
2-PB1,22,0,0,0,487,487,C
2-PB1,23,0,486,1,0,487,T
2-PB1,24,0,0,549,0,549,G
2-PB1,25,0,560,0,0,560,T
2-PB1,26,0,561,0,0,561,T
2-PB1,27,1,1,0,557,559,C
2-PB1,28,0,0,0,559,559,C
2-PB1,29,0,644,0,1,645,T
2-PB1,30,663,1,0,0,664,A
2-PB1,31,664,0,0,0,664,A
2-PB1,32,670,0,0,0,670,A
2-PB1,33,1,1,672,0,674,G
2-PB1,34,1,0,675,0,676,G
2-PB1,35,0,672,0,0,672,T
2-PB1,36,0,680,0,1,681,T
2-PB1,37,0,0,0,684,684,C
2-PB1,38,0,0,0,689,689,C
2-PB1,39,692,0,2,0,694,A
2-PB1,40,0,0,699,0,699,G
2-PB1,41,0,0,0,699,699,C
2-PB1,42,0,0,701,0,701,G
2-PB1,43,1,0,0,698,699,C
2-PB1,44,704,0,0,0,704,A
2-PB1,45,703,0,1,0,704,A
2-PB1,46,702,0,1,0,703,A
2-PB1,47,711,0,0,1,712,A
2-PB1,48,0,714,0,0,714,T
2-PB1,49,0,0,748,0,748,G
2-PB1,50,1,0,0,751,752,C
2-PB1,51,1,0,0,752,753,C
2-PB1,52,757,0,1,0,758,A
2-PB1,53,0,757,0,0,757,T
2-PB1,54,817,0,0,0,817,A
2-PB1,55,818,0,0,0,818,A
2-PB1,56,0,1,844,0,845,G
2-PB1,57,0,1,0,849,850,C
2-PB1,58,849,0,0,0,849,A
2-PB1,59,0,0,0,889,889,C
2-PB1,60,883,0,0,0,883,A
2-PB1,61,929,0,1,0,930,A
2-PB1,62,0,0,0,937,937,C
2-PB1,63,935,0,0,0,935,A
2-PB1,64,0,944,0,2,946,T
2-PB1,65,1,939,0,1,941,T
2-PB1,66,0,0,0,1161,1161,C
2-PB1,67,0,1,0,1163,1164,C
2-PB1,68,2,1,0,1165,1168,C
2-PB1,69,0,1179,0,3,1182,T
2-PB1,70,0,1176,0,0,1176,T
2-PB1,71,1298,0,1,0,1299,A
2-PB1,72,0,1311,0,0,1311,T
2-PB1,73,1317,1,1,0,1319,A
2-PB1,74,0,0,0,1329,1329,C
2-PB1,75,0,1284,0,5,1289,T
2-PB1,76,1,3,1304,0,1308,G
2-PB1,77,0,1,1301,0,1302,G
2-PB1,78,1296,0,3,0,1299,A
2-PB1,79,1,0,1311,0,1312,G
2-PB1,80,1289,0,1,0,1290,A
2-PB1,81,0,1286,0,2,1288,T
2-PB1,82,1,0,0,1377,1378,C
2-PB1,83,2,0,0,1376,1378,C
2-PB1,84,0,1389,0,2,1391,T
2-PB1,85,1,0,0,1497,1498,C
2-PB1,86,0,1,0,1500,1501,C
2-PB1,87,1521,0,1,0,1522,A
2-PB1,88,0,1518,0,1,1519,T
2-PB1,89,1521,0,0,0,1521,A
2-PB1,90,0,0,0,1531,1531,C
2-PB1,91,1493,0,2,0,1495,A
2-PB1,92,0,1,1559,0,1560,G
2-PB1,93,0,0,0,1577,1577,C
2-PB1,94,0,0,0,1570,1570,C
2-PB1,95,1578,0,2,0,1580,A
2-PB1,96,0,1571,0,2,1573,T
2-PB1,97,0,2,1575,0,1577,G
2-PB1,98,0,13,1651,0,1664,G
2-PB1,99,1661,0,1,0,1662,A
2-PB1,100,1679,0,5,0,1684,A
2-PB1,101,0,1,0,1677,1678,C
2-PB1,102,1663,0,3,1,1667,A
2-PB1,103,1,1,1697,0,1699,G
2-PB1,104,0,4,1714,0,1718,G
2-PB1,105,1724,0,2,0,1726,A
2-PB1,106,1738,0,4,0,1742,A
2-PB1,107,0,0,0,1753,1753,C
2-PB1,108,1727,2,1,0,1730,A
2-PB1,109,0,2,1928,0,1930,G
2-PB1,110,0,5,1923,1,1929,G
2-PB1,111,2,0,1965,0,1967,G
2-PB1,112,0,1962,0,3,1965,T
2-PB1,113,1972,0,0,0,1972,A
2-PB1,114,2,0,0,1998,2000,C
2-PB1,115,2060,0,1,0,2061,A
2-PB1,116,0,1,0,2131,2132,C
2-PB1,117,4,0,0,2105,2109,C
2-PB1,118,2034,0,4,0,2038,A
2-PB1,119,0,2037,0,2,2039,T
2-PB1,120,1,5,2039,0,2045,G
2-PB1,121,1,6,2027,1,2035,G
2-PB1,122,2038,0,4,0,2042,A
2-PB1,123,0,0,0,2049,2049,C
2-PB1,124,2017,0,2,1,2020,A
2-PB1,125,0,0,0,2053,2053,C
2-PB1,126,2055,0,2,0,2057,A
2-PB1,127,0,0,2103,0,2103,G
2-PB1,128,0,2099,0,6,2105,T
2-PB1,129,5,0,0,2165,2170,C
2-PB1,130,2162,0,1,0,2163,A
2-PB1,131,2171,0,1,0,2172,A
2-PB1,132,1,0,0,2180,2181,C
2-PB1,133,2168,0,1,0,2169,A
2-PB1,134,1,5,2187,0,2193,G
2-PB1,135,2142,0,5,0,2147,A
2-PB1,136,2147,0,3,0,2150,A
2-PB1,137,0,3,0,2144,2147,C
2-PB1,138,2108,0,3,0,2111,A
2-PB1,139,0,0,0,2177,2177,C
2-PB1,140,2164,0,3,0,2167,A
2-PB1,141,2,0,0,2266,2268,C
2-PB1,142,3,0,0,2266,2269,C
2-PB1,143,2265,0,1,0,2266,A
2-PB1,144,2279,1,3,0,2283,A
2-PB1,145,0,2348,0,0,2348,T
2-PB1,146,2408,0,3,0,2411,A
2-PB1,147,0,2403,0,1,2404,T
2-PB1,148,0,2365,0,3,2368,T
2-PB1,149,5,1,0,2369,2375,C
2-PB1,150,2314,1,6,0,2321,A
2-PB1,151,0,4,2317,0,2321,G
2-PB1,152,2294,2,3,0,2299,A
2-PB1,153,4,1,2300,0,2305,G
2-PB1,154,2236,0,3,0,2239,A
2-PB1,155,3,3,2176,0,2182,G
2-PB1,156,0,4,2169,0,2173,G
2-PB1,157,0,3,2258,0,2261,G
2-PB1,158,1,2,2267,0,2270,G
2-PB1,159,2,1,2290,0,2293,G
2-PB1,160,2278,0,5,0,2283,A
2-PB1,161,2276,0,6,0,2282,A
2-PB1,162,1,0,2307,0,2308,G
2-PB1,163,0,2252,0,2,2254,T
2-PB1,164,0,3,2257,1,2261,G
2-PB1,165,0,2,2250,0,2252,G
2-PB1,166,2243,1,8,0,2252,A
2-PB1,167,0,2,0,2273,2275,C
2-PB1,168,1,4,2275,0,2280,G
2-PB1,169,2287,1,4,0,2292,A
2-PB1,170,2,0,0,2313,2315,C
2-PB1,171,2301,0,1,1,2303,A
2-PB1,172,2309,0,1,0,2310,A
2-PB1,173,2315,0,0,0,2315,A
2-PB1,174,0,2352,0,0,2352,T
2-PB1,175,2369,0,0,0,2369,A
2-PB1,176,0,1,0,2368,2369,C
2-PB1,177,2345,0,2,0,2347,A
2-PB1,178,0,2,2345,0,2347,G
2-PB1,179,2329,0,1,0,2330,A
2-PB1,180,2363,0,2,0,2365,A
2-PB1,181,2363,0,2,0,2365,A
2-PB1,182,0,0,0,2373,2373,C
2-PB1,183,0,2327,0,3,2330,T
2-PB1,184,1,2,2325,0,2328,G
2-PB1,185,0,3,2315,0,2318,G
2-PB1,186,1,4,2289,0,2294,G
2-PB1,187,2,1,2298,0,2301,G
2-PB1,188,1,0,0,2322,2323,C
2-PB1,189,2308,0,2,0,2310,A
2-PB1,190,1,2,0,2417,2420,C
2-PB1,191,5,0,0,2417,2422,C
2-PB1,192,1,1,0,2416,2418,C
2-PB1,193,2,0,0,2426,2428,C
2-PB1,194,2432,1,4,0,2437,A
2-PB1,195,2457,0,3,0,2460,A
2-PB1,196,1,0,0,2456,2457,C
2-PB1,197,0,2437,0,4,2441,T
2-PB1,198,4,0,0,2465,2469,C
2-PB1,199,2365,0,1,0,2366,A
2-PB1,200,2391,1,3,0,2395,A
2-PB1,201,0,2,0,2406,2408,C
2-PB1,202,3,0,0,2392,2395,C
2-PB1,203,7,1,0,2390,2398,C
2-PB1,204,2391,0,1,0,2392,A
2-PB1,205,2405,0,0,0,2405,A
2-PB1,206,1,2403,0,1,2405,T
2-PB1,207,0,2415,0,2,2417,T
2-PB1,208,0,3,2418,1,2422,G
2-PB1,209,2393,0,3,0,2396,A
2-PB1,210,0,2365,0,3,2368,T
2-PB1,211,0,7,2382,0,2389,G
2-PB1,212,0,2,2398,0,2400,G
2-PB1,213,2429,0,3,0,2432,A
2-PB1,214,1,0,0,2424,2425,C
2-PB1,215,3,0,0,2413,2416,C
2-PB1,216,2406,1,4,0,2411,A
2-PB1,217,0,0,0,2469,2469,C
2-PB1,218,0,2468,0,2,2470,T
2-PB1,219,2502,0,3,0,2505,A
2-PB1,220,1,1,1,2525,2528,C
2-PB1,221,2,0,0,2498,2500,C
2-PB1,222,0,2452,0,3,2455,T
2-PB1,223,0,2,2451,0,2453,G
2-PB1,224,2426,0,3,0,2429,A
2-PB1,225,0,2,2451,0,2453,G
2-PB1,226,0,7,2425,0,2432,G
2-PB1,227,2402,1,2,0,2405,A
2-PB1,228,0,2381,0,2,2383,T
2-PB1,229,2351,0,0,0,2351,A
2-PB1,230,2339,0,4,0,2343,A
2-PB1,231,1,2344,0,1,2346,T
2-PB1,232,2,7,2321,0,2330,G
2-PB1,233,2316,0,7,0,2323,A
2-PB1,234,2300,0,5,0,2305,A
2-PB1,235,0,1,0,2317,2318,C
2-PB1,236,3,0,0,2272,2275,C
2-PB1,237,2275,0,1,0,2276,A
2-PB1,238,2267,1,2,1,2271,A
2-PB1,239,0,0,2295,0,2295,G
2-PB1,240,0,2276,0,0,2276,T
2-PB1,241,0,2,2281,1,2284,G
2-PB1,242,0,2,2315,0,2317,G
2-PB1,243,2303,0,8,0,2311,A
2-PB1,244,0,2309,0,1,2310,T
2-PB1,245,2315,0,1,0,2316,A
2-PB1,246,0,2363,0,0,2363,T
2-PB1,247,0,0,2364,0,2364,G
2-PB1,248,1,1,0,2352,2354,C
2-PB1,249,2350,0,3,0,2353,A
2-PB1,250,1,1,0,2429,2431,C
2-PB1,251,2395,0,2,0,2397,A
2-PB1,252,2424,0,2,0,2426,A
2-PB1,253,2415,1,0,0,2416,A
2-PB1,254,1,0,0,2432,2433,C
2-PB1,255,2356,0,0,0,2356,A
2-PB1,256,1,4,2377,0,2382,G
2-PB1,257,2350,0,3,0,2353,A
2-PB1,258,0,0,0,2367,2367,C
2-PB1,259,1,2286,0,1,2288,T
2-PB1,260,0,0,2326,0,2326,G
2-PB1,261,0,2262,0,3,2265,T
2-PB1,262,0,0,2409,0,2409,G
2-PB1,263,1,2404,0,2,2407,T
2-PB1,264,3,1,0,2406,2410,C
2-PB1,265,2,0,1,2404,2407,C
2-PB1,266,0,2390,0,4,2394,T
2-PB1,267,1,2,2383,0,2386,G
2-PB1,268,0,2,2378,0,2380,G
2-PB1,269,2320,0,3,0,2323,A
2-PB1,270,0,0,2358,0,2358,G
2-PB1,271,4,0,2299,0,2303,G
2-PB1,272,1,0,0,2298,2299,C
2-PB1,273,0,2293,0,0,2293,T
2-PB1,274,2300,0,2,0,2302,A
2-PB1,275,1,2284,1,2,2288,T
2-PB1,276,1,2,2288,0,2291,G
2-PB1,277,0,0,2272,0,2272,G
2-PB1,278,0,1,0,2283,2284,C
2-PB1,279,1,0,0,2248,2249,C
2-PB1,280,0,2218,0,4,2222,T
2-PB1,281,0,2330,0,2,2332,T
2-PB1,282,0,0,0,2330,2330,C
2-PB1,283,2,0,0,2336,2338,C
2-PB1,284,0,2342,0,1,2343,T
2-PB1,285,0,2327,0,3,2330,T
2-PB1,286,0,4,2331,0,2335,G
2-PB1,287,2333,0,1,0,2334,A
2-PB1,288,2334,0,3,0,2337,A
2-PB1,289,0,5,2326,0,2331,G
2-PB1,290,2234,0,0,0,2234,A
2-PB1,291,2252,0,1,0,2253,A
2-PB1,292,0,2244,0,1,2245,T
2-PB1,293,2,0,0,2257,2259,C
2-PB1,294,2,3,0,2254,2259,C
2-PB1,295,3,3,0,2231,2237,C
2-PB1,296,2236,0,0,1,2237,A
2-PB1,297,2,0,0,2260,2262,C
2-PB1,298,3,0,0,2257,2260,C
2-PB1,299,4,1,0,2257,2262,C
2-PB1,300,2228,1,3,0,2232,A
2-PB1,301,0,0,2244,0,2244,G
2-PB1,302,0,1,2246,0,2247,G
2-PB1,303,0,2206,1,2,2209,T
2-PB1,304,2268,0,0,0,2268,A
2-PB1,305,0,2242,0,1,2243,T
2-PB1,306,0,2,0,2255,2257,C
2-PB1,307,1,2249,0,6,2256,T
2-PB1,308,0,2257,0,1,2258,T
2-PB1,309,1,2254,0,1,2256,T
2-PB1,310,2,4,2236,0,2242,G
2-PB1,311,2211,0,5,1,2217,A
2-PB1,312,1,3,2221,0,2225,G
2-PB1,313,2193,0,3,0,2196,A
2-PB1,314,2207,1,2,0,2210,A
2-PB1,315,1,0,0,2224,2225,C
2-PB1,316,0,2173,0,2,2175,T
2-PB1,317,3,2,0,2188,2193,C
2-PB1,318,2192,0,1,0,2193,A
2-PB1,319,0,2188,0,1,2189,T
2-PB1,320,0,1,2192,0,2193,G
2-PB1,321,0,0,0,2236,2236,C
2-PB1,322,1,0,0,2227,2228,C
2-PB1,323,1,2221,0,4,2226,T
2-PB1,324,0,2204,0,3,2207,T
2-PB1,325,0,2,2211,0,2213,G
2-PB1,326,2221,0,2,0,2223,A
2-PB1,327,2221,1,3,0,2225,A
2-PB1,328,2222,0,6,1,2229,A
2-PB1,329,1,0,0,2249,2250,C
2-PB1,330,2202,0,0,0,2202,A
2-PB1,331,2226,0,0,0,2226,A
2-PB1,332,1,2211,0,3,2215,T
2-PB1,333,6,5,2213,0,2224,G
2-PB1,334,0,2,2213,0,2215,G
2-PB1,335,2180,0,4,0,2184,A
2-PB1,336,2174,0,4,0,2178,A
2-PB1,337,2,0,2181,0,2183,G
2-PB1,338,0,0,0,2182,2182,C
2-PB1,339,2,0,0,2156,2158,C
2-PB1,340,2,1,2168,0,2171,G
2-PB1,341,0,2161,0,6,2167,T
2-PB1,342,0,2153,0,4,2157,T
2-PB1,343,5,0,0,2186,2191,C
2-PB1,344,2185,0,1,0,2186,A
2-PB1,345,2199,0,3,0,2202,A
2-PB1,346,1,0,0,2215,2216,C
2-PB1,347,2204,1,3,0,2208,A
2-PB1,348,0,1,2218,0,2219,G
2-PB1,349,2183,0,5,0,2188,A
2-PB1,350,1,0,0,2179,2180,C
2-PB1,351,2188,2,2,0,2192,A
2-PB1,352,2201,1,4,0,2206,A
2-PB1,353,0,4,2226,0,2230,G
2-PB1,354,1,0,2181,0,2182,G
2-PB1,355,0,0,2194,0,2194,G
2-PB1,356,1,2096,0,2,2099,T
2-PB1,357,1,1,2141,0,2143,G
2-PB1,358,0,2,2145,0,2147,G
2-PB1,359,2140,0,4,0,2144,A
2-PB1,360,2,0,0,2160,2162,C
2-PB1,361,2107,0,1,0,2108,A
2-PB1,362,2129,0,3,0,2132,A
2-PB1,363,2134,0,0,0,2134,A
2-PB1,364,1,0,0,2135,2136,C
2-PB1,365,0,2125,0,2,2127,T
2-PB1,366,2124,0,0,0,2124,A
2-PB1,367,2109,0,2,0,2111,A
2-PB1,368,2,1,0,2123,2126,C
2-PB1,369,2,0,0,2131,2133,C
2-PB1,370,4,0,0,2131,2135,C
2-PB1,371,2052,0,1,0,2053,A
2-PB1,372,2049,0,3,1,2053,A
2-PB1,373,0,6,2043,0,2049,G
2-PB1,374,3,1,2048,0,2052,G
2-PB1,375,0,2021,0,1,2022,T
2-PB1,376,4,1,0,2045,2050,C
2-PB1,377,2,1,2037,0,2040,G
2-PB1,378,3,1,0,2040,2044,C
2-PB1,379,0,1,0,2045,2046,C
2-PB1,380,2050,0,1,0,2051,A
2-PB1,381,0,5,2100,0,2105,G
2-PB1,382,2116,0,2,1,2119,A
2-PB1,383,1,0,0,2140,2141,C
2-PB1,384,0,2124,1,6,2131,T
2-PB1,385,0,2126,0,4,2130,T
2-PB1,386,2132,0,1,0,2133,A
2-PB1,387,0,2150,0,3,2153,T
2-PB1,388,1,5,2146,0,2152,G
2-PB1,389,2127,0,0,0,2127,A
2-PB1,390,0,2082,0,3,2085,T
2-PB1,391,0,1993,0,0,1993,T
2-PB1,392,0,2,1995,0,1997,G
2-PB1,393,0,4,1980,0,1984,G
2-PB1,394,2011,0,5,0,2016,A
2-PB1,395,0,0,0,2035,2035,C
2-PB1,396,1999,0,0,0,1999,A
2-PB1,397,0,1987,0,0,1987,T
2-PB1,398,0,2004,0,0,2004,T
2-PB1,399,2012,0,0,0,2012,A
2-PB1,400,2010,0,0,0,2010,A
2-PB1,401,2002,0,2,0,2004,A
2-PB1,402,0,0,0,2017,2017,C
2-PB1,403,1967,0,2,0,1969,A
2-PB1,404,0,3,1978,0,1981,G
2-PB1,405,1976,0,4,0,1980,A
2-PB1,406,1991,0,0,0,1991,A
2-PB1,407,1974,0,2,0,1976,A
2-PB1,408,0,1936,1,2,1939,T
2-PB1,409,6,0,0,1954,1960,C
2-PB1,410,1956,0,2,0,1958,A
2-PB1,411,1956,0,4,0,1960,A
2-PB1,412,1,1,0,1944,1946,C
2-PB1,413,1,0,1,1928,1930,C
2-PB1,414,1,1,1933,1,1936,G
2-PB1,415,2,0,1933,0,1935,G
2-PB1,416,0,0,0,1950,1950,C
2-PB1,417,1955,0,0,0,1955,A
2-PB1,418,0,1,1950,0,1951,G
2-PB1,419,1,1,0,1958,1960,C
2-PB1,420,1968,0,2,0,1970,A
2-PB1,421,1978,0,0,0,1978,A
2-PB1,422,0,2,0,1968,1970,C
2-PB1,423,0,1955,1,5,1961,T
2-PB1,424,0,0,2050,0,2050,G
2-PB1,425,0,4,0,2056,2060,C
2-PB1,426,2054,3,2,0,2059,A
2-PB1,427,0,2065,0,2,2067,T
2-PB1,428,1,2037,1,2,2041,T
2-PB1,429,2158,1,2,2,2163,A
2-PB1,430,1,0,2149,0,2150,G
2-PB1,431,1,0,0,2138,2139,C
2-PB1,432,0,1,0,2153,2154,C
2-PB1,433,2086,0,1,0,2087,A
2-PB1,434,2100,0,3,0,2103,A
2-PB1,435,0,0,0,2121,2121,C
2-PB1,436,2106,0,1,0,2107,A
2-PB1,437,1,0,0,2167,2168,C
2-PB1,438,1,1,0,2032,2034,C
2-PB1,439,2024,0,1,0,2025,A
2-PB1,440,0,2018,2,2,2022,T
2-PB1,441,2032,1,0,0,2033,A
2-PB1,442,1,1,2026,0,2028,G
2-PB1,443,2007,0,1,0,2008,A
2-PB1,444,1994,0,1,0,1995,A
2-PB1,445,0,1,2011,0,2012,G
2-PB1,446,0,1942,0,3,1945,T
2-PB1,447,0,1947,0,4,1951,T
2-PB1,448,1,1964,0,1,1966,T
2-PB1,449,0,1972,0,0,1972,T
2-PB1,450,0,1975,0,0,1975,T
2-PB1,451,1973,0,1,0,1974,A
2-PB1,452,1,1,1962,0,1964,G
2-PB1,453,1955,0,1,0,1956,A
2-PB1,454,0,1925,1,0,1926,T
2-PB1,455,4,0,0,1920,1924,C
2-PB1,456,0,5,1922,0,1927,G
2-PB1,457,1919,0,0,0,1919,A
2-PB1,458,1924,0,0,0,1924,A
2-PB1,459,0,1,0,1942,1943,C
2-PB1,460,1,1,1937,0,1939,G
2-PB1,461,2,5,2034,0,2041,G
2-PB1,462,2041,0,1,0,2042,A
2-PB1,463,0,2047,1,0,2048,T
2-PB1,464,0,2062,0,0,2062,T
2-PB1,465,2048,0,7,0,2055,A
2-PB1,466,2047,0,2,1,2050,A
2-PB1,467,0,0,0,2062,2062,C
2-PB1,468,2039,0,1,0,2040,A
2-PB1,469,0,1,2052,0,2053,G
2-PB1,470,0,0,0,1959,1959,C
2-PB1,471,0,1949,0,1,1950,T
2-PB1,472,1962,0,0,0,1962,A
2-PB1,473,1946,1,3,1,1951,A
2-PB1,474,0,1953,0,2,1955,T
2-PB1,475,0,8,1982,0,1990,G
2-PB1,476,1983,0,0,0,1983,A
2-PB1,477,1984,0,1,0,1985,A
2-PB1,478,0,1932,0,2,1934,T
2-PB1,479,2,0,0,1947,1949,C
2-PB1,480,1945,1,2,0,1948,A
2-PB1,481,0,0,1946,0,1946,G
2-PB1,482,0,5,1931,0,1936,G
2-PB1,483,1938,0,5,0,1943,A
2-PB1,484,1912,0,3,0,1915,A
2-PB1,485,1,0,1975,0,1976,G
2-PB1,486,0,0,1969,0,1969,G
2-PB1,487,0,0,0,1980,1980,C
2-PB1,488,0,1988,0,2,1990,T
2-PB1,489,1991,0,1,0,1992,A
2-PB1,490,1984,0,4,0,1988,A
2-PB1,491,0,1990,0,2,1992,T
2-PB1,492,1993,0,1,0,1994,A
2-PB1,493,0,2,2001,0,2003,G
2-PB1,494,1908,0,1,0,1909,A
2-PB1,495,1,1876,1,1,1879,T
2-PB1,496,0,1875,0,2,1877,T
2-PB1,497,0,1864,0,2,1866,T
2-PB1,498,2,0,0,1946,1948,C
2-PB1,499,1,1,0,1940,1942,C
2-PB1,500,0,1932,0,2,1934,T
2-PB1,501,1,0,0,1959,1960,C
2-PB1,502,1963,0,0,2,1965,A
2-PB1,503,1960,0,2,0,1962,A
2-PB1,504,3,1,1970,0,1974,G
2-PB1,505,0,4,1981,0,1985,G
2-PB1,506,1985,0,1,0,1986,A
2-PB1,507,0,1917,0,2,1919,T
2-PB1,508,0,0,1953,0,1953,G
2-PB1,509,0,1932,0,3,1935,T
2-PB1,510,45,1,1924,0,1970,G
2-PB1,511,1970,0,3,0,1973,A
2-PB1,512,1,1962,0,1,1964,T
2-PB1,513,1,5,1939,0,1945,G
2-PB1,514,0,2,1949,0,1951,G
2-PB1,515,1912,0,10,0,1922,A
2-PB1,516,1923,0,2,0,1925,A
2-PB1,517,1,1886,0,1,1888,T
2-PB1,518,6,0,0,1903,1909,C
2-PB1,519,1895,0,2,0,1897,A
2-PB1,520,1893,0,0,0,1893,A
2-PB1,521,0,1891,0,1,1892,T
2-PB1,522,0,4,1922,0,1926,G
2-PB1,523,0,3,1928,0,1931,G
2-PB1,524,1919,1,3,0,1923,A
2-PB1,525,0,1918,0,2,1920,T
2-PB1,526,1926,0,1,1,1928,A
2-PB1,527,1918,0,3,0,1921,A
2-PB1,528,1922,0,2,0,1924,A
2-PB1,529,0,0,1946,0,1946,G
2-PB1,530,1925,0,6,0,1931,A
2-PB1,531,0,0,1921,0,1921,G
2-PB1,532,0,1,1916,0,1917,G
2-PB1,533,1902,0,1,0,1903,A
2-PB1,534,1912,0,1,0,1913,A
2-PB1,535,1920,0,1,0,1921,A
2-PB1,536,0,1914,0,0,1914,T
2-PB1,537,0,1,1936,0,1937,G
2-PB1,538,0,2,1932,0,1934,G
2-PB1,539,1906,0,5,0,1911,A
2-PB1,540,0,2,1920,0,1922,G
2-PB1,541,1917,0,2,0,1919,A
2-PB1,542,0,1957,0,0,1957,T
2-PB1,543,1963,0,0,0,1963,A
2-PB1,544,1987,0,1,0,1988,A
2-PB1,545,1,1,0,1988,1990,C
2-PB1,546,1961,0,4,0,1965,A
2-PB1,547,1966,0,1,0,1967,A
2-PB1,548,1,3,0,1957,1961,C
2-PB1,549,1951,0,3,0,1954,A
2-PB1,550,0,0,0,1954,1954,C
2-PB1,551,1914,0,1,0,1915,A
2-PB1,552,1,1,0,1930,1932,C
2-PB1,553,0,1896,1,2,1899,T
2-PB1,554,0,1905,0,0,1905,T
2-PB1,555,0,1899,0,2,1901,T
2-PB1,556,4,1,0,1911,1916,C
2-PB1,557,1914,0,4,0,1918,A
2-PB1,558,1912,0,2,0,1914,A
2-PB1,559,1912,0,2,1,1915,A
2-PB1,560,0,2,1935,0,1937,G
2-PB1,561,1905,0,2,0,1907,A
2-PB1,562,1910,0,0,0,1910,A
2-PB1,563,1906,0,2,0,1908,A
2-PB1,564,1917,0,1,0,1918,A
2-PB1,565,1914,0,5,0,1919,A
2-PB1,566,1,3,1924,0,1928,G
2-PB1,567,0,3,1928,0,1931,G
2-PB1,568,1903,0,5,0,1908,A
2-PB1,569,1,3,1940,0,1944,G
2-PB1,570,1936,0,5,0,1941,A
2-PB1,571,1,0,2004,0,2005,G
2-PB1,572,0,1975,0,0,1975,T
2-PB1,573,2003,0,2,0,2005,A
2-PB1,574,1997,0,2,0,1999,A
2-PB1,575,3,2,2004,1,2010,G
2-PB1,576,0,3,2015,1,2019,G
2-PB1,577,1,6,2002,0,2009,G
2-PB1,578,1983,0,4,0,1987,A
2-PB1,579,1,0,1,1997,1999,C
2-PB1,580,1968,0,0,0,1968,A
2-PB1,581,1971,0,2,0,1973,A
2-PB1,582,0,1,0,1964,1965,C
2-PB1,583,1959,0,4,0,1963,A
2-PB1,584,0,1931,0,0,1931,T
2-PB1,585,0,9,1913,0,1922,G
2-PB1,586,1919,0,2,0,1921,A
2-PB1,587,0,1,0,1896,1897,C
2-PB1,588,2,0,0,1892,1894,C
2-PB1,589,1906,0,0,0,1906,A
2-PB1,590,1915,0,1,0,1916,A
2-PB1,591,0,5,1922,0,1927,G
2-PB1,592,1920,0,2,0,1922,A
2-PB1,593,1923,0,1,0,1924,A
2-PB1,594,1908,0,2,0,1910,A
2-PB1,595,1904,0,3,1,1908,A
2-PB1,596,0,1912,0,2,1914,T
2-PB1,597,0,5,1908,0,1913,G
2-PB1,598,0,0,1903,0,1903,G
2-PB1,599,0,1824,0,2,1826,T
2-PB1,600,3,1,0,1816,1820,C
2-PB1,601,1831,0,1,0,1832,A
2-PB1,602,1,0,0,1984,1985,C
2-PB1,603,2033,0,1,0,2034,A
2-PB1,604,0,0,1,2053,2054,C
2-PB1,605,2047,0,1,0,2048,A
2-PB1,606,2143,0,0,0,2143,A
2-PB1,607,2137,0,3,0,2140,A
2-PB1,608,1,7,2294,0,2302,G
2-PB1,609,2296,1,0,0,2297,A
2-PB1,610,2319,0,4,0,2323,A
2-PB1,611,2,0,0,2380,2382,C
2-PB1,612,2327,0,2,0,2329,A
2-PB1,613,2338,0,3,0,2341,A
2-PB1,614,0,2316,0,0,2316,T
2-PB1,615,2306,0,3,0,2309,A
2-PB1,616,0,1,2310,0,2311,G
2-PB1,617,0,1,2259,0,2260,G
2-PB1,618,1,3,2256,0,2260,G
2-PB1,619,2249,0,1,0,2250,A
2-PB1,620,2236,0,4,0,2240,A
2-PB1,621,0,3,2265,0,2268,G
2-PB1,622,2267,0,0,1,2268,A
2-PB1,623,2272,0,1,0,2273,A
2-PB1,624,2284,0,1,0,2285,A
2-PB1,625,2291,0,2,0,2293,A
2-PB1,626,2346,0,2,0,2348,A
2-PB1,627,2349,0,0,1,2350,A
2-PB1,628,1,0,0,2360,2361,C
2-PB1,629,2346,0,0,0,2346,A
2-PB1,630,2347,1,3,1,2352,A
2-PB1,631,2335,0,6,0,2341,A
2-PB1,632,1,0,2382,0,2383,G
2-PB1,633,2388,0,2,0,2390,A
2-PB1,634,1,0,2499,0,2500,G
2-PB1,635,0,2467,0,0,2467,T
2-PB1,636,0,3,2930,2,2935,G
2-PB1,637,2947,0,6,1,2954,A
2-PB1,638,2957,0,2,1,2960,A
2-PB1,639,0,2989,0,0,2989,T
2-PB1,640,3019,0,2,0,3021,A
2-PB1,641,3016,0,3,0,3019,A
2-PB1,642,0,2,3016,0,3018,G
2-PB1,643,2961,1,4,1,2967,A
2-PB1,644,1,3,2974,0,2978,G
2-PB1,645,2824,0,2,0,2826,A
2-PB1,646,0,2,2839,0,2841,G
2-PB1,647,0,0,2818,0,2818,G
2-PB1,648,0,1,0,2825,2826,C
2-PB1,649,0,2811,0,3,2814,T
2-PB1,650,2914,0,1,0,2915,A
2-PB1,651,0,0,0,3063,3063,C
2-PB1,652,5,0,0,3065,3070,C
2-PB1,653,1,3113,0,2,3116,T
2-PB1,654,3241,7,0,0,3248,A
2-PB1,655,3242,0,1,0,3243,A
2-PB1,656,0,3229,0,0,3229,T
2-PB1,657,3235,0,1,0,3236,A
2-PB1,658,3232,0,4,0,3236,A
2-PB1,659,1,5,3228,0,3234,G
2-PB1,660,3115,0,6,0,3121,A
2-PB1,661,0,0,3133,0,3133,G
2-PB1,662,0,0,0,3150,3150,C
2-PB1,663,1,3085,0,4,3090,T
2-PB1,664,0,3104,0,1,3105,T
2-PB1,665,0,3111,0,0,3111,T
2-PB1,666,1,8,3102,0,3111,G
2-PB1,667,3182,1,7,0,3190,A
2-PB1,668,0,2,0,3209,3211,C
2-PB1,669,3204,0,1,1,3206,A
2-PB1,670,0,3188,0,4,3192,T
2-PB1,671,0,3177,0,0,3177,T
2-PB1,672,3,5,3253,0,3261,G
2-PB1,673,3266,1,3,0,3270,A
2-PB1,674,3269,0,6,0,3275,A
2-PB1,675,1,1,0,3270,3272,C
2-PB1,676,3262,0,2,0,3264,A
2-PB1,677,2,0,0,3268,3270,C
2-PB1,678,0,7,3250,1,3258,G
2-PB1,679,3246,0,2,0,3248,A
2-PB1,680,0,3272,0,2,3274,T
2-PB1,681,0,16,3322,0,3338,G
2-PB1,682,3358,0,4,1,3363,A
2-PB1,683,2,1,0,3380,3383,C
2-PB1,684,15,2,0,3366,3383,C
2-PB1,685,3387,0,5,0,3392,A
2-PB1,686,3430,0,1,0,3431,A
2-PB1,687,3425,0,8,0,3433,A
2-PB1,688,0,3,3527,0,3530,G
2-PB1,689,3567,0,2,0,3569,A
2-PB1,690,0,3512,0,3,3515,T
2-PB1,691,3,0,3539,1,3543,G
2-PB1,692,1,2,0,3504,3507,C
2-PB1,693,3523,0,10,0,3533,A
2-PB1,694,2,9,3573,0,3584,G
2-PB1,695,3532,0,8,0,3540,A
2-PB1,696,0,3,3559,0,3562,G
2-PB1,697,3443,0,6,0,3449,A
2-PB1,698,0,2,3440,1,3443,G
2-PB1,699,3402,0,5,0,3407,A
2-PB1,700,0,5,3399,0,3404,G
2-PB1,701,2,0,3394,0,3396,G
2-PB1,702,2,1,0,3391,3394,C
2-PB1,703,3378,0,4,0,3382,A
2-PB1,704,3392,0,3,0,3395,A
2-PB1,705,3409,0,1,0,3410,A
2-PB1,706,0,3423,0,0,3423,T
2-PB1,707,0,3426,0,1,3427,T
2-PB1,708,3440,0,0,0,3440,A
2-PB1,709,3418,0,1,0,3419,A
2-PB1,710,3434,0,2,0,3436,A
2-PB1,711,3449,0,1,0,3450,A
2-PB1,712,3433,0,3,0,3436,A
2-PB1,713,0,0,3452,0,3452,G
2-PB1,714,3400,1,2,0,3403,A
2-PB1,715,3389,0,2,0,3391,A
2-PB1,716,0,2,3459,0,3461,G
2-PB1,717,1,3,3505,0,3509,G
2-PB1,718,0,2,3504,0,3506,G
2-PB1,719,1,1,0,3542,3544,C
2-PB1,720,0,3532,1,5,3538,T
2-PB1,721,3575,0,5,0,3580,A
2-PB1,722,0,3642,0,9,3651,T
2-PB1,723,3,3655,0,3,3661,T
2-PB1,724,0,2,3679,0,3681,G
2-PB1,725,2,1,0,3645,3648,C
2-PB1,726,3554,0,6,0,3560,A
2-PB1,727,3559,0,5,0,3564,A
2-PB1,728,2,2,0,3563,3567,C
2-PB1,729,3537,0,2,0,3539,A
2-PB1,730,2,0,0,3555,3557,C
2-PB1,731,3,0,0,3491,3494,C
2-PB1,732,7,5,1,3475,3488,C
2-PB1,733,1,8,3463,3,3475,G
2-PB1,734,1,3,3471,0,3475,G
2-PB1,735,0,2,3487,0,3489,G
2-PB1,736,3490,0,2,0,3492,A
2-PB1,737,0,3446,0,3,3449,T
2-PB1,738,1,0,3472,0,3473,G
2-PB1,739,1,2,0,3443,3446,C
2-PB1,740,3485,0,5,0,3490,A
2-PB1,741,3538,0,0,0,3538,A
2-PB1,742,3582,0,0,0,3582,A
2-PB1,743,0,3596,0,1,3597,T
2-PB1,744,0,3587,0,2,3589,T
2-PB1,745,3566,0,3,1,3570,A
2-PB1,746,0,1,3563,0,3564,G
2-PB1,747,3543,1,4,0,3548,A
2-PB1,748,0,0,3567,0,3567,G
2-PB1,749,2,10,3493,0,3505,G
2-PB1,750,0,1,3587,0,3588,G
2-PB1,751,1,3560,0,1,3562,T
2-PB1,752,0,3581,2,4,3587,T
2-PB1,753,8,2,0,3613,3623,C
2-PB1,754,1,1,3666,0,3668,G
2-PB1,755,1,3643,0,7,3651,T
2-PB1,756,1,0,3677,0,3678,G
2-PB1,757,0,3646,0,0,3646,T
2-PB1,758,3623,0,1,0,3624,A
2-PB1,759,1,0,0,3616,3617,C
2-PB1,760,0,3407,0,6,3413,T
2-PB1,761,0,3413,0,3,3416,T
2-PB1,762,4,1,0,3416,3421,C
2-PB1,763,7,0,3401,0,3408,G
2-PB1,764,0,3400,0,2,3402,T
2-PB1,765,0,3385,0,6,3391,T
2-PB1,766,3,7,3383,0,3393,G
2-PB1,767,3379,0,3,0,3382,A
2-PB1,768,3380,0,3,0,3383,A
2-PB1,769,3406,0,4,0,3410,A
2-PB1,770,0,1,0,3426,3427,C
2-PB1,771,0,3393,0,6,3399,T
2-PB1,772,0,3384,0,0,3384,T
2-PB1,773,0,3389,0,1,3390,T
2-PB1,774,3456,2,2,0,3460,A
2-PB1,775,1,1,3460,0,3462,G
2-PB1,776,1,0,0,3458,3459,C
2-PB1,777,1,3462,0,3,3466,T
2-PB1,778,3424,0,3,0,3427,A
2-PB1,779,1,1,3433,0,3435,G
2-PB1,780,3421,0,2,0,3423,A
2-PB1,781,3418,0,8,1,3427,A
2-PB1,782,0,0,3434,0,3434,G
2-PB1,783,0,0,0,3359,3359,C
2-PB1,784,3358,0,0,0,3358,A
2-PB1,785,0,3335,1,0,3336,T
2-PB1,786,0,3339,0,5,3344,T
2-PB1,787,0,3331,0,2,3333,T
2-PB1,788,0,0,3340,0,3340,G
2-PB1,789,1,2,0,3334,3337,C
2-PB1,790,1,7,3332,0,3340,G
2-PB1,791,3321,0,2,0,3323,A
2-PB1,792,3311,0,2,0,3313,A
2-PB1,793,3324,0,2,0,3326,A
2-PB1,794,3425,0,7,0,3432,A
2-PB1,795,0,0,3475,0,3475,G
2-PB1,796,2,0,0,3477,3479,C
2-PB1,797,0,3469,0,4,3473,T
2-PB1,798,0,3478,0,1,3479,T
2-PB1,799,0,8,3475,0,3483,G
2-PB1,800,3480,0,1,0,3481,A
2-PB1,801,3469,0,4,0,3473,A
2-PB1,802,1,0,1,3502,3504,C
2-PB1,803,3376,0,2,0,3378,A
2-PB1,804,1,1,3679,0,3681,G
2-PB1,805,1,3637,1,1,3640,T
2-PB1,806,4,1,0,3637,3642,C
2-PB1,807,0,3648,0,4,3652,T
2-PB1,808,0,1,3654,0,3655,G
2-PB1,809,2,5,3648,0,3655,G
2-PB1,810,3644,0,2,1,3647,A
2-PB1,811,0,0,0,3671,3671,C
2-PB1,812,0,3541,1,5,3547,T
2-PB1,813,0,3334,0,4,3338,T
2-PB1,814,4,0,0,3316,3320,C
2-PB1,815,3,1,1,3320,3325,C
2-PB1,816,3286,0,3,0,3289,A
2-PB1,817,6,0,3356,0,3362,G
2-PB1,818,0,3341,0,3,3344,T
2-PB1,819,0,3370,0,1,3371,T
2-PB1,820,1,3,3336,0,3340,G
2-PB1,821,0,7,3333,0,3340,G
2-PB1,822,4,6,3344,0,3354,G
2-PB1,823,2,0,3353,0,3355,G
2-PB1,824,1,1,3378,0,3380,G
2-PB1,825,0,3322,0,2,3324,T
2-PB1,826,3322,0,1,0,3323,A
2-PB1,827,3343,0,2,1,3346,A
2-PB1,828,0,3367,0,1,3368,T
2-PB1,829,0,7,3358,0,3365,G
2-PB1,830,3336,0,1,0,3337,A
2-PB1,831,3327,0,5,1,3333,A
2-PB1,832,3336,0,3,0,3339,A
2-PB1,833,3306,0,7,0,3313,A
2-PB1,834,0,3,3307,0,3310,G
2-PB1,835,3264,0,5,0,3269,A
2-PB1,836,3233,0,2,0,3235,A
2-PB1,837,0,0,3248,0,3248,G
2-PB1,838,2,1,3221,0,3224,G
2-PB1,839,3,0,0,3216,3219,C
2-PB1,840,4,0,0,3225,3229,C
2-PB1,841,3236,0,0,0,3236,A
2-PB1,842,3247,0,0,0,3247,A
2-PB1,843,3232,1,1,0,3234,A
2-PB1,844,1,1,0,3246,3248,C
2-PB1,845,0,3226,0,4,3230,T
2-PB1,846,2,5,3298,0,3305,G
2-PB1,847,2,1,3289,0,3292,G
2-PB1,848,1,0,0,3304,3305,C
2-PB1,849,3317,0,1,0,3318,A
2-PB1,850,3304,0,0,0,3304,A
2-PB1,851,3297,0,2,0,3299,A
2-PB1,852,0,3304,1,0,3305,T
2-PB1,853,0,0,3319,0,3319,G
2-PB1,854,1,3295,1,6,3303,T
2-PB1,855,0,3219,1,1,3221,T
2-PB1,856,1,2,3223,0,3226,G
2-PB1,857,1,3202,2,2,3207,T
2-PB1,858,1,7,3210,0,3218,G
2-PB1,859,3222,1,4,0,3227,A
2-PB1,860,0,6,3211,0,3217,G
2-PB1,861,3217,0,2,1,3220,A
2-PB1,862,3197,0,0,0,3197,A
2-PB1,863,3194,0,4,0,3198,A
2-PB1,864,3203,0,7,0,3210,A
2-PB1,865,3219,0,3,0,3222,A
2-PB1,866,0,3200,1,0,3201,T
2-PB1,867,1,2,3201,0,3204,G
2-PB1,868,3193,0,4,0,3197,A
2-PB1,869,0,3156,1,2,3159,T
2-PB1,870,2,6,3189,0,3197,G
2-PB1,871,3188,0,6,0,3194,A
2-PB1,872,0,14,0,3201,3215,C
2-PB1,873,0,3220,0,3,3223,T
2-PB1,874,3231,0,1,0,3232,A
2-PB1,875,3258,1,1,0,3260,A
2-PB1,876,0,3258,1,0,3259,T
2-PB1,877,1,3285,1,3,3290,T
2-PB1,878,7,0,0,3319,3326,C
2-PB1,879,3312,1,4,0,3317,A
2-PB1,880,1,0,0,3331,3332,C
2-PB1,881,3296,0,2,0,3298,A
2-PB1,882,3291,0,13,0,3304,A
2-PB1,883,2,5,3306,0,3313,G
2-PB1,884,3365,1,2,0,3368,A
2-PB1,885,1,1,0,3356,3358,C
2-PB1,886,3316,1,8,0,3325,A
2-PB1,887,0,1,0,3318,3319,C
2-PB1,888,3271,0,3,0,3274,A
2-PB1,889,0,2,3283,1,3286,G
2-PB1,890,3256,1,6,0,3263,A
2-PB1,891,1,0,3256,0,3257,G
2-PB1,892,4,1,0,3230,3235,C
2-PB1,893,0,3152,0,5,3157,T
2-PB1,894,0,3216,0,0,3216,T
2-PB1,895,0,3205,0,3,3208,T
2-PB1,896,2,0,0,3229,3231,C
2-PB1,897,1,3227,0,4,3232,T
2-PB1,898,0,3226,0,1,3227,T
2-PB1,899,0,3226,0,4,3230,T
2-PB1,900,1,1,0,3233,3235,C
2-PB1,901,3217,2,1,0,3220,A
2-PB1,902,0,1,0,3248,3249,C
2-PB1,903,3205,1,1,0,3207,A
2-PB1,904,3209,0,4,1,3214,A
2-PB1,905,0,3251,0,2,3253,T
2-PB1,906,7,0,0,3295,3302,C
2-PB1,907,3305,0,4,0,3309,A
2-PB1,908,1,0,0,3358,3359,C
2-PB1,909,0,3318,1,2,3321,T
2-PB1,910,2,3,3346,0,3351,G
2-PB1,911,1,7,3316,1,3325,G
2-PB1,912,0,4,3437,0,3441,G
2-PB1,913,0,5,3435,0,3440,G
2-PB1,914,3362,0,4,0,3366,A
2-PB1,915,2,2,0,3190,3194,C
2-PB1,916,3257,1,2,0,3260,A
2-PB1,917,3463,0,6,2,3471,A
2-PB1,918,0,0,0,3502,3502,C
2-PB1,919,3486,0,0,0,3486,A
2-PB1,920,0,0,0,3512,3512,C
2-PB1,921,0,3362,0,0,3362,T
2-PB1,922,3376,0,2,0,3378,A
2-PB1,923,3363,0,3,1,3367,A
2-PB1,924,0,1,3383,0,3384,G
2-PB1,925,0,3343,0,2,3345,T
2-PB1,926,3,7,3123,0,3133,G
2-PB1,927,0,2,3090,0,3092,G
2-PB1,928,3067,0,2,0,3069,A
2-PB1,929,3079,0,3,0,3082,A
2-PB1,930,1,3086,0,0,3087,T
2-PB1,931,1,5,3077,0,3083,G
2-PB1,932,3077,0,1,0,3078,A
2-PB1,933,3037,0,0,1,3038,A
2-PB1,934,3066,0,2,0,3068,A
2-PB1,935,3067,0,2,0,3069,A
2-PB1,936,0,3041,0,1,3042,T
2-PB1,937,10,1,0,3063,3074,C
2-PB1,938,3065,0,3,0,3068,A
2-PB1,939,3062,0,5,0,3067,A
2-PB1,940,3051,0,3,0,3054,A
2-PB1,941,3025,0,5,0,3030,A
2-PB1,942,0,0,0,3075,3075,C
2-PB1,943,4,1,0,3040,3045,C
2-PB1,944,3,1,0,3038,3042,C
2-PB1,945,0,3001,0,8,3009,T
2-PB1,946,2,0,1,3039,3042,C
2-PB1,947,3,4,3032,0,3039,G
2-PB1,948,3026,1,1,0,3028,A
2-PB1,949,3028,0,1,0,3029,A
2-PB1,950,0,3034,0,0,3034,T
2-PB1,951,1,1,3041,0,3043,G
2-PB1,952,1,3005,2,5,3013,T
2-PB1,953,0,2995,0,1,2996,T
2-PB1,954,0,3017,0,0,3017,T
2-PB1,955,0,3003,0,2,3005,T
2-PB1,956,0,3013,0,0,3013,T
2-PB1,957,0,2,2996,0,2998,G
2-PB1,958,0,0,2992,0,2992,G
2-PB1,959,0,2,0,2980,2982,C
2-PB1,960,1,2,2891,0,2894,G
2-PB1,961,2883,0,0,0,2883,A
2-PB1,962,0,2977,0,0,2977,T
2-PB1,963,1,6,3080,0,3087,G
2-PB1,964,3236,0,4,0,3240,A
2-PB1,965,0,3257,0,2,3259,T
2-PB1,966,0,3254,0,1,3255,T
2-PB1,967,3273,0,4,0,3277,A
2-PB1,968,1,2,0,3283,3286,C
2-PB1,969,3311,0,1,1,3313,A
2-PB1,970,1,3293,1,0,3295,T
2-PB1,971,3109,1,3,0,3113,A
2-PB1,972,2,1,0,3151,3154,C
2-PB1,973,2834,0,2,0,2836,A
2-PB1,974,0,2825,0,4,2829,T
2-PB1,975,3,1,0,2808,2812,C
2-PB1,976,2800,0,2,0,2802,A
2-PB1,977,0,1,0,2809,2810,C
2-PB1,978,2781,0,0,1,2782,A
2-PB1,979,2787,0,0,0,2787,A
2-PB1,980,2785,0,0,0,2785,A
2-PB1,981,6,3,2660,0,2669,G
2-PB1,982,2773,0,2,0,2775,A
2-PB1,983,2766,0,4,0,2770,A
2-PB1,984,0,2758,0,0,2758,T
2-PB1,985,8,1,0,2757,2766,C
2-PB1,986,2788,0,4,1,2793,A
2-PB1,987,2796,0,4,0,2800,A
2-PB1,988,0,0,0,2819,2819,C
2-PB1,989,5,0,0,2822,2827,C
2-PB1,990,0,2705,0,2,2707,T
2-PB1,991,0,1,2730,0,2731,G
2-PB1,992,2708,1,1,0,2710,A
2-PB1,993,1,1,2716,0,2718,G
2-PB1,994,0,2700,0,3,2703,T
2-PB1,995,0,3,2659,0,2662,G
2-PB1,996,2,0,2820,0,2822,G
2-PB1,997,0,2810,0,2,2812,T
2-PB1,998,0,2803,0,6,2809,T
2-PB1,999,6,0,1,2813,2820,C
2-PB1,1000,2797,0,0,0,2797,A
2-PB1,1001,2,3,2835,0,2840,G
2-PB1,1002,2848,0,1,0,2849,A
2-PB1,1003,2852,0,5,0,2857,A
2-PB1,1004,2820,0,2,0,2822,A
2-PB1,1005,1,2,0,2550,2553,C
2-PB1,1006,2584,0,0,1,2585,A
2-PB1,1007,0,2565,0,3,2568,T
2-PB1,1008,3,1,0,2616,2620,C
2-PB1,1009,0,1,0,2622,2623,C
2-PB1,1010,1,2537,0,0,2538,T
2-PB1,1011,0,4,2534,0,2538,G
2-PB1,1012,2515,1,2,1,2519,A
2-PB1,1013,0,0,2548,0,2548,G
2-PB1,1014,1,0,0,2528,2529,C
2-PB1,1015,2440,0,1,0,2441,A
2-PB1,1016,0,2429,0,2,2431,T
2-PB1,1017,3,2,0,2407,2412,C
2-PB1,1018,1,1,2406,0,2408,G
2-PB1,1019,1,0,0,2505,2506,C
2-PB1,1020,2513,0,4,0,2517,A
2-PB1,1021,0,0,0,2588,2588,C
2-PB1,1022,2,1,0,2586,2589,C
2-PB1,1023,2595,0,3,0,2598,A
2-PB1,1024,2615,0,2,0,2617,A
2-PB1,1025,0,2625,0,1,2626,T
2-PB1,1026,2628,0,0,0,2628,A
2-PB1,1027,2616,0,2,0,2618,A
2-PB1,1028,0,2536,0,0,2536,T
2-PB1,1029,0,2,2546,0,2548,G
2-PB1,1030,0,2478,1,2,2481,T
2-PB1,1031,0,2453,1,9,2463,T
2-PB1,1032,7,0,0,2474,2481,C
2-PB1,1033,0,2458,0,4,2462,T
2-PB1,1034,2,0,0,2475,2477,C
2-PB1,1035,2475,0,0,0,2475,A
2-PB1,1036,2471,0,3,0,2474,A
2-PB1,1037,2474,0,1,0,2475,A
2-PB1,1038,1,0,0,2488,2489,C
2-PB1,1039,2490,1,0,0,2491,A
2-PB1,1040,2481,0,1,0,2482,A
2-PB1,1041,2461,1,1,0,2463,A
2-PB1,1042,2487,0,6,0,2493,A
2-PB1,1043,1,2515,0,3,2519,T
2-PB1,1044,0,4,2528,0,2532,G
2-PB1,1045,0,2,2518,0,2520,G
2-PB1,1046,0,2,0,2515,2517,C
2-PB1,1047,2514,0,8,0,2522,A
2-PB1,1048,2526,0,3,1,2530,A
2-PB1,1049,0,3,2534,0,2537,G
2-PB1,1050,2540,0,6,0,2546,A
2-PB1,1051,1,1,0,2554,2556,C
2-PB1,1052,0,2514,0,0,2514,T
2-PB1,1053,1,3,2554,0,2558,G
2-PB1,1054,0,2,2545,0,2547,G
2-PB1,1055,0,2,2561,2,2565,G
2-PB1,1056,2567,2,3,0,2572,A
2-PB1,1057,2565,0,3,0,2568,A
2-PB1,1058,2534,0,3,0,2537,A
2-PB1,1059,2518,0,2,1,2521,A
2-PB1,1060,0,2,2613,0,2615,G
2-PB1,1061,1,1,2610,0,2612,G
2-PB1,1062,2596,1,2,0,2599,A
2-PB1,1063,0,2582,0,2,2584,T
2-PB1,1064,2575,0,2,0,2577,A
2-PB1,1065,1,0,0,2581,2582,C
2-PB1,1066,2617,0,3,1,2621,A
2-PB1,1067,0,2612,0,0,2612,T
2-PB1,1068,2,1,2621,0,2624,G
2-PB1,1069,0,2578,0,6,2584,T
2-PB1,1070,0,2576,0,1,2577,T
2-PB1,1071,6,3,0,2566,2575,C
2-PB1,1072,4,4,2575,0,2583,G
2-PB1,1073,2556,0,2,0,2558,A
2-PB1,1074,0,5,2638,0,2643,G
2-PB1,1075,2596,0,2,0,2598,A
2-PB1,1076,0,0,2640,0,2640,G
2-PB1,1077,0,2603,0,1,2604,T
2-PB1,1078,2611,0,0,0,2611,A
2-PB1,1079,2626,0,3,0,2629,A
2-PB1,1080,2,5,2635,0,2642,G
2-PB1,1081,2630,0,0,0,2630,A
2-PB1,1082,2,4,2650,0,2656,G
2-PB1,1083,2595,0,4,0,2599,A
2-PB1,1084,2616,0,1,0,2617,A
2-PB1,1085,1,2587,0,1,2589,T
2-PB1,1086,1,6,2585,0,2592,G
2-PB1,1087,2583,0,2,0,2585,A
2-PB1,1088,2571,0,1,0,2572,A
2-PB1,1089,1,1,2561,0,2563,G
2-PB1,1090,2,1,0,2553,2556,C
2-PB1,1091,0,2504,0,1,2505,T
2-PB1,1092,3,0,0,2535,2538,C
2-PB1,1093,2,0,0,2522,2524,C
2-PB1,1094,1,2,2538,0,2541,G
2-PB1,1095,5,6,2520,0,2531,G
2-PB1,1096,2546,0,4,0,2550,A
2-PB1,1097,1,1,0,2593,2595,C
2-PB1,1098,2586,1,3,0,2590,A
2-PB1,1099,0,0,1,2619,2620,C
2-PB1,1100,2624,0,1,0,2625,A
2-PB1,1101,2620,1,2,0,2623,A
2-PB1,1102,2615,0,1,0,2616,A
2-PB1,1103,0,2613,0,1,2614,T
2-PB1,1104,2609,0,0,0,2609,A
2-PB1,1105,0,1,0,2599,2600,C
2-PB1,1106,0,1,1,2574,2576,C
2-PB1,1107,0,2538,0,5,2543,T
2-PB1,1108,1,1,2574,0,2576,G
2-PB1,1109,0,2,0,2565,2567,C
2-PB1,1110,2572,0,0,0,2572,A
2-PB1,1111,0,2,2575,1,2578,G
2-PB1,1112,2554,0,2,0,2556,A
2-PB1,1113,2549,0,1,0,2550,A
2-PB1,1114,2567,0,0,0,2567,A
2-PB1,1115,0,2563,0,0,2563,T
2-PB1,1116,2,1,2569,1,2573,G
2-PB1,1117,1,0,0,2555,2556,C
2-PB1,1118,0,2565,0,5,2570,T
2-PB1,1119,2610,0,3,0,2613,A
2-PB1,1120,0,0,2600,0,2600,G
2-PB1,1121,0,0,0,2582,2582,C
2-PB1,1122,2600,0,1,0,2601,A
2-PB1,1123,2598,0,3,1,2602,A
2-PB1,1124,1,1,2583,0,2585,G
2-PB1,1125,0,1,0,2577,2578,C
2-PB1,1126,2551,0,1,0,2552,A
2-PB1,1127,0,2603,1,2,2606,T
2-PB1,1128,0,2618,0,2,2620,T
2-PB1,1129,0,4,2672,0,2676,G
2-PB1,1130,2694,1,1,0,2696,A
2-PB1,1131,0,1,0,2688,2689,C
2-PB1,1132,2,2,0,2706,2710,C
2-PB1,1133,1,2649,1,5,2656,T
2-PB1,1134,0,2,2690,0,2692,G
2-PB1,1135,2704,1,0,0,2705,A
2-PB1,1136,2703,0,3,0,2706,A
2-PB1,1137,1,0,2738,0,2739,G
2-PB1,1138,1,2627,0,1,2629,T
2-PB1,1139,2640,0,1,0,2641,A
2-PB1,1140,0,2615,0,2,2617,T
2-PB1,1141,1,2615,0,2,2618,T
2-PB1,1142,0,2612,0,4,2616,T
2-PB1,1143,3,1,0,2589,2593,C
2-PB1,1144,2595,0,0,0,2595,A
2-PB1,1145,2595,0,0,0,2595,A
2-PB1,1146,0,2552,0,0,2552,T
2-PB1,1147,2,11,2551,0,2564,G
2-PB1,1148,2542,0,1,0,2543,A
2-PB1,1149,2536,0,0,0,2536,A
2-PB1,1150,1,2514,1,4,2520,T
2-PB1,1151,1,4,0,2547,2552,C
2-PB1,1152,2542,0,2,0,2544,A
2-PB1,1153,2535,1,2,0,2538,A
2-PB1,1154,1,2,0,2541,2544,C
2-PB1,1155,2535,0,1,0,2536,A
2-PB1,1156,2524,0,1,0,2525,A
2-PB1,1157,0,4,2533,0,2537,G
2-PB1,1158,0,0,2558,0,2558,G
2-PB1,1159,2547,0,2,0,2549,A
2-PB1,1160,2541,0,2,2,2545,A
2-PB1,1161,0,5,2546,0,2551,G
2-PB1,1162,2550,0,2,0,2552,A
2-PB1,1163,2551,0,2,0,2553,A
2-PB1,1164,2559,0,1,0,2560,A
2-PB1,1165,2557,0,0,0,2557,A
2-PB1,1166,0,2540,0,0,2540,T
2-PB1,1167,0,2522,0,0,2522,T
2-PB1,1168,2,10,2522,0,2534,G
2-PB1,1169,2519,1,3,0,2523,A
2-PB1,1170,0,2,2527,0,2529,G
2-PB1,1171,2526,0,0,0,2526,A
2-PB1,1172,2550,1,0,0,2551,A
2-PB1,1173,2580,1,0,0,2581,A
2-PB1,1174,2577,1,0,0,2578,A
2-PB1,1175,0,2574,0,1,2575,T
2-PB1,1176,2586,0,0,0,2586,A
2-PB1,1177,2580,0,6,0,2586,A
2-PB1,1178,0,2,2588,0,2590,G
2-PB1,1179,3,2,2574,0,2579,G
2-PB1,1180,0,0,0,2563,2563,C
2-PB1,1181,3,1,0,2548,2552,C
2-PB1,1182,0,2539,0,1,2540,T
2-PB1,1183,4,1,1,2890,2896,C
2-PB1,1184,0,2934,0,4,2938,T
2-PB1,1185,0,2945,0,4,2949,T
2-PB1,1186,1,0,1,3012,3014,C
2-PB1,1187,0,3005,0,0,3005,T
2-PB1,1188,3011,0,3,0,3014,A
2-PB1,1189,3015,0,7,1,3023,A
2-PB1,1190,0,3011,0,3,3014,T
2-PB1,1191,3055,0,2,0,3057,A
2-PB1,1192,1,0,2981,0,2982,G
2-PB1,1193,2697,0,4,0,2701,A
2-PB1,1194,0,2690,0,1,2691,T
2-PB1,1195,0,4,2632,0,2636,G
2-PB1,1196,0,1,2676,0,2677,G
2-PB1,1197,1,0,0,2685,2686,C
2-PB1,1198,2692,0,1,0,2693,A
2-PB1,1199,1,0,0,2695,2696,C
2-PB1,1200,2650,0,2,0,2652,A
2-PB1,1201,1,0,2758,0,2759,G
2-PB1,1202,0,1,1,2751,2753,C
2-PB1,1203,2770,0,1,0,2771,A
2-PB1,1204,0,2809,0,1,2810,T
2-PB1,1205,7,3,0,2783,2793,C
2-PB1,1206,2822,0,1,0,2823,A
2-PB1,1207,0,2820,0,1,2821,T
2-PB1,1208,0,2808,0,2,2810,T
2-PB1,1209,0,6,2797,0,2803,G
2-PB1,1210,2691,0,5,0,2696,A
2-PB1,1211,2,0,2763,0,2765,G
2-PB1,1212,1,1,0,2760,2762,C
2-PB1,1213,5,0,0,2703,2708,C
2-PB1,1214,3,0,0,2782,2785,C
2-PB1,1215,0,2759,0,5,2764,T
2-PB1,1216,1,2,3094,1,3098,G
2-PB1,1217,0,3,3169,0,3172,G
2-PB1,1218,3158,0,7,0,3165,A
2-PB1,1219,3317,0,1,0,3318,A
2-PB1,1220,0,3228,0,0,3228,T
2-PB1,1221,0,4,3355,0,3359,G
2-PB1,1222,3440,1,1,0,3442,A
2-PB1,1223,0,3468,0,5,3473,T
2-PB1,1224,1,3,3496,0,3500,G
2-PB1,1225,3453,0,5,1,3459,A
2-PB1,1226,0,3440,0,3,3443,T
2-PB1,1227,0,3,3432,1,3436,G
2-PB1,1228,1,7,3477,0,3485,G
2-PB1,1229,5,0,3477,0,3482,G
2-PB1,1230,1,0,0,3463,3464,C
2-PB1,1231,3482,0,4,0,3486,A
2-PB1,1232,0,3523,0,1,3524,T
2-PB1,1233,2,0,3656,0,3658,G
2-PB1,1234,0,3663,0,2,3665,T
2-PB1,1235,0,3675,0,2,3677,T
2-PB1,1236,10,1,0,3695,3706,C
2-PB1,1237,3689,0,3,0,3692,A
2-PB1,1238,3701,0,6,0,3707,A
2-PB1,1239,1,0,1,3712,3714,C
2-PB1,1240,3720,10,2,0,3732,A
2-PB1,1241,1,3749,0,1,3751,T
2-PB1,1242,0,4,3784,0,3788,G
2-PB1,1243,1,3,0,3777,3781,C
2-PB1,1244,0,3802,0,2,3804,T
2-PB1,1245,3841,1,3,1,3846,A
2-PB1,1246,3824,0,5,0,3829,A
2-PB1,1247,2,0,3933,0,3935,G
2-PB1,1248,0,3903,0,1,3904,T
2-PB1,1249,3900,0,2,0,3902,A
2-PB1,1250,3,2,0,3928,3933,C
2-PB1,1251,4,7,3934,0,3945,G
2-PB1,1252,2,1,4208,0,4211,G
2-PB1,1253,0,4187,1,2,4190,T
2-PB1,1254,0,4198,0,0,4198,T
2-PB1,1255,0,4193,0,3,4196,T
2-PB1,1256,0,4186,0,3,4189,T
2-PB1,1257,4188,1,7,0,4196,A
2-PB1,1258,2,3,4180,0,4185,G
2-PB1,1259,0,7,4163,0,4170,G
2-PB1,1260,4106,1,5,0,4112,A
2-PB1,1261,2,2,4077,0,4081,G
2-PB1,1262,0,4129,0,1,4130,T
2-PB1,1263,3,2,0,4163,4168,C
2-PB1,1264,0,4159,0,2,4161,T
2-PB1,1265,11,1,0,4174,4186,C
2-PB1,1266,5,8,4171,1,4185,G
2-PB1,1267,4321,0,1,0,4322,A
2-PB1,1268,0,4346,0,3,4349,T
2-PB1,1269,4342,0,3,0,4345,A
2-PB1,1270,0,0,0,4374,4374,C
2-PB1,1271,0,4300,2,4,4306,T
2-PB1,1272,1,8,4302,1,4312,G
2-PB1,1273,4299,0,0,0,4299,A
2-PB1,1274,4357,0,5,0,4362,A
2-PB1,1275,0,4369,0,2,4371,T
2-PB1,1276,5,1,0,4266,4272,C
2-PB1,1277,0,4270,0,4,4274,T
2-PB1,1278,0,4249,0,4,4253,T
2-PB1,1279,1,2,4267,0,4270,G
2-PB1,1280,0,6,4236,0,4242,G
2-PB1,1281,4232,0,5,0,4237,A
2-PB1,1282,0,1,0,4253,4254,C
2-PB1,1283,4194,0,1,0,4195,A
2-PB1,1284,4230,0,2,1,4233,A
2-PB1,1285,4249,0,1,0,4250,A
2-PB1,1286,4254,0,6,0,4260,A
2-PB1,1287,2,7,4356,0,4365,G
2-PB1,1288,4380,0,4,0,4384,A
2-PB1,1289,4371,0,6,0,4377,A
2-PB1,1290,4372,1,10,0,4383,A
2-PB1,1291,1,4374,0,1,4376,T
2-PB1,1292,4387,0,1,0,4388,A
2-PB1,1293,0,4,0,4546,4550,C
2-PB1,1294,4479,0,8,0,4487,A
2-PB1,1295,2,1,0,4503,4506,C
2-PB1,1296,5,1,1,4471,4478,C
2-PB1,1297,4469,0,1,0,4470,A
2-PB1,1298,4530,0,6,0,4536,A
2-PB1,1299,1,6,4700,0,4707,G
2-PB1,1300,4735,0,5,0,4740,A
2-PB1,1301,0,2,0,4806,4808,C
2-PB1,1302,4708,0,3,1,4712,A
2-PB1,1303,4848,0,8,0,4856,A
2-PB1,1304,0,1,0,4875,4876,C
2-PB1,1305,4956,0,3,0,4959,A
2-PB1,1306,0,4988,0,0,4988,T
2-PB1,1307,4928,0,1,0,4929,A
2-PB1,1308,0,3,0,5055,5058,C
2-PB1,1309,0,4862,0,1,4863,T
2-PB1,1310,1,7,4931,0,4939,G
2-PB1,1311,2,0,4928,0,4930,G
2-PB1,1312,0,4785,0,4,4789,T
2-PB1,1313,1,4,4812,0,4817,G
2-PB1,1314,0,2,4747,0,4749,G
2-PB1,1315,3,11,4745,0,4759,G
2-PB1,1316,4759,0,1,0,4760,A
2-PB1,1317,0,4683,0,2,4685,T
2-PB1,1318,1,7,4682,0,4690,G
2-PB1,1319,0,1,4634,0,4635,G
2-PB1,1320,1,1,4681,0,4683,G
2-PB1,1321,1,4,0,4731,4736,C
2-PB1,1322,2,4683,0,11,4696,T
2-PB1,1323,8,1,0,4738,4747,C
2-PB1,1324,9,3,0,4727,4739,C
2-PB1,1325,4740,0,1,0,4741,A
2-PB1,1326,4744,0,2,0,4746,A
2-PB1,1327,0,4714,0,2,4716,T
2-PB1,1328,4,0,0,4690,4694,C
2-PB1,1329,5,1,0,4653,4659,C
2-PB1,1330,0,4599,0,4,4603,T
2-PB1,1331,1,1,0,4612,4614,C
2-PB1,1332,3,5,0,4587,4595,C
2-PB1,1333,2,4,4601,0,4607,G
2-PB1,1334,4587,0,1,0,4588,A
2-PB1,1335,2,8,0,4594,4604,C
2-PB1,1336,2,11,4613,0,4626,G
2-PB1,1337,4631,0,1,0,4632,A
2-PB1,1338,0,4632,0,2,4634,T
2-PB1,1339,0,4631,0,2,4633,T
2-PB1,1340,0,4636,0,0,4636,T
2-PB1,1341,0,4622,0,8,4630,T
2-PB1,1342,2,2,4654,0,4658,G
2-PB1,1343,1,2,1,4657,4661,C
2-PB1,1344,14,0,0,4640,4654,C
2-PB1,1345,3,4,0,4834,4841,C
2-PB1,1346,0,4749,2,14,4765,T
2-PB1,1347,4,0,0,4981,4985,C
2-PB1,1348,5027,1,0,0,5028,A
2-PB1,1349,0,5058,0,4,5062,T
2-PB1,1350,5072,0,1,0,5073,A
2-PB1,1351,4,1,5121,0,5126,G
2-PB1,1352,0,5036,0,1,5037,T
2-PB1,1353,5,12,5067,0,5084,G
2-PB1,1354,4891,0,2,0,4893,A
2-PB1,1355,4900,0,2,0,4902,A
2-PB1,1356,0,4617,0,1,4618,T
2-PB1,1357,2,3,4608,0,4613,G
2-PB1,1358,3,0,1,4663,4667,C
2-PB1,1359,4623,0,5,1,4629,A
2-PB1,1360,0,2,0,4664,4666,C
2-PB1,1361,4,0,1,4614,4619,C
2-PB1,1362,4599,0,0,0,4599,A
2-PB1,1363,4596,0,0,1,4597,A
2-PB1,1364,4571,0,6,0,4577,A
2-PB1,1365,1,4454,0,1,4456,T
2-PB1,1366,15,2,0,4632,4649,C
2-PB1,1367,4651,1,1,0,4653,A
2-PB1,1368,0,4653,0,3,4656,T
2-PB1,1369,2,8,4655,0,4665,G
2-PB1,1370,4658,0,15,1,4674,A
2-PB1,1371,0,9,4716,0,4725,G
2-PB1,1372,1,4,4696,0,4701,G
2-PB1,1373,0,9,4723,0,4732,G
2-PB1,1374,4686,1,9,0,4696,A
2-PB1,1375,4780,0,10,0,4790,A
2-PB1,1376,0,4804,0,3,4807,T
2-PB1,1377,4818,0,3,0,4821,A
2-PB1,1378,0,0,0,4833,4833,C
2-PB1,1379,4840,0,4,0,4844,A
2-PB1,1380,4809,3,16,1,4829,A
2-PB1,1381,0,2,4803,0,4805,G
2-PB1,1382,1,1,0,4776,4778,C
2-PB1,1383,4734,0,2,0,4736,A
2-PB1,1384,1,4,4788,0,4793,G
2-PB1,1385,0,3,4783,0,4786,G
2-PB1,1386,4733,0,8,0,4741,A
2-PB1,1387,2,0,4805,0,4807,G
2-PB1,1388,0,4705,0,2,4707,T
2-PB1,1389,1,6,4791,0,4798,G
2-PB1,1390,3,4,4806,0,4813,G
2-PB1,1391,4794,0,8,0,4802,A
2-PB1,1392,0,4801,1,2,4804,T
2-PB1,1393,4738,0,7,0,4745,A
2-PB1,1394,3,9,4795,0,4807,G
2-PB1,1395,4864,0,1,0,4865,A
2-PB1,1396,0,4861,0,3,4864,T
2-PB1,1397,0,4827,1,3,4831,T
2-PB1,1398,8,4,0,4994,5006,C
2-PB1,1399,1,4982,1,0,4984,T
2-PB1,1400,4993,0,3,0,4996,A
2-PB1,1401,0,0,0,5001,5001,C
2-PB1,1402,4896,1,6,0,4903,A
2-PB1,1403,1,5,4900,1,4907,G
2-PB1,1404,3,8,4806,0,4817,G
2-PB1,1405,4866,0,6,0,4872,A
2-PB1,1406,0,2,0,4884,4886,C
2-PB1,1407,2,0,0,4798,4800,C
2-PB1,1408,2,4739,0,9,4750,T
2-PB1,1409,2,1,4769,0,4772,G
2-PB1,1410,0,1,0,4779,4780,C
2-PB1,1411,4790,0,2,0,4792,A
2-PB1,1412,4818,0,6,0,4824,A
2-PB1,1413,1,1,4861,0,4863,G
2-PB1,1414,0,4757,0,5,4762,T
2-PB1,1415,0,4796,0,3,4799,T
2-PB1,1416,4707,0,3,0,4710,A
2-PB1,1417,3,0,4713,1,4717,G
2-PB1,1418,1,4657,1,9,4668,T
2-PB1,1419,5,11,4652,1,4669,G
2-PB1,1420,2,3,4665,0,4670,G
2-PB1,1421,0,6,4706,0,4712,G
2-PB1,1422,4676,1,2,0,4679,A
2-PB1,1423,4708,0,1,0,4709,A
2-PB1,1424,0,4691,0,5,4696,T
2-PB1,1425,10,0,1,4694,4705,C
2-PB1,1426,4707,0,2,0,4709,A
2-PB1,1427,4712,0,6,0,4718,A
2-PB1,1428,4,3,0,4703,4710,C
2-PB1,1429,4708,0,2,0,4710,A
2-PB1,1430,0,4573,1,0,4574,T
2-PB1,1431,1,12,4572,0,4585,G
2-PB1,1432,4583,2,5,0,4590,A
2-PB1,1433,2,1,4618,0,4621,G
2-PB1,1434,1,1,0,4593,4595,C
2-PB1,1435,4599,2,2,0,4603,A
2-PB1,1436,4601,0,3,0,4604,A
2-PB1,1437,4593,0,6,0,4599,A
2-PB1,1438,4646,0,6,0,4652,A
2-PB1,1439,4655,0,4,0,4659,A
2-PB1,1440,0,3,4644,0,4647,G
2-PB1,1441,4594,1,2,0,4597,A
2-PB1,1442,4532,0,9,0,4541,A
2-PB1,1443,1,0,4712,0,4713,G
2-PB1,1444,0,4680,0,1,4681,T
2-PB1,1445,9,0,0,4697,4706,C
2-PB1,1446,4,2,2,4721,4729,C
2-PB1,1447,1,4706,0,3,4710,T
2-PB1,1448,4786,1,0,0,4787,A
2-PB1,1449,0,4781,0,1,4782,T
2-PB1,1450,4787,0,1,0,4788,A
2-PB1,1451,1,4774,0,1,4776,T
2-PB1,1452,4704,1,3,0,4708,A
2-PB1,1453,4717,0,1,0,4718,A
2-PB1,1454,4708,0,0,0,4708,A
2-PB1,1455,1,4694,0,1,4696,T
2-PB1,1456,4647,0,1,0,4648,A
2-PB1,1457,4650,0,2,0,4652,A
2-PB1,1458,4657,0,2,0,4659,A
2-PB1,1459,4654,0,5,0,4659,A
2-PB1,1460,0,2,0,4670,4672,C
2-PB1,1461,4484,0,3,0,4487,A
2-PB1,1462,0,3,4486,0,4489,G
2-PB1,1463,1,8,4472,0,4481,G
2-PB1,1464,0,7,4476,0,4483,G
2-PB1,1465,4456,1,6,0,4463,A
2-PB1,1466,1,1,0,4522,4524,C
2-PB1,1467,4493,0,5,1,4499,A
2-PB1,1468,0,4534,0,1,4535,T
2-PB1,1469,0,4542,0,4,4546,T
2-PB1,1470,0,4555,0,3,4558,T
2-PB1,1471,1,10,4550,0,4561,G
2-PB1,1472,4523,0,6,0,4529,A
2-PB1,1473,4549,0,2,1,4552,A
2-PB1,1474,0,4550,0,3,4553,T
2-PB1,1475,0,4461,0,3,4464,T
2-PB1,1476,8,0,0,4484,4492,C
2-PB1,1477,4431,0,3,0,4434,A
2-PB1,1478,1,1,0,4457,4459,C
2-PB1,1479,0,4444,0,6,4450,T
2-PB1,1480,4459,0,1,0,4460,A
2-PB1,1481,0,1,4442,0,4443,G
2-PB1,1482,0,2,0,4429,4431,C
2-PB1,1483,1,4391,0,6,4398,T
2-PB1,1484,1,4462,0,1,4464,T
2-PB1,1485,0,4461,0,2,4463,T
2-PB1,1486,2,4462,0,2,4466,T
2-PB1,1487,0,4467,0,1,4468,T
2-PB1,1488,0,4459,0,1,4460,T
2-PB1,1489,0,4444,0,0,4444,T
2-PB1,1490,4426,1,1,0,4428,A
2-PB1,1491,0,4393,0,0,4393,T
2-PB1,1492,4,2,0,4426,4432,C
2-PB1,1493,1,5,4456,0,4462,G
2-PB1,1494,4625,0,0,0,4625,A
2-PB1,1495,0,4626,0,0,4626,T
2-PB1,1496,4626,0,2,0,4628,A
2-PB1,1497,0,4651,0,6,4657,T
2-PB1,1498,2,9,4650,0,4661,G
2-PB1,1499,0,6,4679,0,4685,G
2-PB1,1500,4682,0,5,0,4687,A
2-PB1,1501,1,4618,0,4,4623,T
2-PB1,1502,0,4599,0,0,4599,T
2-PB1,1503,0,4452,0,0,4452,T
2-PB1,1504,1,0,4463,0,4464,G
2-PB1,1505,0,4413,0,2,4415,T
2-PB1,1506,1,2,4422,0,4425,G
2-PB1,1507,0,2,4403,0,4405,G
2-PB1,1508,1,1,0,4348,4350,C
2-PB1,1509,1,4400,0,4,4405,T
2-PB1,1510,4420,0,2,0,4422,A
2-PB1,1511,4458,0,0,0,4458,A
2-PB1,1512,1,4483,0,2,4486,T
2-PB1,1513,0,4503,1,1,4505,T
2-PB1,1514,0,4497,0,0,4497,T
2-PB1,1515,0,4499,0,2,4501,T
2-PB1,1516,4521,0,1,1,4523,A
2-PB1,1517,1,4,4543,0,4548,G
2-PB1,1518,2,6,0,4549,4557,C
2-PB1,1519,4539,0,3,0,4542,A
2-PB1,1520,0,4485,1,5,4491,T
2-PB1,1521,1,3,4437,0,4441,G
2-PB1,1522,1,5,4520,0,4526,G
2-PB1,1523,4490,0,5,0,4495,A
2-PB1,1524,1,0,4505,0,4506,G
2-PB1,1525,0,1,0,4462,4463,C
2-PB1,1526,0,4406,0,2,4408,T
2-PB1,1527,1,0,4436,0,4437,G
2-PB1,1528,1,1,0,4397,4399,C
2-PB1,1529,6,0,1,4385,4392,C
2-PB1,1530,8,1,1,4436,4446,C
2-PB1,1531,4287,1,2,0,4290,A
2-PB1,1532,0,0,4574,0,4574,G
2-PB1,1533,0,4572,0,1,4573,T
2-PB1,1534,0,4574,0,2,4576,T
2-PB1,1535,0,4576,1,1,4578,T
2-PB1,1536,0,4544,0,2,4546,T
2-PB1,1537,1,4,4523,0,4528,G
2-PB1,1538,0,5,4524,0,4529,G
2-PB1,1539,4501,0,6,0,4507,A
2-PB1,1540,2,2,4518,0,4522,G
2-PB1,1541,0,4164,0,0,4164,T
2-PB1,1542,3,1,4386,0,4390,G
2-PB1,1543,0,4344,0,5,4349,T
2-PB1,1544,13,0,0,4360,4373,C
2-PB1,1545,0,4390,0,5,4395,T
2-PB1,1546,0,3,4417,1,4421,G
2-PB1,1547,0,7,4462,1,4470,G
2-PB1,1548,4477,0,4,0,4481,A
2-PB1,1549,4494,0,6,0,4500,A
2-PB1,1550,0,4471,0,0,4471,T
2-PB1,1551,4167,0,2,0,4169,A
2-PB1,1552,4161,0,2,0,4163,A
2-PB1,1553,4155,0,1,0,4156,A
2-PB1,1554,0,7,0,4161,4168,C
2-PB1,1555,0,9,4116,1,4126,G
2-PB1,1556,4059,0,5,0,4064,A
2-PB1,1557,1,2,4064,0,4067,G
2-PB1,1558,0,4043,0,1,4044,T
2-PB1,1559,7,1,0,4065,4073,C
2-PB1,1560,4068,0,3,1,4072,A
2-PB1,1561,0,1,4131,0,4132,G
2-PB1,1562,1,1,0,4135,4137,C
2-PB1,1563,0,4138,0,5,4143,T
2-PB1,1564,2,6,4274,0,4282,G
2-PB1,1565,4247,1,3,0,4251,A
2-PB1,1566,0,4263,0,1,4264,T
2-PB1,1567,4270,0,8,0,4278,A
2-PB1,1568,0,4199,0,1,4200,T
2-PB1,1569,2,16,4226,0,4244,G
2-PB1,1570,4067,1,9,0,4077,A
2-PB1,1571,0,1,4158,0,4159,G
2-PB1,1572,3,0,0,4185,4188,C
2-PB1,1573,3973,0,1,0,3974,A
2-PB1,1574,0,3980,0,0,3980,T
2-PB1,1575,0,3976,1,2,3979,T
2-PB1,1576,1,4,4032,0,4037,G
2-PB1,1577,0,5,4223,0,4228,G
2-PB1,1578,4145,0,9,0,4154,A
2-PB1,1579,7,2,4174,0,4183,G
2-PB1,1580,0,4048,0,3,4051,T
2-PB1,1581,4050,0,3,0,4053,A
2-PB1,1582,4056,2,4,0,4062,A
2-PB1,1583,0,1,1,4091,4093,C
2-PB1,1584,4069,0,2,0,4071,A
2-PB1,1585,2,0,4114,0,4116,G
2-PB1,1586,0,3656,0,2,3658,T
2-PB1,1587,5,6,3702,0,3713,G
2-PB1,1588,3745,0,6,0,3751,A
2-PB1,1589,0,3760,0,0,3760,T
2-PB1,1590,3739,0,3,0,3742,A
2-PB1,1591,3746,0,0,0,3746,A
2-PB1,1592,3646,0,8,0,3654,A
2-PB1,1593,0,5,3710,0,3715,G
2-PB1,1594,3562,0,4,0,3566,A
2-PB1,1595,3560,1,3,0,3564,A
2-PB1,1596,1,2,0,3583,3586,C
2-PB1,1597,3465,0,3,0,3468,A
2-PB1,1598,3500,0,6,0,3506,A
2-PB1,1599,2,0,0,3531,3533,C
2-PB1,1600,3562,0,2,0,3564,A
2-PB1,1601,0,3558,10,1,3569,T
2-PB1,1602,1,7,3530,0,3538,G
2-PB1,1603,3536,0,5,0,3541,A
2-PB1,1604,0,3541,0,3,3544,T
2-PB1,1605,3510,0,2,0,3512,A
2-PB1,1606,3532,1,4,1,3538,A
2-PB1,1607,3493,0,4,0,3497,A
2-PB1,1608,1,0,0,3533,3534,C
2-PB1,1609,3384,0,1,0,3385,A
2-PB1,1610,3367,0,5,0,3372,A
2-PB1,1611,0,3291,0,2,3293,T
2-PB1,1612,0,7,3296,0,3303,G
2-PB1,1613,3379,0,2,0,3381,A
2-PB1,1614,1,0,0,3425,3426,C
2-PB1,1615,3,0,0,3384,3387,C
2-PB1,1616,1,3282,0,3,3286,T
2-PB1,1617,0,3232,0,5,3237,T
2-PB1,1618,1,5,3243,0,3249,G
2-PB1,1619,1,6,3257,0,3264,G
2-PB1,1620,3284,2,5,0,3291,A
2-PB1,1621,2,0,0,3285,3287,C
2-PB1,1622,5,3,0,3253,3261,C
2-PB1,1623,3227,0,3,0,3230,A
2-PB1,1624,1,2,3270,0,3273,G
2-PB1,1625,0,0,0,3281,3281,C
2-PB1,1626,3289,0,0,0,3289,A
2-PB1,1627,3283,1,1,0,3285,A
2-PB1,1628,0,1,0,3276,3277,C
2-PB1,1629,3261,0,4,0,3265,A
2-PB1,1630,1,2,3315,0,3318,G
2-PB1,1631,2,0,0,3298,3300,C
2-PB1,1632,3,1,0,3314,3318,C
2-PB1,1633,4,2,0,3308,3314,C
2-PB1,1634,3333,0,0,0,3333,A
2-PB1,1635,3326,0,2,0,3328,A
2-PB1,1636,3320,0,0,0,3320,A
2-PB1,1637,1,3315,0,1,3317,T
2-PB1,1638,1,3,3304,0,3308,G
2-PB1,1639,2,1,3236,0,3239,G
2-PB1,1640,0,1,0,3269,3270,C
2-PB1,1641,0,3232,0,10,3242,T
2-PB1,1642,5,1,0,3347,3353,C
2-PB1,1643,0,3332,0,5,3337,T
2-PB1,1644,3,0,0,3358,3361,C
2-PB1,1645,3,2,0,3383,3388,C
2-PB1,1646,3382,0,2,1,3385,A
2-PB1,1647,3401,0,0,0,3401,A
2-PB1,1648,1,3379,0,3,3383,T
2-PB1,1649,0,3348,0,3,3351,T
2-PB1,1650,1,0,3372,0,3373,G
2-PB1,1651,1,3304,0,4,3309,T
2-PB1,1652,0,3310,0,2,3312,T
2-PB1,1653,8,6,0,3294,3308,C
2-PB1,1654,3317,0,1,1,3319,A
2-PB1,1655,0,3305,0,5,3310,T
2-PB1,1656,3,0,0,3318,3321,C
2-PB1,1657,3338,1,1,1,3341,A
2-PB1,1658,3330,0,1,1,3332,A
2-PB1,1659,3321,1,3,0,3325,A
2-PB1,1660,2,2,3394,0,3398,G
2-PB1,1661,3382,0,4,0,3386,A
2-PB1,1662,0,3398,0,2,3400,T
2-PB1,1663,0,3403,0,2,3405,T
2-PB1,1664,3415,2,1,0,3418,A
2-PB1,1665,1,0,0,3485,3486,C
2-PB1,1666,3464,0,7,0,3471,A
2-PB1,1667,1,0,3518,0,3519,G
2-PB1,1668,3502,2,5,1,3510,A
2-PB1,1669,0,3566,0,0,3566,T
2-PB1,1670,3573,0,1,1,3575,A
2-PB1,1671,1,1,0,3780,3782,C
2-PB1,1672,3852,1,7,1,3861,A
2-PB1,1673,2,1,0,4121,4124,C
2-PB1,1674,4049,0,2,1,4052,A
2-PB1,1675,0,4087,0,3,4090,T
2-PB1,1676,4045,0,3,1,4049,A
2-PB1,1677,0,4029,0,2,4031,T
2-PB1,1678,3910,0,1,0,3911,A
2-PB1,1679,0,4,3889,0,3893,G
2-PB1,1680,1,1,3854,0,3856,G
2-PB1,1681,0,3646,0,5,3651,T
2-PB1,1682,1,1,3631,0,3633,G
2-PB1,1683,0,0,0,3750,3750,C
2-PB1,1684,1,0,0,3759,3760,C
2-PB1,1685,3825,1,3,1,3830,A
2-PB1,1686,0,3842,0,1,3843,T
2-PB1,1687,3854,1,2,0,3857,A
2-PB1,1688,0,2,3862,0,3864,G
2-PB1,1689,3756,0,5,0,3761,A
2-PB1,1690,0,5,3794,0,3799,G
2-PB1,1691,1,6,3779,0,3786,G
2-PB1,1692,3631,1,4,0,3636,A
2-PB1,1693,1,8,3647,0,3656,G
2-PB1,1694,3605,0,11,1,3617,A
2-PB1,1695,0,0,1,3637,3638,C
2-PB1,1696,3623,2,6,2,3633,A
2-PB1,1697,0,0,0,3703,3703,C
2-PB1,1698,3682,0,6,1,3689,A
2-PB1,1699,1,0,0,3706,3707,C
2-PB1,1700,3674,0,2,0,3676,A
2-PB1,1701,3685,0,8,0,3693,A
2-PB1,1702,3710,0,1,0,3711,A
2-PB1,1703,0,3690,0,3,3693,T
2-PB1,1704,7,0,0,3700,3707,C
2-PB1,1705,9,1,0,3698,3708,C
2-PB1,1706,3665,1,4,0,3670,A
2-PB1,1707,1,5,3669,0,3675,G
2-PB1,1708,3669,0,1,0,3670,A
2-PB1,1709,0,3,0,3704,3707,C
2-PB1,1710,0,7,3688,0,3695,G
2-PB1,1711,3663,0,1,0,3664,A
2-PB1,1712,0,3,3663,0,3666,G
2-PB1,1713,3676,0,0,1,3677,A
2-PB1,1714,3674,1,4,0,3679,A
2-PB1,1715,0,10,3685,0,3695,G
2-PB1,1716,3674,0,1,1,3676,A
2-PB1,1717,1,3681,0,5,3687,T
2-PB1,1718,9,0,0,3634,3643,C
2-PB1,1719,3658,0,1,0,3659,A
2-PB1,1720,1,3632,1,3,3637,T
2-PB1,1721,1,3625,0,1,3627,T
2-PB1,1722,6,2,0,3627,3635,C
2-PB1,1723,0,13,3628,0,3641,G
2-PB1,1724,3603,0,2,0,3605,A
2-PB1,1725,0,1,3620,0,3621,G
2-PB1,1726,3585,0,4,1,3590,A
2-PB1,1727,0,3724,0,0,3724,T
2-PB1,1728,3737,0,2,0,3739,A
2-PB1,1729,3744,0,1,0,3745,A
2-PB1,1730,3721,0,10,0,3731,A
2-PB1,1731,0,2,3743,0,3745,G
2-PB1,1732,3736,0,1,0,3737,A
2-PB1,1733,3633,1,5,0,3639,A
2-PB1,1734,0,1,3628,0,3629,G
2-PB1,1735,0,5,1,3626,3632,C
2-PB1,1736,0,3604,0,2,3606,T
2-PB1,1737,1,0,3629,0,3630,G
2-PB1,1738,1,3586,0,2,3589,T
2-PB1,1739,0,3,3596,0,3599,G
2-PB1,1740,2,2,3598,0,3602,G
2-PB1,1741,3,4,3627,0,3634,G
2-PB1,1742,3643,0,3,0,3646,A
2-PB1,1743,0,3623,0,3,3626,T
2-PB1,1744,5,0,0,3603,3608,C
2-PB1,1745,3613,0,2,0,3615,A
2-PB1,1746,3635,0,4,0,3639,A
2-PB1,1747,3641,1,4,0,3646,A
2-PB1,1748,0,1,0,3667,3668,C
2-PB1,1749,3,0,0,3648,3651,C
2-PB1,1750,8,0,0,3622,3630,C
2-PB1,1751,3634,0,1,0,3635,A
2-PB1,1752,3701,0,2,0,3703,A
2-PB1,1753,0,3678,0,0,3678,T
2-PB1,1754,8,0,0,3696,3704,C
2-PB1,1755,3668,0,4,1,3673,A
2-PB1,1756,3648,0,3,0,3651,A
2-PB1,1757,1,5,3695,0,3701,G
2-PB1,1758,1,4,3671,0,3676,G
2-PB1,1759,2,0,3659,0,3661,G
2-PB1,1760,2,2,0,3691,3695,C
2-PB1,1761,3613,1,4,0,3618,A
2-PB1,1762,2,1,3724,0,3727,G
2-PB1,1763,1,4,3762,0,3767,G
2-PB1,1764,3778,0,1,0,3779,A
2-PB1,1765,1,0,0,3840,3841,C
2-PB1,1766,0,3760,0,0,3760,T
2-PB1,1767,3896,0,2,0,3898,A
2-PB1,1768,0,3885,0,3,3888,T
2-PB1,1769,0,3882,1,1,3884,T
2-PB1,1770,2,4,3918,0,3924,G
2-PB1,1771,3,1,3906,0,3910,G
2-PB1,1772,1,3849,1,3,3854,T
2-PB1,1773,3875,0,1,0,3876,A
2-PB1,1774,0,3810,0,2,3812,T
2-PB1,1775,3,2,1,3821,3827,C
2-PB1,1776,3742,0,2,1,3745,A
2-PB1,1777,0,0,3787,0,3787,G
2-PB1,1778,3759,0,6,0,3765,A
2-PB1,1779,0,3742,0,2,3744,T
2-PB1,1780,0,5,3617,0,3622,G
2-PB1,1781,0,4,3607,1,3612,G
2-PB1,1782,0,3,3601,0,3604,G
2-PB1,1783,1,2,3618,0,3621,G
2-PB1,1784,1,7,3610,0,3618,G
2-PB1,1785,3590,0,6,0,3596,A
2-PB1,1786,2,0,1,3599,3602,C
2-PB1,1787,6,0,0,3569,3575,C
2-PB1,1788,3591,0,2,0,3593,A
2-PB1,1789,3831,0,1,0,3832,A
2-PB1,1790,3850,0,1,0,3851,A
2-PB1,1791,0,0,0,3956,3956,C
2-PB1,1792,0,3903,0,3,3906,T
2-PB1,1793,0,3923,0,1,3924,T
2-PB1,1794,3947,0,2,1,3950,A
2-PB1,1795,0,3924,1,0,3925,T
2-PB1,1796,3943,0,7,0,3950,A
2-PB1,1797,1,9,0,3940,3950,C
2-PB1,1798,3652,0,4,0,3656,A
2-PB1,1799,3652,0,5,0,3657,A
2-PB1,1800,0,3605,1,0,3606,T
2-PB1,1801,3657,0,0,0,3657,A
2-PB1,1802,1,3652,0,0,3653,T
2-PB1,1803,2,3,1,3642,3648,C
2-PB1,1804,4,6,0,3639,3649,C
2-PB1,1805,5,2,3646,0,3653,G
2-PB1,1806,0,2,3658,1,3661,G
2-PB1,1807,3651,0,0,1,3652,A
2-PB1,1808,3663,0,2,0,3665,A
2-PB1,1809,0,3647,2,7,3656,T
2-PB1,1810,4,0,0,3682,3686,C
2-PB1,1811,0,3674,0,2,3676,T
2-PB1,1812,0,3687,1,1,3689,T
2-PB1,1813,0,1,0,3681,3682,C
2-PB1,1814,3682,0,3,0,3685,A
2-PB1,1815,3,0,0,3696,3699,C
2-PB1,1816,3680,0,0,1,3681,A
2-PB1,1817,0,3964,0,0,3964,T
2-PB1,1818,6,0,0,3971,3977,C
2-PB1,1819,4,1,0,3973,3978,C
2-PB1,1820,6,1,0,4022,4029,C
2-PB1,1821,1,4021,1,4,4027,T
2-PB1,1822,2,2,4038,0,4042,G
2-PB1,1823,4019,0,0,1,4020,A
2-PB1,1824,4000,1,4,1,4006,A
2-PB1,1825,0,1,4028,0,4029,G
2-PB1,1826,0,3747,0,4,3751,T
2-PB1,1827,5,0,0,3775,3780,C
2-PB1,1828,0,3713,0,0,3713,T
2-PB1,1829,3,1,3796,0,3800,G
2-PB1,1830,0,0,0,3807,3807,C
2-PB1,1831,0,3800,0,3,3803,T
2-PB1,1832,0,3817,0,0,3817,T
2-PB1,1833,3806,0,1,0,3807,A
2-PB1,1834,3804,0,0,1,3805,A
2-PB1,1835,3801,2,4,0,3807,A
2-PB1,1836,1,0,3842,0,3843,G
2-PB1,1837,0,3794,1,2,3797,T
2-PB1,1838,1,3,3732,0,3736,G
2-PB1,1839,0,4,3703,0,3707,G
2-PB1,1840,2,2,3730,0,3734,G
2-PB1,1841,3711,0,4,0,3715,A
2-PB1,1842,2,0,3726,0,3728,G
2-PB1,1843,5,2,0,3713,3720,C
2-PB1,1844,1,3726,0,0,3727,T
2-PB1,1845,0,3,3740,0,3743,G
2-PB1,1846,3711,0,5,0,3716,A
2-PB1,1847,0,3740,0,0,3740,T
2-PB1,1848,1,3,3749,0,3753,G
2-PB1,1849,1,4,3751,0,3756,G
2-PB1,1850,3745,1,1,0,3747,A
2-PB1,1851,0,3728,1,4,3733,T
2-PB1,1852,2,8,3726,0,3736,G
2-PB1,1853,3701,0,5,0,3706,A
2-PB1,1854,0,7,3767,0,3774,G
2-PB1,1855,3775,0,2,0,3777,A
2-PB1,1856,3774,0,1,0,3775,A
2-PB1,1857,0,3755,1,1,3757,T
2-PB1,1858,0,3721,0,1,3722,T
2-PB1,1859,3733,0,0,2,3735,A
2-PB1,1860,0,3728,0,0,3728,T
2-PB1,1861,5,4,0,3729,3738,C
2-PB1,1862,2,6,3741,1,3750,G
2-PB1,1863,1,3,3683,0,3687,G
2-PB1,1864,0,1,3694,0,3695,G
2-PB1,1865,0,2,3688,0,3690,G
2-PB1,1866,3693,0,10,0,3703,A
2-PB1,1867,3703,0,4,0,3707,A
2-PB1,1868,3,4,3718,0,3725,G
2-PB1,1869,3732,0,4,0,3736,A
2-PB1,1870,2,0,0,3781,3783,C
2-PB1,1871,0,3762,1,3,3766,T
2-PB1,1872,0,3842,0,3,3845,T
2-PB1,1873,0,3843,0,2,3845,T
2-PB1,1874,1,1,3865,0,3867,G
2-PB1,1875,0,3870,1,3,3874,T
2-PB1,1876,3867,0,2,0,3869,A
2-PB1,1877,3857,0,0,0,3857,A
2-PB1,1878,0,3791,0,3,3794,T
2-PB1,1879,6,5,0,3816,3827,C
2-PB1,1880,4,1,0,3805,3810,C
2-PB1,1881,6,2,1,3804,3813,C
2-PB1,1882,4,1,1,3817,3823,C
2-PB1,1883,1,3813,0,4,3818,T
2-PB1,1884,0,2,3832,0,3834,G
2-PB1,1885,3822,0,0,0,3822,A
2-PB1,1886,3826,0,1,0,3827,A
2-PB1,1887,0,3832,0,4,3836,T
2-PB1,1888,7,0,0,3801,3808,C
2-PB1,1889,4,2,1,3794,3801,C
2-PB1,1890,5,0,0,3766,3771,C
2-PB1,1891,0,3765,0,9,3774,T
2-PB1,1892,0,3784,0,4,3788,T
2-PB1,1893,0,3774,0,3,3777,T
2-PB1,1894,0,1,3777,0,3778,G
2-PB1,1895,0,3745,0,7,3752,T
2-PB1,1896,9,3,0,3738,3750,C
2-PB1,1897,3699,0,3,0,3702,A
2-PB1,1898,1,2,3745,0,3748,G
2-PB1,1899,2,1,0,3725,3728,C
2-PB1,1900,3,1,1,3737,3742,C
2-PB1,1901,3766,0,1,0,3767,A
2-PB1,1902,0,3777,0,1,3778,T
2-PB1,1903,3765,0,1,0,3766,A
2-PB1,1904,3788,1,1,0,3790,A
2-PB1,1905,3790,0,3,1,3794,A
2-PB1,1906,0,4,3843,0,3847,G
2-PB1,1907,3742,0,0,0,3742,A
2-PB1,1908,3749,0,2,0,3751,A
2-PB1,1909,3739,0,6,0,3745,A
2-PB1,1910,0,3716,1,1,3718,T
2-PB1,1911,0,3732,1,1,3734,T
2-PB1,1912,0,6,3725,0,3731,G
2-PB1,1913,3703,0,2,0,3705,A
2-PB1,1914,0,0,3775,0,3775,G
2-PB1,1915,0,3771,0,3,3774,T
2-PB1,1916,4,0,0,3793,3797,C
2-PB1,1917,0,3776,1,2,3779,T
2-PB1,1918,1,0,3880,0,3881,G
2-PB1,1919,0,3868,0,4,3872,T
2-PB1,1920,3950,0,0,1,3951,A
2-PB1,1921,3938,0,4,0,3942,A
2-PB1,1922,3927,0,5,0,3932,A
2-PB1,1923,1,0,0,3944,3945,C
2-PB1,1924,3840,1,0,0,3841,A
2-PB1,1925,3941,0,0,0,3941,A
2-PB1,1926,0,3924,0,0,3924,T
2-PB1,1927,2,0,3904,0,3906,G
2-PB1,1928,1,0,0,3922,3923,C
2-PB1,1929,0,3883,0,8,3891,T
2-PB1,1930,0,0,4012,0,4012,G
2-PB1,1931,1,4006,0,4,4011,T
2-PB1,1932,4077,0,2,3,4082,A
2-PB1,1933,1,0,4076,0,4077,G
2-PB1,1934,0,3963,0,1,3964,T
2-PB1,1935,3952,0,0,0,3952,A
2-PB1,1936,3888,1,4,1,3894,A
2-PB1,1937,0,3860,0,0,3860,T
2-PB1,1938,4,2,3848,0,3854,G
2-PB1,1939,1,1,0,3794,3796,C
2-PB1,1940,1,1,0,3746,3748,C
2-PB1,1941,3676,0,6,0,3682,A
2-PB1,1942,0,1,3713,0,3714,G
2-PB1,1943,1,3,0,3777,3781,C
2-PB1,1944,2,0,0,3792,3794,C
2-PB1,1945,6,2,1,3801,3810,C
2-PB1,1946,3787,0,6,1,3794,A
2-PB1,1947,0,3786,0,2,3788,T
2-PB1,1948,2,3,3775,1,3781,G
2-PB1,1949,2,0,3764,0,3766,G
2-PB1,1950,1,3732,0,5,3738,T
2-PB1,1951,2,0,0,3708,3710,C
2-PB1,1952,5,4,0,3618,3627,C
2-PB1,1953,4,1,3650,0,3655,G
2-PB1,1954,5,0,3658,0,3663,G
2-PB1,1955,2,0,0,3627,3629,C
2-PB1,1956,4,2,0,3644,3650,C
2-PB1,1957,3665,0,0,0,3665,A
2-PB1,1958,3651,0,3,0,3654,A
2-PB1,1959,3665,0,0,0,3665,A
2-PB1,1960,3683,0,5,0,3688,A
2-PB1,1961,1,0,3757,0,3758,G
2-PB1,1962,0,3633,0,0,3633,T
2-PB1,1963,3671,0,0,0,3671,A
2-PB1,1964,0,3659,0,2,3661,T
2-PB1,1965,2,3,3672,0,3677,G
2-PB1,1966,0,10,3718,0,3728,G
2-PB1,1967,3698,0,2,0,3700,A
2-PB1,1968,3743,0,1,0,3744,A
2-PB1,1969,0,3722,0,1,3723,T
2-PB1,1970,3671,0,0,0,3671,A
2-PB1,1971,0,3662,0,3,3665,T
2-PB1,1972,0,4,3629,0,3633,G
2-PB1,1973,3633,0,4,0,3637,A
2-PB1,1974,1,3592,0,2,3595,T
2-PB1,1975,0,0,3510,0,3510,G
2-PB1,1976,0,1,0,3520,3521,C
2-PB1,1977,7,4,0,3462,3473,C
2-PB1,1978,1,0,3476,0,3477,G
2-PB1,1979,0,3486,0,0,3486,T
2-PB1,1980,0,3470,0,3,3473,T
2-PB1,1981,1,1,3485,0,3487,G
2-PB1,1982,1,2,0,3552,3555,C
2-PB1,1983,3568,0,0,1,3569,A
2-PB1,1984,3610,0,5,0,3615,A
2-PB1,1985,7,1,0,3617,3625,C
2-PB1,1986,0,3586,0,4,3590,T
2-PB1,1987,3599,0,2,0,3601,A
2-PB1,1988,1,3,0,3596,3600,C
2-PB1,1989,3587,0,4,0,3591,A
2-PB1,1990,1,2,0,3590,3593,C
2-PB1,1991,3439,0,3,0,3442,A
2-PB1,1992,1,1,0,3791,3793,C
2-PB1,1993,1,3685,0,7,3693,T
2-PB1,1994,9,0,0,3726,3735,C
2-PB1,1995,2,1,0,3739,3742,C
2-PB1,1996,0,3699,0,6,3705,T
2-PB1,1997,0,4,3705,1,3710,G
2-PB1,1998,0,5,3705,1,3711,G
2-PB1,1999,3686,0,1,0,3687,A
2-PB1,2000,0,3692,0,0,3692,T
2-PB1,2001,0,3278,0,5,3283,T
2-PB1,2002,6,0,0,3322,3328,C
2-PB1,2003,3,1,0,3303,3307,C
2-PB1,2004,6,3,0,3345,3354,C
2-PB1,2005,3364,0,1,0,3365,A
2-PB1,2006,3354,0,0,0,3354,A
2-PB1,2007,1,4,3373,0,3378,G
2-PB1,2008,3335,0,5,0,3340,A
2-PB1,2009,1,0,3343,1,3345,G
2-PB1,2010,1,6,3336,0,3343,G
2-PB1,2011,3285,0,2,0,3287,A
2-PB1,2012,3284,1,6,0,3291,A
2-PB1,2013,1,0,0,3276,3277,C
2-PB1,2014,3,0,0,3257,3260,C
2-PB1,2015,0,0,3301,0,3301,G
2-PB1,2016,2,0,0,3292,3294,C
2-PB1,2017,0,3289,0,3,3292,T
2-PB1,2018,4,1,0,3316,3321,C
2-PB1,2019,0,3299,0,2,3301,T
2-PB1,2020,3576,0,0,0,3576,A
2-PB1,2021,0,3561,1,7,3569,T
2-PB1,2022,0,3574,0,2,3576,T
2-PB1,2023,10,2,0,3594,3606,C
2-PB1,2024,0,3494,1,2,3497,T
2-PB1,2025,3501,0,1,0,3502,A
2-PB1,2026,3489,0,1,0,3490,A
2-PB1,2027,3488,1,2,0,3491,A
2-PB1,2028,2,0,0,3484,3486,C
2-PB1,2029,3229,0,1,0,3230,A
2-PB1,2030,0,0,0,3215,3215,C
2-PB1,2031,3187,0,3,0,3190,A
2-PB1,2032,3212,0,4,0,3216,A
2-PB1,2033,0,2,3227,0,3229,G
2-PB1,2034,1,0,0,3202,3203,C
2-PB1,2035,3,0,0,3237,3240,C
2-PB1,2036,3198,0,1,0,3199,A
2-PB1,2037,3184,0,4,0,3188,A
2-PB1,2038,3179,1,4,0,3184,A
2-PB1,2039,0,2,3219,0,3221,G
2-PB1,2040,1,4,3197,0,3202,G
2-PB1,2041,0,3,3146,0,3149,G
2-PB1,2042,1,1,3157,0,3159,G
2-PB1,2043,3145,0,2,0,3147,A
2-PB1,2044,3170,0,0,0,3170,A
2-PB1,2045,0,3174,0,1,3175,T
2-PB1,2046,0,3173,0,2,3175,T
2-PB1,2047,1,0,0,3176,3177,C
2-PB1,2048,1,3142,0,4,3147,T
2-PB1,2049,0,3153,0,0,3153,T
2-PB1,2050,0,3,3149,0,3152,G
2-PB1,2051,3145,0,2,0,3147,A
2-PB1,2052,0,2,3163,0,3165,G
2-PB1,2053,0,4,3148,0,3152,G
2-PB1,2054,3139,1,1,0,3141,A
2-PB1,2055,0,3134,0,0,3134,T
2-PB1,2056,2,5,3160,0,3167,G
2-PB1,2057,3136,1,5,0,3142,A
2-PB1,2058,3147,0,4,0,3151,A
2-PB1,2059,1,1,0,3176,3178,C
2-PB1,2060,3133,0,2,0,3135,A
2-PB1,2061,2,1,3194,0,3197,G
2-PB1,2062,3172,0,3,0,3175,A
2-PB1,2063,0,3171,0,0,3171,T
2-PB1,2064,3,1,3190,0,3194,G
2-PB1,2065,1,3297,0,6,3304,T
2-PB1,2066,3292,0,1,0,3293,A
2-PB1,2067,1,1,0,3289,3291,C
2-PB1,2068,5,1,0,3284,3290,C
2-PB1,2069,3249,2,1,0,3252,A
2-PB1,2070,0,2,3217,0,3219,G
2-PB1,2071,3187,0,0,0,3187,A
2-PB1,2072,3173,0,1,0,3174,A
2-PB1,2073,0,2,3193,0,3195,G
2-PB1,2074,1,2979,0,0,2980,T
2-PB1,2075,2,3,2980,0,2985,G
2-PB1,2076,2,0,0,2973,2975,C
2-PB1,2077,0,2978,0,3,2981,T
2-PB1,2078,3,2,2990,0,2995,G
2-PB1,2079,4,0,0,2980,2984,C
2-PB1,2080,2979,0,0,0,2979,A
2-PB1,2081,2975,0,6,0,2981,A
2-PB1,2082,1,1,0,2946,2948,C
2-PB1,2083,0,2943,0,3,2946,T
2-PB1,2084,0,2914,0,0,2914,T
2-PB1,2085,2,0,2904,0,2906,G
2-PB1,2086,0,2894,0,1,2895,T
2-PB1,2087,0,2878,0,0,2878,T
2-PB1,2088,7,0,0,2886,2893,C
2-PB1,2089,0,6,2893,0,2899,G
2-PB1,2090,2898,0,1,0,2899,A
2-PB1,2091,0,1,2889,0,2890,G
2-PB1,2092,2900,0,3,0,2903,A
2-PB1,2093,2901,0,1,0,2902,A
2-PB1,2094,2902,0,1,1,2904,A
2-PB1,2095,0,2886,0,1,2887,T
2-PB1,2096,0,2897,0,1,2898,T
2-PB1,2097,0,2904,0,1,2905,T
2-PB1,2098,0,2900,0,4,2904,T
2-PB1,2099,0,2894,0,1,2895,T
2-PB1,2100,4,1,0,2888,2893,C
2-PB1,2101,4,2,0,2884,2890,C
2-PB1,2102,9,1,0,2901,2911,C
2-PB1,2103,0,2910,0,3,2913,T
2-PB1,2104,2908,0,0,0,2908,A
2-PB1,2105,1,1,2929,0,2931,G
2-PB1,2106,2,2915,0,1,2918,T
2-PB1,2107,2937,0,0,0,2937,A
2-PB1,2108,0,0,2955,0,2955,G
2-PB1,2109,0,2929,0,3,2932,T
2-PB1,2110,0,3030,0,4,3034,T
2-PB1,2111,8,0,0,3057,3065,C
2-PB1,2112,3107,0,2,0,3109,A
2-PB1,2113,0,3114,0,0,3114,T
2-PB1,2114,3116,1,3,0,3120,A
2-PB1,2115,1,3115,0,2,3118,T
2-PB1,2116,3007,0,4,0,3011,A
2-PB1,2117,0,4,2983,0,2987,G
2-PB1,2118,2,1,2965,0,2968,G
2-PB1,2119,2607,0,7,0,2614,A
2-PB1,2120,0,2,2617,0,2619,G
2-PB1,2121,2447,0,3,0,2450,A
2-PB1,2122,0,0,0,2456,2456,C
2-PB1,2123,6,0,0,2334,2340,C
2-PB1,2124,0,2,2336,0,2338,G
2-PB1,2125,2327,0,0,1,2328,A
2-PB1,2126,0,2312,0,0,2312,T
2-PB1,2127,0,2324,0,0,2324,T
2-PB1,2128,1,2,2313,0,2316,G
2-PB1,2129,1,3,2315,0,2319,G
2-PB1,2130,2327,0,1,0,2328,A
2-PB1,2131,2324,0,0,1,2325,A
2-PB1,2132,0,2298,0,0,2298,T
2-PB1,2133,1,2346,0,0,2347,T
2-PB1,2134,0,2344,0,0,2344,T
2-PB1,2135,5,1,0,2364,2370,C
2-PB1,2136,0,2369,0,1,2370,T
2-PB1,2137,2361,0,0,1,2362,A
2-PB1,2138,0,0,2361,0,2361,G
2-PB1,2139,1,2219,0,0,2220,T
2-PB1,2140,2279,0,2,0,2281,A
2-PB1,2141,0,2276,0,2,2278,T
2-PB1,2142,0,2,2310,0,2312,G
2-PB1,2143,2,2,2358,0,2362,G
2-PB1,2144,0,2325,0,1,2326,T
2-PB1,2145,0,3,2324,0,2327,G
2-PB1,2146,0,0,2319,0,2319,G
2-PB1,2147,2242,0,4,0,2246,A
2-PB1,2148,1,0,2259,0,2260,G
2-PB1,2149,0,0,2245,0,2245,G
2-PB1,2150,2,1,0,2214,2217,C
2-PB1,2151,2,1,0,2205,2208,C
2-PB1,2152,2095,0,3,0,2098,A
2-PB1,2153,0,2092,0,4,2096,T
2-PB1,2154,0,0,2127,0,2127,G
2-PB1,2155,0,0,2149,0,2149,G
2-PB1,2156,0,2088,0,4,2092,T
2-PB1,2157,1,0,2143,0,2144,G
2-PB1,2158,0,2099,0,2,2101,T
2-PB1,2159,4,0,0,2087,2091,C
2-PB1,2160,0,2096,1,1,2098,T
2-PB1,2161,2077,0,2,0,2079,A
2-PB1,2162,4,3,2070,0,2077,G
2-PB1,2163,0,1,1998,0,1999,G
2-PB1,2164,0,1,1978,0,1979,G
2-PB1,2165,1,3,0,1919,1923,C
2-PB1,2166,2,1,0,1839,1842,C
2-PB1,2167,5,1,0,1804,1810,C
2-PB1,2168,2,3,1813,0,1818,G
2-PB1,2169,1,3,1818,0,1822,G
2-PB1,2170,1829,0,0,0,1829,A
2-PB1,2171,0,1809,0,0,1809,T
2-PB1,2172,0,1746,0,0,1746,T
2-PB1,2173,0,0,1727,0,1727,G
2-PB1,2174,1716,0,1,0,1717,A
2-PB1,2175,1,1722,0,1,1724,T
2-PB1,2176,0,0,1717,0,1717,G
2-PB1,2177,0,1,0,1691,1692,C
2-PB1,2178,2,0,0,1701,1703,C
2-PB1,2179,1693,0,2,0,1695,A
2-PB1,2180,0,0,1694,0,1694,G
2-PB1,2181,1688,0,2,0,1690,A
2-PB1,2182,1695,0,0,0,1695,A
2-PB1,2183,0,1686,0,2,1688,T
2-PB1,2184,0,1666,0,3,1669,T
2-PB1,2185,2,3,1668,0,1673,G
2-PB1,2186,1645,0,2,0,1647,A
2-PB1,2187,0,0,0,1645,1645,C
2-PB1,2188,0,1618,0,3,1621,T
2-PB1,2189,1,1607,0,1,1609,T
2-PB1,2190,1,0,0,1612,1613,C
2-PB1,2191,2,3,1612,0,1617,G
2-PB1,2192,1607,0,1,0,1608,A
2-PB1,2193,4,1,1576,0,1581,G
2-PB1,2194,0,1583,0,0,1583,T
2-PB1,2195,2,1,0,1593,1596,C
2-PB1,2196,0,1597,0,2,1599,T
2-PB1,2197,0,1,1605,0,1606,G
2-PB1,2198,0,0,1606,0,1606,G
2-PB1,2199,1592,0,0,0,1592,A
2-PB1,2200,1456,0,6,1,1463,A
2-PB1,2201,0,1,1480,0,1481,G
2-PB1,2202,0,0,1484,0,1484,G
2-PB1,2203,1489,1,1,0,1491,A
2-PB1,2204,0,1482,0,0,1482,T
2-PB1,2205,0,1488,0,0,1488,T
2-PB1,2206,1478,0,2,0,1480,A
2-PB1,2207,1473,0,1,0,1474,A
2-PB1,2208,20,1,1450,0,1471,G
2-PB1,2209,1466,0,1,0,1467,A
2-PB1,2210,1383,0,2,0,1385,A
2-PB1,2211,2,0,1302,0,1304,G
2-PB1,2212,0,0,1281,0,1281,G
2-PB1,2213,1273,0,0,0,1273,A
2-PB1,2214,1268,0,1,0,1269,A
2-PB1,2215,2,0,1269,0,1271,G
2-PB1,2216,1185,0,0,0,1185,A
2-PB1,2217,0,0,1185,0,1185,G
2-PB1,2218,0,1149,0,0,1149,T
2-PB1,2219,0,1134,0,0,1134,T
2-PB1,2220,4,0,0,1151,1155,C
2-PB1,2221,0,1121,0,3,1124,T
2-PB1,2222,1,2,0,1127,1130,C
2-PB1,2223,0,1129,0,2,1131,T
2-PB1,2224,0,2,1123,0,1125,G
2-PB1,2225,1097,0,1,0,1098,A
2-PB1,2226,0,1,1086,0,1087,G
2-PB1,2227,1076,0,0,0,1076,A
2-PB1,2228,0,1054,0,1,1055,T
2-PB1,2229,1,0,0,993,994,C
2-PB1,2230,1001,0,1,0,1002,A
2-PB1,2231,0,1001,0,1,1002,T
2-PB1,2232,0,0,1004,0,1004,G
2-PB1,2233,997,0,1,0,998,A
2-PB1,2234,985,0,4,0,989,A
2-PB1,2235,0,3,966,0,969,G
2-PB1,2236,959,0,1,0,960,A
2-PB1,2237,0,947,0,0,947,T
2-PB1,2238,2,0,0,941,943,C
2-PB1,2239,0,893,0,1,894,T
2-PB1,2240,0,0,904,0,904,G
2-PB1,2241,0,898,0,2,900,T
2-PB1,2242,0,893,0,2,895,T
2-PB1,2243,3,0,0,882,885,C
2-PB1,2244,1,1,0,831,833,C
2-PB1,2245,836,0,0,0,836,A
2-PB1,2246,2,0,0,836,838,C
2-PB1,2247,2,1,0,794,797,C
2-PB1,2248,765,0,1,0,766,A
2-PB1,2249,0,709,0,2,711,T
2-PB1,2250,0,700,0,0,700,T
2-PB1,2251,0,0,699,0,699,G
2-PB1,2252,694,0,0,0,694,A
2-PB1,2253,685,0,1,0,686,A
2-PB1,2254,1,0,684,0,685,G
2-PB1,2255,593,0,0,0,593,A
2-PB1,2256,586,0,0,0,586,A
2-PB1,2257,0,0,0,590,590,C
2-PB1,2258,0,565,0,1,566,T
2-PB1,2259,0,1,0,564,565,C
2-PB1,2260,546,0,0,0,546,A
2-PB1,2261,0,0,553,0,553,G
2-PB1,2262,544,0,0,1,545,A
2-PB1,2263,0,1,0,515,516,C
2-PB1,2264,0,2,505,0,507,G
2-PB1,2265,0,0,497,0,497,G
2-PB1,2266,0,1,0,489,490,C
2-PB1,2267,492,0,1,0,493,A
2-PB1,2268,487,0,1,0,488,A
2-PB1,2269,485,0,0,0,485,A
2-PB1,2270,482,0,1,0,483,A
2-PB1,2271,486,0,0,0,486,A
2-PB1,2272,0,470,0,0,470,T
2-PB1,2273,453,0,0,0,453,A
2-PB1,2274,452,0,0,0,452,A
3-PA,1,73,0,0,0,73,A
3-PA,2,0,73,0,0,73,T
3-PA,3,0,0,76,0,76,G
3-PA,4,0,0,76,0,76,G
3-PA,5,77,0,0,0,77,A
3-PA,6,77,0,1,0,78,A
3-PA,7,0,0,81,0,81,G
3-PA,8,80,0,0,0,80,A
3-PA,9,0,83,0,0,83,T
3-PA,10,0,84,0,0,84,T
3-PA,11,0,86,0,0,86,T
3-PA,12,0,86,0,0,86,T
3-PA,13,0,0,87,0,87,G
3-PA,14,0,86,0,0,86,T
3-PA,15,1,0,86,0,87,G
3-PA,16,0,0,0,89,89,C
3-PA,17,0,0,90,0,90,G
3-PA,18,95,0,0,0,95,A
3-PA,19,0,0,0,98,98,C
3-PA,20,99,0,0,0,99,A
3-PA,21,96,0,0,0,96,A
3-PA,22,0,100,0,0,100,T
3-PA,23,0,0,110,0,110,G
3-PA,24,0,0,0,114,114,C
3-PA,25,0,115,0,0,115,T
3-PA,26,0,116,0,0,116,T
3-PA,27,0,0,0,116,116,C
3-PA,28,121,0,1,0,122,A
3-PA,29,125,0,0,0,125,A
3-PA,30,0,0,0,130,130,C
3-PA,31,0,0,0,131,131,C
3-PA,32,0,1,0,129,130,C
3-PA,33,0,0,130,0,130,G
3-PA,34,129,0,0,0,129,A
3-PA,35,0,129,0,0,129,T
3-PA,36,0,1,129,0,130,G
3-PA,37,132,0,0,0,132,A
3-PA,38,0,139,0,0,139,T
3-PA,39,0,141,0,0,141,T
3-PA,40,0,0,138,0,138,G
3-PA,41,0,137,0,0,137,T
3-PA,42,0,0,0,139,139,C
3-PA,43,0,0,137,0,137,G
3-PA,44,142,0,0,0,142,A
3-PA,45,143,0,0,0,143,A
3-PA,46,0,0,0,144,144,C
3-PA,47,0,144,0,0,144,T
3-PA,48,0,145,0,0,145,T
3-PA,49,0,0,146,0,146,G
3-PA,50,0,1,0,145,146,C
3-PA,51,146,0,0,0,146,A
3-PA,52,0,0,148,0,148,G
3-PA,53,148,0,0,0,148,A
3-PA,54,147,0,0,0,147,A
3-PA,55,148,0,0,0,148,A
3-PA,56,147,0,0,0,147,A
3-PA,57,149,0,0,0,149,A
3-PA,58,0,0,149,0,149,G
3-PA,59,0,0,0,157,157,C
3-PA,60,159,0,0,0,159,A
3-PA,61,168,0,1,0,169,A
3-PA,62,0,169,0,0,169,T
3-PA,63,0,0,171,0,171,G
3-PA,64,173,0,0,0,173,A
3-PA,65,176,0,0,0,176,A
3-PA,66,171,0,2,1,174,A
3-PA,67,0,0,194,0,194,G
3-PA,68,210,0,0,0,210,A
3-PA,69,0,0,250,0,250,G
3-PA,70,0,241,0,0,241,T
3-PA,71,246,0,1,0,247,A
3-PA,72,0,250,0,0,250,T
3-PA,73,0,2,249,0,251,G
3-PA,74,0,0,250,0,250,G
3-PA,75,0,0,248,0,248,G
3-PA,76,0,0,246,0,246,G
3-PA,77,242,0,1,0,243,A
3-PA,78,0,0,240,0,240,G
3-PA,79,0,0,243,0,243,G
3-PA,80,240,0,0,0,240,A
3-PA,81,0,242,0,0,242,T
3-PA,82,0,0,0,246,246,C
3-PA,83,0,245,0,0,245,T
3-PA,84,0,1,247,0,248,G
3-PA,85,246,0,0,0,246,A
3-PA,86,246,0,0,0,246,A
3-PA,87,246,0,0,0,246,A
3-PA,88,246,0,0,0,246,A
3-PA,89,0,246,0,0,246,T
3-PA,90,0,247,0,0,247,T
3-PA,91,0,0,245,0,245,G
3-PA,92,245,0,0,0,245,A
3-PA,93,247,0,0,0,247,A
3-PA,94,247,0,0,0,247,A
3-PA,95,0,0,0,247,247,C
3-PA,96,246,0,0,0,246,A
3-PA,97,249,0,0,0,249,A
3-PA,98,248,0,0,0,248,A
3-PA,99,0,0,0,250,250,C
3-PA,100,250,0,0,0,250,A
3-PA,101,253,0,0,0,253,A
3-PA,102,254,0,0,0,254,A
3-PA,103,1,252,0,0,253,T
3-PA,104,0,255,0,0,255,T
3-PA,105,0,253,0,0,253,T
3-PA,106,0,0,255,0,255,G
3-PA,107,0,0,0,255,255,C
3-PA,108,257,0,0,0,257,A
3-PA,109,0,0,263,0,263,G
3-PA,110,0,0,0,269,269,C
3-PA,111,286,0,0,0,286,A
3-PA,112,290,0,0,0,290,A
3-PA,113,0,287,0,1,288,T
3-PA,114,297,0,0,0,297,A
3-PA,115,0,292,0,0,292,T
3-PA,116,0,0,301,0,301,G
3-PA,117,0,0,0,302,302,C
3-PA,118,301,0,0,0,301,A
3-PA,119,0,0,0,302,302,C
3-PA,120,0,298,0,0,298,T
3-PA,121,1,0,0,363,364,C
3-PA,122,374,0,0,0,374,A
3-PA,123,0,0,0,375,375,C
3-PA,124,0,378,0,1,379,T
3-PA,125,0,378,0,0,378,T
3-PA,126,1,1,374,0,376,G
3-PA,127,0,2,376,2,380,G
3-PA,128,374,0,0,0,374,A
3-PA,129,0,2,381,0,383,G
3-PA,130,0,0,382,0,382,G
3-PA,131,0,354,0,3,357,T
3-PA,132,0,0,373,0,373,G
3-PA,133,0,370,0,0,370,T
3-PA,134,2,0,378,0,380,G
3-PA,135,0,378,0,1,379,T
3-PA,136,0,383,0,0,383,T
3-PA,137,0,382,0,1,383,T
3-PA,138,0,0,0,392,392,C
3-PA,139,388,0,0,0,388,A
3-PA,140,0,390,0,0,390,T
3-PA,141,0,0,394,0,394,G
3-PA,142,0,389,0,0,389,T
3-PA,143,400,0,0,0,400,A
3-PA,144,0,398,0,0,398,T
3-PA,145,0,398,0,0,398,T
3-PA,146,1,0,0,393,394,C
3-PA,147,396,0,1,0,397,A
3-PA,148,0,0,403,0,403,G
3-PA,149,399,0,0,0,399,A
3-PA,150,0,406,0,0,406,T
3-PA,151,0,404,0,1,405,T
3-PA,152,0,402,0,0,402,T
3-PA,153,0,0,0,401,401,C
3-PA,154,0,0,0,410,410,C
3-PA,155,411,0,0,0,411,A
3-PA,156,0,411,0,0,411,T
3-PA,157,0,415,0,0,415,T
3-PA,158,0,413,0,0,413,T
3-PA,159,3,0,0,412,415,C
3-PA,160,414,0,2,0,416,A
3-PA,161,0,441,0,0,441,T
3-PA,162,0,0,0,440,440,C
3-PA,163,439,0,1,0,440,A
3-PA,164,442,0,0,0,442,A
3-PA,165,0,441,0,0,441,T
3-PA,166,0,4,453,0,457,G
3-PA,167,461,0,0,0,461,A
3-PA,168,460,0,2,0,462,A
3-PA,169,0,0,0,461,461,C
3-PA,170,453,0,0,0,453,A
3-PA,171,458,0,0,0,458,A
3-PA,172,0,0,458,0,458,G
3-PA,173,0,0,460,0,460,G
3-PA,174,0,1,0,460,461,C
3-PA,175,0,1,459,0,460,G
3-PA,176,479,0,0,0,479,A
3-PA,177,481,0,0,0,481,A
3-PA,178,0,484,0,0,484,T
3-PA,179,1,0,0,490,491,C
3-PA,180,495,0,0,0,495,A
3-PA,181,496,0,0,0,496,A
3-PA,182,2,500,0,0,502,T
3-PA,183,497,0,0,0,497,A
3-PA,184,0,0,512,0,512,G
3-PA,185,0,509,0,0,509,T
3-PA,186,0,2,509,0,511,G
3-PA,187,0,0,512,0,512,G
3-PA,188,0,506,0,0,506,T
3-PA,189,506,0,1,0,507,A
3-PA,190,0,0,515,0,515,G
3-PA,191,515,0,1,0,516,A
3-PA,192,515,0,0,0,515,A
3-PA,193,1,0,0,512,513,C
3-PA,194,0,506,0,0,506,T
3-PA,195,0,507,0,0,507,T
3-PA,196,0,0,506,0,506,G
3-PA,197,505,0,2,0,507,A
3-PA,198,0,0,0,503,503,C
3-PA,199,1,4,498,0,503,G
3-PA,200,517,0,0,0,517,A
3-PA,201,0,520,0,0,520,T
3-PA,202,1,0,0,524,525,C
3-PA,203,0,0,0,534,534,C
3-PA,204,531,0,1,0,532,A
3-PA,205,530,0,0,0,530,A
3-PA,206,534,0,0,0,534,A
3-PA,207,0,532,0,1,533,T
3-PA,208,0,1,535,0,536,G
3-PA,209,0,0,0,530,530,C
3-PA,210,525,0,0,0,525,A
3-PA,211,0,0,0,550,550,C
3-PA,212,0,531,0,0,531,T
3-PA,213,0,0,628,0,628,G
3-PA,214,0,630,0,1,631,T
3-PA,215,0,626,0,2,628,T
3-PA,216,630,0,0,0,630,A
3-PA,217,629,0,1,0,630,A
3-PA,218,623,0,0,0,623,A
3-PA,219,0,0,628,0,628,G
3-PA,220,0,0,0,620,620,C
3-PA,221,611,0,0,0,611,A
3-PA,222,0,0,0,609,609,C
3-PA,223,570,0,0,0,570,A
3-PA,224,0,0,593,0,593,G
3-PA,225,594,0,0,0,594,A
3-PA,226,0,595,0,1,596,T
3-PA,227,0,599,0,0,599,T
3-PA,228,0,592,0,0,592,T
3-PA,229,1,1,590,0,592,G
3-PA,230,594,0,0,0,594,A
3-PA,231,595,1,0,0,596,A
3-PA,232,591,0,1,0,592,A
3-PA,233,0,580,1,0,581,T
3-PA,234,579,0,0,0,579,A
3-PA,235,590,0,0,0,590,A
3-PA,236,0,583,0,0,583,T
3-PA,237,1,0,0,586,587,C
3-PA,238,0,0,587,0,587,G
3-PA,239,582,0,1,0,583,A
3-PA,240,0,0,589,0,589,G
3-PA,241,0,0,601,0,601,G
3-PA,242,0,0,593,0,593,G
3-PA,243,0,1,594,0,595,G
3-PA,244,580,0,5,0,585,A
3-PA,245,0,0,598,0,598,G
3-PA,246,610,0,0,0,610,A
3-PA,247,0,1,615,0,616,G
3-PA,248,615,0,1,0,616,A
3-PA,249,0,0,0,621,621,C
3-PA,250,605,0,0,0,605,A
3-PA,251,1,2,616,0,619,G
3-PA,252,612,0,1,0,613,A
3-PA,253,624,0,0,0,624,A
3-PA,254,0,0,0,624,624,C
3-PA,255,608,0,0,0,608,A
3-PA,256,608,0,0,0,608,A
3-PA,257,0,606,0,0,606,T
3-PA,258,0,5,624,0,629,G
3-PA,259,0,1,633,0,634,G
3-PA,260,0,0,0,623,623,C
3-PA,261,1,0,0,630,631,C
3-PA,262,0,622,0,0,622,T
3-PA,263,1,1,636,0,638,G
3-PA,264,0,0,638,0,638,G
3-PA,265,638,0,0,0,638,A
3-PA,266,1,0,0,646,647,C
3-PA,267,623,0,1,0,624,A
3-PA,268,0,0,689,0,689,G
3-PA,269,0,690,0,0,690,T
3-PA,270,695,0,0,0,695,A
3-PA,271,0,0,695,0,695,G
3-PA,272,0,686,0,0,686,T
3-PA,273,688,0,0,0,688,A
3-PA,274,681,0,0,0,681,A
3-PA,275,685,0,0,0,685,A
3-PA,276,0,1,0,691,692,C
3-PA,277,625,1,0,0,626,A
3-PA,278,0,0,646,0,646,G
3-PA,279,0,640,0,0,640,T
3-PA,280,654,0,0,0,654,A
3-PA,281,0,654,0,1,655,T
3-PA,282,0,0,0,667,667,C
3-PA,283,0,662,0,1,663,T
3-PA,284,0,1,660,0,661,G
3-PA,285,0,0,0,663,663,C
3-PA,286,662,0,0,0,662,A
3-PA,287,667,0,0,0,667,A
3-PA,288,0,0,0,678,678,C
3-PA,289,679,0,0,0,679,A
3-PA,290,0,0,0,702,702,C
3-PA,291,0,693,0,0,693,T
3-PA,292,699,0,1,0,700,A
3-PA,293,0,0,0,694,694,C
3-PA,294,0,698,0,1,699,T
3-PA,295,0,1,694,0,695,G
3-PA,296,0,1,692,0,693,G
3-PA,297,687,0,1,0,688,A
3-PA,298,0,1,686,0,687,G
3-PA,299,0,0,0,668,668,C
3-PA,300,1,674,0,1,676,T
3-PA,301,1,1,674,0,676,G
3-PA,302,0,2,670,0,672,G
3-PA,303,675,0,0,0,675,A
3-PA,304,671,0,0,0,671,A
3-PA,305,672,0,0,0,672,A
3-PA,306,667,0,1,0,668,A
3-PA,307,0,0,0,664,664,C
3-PA,308,0,0,0,667,667,C
3-PA,309,0,1,671,0,672,G
3-PA,310,671,0,0,0,671,A
3-PA,311,672,0,1,0,673,A
3-PA,312,1,0,673,0,674,G
3-PA,313,0,673,0,0,673,T
3-PA,314,0,676,0,0,676,T
3-PA,315,0,676,0,0,676,T
3-PA,316,0,0,0,678,678,C
3-PA,317,0,681,0,0,681,T
3-PA,318,678,0,0,0,678,A
3-PA,319,0,0,0,675,675,C
3-PA,320,0,0,0,676,676,C
3-PA,321,677,0,0,0,677,A
3-PA,322,0,1,685,0,686,G
3-PA,323,682,0,0,0,682,A
3-PA,324,0,683,0,0,683,T
3-PA,325,0,682,0,0,682,T
3-PA,326,0,687,0,0,687,T
3-PA,327,0,0,694,0,694,G
3-PA,328,0,693,0,0,693,T
3-PA,329,692,0,0,0,692,A
3-PA,330,0,693,0,0,693,T
3-PA,331,0,0,689,0,689,G
3-PA,332,723,0,1,0,724,A
3-PA,333,0,716,0,0,716,T
3-PA,334,0,725,0,0,725,T
3-PA,335,725,0,0,0,725,A
3-PA,336,0,1,0,724,725,C
3-PA,337,733,0,1,0,734,A
3-PA,338,733,0,0,0,733,A
3-PA,339,0,1,731,0,732,G
3-PA,340,0,1,736,0,737,G
3-PA,341,698,0,1,0,699,A
3-PA,342,0,0,712,0,712,G
3-PA,343,708,0,1,0,709,A
3-PA,344,709,0,2,0,711,A
3-PA,345,0,0,0,711,711,C
3-PA,346,699,0,1,0,700,A
3-PA,347,0,1,700,0,701,G
3-PA,348,695,0,0,0,695,A
3-PA,349,0,690,0,0,690,T
3-PA,350,0,690,0,0,690,T
3-PA,351,3,1,0,677,681,C
3-PA,352,681,0,0,0,681,A
3-PA,353,0,684,0,0,684,T
3-PA,354,0,0,0,683,683,C
3-PA,355,0,1,682,0,683,G
3-PA,356,684,0,0,0,684,A
3-PA,357,684,0,0,0,684,A
3-PA,358,678,0,0,1,679,A
3-PA,359,0,684,0,0,684,T
3-PA,360,0,681,0,1,682,T
3-PA,361,0,2,677,0,679,G
3-PA,362,1,1,672,0,674,G
3-PA,363,0,2,675,0,677,G
3-PA,364,0,0,684,0,684,G
3-PA,365,0,668,0,0,668,T
3-PA,366,0,1,694,0,695,G
3-PA,367,697,0,1,0,698,A
3-PA,368,0,0,0,708,708,C
3-PA,369,706,0,0,0,706,A
3-PA,370,703,0,1,0,704,A
3-PA,371,7,0,713,0,720,G
3-PA,372,1,2,715,0,718,G
3-PA,373,710,0,0,0,710,A
3-PA,374,0,2,709,0,711,G
3-PA,375,687,0,4,0,691,A
3-PA,376,0,0,697,0,697,G
3-PA,377,684,0,0,0,684,A
3-PA,378,678,0,0,0,678,A
3-PA,379,0,0,695,0,695,G
3-PA,380,0,683,0,0,683,T
3-PA,381,0,1,0,680,681,C
3-PA,382,0,0,0,690,690,C
3-PA,383,688,0,1,0,689,A
3-PA,384,0,0,0,699,699,C
3-PA,385,722,0,1,0,723,A
3-PA,386,0,734,0,1,735,T
3-PA,387,744,0,0,0,744,A
3-PA,388,0,727,0,0,727,T
3-PA,389,716,0,0,0,716,A
3-PA,390,0,705,0,1,706,T
3-PA,391,0,700,0,0,700,T
3-PA,392,718,0,0,0,718,A
3-PA,393,0,0,0,722,722,C
3-PA,394,1,0,0,702,703,C
3-PA,395,0,690,0,0,690,T
3-PA,396,0,681,0,1,682,T
3-PA,397,0,3,678,0,681,G
3-PA,398,683,0,0,0,683,A
3-PA,399,684,0,0,0,684,A
3-PA,400,682,0,0,0,682,A
3-PA,401,652,0,2,0,654,A
3-PA,402,0,0,657,0,657,G
3-PA,403,1,1,650,0,652,G
3-PA,404,0,0,0,652,652,C
3-PA,405,1,0,0,659,660,C
3-PA,406,659,0,0,0,659,A
3-PA,407,654,0,1,0,655,A
3-PA,408,0,657,0,0,657,T
3-PA,409,660,0,0,0,660,A
3-PA,410,658,0,0,0,658,A
3-PA,411,0,1,672,0,673,G
3-PA,412,662,0,1,0,663,A
3-PA,413,0,662,0,0,662,T
3-PA,414,0,661,0,0,661,T
3-PA,415,667,0,0,0,667,A
3-PA,416,665,0,0,0,665,A
3-PA,417,664,0,0,0,664,A
3-PA,418,0,669,0,0,669,T
3-PA,419,0,0,0,673,673,C
3-PA,420,0,656,0,0,656,T
3-PA,421,0,0,666,0,666,G
3-PA,422,665,0,0,0,665,A
3-PA,423,0,2,672,0,674,G
3-PA,424,673,0,1,0,674,A
3-PA,425,669,0,3,0,672,A
3-PA,426,0,0,0,679,679,C
3-PA,427,668,0,0,0,668,A
3-PA,428,0,0,0,669,669,C
3-PA,429,671,0,0,0,671,A
3-PA,430,1,1,0,674,676,C
3-PA,431,671,0,1,0,672,A
3-PA,432,0,1,0,682,683,C
3-PA,433,678,0,0,0,678,A
3-PA,434,0,680,0,0,680,T
3-PA,435,0,673,0,0,673,T
3-PA,436,2,0,0,678,680,C
3-PA,437,672,0,2,0,674,A
3-PA,438,0,1,0,681,682,C
3-PA,439,676,0,0,0,676,A
3-PA,440,0,675,0,0,675,T
3-PA,441,0,649,0,0,649,T
3-PA,442,0,655,0,1,656,T
3-PA,443,0,655,0,1,656,T
3-PA,444,2,0,0,672,674,C
3-PA,445,0,670,0,1,671,T
3-PA,446,0,0,0,673,673,C
3-PA,447,663,0,0,0,663,A
3-PA,448,0,664,0,0,664,T
3-PA,449,0,665,0,0,665,T
3-PA,450,3,0,0,666,669,C
3-PA,451,660,0,0,0,660,A
3-PA,452,1,0,0,667,668,C
3-PA,453,0,664,0,0,664,T
3-PA,454,0,2,679,0,681,G
3-PA,455,0,0,680,0,680,G
3-PA,456,0,1,683,0,684,G
3-PA,457,0,0,688,0,688,G
3-PA,458,680,0,3,0,683,A
3-PA,459,0,1,689,0,690,G
3-PA,460,0,2,686,0,688,G
3-PA,461,686,0,1,0,687,A
3-PA,462,688,0,0,0,688,A
3-PA,463,664,0,0,0,664,A
3-PA,464,0,659,0,0,659,T
3-PA,465,0,1,656,0,657,G
3-PA,466,0,0,648,0,648,G
3-PA,467,0,0,0,657,657,C
3-PA,468,0,0,0,658,658,C
3-PA,469,658,0,0,0,658,A
3-PA,470,0,0,0,656,656,C
3-PA,471,661,0,0,0,661,A
3-PA,472,662,0,0,0,662,A
3-PA,473,659,0,0,0,659,A
3-PA,474,0,0,651,0,651,G
3-PA,475,0,0,654,0,654,G
3-PA,476,0,1,0,651,652,C
3-PA,477,652,0,0,0,652,A
3-PA,478,0,0,669,0,669,G
3-PA,479,667,0,2,0,669,A
3-PA,480,0,0,0,677,677,C
3-PA,481,0,666,0,1,667,T
3-PA,482,670,0,1,0,671,A
3-PA,483,0,0,0,672,672,C
3-PA,484,663,0,0,0,663,A
3-PA,485,0,0,0,667,667,C
3-PA,486,0,645,0,1,646,T
3-PA,487,1,0,0,649,650,C
3-PA,488,1,639,0,0,640,T
3-PA,489,1,0,0,639,640,C
3-PA,490,0,0,638,0,638,G
3-PA,491,630,0,1,0,631,A
3-PA,492,0,0,0,636,636,C
3-PA,493,0,3,632,0,635,G
3-PA,494,626,0,0,0,626,A
3-PA,495,0,0,626,0,626,G
3-PA,496,0,0,623,0,623,G
3-PA,497,629,0,0,0,629,A
3-PA,498,630,0,1,0,631,A
3-PA,499,628,0,1,0,629,A
3-PA,500,0,1,625,0,626,G
3-PA,501,1,0,0,620,621,C
3-PA,502,620,0,0,0,620,A
3-PA,503,0,0,627,0,627,G
3-PA,504,3,0,625,0,628,G
3-PA,505,0,0,628,1,629,G
3-PA,506,0,1,0,624,625,C
3-PA,507,0,624,0,0,624,T
3-PA,508,625,0,0,0,625,A
3-PA,509,0,1,637,0,638,G
3-PA,510,0,1,665,0,666,G
3-PA,511,673,0,0,0,673,A
3-PA,512,0,655,0,0,655,T
3-PA,513,0,640,0,1,641,T
3-PA,514,645,0,1,0,646,A
3-PA,515,656,0,1,0,657,A
3-PA,516,0,0,658,0,658,G
3-PA,517,658,0,0,0,658,A
3-PA,518,0,0,0,653,653,C
3-PA,519,1,0,0,617,618,C
3-PA,520,610,0,0,0,610,A
3-PA,521,0,2,617,0,619,G
3-PA,522,0,0,615,0,615,G
3-PA,523,0,0,0,619,619,C
3-PA,524,0,572,0,0,572,T
3-PA,525,0,1,578,0,579,G
3-PA,526,0,565,0,1,566,T
3-PA,527,0,571,0,1,572,T
3-PA,528,2,2,0,554,558,C
3-PA,529,559,0,1,0,560,A
3-PA,530,0,1,0,586,587,C
3-PA,531,0,1,0,594,595,C
3-PA,532,595,0,1,0,596,A
3-PA,533,0,593,0,0,593,T
3-PA,534,573,0,0,0,573,A
3-PA,535,577,0,0,0,577,A
3-PA,536,0,0,580,0,580,G
3-PA,537,568,1,1,0,570,A
3-PA,538,1,0,0,575,576,C
3-PA,539,544,0,1,0,545,A
3-PA,540,545,0,1,0,546,A
3-PA,541,0,1,553,0,554,G
3-PA,542,550,0,1,0,551,A
3-PA,543,550,0,0,0,550,A
3-PA,544,548,0,0,0,548,A
3-PA,545,0,526,0,0,526,T
3-PA,546,1,0,545,0,546,G
3-PA,547,0,0,543,0,543,G
3-PA,548,0,0,0,540,540,C
3-PA,549,0,537,0,1,538,T
3-PA,550,550,1,0,0,551,A
3-PA,551,550,0,1,0,551,A
3-PA,552,0,1,0,547,548,C
3-PA,553,545,0,0,0,545,A
3-PA,554,0,0,539,0,539,G
3-PA,555,533,0,0,0,533,A
3-PA,556,0,1,531,0,532,G
3-PA,557,0,0,535,0,535,G
3-PA,558,0,0,0,534,534,C
3-PA,559,0,0,0,545,545,C
3-PA,560,0,534,0,0,534,T
3-PA,561,0,0,0,548,548,C
3-PA,562,0,547,0,0,547,T
3-PA,563,0,1,550,0,551,G
3-PA,564,0,0,547,0,547,G
3-PA,565,0,0,540,0,540,G
3-PA,566,538,0,0,0,538,A
3-PA,567,0,518,0,3,521,T
3-PA,568,0,518,0,1,519,T
3-PA,569,1,0,0,668,669,C
3-PA,570,1,0,0,655,656,C
3-PA,571,0,660,0,0,660,T
3-PA,572,0,655,0,1,656,T
3-PA,573,0,665,0,0,665,T
3-PA,574,0,1,0,684,685,C
3-PA,575,1,1,684,0,686,G
3-PA,576,0,685,0,2,687,T
3-PA,577,4,0,0,685,689,C
3-PA,578,677,0,0,0,677,A
3-PA,579,0,0,887,0,887,G
3-PA,580,0,901,0,1,902,T
3-PA,581,1,0,0,902,903,C
3-PA,582,1,1,0,917,919,C
3-PA,583,1,6,921,0,928,G
3-PA,584,923,0,1,0,924,A
3-PA,585,933,0,0,0,933,A
3-PA,586,933,0,2,0,935,A
3-PA,587,6,1,966,0,973,G
3-PA,588,942,0,1,0,943,A
3-PA,589,0,0,964,0,964,G
3-PA,590,0,1,957,0,958,G
3-PA,591,0,0,0,963,963,C
3-PA,592,1,4,963,0,968,G
3-PA,593,972,0,1,0,973,A
3-PA,594,975,0,1,0,976,A
3-PA,595,0,1,987,0,988,G
3-PA,596,1005,0,2,0,1007,A
3-PA,597,1002,0,3,0,1005,A
3-PA,598,989,0,2,0,991,A
3-PA,599,0,0,0,1009,1009,C
3-PA,600,1001,0,0,0,1001,A
3-PA,601,1011,0,0,0,1011,A
3-PA,602,0,1009,0,0,1009,T
3-PA,603,0,1006,0,2,1008,T
3-PA,604,0,1,1012,0,1013,G
3-PA,605,1006,0,0,0,1006,A
3-PA,606,1004,0,1,0,1005,A
3-PA,607,0,0,1011,0,1011,G
3-PA,608,1007,0,2,0,1009,A
3-PA,609,1011,0,1,0,1012,A
3-PA,610,1005,0,0,0,1005,A
3-PA,611,1010,0,1,0,1011,A
3-PA,612,1010,0,0,0,1010,A
3-PA,613,0,1009,1,0,1010,T
3-PA,614,0,1018,0,0,1018,T
3-PA,615,0,1023,0,0,1023,T
3-PA,616,0,1,1018,0,1019,G
3-PA,617,1018,1,1,0,1020,A
3-PA,618,1020,1,0,0,1021,A
3-PA,619,1029,0,0,0,1029,A
3-PA,620,0,1051,0,0,1051,T
3-PA,621,4,0,0,1222,1226,C
3-PA,622,1221,0,1,0,1222,A
3-PA,623,0,0,0,1247,1247,C
3-PA,624,1244,1,1,0,1246,A
3-PA,625,0,1,1281,0,1282,G
3-PA,626,1,2,1317,0,1320,G
3-PA,627,1354,0,4,0,1358,A
3-PA,628,1393,0,1,0,1394,A
3-PA,629,0,0,0,1416,1416,C
3-PA,630,0,1370,0,0,1370,T
3-PA,631,1513,0,2,0,1515,A
3-PA,632,0,1530,0,2,1532,T
3-PA,633,4,1,1620,0,1625,G
3-PA,634,1,2,0,1618,1621,C
3-PA,635,2,0,1601,0,1603,G
3-PA,636,0,1593,0,1,1594,T
3-PA,637,1596,0,0,0,1596,A
3-PA,638,0,0,1616,0,1616,G
3-PA,639,0,0,1604,0,1604,G
3-PA,640,0,0,0,1590,1590,C
3-PA,641,0,1572,0,1,1573,T
3-PA,642,0,1563,0,0,1563,T
3-PA,643,1,0,1556,0,1557,G
3-PA,644,0,1,0,1553,1554,C
3-PA,645,1,1,0,1565,1567,C
3-PA,646,0,3,1583,0,1586,G
3-PA,647,1585,1,1,0,1587,A
3-PA,648,1,0,0,1603,1604,C
3-PA,649,2,0,0,1595,1597,C
3-PA,650,1618,0,0,0,1618,A
3-PA,651,1623,0,0,0,1623,A
3-PA,652,1623,0,0,0,1623,A
3-PA,653,1,0,1665,0,1666,G
3-PA,654,0,1645,2,5,1652,T
3-PA,655,3,1,0,1657,1661,C
3-PA,656,0,1658,0,3,1661,T
3-PA,657,1,2,0,1666,1669,C
3-PA,658,3,0,0,1683,1686,C
3-PA,659,4,0,0,1688,1692,C
3-PA,660,1694,0,1,1,1696,A
3-PA,661,0,1,0,1709,1710,C
3-PA,662,1,1,0,1693,1695,C
3-PA,663,1,3,1716,0,1720,G
3-PA,664,1739,0,1,0,1740,A
3-PA,665,1732,0,1,0,1733,A
3-PA,666,1,1,0,1749,1751,C
3-PA,667,0,1740,0,4,1744,T
3-PA,668,0,1786,0,1,1787,T
3-PA,669,4,0,0,1829,1833,C
3-PA,670,0,1817,0,3,1820,T
3-PA,671,5,0,0,1827,1832,C
3-PA,672,1,0,0,1834,1835,C
3-PA,673,1,1813,0,7,1821,T
3-PA,674,0,0,1845,0,1845,G
3-PA,675,2,0,0,1841,1843,C
3-PA,676,2,1,0,1844,1847,C
3-PA,677,0,1848,0,1,1849,T
3-PA,678,0,1840,0,3,1843,T
3-PA,679,0,5,1842,0,1847,G
3-PA,680,1841,0,4,0,1845,A
3-PA,681,0,5,1864,0,1869,G
3-PA,682,1857,0,4,0,1861,A
3-PA,683,1880,0,0,0,1880,A
3-PA,684,0,1928,0,0,1928,T
3-PA,685,0,1938,0,1,1939,T
3-PA,686,1,1933,0,0,1934,T
3-PA,687,0,1943,0,0,1943,T
3-PA,688,1939,0,2,0,1941,A
3-PA,689,1,1,1923,0,1925,G
3-PA,690,1916,1,3,0,1920,A
3-PA,691,1,0,1991,0,1992,G
3-PA,692,0,0,0,1982,1982,C
3-PA,693,5,0,0,2004,2009,C
3-PA,694,0,2058,0,4,2062,T
3-PA,695,2186,0,0,0,2186,A
3-PA,696,0,2183,0,1,2184,T
3-PA,697,0,1,2205,0,2206,G
3-PA,698,2,2194,0,1,2197,T
3-PA,699,1,4,2204,0,2209,G
3-PA,700,2,2,2166,3,2173,G
3-PA,701,2161,0,4,0,2165,A
3-PA,702,0,2132,0,0,2132,T
3-PA,703,0,2,2094,0,2096,G
3-PA,704,1,1,2167,0,2169,G
3-PA,705,2178,0,0,0,2178,A
3-PA,706,0,2157,0,0,2157,T
3-PA,707,0,2163,0,0,2163,T
3-PA,708,5,0,0,2154,2159,C
3-PA,709,16,9,2136,0,2161,G
3-PA,710,2168,0,1,0,2169,A
3-PA,711,2165,0,2,0,2167,A
3-PA,712,0,0,0,2186,2186,C
3-PA,713,1,2,0,2128,2131,C
3-PA,714,1,0,2138,0,2139,G
3-PA,715,2128,0,1,0,2129,A
3-PA,716,2135,0,5,0,2140,A
3-PA,717,0,2,0,2168,2170,C
3-PA,718,0,3,2155,0,2158,G
3-PA,719,0,0,2221,0,2221,G
3-PA,720,1,0,0,2230,2231,C
3-PA,721,1,2215,0,6,2222,T
3-PA,722,3,0,2303,0,2306,G
3-PA,723,0,0,0,2322,2322,C
3-PA,724,2336,1,3,0,2340,A
3-PA,725,0,2336,0,2,2338,T
3-PA,726,0,2324,0,1,2325,T
3-PA,727,3,3,2320,0,2326,G
3-PA,728,2246,0,3,0,2249,A
3-PA,729,0,5,2266,0,2271,G
3-PA,730,2,2,2274,0,2278,G
3-PA,731,2,1,2258,0,2261,G
3-PA,732,0,2,0,2251,2253,C
3-PA,733,2249,0,0,0,2249,A
3-PA,734,2258,0,1,1,2260,A
3-PA,735,0,1,2270,0,2271,G
3-PA,736,0,1,0,2287,2288,C
3-PA,737,0,2290,0,4,2294,T
3-PA,738,0,2281,0,1,2282,T
3-PA,739,0,2295,1,1,2297,T
3-PA,740,3,1,0,2301,2305,C
3-PA,741,0,2293,0,2,2295,T
3-PA,742,5,2,0,2301,2308,C
3-PA,743,2306,0,0,1,2307,A
3-PA,744,2288,0,0,0,2288,A
3-PA,745,2280,0,2,1,2283,A
3-PA,746,0,2278,0,0,2278,T
3-PA,747,0,0,2359,0,2359,G
3-PA,748,0,2338,0,4,2342,T
3-PA,749,3,1,0,2364,2368,C
3-PA,750,3,2,0,2366,2371,C
3-PA,751,2389,0,2,0,2391,A
3-PA,752,2399,0,4,0,2403,A
3-PA,753,2399,1,6,0,2406,A
3-PA,754,0,3,2463,0,2466,G
3-PA,755,2454,0,0,1,2455,A
3-PA,756,2400,0,4,1,2405,A
3-PA,757,0,0,2418,0,2418,G
3-PA,758,0,2389,0,2,2391,T
3-PA,759,3,4,2390,0,2397,G
3-PA,760,2387,0,2,0,2389,A
3-PA,761,2373,0,0,0,2373,A
3-PA,762,1,2384,0,0,2385,T
3-PA,763,1,3,2364,1,2369,G
3-PA,764,1,2,0,2382,2385,C
3-PA,765,2,0,1,2382,2385,C
3-PA,766,4,0,0,2385,2389,C
3-PA,767,2383,0,1,0,2384,A
3-PA,768,2415,0,1,0,2416,A
3-PA,769,2440,0,0,0,2440,A
3-PA,770,0,2432,0,0,2432,T
3-PA,771,0,2421,0,2,2423,T
3-PA,772,3,5,2420,0,2428,G
3-PA,773,2394,1,3,1,2399,A
3-PA,774,2400,0,3,0,2403,A
3-PA,775,1,1,0,2404,2406,C
3-PA,776,3,0,0,2415,2418,C
3-PA,777,0,2377,0,4,2381,T
3-PA,778,0,2461,0,1,2462,T
3-PA,779,0,2469,0,2,2471,T
3-PA,780,0,2544,0,0,2544,T
3-PA,781,2,0,0,2548,2550,C
3-PA,782,0,2545,1,0,2546,T
3-PA,783,0,3,2545,0,2548,G
3-PA,784,2545,1,3,0,2549,A
3-PA,785,2572,0,6,0,2578,A
3-PA,786,0,10,2584,0,2594,G
3-PA,787,2562,0,3,0,2565,A
3-PA,788,0,1,0,2579,2580,C
3-PA,789,2541,0,3,0,2544,A
3-PA,790,2569,0,6,1,2576,A
3-PA,791,0,1,0,2857,2858,C
3-PA,792,2847,0,2,0,2849,A
3-PA,793,0,0,0,2868,2868,C
3-PA,794,2,1,0,2823,2826,C
3-PA,795,2819,0,4,0,2823,A
3-PA,796,2818,0,5,0,2823,A
3-PA,797,0,4,2822,0,2826,G
3-PA,798,2818,0,2,0,2820,A
3-PA,799,3,1,0,2822,2826,C
3-PA,800,2,2,0,2607,2611,C
3-PA,801,2600,0,1,0,2601,A
3-PA,802,2605,0,2,0,2607,A
3-PA,803,1,2606,0,0,2607,T
3-PA,804,3,0,0,2616,2619,C
3-PA,805,2620,0,1,0,2621,A
3-PA,806,2604,0,1,0,2605,A
3-PA,807,2589,0,1,1,2591,A
3-PA,808,1,0,0,2627,2628,C
3-PA,809,0,2602,0,0,2602,T
3-PA,810,0,2619,0,0,2619,T
3-PA,811,4,2,0,2636,2642,C
3-PA,812,3,2,0,2636,2641,C
3-PA,813,3,6,2653,0,2662,G
3-PA,814,2661,0,0,0,2661,A
3-PA,815,2658,0,1,1,2660,A
3-PA,816,0,2652,0,1,2653,T
3-PA,817,0,3,2609,0,2612,G
3-PA,818,0,2,2620,1,2623,G
3-PA,819,2611,0,2,0,2613,A
3-PA,820,0,3,0,2629,2632,C
3-PA,821,1,1,0,2633,2635,C
3-PA,822,0,2711,0,1,2712,T
3-PA,823,5,0,0,2796,2801,C
3-PA,824,1,1,0,2806,2808,C
3-PA,825,0,2797,0,2,2799,T
3-PA,826,0,2824,0,0,2824,T
3-PA,827,1,0,2983,0,2984,G
3-PA,828,0,2951,0,3,2954,T
3-PA,829,0,2956,0,2,2958,T
3-PA,830,2946,0,1,0,2947,A
3-PA,831,0,2845,0,1,2846,T
3-PA,832,6,0,0,2823,2829,C
3-PA,833,2762,0,1,0,2763,A
3-PA,834,2,0,2756,0,2758,G
3-PA,835,0,1,0,2747,2748,C
3-PA,836,1,2,2668,0,2671,G
3-PA,837,0,1,2747,0,2748,G
3-PA,838,0,2729,0,3,2732,T
3-PA,839,7,0,0,2752,2759,C
3-PA,840,4,1,0,2754,2759,C
3-PA,841,2791,0,0,0,2791,A
3-PA,842,2797,0,1,0,2798,A
3-PA,843,2802,0,0,0,2802,A
3-PA,844,0,2801,0,0,2801,T
3-PA,845,0,2807,0,0,2807,T
3-PA,846,3,0,0,2781,2784,C
3-PA,847,2,0,1,2742,2745,C
3-PA,848,0,2744,0,2,2746,T
3-PA,849,3,0,0,2757,2760,C
3-PA,850,1,0,1,2772,2774,C
3-PA,851,0,2774,0,2,2776,T
3-PA,852,1,2,2805,0,2808,G
3-PA,853,2786,0,0,0,2786,A
3-PA,854,0,2803,0,0,2803,T
3-PA,855,3,5,2760,0,2768,G
3-PA,856,2,3,2745,0,2750,G
3-PA,857,2726,0,4,0,2730,A
3-PA,858,0,2714,0,0,2714,T
3-PA,859,1,0,2723,0,2724,G
3-PA,860,1,0,0,2860,2861,C
3-PA,861,0,2847,0,1,2848,T
3-PA,862,0,2862,0,0,2862,T
3-PA,863,0,2862,0,3,2865,T
3-PA,864,2867,0,1,0,2868,A
3-PA,865,2874,1,3,0,2878,A
3-PA,866,2876,0,2,0,2878,A
3-PA,867,2884,0,2,0,2886,A
3-PA,868,0,2882,0,0,2882,T
3-PA,869,0,2691,0,1,2692,T
3-PA,870,0,7,2681,0,2688,G
3-PA,871,2662,0,0,0,2662,A
3-PA,872,1,1,2690,0,2692,G
3-PA,873,0,1,0,2702,2703,C
3-PA,874,2690,0,0,0,2690,A
3-PA,875,0,2750,0,1,2751,T
3-PA,876,0,2758,0,0,2758,T
3-PA,877,0,1,2733,0,2734,G
3-PA,878,2748,0,3,0,2751,A
3-PA,879,2726,0,11,0,2737,A
3-PA,880,0,3,2748,0,2751,G
3-PA,881,2709,0,4,1,2714,A
3-PA,882,2,0,0,2731,2733,C
3-PA,883,5,1,0,2717,2723,C
3-PA,884,4,0,0,2679,2683,C
3-PA,885,2658,0,6,0,2664,A
3-PA,886,2666,0,3,0,2669,A
3-PA,887,0,0,2681,0,2681,G
3-PA,888,0,2668,0,1,2669,T
3-PA,889,10,0,0,2670,2680,C
3-PA,890,2693,0,0,0,2693,A
3-PA,891,0,9,0,2677,2686,C
3-PA,892,3,2,2685,0,2690,G
3-PA,893,2711,0,5,1,2717,A
3-PA,894,2718,0,4,0,2722,A
3-PA,895,1,6,2780,0,2787,G
3-PA,896,0,7,2786,0,2793,G
3-PA,897,2734,0,3,0,2737,A
3-PA,898,4,5,2776,0,2785,G
3-PA,899,2770,0,4,0,2774,A
3-PA,900,2775,0,5,0,2780,A
3-PA,901,1,2,2774,0,2777,G
3-PA,902,1,2,2721,0,2724,G
3-PA,903,2,5,2743,0,2750,G
3-PA,904,2643,0,3,0,2646,A
3-PA,905,0,2667,0,1,2668,T
3-PA,906,4,1,0,2685,2690,C
3-PA,907,2,0,0,2900,2902,C
3-PA,908,4,1,0,2918,2923,C
3-PA,909,2972,0,2,0,2974,A
3-PA,910,0,2986,0,1,2987,T
3-PA,911,0,2992,0,0,2992,T
3-PA,912,3089,0,0,0,3089,A
3-PA,913,0,3080,0,3,3083,T
3-PA,914,3067,0,4,1,3072,A
3-PA,915,0,3055,0,2,3057,T
3-PA,916,1,8,2752,0,2761,G
3-PA,917,2757,0,1,0,2758,A
3-PA,918,0,2711,0,2,2713,T
3-PA,919,2,2,2738,0,2742,G
3-PA,920,1,3,0,2708,2712,C
3-PA,921,1,7,2690,0,2698,G
3-PA,922,2715,0,0,0,2715,A
3-PA,923,0,2705,0,3,2708,T
3-PA,924,5,1,0,2729,2735,C
3-PA,925,2721,0,1,0,2722,A
3-PA,926,2697,0,4,0,2701,A
3-PA,927,2,0,2730,0,2732,G
3-PA,928,0,2684,1,0,2685,T
3-PA,929,1,0,2721,0,2722,G
3-PA,930,0,0,0,2722,2722,C
3-PA,931,2715,1,3,0,2719,A
3-PA,932,0,2732,0,0,2732,T
3-PA,933,2732,0,2,0,2734,A
3-PA,934,2775,1,1,0,2777,A
3-PA,935,2769,0,0,0,2769,A
3-PA,936,2761,0,4,0,2765,A
3-PA,937,2749,0,4,1,2754,A
3-PA,938,0,1,0,2768,2769,C
3-PA,939,2735,0,0,0,2735,A
3-PA,940,0,2739,0,2,2741,T
3-PA,941,1,2732,0,1,2734,T
3-PA,942,8,1,0,2749,2758,C
3-PA,943,1,2723,0,2,2726,T
3-PA,944,0,2718,0,3,2721,T
3-PA,945,0,2726,0,0,2726,T
3-PA,946,0,2,2729,1,2732,G
3-PA,947,1,0,2728,0,2729,G
3-PA,948,2708,0,3,0,2711,A
3-PA,949,0,2711,0,0,2711,T
3-PA,950,2,2,2744,0,2748,G
3-PA,951,0,5,2774,0,2779,G
3-PA,952,2776,0,2,0,2778,A
3-PA,953,2791,0,2,0,2793,A
3-PA,954,2793,0,3,0,2796,A
3-PA,955,1,1,2813,0,2815,G
3-PA,956,2804,0,4,0,2808,A
3-PA,957,3045,0,7,0,3052,A
3-PA,958,0,0,0,3120,3120,C
3-PA,959,2,1,0,3116,3119,C
3-PA,960,0,3096,0,1,3097,T
3-PA,961,0,3168,0,0,3168,T
3-PA,962,3181,1,0,0,3182,A
3-PA,963,0,3184,0,1,3185,T
3-PA,964,3162,0,1,0,3163,A
3-PA,965,1,3235,0,1,3237,T
3-PA,966,2958,0,3,1,2962,A
3-PA,967,0,2,2970,0,2972,G
3-PA,968,0,2944,0,7,2951,T
3-PA,969,2,0,0,2940,2942,C
3-PA,970,2898,0,0,0,2898,A
3-PA,971,2889,0,2,0,2891,A
3-PA,972,2898,0,2,0,2900,A
3-PA,973,1,1,0,2916,2918,C
3-PA,974,1,1,0,2877,2879,C
3-PA,975,2840,0,0,1,2841,A
3-PA,976,1,1,0,2858,2860,C
3-PA,977,2849,0,6,0,2855,A
3-PA,978,1,2,0,2880,2883,C
3-PA,979,0,7,2877,0,2884,G
3-PA,980,2855,0,0,0,2855,A
3-PA,981,2865,0,3,0,2868,A
3-PA,982,2862,0,1,1,2864,A
3-PA,983,2858,0,0,1,2859,A
3-PA,984,0,4,2876,1,2881,G
3-PA,985,2,2,2863,0,2867,G
3-PA,986,0,4,2869,0,2873,G
3-PA,987,2875,0,6,0,2881,A
3-PA,988,2889,0,3,0,2892,A
3-PA,989,0,2891,1,0,2892,T
3-PA,990,2896,0,1,0,2897,A
3-PA,991,2898,0,0,0,2898,A
3-PA,992,2902,0,0,0,2902,A
3-PA,993,0,2889,0,0,2889,T
3-PA,994,0,2876,1,1,2878,T
3-PA,995,8,1,0,2883,2892,C
3-PA,996,2893,0,0,0,2893,A
3-PA,997,2891,0,1,0,2892,A
3-PA,998,2889,0,1,0,2890,A
3-PA,999,0,2883,0,0,2883,T
3-PA,1000,0,2888,0,2,2890,T
3-PA,1001,2893,1,0,0,2894,A
3-PA,1002,0,1,0,2908,2909,C
3-PA,1003,1,0,0,2899,2900,C
3-PA,1004,0,2869,0,3,2872,T
3-PA,1005,0,0,2905,0,2905,G
3-PA,1006,0,0,0,2907,2907,C
3-PA,1007,0,2915,0,0,2915,T
3-PA,1008,0,0,2968,0,2968,G
3-PA,1009,1,2966,0,4,2971,T
3-PA,1010,7,0,0,2990,2997,C
3-PA,1011,2991,0,6,0,2997,A
3-PA,1012,0,2999,0,1,3000,T
3-PA,1013,2,2,2987,0,2991,G
3-PA,1014,1,5,2979,0,2985,G
3-PA,1015,2985,0,3,0,2988,A
3-PA,1016,3045,0,1,0,3046,A
3-PA,1017,0,1,3015,0,3016,G
3-PA,1018,1,5,0,3025,3031,C
3-PA,1019,3014,0,4,0,3018,A
3-PA,1020,3028,0,1,0,3029,A
3-PA,1021,2,0,3046,0,3048,G
3-PA,1022,0,3036,0,0,3036,T
3-PA,1023,3025,0,10,0,3035,A
3-PA,1024,1,0,0,3037,3038,C
3-PA,1025,1,2966,0,0,2967,T
3-PA,1026,0,1,3006,0,3007,G
3-PA,1027,0,2972,0,2,2974,T
3-PA,1028,10,1,0,2972,2983,C
3-PA,1029,2974,0,1,0,2975,A
3-PA,1030,1,7,3004,0,3012,G
3-PA,1031,2999,0,0,0,2999,A
3-PA,1032,2999,0,3,1,3003,A
3-PA,1033,0,3066,0,1,3067,T
3-PA,1034,0,3050,0,4,3054,T
3-PA,1035,1,1,3035,0,3037,G
3-PA,1036,1,2,0,3028,3031,C
3-PA,1037,3034,1,2,0,3037,A
3-PA,1038,0,2,3053,1,3056,G
3-PA,1039,0,6,3011,0,3017,G
3-PA,1040,3028,0,2,0,3030,A
3-PA,1041,0,2,0,3057,3059,C
3-PA,1042,2975,0,2,0,2977,A
3-PA,1043,0,3008,0,1,3009,T
3-PA,1044,0,3010,0,1,3011,T
3-PA,1045,1,4,3028,0,3033,G
3-PA,1046,3044,0,2,0,3046,A
3-PA,1047,3038,2,0,0,3040,A
3-PA,1048,3032,0,0,0,3032,A
3-PA,1049,3012,1,1,0,3014,A
3-PA,1050,0,2981,0,2,2983,T
3-PA,1051,2,5,3000,0,3007,G
3-PA,1052,2978,1,7,0,2986,A
3-PA,1053,1,3,3002,0,3006,G
3-PA,1054,2,8,2986,0,2996,G
3-PA,1055,2984,1,1,0,2986,A
3-PA,1056,0,1,3006,0,3007,G
3-PA,1057,3006,0,3,0,3009,A
3-PA,1058,3000,0,3,1,3004,A
3-PA,1059,0,4,3019,0,3023,G
3-PA,1060,3020,0,4,0,3024,A
3-PA,1061,0,3024,0,1,3025,T
3-PA,1062,1,2992,0,2,2995,T
3-PA,1063,5,1,0,3022,3028,C
3-PA,1064,3,0,0,3018,3021,C
3-PA,1065,3012,1,1,1,3015,A
3-PA,1066,3014,0,1,0,3015,A
3-PA,1067,1,7,3020,0,3028,G
3-PA,1068,5,3,3066,0,3074,G
3-PA,1069,3052,0,2,0,3054,A
3-PA,1070,0,2,0,3062,3064,C
3-PA,1071,0,3085,0,0,3085,T
3-PA,1072,3086,0,0,0,3086,A
3-PA,1073,3079,0,4,0,3083,A
3-PA,1074,3081,0,0,1,3082,A
3-PA,1075,3093,0,3,0,3096,A
3-PA,1076,3069,0,1,2,3072,A
3-PA,1077,1,2,0,3040,3043,C
3-PA,1078,3028,0,2,0,3030,A
3-PA,1079,0,3010,0,1,3011,T
3-PA,1080,0,3,3044,0,3047,G
3-PA,1081,3030,0,7,1,3038,A
3-PA,1082,3035,0,3,0,3038,A
3-PA,1083,1,7,3060,0,3068,G
3-PA,1084,3066,0,1,0,3067,A
3-PA,1085,3064,1,0,0,3065,A
3-PA,1086,3044,0,1,0,3045,A
3-PA,1087,3028,0,1,0,3029,A
3-PA,1088,0,2,0,3054,3056,C
3-PA,1089,1,14,3029,0,3044,G
3-PA,1090,3045,1,4,0,3050,A
3-PA,1091,0,0,3043,0,3043,G
3-PA,1092,1,3011,0,2,3014,T
3-PA,1093,12,4,0,3088,3104,C
3-PA,1094,3110,0,2,0,3112,A
3-PA,1095,3167,0,1,1,3169,A
3-PA,1096,0,2,0,3168,3170,C
3-PA,1097,0,3171,0,1,3172,T
3-PA,1098,1,2,3228,0,3231,G
3-PA,1099,3205,0,1,0,3206,A
3-PA,1100,3224,0,3,0,3227,A
3-PA,1101,3,1,3237,0,3241,G
3-PA,1102,2,3143,1,5,3151,T
3-PA,1103,3,7,3167,0,3177,G
3-PA,1104,0,0,3145,0,3145,G
3-PA,1105,2,1,3157,0,3160,G
3-PA,1106,1,2,0,3171,3174,C
3-PA,1107,0,3134,0,7,3141,T
3-PA,1108,2,0,0,3181,3183,C
3-PA,1109,0,3158,0,1,3159,T
3-PA,1110,0,3177,1,0,3178,T
3-PA,1111,3,3,3235,0,3241,G
3-PA,1112,0,1,3256,1,3258,G
3-PA,1113,0,3216,0,5,3221,T
3-PA,1114,3,8,3230,0,3241,G
3-PA,1115,3212,0,0,0,3212,A
3-PA,1116,3243,0,5,0,3248,A
3-PA,1117,3216,0,3,1,3220,A
3-PA,1118,3226,0,2,0,3228,A
3-PA,1119,0,7,0,3255,3262,C
3-PA,1120,3206,1,1,0,3208,A
3-PA,1121,0,3193,0,2,3195,T
3-PA,1122,1,6,3195,0,3202,G
3-PA,1123,2,1,3218,0,3221,G
3-PA,1124,0,1,0,3238,3239,C
3-PA,1125,3235,0,3,0,3238,A
3-PA,1126,1,0,1,3269,3271,C
3-PA,1127,5,0,0,3269,3274,C
3-PA,1128,3308,1,3,0,3312,A
3-PA,1129,0,5,3352,0,3357,G
3-PA,1130,3328,0,3,0,3331,A
3-PA,1131,0,2,3370,0,3372,G
3-PA,1132,3367,0,1,0,3368,A
3-PA,1133,3349,0,3,0,3352,A
3-PA,1134,0,1,3384,0,3385,G
3-PA,1135,4,1,3347,0,3352,G
3-PA,1136,2,3310,0,4,3316,T
3-PA,1137,3309,0,0,0,3309,A
3-PA,1138,0,5,3312,0,3317,G
3-PA,1139,3300,0,4,0,3304,A
3-PA,1140,0,0,0,3333,3333,C
3-PA,1141,0,3298,0,1,3299,T
3-PA,1142,0,3275,0,1,3276,T
3-PA,1143,0,3285,0,2,3287,T
3-PA,1144,2,7,3284,0,3293,G
3-PA,1145,3291,0,3,1,3295,A
3-PA,1146,3294,0,1,0,3295,A
3-PA,1147,3290,0,3,0,3293,A
3-PA,1148,3273,1,1,0,3275,A
3-PA,1149,1,1,1,3364,3367,C
3-PA,1150,1,3332,0,1,3334,T
3-PA,1151,2,0,3366,0,3368,G
3-PA,1152,1,3,0,3366,3370,C
3-PA,1153,3372,0,4,1,3377,A
3-PA,1154,0,2,3378,0,3380,G
3-PA,1155,3366,1,7,0,3374,A
3-PA,1156,1,6,3555,0,3562,G
3-PA,1157,3550,0,2,0,3552,A
3-PA,1158,0,0,1,3501,3502,C
3-PA,1159,3474,0,2,0,3476,A
3-PA,1160,0,3444,0,0,3444,T
3-PA,1161,3435,0,4,0,3439,A
3-PA,1162,3,0,3313,0,3316,G
3-PA,1163,1,1,3307,0,3309,G
3-PA,1164,0,2,0,3331,3333,C
3-PA,1165,3,6,3340,0,3349,G
3-PA,1166,3397,0,2,0,3399,A
3-PA,1167,0,3400,0,1,3401,T
3-PA,1168,0,3393,0,3,3396,T
3-PA,1169,0,3402,0,0,3402,T
3-PA,1170,0,4,3414,0,3418,G
3-PA,1171,3418,1,0,0,3419,A
3-PA,1172,3408,2,3,0,3413,A
3-PA,1173,0,1,3438,0,3439,G
3-PA,1174,1,2,1,3490,3494,C
3-PA,1175,3468,2,5,0,3475,A
3-PA,1176,3711,2,2,0,3715,A
3-PA,1177,0,3719,1,1,3721,T
3-PA,1178,3744,0,2,0,3746,A
3-PA,1179,0,3765,0,0,3765,T
3-PA,1180,0,3,3766,0,3769,G
3-PA,1181,3811,0,8,1,3820,A
3-PA,1182,0,3806,0,1,3807,T
3-PA,1183,3665,0,1,0,3666,A
3-PA,1184,3,0,3666,0,3669,G
3-PA,1185,0,3516,0,2,3518,T
3-PA,1186,0,6,3541,1,3548,G
3-PA,1187,3543,3,4,0,3550,A
3-PA,1188,0,11,0,3517,3528,C
3-PA,1189,1,7,3517,0,3525,G
3-PA,1190,3534,0,0,0,3534,A
3-PA,1191,3548,0,6,0,3554,A
3-PA,1192,0,0,0,3576,3576,C
3-PA,1193,7,0,0,3580,3587,C
3-PA,1194,1,3583,0,4,3588,T
3-PA,1195,2,5,3677,0,3684,G
3-PA,1196,3662,0,2,0,3664,A
3-PA,1197,3691,0,0,1,3692,A
3-PA,1198,0,3694,0,0,3694,T
3-PA,1199,0,3671,0,1,3672,T
3-PA,1200,3655,0,4,1,3660,A
3-PA,1201,3627,0,3,0,3630,A
3-PA,1202,2,2,3636,0,3640,G
3-PA,1203,12,2,3618,0,3632,G
3-PA,1204,0,3550,0,2,3552,T
3-PA,1205,7,2,0,3549,3558,C
3-PA,1206,3544,0,3,1,3548,A
3-PA,1207,1,0,0,3694,3695,C
3-PA,1208,0,3695,0,5,3700,T
3-PA,1209,2,3702,0,1,3705,T
3-PA,1210,0,3706,0,2,3708,T
3-PA,1211,4,0,0,3709,3713,C
3-PA,1212,3711,0,4,0,3715,A
3-PA,1213,3702,0,6,0,3708,A
3-PA,1214,1,2,3770,0,3773,G
3-PA,1215,0,1,0,3772,3773,C
3-PA,1216,0,3689,0,2,3691,T
3-PA,1217,1,4,3797,0,3802,G
3-PA,1218,0,1,3814,1,3816,G
3-PA,1219,3880,0,2,0,3882,A
3-PA,1220,0,3921,0,2,3923,T
3-PA,1221,3917,1,3,0,3921,A
3-PA,1222,2,1,0,3958,3961,C
3-PA,1223,3876,0,1,1,3878,A
3-PA,1224,0,3,3921,0,3924,G
3-PA,1225,3899,0,4,0,3903,A
3-PA,1226,3806,0,1,0,3807,A
3-PA,1227,0,3775,0,1,3776,T
3-PA,1228,1,4,3806,0,3811,G
3-PA,1229,3783,0,3,0,3786,A
3-PA,1230,1,0,3824,0,3825,G
3-PA,1231,0,3789,0,5,3794,T
3-PA,1232,0,3783,0,4,3787,T
3-PA,1233,5,0,0,3869,3874,C
3-PA,1234,3886,0,2,0,3888,A
3-PA,1235,3890,0,3,0,3893,A
3-PA,1236,0,0,0,3901,3901,C
3-PA,1237,3851,0,2,0,3853,A
3-PA,1238,3838,0,3,0,3841,A
3-PA,1239,0,2,3831,0,3833,G
3-PA,1240,0,1,3850,0,3851,G
3-PA,1241,3,1,0,3861,3865,C
3-PA,1242,2,0,0,3855,3857,C
3-PA,1243,0,3820,0,6,3826,T
3-PA,1244,0,1,3891,0,3892,G
3-PA,1245,1,3877,0,1,3879,T
3-PA,1246,0,5,3928,0,3933,G
3-PA,1247,3920,0,5,0,3925,A
3-PA,1248,0,1,3928,0,3929,G
3-PA,1249,0,2,0,3894,3896,C
3-PA,1250,1,3861,0,6,3868,T
3-PA,1251,3977,1,3,0,3981,A
3-PA,1252,3968,1,2,0,3971,A
3-PA,1253,3,1,0,3991,3995,C
3-PA,1254,1,3962,0,2,3965,T
3-PA,1255,4,5,3964,0,3973,G
3-PA,1256,3927,1,5,0,3933,A
3-PA,1257,0,3945,1,0,3946,T
3-PA,1258,1,3929,0,2,3932,T
3-PA,1259,9,1,0,3946,3956,C
3-PA,1260,4078,0,1,0,4079,A
3-PA,1261,1,0,4181,0,4182,G
3-PA,1262,0,4142,1,3,4146,T
3-PA,1263,6,0,0,4160,4166,C
3-PA,1264,0,4138,0,8,4146,T
3-PA,1265,0,3,4301,0,4304,G
3-PA,1266,1,2,4305,0,4308,G
3-PA,1267,4305,0,6,0,4311,A
3-PA,1268,0,4314,0,0,4314,T
3-PA,1269,4083,0,1,0,4084,A
3-PA,1270,0,2,4086,0,4088,G
3-PA,1271,3999,1,5,0,4005,A
3-PA,1272,1,1,4007,0,4009,G
3-PA,1273,1,0,0,3985,3986,C
3-PA,1274,0,3895,0,4,3899,T
3-PA,1275,7,1,0,3917,3925,C
3-PA,1276,1,3,3945,0,3949,G
3-PA,1277,3948,0,3,0,3951,A
3-PA,1278,1,3956,0,0,3957,T
3-PA,1279,2,9,3932,0,3943,G
3-PA,1280,3992,1,1,0,3994,A
3-PA,1281,3972,0,4,0,3976,A
3-PA,1282,4003,0,2,0,4005,A
3-PA,1283,1,3984,0,0,3985,T
3-PA,1284,0,3988,0,0,3988,T
3-PA,1285,3,11,3959,0,3973,G
3-PA,1286,8,2,3949,0,3959,G
3-PA,1287,2,1,3896,0,3899,G
3-PA,1288,0,4,3953,1,3958,G
3-PA,1289,3964,0,6,0,3970,A
3-PA,1290,2,6,3986,0,3994,G
3-PA,1291,0,1,4011,0,4012,G
3-PA,1292,4061,0,1,0,4062,A
3-PA,1293,2,0,0,4065,4067,C
3-PA,1294,7,0,4046,0,4053,G
3-PA,1295,0,4040,0,0,4040,T
3-PA,1296,4072,0,1,1,4074,A
3-PA,1297,5,1,4087,0,4093,G
3-PA,1298,4,1,0,4114,4119,C
3-PA,1299,5,2,0,4039,4046,C
3-PA,1300,2,0,0,4015,4017,C
3-PA,1301,2,2,0,4047,4051,C
3-PA,1302,4055,0,0,0,4055,A
3-PA,1303,4227,0,0,1,4228,A
3-PA,1304,0,4207,0,1,4208,T
3-PA,1305,0,4187,0,3,4190,T
3-PA,1306,0,9,4165,0,4174,G
3-PA,1307,4088,0,6,0,4094,A
3-PA,1308,1,7,4103,0,4111,G
3-PA,1309,0,0,0,4094,4094,C
3-PA,1310,4070,0,1,0,4071,A
3-PA,1311,0,1,0,4183,4184,C
3-PA,1312,4091,0,3,0,4094,A
3-PA,1313,0,4201,0,3,4204,T
3-PA,1314,0,4214,0,1,4215,T
3-PA,1315,0,0,4220,0,4220,G
3-PA,1316,1,0,0,4193,4194,C
3-PA,1317,4200,0,4,0,4204,A
3-PA,1318,4204,0,5,0,4209,A
3-PA,1319,0,1,4205,0,4206,G
3-PA,1320,2,1,0,4159,4162,C
3-PA,1321,4147,0,1,1,4149,A
3-PA,1322,0,4034,3,1,4038,T
3-PA,1323,3,4,4038,0,4045,G
3-PA,1324,4009,0,3,1,4013,A
3-PA,1325,1,3,4043,1,4048,G
3-PA,1326,4032,0,10,1,4043,A
3-PA,1327,4052,0,1,0,4053,A
3-PA,1328,1,3,4017,0,4021,G
3-PA,1329,1,7,4011,0,4019,G
3-PA,1330,4023,0,3,0,4026,A
3-PA,1331,4020,0,2,0,4022,A
3-PA,1332,0,4004,0,0,4004,T
3-PA,1333,0,4008,0,1,4009,T
3-PA,1334,4023,0,1,0,4024,A
3-PA,1335,0,4026,0,0,4026,T
3-PA,1336,0,4019,0,1,4020,T
3-PA,1337,0,4022,0,3,4025,T
3-PA,1338,7,3,0,3986,3996,C
3-PA,1339,3988,0,3,0,3991,A
3-PA,1340,2,1,0,4098,4101,C
3-PA,1341,4091,0,0,0,4091,A
3-PA,1342,0,0,4138,0,4138,G
3-PA,1343,4,2,0,4109,4115,C
3-PA,1344,4096,0,2,0,4098,A
3-PA,1345,0,5,4129,0,4134,G
3-PA,1346,4113,0,6,0,4119,A
3-PA,1347,1,4,4130,0,4135,G
3-PA,1348,2,1,4125,0,4128,G
3-PA,1349,0,4014,0,2,4016,T
3-PA,1350,1,3,4098,0,4102,G
3-PA,1351,1,4034,0,7,4042,T
3-PA,1352,10,0,0,4035,4045,C
3-PA,1353,5,1,0,4080,4086,C
3-PA,1354,8,1,0,4068,4077,C
3-PA,1355,4149,0,1,1,4151,A
3-PA,1356,1,4208,0,9,4218,T
3-PA,1357,0,4180,0,3,4183,T
3-PA,1358,3,1,4208,0,4212,G
3-PA,1359,0,4121,0,2,4123,T
3-PA,1360,4045,0,2,0,4047,A
3-PA,1361,1,5,4027,1,4034,G
3-PA,1362,3927,1,4,0,3932,A
3-PA,1363,0,2,3934,0,3936,G
3-PA,1364,2,1,0,3882,3885,C
3-PA,1365,6,0,0,3814,3820,C
3-PA,1366,3865,0,1,0,3866,A
3-PA,1367,1,1,0,3888,3890,C
3-PA,1368,0,3858,0,3,3861,T
3-PA,1369,0,4,3857,0,3861,G
3-PA,1370,3846,2,1,1,3850,A
3-PA,1371,3790,0,3,0,3793,A
3-PA,1372,0,3914,0,2,3916,T
3-PA,1373,3956,2,1,0,3959,A
3-PA,1374,2,3,0,3982,3987,C
3-PA,1375,3907,1,4,0,3912,A
3-PA,1376,0,3928,0,3,3931,T
3-PA,1377,3877,0,0,1,3878,A
3-PA,1378,3866,1,3,0,3870,A
3-PA,1379,0,3863,0,1,3864,T
3-PA,1380,1,1,3790,0,3792,G
3-PA,1381,3766,1,1,0,3768,A
3-PA,1382,3678,0,3,0,3681,A
3-PA,1383,0,5,3679,0,3684,G
3-PA,1384,1,8,3643,0,3652,G
3-PA,1385,1,3,3689,0,3693,G
3-PA,1386,0,4,3673,0,3677,G
3-PA,1387,1,0,3732,0,3733,G
3-PA,1388,0,3637,1,1,3639,T
3-PA,1389,3663,0,4,1,3668,A
3-PA,1390,0,3698,1,3,3702,T
3-PA,1391,3718,0,2,1,3721,A
3-PA,1392,3,1,0,4056,4060,C
3-PA,1393,3939,0,3,0,3942,A
3-PA,1394,0,3830,2,5,3837,T
3-PA,1395,0,3797,1,3,3801,T
3-PA,1396,3732,0,0,0,3732,A
3-PA,1397,3814,0,2,0,3816,A
3-PA,1398,0,0,0,3811,3811,C
3-PA,1399,3732,0,2,0,3734,A
3-PA,1400,0,1,0,3737,3738,C
3-PA,1401,0,3343,0,1,3344,T
3-PA,1402,0,2,3492,0,3494,G
3-PA,1403,0,4,1,3452,3457,C
3-PA,1404,1,0,0,3452,3453,C
3-PA,1405,5,0,0,3474,3479,C
3-PA,1406,0,3372,0,2,3374,T
3-PA,1407,2,0,3498,0,3500,G
3-PA,1408,0,0,0,3489,3489,C
3-PA,1409,0,3473,0,0,3473,T
3-PA,1410,7,0,0,3602,3609,C
3-PA,1411,3477,1,1,0,3479,A
3-PA,1412,3510,0,1,0,3511,A
3-PA,1413,2,3524,1,0,3527,T
3-PA,1414,2,1,3521,0,3524,G
3-PA,1415,1,1,0,3496,3498,C
3-PA,1416,3437,0,1,0,3438,A
3-PA,1417,0,3429,0,6,3435,T
3-PA,1418,2,2,0,3414,3418,C
3-PA,1419,3,0,0,3462,3465,C
3-PA,1420,0,3317,0,2,3319,T
3-PA,1421,1,0,3414,0,3415,G
3-PA,1422,0,3395,0,2,3397,T
3-PA,1423,2,1,3392,0,3395,G
3-PA,1424,1,1,0,3402,3404,C
3-PA,1425,3341,0,1,0,3342,A
3-PA,1426,2,0,3370,0,3372,G
3-PA,1427,0,1,0,3360,3361,C
3-PA,1428,3298,0,0,0,3298,A
3-PA,1429,3299,0,0,0,3299,A
3-PA,1430,0,3158,0,0,3158,T
3-PA,1431,2,1,3161,0,3164,G
3-PA,1432,0,4,3159,0,3163,G
3-PA,1433,3157,1,8,0,3166,A
3-PA,1434,1,2,0,3170,3173,C
3-PA,1435,1,9,3149,0,3159,G
3-PA,1436,3186,1,1,0,3188,A
3-PA,1437,0,3190,0,0,3190,T
3-PA,1438,0,3189,0,0,3189,T
3-PA,1439,0,3185,0,1,3186,T
3-PA,1440,0,3166,0,2,3168,T
3-PA,1441,5,2,0,3172,3179,C
3-PA,1442,3183,0,1,0,3184,A
3-PA,1443,3187,0,1,1,3189,A
3-PA,1444,1,1,0,3186,3188,C
3-PA,1445,0,3205,0,1,3206,T
3-PA,1446,3189,0,5,0,3194,A
3-PA,1447,3189,0,0,0,3189,A
3-PA,1448,0,3195,0,2,3197,T
3-PA,1449,0,3165,0,3,3168,T
3-PA,1450,5,2,0,3186,3193,C
3-PA,1451,5,1,0,3177,3183,C
3-PA,1452,3,1,0,3177,3181,C
3-PA,1453,3177,0,2,0,3179,A
3-PA,1454,0,3230,0,3,3233,T
3-PA,1455,1,7,3237,0,3245,G
3-PA,1456,3248,0,3,0,3251,A
3-PA,1457,0,3231,0,1,3232,T
3-PA,1458,3236,0,0,0,3236,A
3-PA,1459,3239,0,4,0,3243,A
3-PA,1460,0,1,3224,0,3225,G
3-PA,1461,2,1,0,3229,3232,C
3-PA,1462,3221,0,1,0,3222,A
3-PA,1463,3094,0,2,0,3096,A
3-PA,1464,3,0,3143,0,3146,G
3-PA,1465,0,3116,0,2,3118,T
3-PA,1466,1,1,3100,0,3102,G
3-PA,1467,0,0,0,3110,3110,C
3-PA,1468,3072,0,3,0,3075,A
3-PA,1469,0,9,3115,0,3124,G
3-PA,1470,3114,0,3,0,3117,A
3-PA,1471,3158,1,0,0,3159,A
3-PA,1472,0,2,0,3168,3170,C
3-PA,1473,0,3073,0,2,3075,T
3-PA,1474,3095,0,2,0,3097,A
3-PA,1475,3102,0,1,0,3103,A
3-PA,1476,3089,0,4,0,3093,A
3-PA,1477,2,5,3096,0,3103,G
3-PA,1478,2972,0,1,0,2973,A
3-PA,1479,2,14,2952,0,2968,G
3-PA,1480,0,2,2892,0,2894,G
3-PA,1481,1,1,2895,0,2897,G
3-PA,1482,2865,0,3,0,2868,A
3-PA,1483,2796,0,5,0,2801,A
3-PA,1484,1,2,2796,0,2799,G
3-PA,1485,1,1,2770,0,2772,G
3-PA,1486,1,4,0,2784,2789,C
3-PA,1487,0,4,2789,0,2793,G
3-PA,1488,2781,0,3,0,2784,A
3-PA,1489,2779,1,0,0,2780,A
3-PA,1490,2778,0,0,0,2778,A
3-PA,1491,2781,0,0,0,2781,A
3-PA,1492,2780,0,4,0,2784,A
3-PA,1493,0,0,0,2784,2784,C
3-PA,1494,2,1,0,2775,2778,C
3-PA,1495,2785,0,0,0,2785,A
3-PA,1496,2824,1,1,0,2826,A
3-PA,1497,0,2823,0,0,2823,T
3-PA,1498,0,2813,0,3,2816,T
3-PA,1499,0,2831,0,0,2831,T
3-PA,1500,2852,0,0,0,2852,A
3-PA,1501,0,2838,0,1,2839,T
3-PA,1502,2841,0,2,0,2843,A
3-PA,1503,0,2824,0,4,2828,T
3-PA,1504,0,4,2800,0,2804,G
3-PA,1505,0,10,2769,1,2780,G
3-PA,1506,2774,0,3,0,2777,A
3-PA,1507,1,2759,0,1,2761,T
3-PA,1508,1,2719,1,1,2722,T
3-PA,1509,6,1,1,2706,2714,C
3-PA,1510,2729,0,1,1,2731,A
3-PA,1511,0,2757,0,3,2760,T
3-PA,1512,1,2,0,2760,2763,C
3-PA,1513,2762,0,1,0,2763,A
3-PA,1514,0,2747,0,2,2749,T
3-PA,1515,2724,1,1,0,2726,A
3-PA,1516,2724,1,0,0,2725,A
3-PA,1517,2723,0,4,1,2728,A
3-PA,1518,0,2,2710,0,2712,G
3-PA,1519,0,3,2660,1,2664,G
3-PA,1520,0,5,2637,0,2642,G
3-PA,1521,2614,0,2,0,2616,A
3-PA,1522,2563,0,2,0,2565,A
3-PA,1523,2,4,2568,0,2574,G
3-PA,1524,2556,0,1,0,2557,A
3-PA,1525,0,2545,0,2,2547,T
3-PA,1526,2,1,0,2544,2547,C
3-PA,1527,1,2494,0,4,2499,T
3-PA,1528,5,0,0,2562,2567,C
3-PA,1529,2560,0,0,0,2560,A
3-PA,1530,0,2551,1,0,2552,T
3-PA,1531,0,2554,0,2,2556,T
3-PA,1532,0,2520,0,0,2520,T
3-PA,1533,2501,0,1,0,2502,A
3-PA,1534,2500,0,4,0,2504,A
3-PA,1535,0,2,2496,0,2498,G
3-PA,1536,2,8,2518,0,2528,G
3-PA,1537,2369,0,2,0,2371,A
3-PA,1538,2378,0,1,0,2379,A
3-PA,1539,0,2365,0,2,2367,T
3-PA,1540,0,6,2379,1,2386,G
3-PA,1541,2455,0,3,0,2458,A
3-PA,1542,0,1,0,2460,2461,C
3-PA,1543,2437,0,2,0,2439,A
3-PA,1544,1,0,0,2444,2445,C
3-PA,1545,2338,0,5,0,2343,A
3-PA,1546,0,0,2362,0,2362,G
3-PA,1547,2343,0,0,0,2343,A
3-PA,1548,1,0,0,2296,2297,C
3-PA,1549,0,0,2258,0,2258,G
3-PA,1550,0,2046,0,5,2051,T
3-PA,1551,3,4,2051,1,2059,G
3-PA,1552,0,1,2072,0,2073,G
3-PA,1553,0,2067,0,1,2068,T
3-PA,1554,2072,0,3,0,2075,A
3-PA,1555,2024,0,0,0,2024,A
3-PA,1556,2018,0,0,0,2018,A
3-PA,1557,0,2018,0,0,2018,T
3-PA,1558,0,1960,0,0,1960,T
3-PA,1559,0,1965,0,2,1967,T
3-PA,1560,0,1927,0,0,1927,T
3-PA,1561,0,0,1926,0,1926,G
3-PA,1562,0,1894,0,1,1895,T
3-PA,1563,1,6,1889,0,1896,G
3-PA,1564,1890,0,4,0,1894,A
3-PA,1565,0,1,1900,0,1901,G
3-PA,1566,0,0,1,1886,1887,C
3-PA,1567,1892,0,0,0,1892,A
3-PA,1568,0,1888,0,1,1889,T
3-PA,1569,0,5,1890,0,1895,G
3-PA,1570,1,3,1898,0,1902,G
3-PA,1571,1897,0,2,0,1899,A
3-PA,1572,1,1,1902,0,1904,G
3-PA,1573,0,1851,3,3,1857,T
3-PA,1574,0,1817,0,9,1826,T
3-PA,1575,0,1835,0,1,1836,T
3-PA,1576,0,1823,0,3,1826,T
3-PA,1577,2,0,0,1831,1833,C
3-PA,1578,0,1817,0,4,1821,T
3-PA,1579,4,3,0,1808,1815,C
3-PA,1580,0,1752,0,2,1754,T
3-PA,1581,2,1,0,1740,1743,C
3-PA,1582,1737,1,1,0,1739,A
3-PA,1583,0,3,0,1729,1732,C
3-PA,1584,0,1681,0,0,1681,T
3-PA,1585,0,6,1681,0,1687,G
3-PA,1586,1669,0,0,0,1669,A
3-PA,1587,1,0,0,1679,1680,C
3-PA,1588,3,0,0,1667,1670,C
3-PA,1589,2,1,0,1647,1650,C
3-PA,1590,1,1,1639,0,1641,G
3-PA,1591,1635,0,1,0,1636,A
3-PA,1592,0,5,1641,0,1646,G
3-PA,1593,1640,1,2,0,1643,A
3-PA,1594,0,0,0,1598,1598,C
3-PA,1595,0,1543,0,2,1545,T
3-PA,1596,0,1445,0,1,1446,T
3-PA,1597,0,3,1445,0,1448,G
3-PA,1598,1433,0,3,0,1436,A
3-PA,1599,0,0,1440,0,1440,G
3-PA,1600,1,0,0,1420,1421,C
3-PA,1601,0,0,0,1362,1362,C
3-PA,1602,1350,0,1,0,1351,A
3-PA,1603,1,1,0,1358,1360,C
3-PA,1604,1358,0,0,0,1358,A
3-PA,1605,0,1354,0,0,1354,T
3-PA,1606,1342,0,0,0,1342,A
3-PA,1607,1327,0,2,0,1329,A
3-PA,1608,1318,0,0,0,1318,A
3-PA,1609,0,1289,0,0,1289,T
3-PA,1610,0,0,1289,0,1289,G
3-PA,1611,0,0,1139,0,1139,G
3-PA,1612,0,0,1113,0,1113,G
3-PA,1613,1061,1,1,0,1063,A
3-PA,1614,0,1,1048,0,1049,G
3-PA,1615,1023,0,0,0,1023,A
3-PA,1616,998,0,1,0,999,A
3-PA,1617,993,1,1,0,995,A
3-PA,1618,0,980,0,0,980,T
3-PA,1619,961,0,0,0,961,A
3-PA,1620,1,0,0,961,962,C
3-PA,1621,0,555,0,0,555,T
3-PA,1622,0,0,554,0,554,G
3-PA,1623,0,349,0,1,350,T
3-PA,1624,0,0,343,0,343,G
3-PA,1625,0,321,0,0,321,T
3-PA,1626,1,0,0,219,220,C
3-PA,1627,0,0,0,209,209,C
3-PA,1628,0,189,0,0,189,T
3-PA,1629,0,191,0,0,191,T
3-PA,1630,1,1,190,0,192,G
3-PA,1631,190,0,0,0,190,A
3-PA,1632,0,0,192,0,192,G
3-PA,1633,183,0,0,0,183,A
3-PA,1634,0,184,0,0,184,T
3-PA,1635,183,0,0,0,183,A
3-PA,1636,0,0,185,0,185,G
3-PA,1637,0,0,187,0,187,G
3-PA,1638,184,0,0,0,184,A
3-PA,1639,0,0,184,0,184,G
3-PA,1640,181,0,0,0,181,A
3-PA,1641,0,180,0,0,180,T
3-PA,1642,182,0,0,0,182,A
3-PA,1643,0,183,0,0,183,T
3-PA,1644,0,0,189,0,189,G
3-PA,1645,0,186,0,0,186,T
3-PA,1646,0,184,0,0,184,T
3-PA,1647,186,0,0,0,186,A
3-PA,1648,0,1,0,186,187,C
3-PA,1649,0,185,0,0,185,T
3-PA,1650,186,0,0,0,186,A
3-PA,1651,182,0,0,0,182,A
3-PA,1652,0,0,189,0,189,G
3-PA,1653,183,0,0,0,183,A
3-PA,1654,177,0,0,0,177,A
3-PA,1655,0,0,174,0,174,G
3-PA,1656,0,174,0,0,174,T
3-PA,1657,0,0,175,0,175,G
3-PA,1658,0,0,0,177,177,C
3-PA,1659,0,0,0,177,177,C
3-PA,1660,175,0,0,0,175,A
3-PA,1661,0,174,0,0,174,T
3-PA,1662,173,0,0,0,173,A
3-PA,1663,0,0,175,0,175,G
3-PA,1664,0,0,174,0,174,G
3-PA,1665,0,0,0,174,174,C
3-PA,1666,1,0,0,174,175,C
3-PA,1667,173,0,0,0,173,A
3-PA,1668,170,0,0,0,170,A
3-PA,1669,171,0,0,0,171,A
3-PA,1670,0,175,0,0,175,T
3-PA,1671,0,174,0,1,175,T
3-PA,1672,0,177,0,0,177,T
3-PA,1673,0,0,0,178,178,C
3-PA,1674,177,0,0,0,177,A
3-PA,1675,178,0,0,0,178,A
3-PA,1676,0,0,177,0,177,G
3-PA,1677,0,0,183,0,183,G
3-PA,1678,0,0,0,183,183,C
3-PA,1679,0,0,0,180,180,C
3-PA,1680,0,175,0,0,175,T
3-PA,1681,189,0,1,0,190,A
3-PA,1682,0,192,0,0,192,T
3-PA,1683,0,0,194,0,194,G
3-PA,1684,0,193,0,0,193,T
3-PA,1685,0,193,0,0,193,T
3-PA,1686,2,0,0,188,190,C
3-PA,1687,0,188,0,0,188,T
3-PA,1688,0,192,0,0,192,T
3-PA,1689,0,0,193,0,193,G
3-PA,1690,0,183,0,0,183,T
3-PA,1691,184,0,0,0,184,A
3-PA,1692,0,176,0,0,176,T
3-PA,1693,2,0,174,0,176,G
3-PA,1694,0,170,0,0,170,T
3-PA,1695,0,0,171,0,171,G
3-PA,1696,165,1,1,0,167,A
3-PA,1697,0,1,169,0,170,G
3-PA,1698,0,0,168,0,168,G
3-PA,1699,168,0,0,0,168,A
3-PA,1700,1,0,0,168,169,C
3-PA,1701,168,0,0,0,168,A
3-PA,1702,168,0,0,0,168,A
3-PA,1703,169,0,0,0,169,A
3-PA,1704,0,1,0,171,172,C
3-PA,1705,0,2,169,0,171,G
3-PA,1706,0,0,172,0,172,G
3-PA,1707,171,0,0,0,171,A
3-PA,1708,173,0,0,0,173,A
3-PA,1709,0,0,0,176,176,C
3-PA,1710,173,0,0,0,173,A
3-PA,1711,0,173,0,0,173,T
3-PA,1712,0,0,0,173,173,C
3-PA,1713,174,0,0,0,174,A
3-PA,1714,172,0,0,0,172,A
3-PA,1715,170,0,1,0,171,A
3-PA,1716,0,0,177,0,177,G
3-PA,1717,0,0,176,0,176,G
3-PA,1718,0,172,0,1,173,T
3-PA,1719,1,0,0,172,173,C
3-PA,1720,175,0,0,0,175,A
3-PA,1721,175,0,1,0,176,A
3-PA,1722,176,0,0,0,176,A
3-PA,1723,179,0,0,0,179,A
3-PA,1724,0,178,0,0,178,T
3-PA,1725,0,1,179,0,180,G
3-PA,1726,179,0,0,0,179,A
3-PA,1727,175,0,1,0,176,A
3-PA,1728,179,0,0,0,179,A
3-PA,1729,0,180,0,0,180,T
3-PA,1730,0,0,185,0,185,G
3-PA,1731,0,0,184,0,184,G
3-PA,1732,0,0,182,0,182,G
3-PA,1733,0,1,185,0,186,G
3-PA,1734,180,0,0,0,180,A
3-PA,1735,183,0,1,0,184,A
3-PA,1736,0,183,0,0,183,T
3-PA,1737,0,0,188,0,188,G
3-PA,1738,0,0,188,0,188,G
3-PA,1739,183,0,0,0,183,A
3-PA,1740,0,0,190,0,190,G
3-PA,1741,188,0,1,0,189,A
3-PA,1742,0,189,0,0,189,T
3-PA,1743,0,0,184,0,184,G
3-PA,1744,186,0,0,0,186,A
3-PA,1745,2,0,190,0,192,G
3-PA,1746,190,0,0,0,190,A
3-PA,1747,0,0,0,191,191,C
3-PA,1748,0,0,190,0,190,G
3-PA,1749,0,185,0,0,185,T
3-PA,1750,0,186,0,0,186,T
3-PA,1751,0,0,184,0,184,G
3-PA,1752,0,0,0,183,183,C
3-PA,1753,0,0,0,184,184,C
3-PA,1754,0,185,0,0,185,T
3-PA,1755,0,0,0,189,189,C
3-PA,1756,0,0,0,192,192,C
3-PA,1757,0,190,0,0,190,T
3-PA,1758,0,192,0,1,193,T
3-PA,1759,0,0,0,192,192,C
3-PA,1760,190,0,0,0,190,A
3-PA,1761,0,0,191,0,191,G
3-PA,1762,0,192,0,1,193,T
3-PA,1763,0,0,0,194,194,C
3-PA,1764,183,0,0,0,183,A
3-PA,1765,0,0,0,189,189,C
3-PA,1766,0,191,0,0,191,T
3-PA,1767,0,0,0,191,191,C
3-PA,1768,0,0,0,190,190,C
3-PA,1769,191,0,0,0,191,A
3-PA,1770,0,0,187,0,187,G
3-PA,1771,1,0,0,188,189,C
3-PA,1772,192,0,1,0,193,A
3-PA,1773,0,1,193,0,194,G
3-PA,1774,181,0,0,0,181,A
3-PA,1775,0,179,0,0,179,T
3-PA,1776,0,0,0,184,184,C
3-PA,1777,1,0,183,0,184,G
3-PA,1778,182,0,0,0,182,A
3-PA,1779,0,0,183,0,183,G
3-PA,1780,185,0,0,0,185,A
3-PA,1781,1,0,187,0,188,G
3-PA,1782,0,0,0,183,183,C
3-PA,1783,182,0,0,0,182,A
3-PA,1784,0,186,0,0,186,T
3-PA,1785,0,0,189,0,189,G
3-PA,1786,190,0,0,0,190,A
3-PA,1787,0,190,0,0,190,T
3-PA,1788,0,187,0,1,188,T
3-PA,1789,0,0,186,0,186,G
3-PA,1790,183,0,0,0,183,A
3-PA,1791,186,0,0,0,186,A
3-PA,1792,0,0,187,0,187,G
3-PA,1793,0,0,0,184,184,C
3-PA,1794,0,0,0,185,185,C
3-PA,1795,0,0,185,0,185,G
3-PA,1796,182,0,0,0,182,A
3-PA,1797,0,0,187,0,187,G
3-PA,1798,0,179,0,0,179,T
3-PA,1799,0,0,0,186,186,C
3-PA,1800,0,0,0,186,186,C
3-PA,1801,0,184,0,0,184,T
3-PA,1802,0,0,0,193,193,C
3-PA,1803,0,0,190,0,190,G
3-PA,1804,0,0,197,0,197,G
3-PA,1805,0,195,0,0,195,T
3-PA,1806,0,196,0,0,196,T
3-PA,1807,197,0,0,0,197,A
3-PA,1808,194,0,0,0,194,A
3-PA,1809,198,0,0,0,198,A
3-PA,1810,0,0,199,0,199,G
3-PA,1811,197,0,0,0,197,A
3-PA,1812,0,0,201,0,201,G
3-PA,1813,194,0,1,0,195,A
3-PA,1814,195,0,0,0,195,A
3-PA,1815,194,0,3,0,197,A
3-PA,1816,0,0,198,0,198,G
3-PA,1817,198,0,0,0,198,A
3-PA,1818,0,0,0,198,198,C
3-PA,1819,196,0,0,0,196,A
3-PA,1820,0,198,0,0,198,T
3-PA,1821,0,2,194,0,196,G
3-PA,1822,194,0,0,0,194,A
3-PA,1823,0,0,0,194,194,C
3-PA,1824,0,0,0,196,196,C
3-PA,1825,197,0,0,0,197,A
3-PA,1826,195,0,0,0,195,A
3-PA,1827,196,0,0,0,196,A
3-PA,1828,0,0,196,0,196,G
3-PA,1829,192,0,0,0,192,A
3-PA,1830,0,0,198,0,198,G
3-PA,1831,0,197,0,0,197,T
3-PA,1832,0,196,0,0,196,T
3-PA,1833,0,197,0,1,198,T
3-PA,1834,0,200,0,0,200,T
3-PA,1835,0,198,0,0,198,T
3-PA,1836,0,201,0,0,201,T
3-PA,1837,0,0,198,0,198,G
3-PA,1838,198,0,0,0,198,A
3-PA,1839,0,2,198,0,200,G
3-PA,1840,197,0,0,0,197,A
3-PA,1841,199,0,0,0,199,A
3-PA,1842,0,197,0,0,197,T
3-PA,1843,200,0,0,0,200,A
3-PA,1844,211,0,0,0,211,A
3-PA,1845,210,0,0,0,210,A
3-PA,1846,0,208,0,0,208,T
3-PA,1847,1,0,0,210,211,C
3-PA,1848,210,0,0,0,210,A
3-PA,1849,0,1,206,0,207,G
3-PA,1850,210,0,0,0,210,A
3-PA,1851,210,0,0,0,210,A
3-PA,1852,0,0,213,0,213,G
3-PA,1853,0,0,0,209,209,C
3-PA,1854,207,0,0,0,207,A
3-PA,1855,0,210,0,0,210,T
3-PA,1856,1,0,208,0,209,G
3-PA,1857,0,0,212,0,212,G
3-PA,1858,0,0,0,208,208,C
3-PA,1859,0,0,0,214,214,C
3-PA,1860,0,0,0,217,217,C
3-PA,1861,221,0,0,0,221,A
3-PA,1862,0,222,0,0,222,T
3-PA,1863,0,219,0,0,219,T
3-PA,1864,0,1,221,0,222,G
3-PA,1865,0,0,221,0,221,G
3-PA,1866,0,1,217,0,218,G
3-PA,1867,0,0,220,0,220,G
3-PA,1868,206,0,0,0,206,A
3-PA,1869,0,0,217,0,217,G
3-PA,1870,0,215,0,1,216,T
3-PA,1871,1,0,0,217,218,C
3-PA,1872,0,0,0,226,226,C
3-PA,1873,0,0,0,226,226,C
3-PA,1874,0,0,0,227,227,C
3-PA,1875,0,0,0,229,229,C
3-PA,1876,230,0,0,0,230,A
3-PA,1877,228,0,0,1,229,A
3-PA,1878,0,1,230,0,231,G
3-PA,1879,0,0,227,0,227,G
3-PA,1880,0,0,223,0,223,G
3-PA,1881,216,0,0,0,216,A
3-PA,1882,0,0,217,0,217,G
3-PA,1883,0,215,0,0,215,T
3-PA,1884,0,0,217,0,217,G
3-PA,1885,0,0,216,0,216,G
3-PA,1886,215,0,0,0,215,A
3-PA,1887,215,1,0,0,216,A
3-PA,1888,0,0,213,0,213,G
3-PA,1889,214,0,0,0,214,A
3-PA,1890,212,0,0,0,212,A
3-PA,1891,0,1,209,0,210,G
3-PA,1892,0,0,209,0,209,G
3-PA,1893,0,202,0,1,203,T
3-PA,1894,0,204,0,0,204,T
3-PA,1895,4,0,0,202,206,C
3-PA,1896,0,0,0,206,206,C
3-PA,1897,206,0,0,0,206,A
3-PA,1898,0,205,0,0,205,T
3-PA,1899,0,204,0,1,205,T
3-PA,1900,0,1,204,0,205,G
3-PA,1901,0,0,205,0,205,G
3-PA,1902,0,1,202,0,203,G
3-PA,1903,206,0,0,0,206,A
3-PA,1904,205,0,0,0,205,A
3-PA,1905,205,0,0,0,205,A
3-PA,1906,0,0,212,0,212,G
3-PA,1907,0,210,0,0,210,T
3-PA,1908,0,0,0,212,212,C
3-PA,1909,0,212,0,0,212,T
3-PA,1910,0,0,211,0,211,G
3-PA,1911,0,210,0,1,211,T
3-PA,1912,213,0,0,0,213,A
3-PA,1913,0,0,213,0,213,G
3-PA,1914,0,0,208,0,208,G
3-PA,1915,203,0,0,0,203,A
3-PA,1916,0,0,0,206,206,C
3-PA,1917,0,200,0,0,200,T
3-PA,1918,0,0,0,213,213,C
3-PA,1919,0,211,0,0,211,T
3-PA,1920,213,0,0,0,213,A
3-PA,1921,0,213,0,0,213,T
3-PA,1922,0,210,0,0,210,T
3-PA,1923,0,0,214,0,214,G
3-PA,1924,0,0,210,0,210,G
3-PA,1925,0,0,0,208,208,C
3-PA,1926,0,210,0,0,210,T
3-PA,1927,195,0,0,0,195,A
3-PA,1928,200,0,0,0,200,A
3-PA,1929,0,0,201,0,201,G
3-PA,1930,0,199,0,0,199,T
3-PA,1931,1,0,0,199,200,C
3-PA,1932,196,0,0,0,196,A
3-PA,1933,0,0,198,0,198,G
3-PA,1934,0,198,0,0,198,T
3-PA,1935,202,0,0,0,202,A
3-PA,1936,0,200,0,0,200,T
3-PA,1937,0,196,0,0,196,T
3-PA,1938,1,0,0,198,199,C
3-PA,1939,197,0,0,0,197,A
3-PA,1940,198,0,0,0,198,A
3-PA,1941,0,198,0,0,198,T
3-PA,1942,194,0,0,0,194,A
3-PA,1943,0,0,197,0,197,G
3-PA,1944,0,0,0,192,192,C
3-PA,1945,0,0,0,192,192,C
3-PA,1946,0,184,0,0,184,T
3-PA,1947,0,0,186,0,186,G
3-PA,1948,0,185,0,0,185,T
3-PA,1949,186,0,0,0,186,A
3-PA,1950,0,187,0,0,187,T
3-PA,1951,0,0,182,0,182,G
3-PA,1952,0,0,0,182,182,C
3-PA,1953,176,0,0,0,176,A
3-PA,1954,0,175,0,0,175,T
3-PA,1955,0,0,0,175,175,C
3-PA,1956,171,0,0,0,171,A
3-PA,1957,0,0,0,173,173,C
3-PA,1958,0,0,0,174,174,C
3-PA,1959,171,1,1,0,173,A
3-PA,1960,0,0,0,175,175,C
3-PA,1961,173,0,0,0,173,A
3-PA,1962,172,0,0,0,172,A
3-PA,1963,0,174,0,0,174,T
3-PA,1964,0,174,0,0,174,T
3-PA,1965,0,0,171,0,171,G
3-PA,1966,0,0,170,0,170,G
3-PA,1967,168,0,0,0,168,A
3-PA,1968,168,0,0,0,168,A
3-PA,1969,0,0,165,0,165,G
3-PA,1970,0,1,168,0,169,G
3-PA,1971,167,0,0,0,167,A
3-PA,1972,0,165,0,1,166,T
3-PA,1973,0,167,0,0,167,T
3-PA,1974,0,166,0,0,166,T
3-PA,1975,0,167,0,0,167,T
3-PA,1976,0,0,0,167,167,C
3-PA,1977,167,0,0,0,167,A
3-PA,1978,0,0,166,0,166,G
3-PA,1979,0,0,0,164,164,C
3-PA,1980,0,0,165,0,165,G
3-PA,1981,0,1,166,0,167,G
3-PA,1982,167,0,0,0,167,A
3-PA,1983,1,0,167,0,168,G
3-PA,1984,0,170,0,0,170,T
3-PA,1985,0,0,0,170,170,C
3-PA,1986,169,0,0,0,169,A
3-PA,1987,171,0,2,0,173,A
3-PA,1988,0,0,173,0,173,G
3-PA,1989,173,0,0,0,173,A
3-PA,1990,171,0,0,0,171,A
3-PA,1991,170,0,0,0,170,A
3-PA,1992,165,0,0,0,165,A
3-PA,1993,0,0,0,165,165,C
3-PA,1994,0,165,0,0,165,T
3-PA,1995,0,0,164,0,164,G
3-PA,1996,0,0,0,161,161,C
3-PA,1997,0,163,0,0,163,T
3-PA,1998,1,0,0,160,161,C
3-PA,1999,0,1,0,160,161,C
3-PA,2000,0,165,0,0,165,T
3-PA,2001,0,165,0,0,165,T
3-PA,2002,0,0,166,0,166,G
3-PA,2003,0,166,0,0,166,T
3-PA,2004,0,161,0,0,161,T
3-PA,2005,0,0,165,0,165,G
3-PA,2006,0,164,0,0,164,T
3-PA,2007,0,162,0,0,162,T
3-PA,2008,2,0,0,161,163,C
3-PA,2009,162,0,0,0,162,A
3-PA,2010,0,1,162,0,163,G
3-PA,2011,0,0,163,0,163,G
3-PA,2012,0,1,0,161,162,C
3-PA,2013,0,163,0,0,163,T
3-PA,2014,1,0,0,167,168,C
3-PA,2015,0,169,0,0,169,T
3-PA,2016,0,170,0,0,170,T
3-PA,2017,169,0,0,0,169,A
3-PA,2018,0,0,171,0,171,G
3-PA,2019,0,0,168,0,168,G
3-PA,2020,0,0,168,0,168,G
3-PA,2021,165,0,0,0,165,A
3-PA,2022,0,0,0,166,166,C
3-PA,2023,153,0,0,0,153,A
3-PA,2024,156,0,1,0,157,A
3-PA,2025,0,0,0,160,160,C
3-PA,2026,0,0,0,160,160,C
3-PA,2027,0,159,0,0,159,T
3-PA,2028,0,0,0,157,157,C
3-PA,2029,0,0,160,0,160,G
3-PA,2030,159,0,0,0,159,A
3-PA,2031,159,0,0,0,159,A
3-PA,2032,0,0,0,159,159,C
3-PA,2033,0,0,0,157,157,C
3-PA,2034,0,155,0,0,155,T
3-PA,2035,0,0,156,0,156,G
3-PA,2036,0,0,156,0,156,G
3-PA,2037,0,0,152,0,152,G
3-PA,2038,152,0,0,0,152,A
3-PA,2039,0,0,0,154,154,C
3-PA,2040,1,0,0,152,153,C
3-PA,2041,0,152,0,0,152,T
3-PA,2042,0,153,0,0,153,T
3-PA,2043,0,153,0,1,154,T
3-PA,2044,0,0,155,0,155,G
3-PA,2045,153,0,0,0,153,A
3-PA,2046,0,151,0,0,151,T
3-PA,2047,0,0,0,152,152,C
3-PA,2048,0,147,0,0,147,T
3-PA,2049,0,149,0,0,149,T
3-PA,2050,0,0,148,0,148,G
3-PA,2051,0,0,146,0,146,G
3-PA,2052,0,1,146,0,147,G
3-PA,2053,0,0,148,0,148,G
3-PA,2054,0,0,144,0,144,G
3-PA,2055,0,0,148,0,148,G
3-PA,2056,0,0,0,147,147,C
3-PA,2057,0,149,0,0,149,T
3-PA,2058,155,0,0,0,155,A
3-PA,2059,0,156,0,0,156,T
3-PA,2060,156,0,1,0,157,A
3-PA,2061,0,157,0,0,157,T
3-PA,2062,0,0,153,0,153,G
3-PA,2063,150,0,0,0,150,A
3-PA,2064,150,0,0,0,150,A
3-PA,2065,0,0,150,0,150,G
3-PA,2066,0,0,0,150,150,C
3-PA,2067,142,0,0,0,142,A
3-PA,2068,151,0,0,0,151,A
3-PA,2069,0,153,0,0,153,T
3-PA,2070,0,151,0,0,151,T
3-PA,2071,0,0,153,0,153,G
3-PA,2072,148,0,0,0,148,A
3-PA,2073,1,0,149,0,150,G
3-PA,2074,0,0,149,0,149,G
3-PA,2075,139,0,0,0,139,A
3-PA,2076,0,0,142,0,142,G
3-PA,2077,0,132,0,0,132,T
3-PA,2078,0,0,132,0,132,G
3-PA,2079,0,0,0,131,131,C
3-PA,2080,0,0,0,131,131,C
3-PA,2081,0,132,0,0,132,T
3-PA,2082,0,0,137,0,137,G
3-PA,2083,138,0,0,0,138,A
3-PA,2084,0,135,0,0,135,T
3-PA,2085,0,133,0,0,133,T
3-PA,2086,132,0,0,0,132,A
3-PA,2087,132,0,0,0,132,A
3-PA,2088,0,129,0,0,129,T
3-PA,2089,0,0,128,0,128,G
3-PA,2090,125,0,0,0,125,A
3-PA,2091,0,128,0,0,128,T
3-PA,2092,0,0,0,128,128,C
3-PA,2093,0,0,0,126,126,C
3-PA,2094,1,0,0,126,127,C
3-PA,2095,0,128,0,0,128,T
3-PA,2096,0,1,126,0,127,G
3-PA,2097,0,0,129,0,129,G
3-PA,2098,0,0,129,0,129,G
3-PA,2099,0,126,0,0,126,T
3-PA,2100,0,123,0,0,123,T
3-PA,2101,0,123,0,0,123,T
3-PA,2102,0,122,0,0,122,T
3-PA,2103,0,0,123,0,123,G
3-PA,2104,0,0,0,120,120,C
3-PA,2105,0,120,0,0,120,T
3-PA,2106,0,0,0,123,123,C
3-PA,2107,121,0,0,0,121,A
3-PA,2108,122,0,0,0,122,A
3-PA,2109,0,122,0,0,122,T
3-PA,2110,0,0,121,0,121,G
3-PA,2111,1,0,0,120,121,C
3-PA,2112,0,0,120,0,120,G
3-PA,2113,0,121,0,0,121,T
3-PA,2114,0,0,0,118,118,C
3-PA,2115,0,120,0,0,120,T
3-PA,2116,0,120,0,0,120,T
3-PA,2117,0,0,118,0,118,G
3-PA,2118,0,0,118,0,118,G
3-PA,2119,0,119,0,0,119,T
3-PA,2120,0,118,0,0,118,T
3-PA,2121,0,0,0,116,116,C
3-PA,2122,112,0,0,0,112,A
3-PA,2123,113,0,0,0,113,A
3-PA,2124,0,0,0,113,113,C
3-PA,2125,0,113,0,0,113,T
3-PA,2126,0,0,0,111,111,C
3-PA,2127,0,1,0,108,109,C
3-PA,2128,0,108,0,0,108,T
3-PA,2129,0,107,0,0,107,T
3-PA,2130,1,0,0,102,103,C
3-PA,2131,0,0,0,106,106,C
3-PA,2132,0,105,0,0,105,T
3-PA,2133,0,0,106,0,106,G
3-PA,2134,105,0,0,0,105,A
3-PA,2135,0,0,0,102,102,C
3-PA,2136,100,0,0,0,100,A
3-PA,2137,0,0,0,98,98,C
3-PA,2138,97,0,0,0,97,A
3-PA,2139,0,95,0,0,95,T
3-PA,2140,0,0,93,0,93,G
3-PA,2141,1,0,0,93,94,C
3-PA,2142,94,0,0,0,94,A
3-PA,2143,0,93,0,0,93,T
3-PA,2144,0,92,0,0,92,T
3-PA,2145,93,0,0,0,93,A
3-PA,2146,92,0,0,0,92,A
3-PA,2147,92,0,1,0,93,A
3-PA,2148,92,0,0,0,92,A
3-PA,2149,0,89,0,0,89,T
3-PA,2150,76,0,0,0,76,A
3-PA,2151,0,0,77,0,77,G
4-HA,1,290,0,0,0,290,A
4-HA,2,0,288,0,0,288,T
4-HA,3,0,0,294,0,294,G
4-HA,4,295,0,0,0,295,A
4-HA,5,298,0,1,0,299,A
4-HA,6,0,1,324,0,325,G
4-HA,7,325,0,0,0,325,A
4-HA,8,0,0,0,353,353,C
4-HA,9,0,355,0,3,358,T
4-HA,10,362,0,1,0,363,A
4-HA,11,0,393,0,1,394,T
4-HA,12,0,0,0,398,398,C
4-HA,13,396,0,0,0,396,A
4-HA,14,0,397,0,0,397,T
4-HA,15,0,400,0,0,400,T
4-HA,16,0,0,442,0,442,G
4-HA,17,1,0,0,443,444,C
4-HA,18,0,445,0,0,445,T
4-HA,19,0,447,0,0,447,T
4-HA,20,0,448,0,0,448,T
4-HA,21,0,1,472,0,473,G
4-HA,22,477,0,0,0,477,A
4-HA,23,0,0,495,0,495,G
4-HA,24,0,0,0,499,499,C
4-HA,25,0,501,0,0,501,T
4-HA,26,541,0,0,0,541,A
4-HA,27,0,0,0,550,550,C
4-HA,28,559,0,0,0,559,A
4-HA,29,0,585,0,0,585,T
4-HA,30,0,582,0,0,582,T
4-HA,31,0,0,0,586,586,C
4-HA,32,0,588,0,0,588,T
4-HA,33,603,0,0,0,603,A
4-HA,34,0,602,0,0,602,T
4-HA,35,0,0,610,0,610,G
4-HA,36,0,604,0,1,605,T
4-HA,37,0,0,0,607,607,C
4-HA,38,0,605,0,2,607,T
4-HA,39,1,0,601,0,602,G
4-HA,40,0,0,610,0,610,G
4-HA,41,1,603,0,0,604,T
4-HA,42,0,607,0,0,607,T
4-HA,43,0,606,0,0,606,T
4-HA,44,0,605,0,0,605,T
4-HA,45,1,1,0,605,607,C
4-HA,46,0,0,605,0,605,G
4-HA,47,0,0,0,612,612,C
4-HA,48,0,610,0,2,612,T
4-HA,49,2,1,0,612,615,C
4-HA,50,611,0,0,0,611,A
4-HA,51,618,0,0,0,618,A
4-HA,52,619,0,0,0,619,A
4-HA,53,614,0,1,0,615,A
4-HA,54,616,0,0,0,616,A
4-HA,55,0,1,0,623,624,C
4-HA,56,0,619,0,0,619,T
4-HA,57,0,620,0,0,620,T
4-HA,58,2,0,0,620,622,C
4-HA,59,0,0,0,625,625,C
4-HA,60,0,623,0,1,624,T
4-HA,61,0,1,624,0,625,G
4-HA,62,0,3,626,0,629,G
4-HA,63,625,0,0,0,625,A
4-HA,64,633,0,0,0,633,A
4-HA,65,632,0,0,0,632,A
4-HA,66,0,640,0,1,641,T
4-HA,67,0,1,641,0,642,G
4-HA,68,641,0,1,0,642,A
4-HA,69,0,0,0,648,648,C
4-HA,70,641,0,2,0,643,A
4-HA,71,643,0,0,0,643,A
4-HA,72,0,0,0,658,658,C
4-HA,73,639,1,0,0,640,A
4-HA,74,0,1,643,0,644,G
4-HA,75,0,0,0,646,646,C
4-HA,76,645,0,0,0,645,A
4-HA,77,0,0,0,664,664,C
4-HA,78,1,0,659,0,660,G
4-HA,79,0,0,658,0,658,G
4-HA,80,0,0,0,671,671,C
4-HA,81,663,0,0,0,663,A
4-HA,82,677,0,0,1,678,A
4-HA,83,0,0,0,678,678,C
4-HA,84,0,0,679,0,679,G
4-HA,85,0,0,0,684,684,C
4-HA,86,0,674,0,0,674,T
4-HA,87,1,1,684,0,686,G
4-HA,88,0,678,0,0,678,T
4-HA,89,0,1,708,0,709,G
4-HA,90,0,1,0,723,724,C
4-HA,91,0,0,0,748,748,C
4-HA,92,0,750,0,1,751,T
4-HA,93,0,741,0,0,741,T
4-HA,94,1,1,744,0,746,G
4-HA,95,0,0,748,0,748,G
4-HA,96,1,0,752,0,753,G
4-HA,97,0,0,0,761,761,C
4-HA,98,753,0,0,0,753,A
4-HA,99,1,0,0,765,766,C
4-HA,100,2,0,0,760,762,C
4-HA,101,821,0,0,0,821,A
4-HA,102,0,828,0,2,830,T
4-HA,103,1,0,831,0,832,G
4-HA,104,0,0,0,836,836,C
4-HA,105,818,0,2,0,820,A
4-HA,106,1,0,878,0,879,G
4-HA,107,0,871,0,1,872,T
4-HA,108,875,1,1,0,877,A
4-HA,109,0,0,0,875,875,C
4-HA,110,0,0,0,839,839,C
4-HA,111,842,0,0,0,842,A
4-HA,112,842,0,0,0,842,A
4-HA,113,838,0,1,1,840,A
4-HA,114,0,1,0,840,841,C
4-HA,115,1,2,808,0,811,G
4-HA,116,0,0,836,0,836,G
4-HA,117,835,0,1,0,836,A
4-HA,118,839,0,2,0,841,A
4-HA,119,0,0,0,840,840,C
4-HA,120,829,0,1,0,830,A
4-HA,121,841,0,0,6,847,A
4-HA,122,0,844,0,0,844,T
4-HA,123,861,0,0,0,861,A
4-HA,124,0,0,859,0,859,G
4-HA,125,1,831,0,1,833,T
4-HA,126,0,2,847,0,849,G
4-HA,127,845,0,0,0,845,A
4-HA,128,847,0,1,0,848,A
4-HA,129,846,0,1,0,847,A
4-HA,130,836,0,3,0,839,A
4-HA,131,0,0,0,851,851,C
4-HA,132,847,0,1,0,848,A
4-HA,133,843,0,0,0,843,A
4-HA,134,0,851,0,0,851,T
4-HA,135,0,1,0,847,848,C
4-HA,136,848,0,1,0,849,A
4-HA,137,0,0,0,858,858,C
4-HA,138,0,2,856,0,858,G
4-HA,139,850,0,0,0,850,A
4-HA,140,850,0,0,0,850,A
4-HA,141,0,843,0,1,844,T
4-HA,142,0,3,845,0,848,G
4-HA,143,859,0,0,0,859,A
4-HA,144,0,0,0,859,859,C
4-HA,145,2,0,0,854,856,C
4-HA,146,864,0,0,0,864,A
4-HA,147,862,0,0,0,862,A
4-HA,148,865,0,0,0,865,A
4-HA,149,0,868,0,0,868,T
4-HA,150,0,869,0,0,869,T
4-HA,151,1,1,871,1,874,G
4-HA,152,868,0,1,0,869,A
4-HA,153,869,0,1,0,870,A
4-HA,154,0,0,870,0,870,G
4-HA,155,0,864,0,1,865,T
4-HA,156,0,892,0,0,892,T
4-HA,157,902,1,0,0,903,A
4-HA,158,0,0,0,907,907,C
4-HA,159,0,909,0,0,909,T
4-HA,160,905,0,0,0,905,A
4-HA,161,935,0,0,0,935,A
4-HA,162,0,931,0,2,933,T
4-HA,163,0,0,933,0,933,G
4-HA,164,0,0,0,972,972,C
4-HA,165,0,956,0,0,956,T
4-HA,166,960,0,0,0,960,A
4-HA,167,1,0,0,959,960,C
4-HA,168,0,949,1,1,951,T
4-HA,169,0,2,963,0,965,G
4-HA,170,944,0,0,1,945,A
4-HA,171,0,0,944,0,944,G
4-HA,172,0,0,0,942,942,C
4-HA,173,0,928,0,0,928,T
4-HA,174,0,3,959,0,962,G
4-HA,175,0,0,972,0,972,G
4-HA,176,0,975,0,1,976,T
4-HA,177,1,976,0,0,977,T
4-HA,178,1,0,0,977,978,C
4-HA,179,970,0,0,0,970,A
4-HA,180,0,2,973,0,975,G
4-HA,181,976,0,1,0,977,A
4-HA,182,0,0,993,0,993,G
4-HA,183,0,980,0,0,980,T
4-HA,184,0,961,0,0,961,T
4-HA,185,1,2,0,970,973,C
4-HA,186,2,0,0,974,976,C
4-HA,187,0,970,0,1,971,T
4-HA,188,0,0,0,974,974,C
4-HA,189,971,0,1,0,972,A
4-HA,190,973,0,1,0,974,A
4-HA,191,0,1,0,990,991,C
4-HA,192,973,0,2,0,975,A
4-HA,193,0,0,996,0,996,G
4-HA,194,1,0,987,0,988,G
4-HA,195,0,973,0,1,974,T
4-HA,196,0,1,984,0,985,G
4-HA,197,981,0,0,1,982,A
4-HA,198,984,0,2,1,987,A
4-HA,199,1007,0,1,0,1008,A
4-HA,200,0,993,0,0,993,T
4-HA,201,999,0,2,0,1001,A
4-HA,202,0,988,0,0,988,T
4-HA,203,0,1,987,0,988,G
4-HA,204,0,4,0,987,991,C
4-HA,205,1,2,983,0,986,G
4-HA,206,977,1,0,0,978,A
4-HA,207,0,0,0,979,979,C
4-HA,208,959,0,0,0,959,A
4-HA,209,0,0,1036,0,1036,G
4-HA,210,0,1033,0,3,1036,T
4-HA,211,1,0,0,1049,1050,C
4-HA,212,0,1,0,1052,1053,C
4-HA,213,0,1043,0,2,1045,T
4-HA,214,0,1,0,1072,1073,C
4-HA,215,1070,0,0,1,1071,A
4-HA,216,0,1070,0,3,1073,T
4-HA,217,0,0,0,1076,1076,C
4-HA,218,1018,1,3,0,1022,A
4-HA,219,0,1,1029,0,1030,G
4-HA,220,1011,0,2,0,1013,A
4-HA,221,0,1021,0,0,1021,T
4-HA,222,2,0,0,1023,1025,C
4-HA,223,0,0,0,1005,1005,C
4-HA,224,0,1001,0,1,1002,T
4-HA,225,0,998,0,2,1000,T
4-HA,226,1,0,1002,0,1003,G
4-HA,227,1006,1,1,0,1008,A
4-HA,228,0,1002,0,0,1002,T
4-HA,229,0,2,1016,1,1019,G
4-HA,230,0,3,1012,0,1015,G
4-HA,231,1007,1,4,0,1012,A
4-HA,232,0,0,1021,0,1021,G
4-HA,233,1021,0,0,0,1021,A
4-HA,234,1024,0,1,0,1025,A
4-HA,235,1029,0,0,0,1029,A
4-HA,236,1034,0,0,0,1034,A
4-HA,237,0,0,0,1036,1036,C
4-HA,238,0,1021,0,0,1021,T
4-HA,239,0,0,1035,0,1035,G
4-HA,240,0,0,0,1031,1031,C
4-HA,241,1028,0,1,0,1029,A
4-HA,242,0,0,0,1057,1057,C
4-HA,243,1049,0,0,0,1049,A
4-HA,244,0,0,0,1149,1149,C
4-HA,245,0,1141,0,1,1142,T
4-HA,246,1175,0,1,0,1176,A
4-HA,247,1171,0,0,0,1171,A
4-HA,248,0,1166,0,0,1166,T
4-HA,249,1172,0,0,0,1172,A
4-HA,250,0,0,1177,0,1177,G
4-HA,251,1156,0,2,0,1158,A
4-HA,252,0,1136,0,1,1137,T
4-HA,253,0,0,1082,0,1082,G
4-HA,254,0,0,0,1095,1095,C
4-HA,255,0,1080,0,3,1083,T
4-HA,256,2,0,0,1159,1161,C
4-HA,257,1,1161,1,1,1164,T
4-HA,258,1202,0,2,0,1204,A
4-HA,259,0,1202,0,0,1202,T
4-HA,260,0,1198,0,0,1198,T
4-HA,261,0,1,1219,0,1220,G
4-HA,262,0,1,1226,0,1227,G
4-HA,263,0,3,1242,0,1245,G
4-HA,264,1216,0,2,0,1218,A
4-HA,265,1,4,1219,0,1224,G
4-HA,266,1192,0,3,0,1195,A
4-HA,267,0,0,2,1464,1466,C
4-HA,268,1,1,0,1506,1508,C
4-HA,269,0,1,0,1526,1527,C
4-HA,270,0,1518,6,2,1526,T
4-HA,271,1,1,0,1588,1590,C
4-HA,272,1590,0,0,0,1590,A
4-HA,273,0,0,1747,0,1747,G
4-HA,274,0,1741,0,2,1743,T
4-HA,275,0,1,1769,0,1770,G
4-HA,276,0,1721,0,2,1723,T
4-HA,277,0,2,1709,0,1711,G
4-HA,278,1713,1,1,1,1716,A
4-HA,279,0,1718,0,1,1719,T
4-HA,280,1,2,1716,0,1719,G
4-HA,281,2,1,1716,0,1719,G
4-HA,282,0,0,0,1706,1706,C
4-HA,283,0,1701,0,2,1703,T
4-HA,284,1,1704,0,0,1705,T
4-HA,285,2,2,0,1704,1708,C
4-HA,286,1,0,0,1712,1713,C
4-HA,287,1721,0,0,0,1721,A
4-HA,288,1720,0,1,0,1721,A
4-HA,289,1724,0,0,0,1724,A
4-HA,290,1746,0,0,0,1746,A
4-HA,291,0,1746,1,0,1747,T
4-HA,292,1741,0,3,0,1744,A
4-HA,293,1745,0,1,0,1746,A
4-HA,294,0,1,1757,0,1758,G
4-HA,295,1770,2,1,1,1774,A
4-HA,296,1785,0,0,0,1785,A
4-HA,297,1783,0,2,0,1785,A
4-HA,298,0,1786,0,0,1786,T
4-HA,299,0,3,1775,0,1778,G
4-HA,300,0,2,1766,0,1768,G
4-HA,301,1,3,1767,0,1771,G
4-HA,302,1751,0,3,0,1754,A
4-HA,303,0,0,0,1776,1776,C
4-HA,304,4,0,0,1781,1785,C
4-HA,305,0,1820,0,4,1824,T
4-HA,306,0,1830,0,1,1831,T
4-HA,307,0,1822,0,1,1823,T
4-HA,308,0,1840,0,0,1840,T
4-HA,309,0,1847,0,0,1847,T
4-HA,310,0,1,1864,0,1865,G
4-HA,311,0,1855,0,0,1855,T
4-HA,312,0,1843,0,2,1845,T
4-HA,313,2,3,1843,0,1848,G
4-HA,314,1831,0,2,0,1833,A
4-HA,315,1843,0,1,0,1844,A
4-HA,316,1,2,0,1843,1846,C
4-HA,317,0,0,1838,0,1838,G
4-HA,318,1,0,0,1878,1879,C
4-HA,319,1875,0,3,0,1878,A
4-HA,320,0,1,1885,0,1886,G
4-HA,321,1,0,0,1886,1887,C
4-HA,322,1891,0,1,0,1892,A
4-HA,323,1878,0,5,1,1884,A
4-HA,324,1882,1,0,0,1883,A
4-HA,325,1,0,1993,0,1994,G
4-HA,326,1,1,0,1995,1997,C
4-HA,327,1,0,0,1989,1990,C
4-HA,328,0,1992,0,0,1992,T
4-HA,329,1985,0,2,0,1987,A
4-HA,330,1,0,0,2016,2017,C
4-HA,331,2009,0,3,0,2012,A
4-HA,332,0,1,2011,1,2013,G
4-HA,333,0,0,0,2000,2000,C
4-HA,334,1945,0,1,0,1946,A
4-HA,335,1962,0,1,0,1963,A
4-HA,336,0,0,0,2067,2067,C
4-HA,337,0,2062,0,0,2062,T
4-HA,338,2,2,2067,0,2071,G
4-HA,339,0,2057,0,3,2060,T
4-HA,340,0,2066,0,0,2066,T
4-HA,341,2055,0,0,1,2056,A
4-HA,342,0,0,0,2217,2217,C
4-HA,343,1,1,0,2214,2216,C
4-HA,344,5,0,0,2267,2272,C
4-HA,345,0,2195,0,1,2196,T
4-HA,346,0,2201,0,0,2201,T
4-HA,347,2203,0,2,0,2205,A
4-HA,348,0,2207,0,0,2207,T
4-HA,349,0,2,2203,0,2205,G
4-HA,350,2197,0,0,0,2197,A
4-HA,351,1,2056,0,0,2057,T
4-HA,352,0,0,2105,1,2106,G
4-HA,353,0,2046,0,1,2047,T
4-HA,354,0,2,2054,0,2056,G
4-HA,355,2,2,0,2044,2048,C
4-HA,356,1,0,0,2046,2047,C
4-HA,357,1,0,2073,0,2074,G
4-HA,358,2,5,2094,0,2101,G
4-HA,359,2096,0,0,0,2096,A
4-HA,360,0,2111,0,0,2111,T
4-HA,361,0,2084,0,3,2087,T
4-HA,362,2105,0,1,0,2106,A
4-HA,363,0,2092,0,3,2095,T
4-HA,364,1,2,2086,0,2089,G
4-HA,365,1,1,0,2088,2090,C
4-HA,366,1,0,0,2075,2076,C
4-HA,367,0,2085,0,4,2089,T
4-HA,368,2,0,0,2208,2210,C
4-HA,369,5,2,0,2218,2225,C
4-HA,370,7,1,0,2230,2238,C
4-HA,371,0,2221,0,1,2222,T
4-HA,372,0,2234,0,1,2235,T
4-HA,373,2227,0,0,0,2227,A
4-HA,374,1,1,2274,0,2276,G
4-HA,375,0,0,2277,0,2277,G
4-HA,376,0,2249,0,2,2251,T
4-HA,377,2,0,0,2202,2204,C
4-HA,378,2159,0,1,0,2160,A
4-HA,379,0,0,1,2243,2244,C
4-HA,380,0,2248,0,1,2249,T
4-HA,381,2253,0,1,0,2254,A
4-HA,382,0,1,2233,0,2234,G
4-HA,383,0,2199,0,1,2200,T
4-HA,384,0,2205,0,2,2207,T
4-HA,385,0,1,2233,0,2234,G
4-HA,386,0,1,0,2222,2223,C
4-HA,387,4,0,0,2224,2228,C
4-HA,388,0,2188,0,4,2192,T
4-HA,389,1,1,0,2212,2214,C
4-HA,390,2299,0,1,0,2300,A
4-HA,391,0,2306,0,0,2306,T
4-HA,392,0,0,0,2309,2309,C
4-HA,393,4,2,0,2309,2315,C
4-HA,394,1,5,2293,0,2299,G
4-HA,395,1,0,2307,0,2308,G
4-HA,396,1,0,2,2314,2317,C
4-HA,397,2336,0,2,0,2338,A
4-HA,398,0,1,0,2388,2389,C
4-HA,399,2330,0,1,0,2331,A
4-HA,400,1,2,0,2343,2346,C
4-HA,401,0,2335,0,5,2340,T
4-HA,402,1,0,2369,0,2370,G
4-HA,403,0,1,2392,0,2393,G
4-HA,404,2375,0,3,0,2378,A
4-HA,405,0,0,2415,0,2415,G
4-HA,406,0,2385,0,1,2386,T
4-HA,407,0,2380,0,3,2383,T
4-HA,408,0,2392,0,1,2393,T
4-HA,409,2378,0,2,0,2380,A
4-HA,410,2388,1,1,0,2390,A
4-HA,411,1,0,0,2399,2400,C
4-HA,412,2348,0,2,0,2350,A
4-HA,413,2353,0,1,0,2354,A
4-HA,414,0,2333,0,0,2333,T
4-HA,415,0,6,2315,0,2321,G
4-HA,416,2319,0,1,0,2320,A
4-HA,417,2323,0,1,0,2324,A
4-HA,418,2325,1,5,0,2331,A
4-HA,419,0,0,2332,0,2332,G
4-HA,420,1,0,0,2345,2346,C
4-HA,421,0,2339,0,4,2343,T
4-HA,422,0,2342,1,0,2343,T
4-HA,423,3,0,0,2367,2370,C
4-HA,424,2361,0,2,0,2363,A
4-HA,425,2365,0,1,0,2366,A
4-HA,426,0,2369,0,1,2370,T
4-HA,427,0,2363,0,2,2365,T
4-HA,428,2,4,2445,0,2451,G
4-HA,429,1,5,2493,0,2499,G
4-HA,430,2497,1,2,0,2500,A
4-HA,431,0,1,0,2516,2517,C
4-HA,432,2,2484,0,3,2489,T
4-HA,433,0,0,2492,0,2492,G
4-HA,434,0,3,2496,0,2499,G
4-HA,435,2480,0,7,0,2487,A
4-HA,436,0,1,2512,0,2513,G
4-HA,437,1,2436,1,1,2439,T
4-HA,438,3,1,0,2410,2414,C
4-HA,439,2428,0,0,0,2428,A
4-HA,440,0,0,0,2442,2442,C
4-HA,441,0,2436,0,3,2439,T
4-HA,442,1,2,2,2434,2439,C
4-HA,443,2417,1,2,0,2420,A
4-HA,444,2450,0,1,0,2451,A
4-HA,445,2450,0,3,0,2453,A
4-HA,446,2438,0,0,0,2438,A
4-HA,447,0,2415,0,0,2415,T
4-HA,448,0,2,2437,0,2439,G
4-HA,449,1,4,2456,0,2461,G
4-HA,450,2467,0,2,0,2469,A
4-HA,451,2469,0,5,0,2474,A
4-HA,452,0,1,0,2484,2485,C
4-HA,453,2461,0,1,0,2462,A
4-HA,454,2492,0,2,0,2494,A
4-HA,455,1,0,2498,0,2499,G
4-HA,456,0,0,0,2511,2511,C
4-HA,457,1,2478,0,6,2485,T
4-HA,458,3,2,0,2500,2505,C
4-HA,459,0,2487,0,0,2487,T
4-HA,460,4,1,2485,0,2490,G
4-HA,461,0,1,0,2499,2500,C
4-HA,462,0,2502,0,7,2509,T
4-HA,463,1,2543,0,1,2545,T
4-HA,464,0,2,2582,0,2584,G
4-HA,465,4,1,0,2599,2604,C
4-HA,466,2598,0,0,0,2598,A
4-HA,467,1,2574,0,1,2576,T
4-HA,468,2573,0,2,0,2575,A
4-HA,469,2550,0,4,1,2555,A
4-HA,470,0,3,2554,0,2557,G
4-HA,471,0,3,2549,0,2552,G
4-HA,472,2449,1,0,0,2450,A
4-HA,473,1,2,2444,0,2447,G
4-HA,474,2396,1,7,0,2404,A
4-HA,475,0,2495,0,2,2497,T
4-HA,476,1,0,1,2528,2530,C
4-HA,477,1,2543,0,2,2546,T
4-HA,478,2550,0,1,0,2551,A
4-HA,479,2539,0,2,1,2542,A
4-HA,480,0,2536,0,1,2537,T
4-HA,481,2529,0,0,0,2529,A
4-HA,482,2505,0,3,0,2508,A
4-HA,483,0,1,0,2511,2512,C
4-HA,484,2423,1,0,0,2424,A
4-HA,485,1,0,2439,0,2440,G
4-HA,486,1,2390,0,2,2393,T
4-HA,487,0,2461,0,1,2462,T
4-HA,488,1,2468,1,3,2473,T
4-HA,489,4,0,0,2508,2512,C
4-HA,490,0,2500,0,4,2504,T
4-HA,491,0,2507,0,1,2508,T
4-HA,492,0,2515,0,2,2517,T
4-HA,493,2489,0,2,0,2491,A
4-HA,494,1,0,2487,0,2488,G
4-HA,495,0,2473,0,1,2474,T
4-HA,496,2469,0,3,0,2472,A
4-HA,497,0,2,2494,0,2496,G
4-HA,498,2470,0,2,0,2472,A
4-HA,499,0,2476,0,0,2476,T
4-HA,500,0,2475,0,0,2475,T
4-HA,501,2462,0,2,0,2464,A
4-HA,502,2501,0,1,0,2502,A
4-HA,503,2503,0,2,0,2505,A
4-HA,504,0,2502,0,2,2504,T
4-HA,505,0,2479,0,0,2479,T
4-HA,506,0,7,2482,0,2489,G
4-HA,507,1,2,2489,0,2492,G
4-HA,508,0,2474,0,2,2476,T
4-HA,509,0,2480,0,4,2484,T
4-HA,510,1,8,2458,0,2467,G
4-HA,511,2457,0,2,0,2459,A
4-HA,512,1,0,0,2465,2466,C
4-HA,513,4,0,0,2456,2460,C
4-HA,514,2,0,0,2460,2462,C
4-HA,515,2456,0,3,0,2459,A
4-HA,516,0,1,0,2493,2494,C
4-HA,517,1,2487,1,1,2490,T
4-HA,518,0,2491,1,1,2493,T
4-HA,519,2490,0,0,1,2491,A
4-HA,520,2488,0,1,0,2489,A
4-HA,521,2490,0,0,0,2490,A
4-HA,522,2497,0,0,0,2497,A
4-HA,523,0,2535,0,0,2535,T
4-HA,524,0,2519,0,2,2521,T
4-HA,525,5,0,1,2529,2535,C
4-HA,526,2522,0,4,0,2526,A
4-HA,527,2528,0,0,0,2528,A
4-HA,528,2532,0,0,0,2532,A
4-HA,529,0,2529,0,1,2530,T
4-HA,530,2587,0,0,0,2587,A
4-HA,531,1,0,0,2620,2621,C
4-HA,532,5,2,0,2558,2565,C
4-HA,533,2,1,0,2561,2564,C
4-HA,534,2555,0,3,0,2558,A
4-HA,535,2,1,2682,0,2685,G
4-HA,536,0,0,0,2698,2698,C
4-HA,537,2696,0,1,0,2697,A
4-HA,538,0,2695,0,1,2696,T
4-HA,539,0,2632,0,1,2633,T
4-HA,540,0,6,2722,0,2728,G
4-HA,541,2715,0,1,0,2716,A
4-HA,542,2724,0,5,0,2729,A
4-HA,543,2,1,0,2722,2725,C
4-HA,544,3,0,2663,0,2666,G
4-HA,545,0,2658,0,4,2662,T
4-HA,546,0,12,2679,0,2691,G
4-HA,547,2680,0,4,0,2684,A
4-HA,548,1,0,0,2696,2697,C
4-HA,549,0,2605,0,1,2606,T
4-HA,550,2665,0,1,0,2666,A
4-HA,551,0,2653,0,1,2654,T
4-HA,552,0,0,2674,0,2674,G
4-HA,553,2,1,0,2657,2660,C
4-HA,554,4,1,0,2633,2638,C
4-HA,555,2630,1,4,0,2635,A
4-HA,556,2628,0,1,0,2629,A
4-HA,557,2672,0,1,1,2674,A
4-HA,558,0,0,0,2693,2693,C
4-HA,559,2616,0,0,0,2616,A
4-HA,560,2611,0,2,0,2613,A
4-HA,561,0,2581,0,0,2581,T
4-HA,562,3,6,2586,0,2595,G
4-HA,563,2593,1,4,0,2598,A
4-HA,564,2588,0,1,0,2589,A
4-HA,565,1,0,0,2540,2541,C
4-HA,566,2554,0,2,0,2556,A
4-HA,567,2577,0,1,0,2578,A
4-HA,568,1,2573,0,1,2575,T
4-HA,569,0,2569,0,0,2569,T
4-HA,570,1,2567,0,3,2571,T
4-HA,571,1,7,2562,0,2570,G
4-HA,572,2569,0,1,0,2570,A
4-HA,573,0,0,0,2577,2577,C
4-HA,574,2576,0,1,0,2577,A
4-HA,575,2581,0,1,0,2582,A
4-HA,576,2591,0,0,0,2591,A
4-HA,577,1,2610,0,1,2612,T
4-HA,578,1,2601,0,0,2602,T
4-HA,579,0,0,2624,0,2624,G
4-HA,580,1,2610,0,3,2614,T
4-HA,581,2622,2,2,0,2626,A
4-HA,582,1,1,0,2681,2683,C
4-HA,583,2677,0,1,0,2678,A
4-HA,584,1,2742,0,1,2744,T
4-HA,585,0,2700,0,0,2700,T
4-HA,586,0,2700,1,2,2703,T
4-HA,587,1,5,2690,0,2696,G
4-HA,588,1,4,2687,0,2692,G
4-HA,589,2,4,2670,0,2676,G
4-HA,590,3,5,2669,1,2678,G
4-HA,591,0,2,2654,0,2656,G
4-HA,592,1,0,2720,0,2721,G
4-HA,593,0,2695,1,3,2699,T
4-HA,594,1,2719,0,1,2721,T
4-HA,595,6,0,0,2718,2724,C
4-HA,596,2704,0,4,1,2709,A
4-HA,597,1,0,0,2731,2732,C
4-HA,598,7,1,0,2723,2731,C
4-HA,599,2726,0,3,0,2729,A
4-HA,600,0,0,0,2765,2765,C
4-HA,601,1,2,0,2707,2710,C
4-HA,602,4,2,0,2696,2702,C
4-HA,603,3,0,2706,0,2709,G
4-HA,604,1,1,2820,0,2822,G
4-HA,605,3,1,2838,0,2842,G
4-HA,606,0,2801,0,1,2802,T
4-HA,607,2836,0,2,0,2838,A
4-HA,608,1,3,1,2799,2804,C
4-HA,609,0,4,2755,0,2759,G
4-HA,610,2,3,2799,0,2804,G
4-HA,611,2808,0,1,0,2809,A
4-HA,612,2,3,0,2802,2807,C
4-HA,613,2639,1,0,0,2640,A
4-HA,614,2635,0,2,0,2637,A
4-HA,615,0,2625,0,0,2625,T
4-HA,616,2,6,2647,1,2656,G
4-HA,617,2659,2,3,0,2664,A
4-HA,618,0,0,0,2659,2659,C
4-HA,619,4,0,0,2633,2637,C
4-HA,620,2631,0,1,0,2632,A
4-HA,621,2626,0,0,0,2626,A
4-HA,622,2665,0,0,0,2665,A
4-HA,623,0,2639,0,0,2639,T
4-HA,624,3,0,0,2685,2688,C
4-HA,625,0,2586,0,4,2590,T
4-HA,626,0,2548,0,0,2548,T
4-HA,627,1,0,0,2609,2610,C
4-HA,628,0,3,0,2631,2634,C
4-HA,629,0,2634,0,3,2637,T
4-HA,630,0,1,2657,0,2658,G
4-HA,631,0,2619,0,0,2619,T
4-HA,632,2648,0,0,0,2648,A
4-HA,633,0,2626,0,1,2627,T
4-HA,634,1,1,2644,0,2646,G
4-HA,635,0,0,2,2647,2649,C
4-HA,636,0,2631,0,2,2633,T
4-HA,637,9,5,0,2635,2649,C
4-HA,638,2647,0,4,0,2651,A
4-HA,639,2637,0,2,0,2639,A
4-HA,640,3,0,2646,0,2649,G
4-HA,641,1,2,1,2656,2660,C
4-HA,642,2655,0,2,0,2657,A
4-HA,643,0,2628,0,2,2630,T
4-HA,644,5,1,1,2621,2628,C
4-HA,645,2616,0,7,1,2624,A
4-HA,646,0,2,2637,0,2639,G
4-HA,647,0,4,2644,0,2648,G
4-HA,648,2643,0,0,0,2643,A
4-HA,649,2620,1,6,1,2628,A
4-HA,650,0,4,2646,0,2650,G
4-HA,651,2648,0,0,0,2648,A
4-HA,652,2668,0,1,1,2670,A
4-HA,653,0,2700,0,0,2700,T
4-HA,654,2,2,0,2698,2702,C
4-HA,655,2674,0,3,0,2677,A
4-HA,656,1,0,0,2682,2683,C
4-HA,657,2670,0,3,0,2673,A
4-HA,658,0,1,2740,0,2741,G
4-HA,659,0,2684,1,0,2685,T
4-HA,660,0,0,0,2714,2714,C
4-HA,661,1,2651,0,3,2655,T
4-HA,662,5,0,0,2761,2766,C
4-HA,663,0,2772,0,1,2773,T
4-HA,664,2787,1,0,0,2788,A
4-HA,665,1,0,0,2792,2793,C
4-HA,666,7,0,0,2786,2793,C
4-HA,667,2753,0,1,0,2754,A
4-HA,668,2760,0,1,0,2761,A
4-HA,669,2723,0,2,0,2725,A
4-HA,670,2727,0,4,0,2731,A
4-HA,671,1,1,2721,0,2723,G
4-HA,672,2665,0,2,0,2667,A
4-HA,673,2642,1,3,0,2646,A
4-HA,674,0,0,2657,0,2657,G
4-HA,675,1,2,0,2637,2640,C
4-HA,676,2,0,0,2668,2670,C
4-HA,677,2667,0,0,1,2668,A
4-HA,678,2667,1,3,0,2671,A
4-HA,679,0,3,0,2675,2678,C
4-HA,680,2684,0,0,0,2684,A
4-HA,681,2680,0,2,1,2683,A
4-HA,682,2672,0,3,0,2675,A
4-HA,683,1,1,0,2733,2735,C
4-HA,684,1,2698,0,3,2702,T
4-HA,685,0,0,2716,0,2716,G
4-HA,686,1,2703,1,1,2706,T
4-HA,687,2711,0,1,0,2712,A
4-HA,688,2720,0,1,1,2722,A
4-HA,689,0,2677,0,1,2678,T
4-HA,690,2,1,0,2712,2715,C
4-HA,691,2,0,0,2706,2708,C
4-HA,692,2,0,0,2671,2673,C
4-HA,693,1,5,2672,0,2678,G
4-HA,694,2659,1,0,0,2660,A
4-HA,695,2679,0,0,0,2679,A
4-HA,696,0,2673,0,0,2673,T
4-HA,697,2685,0,0,0,2685,A
4-HA,698,0,2653,0,2,2655,T
4-HA,699,5,4,1,2649,2659,C
4-HA,700,1,1,2653,0,2655,G
4-HA,701,1,2,2712,0,2715,G
4-HA,702,2712,0,0,0,2712,A
4-HA,703,0,2749,0,1,2750,T
4-HA,704,5,0,1,2745,2751,C
4-HA,705,0,2748,0,1,2749,T
4-HA,706,2731,0,2,0,2733,A
4-HA,707,0,4,2747,0,2751,G
4-HA,708,2747,0,4,0,2751,A
4-HA,709,1,1,0,2749,2751,C
4-HA,710,4,0,0,2656,2660,C
4-HA,711,1,0,0,2674,2675,C
4-HA,712,2647,0,5,0,2652,A
4-HA,713,0,3,2809,0,2812,G
4-HA,714,2801,0,3,0,2804,A
4-HA,715,0,1,2856,0,2857,G
4-HA,716,0,2822,0,1,2823,T
4-HA,717,2818,0,1,0,2819,A
4-HA,718,2802,1,4,0,2807,A
4-HA,719,0,1,2857,0,2858,G
4-HA,720,0,1,2886,1,2888,G
4-HA,721,2856,0,1,0,2857,A
4-HA,722,2630,0,5,0,2635,A
4-HA,723,0,2635,0,0,2635,T
4-HA,724,2662,0,1,0,2663,A
4-HA,725,1,2644,1,3,2649,T
4-HA,726,3,1,0,2673,2677,C
4-HA,727,3,0,0,2667,2670,C
4-HA,728,6,0,0,2622,2628,C
4-HA,729,1,2597,1,1,2600,T
4-HA,730,2618,0,0,0,2618,A
4-HA,731,2,1,2616,0,2619,G
4-HA,732,1,4,0,2622,2627,C
4-HA,733,2569,0,2,0,2571,A
4-HA,734,0,3,2656,0,2659,G
4-HA,735,2624,0,5,0,2629,A
4-HA,736,2635,0,1,0,2636,A
4-HA,737,0,2631,0,1,2632,T
4-HA,738,2633,0,0,0,2633,A
4-HA,739,2639,0,2,0,2641,A
4-HA,740,1,0,2631,0,2632,G
4-HA,741,1,2,0,2642,2645,C
4-HA,742,2647,0,0,0,2647,A
4-HA,743,0,2572,0,0,2572,T
4-HA,744,5,0,1,2720,2726,C
4-HA,745,0,2716,0,2,2718,T
4-HA,746,2740,0,0,0,2740,A
4-HA,747,0,2743,0,3,2746,T
4-HA,748,0,2716,0,0,2716,T
4-HA,749,1,2,2744,0,2747,G
4-HA,750,0,6,2716,0,2722,G
4-HA,751,2722,0,2,0,2724,A
4-HA,752,1,0,0,2729,2730,C
4-HA,753,2545,0,1,0,2546,A
4-HA,754,2614,1,0,0,2615,A
4-HA,755,0,2777,0,1,2778,T
4-HA,756,2803,0,3,0,2806,A
4-HA,757,0,0,2833,0,2833,G
4-HA,758,0,2804,1,0,2805,T
4-HA,759,2814,2,5,0,2821,A
4-HA,760,2822,0,1,0,2823,A
4-HA,761,2859,0,3,0,2862,A
4-HA,762,2877,0,3,0,2880,A
4-HA,763,1,1,0,2920,2922,C
4-HA,764,3,1,0,2782,2786,C
4-HA,765,2,5,2764,1,2772,G
4-HA,766,1,1,2787,1,2790,G
4-HA,767,1,0,2818,0,2819,G
4-HA,768,2811,0,1,0,2812,A
4-HA,769,0,9,2843,0,2852,G
4-HA,770,2899,0,4,0,2903,A
4-HA,771,3,0,0,2900,2903,C
4-HA,772,2892,1,3,3,2899,A
4-HA,773,0,2904,0,3,2907,T
4-HA,774,2915,0,0,2,2917,A
4-HA,775,0,0,0,2977,2977,C
4-HA,776,0,2949,0,8,2957,T
4-HA,777,0,2997,0,1,2998,T
4-HA,778,0,3006,0,1,3007,T
4-HA,779,1,3001,0,2,3004,T
4-HA,780,0,8,3042,0,3050,G
4-HA,781,3052,0,0,0,3052,A
4-HA,782,0,3047,0,1,3048,T
4-HA,783,0,3153,0,1,3154,T
4-HA,784,3137,1,0,0,3138,A
4-HA,785,3145,0,2,1,3148,A
4-HA,786,2,2,0,3193,3197,C
4-HA,787,3174,0,2,0,3176,A
4-HA,788,0,0,3305,0,3305,G
4-HA,789,1,2,0,3302,3305,C
4-HA,790,3302,0,2,0,3304,A
4-HA,791,0,1,0,3333,3334,C
4-HA,792,3282,0,6,0,3288,A
4-HA,793,1,2,3343,0,3346,G
4-HA,794,1,2,3323,0,3326,G
4-HA,795,0,8,3449,0,3457,G
4-HA,796,3436,0,3,0,3439,A
4-HA,797,3437,0,3,0,3440,A
4-HA,798,0,3446,0,2,3448,T
4-HA,799,4,1,0,3446,3451,C
4-HA,800,0,3481,0,0,3481,T
4-HA,801,3483,0,1,0,3484,A
4-HA,802,3466,0,1,0,3467,A
4-HA,803,0,3453,0,0,3453,T
4-HA,804,0,3346,0,2,3348,T
4-HA,805,1,2,3408,0,3411,G
4-HA,806,0,0,1,3516,3517,C
4-HA,807,0,3620,0,6,3626,T
4-HA,808,9,1,2,3737,3749,C
4-HA,809,3,2,0,3740,3745,C
4-HA,810,0,3756,0,1,3757,T
4-HA,811,3743,0,2,1,3746,A
4-HA,812,1,6,3753,0,3760,G
4-HA,813,1,18,3766,0,3785,G
4-HA,814,0,6,3772,0,3778,G
4-HA,815,1,1,3751,0,3753,G
4-HA,816,0,3647,1,3,3651,T
4-HA,817,0,3627,0,3,3630,T
4-HA,818,3622,0,2,0,3624,A
4-HA,819,0,0,0,3703,3703,C
4-HA,820,1,3684,0,6,3691,T
4-HA,821,0,3717,0,1,3718,T
4-HA,822,3,0,0,3694,3697,C
4-HA,823,3682,0,0,0,3682,A
4-HA,824,3689,0,1,0,3690,A
4-HA,825,3695,0,1,1,3697,A
4-HA,826,3719,0,0,1,3720,A
4-HA,827,0,3721,0,2,3723,T
4-HA,828,3700,0,1,0,3701,A
4-HA,829,0,2,0,3705,3707,C
4-HA,830,28,6,3670,0,3704,G
4-HA,831,3697,0,3,0,3700,A
4-HA,832,3704,0,3,0,3707,A
4-HA,833,1,1,3769,0,3771,G
4-HA,834,0,3754,0,2,3756,T
4-HA,835,3,3,3783,1,3790,G
4-HA,836,0,5,3782,0,3787,G
4-HA,837,3,9,3783,0,3795,G
4-HA,838,3796,0,4,0,3800,A
4-HA,839,3802,0,3,0,3805,A
4-HA,840,3809,0,3,0,3812,A
4-HA,841,3778,0,7,2,3787,A
4-HA,842,0,1,3852,0,3853,G
4-HA,843,0,2,0,3825,3827,C
4-HA,844,0,3786,0,8,3794,T
4-HA,845,5,1,0,3864,3870,C
4-HA,846,3877,0,4,0,3881,A
4-HA,847,3907,0,3,0,3910,A
4-HA,848,0,3913,0,0,3913,T
4-HA,849,3954,0,1,0,3955,A
4-HA,850,3948,0,2,0,3950,A
4-HA,851,1,3880,0,3,3884,T
4-HA,852,1,8,3889,0,3898,G
4-HA,853,3862,2,3,0,3867,A
4-HA,854,1,4,3997,0,4002,G
4-HA,855,4006,1,2,0,4009,A
4-HA,856,0,3982,0,2,3984,T
4-HA,857,7,2,0,4054,4063,C
4-HA,858,4028,0,0,0,4028,A
4-HA,859,0,6,4116,0,4122,G
4-HA,860,4119,0,6,1,4126,A
4-HA,861,0,4089,0,4,4093,T
4-HA,862,2,0,4098,0,4100,G
4-HA,863,2,1,1,3978,3982,C
4-HA,864,3976,0,7,0,3983,A
4-HA,865,2,4,0,4095,4101,C
4-HA,866,9,1,0,4033,4043,C
4-HA,867,7,0,0,4056,4063,C
4-HA,868,3980,0,2,0,3982,A
4-HA,869,1,3960,0,4,3965,T
4-HA,870,0,3955,1,6,3962,T
4-HA,871,1,8,3994,0,4003,G
4-HA,872,3,2,3988,0,3993,G
4-HA,873,2,0,0,4005,4007,C
4-HA,874,3919,1,0,0,3920,A
4-HA,875,3909,0,1,0,3910,A
4-HA,876,3979,1,2,0,3982,A
4-HA,877,0,3982,0,1,3983,T
4-HA,878,0,1,3991,0,3992,G
4-HA,879,1,1,0,3992,3994,C
4-HA,880,3940,0,1,0,3941,A
4-HA,881,4038,1,3,0,4042,A
4-HA,882,1,4019,0,8,4028,T
4-HA,883,0,4071,0,1,4072,T
4-HA,884,6,0,0,4092,4098,C
4-HA,885,0,3998,1,6,4005,T
4-HA,886,1,7,4063,0,4071,G
4-HA,887,4060,0,2,0,4062,A
4-HA,888,4086,0,2,0,4088,A
4-HA,889,0,4069,0,4,4073,T
4-HA,890,3,0,4016,0,4019,G
4-HA,891,1,3,0,4043,4047,C
4-HA,892,4033,0,0,0,4033,A
4-HA,893,0,4025,0,8,4033,T
4-HA,894,11,1,0,4017,4029,C
4-HA,895,4017,0,4,0,4021,A
4-HA,896,1,0,0,4196,4197,C
4-HA,897,0,4148,0,4,4152,T
4-HA,898,2,1,0,4186,4189,C
4-HA,899,4,0,1,4165,4170,C
4-HA,900,4200,0,0,0,4200,A
4-HA,901,4198,0,0,0,4198,A
4-HA,902,4185,0,1,1,4187,A
4-HA,903,0,4039,0,0,4039,T
4-HA,904,0,10,4067,0,4077,G
4-HA,905,1,4,4075,0,4080,G
4-HA,906,4073,0,3,0,4076,A
4-HA,907,4064,1,6,0,4071,A
4-HA,908,2,0,4082,0,4084,G
4-HA,909,2,0,0,4028,4030,C
4-HA,910,4021,0,1,0,4022,A
4-HA,911,2,4034,0,2,4038,T
4-HA,912,0,4009,0,1,4010,T
4-HA,913,5,1,0,4140,4146,C
4-HA,914,2,0,0,4127,4129,C
4-HA,915,2,0,0,4140,4142,C
4-HA,916,4143,0,2,0,4145,A
4-HA,917,4194,1,1,7,4203,A
4-HA,918,0,4279,0,4,4283,T
4-HA,919,0,9,4276,0,4285,G
4-HA,920,4269,0,1,0,4270,A
4-HA,921,2,0,0,4273,4275,C
4-HA,922,4169,0,3,0,4172,A
4-HA,923,4173,1,1,2,4177,A
4-HA,924,4158,0,1,1,4160,A
4-HA,925,1,0,0,4201,4202,C
4-HA,926,5,0,0,4121,4126,C
4-HA,927,4052,0,2,0,4054,A
4-HA,928,0,4042,0,4,4046,T
4-HA,929,0,4018,0,4,4022,T
4-HA,930,4,2,0,4053,4059,C
4-HA,931,4,0,0,4060,4064,C
4-HA,932,4066,0,0,0,4066,A
4-HA,933,4053,0,0,1,4054,A
4-HA,934,4041,1,4,0,4046,A
4-HA,935,4211,1,0,0,4212,A
4-HA,936,1,4186,0,0,4187,T
4-HA,937,2,1,4215,0,4218,G
4-HA,938,0,4182,0,3,4185,T
4-HA,939,3810,0,411,0,4221,A
4-HA,940,4221,0,1,0,4222,A
4-HA,941,4208,0,3,1,4212,A
4-HA,942,1,1,0,4232,4234,C
4-HA,943,4148,0,0,1,4149,A
4-HA,944,1,1,4110,0,4112,G
4-HA,945,2,6,4067,0,4075,G
4-HA,946,4162,0,0,0,4162,A
4-HA,947,0,4148,0,4,4152,T
4-HA,948,9,1,0,4194,4204,C
4-HA,949,4221,0,2,0,4223,A
4-HA,950,7,0,0,4366,4373,C
4-HA,951,4378,0,0,0,4378,A
4-HA,952,1,4526,0,0,4527,T
4-HA,953,4411,0,3,0,4414,A
4-HA,954,1,7,0,4403,4411,C
4-HA,955,3,4,4276,0,4283,G
4-HA,956,1,5,4261,0,4267,G
4-HA,957,3,4,4196,0,4203,G
4-HA,958,2,0,4198,2,4202,G
4-HA,959,1,1,1,4134,4137,C
4-HA,960,6,1,0,4139,4146,C
4-HA,961,0,4030,0,5,4035,T
4-HA,962,0,1,4434,0,4435,G
4-HA,963,0,4397,0,6,4403,T
4-HA,964,5,0,0,4442,4447,C
4-HA,965,4,2,1,4436,4443,C
4-HA,966,8,1,0,4459,4468,C
4-HA,967,4448,0,4,0,4452,A
4-HA,968,0,3,4486,1,4490,G
4-HA,969,4465,0,1,0,4466,A
4-HA,970,0,4447,0,3,4450,T
4-HA,971,4096,1,1,0,4098,A
4-HA,972,0,4031,0,2,4033,T
4-HA,973,2,3,4059,0,4064,G
4-HA,974,0,4035,0,5,4040,T
4-HA,975,0,3999,0,0,3999,T
4-HA,976,4040,0,1,0,4041,A
4-HA,977,3984,0,2,0,3986,A
4-HA,978,3,5,4012,0,4020,G
4-HA,979,0,0,0,4020,4020,C
4-HA,980,3950,0,0,0,3950,A
4-HA,981,3956,0,3,0,3959,A
4-HA,982,3915,1,2,0,3918,A
4-HA,983,3921,0,4,0,3925,A
4-HA,984,1,0,0,3918,3919,C
4-HA,985,3880,2,0,0,3882,A
4-HA,986,1,0,0,3921,3922,C
4-HA,987,0,3828,0,2,3830,T
4-HA,988,7,0,0,3855,3862,C
4-HA,989,0,3876,0,2,3878,T
4-HA,990,1,10,3890,0,3901,G
4-HA,991,3902,0,2,0,3904,A
4-HA,992,3899,0,2,0,3901,A
4-HA,993,3896,0,2,1,3899,A
4-HA,994,0,3870,0,2,3872,T
4-HA,995,0,3835,0,0,3835,T
4-HA,996,0,8,3862,0,3870,G
4-HA,997,1,0,3851,0,3852,G
4-HA,998,0,2,0,3868,3870,C
4-HA,999,3856,1,3,0,3860,A
4-HA,1000,3844,0,4,0,3848,A
4-HA,1001,2,1,0,3858,3861,C
4-HA,1002,3851,0,2,0,3853,A
4-HA,1003,1,9,3888,1,3899,G
4-HA,1004,0,2,3883,0,3885,G
4-HA,1005,1,4,3864,0,3869,G
4-HA,1006,3833,0,5,1,3839,A
4-HA,1007,2,3803,0,1,3806,T
4-HA,1008,0,2,3829,0,3831,G
4-HA,1009,2,1,0,3834,3837,C
4-HA,1010,1,5,3844,0,3850,G
4-HA,1011,3886,0,3,0,3889,A
4-HA,1012,3823,0,2,0,3825,A
4-HA,1013,3855,0,4,0,3859,A
4-HA,1014,0,3789,0,1,3790,T
4-HA,1015,1,2,3878,0,3881,G
4-HA,1016,1,3863,0,4,3868,T
4-HA,1017,3838,0,3,1,3842,A
4-HA,1018,2,3,0,3846,3851,C
4-HA,1019,6,0,0,3836,3842,C
4-HA,1020,3761,1,4,1,3767,A
4-HA,1021,0,6,3750,0,3756,G
4-HA,1022,3719,0,4,0,3723,A
4-HA,1023,2,3,3757,0,3762,G
4-HA,1024,3680,0,3,0,3683,A
4-HA,1025,3666,0,5,0,3671,A
4-HA,1026,3669,0,5,0,3674,A
4-HA,1027,0,0,0,3679,3679,C
4-HA,1028,3673,0,2,0,3675,A
4-HA,1029,3736,0,3,0,3739,A
4-HA,1030,3698,0,5,2,3705,A
4-HA,1031,1,1,0,3735,3737,C
4-HA,1032,0,3695,0,23,3718,T
4-HA,1033,3672,0,5,1,3678,A
4-HA,1034,1,1,3670,0,3672,G
4-HA,1035,3635,1,8,0,3644,A
4-HA,1036,1,2,3738,0,3741,G
4-HA,1037,2,0,3715,0,3717,G
4-HA,1038,2,0,0,3668,3670,C
4-HA,1039,3668,0,3,0,3671,A
4-HA,1040,0,3696,1,1,3698,T
4-HA,1041,3723,0,1,0,3724,A
4-HA,1042,0,3699,0,2,3701,T
4-HA,1043,0,3690,0,1,3691,T
4-HA,1044,0,3692,0,1,3693,T
4-HA,1045,3,2,3582,0,3587,G
4-HA,1046,1,0,3584,0,3585,G
4-HA,1047,3,9,0,3536,3548,C
4-HA,1048,1,0,3573,0,3574,G
4-HA,1049,0,0,1,3539,3540,C
4-HA,1050,3537,1,3,0,3541,A
4-HA,1051,3560,0,1,0,3561,A
4-HA,1052,0,3542,0,1,3543,T
4-HA,1053,3,1,1,3567,3572,C
4-HA,1054,1,0,3577,0,3578,G
4-HA,1055,1,3,0,3554,3558,C
4-HA,1056,3,5,3572,0,3580,G
4-HA,1057,2,3,3596,0,3601,G
4-HA,1058,2,2,3610,0,3614,G
4-HA,1059,0,3584,1,4,3589,T
4-HA,1060,0,3560,0,2,3562,T
4-HA,1061,0,3565,0,6,3571,T
4-HA,1062,12,0,0,3547,3559,C
4-HA,1063,3569,0,2,0,3571,A
4-HA,1064,0,3575,0,0,3575,T
4-HA,1065,3565,0,5,0,3570,A
4-HA,1066,2,2,3607,0,3611,G
4-HA,1067,3516,1,0,0,3517,A
4-HA,1068,3531,0,0,0,3531,A
4-HA,1069,3528,0,0,0,3528,A
4-HA,1070,3539,0,2,0,3541,A
4-HA,1071,0,3530,0,0,3530,T
4-HA,1072,0,3,3557,0,3560,G
4-HA,1073,0,1,3555,0,3556,G
4-HA,1074,0,3507,0,2,3509,T
4-HA,1075,1,3475,0,4,3480,T
4-HA,1076,2,3,3481,0,3486,G
4-HA,1077,2,5,3478,0,3485,G
4-HA,1078,1,4,3490,0,3495,G
4-HA,1079,3440,0,14,0,3454,A
4-HA,1080,1,1,3477,0,3479,G
4-HA,1081,0,4,3429,0,3433,G
4-HA,1082,0,2,3477,0,3479,G
4-HA,1083,3449,1,3,0,3453,A
4-HA,1084,3485,1,5,0,3491,A
4-HA,1085,0,3482,0,3,3485,T
4-HA,1086,1,2,3476,0,3479,G
4-HA,1087,0,2,3556,0,3558,G
4-HA,1088,0,3494,1,1,3496,T
4-HA,1089,2,2,3505,0,3509,G
4-HA,1090,1,2,3491,0,3494,G
4-HA,1091,3395,0,0,1,3396,A
4-HA,1092,0,3426,0,1,3427,T
4-HA,1093,0,3,3473,0,3476,G
4-HA,1094,1,2,3532,0,3535,G
4-HA,1095,0,3427,0,1,3428,T
4-HA,1096,0,3328,0,4,3332,T
4-HA,1097,0,6,3310,1,3317,G
4-HA,1098,0,2,3384,0,3386,G
4-HA,1099,0,3345,0,2,3347,T
4-HA,1100,3366,1,5,0,3372,A
4-HA,1101,0,1,0,3184,3185,C
4-HA,1102,0,4,3231,0,3235,G
4-HA,1103,0,0,3315,0,3315,G
4-HA,1104,0,3301,0,3,3304,T
4-HA,1105,0,3308,1,3,3312,T
4-HA,1106,0,3301,0,1,3302,T
4-HA,1107,3,0,0,3227,3230,C
4-HA,1108,3240,0,5,0,3245,A
4-HA,1109,0,3,3231,0,3234,G
4-HA,1110,1,0,3237,0,3238,G
4-HA,1111,1,0,0,3216,3217,C
4-HA,1112,3102,0,0,0,3102,A
4-HA,1113,1,3107,0,1,3109,T
4-HA,1114,3,0,0,3132,3135,C
4-HA,1115,3139,3,0,0,3142,A
4-HA,1116,3138,2,0,0,3140,A
4-HA,1117,3142,0,1,0,3143,A
4-HA,1118,3149,0,0,0,3149,A
4-HA,1119,0,3153,0,0,3153,T
4-HA,1120,0,3142,0,3,3145,T
4-HA,1121,3,1,0,3147,3151,C
4-HA,1122,0,3125,0,2,3127,T
4-HA,1123,1,2,3126,0,3129,G
4-HA,1124,3108,0,3,1,3112,A
4-HA,1125,0,3,3136,0,3139,G
4-HA,1126,1,3,3141,0,3145,G
4-HA,1127,3,1,3166,0,3170,G
4-HA,1128,3140,0,2,1,3143,A
4-HA,1129,3133,0,1,0,3134,A
4-HA,1130,1,5,3125,0,3131,G
4-HA,1131,3150,0,1,0,3151,A
4-HA,1132,1,4,3174,0,3179,G
4-HA,1133,0,5,3187,0,3192,G
4-HA,1134,3175,0,4,0,3179,A
4-HA,1135,2,1,0,3173,3176,C
4-HA,1136,3150,0,3,0,3153,A
4-HA,1137,3132,1,8,0,3141,A
4-HA,1138,2,2,3148,0,3152,G
4-HA,1139,1,2,0,3147,3150,C
4-HA,1140,3108,0,3,1,3112,A
4-HA,1141,1,0,3107,0,3108,G
4-HA,1142,3,2,0,3084,3089,C
4-HA,1143,3091,0,2,0,3093,A
4-HA,1144,2,2,3126,0,3130,G
4-HA,1145,3084,0,4,0,3088,A
4-HA,1146,0,3142,0,1,3143,T
4-HA,1147,5,1,0,3175,3181,C
4-HA,1148,1,3134,0,4,3139,T
4-HA,1149,9,2,0,3173,3184,C
4-HA,1150,3175,0,0,0,3175,A
4-HA,1151,3166,0,5,0,3171,A
4-HA,1152,3174,0,1,0,3175,A
4-HA,1153,3098,0,13,1,3112,A
4-HA,1154,2,1,3100,0,3103,G
4-HA,1155,0,0,0,3053,3053,C
4-HA,1156,3023,0,0,0,3023,A
4-HA,1157,3,0,0,3083,3086,C
4-HA,1158,0,3031,0,5,3036,T
4-HA,1159,7,0,0,3059,3066,C
4-HA,1160,3058,0,1,0,3059,A
4-HA,1161,3125,0,2,0,3127,A
4-HA,1162,0,1,3126,0,3127,G
4-HA,1163,0,2,0,3125,3127,C
4-HA,1164,3119,0,5,0,3124,A
4-HA,1165,1,2,3121,0,3124,G
4-HA,1166,0,1,0,3047,3048,C
4-HA,1167,3047,0,0,0,3047,A
4-HA,1168,3037,0,0,0,3037,A
4-HA,1169,0,3001,0,0,3001,T
4-HA,1170,6,2,0,2914,2922,C
4-HA,1171,5,4,2941,0,2950,G
4-HA,1172,2939,0,0,0,2939,A
4-HA,1173,0,2919,1,2,2922,T
4-HA,1174,4,1,0,2921,2926,C
4-HA,1175,2919,0,2,0,2921,A
4-HA,1176,2965,0,1,0,2966,A
4-HA,1177,2968,0,1,0,2969,A
4-HA,1178,0,2952,0,0,2952,T
4-HA,1179,6,2,0,2971,2979,C
4-HA,1180,2933,0,1,0,2934,A
4-HA,1181,2942,0,4,0,2946,A
4-HA,1182,0,2940,0,3,2943,T
4-HA,1183,1,7,2958,0,2966,G
4-HA,1184,1,2,2934,1,2938,G
4-HA,1185,1,4,2904,0,2909,G
4-HA,1186,2895,0,4,0,2899,A
4-HA,1187,2897,1,1,0,2899,A
4-HA,1188,0,0,2954,0,2954,G
4-HA,1189,3,1,0,2944,2948,C
4-HA,1190,0,2928,0,5,2933,T
4-HA,1191,3,6,3047,0,3056,G
4-HA,1192,3053,1,2,1,3057,A
4-HA,1193,3057,0,1,0,3058,A
4-HA,1194,0,3053,0,2,3055,T
4-HA,1195,3002,0,1,0,3003,A
4-HA,1196,1,0,2997,0,2998,G
4-HA,1197,2731,0,9,1,2741,A
4-HA,1198,0,2751,0,0,2751,T
4-HA,1199,1,2758,0,1,2760,T
4-HA,1200,0,5,2769,0,2774,G
4-HA,1201,2756,0,2,0,2758,A
4-HA,1202,0,2742,0,1,2743,T
4-HA,1203,4,1,0,2756,2761,C
4-HA,1204,4,2,2750,0,2756,G
4-HA,1205,2,1,2748,0,2751,G
4-HA,1206,3,3,2754,0,2760,G
4-HA,1207,2754,0,3,0,2757,A
4-HA,1208,2756,0,2,0,2758,A
4-HA,1209,2726,0,1,0,2727,A
4-HA,1210,2722,0,3,0,2725,A
4-HA,1211,0,0,0,2740,2740,C
4-HA,1212,10,0,0,2738,2748,C
4-HA,1213,2719,0,1,0,2720,A
4-HA,1214,2711,0,1,0,2712,A
4-HA,1215,0,2,1,2722,2725,C
4-HA,1216,0,5,2727,0,2732,G
4-HA,1217,2724,0,3,0,2727,A
4-HA,1218,0,1,2717,0,2718,G
4-HA,1219,2723,0,5,0,2728,A
4-HA,1220,2720,0,1,0,2721,A
4-HA,1221,2725,0,3,0,2728,A
4-HA,1222,0,2704,0,2,2706,T
4-HA,1223,0,2709,0,7,2716,T
4-HA,1224,3,0,0,2722,2725,C
4-HA,1225,3,1,0,2718,2722,C
4-HA,1226,2727,0,0,0,2727,A
4-HA,1227,0,2708,0,2,2710,T
4-HA,1228,3,2,0,2711,2716,C
4-HA,1229,2702,1,1,0,2704,A
4-HA,1230,19,2,2688,0,2709,G
4-HA,1231,2675,0,1,0,2676,A
4-HA,1232,0,2680,0,0,2680,T
4-HA,1233,0,2668,1,1,2670,T
4-HA,1234,0,3,2683,0,2686,G
4-HA,1235,2678,0,5,0,2683,A
4-HA,1236,2679,0,2,0,2681,A
4-HA,1237,2683,0,1,0,2684,A
4-HA,1238,2682,0,0,1,2683,A
4-HA,1239,2632,0,11,0,2643,A
4-HA,1240,0,2,2641,0,2643,G
4-HA,1241,2636,0,2,0,2638,A
4-HA,1242,2629,0,6,0,2635,A
4-HA,1243,1,2580,0,1,2582,T
4-HA,1244,0,2581,0,1,2582,T
4-HA,1245,6,2,0,2597,2605,C
4-HA,1246,0,2589,0,1,2590,T
4-HA,1247,5,1,1,2590,2597,C
4-HA,1248,2596,0,0,1,2597,A
4-HA,1249,0,2,2593,0,2595,G
4-HA,1250,2581,0,1,0,2582,A
4-HA,1251,2553,0,6,0,2559,A
4-HA,1252,0,0,2593,0,2593,G
4-HA,1253,0,2534,0,4,2538,T
4-HA,1254,4,1,0,2565,2570,C
4-HA,1255,1,3,2563,0,2567,G
4-HA,1256,2554,0,2,0,2556,A
4-HA,1257,2561,0,4,0,2565,A
4-HA,1258,0,2,2573,0,2575,G
4-HA,1259,0,4,2563,0,2567,G
4-HA,1260,0,3,2569,0,2572,G
4-HA,1261,2511,0,4,0,2515,A
4-HA,1262,0,2,2515,1,2518,G
4-HA,1263,2514,0,1,0,2515,A
4-HA,1264,2647,0,0,0,2647,A
4-HA,1265,0,2629,0,0,2629,T
4-HA,1266,0,2627,0,3,2630,T
4-HA,1267,6,1,0,2617,2624,C
4-HA,1268,2567,1,7,1,2576,A
4-HA,1269,2,3,2576,0,2581,G
4-HA,1270,0,2,2580,0,2582,G
4-HA,1271,2551,0,1,0,2552,A
4-HA,1272,0,0,1,2559,2560,C
4-HA,1273,4,0,0,2326,2330,C
4-HA,1274,1,2306,0,3,2310,T
4-HA,1275,0,2209,0,118,2327,T
4-HA,1276,0,6,2342,0,2348,G
4-HA,1277,2334,0,3,0,2337,A
4-HA,1278,0,3,2383,0,2386,G
4-HA,1279,2352,0,0,0,2352,A
4-HA,1280,2025,0,1,0,2026,A
4-HA,1281,1989,0,2,0,1991,A
4-HA,1282,0,1937,0,1,1938,T
4-HA,1283,1980,0,3,0,1983,A
4-HA,1284,0,1981,0,1,1982,T
4-HA,1285,1,1,1981,0,1983,G
4-HA,1286,1,1965,0,5,1971,T
4-HA,1287,0,1910,0,1,1911,T
4-HA,1288,0,2,1906,0,1908,G
4-HA,1289,1884,0,5,0,1889,A
4-HA,1290,0,5,1891,1,1897,G
4-HA,1291,0,7,1883,0,1890,G
4-HA,1292,1834,0,3,0,1837,A
4-HA,1293,0,0,0,1879,1879,C
4-HA,1294,1831,1,2,0,1834,A
4-HA,1295,0,0,0,1868,1868,C
4-HA,1296,3,2,0,1876,1881,C
4-HA,1297,1885,0,0,0,1885,A
4-HA,1298,1927,0,0,0,1927,A
4-HA,1299,1928,0,3,0,1931,A
4-HA,1300,1943,0,2,0,1945,A
4-HA,1301,0,1933,0,0,1933,T
4-HA,1302,1898,0,0,0,1898,A
4-HA,1303,0,3,1899,0,1902,G
4-HA,1304,1855,0,3,1,1859,A
4-HA,1305,0,1869,0,3,1872,T
4-HA,1306,3,0,0,1868,1871,C
4-HA,1307,0,1822,0,3,1825,T
4-HA,1308,1,1,0,1888,1890,C
4-HA,1309,0,1876,0,0,1876,T
4-HA,1310,2,5,1925,0,1932,G
4-HA,1311,1,0,1986,0,1987,G
4-HA,1312,1,1959,0,3,1963,T
4-HA,1313,6,0,0,1977,1983,C
4-HA,1314,2003,0,4,1,2008,A
4-HA,1315,0,1997,1,2,2000,T
4-HA,1316,2000,0,0,0,2000,A
4-HA,1317,0,2,0,1997,1999,C
4-HA,1318,1923,1,1,0,1925,A
4-HA,1319,1947,0,1,0,1948,A
4-HA,1320,0,0,0,1876,1876,C
4-HA,1321,1,1,1873,0,1875,G
4-HA,1322,0,3,0,1871,1874,C
4-HA,1323,0,2,1859,0,1861,G
4-HA,1324,0,1,1861,0,1862,G
4-HA,1325,1856,0,4,1,1861,A
4-HA,1326,1,1,1898,0,1900,G
4-HA,1327,1,0,0,1877,1878,C
4-HA,1328,0,1871,0,5,1876,T
4-HA,1329,0,1897,0,1,1898,T
4-HA,1330,1,0,0,1890,1891,C
4-HA,1331,0,1910,0,2,1912,T
4-HA,1332,0,1909,0,2,1911,T
4-HA,1333,0,0,1906,0,1906,G
4-HA,1334,0,1887,0,4,1891,T
4-HA,1335,0,1860,0,3,1863,T
4-HA,1336,1,0,1901,0,1902,G
4-HA,1337,0,0,0,1899,1899,C
4-HA,1338,5,0,0,1884,1889,C
4-HA,1339,6,0,0,1896,1902,C
4-HA,1340,0,1892,0,4,1896,T
4-HA,1341,1,0,1918,0,1919,G
4-HA,1342,2,2,1919,0,1923,G
4-HA,1343,1915,0,4,0,1919,A
4-HA,1344,1,3,1937,0,1941,G
4-HA,1345,1878,1,3,0,1882,A
4-HA,1346,1882,0,3,0,1885,A
4-HA,1347,1,2,2,1908,1913,C
4-HA,1348,0,2,0,1916,1918,C
4-HA,1349,1915,0,0,0,1915,A
4-HA,1350,1998,0,3,0,2001,A
4-HA,1351,0,1,0,2019,2020,C
4-HA,1352,2027,0,2,0,2029,A
4-HA,1353,1,2017,0,2,2020,T
4-HA,1354,2009,0,1,0,2010,A
4-HA,1355,0,0,0,2048,2048,C
4-HA,1356,2020,1,1,0,2022,A
4-HA,1357,2019,0,1,0,2020,A
4-HA,1358,0,1996,0,0,1996,T
4-HA,1359,0,1925,0,0,1925,T
4-HA,1360,1,1,1960,0,1962,G
4-HA,1361,1985,0,0,0,1985,A
4-HA,1362,0,1969,0,4,1973,T
4-HA,1363,3,0,0,1990,1993,C
4-HA,1364,0,1956,0,2,1958,T
4-HA,1365,1979,0,1,0,1980,A
4-HA,1366,1977,0,1,0,1978,A
4-HA,1367,1,0,0,1971,1972,C
4-HA,1368,1,1954,0,4,1959,T
4-HA,1369,0,3,1949,0,1952,G
4-HA,1370,1933,0,0,0,1933,A
4-HA,1371,1,0,0,1935,1936,C
4-HA,1372,0,1924,0,3,1927,T
4-HA,1373,3,1,0,1938,1942,C
4-HA,1374,1941,0,0,1,1942,A
4-HA,1375,0,2,1985,0,1987,G
4-HA,1376,1981,0,1,0,1982,A
4-HA,1377,1976,0,0,0,1976,A
4-HA,1378,1985,0,3,0,1988,A
4-HA,1379,0,1957,0,1,1958,T
4-HA,1380,0,7,1985,0,1992,G
4-HA,1381,1979,1,1,0,1981,A
4-HA,1382,1985,0,1,0,1986,A
4-HA,1383,0,0,0,1993,1993,C
4-HA,1384,1971,0,0,0,1971,A
4-HA,1385,1970,0,1,0,1971,A
4-HA,1386,1967,0,1,0,1968,A
4-HA,1387,1,1,0,1980,1982,C
4-HA,1388,0,1943,0,0,1943,T
4-HA,1389,1,12,1965,0,1978,G
4-HA,1390,0,1946,0,0,1946,T
4-HA,1391,0,1942,0,0,1942,T
4-HA,1392,0,1948,0,1,1949,T
4-HA,1393,2,4,1949,0,1955,G
4-HA,1394,1948,0,0,0,1948,A
4-HA,1395,1949,0,1,0,1950,A
4-HA,1396,1945,0,1,0,1946,A
4-HA,1397,1943,0,2,0,1945,A
4-HA,1398,1927,0,1,0,1928,A
4-HA,1399,1948,0,1,0,1949,A
4-HA,1400,1,0,0,1951,1952,C
4-HA,1401,1951,0,0,0,1951,A
4-HA,1402,1948,0,3,0,1951,A
4-HA,1403,1944,0,4,0,1948,A
4-HA,1404,0,1,1955,0,1956,G
4-HA,1405,1962,0,0,0,1962,A
4-HA,1406,1953,0,3,0,1956,A
4-HA,1407,1,0,1952,0,1953,G
4-HA,1408,0,0,0,1955,1955,C
4-HA,1409,1955,0,4,0,1959,A
4-HA,1410,1964,1,1,0,1966,A
4-HA,1411,0,0,0,1964,1964,C
4-HA,1412,0,1955,0,0,1955,T
4-HA,1413,0,0,1965,0,1965,G
4-HA,1414,1941,0,1,0,1942,A
4-HA,1415,0,2,1972,0,1974,G
4-HA,1416,1,2,1968,0,1971,G
4-HA,1417,0,5,1967,0,1972,G
4-HA,1418,1973,0,1,0,1974,A
4-HA,1419,1951,0,3,0,1954,A
4-HA,1420,1948,0,2,0,1950,A
4-HA,1421,1971,0,1,0,1972,A
4-HA,1422,0,1964,0,0,1964,T
4-HA,1423,2,0,1962,0,1964,G
4-HA,1424,1,0,0,1971,1972,C
4-HA,1425,0,1942,2,3,1947,T
4-HA,1426,1,4,1961,0,1966,G
4-HA,1427,1958,0,2,0,1960,A
4-HA,1428,0,1,2073,0,2074,G
4-HA,1429,0,2,2095,0,2097,G
4-HA,1430,2065,0,2,0,2067,A
4-HA,1431,0,2066,0,1,2067,T
4-HA,1432,2045,0,2,0,2047,A
4-HA,1433,0,2036,0,4,2040,T
4-HA,1434,0,6,2068,0,2074,G
4-HA,1435,1,2,2085,0,2088,G
4-HA,1436,0,2,2081,0,2083,G
4-HA,1437,1,1,0,1990,1992,C
4-HA,1438,1941,0,0,0,1941,A
4-HA,1439,1940,0,5,0,1945,A
4-HA,1440,0,1928,0,2,1930,T
4-HA,1441,0,1,1948,0,1949,G
4-HA,1442,0,0,1938,0,1938,G
4-HA,1443,0,1916,0,1,1917,T
4-HA,1444,1,1859,0,2,1862,T
4-HA,1445,0,1,1881,0,1882,G
4-HA,1446,0,1894,0,2,1896,T
4-HA,1447,0,1903,0,4,1907,T
4-HA,1448,0,1908,0,2,1910,T
4-HA,1449,5,0,0,1911,1916,C
4-HA,1450,1908,0,0,0,1908,A
4-HA,1451,1917,0,2,0,1919,A
4-HA,1452,1922,0,0,0,1922,A
4-HA,1453,1945,0,1,0,1946,A
4-HA,1454,0,1936,0,0,1936,T
4-HA,1455,1903,0,1,1,1905,A
4-HA,1456,0,1907,0,1,1908,T
4-HA,1457,1900,1,0,0,1901,A
4-HA,1458,1,1,0,1920,1922,C
4-HA,1459,1,0,0,1908,1909,C
4-HA,1460,1909,0,0,1,1910,A
4-HA,1461,0,0,0,1926,1926,C
4-HA,1462,1928,0,2,0,1930,A
4-HA,1463,1942,0,0,0,1942,A
4-HA,1464,1944,0,2,1,1947,A
4-HA,1465,0,1942,0,1,1943,T
4-HA,1466,0,1,1950,0,1951,G
4-HA,1467,0,1925,0,2,1927,T
4-HA,1468,3,8,1950,0,1961,G
4-HA,1469,1946,0,6,0,1952,A
4-HA,1470,2,1,0,1944,1947,C
4-HA,1471,1905,0,1,0,1906,A
4-HA,1472,1905,0,3,0,1908,A
4-HA,1473,0,1929,0,1,1930,T
4-HA,1474,0,2,1952,0,1954,G
4-HA,1475,0,0,0,1929,1929,C
4-HA,1476,1,1,0,1956,1958,C
4-HA,1477,0,1935,0,6,1941,T
4-HA,1478,0,0,2055,0,2055,G
4-HA,1479,0,0,0,2063,2063,C
4-HA,1480,2068,0,0,0,2068,A
4-HA,1481,0,2067,0,1,2068,T
4-HA,1482,1976,0,1,0,1977,A
4-HA,1483,1,3,1995,0,1999,G
4-HA,1484,1,2,1986,0,1989,G
4-HA,1485,1980,0,2,0,1982,A
4-HA,1486,0,1970,0,2,1972,T
4-HA,1487,2,3,0,1875,1880,C
4-HA,1488,1889,0,2,0,1891,A
4-HA,1489,1902,0,0,0,1902,A
4-HA,1490,0,1901,0,1,1902,T
4-HA,1491,3,0,0,1895,1898,C
4-HA,1492,1856,0,1,0,1857,A
4-HA,1493,0,5,1871,0,1876,G
4-HA,1494,1874,0,1,0,1875,A
4-HA,1495,1878,0,0,0,1878,A
4-HA,1496,1873,0,2,0,1875,A
4-HA,1497,0,1856,0,1,1857,T
4-HA,1498,1,4,1839,0,1844,G
4-HA,1499,0,3,1839,0,1842,G
4-HA,1500,1852,0,1,0,1853,A
4-HA,1501,1872,0,1,0,1873,A
4-HA,1502,0,0,0,1853,1853,C
4-HA,1503,0,1836,0,2,1838,T
4-HA,1504,0,1841,0,0,1841,T
4-HA,1505,1845,0,1,0,1846,A
4-HA,1506,0,1840,0,2,1842,T
4-HA,1507,2,7,1835,0,1844,G
4-HA,1508,1844,0,4,1,1849,A
4-HA,1509,0,1,0,1848,1849,C
4-HA,1510,1,0,0,1822,1823,C
4-HA,1511,1823,1,0,0,1824,A
4-HA,1512,0,2,0,1870,1872,C
4-HA,1513,0,2,1914,0,1916,G
4-HA,1514,1964,0,1,0,1965,A
4-HA,1515,0,1990,0,0,1990,T
4-HA,1516,0,0,2094,0,2094,G
4-HA,1517,0,2072,0,2,2074,T
4-HA,1518,2154,0,3,1,2158,A
4-HA,1519,0,2164,0,2,2166,T
4-HA,1520,2152,0,1,0,2153,A
4-HA,1521,1,1,1,2154,2157,C
4-HA,1522,1944,1,0,0,1945,A
4-HA,1523,5,4,1946,0,1955,G
4-HA,1524,1837,0,4,0,1841,A
4-HA,1525,2,0,1775,0,1777,G
4-HA,1526,1763,0,2,0,1765,A
4-HA,1527,0,1627,0,2,1629,T
4-HA,1528,0,1,1626,0,1627,G
4-HA,1529,1620,0,2,0,1622,A
4-HA,1530,1609,0,6,0,1615,A
4-HA,1531,0,1,1660,0,1661,G
4-HA,1532,1,1,0,1624,1626,C
4-HA,1533,1622,0,0,0,1622,A
4-HA,1534,0,1624,0,1,1625,T
4-HA,1535,0,1618,0,2,1620,T
4-HA,1536,1632,0,1,0,1633,A
4-HA,1537,1625,0,0,0,1625,A
4-HA,1538,1631,0,1,0,1632,A
4-HA,1539,1,0,0,1633,1634,C
4-HA,1540,1568,0,0,0,1568,A
4-HA,1541,1574,0,0,0,1574,A
4-HA,1542,1,0,0,1568,1569,C
4-HA,1543,2,2,0,1569,1573,C
4-HA,1544,2,2,1557,0,1561,G
4-HA,1545,1,0,1584,0,1585,G
4-HA,1546,1,1591,0,4,1596,T
4-HA,1547,0,1591,0,2,1593,T
4-HA,1548,3,2,0,1589,1594,C
4-HA,1549,3,3,0,1589,1595,C
4-HA,1550,1597,0,0,0,1597,A
4-HA,1551,1,1,1602,0,1604,G
4-HA,1552,1608,0,1,0,1609,A
4-HA,1553,0,1588,0,1,1589,T
4-HA,1554,2,0,0,1517,1519,C
4-HA,1555,1495,0,1,0,1496,A
4-HA,1556,1498,0,3,0,1501,A
4-HA,1557,0,4,1500,0,1504,G
4-HA,1558,0,1,1495,0,1496,G
4-HA,1559,0,3,1489,0,1492,G
4-HA,1560,1440,0,0,0,1440,A
4-HA,1561,1,0,1455,0,1456,G
4-HA,1562,0,1462,0,0,1462,T
4-HA,1563,0,1467,0,1,1468,T
4-HA,1564,0,5,1473,0,1478,G
4-HA,1565,1464,0,3,0,1467,A
4-HA,1566,1,1,1469,0,1471,G
4-HA,1567,1,0,0,1471,1472,C
4-HA,1568,0,1461,0,1,1462,T
4-HA,1569,4,0,1473,0,1477,G
4-HA,1570,1471,0,1,0,1472,A
4-HA,1571,1472,0,0,1,1473,A
4-HA,1572,0,0,1479,0,1479,G
4-HA,1573,0,1435,0,1,1436,T
4-HA,1574,3,0,0,1438,1441,C
4-HA,1575,1417,0,1,0,1418,A
4-HA,1576,0,0,1412,0,1412,G
4-HA,1577,0,1,1404,0,1405,G
4-HA,1578,0,1,1378,0,1379,G
4-HA,1579,0,1425,0,0,1425,T
4-HA,1580,1421,0,2,0,1423,A
4-HA,1581,0,2,0,1436,1438,C
4-HA,1582,1430,0,0,0,1430,A
4-HA,1583,1423,0,3,0,1426,A
4-HA,1584,1431,0,0,0,1431,A
4-HA,1585,1,1,1439,0,1441,G
4-HA,1586,1408,0,0,0,1408,A
4-HA,1587,0,1354,0,6,1360,T
4-HA,1588,0,1343,0,0,1343,T
4-HA,1589,0,1,1340,0,1341,G
4-HA,1590,1,0,1330,0,1331,G
4-HA,1591,1339,0,0,0,1339,A
4-HA,1592,0,1335,0,1,1336,T
4-HA,1593,0,0,0,1342,1342,C
4-HA,1594,1,0,0,1325,1326,C
4-HA,1595,0,1315,0,1,1316,T
4-HA,1596,1317,0,1,0,1318,A
4-HA,1597,0,1321,0,3,1324,T
4-HA,1598,0,0,1319,0,1319,G
4-HA,1599,0,4,1320,0,1324,G
4-HA,1600,1288,0,0,0,1288,A
4-HA,1601,0,1276,0,0,1276,T
4-HA,1602,0,1264,0,1,1265,T
4-HA,1603,0,1266,0,0,1266,T
4-HA,1604,5,0,0,1266,1271,C
4-HA,1605,1,0,0,1268,1269,C
4-HA,1606,1,1255,0,2,1258,T
4-HA,1607,0,1254,0,0,1254,T
4-HA,1608,0,1247,0,1,1248,T
4-HA,1609,1,0,1248,0,1249,G
4-HA,1610,1,0,0,1245,1246,C
4-HA,1611,4,1,0,1248,1253,C
4-HA,1612,1225,0,3,0,1228,A
4-HA,1613,0,1222,0,0,1222,T
4-HA,1614,1220,0,4,0,1224,A
4-HA,1615,0,1213,1,0,1214,T
4-HA,1616,3,0,0,1204,1207,C
4-HA,1617,1206,0,1,0,1207,A
4-HA,1618,0,1188,0,1,1189,T
4-HA,1619,0,0,1196,0,1196,G
4-HA,1620,0,1186,0,2,1188,T
4-HA,1621,0,1185,0,0,1185,T
4-HA,1622,0,1179,0,1,1180,T
4-HA,1623,0,1149,0,2,1151,T
4-HA,1624,0,1148,0,1,1149,T
4-HA,1625,0,1147,0,1,1148,T
4-HA,1626,0,3,1149,0,1152,G
4-HA,1627,0,0,0,1141,1141,C
4-HA,1628,0,1116,0,1,1117,T
4-HA,1629,0,1118,0,0,1118,T
4-HA,1630,1,1123,0,0,1124,T
4-HA,1631,0,0,1151,0,1151,G
4-HA,1632,0,1149,0,0,1149,T
4-HA,1633,1,0,1148,0,1149,G
4-HA,1634,0,1144,0,2,1146,T
4-HA,1635,0,1120,0,0,1120,T
4-HA,1636,0,0,1129,0,1129,G
4-HA,1637,2,1,0,1115,1118,C
4-HA,1638,0,1117,0,0,1117,T
4-HA,1639,0,1122,0,0,1122,T
4-HA,1640,0,1063,0,0,1063,T
4-HA,1641,1,0,1073,0,1074,G
4-HA,1642,0,1063,0,2,1065,T
4-HA,1643,0,1064,0,1,1065,T
4-HA,1644,0,0,1069,0,1069,G
4-HA,1645,0,0,1045,0,1045,G
4-HA,1646,1,1,1038,0,1040,G
4-HA,1647,0,0,1052,0,1052,G
4-HA,1648,1,1009,0,5,1015,T
4-HA,1649,0,1000,0,3,1003,T
4-HA,1650,4,0,0,991,995,C
4-HA,1651,972,0,0,0,972,A
4-HA,1652,0,972,0,2,974,T
4-HA,1653,2,0,0,968,970,C
4-HA,1654,966,0,1,0,967,A
4-HA,1655,0,942,0,0,942,T
4-HA,1656,0,0,931,0,931,G
4-HA,1657,0,910,0,1,911,T
4-HA,1658,1,1,898,0,900,G
4-HA,1659,0,2,865,0,867,G
4-HA,1660,1,0,861,0,862,G
4-HA,1661,0,1,0,835,836,C
4-HA,1662,0,0,0,823,823,C
4-HA,1663,0,771,0,2,773,T
4-HA,1664,1,0,776,0,777,G
4-HA,1665,0,1,0,768,769,C
4-HA,1666,1,0,0,770,771,C
4-HA,1667,773,0,1,0,774,A
4-HA,1668,770,0,0,0,770,A
4-HA,1669,771,0,2,0,773,A
4-HA,1670,771,0,2,1,774,A
4-HA,1671,767,0,2,0,769,A
4-HA,1672,1,0,766,0,767,G
4-HA,1673,0,1,739,0,740,G
4-HA,1674,0,0,0,730,730,C
4-HA,1675,727,0,3,0,730,A
4-HA,1676,738,0,1,0,739,A
4-HA,1677,0,0,0,738,738,C
4-HA,1678,742,0,0,0,742,A
4-HA,1679,0,733,0,2,735,T
4-HA,1680,0,730,0,0,730,T
4-HA,1681,715,0,1,0,716,A
4-HA,1682,0,1,705,0,706,G
4-HA,1683,0,1,701,0,702,G
4-HA,1684,0,687,0,0,687,T
4-HA,1685,0,0,646,0,646,G
4-HA,1686,1,0,0,607,608,C
4-HA,1687,602,0,1,0,603,A
4-HA,1688,604,0,1,0,605,A
4-HA,1689,0,0,0,608,608,C
4-HA,1690,594,0,0,0,594,A
4-HA,1691,0,582,0,0,582,T
4-HA,1692,0,555,0,2,557,T
4-HA,1693,0,558,0,0,558,T
4-HA,1694,0,0,555,0,555,G
4-HA,1695,0,0,0,549,549,C
4-HA,1696,548,0,1,0,549,A
4-HA,1697,0,504,0,1,505,T
4-HA,1698,0,492,0,1,493,T
4-HA,1699,0,481,0,0,481,T
4-HA,1700,0,0,484,0,484,G
4-HA,1701,458,0,0,0,458,A
5-NP,1,284,0,0,0,284,A
5-NP,2,0,283,0,0,283,T
5-NP,3,0,0,282,0,282,G
5-NP,4,0,0,280,0,280,G
5-NP,5,0,0,0,280,280,C
5-NP,6,1,0,289,0,290,G
5-NP,7,0,299,0,1,300,T
5-NP,8,0,0,0,313,313,C
5-NP,9,1,0,0,315,316,C
5-NP,10,1,0,0,316,317,C
5-NP,11,317,1,0,0,318,A
5-NP,12,318,0,0,0,318,A
5-NP,13,0,0,319,0,319,G
5-NP,14,0,0,331,0,331,G
5-NP,15,0,0,0,333,333,C
5-NP,16,331,0,1,0,332,A
5-NP,17,0,0,0,341,341,C
5-NP,18,1,0,0,338,339,C
5-NP,19,344,0,0,0,344,A
5-NP,20,342,0,0,0,342,A
5-NP,21,344,0,0,0,344,A
5-NP,22,0,0,0,344,344,C
5-NP,23,0,0,347,0,347,G
5-NP,24,0,0,377,0,377,G
5-NP,25,0,373,0,0,373,T
5-NP,26,0,0,0,409,409,C
5-NP,27,0,407,0,0,407,T
5-NP,28,0,410,0,0,410,T
5-NP,29,412,0,0,0,412,A
5-NP,30,0,411,0,0,411,T
5-NP,31,0,3,417,0,420,G
5-NP,32,416,1,0,0,417,A
5-NP,33,405,1,1,0,407,A
5-NP,34,1,0,0,408,409,C
5-NP,35,399,1,0,0,400,A
5-NP,36,0,0,428,0,428,G
5-NP,37,423,1,0,0,424,A
5-NP,38,0,432,0,0,432,T
5-NP,39,0,0,429,0,429,G
5-NP,40,0,0,429,0,429,G
5-NP,41,436,0,0,0,436,A
5-NP,42,432,0,0,0,432,A
5-NP,43,439,0,0,0,439,A
5-NP,44,0,0,0,457,457,C
5-NP,45,0,446,0,0,446,T
5-NP,46,0,2,456,0,458,G
5-NP,47,450,0,0,0,450,A
5-NP,48,0,460,0,0,460,T
5-NP,49,1,1,456,0,458,G
5-NP,50,0,1,458,0,459,G
5-NP,51,6,0,452,0,458,G
5-NP,52,0,0,458,0,458,G
5-NP,53,455,0,0,0,455,A
5-NP,54,0,452,0,0,452,T
5-NP,55,0,0,0,458,458,C
5-NP,56,0,0,455,0,455,G
5-NP,57,0,0,0,461,461,C
5-NP,58,0,0,0,467,467,C
5-NP,59,463,0,0,1,464,A
5-NP,60,0,0,471,0,471,G
5-NP,61,464,0,0,0,464,A
5-NP,62,470,0,1,0,471,A
5-NP,63,0,470,0,0,470,T
5-NP,64,0,0,467,0,467,G
5-NP,65,0,7,0,463,470,C
5-NP,66,468,0,0,0,468,A
5-NP,67,470,0,1,0,471,A
5-NP,68,1,0,0,473,474,C
5-NP,69,0,470,0,0,470,T
5-NP,70,0,0,470,0,470,G
5-NP,71,473,0,1,0,474,A
5-NP,72,0,1,504,0,505,G
5-NP,73,507,0,0,0,507,A
5-NP,74,0,505,0,0,505,T
5-NP,75,0,504,0,0,504,T
5-NP,76,505,0,0,0,505,A
5-NP,77,0,1,503,0,504,G
5-NP,78,0,0,499,0,499,G
5-NP,79,0,0,499,0,499,G
5-NP,80,0,0,0,497,497,C
5-NP,81,488,0,0,0,488,A
5-NP,82,0,493,0,2,495,T
5-NP,83,1,0,0,496,497,C
5-NP,84,0,0,0,496,496,C
5-NP,85,0,0,508,0,508,G
5-NP,86,0,504,0,0,504,T
5-NP,87,0,0,0,508,508,C
5-NP,88,0,1,509,0,510,G
5-NP,89,0,0,506,0,506,G
5-NP,90,0,0,511,0,511,G
5-NP,91,508,0,0,0,508,A
5-NP,92,512,0,0,0,512,A
5-NP,93,0,1,518,0,519,G
5-NP,94,508,0,2,0,510,A
5-NP,95,0,517,0,0,517,T
5-NP,96,0,1,521,0,522,G
5-NP,97,519,0,1,0,520,A
5-NP,98,0,516,0,0,516,T
5-NP,99,0,517,0,0,517,T
5-NP,100,1,1,515,0,517,G
5-NP,101,517,0,0,0,517,A
5-NP,102,0,519,0,0,519,T
5-NP,103,0,1,517,0,518,G
5-NP,104,0,0,529,0,529,G
5-NP,105,528,0,0,0,528,A
5-NP,106,528,0,0,0,528,A
5-NP,107,0,528,0,0,528,T
5-NP,108,0,529,1,1,531,T
5-NP,109,0,2,526,0,528,G
5-NP,110,0,2,528,0,530,G
5-NP,111,0,3,531,0,534,G
5-NP,112,522,0,1,0,523,A
5-NP,113,0,0,523,0,523,G
5-NP,114,515,0,0,0,515,A
5-NP,115,0,529,0,0,529,T
5-NP,116,0,532,0,0,532,T
5-NP,117,0,0,0,534,534,C
5-NP,118,0,529,0,0,529,T
5-NP,119,544,0,0,0,544,A
5-NP,120,1,0,0,539,540,C
5-NP,121,554,0,0,0,554,A
5-NP,122,0,557,0,0,557,T
5-NP,123,0,0,0,550,550,C
5-NP,124,0,0,0,546,546,C
5-NP,125,546,0,0,0,546,A
5-NP,126,562,0,0,0,562,A
5-NP,127,562,0,0,0,562,A
5-NP,128,0,556,0,1,557,T
5-NP,129,0,0,555,0,555,G
5-NP,130,0,539,0,0,539,T
5-NP,131,0,0,553,0,553,G
5-NP,132,0,0,0,552,552,C
5-NP,133,544,0,2,0,546,A
5-NP,134,0,0,0,548,548,C
5-NP,135,0,540,0,0,540,T
5-NP,136,0,0,574,0,574,G
5-NP,137,583,0,0,0,583,A
5-NP,138,599,0,0,0,599,A
5-NP,139,0,0,0,606,606,C
5-NP,140,0,606,0,0,606,T
5-NP,141,0,605,0,2,607,T
5-NP,142,608,0,0,0,608,A
5-NP,143,603,0,1,0,604,A
5-NP,144,607,0,0,0,607,A
5-NP,145,0,1,0,608,609,C
5-NP,146,0,591,0,0,591,T
5-NP,147,1,0,0,596,597,C
5-NP,148,593,0,0,0,593,A
5-NP,149,0,0,599,0,599,G
5-NP,150,0,604,0,0,604,T
5-NP,151,0,1,610,0,611,G
5-NP,152,618,0,0,0,618,A
5-NP,153,0,618,0,0,618,T
5-NP,154,0,0,0,624,624,C
5-NP,155,619,0,0,0,619,A
5-NP,156,0,621,0,0,621,T
5-NP,157,0,0,621,0,621,G
5-NP,158,612,0,0,0,612,A
5-NP,159,615,0,1,0,616,A
5-NP,160,0,1,615,0,616,G
5-NP,161,0,1,609,0,610,G
5-NP,162,1,0,615,0,616,G
5-NP,163,0,0,0,604,604,C
5-NP,164,2,1,607,0,610,G
5-NP,165,0,0,608,0,608,G
5-NP,166,0,608,0,1,609,T
5-NP,167,0,611,0,0,611,T
5-NP,168,0,0,605,0,605,G
5-NP,169,659,0,0,0,659,A
5-NP,170,0,656,0,0,656,T
5-NP,171,0,0,0,654,654,C
5-NP,172,0,0,0,659,659,C
5-NP,173,652,0,0,0,652,A
5-NP,174,0,1,661,0,662,G
5-NP,175,652,0,0,0,652,A
5-NP,176,659,0,0,0,659,A
5-NP,177,0,1,0,660,661,C
5-NP,178,612,0,1,0,613,A
5-NP,179,0,0,610,0,610,G
5-NP,180,0,0,0,612,612,C
5-NP,181,0,618,0,0,618,T
5-NP,182,0,618,0,1,619,T
5-NP,183,0,1,616,0,617,G
5-NP,184,618,0,2,0,620,A
5-NP,185,0,0,0,623,623,C
5-NP,186,622,0,0,0,622,A
5-NP,187,621,0,0,0,621,A
5-NP,188,0,621,0,0,621,T
5-NP,189,624,0,0,0,624,A
5-NP,190,0,3,621,0,624,G
5-NP,191,619,0,1,0,620,A
5-NP,192,0,2,621,0,623,G
5-NP,193,610,0,0,0,610,A
5-NP,194,624,0,0,0,624,A
5-NP,195,621,0,1,0,622,A
5-NP,196,631,0,1,0,632,A
5-NP,197,0,635,0,0,635,T
5-NP,198,0,0,637,0,637,G
5-NP,199,0,0,633,0,633,G
5-NP,200,0,629,0,0,629,T
5-NP,201,615,0,0,0,615,A
5-NP,202,1,0,0,622,623,C
5-NP,203,0,629,0,0,629,T
5-NP,204,0,0,0,642,642,C
5-NP,205,0,622,0,1,623,T
5-NP,206,3,0,0,627,630,C
5-NP,207,0,625,0,2,627,T
5-NP,208,0,0,636,0,636,G
5-NP,209,0,0,0,638,638,C
5-NP,210,0,630,0,0,630,T
5-NP,211,0,637,0,0,637,T
5-NP,212,0,636,0,0,636,T
5-NP,213,0,632,0,0,632,T
5-NP,214,0,0,633,0,633,G
5-NP,215,629,0,0,0,629,A
5-NP,216,0,627,0,1,628,T
5-NP,217,0,1,624,0,625,G
5-NP,218,616,1,0,0,617,A
5-NP,219,614,0,1,0,615,A
5-NP,220,616,0,0,0,616,A
5-NP,221,0,0,617,0,617,G
5-NP,222,619,0,0,0,619,A
5-NP,223,618,0,1,0,619,A
5-NP,224,0,0,621,0,621,G
5-NP,225,2,4,628,0,634,G
5-NP,226,638,1,0,0,639,A
5-NP,227,637,0,0,0,637,A
5-NP,228,0,643,0,0,643,T
5-NP,229,643,0,0,0,643,A
5-NP,230,646,0,0,0,646,A
5-NP,231,639,0,1,0,640,A
5-NP,232,0,637,0,0,637,T
5-NP,233,636,0,0,0,636,A
5-NP,234,0,0,0,637,637,C
5-NP,235,0,0,0,625,625,C
5-NP,236,1,620,0,0,621,T
5-NP,237,0,0,623,0,623,G
5-NP,238,0,0,635,0,635,G
5-NP,239,630,0,0,0,630,A
5-NP,240,627,0,1,0,628,A
5-NP,241,0,2,628,0,630,G
5-NP,242,634,0,0,0,634,A
5-NP,243,635,0,0,0,635,A
5-NP,244,0,0,0,629,629,C
5-NP,245,627,0,0,0,627,A
5-NP,246,0,2,0,634,636,C
5-NP,247,1,0,0,630,631,C
5-NP,248,2,0,0,632,634,C
5-NP,249,1,0,0,631,632,C
5-NP,250,627,0,1,1,629,A
5-NP,251,0,0,617,0,617,G
5-NP,252,0,5,0,616,621,C
5-NP,253,0,0,623,0,623,G
5-NP,254,0,0,0,623,623,C
5-NP,255,0,0,623,0,623,G
5-NP,256,2,2,622,0,626,G
5-NP,257,0,0,624,0,624,G
5-NP,258,0,0,632,0,632,G
5-NP,259,634,0,0,0,634,A
5-NP,260,637,0,1,0,638,A
5-NP,261,638,0,0,0,638,A
5-NP,262,0,0,637,0,637,G
5-NP,263,633,0,1,0,634,A
5-NP,264,0,629,0,0,629,T
5-NP,265,1,0,0,620,621,C
5-NP,266,1,0,0,619,620,C
5-NP,267,0,0,0,630,630,C
5-NP,268,636,0,0,0,636,A
5-NP,269,632,0,0,0,632,A
5-NP,270,0,0,636,0,636,G
5-NP,271,634,0,0,0,634,A
5-NP,272,636,0,0,0,636,A
5-NP,273,637,0,0,0,637,A
5-NP,274,634,0,1,0,635,A
5-NP,275,0,0,0,633,633,C
5-NP,276,0,629,0,0,629,T
5-NP,277,0,1,630,0,631,G
5-NP,278,0,0,628,0,628,G
5-NP,279,0,1,635,0,636,G
5-NP,280,1,0,627,0,628,G
5-NP,281,0,1,641,0,642,G
5-NP,282,1,0,640,0,641,G
5-NP,283,0,0,0,687,687,C
5-NP,284,0,0,0,685,685,C
5-NP,285,0,0,0,699,699,C
5-NP,286,780,0,0,0,780,A
5-NP,287,0,784,0,0,784,T
5-NP,288,830,0,0,0,830,A
5-NP,289,0,837,0,0,837,T
5-NP,290,826,0,2,0,828,A
5-NP,291,1,0,0,830,831,C
5-NP,292,773,0,0,1,774,A
5-NP,293,0,1,786,0,787,G
5-NP,294,0,0,778,0,778,G
5-NP,295,695,0,1,0,696,A
5-NP,296,0,1,714,0,715,G
5-NP,297,675,0,0,0,675,A
5-NP,298,0,0,688,0,688,G
5-NP,299,0,676,0,0,676,T
5-NP,300,675,0,0,1,676,A
5-NP,301,6,0,678,0,684,G
5-NP,302,676,1,0,0,677,A
5-NP,303,0,674,0,0,674,T
5-NP,304,0,2,678,0,680,G
5-NP,305,0,0,681,0,681,G
5-NP,306,671,0,5,0,676,A
5-NP,307,670,0,0,1,671,A
5-NP,308,672,0,0,1,673,A
5-NP,309,673,0,2,0,675,A
5-NP,310,0,680,0,0,680,T
5-NP,311,0,0,686,0,686,G
5-NP,312,0,2,680,0,682,G
5-NP,313,677,0,0,1,678,A
5-NP,314,0,674,0,0,674,T
5-NP,315,0,1,683,0,684,G
5-NP,316,685,0,1,1,687,A
5-NP,317,0,0,689,0,689,G
5-NP,318,0,1,682,0,683,G
5-NP,319,0,4,692,0,696,G
5-NP,320,713,0,1,1,715,A
5-NP,321,714,0,1,1,716,A
5-NP,322,0,1,0,732,733,C
5-NP,323,0,723,0,1,724,T
5-NP,324,1,0,0,754,755,C
5-NP,325,0,0,772,0,772,G
5-NP,326,0,776,0,0,776,T
5-NP,327,2,0,0,788,790,C
5-NP,328,1,0,0,903,904,C
5-NP,329,0,902,0,1,903,T
5-NP,330,0,914,0,0,914,T
5-NP,331,0,912,0,1,913,T
5-NP,332,913,0,2,0,915,A
5-NP,333,0,918,0,0,918,T
5-NP,334,0,4,916,0,920,G
5-NP,335,930,0,0,0,930,A
5-NP,336,0,0,0,934,934,C
5-NP,337,916,0,0,0,916,A
5-NP,338,914,0,0,0,914,A
5-NP,339,916,0,0,0,916,A
5-NP,340,1,2,976,0,979,G
5-NP,341,973,0,1,0,974,A
5-NP,342,978,0,5,0,983,A
5-NP,343,1,1,1033,0,1035,G
5-NP,344,1038,0,1,0,1039,A
5-NP,345,1048,0,0,0,1048,A
5-NP,346,1044,0,2,0,1046,A
5-NP,347,0,1044,0,0,1044,T
5-NP,348,1045,0,1,0,1046,A
5-NP,349,1031,0,1,0,1032,A
5-NP,350,0,1,1048,0,1049,G
5-NP,351,0,1,1040,0,1041,G
5-NP,352,0,1,0,1041,1042,C
5-NP,353,1,0,1046,0,1047,G
5-NP,354,1057,0,1,0,1058,A
5-NP,355,1073,0,0,0,1073,A
5-NP,356,1,1080,0,1,1082,T
5-NP,357,1,0,0,1077,1078,C
5-NP,358,0,1079,0,1,1080,T
5-NP,359,0,0,1076,0,1076,G
5-NP,360,0,0,1076,0,1076,G
5-NP,361,4,0,0,1079,1083,C
5-NP,362,0,1,1082,0,1083,G
5-NP,363,0,0,0,1079,1079,C
5-NP,364,0,1,0,1082,1083,C
5-NP,365,1084,0,0,0,1084,A
5-NP,366,1096,0,0,0,1096,A
5-NP,367,0,0,1114,0,1114,G
5-NP,368,0,0,0,1124,1124,C
5-NP,369,1,0,0,1141,1142,C
5-NP,370,1141,0,1,0,1142,A
5-NP,371,1159,0,1,0,1160,A
5-NP,372,0,0,0,1178,1178,C
5-NP,373,1180,0,1,0,1181,A
5-NP,374,1224,1,0,0,1225,A
5-NP,375,0,1229,0,0,1229,T
5-NP,376,0,0,1249,0,1249,G
5-NP,377,0,1,1250,0,1251,G
5-NP,378,0,1238,0,1,1239,T
5-NP,379,0,0,1247,0,1247,G
5-NP,380,1236,0,3,0,1239,A
5-NP,381,0,1,1270,0,1271,G
5-NP,382,0,0,1276,0,1276,G
5-NP,383,1285,0,0,0,1285,A
5-NP,384,0,1438,0,0,1438,T
5-NP,385,1,0,1451,0,1452,G
5-NP,386,0,0,0,1452,1452,C
5-NP,387,0,1452,0,4,1456,T
5-NP,388,1464,0,3,0,1467,A
5-NP,389,0,0,0,1492,1492,C
5-NP,390,1484,0,0,1,1485,A
5-NP,391,0,1481,0,2,1483,T
5-NP,392,2,0,0,1475,1477,C
5-NP,393,0,1413,0,1,1414,T
5-NP,394,1,4,1492,0,1497,G
5-NP,395,0,0,1529,0,1529,G
5-NP,396,0,1526,0,1,1527,T
5-NP,397,2,0,0,1534,1536,C
5-NP,398,0,1518,0,3,1521,T
5-NP,399,1556,0,1,0,1557,A
5-NP,400,1551,0,2,0,1553,A
5-NP,401,1,0,0,1572,1573,C
5-NP,402,0,1557,0,7,1564,T
5-NP,403,3,0,0,1585,1588,C
5-NP,404,1574,2,1,0,1577,A
5-NP,405,0,1,0,1656,1657,C
5-NP,406,1658,0,0,0,1658,A
5-NP,407,0,1667,0,2,1669,T
5-NP,408,1654,0,0,0,1654,A
5-NP,409,1668,0,1,1,1670,A
5-NP,410,0,1672,0,1,1673,T
5-NP,411,0,7,1700,0,1707,G
5-NP,412,1698,0,0,0,1698,A
5-NP,413,0,1693,0,2,1695,T
5-NP,414,0,1669,0,0,1669,T
5-NP,415,0,1668,0,1,1669,T
5-NP,416,1,2,1651,0,1654,G
5-NP,417,0,0,1653,0,1653,G
5-NP,418,2,0,0,1668,1670,C
5-NP,419,1657,0,1,0,1658,A
5-NP,420,0,1663,0,1,1664,T
5-NP,421,0,1654,0,2,1656,T
5-NP,422,2,0,0,1661,1663,C
5-NP,423,0,0,0,1668,1668,C
5-NP,424,1710,0,0,0,1710,A
5-NP,425,1699,0,2,0,1701,A
5-NP,426,0,1705,0,0,1705,T
5-NP,427,0,1704,0,0,1704,T
5-NP,428,0,1707,0,0,1707,T
5-NP,429,1,5,1721,0,1727,G
5-NP,430,1725,0,1,0,1726,A
5-NP,431,1726,0,1,0,1727,A
5-NP,432,1,1733,0,0,1734,T
5-NP,433,1,8,1700,0,1709,G
5-NP,434,1793,3,3,0,1799,A
5-NP,435,0,1803,0,1,1804,T
5-NP,436,1,1,1815,0,1817,G
5-NP,437,0,1,0,1875,1876,C
5-NP,438,1864,0,0,0,1864,A
5-NP,439,1941,0,4,1,1946,A
5-NP,440,1,0,0,1956,1957,C
5-NP,441,1978,0,2,0,1980,A
5-NP,442,1,2024,0,1,2026,T
5-NP,443,1981,0,1,0,1982,A
5-NP,444,0,1,0,2028,2029,C
5-NP,445,0,2,0,2023,2025,C
5-NP,446,1979,0,1,0,1980,A
5-NP,447,0,1,2006,0,2007,G
5-NP,448,1953,0,6,0,1959,A
5-NP,449,1,1,2012,0,2014,G
5-NP,450,3,6,1988,0,1997,G
5-NP,451,1972,0,3,0,1975,A
5-NP,452,0,1,0,1993,1994,C
5-NP,453,1971,0,1,0,1972,A
5-NP,454,1972,0,2,0,1974,A
5-NP,455,0,1,1984,0,1985,G
5-NP,456,1962,0,5,0,1967,A
5-NP,457,0,1,1984,0,1985,G
5-NP,458,1,0,0,1983,1984,C
5-NP,459,0,1959,0,8,1967,T
5-NP,460,5,0,0,1973,1978,C
5-NP,461,0,1965,1,4,1970,T
5-NP,462,0,1977,0,0,1977,T
5-NP,463,0,0,1984,0,1984,G
5-NP,464,0,1982,1,1,1984,T
5-NP,465,0,1973,0,2,1975,T
5-NP,466,2,0,0,1968,1970,C
5-NP,467,2,9,1958,0,1969,G
5-NP,468,1988,0,4,0,1992,A
5-NP,469,1989,0,0,0,1989,A
5-NP,470,0,0,0,2013,2013,C
5-NP,471,0,2013,0,0,2013,T
5-NP,472,1,1,2038,0,2040,G
5-NP,473,0,5,2047,0,2052,G
5-NP,474,2047,0,4,0,2051,A
5-NP,475,2059,0,0,0,2059,A
5-NP,476,0,2046,0,1,2047,T
5-NP,477,0,3,2045,0,2048,G
5-NP,478,0,3,2051,0,2054,G
5-NP,479,2041,0,3,0,2044,A
5-NP,480,0,2064,0,2,2066,T
5-NP,481,2,0,0,2076,2078,C
5-NP,482,4,0,0,2087,2091,C
5-NP,483,3,0,0,2106,2109,C
5-NP,484,2151,0,2,0,2153,A
5-NP,485,1,2,2198,0,2201,G
5-NP,486,2215,0,0,0,2215,A
5-NP,487,2212,0,1,0,2213,A
5-NP,488,0,2186,0,0,2186,T
5-NP,489,3,0,2227,0,2230,G
5-NP,490,1,2203,0,2,2206,T
5-NP,491,0,1,2227,0,2228,G
5-NP,492,0,3,0,2219,2222,C
5-NP,493,0,2223,0,2,2225,T
5-NP,494,2,0,0,2424,2426,C
5-NP,495,0,2420,0,2,2422,T
5-NP,496,2,0,0,2540,2542,C
5-NP,497,0,2533,0,13,2546,T
5-NP,498,0,4,2552,2,2558,G
5-NP,499,2583,0,4,0,2587,A
5-NP,500,0,2576,0,0,2576,T
5-NP,501,1,1,2571,0,2573,G
5-NP,502,0,0,0,2573,2573,C
5-NP,503,2498,0,3,0,2501,A
5-NP,504,1,5,2609,0,2615,G
5-NP,505,0,3,2537,0,2540,G
5-NP,506,1,0,2559,0,2560,G
5-NP,507,1,0,0,2570,2571,C
5-NP,508,0,2549,0,4,2553,T
5-NP,509,0,2,1,2565,2568,C
5-NP,510,0,4,2573,0,2577,G
5-NP,511,2592,1,0,0,2593,A
5-NP,512,0,2,0,2620,2622,C
5-NP,513,0,2573,0,6,2579,T
5-NP,514,3,0,0,2706,2709,C
5-NP,515,0,2678,0,4,2682,T
5-NP,516,2,0,0,3127,3129,C
5-NP,517,2,3,1,3124,3130,C
5-NP,518,3,0,0,3131,3134,C
5-NP,519,0,3157,0,1,3158,T
5-NP,520,3122,0,0,0,3122,A
5-NP,521,0,1,3113,0,3114,G
5-NP,522,3108,0,0,0,3108,A
5-NP,523,3017,0,4,0,3021,A
5-NP,524,1,5,3009,0,3015,G
5-NP,525,0,2,2960,0,2962,G
5-NP,526,0,2897,0,2,2899,T
5-NP,527,3,0,0,2925,2928,C
5-NP,528,1,2,0,2928,2931,C
5-NP,529,3,2,2919,0,2924,G
5-NP,530,1,5,2938,0,2944,G
5-NP,531,2938,0,4,0,2942,A
5-NP,532,2,0,2985,0,2987,G
5-NP,533,0,1,0,2998,2999,C
5-NP,534,0,2967,0,5,2972,T
5-NP,535,2,0,2999,0,3001,G
5-NP,536,0,0,0,3005,3005,C
5-NP,537,2988,0,6,0,2994,A
5-NP,538,0,3,2994,0,2997,G
5-NP,539,1,4,3010,0,3015,G
5-NP,540,0,2957,0,2,2959,T
5-NP,541,0,1,3010,0,3011,G
5-NP,542,1,2,0,3003,3006,C
5-NP,543,0,3005,0,5,3010,T
5-NP,544,0,0,3019,0,3019,G
5-NP,545,0,1,0,3017,3018,C
5-NP,546,3055,1,4,0,3060,A
5-NP,547,2,1,3126,0,3129,G
5-NP,548,0,3086,0,3,3089,T
5-NP,549,5,0,0,3118,3123,C
5-NP,550,3102,0,2,0,3104,A
5-NP,551,3112,0,2,0,3114,A
5-NP,552,3096,1,11,0,3108,A
5-NP,553,0,2,3124,0,3126,G
5-NP,554,0,4,3144,0,3148,G
5-NP,555,3144,0,1,0,3145,A
5-NP,556,3116,0,3,0,3119,A
5-NP,557,0,3116,0,0,3116,T
5-NP,558,1,2,0,3116,3119,C
5-NP,559,4,6,3110,0,3120,G
5-NP,560,1,4,3201,0,3206,G
5-NP,561,0,1,3217,0,3218,G
5-NP,562,3189,0,4,0,3193,A
5-NP,563,0,5,0,3218,3223,C
5-NP,564,3191,1,2,0,3194,A
5-NP,565,3284,0,7,0,3291,A
5-NP,566,0,3332,0,0,3332,T
5-NP,567,3,6,3360,0,3369,G
5-NP,568,2,0,3456,0,3458,G
5-NP,569,0,3430,0,5,3435,T
5-NP,570,3,4,3495,0,3502,G
5-NP,571,3484,0,5,0,3489,A
5-NP,572,0,3489,0,3,3492,T
5-NP,573,6,2,3487,0,3495,G
5-NP,574,0,2,3505,1,3508,G
5-NP,575,3465,0,7,0,3472,A
5-NP,576,3500,0,1,0,3501,A
5-NP,577,0,0,0,3511,3511,C
5-NP,578,0,3386,0,1,3387,T
5-NP,579,0,7,3591,0,3598,G
5-NP,580,3539,1,3,0,3543,A
5-NP,581,0,3570,0,2,3572,T
5-NP,582,3,2,0,3581,3586,C
5-NP,583,3529,0,5,0,3534,A
5-NP,584,5,1,3666,0,3672,G
5-NP,585,3616,0,0,0,3616,A
5-NP,586,3648,1,2,0,3651,A
5-NP,587,0,3671,0,0,3671,T
5-NP,588,0,5,3606,0,3611,G
5-NP,589,0,3,3651,1,3655,G
5-NP,590,1,3640,0,2,3643,T
5-NP,591,7,2,0,3665,3674,C
5-NP,592,3666,0,0,0,3666,A
5-NP,593,3632,0,5,1,3638,A
5-NP,594,3657,0,2,1,3660,A
5-NP,595,0,1,0,3666,3667,C
5-NP,596,1,3,3657,0,3661,G
5-NP,597,3,7,3654,0,3664,G
5-NP,598,1,7,3625,0,3633,G
5-NP,599,3,3,3655,0,3661,G
5-NP,600,0,4,3675,1,3680,G
5-NP,601,3680,0,4,0,3684,A
5-NP,602,0,3644,0,5,3649,T
5-NP,603,9,1,0,3653,3663,C
5-NP,604,3670,0,4,0,3674,A
5-NP,605,3660,0,1,0,3661,A
5-NP,606,0,5,0,3649,3654,C
5-NP,607,1,6,3628,0,3635,G
5-NP,608,3606,1,1,0,3608,A
5-NP,609,0,3604,0,0,3604,T
5-NP,610,8,0,0,3600,3608,C
5-NP,611,0,6,3619,0,3625,G
5-NP,612,3607,1,1,0,3609,A
5-NP,613,3611,0,0,0,3611,A
5-NP,614,3603,0,1,0,3604,A
5-NP,615,1,3666,0,1,3668,T
5-NP,616,0,3674,0,0,3674,T
5-NP,617,0,3669,0,0,3669,T
5-NP,618,1,3681,0,0,3682,T
5-NP,619,0,3685,0,1,3686,T
5-NP,620,1,3,3683,0,3687,G
5-NP,621,1,7,3680,0,3688,G
5-NP,622,3646,0,3,0,3649,A
5-NP,623,0,3,3693,0,3696,G
5-NP,624,3620,0,3,0,3623,A
5-NP,625,1,2,3827,0,3830,G
5-NP,626,1,1,3840,0,3842,G
5-NP,627,0,3747,0,4,3751,T
5-NP,628,0,11,3835,0,3846,G
5-NP,629,3834,1,7,0,3842,A
5-NP,630,0,6,3862,0,3868,G
5-NP,631,3848,0,6,0,3854,A
5-NP,632,3826,1,3,0,3830,A
5-NP,633,0,3815,0,0,3815,T
5-NP,634,1,7,3675,0,3683,G
5-NP,635,1,4,3631,0,3636,G
5-NP,636,0,3,3625,0,3628,G
5-NP,637,1,3,1,3610,3615,C
5-NP,638,3,3,3641,0,3647,G
5-NP,639,0,2,3676,0,3678,G
5-NP,640,3657,0,1,0,3658,A
5-NP,641,3661,0,1,1,3663,A
5-NP,642,3747,0,5,0,3752,A
5-NP,643,3762,0,3,2,3767,A
5-NP,644,1,0,0,3796,3797,C
5-NP,645,3785,0,0,0,3785,A
5-NP,646,3776,0,2,0,3778,A
5-NP,647,1,5,3786,0,3792,G
5-NP,648,3675,0,6,0,3681,A
5-NP,649,3697,0,3,0,3700,A
5-NP,650,1,0,3811,0,3812,G
5-NP,651,0,3763,0,0,3763,T
5-NP,652,4,1,3996,0,4001,G
5-NP,653,2,0,0,3979,3981,C
5-NP,654,0,3994,2,5,4001,T
5-NP,655,1,4024,0,3,4028,T
5-NP,656,4095,0,1,0,4096,A
5-NP,657,1,4094,0,2,4097,T
5-NP,658,0,11,4111,1,4123,G
5-NP,659,4027,1,9,0,4037,A
5-NP,660,1,9,4051,0,4061,G
5-NP,661,3848,0,8,0,3856,A
5-NP,662,0,7,3868,0,3875,G
5-NP,663,3866,0,5,0,3871,A
5-NP,664,3911,0,1,0,3912,A
5-NP,665,0,3853,0,2,3855,T
5-NP,666,0,1,3912,0,3913,G
5-NP,667,2,3855,0,11,3868,T
5-NP,668,1,1,3911,1,3914,G
5-NP,669,2,2,0,3892,3896,C
5-NP,670,3889,1,5,0,3895,A
5-NP,671,3899,0,6,0,3905,A
5-NP,672,0,1,0,3895,3896,C
5-NP,673,3850,0,1,0,3851,A
5-NP,674,0,3865,0,3,3868,T
5-NP,675,0,3817,0,11,3828,T
5-NP,676,3,0,0,3836,3839,C
5-NP,677,0,3815,0,4,3819,T
5-NP,678,0,3845,0,0,3845,T
5-NP,679,3835,2,1,0,3838,A
5-NP,680,3815,0,2,0,3817,A
5-NP,681,3806,0,8,0,3814,A
5-NP,682,0,1,3818,0,3819,G
5-NP,683,0,5,3796,0,3801,G
5-NP,684,3788,1,5,0,3794,A
5-NP,685,3787,0,3,0,3790,A
5-NP,686,3779,1,0,0,3780,A
5-NP,687,3842,0,0,0,3842,A
5-NP,688,0,3841,0,0,3841,T
5-NP,689,0,3833,0,0,3833,T
5-NP,690,0,3844,0,0,3844,T
5-NP,691,7,0,0,3844,3851,C
5-NP,692,3863,0,0,0,3863,A
5-NP,693,3857,0,1,0,3858,A
5-NP,694,3853,0,5,2,3860,A
5-NP,695,2,1,0,3914,3917,C
5-NP,696,3882,0,1,0,3883,A
5-NP,697,0,0,3966,0,3966,G
5-NP,698,1,1,1,3969,3972,C
5-NP,699,0,3952,0,8,3960,T
5-NP,700,0,1,4056,0,4057,G
5-NP,701,0,2,1,4051,4054,C
5-NP,702,4065,0,5,0,4070,A
5-NP,703,0,4,0,4073,4077,C
5-NP,704,4038,0,3,0,4041,A
5-NP,705,4064,0,1,0,4065,A
5-NP,706,3955,0,3,1,3959,A
5-NP,707,1,12,4139,0,4152,G
5-NP,708,4121,0,13,0,4134,A
5-NP,709,0,1,4207,0,4208,G
5-NP,710,1,1,0,4204,4206,C
5-NP,711,4207,0,2,0,4209,A
5-NP,712,4336,0,4,1,4341,A
5-NP,713,0,4355,0,1,4356,T
5-NP,714,0,6,4369,0,4375,G
5-NP,715,3,1,4391,0,4395,G
5-NP,716,0,4226,0,5,4231,T
5-NP,717,1,8,4274,0,4283,G
5-NP,718,0,5,4293,0,4298,G
5-NP,719,4296,0,3,0,4299,A
5-NP,720,0,4290,0,4,4294,T
5-NP,721,13,0,0,4154,4167,C
5-NP,722,4191,0,3,0,4194,A
5-NP,723,4231,0,5,0,4236,A
5-NP,724,4,2,4270,0,4276,G
5-NP,725,0,4218,0,5,4223,T
5-NP,726,3,10,4231,0,4244,G
5-NP,727,4191,0,10,0,4201,A
5-NP,728,1,10,4210,0,4221,G
5-NP,729,4213,0,5,1,4219,A
5-NP,730,1,4,4201,0,4206,G
5-NP,731,4174,1,2,0,4177,A
5-NP,732,4108,0,1,0,4109,A
5-NP,733,4122,0,5,0,4127,A
5-NP,734,0,0,4150,0,4150,G
5-NP,735,0,4136,0,1,4137,T
5-NP,736,6,2,1,4130,4139,C
5-NP,737,1,7,4111,0,4119,G
5-NP,738,2,8,4110,0,4120,G
5-NP,739,4124,0,4,0,4128,A
5-NP,740,4136,0,3,0,4139,A
5-NP,741,2,0,0,4178,4180,C
5-NP,742,6,1,0,4131,4138,C
5-NP,743,5,1,0,4154,4160,C
5-NP,744,4152,1,6,0,4159,A
5-NP,745,0,3,4168,0,4171,G
5-NP,746,0,4,4163,0,4167,G
5-NP,747,4167,0,2,1,4170,A
5-NP,748,4173,0,2,0,4175,A
5-NP,749,4121,0,5,0,4126,A
5-NP,750,1,2,0,4153,4156,C
5-NP,751,1,2,4135,0,4138,G
5-NP,752,0,1,0,4132,4133,C
5-NP,753,1,4122,0,3,4126,T
5-NP,754,1,8,4156,0,4165,G
5-NP,755,4143,0,1,0,4144,A
5-NP,756,1,8,4201,0,4210,G
5-NP,757,4199,0,4,0,4203,A
5-NP,758,0,4188,0,0,4188,T
5-NP,759,8,2,0,4156,4166,C
5-NP,760,6,5,4180,0,4191,G
5-NP,761,4170,0,0,0,4170,A
5-NP,762,4165,0,7,0,4172,A
5-NP,763,1,4,4167,0,4172,G
5-NP,764,4166,0,4,0,4170,A
5-NP,765,1,4134,0,2,4137,T
5-NP,766,3,0,0,4175,4178,C
5-NP,767,1,4197,0,3,4201,T
5-NP,768,9,0,1,4247,4257,C
5-NP,769,4274,0,1,0,4275,A
5-NP,770,0,4254,0,1,4255,T
5-NP,771,4273,0,1,0,4274,A
5-NP,772,1,4268,0,0,4269,T
5-NP,773,0,4242,0,1,4243,T
5-NP,774,0,4236,1,1,4238,T
5-NP,775,0,4195,0,2,4197,T
5-NP,776,0,4187,0,0,4187,T
5-NP,777,4219,0,3,0,4222,A
5-NP,778,0,1,4194,0,4195,G
5-NP,779,2,2,0,4209,4213,C
5-NP,780,4200,0,2,0,4202,A
5-NP,781,4174,0,3,0,4177,A
5-NP,782,0,4,4316,0,4320,G
5-NP,783,4308,1,3,1,4313,A
5-NP,784,0,4305,1,3,4309,T
5-NP,785,3,1,0,4365,4369,C
5-NP,786,0,4346,0,6,4352,T
5-NP,787,0,2,4478,0,4480,G
5-NP,788,1,1,0,4486,4488,C
5-NP,789,4496,0,3,0,4499,A
5-NP,790,1,4548,0,0,4549,T
5-NP,791,0,4394,0,1,4395,T
5-NP,792,1,5,4636,0,4642,G
5-NP,793,4725,0,7,0,4732,A
5-NP,794,0,4737,0,2,4739,T
5-NP,795,4731,0,2,0,4733,A
5-NP,796,0,4645,0,1,4646,T
5-NP,797,0,4606,0,1,4607,T
5-NP,798,2,8,4634,0,4644,G
5-NP,799,4580,1,8,0,4589,A
5-NP,800,0,5,4641,0,4646,G
5-NP,801,4404,0,6,0,4410,A
5-NP,802,1,7,4334,0,4342,G
5-NP,803,1,4,4398,0,4403,G
5-NP,804,4367,0,6,0,4373,A
5-NP,805,1,4355,0,1,4357,T
5-NP,806,11,1,0,4384,4396,C
5-NP,807,4362,1,4,0,4367,A
5-NP,808,1,0,4404,0,4405,G
5-NP,809,0,4367,0,2,4369,T
5-NP,810,0,4316,0,1,4317,T
5-NP,811,1,0,4315,1,4317,G
5-NP,812,0,2,0,4281,4283,C
5-NP,813,0,4298,0,5,4303,T
5-NP,814,7,1,1,4295,4304,C
5-NP,815,4314,1,1,2,4318,A
5-NP,816,1,0,0,4328,4329,C
5-NP,817,4337,0,1,0,4338,A
5-NP,818,4359,0,2,0,4361,A
5-NP,819,4330,0,1,0,4331,A
5-NP,820,0,4313,0,1,4314,T
5-NP,821,8,0,0,4341,4349,C
5-NP,822,1,4321,0,2,4324,T
5-NP,823,0,4324,0,2,4326,T
5-NP,824,1,0,4353,1,4355,G
5-NP,825,1,6,0,4337,4344,C
5-NP,826,4,4,0,4362,4370,C
5-NP,827,0,4388,0,3,4391,T
5-NP,828,4380,0,0,0,4380,A
5-NP,829,0,2,0,4435,4437,C
5-NP,830,5,2,0,4439,4446,C
5-NP,831,2,4414,0,4,4420,T
5-NP,832,4,1,4490,0,4495,G
5-NP,833,2,0,0,4458,4460,C
5-NP,834,2,0,0,4502,4504,C
5-NP,835,1,4411,0,2,4414,T
5-NP,836,3,1,4521,0,4525,G
5-NP,837,0,4448,1,2,4451,T
5-NP,838,6,2,4566,0,4574,G
5-NP,839,18,6,0,4577,4601,C
5-NP,840,4,2,4675,1,4682,G
5-NP,841,0,4580,0,5,4585,T
5-NP,842,4570,0,2,0,4572,A
5-NP,843,0,4563,0,10,4573,T
5-NP,844,2,10,4577,0,4589,G
5-NP,845,0,5,4733,0,4738,G
5-NP,846,4714,0,2,0,4716,A
5-NP,847,2,1,0,4633,4636,C
5-NP,848,3,0,0,4599,4602,C
5-NP,849,1,4491,0,12,4504,T
5-NP,850,2,2,4720,0,4724,G
5-NP,851,1,3,0,4726,4730,C
5-NP,852,4758,0,3,0,4761,A
5-NP,853,4,0,4839,0,4843,G
5-NP,854,0,4621,0,2,4623,T
5-NP,855,4830,0,0,0,4830,A
5-NP,856,0,4789,0,5,4794,T
5-NP,857,6,1,0,4769,4776,C
5-NP,858,3,3,0,4799,4805,C
5-NP,859,4611,0,2,1,4614,A
5-NP,860,5,1,4630,1,4637,G
5-NP,861,1,4597,1,2,4601,T
5-NP,862,2,3,4692,0,4697,G
5-NP,863,1,5,4651,0,4657,G
5-NP,864,4,0,4602,0,4606,G
5-NP,865,1,4575,0,7,4583,T
5-NP,866,4592,0,1,0,4593,A
5-NP,867,2,2,0,4585,4589,C
5-NP,868,2,12,4533,2,4549,G
5-NP,869,4522,1,6,0,4529,A
5-NP,870,0,0,0,4560,4560,C
5-NP,871,0,4421,1,6,4428,T
5-NP,872,0,4436,0,1,4437,T
5-NP,873,6,3,0,4437,4446,C
5-NP,874,2,6,4446,0,4454,G
5-NP,875,4440,0,4,0,4444,A
5-NP,876,4452,0,4,0,4456,A
5-NP,877,4469,1,1,0,4471,A
5-NP,878,4454,0,2,1,4457,A
5-NP,879,4450,0,6,0,4456,A
5-NP,880,1,4,4464,0,4469,G
5-NP,881,4446,0,10,0,4456,A
5-NP,882,9,6,4479,1,4495,G
5-NP,883,2,3,4530,1,4536,G
5-NP,884,1,4,4522,0,4527,G
5-NP,885,4546,0,9,0,4555,A
5-NP,886,0,4552,0,2,4554,T
5-NP,887,4592,0,0,0,4592,A
5-NP,888,0,4610,1,8,4619,T
5-NP,889,0,4610,0,4,4614,T
5-NP,890,8,1,0,4693,4702,C
5-NP,891,6,1,1,4676,4684,C
5-NP,892,0,4607,0,5,4612,T
5-NP,893,0,4636,0,0,4636,T
5-NP,894,1,6,4718,0,4725,G
5-NP,895,4,1,4730,0,4735,G
5-NP,896,0,4660,2,3,4665,T
5-NP,897,2,6,4669,0,4677,G
5-NP,898,1,3,4608,0,4612,G
5-NP,899,2,5,4570,0,4577,G
5-NP,900,3,4,4469,1,4477,G
5-NP,901,4771,2,14,0,4787,A
5-NP,902,0,4793,0,1,4794,T
5-NP,903,4803,1,4,0,4808,A
5-NP,904,1,5,4773,1,4780,G
5-NP,905,4725,0,9,0,4734,A
5-NP,906,1,2,0,4758,4761,C
5-NP,907,6,1,0,4667,4674,C
5-NP,908,7,1,0,4570,4578,C
5-NP,909,0,4622,0,8,4630,T
5-NP,910,1,4628,0,3,4632,T
5-NP,911,0,4626,0,6,4632,T
5-NP,912,3,2,0,4631,4636,C
5-NP,913,4622,0,1,0,4623,A
5-NP,914,4628,1,2,0,4631,A
5-NP,915,4600,1,3,0,4604,A
5-NP,916,1,0,0,4623,4624,C
5-NP,917,0,4516,0,0,4516,T
5-NP,918,4490,2,0,0,4492,A
5-NP,919,1,2,0,4535,4538,C
5-NP,920,1,4525,0,4,4530,T
5-NP,921,0,4509,0,4,4513,T
5-NP,922,4,0,0,4547,4551,C
5-NP,923,4524,0,4,0,4528,A
5-NP,924,4538,0,2,0,4540,A
5-NP,925,4518,0,1,0,4519,A
5-NP,926,4521,1,0,1,4523,A
5-NP,927,0,4483,0,0,4483,T
5-NP,928,4399,0,4,1,4404,A
5-NP,929,0,0,4465,0,4465,G
5-NP,930,2,2,0,4486,4490,C
5-NP,931,8,0,0,4565,4573,C
5-NP,932,4581,0,1,0,4582,A
5-NP,933,4571,0,2,0,4573,A
5-NP,934,4756,0,1,1,4758,A
5-NP,935,0,4771,0,0,4771,T
5-NP,936,4806,0,1,0,4807,A
5-NP,937,1,4795,0,2,4798,T
5-NP,938,4734,0,2,1,4737,A
5-NP,939,0,0,0,4745,4745,C
5-NP,940,4645,0,1,0,4646,A
5-NP,941,3,0,4781,0,4784,G
5-NP,942,2,0,0,4762,4764,C
5-NP,943,0,4627,1,11,4639,T
5-NP,944,0,4718,0,1,4719,T
5-NP,945,4745,2,0,0,4747,A
5-NP,946,4741,0,4,0,4745,A
5-NP,947,0,4727,0,0,4727,T
5-NP,948,11,1,0,4723,4735,C
5-NP,949,4588,1,7,1,4597,A
5-NP,950,0,2,4651,0,4653,G
5-NP,951,4631,0,4,0,4635,A
5-NP,952,1,2,0,4687,4690,C
5-NP,953,3,0,0,4661,4664,C
5-NP,954,1,4604,0,3,4608,T
5-NP,955,4664,1,2,0,4667,A
5-NP,956,4649,0,3,0,4652,A
5-NP,957,3,6,0,4670,4679,C
5-NP,958,2,10,4665,0,4677,G
5-NP,959,4594,1,3,0,4598,A
5-NP,960,1,10,4595,0,4606,G
5-NP,961,4550,0,2,0,4552,A
5-NP,962,4588,0,2,0,4590,A
5-NP,963,1,4577,0,5,4583,T
5-NP,964,6,2,0,4538,4546,C
5-NP,965,1,1,0,4560,4562,C
5-NP,966,4450,1,9,0,4460,A
5-NP,967,4,3,4455,0,4462,G
5-NP,968,1,3,0,4466,4470,C
5-NP,969,4487,3,6,0,4496,A
5-NP,970,3,1,0,4553,4557,C
5-NP,971,4483,0,5,0,4488,A
5-NP,972,1,0,1,4508,4510,C
5-NP,973,4512,0,2,0,4514,A
5-NP,974,4541,0,8,0,4549,A
5-NP,975,0,6,4538,0,4544,G
5-NP,976,4496,0,8,0,4504,A
5-NP,977,3,2,4488,0,4493,G
5-NP,978,2,4390,0,6,4398,T
5-NP,979,11,1,0,4403,4415,C
5-NP,980,4390,0,10,1,4401,A
5-NP,981,0,0,4386,0,4386,G
5-NP,982,0,0,0,4389,4389,C
5-NP,983,0,4350,0,6,4356,T
5-NP,984,3,3,4462,0,4468,G
5-NP,985,1,2,4490,0,4493,G
5-NP,986,0,4442,0,6,4448,T
5-NP,987,37,0,4474,0,4511,G
5-NP,988,0,4462,0,7,4469,T
5-NP,989,2,3,4452,0,4457,G
5-NP,990,0,4,4435,1,4440,G
5-NP,991,4436,1,3,0,4440,A
5-NP,992,0,4450,0,2,4452,T
5-NP,993,1,9,4217,0,4227,G
5-NP,994,3,1,4188,0,4192,G
5-NP,995,1,0,1,4179,4181,C
5-NP,996,4148,0,5,0,4153,A
5-NP,997,0,4160,1,4,4165,T
5-NP,998,3,1,4129,0,4133,G
5-NP,999,1,4,0,4164,4169,C
5-NP,1000,4,2,0,4186,4192,C
5-NP,1001,4204,0,3,0,4207,A
5-NP,1002,0,4193,0,8,4201,T
5-NP,1003,0,4133,0,8,4141,T
5-NP,1004,7,0,0,4170,4177,C
5-NP,1005,0,4114,0,2,4116,T
5-NP,1006,0,0,4096,1,4097,G
5-NP,1007,1,1,0,4097,4099,C
5-NP,1008,0,3986,1,4,3991,T
5-NP,1009,1,1,4016,0,4018,G
5-NP,1010,2,1,0,3980,3983,C
5-NP,1011,3990,0,1,0,3991,A
5-NP,1012,1,3984,1,3,3989,T
5-NP,1013,0,3962,0,2,3964,T
5-NP,1014,0,3964,0,1,3965,T
5-NP,1015,1,6,3953,0,3960,G
5-NP,1016,3958,1,2,0,3961,A
5-NP,1017,3959,0,10,0,3969,A
5-NP,1018,1,7,3979,0,3987,G
5-NP,1019,3973,1,4,0,3978,A
5-NP,1020,0,3966,0,5,3971,T
5-NP,1021,1,3969,0,0,3970,T
5-NP,1022,0,3973,0,4,3977,T
5-NP,1023,3967,1,6,0,3974,A
5-NP,1024,3975,0,1,0,3976,A
5-NP,1025,1,8,3974,0,3983,G
5-NP,1026,3958,1,2,0,3961,A
5-NP,1027,0,3955,0,1,3956,T
5-NP,1028,1,3903,0,2,3906,T
5-NP,1029,2,0,3934,0,3936,G
5-NP,1030,1,3923,2,4,3930,T
5-NP,1031,0,3929,0,1,3930,T
5-NP,1032,3932,1,3,0,3936,A
5-NP,1033,3935,0,3,0,3938,A
5-NP,1034,1,0,3934,0,3935,G
5-NP,1035,0,2,0,3954,3956,C
5-NP,1036,1,3872,0,15,3888,T
5-NP,1037,0,3901,0,6,3907,T
5-NP,1038,5,3,0,3926,3934,C
5-NP,1039,3926,0,2,0,3928,A
5-NP,1040,1,3909,0,1,3911,T
5-NP,1041,3,2,0,3929,3934,C
5-NP,1042,3868,1,2,0,3871,A
5-NP,1043,0,2,3867,0,3869,G
5-NP,1044,3802,1,11,0,3814,A
5-NP,1045,0,7,3820,0,3827,G
5-NP,1046,0,8,3840,0,3848,G
5-NP,1047,0,9,3810,0,3819,G
5-NP,1048,3809,0,2,0,3811,A
5-NP,1049,1,0,0,3850,3851,C
5-NP,1050,3850,1,1,1,3853,A
5-NP,1051,3864,1,1,0,3866,A
5-NP,1052,3874,0,5,0,3879,A
5-NP,1053,3888,0,7,0,3895,A
5-NP,1054,0,0,3920,0,3920,G
5-NP,1055,1,3831,0,1,3833,T
5-NP,1056,3811,0,1,0,3812,A
5-NP,1057,0,3786,0,6,3792,T
5-NP,1058,5,47,0,3738,3790,C
5-NP,1059,5,3732,1,5,3743,T
5-NP,1060,6,2,0,3765,3773,C
5-NP,1061,6,1,0,3758,3765,C
5-NP,1062,0,3708,0,4,3712,T
5-NP,1063,4,2,0,3728,3734,C
5-NP,1064,2,1,3716,0,3719,G
5-NP,1065,2,4,3737,0,3743,G
5-NP,1066,2,8,3726,1,3737,G
5-NP,1067,2,2,3728,0,3732,G
5-NP,1068,1,3,3722,0,3726,G
5-NP,1069,3670,0,1,0,3671,A
5-NP,1070,3669,0,3,0,3672,A
5-NP,1071,3653,0,3,0,3656,A
5-NP,1072,1,0,0,3683,3684,C
5-NP,1073,0,3669,0,3,3672,T
5-NP,1074,1,0,3712,0,3713,G
5-NP,1075,2,3688,0,6,3696,T
5-NP,1076,8,1,1,3708,3718,C
5-NP,1077,3796,0,3,1,3800,A
5-NP,1078,3814,0,3,0,3817,A
5-NP,1079,1,1,0,3850,3852,C
5-NP,1080,0,3837,0,1,3838,T
5-NP,1081,3778,0,1,0,3779,A
5-NP,1082,1,2,3789,0,3792,G
5-NP,1083,3725,0,6,1,3732,A
5-NP,1084,0,3,3748,0,3751,G
5-NP,1085,0,8,3754,0,3762,G
5-NP,1086,3586,0,3,0,3589,A
5-NP,1087,1,0,3669,0,3670,G
5-NP,1088,0,3616,0,2,3618,T
5-NP,1089,3632,1,3,0,3636,A
5-NP,1090,1,0,0,3649,3650,C
5-NP,1091,3601,0,3,1,3605,A
5-NP,1092,3592,0,3,0,3595,A
5-NP,1093,3582,0,1,0,3583,A
5-NP,1094,0,3544,0,1,3545,T
5-NP,1095,0,3542,1,0,3543,T
5-NP,1096,0,1,3452,0,3453,G
5-NP,1097,1,2,1,3454,3458,C
5-NP,1098,0,3452,2,4,3458,T
5-NP,1099,0,3439,1,5,3445,T
5-NP,1100,2,0,0,3455,3457,C
5-NP,1101,3466,0,0,0,3466,A
5-NP,1102,3486,0,1,0,3487,A
5-NP,1103,3473,0,2,0,3475,A
5-NP,1104,0,3489,0,0,3489,T
5-NP,1105,0,7,3480,1,3488,G
5-NP,1106,3405,1,8,1,3415,A
5-NP,1107,0,10,3430,0,3440,G
5-NP,1108,3438,0,6,0,3444,A
5-NP,1109,3433,0,6,0,3439,A
5-NP,1110,0,0,0,3457,3457,C
5-NP,1111,3428,0,1,1,3430,A
5-NP,1112,0,3416,1,1,3418,T
5-NP,1113,1,1,3476,0,3478,G
5-NP,1114,2,4,3496,0,3502,G
5-NP,1115,3489,0,5,0,3494,A
5-NP,1116,1,3452,1,1,3455,T
5-NP,1117,3421,0,1,1,3423,A
5-NP,1118,3731,0,1,1,3733,A
5-NP,1119,1,3674,0,2,3677,T
5-NP,1120,3672,0,4,0,3676,A
5-NP,1121,0,3635,1,4,3640,T
5-NP,1122,3,4,3461,0,3468,G
5-NP,1123,1,3,3411,0,3415,G
5-NP,1124,2,6,3406,0,3414,G
5-NP,1125,3412,0,6,0,3418,A
5-NP,1126,0,3389,0,1,3390,T
5-NP,1127,3,4,0,2864,2871,C
5-NP,1128,1,6,2878,0,2885,G
5-NP,1129,2867,1,4,0,2872,A
5-NP,1130,3,2,2862,0,2867,G
5-NP,1131,0,3,0,2863,2866,C
5-NP,1132,2830,1,2,0,2833,A
5-NP,1133,2,0,0,3000,3002,C
5-NP,1134,1,2940,0,5,2946,T
5-NP,1135,5,0,0,2972,2977,C
5-NP,1136,0,2972,0,6,2978,T
5-NP,1137,0,2962,0,0,2962,T
5-NP,1138,0,8,2952,0,2960,G
5-NP,1139,2943,0,4,0,2947,A
5-NP,1140,2945,0,6,0,2951,A
5-NP,1141,0,0,0,2963,2963,C
5-NP,1142,0,2587,0,1,2588,T
5-NP,1143,0,2,2594,0,2596,G
5-NP,1144,2556,0,5,0,2561,A
5-NP,1145,0,0,2576,0,2576,G
5-NP,1146,2639,0,1,0,2640,A
5-NP,1147,2699,0,4,0,2703,A
5-NP,1148,0,2,2722,0,2724,G
5-NP,1149,1,1,0,2687,2689,C
5-NP,1150,517,0,2170,0,2687,G
5-NP,1151,1,4,2722,0,2727,G
5-NP,1152,16,0,2717,0,2733,G
5-NP,1153,0,2703,0,3,2706,T
5-NP,1154,2678,0,0,0,2678,A
5-NP,1155,1,2,0,2678,2681,C
5-NP,1156,0,2306,0,1,2307,T
5-NP,1157,2,1,2312,0,2315,G
5-NP,1158,0,0,2284,0,2284,G
5-NP,1159,2,2,2286,0,2290,G
5-NP,1160,0,2,0,2259,2261,C
5-NP,1161,2,0,0,2185,2187,C
5-NP,1162,2216,1,2,0,2219,A
5-NP,1163,0,2220,0,0,2220,T
5-NP,1164,2225,0,0,0,2225,A
5-NP,1165,2213,1,4,0,2218,A
5-NP,1166,0,0,2198,0,2198,G
5-NP,1167,0,0,2264,0,2264,G
5-NP,1168,2210,0,2,1,2213,A
5-NP,1169,1,2,0,2220,2223,C
5-NP,1170,3,2,0,2218,2223,C
5-NP,1171,2206,0,5,0,2211,A
5-NP,1172,2,1,2256,0,2259,G
5-NP,1173,1,2,2268,0,2271,G
5-NP,1174,2260,1,0,0,2261,A
5-NP,1175,0,2,2279,0,2281,G
5-NP,1176,0,2170,0,0,2170,T
5-NP,1177,1,0,2186,0,2187,G
5-NP,1178,0,2,2207,0,2209,G
5-NP,1179,2193,1,4,0,2198,A
5-NP,1180,0,2,2229,0,2231,G
5-NP,1181,1,1,2194,0,2196,G
5-NP,1182,2170,0,1,0,2171,A
5-NP,1183,2166,0,2,0,2168,A
5-NP,1184,2169,0,6,0,2175,A
5-NP,1185,0,1,0,2182,2183,C
5-NP,1186,2178,0,2,0,2180,A
5-NP,1187,0,0,0,2232,2232,C
5-NP,1188,0,2195,0,0,2195,T
5-NP,1189,2255,0,0,0,2255,A
5-NP,1190,2250,0,1,0,2251,A
5-NP,1191,0,2250,0,2,2252,T
5-NP,1192,6,0,0,2274,2280,C
5-NP,1193,2264,0,2,0,2266,A
5-NP,1194,2283,0,1,0,2284,A
5-NP,1195,2,1,0,2285,2288,C
5-NP,1196,2231,0,2,0,2233,A
5-NP,1197,0,1,2229,0,2230,G
5-NP,1198,2159,0,3,0,2162,A
5-NP,1199,4,3,2169,0,2176,G
5-NP,1200,0,2,2180,0,2182,G
5-NP,1201,2,1,2156,0,2159,G
5-NP,1202,0,1,1,2146,2148,C
5-NP,1203,1,0,0,2137,2138,C
5-NP,1204,0,2099,0,2,2101,T
5-NP,1205,4,0,0,2146,2150,C
5-NP,1206,1,2,0,2143,2146,C
5-NP,1207,3,0,2151,0,2154,G
5-NP,1208,1,0,0,2144,2145,C
5-NP,1209,2117,0,2,0,2119,A
5-NP,1210,0,1,2189,0,2190,G
5-NP,1211,1,1,2182,0,2184,G
5-NP,1212,0,0,0,2202,2202,C
5-NP,1213,2,0,0,2214,2216,C
5-NP,1214,2203,0,0,0,2203,A
5-NP,1215,2210,0,0,0,2210,A
5-NP,1216,2207,1,1,0,2209,A
5-NP,1217,0,0,0,2219,2219,C
5-NP,1218,3,0,0,2225,2228,C
5-NP,1219,2091,0,0,0,2091,A
5-NP,1220,1,1,2141,0,2143,G
5-NP,1221,1,2117,0,1,2119,T
5-NP,1222,6,0,2133,0,2139,G
5-NP,1223,0,2118,0,0,2118,T
5-NP,1224,1,0,2127,0,2128,G
5-NP,1225,1,1,0,2125,2127,C
5-NP,1226,2117,0,1,0,2118,A
5-NP,1227,2149,0,1,0,2150,A
5-NP,1228,1,0,0,2152,2153,C
5-NP,1229,3,0,0,2147,2150,C
5-NP,1230,0,2122,0,3,2125,T
5-NP,1231,2121,0,2,0,2123,A
5-NP,1232,1,1,0,2116,2118,C
5-NP,1233,0,0,2130,0,2130,G
5-NP,1234,0,2103,2,1,2106,T
5-NP,1235,0,2129,0,4,2133,T
5-NP,1236,0,2103,1,0,2104,T
5-NP,1237,0,2086,0,1,2087,T
5-NP,1238,1,1,0,2095,2097,C
5-NP,1239,0,2079,0,2,2081,T
5-NP,1240,0,0,2125,0,2125,G
5-NP,1241,0,2116,0,1,2117,T
5-NP,1242,2112,0,3,1,2116,A
5-NP,1243,1,0,0,2141,2142,C
5-NP,1244,2116,0,3,0,2119,A
5-NP,1245,2118,0,1,0,2119,A
5-NP,1246,2120,0,1,0,2121,A
5-NP,1247,1,0,2127,0,2128,G
5-NP,1248,2124,0,1,0,2125,A
5-NP,1249,2068,0,0,0,2068,A
5-NP,1250,2068,0,4,1,2073,A
5-NP,1251,1,0,0,2072,2073,C
5-NP,1252,3,0,0,2027,2030,C
5-NP,1253,0,1999,0,6,2005,T
5-NP,1254,5,0,0,2022,2027,C
5-NP,1255,0,1,0,2019,2020,C
5-NP,1256,4,0,0,2021,2025,C
5-NP,1257,2026,1,0,0,2027,A
5-NP,1258,1,2036,0,0,2037,T
5-NP,1259,0,2039,0,2,2041,T
5-NP,1260,0,2038,0,0,2038,T
5-NP,1261,1,7,2034,0,2042,G
5-NP,1262,2027,0,1,0,2028,A
5-NP,1263,2029,0,5,0,2034,A
5-NP,1264,2033,0,1,0,2034,A
5-NP,1265,2022,0,2,0,2024,A
5-NP,1266,0,0,2043,0,2043,G
5-NP,1267,0,2006,0,4,2010,T
5-NP,1268,4,0,0,2011,2015,C
5-NP,1269,2029,0,0,0,2029,A
5-NP,1270,2021,1,3,0,2025,A
5-NP,1271,1,0,0,2040,2041,C
5-NP,1272,3,1,0,2065,2069,C
5-NP,1273,2066,0,1,0,2067,A
5-NP,1274,0,2055,0,3,2058,T
5-NP,1275,1,0,0,2063,2064,C
5-NP,1276,2038,0,7,1,2046,A
5-NP,1277,0,2055,0,2,2057,T
5-NP,1278,1,2,2059,0,2062,G
5-NP,1279,0,0,2058,0,2058,G
5-NP,1280,0,0,0,2060,2060,C
5-NP,1281,2021,0,3,0,2024,A
5-NP,1282,2,0,2034,0,2036,G
5-NP,1283,0,1,0,2009,2010,C
5-NP,1284,2007,0,1,0,2008,A
5-NP,1285,0,2007,0,1,2008,T
5-NP,1286,0,1986,0,1,1987,T
5-NP,1287,2,0,0,1998,2000,C
5-NP,1288,1984,1,1,0,1986,A
5-NP,1289,0,0,0,2001,2001,C
5-NP,1290,0,1982,0,3,1985,T
5-NP,1291,1,0,1995,0,1996,G
5-NP,1292,1,1,1996,0,1998,G
5-NP,1293,1983,0,6,0,1989,A
5-NP,1294,1985,0,2,0,1987,A
5-NP,1295,1979,0,3,0,1982,A
5-NP,1296,0,1968,1,0,1969,T
5-NP,1297,1968,0,0,1,1969,A
5-NP,1298,1,2,0,1957,1960,C
5-NP,1299,2,2,1929,0,1933,G
5-NP,1300,0,0,1933,0,1933,G
5-NP,1301,1862,1,0,0,1863,A
5-NP,1302,0,2,1888,0,1890,G
5-NP,1303,0,0,1885,0,1885,G
5-NP,1304,3,3,1880,0,1886,G
5-NP,1305,1889,0,1,0,1890,A
5-NP,1306,1879,0,5,0,1884,A
5-NP,1307,0,2,1893,0,1895,G
5-NP,1308,1888,0,0,0,1888,A
5-NP,1309,1876,0,0,0,1876,A
5-NP,1310,0,1,0,1903,1904,C
5-NP,1311,0,1883,0,5,1888,T
5-NP,1312,0,1893,0,0,1893,T
5-NP,1313,3,0,0,1890,1893,C
5-NP,1314,1898,1,2,0,1901,A
5-NP,1315,1,2,1900,0,1903,G
5-NP,1316,1891,0,1,0,1892,A
5-NP,1317,0,0,0,1895,1895,C
5-NP,1318,1876,0,0,0,1876,A
5-NP,1319,0,1824,0,3,1827,T
5-NP,1320,1,1,1840,0,1842,G
5-NP,1321,1800,0,2,0,1802,A
5-NP,1322,1,5,1810,0,1816,G
5-NP,1323,2,1,1813,0,1816,G
5-NP,1324,0,1,1806,0,1807,G
5-NP,1325,1,1,0,1809,1811,C
5-NP,1326,1800,0,3,0,1803,A
5-NP,1327,0,1,1809,0,1810,G
5-NP,1328,1795,1,0,0,1796,A
5-NP,1329,1813,0,2,0,1815,A
5-NP,1330,1817,0,0,0,1817,A
5-NP,1331,0,1798,0,2,1800,T
5-NP,1332,6,0,0,1804,1810,C
5-NP,1333,1797,0,0,1,1798,A
5-NP,1334,0,1797,0,0,1797,T
5-NP,1335,1803,0,0,0,1803,A
5-NP,1336,1786,0,1,0,1787,A
5-NP,1337,1,2,1816,0,1819,G
5-NP,1338,1784,0,1,0,1785,A
5-NP,1339,1805,0,0,0,1805,A
5-NP,1340,0,1762,0,0,1762,T
5-NP,1341,0,1,1765,0,1766,G
5-NP,1342,1758,0,3,0,1761,A
5-NP,1343,0,1755,0,1,1756,T
5-NP,1344,0,0,1767,0,1767,G
5-NP,1345,0,1,1763,1,1765,G
5-NP,1346,1717,0,0,0,1717,A
5-NP,1347,1701,0,1,0,1702,A
5-NP,1348,1,0,1665,0,1666,G
5-NP,1349,0,0,1693,0,1693,G
5-NP,1350,0,1662,0,1,1663,T
5-NP,1351,1,0,1669,0,1670,G
5-NP,1352,0,0,0,1665,1665,C
5-NP,1353,1668,0,1,0,1669,A
5-NP,1354,1676,0,1,0,1677,A
5-NP,1355,1673,0,0,0,1673,A
5-NP,1356,1683,0,1,0,1684,A
5-NP,1357,0,0,0,1682,1682,C
5-NP,1358,2,0,0,1669,1671,C
5-NP,1359,1634,0,0,0,1634,A
5-NP,1360,0,2,1648,0,1650,G
5-NP,1361,1652,0,1,0,1653,A
5-NP,1362,1648,0,1,0,1649,A
5-NP,1363,0,1,1647,1,1649,G
5-NP,1364,1641,0,0,0,1641,A
5-NP,1365,1599,0,3,0,1602,A
5-NP,1366,0,0,1620,0,1620,G
5-NP,1367,0,1592,0,3,1595,T
5-NP,1368,0,0,1616,0,1616,G
5-NP,1369,0,1594,1,2,1597,T
5-NP,1370,4,0,0,1595,1599,C
5-NP,1371,1604,0,1,0,1605,A
5-NP,1372,0,1621,0,0,1621,T
5-NP,1373,0,1598,0,2,1600,T
5-NP,1374,4,0,0,1609,1613,C
5-NP,1375,2,0,0,1582,1584,C
5-NP,1376,2,0,1573,0,1575,G
5-NP,1377,1550,0,2,0,1552,A
5-NP,1378,1,1,1569,0,1571,G
5-NP,1379,1,0,1576,0,1577,G
5-NP,1380,0,1,1563,0,1564,G
5-NP,1381,1504,0,2,0,1506,A
5-NP,1382,0,0,1515,0,1515,G
5-NP,1383,0,2,1505,0,1507,G
5-NP,1384,0,1,1498,0,1499,G
5-NP,1385,2,1,1509,0,1512,G
5-NP,1386,1489,0,0,0,1489,A
5-NP,1387,2,1,1507,0,1510,G
5-NP,1388,2,1469,1,3,1475,T
5-NP,1389,0,1471,0,0,1471,T
5-NP,1390,0,1482,0,1,1483,T
5-NP,1391,1,1468,0,0,1469,T
5-NP,1392,3,1,0,1473,1477,C
5-NP,1393,1,2,1467,0,1470,G
5-NP,1394,1462,1,2,0,1465,A
5-NP,1395,0,1,1532,0,1533,G
5-NP,1396,1,0,0,1512,1513,C
5-NP,1397,0,1517,0,1,1518,T
5-NP,1398,0,1,0,1530,1531,C
5-NP,1399,0,1511,0,6,1517,T
5-NP,1400,4,1,0,1524,1529,C
5-NP,1401,1530,0,0,1,1531,A
5-NP,1402,0,1,1543,0,1544,G
5-NP,1403,1532,0,2,0,1534,A
5-NP,1404,2,1,0,1534,1537,C
5-NP,1405,0,4,1533,0,1537,G
5-NP,1406,1499,0,4,0,1503,A
5-NP,1407,0,2,1507,0,1509,G
5-NP,1408,1500,0,1,0,1501,A
5-NP,1409,1489,0,2,0,1491,A
5-NP,1410,1,2,1487,0,1490,G
5-NP,1411,0,0,1471,0,1471,G
5-NP,1412,1,1,0,1470,1472,C
5-NP,1413,1467,0,2,0,1469,A
5-NP,1414,1463,0,0,0,1463,A
5-NP,1415,1,0,0,1458,1459,C
5-NP,1416,0,6,1460,0,1466,G
5-NP,1417,1467,0,1,0,1468,A
5-NP,1418,1453,0,0,0,1453,A
5-NP,1419,0,0,0,1449,1449,C
5-NP,1420,2,1,0,1443,1446,C
5-NP,1421,0,1,0,1433,1434,C
5-NP,1422,0,4,1444,0,1448,G
5-NP,1423,1446,0,0,0,1446,A
5-NP,1424,0,1446,0,1,1447,T
5-NP,1425,1,1,0,1403,1405,C
5-NP,1426,0,0,1431,0,1431,G
5-NP,1427,0,1428,0,1,1429,T
5-NP,1428,0,0,1414,0,1414,G
5-NP,1429,0,0,0,1397,1397,C
5-NP,1430,1,1,0,1396,1398,C
5-NP,1431,4,2,0,1408,1414,C
5-NP,1432,0,1383,0,1,1384,T
5-NP,1433,2,0,0,1463,1465,C
5-NP,1434,1,1464,1,4,1470,T
5-NP,1435,0,1461,1,1,1463,T
5-NP,1436,0,1474,0,0,1474,T
5-NP,1437,0,1466,0,1,1467,T
5-NP,1438,4,1,1476,0,1481,G
5-NP,1439,1482,0,3,0,1485,A
5-NP,1440,0,1461,0,1,1462,T
5-NP,1441,1460,0,2,0,1462,A
5-NP,1442,0,1248,0,0,1248,T
5-NP,1443,0,7,1287,0,1294,G
5-NP,1444,1267,0,2,0,1269,A
5-NP,1445,0,1,1295,0,1296,G
5-NP,1446,0,1287,0,1,1288,T
5-NP,1447,1259,0,0,0,1259,A
5-NP,1448,1262,0,1,0,1263,A
5-NP,1449,0,1256,0,0,1256,T
5-NP,1450,2,0,1257,0,1259,G
5-NP,1451,1248,0,1,0,1249,A
5-NP,1452,1115,0,3,1,1119,A
5-NP,1453,0,2,1108,0,1110,G
5-NP,1454,0,1,1061,0,1062,G
5-NP,1455,1069,0,0,0,1069,A
5-NP,1456,0,1055,0,3,1058,T
5-NP,1457,1,0,0,1060,1061,C
5-NP,1458,0,1042,0,3,1045,T
5-NP,1459,0,1043,0,1,1044,T
5-NP,1460,1040,0,0,0,1040,A
5-NP,1461,0,1039,0,0,1039,T
5-NP,1462,0,1036,0,2,1038,T
5-NP,1463,0,1017,0,3,1020,T
5-NP,1464,0,0,0,1010,1010,C
5-NP,1465,0,970,0,1,971,T
5-NP,1466,0,974,0,1,975,T
5-NP,1467,0,1,0,976,977,C
5-NP,1468,4,0,972,0,976,G
5-NP,1469,0,1,972,0,973,G
5-NP,1470,965,0,2,0,967,A
5-NP,1471,0,0,969,0,969,G
5-NP,1472,973,0,0,0,973,A
5-NP,1473,1,1,0,959,961,C
5-NP,1474,914,0,1,0,915,A
5-NP,1475,910,0,2,0,912,A
5-NP,1476,1,912,0,0,913,T
5-NP,1477,0,0,912,0,912,G
5-NP,1478,1,2,0,903,906,C
5-NP,1479,875,0,4,0,879,A
5-NP,1480,0,0,878,0,878,G
5-NP,1481,876,0,0,0,876,A
5-NP,1482,808,0,0,0,808,A
5-NP,1483,0,0,805,0,805,G
5-NP,1484,556,0,2,0,558,A
5-NP,1485,0,0,560,0,560,G
5-NP,1486,0,517,0,0,517,T
5-NP,1487,514,0,0,0,514,A
5-NP,1488,0,0,0,510,510,C
5-NP,1489,0,0,463,0,463,G
5-NP,1490,465,0,1,0,466,A
5-NP,1491,0,0,0,454,454,C
5-NP,1492,329,0,0,1,330,A
5-NP,1493,334,0,0,0,334,A
5-NP,1494,0,263,0,0,263,T
5-NP,1495,0,255,0,0,255,T
5-NP,1496,256,0,0,0,256,A
5-NP,1497,236,0,0,0,236,A
6-NA,1,16,0,0,0,16,A
6-NA,2,0,16,0,0,16,T
6-NA,3,0,0,16,0,16,G
6-NA,4,16,0,1,0,17,A
6-NA,5,17,0,0,0,17,A
6-NA,6,0,17,0,0,17,T
6-NA,7,0,0,0,17,17,C
6-NA,8,0,0,0,17,17,C
6-NA,9,17,0,0,0,17,A
6-NA,10,19,0,0,0,19,A
6-NA,11,19,0,0,0,19,A
6-NA,12,0,19,0,0,19,T
6-NA,13,0,0,0,19,19,C
6-NA,14,19,0,0,0,19,A
6-NA,15,19,0,0,0,19,A
6-NA,16,19,0,0,0,19,A
6-NA,17,22,0,0,0,22,A
6-NA,18,0,0,23,0,23,G
6-NA,19,23,0,0,0,23,A
6-NA,20,0,23,0,0,23,T
6-NA,21,23,0,0,0,23,A
6-NA,22,22,0,0,0,22,A
6-NA,23,0,23,0,0,23,T
6-NA,24,23,0,0,0,23,A
6-NA,25,24,0,0,0,24,A
6-NA,26,0,0,0,26,26,C
6-NA,27,0,0,27,0,27,G
6-NA,28,26,0,0,0,26,A
6-NA,29,0,26,0,0,26,T
6-NA,30,0,27,0,0,27,T
6-NA,31,0,0,26,0,26,G
6-NA,32,0,0,27,0,27,G
6-NA,33,0,0,0,28,28,C
6-NA,34,0,28,0,0,28,T
6-NA,35,0,0,0,31,31,C
6-NA,36,0,31,0,0,31,T
6-NA,37,0,0,32,0,32,G
6-NA,38,0,31,0,0,31,T
6-NA,39,0,31,0,0,31,T
6-NA,40,0,34,0,0,34,T
6-NA,41,0,0,0,35,35,C
6-NA,42,0,34,0,0,34,T
6-NA,43,0,0,0,35,35,C
6-NA,44,0,34,0,0,34,T
6-NA,45,0,0,0,37,37,C
6-NA,46,37,0,0,0,37,A
6-NA,47,0,0,0,40,40,C
6-NA,48,0,0,0,41,41,C
6-NA,49,41,0,0,0,41,A
6-NA,50,0,44,0,0,44,T
6-NA,51,0,47,0,0,47,T
6-NA,52,0,47,0,0,47,T
6-NA,53,0,0,0,46,46,C
6-NA,54,0,0,0,49,49,C
6-NA,55,50,0,0,0,50,A
6-NA,56,0,0,0,52,52,C
6-NA,57,50,0,0,0,50,A
6-NA,58,51,0,0,0,51,A
6-NA,59,0,51,0,0,51,T
6-NA,60,54,0,0,0,54,A
6-NA,61,0,54,0,0,54,T
6-NA,62,0,0,54,0,54,G
6-NA,63,0,0,0,53,53,C
6-NA,64,0,53,0,0,53,T
6-NA,65,0,54,0,0,54,T
6-NA,66,0,0,0,55,55,C
6-NA,67,0,53,0,0,53,T
6-NA,68,0,54,0,0,54,T
6-NA,69,0,0,0,54,54,C
6-NA,70,54,0,0,0,54,A
6-NA,71,0,54,0,0,54,T
6-NA,72,0,0,53,0,53,G
6-NA,73,0,0,0,54,54,C
6-NA,74,53,0,0,0,53,A
6-NA,75,54,0,0,0,54,A
6-NA,76,54,0,0,0,54,A
6-NA,77,0,56,0,0,56,T
6-NA,78,0,55,0,0,55,T
6-NA,79,0,0,57,0,57,G
6-NA,80,0,0,0,58,58,C
6-NA,81,0,0,0,56,56,C
6-NA,82,57,0,0,0,57,A
6-NA,83,0,58,0,0,58,T
6-NA,84,0,0,0,63,63,C
6-NA,85,0,63,0,0,63,T
6-NA,86,0,63,0,0,63,T
6-NA,87,0,0,65,0,65,G
6-NA,88,63,0,0,0,63,A
6-NA,89,0,65,0,0,65,T
6-NA,90,66,0,0,0,66,A
6-NA,91,66,0,0,0,66,A
6-NA,92,0,0,0,75,75,C
6-NA,93,0,72,0,0,72,T
6-NA,94,73,0,0,0,73,A
6-NA,95,0,0,0,76,76,C
6-NA,96,0,75,0,0,75,T
6-NA,97,0,0,77,0,77,G
6-NA,98,0,77,0,0,77,T
6-NA,99,77,0,1,0,78,A
6-NA,100,78,0,0,0,78,A
6-NA,101,0,0,0,72,72,C
6-NA,102,71,0,0,0,71,A
6-NA,103,0,70,0,0,70,T
6-NA,104,0,67,0,0,67,T
6-NA,105,0,0,67,0,67,G
6-NA,106,0,0,0,66,66,C
6-NA,107,67,0,0,0,67,A
6-NA,108,0,68,0,1,69,T
6-NA,109,0,70,0,0,70,T
6-NA,110,0,70,0,0,70,T
6-NA,111,0,0,0,70,70,C
6-NA,112,70,0,0,0,70,A
6-NA,113,71,0,0,0,71,A
6-NA,114,0,0,72,0,72,G
6-NA,115,0,0,0,71,71,C
6-NA,116,71,0,0,0,71,A
6-NA,117,75,0,0,0,75,A
6-NA,118,0,76,0,0,76,T
6-NA,119,76,0,0,0,76,A
6-NA,120,0,76,0,0,76,T
6-NA,121,0,0,77,1,78,G
6-NA,122,78,0,0,0,78,A
6-NA,123,78,0,0,0,78,A
6-NA,124,0,79,0,0,79,T
6-NA,125,0,78,0,1,79,T
6-NA,126,0,0,0,78,78,C
6-NA,127,78,0,0,0,78,A
6-NA,128,78,0,0,0,78,A
6-NA,129,0,0,0,78,78,C
6-NA,130,0,75,0,2,77,T
6-NA,131,0,0,0,75,75,C
6-NA,132,0,0,0,76,76,C
6-NA,133,0,0,0,75,75,C
6-NA,134,2,0,0,74,76,C
6-NA,135,0,0,0,76,76,C
6-NA,136,0,0,0,77,77,C
6-NA,137,0,0,0,77,77,C
6-NA,138,78,0,0,0,78,A
6-NA,139,76,0,0,0,76,A
6-NA,140,78,0,0,0,78,A
6-NA,141,0,0,0,76,76,C
6-NA,142,77,0,0,0,77,A
6-NA,143,76,0,0,0,76,A
6-NA,144,0,0,0,77,77,C
6-NA,145,0,0,0,78,78,C
6-NA,146,80,0,0,0,80,A
6-NA,147,78,0,0,0,78,A
6-NA,148,0,0,77,0,77,G
6-NA,149,0,79,0,0,79,T
6-NA,150,0,0,78,0,78,G
6-NA,151,78,0,0,0,78,A
6-NA,152,0,78,0,0,78,T
6-NA,153,0,0,79,0,79,G
6-NA,154,0,0,0,79,79,C
6-NA,155,0,79,0,0,79,T
6-NA,156,0,0,84,0,84,G
6-NA,157,0,85,0,0,85,T
6-NA,158,0,0,85,0,85,G
6-NA,159,0,87,0,0,87,T
6-NA,160,0,0,86,0,86,G
6-NA,161,87,0,0,0,87,A
6-NA,162,86,0,0,0,86,A
6-NA,163,0,0,0,87,87,C
6-NA,164,0,0,0,85,85,C
6-NA,165,79,0,0,0,79,A
6-NA,166,81,0,1,0,82,A
6-NA,167,0,0,0,83,83,C
6-NA,168,83,0,0,0,83,A
6-NA,169,83,0,0,0,83,A
6-NA,170,0,84,0,0,84,T
6-NA,171,84,0,0,0,84,A
6-NA,172,84,0,0,0,84,A
6-NA,173,0,84,0,0,84,T
6-NA,174,84,0,0,0,84,A
6-NA,175,0,0,84,0,84,G
6-NA,176,80,0,0,0,80,A
6-NA,177,83,0,0,0,83,A
6-NA,178,80,0,0,0,80,A
6-NA,179,0,0,83,0,83,G
6-NA,180,82,0,0,0,82,A
6-NA,181,84,0,0,0,84,A
6-NA,182,86,0,0,0,86,A
6-NA,183,0,0,0,86,86,C
6-NA,184,87,0,0,0,87,A
6-NA,185,0,86,0,0,86,T
6-NA,186,93,0,0,0,93,A
6-NA,187,90,0,1,0,91,A
6-NA,188,0,0,0,92,92,C
6-NA,189,91,0,0,0,91,A
6-NA,190,0,0,94,0,94,G
6-NA,191,97,0,1,0,98,A
6-NA,192,0,0,99,0,99,G
6-NA,193,92,0,1,0,93,A
6-NA,194,0,104,0,0,104,T
6-NA,195,106,0,0,0,106,A
6-NA,196,0,0,107,0,107,G
6-NA,197,0,105,0,0,105,T
6-NA,198,0,0,109,0,109,G
6-NA,199,0,107,0,0,107,T
6-NA,200,110,0,0,0,110,A
6-NA,201,0,111,0,1,112,T
6-NA,202,0,0,0,109,109,C
6-NA,203,0,106,0,0,106,T
6-NA,204,0,1,103,0,104,G
6-NA,205,108,0,0,0,108,A
6-NA,206,0,0,0,109,109,C
6-NA,207,0,0,0,109,109,C
6-NA,208,108,0,0,0,108,A
6-NA,209,105,0,0,0,105,A
6-NA,210,0,0,0,112,112,C
6-NA,211,111,0,0,0,111,A
6-NA,212,0,0,0,114,114,C
6-NA,213,0,0,0,113,113,C
6-NA,214,116,0,0,0,116,A
6-NA,215,0,0,0,126,126,C
6-NA,216,1,0,0,125,126,C
6-NA,217,126,0,0,0,126,A
6-NA,218,0,127,0,0,127,T
6-NA,219,126,0,0,0,126,A
6-NA,220,0,0,126,0,126,G
6-NA,221,122,0,0,0,122,A
6-NA,222,0,0,126,0,126,G
6-NA,223,125,0,0,0,125,A
6-NA,224,122,0,0,0,122,A
6-NA,225,0,0,122,0,122,G
6-NA,226,2,1,119,0,122,G
6-NA,227,124,0,0,0,124,A
6-NA,228,126,0,0,0,126,A
6-NA,229,124,0,0,0,124,A
6-NA,230,0,123,0,0,123,T
6-NA,231,121,0,0,0,121,A
6-NA,232,0,121,0,0,121,T
6-NA,233,0,0,122,0,122,G
6-NA,234,0,0,0,123,123,C
6-NA,235,0,0,0,121,121,C
6-NA,236,0,0,0,123,123,C
6-NA,237,0,0,0,121,121,C
6-NA,238,122,0,0,0,122,A
6-NA,239,126,0,0,0,126,A
6-NA,240,123,0,0,0,123,A
6-NA,241,0,0,0,123,123,C
6-NA,242,0,127,0,0,127,T
6-NA,243,124,0,0,0,124,A
6-NA,244,0,0,125,0,125,G
6-NA,245,0,0,0,125,125,C
6-NA,246,125,0,0,0,125,A
6-NA,247,0,0,122,0,122,G
6-NA,248,125,0,0,0,125,A
6-NA,249,125,0,0,0,125,A
6-NA,250,0,125,0,0,125,T
6-NA,251,125,0,0,0,125,A
6-NA,252,0,0,0,125,125,C
6-NA,253,125,0,0,0,125,A
6-NA,254,0,0,125,0,125,G
6-NA,255,124,0,0,0,124,A
6-NA,256,119,0,1,0,120,A
6-NA,257,121,0,0,0,121,A
6-NA,258,0,116,0,0,116,T
6-NA,259,0,112,0,0,112,T
6-NA,260,0,0,116,0,116,G
6-NA,261,0,0,116,0,116,G
6-NA,262,0,115,0,1,116,T
6-NA,263,0,0,0,117,117,C
6-NA,264,116,0,0,0,116,A
6-NA,265,115,0,0,0,115,A
6-NA,266,115,0,0,0,115,A
6-NA,267,0,0,112,0,112,G
6-NA,268,0,0,0,116,116,C
6-NA,269,0,0,0,116,116,C
6-NA,270,0,0,114,0,114,G
6-NA,271,0,0,0,115,115,C
6-NA,272,116,0,0,0,116,A
6-NA,273,120,0,0,0,120,A
6-NA,274,0,122,0,0,122,T
6-NA,275,0,0,123,0,123,G
6-NA,276,0,121,0,0,121,T
6-NA,277,0,1,120,0,121,G
6-NA,278,124,0,0,0,124,A
6-NA,279,0,0,0,125,125,C
6-NA,280,125,0,0,0,125,A
6-NA,281,0,126,0,0,126,T
6-NA,282,0,124,0,0,124,T
6-NA,283,128,0,0,0,128,A
6-NA,284,0,0,0,128,128,C
6-NA,285,125,0,0,0,125,A
6-NA,286,0,0,123,0,123,G
6-NA,287,0,0,124,0,124,G
6-NA,288,122,0,0,0,122,A
6-NA,289,0,123,0,1,124,T
6-NA,290,0,124,0,0,124,T
6-NA,291,0,125,0,0,125,T
6-NA,292,0,0,121,0,121,G
6-NA,293,0,0,0,122,122,C
6-NA,294,120,1,0,0,121,A
6-NA,295,0,0,0,124,124,C
6-NA,296,0,0,0,124,124,C
6-NA,297,0,123,0,0,123,T
6-NA,298,0,122,0,0,122,T
6-NA,299,0,122,0,0,122,T
6-NA,300,0,124,0,0,124,T
6-NA,301,0,125,0,0,125,T
6-NA,302,0,0,0,130,130,C
6-NA,303,0,129,0,0,129,T
6-NA,304,128,0,0,0,128,A
6-NA,305,126,0,0,0,126,A
6-NA,306,0,0,129,0,129,G
6-NA,307,0,0,127,0,127,G
6-NA,308,128,0,0,0,128,A
6-NA,309,0,0,0,130,130,C
6-NA,310,125,0,1,0,126,A
6-NA,311,121,0,0,0,121,A
6-NA,312,0,121,0,0,121,T
6-NA,313,0,124,0,0,124,T
6-NA,314,0,0,0,124,124,C
6-NA,315,0,0,126,0,126,G
6-NA,316,126,0,0,0,126,A
6-NA,317,0,125,0,0,125,T
6-NA,318,0,124,0,0,124,T
6-NA,319,125,0,0,0,125,A
6-NA,320,0,0,126,0,126,G
6-NA,321,1,0,124,0,125,G
6-NA,322,0,0,0,128,128,C
6-NA,323,0,124,0,0,124,T
6-NA,324,0,128,0,0,128,T
6-NA,325,0,129,0,0,129,T
6-NA,326,0,0,0,128,128,C
6-NA,327,0,0,0,129,129,C
6-NA,328,0,0,128,0,128,G
6-NA,329,0,0,0,130,130,C
6-NA,330,0,128,0,0,128,T
6-NA,331,0,0,130,0,130,G
6-NA,332,0,0,130,0,130,G
6-NA,333,0,131,0,0,131,T
6-NA,334,0,0,130,0,130,G
6-NA,335,0,0,128,0,128,G
6-NA,336,0,0,129,0,129,G
6-NA,337,0,0,131,0,131,G
6-NA,338,128,0,0,0,128,A
6-NA,339,0,0,0,131,131,C
6-NA,340,129,0,0,0,129,A
6-NA,341,0,126,0,0,126,T
6-NA,342,0,0,0,131,131,C
6-NA,343,0,132,0,0,132,T
6-NA,344,0,0,130,0,130,G
6-NA,345,0,0,133,0,133,G
6-NA,346,0,0,129,0,129,G
6-NA,347,0,129,0,0,129,T
6-NA,348,1,1,128,0,130,G
6-NA,349,128,0,0,0,128,A
6-NA,350,0,0,0,138,138,C
6-NA,351,140,0,0,0,140,A
6-NA,352,189,0,0,0,189,A
6-NA,353,0,0,217,0,217,G
6-NA,354,218,0,0,0,218,A
6-NA,355,0,0,282,0,282,G
6-NA,356,300,0,1,0,301,A
6-NA,357,417,0,0,0,417,A
6-NA,358,0,0,0,801,801,C
6-NA,359,1,0,0,970,971,C
6-NA,360,0,965,0,0,965,T
6-NA,361,0,983,0,1,984,T
6-NA,362,987,1,0,0,988,A
6-NA,363,0,996,0,1,997,T
6-NA,364,1,0,1123,0,1124,G
6-NA,365,0,1144,0,1,1145,T
6-NA,366,1,0,1224,0,1225,G
6-NA,367,0,1239,0,0,1239,T
6-NA,368,0,0,0,1246,1246,C
6-NA,369,1255,2,1,22,1280,A
6-NA,370,0,1290,0,1,1291,T
6-NA,371,0,0,1287,0,1287,G
6-NA,372,1,3,0,1285,1289,C
6-NA,373,1,2,1296,0,1299,G
6-NA,374,1618,0,0,0,1618,A
6-NA,375,0,1630,0,1,1631,T
6-NA,376,2,0,0,1706,1708,C
6-NA,377,1,1,1,1703,1706,C
6-NA,378,0,1761,0,5,1766,T
6-NA,379,1,8,1797,0,1806,G
6-NA,380,1807,0,3,0,1810,A
6-NA,381,0,0,0,1823,1823,C
6-NA,382,1824,0,0,0,1824,A
6-NA,383,1831,0,0,0,1831,A
6-NA,384,1,1,1951,0,1953,G
6-NA,385,0,1953,0,0,1953,T
6-NA,386,2,0,2015,0,2017,G
6-NA,387,0,2012,0,4,2016,T
6-NA,388,0,2022,0,3,2025,T
6-NA,389,2022,0,1,0,2023,A
6-NA,390,0,2027,0,4,2031,T
6-NA,391,2,0,1,2060,2063,C
6-NA,392,2079,0,0,0,2079,A
6-NA,393,2081,0,1,2,2084,A
6-NA,394,0,2087,0,2,2089,T
6-NA,395,0,2083,0,2,2085,T
6-NA,396,0,2086,0,3,2089,T
6-NA,397,0,0,2106,0,2106,G
6-NA,398,0,2,0,2254,2256,C
6-NA,399,2,0,0,2258,2260,C
6-NA,400,3,2,0,2274,2279,C
6-NA,401,0,2263,0,4,2267,T
6-NA,402,0,2269,0,4,2273,T
6-NA,403,0,4,2322,0,2326,G
6-NA,404,1,6,2325,0,2332,G
6-NA,405,2343,1,4,0,2348,A
6-NA,406,0,0,0,2366,2366,C
6-NA,407,2320,0,1,0,2321,A
6-NA,408,2,8,2386,0,2396,G
6-NA,409,0,5,2386,0,2391,G
6-NA,410,0,7,2499,0,2506,G
6-NA,411,2503,0,3,0,2506,A
6-NA,412,2506,0,5,0,2511,A
6-NA,413,0,2,0,2526,2528,C
6-NA,414,2512,0,5,2,2519,A
6-NA,415,2812,0,4,1,2817,A
6-NA,416,0,2,0,2866,2868,C
6-NA,417,2845,1,1,0,2847,A
6-NA,418,0,1,0,2905,2906,C
6-NA,419,0,2859,0,4,2863,T
6-NA,420,2900,0,0,0,2900,A
6-NA,421,2894,0,2,0,2896,A
6-NA,422,2896,0,3,0,2899,A
6-NA,423,1,2,0,2913,2916,C
6-NA,424,2823,0,1,0,2824,A
6-NA,425,2816,0,2,0,2818,A
6-NA,426,1,1,0,2806,2808,C
6-NA,427,1,0,2812,0,2813,G
6-NA,428,0,2796,0,2,2798,T
6-NA,429,1,1,2807,0,2809,G
6-NA,430,1,1,0,2817,2819,C
6-NA,431,2832,0,0,1,2833,A
6-NA,432,0,2852,0,0,2852,T
6-NA,433,0,2863,0,0,2863,T
6-NA,434,4,1,1,2914,2920,C
6-NA,435,2968,1,1,0,2970,A
6-NA,436,2982,0,3,0,2985,A
6-NA,437,2994,1,2,0,2997,A
6-NA,438,0,2998,2,1,3001,T
6-NA,439,2,11,2989,0,3002,G
6-NA,440,3049,0,8,1,3058,A
6-NA,441,0,1,0,3061,3062,C
6-NA,442,3048,0,6,0,3054,A
6-NA,443,0,1,0,3120,3121,C
6-NA,444,3077,0,7,0,3084,A
6-NA,445,0,0,3910,0,3910,G
6-NA,446,0,3905,0,1,3906,T
6-NA,447,3993,0,2,0,3995,A
6-NA,448,0,3,0,4019,4022,C
6-NA,449,2,1,3992,0,3995,G
6-NA,450,1,4118,0,2,4121,T
6-NA,451,3,7,4136,0,4146,G
6-NA,452,4146,1,3,1,4151,A
6-NA,453,0,4170,0,1,4171,T
6-NA,454,3839,1,0,0,3840,A
6-NA,455,1,8,3821,0,3830,G
6-NA,456,1,3,3760,0,3764,G
6-NA,457,3800,0,4,1,3805,A
6-NA,458,0,1,0,3880,3881,C
6-NA,459,4,0,0,3821,3825,C
6-NA,460,3,0,0,3889,3892,C
6-NA,461,11,1,0,3909,3921,C
6-NA,462,0,3955,1,4,3960,T
6-NA,463,0,4005,0,2,4007,T
6-NA,464,4032,0,0,0,4032,A
6-NA,465,0,4024,0,0,4024,T
6-NA,466,2,3,0,4037,4042,C
6-NA,467,3,2,3973,1,3979,G
6-NA,468,1,4,3945,0,3950,G
6-NA,469,3965,0,1,0,3966,A
6-NA,470,3,3,0,3985,3991,C
6-NA,471,7,3,0,3984,3994,C
6-NA,472,4,0,0,4191,4195,C
6-NA,473,0,4182,0,4,4186,T
6-NA,474,4243,0,0,0,4243,A
6-NA,475,0,4245,0,1,4246,T
6-NA,476,1,4258,0,0,4259,T
6-NA,477,1,5,4258,0,4264,G
6-NA,478,4251,0,5,0,4256,A
6-NA,479,0,4238,0,3,4241,T
6-NA,480,0,16,4247,0,4263,G
6-NA,481,4133,0,2,0,4135,A
6-NA,482,4153,0,7,0,4160,A
6-NA,483,0,4148,1,2,4151,T
6-NA,484,1,6,4210,0,4217,G
6-NA,485,4241,1,3,0,4245,A
6-NA,486,1,2,4361,0,4364,G
6-NA,487,0,4325,0,5,4330,T
6-NA,488,0,4357,0,0,4357,T
6-NA,489,4365,0,3,0,4368,A
6-NA,490,1,5,4370,0,4376,G
6-NA,491,1,0,4379,0,4380,G
6-NA,492,0,4340,0,5,4345,T
6-NA,493,0,0,4361,0,4361,G
6-NA,494,0,4301,1,7,4309,T
6-NA,495,0,4300,0,7,4307,T
6-NA,496,9,0,0,4327,4336,C
6-NA,497,5,2,0,4375,4382,C
6-NA,498,0,4374,0,5,4379,T
6-NA,499,0,4391,0,0,4391,T
6-NA,500,0,4370,1,6,4377,T
6-NA,501,0,4374,0,5,4379,T
6-NA,502,6,1,0,4390,4397,C
6-NA,503,4377,0,2,0,4379,A
6-NA,504,0,4509,0,4,4513,T
6-NA,505,2,2,0,4507,4511,C
6-NA,506,0,4464,0,5,4469,T
6-NA,507,0,7,4445,0,4452,G
6-NA,508,0,7,4401,1,4409,G
6-NA,509,3,7,4405,0,4415,G
6-NA,510,0,6,4475,0,4481,G
6-NA,511,4480,5,10,0,4495,A
6-NA,512,0,0,0,4549,4549,C
6-NA,513,6,1,0,4469,4476,C
6-NA,514,4564,1,2,0,4567,A
6-NA,515,4628,1,3,1,4633,A
6-NA,516,1,0,4647,1,4649,G
6-NA,517,1,1,0,4668,4670,C
6-NA,518,4660,0,1,0,4661,A
6-NA,519,4544,0,206,0,4750,A
6-NA,520,2,1,4793,0,4796,G
6-NA,521,1,4757,0,1,4759,T
6-NA,522,3,1,4912,0,4916,G
6-NA,523,0,4807,1,5,4813,T
6-NA,524,3,1,4967,0,4971,G
6-NA,525,1,5,1,4968,4975,C
6-NA,526,4962,1,0,0,4963,A
6-NA,527,0,5042,2,3,5047,T
6-NA,528,4926,0,3,0,4929,A
6-NA,529,1,1,5071,0,5073,G
6-NA,530,2,2,0,5047,5051,C
6-NA,531,4950,0,2,0,4952,A
6-NA,532,0,4923,0,4,4927,T
6-NA,533,1,9,4767,0,4777,G
6-NA,534,0,2,5126,0,5128,G
6-NA,535,0,5138,0,5,5143,T
6-NA,536,6,0,0,5108,5114,C
6-NA,537,3,1,0,5142,5146,C
6-NA,538,5131,0,3,0,5134,A
6-NA,539,5,4,5296,0,5305,G
6-NA,540,1,3,0,5299,5303,C
6-NA,541,1,5315,0,9,5325,T
6-NA,542,11,1,0,5336,5348,C
6-NA,543,5181,1,2,0,5184,A
6-NA,544,5263,0,2,1,5266,A
6-NA,545,1,3,5295,0,5299,G
6-NA,546,0,5294,0,4,5298,T
6-NA,547,0,5290,0,2,5292,T
6-NA,548,0,1,5290,0,5291,G
6-NA,549,1,5271,0,1,5273,T
6-NA,550,10,1,0,5261,5272,C
6-NA,551,5273,1,5,1,5280,A
6-NA,552,0,2,0,5320,5322,C
6-NA,553,3,1,5322,0,5326,G
6-NA,554,5364,1,5,0,5370,A
6-NA,555,0,5426,0,4,5430,T
6-NA,556,3,5,5524,0,5532,G
6-NA,557,2,10,5544,0,5556,G
6-NA,558,5559,1,9,0,5569,A
6-NA,559,5578,0,6,1,5585,A
6-NA,560,5628,0,7,1,5636,A
6-NA,561,5615,0,13,0,5628,A
6-NA,562,0,1,5682,0,5683,G
6-NA,563,6,3,0,5651,5660,C
6-NA,564,5664,0,2,2,5668,A
6-NA,565,1,5646,0,0,5647,T
6-NA,566,2,5,5669,0,5676,G
6-NA,567,4,1,5688,0,5693,G
6-NA,568,1,1,0,5765,5767,C
6-NA,569,1,5742,0,5,5748,T
6-NA,570,4,2,5786,0,5792,G
6-NA,571,3,0,0,5777,5780,C
6-NA,572,5792,1,4,0,5797,A
6-NA,573,0,6016,0,0,6016,T
6-NA,574,2,2,6028,0,6032,G
6-NA,575,0,6079,1,6,6086,T
6-NA,576,0,6262,0,6,6268,T
6-NA,577,0,6244,0,5,6249,T
6-NA,578,1,1,6587,0,6589,G
6-NA,579,0,6542,0,8,6550,T
6-NA,580,6583,1,2,0,6586,A
6-NA,581,2,6614,0,2,6618,T
6-NA,582,6501,0,5,0,6506,A
6-NA,583,6526,1,5,3,6535,A
6-NA,584,0,5,0,6476,6481,C
6-NA,585,2,22,6418,0,6442,G
6-NA,586,1,11,6411,0,6423,G
6-NA,587,0,15,6336,0,6351,G
6-NA,588,1,10,6332,0,6343,G
6-NA,589,3,4,6359,0,6366,G
6-NA,590,6300,1,9,0,6310,A
6-NA,591,0,6367,0,2,6369,T
6-NA,592,2,13,6372,0,6387,G
6-NA,593,6411,1,7,0,6419,A
6-NA,594,1,6454,0,1,6456,T
6-NA,595,6425,0,7,0,6432,A
6-NA,596,6525,0,2,0,6527,A
6-NA,597,6534,0,1,2,6537,A
6-NA,598,6527,1,3,0,6531,A
6-NA,599,6537,0,3,0,6540,A
6-NA,600,0,6512,0,2,6514,T
6-NA,601,1,3,6525,1,6530,G
6-NA,602,4,1,0,6498,6503,C
6-NA,603,6490,0,7,0,6497,A
6-NA,604,6516,0,6,0,6522,A
6-NA,605,1,0,0,6597,6598,C
6-NA,606,0,6573,0,6,6579,T
6-NA,607,4,1,6603,0,6608,G
6-NA,608,1,1,0,6605,6607,C
6-NA,609,0,6612,0,1,6613,T
6-NA,610,6618,0,6,0,6624,A
6-NA,611,0,0,6626,0,6626,G
6-NA,612,1,1,0,6688,6690,C
6-NA,613,1,6664,1,12,6678,T
6-NA,614,0,6670,0,5,6675,T
6-NA,615,12,1,0,6763,6776,C
6-NA,616,6812,0,2,1,6815,A
6-NA,617,0,6821,0,0,6821,T
6-NA,618,0,6840,0,6,6846,T
6-NA,619,0,6906,0,0,6906,T
6-NA,620,6929,0,5,0,6934,A
6-NA,621,0,0,1,6994,6995,C
6-NA,622,6944,0,2,0,6946,A
6-NA,623,6983,0,7,0,6990,A
6-NA,624,0,6979,1,3,6983,T
6-NA,625,4,7,6961,0,6972,G
6-NA,626,1,4,6926,0,6931,G
6-NA,627,2,4,6945,0,6951,G
6-NA,628,6858,0,16,0,6874,A
6-NA,629,1,5,7088,0,7094,G
6-NA,630,7,1,7144,0,7152,G
6-NA,631,0,5,0,7616,7621,C
6-NA,632,0,7677,0,16,7693,T
6-NA,633,1,7793,0,4,7798,T
6-NA,634,4,1,7875,0,7880,G
6-NA,635,0,7837,0,3,7840,T
6-NA,636,7975,1,3,0,7979,A
6-NA,637,6,5,8027,0,8038,G
6-NA,638,7874,0,6,0,7880,A
6-NA,639,1,7911,0,4,7916,T
6-NA,640,7295,1,0,0,7296,A
6-NA,641,0,1,7288,0,7289,G
6-NA,642,0,7176,1,4,7181,T
6-NA,643,1,1,7082,0,7084,G
6-NA,644,1,7458,0,4,7463,T
6-NA,645,0,7475,0,3,7478,T
6-NA,646,4,2,7612,0,7618,G
6-NA,647,1,7578,2,12,7593,T
6-NA,648,1,7599,2,6,7608,T
6-NA,649,2,7603,1,9,7615,T
6-NA,650,14,1,0,7487,7502,C
6-NA,651,7490,0,10,0,7500,A
6-NA,652,2,7450,1,4,7457,T
6-NA,653,1,15,7450,1,7467,G
6-NA,654,1,0,7903,0,7904,G
6-NA,655,0,7822,0,11,7833,T
6-NA,656,11,0,0,7836,7847,C
6-NA,657,11,1,0,7863,7875,C
6-NA,658,7894,0,3,0,7897,A
6-NA,659,7941,0,4,0,7945,A
6-NA,660,7954,1,7,1,7963,A
6-NA,661,1,13,7971,0,7985,G
6-NA,662,7941,0,1,0,7942,A
6-NA,663,7695,0,7,1,7703,A
6-NA,664,7685,0,9,0,7694,A
6-NA,665,2,7677,0,0,7679,T
6-NA,666,13,0,0,7930,7943,C
6-NA,667,13,2,0,7925,7940,C
6-NA,668,0,7931,0,7,7938,T
6-NA,669,10,6,0,7932,7948,C
6-NA,670,7894,2,16,3,7915,A
6-NA,671,5,13,7964,2,7984,G
6-NA,672,0,17,7949,0,7966,G
6-NA,673,8186,0,10,1,8197,A
6-NA,674,3,3,0,8201,8207,C
6-NA,675,4,5,1,8051,8061,C
6-NA,676,12,2,2,8077,8093,C
6-NA,677,8089,2,7,0,8098,A
6-NA,678,1,7,8140,0,8148,G
6-NA,679,3,8,8148,1,8160,G
6-NA,680,8096,1,9,1,8107,A
6-NA,681,3,2,8227,0,8232,G
6-NA,682,1,8068,0,10,8079,T
6-NA,683,13,2,0,8106,8121,C
6-NA,684,8103,0,7,0,8110,A
6-NA,685,1,6,8186,1,8194,G
6-NA,686,8147,2,9,0,8158,A
6-NA,687,8165,0,3,0,8168,A
6-NA,688,1,8134,0,1,8136,T
6-NA,689,2,0,8180,0,8182,G
6-NA,690,2,1,0,8183,8186,C
6-NA,691,5,3,8261,0,8269,G
6-NA,692,1,8200,0,3,8204,T
6-NA,693,0,8250,0,2,8252,T
6-NA,694,0,8210,0,3,8213,T
6-NA,695,3,3,8268,0,8274,G
6-NA,696,0,8277,0,8,8285,T
6-NA,697,8288,0,3,0,8291,A
6-NA,698,2,8248,0,8,8258,T
6-NA,699,11,2,1,8236,8250,C
6-NA,700,8246,0,6,0,8252,A
6-NA,701,8227,2,2,0,8231,A
6-NA,702,1,8243,0,5,8249,T
6-NA,703,4,10,8243,0,8257,G
6-NA,704,3,14,8262,1,8280,G
6-NA,705,8429,0,9,0,8438,A
6-NA,706,8449,0,11,0,8460,A
6-NA,707,0,2,0,8569,8571,C
6-NA,708,1,8638,1,10,8650,T
6-NA,709,0,8634,0,4,8638,T
6-NA,710,0,3,8897,0,8900,G
6-NA,711,1,8881,0,9,8891,T
6-NA,712,8897,0,6,1,8904,A
6-NA,713,1,2,0,9034,9037,C
6-NA,714,8844,1,10,0,8855,A
6-NA,715,9,1,9492,0,9502,G
6-NA,716,0,9418,0,2,9420,T
6-NA,717,9792,0,6,0,9798,A
6-NA,718,7,1,9850,0,9858,G
6-NA,719,0,9666,0,8,9674,T
6-NA,720,9699,0,3,0,9702,A
6-NA,721,9670,1,5,1,9677,A
6-NA,722,1,9641,0,5,9647,T
6-NA,723,5,30,9672,0,9707,G
6-NA,724,9415,0,4,0,9419,A
6-NA,725,0,1,0,9587,9588,C
6-NA,726,0,9322,0,8,9330,T
6-NA,727,3,6,9368,0,9377,G
6-NA,728,9258,1,12,0,9271,A
6-NA,729,0,9377,0,5,9382,T
6-NA,730,3,14,9353,0,9370,G
6-NA,731,4,12,9273,4,9293,G
6-NA,732,4,19,9300,1,9324,G
6-NA,733,9128,0,14,0,9142,A
6-NA,734,3,0,9169,0,9172,G
6-NA,735,1,9151,0,3,9155,T
6-NA,736,6,2,9196,0,9204,G
6-NA,737,5,2,0,9745,9752,C
6-NA,738,0,9747,1,12,9760,T
6-NA,739,1,9762,1,11,9775,T
6-NA,740,6,0,0,9764,9770,C
6-NA,741,9744,2,10,0,9756,A
6-NA,742,5,9,9810,0,9824,G
6-NA,743,4,15,9780,0,9799,G
6-NA,744,9687,0,8,0,9695,A
6-NA,745,1,6,9230,0,9237,G
6-NA,746,9234,0,7,0,9241,A
6-NA,747,9316,1,6,0,9323,A
6-NA,748,1,0,9392,0,9393,G
6-NA,749,0,2,0,9383,9385,C
6-NA,750,0,9379,0,8,9387,T
6-NA,751,2,7,9385,0,9394,G
6-NA,752,9317,1,6,1,9325,A
6-NA,753,1,9484,0,1,9486,T
6-NA,754,9479,0,9,0,9488,A
6-NA,755,1,3,0,9914,9918,C
6-NA,756,1,9872,0,6,9879,T
6-NA,757,9872,0,2,0,9874,A
6-NA,758,9879,0,4,1,9884,A
6-NA,759,9887,0,3,0,9890,A
6-NA,760,10113,0,5,0,10118,A
6-NA,761,0,10144,0,4,10148,T
6-NA,762,10077,7,5,0,10089,A
6-NA,763,1,2,0,10173,10176,C
6-NA,764,1,9889,1,6,9897,T
6-NA,765,10004,1,4,0,10009,A
6-NA,766,0,9958,0,12,9970,T
6-NA,767,0,10377,0,4,10381,T
6-NA,768,28,2,0,10406,10436,C
6-NA,769,10281,0,1,1,10283,A
6-NA,770,0,10277,0,4,10281,T
6-NA,771,0,10256,0,7,10263,T
6-NA,772,1,5,10305,0,10311,G
6-NA,773,10187,1,6,0,10194,A
6-NA,774,5,8,10180,0,10193,G
6-NA,775,1,9,10181,1,10192,G
6-NA,776,9788,1,12,0,9801,A
6-NA,777,5,12,10009,1,10027,G
6-NA,778,2,16,9974,1,9993,G
6-NA,779,4,15,9990,0,10009,G
6-NA,780,8,21,10002,0,10031,G
6-NA,781,9952,1,12,1,9966,A
6-NA,782,10028,0,12,1,10041,A
6-NA,783,9976,1,12,1,9990,A
6-NA,784,9931,2,21,0,9954,A
6-NA,785,0,9916,0,3,9919,T
6-NA,786,15,6,0,9912,9933,C
6-NA,787,10,5,10001,0,10016,G
6-NA,788,0,9956,1,4,9961,T
6-NA,789,1,9933,2,11,9947,T
6-NA,790,25,1,0,9980,10006,C
6-NA,791,9987,0,6,0,9993,A
6-NA,792,0,10689,0,2,10691,T
6-NA,793,10662,0,3,0,10665,A
6-NA,794,0,5,0,10758,10763,C
6-NA,795,0,10725,0,14,10739,T
6-NA,796,10731,0,11,1,10743,A
6-NA,797,0,3,10702,0,10705,G
6-NA,798,2,7,0,10702,10711,C
6-NA,799,10681,1,10,0,10692,A
6-NA,800,2,4,0,10754,10760,C
6-NA,801,10346,0,2,0,10348,A
6-NA,802,1,10513,1,6,10521,T
6-NA,803,0,10472,0,5,10477,T
6-NA,804,6,1,11137,0,11144,G
6-NA,805,1,11071,0,15,11087,T
6-NA,806,22,3,0,11063,11088,C
6-NA,807,11083,2,18,1,11104,A
6-NA,808,6,7,11111,0,11124,G
6-NA,809,2,8,11105,0,11115,G
6-NA,810,11050,1,0,1,11052,A
6-NA,811,10898,0,14,1,10913,A
6-NA,812,4,1,11048,0,11053,G
6-NA,813,0,10436,2,4,10442,T
6-NA,814,7,5,10481,0,10493,G
6-NA,815,2,7,0,10461,10470,C
6-NA,816,0,10511,2,10,10523,T
6-NA,817,21,3,0,10555,10579,C
6-NA,818,10530,0,4,0,10534,A
6-NA,819,4,2,10576,0,10582,G
6-NA,820,5,3,1,10586,10595,C
6-NA,821,10565,0,13,0,10578,A
6-NA,822,0,10576,0,2,10578,T
6-NA,823,3,3,10934,0,10940,G
6-NA,824,1,10912,0,9,10922,T
6-NA,825,22,4,1,10921,10948,C
6-NA,826,3,8,10928,0,10939,G
6-NA,827,10829,0,9,0,10838,A
6-NA,828,3,10,10842,1,10856,G
6-NA,829,0,16,10832,0,10848,G
6-NA,830,10708,2,12,0,10722,A
6-NA,831,2,4,10888,0,10894,G
6-NA,832,0,10565,0,7,10572,T
6-NA,833,5,4,10622,0,10631,G
6-NA,834,5,2,0,10775,10782,C
6-NA,835,1,10733,0,17,10751,T
6-NA,836,26,4,1,10794,10825,C
6-NA,837,7,42,0,10816,10865,C
6-NA,838,3,10891,0,8,10902,T
6-NA,839,2,1,10931,0,10934,G
6-NA,840,4,1,1,10820,10826,C
6-NA,841,0,10791,1,9,10801,T
6-NA,842,10831,1,4,0,10836,A
6-NA,843,1,10592,0,11,10604,T
6-NA,844,17,3,0,10663,10683,C
6-NA,845,10,2,0,10659,10671,C
6-NA,846,0,10637,1,7,10645,T
6-NA,847,13,4,0,10729,10746,C
6-NA,848,6,8,10738,0,10752,G
6-NA,849,10781,2,5,1,10789,A
6-NA,850,0,10806,0,9,10815,T
6-NA,851,10817,0,3,0,10820,A
6-NA,852,0,10794,0,9,10803,T
6-NA,853,21,9,4,10729,10763,C
6-NA,854,13,2,0,10742,10757,C
6-NA,855,1,10693,1,8,10703,T
6-NA,856,8,8,10747,0,10763,G
6-NA,857,2,2,10756,0,10760,G
6-NA,858,2,10877,0,7,10886,T
6-NA,859,2,1,10926,0,10929,G
6-NA,860,0,10862,0,14,10876,T
6-NA,861,40,1,1,10844,10886,C
6-NA,862,10856,0,14,0,10870,A
6-NA,863,5,3,10885,0,10893,G
6-NA,864,10875,1,7,0,10883,A
6-NA,865,0,10746,0,6,10752,T
6-NA,866,3,4,10808,0,10815,G
6-NA,867,1,10656,0,8,10665,T
6-NA,868,3,1,10723,1,10728,G
6-NA,869,0,10680,0,10,10690,T
6-NA,870,21,5,0,10713,10739,C
6-NA,871,3,10689,1,25,10718,T
6-NA,872,5,1,10753,0,10759,G
6-NA,873,3,1,1,10740,10745,C
6-NA,874,10750,1,8,0,10759,A
6-NA,875,0,6,10750,0,10756,G
6-NA,876,10452,1,14,0,10467,A
6-NA,877,1,10,10476,1,10488,G
6-NA,878,10427,0,12,0,10439,A
6-NA,879,2,7,0,10525,10534,C
6-NA,880,10484,1,11,1,10497,A
6-NA,881,10527,3,9,0,10539,A
6-NA,882,2,1,0,10575,10578,C
6-NA,883,0,10579,0,3,10582,T
6-NA,884,3,6,10571,0,10580,G
6-NA,885,1,13,10521,0,10535,G
6-NA,886,10503,0,9,0,10512,A
6-NA,887,10496,1,10,0,10507,A
6-NA,888,10225,0,15,1,10241,A
6-NA,889,3,6,10378,0,10387,G
6-NA,890,0,4,10277,0,10281,G
6-NA,891,4,8,0,10271,10283,C
6-NA,892,1,10170,0,14,10185,T
6-NA,893,10,8,1,10401,10420,C
6-NA,894,13,3,0,10507,10523,C
6-NA,895,10588,0,2,0,10590,A
6-NA,896,10556,0,7,0,10563,A
6-NA,897,0,10608,0,1,10609,T
6-NA,898,10139,1,5,4,10149,A
6-NA,899,0,3,10118,0,10121,G
6-NA,900,5,6,10079,0,10090,G
6-NA,901,3,4,0,10063,10070,C
6-NA,902,8,2,0,9827,9837,C
6-NA,903,20,2,0,9696,9718,C
6-NA,904,9805,0,5,0,9810,A
6-NA,905,0,9874,0,13,9887,T
6-NA,906,12,3,2,9926,9943,C
6-NA,907,12,1,9971,0,9984,G
6-NA,908,1,9926,0,0,9927,T
6-NA,909,9655,1,9,0,9665,A
6-NA,910,4,6,9875,0,9885,G
6-NA,911,9863,0,17,0,9880,A
6-NA,912,1,9893,0,8,9902,T
6-NA,913,9633,0,1,0,9634,A
6-NA,914,0,9512,0,4,9516,T
6-NA,915,9499,1,4,0,9504,A
6-NA,916,9489,0,4,0,9493,A
6-NA,917,9625,1,11,0,9637,A
6-NA,918,2,1,0,9861,9864,C
6-NA,919,9568,1,2,0,9571,A
6-NA,920,0,9562,0,2,9564,T
6-NA,921,9469,0,2,0,9471,A
6-NA,922,9471,0,5,0,9476,A
6-NA,923,9443,0,13,2,9458,A
6-NA,924,0,7,9513,0,9520,G
6-NA,925,5,13,9588,0,9606,G
6-NA,926,9282,0,11,0,9293,A
6-NA,927,0,9232,1,6,9239,T
6-NA,928,9,4,0,9274,9287,C
6-NA,929,9342,0,8,1,9351,A
6-NA,930,1,9330,0,8,9339,T
6-NA,931,9350,1,7,0,9358,A
6-NA,932,5,1,9354,0,9360,G
6-NA,933,2,3,0,9229,9234,C
6-NA,934,9067,2,3,1,9073,A
6-NA,935,0,8765,0,7,8772,T
6-NA,936,0,8814,0,0,8814,T
6-NA,937,2,2,9076,0,9080,G
6-NA,938,0,9038,0,6,9044,T
6-NA,939,0,9177,1,12,9190,T
6-NA,940,1,9132,0,9,9142,T
6-NA,941,19,1,0,9127,9147,C
6-NA,942,7,6,0,9172,9185,C
6-NA,943,9301,0,6,0,9307,A
6-NA,944,1,1,9448,0,9450,G
6-NA,945,0,9400,0,12,9412,T
6-NA,946,0,9107,0,7,9114,T
6-NA,947,9134,0,4,0,9138,A
6-NA,948,0,9017,0,8,9025,T
6-NA,949,3,5,9050,0,9058,G
6-NA,950,1,8944,0,9,8954,T
6-NA,951,11,0,9026,0,9037,G
6-NA,952,0,8736,0,7,8743,T
6-NA,953,6,2,8968,1,8977,G
6-NA,954,0,8945,0,14,8959,T
6-NA,955,0,8905,2,7,8914,T
6-NA,956,27,2,0,8902,8931,C
6-NA,957,8862,1,8,1,8872,A
6-NA,958,0,6,8898,0,8904,G
6-NA,959,3,14,8847,0,8864,G
6-NA,960,8770,0,6,0,8776,A
6-NA,961,3,1,0,8833,8837,C
6-NA,962,0,8620,0,6,8626,T
6-NA,963,0,8654,0,1,8655,T
6-NA,964,1,4,8957,0,8962,G
6-NA,965,3,8924,0,9,8936,T
6-NA,966,0,8956,1,6,8963,T
6-NA,967,0,7,8880,2,8889,G
6-NA,968,5,14,8882,0,8901,G
6-NA,969,8820,0,24,1,8845,A
6-NA,970,1,9,8868,0,8878,G
6-NA,971,8808,0,14,0,8822,A
6-NA,972,4,2,0,8751,8757,C
6-NA,973,8352,0,13,0,8365,A
6-NA,974,1,1,0,8419,8421,C
6-NA,975,8386,1,5,2,8394,A
6-NA,976,3,2,0,8435,8440,C
6-NA,977,13,3,0,8334,8350,C
6-NA,978,9,22,1,8366,8398,C
6-NA,979,8386,0,5,0,8391,A
6-NA,980,1,12,8413,0,8426,G
6-NA,981,8403,1,8,1,8413,A
6-NA,982,8473,0,2,2,8477,A
6-NA,983,8413,0,1,0,8414,A
6-NA,984,8389,0,4,0,8393,A
6-NA,985,8328,0,10,0,8338,A
6-NA,986,8311,0,3,0,8314,A
6-NA,987,2,8,0,8337,8347,C
6-NA,988,0,26,8294,0,8320,G
6-NA,989,8274,0,5,1,8280,A
6-NA,990,3,4,0,8278,8285,C
6-NA,991,8241,0,8,0,8249,A
6-NA,992,5,0,8333,0,8338,G
6-NA,993,2,0,1,8601,8604,C
6-NA,994,1,8490,0,14,8505,T
6-NA,995,24,0,0,8564,8588,C
6-NA,996,4,6,0,8610,8620,C
6-NA,997,8648,0,13,0,8661,A
6-NA,998,6,1,8738,0,8745,G
6-NA,999,2,3,0,8739,8744,C
6-NA,1000,8689,1,4,0,8694,A
6-NA,1001,2,2,8699,0,8703,G
6-NA,1002,0,8217,0,1,8218,T
6-NA,1003,8216,0,8,0,8224,A
6-NA,1004,2,3,8247,1,8253,G
6-NA,1005,2,3,0,8205,8210,C
6-NA,1006,5,3,0,8253,8261,C
6-NA,1007,8142,1,3,1,8147,A
6-NA,1008,1,8142,0,2,8145,T
6-NA,1009,0,8172,0,3,8175,T
6-NA,1010,1,2,8366,0,8369,G
6-NA,1011,1,8285,1,12,8299,T
6-NA,1012,0,8286,0,6,8292,T
6-NA,1013,1,8273,0,10,8284,T
6-NA,1014,4,13,8162,0,8179,G
6-NA,1015,5,7,8244,0,8256,G
6-NA,1016,8206,2,2,0,8210,A
6-NA,1017,0,8236,0,9,8245,T
6-NA,1018,11,2,1,8246,8260,C
6-NA,1019,13,0,0,8080,8093,C
6-NA,1020,2,8124,0,10,8136,T
6-NA,1021,8142,0,4,0,8146,A
6-NA,1022,8152,0,11,0,8163,A
6-NA,1023,1,6,0,8289,8296,C
6-NA,1024,8085,0,0,0,8085,A
6-NA,1025,8177,0,1,0,8178,A
6-NA,1026,0,8161,0,7,8168,T
6-NA,1027,2,7,8244,0,8253,G
6-NA,1028,8206,0,14,0,8220,A
6-NA,1029,8124,0,24,1,8149,A
6-NA,1030,4,6,8210,0,8220,G
6-NA,1031,8143,0,9,1,8153,A
6-NA,1032,7947,2,17,1,7967,A
6-NA,1033,6,7,7989,1,8003,G
6-NA,1034,0,2,7987,0,7989,G
6-NA,1035,0,7763,0,3,7766,T
6-NA,1036,4,11,7795,0,7810,G
6-NA,1037,8,2,8016,0,8026,G
6-NA,1038,0,7939,0,13,7952,T
6-NA,1039,22,0,3,7929,7954,C
6-NA,1040,7947,2,4,0,7953,A
6-NA,1041,0,7941,1,7,7949,T
6-NA,1042,2,7,7948,1,7958,G
6-NA,1043,3,9,8014,0,8026,G
6-NA,1044,7913,2,11,0,7926,A
6-NA,1045,3,0,8208,0,8211,G
6-NA,1046,0,7806,0,9,7815,T
6-NA,1047,0,5,7818,0,7823,G
6-NA,1048,7802,0,6,0,7808,A
6-NA,1049,7798,0,4,0,7802,A
6-NA,1050,7809,0,24,1,7834,A
6-NA,1051,0,13,7826,0,7839,G
6-NA,1052,1,0,7758,0,7759,G
6-NA,1053,0,0,0,7731,7731,C
6-NA,1054,0,7462,2,6,7470,T
6-NA,1055,0,5,7476,0,7481,G
6-NA,1056,0,7,7443,1,7451,G
6-NA,1057,3,0,7516,0,7519,G
6-NA,1058,3,1,0,7493,7497,C
6-NA,1059,8,2,0,7528,7538,C
6-NA,1060,0,7436,1,15,7452,T
6-NA,1061,0,7457,0,5,7462,T
6-NA,1062,0,7514,1,2,7517,T
6-NA,1063,0,4,7521,0,7525,G
6-NA,1064,7486,0,10,0,7496,A
6-NA,1065,0,7444,0,3,7447,T
6-NA,1066,3,6,7318,0,7327,G
6-NA,1067,7225,0,4,0,7229,A
6-NA,1068,1,7236,1,3,7241,T
6-NA,1069,1,11,7269,0,7281,G
6-NA,1070,1,8,7377,1,7387,G
6-NA,1071,7345,0,5,0,7350,A
6-NA,1072,7336,0,2,0,7338,A
6-NA,1073,7344,0,1,1,7346,A
6-NA,1074,0,7326,0,3,7329,T
6-NA,1075,1,16,7355,0,7372,G
6-NA,1076,7331,1,6,0,7338,A
6-NA,1077,3,1,1,7297,7302,C
6-NA,1078,2,7,7343,0,7352,G
6-NA,1079,3,7153,1,9,7166,T
6-NA,1080,4,1,7234,0,7239,G
6-NA,1081,0,7215,1,6,7222,T
6-NA,1082,4,5,7223,1,7233,G
6-NA,1083,0,1,7291,0,7292,G
6-NA,1084,7201,0,5,0,7206,A
6-NA,1085,0,7198,0,6,7204,T
6-NA,1086,4,7,7194,0,7205,G
6-NA,1087,5,6,7166,0,7177,G
6-NA,1088,0,3,7213,0,7216,G
6-NA,1089,7126,0,8,0,7134,A
6-NA,1090,7096,0,13,0,7109,A
6-NA,1091,5,13,7113,0,7131,G
6-NA,1092,6982,2,8,0,6992,A
6-NA,1093,6982,0,5,0,6987,A
6-NA,1094,4,2,1,6959,6966,C
6-NA,1095,3,10,6909,1,6923,G
6-NA,1096,6889,0,4,0,6893,A
6-NA,1097,0,6715,1,3,6719,T
6-NA,1098,16,1,0,6756,6773,C
6-NA,1099,6761,1,7,0,6769,A
6-NA,1100,0,0,6781,1,6782,G
6-NA,1101,3,4,0,6754,6761,C
6-NA,1102,4,8,6775,0,6787,G
6-NA,1103,6749,0,8,0,6757,A
6-NA,1104,2,3,6761,0,6766,G
6-NA,1105,6766,0,3,0,6769,A
6-NA,1106,6751,0,4,0,6755,A
6-NA,1107,2,1,6812,0,6815,G
6-NA,1108,0,6700,0,8,6708,T
6-NA,1109,24,2,0,6671,6697,C
6-NA,1110,6644,0,2,0,6646,A
6-NA,1111,1,2,0,6874,6877,C
6-NA,1112,1,2,6892,1,6896,G
6-NA,1113,0,1,1,6880,6882,C
6-NA,1114,0,6856,0,9,6865,T
6-NA,1115,0,6868,0,2,6870,T
6-NA,1116,6763,0,10,0,6773,A
6-NA,1117,1,10,6935,1,6947,G
6-NA,1118,1,10,6931,0,6942,G
6-NA,1119,0,3,7052,0,7055,G
6-NA,1120,1,6575,0,5,6581,T
6-NA,1121,6597,1,6,0,6604,A
6-NA,1122,1,6548,1,4,6554,T
6-NA,1123,3,11,6548,0,6562,G
6-NA,1124,6559,0,6,0,6565,A
6-NA,1125,6508,0,6,0,6514,A
6-NA,1126,6106,0,16,0,6122,A
6-NA,1127,1,1,1,6154,6157,C
6-NA,1128,10,2,0,5993,6005,C
6-NA,1129,1,5841,0,6,5848,T
6-NA,1130,0,5838,0,8,5846,T
6-NA,1131,0,1,0,5843,5844,C
6-NA,1132,5852,0,3,0,5855,A
6-NA,1133,5865,0,1,0,5866,A
6-NA,1134,5845,2,9,1,5857,A
6-NA,1135,2,1,5879,0,5882,G
6-NA,1136,3,5727,0,2,5732,T
6-NA,1137,24,3,0,5770,5797,C
6-NA,1138,5921,2,4,1,5928,A
6-NA,1139,0,5924,0,2,5926,T
6-NA,1140,0,5927,0,5,5932,T
6-NA,1141,1,1,5936,0,5938,G
6-NA,1142,5909,0,5,0,5914,A
6-NA,1143,5930,1,10,1,5942,A
6-NA,1144,3,2,5938,0,5943,G
6-NA,1145,2,0,5878,0,5880,G
6-NA,1146,1,1,0,5888,5890,C
6-NA,1147,0,5664,0,5,5669,T
6-NA,1148,2,5,5703,1,5711,G
6-NA,1149,1,2,5835,0,5838,G
6-NA,1150,1,5810,0,6,5817,T
6-NA,1151,12,0,0,5793,5805,C
6-NA,1152,8,3,0,5763,5774,C
6-NA,1153,5759,0,5,0,5764,A
6-NA,1154,5785,0,1,0,5786,A
6-NA,1155,2,1,0,5851,5854,C
6-NA,1156,5,3,0,5810,5818,C
6-NA,1157,10,0,0,5790,5800,C
6-NA,1158,0,5510,0,4,5514,T
6-NA,1159,5499,0,1,0,5500,A
6-NA,1160,5511,0,5,0,5516,A
6-NA,1161,0,3,5558,0,5561,G
6-NA,1162,1,5458,0,6,5465,T
6-NA,1163,10,0,0,5476,5486,C
6-NA,1164,6,4,0,5346,5356,C
6-NA,1165,5353,1,1,0,5355,A
6-NA,1166,5340,0,1,0,5341,A
6-NA,1167,5359,0,2,0,5361,A
6-NA,1168,0,5332,0,0,5332,T
6-NA,1169,0,5337,0,0,5337,T
6-NA,1170,1,2,5332,0,5335,G
6-NA,1171,1,1,0,5282,5284,C
6-NA,1172,5283,0,8,0,5291,A
6-NA,1173,1,14,5299,1,5315,G
6-NA,1174,5309,0,4,0,5313,A
6-NA,1175,0,5410,0,0,5410,T
6-NA,1176,5410,0,4,0,5414,A
6-NA,1177,5381,0,3,0,5384,A
6-NA,1178,5380,0,6,0,5386,A
6-NA,1179,0,5347,0,0,5347,T
6-NA,1180,5316,0,1,0,5317,A
6-NA,1181,0,1,5299,0,5300,G
6-NA,1182,1,0,5254,0,5255,G
6-NA,1183,2,2,0,5231,5235,C
6-NA,1184,5011,0,0,0,5011,A
6-NA,1185,5024,1,6,0,5031,A
6-NA,1186,2,1,5073,0,5076,G
6-NA,1187,1,5052,0,5,5058,T
6-NA,1188,14,2,0,5046,5062,C
6-NA,1189,5082,0,4,0,5086,A
6-NA,1190,0,5049,0,4,5053,T
6-NA,1191,5063,0,2,0,5065,A
6-NA,1192,0,1,5083,0,5084,G
6-NA,1193,0,5069,0,1,5070,T
6-NA,1194,0,4838,0,5,4843,T
6-NA,1195,0,9,4749,1,4759,G
6-NA,1196,4700,0,13,0,4713,A
6-NA,1197,1,0,0,4725,4726,C
6-NA,1198,4616,1,3,0,4620,A
6-NA,1199,0,0,4685,0,4685,G
6-NA,1200,4588,0,11,0,4599,A
6-NA,1201,6,1,4732,0,4739,G
6-NA,1202,4,1,4747,0,4752,G
6-NA,1203,1,4684,0,5,4690,T
6-NA,1204,4690,2,3,0,4695,A
6-NA,1205,4677,0,12,0,4689,A
6-NA,1206,0,4683,0,2,4685,T
6-NA,1207,4633,1,4,0,4638,A
6-NA,1208,0,4,4457,0,4461,G
6-NA,1209,1,1,4292,0,4294,G
6-NA,1210,0,3713,0,4,3717,T
6-NA,1211,9,1,1,3670,3681,C
6-NA,1212,5,2,3,3633,3643,C
6-NA,1213,4,4,3646,1,3655,G
6-NA,1214,0,0,3654,0,3654,G
6-NA,1215,0,3658,0,5,3663,T
6-NA,1216,0,3649,0,0,3649,T
6-NA,1217,3570,0,1,0,3571,A
6-NA,1218,0,3469,0,0,3469,T
6-NA,1219,0,3465,0,1,3466,T
6-NA,1220,5,1,1,3448,3455,C
6-NA,1221,1,3241,0,2,3244,T
6-NA,1222,4,1,3234,1,3240,G
6-NA,1223,3,1,3234,0,3238,G
6-NA,1224,0,3221,0,1,3222,T
6-NA,1225,3223,0,0,2,3225,A
6-NA,1226,0,3154,0,5,3159,T
6-NA,1227,0,3159,0,6,3165,T
6-NA,1228,0,3161,1,4,3166,T
6-NA,1229,1,3172,1,2,3176,T
6-NA,1230,3,0,0,3187,3190,C
6-NA,1231,0,3096,0,1,3097,T
6-NA,1232,4,0,0,3129,3133,C
6-NA,1233,0,3123,0,1,3124,T
6-NA,1234,2,1,3201,0,3204,G
6-NA,1235,1,3199,0,2,3202,T
6-NA,1236,0,3181,0,0,3181,T
6-NA,1237,1,2,3183,0,3186,G
6-NA,1238,3143,0,2,0,3145,A
6-NA,1239,3132,0,9,0,3141,A
6-NA,1240,1,2,3169,0,3172,G
6-NA,1241,2,0,3147,0,3149,G
6-NA,1242,2,0,0,3152,3154,C
6-NA,1243,3097,0,3,0,3100,A
6-NA,1244,3088,0,4,0,3092,A
6-NA,1245,3108,0,6,0,3114,A
6-NA,1246,3116,0,8,1,3125,A
6-NA,1247,1,1,3103,0,3105,G
6-NA,1248,3,0,0,3100,3103,C
6-NA,1249,0,3053,0,1,3054,T
6-NA,1250,0,0,3089,0,3089,G
6-NA,1251,0,2,0,3083,3085,C
6-NA,1252,3095,0,1,0,3096,A
6-NA,1253,0,3070,0,7,3077,T
6-NA,1254,4,1,0,3062,3067,C
6-NA,1255,3063,0,1,0,3064,A
6-NA,1256,3059,1,0,0,3060,A
6-NA,1257,0,3034,0,0,3034,T
6-NA,1258,2,6,0,3060,3068,C
6-NA,1259,3,1,3010,0,3014,G
6-NA,1260,0,0,3083,0,3083,G
6-NA,1261,0,3074,0,3,3077,T
6-NA,1262,1,0,3090,0,3091,G
6-NA,1263,3,0,0,3098,3101,C
6-NA,1264,0,3093,0,8,3101,T
6-NA,1265,0,3144,0,1,3145,T
6-NA,1266,0,3144,0,3,3147,T
6-NA,1267,1,3158,0,0,3159,T
6-NA,1268,3182,0,0,1,3183,A
6-NA,1269,0,3056,0,2,3058,T
6-NA,1270,1,0,3064,0,3065,G
6-NA,1271,0,3013,0,4,3017,T
6-NA,1272,3,2,2995,0,3000,G
6-NA,1273,0,6,3052,0,3058,G
6-NA,1274,3003,0,2,0,3005,A
6-NA,1275,3,0,3056,0,3059,G
6-NA,1276,0,3039,0,3,3042,T
6-NA,1277,0,3019,0,2,3021,T
6-NA,1278,0,4,3048,0,3052,G
6-NA,1279,3037,0,1,0,3038,A
6-NA,1280,1,3040,0,1,3042,T
6-NA,1281,3022,0,2,0,3024,A
6-NA,1282,2903,0,3,1,2907,A
6-NA,1283,0,4,2937,1,2942,G
6-NA,1284,2,7,2873,0,2882,G
6-NA,1285,0,4,2859,0,2863,G
6-NA,1286,1,1,2866,0,2868,G
6-NA,1287,2813,0,1,0,2814,A
6-NA,1288,2803,0,4,0,2807,A
6-NA,1289,0,0,2843,0,2843,G
6-NA,1290,2837,0,1,0,2838,A
6-NA,1291,2837,0,6,0,2843,A
6-NA,1292,2798,0,2,0,2800,A
6-NA,1293,2741,0,8,0,2749,A
6-NA,1294,1,2,2756,0,2759,G
6-NA,1295,2726,0,2,0,2728,A
6-NA,1296,2,1,2730,0,2733,G
6-NA,1297,2,1,2733,0,2736,G
6-NA,1298,2706,0,2,0,2708,A
6-NA,1299,2710,0,1,0,2711,A
6-NA,1300,2703,0,0,0,2703,A
6-NA,1301,0,0,0,2726,2726,C
6-NA,1302,0,2709,0,1,2710,T
6-NA,1303,2,2,2727,0,2731,G
6-NA,1304,2725,0,6,0,2731,A
6-NA,1305,2712,1,7,0,2720,A
6-NA,1306,2,0,2751,0,2753,G
6-NA,1307,0,2699,0,3,2702,T
6-NA,1308,9,2,1,2720,2732,C
6-NA,1309,0,2721,0,3,2724,T
6-NA,1310,0,2690,0,1,2691,T
6-NA,1311,1,0,2688,0,2689,G
6-NA,1312,0,2681,0,4,2685,T
6-NA,1313,0,6,2673,0,2679,G
6-NA,1314,0,4,2658,0,2662,G
6-NA,1315,2628,1,3,0,2632,A
6-NA,1316,2,0,0,2656,2658,C
6-NA,1317,0,0,0,2582,2582,C
6-NA,1318,0,2608,1,2,2611,T
6-NA,1319,2,0,0,2611,2613,C
6-NA,1320,2636,0,2,0,2638,A
6-NA,1321,2633,0,0,0,2633,A
6-NA,1322,2637,0,3,0,2640,A
6-NA,1323,1,3,0,2663,2667,C
6-NA,1324,2590,0,2,0,2592,A
6-NA,1325,1,0,2646,0,2647,G
6-NA,1326,0,2607,1,1,2609,T
6-NA,1327,2602,0,1,0,2603,A
6-NA,1328,0,2589,0,3,2592,T
6-NA,1329,0,2544,0,0,2544,T
6-NA,1330,2,0,2581,0,2583,G
6-NA,1331,0,2571,0,1,2572,T
6-NA,1332,0,2473,0,2,2475,T
6-NA,1333,1,1,2489,0,2491,G
6-NA,1334,0,2315,0,1,2316,T
6-NA,1335,4,0,2342,0,2346,G
6-NA,1336,0,2320,0,4,2324,T
6-NA,1337,1,2281,0,2,2284,T
6-NA,1338,0,2284,0,1,2285,T
6-NA,1339,0,2231,0,1,2232,T
6-NA,1340,1,0,2244,0,2245,G
6-NA,1341,0,2231,3,2,2236,T
6-NA,1342,2,2,2211,0,2215,G
6-NA,1343,0,1,2201,0,2202,G
6-NA,1344,1,1,0,2176,2178,C
6-NA,1345,2165,0,1,0,2166,A
6-NA,1346,1,0,0,2203,2204,C
6-NA,1347,0,0,0,2210,2210,C
6-NA,1348,1,2211,0,4,2216,T
6-NA,1349,3,1,0,2222,2226,C
6-NA,1350,2229,1,0,1,2231,A
6-NA,1351,1,1,2250,0,2252,G
6-NA,1352,0,0,2259,0,2259,G
6-NA,1353,1,2231,0,0,2232,T
6-NA,1354,2220,0,2,0,2222,A
6-NA,1355,0,1,0,2109,2110,C
6-NA,1356,2087,0,3,0,2090,A
6-NA,1357,1,2091,0,1,2093,T
6-NA,1358,2015,1,1,0,2017,A
6-NA,1359,0,2009,1,1,2011,T
6-NA,1360,0,2,1879,0,1881,G
6-NA,1361,0,2,1885,0,1887,G
6-NA,1362,1872,0,0,0,1872,A
6-NA,1363,1853,0,1,0,1854,A
6-NA,1364,0,0,0,1820,1820,C
6-NA,1365,1560,0,1,0,1561,A
6-NA,1366,0,2,1566,0,1568,G
6-NA,1367,1,1,1548,0,1550,G
6-NA,1368,0,0,0,1554,1554,C
6-NA,1369,0,1554,0,0,1554,T
6-NA,1370,4,1,0,1473,1478,C
6-NA,1371,1462,0,1,0,1463,A
6-NA,1372,0,1459,0,0,1459,T
6-NA,1373,0,4,1461,0,1465,G
6-NA,1374,0,0,1458,0,1458,G
6-NA,1375,1,0,0,1395,1396,C
6-NA,1376,0,0,0,1391,1391,C
6-NA,1377,0,1316,0,0,1316,T
6-NA,1378,1,2,1315,0,1318,G
6-NA,1379,1316,0,2,0,1318,A
6-NA,1380,0,1307,0,1,1308,T
6-NA,1381,0,1,1290,0,1291,G
6-NA,1382,0,1,1261,0,1262,G
6-NA,1383,0,0,1185,0,1185,G
6-NA,1384,0,0,1185,0,1185,G
6-NA,1385,0,2,0,1151,1153,C
6-NA,1386,1,2,1156,0,1159,G
6-NA,1387,0,2,1137,0,1139,G
6-NA,1388,1115,0,3,0,1118,A
6-NA,1389,1,2,0,1106,1109,C
6-NA,1390,1105,0,0,0,1105,A
6-NA,1391,0,1087,0,2,1089,T
6-NA,1392,3,0,0,1060,1063,C
6-NA,1393,1064,0,1,0,1065,A
6-NA,1394,1056,0,0,0,1056,A
6-NA,1395,1,1050,0,1,1052,T
6-NA,1396,0,0,0,1025,1025,C
6-NA,1397,0,999,0,1,1000,T
6-NA,1398,1,0,0,873,874,C
6-NA,1399,878,0,0,0,878,A
6-NA,1400,0,871,0,1,872,T
6-NA,1401,0,1,868,0,869,G
6-NA,1402,0,0,0,853,853,C
6-NA,1403,3,3,0,806,812,C
6-NA,1404,0,729,2,1,732,T
6-NA,1405,728,0,0,0,728,A
6-NA,1406,0,720,3,0,723,T
6-NA,1407,714,0,0,0,714,A
6-NA,1408,0,713,0,0,713,T
6-NA,1409,627,0,0,0,627,A
6-NA,1410,593,0,0,0,593,A
7-M,1,324,0,0,0,324,A
7-M,2,0,327,0,0,327,T
7-M,3,0,0,330,0,330,G
7-M,4,332,0,0,0,332,A
7-M,5,0,0,361,0,361,G
7-M,6,0,0,0,382,382,C
7-M,7,0,0,0,396,396,C
7-M,8,0,543,0,3,546,T
7-M,9,0,549,0,2,551,T
7-M,10,1,0,0,552,553,C
7-M,11,0,553,0,0,553,T
7-M,12,561,0,0,0,561,A
7-M,13,570,0,0,0,570,A
7-M,14,0,0,0,567,567,C
7-M,15,0,0,0,565,565,C
7-M,16,0,1,567,0,568,G
7-M,17,570,0,0,0,570,A
7-M,18,0,0,583,0,583,G
7-M,19,0,0,586,0,586,G
7-M,20,0,585,0,0,585,T
7-M,21,1,0,0,600,601,C
7-M,22,2,0,593,0,595,G
7-M,23,612,0,1,0,613,A
7-M,24,626,0,0,0,626,A
7-M,25,630,0,0,0,630,A
7-M,26,0,0,0,689,689,C
7-M,27,0,1,699,0,700,G
7-M,28,0,699,0,0,699,T
7-M,29,712,0,1,0,713,A
7-M,30,0,716,0,0,716,T
7-M,31,0,1,729,0,730,G
7-M,32,0,730,0,0,730,T
7-M,33,0,817,1,1,819,T
7-M,34,3,1,0,847,851,C
7-M,35,0,845,0,1,846,T
7-M,36,3,0,0,887,890,C
7-M,37,0,886,0,1,887,T
7-M,38,3,0,0,936,939,C
7-M,39,0,945,0,0,945,T
7-M,40,952,0,0,0,952,A
7-M,41,0,956,0,0,956,T
7-M,42,0,0,0,962,962,C
7-M,43,2,0,970,0,972,G
7-M,44,0,973,0,2,975,T
7-M,45,0,967,0,1,968,T
7-M,46,4,0,0,996,1000,C
7-M,47,1,0,0,1029,1030,C
7-M,48,1039,0,0,0,1039,A
7-M,49,0,1033,0,2,1035,T
7-M,50,1,1,0,1041,1043,C
7-M,51,1034,0,3,0,1037,A
7-M,52,0,1,1041,0,1042,G
7-M,53,0,0,1028,0,1028,G
7-M,54,0,1,0,1045,1046,C
7-M,55,0,0,0,1051,1051,C
7-M,56,0,1,0,1059,1060,C
7-M,57,0,0,0,1096,1096,C
7-M,58,1,0,0,1109,1110,C
7-M,59,0,1100,0,2,1102,T
7-M,60,1,0,0,1120,1121,C
7-M,61,1116,0,0,0,1116,A
7-M,62,1116,0,2,0,1118,A
7-M,63,1135,0,1,0,1136,A
7-M,64,0,0,1151,0,1151,G
7-M,65,0,1,0,1154,1155,C
7-M,66,0,0,0,1147,1147,C
7-M,67,1,0,1142,2,1145,G
7-M,68,1135,0,0,0,1135,A
7-M,69,0,1,1149,0,1150,G
7-M,70,1151,0,1,0,1152,A
7-M,71,0,1161,0,0,1161,T
7-M,72,4,0,0,1148,1152,C
7-M,73,0,1,1159,0,1160,G
7-M,74,1,0,0,1164,1165,C
7-M,75,1,0,1157,0,1158,G
7-M,76,0,0,0,1166,1166,C
7-M,77,1159,0,2,1,1162,A
7-M,78,1,1,1174,0,1176,G
7-M,79,1159,0,0,0,1159,A
7-M,80,0,6,1252,0,1258,G
7-M,81,1245,0,2,0,1247,A
7-M,82,0,0,0,1292,1292,C
7-M,83,0,1291,0,1,1292,T
7-M,84,0,1289,0,0,1289,T
7-M,85,0,2,1292,0,1294,G
7-M,86,1295,0,0,0,1295,A
7-M,87,1298,0,2,0,1300,A
7-M,88,1,1,1304,0,1306,G
7-M,89,1321,0,0,0,1321,A
7-M,90,0,1360,0,0,1360,T
7-M,91,2,1,1369,0,1372,G
7-M,92,0,1376,0,1,1377,T
7-M,93,109,1,0,1265,1375,C
7-M,94,0,1373,0,1,1374,T
7-M,95,0,1372,0,0,1372,T
7-M,96,0,1380,0,0,1380,T
7-M,97,0,0,1373,0,1373,G
7-M,98,1,1,0,1365,1367,C
7-M,99,0,1354,1,1,1356,T
7-M,100,0,5,1352,0,1357,G
7-M,101,0,3,1345,0,1348,G
7-M,102,0,3,1377,0,1380,G
7-M,103,1364,0,0,0,1364,A
7-M,104,1381,0,0,0,1381,A
7-M,105,1380,0,1,0,1381,A
7-M,106,1385,0,0,0,1385,A
7-M,107,1396,0,2,0,1398,A
7-M,108,0,3,0,1408,1411,C
7-M,109,1404,0,4,0,1408,A
7-M,110,1,0,0,1410,1411,C
7-M,111,1399,0,2,0,1401,A
7-M,112,0,0,1439,0,1439,G
7-M,113,1450,0,1,0,1451,A
7-M,114,1,1467,0,0,1468,T
7-M,115,0,1,0,1486,1487,C
7-M,116,0,1479,0,0,1479,T
7-M,117,0,1478,0,1,1479,T
7-M,118,0,1,1473,0,1474,G
7-M,119,1468,0,3,0,1471,A
7-M,120,0,2,1468,0,1470,G
7-M,121,1,0,1460,0,1461,G
7-M,122,1,0,0,1473,1474,C
7-M,123,0,1458,0,5,1463,T
7-M,124,1,0,0,1628,1629,C
7-M,125,0,1622,0,0,1622,T
7-M,126,2,0,0,1636,1638,C
7-M,127,1634,0,2,0,1636,A
7-M,128,0,1648,0,1,1649,T
7-M,129,4,2,1646,0,1652,G
7-M,130,1,5,1638,0,1644,G
7-M,131,1620,0,0,0,1620,A
7-M,132,1618,0,1,0,1619,A
7-M,133,0,1541,0,0,1541,T
7-M,134,0,1,1594,0,1595,G
7-M,135,1,0,1656,0,1657,G
7-M,136,1,0,0,1669,1670,C
7-M,137,0,1677,0,1,1678,T
7-M,138,1682,0,0,0,1682,A
7-M,139,1667,0,0,0,1667,A
7-M,140,1688,0,4,1,1693,A
7-M,141,0,3,1703,0,1706,G
7-M,142,1688,0,1,0,1689,A
7-M,143,1,0,0,1691,1692,C
7-M,144,1638,0,1,0,1639,A
7-M,145,1644,0,0,0,1644,A
7-M,146,0,5,1676,0,1681,G
7-M,147,1673,0,1,0,1674,A
7-M,148,0,0,0,1694,1694,C
7-M,149,1,2,0,1682,1685,C
7-M,150,1675,0,2,0,1677,A
7-M,151,1710,0,1,0,1711,A
7-M,152,0,1712,0,1,1713,T
7-M,153,0,1720,0,1,1721,T
7-M,154,1,1,0,1731,1733,C
7-M,155,0,1698,0,0,1698,T
7-M,156,0,0,1712,0,1712,G
7-M,157,0,1708,0,1,1709,T
7-M,158,5,0,0,1702,1707,C
7-M,159,1703,0,1,0,1704,A
7-M,160,1,1,0,1768,1770,C
7-M,161,1,2,0,1763,1766,C
7-M,162,0,1759,0,0,1759,T
7-M,163,1,0,0,1762,1763,C
7-M,164,0,1761,0,2,1763,T
7-M,165,0,4,1829,0,1833,G
7-M,166,1817,1,2,0,1820,A
7-M,167,0,0,0,1833,1833,C
7-M,168,0,1829,0,1,1830,T
7-M,169,1788,0,1,0,1789,A
7-M,170,1778,0,3,1,1782,A
7-M,171,2,2,1786,0,1790,G
7-M,172,0,4,1776,0,1780,G
7-M,173,1,2,1781,0,1784,G
7-M,174,0,4,1785,0,1789,G
7-M,175,1801,0,2,0,1803,A
7-M,176,0,1816,0,0,1816,T
7-M,177,0,1813,0,0,1813,T
7-M,178,0,1819,0,0,1819,T
7-M,179,0,1826,0,0,1826,T
7-M,180,0,4,1818,0,1822,G
7-M,181,1,3,1815,0,1819,G
7-M,182,0,1,1821,0,1822,G
7-M,183,1,1,1825,0,1827,G
7-M,184,0,1771,6,1,1778,T
7-M,185,0,1798,0,0,1798,T
7-M,186,0,1802,0,0,1802,T
7-M,187,0,0,1853,0,1853,G
7-M,188,1,1846,0,0,1847,T
7-M,189,0,2,1883,0,1885,G
7-M,190,0,1886,0,2,1888,T
7-M,191,1,1879,0,2,1882,T
7-M,192,6,0,0,1922,1928,C
7-M,193,1932,0,1,0,1933,A
7-M,194,2,1,0,1985,1988,C
7-M,195,1,2,1966,0,1969,G
7-M,196,2,1,0,1965,1968,C
7-M,197,0,1943,0,1,1944,T
7-M,198,8,0,0,1995,2003,C
7-M,199,2014,0,1,0,2015,A
7-M,200,2,0,0,2036,2038,C
7-M,201,3,3,0,2016,2022,C
7-M,202,2,0,2027,0,2029,G
7-M,203,0,2011,3,2,2016,T
7-M,204,0,1,2023,0,2024,G
7-M,205,1,1,0,2015,2017,C
7-M,206,5,0,0,2012,2017,C
7-M,207,2,1,0,2018,2021,C
7-M,208,2001,0,3,0,2004,A
7-M,209,0,0,2024,0,2024,G
7-M,210,0,2003,0,1,2004,T
7-M,211,0,10,2020,0,2030,G
7-M,212,2043,0,1,0,2044,A
7-M,213,0,0,2039,0,2039,G
7-M,214,1,0,0,2044,2045,C
7-M,215,0,2,2053,0,2055,G
7-M,216,2036,0,1,0,2037,A
7-M,217,2,3,2055,1,2061,G
7-M,218,0,5,2058,0,2063,G
7-M,219,2046,0,0,0,2046,A
7-M,220,0,0,0,2090,2090,C
7-M,221,0,2052,0,1,2053,T
7-M,222,0,0,2065,0,2065,G
7-M,223,2,2,0,2050,2054,C
7-M,224,2053,0,3,0,2056,A
7-M,225,0,0,2106,0,2106,G
7-M,226,0,1,0,2095,2096,C
7-M,227,0,0,2126,0,2126,G
7-M,228,0,2126,0,0,2126,T
7-M,229,2095,0,0,0,2095,A
7-M,230,0,2,2089,0,2091,G
7-M,231,2088,0,1,0,2089,A
7-M,232,0,1,0,2094,2095,C
7-M,233,0,0,2094,0,2094,G
7-M,234,0,0,0,2082,2082,C
7-M,235,0,2053,0,0,2053,T
7-M,236,0,2054,0,2,2056,T
7-M,237,0,2048,0,1,2049,T
7-M,238,0,0,2099,0,2099,G
7-M,239,0,2100,0,0,2100,T
7-M,240,4,1,0,2094,2099,C
7-M,241,2,1,0,2097,2100,C
7-M,242,2102,0,1,0,2103,A
7-M,243,2102,0,1,0,2103,A
7-M,244,2099,0,3,0,2102,A
7-M,245,2105,0,0,0,2105,A
7-M,246,0,2104,0,0,2104,T
7-M,247,0,0,2080,0,2080,G
7-M,248,0,2,0,2066,2068,C
7-M,249,3,0,1,2060,2064,C
7-M,250,2,0,0,2092,2094,C
7-M,251,0,2097,0,0,2097,T
7-M,252,0,0,0,2198,2198,C
7-M,253,2206,0,0,0,2206,A
7-M,254,2219,0,1,0,2220,A
7-M,255,0,2241,0,2,2243,T
7-M,256,1,2,2241,0,2244,G
7-M,257,0,3,2259,0,2262,G
7-M,258,0,4,2276,0,2280,G
7-M,259,2269,0,0,0,2269,A
7-M,260,2263,0,2,0,2265,A
7-M,261,0,2205,0,0,2205,T
7-M,262,0,2,2203,0,2205,G
7-M,263,0,2,2205,0,2207,G
7-M,264,2187,0,3,0,2190,A
7-M,265,0,4,2172,1,2177,G
7-M,266,2151,0,2,0,2153,A
7-M,267,0,16,0,2099,2115,C
7-M,268,2,1,0,2209,2212,C
7-M,269,1,0,1,2220,2222,C
7-M,270,2245,0,2,0,2247,A
7-M,271,2266,0,0,0,2266,A
7-M,272,2257,0,1,0,2258,A
7-M,273,0,2281,0,0,2281,T
7-M,274,2330,0,1,1,2332,A
7-M,275,2327,0,2,1,2330,A
7-M,276,1,4,0,2279,2284,C
7-M,277,2263,0,4,0,2267,A
7-M,278,0,2248,1,1,2250,T
7-M,279,1,2,2294,0,2297,G
7-M,280,0,2,2295,0,2297,G
7-M,281,2295,0,2,0,2297,A
7-M,282,1,0,0,2288,2289,C
7-M,283,2259,0,1,0,2260,A
7-M,284,2263,0,0,0,2263,A
7-M,285,2245,1,3,1,2250,A
7-M,286,1,0,2277,0,2278,G
7-M,287,1,0,0,2327,2328,C
7-M,288,2282,0,3,0,2285,A
7-M,289,1,0,2330,0,2331,G
7-M,290,1,2318,0,2,2321,T
7-M,291,0,2313,0,0,2313,T
7-M,292,2348,0,1,0,2349,A
7-M,293,2335,0,3,2,2340,A
7-M,294,2331,0,3,0,2334,A
7-M,295,0,2,0,2356,2358,C
7-M,296,0,2294,0,0,2294,T
7-M,297,1,0,2548,0,2549,G
7-M,298,0,2520,0,1,2521,T
7-M,299,2543,1,3,0,2547,A
7-M,300,0,2541,0,0,2541,T
7-M,301,2528,1,0,1,2530,A
7-M,302,3,3,2534,0,2540,G
7-M,303,0,5,2512,0,2517,G
7-M,304,2513,0,3,0,2516,A
7-M,305,2515,0,2,0,2517,A
7-M,306,2353,0,3,0,2356,A
7-M,307,0,2,0,2417,2419,C
7-M,308,0,2408,0,0,2408,T
7-M,309,0,2417,0,0,2417,T
7-M,310,2416,0,0,0,2416,A
7-M,311,2403,0,3,0,2406,A
7-M,312,2,0,2407,0,2409,G
7-M,313,2393,0,1,0,2394,A
7-M,314,1,2,2399,0,2402,G
7-M,315,0,2,2409,0,2411,G
7-M,316,0,4,2401,1,2406,G
7-M,317,2389,0,3,0,2392,A
7-M,318,0,0,2420,0,2420,G
7-M,319,2432,0,3,0,2435,A
7-M,320,0,2428,0,2,2430,T
7-M,321,2433,0,2,0,2435,A
7-M,322,2448,0,3,0,2451,A
7-M,323,0,3,0,2461,2464,C
7-M,324,0,0,2452,0,2452,G
7-M,325,0,2443,0,1,2444,T
7-M,326,1,2421,0,4,2426,T
7-M,327,3,0,0,2453,2456,C
7-M,328,1,0,0,2439,2440,C
7-M,329,2443,0,1,0,2444,A
7-M,330,0,2442,0,2,2444,T
7-M,331,0,3,2417,0,2420,G
7-M,332,0,4,2405,0,2409,G
7-M,333,1,5,2401,0,2407,G
7-M,334,0,0,2411,0,2411,G
7-M,335,0,1,2,2401,2404,C
7-M,336,3,0,1,2409,2413,C
7-M,337,2430,0,1,0,2431,A
7-M,338,2445,0,1,0,2446,A
7-M,339,2443,0,4,0,2447,A
7-M,340,2,3,2469,0,2474,G
7-M,341,2474,0,2,0,2476,A
7-M,342,2458,0,0,0,2458,A
7-M,343,2457,0,2,0,2459,A
7-M,344,0,2451,0,1,2452,T
7-M,345,2450,0,0,0,2450,A
7-M,346,0,1,2455,0,2456,G
7-M,347,1,1,0,2440,2442,C
7-M,348,0,2422,0,4,2426,T
7-M,349,4,0,0,2435,2439,C
7-M,350,0,2396,0,3,2399,T
7-M,351,6,0,0,2509,2515,C
7-M,352,2522,0,0,1,2523,A
7-M,353,0,0,2518,0,2518,G
7-M,354,0,2473,0,3,2476,T
7-M,355,0,2520,0,1,2521,T
7-M,356,2530,0,0,0,2530,A
7-M,357,0,2527,0,2,2529,T
7-M,358,0,2525,0,0,2525,T
7-M,359,3,1,0,2532,2536,C
7-M,360,1,2436,0,0,2437,T
7-M,361,0,0,2464,0,2464,G
7-M,362,0,2,0,2449,2451,C
7-M,363,0,2445,0,3,2448,T
7-M,364,1,3,2449,0,2453,G
7-M,365,0,0,2446,0,2446,G
7-M,366,0,2418,0,4,2422,T
7-M,367,1,2,2443,0,2446,G
7-M,368,0,1,0,2442,2443,C
7-M,369,2433,0,1,0,2434,A
7-M,370,0,0,0,2446,2446,C
7-M,371,1,2431,0,1,2433,T
7-M,372,0,2482,0,1,2483,T
7-M,373,2,1,2477,0,2480,G
7-M,374,3,0,0,2457,2460,C
7-M,375,3,0,0,2475,2478,C
7-M,376,2471,0,3,0,2474,A
7-M,377,1,0,2486,0,2487,G
7-M,378,0,2493,0,2,2495,T
7-M,379,0,2483,0,0,2483,T
7-M,380,1,1,2506,0,2508,G
7-M,381,0,1,0,2459,2460,C
7-M,382,2461,0,2,0,2463,A
7-M,383,0,2464,0,0,2464,T
7-M,384,1,1,2461,0,2463,G
7-M,385,1,1,2505,0,2507,G
7-M,386,1,1,2520,0,2522,G
7-M,387,3,0,0,2521,2524,C
7-M,388,0,1,1,2571,2573,C
7-M,389,0,2578,0,8,2586,T
7-M,390,4,1,0,2628,2633,C
7-M,391,2783,1,2,0,2786,A
7-M,392,1,2800,0,0,2801,T
7-M,393,2878,0,3,0,2881,A
7-M,394,0,2823,0,3,2826,T
7-M,395,2782,2,0,0,2784,A
7-M,396,0,0,0,2951,2951,C
7-M,397,2831,1,2,0,2834,A
7-M,398,2834,0,1,0,2835,A
7-M,399,0,2801,0,1,2802,T
7-M,400,2680,0,2,0,2682,A
7-M,401,2,3,2714,1,2720,G
7-M,402,0,4,2685,1,2690,G
7-M,403,2664,0,2,0,2666,A
7-M,404,1,2671,0,0,2672,T
7-M,405,0,3,2554,0,2557,G
7-M,406,0,4,2532,0,2536,G
7-M,407,0,1,2520,0,2521,G
7-M,408,0,1,2556,1,2558,G
7-M,409,0,0,2560,0,2560,G
7-M,410,0,1,3,2532,2536,C
7-M,411,0,2496,0,4,2500,T
7-M,412,7,0,2517,0,2524,G
7-M,413,0,2522,0,0,2522,T
7-M,414,2526,0,2,0,2528,A
7-M,415,2516,0,0,0,2516,A
7-M,416,0,0,0,2515,2515,C
7-M,417,2,2,0,2482,2486,C
7-M,418,2459,0,2,0,2461,A
7-M,419,0,1,0,2475,2476,C
7-M,420,0,2471,0,3,2474,T
7-M,421,0,0,2479,0,2479,G
7-M,422,2458,0,1,0,2459,A
7-M,423,2445,0,4,0,2449,A
7-M,424,1,0,2465,0,2466,G
7-M,425,0,2441,0,2,2443,T
7-M,426,0,5,2429,0,2434,G
7-M,427,1,2,2439,0,2442,G
7-M,428,0,1,0,2455,2456,C
7-M,429,2460,0,0,0,2460,A
7-M,430,0,2448,0,2,2450,T
7-M,431,0,2452,0,2,2454,T
7-M,432,2,2451,0,1,2454,T
7-M,433,1,4,2497,0,2502,G
7-M,434,0,0,2501,0,2501,G
7-M,435,2,1,0,2495,2498,C
7-M,436,1,2,0,2487,2490,C
7-M,437,0,2489,0,2,2491,T
7-M,438,1,0,2580,1,2582,G
7-M,439,0,1,2604,1,2606,G
7-M,440,0,2609,0,0,2609,T
7-M,441,2636,0,2,0,2638,A
7-M,442,0,2514,0,0,2514,T
7-M,443,0,1,2577,0,2578,G
7-M,444,0,2564,0,5,2569,T
7-M,445,1,1,2572,0,2574,G
7-M,446,1,2,0,2570,2573,C
7-M,447,2466,0,1,0,2467,A
7-M,448,2464,2,2,0,2468,A
7-M,449,1,0,0,2481,2482,C
7-M,450,2480,0,0,0,2480,A
7-M,451,0,2482,0,0,2482,T
7-M,452,0,0,2450,0,2450,G
7-M,453,0,2374,0,0,2374,T
7-M,454,1,7,2375,0,2383,G
7-M,455,2362,0,3,1,2366,A
7-M,456,1,0,2362,0,2363,G
7-M,457,0,0,0,2352,2352,C
7-M,458,2310,0,0,0,2310,A
7-M,459,0,2,2318,1,2321,G
7-M,460,2304,0,2,0,2306,A
7-M,461,0,2308,0,1,2309,T
7-M,462,0,2313,0,0,2313,T
7-M,463,0,0,2313,0,2313,G
7-M,464,0,0,0,2310,2310,C
7-M,465,0,2301,0,3,2304,T
7-M,466,0,5,2301,0,2306,G
7-M,467,2297,0,0,0,2297,A
7-M,468,1,0,0,2413,2414,C
7-M,469,0,2416,0,3,2419,T
7-M,470,5,2,0,2434,2441,C
7-M,471,5,1,0,2421,2427,C
7-M,472,2,0,0,2447,2449,C
7-M,473,2440,0,4,0,2444,A
7-M,474,3,0,2452,0,2455,G
7-M,475,1,1,0,2447,2449,C
7-M,476,2468,0,2,0,2470,A
7-M,477,0,1,0,2462,2463,C
7-M,478,2203,0,3,0,2206,A
7-M,479,0,0,2255,0,2255,G
7-M,480,1,2,2247,0,2250,G
7-M,481,1,2229,0,3,2233,T
7-M,482,3,0,0,2262,2265,C
7-M,483,0,2229,0,4,2233,T
7-M,484,6,1,0,2233,2240,C
7-M,485,2240,0,0,0,2240,A
7-M,486,0,2243,0,0,2243,T
7-M,487,2243,1,1,0,2245,A
7-M,488,0,4,2204,0,2208,G
7-M,489,0,0,2186,0,2186,G
7-M,490,2,0,0,2186,2188,C
7-M,491,2157,0,0,0,2157,A
7-M,492,2157,1,1,0,2159,A
7-M,493,2156,0,1,0,2157,A
7-M,494,1,2152,0,0,2153,T
7-M,495,0,2,2155,1,2158,G
7-M,496,2,1,2153,0,2156,G
7-M,497,1,2114,0,1,2116,T
7-M,498,0,9,2120,0,2129,G
7-M,499,1,0,2134,0,2135,G
7-M,500,0,0,0,2141,2141,C
7-M,501,2147,0,2,0,2149,A
7-M,502,2143,1,2,0,2146,A
7-M,503,0,0,0,2170,2170,C
7-M,504,2167,0,0,0,2167,A
7-M,505,2170,0,1,0,2171,A
7-M,506,0,1,0,2180,2181,C
7-M,507,1,0,0,2161,2162,C
7-M,508,2145,0,0,0,2145,A
7-M,509,2151,0,1,0,2152,A
7-M,510,0,2158,1,2,2161,T
7-M,511,3,2,0,2166,2171,C
7-M,512,5,0,0,2142,2147,C
7-M,513,2111,0,1,0,2112,A
7-M,514,0,2114,1,0,2115,T
7-M,515,1,2125,0,1,2127,T
7-M,516,2141,0,1,0,2142,A
7-M,517,2157,0,0,0,2157,A
7-M,518,0,2162,0,0,2162,T
7-M,519,2142,0,1,0,2143,A
7-M,520,2137,0,0,2,2139,A
7-M,521,1997,0,114,0,2111,A
7-M,522,2129,0,0,0,2129,A
7-M,523,0,0,0,2177,2177,C
7-M,524,2174,0,3,0,2177,A
7-M,525,0,2161,0,0,2161,T
7-M,526,0,3,2153,0,2156,G
7-M,527,2111,2,5,0,2118,A
7-M,528,0,6,2136,0,2142,G
7-M,529,2115,0,5,0,2120,A
7-M,530,2121,0,3,1,2125,A
7-M,531,1,0,0,2129,2130,C
7-M,532,2065,0,1,0,2066,A
7-M,533,0,0,2086,0,2086,G
7-M,534,2070,0,1,0,2071,A
7-M,535,2067,0,2,0,2069,A
7-M,536,0,2062,0,2,2064,T
7-M,537,0,1,2049,0,2050,G
7-M,538,0,0,2055,0,2055,G
7-M,539,0,2030,0,1,2031,T
7-M,540,0,1998,1,0,1999,T
7-M,541,0,2031,1,2,2034,T
7-M,542,0,2044,1,0,2045,T
7-M,543,0,2,2046,0,2048,G
7-M,544,1,1,2050,0,2052,G
7-M,545,1,5,2,2039,2047,C
7-M,546,1,0,0,2059,2060,C
7-M,547,2026,0,2,0,2028,A
7-M,548,0,0,2102,0,2102,G
7-M,549,0,1,0,2101,2102,C
7-M,550,2125,0,0,0,2125,A
7-M,551,0,1,0,2170,2171,C
7-M,552,0,2143,0,0,2143,T
7-M,553,2142,0,2,0,2144,A
7-M,554,1,4,0,2166,2171,C
7-M,555,2196,0,1,0,2197,A
7-M,556,0,0,2230,0,2230,G
7-M,557,0,1,0,2150,2151,C
7-M,558,0,2123,0,1,2124,T
7-M,559,2115,0,1,0,2116,A
7-M,560,2068,0,3,0,2071,A
7-M,561,0,1,2093,0,2094,G
7-M,562,0,0,2089,0,2089,G
7-M,563,0,0,0,2082,2082,C
7-M,564,0,1980,0,3,1983,T
7-M,565,1978,0,1,0,1979,A
7-M,566,0,1975,0,3,1978,T
7-M,567,0,3,1980,0,1983,G
7-M,568,0,3,1984,1,1988,G
7-M,569,1954,0,2,0,1956,A
7-M,570,0,1,1958,0,1959,G
7-M,571,0,0,0,1924,1924,C
7-M,572,1917,0,0,0,1917,A
7-M,573,1906,0,0,0,1906,A
7-M,574,1893,0,1,1,1895,A
7-M,575,1,1923,0,0,1924,T
7-M,576,0,2,1929,1,1932,G
7-M,577,0,1,1903,0,1904,G
7-M,578,0,0,0,1895,1895,C
7-M,579,0,1875,0,4,1879,T
7-M,580,1,3,1890,0,1894,G
7-M,581,0,3,1922,0,1925,G
7-M,582,1923,0,0,0,1923,A
7-M,583,1,1906,0,2,1909,T
7-M,584,5,0,1,1915,1921,C
7-M,585,1918,0,1,0,1919,A
7-M,586,1930,0,0,0,1930,A
7-M,587,0,1,1951,0,1952,G
7-M,588,2,1937,0,0,1939,T
7-M,589,0,1,1941,1,1943,G
7-M,590,1900,0,2,0,1902,A
7-M,591,0,0,1901,0,1901,G
7-M,592,0,1,0,1888,1889,C
7-M,593,1899,0,2,0,1901,A
7-M,594,0,2,1902,0,1904,G
7-M,595,1,0,1872,0,1873,G
7-M,596,0,0,0,1896,1896,C
7-M,597,1888,0,1,0,1889,A
7-M,598,5,0,1898,0,1903,G
7-M,599,1,4,0,1898,1903,C
7-M,600,1,1,1914,0,1916,G
7-M,601,0,2,1897,0,1899,G
7-M,602,1900,0,1,0,1901,A
7-M,603,0,2,1934,0,1936,G
7-M,604,0,1,1944,0,1945,G
7-M,605,1,1,0,1936,1938,C
7-M,606,3,0,0,1947,1950,C
7-M,607,1945,0,2,0,1947,A
7-M,608,0,1944,0,3,1947,T
7-M,609,1,2,1954,0,1957,G
7-M,610,1,4,1958,0,1963,G
7-M,611,1954,0,0,0,1954,A
7-M,612,1,1,1958,0,1960,G
7-M,613,1918,0,0,0,1918,A
7-M,614,0,1961,0,0,1961,T
7-M,615,0,1951,0,5,1956,T
7-M,616,1,1,1959,0,1961,G
7-M,617,0,0,0,1962,1962,C
7-M,618,0,1956,0,1,1957,T
7-M,619,1979,0,0,0,1979,A
7-M,620,2,0,1978,0,1980,G
7-M,621,0,1966,0,2,1968,T
7-M,622,5,0,0,1977,1982,C
7-M,623,1924,0,1,0,1925,A
7-M,624,1,3,1951,0,1955,G
7-M,625,0,1,1946,0,1947,G
7-M,626,1,1,0,1946,1948,C
7-M,627,4,0,0,1947,1951,C
7-M,628,1955,0,5,0,1960,A
7-M,629,1,2,1976,0,1979,G
7-M,630,1,2,1963,0,1966,G
7-M,631,0,0,0,1979,1979,C
7-M,632,1978,0,0,0,1978,A
7-M,633,0,1,1971,0,1972,G
7-M,634,1951,1,4,0,1956,A
7-M,635,0,1956,0,1,1957,T
7-M,636,0,2,1964,0,1966,G
7-M,637,1,2,2029,0,2032,G
7-M,638,0,1979,0,1,1980,T
7-M,639,0,0,1997,0,1997,G
7-M,640,0,1,0,1978,1979,C
7-M,641,1983,1,7,0,1991,A
7-M,642,1,1,2010,0,2012,G
7-M,643,0,2,2006,0,2008,G
7-M,644,0,0,0,2000,2000,C
7-M,645,1983,0,0,0,1983,A
7-M,646,1936,0,0,0,1936,A
7-M,647,0,1924,0,0,1924,T
7-M,648,0,5,1916,0,1921,G
7-M,649,1910,0,3,0,1913,A
7-M,650,1,2,1911,0,1914,G
7-M,651,1849,0,6,0,1855,A
7-M,652,1,1,1873,0,1875,G
7-M,653,0,1,0,1874,1875,C
7-M,654,1,1,0,1916,1918,C
7-M,655,1930,0,1,0,1931,A
7-M,656,0,1931,0,2,1933,T
7-M,657,0,1948,0,0,1948,T
7-M,658,0,2,1928,0,1930,G
7-M,659,0,2,1916,0,1918,G
7-M,660,0,1,1923,0,1924,G
7-M,661,1931,0,5,0,1936,A
7-M,662,0,1,0,1898,1899,C
7-M,663,0,1840,0,2,1842,T
7-M,664,5,0,0,1858,1863,C
7-M,665,1875,0,0,0,1875,A
7-M,666,0,1938,0,0,1938,T
7-M,667,1,0,0,1955,1956,C
7-M,668,2,0,0,1951,1953,C
7-M,669,0,1949,0,0,1949,T
7-M,670,1949,0,1,0,1950,A
7-M,671,1,0,1979,0,1980,G
7-M,672,0,2193,0,1,2194,T
7-M,673,0,2163,0,4,2167,T
7-M,674,3,1,0,2168,2172,C
7-M,675,2,2,0,2136,2140,C
7-M,676,2118,0,0,0,2118,A
7-M,677,1,0,2154,0,2155,G
7-M,678,0,2148,0,1,2149,T
7-M,679,2145,0,0,0,2145,A
7-M,680,0,0,0,2144,2144,C
7-M,681,0,1896,0,4,1900,T
7-M,682,0,3,1962,0,1965,G
7-M,683,0,0,2010,0,2010,G
7-M,684,0,2010,0,2,2012,T
7-M,685,2,0,0,2015,2017,C
7-M,686,0,1981,0,2,1983,T
7-M,687,1984,0,0,0,1984,A
7-M,688,1982,0,2,0,1984,A
7-M,689,1,0,2001,0,2002,G
7-M,690,1975,0,0,0,1975,A
7-M,691,0,1,1947,0,1948,G
7-M,692,1862,0,1,0,1863,A
7-M,693,0,1849,0,2,1851,T
7-M,694,0,4,1862,0,1866,G
7-M,695,1853,0,6,0,1859,A
7-M,696,0,1851,0,0,1851,T
7-M,697,2,0,0,1854,1856,C
7-M,698,1,1832,0,0,1833,T
7-M,699,0,1836,0,0,1836,T
7-M,700,1,0,0,1840,1841,C
7-M,701,1,1835,1,0,1837,T
7-M,702,0,1846,0,0,1846,T
7-M,703,1,2,1848,0,1851,G
7-M,704,1844,0,0,0,1844,A
7-M,705,1836,0,0,1,1837,A
7-M,706,1842,0,0,0,1842,A
7-M,707,1836,0,1,0,1837,A
7-M,708,0,1849,0,0,1849,T
7-M,709,0,1861,0,2,1863,T
7-M,710,0,1863,0,1,1864,T
7-M,711,3,0,1852,0,1855,G
7-M,712,1,1,0,1861,1863,C
7-M,713,1864,0,1,0,1865,A
7-M,714,2,0,1862,0,1864,G
7-M,715,1851,0,0,0,1851,A
7-M,716,0,0,0,1909,1909,C
7-M,717,1,0,0,1903,1904,C
7-M,718,0,1905,0,0,1905,T
7-M,719,1937,0,0,0,1937,A
7-M,720,0,1938,0,2,1940,T
7-M,721,3,0,0,1940,1943,C
7-M,722,1940,0,0,0,1940,A
7-M,723,0,6,1929,0,1935,G
7-M,724,1916,0,1,1,1918,A
7-M,725,1868,0,1,0,1869,A
7-M,726,1869,0,0,0,1869,A
7-M,727,0,1,0,1868,1869,C
7-M,728,0,3,1882,0,1885,G
7-M,729,1847,0,2,0,1849,A
7-M,730,1866,0,1,0,1867,A
7-M,731,0,1867,0,0,1867,T
7-M,732,2,3,1870,0,1875,G
7-M,733,0,5,1879,0,1884,G
7-M,734,1,1,1891,0,1893,G
7-M,735,0,1,1886,0,1887,G
7-M,736,1,0,1892,0,1893,G
7-M,737,1,1836,0,0,1837,T
7-M,738,3,2,1853,0,1858,G
7-M,739,0,0,0,1848,1848,C
7-M,740,1843,1,2,0,1846,A
7-M,741,0,1,1863,0,1864,G
7-M,742,1826,0,2,0,1828,A
7-M,743,0,1812,0,0,1812,T
7-M,744,0,0,1792,0,1792,G
7-M,745,0,0,0,1770,1770,C
7-M,746,1778,0,3,0,1781,A
7-M,747,1778,0,0,0,1778,A
7-M,748,0,1,0,1785,1786,C
7-M,749,0,3,1789,0,1792,G
7-M,750,1796,0,0,0,1796,A
7-M,751,0,1794,0,0,1794,T
7-M,752,0,1793,0,0,1793,T
7-M,753,2,0,0,1815,1817,C
7-M,754,1793,0,0,0,1793,A
7-M,755,1799,0,1,0,1800,A
7-M,756,0,0,1796,0,1796,G
7-M,757,0,1762,0,3,1765,T
7-M,758,0,4,1756,0,1760,G
7-M,759,1744,0,4,0,1748,A
7-M,760,2,0,0,1739,1741,C
7-M,761,1,1,0,1744,1746,C
7-M,762,5,1,0,1750,1756,C
7-M,763,2,1,1755,0,1758,G
7-M,764,2,0,0,1762,1764,C
7-M,765,0,1768,1,1,1770,T
7-M,766,0,1772,0,0,1772,T
7-M,767,0,0,1776,0,1776,G
7-M,768,1,1765,0,4,1770,T
7-M,769,0,1773,0,1,1774,T
7-M,770,4,0,1767,0,1771,G
7-M,771,0,1727,0,1,1728,T
7-M,772,0,1709,0,3,1712,T
7-M,773,1,0,1701,0,1702,G
7-M,774,1,3,0,1681,1685,C
7-M,775,4,2,0,1677,1683,C
7-M,776,2,1,1704,0,1707,G
7-M,777,1,0,0,1666,1667,C
7-M,778,1,4,1696,0,1701,G
7-M,779,1688,0,0,0,1688,A
7-M,780,1697,1,0,0,1698,A
7-M,781,0,1732,0,1,1733,T
7-M,782,1736,0,1,0,1737,A
7-M,783,0,1753,0,1,1754,T
7-M,784,6,0,0,1760,1766,C
7-M,785,1770,0,1,0,1771,A
7-M,786,0,1764,0,2,1766,T
7-M,787,0,1746,0,2,1748,T
7-M,788,1,1,1747,0,1749,G
7-M,789,1,1,1743,0,1745,G
7-M,790,0,4,1742,0,1746,G
7-M,791,1736,0,1,0,1737,A
7-M,792,0,1719,0,1,1720,T
7-M,793,1,1,0,1686,1688,C
7-M,794,0,1683,0,7,1690,T
7-M,795,1,1690,0,1,1692,T
7-M,796,0,0,1709,0,1709,G
7-M,797,1,1,0,1700,1702,C
7-M,798,1696,0,1,0,1697,A
7-M,799,0,0,0,1714,1714,C
7-M,800,0,1675,1,1,1677,T
7-M,801,1,1685,1,1,1688,T
7-M,802,0,0,1683,0,1683,G
7-M,803,1697,0,1,0,1698,A
7-M,804,0,1703,0,0,1703,T
7-M,805,1667,0,0,0,1667,A
7-M,806,0,1652,0,2,1654,T
7-M,807,0,1646,0,0,1646,T
7-M,808,1,0,1652,0,1653,G
7-M,809,0,1638,0,3,1641,T
7-M,810,0,4,1624,0,1628,G
7-M,811,0,3,1624,0,1627,G
7-M,812,1601,0,0,0,1601,A
7-M,813,0,1605,0,1,1606,T
7-M,814,0,1599,0,6,1605,T
7-M,815,4,1,0,1597,1602,C
7-M,816,0,1597,0,1,1598,T
7-M,817,0,1584,1,0,1585,T
7-M,818,0,0,1586,0,1586,G
7-M,819,1575,0,1,0,1576,A
7-M,820,0,1564,0,0,1564,T
7-M,821,3,0,0,1561,1564,C
7-M,822,2,0,1559,0,1561,G
7-M,823,0,1551,0,2,1553,T
7-M,824,2,0,0,1551,1553,C
7-M,825,0,1536,0,3,1539,T
7-M,826,0,1560,0,0,1560,T
7-M,827,0,1562,0,1,1563,T
7-M,828,0,1558,0,0,1558,T
7-M,829,0,1570,0,1,1571,T
7-M,830,0,1559,0,3,1562,T
7-M,831,0,1558,0,2,1560,T
7-M,832,4,0,0,1562,1566,C
7-M,833,1553,0,1,0,1554,A
7-M,834,1559,0,0,0,1559,A
7-M,835,1550,0,1,0,1551,A
7-M,836,0,1551,0,0,1551,T
7-M,837,1,0,1547,0,1548,G
7-M,838,2,1,0,1539,1542,C
7-M,839,1,0,1552,0,1553,G
7-M,840,0,1591,0,0,1591,T
7-M,841,0,0,0,1589,1589,C
7-M,842,2,1588,0,0,1590,T
7-M,843,1595,0,0,0,1595,A
7-M,844,0,1572,0,6,1578,T
7-M,845,1,0,0,1587,1588,C
7-M,846,0,0,1586,0,1586,G
7-M,847,1571,0,1,0,1572,A
7-M,848,0,1,0,1575,1576,C
7-M,849,0,1504,0,3,1507,T
7-M,850,3,0,0,1536,1539,C
7-M,851,1,1525,0,8,1534,T
7-M,852,0,1524,0,2,1526,T
7-M,853,0,1,1,1531,1533,C
7-M,854,1537,0,2,0,1539,A
7-M,855,1539,0,0,0,1539,A
7-M,856,1531,0,3,0,1534,A
7-M,857,0,0,0,1528,1528,C
7-M,858,1512,0,1,0,1513,A
7-M,859,1,1,0,1450,1452,C
7-M,860,1,2,1415,0,1418,G
7-M,861,0,0,1475,0,1475,G
7-M,862,0,0,0,1474,1474,C
7-M,863,2,0,1,1487,1490,C
7-M,864,0,1489,0,2,1491,T
7-M,865,0,1501,0,0,1501,T
7-M,866,1509,0,1,0,1510,A
7-M,867,1508,0,1,0,1509,A
7-M,868,1516,0,0,0,1516,A
7-M,869,1494,0,3,0,1497,A
7-M,870,1,0,1487,0,1488,G
7-M,871,1265,1,4,0,1270,A
7-M,872,0,3,1250,0,1253,G
7-M,873,0,1,1250,1,1252,G
7-M,874,1,2,0,1252,1255,C
7-M,875,2,0,0,1235,1237,C
7-M,876,1,1,0,1238,1240,C
7-M,877,0,1247,0,0,1247,T
7-M,878,0,1260,0,0,1260,T
7-M,879,1,0,0,1263,1264,C
7-M,880,0,1273,0,0,1273,T
7-M,881,1273,0,1,0,1274,A
7-M,882,0,3,0,1270,1273,C
7-M,883,1,1,1247,0,1249,G
7-M,884,0,1,1249,0,1250,G
7-M,885,1217,0,0,0,1217,A
7-M,886,1213,0,3,0,1216,A
7-M,887,1,1,1198,0,1200,G
7-M,888,0,3,1198,0,1201,G
7-M,889,1182,0,2,0,1184,A
7-M,890,0,0,1183,1,1184,G
7-M,891,0,1178,0,0,1178,T
7-M,892,1181,0,2,0,1183,A
7-M,893,1,0,0,1175,1176,C
7-M,894,0,0,0,1175,1175,C
7-M,895,1,1158,0,2,1161,T
7-M,896,0,1,1157,0,1158,G
7-M,897,1099,0,0,0,1099,A
7-M,898,0,1,1126,0,1127,G
7-M,899,0,1083,0,1,1084,T
7-M,900,3,1,0,1086,1090,C
7-M,901,0,1071,0,3,1074,T
7-M,902,1069,0,0,0,1069,A
7-M,903,0,1069,0,0,1069,T
7-M,904,0,1,1071,0,1072,G
7-M,905,1033,0,5,0,1038,A
7-M,906,0,2,1041,0,1043,G
7-M,907,1,2,963,0,966,G
7-M,908,0,0,972,0,972,G
7-M,909,964,0,0,0,964,A
7-M,910,952,0,1,0,953,A
7-M,911,0,0,954,1,955,G
7-M,912,948,0,1,0,949,A
7-M,913,945,0,0,0,945,A
7-M,914,0,939,0,0,939,T
7-M,915,923,0,1,0,924,A
7-M,916,0,925,0,0,925,T
7-M,917,4,4,0,896,904,C
7-M,918,2,2,909,0,913,G
7-M,919,909,0,0,0,909,A
7-M,920,893,0,0,0,893,A
7-M,921,894,0,1,0,895,A
7-M,922,0,1,876,0,877,G
7-M,923,0,4,883,0,887,G
7-M,924,880,1,1,0,882,A
7-M,925,883,0,0,0,883,A
7-M,926,0,3,0,877,880,C
7-M,927,873,0,2,0,875,A
7-M,928,1,0,879,0,880,G
7-M,929,0,1,1,875,877,C
7-M,930,871,0,0,0,871,A
7-M,931,0,0,871,0,871,G
7-M,932,813,0,0,0,813,A
7-M,933,815,0,1,0,816,A
7-M,934,0,809,0,0,809,T
7-M,935,0,0,799,0,799,G
7-M,936,0,1,0,799,800,C
7-M,937,0,753,0,2,755,T
7-M,938,0,0,754,0,754,G
7-M,939,0,748,0,1,749,T
7-M,940,0,0,748,0,748,G
7-M,941,0,1,747,0,748,G
7-M,942,717,0,0,0,717,A
7-M,943,0,708,0,0,708,T
7-M,944,0,0,685,0,685,G
7-M,945,0,1,0,678,679,C
7-M,946,0,642,0,3,645,T
7-M,947,0,1,640,0,641,G
7-M,948,634,0,1,0,635,A
7-M,949,0,1,0,626,627,C
7-M,950,0,0,625,0,625,G
7-M,951,616,0,1,0,617,A
7-M,952,0,0,0,616,616,C
7-M,953,596,0,0,0,596,A
7-M,954,1,0,591,0,592,G
7-M,955,0,591,0,1,592,T
7-M,956,3,0,0,579,582,C
7-M,957,581,0,0,0,581,A
7-M,958,0,573,0,0,573,T
7-M,959,0,565,0,3,568,T
7-M,960,0,567,0,1,568,T
7-M,961,0,556,0,0,556,T
7-M,962,0,0,555,0,555,G
7-M,963,0,533,0,0,533,T
7-M,964,2,0,0,532,534,C
7-M,965,510,0,2,0,512,A
7-M,966,0,0,512,0,512,G
7-M,967,0,0,0,510,510,C
7-M,968,507,0,1,0,508,A
7-M,969,0,508,0,0,508,T
7-M,970,489,0,1,0,490,A
7-M,971,0,0,490,0,490,G
7-M,972,479,0,2,0,481,A
7-M,973,0,0,478,0,478,G
7-M,974,1,468,0,0,469,T
7-M,975,0,314,0,1,315,T
7-M,976,0,0,314,0,314,G
7-M,977,0,0,310,0,310,G
7-M,978,308,0,0,0,308,A
7-M,979,0,0,309,0,309,G
7-M,980,0,193,0,0,193,T
7-M,981,186,0,0,0,186,A
7-M,982,186,0,0,0,186,A
8-NS,1,530,0,0,0,530,A
8-NS,2,0,532,0,0,532,T
8-NS,3,0,0,570,0,570,G
8-NS,4,0,2,611,0,613,G
8-NS,5,653,0,0,0,653,A
8-NS,6,0,1326,0,0,1326,T
8-NS,7,0,1333,0,1,1334,T
8-NS,8,0,0,0,1376,1376,C
8-NS,9,0,1,0,1382,1383,C
8-NS,10,1389,0,0,0,1389,A
8-NS,11,1406,0,3,0,1409,A
8-NS,12,0,0,0,1411,1411,C
8-NS,13,1413,1,0,0,1414,A
8-NS,14,1,0,0,1425,1426,C
8-NS,15,0,1436,0,0,1436,T
8-NS,16,0,1,1580,0,1581,G
8-NS,17,0,1575,0,2,1577,T
8-NS,18,0,0,1598,0,1598,G
8-NS,19,0,1603,0,2,1605,T
8-NS,20,1,1,0,1601,1603,C
8-NS,21,1602,1,2,0,1605,A
8-NS,22,1600,0,2,0,1602,A
8-NS,23,0,0,1626,0,1626,G
8-NS,24,0,1652,0,1,1653,T
8-NS,25,0,1659,0,1,1660,T
8-NS,26,0,1673,0,1,1674,T
8-NS,27,4,0,0,1667,1671,C
8-NS,28,0,0,0,1684,1684,C
8-NS,29,1666,0,4,0,1670,A
8-NS,30,2,2,1692,0,1696,G
8-NS,31,0,0,1701,0,1701,G
8-NS,32,0,1680,0,1,1681,T
8-NS,33,1716,0,1,0,1717,A
8-NS,34,0,3,1728,0,1731,G
8-NS,35,1736,0,0,0,1736,A
8-NS,36,0,1740,0,1,1741,T
8-NS,37,0,1741,0,1,1742,T
8-NS,38,0,0,1760,0,1760,G
8-NS,39,0,0,0,1762,1762,C
8-NS,40,0,1761,0,3,1764,T
8-NS,41,1,1785,0,2,1788,T
8-NS,42,0,1788,0,4,1792,T
8-NS,43,1,0,0,1818,1819,C
8-NS,44,0,1820,0,0,1820,T
8-NS,45,0,1818,0,0,1818,T
8-NS,46,0,1816,0,4,1820,T
8-NS,47,0,3,1840,0,1843,G
8-NS,48,2,0,1818,0,1820,G
8-NS,49,0,0,0,1839,1839,C
8-NS,50,1834,0,2,0,1836,A
8-NS,51,0,1842,0,0,1842,T
8-NS,52,1866,0,0,1,1867,A
8-NS,53,1,1909,0,0,1910,T
8-NS,54,0,0,0,1913,1913,C
8-NS,55,0,0,0,1915,1915,C
8-NS,56,6,3,1902,0,1911,G
8-NS,57,0,1,1919,0,1920,G
8-NS,58,1917,0,0,0,1917,A
8-NS,59,1920,0,2,0,1922,A
8-NS,60,1935,0,0,0,1935,A
8-NS,61,1,0,0,1952,1953,C
8-NS,62,1951,0,2,0,1953,A
8-NS,63,1949,0,0,0,1949,A
8-NS,64,0,0,2010,0,2010,G
8-NS,65,1,2026,0,3,2030,T
8-NS,66,0,2031,1,0,2032,T
8-NS,67,0,1,2036,0,2037,G
8-NS,68,0,2030,0,1,2031,T
8-NS,69,2030,1,4,0,2035,A
8-NS,70,1,6,2035,0,2042,G
8-NS,71,2149,0,1,0,2150,A
8-NS,72,0,1,0,2174,2175,C
8-NS,73,1,0,0,2134,2135,C
8-NS,74,2133,0,1,0,2134,A
8-NS,75,2136,0,3,0,2139,A
8-NS,76,0,3,2244,0,2247,G
8-NS,77,2237,0,2,0,2239,A
8-NS,78,2271,0,2,0,2273,A
8-NS,79,0,1,0,2273,2274,C
8-NS,80,0,2215,0,1,2216,T
8-NS,81,0,5,2244,0,2249,G
8-NS,82,2225,0,3,0,2228,A
8-NS,83,0,1,2305,0,2306,G
8-NS,84,0,2307,0,0,2307,T
8-NS,85,2,4,2262,0,2268,G
8-NS,86,2270,0,0,0,2270,A
8-NS,87,0,2264,0,0,2264,T
8-NS,88,3,0,2299,0,2302,G
8-NS,89,1,3,0,2326,2330,C
8-NS,90,3,1,0,2337,2341,C
8-NS,91,6,1,1,2342,2350,C
8-NS,92,1,0,0,2342,2343,C
8-NS,93,2356,0,0,0,2356,A
8-NS,94,1,2390,0,2,2393,T
8-NS,95,0,2444,0,2,2446,T
8-NS,96,4,0,0,2447,2451,C
8-NS,97,4,1,0,2450,2455,C
8-NS,98,0,2442,0,6,2448,T
8-NS,99,0,2424,0,3,2427,T
8-NS,100,0,5,2415,0,2420,G
8-NS,101,2391,0,0,0,2391,A
8-NS,102,0,2406,0,2,2408,T
8-NS,103,6,3,0,2389,2398,C
8-NS,104,2,1,2358,0,2361,G
8-NS,105,2,0,2384,0,2386,G
8-NS,106,1,0,0,2402,2403,C
8-NS,107,0,2384,0,2,2386,T
8-NS,108,0,2408,0,0,2408,T
8-NS,109,6,2,0,2395,2403,C
8-NS,110,2,2,2405,0,2409,G
8-NS,111,2,1,0,2406,2409,C
8-NS,112,1,1,0,2421,2423,C
8-NS,113,4,2,2423,0,2429,G
8-NS,114,2384,0,2,0,2386,A
8-NS,115,0,3,2481,0,2484,G
8-NS,116,2478,0,1,0,2479,A
8-NS,117,0,2493,0,1,2494,T
8-NS,118,3,2,0,2498,2503,C
8-NS,119,2491,1,1,0,2493,A
8-NS,120,3,2,2491,0,2496,G
8-NS,121,2469,0,2,0,2471,A
8-NS,122,1,1,2491,0,2493,G
8-NS,123,0,1,2530,0,2531,G
8-NS,124,0,2537,0,3,2540,T
8-NS,125,9,0,0,2653,2662,C
8-NS,126,3,0,0,2667,2670,C
8-NS,127,3,1,1,2693,2698,C
8-NS,128,0,2699,0,1,2700,T
8-NS,129,2699,0,0,0,2699,A
8-NS,130,2689,0,2,0,2691,A
8-NS,131,1,8,2739,1,2749,G
8-NS,132,0,7,2734,0,2741,G
8-NS,133,3,5,2712,0,2720,G
8-NS,134,0,2,2679,1,2682,G
8-NS,135,2646,0,3,0,2649,A
8-NS,136,2651,0,5,0,2656,A
8-NS,137,0,1,2683,0,2684,G
8-NS,138,2710,1,5,0,2716,A
8-NS,139,0,2,2751,0,2753,G
8-NS,140,1,0,2733,1,2735,G
8-NS,141,0,0,0,2742,2742,C
8-NS,142,2728,0,2,0,2730,A
8-NS,143,2744,1,1,0,2746,A
8-NS,144,0,2742,0,3,2745,T
8-NS,145,2778,0,1,0,2779,A
8-NS,146,1,1,0,2833,2835,C
8-NS,147,0,2776,0,1,2777,T
8-NS,148,6,0,0,2770,2776,C
8-NS,149,0,2733,1,1,2735,T
8-NS,150,2,5,0,2763,2770,C
8-NS,151,2,1,2795,1,2799,G
8-NS,152,0,1,2964,0,2965,G
8-NS,153,0,2955,0,0,2955,T
8-NS,154,6,1,0,2974,2981,C
8-NS,155,0,2947,0,1,2948,T
8-NS,156,2972,0,0,1,2973,A
8-NS,157,0,4,2964,0,2968,G
8-NS,158,2954,1,2,0,2957,A
8-NS,159,0,2,0,3031,3033,C
8-NS,160,2971,0,1,0,2972,A
8-NS,161,0,2921,0,1,2922,T
8-NS,162,2,1,0,2919,2922,C
8-NS,163,2918,0,0,0,2918,A
8-NS,164,2911,2,0,0,2913,A
8-NS,165,2900,0,0,0,2900,A
8-NS,166,2850,0,3,0,2853,A
8-NS,167,0,0,0,2888,2888,C
8-NS,168,2886,0,3,0,2889,A
8-NS,169,0,2,2896,0,2898,G
8-NS,170,1,0,0,2881,2882,C
8-NS,171,4,0,0,2890,2894,C
8-NS,172,2899,0,5,0,2904,A
8-NS,173,1,3,0,2955,2959,C
8-NS,174,3,0,0,2973,2976,C
8-NS,175,7,1,0,2971,2979,C
8-NS,176,3005,2,7,0,3014,A
8-NS,177,1,3017,0,1,3019,T
8-NS,178,3,3,3022,0,3028,G
8-NS,179,0,3012,0,4,3016,T
8-NS,180,0,3016,2,6,3024,T
8-NS,181,2,6,3007,0,3015,G
8-NS,182,2,2,2968,0,2972,G
8-NS,183,2949,1,1,0,2951,A
8-NS,184,2962,0,2,0,2964,A
8-NS,185,2899,0,4,0,2903,A
8-NS,186,1,2,2911,1,2915,G
8-NS,187,0,0,0,2903,2903,C
8-NS,188,2918,0,2,0,2920,A
8-NS,189,2908,0,0,1,2909,A
8-NS,190,2902,0,0,0,2902,A
8-NS,191,2,2920,0,0,2922,T
8-NS,192,0,2921,0,1,2922,T
8-NS,193,0,0,2972,0,2972,G
8-NS,194,0,2958,0,0,2958,T
8-NS,195,2956,0,4,0,2960,A
8-NS,196,0,4,2945,0,2949,G
8-NS,197,2950,0,0,0,2950,A
8-NS,198,2942,1,4,0,2947,A
8-NS,199,2950,0,0,0,2950,A
8-NS,200,2933,0,5,0,2938,A
8-NS,201,0,6,2940,0,2946,G
8-NS,202,2887,0,3,0,2890,A
8-NS,203,0,2903,0,1,2904,T
8-NS,204,1,2902,0,4,2907,T
8-NS,205,4,0,0,2899,2903,C
8-NS,206,1,2897,0,1,2899,T
8-NS,207,0,4,2900,0,2904,G
8-NS,208,2897,0,3,0,2900,A
8-NS,209,2906,0,0,0,2906,A
8-NS,210,2893,0,1,0,2894,A
8-NS,211,0,1,2903,0,2904,G
8-NS,212,2897,0,3,0,2900,A
8-NS,213,2902,0,3,0,2905,A
8-NS,214,1,10,2924,0,2935,G
8-NS,215,2936,0,4,0,2940,A
8-NS,216,2950,0,3,0,2953,A
8-NS,217,0,2946,0,2,2948,T
8-NS,218,3,0,1,2971,2975,C
8-NS,219,0,2985,0,2,2987,T
8-NS,220,2,4,2988,0,2994,G
8-NS,221,2992,1,3,0,2996,A
8-NS,222,0,2995,0,0,2995,T
8-NS,223,2,1,2979,0,2982,G
8-NS,224,2943,0,6,0,2949,A
8-NS,225,3,3,2941,0,2947,G
8-NS,226,1,1,2928,0,2930,G
8-NS,227,1,1,0,2913,2915,C
8-NS,228,2907,0,3,0,2910,A
8-NS,229,1,1,0,2986,2988,C
8-NS,230,0,2974,1,2,2977,T
8-NS,231,0,3003,0,0,3003,T
8-NS,232,3031,0,0,0,3031,A
8-NS,233,3028,0,5,0,3033,A
8-NS,234,3023,0,2,0,3025,A
8-NS,235,3018,0,0,1,3019,A
8-NS,236,1,3010,0,1,3012,T
8-NS,237,1,6,3007,0,3014,G
8-NS,238,3009,1,2,0,3012,A
8-NS,239,1,2,0,3024,3027,C
8-NS,240,4,0,0,3007,3011,C
8-NS,241,3008,1,1,0,3010,A
8-NS,242,0,2989,0,1,2990,T
8-NS,243,1,5,3075,0,3081,G
8-NS,244,0,0,3102,0,3102,G
8-NS,245,1,3104,1,3,3109,T
8-NS,246,4,2,1,3273,3280,C
8-NS,247,1,3258,1,2,3262,T
8-NS,248,1,0,0,3297,3298,C
8-NS,249,4,0,1,3279,3284,C
8-NS,250,3302,1,1,0,3304,A
8-NS,251,1,1,0,3334,3336,C
8-NS,252,3229,0,3,0,3232,A
8-NS,253,2,2,0,3250,3254,C
8-NS,254,2,3,0,3227,3232,C
8-NS,255,1,3086,0,4,3091,T
8-NS,256,1,0,3096,0,3097,G
8-NS,257,0,1,0,3077,3078,C
8-NS,258,0,3042,0,3,3045,T
8-NS,259,0,3076,0,2,3078,T
8-NS,260,9,0,0,3064,3073,C
8-NS,261,2,0,3085,0,3087,G
8-NS,262,1,2,1,3065,3069,C
8-NS,263,3,4,3073,0,3080,G
8-NS,264,3219,0,3,0,3222,A
8-NS,265,0,3226,0,1,3227,T
8-NS,266,3312,0,2,0,3314,A
8-NS,267,1,2,0,3317,3320,C
8-NS,268,3301,1,1,0,3303,A
8-NS,269,1,3387,0,5,3393,T
8-NS,270,3382,0,4,1,3387,A
8-NS,271,3389,0,1,2,3392,A
8-NS,272,0,0,0,3398,3398,C
8-NS,273,0,3250,0,2,3252,T
8-NS,274,1,9,3293,0,3303,G
8-NS,275,3250,0,2,0,3252,A
8-NS,276,1,0,0,3273,3274,C
8-NS,277,3254,0,3,0,3257,A
8-NS,278,0,3223,0,5,3228,T
8-NS,279,0,6,3245,0,3251,G
8-NS,280,3208,0,7,0,3215,A
8-NS,281,0,3,0,3331,3334,C
8-NS,282,2,3319,1,2,3324,T
8-NS,283,3383,0,1,0,3384,A
8-NS,284,0,3373,0,2,3375,T
8-NS,285,0,3361,0,3,3364,T
8-NS,286,3,1,3351,1,3356,G
8-NS,287,3329,0,7,0,3336,A
8-NS,288,2,1,3336,0,3339,G
8-NS,289,0,8,3326,1,3335,G
8-NS,290,3247,0,1,0,3248,A
8-NS,291,3262,1,3,0,3266,A
8-NS,292,0,3191,0,1,3192,T
8-NS,293,0,3193,0,1,3194,T
8-NS,294,2,1,3251,0,3254,G
8-NS,295,2,3245,0,5,3252,T
8-NS,296,3,1,0,3265,3269,C
8-NS,297,3249,2,3,0,3254,A
8-NS,298,3255,0,6,0,3261,A
8-NS,299,0,10,3249,0,3259,G
8-NS,300,3252,0,4,0,3256,A
8-NS,301,3258,0,2,0,3260,A
8-NS,302,3249,0,5,0,3254,A
8-NS,303,0,2,0,3251,3253,C
8-NS,304,0,3197,0,2,3199,T
8-NS,305,0,2,3272,0,3274,G
8-NS,306,1,0,3317,0,3318,G
8-NS,307,2,3304,0,1,3307,T
8-NS,308,0,3311,0,1,3312,T
8-NS,309,6,0,1,3294,3301,C
8-NS,310,3310,0,4,0,3314,A
8-NS,311,0,3356,0,2,3358,T
8-NS,312,1,0,3381,1,3383,G
8-NS,313,1,1,0,3390,3392,C
8-NS,314,0,3350,0,2,3352,T
8-NS,315,3301,0,4,0,3305,A
8-NS,316,3317,0,0,0,3317,A
8-NS,317,0,3344,0,2,3346,T
8-NS,318,2,1,3348,0,3351,G
8-NS,319,0,1,0,3338,3339,C
8-NS,320,5,0,0,3283,3288,C
8-NS,321,4,3,1,3278,3286,C
8-NS,322,3276,0,0,1,3277,A
8-NS,323,3298,0,4,0,3302,A
8-NS,324,0,2,3323,0,3325,G
8-NS,325,1,1,0,3331,3333,C
8-NS,326,3305,0,0,0,3305,A
8-NS,327,0,2,3315,0,3317,G
8-NS,328,3292,0,2,0,3294,A
8-NS,329,3318,0,2,0,3320,A
8-NS,330,3308,0,4,0,3312,A
8-NS,331,1,0,3381,0,3382,G
8-NS,332,0,3316,0,3,3319,T
8-NS,333,3,2,3329,0,3334,G
8-NS,334,0,3,3335,2,3340,G
8-NS,335,3332,0,4,0,3336,A
8-NS,336,3323,1,2,2,3328,A
8-NS,337,2,4,3297,0,3303,G
8-NS,338,0,4,3304,0,3308,G
8-NS,339,3295,0,5,0,3300,A
8-NS,340,3,0,1,3289,3293,C
8-NS,341,3,1,0,3284,3288,C
8-NS,342,0,3284,0,4,3288,T
8-NS,343,4,1,0,3340,3345,C
8-NS,344,0,3335,0,5,3340,T
8-NS,345,0,3366,1,2,3369,T
8-NS,346,1,3356,0,1,3358,T
8-NS,347,0,1,3344,0,3345,G
8-NS,348,0,0,0,3399,3399,C
8-NS,349,3371,0,2,0,3373,A
8-NS,350,1,3364,0,2,3367,T
8-NS,351,4,4,0,3361,3369,C
8-NS,352,3396,0,0,1,3397,A
8-NS,353,1,6,3505,0,3512,G
8-NS,354,3499,0,2,2,3503,A
8-NS,355,3503,1,0,1,3505,A
8-NS,356,0,3490,0,1,3491,T
8-NS,357,0,5,3439,0,3444,G
8-NS,358,10,7,3468,0,3485,G
8-NS,359,3474,0,3,1,3478,A
8-NS,360,1,3,0,3468,3472,C
8-NS,361,3,0,0,3392,3395,C
8-NS,362,3335,1,5,0,3341,A
8-NS,363,2,1,3369,0,3372,G
8-NS,364,2,2,3354,0,3358,G
8-NS,365,1,1,0,3369,3371,C
8-NS,366,3358,0,6,0,3364,A
8-NS,367,3373,0,6,0,3379,A
8-NS,368,0,3367,1,1,3369,T
8-NS,369,6,1,0,3368,3375,C
8-NS,370,3376,1,3,0,3380,A
8-NS,371,1,3358,0,0,3359,T
8-NS,372,4,4,3298,0,3306,G
8-NS,373,0,3,3317,0,3320,G
8-NS,374,3303,0,5,0,3308,A
8-NS,375,2,4,3347,0,3353,G
8-NS,376,3309,0,0,0,3309,A
8-NS,377,3300,0,0,0,3300,A
8-NS,378,3316,0,4,0,3320,A
8-NS,379,3299,0,0,0,3299,A
8-NS,380,3309,0,2,2,3313,A
8-NS,381,0,0,0,3356,3356,C
8-NS,382,3321,0,3,0,3324,A
8-NS,383,0,3292,0,2,3294,T
8-NS,384,3,0,0,3289,3292,C
8-NS,385,3284,0,0,0,3284,A
8-NS,386,0,3299,2,2,3303,T
8-NS,387,1,1,3312,0,3314,G
8-NS,388,0,3298,0,3,3301,T
8-NS,389,0,3281,1,2,3284,T
8-NS,390,1,5,3281,0,3287,G
8-NS,391,3266,0,1,0,3267,A
8-NS,392,3259,0,3,0,3262,A
8-NS,393,3252,0,5,0,3257,A
8-NS,394,0,1,3262,0,3263,G
8-NS,395,4,2,0,3227,3233,C
8-NS,396,5,4,3228,0,3237,G
8-NS,397,3234,0,2,0,3236,A
8-NS,398,3245,0,1,0,3246,A
8-NS,399,1,3220,0,3,3224,T
8-NS,400,0,3235,1,2,3238,T
8-NS,401,0,3224,0,3,3227,T
8-NS,402,3,0,0,3244,3247,C
8-NS,403,3221,0,3,0,3224,A
8-NS,404,3,1,3235,0,3239,G
8-NS,405,0,3198,1,4,3203,T
8-NS,406,1,1,3217,0,3219,G
8-NS,407,0,3201,0,2,3203,T
8-NS,408,0,2,3225,0,3227,G
8-NS,409,3238,0,1,0,3239,A
8-NS,410,0,3233,0,3,3236,T
8-NS,411,1,3244,0,3,3248,T
8-NS,412,0,3249,0,1,3250,T
8-NS,413,0,3232,0,0,3232,T
8-NS,414,0,3224,0,8,3232,T
8-NS,415,4,7,3221,0,3232,G
8-NS,416,3208,0,4,0,3212,A
8-NS,417,1,2,0,3198,3201,C
8-NS,418,5,3,0,3179,3187,C
8-NS,419,1,2,3206,1,3210,G
8-NS,420,3416,1,1,0,3418,A
8-NS,421,1,1,0,3494,3496,C
8-NS,422,0,3505,0,2,3507,T
8-NS,423,3525,0,5,0,3530,A
8-NS,424,2,4,3505,0,3511,G
8-NS,425,3518,0,8,0,3526,A
8-NS,426,3,7,3532,0,3542,G
8-NS,427,3524,1,5,0,3530,A
8-NS,428,0,2,0,3604,3606,C
8-NS,429,5,1,0,3419,3425,C
8-NS,430,3298,1,1,0,3300,A
8-NS,431,0,3476,0,3,3479,T
8-NS,432,3462,0,2,1,3465,A
8-NS,433,0,2,3696,0,3698,G
8-NS,434,0,3660,0,1,3661,T
8-NS,435,3661,0,0,0,3661,A
8-NS,436,0,3653,0,8,3661,T
8-NS,437,0,3573,0,1,3574,T
8-NS,438,3670,1,2,0,3673,A
8-NS,439,0,0,0,3671,3671,C
8-NS,440,0,3492,0,7,3499,T
8-NS,441,3480,0,0,0,3480,A
8-NS,442,3170,0,4,0,3174,A
8-NS,443,2,5,3175,0,3182,G
8-NS,444,0,3,3152,0,3155,G
8-NS,445,2,1,3149,0,3152,G
8-NS,446,2,1,1,3104,3108,C
8-NS,447,0,3052,0,7,3059,T
8-NS,448,0,3060,0,4,3064,T
8-NS,449,0,3107,0,1,3108,T
8-NS,450,1,0,0,3136,3137,C
8-NS,451,3159,0,3,0,3162,A
8-NS,452,2,0,0,3179,3181,C
8-NS,453,1,3,1,3132,3137,C
8-NS,454,2,0,3143,0,3145,G
8-NS,455,3125,1,2,0,3128,A
8-NS,456,3125,0,0,0,3125,A
8-NS,457,0,2,3141,0,3143,G
8-NS,458,3096,0,3,0,3099,A
8-NS,459,0,5,3101,1,3107,G
8-NS,460,0,1,3057,0,3058,G
8-NS,461,2,8,3073,0,3083,G
8-NS,462,3081,0,5,0,3086,A
8-NS,463,0,0,3087,0,3087,G
8-NS,464,0,6,0,3067,3073,C
8-NS,465,3084,1,1,0,3086,A
8-NS,466,3080,0,1,0,3081,A
8-NS,467,0,3091,0,1,3092,T
8-NS,468,0,3082,0,0,3082,T
8-NS,469,1,1,3070,0,3072,G
8-NS,470,0,3039,0,1,3040,T
8-NS,471,0,3032,0,3,3035,T
8-NS,472,0,5,3030,0,3035,G
8-NS,473,0,1,3013,1,3015,G
8-NS,474,2,1,1,3013,3017,C
8-NS,475,0,5,3034,0,3039,G
8-NS,476,3039,0,0,0,3039,A
8-NS,477,3063,0,1,0,3064,A
8-NS,478,3075,0,0,0,3075,A
8-NS,479,0,3081,0,1,3082,T
8-NS,480,4,0,0,3078,3082,C
8-NS,481,2,3058,0,6,3066,T
8-NS,482,6,0,0,3081,3087,C
8-NS,483,3090,1,4,0,3095,A
8-NS,484,1,0,0,3084,3085,C
8-NS,485,2,0,0,3078,3080,C
8-NS,486,3054,0,1,0,3055,A
8-NS,487,0,3052,0,2,3054,T
8-NS,488,0,3029,0,1,3030,T
8-NS,489,0,0,3040,0,3040,G
8-NS,490,1,0,0,3015,3016,C
8-NS,491,6,1,0,3006,3013,C
8-NS,492,1,3028,0,9,3038,T
8-NS,493,0,3008,0,3,3011,T
8-NS,494,3,1,0,3042,3046,C
8-NS,495,0,3044,0,6,3050,T
8-NS,496,0,3056,0,0,3056,T
8-NS,497,0,3118,0,3,3121,T
8-NS,498,0,3109,0,1,3110,T
8-NS,499,3,5,0,3099,3107,C
8-NS,500,1,2,1,3096,3100,C
8-NS,501,3085,2,7,0,3094,A
8-NS,502,1,9,3126,0,3136,G
8-NS,503,0,2,3106,0,3108,G
8-NS,504,3168,1,3,0,3172,A
8-NS,505,1,1,0,3176,3178,C
8-NS,506,3160,2,3,0,3165,A
8-NS,507,0,3175,0,3,3178,T
8-NS,508,3172,1,2,0,3175,A
8-NS,509,2,0,0,3400,3402,C
8-NS,510,1,3401,0,3,3405,T
8-NS,511,3376,1,1,0,3378,A
8-NS,512,0,3349,0,4,3353,T
8-NS,513,0,3228,0,4,3232,T
8-NS,514,0,4,3228,0,3232,G
8-NS,515,3092,0,4,0,3096,A
8-NS,516,1,2,3099,0,3102,G
8-NS,517,0,6,3078,0,3084,G
8-NS,518,2788,0,1,0,2789,A
8-NS,519,0,2803,0,0,2803,T
8-NS,520,2,2,2760,0,2764,G
8-NS,521,1,2721,0,3,2725,T
8-NS,522,6,0,0,2754,2760,C
8-NS,523,2765,0,0,0,2765,A
8-NS,524,2767,0,0,0,2767,A
8-NS,525,2771,0,1,0,2772,A
8-NS,526,2757,0,0,0,2757,A
8-NS,527,2770,0,0,0,2770,A
8-NS,528,0,2759,0,0,2759,T
8-NS,529,1,0,2739,0,2740,G
8-NS,530,0,2,0,2767,2769,C
8-NS,531,2777,0,2,0,2779,A
8-NS,532,2799,0,1,0,2800,A
8-NS,533,0,2808,0,1,2809,T
8-NS,534,0,2812,0,0,2812,T
8-NS,535,0,2,2811,0,2813,G
8-NS,536,2,6,2767,0,2775,G
8-NS,537,4,4,2768,0,2776,G
8-NS,538,0,0,2800,0,2800,G
8-NS,539,0,2756,0,4,2760,T
8-NS,540,4,0,0,2768,2772,C
8-NS,541,6,2,0,2783,2791,C
8-NS,542,1,2777,0,3,2781,T
8-NS,543,6,1,0,2819,2826,C
8-NS,544,2826,0,1,0,2827,A
8-NS,545,0,2815,1,4,2820,T
8-NS,546,2,2,0,2834,2838,C
8-NS,547,2,0,2806,0,2808,G
8-NS,548,1,3,2813,1,2818,G
8-NS,549,2755,0,1,0,2756,A
8-NS,550,0,3,2764,0,2767,G
8-NS,551,0,5,2789,0,2794,G
8-NS,552,2748,0,4,0,2752,A
8-NS,553,1,1,0,2786,2788,C
8-NS,554,0,2778,1,3,2782,T
8-NS,555,0,2791,0,0,2791,T
8-NS,556,1,4,2810,1,2816,G
8-NS,557,2794,0,1,0,2795,A
8-NS,558,2800,0,1,0,2801,A
8-NS,559,0,2793,1,0,2794,T
8-NS,560,0,3,2737,1,2741,G
8-NS,561,0,3,2774,0,2777,G
8-NS,562,2732,0,0,0,2732,A
8-NS,563,2781,0,4,0,2785,A
8-NS,564,1,2915,0,0,2916,T
8-NS,565,3,4,2944,0,2951,G
8-NS,566,2971,0,2,0,2973,A
8-NS,567,0,2964,0,0,2964,T
8-NS,568,2957,0,4,0,2961,A
8-NS,569,2972,0,7,0,2979,A
8-NS,570,1,3,0,2937,2941,C
8-NS,571,2889,0,0,0,2889,A
8-NS,572,1,0,0,2916,2917,C
8-NS,573,2670,0,4,0,2674,A
8-NS,574,0,0,2716,0,2716,G
8-NS,575,0,2678,1,4,2683,T
8-NS,576,0,2664,0,1,2665,T
8-NS,577,8,0,0,2677,2685,C
8-NS,578,1,6,2653,0,2660,G
8-NS,579,2634,0,1,0,2635,A
8-NS,580,1,2,2651,0,2654,G
8-NS,581,1,2610,0,2,2613,T
8-NS,582,7,0,0,2619,2626,C
8-NS,583,0,2563,0,2,2565,T
8-NS,584,6,2,0,2584,2592,C
8-NS,585,0,2605,0,3,2608,T
8-NS,586,2614,0,0,0,2614,A
8-NS,587,2613,0,0,0,2613,A
8-NS,588,2606,0,1,0,2607,A
8-NS,589,2639,0,0,0,2639,A
8-NS,590,2629,0,2,0,2631,A
8-NS,591,0,2595,0,2,2597,T
8-NS,592,2,0,0,2629,2631,C
8-NS,593,0,2601,0,2,2603,T
8-NS,594,2626,0,1,0,2627,A
8-NS,595,0,1,0,2625,2626,C
8-NS,596,2618,1,1,1,2621,A
8-NS,597,0,2,2615,0,2617,G
8-NS,598,2566,0,3,0,2569,A
8-NS,599,1,3,2578,0,2582,G
8-NS,600,2561,0,2,0,2563,A
8-NS,601,0,2525,0,1,2526,T
8-NS,602,0,2530,0,2,2532,T
8-NS,603,5,1,0,2535,2541,C
8-NS,604,3,4,2535,0,2542,G
8-NS,605,0,1,0,2539,2540,C
8-NS,606,0,2529,0,3,2532,T
8-NS,607,0,2539,1,0,2540,T
8-NS,608,1,2,2520,0,2523,G
8-NS,609,0,6,2524,0,2530,G
8-NS,610,2535,0,6,0,2541,A
8-NS,611,0,4,2538,1,2543,G
8-NS,612,2521,0,0,0,2521,A
8-NS,613,2506,0,1,0,2507,A
8-NS,614,0,0,2546,0,2546,G
8-NS,615,1,4,0,2545,2550,C
8-NS,616,2548,1,2,0,2551,A
8-NS,617,0,1,2621,0,2622,G
8-NS,618,1,2599,0,0,2600,T
8-NS,619,2616,0,1,0,2617,A
8-NS,620,2616,0,2,0,2618,A
8-NS,621,0,2610,0,1,2611,T
8-NS,622,0,5,2633,0,2638,G
8-NS,623,2534,0,4,0,2538,A
8-NS,624,0,3,2581,0,2584,G
8-NS,625,2556,1,7,0,2564,A
8-NS,626,2476,0,0,0,2476,A
8-NS,627,0,2459,0,2,2461,T
8-NS,628,1,3,2421,0,2425,G
8-NS,629,0,5,2420,0,2425,G
8-NS,630,1,1,2414,0,2416,G
8-NS,631,1,1,2397,0,2399,G
8-NS,632,2,4,2409,0,2415,G
8-NS,633,2346,0,7,0,2353,A
8-NS,634,0,5,0,2392,2397,C
8-NS,635,4,0,1,2389,2394,C
8-NS,636,2,2334,0,5,2341,T
8-NS,637,2,0,0,2374,2376,C
8-NS,638,0,0,0,2384,2384,C
8-NS,639,2383,0,0,0,2383,A
8-NS,640,0,1,1,2387,2389,C
8-NS,641,1,2339,1,2,2343,T
8-NS,642,0,2316,0,1,2317,T
8-NS,643,2231,1,2,0,2234,A
8-NS,644,0,0,0,2248,2248,C
8-NS,645,0,2223,0,3,2226,T
8-NS,646,2,0,0,2229,2231,C
8-NS,647,0,0,0,2225,2225,C
8-NS,648,2223,0,0,0,2223,A
8-NS,649,2234,1,0,0,2235,A
8-NS,650,2232,0,1,0,2233,A
8-NS,651,2234,0,1,0,2235,A
8-NS,652,0,0,0,2244,2244,C
8-NS,653,2194,0,1,0,2195,A
8-NS,654,0,4,2195,0,2199,G
8-NS,655,2185,0,2,0,2187,A
8-NS,656,2193,0,1,1,2195,A
8-NS,657,2186,0,2,0,2188,A
8-NS,658,0,0,0,2188,2188,C
8-NS,659,1,5,2184,0,2190,G
8-NS,660,1,4,2179,0,2184,G
8-NS,661,0,1,2188,0,2189,G
8-NS,662,2194,0,0,0,2194,A
8-NS,663,2166,0,3,0,2169,A
8-NS,664,2166,0,3,1,2170,A
8-NS,665,0,2164,0,1,2165,T
8-NS,666,1,4,2185,0,2190,G
8-NS,667,2,1,2177,0,2180,G
8-NS,668,2,1,1,2154,2158,C
8-NS,669,1,2,2154,0,2157,G
8-NS,670,2159,0,2,0,2161,A
8-NS,671,1,3,2159,0,2163,G
8-NS,672,2164,0,1,0,2165,A
8-NS,673,2156,0,3,0,2159,A
8-NS,674,0,1,0,2164,2165,C
8-NS,675,2116,0,2,0,2118,A
8-NS,676,0,0,2100,0,2100,G
8-NS,677,1,0,0,2090,2091,C
8-NS,678,0,2104,0,3,2107,T
8-NS,679,2107,0,0,0,2107,A
8-NS,680,0,4,2082,0,2086,G
8-NS,681,1,1,2095,0,2097,G
8-NS,682,0,2077,0,3,2080,T
8-NS,683,5,1,0,2045,2051,C
8-NS,684,2063,0,0,0,2063,A
8-NS,685,2056,0,1,0,2057,A
8-NS,686,2055,0,0,0,2055,A
8-NS,687,2068,0,0,0,2068,A
8-NS,688,1,0,2061,0,2062,G
8-NS,689,0,2012,1,2,2015,T
8-NS,690,0,2011,0,0,2011,T
8-NS,691,0,2020,0,1,2021,T
8-NS,692,0,1,2030,0,2031,G
8-NS,693,2029,0,1,0,2030,A
8-NS,694,2026,0,4,0,2030,A
8-NS,695,0,3,2047,0,2050,G
8-NS,696,1990,0,1,0,1991,A
8-NS,697,0,1,2001,0,2002,G
8-NS,698,1995,0,4,0,1999,A
8-NS,699,3,1996,0,2,2001,T
8-NS,700,2003,0,0,0,2003,A
8-NS,701,1987,0,0,0,1987,A
8-NS,702,0,1,1989,0,1990,G
8-NS,703,1836,0,2,0,1838,A
8-NS,704,1,1831,0,0,1832,T
8-NS,705,2,4,1846,0,1852,G
8-NS,706,0,1,1853,0,1854,G
8-NS,707,1,1,0,1843,1845,C
8-NS,708,0,1846,0,3,1849,T
8-NS,709,1850,0,2,0,1852,A
8-NS,710,1848,0,2,0,1850,A
8-NS,711,0,1858,0,0,1858,T
8-NS,712,1,1851,0,2,1854,T
8-NS,713,1,1,1856,0,1858,G
8-NS,714,1826,0,0,0,1826,A
8-NS,715,1823,0,2,0,1825,A
8-NS,716,0,1,1825,0,1826,G
8-NS,717,1824,0,0,0,1824,A
8-NS,718,1804,0,2,0,1806,A
8-NS,719,3,0,1835,0,1838,G
8-NS,720,0,1795,0,1,1796,T
8-NS,721,0,3,1804,0,1807,G
8-NS,722,1795,0,3,0,1798,A
8-NS,723,2,2,1794,0,1798,G
8-NS,724,1802,0,4,0,1806,A
8-NS,725,1,0,0,1788,1789,C
8-NS,726,1775,0,1,0,1776,A
8-NS,727,1,0,0,1774,1775,C
8-NS,728,1624,0,1,0,1625,A
8-NS,729,0,0,1680,0,1680,G
8-NS,730,1675,0,1,0,1676,A
8-NS,731,0,1648,0,3,1651,T
8-NS,732,0,1655,0,1,1656,T
8-NS,733,1651,0,0,0,1651,A
8-NS,734,1651,0,1,0,1652,A
8-NS,735,1652,0,0,0,1652,A
8-NS,736,1648,0,2,0,1650,A
8-NS,737,1651,0,1,0,1652,A
8-NS,738,0,0,0,1587,1587,C
8-NS,739,1519,0,0,0,1519,A
8-NS,740,1534,0,0,0,1534,A
8-NS,741,0,0,0,1529,1529,C
8-NS,742,0,1517,0,1,1518,T
8-NS,743,0,1,1544,0,1545,G
8-NS,744,1532,0,1,0,1533,A
8-NS,745,1540,0,1,0,1541,A
8-NS,746,1538,0,3,0,1541,A
8-NS,747,1512,1,2,0,1515,A
8-NS,748,0,1500,0,1,1501,T
8-NS,749,1480,1,0,0,1481,A
8-NS,750,1,0,1485,0,1486,G
8-NS,751,2,0,0,1485,1487,C
8-NS,752,0,1449,0,1,1450,T
8-NS,753,1,1456,0,0,1457,T
8-NS,754,0,1435,0,1,1436,T
8-NS,755,0,4,1434,1,1439,G
8-NS,756,1432,0,1,0,1433,A
8-NS,757,1447,0,0,0,1447,A
8-NS,758,0,0,0,1446,1446,C
8-NS,759,1409,0,0,0,1409,A
8-NS,760,1428,0,0,0,1428,A
8-NS,761,1431,0,1,0,1432,A
8-NS,762,0,1429,0,1,1430,T
8-NS,763,1433,0,1,0,1434,A
8-NS,764,1415,0,1,0,1416,A
8-NS,765,1,0,0,1414,1415,C
8-NS,766,1409,0,0,0,1409,A
8-NS,767,1,1385,0,2,1388,T
8-NS,768,0,1357,0,1,1358,T
8-NS,769,4,2,0,1338,1344,C
8-NS,770,1333,0,0,0,1333,A
8-NS,771,1,1326,0,1,1328,T
8-NS,772,2,0,1320,0,1322,G
8-NS,773,2,0,0,1290,1292,C
8-NS,774,1272,1,0,0,1273,A
8-NS,775,1277,0,0,0,1277,A
8-NS,776,0,0,1269,0,1269,G
8-NS,777,1,0,0,1294,1295,C
8-NS,778,1271,0,0,0,1271,A
8-NS,779,0,1267,0,6,1273,T
8-NS,780,0,1268,0,2,1270,T
8-NS,781,1263,0,1,0,1264,A
8-NS,782,1,1,0,1263,1265,C
8-NS,783,1254,0,0,0,1254,A
8-NS,784,1243,0,2,0,1245,A
8-NS,785,1,1,0,1233,1235,C
8-NS,786,0,1061,0,2,1063,T
8-NS,787,0,0,1061,0,1061,G
8-NS,788,1,3,0,1035,1039,C
8-NS,789,0,1012,0,1,1013,T
8-NS,790,0,0,1017,0,1017,G
8-NS,791,0,996,0,1,997,T
8-NS,792,0,1000,0,1,1001,T
8-NS,793,0,993,0,0,993,T
8-NS,794,0,2,987,0,989,G
8-NS,795,987,0,3,0,990,A
8-NS,796,979,0,1,0,980,A
8-NS,797,0,0,975,0,975,G
8-NS,798,0,955,0,2,957,T
8-NS,799,0,2,917,0,919,G
8-NS,800,0,0,933,0,933,G
8-NS,801,928,0,1,0,929,A
8-NS,802,925,0,2,0,927,A
8-NS,803,0,0,0,928,928,C
8-NS,804,896,0,1,0,897,A
8-NS,805,0,0,899,0,899,G
8-NS,806,0,0,885,0,885,G
8-NS,807,873,0,0,0,873,A
8-NS,808,0,1,885,0,886,G
8-NS,809,732,0,2,0,734,A
8-NS,810,0,730,0,0,730,T
8-NS,811,728,0,1,0,729,A
8-NS,812,721,0,1,0,722,A
8-NS,813,0,4,713,0,717,G
8-NS,814,650,0,2,0,652,A
8-NS,815,643,0,0,0,643,A
8-NS,816,0,0,0,640,640,C
8-NS,817,0,539,0,1,540,T
8-NS,818,0,538,0,0,538,T
8-NS,819,0,535,0,3,538,T
8-NS,820,1,0,0,532,533,C
8-NS,821,0,526,0,0,526,T
8-NS,822,2,0,0,517,519,C
8-NS,823,510,0,0,0,510,A
8-NS,824,0,506,0,0,506,T
8-NS,825,0,500,0,1,501,T
8-NS,826,0,496,0,0,496,T
8-NS,827,0,0,0,485,485,C
8-NS,828,472,0,0,0,472,A
8-NS,829,0,0,467,0,467,G
8-NS,830,0,0,0,466,466,C
8-NS,831,0,437,0,1,438,T
8-NS,832,0,439,0,0,439,T
8-NS,833,426,0,1,0,427,A
8-NS,834,0,426,0,0,426,T
8-NS,835,0,423,0,0,423,T
8-NS,836,0,419,1,0,420,T
8-NS,837,408,0,0,0,408,A
8-NS,838,390,0,0,0,390,A
8-NS,839,0,381,0,0,381,T
8-NS,840,0,1,381,0,382,G
8-NS,841,370,0,2,0,372,A
8-NS,842,0,329,0,0,329,T
8-NS,843,325,0,0,0,325,A
8-NS,844,325,0,0,0,325,A
8-NS,845,322,0,0,0,322,A
8-NS,846,323,0,0,0,323,A
8-NS,847,313,0,1,0,314,A
8-NS,848,311,0,1,0,312,A
8-NS,849,0,0,0,309,309,C
8-NS,850,255,0,0,0,255,A
8-NS,851,0,0,0,265,265,C
8-NS,852,2,0,0,258,260,C
8-NS,853,0,0,0,246,246,C
8-NS,854,0,232,0,0,232,T
8-NS,855,0,224,0,0,224,T
8-NS,856,0,0,224,0,224,G
8-NS,857,0,213,0,0,213,T
8-NS,858,0,210,0,0,210,T
8-NS,859,0,199,0,0,199,T
8-NS,860,0,0,0,77,77,C
8-NS,861,0,54,0,0,54,T
8-NS,862,48,0,0,0,48,A
8-NS,863,0,0,0,48,48,C
