Gene,Position,A,T,G,C,Coverage,Consensus
1-PB2,1,837,0,0,0,837,A
1-PB2,2,0,837,0,0,837,T
1-PB2,3,0,0,863,0,863,G
1-PB2,4,0,1,864,0,865,G
1-PB2,5,865,0,1,0,866,A
1-PB2,6,865,0,1,0,866,A
1-PB2,7,864,0,3,0,867,A
1-PB2,8,1,0,959,0,960,G
1-PB2,9,966,0,1,0,967,A
1-PB2,10,971,0,3,0,974,A
1-PB2,11,0,995,0,1,996,T
1-PB2,12,998,0,0,0,998,A
1-PB2,13,1001,0,1,0,1002,A
1-PB2,14,1003,0,0,0,1003,A
1-PB2,15,1003,0,2,0,1005,A
1-PB2,16,0,3,1040,0,1043,G
1-PB2,17,1042,0,0,0,1042,A
1-PB2,18,1042,0,1,1,1044,A
1-PB2,19,0,0,0,1061,1061,C
1-PB2,20,0,1061,0,1,1062,T
1-PB2,21,1083,0,1,0,1084,A
1-PB2,22,0,0,0,1085,1085,C
1-PB2,23,1,1,1084,0,1086,G
1-PB2,24,0,1,1101,0,1102,G
1-PB2,25,1109,0,0,1,1110,A
1-PB2,26,1143,0,0,0,1143,A
1-PB2,27,0,1145,0,1,1146,T
1-PB2,28,3,0,0,1153,1156,C
1-PB2,29,0,1157,0,2,1159,T
1-PB2,30,1,2,1162,0,1165,G
1-PB2,31,1169,0,0,0,1169,A
1-PB2,32,0,1170,1,0,1171,T
1-PB2,33,1,0,1171,0,1172,G
1-PB2,34,1,1185,0,3,1189,T
1-PB2,35,0,0,0,1184,1184,C
1-PB2,36,2,0,1182,0,1184,G
1-PB2,37,0,0,0,1188,1188,C
1-PB2,38,1186,0,0,0,1186,A
1-PB2,39,1,0,1262,0,1263,G
1-PB2,40,0,1267,0,0,1267,T
1-PB2,41,1,0,0,1266,1267,C
1-PB2,42,0,1254,0,7,1261,T
1-PB2,43,2,1,0,1264,1267,C
1-PB2,44,0,0,1265,0,1265,G
1-PB2,45,1,1,0,1264,1266,C
1-PB2,46,1268,0,1,0,1269,A
1-PB2,47,1,3,0,1287,1291,C
1-PB2,48,0,1277,0,5,1282,T
1-PB2,49,3,0,0,1315,1318,C
1-PB2,50,1,1,1320,0,1322,G
1-PB2,51,1,0,0,1322,1323,C
1-PB2,52,1,1,1325,0,1327,G
1-PB2,53,1326,0,0,0,1326,A
1-PB2,54,1,0,1339,0,1340,G
1-PB2,55,1377,0,3,0,1380,A
1-PB2,56,0,1380,0,0,1380,T
1-PB2,57,1382,0,1,0,1383,A
1-PB2,58,1,0,0,1385,1386,C
1-PB2,59,0,1371,0,2,1373,T
1-PB2,60,1,5,1415,0,1421,G
1-PB2,61,1423,0,0,0,1423,A
1-PB2,62,0,1,0,1437,1438,C
1-PB2,63,1439,0,1,0,1440,A
1-PB2,64,1440,0,0,0,1440,A
1-PB2,65,1468,0,1,0,1469,A
1-PB2,66,1494,0,0,0,1494,A
1-PB2,67,1486,0,5,0,1491,A
1-PB2,68,2,1,0,1500,1503,C
1-PB2,69,2,1,0,1501,1504,C
1-PB2,70,1535,0,3,0,1538,A
1-PB2,71,0,1,0,1557,1558,C
1-PB2,72,1552,0,4,0,1556,A
1-PB2,73,0,1,1620,0,1621,G
1-PB2,74,1,1615,0,1,1617,T
1-PB2,75,1,3,1667,0,1671,G
1-PB2,76,1,0,1686,0,1687,G
1-PB2,77,1686,1,0,0,1687,A
1-PB2,78,0,1,0,1759,1760,C
1-PB2,79,4,1,0,1750,1755,C
1-PB2,80,1782,0,0,2,1784,A
1-PB2,81,0,1788,0,1,1789,T
1-PB2,82,1765,2,0,0,1767,A
1-PB2,83,0,1767,0,1,1768,T
1-PB2,84,1,2,1784,0,1787,G
1-PB2,85,1,0,1802,0,1803,G
1-PB2,86,0,1,0,1806,1807,C
1-PB2,87,2,1,0,1778,1781,C
1-PB2,88,1776,0,1,0,1777,A
1-PB2,89,0,1919,0,2,1921,T
1-PB2,90,1922,0,0,0,1922,A
1-PB2,91,2014,0,7,0,2021,A
1-PB2,92,0,2025,0,0,2025,T
1-PB2,93,0,2001,0,7,2008,T
1-PB2,94,2032,0,1,0,2033,A
1-PB2,95,2022,1,4,0,2027,A
1-PB2,96,0,3,2069,0,2072,G
1-PB2,97,2066,0,2,0,2068,A
1-PB2,98,2042,0,2,0,2044,A
1-PB2,99,0,0,2137,0,2137,G
1-PB2,100,0,2109,0,2,2111,T
1-PB2,101,2117,0,1,0,2118,A
1-PB2,102,0,1,0,2120,2121,C
1-PB2,103,2121,0,6,1,2128,A
1-PB2,104,0,0,0,2183,2183,C
1-PB2,105,2177,0,2,0,2179,A
1-PB2,106,0,2183,0,1,2184,T
1-PB2,107,1,0,0,2192,2193,C
1-PB2,108,0,10,2158,0,2168,G
1-PB2,109,0,4,2167,0,2171,G
1-PB2,110,0,2,2167,0,2169,G
1-PB2,111,0,1,2170,0,2171,G
1-PB2,112,2152,1,7,0,2160,A
1-PB2,113,0,2,2173,0,2175,G
1-PB2,114,2169,1,1,0,2171,A
1-PB2,115,1,1,0,2201,2203,C
1-PB2,116,2193,1,3,1,2198,A
1-PB2,117,1,0,2226,0,2227,G
1-PB2,118,1,3,2265,1,2270,G
1-PB2,119,2274,0,3,0,2277,A
1-PB2,120,2271,0,5,0,2276,A
1-PB2,121,2276,1,3,0,2280,A
1-PB2,122,2262,0,7,0,2269,A
1-PB2,123,2,1,2269,0,2272,G
1-PB2,124,2249,2,4,0,2255,A
1-PB2,125,2259,0,5,0,2264,A
1-PB2,126,1,2,0,2255,2258,C
1-PB2,127,1,0,0,2240,2241,C
1-PB2,128,4,2,0,2238,2244,C
1-PB2,129,0,0,2253,0,2253,G
1-PB2,130,2,2238,0,5,2245,T
1-PB2,131,2,2,2,2249,2255,C
1-PB2,132,2277,0,0,0,2277,A
1-PB2,133,1,0,0,2299,2300,C
1-PB2,134,0,2295,1,2,2298,T
1-PB2,135,0,2291,0,0,2291,T
1-PB2,136,2290,0,4,1,2295,A
1-PB2,137,1,1,2333,0,2335,G
1-PB2,138,0,2,2336,0,2338,G
1-PB2,139,2330,2,1,0,2333,A
1-PB2,140,0,2338,0,0,2338,T
1-PB2,141,1,4,2362,0,2367,G
1-PB2,142,2389,0,3,0,2392,A
1-PB2,143,2393,0,3,0,2396,A
1-PB2,144,2398,0,3,0,2401,A
1-PB2,145,0,2399,0,1,2400,T
1-PB2,146,1,3,2391,0,2395,G
1-PB2,147,0,3,2406,0,2409,G
1-PB2,148,2403,0,3,0,2406,A
1-PB2,149,0,2411,0,0,2411,T
1-PB2,150,1,1,2387,2,2391,G
1-PB2,151,2361,0,4,0,2365,A
1-PB2,152,0,2381,0,0,2381,T
1-PB2,153,3,3,2383,1,2390,G
1-PB2,154,5,0,2387,0,2392,G
1-PB2,155,0,2,0,2402,2404,C
1-PB2,156,2378,1,3,1,2383,A
1-PB2,157,2412,0,3,1,2416,A
1-PB2,158,0,2422,0,0,2422,T
1-PB2,159,8,1,2489,0,2498,G
1-PB2,160,2491,0,0,1,2492,A
1-PB2,161,2485,0,1,1,2487,A
1-PB2,162,2490,0,6,0,2496,A
1-PB2,163,0,2498,0,2,2500,T
1-PB2,164,2504,0,2,0,2506,A
1-PB2,165,0,0,0,2561,2561,C
1-PB2,166,3,3,0,2538,2544,C
1-PB2,167,7,0,0,2549,2556,C
1-PB2,168,2549,0,1,1,2551,A
1-PB2,169,2545,2,0,0,2547,A
1-PB2,170,0,2544,0,0,2544,T
1-PB2,171,2,1,0,2546,2549,C
1-PB2,172,2546,1,1,0,2548,A
1-PB2,173,0,0,0,2592,2592,C
1-PB2,174,0,2563,0,4,2567,T
1-PB2,175,0,1,2579,0,2580,G
1-PB2,176,1,0,2,2572,2575,C
1-PB2,177,0,2565,0,3,2568,T
1-PB2,178,0,3,2589,1,2593,G
1-PB2,179,2596,0,2,0,2598,A
1-PB2,180,0,0,0,2617,2617,C
1-PB2,181,2614,0,2,0,2616,A
1-PB2,182,2581,0,2,0,2583,A
1-PB2,183,2591,0,2,0,2593,A
1-PB2,184,2588,0,5,0,2593,A
1-PB2,185,1,2,2653,1,2657,G
1-PB2,186,0,0,2650,0,2650,G
1-PB2,187,2630,1,3,1,2635,A
1-PB2,188,1,2648,0,2,2651,T
1-PB2,189,2631,0,0,0,2631,A
1-PB2,190,2649,1,3,0,2653,A
1-PB2,191,1,1,0,2680,2682,C
1-PB2,192,2672,0,1,1,2674,A
1-PB2,193,1,4,2677,0,2682,G
1-PB2,194,2650,0,2,1,2653,A
1-PB2,195,2654,0,2,0,2656,A
1-PB2,196,2646,1,5,0,2652,A
1-PB2,197,2,2654,0,2,2658,T
1-PB2,198,1,8,2644,2,2655,G
1-PB2,199,1,1,2694,0,2696,G
1-PB2,200,1,2686,0,4,2691,T
1-PB2,201,1,2680,0,5,2686,T
1-PB2,202,7,0,0,2667,2674,C
1-PB2,203,1,2,1,2677,2681,C
1-PB2,204,2674,2,2,0,2678,A
1-PB2,205,0,3,2689,0,2692,G
1-PB2,206,2688,0,3,0,2691,A
1-PB2,207,4,0,2697,0,2701,G
1-PB2,208,2649,0,4,0,2653,A
1-PB2,209,0,1,2696,0,2697,G
1-PB2,210,2704,0,1,0,2705,A
1-PB2,211,2698,1,3,0,2702,A
1-PB2,212,2700,0,4,2,2706,A
1-PB2,213,0,2697,0,1,2698,T
1-PB2,214,0,8,2704,0,2712,G
1-PB2,215,2718,0,2,0,2720,A
1-PB2,216,2708,0,4,0,2712,A
1-PB2,217,1,1,0,2708,2710,C
1-PB2,218,2672,0,2,0,2674,A
1-PB2,219,2688,0,3,0,2691,A
1-PB2,220,0,3,2741,0,2744,G
1-PB2,221,2,1,2759,0,2762,G
1-PB2,222,2758,3,4,0,2765,A
1-PB2,223,1,0,0,2753,2754,C
1-PB2,224,2754,0,2,0,2756,A
1-PB2,225,2751,0,6,0,2757,A
1-PB2,226,2858,1,7,0,2866,A
1-PB2,227,0,0,0,2878,2878,C
1-PB2,228,0,2834,1,8,2843,T
1-PB2,229,4,0,0,2908,2912,C
1-PB2,230,0,2843,0,11,2854,T
1-PB2,231,2876,0,0,0,2876,A
1-PB2,232,0,2866,0,0,2866,T
1-PB2,233,2,6,2866,0,2874,G
1-PB2,234,0,8,2934,0,2942,G
1-PB2,235,2816,2,3,0,2821,A
1-PB2,236,0,1,2854,0,2855,G
1-PB2,237,1,2849,0,2,2852,T
1-PB2,238,2835,0,1,0,2836,A
1-PB2,239,2843,1,2,0,2846,A
1-PB2,240,2829,0,11,0,2840,A
1-PB2,241,2839,0,2,0,2841,A
1-PB2,242,0,2828,3,1,2832,T
1-PB2,243,0,6,2820,0,2826,G
1-PB2,244,2781,0,2,0,2783,A
1-PB2,245,1,2,2793,0,2796,G
1-PB2,246,0,2779,0,2,2781,T
1-PB2,247,0,1,2775,0,2776,G
1-PB2,248,2818,0,0,0,2818,A
1-PB2,249,0,2837,0,2,2839,T
1-PB2,250,1,0,2834,0,2835,G
1-PB2,251,2,0,0,2829,2831,C
1-PB2,252,0,2818,0,5,2823,T
1-PB2,253,1,5,2902,0,2908,G
1-PB2,254,1,4,2910,0,2915,G
1-PB2,255,2942,1,5,0,2948,A
1-PB2,256,0,2943,0,5,2948,T
1-PB2,257,5,1,0,2939,2945,C
1-PB2,258,2958,0,1,0,2959,A
1-PB2,259,2,0,3019,0,3021,G
1-PB2,260,3024,0,4,0,3028,A
1-PB2,261,0,3031,0,2,3033,T
1-PB2,262,2933,0,3,0,2936,A
1-PB2,263,0,5,3020,0,3025,G
1-PB2,264,2991,0,5,0,2996,A
1-PB2,265,2,3,3040,0,3045,G
1-PB2,266,0,3007,0,2,3009,T
1-PB2,267,1,4,2985,0,2990,G
1-PB2,268,2932,1,0,0,2933,A
1-PB2,269,0,2940,0,2,2942,T
1-PB2,270,2,6,2987,0,2995,G
1-PB2,271,3,0,3055,0,3058,G
1-PB2,272,0,3003,0,2,3005,T
1-PB2,273,3000,0,3,1,3004,A
1-PB2,274,1,2944,0,6,2951,T
1-PB2,275,4,2,0,2949,2955,C
1-PB2,276,2998,1,3,0,3002,A
1-PB2,277,2,1,0,3055,3058,C
1-PB2,278,3,1,0,3055,3059,C
1-PB2,279,0,2988,0,3,2991,T
1-PB2,280,0,2955,2,11,2968,T
1-PB2,281,1,2978,0,1,2980,T
1-PB2,282,0,4,3039,0,3043,G
1-PB2,283,0,0,3050,0,3050,G
1-PB2,284,0,0,0,3069,3069,C
1-PB2,285,1,3023,0,6,3030,T
1-PB2,286,0,1,3041,0,3042,G
1-PB2,287,0,3044,0,4,3048,T
1-PB2,288,3048,0,8,0,3056,A
1-PB2,289,3065,0,3,0,3068,A
1-PB2,290,0,2,1,3060,3063,C
1-PB2,291,3025,0,0,0,3025,A
1-PB2,292,1,3023,0,3,3027,T
1-PB2,293,1,5,2981,0,2987,G
1-PB2,294,3,5,3030,0,3038,G
1-PB2,295,1,3020,0,2,3023,T
1-PB2,296,2,4,3011,0,3017,G
1-PB2,297,0,3,3056,0,3059,G
1-PB2,298,3059,1,3,0,3063,A
1-PB2,299,3078,0,1,0,3079,A
1-PB2,300,0,3077,0,0,3077,T
1-PB2,301,3077,0,1,0,3078,A
1-PB2,302,0,0,3135,0,3135,G
1-PB2,303,3094,0,1,0,3095,A
1-PB2,304,3095,0,6,0,3101,A
1-PB2,305,3104,0,2,0,3106,A
1-PB2,306,0,3056,1,0,3057,T
1-PB2,307,2,8,3041,1,3052,G
1-PB2,308,1,7,3036,1,3045,G
1-PB2,309,3051,1,4,1,3057,A
1-PB2,310,0,2,0,3059,3061,C
1-PB2,311,5,1,0,3021,3027,C
1-PB2,312,10,1,0,3018,3029,C
1-PB2,313,4,1,3042,0,3047,G
1-PB2,314,1,3053,0,6,3060,T
1-PB2,315,1,5,3123,0,3129,G
1-PB2,316,3128,1,5,0,3134,A
1-PB2,317,0,0,0,3145,3145,C
1-PB2,318,3153,0,2,0,3155,A
1-PB2,319,3144,1,1,0,3146,A
1-PB2,320,0,1,3219,0,3220,G
1-PB2,321,1,3209,0,0,3210,T
1-PB2,322,3202,0,1,0,3203,A
1-PB2,323,1,1,0,3186,3188,C
1-PB2,324,2,8,3127,0,3137,G
1-PB2,325,0,0,3227,0,3227,G
1-PB2,326,2,3214,0,4,3220,T
1-PB2,327,5,1,0,3252,3258,C
1-PB2,328,5,2,0,3256,3263,C
1-PB2,329,3211,1,2,0,3214,A
1-PB2,330,0,3223,0,3,3226,T
1-PB2,331,0,3229,1,2,3232,T
1-PB2,332,3392,0,1,0,3393,A
1-PB2,333,2,10,0,3361,3373,C
1-PB2,334,4,1,0,3293,3298,C
1-PB2,335,7,0,0,3285,3292,C
1-PB2,336,3270,0,2,0,3272,A
1-PB2,337,3301,0,1,0,3302,A
1-PB2,338,3297,0,1,0,3298,A
1-PB2,339,3288,0,1,1,3290,A
1-PB2,340,1,1,3323,0,3325,G
1-PB2,341,0,3219,0,1,3220,T
1-PB2,342,1,0,3269,1,3271,G
1-PB2,343,0,3273,0,3,3276,T
1-PB2,344,3269,0,5,0,3274,A
1-PB2,345,2,0,0,3270,3272,C
1-PB2,346,3259,0,0,0,3259,A
1-PB2,347,3258,1,4,0,3263,A
1-PB2,348,0,2,3289,0,3291,G
1-PB2,349,3249,1,5,0,3255,A
1-PB2,350,0,1,0,3258,3259,C
1-PB2,351,2,3190,0,4,3196,T
1-PB2,352,0,3213,0,8,3221,T
1-PB2,353,3221,0,0,0,3221,A
1-PB2,354,0,3216,0,2,3218,T
1-PB2,355,1,3218,0,3,3222,T
1-PB2,356,2,3210,0,1,3213,T
1-PB2,357,5,0,0,3185,3190,C
1-PB2,358,2,7,3184,1,3194,G
1-PB2,359,3180,0,11,0,3191,A
1-PB2,360,2,2,0,3188,3192,C
1-PB2,361,3165,0,1,0,3166,A
1-PB2,362,3175,0,1,0,3176,A
1-PB2,363,3164,0,4,0,3168,A
1-PB2,364,5,1,3208,1,3215,G
1-PB2,365,0,3208,0,1,3209,T
1-PB2,366,3,0,0,3209,3212,C
1-PB2,367,1,4,3216,0,3221,G
1-PB2,368,3214,0,2,0,3216,A
1-PB2,369,3206,0,6,0,3212,A
1-PB2,370,3213,0,3,0,3216,A
1-PB2,371,1,6,3314,1,3322,G
1-PB2,372,0,1,3337,0,3338,G
1-PB2,373,0,3307,0,2,3309,T
1-PB2,374,3,3299,0,3,3305,T
1-PB2,375,3306,0,2,0,3308,A
1-PB2,376,3298,0,7,0,3305,A
1-PB2,377,3308,1,1,0,3310,A
1-PB2,378,3332,0,4,3,3339,A
1-PB2,379,2,0,0,3365,3367,C
1-PB2,380,3297,1,3,0,3301,A
1-PB2,381,0,3288,0,4,3292,T
1-PB2,382,0,4,3275,0,3279,G
1-PB2,383,2,7,3274,0,3283,G
1-PB2,384,3279,0,4,0,3283,A
1-PB2,385,3300,0,9,1,3310,A
1-PB2,386,1,0,1,3374,3376,C
1-PB2,387,8,1,0,3411,3420,C
1-PB2,388,0,3386,1,4,3391,T
1-PB2,389,0,3392,0,3,3395,T
1-PB2,390,0,3396,0,4,3400,T
1-PB2,391,1,2,3380,0,3383,G
1-PB2,392,1,3,3397,0,3401,G
1-PB2,393,1,1,0,3410,3412,C
1-PB2,394,3,3,0,3388,3394,C
1-PB2,395,3,1,0,3365,3369,C
1-PB2,396,1,3282,0,4,3287,T
1-PB2,397,0,0,3324,0,3324,G
1-PB2,398,1,3316,1,6,3324,T
1-PB2,399,2,3318,0,5,3325,T
1-PB2,400,5,1,0,3328,3334,C
1-PB2,401,3307,0,0,0,3307,A
1-PB2,402,1,3298,1,2,3302,T
1-PB2,403,0,3294,0,1,3295,T
1-PB2,404,0,3301,0,1,3302,T
1-PB2,405,0,3300,1,1,3302,T
1-PB2,406,3257,0,3,0,3260,A
1-PB2,407,0,3,3255,0,3258,G
1-PB2,408,3247,0,3,0,3250,A
1-PB2,409,3252,0,3,0,3255,A
1-PB2,410,3250,0,1,0,3251,A
1-PB2,411,0,3243,0,0,3243,T
1-PB2,412,3,2,0,3245,3250,C
1-PB2,413,3243,1,5,0,3249,A
1-PB2,414,3275,0,5,0,3280,A
1-PB2,415,1,1,3296,1,3299,G
1-PB2,416,1,3289,0,2,3292,T
1-PB2,417,10,1,1,3286,3298,C
1-PB2,418,3313,1,1,0,3315,A
1-PB2,419,3321,0,2,0,3323,A
1-PB2,420,4,1,3325,0,3330,G
1-PB2,421,3319,0,10,0,3329,A
1-PB2,422,1,3317,0,2,3320,T
1-PB2,423,3347,1,2,0,3350,A
1-PB2,424,0,2,0,3342,3344,C
1-PB2,425,2,0,3340,1,3343,G
1-PB2,426,0,2,0,3430,3432,C
1-PB2,427,3407,1,2,0,3410,A
1-PB2,428,0,1,3442,0,3443,G
1-PB2,429,3432,0,1,0,3433,A
1-PB2,430,3442,1,5,0,3448,A
1-PB2,431,2,4,3497,1,3504,G
1-PB2,432,3444,2,3,0,3449,A
1-PB2,433,1,1,3457,0,3459,G
1-PB2,434,0,3434,0,0,3434,T
1-PB2,435,3404,0,5,0,3409,A
1-PB2,436,2,2,3449,0,3453,G
1-PB2,437,3410,0,6,0,3416,A
1-PB2,438,1,3,1,3516,3521,C
1-PB2,439,3472,0,0,0,3472,A
1-PB2,440,0,3404,0,0,3404,T
1-PB2,441,3383,0,3,0,3386,A
1-PB2,442,3375,0,10,0,3385,A
1-PB2,443,3400,0,1,0,3401,A
1-PB2,444,0,0,0,3413,3413,C
1-PB2,445,4,2,0,3357,3363,C
1-PB2,446,7,0,0,3307,3314,C
1-PB2,447,0,3037,1,5,3043,T
1-PB2,448,0,4,3052,0,3056,G
1-PB2,449,1,2,3093,0,3096,G
1-PB2,450,1,3095,1,3,3100,T
1-PB2,451,13,0,1,3073,3087,C
1-PB2,452,3115,0,0,0,3115,A
1-PB2,453,0,3092,2,3,3097,T
1-PB2,454,0,1,3115,0,3116,G
1-PB2,455,0,0,0,3111,3111,C
1-PB2,456,3088,0,3,1,3092,A
1-PB2,457,2,5,3105,0,3112,G
1-PB2,458,3032,0,3,0,3035,A
1-PB2,459,0,0,0,3074,3074,C
1-PB2,460,1,0,0,3063,3064,C
1-PB2,461,1,3001,1,4,3007,T
1-PB2,462,4,0,0,3003,3007,C
1-PB2,463,2981,0,1,0,2982,A
1-PB2,464,0,0,3046,0,3046,G
1-PB2,465,0,3023,0,3,3026,T
1-PB2,466,1,2,3026,0,3029,G
1-PB2,467,5,2,0,3021,3028,C
1-PB2,468,7,2,1,2996,3006,C
1-PB2,469,3000,1,3,0,3004,A
1-PB2,470,3013,0,0,0,3013,A
1-PB2,471,2993,0,6,0,2999,A
1-PB2,472,1,0,3014,0,3015,G
1-PB2,473,2930,1,3,1,2935,A
1-PB2,474,1,3,2948,0,2952,G
1-PB2,475,0,0,2952,0,2952,G
1-PB2,476,0,0,1,2947,2948,C
1-PB2,477,2952,1,5,0,2958,A
1-PB2,478,1,1,0,2955,2957,C
1-PB2,479,2952,1,1,1,2955,A
1-PB2,480,3034,0,6,0,3040,A
1-PB2,481,2,2,3062,0,3066,G
1-PB2,482,3110,1,6,0,3117,A
1-PB2,483,0,3093,0,1,3094,T
1-PB2,484,2,0,3094,0,3096,G
1-PB2,485,1,3097,0,1,3099,T
1-PB2,486,3109,0,2,0,3111,A
1-PB2,487,3112,0,3,0,3115,A
1-PB2,488,0,3119,1,2,3122,T
1-PB2,489,0,3020,0,0,3020,T
1-PB2,490,2991,1,0,0,2992,A
1-PB2,491,1,2919,0,2,2922,T
1-PB2,492,2,2,2916,0,2920,G
1-PB2,493,2,4,2905,0,2911,G
1-PB2,494,2891,0,3,0,2894,A
1-PB2,495,2884,0,0,0,2884,A
1-PB2,496,0,0,2885,0,2885,G
1-PB2,497,0,2879,0,1,2880,T
1-PB2,498,2,2881,0,2,2885,T
1-PB2,499,0,0,2901,0,2901,G
1-PB2,500,2,2883,0,2,2887,T
1-PB2,501,1,2888,0,0,2889,T
1-PB2,502,0,2877,0,8,2885,T
1-PB2,503,0,2884,0,2,2886,T
1-PB2,504,0,2883,0,12,2895,T
1-PB2,505,5,0,0,2880,2885,C
1-PB2,506,2,0,0,2885,2887,C
1-PB2,507,5,0,0,2898,2903,C
1-PB2,508,2888,1,2,0,2891,A
1-PB2,509,2899,0,2,0,2901,A
1-PB2,510,1,2900,0,5,2906,T
1-PB2,511,1,4,2923,0,2928,G
1-PB2,512,2924,1,3,0,2928,A
1-PB2,513,2908,1,1,0,2910,A
1-PB2,514,1,0,2937,0,2938,G
1-PB2,515,1,2920,0,1,2922,T
1-PB2,516,2,6,2906,0,2914,G
1-PB2,517,2,7,2900,0,2909,G
1-PB2,518,1,3,2902,0,2906,G
1-PB2,519,2931,0,0,0,2931,A
1-PB2,520,2,1,2927,0,2930,G
1-PB2,521,1,2,1,2927,2931,C
1-PB2,522,4,1,1,2941,2947,C
1-PB2,523,2923,1,5,0,2929,A
1-PB2,524,3,3,3008,0,3014,G
1-PB2,525,0,2,3022,0,3024,G
1-PB2,526,3027,1,3,0,3031,A
1-PB2,527,0,3002,0,1,3003,T
1-PB2,528,3008,0,4,1,3013,A
1-PB2,529,1,0,0,3004,3005,C
1-PB2,530,1,2987,0,0,2988,T
1-PB2,531,2986,1,1,0,2988,A
1-PB2,532,2981,0,1,0,2982,A
1-PB2,533,1,0,0,3017,3018,C
1-PB2,534,2929,0,1,0,2930,A
1-PB2,535,1,2901,0,7,2909,T
1-PB2,536,2,1,0,2909,2912,C
1-PB2,537,2858,0,2,1,2861,A
1-PB2,538,0,4,2886,0,2890,G
1-PB2,539,2886,1,1,0,2888,A
1-PB2,540,2891,0,1,0,2892,A
1-PB2,541,0,2884,0,5,2889,T
1-PB2,542,2,1,0,2837,2840,C
1-PB2,543,2841,0,4,0,2845,A
1-PB2,544,0,1,0,2902,2903,C
1-PB2,545,2896,0,3,1,2900,A
1-PB2,546,2922,2,0,0,2924,A
1-PB2,547,1,2886,1,2,2890,T
1-PB2,548,0,2897,0,4,2901,T
1-PB2,549,2907,2,0,0,2909,A
1-PB2,550,2929,1,5,0,2935,A
1-PB2,551,1,0,0,2951,2952,C
1-PB2,552,2932,0,2,0,2934,A
1-PB2,553,2903,0,1,0,2904,A
1-PB2,554,1,2913,0,1,2915,T
1-PB2,555,2911,0,1,0,2912,A
1-PB2,556,2917,0,3,0,2920,A
1-PB2,557,0,0,0,2921,2921,C
1-PB2,558,1,2906,0,3,2910,T
1-PB2,559,2901,0,2,0,2903,A
1-PB2,560,2887,0,1,0,2888,A
1-PB2,561,2887,0,4,0,2891,A
1-PB2,562,1,5,2890,0,2896,G
1-PB2,563,2836,0,5,2,2843,A
1-PB2,564,0,1,2864,0,2865,G
1-PB2,565,2845,0,2,1,2848,A
1-PB2,566,2844,0,3,0,2847,A
1-PB2,567,2845,0,1,0,2846,A
1-PB2,568,2841,0,2,0,2843,A
1-PB2,569,2859,0,2,0,2861,A
1-PB2,570,2856,0,4,0,2860,A
1-PB2,571,2,5,2860,1,2868,G
1-PB2,572,2863,0,2,0,2865,A
1-PB2,573,2838,0,3,0,2841,A
1-PB2,574,1,2,2848,0,2851,G
1-PB2,575,2846,0,2,0,2848,A
1-PB2,576,2855,0,3,0,2858,A
1-PB2,577,0,2,0,2870,2872,C
1-PB2,578,2,2836,1,2,2841,T
1-PB2,579,6,0,2,2846,2854,C
1-PB2,580,3,1,0,2846,2850,C
1-PB2,581,4,7,2848,0,2859,G
1-PB2,582,2851,1,2,0,2854,A
1-PB2,583,1,3,2853,0,2857,G
1-PB2,584,2847,1,0,0,2848,A
1-PB2,585,0,2834,0,2,2836,T
1-PB2,586,0,2818,0,2,2820,T
1-PB2,587,4,0,2821,1,2826,G
1-PB2,588,0,2,0,2817,2819,C
1-PB2,589,2833,0,0,0,2833,A
1-PB2,590,2833,0,0,0,2833,A
1-PB2,591,2838,0,1,0,2839,A
1-PB2,592,2859,0,0,0,2859,A
1-PB2,593,0,2854,0,1,2855,T
1-PB2,594,1,2841,0,1,2843,T
1-PB2,595,0,2838,0,4,2842,T
1-PB2,596,3,0,1,2833,2837,C
1-PB2,597,0,2808,0,9,2817,T
1-PB2,598,5,0,0,2896,2901,C
1-PB2,599,1,0,2,2898,2901,C
1-PB2,600,10,0,0,2988,2998,C
1-PB2,601,0,2973,1,4,2978,T
1-PB2,602,0,3007,1,2,3010,T
1-PB2,603,5,1,3018,0,3024,G
1-PB2,604,3019,0,2,1,3022,A
1-PB2,605,1,3035,0,2,3038,T
1-PB2,606,0,0,3073,0,3073,G
1-PB2,607,0,3,3196,0,3199,G
1-PB2,608,0,3231,0,9,3240,T
1-PB2,609,0,3188,0,3,3191,T
1-PB2,610,1,1,3340,0,3342,G
1-PB2,611,1,9,0,3329,3339,C
1-PB2,612,3369,0,3,0,3372,A
1-PB2,613,0,3366,0,3,3369,T
1-PB2,614,3370,0,1,7,3378,A
1-PB2,615,1,1,0,3485,3487,C
1-PB2,616,3633,1,0,7,3641,A
1-PB2,617,1,3674,1,3,3679,T
1-PB2,618,0,2,3803,0,3805,G
1-PB2,619,1,3735,0,2,3738,T
1-PB2,620,0,3726,0,5,3731,T
1-PB2,621,3709,0,5,0,3714,A
1-PB2,622,0,5,3707,0,3712,G
1-PB2,623,3732,0,6,0,3738,A
1-PB2,624,0,6,3766,0,3772,G
1-PB2,625,3541,0,6,0,3547,A
1-PB2,626,1,6,3545,0,3552,G
1-PB2,627,3457,0,5,0,3462,A
1-PB2,628,2,8,3470,0,3480,G
1-PB2,629,3490,0,6,0,3496,A
1-PB2,630,3501,0,2,1,3504,A
1-PB2,631,3,1,1,3508,3513,C
1-PB2,632,0,3481,1,5,3487,T
1-PB2,633,0,3467,0,0,3467,T
1-PB2,634,0,0,3473,0,3473,G
1-PB2,635,0,3466,0,2,3468,T
1-PB2,636,3470,0,3,0,3473,A
1-PB2,637,2,4,0,3447,3453,C
1-PB2,638,1,2,3448,0,3451,G
1-PB2,639,3458,1,2,0,3461,A
1-PB2,640,3438,0,0,0,3438,A
1-PB2,641,3466,2,1,0,3469,A
1-PB2,642,3465,0,9,0,3474,A
1-PB2,643,3459,0,11,1,3471,A
1-PB2,644,0,0,0,3475,3475,C
1-PB2,645,3474,0,3,0,3477,A
1-PB2,646,3477,1,0,0,3478,A
1-PB2,647,1,7,3486,0,3494,G
1-PB2,648,3500,2,4,0,3506,A
1-PB2,649,0,3501,0,3,3504,T
1-PB2,650,2,3489,0,3,3494,T
1-PB2,651,0,3495,0,8,3503,T
1-PB2,652,2,0,0,3508,3510,C
1-PB2,653,0,3505,0,5,3510,T
1-PB2,654,12,1,0,3502,3515,C
1-PB2,655,6,1,1,3494,3502,C
1-PB2,656,5,0,0,3514,3519,C
1-PB2,657,3514,0,4,0,3518,A
1-PB2,658,1,2,3541,0,3544,G
1-PB2,659,2,3543,0,3,3548,T
1-PB2,660,1,3544,0,3,3548,T
1-PB2,661,1,0,3535,0,3536,G
1-PB2,662,1,1,0,3526,3528,C
1-PB2,663,0,3526,0,4,3530,T
1-PB2,664,3,0,3528,2,3533,G
1-PB2,665,0,0,3521,0,3521,G
1-PB2,666,2,2,0,3519,3523,C
1-PB2,667,2,2,3513,0,3517,G
1-PB2,668,0,5,3558,0,3563,G
1-PB2,669,3576,3,1,0,3580,A
1-PB2,670,3583,0,3,0,3586,A
1-PB2,671,4,1,0,3584,3589,C
1-PB2,672,3602,2,1,0,3605,A
1-PB2,673,3592,0,2,0,3594,A
1-PB2,674,1,0,3723,0,3724,G
1-PB2,675,0,1,0,3775,3776,C
1-PB2,676,3779,1,2,0,3782,A
1-PB2,677,2,1,4524,0,4527,G
1-PB2,678,0,4517,0,3,4520,T
1-PB2,679,4535,1,6,0,4542,A
1-PB2,680,0,4539,0,2,4541,T
1-PB2,681,4551,1,5,0,4557,A
1-PB2,682,1,4551,0,5,4557,T
1-PB2,683,4447,0,2,0,4449,A
1-PB2,684,0,2,1,4502,4505,C
1-PB2,685,4294,0,0,0,4294,A
1-PB2,686,0,4020,1,2,4023,T
1-PB2,687,1,3866,0,4,3871,T
1-PB2,688,0,3,3862,0,3865,G
1-PB2,689,3864,0,0,0,3864,A
1-PB2,690,3844,0,6,0,3850,A
1-PB2,691,1,0,3899,0,3900,G
1-PB2,692,0,3866,0,5,3871,T
1-PB2,693,1,3837,0,4,3842,T
1-PB2,694,0,3850,0,2,3852,T
1-PB2,695,0,3847,2,5,3854,T
1-PB2,696,3878,1,7,0,3886,A
1-PB2,697,0,1,1,3920,3922,C
1-PB2,698,3920,0,3,0,3923,A
1-PB2,699,1,3917,0,6,3924,T
1-PB2,700,1,3877,0,3,3881,T
1-PB2,701,1,3889,0,1,3891,T
1-PB2,702,1,8,3914,0,3923,G
1-PB2,703,3930,0,3,0,3933,A
1-PB2,704,1,0,0,3950,3951,C
1-PB2,705,0,3920,0,5,3925,T
1-PB2,706,3,0,0,3918,3921,C
1-PB2,707,3910,1,3,0,3914,A
1-PB2,708,3,13,3860,0,3876,G
1-PB2,709,2,4,3947,1,3954,G
1-PB2,710,3,5,3956,2,3966,G
1-PB2,711,3972,0,3,0,3975,A
1-PB2,712,3967,0,9,0,3976,A
1-PB2,713,1,4,0,3960,3965,C
1-PB2,714,1,6,3982,0,3989,G
1-PB2,715,0,3979,0,3,3982,T
1-PB2,716,1,2,4007,0,4010,G
1-PB2,717,1,3953,0,2,3956,T
1-PB2,718,1,3952,0,0,3953,T
1-PB2,719,2,6,3957,0,3965,G
1-PB2,720,0,6,3954,0,3960,G
1-PB2,721,2,9,3989,0,4000,G
1-PB2,722,3967,0,3,0,3970,A
1-PB2,723,3930,2,10,0,3942,A
1-PB2,724,1,1,0,4035,4037,C
1-PB2,725,4015,1,1,0,4017,A
1-PB2,726,4122,0,2,0,4124,A
1-PB2,727,4132,1,2,1,4136,A
1-PB2,728,0,4157,0,1,4158,T
1-PB2,729,3,0,4207,0,4210,G
1-PB2,730,1,4160,0,7,4168,T
1-PB2,731,4168,1,1,1,4171,A
1-PB2,732,1,2,1,4173,4177,C
1-PB2,733,4087,1,4,1,4093,A
1-PB2,734,2,0,0,4090,4092,C
1-PB2,735,2,3947,2,7,3958,T
1-PB2,736,6,5,0,4227,4238,C
1-PB2,737,4,0,0,4237,4241,C
1-PB2,738,4276,1,4,1,4282,A
1-PB2,739,1,3,4303,0,4307,G
1-PB2,740,0,2,4352,0,4354,G
1-PB2,741,1,4339,1,4,4345,T
1-PB2,742,1,9,4328,0,4338,G
1-PB2,743,0,8,4203,0,4211,G
1-PB2,744,4170,0,4,0,4174,A
1-PB2,745,1,7,4183,0,4191,G
1-PB2,746,0,6,4184,0,4190,G
1-PB2,747,4126,1,3,1,4131,A
1-PB2,748,0,3,4150,0,4153,G
1-PB2,749,0,4033,0,9,4042,T
1-PB2,750,1,8,4062,1,4072,G
1-PB2,751,4063,0,9,1,4073,A
1-PB2,752,0,3,4085,0,4088,G
1-PB2,753,1,7,4089,0,4097,G
1-PB2,754,4064,1,3,0,4068,A
1-PB2,755,4062,0,5,0,4067,A
1-PB2,756,0,4079,0,0,4079,T
1-PB2,757,0,4,4055,0,4059,G
1-PB2,758,4051,0,6,3,4060,A
1-PB2,759,1,2,0,4033,4036,C
1-PB2,760,1,6,4025,0,4032,G
1-PB2,761,4084,0,0,1,4085,A
1-PB2,762,1,4042,0,4,4047,T
1-PB2,763,2,1,4067,0,4070,G
1-PB2,764,1,4055,0,5,4061,T
1-PB2,765,0,4027,0,4,4031,T
1-PB2,766,4,4,4021,0,4029,G
1-PB2,767,4019,1,5,1,4026,A
1-PB2,768,0,3950,0,2,3952,T
1-PB2,769,13,4,0,3998,4015,C
1-PB2,770,4011,0,0,0,4011,A
1-PB2,771,4019,1,2,0,4022,A
1-PB2,772,3992,2,4,1,3999,A
1-PB2,773,2,0,4061,0,4063,G
1-PB2,774,1,2,1,4063,4067,C
1-PB2,775,2,0,0,4045,4047,C
1-PB2,776,0,4069,0,4,4073,T
1-PB2,777,4077,0,1,0,4078,A
1-PB2,778,4081,0,1,0,4082,A
1-PB2,779,1,4086,0,3,4090,T
1-PB2,780,0,4066,1,3,4070,T
1-PB2,781,4044,1,1,1,4047,A
1-PB2,782,0,3948,0,2,3950,T
1-PB2,783,1,3929,0,5,3935,T
1-PB2,784,0,2,3920,0,3922,G
1-PB2,785,1,2,0,3903,3906,C
1-PB2,786,5,4,3901,0,3910,G
1-PB2,787,1,1,3938,0,3940,G
1-PB2,788,6,0,0,3925,3931,C
1-PB2,789,2,3,0,3939,3944,C
1-PB2,790,3943,0,2,0,3945,A
1-PB2,791,1,1,3992,0,3994,G
1-PB2,792,2,11,4006,0,4019,G
1-PB2,793,4014,0,7,4,4025,A
1-PB2,794,4035,0,5,0,4040,A
1-PB2,795,1,0,1,4057,4059,C
1-PB2,796,4019,0,2,0,4021,A
1-PB2,797,1,4064,0,0,4065,T
1-PB2,798,4078,1,3,0,4082,A
1-PB2,799,4,1,4110,0,4115,G
1-PB2,800,1,4054,0,4,4059,T
1-PB2,801,4015,0,7,0,4022,A
1-PB2,802,4000,2,2,0,4004,A
1-PB2,803,0,1,4019,3,4023,G
1-PB2,804,3999,0,3,0,4002,A
1-PB2,805,3920,0,5,0,3925,A
1-PB2,806,1,5,3890,0,3896,G
1-PB2,807,3721,0,3,0,3724,A
1-PB2,808,0,0,3714,0,3714,G
1-PB2,809,1,1,0,3711,3713,C
1-PB2,810,5,1,0,3698,3704,C
1-PB2,811,3,0,3709,1,3713,G
1-PB2,812,0,1,0,3726,3727,C
1-PB2,813,3734,0,4,0,3738,A
1-PB2,814,0,0,3985,1,3986,G
1-PB2,815,0,3979,0,0,3979,T
1-PB2,816,3990,0,2,0,3992,A
1-PB2,817,0,3963,0,2,3965,T
1-PB2,818,3,1,0,3971,3975,C
1-PB2,819,3978,1,4,1,3984,A
1-PB2,820,3,1,3977,0,3981,G
1-PB2,821,0,0,0,3979,3979,C
1-PB2,822,3814,0,2,0,3816,A
1-PB2,823,0,1,3745,1,3747,G
1-PB2,824,3743,0,4,0,3747,A
1-PB2,825,0,3736,0,3,3739,T
1-PB2,826,5,0,0,3732,3737,C
1-PB2,827,5,2,1,3727,3735,C
1-PB2,828,3739,0,3,0,3742,A
1-PB2,829,3,0,0,3736,3739,C
1-PB2,830,0,3730,0,1,3731,T
1-PB2,831,3740,1,2,0,3743,A
1-PB2,832,2,0,3721,0,3723,G
1-PB2,833,2,1,0,3676,3679,C
1-PB2,834,3670,0,2,0,3672,A
1-PB2,835,1,3667,0,5,3673,T
1-PB2,836,1,1,0,3712,3714,C
1-PB2,837,0,3695,0,9,3704,T
1-PB2,838,0,3770,0,1,3771,T
1-PB2,839,0,3773,0,2,3775,T
1-PB2,840,3770,0,2,0,3772,A
1-PB2,841,0,3778,4,0,3782,T
1-PB2,842,1,3745,0,1,3747,T
1-PB2,843,1,5,3733,0,3739,G
1-PB2,844,1,4,3729,0,3734,G
1-PB2,845,3636,0,4,0,3640,A
1-PB2,846,1,4,3651,0,3656,G
1-PB2,847,3577,1,2,0,3580,A
1-PB2,848,1,3535,0,4,3540,T
1-PB2,849,0,0,3589,0,3589,G
1-PB2,850,1,3589,0,4,3594,T
1-PB2,851,0,1,3590,0,3591,G
1-PB2,852,1,1,0,3604,3606,C
1-PB2,853,6,0,0,3577,3583,C
1-PB2,854,3575,0,9,0,3584,A
1-PB2,855,0,0,0,3580,3580,C
1-PB2,856,3526,0,5,0,3531,A
1-PB2,857,5,1,3572,0,3578,G
1-PB2,858,2,0,0,3457,3459,C
1-PB2,859,3452,1,6,0,3459,A
1-PB2,860,1,1,0,3455,3457,C
1-PB2,861,3443,0,3,1,3447,A
1-PB2,862,0,0,0,3474,3474,C
1-PB2,863,3455,0,1,0,3456,A
1-PB2,864,3455,0,4,0,3459,A
1-PB2,865,3448,0,6,0,3454,A
1-PB2,866,1,3340,0,0,3341,T
1-PB2,867,0,3334,0,0,3334,T
1-PB2,868,0,6,3310,0,3316,G
1-PB2,869,0,0,3309,0,3309,G
1-PB2,870,1,3,0,3307,3311,C
1-PB2,871,1,7,3258,0,3266,G
1-PB2,872,0,4,3298,1,3303,G
1-PB2,873,2,1,3324,0,3327,G
1-PB2,874,3328,0,4,0,3332,A
1-PB2,875,0,0,0,3332,3332,C
1-PB2,876,3331,0,3,0,3334,A
1-PB2,877,3326,0,4,1,3331,A
1-PB2,878,2,1,3350,0,3353,G
1-PB2,879,0,1,3342,2,3345,G
1-PB2,880,3364,0,4,0,3368,A
1-PB2,881,1,3194,0,1,3196,T
1-PB2,882,1,6,3110,0,3117,G
1-PB2,883,1,3,3121,0,3125,G
1-PB2,884,0,3084,0,2,3086,T
1-PB2,885,1,2,3073,0,3076,G
1-PB2,886,0,2,3058,0,3060,G
1-PB2,887,2981,1,6,0,2988,A
1-PB2,888,2,2,0,2982,2986,C
1-PB2,889,2923,0,0,0,2923,A
1-PB2,890,1,3230,1,1,3233,T
1-PB2,891,0,3209,0,5,3214,T
1-PB2,892,8,0,1,3192,3201,C
1-PB2,893,0,3160,0,2,3162,T
1-PB2,894,0,3150,0,0,3150,T
1-PB2,895,3144,0,2,0,3146,A
1-PB2,896,1,3,3150,0,3154,G
1-PB2,897,3119,1,3,0,3123,A
1-PB2,898,0,1,0,3118,3119,C
1-PB2,899,2248,1,0,0,2249,A
1-PB2,900,0,0,2275,0,2275,G
1-PB2,901,2266,0,0,0,2266,A
1-PB2,902,2275,0,0,0,2275,A
1-PB2,903,0,0,0,2275,2275,C
1-PB2,904,1,0,1,2278,2280,C
1-PB2,905,5,3,0,2265,2273,C
1-PB2,906,1,3,2270,0,2274,G
1-PB2,907,2282,0,1,0,2283,A
1-PB2,908,0,0,1,2288,2289,C
1-PB2,909,1,2250,0,4,2255,T
1-PB2,910,1,1,2259,0,2261,G
1-PB2,911,2261,0,2,0,2263,A
1-PB2,912,2265,0,3,0,2268,A
1-PB2,913,2,4,2274,0,2280,G
1-PB2,914,2271,0,2,0,2273,A
1-PB2,915,2277,0,4,1,2282,A
1-PB2,916,0,1,0,2271,2272,C
1-PB2,917,2258,0,2,0,2260,A
1-PB2,918,2271,1,5,0,2277,A
1-PB2,919,0,1,2297,0,2298,G
1-PB2,920,1,0,0,2310,2311,C
1-PB2,921,0,2290,0,0,2290,T
1-PB2,922,1,0,2313,0,2314,G
1-PB2,923,1,2305,0,1,2307,T
1-PB2,924,1,3,2358,0,2362,G
1-PB2,925,0,0,2456,0,2456,G
1-PB2,926,2456,0,4,0,2460,A
1-PB2,927,1,2458,0,2,2461,T
1-PB2,928,2424,0,4,0,2428,A
1-PB2,929,1,2404,0,1,2406,T
1-PB2,930,2474,0,0,1,2475,A
1-PB2,931,1,2436,0,0,2437,T
1-PB2,932,0,2,2425,0,2427,G
1-PB2,933,0,0,1,2384,2385,C
1-PB2,934,2317,1,0,0,2318,A
1-PB2,935,2321,0,2,0,2323,A
1-PB2,936,3,1,2313,0,2317,G
1-PB2,937,0,0,2333,0,2333,G
1-PB2,938,0,0,0,2333,2333,C
1-PB2,939,1,2274,0,5,2280,T
1-PB2,940,1,0,2297,0,2298,G
1-PB2,941,0,1,0,2295,2296,C
1-PB2,942,2306,0,0,0,2306,A
1-PB2,943,2305,0,1,0,2306,A
1-PB2,944,0,2293,0,0,2293,T
1-PB2,945,1,1,2300,1,2303,G
1-PB2,946,0,4,2282,1,2287,G
1-PB2,947,1,4,2290,0,2295,G
1-PB2,948,2282,1,2,0,2285,A
1-PB2,949,0,2277,2,1,2280,T
1-PB2,950,1,2272,0,1,2274,T
1-PB2,951,0,3,2276,0,2279,G
1-PB2,952,2276,0,3,0,2279,A
1-PB2,953,4,3,2296,1,2304,G
1-PB2,954,2286,0,4,0,2290,A
1-PB2,955,2276,1,1,0,2278,A
1-PB2,956,0,2249,1,1,2251,T
1-PB2,957,1,0,0,2268,2269,C
1-PB2,958,2267,0,2,1,2270,A
1-PB2,959,0,0,2288,0,2288,G
1-PB2,960,1,0,0,2284,2285,C
1-PB2,961,0,2268,0,5,2273,T
1-PB2,962,3,0,0,2266,2269,C
1-PB2,963,2257,1,4,0,2262,A
1-PB2,964,0,2290,0,2,2292,T
1-PB2,965,2,0,0,2291,2293,C
1-PB2,966,7,1,1,2290,2299,C
1-PB2,967,0,2291,0,7,2298,T
1-PB2,968,0,2291,1,2,2294,T
1-PB2,969,1,1,0,2297,2299,C
1-PB2,970,2294,0,1,0,2295,A
1-PB2,971,0,0,2319,0,2319,G
1-PB2,972,0,1,0,2314,2315,C
1-PB2,973,0,2284,0,2,2286,T
1-PB2,974,0,2294,0,1,2295,T
1-PB2,975,1,2273,0,1,2275,T
1-PB2,976,2,3,2268,0,2273,G
1-PB2,977,1,2,2272,0,2275,G
1-PB2,978,0,2278,0,2,2280,T
1-PB2,979,0,1,2259,0,2260,G
1-PB2,980,1,0,2256,0,2257,G
1-PB2,981,1,0,2,2227,2230,C
1-PB2,982,0,2269,0,4,2273,T
1-PB2,983,1,2263,0,1,2265,T
1-PB2,984,0,2274,0,2,2276,T
1-PB2,985,2283,1,0,0,2284,A
1-PB2,986,0,0,0,2292,2292,C
1-PB2,987,2297,0,2,0,2299,A
1-PB2,988,0,2291,0,1,2292,T
1-PB2,989,0,2249,0,1,2250,T
1-PB2,990,1,2269,0,0,2270,T
1-PB2,991,2272,1,1,0,2274,A
1-PB2,992,2269,0,2,0,2271,A
1-PB2,993,2260,0,11,0,2271,A
1-PB2,994,2256,0,4,0,2260,A
1-PB2,995,0,3,2279,0,2282,G
1-PB2,996,2262,0,2,0,2264,A
1-PB2,997,2270,1,1,0,2272,A
1-PB2,998,1,0,0,2268,2269,C
1-PB2,999,2260,1,1,0,2262,A
1-PB2,1000,2262,0,3,0,2265,A
1-PB2,1001,0,1,2265,0,2266,G
1-PB2,1002,2,2,0,2258,2262,C
1-PB2,1003,2,6,2255,0,2263,G
1-PB2,1004,3,1,2272,1,2277,G
1-PB2,1005,0,2,2284,0,2286,G
1-PB2,1006,1,2267,0,4,2272,T
1-PB2,1007,5,2,0,2267,2274,C
1-PB2,1008,2275,1,0,0,2276,A
1-PB2,1009,0,2281,0,1,2282,T
1-PB2,1010,3,1,0,2287,2291,C
1-PB2,1011,2291,0,0,0,2291,A
1-PB2,1012,1,0,2351,0,2352,G
1-PB2,1013,0,2321,0,3,2324,T
1-PB2,1014,2,0,0,2320,2322,C
1-PB2,1015,2325,1,6,0,2332,A
1-PB2,1016,2334,0,3,0,2337,A
1-PB2,1017,2336,0,0,0,2336,A
1-PB2,1018,2326,0,4,1,2331,A
1-PB2,1019,2343,0,2,1,2346,A
1-PB2,1020,2349,0,8,0,2357,A
1-PB2,1021,1,1,2352,1,2355,G
1-PB2,1022,2339,1,0,0,2340,A
1-PB2,1023,2332,1,2,0,2335,A
1-PB2,1024,0,3,2333,0,2336,G
1-PB2,1025,2335,1,1,0,2337,A
1-PB2,1026,2266,0,13,0,2279,A
1-PB2,1027,0,3,2270,0,2273,G
1-PB2,1028,2261,0,2,1,2264,A
1-PB2,1029,0,4,2263,0,2267,G
1-PB2,1030,1,1,2314,0,2316,G
1-PB2,1031,2,2307,0,0,2309,T
1-PB2,1032,0,0,2347,0,2347,G
1-PB2,1033,0,1,0,2370,2371,C
1-PB2,1034,1,2363,0,4,2368,T
1-PB2,1035,0,2377,0,0,2377,T
1-PB2,1036,2371,1,0,0,2372,A
1-PB2,1037,1,0,0,2367,2368,C
1-PB2,1038,2351,1,1,0,2353,A
1-PB2,1039,2,1,2363,0,2366,G
1-PB2,1040,2,1,2360,0,2363,G
1-PB2,1041,2,1,0,2331,2334,C
1-PB2,1042,2317,0,0,1,2318,A
1-PB2,1043,2330,0,4,0,2334,A
1-PB2,1044,1,2357,0,9,2367,T
1-PB2,1045,2,2,0,2383,2387,C
1-PB2,1046,0,2367,1,4,2372,T
1-PB2,1047,4,0,1,2375,2380,C
1-PB2,1048,2,1,0,2371,2374,C
1-PB2,1049,2371,0,2,0,2373,A
1-PB2,1050,2373,0,1,0,2374,A
1-PB2,1051,2373,1,0,2,2376,A
1-PB2,1052,0,0,0,2382,2382,C
1-PB2,1053,2316,0,0,0,2316,A
1-PB2,1054,0,2301,0,2,2303,T
1-PB2,1055,0,2278,0,0,2278,T
1-PB2,1056,2,0,2319,0,2321,G
1-PB2,1057,2324,0,0,0,2324,A
1-PB2,1058,2343,0,4,0,2347,A
1-PB2,1059,2356,1,3,0,2360,A
1-PB2,1060,2354,0,2,0,2356,A
1-PB2,1061,1,2349,0,2,2352,T
1-PB2,1062,2353,0,2,0,2355,A
1-PB2,1063,2345,1,6,0,2352,A
1-PB2,1064,0,7,2389,0,2396,G
1-PB2,1065,2343,0,5,0,2348,A
1-PB2,1066,0,0,2421,0,2421,G
1-PB2,1067,1,2399,0,1,2401,T
1-PB2,1068,2409,1,2,0,2412,A
1-PB2,1069,0,3,0,2471,2474,C
1-PB2,1070,2446,0,4,0,2450,A
1-PB2,1071,1,2444,1,2,2448,T
1-PB2,1072,0,2,2449,0,2451,G
1-PB2,1073,2417,1,5,0,2423,A
1-PB2,1074,2,2,2437,0,2441,G
1-PB2,1075,3,8,2430,1,2442,G
1-PB2,1076,0,3,2532,0,2535,G
1-PB2,1077,1,2,2552,0,2555,G
1-PB2,1078,0,2508,1,2,2511,T
1-PB2,1079,2520,0,3,0,2523,A
1-PB2,1080,1,2510,0,3,2514,T
1-PB2,1081,1,4,2518,0,2523,G
1-PB2,1082,2517,0,1,0,2518,A
1-PB2,1083,2,4,2493,0,2499,G
1-PB2,1084,0,7,2480,1,2488,G
1-PB2,1085,2310,1,0,0,2311,A
1-PB2,1086,0,1,2382,0,2383,G
1-PB2,1087,3,2365,0,5,2373,T
1-PB2,1088,0,2428,0,3,2431,T
1-PB2,1089,3,0,0,2438,2441,C
1-PB2,1090,2437,1,1,0,2439,A
1-PB2,1091,1,0,0,2440,2441,C
1-PB2,1092,2424,0,1,0,2425,A
1-PB2,1093,2439,0,4,1,2444,A
1-PB2,1094,0,2438,0,1,2439,T
1-PB2,1095,0,6,2358,0,2364,G
1-PB2,1096,1,1,2371,0,2373,G
1-PB2,1097,0,2297,0,4,2301,T
1-PB2,1098,0,4,2294,0,2298,G
1-PB2,1099,2,7,2293,0,2302,G
1-PB2,1100,2,3,2306,0,2311,G
1-PB2,1101,0,1,2320,2,2323,G
1-PB2,1102,2311,0,1,0,2312,A
1-PB2,1103,2308,1,4,1,2314,A
1-PB2,1104,2306,0,1,1,2308,A
1-PB2,1105,2258,0,6,0,2264,A
1-PB2,1106,1,7,2276,0,2284,G
1-PB2,1107,2272,1,3,0,2276,A
1-PB2,1108,0,2,2274,0,2276,G
1-PB2,1109,1,0,0,2283,2284,C
1-PB2,1110,2270,1,2,0,2273,A
1-PB2,1111,2272,0,5,0,2277,A
1-PB2,1112,1,0,0,2338,2339,C
1-PB2,1113,2338,0,0,0,2338,A
1-PB2,1114,1,0,2384,0,2385,G
1-PB2,1115,0,0,0,2357,2357,C
1-PB2,1116,0,2353,0,4,2357,T
1-PB2,1117,2424,1,0,0,2425,A
1-PB2,1118,1,2422,0,1,2424,T
1-PB2,1119,2432,1,1,0,2434,A
1-PB2,1120,1,0,0,2438,2439,C
1-PB2,1121,0,2294,0,1,2295,T
1-PB2,1122,2313,0,1,0,2314,A
1-PB2,1123,2260,0,1,0,2261,A
1-PB2,1124,5,1,2262,0,2268,G
1-PB2,1125,2265,0,1,0,2266,A
1-PB2,1126,2198,0,0,0,2198,A
1-PB2,1127,2194,0,2,0,2196,A
1-PB2,1128,2188,0,6,0,2194,A
1-PB2,1129,0,1,2204,0,2205,G
1-PB2,1130,0,0,0,2194,2194,C
1-PB2,1131,2187,0,2,1,2190,A
1-PB2,1132,2189,1,3,0,2193,A
1-PB2,1133,2,0,0,2186,2188,C
1-PB2,1134,0,2,0,2192,2194,C
1-PB2,1135,2197,0,2,0,2199,A
1-PB2,1136,1,4,2199,0,2204,G
1-PB2,1137,2199,0,1,0,2200,A
1-PB2,1138,2199,0,4,0,2203,A
1-PB2,1139,1,1,2224,0,2226,G
1-PB2,1140,2227,0,0,0,2227,A
1-PB2,1141,0,2209,1,0,2210,T
1-PB2,1142,1,2214,0,0,2215,T
1-PB2,1143,1,1,2221,0,2223,G
1-PB2,1144,1,7,2244,0,2252,G
1-PB2,1145,1,2236,0,5,2242,T
1-PB2,1146,2,2228,1,3,2234,T
1-PB2,1147,5,1,0,2233,2239,C
1-PB2,1148,2265,0,4,0,2269,A
1-PB2,1149,1,0,2352,0,2353,G
1-PB2,1150,0,2,0,2368,2370,C
1-PB2,1151,1,2355,0,5,2361,T
1-PB2,1152,1,2,0,2373,2376,C
1-PB2,1153,2340,0,5,0,2345,A
1-PB2,1154,1,2353,0,2,2356,T
1-PB2,1155,2353,2,3,0,2358,A
1-PB2,1156,0,1,2372,0,2373,G
1-PB2,1157,0,2258,0,1,2259,T
1-PB2,1158,1,6,2278,1,2286,G
1-PB2,1159,2211,0,9,0,2220,A
1-PB2,1160,0,0,2246,1,2247,G
1-PB2,1161,0,2233,0,1,2234,T
1-PB2,1162,3,1,2225,2,2231,G
1-PB2,1163,1,1,2252,1,2255,G
1-PB2,1164,2253,0,0,0,2253,A
1-PB2,1165,2235,0,5,0,2240,A
1-PB2,1166,1,1,2243,1,2246,G
1-PB2,1167,2204,0,2,0,2206,A
1-PB2,1168,1,0,2227,0,2228,G
1-PB2,1169,2209,1,4,0,2214,A
1-PB2,1170,1,4,1,2208,2214,C
1-PB2,1171,2,10,2204,0,2216,G
1-PB2,1172,2195,1,2,2,2200,A
1-PB2,1173,2204,1,8,0,2213,A
1-PB2,1174,0,1,0,2221,2222,C
1-PB2,1175,2202,2,0,0,2204,A
1-PB2,1176,3,0,2316,0,2319,G
1-PB2,1177,0,2299,0,5,2304,T
1-PB2,1178,1,1,0,2302,2304,C
1-PB2,1179,2310,0,1,0,2311,A
1-PB2,1180,2296,0,6,0,2302,A
1-PB2,1181,0,2306,0,2,2308,T
1-PB2,1182,2300,0,0,1,2301,A
1-PB2,1183,2,0,2298,0,2300,G
1-PB2,1184,1,2,0,2282,2285,C
1-PB2,1185,2,0,0,2206,2208,C
1-PB2,1186,1,5,2199,0,2205,G
1-PB2,1187,2207,0,0,0,2207,A
1-PB2,1188,2215,0,1,0,2216,A
1-PB2,1189,0,1,2235,0,2236,G
1-PB2,1190,3,3,0,2261,2267,C
1-PB2,1191,2275,0,3,0,2278,A
1-PB2,1192,2279,0,3,0,2282,A
1-PB2,1193,1,2278,0,1,2280,T
1-PB2,1194,2285,0,1,0,2286,A
1-PB2,1195,2303,1,2,0,2306,A
1-PB2,1196,0,2307,0,0,2307,T
1-PB2,1197,2,0,0,2290,2292,C
1-PB2,1198,1,0,2286,0,2287,G
1-PB2,1199,0,2237,0,0,2237,T
1-PB2,1200,0,0,2232,0,2232,G
1-PB2,1201,0,2,2253,0,2255,G
1-PB2,1202,1,0,0,2259,2260,C
1-PB2,1203,6,2,0,2241,2249,C
1-PB2,1204,2228,0,0,0,2228,A
1-PB2,1205,0,2230,1,4,2235,T
1-PB2,1206,1,1,2233,0,2235,G
1-PB2,1207,0,1,2266,0,2267,G
1-PB2,1208,0,2242,0,2,2244,T
1-PB2,1209,2,0,2250,0,2252,G
1-PB2,1210,0,2157,2,4,2163,T
1-PB2,1211,1,2162,0,5,2168,T
1-PB2,1212,0,2172,1,3,2176,T
1-PB2,1213,0,2170,0,3,2173,T
1-PB2,1214,2,0,0,2225,2227,C
1-PB2,1215,2216,1,3,0,2220,A
1-PB2,1216,0,1,0,2410,2411,C
1-PB2,1217,2349,1,5,0,2355,A
1-PB2,1218,2432,1,3,0,2436,A
1-PB2,1219,0,2,2441,0,2443,G
1-PB2,1220,2415,0,0,0,2415,A
1-PB2,1221,252,3,2193,0,2448,G
1-PB2,1222,0,0,2478,0,2478,G
1-PB2,1223,2449,0,2,0,2451,A
1-PB2,1224,0,2467,0,2,2469,T
1-PB2,1225,1,2415,0,5,2421,T
1-PB2,1226,1,3,2413,0,2417,G
1-PB2,1227,0,0,0,2370,2370,C
1-PB2,1228,2389,1,2,1,2393,A
1-PB2,1229,0,2404,0,2,2406,T
1-PB2,1230,0,1,2531,0,2532,G
1-PB2,1231,2547,0,3,0,2550,A
1-PB2,1232,2,2567,0,1,2570,T
1-PB2,1233,2550,0,2,0,2552,A
1-PB2,1234,2546,0,1,0,2547,A
1-PB2,1235,2554,1,1,0,2556,A
1-PB2,1236,2560,0,9,0,2569,A
1-PB2,1237,1,0,2578,0,2579,G
1-PB2,1238,0,2,1,2639,2642,C
1-PB2,1239,2705,0,1,0,2706,A
1-PB2,1240,1,0,2776,0,2777,G
1-PB2,1241,0,2763,0,4,2767,T
1-PB2,1242,0,2769,1,4,2774,T
1-PB2,1243,2772,2,3,0,2777,A
1-PB2,1244,0,3,2795,0,2798,G
1-PB2,1245,2772,0,10,0,2782,A
1-PB2,1246,3,1,2785,0,2789,G
1-PB2,1247,2,1,2779,0,2782,G
1-PB2,1248,3,2667,0,2,2672,T
1-PB2,1249,0,6,2675,0,2681,G
1-PB2,1250,2688,1,2,0,2691,A
1-PB2,1251,1,0,0,2709,2710,C
1-PB2,1252,5,0,0,2716,2721,C
1-PB2,1253,0,2682,1,7,2690,T
1-PB2,1254,1,1,2706,0,2708,G
1-PB2,1255,2700,0,3,0,2703,A
1-PB2,1256,2710,0,0,0,2710,A
1-PB2,1257,0,2704,1,3,2708,T
1-PB2,1258,0,2719,1,2,2722,T
1-PB2,1259,0,2739,0,1,2740,T
1-PB2,1260,2,1,0,2740,2743,C
1-PB2,1261,1,0,2744,0,2745,G
1-PB2,1262,0,2730,1,5,2736,T
1-PB2,1263,2,3,0,2746,2751,C
1-PB2,1264,2746,0,2,0,2748,A
1-PB2,1265,2755,0,2,0,2757,A
1-PB2,1266,2,2,1,2752,2757,C
1-PB2,1267,2723,0,1,0,2724,A
1-PB2,1268,0,2,2764,0,2766,G
1-PB2,1269,2744,2,11,0,2757,A
1-PB2,1270,1,0,2761,0,2762,G
1-PB2,1271,1,2,0,2765,2768,C
1-PB2,1272,2766,1,2,0,2769,A
1-PB2,1273,2803,0,2,0,2805,A
1-PB2,1274,2811,0,0,0,2811,A
1-PB2,1275,0,2805,0,3,2808,T
1-PB2,1276,2,0,0,2812,2814,C
1-PB2,1277,2777,1,4,1,2783,A
1-PB2,1278,0,0,2788,0,2788,G
1-PB2,1279,0,2,0,2793,2795,C
1-PB2,1280,2,2,2795,0,2799,G
1-PB2,1281,1,2,2967,0,2970,G
1-PB2,1282,0,2949,0,3,2952,T
1-PB2,1283,0,2950,0,2,2952,T
1-PB2,1284,2,2,2965,0,2969,G
1-PB2,1285,2973,0,5,0,2978,A
1-PB2,1286,3003,0,2,0,3005,A
1-PB2,1287,0,0,0,3027,3027,C
1-PB2,1288,3,1,0,3005,3009,C
1-PB2,1289,6,2,0,3025,3033,C
1-PB2,1290,7,0,0,2935,2942,C
1-PB2,1291,2954,0,2,4,2960,A
1-PB2,1292,1,2975,0,4,2980,T
1-PB2,1293,0,0,2995,0,2995,G
1-PB2,1294,0,2,0,3006,3008,C
1-PB2,1295,2990,0,3,1,2994,A
1-PB2,1296,0,2969,0,4,2973,T
1-PB2,1297,0,1,1,2966,2968,C
1-PB2,1298,2950,0,0,2,2952,A
1-PB2,1299,0,1,2999,0,3000,G
1-PB2,1300,1,0,0,3004,3005,C
1-PB2,1301,0,2994,0,9,3003,T
1-PB2,1302,0,3008,0,4,3012,T
1-PB2,1303,0,3010,0,1,3011,T
1-PB2,1304,0,3011,1,2,3014,T
1-PB2,1305,3020,0,0,0,3020,A
1-PB2,1306,3010,0,4,0,3014,A
1-PB2,1307,0,1,3022,0,3023,G
1-PB2,1308,1,0,2995,0,2996,G
1-PB2,1309,2,1,0,2968,2971,C
1-PB2,1310,2963,2,4,1,2970,A
1-PB2,1311,0,2965,0,2,2967,T
1-PB2,1312,0,2978,1,1,2980,T
1-PB2,1313,1,2967,0,4,2972,T
1-PB2,1314,0,2988,0,1,2989,T
1-PB2,1315,2,0,0,2991,2993,C
1-PB2,1316,2979,1,4,1,2985,A
1-PB2,1317,1,2,2989,0,2992,G
1-PB2,1318,2987,0,3,0,2990,A
1-PB2,1319,2987,0,2,0,2989,A
1-PB2,1320,2978,1,3,1,2983,A
1-PB2,1321,1,1,2988,0,2990,G
1-PB2,1322,3007,1,6,0,3014,A
1-PB2,1323,0,3012,0,1,3013,T
1-PB2,1324,0,1,3010,0,3011,G
1-PB2,1325,0,3,0,3015,3018,C
1-PB2,1326,1,3,3019,0,3023,G
1-PB2,1327,3012,0,6,0,3018,A
1-PB2,1328,3009,0,3,1,3013,A
1-PB2,1329,3007,0,4,0,3011,A
1-PB2,1330,0,1,3019,0,3020,G
1-PB2,1331,2,2988,0,2,2992,T
1-PB2,1332,1,2,2998,0,3001,G
1-PB2,1333,0,1,0,2985,2986,C
1-PB2,1334,1,2982,1,8,2992,T
1-PB2,1335,0,2980,0,2,2982,T
1-PB2,1336,0,2983,2,2,2987,T
1-PB2,1337,1,2989,0,1,2991,T
1-PB2,1338,0,2984,1,7,2992,T
1-PB2,1339,7,1,0,2991,2999,C
1-PB2,1340,2991,0,1,0,2992,A
1-PB2,1341,3011,0,1,0,3012,A
1-PB2,1342,3004,0,1,1,3006,A
1-PB2,1343,3017,0,0,0,3017,A
1-PB2,1344,0,3010,1,3,3014,T
1-PB2,1345,1,3012,0,0,3013,T
1-PB2,1346,4,9,3007,0,3020,G
1-PB2,1347,1,2,3009,0,3012,G
1-PB2,1348,1,6,3003,0,3010,G
1-PB2,1349,2,7,3052,0,3061,G
1-PB2,1350,3033,1,6,0,3040,A
1-PB2,1351,1,0,3102,0,3103,G
1-PB2,1352,0,3089,0,5,3094,T
1-PB2,1353,0,3079,0,2,3081,T
1-PB2,1354,1,5,3097,0,3103,G
1-PB2,1355,3095,2,5,1,3103,A
1-PB2,1356,3099,0,12,0,3111,A
1-PB2,1357,0,1,1,3201,3203,C
1-PB2,1358,3159,0,4,0,3163,A
1-PB2,1359,0,4,0,3227,3231,C
1-PB2,1360,3172,0,4,0,3176,A
1-PB2,1361,0,3183,0,5,3188,T
1-PB2,1362,4,1,0,3188,3193,C
1-PB2,1363,1,11,3182,0,3194,G
1-PB2,1364,3213,0,4,0,3217,A
1-PB2,1365,0,3,0,3203,3206,C
1-PB2,1366,3120,0,5,0,3125,A
1-PB2,1367,0,2,3222,0,3224,G
1-PB2,1368,1,3157,0,2,3160,T
1-PB2,1369,0,0,3213,0,3213,G
1-PB2,1370,0,3186,1,3,3190,T
1-PB2,1371,2,2,3185,0,3189,G
1-PB2,1372,3192,0,5,0,3197,A
1-PB2,1373,0,3177,0,1,3178,T
1-PB2,1374,2,7,3170,0,3179,G
1-PB2,1375,1,4,3163,1,3169,G
1-PB2,1376,2,2,3116,0,3120,G
1-PB2,1377,3098,0,8,0,3106,A
1-PB2,1378,3084,1,2,0,3087,A
1-PB2,1379,1,3102,0,1,3104,T
1-PB2,1380,0,2,3138,0,3140,G
1-PB2,1381,3136,1,3,0,3140,A
1-PB2,1382,0,3137,0,1,3138,T
1-PB2,1383,0,3127,0,2,3129,T
1-PB2,1384,0,3,3115,0,3118,G
1-PB2,1385,1,2,3185,1,3189,G
1-PB2,1386,3163,0,5,1,3169,A
1-PB2,1387,1,1,3212,0,3214,G
1-PB2,1388,0,3178,0,2,3180,T
1-PB2,1389,3174,0,1,0,3175,A
1-PB2,1390,0,3181,0,2,3183,T
1-PB2,1391,0,3204,0,1,3205,T
1-PB2,1392,3231,0,3,3,3237,A
1-PB2,1393,1,0,0,3238,3239,C
1-PB2,1394,6,2,0,3178,3186,C
1-PB2,1395,3139,1,3,5,3148,A
1-PB2,1396,0,4,3153,0,3157,G
1-PB2,1397,3220,1,5,0,3226,A
1-PB2,1398,1,3192,1,11,3205,T
1-PB2,1399,3192,1,0,0,3193,A
1-PB2,1400,0,3154,0,6,3160,T
1-PB2,1401,1,6,3138,0,3145,G
1-PB2,1402,3158,0,1,0,3159,A
1-PB2,1403,2,10,0,3173,3185,C
1-PB2,1404,2,3178,0,2,3182,T
1-PB2,1405,4,0,0,3179,3183,C
1-PB2,1406,7,2,0,3139,3148,C
1-PB2,1407,3163,1,4,0,3168,A
1-PB2,1408,3176,1,6,0,3183,A
1-PB2,1409,1,2,3245,0,3248,G
1-PB2,1410,2,1,0,3223,3226,C
1-PB2,1411,3233,1,2,0,3236,A
1-PB2,1412,0,1,0,3234,3235,C
1-PB2,1413,3207,0,1,1,3209,A
1-PB2,1414,0,3,3218,0,3221,G
1-PB2,1415,3208,0,4,0,3212,A
1-PB2,1416,2,3,3229,0,3234,G
1-PB2,1417,3255,0,4,0,3259,A
1-PB2,1418,0,3153,0,5,3158,T
1-PB2,1419,0,1,3200,0,3201,G
1-PB2,1420,3,3171,0,4,3178,T
1-PB2,1421,0,0,1,3158,3159,C
1-PB2,1422,3184,0,4,0,3188,A
1-PB2,1423,3180,2,0,0,3182,A
1-PB2,1424,0,3179,0,2,3181,T
1-PB2,1425,0,8,3168,1,3177,G
1-PB2,1426,3129,0,5,0,3134,A
1-PB2,1427,0,3,3148,1,3152,G
1-PB2,1428,3111,2,8,0,3121,A
1-PB2,1429,0,2,3135,0,3137,G
1-PB2,1430,1,4,3263,0,3268,G
1-PB2,1431,3261,0,2,0,3263,A
1-PB2,1432,3268,1,9,0,3278,A
1-PB2,1433,1,3273,0,3,3277,T
1-PB2,1434,3275,0,1,0,3276,A
1-PB2,1435,3278,0,3,0,3281,A
1-PB2,1436,0,2,3267,0,3269,G
1-PB2,1437,3238,0,7,0,3245,A
1-PB2,1438,0,0,3257,1,3258,G
1-PB2,1439,1,3099,0,2,3102,T
1-PB2,1440,7,1,0,3097,3105,C
1-PB2,1441,3098,0,7,0,3105,A
1-PB2,1442,3,1,3126,0,3130,G
1-PB2,1443,1,0,0,3130,3131,C
1-PB2,1444,3128,2,1,0,3131,A
1-PB2,1445,3139,0,2,0,3141,A
1-PB2,1446,3139,0,2,0,3141,A
1-PB2,1447,3141,0,1,0,3142,A
1-PB2,1448,0,3135,0,2,3137,T
1-PB2,1449,0,8,3133,0,3141,G
1-PB2,1450,1,4,3145,0,3150,G
1-PB2,1451,3,3,3155,0,3161,G
1-PB2,1452,1,3121,0,2,3124,T
1-PB2,1453,0,2,3119,3,3124,G
1-PB2,1454,1,3122,0,5,3128,T
1-PB2,1455,0,1,3137,0,3138,G
1-PB2,1456,1,1,3192,0,3194,G
1-PB2,1457,3182,0,9,0,3191,A
1-PB2,1458,0,3174,0,5,3179,T
1-PB2,1459,2,2,3224,1,3229,G
1-PB2,1460,3187,0,10,0,3197,A
1-PB2,1461,3217,1,1,0,3219,A
1-PB2,1462,0,3219,0,2,3221,T
1-PB2,1463,3191,1,0,0,3192,A
1-PB2,1464,0,0,0,3414,3414,C
1-PB2,1465,1,3317,0,5,3323,T
1-PB2,1466,5,2,0,3362,3369,C
1-PB2,1467,3,1,0,3360,3364,C
1-PB2,1468,3350,0,6,0,3356,A
1-PB2,1469,1,0,3489,0,3490,G
1-PB2,1470,0,3477,0,3,3480,T
1-PB2,1471,3504,1,3,0,3508,A
1-PB2,1472,2,2,0,3519,3523,C
1-PB2,1473,3213,0,4,0,3217,A
1-PB2,1474,1,4,3223,1,3229,G
1-PB2,1475,3140,0,5,0,3145,A
1-PB2,1476,1,3,3159,0,3163,G
1-PB2,1477,3076,1,2,0,3079,A
1-PB2,1478,0,8,2995,0,3003,G
1-PB2,1479,0,3,2991,0,2994,G
1-PB2,1480,1,0,2989,0,2990,G
1-PB2,1481,0,2962,0,3,2965,T
1-PB2,1482,1,5,2959,0,2965,G
1-PB2,1483,1,1,2976,0,2978,G
1-PB2,1484,0,2947,0,1,2948,T
1-PB2,1485,0,5,3015,0,3020,G
1-PB2,1486,0,0,3020,0,3020,G
1-PB2,1487,0,2948,0,0,2948,T
1-PB2,1488,0,2940,0,4,2944,T
1-PB2,1489,2902,0,5,0,2907,A
1-PB2,1490,0,0,2924,0,2924,G
1-PB2,1491,2,1,0,2917,2920,C
1-PB2,1492,2909,0,0,0,2909,A
1-PB2,1493,0,2902,0,2,2904,T
1-PB2,1494,1,2758,0,0,2759,T
1-PB2,1495,0,8,2756,0,2764,G
1-PB2,1496,2747,0,1,0,2748,A
1-PB2,1497,0,2759,1,2,2762,T
1-PB2,1498,5,2,0,2754,2761,C
1-PB2,1499,3,2,2732,0,2737,G
1-PB2,1500,1,0,2782,0,2783,G
1-PB2,1501,1,2774,0,0,2775,T
1-PB2,1502,0,2771,0,3,2774,T
1-PB2,1503,1,2766,0,2,2769,T
1-PB2,1504,3,2772,0,0,2775,T
1-PB2,1505,0,2770,0,2,2772,T
1-PB2,1506,1,2,2771,0,2774,G
1-PB2,1507,2762,0,7,0,2769,A
1-PB2,1508,0,3,2768,1,2772,G
1-PB2,1509,2697,1,1,0,2699,A
1-PB2,1510,1,0,2716,0,2717,G
1-PB2,1511,0,2724,0,6,2730,T
1-PB2,1512,2,2719,0,2,2723,T
1-PB2,1513,8,0,1,2718,2727,C
1-PB2,1514,0,3,2726,0,2729,G
1-PB2,1515,2731,0,4,0,2735,A
1-PB2,1516,0,7,2724,0,2731,G
1-PB2,1517,2725,0,6,0,2731,A
1-PB2,1518,0,1,0,2726,2727,C
1-PB2,1519,6,2,0,2699,2707,C
1-PB2,1520,2691,0,1,0,2692,A
1-PB2,1521,2728,0,3,0,2731,A
1-PB2,1522,1,0,0,2730,2731,C
1-PB2,1523,0,0,2738,0,2738,G
1-PB2,1524,0,2720,0,1,2721,T
1-PB2,1525,0,0,2719,0,2719,G
1-PB2,1526,0,1,2725,0,2726,G
1-PB2,1527,1,3,2726,0,2730,G
1-PB2,1528,2718,0,1,0,2719,A
1-PB2,1529,2720,0,0,0,2720,A
1-PB2,1530,1,2639,0,2,2642,T
1-PB2,1531,1,1,2750,0,2752,G
1-PB2,1532,0,2741,0,0,2741,T
1-PB2,1533,2743,0,0,0,2743,A
1-PB2,1534,1,2741,0,1,2743,T
1-PB2,1535,0,2715,0,2,2717,T
1-PB2,1536,2748,0,0,0,2748,A
1-PB2,1537,1,2732,0,2,2735,T
1-PB2,1538,0,2707,0,1,2708,T
1-PB2,1539,2700,0,1,1,2702,A
1-PB2,1540,0,2407,0,7,2414,T
1-PB2,1541,1,0,0,2504,2505,C
1-PB2,1542,0,2455,1,4,2460,T
1-PB2,1543,4,0,0,2464,2468,C
1-PB2,1544,4,1,1,2468,2474,C
1-PB2,1545,1,2400,1,2,2404,T
1-PB2,1546,0,2,2405,0,2407,G
1-PB2,1547,2391,0,4,0,2395,A
1-PB2,1548,0,2,2393,0,2395,G
1-PB2,1549,1,3,2388,0,2392,G
1-PB2,1550,2152,0,2,0,2154,A
1-PB2,1551,0,1,2189,0,2190,G
1-PB2,1552,0,0,2182,0,2182,G
1-PB2,1553,1,2116,0,2,2119,T
1-PB2,1554,5,0,0,2129,2134,C
1-PB2,1555,2111,0,0,1,2112,A
1-PB2,1556,3,1,2142,0,2146,G
1-PB2,1557,0,2136,0,2,2138,T
1-PB2,1558,0,5,2136,0,2141,G
1-PB2,1559,2137,0,5,0,2142,A
1-PB2,1560,2066,0,0,0,2066,A
1-PB2,1561,2071,0,2,0,2073,A
1-PB2,1562,0,1,1,2070,2072,C
1-PB2,1563,2060,1,0,0,2061,A
1-PB2,1564,0,0,0,2064,2064,C
1-PB2,1565,1979,0,4,0,1983,A
1-PB2,1566,1,3,1989,0,1993,G
1-PB2,1567,0,3,1980,0,1983,G
1-PB2,1568,1,0,1994,0,1995,G
1-PB2,1569,1988,0,2,0,1990,A
1-PB2,1570,1966,0,5,0,1971,A
1-PB2,1571,0,0,0,1984,1984,C
1-PB2,1572,0,1945,0,4,1949,T
1-PB2,1573,1,4,1943,0,1948,G
1-PB2,1574,1943,0,2,0,1945,A
1-PB2,1575,1,2,1944,0,1947,G
1-PB2,1576,1905,0,1,0,1906,A
1-PB2,1577,0,5,1819,0,1824,G
1-PB2,1578,1808,0,4,0,1812,A
1-PB2,1579,0,0,0,1810,1810,C
1-PB2,1580,0,1740,0,0,1740,T
1-PB2,1581,1,5,1775,0,1781,G
1-PB2,1582,1768,1,6,0,1775,A
1-PB2,1583,0,1,0,1772,1773,C
1-PB2,1584,1762,0,2,0,1764,A
1-PB2,1585,1763,0,1,0,1764,A
1-PB2,1586,1,1760,0,1,1762,T
1-PB2,1587,1773,0,1,0,1774,A
1-PB2,1588,1774,1,2,0,1777,A
1-PB2,1589,0,1,0,1778,1779,C
1-PB2,1590,0,1680,0,2,1682,T
1-PB2,1591,0,1669,0,1,1670,T
1-PB2,1592,1646,0,1,0,1647,A
1-PB2,1593,0,1639,0,3,1642,T
1-PB2,1594,1,1635,1,2,1639,T
1-PB2,1595,4,0,0,1630,1634,C
1-PB2,1596,1532,1,0,0,1533,A
1-PB2,1597,0,1530,0,2,1532,T
1-PB2,1598,1,2,0,1478,1481,C
1-PB2,1599,2,0,1480,0,1482,G
1-PB2,1600,0,1490,0,2,1492,T
1-PB2,1601,3,0,0,1465,1468,C
1-PB2,1602,1,2,1475,0,1478,G
1-PB2,1603,1476,0,0,0,1476,A
1-PB2,1604,0,1482,0,0,1482,T
1-PB2,1605,0,1,1480,0,1481,G
1-PB2,1606,1484,0,0,0,1484,A
1-PB2,1607,0,1475,0,2,1477,T
1-PB2,1608,0,1,1475,0,1476,G
1-PB2,1609,0,1415,0,1,1416,T
1-PB2,1610,3,3,1404,0,1410,G
1-PB2,1611,0,2,1410,0,1412,G
1-PB2,1612,0,3,1405,0,1408,G
1-PB2,1613,1390,0,1,1,1392,A
1-PB2,1614,1,0,1397,0,1398,G
1-PB2,1615,1298,1,1,0,1300,A
1-PB2,1616,0,1283,0,0,1283,T
1-PB2,1617,1,1252,0,1,1254,T
1-PB2,1618,1250,0,1,1,1252,A
1-PB2,1619,1244,0,3,1,1248,A
1-PB2,1620,0,1,1,1232,1234,C
1-PB2,1621,2,4,1179,0,1185,G
1-PB2,1622,0,1,1193,0,1194,G
1-PB2,1623,0,1103,0,1,1104,T
1-PB2,1624,2,0,0,1093,1095,C
1-PB2,1625,1,0,0,1092,1093,C
1-PB2,1626,0,1053,1,0,1054,T
1-PB2,1627,0,1,1054,0,1055,G
1-PB2,1628,1054,1,0,1,1056,A
1-PB2,1629,0,0,1065,0,1065,G
1-PB2,1630,0,1063,0,0,1063,T
1-PB2,1631,8,0,1,1021,1030,C
1-PB2,1632,2,2,1028,0,1032,G
1-PB2,1633,0,0,1048,0,1048,G
1-PB2,1634,0,1044,0,2,1046,T
1-PB2,1635,0,1046,0,0,1046,T
1-PB2,1636,0,1039,0,0,1039,T
1-PB2,1637,0,1033,0,0,1033,T
1-PB2,1638,0,0,1065,0,1065,G
1-PB2,1639,2,0,1064,0,1066,G
1-PB2,1640,0,1063,0,2,1065,T
1-PB2,1641,2,0,0,1058,1060,C
1-PB2,1642,1046,1,0,0,1047,A
1-PB2,1643,1097,0,1,0,1098,A
1-PB2,1644,0,1099,1,0,1100,T
1-PB2,1645,1106,0,0,0,1106,A
1-PB2,1646,0,0,0,1131,1131,C
1-PB2,1647,0,3,0,1086,1089,C
1-PB2,1648,0,1083,0,1,1084,T
1-PB2,1649,1099,0,0,0,1099,A
1-PB2,1650,0,1103,0,1,1104,T
1-PB2,1651,0,0,0,1109,1109,C
1-PB2,1652,1064,0,1,0,1065,A
1-PB2,1653,1064,1,0,0,1065,A
1-PB2,1654,0,1057,0,0,1057,T
1-PB2,1655,0,2,1018,0,1020,G
1-PB2,1656,0,0,1027,0,1027,G
1-PB2,1657,1018,0,2,0,1020,A
1-PB2,1658,1,1008,0,0,1009,T
1-PB2,1659,3,2,0,1000,1005,C
1-PB2,1660,1008,0,0,0,1008,A
1-PB2,1661,0,1003,0,1,1004,T
1-PB2,1662,0,1,0,1007,1008,C
1-PB2,1663,1003,0,3,0,1006,A
1-PB2,1664,0,1,1014,0,1015,G
1-PB2,1665,1011,0,0,0,1011,A
1-PB2,1666,1008,0,1,0,1009,A
1-PB2,1667,1007,0,0,0,1007,A
1-PB2,1668,0,1008,0,1,1009,T
1-PB2,1669,0,1006,0,0,1006,T
1-PB2,1670,0,5,1003,0,1008,G
1-PB2,1671,1,1,1003,0,1005,G
1-PB2,1672,0,0,1004,0,1004,G
1-PB2,1673,999,0,0,0,999,A
1-PB2,1674,997,0,0,0,997,A
1-PB2,1675,1,0,997,0,998,G
1-PB2,1676,0,0,0,998,998,C
1-PB2,1677,0,985,0,2,987,T
1-PB2,1678,0,0,1002,0,1002,G
1-PB2,1679,0,997,0,3,1000,T
1-PB2,1680,2,0,0,997,999,C
1-PB2,1681,1003,0,0,0,1003,A
1-PB2,1682,1005,0,0,0,1005,A
1-PB2,1683,998,0,0,0,998,A
1-PB2,1684,1007,0,0,0,1007,A
1-PB2,1685,0,1009,0,0,1009,T
1-PB2,1686,1,1007,0,0,1008,T
1-PB2,1687,3,0,0,1003,1006,C
1-PB2,1688,998,0,0,0,998,A
1-PB2,1689,998,0,1,0,999,A
1-PB2,1690,0,997,0,1,998,T
1-PB2,1691,0,1,995,0,996,G
1-PB2,1692,0,0,1013,0,1013,G
1-PB2,1693,0,1026,0,1,1027,T
1-PB2,1694,0,0,0,1035,1035,C
1-PB2,1695,0,1029,0,0,1029,T
1-PB2,1696,2,0,0,1032,1034,C
1-PB2,1697,1035,0,0,0,1035,A
1-PB2,1698,0,0,1033,0,1033,G
1-PB2,1699,1032,0,1,0,1033,A
1-PB2,1700,1037,0,1,0,1038,A
1-PB2,1701,1,1035,0,0,1036,T
1-PB2,1702,1,1,0,1003,1005,C
1-PB2,1703,0,0,0,1010,1010,C
1-PB2,1704,0,1011,0,1,1012,T
1-PB2,1705,2,0,1011,0,1013,G
1-PB2,1706,0,1,0,1013,1014,C
1-PB2,1707,1010,0,0,0,1010,A
1-PB2,1708,1018,0,0,0,1018,A
1-PB2,1709,0,1004,0,1,1005,T
1-PB2,1710,0,0,1029,0,1029,G
1-PB2,1711,0,1033,0,1,1034,T
1-PB2,1712,0,1007,1,0,1008,T
1-PB2,1713,0,0,1015,0,1015,G
1-PB2,1714,0,1017,0,0,1017,T
1-PB2,1715,1013,0,4,0,1017,A
1-PB2,1716,0,0,0,1020,1020,C
1-PB2,1717,997,0,0,0,997,A
1-PB2,1718,1000,0,3,0,1003,A
1-PB2,1719,0,0,0,986,986,C
1-PB2,1720,961,0,0,0,961,A
1-PB2,1721,962,0,0,0,962,A
1-PB2,1722,942,0,1,0,943,A
1-PB2,1723,944,0,2,0,946,A
1-PB2,1724,1,942,0,1,944,T
1-PB2,1725,2,0,945,0,947,G
1-PB2,1726,0,0,943,0,943,G
1-PB2,1727,938,0,0,0,938,A
1-PB2,1728,938,0,1,0,939,A
1-PB2,1729,0,936,0,1,937,T
1-PB2,1730,0,937,0,0,937,T
1-PB2,1731,0,938,0,0,938,T
1-PB2,1732,0,0,939,0,939,G
1-PB2,1733,940,0,0,0,940,A
1-PB2,1734,941,0,1,0,942,A
1-PB2,1735,2,0,0,937,939,C
1-PB2,1736,1,0,0,933,934,C
1-PB2,1737,940,0,1,0,941,A
1-PB2,1738,0,950,1,3,954,T
1-PB2,1739,1,951,0,1,953,T
1-PB2,1740,0,955,0,1,956,T
1-PB2,1741,2,0,0,951,953,C
1-PB2,1742,952,0,1,0,953,A
1-PB2,1743,956,0,0,0,956,A
1-PB2,1744,0,952,0,1,953,T
1-PB2,1745,0,4,0,965,969,C
1-PB2,1746,2,948,1,2,953,T
1-PB2,1747,1,949,0,0,950,T
1-PB2,1748,0,954,0,1,955,T
1-PB2,1749,954,0,2,0,956,A
1-PB2,1750,0,0,959,0,959,G
1-PB2,1751,0,955,0,0,955,T
1-PB2,1752,0,3,0,967,970,C
1-PB2,1753,0,0,0,965,965,C
1-PB2,1754,1,0,0,952,953,C
1-PB2,1755,0,0,0,956,956,C
1-PB2,1756,958,0,0,1,959,A
1-PB2,1757,963,1,0,0,964,A
1-PB2,1758,1,0,983,0,984,G
1-PB2,1759,0,0,971,0,971,G
1-PB2,1760,1,1,0,972,974,C
1-PB2,1761,1,0,0,960,961,C
1-PB2,1762,960,0,1,0,961,A
1-PB2,1763,0,971,0,3,974,T
1-PB2,1764,0,977,0,0,977,T
1-PB2,1765,975,0,2,0,977,A
1-PB2,1766,1,0,972,0,973,G
1-PB2,1767,943,1,0,0,944,A
1-PB2,1768,997,1,1,0,999,A
1-PB2,1769,0,0,1005,0,1005,G
1-PB2,1770,0,0,0,1009,1009,C
1-PB2,1771,1,0,0,1005,1006,C
1-PB2,1772,995,0,0,0,995,A
1-PB2,1773,1003,1,0,0,1004,A
1-PB2,1774,0,1008,0,0,1008,T
1-PB2,1775,1014,1,0,0,1015,A
1-PB2,1776,0,0,0,1019,1019,C
1-PB2,1777,936,0,1,0,937,A
1-PB2,1778,0,0,939,0,939,G
1-PB2,1779,0,911,0,0,911,T
1-PB2,1780,2,0,919,0,921,G
1-PB2,1781,0,2,911,0,913,G
1-PB2,1782,1,2,913,0,916,G
1-PB2,1783,0,898,0,0,898,T
1-PB2,1784,0,890,0,0,890,T
1-PB2,1785,0,907,0,2,909,T
1-PB2,1786,0,0,914,0,914,G
1-PB2,1787,0,915,0,0,915,T
1-PB2,1788,2,0,0,909,911,C
1-PB2,1789,902,1,0,1,904,A
1-PB2,1790,1,1,902,0,904,G
1-PB2,1791,894,0,0,0,894,A
1-PB2,1792,897,0,0,0,897,A
1-PB2,1793,0,0,0,896,896,C
1-PB2,1794,0,862,0,1,863,T
1-PB2,1795,1,0,0,887,888,C
1-PB2,1796,0,890,0,2,892,T
1-PB2,1797,897,0,1,0,898,A
1-PB2,1798,1,896,0,3,900,T
1-PB2,1799,1,891,0,0,892,T
1-PB2,1800,4,0,0,891,895,C
1-PB2,1801,1,1,0,894,896,C
1-PB2,1802,895,0,0,0,895,A
1-PB2,1803,897,0,0,0,897,A
1-PB2,1804,0,0,0,892,892,C
1-PB2,1805,887,0,0,0,887,A
1-PB2,1806,890,0,1,0,891,A
1-PB2,1807,891,0,1,0,892,A
1-PB2,1808,0,898,0,0,898,T
1-PB2,1809,1,1,893,0,895,G
1-PB2,1810,893,0,3,0,896,A
1-PB2,1811,0,1,900,0,901,G
1-PB2,1812,902,0,0,0,902,A
1-PB2,1813,1,3,898,0,902,G
1-PB2,1814,901,0,1,0,902,A
1-PB2,1815,0,0,0,898,898,C
1-PB2,1816,0,0,899,0,899,G
1-PB2,1817,0,901,0,1,902,T
1-PB2,1818,914,0,0,0,914,A
1-PB2,1819,0,0,1,918,919,C
1-PB2,1820,0,909,0,0,909,T
1-PB2,1821,0,911,0,1,912,T
1-PB2,1822,0,3,902,0,905,G
1-PB2,1823,0,1,896,0,897,G
1-PB2,1824,0,1,903,0,904,G
1-PB2,1825,889,0,0,0,889,A
1-PB2,1826,0,0,0,894,894,C
1-PB2,1827,894,0,0,0,894,A
1-PB2,1828,0,894,0,0,894,T
1-PB2,1829,0,897,0,0,897,T
1-PB2,1830,1,897,1,1,900,T
1-PB2,1831,0,0,898,0,898,G
1-PB2,1832,897,0,1,0,898,A
1-PB2,1833,0,0,0,895,895,C
1-PB2,1834,892,0,0,0,892,A
1-PB2,1835,0,0,0,897,897,C
1-PB2,1836,2,1,0,879,882,C
1-PB2,1837,898,0,3,0,901,A
1-PB2,1838,0,1,0,900,901,C
1-PB2,1839,2,0,0,895,897,C
1-PB2,1840,1,0,0,902,903,C
1-PB2,1841,902,0,1,0,903,A
1-PB2,1842,0,1,918,0,919,G
1-PB2,1843,920,0,1,0,921,A
1-PB2,1844,0,964,0,0,964,T
1-PB2,1845,952,0,1,0,953,A
1-PB2,1846,942,0,0,0,942,A
1-PB2,1847,0,942,0,0,942,T
1-PB2,1848,937,0,0,0,937,A
1-PB2,1849,937,0,0,0,937,A
1-PB2,1850,932,0,1,0,933,A
1-PB2,1851,2,0,941,0,943,G
1-PB2,1852,0,0,0,934,934,C
1-PB2,1853,0,901,0,1,902,T
1-PB2,1854,0,900,0,0,900,T
1-PB2,1855,1,0,0,901,902,C
1-PB2,1856,0,895,0,1,896,T
1-PB2,1857,1,0,0,918,919,C
1-PB2,1858,0,1,1,911,913,C
1-PB2,1859,1,0,0,922,923,C
1-PB2,1860,0,917,0,1,918,T
1-PB2,1861,0,918,0,1,919,T
1-PB2,1862,0,915,0,4,919,T
1-PB2,1863,0,918,0,0,918,T
1-PB2,1864,0,0,918,0,918,G
1-PB2,1865,0,0,0,923,923,C
1-PB2,1866,907,0,1,0,908,A
1-PB2,1867,0,0,910,0,910,G
1-PB2,1868,0,0,0,904,904,C
1-PB2,1869,0,901,0,0,901,T
1-PB2,1870,0,0,902,0,902,G
1-PB2,1871,0,0,0,902,902,C
1-PB2,1872,0,899,0,2,901,T
1-PB2,1873,1,0,0,910,911,C
1-PB2,1874,2,1,0,914,917,C
1-PB2,1875,926,0,0,0,926,A
1-PB2,1876,0,0,0,926,926,C
1-PB2,1877,2,0,0,922,924,C
1-PB2,1878,923,0,0,0,923,A
1-PB2,1879,923,0,0,1,924,A
1-PB2,1880,921,0,0,0,921,A
1-PB2,1881,0,0,929,0,929,G
1-PB2,1882,0,1,0,927,928,C
1-PB2,1883,907,0,0,0,907,A
1-PB2,1884,905,1,0,0,906,A
1-PB2,1885,904,0,1,0,905,A
1-PB2,1886,0,0,919,0,919,G
1-PB2,1887,1,0,0,915,916,C
1-PB2,1888,916,0,1,0,917,A
1-PB2,1889,0,2,921,1,924,G
1-PB2,1890,917,1,0,0,918,A
1-PB2,1891,927,1,0,0,928,A
1-PB2,1892,1,927,0,0,928,T
1-PB2,1893,0,0,925,0,925,G
1-PB2,1894,1,1,0,923,925,C
1-PB2,1895,912,0,0,0,912,A
1-PB2,1896,1,1,922,0,924,G
1-PB2,1897,0,922,0,1,923,T
1-PB2,1898,2,954,0,1,957,T
1-PB2,1899,2,0,0,963,965,C
1-PB2,1900,1,952,0,3,956,T
1-PB2,1901,0,0,0,974,974,C
1-PB2,1902,0,970,0,2,972,T
1-PB2,1903,0,975,0,0,975,T
1-PB2,1904,1,0,0,978,979,C
1-PB2,1905,967,0,0,0,967,A
1-PB2,1906,0,0,0,967,967,C
1-PB2,1907,0,931,0,0,931,T
1-PB2,1908,1,1,939,0,941,G
1-PB2,1909,932,1,0,0,933,A
1-PB2,1910,0,0,0,952,952,C
1-PB2,1911,0,935,0,0,935,T
1-PB2,1912,0,0,953,0,953,G
1-PB2,1913,0,949,0,2,951,T
1-PB2,1914,0,0,960,0,960,G
1-PB2,1915,958,0,1,0,959,A
1-PB2,1916,968,0,0,1,969,A
1-PB2,1917,0,941,0,0,941,T
1-PB2,1918,1,0,944,0,945,G
1-PB2,1919,0,913,0,1,914,T
1-PB2,1920,1,2,910,1,914,G
1-PB2,1921,909,0,0,0,909,A
1-PB2,1922,1,4,905,0,910,G
1-PB2,1923,0,1,902,0,903,G
1-PB2,1924,0,1,899,0,900,G
1-PB2,1925,0,1,932,0,933,G
1-PB2,1926,929,0,1,0,930,A
1-PB2,1927,0,925,0,0,925,T
1-PB2,1928,0,0,0,925,925,C
1-PB2,1929,927,0,0,0,927,A
1-PB2,1930,0,4,937,0,941,G
1-PB2,1931,1,2,928,0,931,G
1-PB2,1932,1,0,937,0,938,G
1-PB2,1933,932,0,1,0,933,A
1-PB2,1934,1,888,0,0,889,T
1-PB2,1935,0,1,895,0,896,G
1-PB2,1936,894,0,1,0,895,A
1-PB2,1937,0,2,919,0,921,G
1-PB2,1938,920,0,0,0,920,A
1-PB2,1939,893,0,0,0,893,A
1-PB2,1940,0,907,0,0,907,T
1-PB2,1941,904,0,0,0,904,A
1-PB2,1942,0,0,0,918,918,C
1-PB2,1943,0,913,0,2,915,T
1-PB2,1944,0,909,0,0,909,T
1-PB2,1945,0,0,918,0,918,G
1-PB2,1946,0,887,0,1,888,T
1-PB2,1947,884,0,1,0,885,A
1-PB2,1948,882,0,0,1,883,A
1-PB2,1949,0,5,866,0,871,G
1-PB2,1950,0,3,883,0,886,G
1-PB2,1951,0,1,856,0,857,G
1-PB2,1952,0,0,863,0,863,G
1-PB2,1953,2,0,0,869,871,C
1-PB2,1954,865,0,0,0,865,A
1-PB2,1955,881,0,0,0,881,A
1-PB2,1956,1,881,0,2,884,T
1-PB2,1957,1,879,0,2,882,T
1-PB2,1958,1,0,0,896,897,C
1-PB2,1959,1,875,0,2,878,T
1-PB2,1960,1,0,0,893,894,C
1-PB2,1961,0,0,0,895,895,C
1-PB2,1962,0,892,0,2,894,T
1-PB2,1963,1,0,920,0,921,G
1-PB2,1964,0,896,0,1,897,T
1-PB2,1965,907,0,0,0,907,A
1-PB2,1966,1,903,0,1,905,T
1-PB2,1967,0,891,0,1,892,T
1-PB2,1968,3,0,0,891,894,C
1-PB2,1969,887,0,0,1,888,A
1-PB2,1970,897,0,0,0,897,A
1-PB2,1971,0,2,0,893,895,C
1-PB2,1972,0,871,0,0,871,T
1-PB2,1973,876,0,0,0,876,A
1-PB2,1974,0,0,1,898,899,C
1-PB2,1975,898,0,0,0,898,A
1-PB2,1976,898,0,1,0,899,A
1-PB2,1977,0,1,0,898,899,C
1-PB2,1978,890,0,0,0,890,A
1-PB2,1979,885,0,0,0,885,A
1-PB2,1980,0,2,882,0,884,G
1-PB2,1981,885,0,2,0,887,A
1-PB2,1982,0,0,0,890,890,C
1-PB2,1983,1,2,0,861,864,C
1-PB2,1984,866,0,2,0,868,A
1-PB2,1985,0,0,0,902,902,C
1-PB2,1986,0,899,0,0,899,T
1-PB2,1987,897,0,0,0,897,A
1-PB2,1988,899,1,0,1,901,A
1-PB2,1989,897,0,0,0,897,A
1-PB2,1990,900,0,0,0,900,A
1-PB2,1991,0,0,908,0,908,G
1-PB2,1992,899,3,1,0,903,A
1-PB2,1993,0,0,0,906,906,C
1-PB2,1994,0,884,0,2,886,T
1-PB2,1995,887,0,0,0,887,A
1-PB2,1996,886,0,0,0,886,A
1-PB2,1997,0,1,0,884,885,C
1-PB2,1998,882,0,0,0,882,A
1-PB2,1999,885,0,0,0,885,A
1-PB2,2000,0,867,0,1,868,T
1-PB2,2001,0,868,0,1,869,T
1-PB2,2002,1,0,0,872,873,C
1-PB2,2003,0,863,0,0,863,T
1-PB2,2004,1,0,0,874,875,C
1-PB2,2005,0,1,873,0,874,G
1-PB2,2006,0,0,875,0,875,G
1-PB2,2007,874,0,0,0,874,A
1-PB2,2008,872,0,1,0,873,A
1-PB2,2009,876,0,0,0,876,A
1-PB2,2010,870,0,5,0,875,A
1-PB2,2011,0,1,872,0,873,G
1-PB2,2012,874,0,3,0,877,A
1-PB2,2013,0,876,0,1,877,T
1-PB2,2014,0,0,874,0,874,G
1-PB2,2015,0,0,0,868,868,C
1-PB2,2016,0,0,0,870,870,C
1-PB2,2017,1,2,865,0,868,G
1-PB2,2018,0,0,870,0,870,G
1-PB2,2019,1,2,0,863,866,C
1-PB2,2020,871,0,0,0,871,A
1-PB2,2021,0,0,0,884,884,C
1-PB2,2022,0,881,0,1,882,T
1-PB2,2023,0,881,0,0,881,T
1-PB2,2024,0,885,0,1,886,T
1-PB2,2025,886,0,0,1,887,A
1-PB2,2026,891,0,0,0,891,A
1-PB2,2027,0,888,0,0,888,T
1-PB2,2028,0,891,0,0,891,T
1-PB2,2029,0,2,887,0,889,G
1-PB2,2030,879,1,0,0,880,A
1-PB2,2031,873,1,0,0,874,A
1-PB2,2032,0,1,877,0,878,G
1-PB2,2033,881,0,0,0,881,A
1-PB2,2034,1,0,0,881,882,C
1-PB2,2035,2,0,0,869,871,C
1-PB2,2036,0,1,0,871,872,C
1-PB2,2037,872,0,0,0,872,A
1-PB2,2038,1,0,882,0,883,G
1-PB2,2039,884,0,0,0,884,A
1-PB2,2040,0,883,0,1,884,T
1-PB2,2041,0,0,888,0,888,G
1-PB2,2042,866,0,2,0,868,A
1-PB2,2043,868,0,0,0,868,A
1-PB2,2044,873,0,2,0,875,A
1-PB2,2045,0,0,879,0,879,G
1-PB2,2046,0,1,0,880,881,C
1-PB2,2047,868,0,1,0,869,A
1-PB2,2048,0,0,0,879,879,C
1-PB2,2049,873,0,0,0,873,A
1-PB2,2050,1,866,0,1,868,T
1-PB2,2051,2,0,0,880,882,C
1-PB2,2052,0,0,0,879,879,C
1-PB2,2053,0,2,879,0,881,G
1-PB2,2054,1,0,885,0,886,G
1-PB2,2055,882,0,0,0,882,A
1-PB2,2056,0,1,888,0,889,G
1-PB2,2057,0,877,0,1,878,T
1-PB2,2058,2,0,872,1,875,G
1-PB2,2059,0,2,875,0,877,G
1-PB2,2060,867,0,2,0,869,A
1-PB2,2061,0,0,870,0,870,G
1-PB2,2062,0,855,0,3,858,T
1-PB2,2063,0,0,0,857,857,C
1-PB2,2064,2,1,0,856,859,C
1-PB2,2065,0,0,854,0,854,G
1-PB2,2066,0,2,0,848,850,C
1-PB2,2067,0,1,0,847,848,C
1-PB2,2068,1,1,863,0,865,G
1-PB2,2069,0,866,0,1,867,T
1-PB2,2070,1,2,0,872,875,C
1-PB2,2071,0,871,0,1,872,T
1-PB2,2072,0,872,0,1,873,T
1-PB2,2073,0,2,869,0,871,G
1-PB2,2074,865,1,0,0,866,A
1-PB2,2075,1,2,863,0,866,G
1-PB2,2076,854,0,5,0,859,A
1-PB2,2077,0,3,832,0,835,G
1-PB2,2078,0,1,837,0,838,G
1-PB2,2079,0,1,830,0,831,G
1-PB2,2080,0,822,0,2,824,T
1-PB2,2081,0,822,0,0,822,T
1-PB2,2082,0,822,0,1,823,T
1-PB2,2083,4,0,0,821,825,C
1-PB2,2084,0,823,0,1,824,T
1-PB2,2085,2,0,0,843,845,C
1-PB2,2086,844,0,2,0,846,A
1-PB2,2087,0,832,0,0,832,T
1-PB2,2088,1,822,0,0,823,T
1-PB2,2089,821,0,2,0,823,A
1-PB2,2090,0,827,0,0,827,T
1-PB2,2091,819,0,0,0,819,A
1-PB2,2092,1,1,828,0,830,G
1-PB2,2093,0,0,829,0,829,G
1-PB2,2094,1,782,0,0,783,T
1-PB2,2095,788,0,0,0,788,A
1-PB2,2096,780,1,0,0,781,A
1-PB2,2097,2,1,782,0,785,G
1-PB2,2098,0,0,787,0,787,G
1-PB2,2099,779,0,0,1,780,A
1-PB2,2100,765,1,1,0,767,A
1-PB2,2101,0,0,768,0,768,G
1-PB2,2102,759,0,1,0,760,A
1-PB2,2103,0,0,0,765,765,C
1-PB2,2104,759,0,2,0,761,A
1-PB2,2105,1,0,763,0,764,G
1-PB2,2106,758,0,0,0,758,A
1-PB2,2107,750,0,3,0,753,A
1-PB2,2108,1,1,750,0,752,G
1-PB2,2109,748,0,2,0,750,A
1-PB2,2110,0,743,0,0,743,T
1-PB2,2111,745,0,0,0,745,A
1-PB2,2112,0,2,0,739,741,C
1-PB2,2113,1,0,734,0,735,G
1-PB2,2114,0,2,747,0,749,G
1-PB2,2115,746,0,1,0,747,A
1-PB2,2116,0,3,0,742,745,C
1-PB2,2117,1,0,0,736,737,C
1-PB2,2118,726,0,1,0,727,A
1-PB2,2119,0,0,753,0,753,G
1-PB2,2120,0,0,1,753,754,C
1-PB2,2121,752,0,1,0,753,A
1-PB2,2122,0,750,0,0,750,T
1-PB2,2123,0,724,0,0,724,T
1-PB2,2124,725,0,0,0,725,A
1-PB2,2125,723,0,0,0,723,A
1-PB2,2126,0,0,725,0,725,G
1-PB2,2127,0,0,0,722,722,C
1-PB2,2128,670,0,1,0,671,A
1-PB2,2129,0,682,0,2,684,T
1-PB2,2130,0,0,0,682,682,C
1-PB2,2131,681,0,0,0,681,A
1-PB2,2132,684,0,0,0,684,A
1-PB2,2133,0,682,0,0,682,T
1-PB2,2134,0,0,688,0,688,G
1-PB2,2135,679,0,2,0,681,A
1-PB2,2136,681,0,1,0,682,A
1-PB2,2137,0,0,0,688,688,C
1-PB2,2138,0,643,1,0,644,T
1-PB2,2139,0,0,663,0,663,G
1-PB2,2140,656,0,0,0,656,A
1-PB2,2141,0,0,654,0,654,G
1-PB2,2142,0,658,0,0,658,T
1-PB2,2143,651,0,0,0,651,A
1-PB2,2144,648,1,0,0,649,A
1-PB2,2145,1,0,0,649,650,C
1-PB2,2146,1,0,0,635,636,C
1-PB2,2147,0,628,0,0,628,T
1-PB2,2148,0,606,0,0,606,T
1-PB2,2149,0,0,606,0,606,G
1-PB2,2150,0,0,0,608,608,C
1-PB2,2151,606,0,0,0,606,A
1-PB2,2152,608,0,0,0,608,A
1-PB2,2153,598,0,0,0,598,A
1-PB2,2154,591,0,1,0,592,A
1-PB2,2155,0,1,594,0,595,G
1-PB2,2156,0,1,592,0,593,G
1-PB2,2157,0,1,589,1,591,G
1-PB2,2158,1,0,589,0,590,G
1-PB2,2159,593,0,0,0,593,A
1-PB2,2160,591,0,0,0,591,A
1-PB2,2161,590,0,0,0,590,A
1-PB2,2162,600,0,3,0,603,A
1-PB2,2163,0,0,605,0,605,G
1-PB2,2164,0,0,602,0,602,G
1-PB2,2165,0,0,0,597,597,C
1-PB2,2166,0,603,0,0,603,T
1-PB2,2167,600,0,0,0,600,A
1-PB2,2168,600,0,0,0,600,A
1-PB2,2169,0,598,0,0,598,T
1-PB2,2170,0,0,608,0,608,G
1-PB2,2171,0,583,0,2,585,T
1-PB2,2172,0,0,581,0,581,G
1-PB2,2173,0,0,0,579,579,C
1-PB2,2174,0,579,0,0,579,T
1-PB2,2175,580,0,0,0,580,A
1-PB2,2176,579,0,0,0,579,A
1-PB2,2177,0,575,0,0,575,T
1-PB2,2178,1,3,0,569,573,C
1-PB2,2179,0,0,554,0,554,G
1-PB2,2180,0,1,550,0,551,G
1-PB2,2181,0,1,552,0,553,G
1-PB2,2182,1,0,0,551,552,C
1-PB2,2183,554,0,0,0,554,A
1-PB2,2184,555,0,1,0,556,A
1-PB2,2185,0,1,556,0,557,G
1-PB2,2186,0,1,553,0,554,G
1-PB2,2187,550,0,1,0,551,A
1-PB2,2188,0,1,554,0,555,G
1-PB2,2189,540,0,0,0,540,A
1-PB2,2190,0,0,0,539,539,C
1-PB2,2191,0,1,539,0,540,G
1-PB2,2192,0,537,0,0,537,T
1-PB2,2193,0,0,530,1,531,G
1-PB2,2194,0,0,538,0,538,G
1-PB2,2195,0,525,0,0,525,T
1-PB2,2196,0,0,527,0,527,G
1-PB2,2197,0,518,0,0,518,T
1-PB2,2198,0,512,0,0,512,T
1-PB2,2199,0,1,512,0,513,G
1-PB2,2200,0,1,512,0,513,G
1-PB2,2201,0,510,0,0,510,T
1-PB2,2202,501,0,0,0,501,A
1-PB2,2203,486,0,0,0,486,A
1-PB2,2204,0,473,0,0,473,T
1-PB2,2205,0,0,470,0,470,G
1-PB2,2206,465,0,0,0,465,A
1-PB2,2207,457,0,0,0,457,A
1-PB2,2208,458,0,0,0,458,A
1-PB2,2209,0,1,0,452,453,C
1-PB2,2210,0,1,451,0,452,G
1-PB2,2211,453,0,0,0,453,A
1-PB2,2212,449,0,1,0,450,A
1-PB2,2213,449,0,0,0,449,A
1-PB2,2214,449,0,2,0,451,A
1-PB2,2215,0,0,0,453,453,C
1-PB2,2216,1,1,449,0,451,G
1-PB2,2217,0,0,451,0,451,G
1-PB2,2218,0,0,452,0,452,G
1-PB2,2219,451,0,0,0,451,A
1-PB2,2220,0,0,0,452,452,C
1-PB2,2221,0,446,0,1,447,T
1-PB2,2222,0,0,0,456,456,C
1-PB2,2223,0,456,0,0,456,T
1-PB2,2224,456,0,0,0,456,A
1-PB2,2225,1,0,454,0,455,G
1-PB2,2226,0,1,1,443,445,C
1-PB2,2227,442,0,2,0,444,A
1-PB2,2228,0,439,0,0,439,T
1-PB2,2229,418,0,0,0,418,A
1-PB2,2230,0,0,0,419,419,C
1-PB2,2231,0,370,0,1,371,T
1-PB2,2232,0,369,0,0,369,T
1-PB2,2233,353,0,0,0,353,A
1-PB2,2234,1,0,0,352,353,C
1-PB2,2235,0,347,0,0,347,T
1-PB2,2236,0,1,346,0,347,G
1-PB2,2237,339,1,0,0,340,A
1-PB2,2238,0,0,0,342,342,C
1-PB2,2239,305,0,0,0,305,A
1-PB2,2240,0,0,308,0,308,G
1-PB2,2241,0,0,0,307,307,C
1-PB2,2242,1,0,0,307,308,C
1-PB2,2243,303,0,0,0,303,A
1-PB2,2244,0,1,303,0,304,G
1-PB2,2245,303,0,0,0,303,A
1-PB2,2246,0,0,0,301,301,C
1-PB2,2247,275,0,2,0,277,A
1-PB2,2248,0,0,276,0,276,G
1-PB2,2249,0,0,0,266,266,C
1-PB2,2250,0,0,267,0,267,G
1-PB2,2251,267,0,0,0,267,A
1-PB2,2252,0,0,0,267,267,C
1-PB2,2253,0,0,0,263,263,C
1-PB2,2254,263,0,0,0,263,A
1-PB2,2255,264,0,0,0,264,A
1-PB2,2256,264,0,0,0,264,A
1-PB2,2257,264,0,0,0,264,A
1-PB2,2258,0,0,265,0,265,G
1-PB2,2259,250,0,0,0,250,A
1-PB2,2260,253,0,0,0,253,A
1-PB2,2261,0,251,0,0,251,T
1-PB2,2262,0,247,0,0,247,T
1-PB2,2263,1,0,0,249,250,C
1-PB2,2264,0,0,243,0,243,G
1-PB2,2265,0,0,243,0,243,G
1-PB2,2266,243,0,0,0,243,A
1-PB2,2267,0,233,0,0,233,T
1-PB2,2268,0,0,230,0,230,G
1-PB2,2269,0,0,232,0,232,G
1-PB2,2270,0,0,0,230,230,C
1-PB2,2271,0,0,0,232,232,C
1-PB2,2272,230,0,1,0,231,A
1-PB2,2273,1,230,0,0,231,T
1-PB2,2274,3,0,0,227,230,C
1-PB2,2275,228,0,0,0,228,A
1-PB2,2276,229,0,0,0,229,A
1-PB2,2277,0,224,0,1,225,T
1-PB2,2278,0,201,0,0,201,T
1-PB2,2279,187,0,0,0,187,A
1-PB2,2280,183,0,0,0,183,A
2-PB1,1,310,0,0,0,310,A
2-PB1,2,0,311,0,0,311,T
2-PB1,3,0,0,316,0,316,G
2-PB1,4,0,2,350,0,352,G
2-PB1,5,395,1,0,0,396,A
2-PB1,6,0,426,0,0,426,T
2-PB1,7,1,0,431,0,432,G
2-PB1,8,1,434,0,0,435,T
2-PB1,9,0,0,0,465,465,C
2-PB1,10,466,0,0,0,466,A
2-PB1,11,488,0,0,0,488,A
2-PB1,12,0,487,0,1,488,T
2-PB1,13,0,0,0,493,493,C
2-PB1,14,0,2,0,520,522,C
2-PB1,15,1,1,528,0,530,G
2-PB1,16,593,0,2,0,595,A
2-PB1,17,0,0,0,611,611,C
2-PB1,18,0,608,0,4,612,T
2-PB1,19,0,0,0,705,705,C
2-PB1,20,0,702,0,3,705,T
2-PB1,21,715,0,0,0,715,A
2-PB1,22,0,0,0,715,715,C
2-PB1,23,0,714,0,0,714,T
2-PB1,24,0,0,790,0,790,G
2-PB1,25,0,795,0,0,795,T
2-PB1,26,0,793,0,2,795,T
2-PB1,27,1,0,0,795,796,C
2-PB1,28,0,1,0,794,795,C
2-PB1,29,0,947,0,0,947,T
2-PB1,30,953,0,0,0,953,A
2-PB1,31,953,0,1,0,954,A
2-PB1,32,960,0,1,0,961,A
2-PB1,33,0,1,966,0,967,G
2-PB1,34,0,0,974,0,974,G
2-PB1,35,0,981,0,4,985,T
2-PB1,36,0,982,0,2,984,T
2-PB1,37,1,0,0,985,986,C
2-PB1,38,0,0,0,987,987,C
2-PB1,39,988,0,1,1,990,A
2-PB1,40,0,0,1000,0,1000,G
2-PB1,41,1,2,0,1001,1004,C
2-PB1,42,1,0,1004,0,1005,G
2-PB1,43,0,0,0,1006,1006,C
2-PB1,44,1006,0,0,0,1006,A
2-PB1,45,1009,0,1,0,1010,A
2-PB1,46,1013,0,1,0,1014,A
2-PB1,47,1025,0,0,0,1025,A
2-PB1,48,1,1026,0,2,1029,T
2-PB1,49,1,0,1075,0,1076,G
2-PB1,50,0,0,0,1083,1083,C
2-PB1,51,1,0,0,1082,1083,C
2-PB1,52,1083,0,2,0,1085,A
2-PB1,53,0,1087,0,1,1088,T
2-PB1,54,1183,0,0,0,1183,A
2-PB1,55,1185,0,2,0,1187,A
2-PB1,56,0,0,1245,0,1245,G
2-PB1,57,0,2,0,1244,1246,C
2-PB1,58,1241,0,1,0,1242,A
2-PB1,59,1,0,0,1290,1291,C
2-PB1,60,1288,2,2,0,1292,A
2-PB1,61,1371,0,0,1,1372,A
2-PB1,62,0,1,0,1377,1378,C
2-PB1,63,1377,0,0,0,1377,A
2-PB1,64,0,1389,0,0,1389,T
2-PB1,65,0,1381,0,1,1382,T
2-PB1,66,1,0,0,1702,1703,C
2-PB1,67,1,0,0,1699,1700,C
2-PB1,68,3,1,0,1715,1719,C
2-PB1,69,1,1739,0,1,1741,T
2-PB1,70,0,1734,0,0,1734,T
2-PB1,71,1893,0,0,0,1893,A
2-PB1,72,0,1904,0,0,1904,T
2-PB1,73,1906,0,0,0,1906,A
2-PB1,74,1,3,0,1924,1928,C
2-PB1,75,0,1873,0,5,1878,T
2-PB1,76,0,1,1899,0,1900,G
2-PB1,77,0,7,1894,0,1901,G
2-PB1,78,1897,1,4,0,1902,A
2-PB1,79,0,1,1907,0,1908,G
2-PB1,80,1902,0,2,1,1905,A
2-PB1,81,1,1905,0,2,1908,T
2-PB1,82,3,3,0,2013,2019,C
2-PB1,83,0,0,0,2024,2024,C
2-PB1,84,0,2015,0,3,2018,T
2-PB1,85,1,0,0,2155,2156,C
2-PB1,86,2,1,0,2154,2157,C
2-PB1,87,2181,0,2,0,2183,A
2-PB1,88,0,2184,0,0,2184,T
2-PB1,89,2177,0,3,0,2180,A
2-PB1,90,0,2,1,2193,2196,C
2-PB1,91,2151,0,3,0,2154,A
2-PB1,92,0,0,2266,0,2266,G
2-PB1,93,1,1,0,2281,2283,C
2-PB1,94,1,0,1,2271,2273,C
2-PB1,95,2273,0,0,0,2273,A
2-PB1,96,0,2272,0,2,2274,T
2-PB1,97,0,4,2272,0,2276,G
2-PB1,98,0,7,2375,0,2382,G
2-PB1,99,2404,0,2,0,2406,A
2-PB1,100,2407,1,4,0,2412,A
2-PB1,101,0,1,0,2409,2410,C
2-PB1,102,2390,0,2,0,2392,A
2-PB1,103,0,2,2461,0,2463,G
2-PB1,104,0,3,2507,0,2510,G
2-PB1,105,2496,2,10,0,2508,A
2-PB1,106,2523,0,2,1,2526,A
2-PB1,107,0,0,0,2537,2537,C
2-PB1,108,2522,1,3,1,2527,A
2-PB1,109,1,5,2862,2,2870,G
2-PB1,110,1,4,2868,0,2873,G
2-PB1,111,1,2,2910,0,2913,G
2-PB1,112,0,2901,0,3,2904,T
2-PB1,113,2893,1,5,0,2899,A
2-PB1,114,1,1,0,2925,2927,C
2-PB1,115,3033,0,7,1,3041,A
2-PB1,116,0,0,0,3157,3157,C
2-PB1,117,3,4,0,3137,3144,C
2-PB1,118,3078,0,2,1,3081,A
2-PB1,119,0,3069,0,2,3071,T
2-PB1,120,1,2,3078,0,3081,G
2-PB1,121,0,0,3094,0,3094,G
2-PB1,122,3092,0,2,0,3094,A
2-PB1,123,0,4,0,3105,3109,C
2-PB1,124,3056,0,4,0,3060,A
2-PB1,125,2,1,0,3122,3125,C
2-PB1,126,3128,0,4,0,3132,A
2-PB1,127,1,0,3190,0,3191,G
2-PB1,128,0,3185,0,1,3186,T
2-PB1,129,2,0,0,3304,3306,C
2-PB1,130,3301,1,4,0,3306,A
2-PB1,131,3340,1,6,0,3347,A
2-PB1,132,2,0,0,3353,3355,C
2-PB1,133,3348,1,0,0,3349,A
2-PB1,134,3,5,3385,0,3393,G
2-PB1,135,3352,2,6,0,3360,A
2-PB1,136,3364,0,7,0,3371,A
2-PB1,137,0,0,0,3366,3366,C
2-PB1,138,3320,0,5,0,3325,A
2-PB1,139,1,3,0,3427,3431,C
2-PB1,140,3424,0,3,0,3427,A
2-PB1,141,1,0,0,3572,3573,C
2-PB1,142,2,0,2,3565,3569,C
2-PB1,143,3559,0,2,0,3561,A
2-PB1,144,3582,1,3,0,3586,A
2-PB1,145,0,3644,0,3,3647,T
2-PB1,146,3745,0,2,0,3747,A
2-PB1,147,0,3757,0,1,3758,T
2-PB1,148,0,3701,0,8,3709,T
2-PB1,149,0,1,0,3716,3717,C
2-PB1,150,3644,0,7,1,3652,A
2-PB1,151,0,6,3641,0,3647,G
2-PB1,152,3618,2,2,0,3622,A
2-PB1,153,1,3,3628,0,3632,G
2-PB1,154,3574,0,10,0,3584,A
2-PB1,155,4,8,3528,0,3540,G
2-PB1,156,0,11,3525,0,3536,G
2-PB1,157,8,6,3635,0,3649,G
2-PB1,158,2,1,3656,0,3659,G
2-PB1,159,2,4,3680,0,3686,G
2-PB1,160,3677,0,1,0,3678,A
2-PB1,161,3673,0,9,0,3682,A
2-PB1,162,0,2,3704,0,3706,G
2-PB1,163,0,3678,0,4,3682,T
2-PB1,164,2,6,3666,0,3674,G
2-PB1,165,1,1,3655,0,3657,G
2-PB1,166,3646,1,5,2,3654,A
2-PB1,167,0,2,1,3674,3677,C
2-PB1,168,3,5,3681,0,3689,G
2-PB1,169,3702,0,7,0,3709,A
2-PB1,170,1,2,0,3733,3736,C
2-PB1,171,3724,0,2,0,3726,A
2-PB1,172,3723,0,2,0,3725,A
2-PB1,173,3736,0,7,2,3745,A
2-PB1,174,0,3785,0,3,3788,T
2-PB1,175,3790,3,0,2,3795,A
2-PB1,176,2,2,0,3798,3802,C
2-PB1,177,3759,0,8,2,3769,A
2-PB1,178,0,4,3770,0,3774,G
2-PB1,179,3757,0,2,0,3759,A
2-PB1,180,3783,0,4,0,3787,A
2-PB1,181,3789,0,2,0,3791,A
2-PB1,182,1,0,0,3789,3790,C
2-PB1,183,1,3736,0,3,3740,T
2-PB1,184,1,5,3730,1,3737,G
2-PB1,185,3,9,3723,0,3735,G
2-PB1,186,1,6,3716,0,3723,G
2-PB1,187,1,2,3742,0,3745,G
2-PB1,188,0,0,2,3737,3739,C
2-PB1,189,3728,1,4,0,3733,A
2-PB1,190,1,2,0,3849,3852,C
2-PB1,191,4,1,0,3836,3841,C
2-PB1,192,10,2,0,3827,3839,C
2-PB1,193,5,1,0,3843,3849,C
2-PB1,194,3867,0,0,1,3868,A
2-PB1,195,3892,0,3,0,3895,A
2-PB1,196,0,0,0,3892,3892,C
2-PB1,197,1,3870,1,6,3878,T
2-PB1,198,5,1,0,3895,3901,C
2-PB1,199,3776,1,3,0,3780,A
2-PB1,200,3846,1,5,0,3852,A
2-PB1,201,4,1,1,3837,3843,C
2-PB1,202,6,0,0,3836,3842,C
2-PB1,203,9,1,0,3829,3839,C
2-PB1,204,3836,0,0,0,3836,A
2-PB1,205,3854,0,3,0,3857,A
2-PB1,206,2,3872,0,1,3875,T
2-PB1,207,1,3881,0,1,3883,T
2-PB1,208,1,3,3879,0,3883,G
2-PB1,209,3853,1,4,0,3858,A
2-PB1,210,0,3854,0,2,3856,T
2-PB1,211,0,6,3841,0,3847,G
2-PB1,212,3,4,3867,0,3874,G
2-PB1,213,3917,1,3,0,3921,A
2-PB1,214,2,1,0,3945,3948,C
2-PB1,215,5,0,1,3928,3934,C
2-PB1,216,3925,0,6,1,3932,A
2-PB1,217,1,2,0,4028,4031,C
2-PB1,218,0,4024,0,2,4026,T
2-PB1,219,4065,1,14,1,4081,A
2-PB1,220,1,0,0,4106,4107,C
2-PB1,221,5,0,0,4068,4073,C
2-PB1,222,1,4004,1,5,4011,T
2-PB1,223,1,5,4013,0,4019,G
2-PB1,224,4009,0,8,0,4017,A
2-PB1,225,2,3,4025,0,4030,G
2-PB1,226,1,8,3996,0,4005,G
2-PB1,227,3993,0,8,0,4001,A
2-PB1,228,0,3976,1,1,3978,T
2-PB1,229,3906,1,0,0,3907,A
2-PB1,230,3899,0,5,0,3904,A
2-PB1,231,1,3907,0,4,3912,T
2-PB1,232,0,8,3903,0,3911,G
2-PB1,233,3914,0,4,0,3918,A
2-PB1,234,3887,0,7,0,3894,A
2-PB1,235,3,0,0,3886,3889,C
2-PB1,236,3,1,0,3835,3839,C
2-PB1,237,3852,0,1,0,3853,A
2-PB1,238,3862,0,3,0,3865,A
2-PB1,239,1,2,3894,0,3897,G
2-PB1,240,1,3895,0,1,3897,T
2-PB1,241,1,5,3877,0,3883,G
2-PB1,242,0,3,3932,0,3935,G
2-PB1,243,3928,1,2,0,3931,A
2-PB1,244,0,3924,0,0,3924,T
2-PB1,245,3923,1,3,1,3928,A
2-PB1,246,0,3982,0,0,3982,T
2-PB1,247,2,1,3994,0,3997,G
2-PB1,248,2,3,0,3997,4002,C
2-PB1,249,3993,0,7,0,4000,A
2-PB1,250,2,1,0,4084,4087,C
2-PB1,251,4022,1,4,0,4027,A
2-PB1,252,4094,0,4,0,4098,A
2-PB1,253,4092,0,4,0,4096,A
2-PB1,254,3,1,0,4109,4113,C
2-PB1,255,4006,1,3,0,4010,A
2-PB1,256,0,2,4061,0,4063,G
2-PB1,257,4036,0,10,0,4046,A
2-PB1,258,2,1,0,4051,4054,C
2-PB1,259,1,3944,0,4,3949,T
2-PB1,260,2,2,4018,0,4022,G
2-PB1,261,0,3952,0,4,3956,T
2-PB1,262,3,0,4118,0,4121,G
2-PB1,263,0,4113,0,4,4117,T
2-PB1,264,6,1,0,4115,4122,C
2-PB1,265,1,1,1,4118,4121,C
2-PB1,266,0,4086,0,5,4091,T
2-PB1,267,1,3,4080,0,4084,G
2-PB1,268,3,0,4077,0,4080,G
2-PB1,269,4007,1,7,0,4015,A
2-PB1,270,1,5,4069,0,4075,G
2-PB1,271,2,1,3956,0,3959,G
2-PB1,272,0,0,0,3968,3968,C
2-PB1,273,5,3939,0,5,3949,T
2-PB1,274,3948,1,2,0,3951,A
2-PB1,275,0,3948,0,3,3951,T
2-PB1,276,1,5,3938,0,3944,G
2-PB1,277,3,2,3943,0,3948,G
2-PB1,278,0,2,0,3931,3933,C
2-PB1,279,1,0,0,3875,3876,C
2-PB1,280,1,3828,0,11,3840,T
2-PB1,281,2,4039,0,4,4045,T
2-PB1,282,6,0,0,4042,4048,C
2-PB1,283,4,1,0,4042,4047,C
2-PB1,284,2,4039,0,5,4046,T
2-PB1,285,0,4024,1,11,4036,T
2-PB1,286,0,0,4045,0,4045,G
2-PB1,287,4045,0,1,0,4046,A
2-PB1,288,4046,0,5,0,4051,A
2-PB1,289,1,2,4053,0,4056,G
2-PB1,290,3889,0,5,0,3894,A
2-PB1,291,3917,0,5,1,3923,A
2-PB1,292,0,3905,0,6,3911,T
2-PB1,293,8,1,0,3906,3915,C
2-PB1,294,4,1,0,3907,3912,C
2-PB1,295,17,1,0,3891,3909,C
2-PB1,296,3927,0,4,0,3931,A
2-PB1,297,1,2,0,3934,3937,C
2-PB1,298,5,2,0,3930,3937,C
2-PB1,299,10,0,0,3938,3948,C
2-PB1,300,3887,2,7,1,3897,A
2-PB1,301,0,5,3911,0,3916,G
2-PB1,302,1,2,3941,0,3944,G
2-PB1,303,2,3936,3,0,3941,T
2-PB1,304,3947,1,1,0,3949,A
2-PB1,305,0,3933,0,4,3937,T
2-PB1,306,3,0,0,3931,3934,C
2-PB1,307,0,3916,0,11,3927,T
2-PB1,308,1,3927,0,0,3928,T
2-PB1,309,0,3926,0,2,3928,T
2-PB1,310,0,3,3908,0,3911,G
2-PB1,311,3871,3,9,0,3883,A
2-PB1,312,2,1,3884,0,3887,G
2-PB1,313,3836,0,5,0,3841,A
2-PB1,314,3856,1,3,0,3860,A
2-PB1,315,2,0,0,3876,3878,C
2-PB1,316,0,3822,0,8,3830,T
2-PB1,317,8,0,0,3829,3837,C
2-PB1,318,3830,0,1,1,3832,A
2-PB1,319,1,3830,0,1,3832,T
2-PB1,320,1,0,3831,0,3832,G
2-PB1,321,1,2,0,3886,3889,C
2-PB1,322,7,0,1,3888,3896,C
2-PB1,323,2,3878,0,4,3884,T
2-PB1,324,0,3855,0,3,3858,T
2-PB1,325,1,9,3868,0,3878,G
2-PB1,326,3880,1,11,0,3892,A
2-PB1,327,3893,0,10,0,3903,A
2-PB1,328,3891,0,7,0,3898,A
2-PB1,329,0,0,0,3944,3944,C
2-PB1,330,3845,1,2,1,3849,A
2-PB1,331,3861,0,0,2,3863,A
2-PB1,332,0,3872,0,4,3876,T
2-PB1,333,1,3,3861,0,3865,G
2-PB1,334,0,3,3859,0,3862,G
2-PB1,335,3825,0,8,0,3833,A
2-PB1,336,3819,0,7,0,3826,A
2-PB1,337,0,1,3821,0,3822,G
2-PB1,338,1,5,0,3821,3827,C
2-PB1,339,4,3,0,3795,3802,C
2-PB1,340,1,0,3833,2,3836,G
2-PB1,341,0,3814,0,6,3820,T
2-PB1,342,2,3817,1,4,3824,T
2-PB1,343,6,0,0,3838,3844,C
2-PB1,344,3849,0,3,1,3853,A
2-PB1,345,3892,0,3,9,3904,A
2-PB1,346,1,1,0,3907,3909,C
2-PB1,347,3896,1,7,0,3904,A
2-PB1,348,55,2,3887,0,3944,G
2-PB1,349,3879,1,9,0,3889,A
2-PB1,350,1,1,0,3891,3893,C
2-PB1,351,3890,0,3,0,3893,A
2-PB1,352,3890,0,7,0,3897,A
2-PB1,353,1,6,3931,0,3938,G
2-PB1,354,0,6,3871,2,3879,G
2-PB1,355,3,1,3902,0,3906,G
2-PB1,356,1,3818,0,4,3823,T
2-PB1,357,1,6,3799,0,3806,G
2-PB1,358,1,4,3805,0,3810,G
2-PB1,359,3800,3,10,0,3813,A
2-PB1,360,1,4,0,3807,3812,C
2-PB1,361,3733,1,0,0,3734,A
2-PB1,362,3783,0,2,0,3785,A
2-PB1,363,3781,0,10,0,3791,A
2-PB1,364,2,0,0,3796,3798,C
2-PB1,365,1,3769,1,7,3778,T
2-PB1,366,3784,0,0,0,3784,A
2-PB1,367,3797,2,4,1,3804,A
2-PB1,368,0,0,0,3800,3800,C
2-PB1,369,6,0,0,3788,3794,C
2-PB1,370,10,0,0,3790,3800,C
2-PB1,371,3694,0,3,1,3698,A
2-PB1,372,3700,0,2,0,3702,A
2-PB1,373,1,1,3709,1,3712,G
2-PB1,374,1,2,3706,0,3709,G
2-PB1,375,0,3692,1,7,3700,T
2-PB1,376,9,1,1,3649,3660,C
2-PB1,377,3,0,3663,0,3666,G
2-PB1,378,2,1,0,3658,3661,C
2-PB1,379,6,2,0,3660,3668,C
2-PB1,380,3659,1,3,0,3663,A
2-PB1,381,0,3,3740,0,3743,G
2-PB1,382,3780,0,5,0,3785,A
2-PB1,383,1,0,0,3797,3798,C
2-PB1,384,1,3770,0,4,3775,T
2-PB1,385,0,3754,1,1,3756,T
2-PB1,386,3763,0,3,0,3766,A
2-PB1,387,0,3774,0,1,3775,T
2-PB1,388,0,3,3775,0,3778,G
2-PB1,389,3761,0,2,1,3764,A
2-PB1,390,0,3701,1,3,3705,T
2-PB1,391,3,3592,0,6,3601,T
2-PB1,392,0,1,3587,0,3588,G
2-PB1,393,1,6,3577,0,3584,G
2-PB1,394,3598,0,10,0,3608,A
2-PB1,395,0,1,0,3597,3598,C
2-PB1,396,3557,0,2,0,3559,A
2-PB1,397,0,3537,0,1,3538,T
2-PB1,398,2,3573,0,0,3575,T
2-PB1,399,3608,0,1,0,3609,A
2-PB1,400,3602,1,1,0,3604,A
2-PB1,401,3603,1,6,2,3612,A
2-PB1,402,0,1,0,3614,3615,C
2-PB1,403,3548,0,5,0,3553,A
2-PB1,404,0,0,3574,0,3574,G
2-PB1,405,3555,1,5,0,3561,A
2-PB1,406,3554,0,0,0,3554,A
2-PB1,407,3562,0,2,2,3566,A
2-PB1,408,0,3530,0,3,3533,T
2-PB1,409,6,0,0,3537,3543,C
2-PB1,410,3532,1,1,0,3534,A
2-PB1,411,3531,2,4,1,3538,A
2-PB1,412,2,0,0,3529,3531,C
2-PB1,413,3,4,1,3510,3518,C
2-PB1,414,3,4,3523,2,3532,G
2-PB1,415,0,0,3522,0,3522,G
2-PB1,416,0,2,0,3532,3534,C
2-PB1,417,3529,1,3,0,3533,A
2-PB1,418,1,1,3526,0,3528,G
2-PB1,419,1,0,0,3555,3556,C
2-PB1,420,3551,0,2,0,3553,A
2-PB1,421,3549,0,2,0,3551,A
2-PB1,422,2,0,0,3563,3565,C
2-PB1,423,0,3539,0,4,3543,T
2-PB1,424,0,2,3690,0,3692,G
2-PB1,425,1,2,0,3686,3689,C
2-PB1,426,3678,5,2,1,3686,A
2-PB1,427,0,3681,0,4,3685,T
2-PB1,428,0,3634,0,2,3636,T
2-PB1,429,3849,0,4,2,3855,A
2-PB1,430,1,0,3860,0,3861,G
2-PB1,431,2,3,0,3836,3841,C
2-PB1,432,5,0,0,3843,3848,C
2-PB1,433,3690,0,3,0,3693,A
2-PB1,434,3701,2,4,1,3708,A
2-PB1,435,2,0,0,3722,3724,C
2-PB1,436,3723,0,5,0,3728,A
2-PB1,437,2,9,0,3806,3817,C
2-PB1,438,8,1,1,3523,3533,C
2-PB1,439,3515,1,1,0,3517,A
2-PB1,440,0,3519,0,0,3519,T
2-PB1,441,3522,1,0,0,3523,A
2-PB1,442,0,2,3524,2,3528,G
2-PB1,443,3494,0,1,0,3495,A
2-PB1,444,3444,0,3,1,3448,A
2-PB1,445,0,1,3465,0,3466,G
2-PB1,446,0,3350,0,5,3355,T
2-PB1,447,0,3349,0,4,3353,T
2-PB1,448,1,3345,1,5,3352,T
2-PB1,449,1,3347,2,2,3352,T
2-PB1,450,0,3356,0,1,3357,T
2-PB1,451,3348,0,1,0,3349,A
2-PB1,452,1,2,3347,0,3350,G
2-PB1,453,3342,1,0,0,3343,A
2-PB1,454,1,3317,0,4,3322,T
2-PB1,455,6,1,0,3273,3280,C
2-PB1,456,0,12,3276,0,3288,G
2-PB1,457,3282,2,4,0,3288,A
2-PB1,458,3284,1,1,0,3286,A
2-PB1,459,1,1,1,3303,3306,C
2-PB1,460,2,5,3306,0,3313,G
2-PB1,461,1,0,3446,0,3447,G
2-PB1,462,3451,2,3,0,3456,A
2-PB1,463,1,3447,1,1,3450,T
2-PB1,464,1,3443,0,3,3447,T
2-PB1,465,3448,0,4,0,3452,A
2-PB1,466,3442,2,4,1,3449,A
2-PB1,467,0,1,0,3478,3479,C
2-PB1,468,3432,0,5,0,3437,A
2-PB1,469,1,0,3466,0,3467,G
2-PB1,470,2,0,0,3332,3334,C
2-PB1,471,1,3330,0,2,3333,T
2-PB1,472,3328,0,4,0,3332,A
2-PB1,473,3328,0,3,0,3331,A
2-PB1,474,0,3328,0,0,3328,T
2-PB1,475,2,4,3362,0,3368,G
2-PB1,476,3346,3,1,0,3350,A
2-PB1,477,3351,0,2,0,3353,A
2-PB1,478,0,3292,0,4,3296,T
2-PB1,479,2,0,0,3310,3312,C
2-PB1,480,3294,0,6,1,3301,A
2-PB1,481,0,4,3293,1,3298,G
2-PB1,482,1,2,3289,0,3292,G
2-PB1,483,3275,1,7,0,3283,A
2-PB1,484,3228,0,3,1,3232,A
2-PB1,485,2,3,3367,0,3372,G
2-PB1,486,2,1,3363,0,3366,G
2-PB1,487,0,1,0,3375,3376,C
2-PB1,488,0,3357,1,2,3360,T
2-PB1,489,3360,0,2,0,3362,A
2-PB1,490,3360,0,4,0,3364,A
2-PB1,491,2,3362,0,4,3368,T
2-PB1,492,3367,0,1,0,3368,A
2-PB1,493,0,3,3380,0,3383,G
2-PB1,494,3182,0,3,0,3185,A
2-PB1,495,0,3170,0,0,3170,T
2-PB1,496,0,3157,0,6,3163,T
2-PB1,497,4,3141,0,1,3146,T
2-PB1,498,3,0,1,3261,3265,C
2-PB1,499,4,0,0,3256,3260,C
2-PB1,500,0,3255,0,3,3258,T
2-PB1,501,0,0,0,3273,3273,C
2-PB1,502,3253,0,4,0,3257,A
2-PB1,503,3260,0,3,0,3263,A
2-PB1,504,2,4,3266,0,3272,G
2-PB1,505,1,2,3313,0,3316,G
2-PB1,506,3311,0,0,0,3311,A
2-PB1,507,0,3207,0,1,3208,T
2-PB1,508,0,0,3238,0,3238,G
2-PB1,509,1,3221,0,4,3226,T
2-PB1,510,0,3,3261,0,3264,G
2-PB1,511,3249,1,3,0,3253,A
2-PB1,512,0,3238,0,3,3241,T
2-PB1,513,4,1,3224,0,3229,G
2-PB1,514,1,3,3209,0,3213,G
2-PB1,515,3202,0,6,1,3209,A
2-PB1,516,3207,0,7,0,3214,A
2-PB1,517,1,3161,0,4,3166,T
2-PB1,518,5,0,0,3167,3172,C
2-PB1,519,3132,0,5,0,3137,A
2-PB1,520,3138,2,2,0,3142,A
2-PB1,521,0,3150,0,0,3150,T
2-PB1,522,0,6,3189,1,3196,G
2-PB1,523,1,2,3190,0,3193,G
2-PB1,524,3184,0,9,0,3193,A
2-PB1,525,1,3191,0,2,3194,T
2-PB1,526,3188,1,1,0,3190,A
2-PB1,527,3187,0,0,1,3188,A
2-PB1,528,3184,0,3,0,3187,A
2-PB1,529,0,5,3208,0,3213,G
2-PB1,530,3198,0,3,0,3201,A
2-PB1,531,0,2,3186,0,3188,G
2-PB1,532,0,1,3167,0,3168,G
2-PB1,533,3137,2,7,0,3146,A
2-PB1,534,3150,2,0,0,3152,A
2-PB1,535,3161,0,3,0,3164,A
2-PB1,536,0,3157,0,1,3158,T
2-PB1,537,1,4,3207,0,3212,G
2-PB1,538,2,4,3195,0,3201,G
2-PB1,539,3148,0,6,0,3154,A
2-PB1,540,0,2,3171,1,3174,G
2-PB1,541,3139,3,6,0,3148,A
2-PB1,542,1,3197,0,1,3199,T
2-PB1,543,3201,0,3,0,3204,A
2-PB1,544,3221,0,6,0,3227,A
2-PB1,545,2,2,0,3219,3223,C
2-PB1,546,3184,1,3,0,3188,A
2-PB1,547,3190,1,4,0,3195,A
2-PB1,548,2,1,0,3184,3187,C
2-PB1,549,3158,1,2,0,3161,A
2-PB1,550,0,0,0,3158,3158,C
2-PB1,551,3106,2,1,0,3109,A
2-PB1,552,1,0,1,3137,3139,C
2-PB1,553,0,3078,0,6,3084,T
2-PB1,554,0,3072,1,5,3078,T
2-PB1,555,0,3081,1,1,3083,T
2-PB1,556,4,0,0,3076,3080,C
2-PB1,557,3091,1,1,0,3093,A
2-PB1,558,3099,0,2,0,3101,A
2-PB1,559,3098,1,3,0,3102,A
2-PB1,560,2,2,3146,0,3150,G
2-PB1,561,3090,1,1,0,3092,A
2-PB1,562,3099,0,1,0,3100,A
2-PB1,563,3103,0,2,0,3105,A
2-PB1,564,3100,0,4,1,3105,A
2-PB1,565,3093,0,13,0,3106,A
2-PB1,566,1,6,3126,0,3133,G
2-PB1,567,1,6,3118,0,3125,G
2-PB1,568,3081,0,4,1,3086,A
2-PB1,569,0,6,3133,0,3139,G
2-PB1,570,3121,0,4,0,3125,A
2-PB1,571,0,0,3258,0,3258,G
2-PB1,572,1,3241,0,1,3243,T
2-PB1,573,3254,1,1,0,3256,A
2-PB1,574,3249,0,11,0,3260,A
2-PB1,575,1,5,3257,0,3263,G
2-PB1,576,2,5,3268,0,3275,G
2-PB1,577,0,3,3278,0,3281,G
2-PB1,578,3232,0,7,0,3239,A
2-PB1,579,1,3,0,3262,3266,C
2-PB1,580,3160,1,12,0,3173,A
2-PB1,581,3182,1,1,0,3184,A
2-PB1,582,2,0,0,3176,3178,C
2-PB1,583,3165,0,7,0,3172,A
2-PB1,584,0,3135,0,3,3138,T
2-PB1,585,0,11,3118,0,3129,G
2-PB1,586,3126,0,4,0,3130,A
2-PB1,587,2,2,1,3105,3110,C
2-PB1,588,1,1,0,3076,3078,C
2-PB1,589,3077,0,1,0,3078,A
2-PB1,590,3080,1,5,1,3087,A
2-PB1,591,0,2,3113,0,3115,G
2-PB1,592,3114,0,1,0,3115,A
2-PB1,593,3116,1,1,0,3118,A
2-PB1,594,3091,0,1,0,3092,A
2-PB1,595,3096,0,0,1,3097,A
2-PB1,596,1,3092,0,3,3096,T
2-PB1,597,2,7,3086,1,3096,G
2-PB1,598,0,0,3107,0,3107,G
2-PB1,599,0,3072,0,7,3079,T
2-PB1,600,10,2,0,3046,3058,C
2-PB1,601,3071,0,2,1,3074,A
2-PB1,602,1,8,0,3170,3179,C
2-PB1,603,3213,0,7,0,3220,A
2-PB1,604,2,1,0,3221,3224,C
2-PB1,605,3212,0,0,0,3212,A
2-PB1,606,3271,1,7,0,3279,A
2-PB1,607,3256,1,2,0,3259,A
2-PB1,608,1,5,3415,0,3421,G
2-PB1,609,3413,1,3,0,3417,A
2-PB1,610,3421,0,4,0,3425,A
2-PB1,611,3,3,0,3469,3475,C
2-PB1,612,3388,0,4,0,3392,A
2-PB1,613,3407,1,3,0,3411,A
2-PB1,614,0,3391,0,0,3391,T
2-PB1,615,3354,0,2,0,3356,A
2-PB1,616,1,5,3349,0,3355,G
2-PB1,617,1,6,3231,0,3238,G
2-PB1,618,4,3,3248,0,3255,G
2-PB1,619,3242,0,4,0,3246,A
2-PB1,620,3199,2,4,0,3205,A
2-PB1,621,2,2,3219,0,3223,G
2-PB1,622,3217,0,1,0,3218,A
2-PB1,623,3215,0,1,0,3216,A
2-PB1,624,3221,2,3,0,3226,A
2-PB1,625,3224,1,6,2,3233,A
2-PB1,626,3281,0,3,1,3285,A
2-PB1,627,3275,1,7,2,3285,A
2-PB1,628,0,0,0,3290,3290,C
2-PB1,629,3280,0,5,0,3285,A
2-PB1,630,3279,1,2,0,3282,A
2-PB1,631,3258,1,8,0,3267,A
2-PB1,632,1,2,3307,1,3311,G
2-PB1,633,3304,1,9,0,3314,A
2-PB1,634,0,0,3429,0,3429,G
2-PB1,635,0,3392,0,1,3393,T
2-PB1,636,0,3,3797,1,3801,G
2-PB1,637,3800,0,5,3,3808,A
2-PB1,638,3813,1,6,1,3821,A
2-PB1,639,1,3862,0,1,3864,T
2-PB1,640,3879,0,0,0,3879,A
2-PB1,641,3876,2,2,0,3880,A
2-PB1,642,0,8,3878,0,3886,G
2-PB1,643,3769,0,8,0,3777,A
2-PB1,644,0,1,3799,0,3800,G
2-PB1,645,3558,0,6,0,3564,A
2-PB1,646,0,1,3582,0,3583,G
2-PB1,647,4,1,3581,0,3586,G
2-PB1,648,1,0,0,3582,3583,C
2-PB1,649,0,3575,0,4,3579,T
2-PB1,650,3667,1,1,0,3669,A
2-PB1,651,1,0,0,3833,3834,C
2-PB1,652,7,0,0,3823,3830,C
2-PB1,653,1,3845,0,11,3857,T
2-PB1,654,3975,1,0,0,3976,A
2-PB1,655,3961,1,3,2,3967,A
2-PB1,656,1,3970,0,0,3971,T
2-PB1,657,3969,0,4,0,3973,A
2-PB1,658,3953,0,8,1,3962,A
2-PB1,659,0,7,3948,0,3955,G
2-PB1,660,3780,1,7,0,3788,A
2-PB1,661,0,0,3823,0,3823,G
2-PB1,662,0,0,2,3832,3834,C
2-PB1,663,1,3765,0,8,3774,T
2-PB1,664,0,3792,0,0,3792,T
2-PB1,665,2,3798,0,2,3802,T
2-PB1,666,1,5,3814,0,3820,G
2-PB1,667,3847,4,4,0,3855,A
2-PB1,668,0,4,0,3859,3863,C
2-PB1,669,3844,0,2,0,3846,A
2-PB1,670,1,3822,2,2,3827,T
2-PB1,671,1,3809,0,1,3811,T
2-PB1,672,1,9,3871,0,3881,G
2-PB1,673,3870,1,13,0,3884,A
2-PB1,674,3871,0,8,0,3879,A
2-PB1,675,2,2,0,3894,3898,C
2-PB1,676,3878,0,1,0,3879,A
2-PB1,677,2,4,0,3886,3892,C
2-PB1,678,1,3,3878,0,3882,G
2-PB1,679,3901,1,7,0,3909,A
2-PB1,680,0,3910,0,4,3914,T
2-PB1,681,0,11,3950,0,3961,G
2-PB1,682,3966,2,5,0,3973,A
2-PB1,683,2,0,0,3971,3973,C
2-PB1,684,8,1,0,3964,3973,C
2-PB1,685,3975,1,3,1,3980,A
2-PB1,686,4021,0,2,1,4024,A
2-PB1,687,4015,0,9,0,4024,A
2-PB1,688,1,1,4106,1,4109,G
2-PB1,689,4146,0,4,0,4150,A
2-PB1,690,1,4073,0,5,4079,T
2-PB1,691,0,1,4078,0,4079,G
2-PB1,692,0,0,0,4073,4073,C
2-PB1,693,4065,3,6,0,4074,A
2-PB1,694,1,2,4095,0,4098,G
2-PB1,695,4023,0,4,0,4027,A
2-PB1,696,0,7,4022,0,4029,G
2-PB1,697,3931,0,4,0,3935,A
2-PB1,698,1,4,3915,2,3922,G
2-PB1,699,3860,2,11,1,3874,A
2-PB1,700,0,3,3882,0,3885,G
2-PB1,701,2,3,3874,0,3879,G
2-PB1,702,1,1,0,3886,3888,C
2-PB1,703,3858,0,3,1,3862,A
2-PB1,704,3869,0,3,0,3872,A
2-PB1,705,3898,0,3,1,3902,A
2-PB1,706,0,3898,1,0,3899,T
2-PB1,707,1,3896,1,1,3899,T
2-PB1,708,3902,1,1,1,3905,A
2-PB1,709,3902,1,1,0,3904,A
2-PB1,710,3917,0,0,0,3917,A
2-PB1,711,3925,1,4,0,3930,A
2-PB1,712,3927,0,2,1,3930,A
2-PB1,713,1,1,3937,0,3939,G
2-PB1,714,3899,0,7,0,3906,A
2-PB1,715,3891,0,10,0,3901,A
2-PB1,716,0,11,3944,0,3955,G
2-PB1,717,1,3,4022,0,4026,G
2-PB1,718,1,3,4019,0,4023,G
2-PB1,719,1,1,1,4043,4046,C
2-PB1,720,0,4045,1,2,4048,T
2-PB1,721,4069,0,0,0,4069,A
2-PB1,722,1,4123,0,7,4131,T
2-PB1,723,0,4146,0,3,4149,T
2-PB1,724,1,1,4163,0,4165,G
2-PB1,725,1,2,1,4129,4133,C
2-PB1,726,4033,1,8,0,4042,A
2-PB1,727,4039,1,8,1,4049,A
2-PB1,728,1,2,0,4054,4057,C
2-PB1,729,4036,1,4,0,4041,A
2-PB1,730,0,0,1,4044,4045,C
2-PB1,731,2,2,0,3964,3968,C
2-PB1,732,9,8,1,3958,3976,C
2-PB1,733,2,8,3946,1,3957,G
2-PB1,734,0,0,3965,0,3965,G
2-PB1,735,1,3,3967,1,3972,G
2-PB1,736,3977,0,6,0,3983,A
2-PB1,737,0,3959,0,0,3959,T
2-PB1,738,2,2,3971,0,3975,G
2-PB1,739,1,0,0,3958,3959,C
2-PB1,740,4009,0,3,0,4012,A
2-PB1,741,4062,0,3,0,4065,A
2-PB1,742,4112,1,2,0,4115,A
2-PB1,743,0,4102,0,8,4110,T
2-PB1,744,0,4118,0,7,4125,T
2-PB1,745,4092,0,2,0,4094,A
2-PB1,746,1,5,4085,0,4091,G
2-PB1,747,4054,0,9,0,4063,A
2-PB1,748,0,8,4078,0,4086,G
2-PB1,749,0,14,4001,0,4015,G
2-PB1,750,1,0,4099,0,4100,G
2-PB1,751,1,4084,0,7,4092,T
2-PB1,752,0,4077,0,10,4087,T
2-PB1,753,10,3,0,4087,4100,C
2-PB1,754,3,1,4156,0,4160,G
2-PB1,755,2,4141,0,13,4156,T
2-PB1,756,7,1,4146,0,4154,G
2-PB1,757,0,4143,0,5,4148,T
2-PB1,758,4128,0,0,0,4128,A
2-PB1,759,1,0,0,4119,4120,C
2-PB1,760,0,3900,0,7,3907,T
2-PB1,761,1,3920,0,5,3926,T
2-PB1,762,3,0,0,3909,3912,C
2-PB1,763,4,0,3883,0,3887,G
2-PB1,764,2,3876,0,3,3881,T
2-PB1,765,0,3863,0,9,3872,T
2-PB1,766,0,4,3878,0,3882,G
2-PB1,767,3866,0,2,0,3868,A
2-PB1,768,3859,0,5,1,3865,A
2-PB1,769,3882,1,7,1,3891,A
2-PB1,770,1,0,0,3903,3904,C
2-PB1,771,1,3870,1,8,3880,T
2-PB1,772,1,3863,1,5,3870,T
2-PB1,773,0,3882,0,0,3882,T
2-PB1,774,3945,0,3,0,3948,A
2-PB1,775,4,0,3954,0,3958,G
2-PB1,776,0,5,0,3958,3963,C
2-PB1,777,1,3960,0,3,3964,T
2-PB1,778,3939,1,2,1,3943,A
2-PB1,779,0,4,3925,0,3929,G
2-PB1,780,3925,0,5,0,3930,A
2-PB1,781,3917,0,6,1,3924,A
2-PB1,782,1,1,3931,0,3933,G
2-PB1,783,1,2,0,3866,3869,C
2-PB1,784,3866,0,1,0,3867,A
2-PB1,785,0,3833,0,10,3843,T
2-PB1,786,0,3837,0,6,3843,T
2-PB1,787,0,3844,0,6,3850,T
2-PB1,788,3,1,3853,1,3858,G
2-PB1,789,0,2,0,3856,3858,C
2-PB1,790,2,5,3850,1,3858,G
2-PB1,791,3852,0,2,0,3854,A
2-PB1,792,3836,0,1,1,3838,A
2-PB1,793,3842,1,2,0,3845,A
2-PB1,794,3959,0,1,0,3960,A
2-PB1,795,1,0,3989,0,3990,G
2-PB1,796,2,0,0,3991,3993,C
2-PB1,797,0,3981,0,6,3987,T
2-PB1,798,1,3983,0,0,3984,T
2-PB1,799,0,6,3982,1,3989,G
2-PB1,800,3986,0,5,0,3991,A
2-PB1,801,3986,1,5,0,3992,A
2-PB1,802,1,0,0,4003,4004,C
2-PB1,803,3860,0,6,1,3867,A
2-PB1,804,3,1,4161,0,4165,G
2-PB1,805,0,4122,0,9,4131,T
2-PB1,806,2,1,2,4132,4137,C
2-PB1,807,0,4125,0,9,4134,T
2-PB1,808,5,1,4143,0,4149,G
2-PB1,809,1,2,4140,0,4143,G
2-PB1,810,4148,1,3,0,4152,A
2-PB1,811,1,2,0,4192,4195,C
2-PB1,812,0,4022,0,7,4029,T
2-PB1,813,0,3888,0,2,3890,T
2-PB1,814,4,0,1,3898,3903,C
2-PB1,815,1,2,0,3891,3894,C
2-PB1,816,1,1,3902,0,3904,G
2-PB1,817,2320,0,1543,0,3863,A
2-PB1,818,1,3881,0,3,3885,T
2-PB1,819,2,3886,0,3,3891,T
2-PB1,820,2,11,3877,0,3890,G
2-PB1,821,0,9,3850,0,3859,G
2-PB1,822,1,7,3817,0,3825,G
2-PB1,823,1,5,3791,0,3797,G
2-PB1,824,2,3,3807,0,3812,G
2-PB1,825,1,3781,0,1,3783,T
2-PB1,826,3770,0,1,0,3771,A
2-PB1,827,3784,1,3,0,3788,A
2-PB1,828,0,3791,0,4,3795,T
2-PB1,829,3,8,3792,0,3803,G
2-PB1,830,3763,0,2,0,3765,A
2-PB1,831,3715,0,4,0,3719,A
2-PB1,832,3715,0,8,1,3724,A
2-PB1,833,3711,2,5,0,3718,A
2-PB1,834,0,0,3717,0,3717,G
2-PB1,835,3666,0,2,0,3668,A
2-PB1,836,3628,0,10,0,3638,A
2-PB1,837,1,1,3656,0,3658,G
2-PB1,838,1,2,3635,1,3639,G
2-PB1,839,1,2,0,3626,3629,C
2-PB1,840,10,1,0,3622,3633,C
2-PB1,841,3639,1,5,0,3645,A
2-PB1,842,3647,1,1,1,3650,A
2-PB1,843,3646,0,4,0,3650,A
2-PB1,844,0,1,0,3660,3661,C
2-PB1,845,1,3651,0,5,3657,T
2-PB1,846,1,3,3705,0,3709,G
2-PB1,847,2,0,3700,0,3702,G
2-PB1,848,2,1,0,3694,3697,C
2-PB1,849,3710,1,1,0,3712,A
2-PB1,850,3708,0,2,0,3710,A
2-PB1,851,3703,0,2,0,3705,A
2-PB1,852,0,3702,0,7,3709,T
2-PB1,853,0,0,3713,0,3713,G
2-PB1,854,0,3689,0,4,3693,T
2-PB1,855,0,3598,0,4,3602,T
2-PB1,856,1,1,3609,0,3611,G
2-PB1,857,1,3594,0,5,3600,T
2-PB1,858,0,8,3609,0,3617,G
2-PB1,859,3605,0,3,1,3609,A
2-PB1,860,0,3,3623,0,3626,G
2-PB1,861,3608,1,5,0,3614,A
2-PB1,862,3595,2,0,0,3597,A
2-PB1,863,3589,1,6,0,3596,A
2-PB1,864,3611,0,1,1,3613,A
2-PB1,865,3610,1,6,0,3617,A
2-PB1,866,1,3603,0,2,3606,T
2-PB1,867,1,4,3602,0,3607,G
2-PB1,868,3593,1,1,0,3595,A
2-PB1,869,0,3555,1,3,3559,T
2-PB1,870,0,9,3568,0,3577,G
2-PB1,871,3579,1,4,0,3584,A
2-PB1,872,2,0,0,3611,3613,C
2-PB1,873,1,3584,0,6,3591,T
2-PB1,874,3587,0,1,1,3589,A
2-PB1,875,3608,0,3,2,3613,A
2-PB1,876,0,3602,0,2,3604,T
2-PB1,877,1,3620,3,0,3624,T
2-PB1,878,9,1,1,3637,3648,C
2-PB1,879,3634,3,7,0,3644,A
2-PB1,880,1,2,0,3644,3647,C
2-PB1,881,3610,1,3,0,3614,A
2-PB1,882,3608,0,8,0,3616,A
2-PB1,883,2,5,3612,0,3619,G
2-PB1,884,3619,1,10,0,3630,A
2-PB1,885,0,0,0,3620,3620,C
2-PB1,886,3577,0,7,1,3585,A
2-PB1,887,1,1,1,3574,3577,C
2-PB1,888,3533,0,3,0,3536,A
2-PB1,889,0,7,3544,1,3552,G
2-PB1,890,3538,0,2,0,3540,A
2-PB1,891,0,1,3547,0,3548,G
2-PB1,892,0,1,0,3531,3532,C
2-PB1,893,1,3416,0,6,3423,T
2-PB1,894,0,3449,1,3,3453,T
2-PB1,895,1,3450,0,3,3454,T
2-PB1,896,3,0,0,3464,3467,C
2-PB1,897,0,3441,0,5,3446,T
2-PB1,898,0,3424,0,4,3428,T
2-PB1,899,1,3422,1,5,3429,T
2-PB1,900,1,8,0,3420,3429,C
2-PB1,901,3425,0,4,0,3429,A
2-PB1,902,1,0,0,3437,3438,C
2-PB1,903,3385,2,0,0,3387,A
2-PB1,904,3394,2,2,0,3398,A
2-PB1,905,1,3407,1,4,3413,T
2-PB1,906,3,7,0,3440,3450,C
2-PB1,907,3449,0,3,1,3453,A
2-PB1,908,2,1,0,3465,3468,C
2-PB1,909,0,3436,0,2,3438,T
2-PB1,910,0,5,3448,0,3453,G
2-PB1,911,1,8,3432,0,3441,G
2-PB1,912,4,6,3493,0,3503,G
2-PB1,913,0,0,3493,0,3493,G
2-PB1,914,3416,0,9,0,3425,A
2-PB1,915,2,2,1,3244,3249,C
2-PB1,916,3293,1,2,0,3296,A
2-PB1,917,3455,0,3,0,3458,A
2-PB1,918,2,0,0,3471,3473,C
2-PB1,919,3459,0,4,0,3463,A
2-PB1,920,2,3,0,3454,3459,C
2-PB1,921,0,3298,0,2,3300,T
2-PB1,922,3307,1,2,0,3310,A
2-PB1,923,3295,0,4,0,3299,A
2-PB1,924,1,0,3316,0,3317,G
2-PB1,925,0,3296,1,0,3297,T
2-PB1,926,1,1,2993,1,2996,G
2-PB1,927,0,1,2959,0,2960,G
2-PB1,928,2943,0,9,0,2952,A
2-PB1,929,2947,0,7,0,2954,A
2-PB1,930,0,2941,0,1,2942,T
2-PB1,931,0,2,2926,0,2928,G
2-PB1,932,2927,0,0,0,2927,A
2-PB1,933,2862,1,2,0,2865,A
2-PB1,934,2878,0,3,1,2882,A
2-PB1,935,2895,0,2,0,2897,A
2-PB1,936,0,2887,0,1,2888,T
2-PB1,937,4,0,0,2884,2888,C
2-PB1,938,2873,1,5,1,2880,A
2-PB1,939,2880,1,0,0,2881,A
2-PB1,940,2866,0,0,2,2868,A
2-PB1,941,2867,0,11,1,2879,A
2-PB1,942,0,1,0,2885,2886,C
2-PB1,943,3,0,0,2847,2850,C
2-PB1,944,3,2,0,2850,2855,C
2-PB1,945,2,2833,0,9,2844,T
2-PB1,946,3,10,0,2842,2855,C
2-PB1,947,2,6,2848,0,2856,G
2-PB1,948,2857,0,3,0,2860,A
2-PB1,949,2859,0,2,0,2861,A
2-PB1,950,0,2850,0,5,2855,T
2-PB1,951,2,2,2848,0,2852,G
2-PB1,952,1,2815,2,2,2820,T
2-PB1,953,0,2808,2,4,2814,T
2-PB1,954,0,2811,1,3,2815,T
2-PB1,955,1,2810,1,1,2813,T
2-PB1,956,2,2812,2,2,2818,T
2-PB1,957,1,3,2810,0,2814,G
2-PB1,958,0,0,2812,0,2812,G
2-PB1,959,0,2,0,2807,2809,C
2-PB1,960,2,4,2773,0,2779,G
2-PB1,961,2775,0,1,0,2776,A
2-PB1,962,0,2822,0,5,2827,T
2-PB1,963,1,4,2892,0,2897,G
2-PB1,964,3000,0,3,0,3003,A
2-PB1,965,0,3002,1,5,3008,T
2-PB1,966,0,3003,1,0,3004,T
2-PB1,967,3023,1,5,0,3029,A
2-PB1,968,0,11,0,3018,3029,C
2-PB1,969,3024,0,4,0,3028,A
2-PB1,970,1,3016,1,2,3020,T
2-PB1,971,2833,0,0,0,2833,A
2-PB1,972,1,0,0,2813,2814,C
2-PB1,973,2478,0,0,0,2478,A
2-PB1,974,0,2467,0,4,2471,T
2-PB1,975,1,1,0,2464,2466,C
2-PB1,976,2446,1,2,0,2449,A
2-PB1,977,1,2,0,2447,2450,C
2-PB1,978,2417,0,2,0,2419,A
2-PB1,979,2418,0,1,0,2419,A
2-PB1,980,2407,1,3,0,2411,A
2-PB1,981,1,7,2294,0,2302,G
2-PB1,982,2381,1,3,0,2385,A
2-PB1,983,2385,0,2,0,2387,A
2-PB1,984,1,2384,0,1,2386,T
2-PB1,985,3,0,0,2385,2388,C
2-PB1,986,2379,0,2,0,2381,A
2-PB1,987,2391,0,1,0,2392,A
2-PB1,988,0,1,0,2399,2400,C
2-PB1,989,1,3,1,2394,2399,C
2-PB1,990,1,2225,0,4,2230,T
2-PB1,991,1,6,2241,0,2248,G
2-PB1,992,2227,0,6,0,2233,A
2-PB1,993,11,0,2227,0,2238,G
2-PB1,994,0,2215,0,1,2216,T
2-PB1,995,2,3,2132,0,2137,G
2-PB1,996,0,1,2198,1,2200,G
2-PB1,997,1,2167,0,3,2171,T
2-PB1,998,0,2173,0,3,2176,T
2-PB1,999,1,0,0,2178,2179,C
2-PB1,1000,2151,0,0,1,2152,A
2-PB1,1001,1,1,2197,0,2199,G
2-PB1,1002,2194,0,0,0,2194,A
2-PB1,1003,2193,0,3,0,2196,A
2-PB1,1004,2172,1,4,0,2177,A
2-PB1,1005,0,2,0,1897,1899,C
2-PB1,1006,1890,1,2,0,1893,A
2-PB1,1007,0,1885,0,2,1887,T
2-PB1,1008,3,4,0,1910,1917,C
2-PB1,1009,5,1,0,1906,1912,C
2-PB1,1010,0,1795,0,2,1797,T
2-PB1,1011,0,4,1799,0,1803,G
2-PB1,1012,1785,0,2,0,1787,A
2-PB1,1013,0,0,1818,0,1818,G
2-PB1,1014,0,0,0,1800,1800,C
2-PB1,1015,1726,1,1,0,1728,A
2-PB1,1016,0,1727,1,2,1730,T
2-PB1,1017,3,1,0,1728,1732,C
2-PB1,1018,2,1,1734,0,1737,G
2-PB1,1019,2,0,0,1771,1773,C
2-PB1,1020,1793,0,1,0,1794,A
2-PB1,1021,0,0,0,1857,1857,C
2-PB1,1022,3,0,1,1848,1852,C
2-PB1,1023,1856,0,3,1,1860,A
2-PB1,1024,1890,0,0,0,1890,A
2-PB1,1025,0,1886,0,1,1887,T
2-PB1,1026,1887,1,0,0,1888,A
2-PB1,1027,1886,0,1,0,1887,A
2-PB1,1028,0,1828,0,2,1830,T
2-PB1,1029,0,0,1841,0,1841,G
2-PB1,1030,0,1798,0,2,1800,T
2-PB1,1031,0,1783,0,4,1787,T
2-PB1,1032,3,0,0,1784,1787,C
2-PB1,1033,0,1783,0,1,1784,T
2-PB1,1034,1,0,0,1787,1788,C
2-PB1,1035,1786,0,1,1,1788,A
2-PB1,1036,1786,0,1,0,1787,A
2-PB1,1037,1789,1,2,0,1792,A
2-PB1,1038,0,1,0,1790,1791,C
2-PB1,1039,1787,0,0,0,1787,A
2-PB1,1040,1786,1,1,0,1788,A
2-PB1,1041,1790,1,0,1,1792,A
2-PB1,1042,1797,0,2,0,1799,A
2-PB1,1043,1,1811,0,2,1814,T
2-PB1,1044,0,3,1809,0,1812,G
2-PB1,1045,0,1,1813,0,1814,G
2-PB1,1046,0,1,0,1812,1813,C
2-PB1,1047,1805,1,2,0,1808,A
2-PB1,1048,1809,1,3,0,1813,A
2-PB1,1049,1,4,1821,0,1826,G
2-PB1,1050,1830,0,3,0,1833,A
2-PB1,1051,1,0,0,1828,1829,C
2-PB1,1052,1,1807,0,0,1808,T
2-PB1,1053,0,3,1832,0,1835,G
2-PB1,1054,0,0,1836,0,1836,G
2-PB1,1055,0,2,1851,1,1854,G
2-PB1,1056,1851,1,2,0,1854,A
2-PB1,1057,1856,0,0,0,1856,A
2-PB1,1058,1848,0,1,0,1849,A
2-PB1,1059,1837,1,2,2,1842,A
2-PB1,1060,1,3,1879,0,1883,G
2-PB1,1061,0,3,1876,0,1879,G
2-PB1,1062,1876,1,3,0,1880,A
2-PB1,1063,0,1865,0,1,1866,T
2-PB1,1064,1861,0,0,0,1861,A
2-PB1,1065,1,0,0,1863,1864,C
2-PB1,1066,1883,0,2,0,1885,A
2-PB1,1067,0,1878,0,1,1879,T
2-PB1,1068,0,0,1885,0,1885,G
2-PB1,1069,0,1849,0,4,1853,T
2-PB1,1070,0,1852,1,2,1855,T
2-PB1,1071,4,2,0,1843,1849,C
2-PB1,1072,0,6,1847,0,1853,G
2-PB1,1073,1854,0,2,0,1856,A
2-PB1,1074,0,5,1887,0,1892,G
2-PB1,1075,1853,0,2,0,1855,A
2-PB1,1076,0,0,1879,0,1879,G
2-PB1,1077,0,1864,0,1,1865,T
2-PB1,1078,1864,0,0,0,1864,A
2-PB1,1079,1856,1,4,0,1861,A
2-PB1,1080,0,4,1864,0,1868,G
2-PB1,1081,1858,0,4,0,1862,A
2-PB1,1082,0,0,1887,0,1887,G
2-PB1,1083,1836,0,4,0,1840,A
2-PB1,1084,1852,0,1,1,1854,A
2-PB1,1085,0,1838,0,2,1840,T
2-PB1,1086,0,4,1824,1,1829,G
2-PB1,1087,1823,0,3,0,1826,A
2-PB1,1088,1816,0,3,0,1819,A
2-PB1,1089,0,0,1825,0,1825,G
2-PB1,1090,0,0,0,1818,1818,C
2-PB1,1091,0,1788,0,2,1790,T
2-PB1,1092,7,0,0,1786,1793,C
2-PB1,1093,2,1,0,1786,1789,C
2-PB1,1094,1,4,1788,0,1793,G
2-PB1,1095,0,2,1791,0,1793,G
2-PB1,1096,1794,1,3,1,1799,A
2-PB1,1097,1,0,0,1827,1828,C
2-PB1,1098,1823,1,0,0,1824,A
2-PB1,1099,0,0,0,1841,1841,C
2-PB1,1100,1841,0,1,0,1842,A
2-PB1,1101,1837,0,2,0,1839,A
2-PB1,1102,1839,0,1,0,1840,A
2-PB1,1103,0,1854,0,4,1858,T
2-PB1,1104,1855,0,1,0,1856,A
2-PB1,1105,0,0,0,1851,1851,C
2-PB1,1106,2,1,0,1835,1838,C
2-PB1,1107,0,1814,1,4,1819,T
2-PB1,1108,1,0,1829,0,1830,G
2-PB1,1109,0,0,1,1834,1835,C
2-PB1,1110,1832,0,1,0,1833,A
2-PB1,1111,1,2,1832,0,1835,G
2-PB1,1112,1825,1,1,0,1827,A
2-PB1,1113,1823,0,2,0,1825,A
2-PB1,1114,1821,0,0,0,1821,A
2-PB1,1115,2,1822,0,0,1824,T
2-PB1,1116,0,1,1828,0,1829,G
2-PB1,1117,0,1,0,1822,1823,C
2-PB1,1118,1,1823,1,2,1827,T
2-PB1,1119,1847,0,5,0,1852,A
2-PB1,1120,1,0,1847,0,1848,G
2-PB1,1121,0,0,0,1847,1847,C
2-PB1,1122,1843,1,1,0,1845,A
2-PB1,1123,1839,0,1,0,1840,A
2-PB1,1124,0,0,1832,0,1832,G
2-PB1,1125,0,0,0,1832,1832,C
2-PB1,1126,1811,0,0,0,1811,A
2-PB1,1127,0,1839,0,3,1842,T
2-PB1,1128,0,1845,0,0,1845,T
2-PB1,1129,0,2,1891,2,1895,G
2-PB1,1130,1910,0,2,0,1912,A
2-PB1,1131,1,1,0,1915,1917,C
2-PB1,1132,5,0,0,1917,1922,C
2-PB1,1133,0,1881,0,3,1884,T
2-PB1,1134,0,2,1901,0,1903,G
2-PB1,1135,1909,0,1,0,1910,A
2-PB1,1136,1911,0,3,1,1915,A
2-PB1,1137,0,0,1934,0,1934,G
2-PB1,1138,0,1872,0,0,1872,T
2-PB1,1139,1899,0,1,0,1900,A
2-PB1,1140,0,1879,0,3,1882,T
2-PB1,1141,0,1877,0,3,1880,T
2-PB1,1142,0,1880,0,1,1881,T
2-PB1,1143,0,1,0,1860,1861,C
2-PB1,1144,1855,0,1,0,1856,A
2-PB1,1145,1861,0,0,0,1861,A
2-PB1,1146,1,1833,0,1,1835,T
2-PB1,1147,2,3,1834,1,1840,G
2-PB1,1148,1822,1,1,0,1824,A
2-PB1,1149,1826,0,1,0,1827,A
2-PB1,1150,0,1816,0,3,1819,T
2-PB1,1151,1,2,0,1829,1832,C
2-PB1,1152,1826,1,4,0,1831,A
2-PB1,1153,1832,0,0,1,1833,A
2-PB1,1154,0,0,0,1832,1832,C
2-PB1,1155,1822,0,4,0,1826,A
2-PB1,1156,1817,2,4,0,1823,A
2-PB1,1157,0,3,1823,0,1826,G
2-PB1,1158,0,1,1838,0,1839,G
2-PB1,1159,1833,0,2,0,1835,A
2-PB1,1160,1829,0,3,0,1832,A
2-PB1,1161,0,2,1835,0,1837,G
2-PB1,1162,1836,1,2,0,1839,A
2-PB1,1163,1837,0,0,0,1837,A
2-PB1,1164,1835,0,0,0,1835,A
2-PB1,1165,1831,0,1,0,1832,A
2-PB1,1166,0,1831,0,0,1831,T
2-PB1,1167,1,1819,0,0,1820,T
2-PB1,1168,0,3,1815,0,1818,G
2-PB1,1169,1814,1,2,1,1818,A
2-PB1,1170,0,1,1814,0,1815,G
2-PB1,1171,1817,0,0,0,1817,A
2-PB1,1172,1828,0,3,1,1832,A
2-PB1,1173,1854,0,1,0,1855,A
2-PB1,1174,1862,0,1,0,1863,A
2-PB1,1175,0,1861,0,1,1862,T
2-PB1,1176,1861,0,0,1,1862,A
2-PB1,1177,1856,0,5,1,1862,A
2-PB1,1178,0,3,1868,0,1871,G
2-PB1,1179,1,0,1866,1,1868,G
2-PB1,1180,0,0,0,1860,1860,C
2-PB1,1181,2,1,0,1849,1852,C
2-PB1,1182,0,1828,1,7,1836,T
2-PB1,1183,1,0,1,2062,2064,C
2-PB1,1184,0,2089,0,2,2091,T
2-PB1,1185,0,2094,0,1,2095,T
2-PB1,1186,0,0,0,2131,2131,C
2-PB1,1187,1,2124,0,4,2129,T
2-PB1,1188,2127,0,4,0,2131,A
2-PB1,1189,2123,1,4,0,2128,A
2-PB1,1190,1,2128,0,0,2129,T
2-PB1,1191,2145,0,1,0,2146,A
2-PB1,1192,0,2,2101,0,2103,G
2-PB1,1193,1924,0,2,0,1926,A
2-PB1,1194,1,1926,0,0,1927,T
2-PB1,1195,0,4,1885,0,1889,G
2-PB1,1196,1,0,1914,1,1916,G
2-PB1,1197,0,1,0,1905,1906,C
2-PB1,1198,1913,0,1,0,1914,A
2-PB1,1199,0,0,0,1924,1924,C
2-PB1,1200,1883,0,6,0,1889,A
2-PB1,1201,1,1,1971,0,1973,G
2-PB1,1202,0,2,0,1964,1966,C
2-PB1,1203,1964,0,2,0,1966,A
2-PB1,1204,0,2014,0,11,2025,T
2-PB1,1205,1,1,1,1994,1997,C
2-PB1,1206,2016,0,0,0,2016,A
2-PB1,1207,0,2004,0,9,2013,T
2-PB1,1208,0,2005,0,2,2007,T
2-PB1,1209,0,4,1995,0,1999,G
2-PB1,1210,1933,1,4,0,1938,A
2-PB1,1211,0,0,1984,0,1984,G
2-PB1,1212,3,1,0,1974,1978,C
2-PB1,1213,1,0,0,1954,1955,C
2-PB1,1214,2,0,0,1997,1999,C
2-PB1,1215,1,1970,0,5,1976,T
2-PB1,1216,0,1,2309,0,2310,G
2-PB1,1217,1,1,2370,0,2372,G
2-PB1,1218,2364,0,8,0,2372,A
2-PB1,1219,2534,1,1,2,2538,A
2-PB1,1220,0,2483,0,0,2483,T
2-PB1,1221,0,6,2595,0,2601,G
2-PB1,1222,2685,0,7,0,2692,A
2-PB1,1223,1,2711,0,4,2716,T
2-PB1,1224,0,1,2732,0,2733,G
2-PB1,1225,2699,1,3,0,2703,A
2-PB1,1226,0,2687,0,0,2687,T
2-PB1,1227,0,6,2700,0,2706,G
2-PB1,1228,1,3,2778,0,2782,G
2-PB1,1229,2,1,2793,0,2796,G
2-PB1,1230,0,2,0,2772,2774,C
2-PB1,1231,2785,2,5,0,2792,A
2-PB1,1232,0,2813,0,1,2814,T
2-PB1,1233,1,0,2937,0,2938,G
2-PB1,1234,1,2942,0,8,2951,T
2-PB1,1235,0,2963,0,3,2966,T
2-PB1,1236,6,0,3,2985,2994,C
2-PB1,1237,2978,1,3,0,2982,A
2-PB1,1238,2996,0,2,2,3000,A
2-PB1,1239,3,1,0,3000,3004,C
2-PB1,1240,3018,0,3,1,3022,A
2-PB1,1241,0,3039,0,2,3041,T
2-PB1,1242,2,2,3121,0,3125,G
2-PB1,1243,0,1,1,3134,3136,C
2-PB1,1244,1,3118,0,5,3124,T
2-PB1,1245,3164,0,3,0,3167,A
2-PB1,1246,3156,1,7,2,3166,A
2-PB1,1247,2,0,3246,0,3248,G
2-PB1,1248,1,3244,0,2,3247,T
2-PB1,1249,3234,0,5,0,3239,A
2-PB1,1250,3,5,0,3254,3262,C
2-PB1,1251,2,7,3288,0,3297,G
2-PB1,1252,1,3,3556,0,3560,G
2-PB1,1253,1,3554,0,4,3559,T
2-PB1,1254,1,3546,3,1,3551,T
2-PB1,1255,0,3548,2,6,3556,T
2-PB1,1256,0,3549,0,2,3551,T
2-PB1,1257,3548,0,0,0,3548,A
2-PB1,1258,1,1,3544,0,3546,G
2-PB1,1259,2,5,3541,1,3549,G
2-PB1,1260,3475,1,8,0,3484,A
2-PB1,1261,0,3,3462,0,3465,G
2-PB1,1262,0,3535,0,3,3538,T
2-PB1,1263,3,1,0,3550,3554,C
2-PB1,1264,1,3552,0,5,3558,T
2-PB1,1265,6,2,0,3547,3555,C
2-PB1,1266,6,1,3557,0,3564,G
2-PB1,1267,3696,0,6,0,3702,A
2-PB1,1268,1,3713,0,4,3718,T
2-PB1,1269,3745,2,2,0,3749,A
2-PB1,1270,1,0,0,3748,3749,C
2-PB1,1271,4,3698,0,6,3708,T
2-PB1,1272,1,6,3713,0,3720,G
2-PB1,1273,3715,1,2,0,3718,A
2-PB1,1274,3791,1,3,0,3795,A
2-PB1,1275,1,3799,1,4,3805,T
2-PB1,1276,6,0,0,3753,3759,C
2-PB1,1277,0,3737,1,3,3741,T
2-PB1,1278,0,3745,1,1,3747,T
2-PB1,1279,3,5,3751,0,3759,G
2-PB1,1280,1,1,3765,1,3768,G
2-PB1,1281,3762,0,7,0,3769,A
2-PB1,1282,2,1,0,3775,3778,C
2-PB1,1283,3743,1,5,0,3749,A
2-PB1,1284,3768,1,5,0,3774,A
2-PB1,1285,3803,0,0,0,3803,A
2-PB1,1286,3805,1,9,0,3815,A
2-PB1,1287,1,4,3889,0,3894,G
2-PB1,1288,3890,0,3,1,3894,A
2-PB1,1289,3879,1,6,1,3887,A
2-PB1,1290,3887,0,6,0,3893,A
2-PB1,1291,0,3901,0,1,3902,T
2-PB1,1292,3911,0,4,0,3915,A
2-PB1,1293,1,3,0,4056,4060,C
2-PB1,1294,4037,2,5,0,4044,A
2-PB1,1295,0,0,0,4068,4068,C
2-PB1,1296,7,1,0,4033,4041,C
2-PB1,1297,4031,0,3,2,4036,A
2-PB1,1298,4097,1,4,0,4102,A
2-PB1,1299,1,5,4246,0,4252,G
2-PB1,1300,4303,1,7,1,4312,A
2-PB1,1301,0,1,0,4351,4352,C
2-PB1,1302,4291,1,3,0,4295,A
2-PB1,1303,4467,2,8,0,4477,A
2-PB1,1304,1,0,0,4498,4499,C
2-PB1,1305,4603,1,2,0,4606,A
2-PB1,1306,0,4626,0,1,4627,T
2-PB1,1307,4598,0,4,1,4603,A
2-PB1,1308,0,1,1,4688,4690,C
2-PB1,1309,0,4584,0,3,4587,T
2-PB1,1310,3,7,4674,1,4685,G
2-PB1,1311,1,3,4678,1,4683,G
2-PB1,1312,2,4605,0,6,4613,T
2-PB1,1313,3,13,4600,0,4616,G
2-PB1,1314,5,5,4569,1,4580,G
2-PB1,1315,2,3,4598,0,4603,G
2-PB1,1316,4592,2,11,0,4605,A
2-PB1,1317,0,4528,0,6,4534,T
2-PB1,1318,2,9,4519,0,4530,G
2-PB1,1319,3,6,4509,0,4518,G
2-PB1,1320,11,2,4543,0,4556,G
2-PB1,1321,2,1,0,4605,4608,C
2-PB1,1322,0,4591,1,6,4598,T
2-PB1,1323,6,2,0,4618,4626,C
2-PB1,1324,3,2,0,4609,4614,C
2-PB1,1325,4608,0,5,1,4614,A
2-PB1,1326,4610,1,3,1,4615,A
2-PB1,1327,1,4603,1,8,4613,T
2-PB1,1328,4,0,1,4582,4587,C
2-PB1,1329,8,3,0,4547,4558,C
2-PB1,1330,0,4529,0,7,4536,T
2-PB1,1331,2,3,0,4528,4533,C
2-PB1,1332,5,2,0,4516,4523,C
2-PB1,1333,3,6,4520,0,4529,G
2-PB1,1334,4524,0,1,0,4525,A
2-PB1,1335,1,2,0,4522,4525,C
2-PB1,1336,0,4,4534,0,4538,G
2-PB1,1337,4594,0,1,0,4595,A
2-PB1,1338,0,4583,1,3,4587,T
2-PB1,1339,0,4584,1,2,4587,T
2-PB1,1340,0,4577,1,2,4580,T
2-PB1,1341,1,4586,0,3,4590,T
2-PB1,1342,2,0,4599,0,4601,G
2-PB1,1343,4,4,0,4621,4629,C
2-PB1,1344,4,2,0,4633,4639,C
2-PB1,1345,12,4,0,4773,4789,C
2-PB1,1346,0,4756,0,7,4763,T
2-PB1,1347,3,7,0,4987,4997,C
2-PB1,1348,5030,0,1,0,5031,A
2-PB1,1349,1,5043,0,2,5046,T
2-PB1,1350,5052,0,2,0,5054,A
2-PB1,1351,5,2,5096,0,5103,G
2-PB1,1352,1,5053,0,3,5057,T
2-PB1,1353,2,11,5064,0,5077,G
2-PB1,1354,4956,3,1,0,4960,A
2-PB1,1355,4950,1,6,0,4957,A
2-PB1,1356,0,4766,1,3,4770,T
2-PB1,1357,2,1,4758,0,4761,G
2-PB1,1358,0,5,1,4799,4805,C
2-PB1,1359,4796,0,14,0,4810,A
2-PB1,1360,3,3,1,4805,4812,C
2-PB1,1361,5,1,0,4779,4785,C
2-PB1,1362,4770,0,2,0,4772,A
2-PB1,1363,4768,0,0,0,4768,A
2-PB1,1364,4750,0,8,1,4759,A
2-PB1,1365,1,4656,1,11,4669,T
2-PB1,1366,6,1,1,4826,4834,C
2-PB1,1367,4832,1,4,0,4837,A
2-PB1,1368,0,4843,0,2,4845,T
2-PB1,1369,1,5,4832,0,4838,G
2-PB1,1370,4858,2,11,0,4871,A
2-PB1,1371,1,12,4891,0,4904,G
2-PB1,1372,0,7,4915,0,4922,G
2-PB1,1373,3,10,4931,0,4944,G
2-PB1,1374,4922,3,9,1,4935,A
2-PB1,1375,5025,0,7,1,5033,A
2-PB1,1376,3,5044,0,3,5050,T
2-PB1,1377,5067,1,1,0,5069,A
2-PB1,1378,0,3,1,5062,5066,C
2-PB1,1379,5082,1,13,0,5096,A
2-PB1,1380,5097,1,9,1,5108,A
2-PB1,1381,1,2,5084,0,5087,G
2-PB1,1382,4,3,0,5036,5043,C
2-PB1,1383,5024,0,2,0,5026,A
2-PB1,1384,1,2,5073,0,5076,G
2-PB1,1385,0,8,5074,0,5082,G
2-PB1,1386,5055,1,5,1,5062,A
2-PB1,1387,1,8,5092,0,5101,G
2-PB1,1388,0,5040,0,6,5046,T
2-PB1,1389,1,9,5114,0,5124,G
2-PB1,1390,2,5,5135,1,5143,G
2-PB1,1391,5139,0,5,0,5144,A
2-PB1,1392,1,5149,0,1,5151,T
2-PB1,1393,5104,0,2,0,5106,A
2-PB1,1394,1,6,5160,0,5167,G
2-PB1,1395,5216,0,8,0,5224,A
2-PB1,1396,1,5236,1,11,5249,T
2-PB1,1397,1,5225,0,4,5230,T
2-PB1,1398,5,2,2,5385,5394,C
2-PB1,1399,2,5365,0,7,5374,T
2-PB1,1400,5375,0,2,0,5377,A
2-PB1,1401,1,1,0,5372,5374,C
2-PB1,1402,5280,0,5,0,5285,A
2-PB1,1403,1,14,5278,0,5293,G
2-PB1,1404,2,12,5199,2,5215,G
2-PB1,1405,5273,2,11,0,5286,A
2-PB1,1406,1,1,0,5265,5267,C
2-PB1,1407,7,2,0,5192,5201,C
2-PB1,1408,1,5142,0,14,5157,T
2-PB1,1409,2,3,5184,0,5189,G
2-PB1,1410,2,1,0,5180,5183,C
2-PB1,1411,5179,0,5,0,5184,A
2-PB1,1412,5224,2,9,0,5235,A
2-PB1,1413,2,0,5257,0,5259,G
2-PB1,1414,0,5168,1,6,5175,T
2-PB1,1415,0,5179,1,3,5183,T
2-PB1,1416,5107,1,6,1,5115,A
2-PB1,1417,0,3,5134,0,5137,G
2-PB1,1418,0,5104,2,5,5111,T
2-PB1,1419,0,10,5098,1,5109,G
2-PB1,1420,3,3,5086,0,5092,G
2-PB1,1421,2,6,5136,1,5145,G
2-PB1,1422,5116,0,8,0,5124,A
2-PB1,1423,5157,0,3,1,5161,A
2-PB1,1424,1,5136,1,5,5143,T
2-PB1,1425,12,1,0,5148,5161,C
2-PB1,1426,5155,2,6,1,5164,A
2-PB1,1427,5168,1,1,0,5170,A
2-PB1,1428,0,1,0,5163,5164,C
2-PB1,1429,5162,0,1,0,5163,A
2-PB1,1430,0,5052,0,1,5053,T
2-PB1,1431,2,10,5054,0,5066,G
2-PB1,1432,5071,0,12,1,5084,A
2-PB1,1433,7,0,5123,0,5130,G
2-PB1,1434,3,3,0,5097,5103,C
2-PB1,1435,5086,0,2,0,5088,A
2-PB1,1436,5083,0,6,0,5089,A
2-PB1,1437,5081,0,11,0,5092,A
2-PB1,1438,5124,0,9,1,5134,A
2-PB1,1439,5136,1,2,0,5139,A
2-PB1,1440,2,2,5126,0,5130,G
2-PB1,1441,5072,1,7,0,5080,A
2-PB1,1442,5011,1,13,0,5025,A
2-PB1,1443,1,2,5186,0,5189,G
2-PB1,1444,1,5180,0,7,5188,T
2-PB1,1445,6,0,1,5179,5186,C
2-PB1,1446,5,0,1,5200,5206,C
2-PB1,1447,2,5185,0,7,5194,T
2-PB1,1448,5277,0,7,0,5284,A
2-PB1,1449,0,5262,0,4,5266,T
2-PB1,1450,5267,2,6,0,5275,A
2-PB1,1451,1,5264,0,4,5269,T
2-PB1,1452,5215,0,5,0,5220,A
2-PB1,1453,5218,0,2,1,5221,A
2-PB1,1454,5214,1,5,0,5220,A
2-PB1,1455,1,5205,0,3,5209,T
2-PB1,1456,5171,0,1,0,5172,A
2-PB1,1457,5142,0,4,0,5146,A
2-PB1,1458,5166,0,8,0,5174,A
2-PB1,1459,5181,1,6,3,5191,A
2-PB1,1460,0,1,0,5193,5194,C
2-PB1,1461,5007,3,1,1,5012,A
2-PB1,1462,2,8,5006,0,5016,G
2-PB1,1463,0,6,4993,0,4999,G
2-PB1,1464,3,5,5020,0,5028,G
2-PB1,1465,5009,0,6,0,5015,A
2-PB1,1466,2,0,0,5056,5058,C
2-PB1,1467,5036,2,2,0,5040,A
2-PB1,1468,0,5072,0,3,5075,T
2-PB1,1469,2,5051,0,6,5059,T
2-PB1,1470,1,5079,0,4,5084,T
2-PB1,1471,2,10,5067,0,5079,G
2-PB1,1472,5040,0,7,1,5048,A
2-PB1,1473,5060,0,2,0,5062,A
2-PB1,1474,0,5056,0,7,5063,T
2-PB1,1475,0,4968,0,8,4976,T
2-PB1,1476,8,2,0,5000,5010,C
2-PB1,1477,4969,1,6,0,4976,A
2-PB1,1478,3,1,0,4987,4991,C
2-PB1,1479,2,4977,2,1,4982,T
2-PB1,1480,4992,2,5,0,4999,A
2-PB1,1481,2,3,4992,0,4997,G
2-PB1,1482,0,0,0,5005,5005,C
2-PB1,1483,0,4927,1,12,4940,T
2-PB1,1484,2,5000,1,8,5011,T
2-PB1,1485,1,4986,1,3,4991,T
2-PB1,1486,1,4989,0,2,4992,T
2-PB1,1487,1,4987,1,4,4993,T
2-PB1,1488,3,4990,3,0,4996,T
2-PB1,1489,0,4975,0,1,4976,T
2-PB1,1490,4969,0,2,0,4971,A
2-PB1,1491,2,4946,0,1,4949,T
2-PB1,1492,4,2,0,4944,4950,C
2-PB1,1493,1,6,4976,0,4983,G
2-PB1,1494,5128,2,2,0,5132,A
2-PB1,1495,0,5156,0,1,5157,T
2-PB1,1496,5161,2,5,0,5168,A
2-PB1,1497,0,5189,7,6,5202,T
2-PB1,1498,1,3,5198,1,5203,G
2-PB1,1499,2,5,5221,1,5229,G
2-PB1,1500,5233,0,5,0,5238,A
2-PB1,1501,1,5213,0,3,5217,T
2-PB1,1502,0,5175,0,4,5179,T
2-PB1,1503,2,5059,0,0,5061,T
2-PB1,1504,1,2,5063,2,5068,G
2-PB1,1505,2,5038,0,11,5051,T
2-PB1,1506,1,5,5021,0,5027,G
2-PB1,1507,2,1,5033,0,5036,G
2-PB1,1508,0,1,0,5008,5009,C
2-PB1,1509,1,5005,0,4,5010,T
2-PB1,1510,5032,0,2,1,5035,A
2-PB1,1511,5065,1,0,2,5068,A
2-PB1,1512,1,5082,2,11,5096,T
2-PB1,1513,1,5090,2,3,5096,T
2-PB1,1514,0,5096,0,2,5098,T
2-PB1,1515,0,5111,0,0,5111,T
2-PB1,1516,5109,1,8,1,5119,A
2-PB1,1517,2,2,5153,0,5157,G
2-PB1,1518,0,0,0,5149,5149,C
2-PB1,1519,5144,0,3,0,5147,A
2-PB1,1520,1,5092,0,8,5101,T
2-PB1,1521,4,7,5038,1,5050,G
2-PB1,1522,0,4,5119,0,5123,G
2-PB1,1523,5116,1,6,2,5125,A
2-PB1,1524,1,3,5113,0,5117,G
2-PB1,1525,2,0,0,5110,5112,C
2-PB1,1526,0,5038,0,7,5045,T
2-PB1,1527,0,0,5094,0,5094,G
2-PB1,1528,3,3,1,5055,5062,C
2-PB1,1529,14,6,1,5046,5067,C
2-PB1,1530,10,3,0,5070,5083,C
2-PB1,1531,5007,0,3,0,5010,A
2-PB1,1532,0,2,5306,0,5308,G
2-PB1,1533,2,5287,0,9,5298,T
2-PB1,1534,1,5300,0,4,5305,T
2-PB1,1535,1,5304,1,5,5311,T
2-PB1,1536,1,5261,0,6,5268,T
2-PB1,1537,3,10,5216,1,5230,G
2-PB1,1538,2,9,5231,0,5242,G
2-PB1,1539,5228,2,5,0,5235,A
2-PB1,1540,1,2,5244,0,5247,G
2-PB1,1541,0,4869,1,5,4875,T
2-PB1,1542,2,1,5093,0,5096,G
2-PB1,1543,2,5072,0,11,5085,T
2-PB1,1544,4,0,0,5076,5080,C
2-PB1,1545,3,5078,1,7,5089,T
2-PB1,1546,2,1,5102,1,5106,G
2-PB1,1547,0,5,5178,2,5185,G
2-PB1,1548,5181,0,4,0,5185,A
2-PB1,1549,5184,1,16,0,5201,A
2-PB1,1550,0,5178,1,2,5181,T
2-PB1,1551,4885,0,1,0,4886,A
2-PB1,1552,4867,1,9,0,4877,A
2-PB1,1553,4873,1,9,1,4884,A
2-PB1,1554,10,1,0,4874,4885,C
2-PB1,1555,1,6,4836,0,4843,G
2-PB1,1556,4804,1,4,0,4809,A
2-PB1,1557,4,0,4810,0,4814,G
2-PB1,1558,0,4791,0,1,4792,T
2-PB1,1559,9,1,0,4802,4812,C
2-PB1,1560,4794,1,4,0,4799,A
2-PB1,1561,2,1,4880,0,4883,G
2-PB1,1562,1,1,0,4879,4881,C
2-PB1,1563,1,4879,1,3,4884,T
2-PB1,1564,1,3,5064,0,5068,G
2-PB1,1565,5028,0,10,0,5038,A
2-PB1,1566,0,5045,1,1,5047,T
2-PB1,1567,5043,0,9,0,5052,A
2-PB1,1568,0,5010,1,3,5014,T
2-PB1,1569,0,11,5032,1,5044,G
2-PB1,1570,4889,0,6,0,4895,A
2-PB1,1571,0,2,4981,0,4983,G
2-PB1,1572,0,2,2,4985,4989,C
2-PB1,1573,4784,0,3,0,4787,A
2-PB1,1574,0,4796,0,1,4797,T
2-PB1,1575,2,4793,0,6,4801,T
2-PB1,1576,6,4,4861,0,4871,G
2-PB1,1577,4,5,5052,0,5061,G
2-PB1,1578,5015,0,9,0,5024,A
2-PB1,1579,2,4,5021,0,5027,G
2-PB1,1580,0,4880,0,11,4891,T
2-PB1,1581,4891,0,5,0,4896,A
2-PB1,1582,4883,1,7,1,4892,A
2-PB1,1583,0,1,0,4939,4940,C
2-PB1,1584,4913,1,3,0,4917,A
2-PB1,1585,2,0,5027,0,5029,G
2-PB1,1586,1,4600,1,6,4608,T
2-PB1,1587,3,9,4655,1,4668,G
2-PB1,1588,4734,1,2,1,4738,A
2-PB1,1589,3,4721,1,8,4733,T
2-PB1,1590,4722,0,1,0,4723,A
2-PB1,1591,4719,0,9,1,4729,A
2-PB1,1592,4619,1,19,0,4639,A
2-PB1,1593,1,10,4695,0,4706,G
2-PB1,1594,4543,0,8,0,4551,A
2-PB1,1595,4547,0,6,0,4553,A
2-PB1,1596,1,3,0,4560,4564,C
2-PB1,1597,4452,0,6,0,4458,A
2-PB1,1598,4501,1,8,0,4510,A
2-PB1,1599,4,1,0,4524,4529,C
2-PB1,1600,4566,1,6,0,4573,A
2-PB1,1601,2,4558,6,4,4570,T
2-PB1,1602,0,7,4525,0,4532,G
2-PB1,1603,4511,0,39,0,4550,A
2-PB1,1604,0,4539,0,3,4542,T
2-PB1,1605,4498,0,4,0,4502,A
2-PB1,1606,4541,0,2,1,4544,A
2-PB1,1607,4538,0,5,1,4544,A
2-PB1,1608,2,2,0,4553,4557,C
2-PB1,1609,4442,0,4,0,4446,A
2-PB1,1610,4432,0,3,0,4435,A
2-PB1,1611,0,4365,1,3,4369,T
2-PB1,1612,1,7,4364,1,4373,G
2-PB1,1613,4464,1,8,0,4473,A
2-PB1,1614,2,7,1,4506,4516,C
2-PB1,1615,6,1,1,4462,4470,C
2-PB1,1616,2,4370,0,8,4380,T
2-PB1,1617,1,4345,0,11,4357,T
2-PB1,1618,1,9,4344,0,4354,G
2-PB1,1619,0,7,4384,0,4391,G
2-PB1,1620,4434,0,16,0,4450,A
2-PB1,1621,2,8,0,4433,4443,C
2-PB1,1622,0,10,0,4363,4373,C
2-PB1,1623,4337,2,5,0,4344,A
2-PB1,1624,3,1,4397,0,4401,G
2-PB1,1625,0,1,0,4392,4393,C
2-PB1,1626,4396,0,4,0,4400,A
2-PB1,1627,4400,0,3,1,4404,A
2-PB1,1628,1,2,0,4389,4392,C
2-PB1,1629,4359,0,1,2,4362,A
2-PB1,1630,1,0,4448,1,4450,G
2-PB1,1631,2,3,0,4436,4441,C
2-PB1,1632,2,1,0,4444,4447,C
2-PB1,1633,5,1,0,4435,4441,C
2-PB1,1634,4441,0,0,4,4445,A
2-PB1,1635,4437,0,6,1,4444,A
2-PB1,1636,4436,0,4,1,4441,A
2-PB1,1637,2,4441,0,6,4449,T
2-PB1,1638,3,6,4419,0,4428,G
2-PB1,1639,6,1,4400,1,4408,G
2-PB1,1640,0,6,0,4391,4397,C
2-PB1,1641,1,4354,0,8,4363,T
2-PB1,1642,2,1,0,4484,4487,C
2-PB1,1643,1,4467,0,12,4480,T
2-PB1,1644,4,1,0,4495,4500,C
2-PB1,1645,5,0,0,4512,4517,C
2-PB1,1646,4521,1,5,0,4527,A
2-PB1,1647,4527,0,0,1,4528,A
2-PB1,1648,2,4511,0,3,4516,T
2-PB1,1649,4,4476,0,1,4481,T
2-PB1,1650,4,1,4511,0,4516,G
2-PB1,1651,1,4427,0,11,4439,T
2-PB1,1652,1,4428,0,2,4431,T
2-PB1,1653,11,10,0,4417,4438,C
2-PB1,1654,4431,0,2,0,4433,A
2-PB1,1655,1,4427,0,5,4433,T
2-PB1,1656,1,1,0,4431,4433,C
2-PB1,1657,4441,1,2,0,4444,A
2-PB1,1658,4438,0,2,1,4441,A
2-PB1,1659,4429,0,9,0,4438,A
2-PB1,1660,1,0,4528,0,4529,G
2-PB1,1661,4533,1,5,0,4539,A
2-PB1,1662,0,4543,0,1,4544,T
2-PB1,1663,0,4549,1,0,4550,T
2-PB1,1664,4561,1,2,0,4564,A
2-PB1,1665,0,1,0,4641,4642,C
2-PB1,1666,4625,1,5,0,4631,A
2-PB1,1667,2,6,4679,0,4687,G
2-PB1,1668,4666,0,8,0,4674,A
2-PB1,1669,1,4768,2,3,4774,T
2-PB1,1670,4773,2,8,0,4783,A
2-PB1,1671,1,1,0,5066,5068,C
2-PB1,1672,5156,0,5,0,5161,A
2-PB1,1673,1,2,0,5470,5473,C
2-PB1,1674,5384,0,7,0,5391,A
2-PB1,1675,0,5439,0,3,5442,T
2-PB1,1676,5377,0,4,0,5381,A
2-PB1,1677,0,5371,0,2,5373,T
2-PB1,1678,5213,1,9,0,5223,A
2-PB1,1679,1,5,5225,0,5231,G
2-PB1,1680,3,1,5162,0,5166,G
2-PB1,1681,0,4922,0,6,4928,T
2-PB1,1682,2,0,4828,0,4830,G
2-PB1,1683,3,9,0,4978,4990,C
2-PB1,1684,6,2,1,4974,4983,C
2-PB1,1685,5049,1,2,0,5052,A
2-PB1,1686,0,5051,0,1,5052,T
2-PB1,1687,5071,2,1,1,5075,A
2-PB1,1688,2,9,5082,0,5093,G
2-PB1,1689,4956,0,13,0,4969,A
2-PB1,1690,1,9,4995,1,5006,G
2-PB1,1691,1,10,4971,1,4983,G
2-PB1,1692,4844,1,4,1,4850,A
2-PB1,1693,1,5,4851,1,4858,G
2-PB1,1694,4818,2,8,0,4828,A
2-PB1,1695,1,2,1,4844,4848,C
2-PB1,1696,4833,2,6,1,4842,A
2-PB1,1697,2,2,1,4890,4895,C
2-PB1,1698,4896,0,7,0,4903,A
2-PB1,1699,1,26,0,4871,4898,C
2-PB1,1700,4869,2,2,0,4873,A
2-PB1,1701,4885,2,10,0,4897,A
2-PB1,1702,4922,0,5,0,4927,A
2-PB1,1703,2,4907,0,2,4911,T
2-PB1,1704,4,2,2,4917,4925,C
2-PB1,1705,6,0,0,4915,4921,C
2-PB1,1706,4849,0,4,1,4854,A
2-PB1,1707,1,4,4872,1,4878,G
2-PB1,1708,4867,2,3,0,4872,A
2-PB1,1709,0,4,0,4893,4897,C
2-PB1,1710,1,4,4881,0,4886,G
2-PB1,1711,4879,2,4,0,4885,A
2-PB1,1712,0,5,4887,1,4893,G
2-PB1,1713,4884,2,7,0,4893,A
2-PB1,1714,4874,1,14,1,4890,A
2-PB1,1715,1,4,4904,1,4910,G
2-PB1,1716,4871,1,20,3,4895,A
2-PB1,1717,1,4869,0,8,4878,T
2-PB1,1718,8,3,0,4852,4863,C
2-PB1,1719,4862,2,1,0,4865,A
2-PB1,1720,1,4848,0,2,4851,T
2-PB1,1721,1,4847,0,1,4849,T
2-PB1,1722,4,4,0,4849,4857,C
2-PB1,1723,1,4,4856,1,4862,G
2-PB1,1724,4818,0,5,0,4823,A
2-PB1,1725,0,4,4829,1,4834,G
2-PB1,1726,4798,0,6,0,4804,A
2-PB1,1727,1,4983,0,2,4986,T
2-PB1,1728,5001,0,1,0,5002,A
2-PB1,1729,5012,0,1,0,5013,A
2-PB1,1730,5006,3,11,0,5020,A
2-PB1,1731,4,3,5018,0,5025,G
2-PB1,1732,5015,0,8,1,5024,A
2-PB1,1733,4886,0,12,1,4899,A
2-PB1,1734,0,2,4910,1,4913,G
2-PB1,1735,0,0,0,4919,4919,C
2-PB1,1736,0,4868,2,8,4878,T
2-PB1,1737,1,1,4895,0,4897,G
2-PB1,1738,1,4866,0,7,4874,T
2-PB1,1739,3,13,4837,0,4853,G
2-PB1,1740,0,9,4867,0,4876,G
2-PB1,1741,1,6,4914,0,4921,G
2-PB1,1742,4940,0,2,0,4942,A
2-PB1,1743,0,4904,1,3,4908,T
2-PB1,1744,9,3,0,4888,4900,C
2-PB1,1745,4898,0,5,1,4904,A
2-PB1,1746,4936,1,1,1,4939,A
2-PB1,1747,4957,0,6,1,4964,A
2-PB1,1748,2,4,0,4948,4954,C
2-PB1,1749,3,4,1,4924,4932,C
2-PB1,1750,11,4,1,4902,4918,C
2-PB1,1751,4926,2,5,1,4934,A
2-PB1,1752,5025,0,5,0,5030,A
2-PB1,1753,0,5005,0,2,5007,T
2-PB1,1754,4,1,0,5018,5023,C
2-PB1,1755,4958,0,7,5,4970,A
2-PB1,1756,4938,1,8,1,4948,A
2-PB1,1757,1,9,5013,0,5023,G
2-PB1,1758,4,2,4991,0,4997,G
2-PB1,1759,1,1,4996,0,4998,G
2-PB1,1760,2,2,1,5004,5009,C
2-PB1,1761,4935,0,7,0,4942,A
2-PB1,1762,0,6,5074,1,5081,G
2-PB1,1763,1,2,5125,0,5128,G
2-PB1,1764,5140,0,4,2,5146,A
2-PB1,1765,0,1,0,5212,5213,C
2-PB1,1766,1,5144,0,1,5146,T
2-PB1,1767,5269,0,1,0,5270,A
2-PB1,1768,0,5250,1,6,5257,T
2-PB1,1769,0,5257,0,6,5263,T
2-PB1,1770,0,8,5262,0,5270,G
2-PB1,1771,5,3,5278,0,5286,G
2-PB1,1772,2,5217,0,5,5224,T
2-PB1,1773,5224,0,4,1,5229,A
2-PB1,1774,1,5142,0,4,5147,T
2-PB1,1775,7,0,1,5154,5162,C
2-PB1,1776,5085,2,2,0,5089,A
2-PB1,1777,0,2,5120,0,5122,G
2-PB1,1778,5093,0,14,0,5107,A
2-PB1,1779,1,5062,0,4,5067,T
2-PB1,1780,3,13,4866,0,4882,G
2-PB1,1781,3,10,4863,0,4876,G
2-PB1,1782,1,13,4858,0,4872,G
2-PB1,1783,5,7,4878,1,4891,G
2-PB1,1784,1,11,4877,0,4889,G
2-PB1,1785,4881,0,10,1,4892,A
2-PB1,1786,3,3,1,4859,4866,C
2-PB1,1787,9,2,0,4832,4843,C
2-PB1,1788,4850,0,1,1,4852,A
2-PB1,1789,5178,1,1,0,5180,A
2-PB1,1790,5197,0,4,2,5203,A
2-PB1,1791,4,0,0,5326,5330,C
2-PB1,1792,0,5288,1,7,5296,T
2-PB1,1793,0,5277,0,1,5278,T
2-PB1,1794,5293,1,5,1,5300,A
2-PB1,1795,3,5298,0,2,5303,T
2-PB1,1796,5312,1,3,1,5317,A
2-PB1,1797,2,2,0,5320,5324,C
2-PB1,1798,4916,0,6,1,4923,A
2-PB1,1799,4928,2,7,2,4939,A
2-PB1,1800,1,4814,0,0,4815,T
2-PB1,1801,4903,1,0,1,4905,A
2-PB1,1802,1,4882,0,2,4885,T
2-PB1,1803,6,1,0,4881,4888,C
2-PB1,1804,3,3,1,4883,4890,C
2-PB1,1805,7,4,4863,0,4874,G
2-PB1,1806,1,3,4879,0,4883,G
2-PB1,1807,4892,0,2,2,4896,A
2-PB1,1808,4903,1,2,0,4906,A
2-PB1,1809,0,4905,0,3,4908,T
2-PB1,1810,1,0,0,4940,4941,C
2-PB1,1811,1,4913,1,8,4923,T
2-PB1,1812,0,4937,1,5,4943,T
2-PB1,1813,1,0,2,4942,4945,C
2-PB1,1814,4934,0,8,0,4942,A
2-PB1,1815,2,2,0,4950,4954,C
2-PB1,1816,4932,0,5,0,4937,A
2-PB1,1817,1,5284,0,5,5290,T
2-PB1,1818,2,0,0,5293,5295,C
2-PB1,1819,6,2,0,5305,5313,C
2-PB1,1820,13,2,1,5331,5347,C
2-PB1,1821,4,5339,0,6,5349,T
2-PB1,1822,3,0,5343,0,5346,G
2-PB1,1823,5341,1,6,0,5348,A
2-PB1,1824,5336,0,9,0,5345,A
2-PB1,1825,0,1,5356,0,5357,G
2-PB1,1826,0,5046,0,9,5055,T
2-PB1,1827,8,0,0,5051,5059,C
2-PB1,1828,0,4964,0,7,4971,T
2-PB1,1829,4,0,5115,0,5119,G
2-PB1,1830,0,0,1,5121,5122,C
2-PB1,1831,0,5117,0,7,5124,T
2-PB1,1832,2,5132,0,1,5135,T
2-PB1,1833,5114,0,1,2,5117,A
2-PB1,1834,5112,2,4,1,5119,A
2-PB1,1835,5145,0,8,0,5153,A
2-PB1,1836,3,1,5176,0,5180,G
2-PB1,1837,0,5123,0,3,5126,T
2-PB1,1838,6,11,5004,0,5021,G
2-PB1,1839,0,4,4997,0,5001,G
2-PB1,1840,4,9,5019,1,5033,G
2-PB1,1841,4999,1,7,1,5008,A
2-PB1,1842,0,0,5043,0,5043,G
2-PB1,1843,2,4,0,5023,5029,C
2-PB1,1844,1,5001,1,5,5008,T
2-PB1,1845,11,2,4998,0,5011,G
2-PB1,1846,5009,0,8,0,5017,A
2-PB1,1847,1,5014,0,0,5015,T
2-PB1,1848,2,10,5009,0,5021,G
2-PB1,1849,1,6,5003,0,5010,G
2-PB1,1850,4995,1,4,0,5000,A
2-PB1,1851,1,4970,1,8,4980,T
2-PB1,1852,2,7,4978,1,4988,G
2-PB1,1853,4966,0,4,2,4972,A
2-PB1,1854,1,5,5048,0,5054,G
2-PB1,1855,5032,1,4,1,5038,A
2-PB1,1856,5053,0,2,0,5055,A
2-PB1,1857,2,5018,2,7,5029,T
2-PB1,1858,0,5006,0,1,5007,T
2-PB1,1859,5016,1,8,0,5025,A
2-PB1,1860,1,5019,1,2,5023,T
2-PB1,1861,4,4,0,5014,5022,C
2-PB1,1862,6,9,5031,0,5046,G
2-PB1,1863,1,10,4993,1,5005,G
2-PB1,1864,2,5,4991,0,4998,G
2-PB1,1865,0,2,5004,0,5006,G
2-PB1,1866,4992,1,2,1,4996,A
2-PB1,1867,4994,1,7,2,5004,A
2-PB1,1868,1,8,5038,0,5047,G
2-PB1,1869,5073,0,10,1,5084,A
2-PB1,1870,2,0,0,5108,5110,C
2-PB1,1871,0,5047,1,6,5054,T
2-PB1,1872,0,5144,0,1,5145,T
2-PB1,1873,1,5151,0,1,5153,T
2-PB1,1874,4,2,5195,1,5202,G
2-PB1,1875,1,5202,0,2,5205,T
2-PB1,1876,5195,1,1,0,5197,A
2-PB1,1877,5167,0,7,1,5175,A
2-PB1,1878,0,5064,2,5,5071,T
2-PB1,1879,3,3,0,5095,5101,C
2-PB1,1880,8,1,0,5076,5085,C
2-PB1,1881,12,3,0,5038,5053,C
2-PB1,1882,14,4,0,5077,5095,C
2-PB1,1883,3,5057,2,7,5069,T
2-PB1,1884,3,11,5072,0,5086,G
2-PB1,1885,5070,0,3,0,5073,A
2-PB1,1886,5106,1,2,0,5109,A
2-PB1,1887,2,5100,1,11,5114,T
2-PB1,1888,8,0,0,5071,5079,C
2-PB1,1889,9,4,0,5038,5051,C
2-PB1,1890,8,1,0,4996,5005,C
2-PB1,1891,1,4986,1,8,4996,T
2-PB1,1892,2,5002,0,7,5011,T
2-PB1,1893,2,4989,0,4,4995,T
2-PB1,1894,1,0,4990,0,4991,G
2-PB1,1895,2,4969,0,6,4977,T
2-PB1,1896,8,3,0,4956,4967,C
2-PB1,1897,4911,2,4,0,4917,A
2-PB1,1898,1,3,4985,0,4989,G
2-PB1,1899,1,0,0,4978,4979,C
2-PB1,1900,7,0,0,4976,4983,C
2-PB1,1901,4992,0,3,0,4995,A
2-PB1,1902,1,4987,0,1,4989,T
2-PB1,1903,4998,0,3,1,5002,A
2-PB1,1904,5007,3,3,0,5013,A
2-PB1,1905,5016,0,5,0,5021,A
2-PB1,1906,1,4,5073,0,5078,G
2-PB1,1907,4961,1,1,0,4963,A
2-PB1,1908,4984,0,5,0,4989,A
2-PB1,1909,4986,0,7,0,4993,A
2-PB1,1910,1,4985,0,1,4987,T
2-PB1,1911,4,4957,2,2,4965,T
2-PB1,1912,0,12,4962,2,4976,G
2-PB1,1913,4923,0,17,0,4940,A
2-PB1,1914,0,0,5006,0,5006,G
2-PB1,1915,3,4981,1,9,4994,T
2-PB1,1916,13,2,0,5017,5032,C
2-PB1,1917,0,4995,0,6,5001,T
2-PB1,1918,3,3,5110,0,5116,G
2-PB1,1919,1,5102,0,2,5105,T
2-PB1,1920,5183,0,3,0,5186,A
2-PB1,1921,5172,0,10,0,5182,A
2-PB1,1922,5165,1,12,1,5179,A
2-PB1,1923,3,1,0,5196,5200,C
2-PB1,1924,5070,1,2,2,5075,A
2-PB1,1925,5169,1,3,0,5173,A
2-PB1,1926,1,5171,0,1,5173,T
2-PB1,1927,5,1,5134,0,5140,G
2-PB1,1928,2,0,0,5177,5179,C
2-PB1,1929,1,5111,0,10,5122,T
2-PB1,1930,3,0,5287,2,5292,G
2-PB1,1931,0,5294,0,2,5296,T
2-PB1,1932,5371,0,7,0,5378,A
2-PB1,1933,0,2,5387,0,5389,G
2-PB1,1934,0,5256,0,3,5259,T
2-PB1,1935,5235,0,3,0,5238,A
2-PB1,1936,5183,0,2,1,5186,A
2-PB1,1937,1,5144,1,4,5150,T
2-PB1,1938,1,1,5143,0,5145,G
2-PB1,1939,2,2,0,5048,5052,C
2-PB1,1940,3,3,0,4997,5003,C
2-PB1,1941,4913,2,1,0,4916,A
2-PB1,1942,1,0,4956,1,4958,G
2-PB1,1943,0,2,0,5086,5088,C
2-PB1,1944,6,2,0,5072,5080,C
2-PB1,1945,12,4,0,5070,5086,C
2-PB1,1946,5065,0,3,0,5068,A
2-PB1,1947,0,5061,1,3,5065,T
2-PB1,1948,2,8,5050,0,5060,G
2-PB1,1949,0,5,5056,1,5062,G
2-PB1,1950,0,5029,1,5,5035,T
2-PB1,1951,12,2,0,4986,5000,C
2-PB1,1952,5,4,0,4835,4844,C
2-PB1,1953,7,8,4889,0,4904,G
2-PB1,1954,3,1,4910,0,4914,G
2-PB1,1955,1,1,0,4883,4885,C
2-PB1,1956,3,2,1,4899,4905,C
2-PB1,1957,4906,0,2,0,4908,A
2-PB1,1958,4904,0,8,0,4912,A
2-PB1,1959,4908,1,1,0,4910,A
2-PB1,1960,4913,2,8,0,4923,A
2-PB1,1961,0,4,4979,1,4984,G
2-PB1,1962,1,4860,2,3,4866,T
2-PB1,1963,4893,0,3,1,4897,A
2-PB1,1964,1,4883,1,7,4892,T
2-PB1,1965,2,4,4897,0,4903,G
2-PB1,1966,0,2,4984,0,4986,G
2-PB1,1967,4930,0,3,0,4933,A
2-PB1,1968,4985,1,6,0,4992,A
2-PB1,1969,1,4959,0,6,4966,T
2-PB1,1970,4902,1,3,0,4906,A
2-PB1,1971,7,4888,0,6,4901,T
2-PB1,1972,2,3,4855,0,4860,G
2-PB1,1973,4857,2,9,0,4868,A
2-PB1,1974,1,4827,0,6,4834,T
2-PB1,1975,1,0,4698,0,4699,G
2-PB1,1976,1,1,6,4675,4683,C
2-PB1,1977,7,23,1,4599,4630,C
2-PB1,1978,2,1,4641,1,4645,G
2-PB1,1979,0,4634,0,6,4640,T
2-PB1,1980,1,4636,0,5,4642,T
2-PB1,1981,1,0,4654,0,4655,G
2-PB1,1982,1,3,1,4736,4741,C
2-PB1,1983,4740,0,3,1,4744,A
2-PB1,1984,4826,0,4,1,4831,A
2-PB1,1985,2,3,0,4835,4840,C
2-PB1,1986,1,4804,0,5,4810,T
2-PB1,1987,4822,1,4,1,4828,A
2-PB1,1988,3,4,1,4813,4821,C
2-PB1,1989,4810,2,8,2,4822,A
2-PB1,1990,1,4,0,4831,4836,C
2-PB1,1991,4620,0,6,0,4626,A
2-PB1,1992,0,1,0,4985,4986,C
2-PB1,1993,2,4886,3,9,4900,T
2-PB1,1994,9,13,0,4893,4915,C
2-PB1,1995,5,1,3,4913,4922,C
2-PB1,1996,2,4880,1,4,4887,T
2-PB1,1997,2,4,4880,1,4887,G
2-PB1,1998,1,3,4881,0,4885,G
2-PB1,1999,4869,2,3,0,4874,A
2-PB1,2000,1,4876,0,1,4878,T
2-PB1,2001,0,4423,1,5,4429,T
2-PB1,2002,6,3,0,4489,4498,C
2-PB1,2003,3,3,1,4469,4476,C
2-PB1,2004,9,2,1,4484,4496,C
2-PB1,2005,4512,0,3,1,4516,A
2-PB1,2006,4487,0,13,0,4500,A
2-PB1,2007,0,1,4518,0,4519,G
2-PB1,2008,4496,0,11,0,4507,A
2-PB1,2009,5,4,4496,0,4505,G
2-PB1,2010,1,4,4517,0,4522,G
2-PB1,2011,4439,0,8,0,4447,A
2-PB1,2012,4441,1,11,0,4453,A
2-PB1,2013,1,1,0,4451,4453,C
2-PB1,2014,6,4,1,4405,4416,C
2-PB1,2015,6,0,4496,0,4502,G
2-PB1,2016,1,1,0,4502,4504,C
2-PB1,2017,1,4475,0,7,4483,T
2-PB1,2018,4,0,1,4509,4514,C
2-PB1,2019,0,4456,0,8,4464,T
2-PB1,2020,4721,0,2,0,4723,A
2-PB1,2021,0,4715,0,6,4721,T
2-PB1,2022,0,4722,0,0,4722,T
2-PB1,2023,2,1,2,4738,4743,C
2-PB1,2024,1,4579,0,6,4586,T
2-PB1,2025,4582,0,7,0,4589,A
2-PB1,2026,4580,0,5,0,4585,A
2-PB1,2027,4576,2,5,1,4584,A
2-PB1,2028,0,2,1,4587,4590,C
2-PB1,2029,4276,0,2,1,4279,A
2-PB1,2030,2,1,0,4270,4273,C
2-PB1,2031,4208,2,3,0,4213,A
2-PB1,2032,4238,2,7,1,4248,A
2-PB1,2033,0,1,4268,1,4270,G
2-PB1,2034,4,0,0,4270,4274,C
2-PB1,2035,3,1,0,4274,4278,C
2-PB1,2036,4227,0,2,1,4230,A
2-PB1,2037,4228,0,6,3,4237,A
2-PB1,2038,4230,1,3,1,4235,A
2-PB1,2039,0,9,4247,0,4256,G
2-PB1,2040,2,8,4239,0,4249,G
2-PB1,2041,1,5,4191,0,4197,G
2-PB1,2042,1,2,4186,0,4189,G
2-PB1,2043,4159,0,7,0,4166,A
2-PB1,2044,4188,0,3,0,4191,A
2-PB1,2045,2,4178,0,6,4186,T
2-PB1,2046,2,4173,0,16,4191,T
2-PB1,2047,9,0,1,4196,4206,C
2-PB1,2048,2,4155,0,7,4164,T
2-PB1,2049,2,4152,0,2,4156,T
2-PB1,2050,0,5,4158,1,4164,G
2-PB1,2051,4150,0,5,0,4155,A
2-PB1,2052,0,6,4155,1,4162,G
2-PB1,2053,0,3,4147,0,4150,G
2-PB1,2054,4141,0,2,0,4143,A
2-PB1,2055,2,4106,0,13,4121,T
2-PB1,2056,1,6,4133,0,4140,G
2-PB1,2057,4127,2,4,1,4134,A
2-PB1,2058,4129,0,11,0,4140,A
2-PB1,2059,2,2,0,4156,4160,C
2-PB1,2060,4108,0,3,1,4112,A
2-PB1,2061,0,2,4159,0,4161,G
2-PB1,2062,4123,0,19,0,4142,A
2-PB1,2063,0,4126,0,2,4128,T
2-PB1,2064,0,1,4130,0,4131,G
2-PB1,2065,0,4184,1,4,4189,T
2-PB1,2066,4196,1,4,1,4202,A
2-PB1,2067,1,3,1,4179,4184,C
2-PB1,2068,11,1,2,4152,4166,C
2-PB1,2069,4104,1,6,0,4111,A
2-PB1,2070,0,3,4059,0,4062,G
2-PB1,2071,4010,0,4,0,4014,A
2-PB1,2072,3992,0,5,0,3997,A
2-PB1,2073,1,2,4013,0,4016,G
2-PB1,2074,1,3795,0,6,3802,T
2-PB1,2075,1,2,3804,0,3807,G
2-PB1,2076,1,2,0,3799,3802,C
2-PB1,2077,1,3785,0,5,3791,T
2-PB1,2078,0,1,3778,0,3779,G
2-PB1,2079,1,0,0,3772,3773,C
2-PB1,2080,3781,0,2,0,3783,A
2-PB1,2081,3776,1,4,0,3781,A
2-PB1,2082,0,5,1,3724,3730,C
2-PB1,2083,0,3722,0,1,3723,T
2-PB1,2084,0,3688,0,1,3689,T
2-PB1,2085,1,0,3686,0,3687,G
2-PB1,2086,0,3677,0,1,3678,T
2-PB1,2087,2,3673,1,4,3680,T
2-PB1,2088,6,1,0,3664,3671,C
2-PB1,2089,1,8,3665,0,3674,G
2-PB1,2090,3669,0,5,0,3674,A
2-PB1,2091,1,4,3663,0,3668,G
2-PB1,2092,3660,0,5,1,3666,A
2-PB1,2093,3663,1,1,0,3665,A
2-PB1,2094,3666,0,0,0,3666,A
2-PB1,2095,0,3650,0,5,3655,T
2-PB1,2096,0,3662,1,2,3665,T
2-PB1,2097,0,3667,0,0,3667,T
2-PB1,2098,0,3664,0,4,3668,T
2-PB1,2099,0,3660,0,5,3665,T
2-PB1,2100,2,1,0,3685,3688,C
2-PB1,2101,2,2,0,3669,3673,C
2-PB1,2102,15,1,0,3683,3699,C
2-PB1,2103,1,3685,0,3,3689,T
2-PB1,2104,3690,0,0,0,3690,A
2-PB1,2105,0,1,3706,0,3707,G
2-PB1,2106,0,3705,0,1,3706,T
2-PB1,2107,3722,0,4,0,3726,A
2-PB1,2108,0,2,3738,0,3740,G
2-PB1,2109,1,3700,1,7,3709,T
2-PB1,2110,0,3813,1,5,3819,T
2-PB1,2111,16,0,0,3812,3828,C
2-PB1,2112,3856,0,6,0,3862,A
2-PB1,2113,0,3871,0,7,3878,T
2-PB1,2114,3868,0,2,0,3870,A
2-PB1,2115,1,3862,0,10,3873,T
2-PB1,2116,3738,1,3,0,3742,A
2-PB1,2117,1,4,3715,0,3720,G
2-PB1,2118,1,2,3693,0,3696,G
2-PB1,2119,3320,0,1,1,3322,A
2-PB1,2120,0,8,3306,0,3314,G
2-PB1,2121,3123,2,2,0,3127,A
2-PB1,2122,2,0,1,3117,3120,C
2-PB1,2123,4,2,0,3010,3016,C
2-PB1,2124,1,3,3012,0,3016,G
2-PB1,2125,3004,1,1,0,3006,A
2-PB1,2126,0,2989,0,0,2989,T
2-PB1,2127,1,2989,0,2,2992,T
2-PB1,2128,1,1,2991,1,2994,G
2-PB1,2129,3,3,2980,0,2986,G
2-PB1,2130,2992,0,0,0,2992,A
2-PB1,2131,2995,0,3,0,2998,A
2-PB1,2132,0,2981,0,5,2986,T
2-PB1,2133,0,2988,0,1,2989,T
2-PB1,2134,3,2972,0,2,2977,T
2-PB1,2135,1,2,0,2984,2987,C
2-PB1,2136,1,2983,0,3,2987,T
2-PB1,2137,2979,0,3,0,2982,A
2-PB1,2138,1,0,2984,0,2985,G
2-PB1,2139,1,0,1,2967,2969,C
2-PB1,2140,2959,0,0,1,2960,A
2-PB1,2141,0,2957,0,1,2958,T
2-PB1,2142,2,4,2908,1,2915,G
2-PB1,2143,0,0,2970,0,2970,G
2-PB1,2144,0,2956,0,2,2958,T
2-PB1,2145,2,2,2950,0,2954,G
2-PB1,2146,2,2,2947,0,2951,G
2-PB1,2147,2891,2,7,0,2900,A
2-PB1,2148,1,0,2910,0,2911,G
2-PB1,2149,1,0,2901,0,2902,G
2-PB1,2150,1,2,1,2883,2887,C
2-PB1,2151,1,2,0,2858,2861,C
2-PB1,2152,2678,0,2,0,2680,A
2-PB1,2153,0,2668,1,2,2671,T
2-PB1,2154,0,2,2684,0,2686,G
2-PB1,2155,2,0,2703,1,2706,G
2-PB1,2156,0,2644,0,6,2650,T
2-PB1,2157,0,0,2654,1,2655,G
2-PB1,2158,0,2596,0,4,2600,T
2-PB1,2159,2,1,1,2577,2581,C
2-PB1,2160,0,2571,0,3,2574,T
2-PB1,2161,2538,0,2,0,2540,A
2-PB1,2162,0,2,2530,0,2532,G
2-PB1,2163,1,0,2465,0,2466,G
2-PB1,2164,0,0,2429,0,2429,G
2-PB1,2165,1,1,0,2374,2376,C
2-PB1,2166,2,0,0,2244,2246,C
2-PB1,2167,5,0,0,2195,2200,C
2-PB1,2168,2,2,2188,1,2193,G
2-PB1,2169,0,0,2195,0,2195,G
2-PB1,2170,2199,0,1,0,2200,A
2-PB1,2171,0,2194,0,0,2194,T
2-PB1,2172,0,2129,0,1,2130,T
2-PB1,2173,0,0,2104,0,2104,G
2-PB1,2174,2094,1,5,0,2100,A
2-PB1,2175,0,2106,0,1,2107,T
2-PB1,2176,0,0,2104,0,2104,G
2-PB1,2177,2,0,0,2083,2085,C
2-PB1,2178,3,0,1,2074,2078,C
2-PB1,2179,2064,0,0,0,2064,A
2-PB1,2180,1,3,2064,0,2068,G
2-PB1,2181,2066,0,0,1,2067,A
2-PB1,2182,2065,0,1,0,2066,A
2-PB1,2183,1,2057,0,2,2060,T
2-PB1,2184,1,2011,0,0,2012,T
2-PB1,2185,1,5,2007,1,2014,G
2-PB1,2186,2006,0,0,0,2006,A
2-PB1,2187,1,0,0,2002,2003,C
2-PB1,2188,0,1980,0,5,1985,T
2-PB1,2189,0,1971,0,1,1972,T
2-PB1,2190,2,0,0,1970,1972,C
2-PB1,2191,1,2,1972,0,1975,G
2-PB1,2192,1961,0,6,1,1968,A
2-PB1,2193,6,0,1926,0,1932,G
2-PB1,2194,0,1943,0,4,1947,T
2-PB1,2195,1,0,0,1947,1948,C
2-PB1,2196,0,1952,0,3,1955,T
2-PB1,2197,0,3,1947,0,1950,G
2-PB1,2198,0,1,1953,0,1954,G
2-PB1,2199,1946,0,2,0,1948,A
2-PB1,2200,1818,0,3,0,1821,A
2-PB1,2201,0,1,1831,0,1832,G
2-PB1,2202,0,0,1849,0,1849,G
2-PB1,2203,1846,1,6,0,1853,A
2-PB1,2204,0,1833,0,0,1833,T
2-PB1,2205,0,1832,0,2,1834,T
2-PB1,2206,1821,0,1,0,1822,A
2-PB1,2207,1819,3,1,0,1823,A
2-PB1,2208,0,0,1834,0,1834,G
2-PB1,2209,1820,1,5,0,1826,A
2-PB1,2210,1737,0,8,0,1745,A
2-PB1,2211,0,3,1630,0,1633,G
2-PB1,2212,0,2,1623,0,1625,G
2-PB1,2213,1624,0,1,0,1625,A
2-PB1,2214,1612,0,9,0,1621,A
2-PB1,2215,0,1,1622,0,1623,G
2-PB1,2216,1551,0,3,0,1554,A
2-PB1,2217,1,1,1555,0,1557,G
2-PB1,2218,0,1482,0,1,1483,T
2-PB1,2219,1,1461,1,0,1463,T
2-PB1,2220,1,0,0,1472,1473,C
2-PB1,2221,0,1422,0,1,1423,T
2-PB1,2222,5,0,0,1420,1425,C
2-PB1,2223,0,1416,1,2,1419,T
2-PB1,2224,0,2,1422,0,1424,G
2-PB1,2225,1391,0,0,0,1391,A
2-PB1,2226,0,3,1368,0,1371,G
2-PB1,2227,1342,0,0,0,1342,A
2-PB1,2228,0,1311,0,1,1312,T
2-PB1,2229,2,0,0,1226,1228,C
2-PB1,2230,1228,0,2,0,1230,A
2-PB1,2231,0,1223,0,0,1223,T
2-PB1,2232,0,1,1212,0,1213,G
2-PB1,2233,1217,0,2,0,1219,A
2-PB1,2234,1208,0,3,0,1211,A
2-PB1,2235,7,1,1184,0,1192,G
2-PB1,2236,1159,1,8,0,1168,A
2-PB1,2237,0,1156,0,1,1157,T
2-PB1,2238,1,1,0,1144,1146,C
2-PB1,2239,0,1048,0,2,1050,T
2-PB1,2240,0,0,1053,0,1053,G
2-PB1,2241,0,1038,0,3,1041,T
2-PB1,2242,0,1037,0,2,1039,T
2-PB1,2243,1,0,0,1031,1032,C
2-PB1,2244,2,0,0,980,982,C
2-PB1,2245,982,0,1,0,983,A
2-PB1,2246,2,0,0,986,988,C
2-PB1,2247,2,0,0,943,945,C
2-PB1,2248,920,0,1,0,921,A
2-PB1,2249,0,848,0,0,848,T
2-PB1,2250,0,825,0,0,825,T
2-PB1,2251,0,0,821,0,821,G
2-PB1,2252,820,0,0,0,820,A
2-PB1,2253,817,1,0,1,819,A
2-PB1,2254,0,0,817,0,817,G
2-PB1,2255,703,0,0,0,703,A
2-PB1,2256,700,0,1,0,701,A
2-PB1,2257,0,1,0,691,692,C
2-PB1,2258,0,663,0,0,663,T
2-PB1,2259,1,0,0,663,664,C
2-PB1,2260,643,0,0,1,644,A
2-PB1,2261,0,0,644,0,644,G
2-PB1,2262,639,0,3,0,642,A
2-PB1,2263,0,0,0,625,625,C
2-PB1,2264,1,0,611,0,612,G
2-PB1,2265,0,0,595,0,595,G
2-PB1,2266,3,0,0,592,595,C
2-PB1,2267,588,0,4,0,592,A
2-PB1,2268,587,0,1,0,588,A
2-PB1,2269,586,0,0,0,586,A
2-PB1,2270,579,0,4,0,583,A
2-PB1,2271,580,0,0,0,580,A
2-PB1,2272,0,566,0,0,566,T
2-PB1,2273,550,0,0,0,550,A
2-PB1,2274,549,0,0,0,549,A
3-PA,1,87,0,0,0,87,A
3-PA,2,0,87,0,0,87,T
3-PA,3,0,0,96,0,96,G
3-PA,4,0,0,98,0,98,G
3-PA,5,98,0,0,0,98,A
3-PA,6,97,0,0,1,98,A
3-PA,7,0,0,101,0,101,G
3-PA,8,107,0,0,0,107,A
3-PA,9,2,106,0,0,108,T
3-PA,10,0,107,0,0,107,T
3-PA,11,0,113,0,0,113,T
3-PA,12,0,113,0,0,113,T
3-PA,13,0,0,115,0,115,G
3-PA,14,0,115,0,0,115,T
3-PA,15,0,0,115,0,115,G
3-PA,16,0,0,0,116,116,C
3-PA,17,0,0,116,0,116,G
3-PA,18,130,0,0,0,130,A
3-PA,19,0,0,0,130,130,C
3-PA,20,131,0,0,0,131,A
3-PA,21,132,0,0,0,132,A
3-PA,22,0,137,0,0,137,T
3-PA,23,0,0,150,0,150,G
3-PA,24,0,0,0,152,152,C
3-PA,25,0,151,0,1,152,T
3-PA,26,0,153,0,1,154,T
3-PA,27,0,0,0,154,154,C
3-PA,28,157,0,2,0,159,A
3-PA,29,167,0,1,0,168,A
3-PA,30,0,1,0,170,171,C
3-PA,31,0,0,0,171,171,C
3-PA,32,0,0,0,171,171,C
3-PA,33,0,0,174,0,174,G
3-PA,34,174,0,0,0,174,A
3-PA,35,0,175,0,0,175,T
3-PA,36,0,0,176,0,176,G
3-PA,37,176,0,0,0,176,A
3-PA,38,0,178,0,0,178,T
3-PA,39,0,180,0,0,180,T
3-PA,40,0,0,183,0,183,G
3-PA,41,0,182,0,1,183,T
3-PA,42,0,0,0,182,182,C
3-PA,43,0,0,184,0,184,G
3-PA,44,185,0,0,0,185,A
3-PA,45,185,0,0,0,185,A
3-PA,46,0,0,0,187,187,C
3-PA,47,0,186,0,1,187,T
3-PA,48,0,187,0,0,187,T
3-PA,49,0,0,188,0,188,G
3-PA,50,0,0,0,191,191,C
3-PA,51,191,0,0,0,191,A
3-PA,52,0,0,192,0,192,G
3-PA,53,192,0,0,0,192,A
3-PA,54,190,0,0,0,190,A
3-PA,55,192,0,0,0,192,A
3-PA,56,193,0,0,0,193,A
3-PA,57,195,0,0,0,195,A
3-PA,58,0,0,196,0,196,G
3-PA,59,0,0,0,202,202,C
3-PA,60,204,0,0,0,204,A
3-PA,61,216,0,0,0,216,A
3-PA,62,0,217,0,0,217,T
3-PA,63,0,0,221,0,221,G
3-PA,64,225,0,0,0,225,A
3-PA,65,225,0,0,0,225,A
3-PA,66,229,1,0,0,230,A
3-PA,67,0,0,243,0,243,G
3-PA,68,250,0,1,0,251,A
3-PA,69,0,1,305,0,306,G
3-PA,70,0,306,0,0,306,T
3-PA,71,308,0,0,0,308,A
3-PA,72,2,308,0,0,310,T
3-PA,73,0,2,309,0,311,G
3-PA,74,0,1,310,0,311,G
3-PA,75,0,2,309,0,311,G
3-PA,76,0,1,313,0,314,G
3-PA,77,310,0,1,0,311,A
3-PA,78,0,0,306,0,306,G
3-PA,79,1,0,315,0,316,G
3-PA,80,315,0,1,0,316,A
3-PA,81,0,318,0,0,318,T
3-PA,82,0,0,0,321,321,C
3-PA,83,0,319,0,1,320,T
3-PA,84,0,0,320,0,320,G
3-PA,85,319,0,1,0,320,A
3-PA,86,319,0,1,0,320,A
3-PA,87,322,2,0,0,324,A
3-PA,88,323,0,0,0,323,A
3-PA,89,0,323,0,0,323,T
3-PA,90,0,322,0,1,323,T
3-PA,91,0,3,320,0,323,G
3-PA,92,320,1,0,1,322,A
3-PA,93,323,0,0,0,323,A
3-PA,94,321,0,1,0,322,A
3-PA,95,0,0,0,323,323,C
3-PA,96,326,0,0,0,326,A
3-PA,97,325,1,0,0,326,A
3-PA,98,324,0,1,0,325,A
3-PA,99,0,0,0,327,327,C
3-PA,100,327,0,0,0,327,A
3-PA,101,330,0,0,0,330,A
3-PA,102,333,0,1,0,334,A
3-PA,103,0,333,0,0,333,T
3-PA,104,0,333,0,0,333,T
3-PA,105,0,334,0,0,334,T
3-PA,106,0,0,335,0,335,G
3-PA,107,0,0,0,336,336,C
3-PA,108,336,0,0,0,336,A
3-PA,109,0,0,354,0,354,G
3-PA,110,0,0,0,356,356,C
3-PA,111,370,0,0,0,370,A
3-PA,112,377,0,0,0,377,A
3-PA,113,0,379,0,0,379,T
3-PA,114,387,0,0,0,387,A
3-PA,115,0,391,0,0,391,T
3-PA,116,0,0,400,0,400,G
3-PA,117,1,0,0,400,401,C
3-PA,118,399,0,0,0,399,A
3-PA,119,0,1,0,402,403,C
3-PA,120,0,400,0,0,400,T
3-PA,121,1,0,0,472,473,C
3-PA,122,482,0,1,0,483,A
3-PA,123,0,0,0,497,497,C
3-PA,124,0,494,0,1,495,T
3-PA,125,0,494,0,0,494,T
3-PA,126,0,0,494,0,494,G
3-PA,127,0,0,504,0,504,G
3-PA,128,498,0,1,0,499,A
3-PA,129,0,0,506,0,506,G
3-PA,130,1,1,503,0,505,G
3-PA,131,0,492,0,1,493,T
3-PA,132,1,0,513,0,514,G
3-PA,133,0,515,0,2,517,T
3-PA,134,0,0,524,0,524,G
3-PA,135,0,523,0,1,524,T
3-PA,136,0,523,0,0,523,T
3-PA,137,0,522,0,0,522,T
3-PA,138,0,0,0,531,531,C
3-PA,139,533,0,0,0,533,A
3-PA,140,0,531,0,0,531,T
3-PA,141,0,0,544,0,544,G
3-PA,142,0,542,0,0,542,T
3-PA,143,544,1,0,0,545,A
3-PA,144,0,544,0,0,544,T
3-PA,145,0,546,0,0,546,T
3-PA,146,0,0,0,549,549,C
3-PA,147,549,0,0,0,549,A
3-PA,148,0,0,554,0,554,G
3-PA,149,556,0,1,0,557,A
3-PA,150,0,554,0,0,554,T
3-PA,151,0,554,0,0,554,T
3-PA,152,0,555,0,0,555,T
3-PA,153,1,1,0,549,551,C
3-PA,154,0,0,0,563,563,C
3-PA,155,564,0,0,0,564,A
3-PA,156,0,566,0,0,566,T
3-PA,157,0,563,0,2,565,T
3-PA,158,0,564,0,1,565,T
3-PA,159,1,0,0,568,569,C
3-PA,160,572,0,1,0,573,A
3-PA,161,0,590,0,0,590,T
3-PA,162,1,0,0,588,589,C
3-PA,163,587,0,1,0,588,A
3-PA,164,587,0,2,0,589,A
3-PA,165,0,589,0,1,590,T
3-PA,166,0,3,610,0,613,G
3-PA,167,611,0,1,0,612,A
3-PA,168,612,0,0,0,612,A
3-PA,169,0,1,0,611,612,C
3-PA,170,604,0,1,0,605,A
3-PA,171,614,0,0,0,614,A
3-PA,172,0,1,616,1,618,G
3-PA,173,0,0,618,0,618,G
3-PA,174,0,0,0,619,619,C
3-PA,175,0,3,612,0,615,G
3-PA,176,633,1,0,0,634,A
3-PA,177,633,0,2,0,635,A
3-PA,178,0,637,0,1,638,T
3-PA,179,2,0,0,638,640,C
3-PA,180,635,1,0,0,636,A
3-PA,181,637,0,0,0,637,A
3-PA,182,0,636,0,0,636,T
3-PA,183,0,2,627,0,629,G
3-PA,184,0,0,645,0,645,G
3-PA,185,0,653,0,0,653,T
3-PA,186,0,1,658,0,659,G
3-PA,187,0,0,657,0,657,G
3-PA,188,0,656,0,1,657,T
3-PA,189,658,0,1,0,659,A
3-PA,190,0,1,666,0,667,G
3-PA,191,670,0,0,0,670,A
3-PA,192,670,1,1,0,672,A
3-PA,193,1,0,0,666,667,C
3-PA,194,0,660,0,1,661,T
3-PA,195,1,656,0,1,658,T
3-PA,196,0,1,659,0,660,G
3-PA,197,656,1,4,0,661,A
3-PA,198,0,0,0,659,659,C
3-PA,199,0,1,656,0,657,G
3-PA,200,677,0,1,0,678,A
3-PA,201,0,688,0,0,688,T
3-PA,202,1,0,0,696,697,C
3-PA,203,1,0,0,699,700,C
3-PA,204,702,0,0,0,702,A
3-PA,205,702,0,0,0,702,A
3-PA,206,702,0,2,0,704,A
3-PA,207,0,700,0,2,702,T
3-PA,208,0,0,706,0,706,G
3-PA,209,0,0,0,701,701,C
3-PA,210,697,0,1,0,698,A
3-PA,211,0,0,0,723,723,C
3-PA,212,1,718,1,0,720,T
3-PA,213,0,0,829,0,829,G
3-PA,214,0,827,0,0,827,T
3-PA,215,0,828,0,1,829,T
3-PA,216,829,0,0,0,829,A
3-PA,217,824,0,2,0,826,A
3-PA,218,822,0,1,0,823,A
3-PA,219,0,0,830,0,830,G
3-PA,220,0,1,0,822,823,C
3-PA,221,808,0,4,0,812,A
3-PA,222,0,0,0,810,810,C
3-PA,223,757,2,0,1,760,A
3-PA,224,0,0,792,0,792,G
3-PA,225,792,0,0,0,792,A
3-PA,226,0,790,0,0,790,T
3-PA,227,0,792,0,0,792,T
3-PA,228,0,789,0,0,789,T
3-PA,229,0,1,786,0,787,G
3-PA,230,791,0,0,1,792,A
3-PA,231,789,0,2,1,792,A
3-PA,232,788,0,3,0,791,A
3-PA,233,0,776,0,0,776,T
3-PA,234,774,0,0,0,774,A
3-PA,235,781,0,1,0,782,A
3-PA,236,1,780,0,0,781,T
3-PA,237,1,0,0,780,781,C
3-PA,238,1,0,782,0,783,G
3-PA,239,775,0,0,0,775,A
3-PA,240,1,1,781,0,783,G
3-PA,241,0,4,789,0,793,G
3-PA,242,0,0,792,0,792,G
3-PA,243,0,1,795,0,796,G
3-PA,244,779,0,0,0,779,A
3-PA,245,0,2,783,0,785,G
3-PA,246,796,1,2,1,800,A
3-PA,247,0,0,807,0,807,G
3-PA,248,806,0,0,0,806,A
3-PA,249,1,0,0,804,805,C
3-PA,250,790,0,1,0,791,A
3-PA,251,0,0,803,0,803,G
3-PA,252,801,0,2,0,803,A
3-PA,253,814,0,0,0,814,A
3-PA,254,0,0,0,814,814,C
3-PA,255,790,0,0,0,790,A
3-PA,256,791,0,0,1,792,A
3-PA,257,0,788,0,1,789,T
3-PA,258,1,0,810,0,811,G
3-PA,259,0,0,815,0,815,G
3-PA,260,0,0,0,807,807,C
3-PA,261,0,0,0,811,811,C
3-PA,262,0,806,0,0,806,T
3-PA,263,0,0,830,0,830,G
3-PA,264,0,3,824,0,827,G
3-PA,265,827,0,2,0,829,A
3-PA,266,0,0,0,832,832,C
3-PA,267,800,0,0,0,800,A
3-PA,268,0,1,923,0,924,G
3-PA,269,0,921,0,1,922,T
3-PA,270,939,0,0,0,939,A
3-PA,271,0,0,942,0,942,G
3-PA,272,0,934,0,0,934,T
3-PA,273,940,0,0,0,940,A
3-PA,274,939,0,1,0,940,A
3-PA,275,942,0,0,0,942,A
3-PA,276,0,2,0,961,963,C
3-PA,277,908,0,1,0,909,A
3-PA,278,1,0,936,0,937,G
3-PA,279,0,928,0,0,928,T
3-PA,280,941,0,1,0,942,A
3-PA,281,0,939,1,1,941,T
3-PA,282,0,0,0,957,957,C
3-PA,283,0,952,0,1,953,T
3-PA,284,0,0,955,0,955,G
3-PA,285,0,0,0,954,954,C
3-PA,286,953,0,0,0,953,A
3-PA,287,956,0,0,0,956,A
3-PA,288,0,0,0,963,963,C
3-PA,289,959,0,0,0,959,A
3-PA,290,0,0,0,986,986,C
3-PA,291,0,972,0,2,974,T
3-PA,292,981,0,0,0,981,A
3-PA,293,2,0,0,976,978,C
3-PA,294,0,974,0,1,975,T
3-PA,295,0,3,973,0,976,G
3-PA,296,0,0,976,1,977,G
3-PA,297,970,0,1,0,971,A
3-PA,298,0,0,975,0,975,G
3-PA,299,0,0,0,948,948,C
3-PA,300,0,951,0,1,952,T
3-PA,301,1,0,950,1,952,G
3-PA,302,0,0,954,0,954,G
3-PA,303,951,0,0,0,951,A
3-PA,304,951,0,0,0,951,A
3-PA,305,952,0,0,0,952,A
3-PA,306,952,0,1,0,953,A
3-PA,307,0,2,0,952,954,C
3-PA,308,1,0,0,953,954,C
3-PA,309,0,1,953,0,954,G
3-PA,310,955,0,0,0,955,A
3-PA,311,951,0,1,1,953,A
3-PA,312,1,0,964,0,965,G
3-PA,313,0,959,0,0,959,T
3-PA,314,0,960,0,1,961,T
3-PA,315,0,965,0,0,965,T
3-PA,316,0,3,0,969,972,C
3-PA,317,0,973,0,2,975,T
3-PA,318,977,0,1,0,978,A
3-PA,319,1,0,0,973,974,C
3-PA,320,1,1,0,972,974,C
3-PA,321,963,0,4,0,967,A
3-PA,322,0,0,964,0,964,G
3-PA,323,967,0,0,0,967,A
3-PA,324,0,0,0,942,942,C
3-PA,325,0,974,0,0,974,T
3-PA,326,0,972,0,2,974,T
3-PA,327,0,0,986,0,986,G
3-PA,328,0,987,0,0,987,T
3-PA,329,988,0,1,0,989,A
3-PA,330,0,984,0,2,986,T
3-PA,331,0,1,981,0,982,G
3-PA,332,1022,0,0,0,1022,A
3-PA,333,0,1009,0,0,1009,T
3-PA,334,0,1016,0,0,1016,T
3-PA,335,1016,2,0,0,1018,A
3-PA,336,0,0,0,1015,1015,C
3-PA,337,1018,0,1,0,1019,A
3-PA,338,1018,0,0,0,1018,A
3-PA,339,0,4,1020,0,1024,G
3-PA,340,0,2,1029,0,1031,G
3-PA,341,985,0,0,0,985,A
3-PA,342,0,2,992,0,994,G
3-PA,343,989,1,1,0,991,A
3-PA,344,992,0,1,0,993,A
3-PA,345,1,1,0,992,994,C
3-PA,346,977,0,0,0,977,A
3-PA,347,1,1,982,0,984,G
3-PA,348,974,0,1,0,975,A
3-PA,349,0,962,0,0,962,T
3-PA,350,1,961,0,1,963,T
3-PA,351,1,0,0,955,956,C
3-PA,352,952,0,3,0,955,A
3-PA,353,0,955,0,0,955,T
3-PA,354,1,0,0,957,958,C
3-PA,355,1,2,955,0,958,G
3-PA,356,957,0,0,0,957,A
3-PA,357,955,1,0,0,956,A
3-PA,358,959,0,0,1,960,A
3-PA,359,0,957,0,0,957,T
3-PA,360,0,954,1,0,955,T
3-PA,361,1,0,955,0,956,G
3-PA,362,0,2,957,0,959,G
3-PA,363,0,2,957,0,959,G
3-PA,364,1,1,962,0,964,G
3-PA,365,0,943,0,1,944,T
3-PA,366,1,0,958,0,959,G
3-PA,367,963,0,1,0,964,A
3-PA,368,0,1,1,965,967,C
3-PA,369,969,0,1,0,970,A
3-PA,370,968,0,1,0,969,A
3-PA,371,0,1,985,0,986,G
3-PA,372,0,1,985,0,986,G
3-PA,373,978,1,1,0,980,A
3-PA,374,1,1,980,0,982,G
3-PA,375,969,0,1,0,970,A
3-PA,376,0,0,972,0,972,G
3-PA,377,960,0,1,0,961,A
3-PA,378,953,0,1,0,954,A
3-PA,379,0,0,987,0,987,G
3-PA,380,0,965,0,1,966,T
3-PA,381,1,0,0,971,972,C
3-PA,382,1,0,0,976,977,C
3-PA,383,980,1,2,0,983,A
3-PA,384,0,0,0,1008,1008,C
3-PA,385,1025,0,0,1,1026,A
3-PA,386,0,1055,0,0,1055,T
3-PA,387,1061,0,1,0,1062,A
3-PA,388,1,1028,0,0,1029,T
3-PA,389,1021,0,1,0,1022,A
3-PA,390,0,1010,0,0,1010,T
3-PA,391,0,1006,0,1,1007,T
3-PA,392,1002,0,0,0,1002,A
3-PA,393,0,0,0,1000,1000,C
3-PA,394,4,0,0,943,947,C
3-PA,395,0,931,0,1,932,T
3-PA,396,0,913,0,0,913,T
3-PA,397,0,1,915,0,916,G
3-PA,398,917,0,0,0,917,A
3-PA,399,917,0,0,0,917,A
3-PA,400,918,0,0,0,918,A
3-PA,401,875,0,1,0,876,A
3-PA,402,0,1,884,0,885,G
3-PA,403,1,0,882,0,883,G
3-PA,404,0,1,0,884,885,C
3-PA,405,3,0,0,890,893,C
3-PA,406,887,0,2,0,889,A
3-PA,407,890,0,0,0,890,A
3-PA,408,0,890,0,0,890,T
3-PA,409,890,0,1,0,891,A
3-PA,410,888,0,2,0,890,A
3-PA,411,0,0,899,0,899,G
3-PA,412,885,2,0,0,887,A
3-PA,413,0,887,0,0,887,T
3-PA,414,0,888,0,0,888,T
3-PA,415,891,0,0,0,891,A
3-PA,416,891,0,2,0,893,A
3-PA,417,890,0,0,0,890,A
3-PA,418,0,897,0,0,897,T
3-PA,419,0,0,1,896,897,C
3-PA,420,0,874,0,0,874,T
3-PA,421,0,3,884,0,887,G
3-PA,422,884,0,1,0,885,A
3-PA,423,1,0,892,0,893,G
3-PA,424,890,0,2,0,892,A
3-PA,425,888,0,2,0,890,A
3-PA,426,0,0,0,896,896,C
3-PA,427,891,0,1,0,892,A
3-PA,428,0,0,0,897,897,C
3-PA,429,895,1,2,0,898,A
3-PA,430,1,0,0,904,905,C
3-PA,431,892,0,2,0,894,A
3-PA,432,0,0,0,916,916,C
3-PA,433,915,0,0,0,915,A
3-PA,434,0,917,0,0,917,T
3-PA,435,0,912,0,1,913,T
3-PA,436,2,1,0,915,918,C
3-PA,437,910,1,0,0,911,A
3-PA,438,1,0,0,918,919,C
3-PA,439,910,0,0,0,910,A
3-PA,440,0,913,0,1,914,T
3-PA,441,0,875,0,0,875,T
3-PA,442,0,884,0,1,885,T
3-PA,443,1,884,0,2,887,T
3-PA,444,1,0,0,895,896,C
3-PA,445,0,885,0,1,886,T
3-PA,446,3,0,0,891,894,C
3-PA,447,888,0,0,0,888,A
3-PA,448,0,887,0,2,889,T
3-PA,449,0,896,0,0,896,T
3-PA,450,5,0,0,897,902,C
3-PA,451,893,0,0,0,893,A
3-PA,452,0,0,0,903,903,C
3-PA,453,0,893,0,1,894,T
3-PA,454,0,0,913,0,913,G
3-PA,455,0,2,905,0,907,G
3-PA,456,2,0,910,0,912,G
3-PA,457,0,0,916,0,916,G
3-PA,458,908,0,3,0,911,A
3-PA,459,1,1,915,0,917,G
3-PA,460,0,0,917,0,917,G
3-PA,461,912,0,2,0,914,A
3-PA,462,913,0,0,0,913,A
3-PA,463,903,0,0,0,903,A
3-PA,464,0,897,0,0,897,T
3-PA,465,0,1,896,0,897,G
3-PA,466,0,1,890,0,891,G
3-PA,467,0,0,0,892,892,C
3-PA,468,2,1,0,892,895,C
3-PA,469,892,0,0,0,892,A
3-PA,470,0,0,0,893,893,C
3-PA,471,892,1,0,0,893,A
3-PA,472,893,0,0,0,893,A
3-PA,473,897,0,0,0,897,A
3-PA,474,0,1,900,0,901,G
3-PA,475,1,0,894,0,895,G
3-PA,476,2,1,0,900,903,C
3-PA,477,903,0,2,1,906,A
3-PA,478,0,2,919,0,921,G
3-PA,479,913,0,1,0,914,A
3-PA,480,0,0,0,932,932,C
3-PA,481,0,928,1,0,929,T
3-PA,482,929,0,4,0,933,A
3-PA,483,0,1,0,929,930,C
3-PA,484,923,1,1,0,925,A
3-PA,485,1,0,0,929,930,C
3-PA,486,0,910,0,1,911,T
3-PA,487,0,0,0,917,917,C
3-PA,488,1,911,0,1,913,T
3-PA,489,2,1,0,895,898,C
3-PA,490,0,1,899,0,900,G
3-PA,491,896,1,0,0,897,A
3-PA,492,0,0,0,894,894,C
3-PA,493,0,0,903,0,903,G
3-PA,494,898,0,0,0,898,A
3-PA,495,1,0,899,0,900,G
3-PA,496,0,0,897,0,897,G
3-PA,497,896,0,0,0,896,A
3-PA,498,899,0,3,0,902,A
3-PA,499,902,0,0,0,902,A
3-PA,500,0,0,905,0,905,G
3-PA,501,0,0,0,907,907,C
3-PA,502,893,0,0,0,893,A
3-PA,503,0,2,909,0,911,G
3-PA,504,0,1,924,0,925,G
3-PA,505,0,0,921,0,921,G
3-PA,506,1,0,0,924,925,C
3-PA,507,0,915,0,0,915,T
3-PA,508,918,0,0,0,918,A
3-PA,509,0,1,931,0,932,G
3-PA,510,0,1,975,0,976,G
3-PA,511,981,0,1,0,982,A
3-PA,512,0,958,0,1,959,T
3-PA,513,0,941,0,0,941,T
3-PA,514,941,0,0,0,941,A
3-PA,515,944,1,1,0,946,A
3-PA,516,0,1,949,0,950,G
3-PA,517,948,1,0,0,949,A
3-PA,518,0,0,0,949,949,C
3-PA,519,1,0,0,872,873,C
3-PA,520,865,0,0,0,865,A
3-PA,521,0,0,873,0,873,G
3-PA,522,0,0,879,0,879,G
3-PA,523,0,0,0,883,883,C
3-PA,524,0,875,0,1,876,T
3-PA,525,0,0,901,0,901,G
3-PA,526,0,892,1,1,894,T
3-PA,527,0,893,0,1,894,T
3-PA,528,0,895,0,1,896,T
3-PA,529,886,0,0,0,886,A
3-PA,530,0,0,0,913,913,C
3-PA,531,3,0,0,892,895,C
3-PA,532,888,0,1,0,889,A
3-PA,533,0,891,0,0,891,T
3-PA,534,854,0,0,0,854,A
3-PA,535,854,0,0,0,854,A
3-PA,536,1,0,866,0,867,G
3-PA,537,863,1,2,0,866,A
3-PA,538,0,0,0,865,865,C
3-PA,539,845,0,0,0,845,A
3-PA,540,843,0,1,0,844,A
3-PA,541,0,1,854,0,855,G
3-PA,542,849,0,1,0,850,A
3-PA,543,852,0,0,0,852,A
3-PA,544,845,0,1,0,846,A
3-PA,545,0,839,0,0,839,T
3-PA,546,0,1,854,0,855,G
3-PA,547,0,0,851,0,851,G
3-PA,548,1,0,0,852,853,C
3-PA,549,1,2,0,844,847,C
3-PA,550,838,0,1,0,839,A
3-PA,551,852,0,0,0,852,A
3-PA,552,0,1,0,849,850,C
3-PA,553,844,0,1,0,845,A
3-PA,554,0,0,847,0,847,G
3-PA,555,819,0,3,0,822,A
3-PA,556,1,2,835,1,839,G
3-PA,557,1,0,836,0,837,G
3-PA,558,0,1,0,836,837,C
3-PA,559,2,0,1,841,844,C
3-PA,560,0,826,0,0,826,T
3-PA,561,0,0,0,835,835,C
3-PA,562,0,835,0,1,836,T
3-PA,563,0,1,839,0,840,G
3-PA,564,0,0,830,0,830,G
3-PA,565,1,1,832,0,834,G
3-PA,566,833,0,0,1,834,A
3-PA,567,0,808,0,0,808,T
3-PA,568,0,796,0,0,796,T
3-PA,569,1,1,0,818,820,C
3-PA,570,3,0,0,802,805,C
3-PA,571,0,777,0,2,779,T
3-PA,572,1,779,0,1,781,T
3-PA,573,0,777,0,1,778,T
3-PA,574,2,1,0,779,782,C
3-PA,575,3,0,778,0,781,G
3-PA,576,0,777,0,3,780,T
3-PA,577,1,0,0,780,781,C
3-PA,578,769,0,1,0,770,A
3-PA,579,0,2,806,0,808,G
3-PA,580,0,806,0,0,806,T
3-PA,581,0,1,0,802,803,C
3-PA,582,1,0,0,806,807,C
3-PA,583,0,2,811,0,813,G
3-PA,584,813,0,0,0,813,A
3-PA,585,813,0,0,0,813,A
3-PA,586,811,0,1,0,812,A
3-PA,587,0,0,816,0,816,G
3-PA,588,783,0,5,0,788,A
3-PA,589,0,3,784,0,787,G
3-PA,590,1,0,784,0,785,G
3-PA,591,0,0,0,782,782,C
3-PA,592,0,1,782,0,783,G
3-PA,593,781,0,1,0,782,A
3-PA,594,780,0,1,0,781,A
3-PA,595,1,1,785,0,787,G
3-PA,596,785,0,0,0,785,A
3-PA,597,786,0,0,0,786,A
3-PA,598,780,0,0,0,780,A
3-PA,599,0,1,0,780,781,C
3-PA,600,778,0,1,0,779,A
3-PA,601,778,0,0,0,778,A
3-PA,602,0,778,0,0,778,T
3-PA,603,0,778,0,1,779,T
3-PA,604,0,0,782,0,782,G
3-PA,605,772,0,7,0,779,A
3-PA,606,778,0,1,0,779,A
3-PA,607,0,0,779,0,779,G
3-PA,608,770,0,0,0,770,A
3-PA,609,773,0,0,0,773,A
3-PA,610,770,0,0,0,770,A
3-PA,611,771,0,0,0,771,A
3-PA,612,773,0,1,0,774,A
3-PA,613,0,763,0,2,765,T
3-PA,614,0,769,0,1,770,T
3-PA,615,0,769,0,0,769,T
3-PA,616,0,3,766,0,769,G
3-PA,617,764,1,0,0,765,A
3-PA,618,767,0,0,0,767,A
3-PA,619,767,0,1,0,768,A
3-PA,620,0,775,0,0,775,T
3-PA,621,1,0,0,816,817,C
3-PA,622,812,1,0,0,813,A
3-PA,623,0,0,0,826,826,C
3-PA,624,816,0,3,0,819,A
3-PA,625,0,0,834,0,834,G
3-PA,626,0,2,850,0,852,G
3-PA,627,862,0,0,0,862,A
3-PA,628,876,0,0,0,876,A
3-PA,629,0,2,0,879,881,C
3-PA,630,0,830,0,4,834,T
3-PA,631,868,0,0,0,868,A
3-PA,632,0,873,0,1,874,T
3-PA,633,0,0,898,0,898,G
3-PA,634,0,1,0,888,889,C
3-PA,635,0,0,871,0,871,G
3-PA,636,0,861,0,1,862,T
3-PA,637,856,0,2,0,858,A
3-PA,638,0,0,851,1,852,G
3-PA,639,0,0,851,0,851,G
3-PA,640,0,0,2,839,841,C
3-PA,641,0,826,0,3,829,T
3-PA,642,0,820,0,0,820,T
3-PA,643,0,1,821,0,822,G
3-PA,644,1,0,0,819,820,C
3-PA,645,0,0,0,821,821,C
3-PA,646,0,0,832,0,832,G
3-PA,647,827,0,0,0,827,A
3-PA,648,0,0,0,825,825,C
3-PA,649,1,0,0,826,827,C
3-PA,650,827,0,0,0,827,A
3-PA,651,828,1,1,0,830,A
3-PA,652,827,0,4,1,832,A
3-PA,653,0,1,842,0,843,G
3-PA,654,0,836,0,4,840,T
3-PA,655,0,0,0,834,834,C
3-PA,656,0,822,0,2,824,T
3-PA,657,4,0,0,827,831,C
3-PA,658,0,0,0,832,832,C
3-PA,659,1,0,0,832,833,C
3-PA,660,830,0,0,0,830,A
3-PA,661,1,0,0,824,825,C
3-PA,662,0,2,0,815,817,C
3-PA,663,0,1,820,0,821,G
3-PA,664,831,0,0,0,831,A
3-PA,665,829,0,0,0,829,A
3-PA,666,0,3,0,832,835,C
3-PA,667,0,818,1,5,824,T
3-PA,668,0,829,0,1,830,T
3-PA,669,0,0,0,844,844,C
3-PA,670,0,837,0,1,838,T
3-PA,671,1,1,0,842,844,C
3-PA,672,0,0,0,840,840,C
3-PA,673,4,833,0,2,839,T
3-PA,674,1,0,843,0,844,G
3-PA,675,0,0,0,841,841,C
3-PA,676,1,1,0,841,843,C
3-PA,677,0,832,0,3,835,T
3-PA,678,0,825,0,0,825,T
3-PA,679,0,2,827,0,829,G
3-PA,680,827,0,1,0,828,A
3-PA,681,0,1,837,0,838,G
3-PA,682,837,0,1,0,838,A
3-PA,683,838,0,0,0,838,A
3-PA,684,0,839,0,0,839,T
3-PA,685,0,840,0,0,840,T
3-PA,686,0,841,0,1,842,T
3-PA,687,0,843,0,0,843,T
3-PA,688,839,1,0,0,840,A
3-PA,689,0,1,836,0,837,G
3-PA,690,826,0,1,0,827,A
3-PA,691,0,0,851,0,851,G
3-PA,692,0,0,0,851,851,C
3-PA,693,0,0,0,856,856,C
3-PA,694,0,860,0,0,860,T
3-PA,695,877,1,0,0,878,A
3-PA,696,0,882,0,0,882,T
3-PA,697,0,0,884,0,884,G
3-PA,698,0,879,0,1,880,T
3-PA,699,0,2,876,0,878,G
3-PA,700,0,1,856,0,857,G
3-PA,701,853,0,0,0,853,A
3-PA,702,0,843,0,0,843,T
3-PA,703,0,2,823,0,825,G
3-PA,704,0,1,829,0,830,G
3-PA,705,831,0,0,0,831,A
3-PA,706,0,819,0,0,819,T
3-PA,707,0,821,0,0,821,T
3-PA,708,0,2,0,813,815,C
3-PA,709,1,2,813,0,816,G
3-PA,710,815,0,2,0,817,A
3-PA,711,819,0,0,0,819,A
3-PA,712,1,0,0,816,817,C
3-PA,713,2,0,0,793,795,C
3-PA,714,0,0,796,0,796,G
3-PA,715,795,0,0,0,795,A
3-PA,716,790,0,1,0,791,A
3-PA,717,0,0,0,799,799,C
3-PA,718,1,1,790,0,792,G
3-PA,719,0,0,796,0,796,G
3-PA,720,1,0,0,798,799,C
3-PA,721,0,795,0,1,796,T
3-PA,722,1,2,808,0,811,G
3-PA,723,0,0,0,812,812,C
3-PA,724,814,0,1,0,815,A
3-PA,725,1,811,0,2,814,T
3-PA,726,0,806,0,0,806,T
3-PA,727,0,1,806,0,807,G
3-PA,728,770,0,1,0,771,A
3-PA,729,0,1,778,1,780,G
3-PA,730,0,0,777,0,777,G
3-PA,731,1,0,758,0,759,G
3-PA,732,0,0,0,757,757,C
3-PA,733,745,1,0,0,746,A
3-PA,734,741,1,3,0,745,A
3-PA,735,0,0,753,0,753,G
3-PA,736,0,0,0,755,755,C
3-PA,737,0,751,0,2,753,T
3-PA,738,0,753,0,0,753,T
3-PA,739,0,755,0,0,755,T
3-PA,740,0,0,0,758,758,C
3-PA,741,0,758,0,1,759,T
3-PA,742,2,0,0,762,764,C
3-PA,743,763,0,0,0,763,A
3-PA,744,754,0,2,0,756,A
3-PA,745,755,0,0,0,755,A
3-PA,746,0,752,0,0,752,T
3-PA,747,2,0,759,0,761,G
3-PA,748,1,757,0,0,758,T
3-PA,749,0,0,0,764,764,C
3-PA,750,0,0,0,766,766,C
3-PA,751,767,0,0,0,767,A
3-PA,752,765,0,1,0,766,A
3-PA,753,766,0,1,1,768,A
3-PA,754,0,2,779,0,781,G
3-PA,755,776,0,0,0,776,A
3-PA,756,739,0,1,0,740,A
3-PA,757,0,0,748,0,748,G
3-PA,758,0,737,0,0,737,T
3-PA,759,0,1,737,0,738,G
3-PA,760,736,0,0,0,736,A
3-PA,761,735,0,0,0,735,A
3-PA,762,0,731,1,2,734,T
3-PA,763,1,0,725,0,726,G
3-PA,764,0,0,0,726,726,C
3-PA,765,1,1,0,723,725,C
3-PA,766,1,1,0,723,725,C
3-PA,767,728,0,0,0,728,A
3-PA,768,734,0,0,0,734,A
3-PA,769,734,0,0,1,735,A
3-PA,770,0,736,0,0,736,T
3-PA,771,0,733,0,0,733,T
3-PA,772,0,1,732,0,733,G
3-PA,773,725,1,0,0,726,A
3-PA,774,726,0,1,0,727,A
3-PA,775,0,0,0,729,729,C
3-PA,776,0,0,0,726,726,C
3-PA,777,0,712,0,5,717,T
3-PA,778,0,717,0,0,717,T
3-PA,779,1,725,0,0,726,T
3-PA,780,0,730,0,0,730,T
3-PA,781,2,1,0,733,736,C
3-PA,782,0,736,0,0,736,T
3-PA,783,0,0,738,0,738,G
3-PA,784,732,0,1,0,733,A
3-PA,785,735,0,2,0,737,A
3-PA,786,1,1,738,0,740,G
3-PA,787,732,0,0,0,732,A
3-PA,788,1,0,0,735,736,C
3-PA,789,718,0,2,0,720,A
3-PA,790,726,1,1,0,728,A
3-PA,791,0,1,0,785,786,C
3-PA,792,783,0,1,0,784,A
3-PA,793,0,1,0,779,780,C
3-PA,794,1,0,0,768,769,C
3-PA,795,766,1,0,0,767,A
3-PA,796,763,0,1,0,764,A
3-PA,797,1,1,765,0,767,G
3-PA,798,760,0,4,0,764,A
3-PA,799,0,0,1,761,762,C
3-PA,800,1,0,0,684,685,C
3-PA,801,678,0,0,0,678,A
3-PA,802,680,0,0,0,680,A
3-PA,803,0,680,0,1,681,T
3-PA,804,2,0,0,678,680,C
3-PA,805,675,0,1,0,676,A
3-PA,806,672,0,0,0,672,A
3-PA,807,673,0,0,0,673,A
3-PA,808,0,0,0,683,683,C
3-PA,809,0,670,1,1,672,T
3-PA,810,0,669,0,0,669,T
3-PA,811,3,0,0,675,678,C
3-PA,812,0,1,0,673,674,C
3-PA,813,0,4,671,0,675,G
3-PA,814,675,1,0,0,676,A
3-PA,815,660,0,17,0,677,A
3-PA,816,0,677,0,0,677,T
3-PA,817,1,1,665,0,667,G
3-PA,818,0,1,668,0,669,G
3-PA,819,666,0,3,0,669,A
3-PA,820,0,0,0,667,667,C
3-PA,821,0,0,0,664,664,C
3-PA,822,0,678,0,0,678,T
3-PA,823,0,0,0,696,696,C
3-PA,824,1,0,0,700,701,C
3-PA,825,0,697,0,0,697,T
3-PA,826,0,699,0,0,699,T
3-PA,827,0,1,729,0,730,G
3-PA,828,0,716,0,1,717,T
3-PA,829,0,710,1,0,711,T
3-PA,830,710,0,1,0,711,A
3-PA,831,0,657,0,1,658,T
3-PA,832,0,0,0,651,651,C
3-PA,833,620,0,2,0,622,A
3-PA,834,0,0,622,0,622,G
3-PA,835,0,1,0,616,617,C
3-PA,836,1,2,587,0,590,G
3-PA,837,0,0,608,0,608,G
3-PA,838,0,608,0,0,608,T
3-PA,839,1,0,0,607,608,C
3-PA,840,1,0,0,610,611,C
3-PA,841,611,0,0,0,611,A
3-PA,842,614,0,0,0,614,A
3-PA,843,610,0,1,0,611,A
3-PA,844,0,612,0,0,612,T
3-PA,845,0,608,0,1,609,T
3-PA,846,1,0,0,597,598,C
3-PA,847,2,0,0,582,584,C
3-PA,848,0,581,0,0,581,T
3-PA,849,1,0,0,583,584,C
3-PA,850,0,0,0,583,583,C
3-PA,851,0,581,0,0,581,T
3-PA,852,1,0,585,0,586,G
3-PA,853,586,0,0,0,586,A
3-PA,854,0,585,0,0,585,T
3-PA,855,0,1,576,0,577,G
3-PA,856,0,0,566,0,566,G
3-PA,857,561,0,2,0,563,A
3-PA,858,0,537,0,0,537,T
3-PA,859,0,0,541,0,541,G
3-PA,860,0,0,0,564,564,C
3-PA,861,0,556,1,2,559,T
3-PA,862,1,559,0,1,561,T
3-PA,863,0,557,0,0,557,T
3-PA,864,561,0,0,0,561,A
3-PA,865,562,0,0,0,562,A
3-PA,866,558,0,1,0,559,A
3-PA,867,562,0,2,0,564,A
3-PA,868,0,559,0,1,560,T
3-PA,869,0,481,0,0,481,T
3-PA,870,0,0,483,0,483,G
3-PA,871,477,0,2,0,479,A
3-PA,872,0,0,484,0,484,G
3-PA,873,0,0,0,484,484,C
3-PA,874,480,0,0,0,480,A
3-PA,875,0,485,0,0,485,T
3-PA,876,0,487,0,0,487,T
3-PA,877,0,0,487,0,487,G
3-PA,878,487,1,0,0,488,A
3-PA,879,482,0,1,0,483,A
3-PA,880,0,0,484,0,484,G
3-PA,881,467,0,2,0,469,A
3-PA,882,0,0,0,473,473,C
3-PA,883,0,0,0,466,466,C
3-PA,884,1,0,0,459,460,C
3-PA,885,451,0,0,0,451,A
3-PA,886,447,0,1,0,448,A
3-PA,887,0,0,461,0,461,G
3-PA,888,0,463,1,0,464,T
3-PA,889,2,0,0,462,464,C
3-PA,890,463,0,0,0,463,A
3-PA,891,0,0,1,467,468,C
3-PA,892,3,2,461,2,468,G
3-PA,893,476,0,0,0,476,A
3-PA,894,473,1,2,0,476,A
3-PA,895,0,0,496,0,496,G
3-PA,896,0,0,492,0,492,G
3-PA,897,493,0,1,0,494,A
3-PA,898,0,0,499,0,499,G
3-PA,899,498,0,0,0,498,A
3-PA,900,496,0,0,0,496,A
3-PA,901,0,0,499,0,499,G
3-PA,902,0,1,495,0,496,G
3-PA,903,0,0,498,0,498,G
3-PA,904,486,0,1,0,487,A
3-PA,905,0,489,0,0,489,T
3-PA,906,0,0,0,494,494,C
3-PA,907,0,0,0,537,537,C
3-PA,908,1,0,0,553,554,C
3-PA,909,553,0,0,0,553,A
3-PA,910,0,553,0,0,553,T
3-PA,911,0,556,0,0,556,T
3-PA,912,571,0,0,0,571,A
3-PA,913,0,570,0,0,570,T
3-PA,914,568,0,0,0,568,A
3-PA,915,0,566,0,1,567,T
3-PA,916,0,2,517,0,519,G
3-PA,917,524,0,1,0,525,A
3-PA,918,0,524,0,0,524,T
3-PA,919,0,1,524,0,525,G
3-PA,920,0,0,0,526,526,C
3-PA,921,1,0,517,0,518,G
3-PA,922,518,0,0,0,518,A
3-PA,923,0,519,0,0,519,T
3-PA,924,1,0,0,517,518,C
3-PA,925,518,0,0,0,518,A
3-PA,926,513,0,0,0,513,A
3-PA,927,0,0,515,0,515,G
3-PA,928,0,514,0,0,514,T
3-PA,929,0,0,518,0,518,G
3-PA,930,0,0,0,520,520,C
3-PA,931,519,1,0,0,520,A
3-PA,932,0,521,0,0,521,T
3-PA,933,519,0,0,0,519,A
3-PA,934,523,0,1,0,524,A
3-PA,935,522,0,0,1,523,A
3-PA,936,516,0,1,0,517,A
3-PA,937,520,0,0,0,520,A
3-PA,938,0,0,0,524,524,C
3-PA,939,515,0,1,0,516,A
3-PA,940,0,518,0,0,518,T
3-PA,941,0,520,0,1,521,T
3-PA,942,0,0,0,520,520,C
3-PA,943,0,511,0,0,511,T
3-PA,944,0,512,0,0,512,T
3-PA,945,0,512,0,0,512,T
3-PA,946,0,0,513,0,513,G
3-PA,947,0,0,514,0,514,G
3-PA,948,513,0,1,0,514,A
3-PA,949,0,510,0,1,511,T
3-PA,950,0,2,508,0,510,G
3-PA,951,0,0,514,0,514,G
3-PA,952,514,0,0,0,514,A
3-PA,953,516,1,0,0,517,A
3-PA,954,517,0,1,0,518,A
3-PA,955,0,0,518,0,518,G
3-PA,956,515,0,1,0,516,A
3-PA,957,571,0,0,0,571,A
3-PA,958,0,0,0,576,576,C
3-PA,959,0,0,0,579,579,C
3-PA,960,0,571,0,2,573,T
3-PA,961,0,587,0,1,588,T
3-PA,962,590,0,0,0,590,A
3-PA,963,0,589,0,1,590,T
3-PA,964,588,0,0,0,588,A
3-PA,965,0,591,0,0,591,T
3-PA,966,545,0,0,0,545,A
3-PA,967,0,0,549,0,549,G
3-PA,968,0,544,0,1,545,T
3-PA,969,0,0,0,545,545,C
3-PA,970,542,0,0,0,542,A
3-PA,971,544,2,0,0,546,A
3-PA,972,546,0,0,0,546,A
3-PA,973,0,0,0,549,549,C
3-PA,974,2,0,0,539,541,C
3-PA,975,538,0,0,0,538,A
3-PA,976,0,2,0,539,541,C
3-PA,977,544,0,0,0,544,A
3-PA,978,1,0,0,541,542,C
3-PA,979,1,0,547,0,548,G
3-PA,980,545,0,0,0,545,A
3-PA,981,544,0,3,0,547,A
3-PA,982,545,0,1,0,546,A
3-PA,983,546,0,1,0,547,A
3-PA,984,0,1,559,0,560,G
3-PA,985,0,1,558,0,559,G
3-PA,986,0,0,561,0,561,G
3-PA,987,561,0,2,0,563,A
3-PA,988,564,0,0,1,565,A
3-PA,989,0,562,0,0,562,T
3-PA,990,562,0,1,0,563,A
3-PA,991,560,0,3,0,563,A
3-PA,992,563,1,1,0,565,A
3-PA,993,0,562,0,0,562,T
3-PA,994,0,563,0,0,563,T
3-PA,995,0,0,0,565,565,C
3-PA,996,564,0,2,0,566,A
3-PA,997,569,0,0,0,569,A
3-PA,998,570,0,0,0,570,A
3-PA,999,0,571,0,0,571,T
3-PA,1000,0,571,0,0,571,T
3-PA,1001,575,0,0,0,575,A
3-PA,1002,0,0,0,574,574,C
3-PA,1003,1,0,0,573,574,C
3-PA,1004,0,569,0,2,571,T
3-PA,1005,0,1,579,0,580,G
3-PA,1006,0,0,0,579,579,C
3-PA,1007,0,580,1,1,582,T
3-PA,1008,4,0,584,0,588,G
3-PA,1009,0,583,0,2,585,T
3-PA,1010,0,1,0,591,592,C
3-PA,1011,591,0,1,0,592,A
3-PA,1012,0,590,0,2,592,T
3-PA,1013,0,2,590,0,592,G
3-PA,1014,0,1,586,0,587,G
3-PA,1015,585,0,1,0,586,A
3-PA,1016,601,0,2,0,603,A
3-PA,1017,0,0,599,0,599,G
3-PA,1018,0,0,0,598,598,C
3-PA,1019,598,0,0,0,598,A
3-PA,1020,599,0,2,1,602,A
3-PA,1021,0,0,606,0,606,G
3-PA,1022,0,608,0,0,608,T
3-PA,1023,605,0,1,0,606,A
3-PA,1024,0,0,0,608,608,C
3-PA,1025,0,596,0,1,597,T
3-PA,1026,0,0,600,0,600,G
3-PA,1027,0,597,0,1,598,T
3-PA,1028,3,2,0,592,597,C
3-PA,1029,598,0,1,1,600,A
3-PA,1030,1,2,610,0,613,G
3-PA,1031,610,0,0,1,611,A
3-PA,1032,611,0,0,1,612,A
3-PA,1033,0,618,1,0,619,T
3-PA,1034,0,614,0,1,615,T
3-PA,1035,0,0,616,0,616,G
3-PA,1036,1,0,0,612,613,C
3-PA,1037,616,0,0,0,616,A
3-PA,1038,0,0,618,0,618,G
3-PA,1039,0,0,614,0,614,G
3-PA,1040,618,0,0,0,618,A
3-PA,1041,0,0,0,624,624,C
3-PA,1042,608,0,1,0,609,A
3-PA,1043,0,613,0,0,613,T
3-PA,1044,0,614,0,0,614,T
3-PA,1045,0,0,610,0,610,G
3-PA,1046,612,0,1,1,614,A
3-PA,1047,613,0,0,0,613,A
3-PA,1048,610,0,0,0,610,A
3-PA,1049,613,0,0,0,613,A
3-PA,1050,0,606,0,0,606,T
3-PA,1051,0,1,610,0,611,G
3-PA,1052,599,0,1,0,600,A
3-PA,1053,0,0,610,0,610,G
3-PA,1054,1,3,605,0,609,G
3-PA,1055,603,0,1,0,604,A
3-PA,1056,0,1,605,0,606,G
3-PA,1057,609,0,0,0,609,A
3-PA,1058,607,0,1,0,608,A
3-PA,1059,0,0,607,0,607,G
3-PA,1060,2,0,591,0,593,G
3-PA,1061,0,626,0,2,628,T
3-PA,1062,0,630,0,2,632,T
3-PA,1063,2,1,0,629,632,C
3-PA,1064,2,0,0,633,635,C
3-PA,1065,635,0,0,1,636,A
3-PA,1066,634,0,0,0,634,A
3-PA,1067,0,1,635,0,636,G
3-PA,1068,0,1,641,0,642,G
3-PA,1069,634,0,1,0,635,A
3-PA,1070,0,0,0,641,641,C
3-PA,1071,0,640,0,1,641,T
3-PA,1072,644,0,0,0,644,A
3-PA,1073,644,0,0,0,644,A
3-PA,1074,640,0,0,0,640,A
3-PA,1075,639,0,1,0,640,A
3-PA,1076,639,0,0,1,640,A
3-PA,1077,0,0,0,633,633,C
3-PA,1078,631,0,0,0,631,A
3-PA,1079,0,625,0,0,625,T
3-PA,1080,0,0,627,0,627,G
3-PA,1081,622,0,1,0,623,A
3-PA,1082,628,0,1,0,629,A
3-PA,1083,0,0,635,0,635,G
3-PA,1084,633,0,0,0,633,A
3-PA,1085,628,1,5,0,634,A
3-PA,1086,630,0,0,0,630,A
3-PA,1087,628,0,2,0,630,A
3-PA,1088,0,0,0,627,627,C
3-PA,1089,0,0,627,0,627,G
3-PA,1090,627,0,1,0,628,A
3-PA,1091,0,0,626,0,626,G
3-PA,1092,0,622,1,1,624,T
3-PA,1093,1,1,0,629,631,C
3-PA,1094,633,0,1,0,634,A
3-PA,1095,643,0,0,0,643,A
3-PA,1096,1,0,0,644,645,C
3-PA,1097,0,641,0,1,642,T
3-PA,1098,0,0,655,0,655,G
3-PA,1099,656,0,1,0,657,A
3-PA,1100,653,0,1,0,654,A
3-PA,1101,0,0,656,0,656,G
3-PA,1102,0,641,0,2,643,T
3-PA,1103,1,3,641,0,645,G
3-PA,1104,1,1,635,0,637,G
3-PA,1105,0,0,641,0,641,G
3-PA,1106,0,0,0,643,643,C
3-PA,1107,0,632,0,1,633,T
3-PA,1108,0,0,0,634,634,C
3-PA,1109,0,631,0,0,631,T
3-PA,1110,0,636,0,0,636,T
3-PA,1111,0,0,649,0,649,G
3-PA,1112,0,0,652,0,652,G
3-PA,1113,0,647,0,1,648,T
3-PA,1114,0,1,648,0,649,G
3-PA,1115,648,0,0,0,648,A
3-PA,1116,654,0,2,0,656,A
3-PA,1117,652,0,1,0,653,A
3-PA,1118,656,0,0,0,656,A
3-PA,1119,0,0,0,665,665,C
3-PA,1120,653,0,0,0,653,A
3-PA,1121,0,653,0,2,655,T
3-PA,1122,0,1,653,0,654,G
3-PA,1123,0,1,665,1,667,G
3-PA,1124,0,0,0,672,672,C
3-PA,1125,673,0,0,0,673,A
3-PA,1126,1,0,0,668,669,C
3-PA,1127,1,0,0,676,677,C
3-PA,1128,687,0,1,0,688,A
3-PA,1129,0,2,702,0,704,G
3-PA,1130,704,0,1,0,705,A
3-PA,1131,1,0,707,0,708,G
3-PA,1132,717,0,0,0,717,A
3-PA,1133,717,0,0,0,717,A
3-PA,1134,0,0,725,0,725,G
3-PA,1135,0,0,722,0,722,G
3-PA,1136,0,723,0,0,723,T
3-PA,1137,714,0,1,0,715,A
3-PA,1138,0,1,716,0,717,G
3-PA,1139,722,0,0,1,723,A
3-PA,1140,0,0,0,725,725,C
3-PA,1141,0,717,1,0,718,T
3-PA,1142,0,711,0,0,711,T
3-PA,1143,0,714,0,0,714,T
3-PA,1144,0,1,707,1,709,G
3-PA,1145,704,2,6,1,713,A
3-PA,1146,711,0,1,1,713,A
3-PA,1147,710,1,0,0,711,A
3-PA,1148,705,0,1,0,706,A
3-PA,1149,0,2,0,721,723,C
3-PA,1150,0,722,0,0,722,T
3-PA,1151,0,0,733,0,733,G
3-PA,1152,0,0,0,734,734,C
3-PA,1153,731,0,1,0,732,A
3-PA,1154,0,1,729,0,730,G
3-PA,1155,728,0,0,0,728,A
3-PA,1156,1,0,758,0,759,G
3-PA,1157,757,0,1,0,758,A
3-PA,1158,0,0,0,746,746,C
3-PA,1159,744,1,0,0,745,A
3-PA,1160,0,740,0,2,742,T
3-PA,1161,743,0,0,0,743,A
3-PA,1162,743,1,1,0,745,A
3-PA,1163,0,1,745,0,746,G
3-PA,1164,2,0,0,741,743,C
3-PA,1165,0,0,730,0,730,G
3-PA,1166,747,0,0,0,747,A
3-PA,1167,0,747,0,0,747,T
3-PA,1168,0,749,0,0,749,T
3-PA,1169,0,746,0,1,747,T
3-PA,1170,0,2,744,0,746,G
3-PA,1171,751,1,0,0,752,A
3-PA,1172,748,0,0,0,748,A
3-PA,1173,0,2,750,0,752,G
3-PA,1174,0,0,0,775,775,C
3-PA,1175,768,0,0,0,768,A
3-PA,1176,824,0,2,0,826,A
3-PA,1177,0,828,0,0,828,T
3-PA,1178,824,0,0,0,824,A
3-PA,1179,1,829,0,0,830,T
3-PA,1180,1,3,835,0,839,G
3-PA,1181,846,0,0,0,846,A
3-PA,1182,0,843,0,0,843,T
3-PA,1183,827,0,0,0,827,A
3-PA,1184,0,0,834,0,834,G
3-PA,1185,0,804,0,1,805,T
3-PA,1186,1,1,806,0,808,G
3-PA,1187,806,0,2,0,808,A
3-PA,1188,0,1,0,799,800,C
3-PA,1189,0,0,798,0,798,G
3-PA,1190,799,1,0,0,800,A
3-PA,1191,801,0,1,0,802,A
3-PA,1192,1,1,0,812,814,C
3-PA,1193,3,1,0,811,815,C
3-PA,1194,0,808,0,2,810,T
3-PA,1195,0,1,839,0,840,G
3-PA,1196,839,0,1,0,840,A
3-PA,1197,847,0,0,0,847,A
3-PA,1198,1,844,0,0,845,T
3-PA,1199,0,837,1,0,838,T
3-PA,1200,836,0,0,0,836,A
3-PA,1201,830,0,0,0,830,A
3-PA,1202,0,0,833,0,833,G
3-PA,1203,0,1,828,0,829,G
3-PA,1204,0,809,0,1,810,T
3-PA,1205,0,0,0,806,806,C
3-PA,1206,811,0,0,0,811,A
3-PA,1207,0,0,0,854,854,C
3-PA,1208,0,850,0,1,851,T
3-PA,1209,0,848,0,1,849,T
3-PA,1210,0,850,0,3,853,T
3-PA,1211,0,0,0,848,848,C
3-PA,1212,847,0,2,0,849,A
3-PA,1213,844,0,1,0,845,A
3-PA,1214,0,0,860,0,860,G
3-PA,1215,0,0,0,859,859,C
3-PA,1216,0,842,0,0,842,T
3-PA,1217,0,1,866,1,868,G
3-PA,1218,0,3,870,0,873,G
3-PA,1219,891,0,2,0,893,A
3-PA,1220,0,895,0,2,897,T
3-PA,1221,894,0,0,0,894,A
3-PA,1222,1,0,0,902,903,C
3-PA,1223,889,0,1,0,890,A
3-PA,1224,1,3,900,0,904,G
3-PA,1225,895,0,1,0,896,A
3-PA,1226,880,0,0,0,880,A
3-PA,1227,0,870,0,0,870,T
3-PA,1228,1,2,874,0,877,G
3-PA,1229,873,0,0,0,873,A
3-PA,1230,0,0,883,0,883,G
3-PA,1231,0,884,0,1,885,T
3-PA,1232,0,886,0,0,886,T
3-PA,1233,2,0,0,901,903,C
3-PA,1234,908,0,0,0,908,A
3-PA,1235,908,0,0,3,911,A
3-PA,1236,0,0,0,915,915,C
3-PA,1237,900,0,1,0,901,A
3-PA,1238,897,0,1,0,898,A
3-PA,1239,1,1,905,0,907,G
3-PA,1240,0,6,909,0,915,G
3-PA,1241,0,1,0,924,925,C
3-PA,1242,0,1,0,917,918,C
3-PA,1243,0,913,0,0,913,T
3-PA,1244,0,0,918,0,918,G
3-PA,1245,1,920,0,0,921,T
3-PA,1246,1,0,929,0,930,G
3-PA,1247,929,0,1,0,930,A
3-PA,1248,0,0,933,0,933,G
3-PA,1249,0,0,0,926,926,C
3-PA,1250,0,916,0,1,917,T
3-PA,1251,930,0,1,0,931,A
3-PA,1252,929,0,2,1,932,A
3-PA,1253,0,0,0,936,936,C
3-PA,1254,0,928,0,0,928,T
3-PA,1255,0,2,921,1,924,G
3-PA,1256,922,0,0,0,922,A
3-PA,1257,0,920,0,2,922,T
3-PA,1258,0,923,0,1,924,T
3-PA,1259,0,0,0,925,925,C
3-PA,1260,952,0,0,0,952,A
3-PA,1261,3,2,971,0,976,G
3-PA,1262,0,973,0,2,975,T
3-PA,1263,0,0,0,978,978,C
3-PA,1264,0,964,0,3,967,T
3-PA,1265,0,1,1008,0,1009,G
3-PA,1266,0,1,1012,0,1013,G
3-PA,1267,1015,0,1,0,1016,A
3-PA,1268,1,1016,0,1,1018,T
3-PA,1269,971,0,1,0,972,A
3-PA,1270,0,0,968,0,968,G
3-PA,1271,958,0,1,0,959,A
3-PA,1272,0,0,975,0,975,G
3-PA,1273,0,0,0,973,973,C
3-PA,1274,0,953,0,1,954,T
3-PA,1275,2,1,0,953,956,C
3-PA,1276,0,0,959,0,959,G
3-PA,1277,962,0,2,0,964,A
3-PA,1278,0,962,0,0,962,T
3-PA,1279,1,2,951,0,954,G
3-PA,1280,966,0,1,0,967,A
3-PA,1281,963,0,2,0,965,A
3-PA,1282,966,0,1,0,967,A
3-PA,1283,1,962,0,0,963,T
3-PA,1284,0,964,0,0,964,T
3-PA,1285,1,0,976,0,977,G
3-PA,1286,0,4,973,0,977,G
3-PA,1287,978,0,1,0,979,A
3-PA,1288,0,4,976,0,980,G
3-PA,1289,972,0,0,0,972,A
3-PA,1290,0,1,979,0,980,G
3-PA,1291,0,3,982,0,985,G
3-PA,1292,997,0,1,0,998,A
3-PA,1293,0,0,0,999,999,C
3-PA,1294,1,1,988,0,990,G
3-PA,1295,0,996,0,0,996,T
3-PA,1296,998,0,1,0,999,A
3-PA,1297,0,0,1009,0,1009,G
3-PA,1298,0,0,0,1017,1017,C
3-PA,1299,2,0,0,1004,1006,C
3-PA,1300,1,2,0,1000,1003,C
3-PA,1301,0,0,0,1005,1005,C
3-PA,1302,1010,0,0,0,1010,A
3-PA,1303,1035,0,2,0,1037,A
3-PA,1304,0,1034,0,0,1034,T
3-PA,1305,0,1023,0,0,1023,T
3-PA,1306,0,3,1022,0,1025,G
3-PA,1307,1002,0,2,0,1004,A
3-PA,1308,0,0,1010,0,1010,G
3-PA,1309,0,1,0,1011,1012,C
3-PA,1310,1009,0,1,0,1010,A
3-PA,1311,0,0,0,1027,1027,C
3-PA,1312,1002,0,0,0,1002,A
3-PA,1313,0,1033,0,0,1033,T
3-PA,1314,0,1030,0,1,1031,T
3-PA,1315,0,0,1035,0,1035,G
3-PA,1316,0,0,0,1029,1029,C
3-PA,1317,1027,0,2,0,1029,A
3-PA,1318,1026,0,2,0,1028,A
3-PA,1319,1,0,1028,0,1029,G
3-PA,1320,0,0,0,1017,1017,C
3-PA,1321,1017,0,1,0,1018,A
3-PA,1322,1,988,0,0,989,T
3-PA,1323,0,1,992,0,993,G
3-PA,1324,984,0,4,0,988,A
3-PA,1325,0,1,998,0,999,G
3-PA,1326,1001,0,0,0,1001,A
3-PA,1327,998,0,2,0,1000,A
3-PA,1328,0,0,1000,0,1000,G
3-PA,1329,993,0,1,0,994,A
3-PA,1330,1001,1,2,0,1004,A
3-PA,1331,1007,0,0,0,1007,A
3-PA,1332,0,1008,0,0,1008,T
3-PA,1333,1,1009,0,0,1010,T
3-PA,1334,1006,0,0,0,1006,A
3-PA,1335,0,1005,0,1,1006,T
3-PA,1336,0,1006,0,0,1006,T
3-PA,1337,1,1005,0,2,1008,T
3-PA,1338,2,0,0,1004,1006,C
3-PA,1339,1004,1,0,0,1005,A
3-PA,1340,1,1,0,1030,1032,C
3-PA,1341,1029,0,0,0,1029,A
3-PA,1342,0,1,1040,0,1041,G
3-PA,1343,1,0,0,1039,1040,C
3-PA,1344,1036,0,1,0,1037,A
3-PA,1345,0,1,1042,0,1043,G
3-PA,1346,1041,0,0,0,1041,A
3-PA,1347,0,0,1048,0,1048,G
3-PA,1348,0,0,1051,0,1051,G
3-PA,1349,1,1022,0,1,1024,T
3-PA,1350,0,0,1040,0,1040,G
3-PA,1351,0,1030,0,2,1032,T
3-PA,1352,1,0,0,1034,1035,C
3-PA,1353,2,0,0,1052,1054,C
3-PA,1354,1,0,0,1048,1049,C
3-PA,1355,1056,0,2,0,1058,A
3-PA,1356,2,1068,0,1,1071,T
3-PA,1357,0,1060,0,0,1060,T
3-PA,1358,1,0,1063,1,1065,G
3-PA,1359,0,1049,0,1,1050,T
3-PA,1360,1030,0,0,0,1030,A
3-PA,1361,0,2,1021,0,1023,G
3-PA,1362,1003,0,1,0,1004,A
3-PA,1363,0,0,1009,0,1009,G
3-PA,1364,0,0,0,988,988,C
3-PA,1365,2,0,0,977,979,C
3-PA,1366,986,1,0,0,987,A
3-PA,1367,2,1,0,984,987,C
3-PA,1368,0,975,0,0,975,T
3-PA,1369,0,0,976,0,976,G
3-PA,1370,974,0,0,0,974,A
3-PA,1371,958,0,0,0,958,A
3-PA,1372,0,994,0,1,995,T
3-PA,1373,1009,0,1,0,1010,A
3-PA,1374,1,0,0,1024,1025,C
3-PA,1375,1008,0,1,0,1009,A
3-PA,1376,0,1014,0,1,1015,T
3-PA,1377,1015,0,0,1,1016,A
3-PA,1378,1013,0,1,0,1014,A
3-PA,1379,0,1009,0,2,1011,T
3-PA,1380,0,0,995,1,996,G
3-PA,1381,986,0,1,0,987,A
3-PA,1382,974,0,0,0,974,A
3-PA,1383,0,1,974,0,975,G
3-PA,1384,0,2,964,0,966,G
3-PA,1385,0,1,994,0,995,G
3-PA,1386,0,1,994,0,995,G
3-PA,1387,0,0,1002,0,1002,G
3-PA,1388,0,986,1,0,987,T
3-PA,1389,995,1,1,1,998,A
3-PA,1390,0,1001,0,0,1001,T
3-PA,1391,1029,0,1,0,1030,A
3-PA,1392,1,0,0,1120,1121,C
3-PA,1393,1091,0,0,0,1091,A
3-PA,1394,0,1067,0,4,1071,T
3-PA,1395,0,1056,1,7,1064,T
3-PA,1396,1054,0,1,0,1055,A
3-PA,1397,1079,1,1,0,1081,A
3-PA,1398,0,0,0,1082,1082,C
3-PA,1399,1061,0,1,0,1062,A
3-PA,1400,5,0,0,1056,1061,C
3-PA,1401,0,963,0,1,964,T
3-PA,1402,1,1,1010,0,1012,G
3-PA,1403,0,0,0,1007,1007,C
3-PA,1404,0,0,0,1006,1006,C
3-PA,1405,0,0,0,1008,1008,C
3-PA,1406,0,976,0,1,977,T
3-PA,1407,0,0,1006,0,1006,G
3-PA,1408,0,0,0,1009,1009,C
3-PA,1409,1,1002,0,2,1005,T
3-PA,1410,2,0,0,1030,1032,C
3-PA,1411,1002,0,0,0,1002,A
3-PA,1412,1008,0,1,0,1009,A
3-PA,1413,0,1012,0,2,1014,T
3-PA,1414,0,0,1012,0,1012,G
3-PA,1415,0,0,0,1014,1014,C
3-PA,1416,1002,0,1,0,1003,A
3-PA,1417,1,999,1,2,1003,T
3-PA,1418,0,0,0,1001,1001,C
3-PA,1419,0,0,0,1007,1007,C
3-PA,1420,0,986,0,1,987,T
3-PA,1421,0,1,1011,0,1012,G
3-PA,1422,0,1008,0,1,1009,T
3-PA,1423,0,0,1005,0,1005,G
3-PA,1424,0,0,0,1005,1005,C
3-PA,1425,991,1,1,0,993,A
3-PA,1426,0,0,1007,0,1007,G
3-PA,1427,0,0,0,1006,1006,C
3-PA,1428,990,0,0,0,990,A
3-PA,1429,988,3,0,0,991,A
3-PA,1430,0,955,0,1,956,T
3-PA,1431,1,2,964,0,967,G
3-PA,1432,0,1,965,0,966,G
3-PA,1433,963,0,3,0,966,A
3-PA,1434,0,0,0,966,966,C
3-PA,1435,0,1,958,0,959,G
3-PA,1436,969,0,0,0,969,A
3-PA,1437,0,970,0,1,971,T
3-PA,1438,0,968,1,0,969,T
3-PA,1439,0,965,0,0,965,T
3-PA,1440,0,969,0,0,969,T
3-PA,1441,1,0,0,969,970,C
3-PA,1442,971,0,1,0,972,A
3-PA,1443,971,1,1,0,973,A
3-PA,1444,1,2,0,970,973,C
3-PA,1445,0,948,0,0,948,T
3-PA,1446,947,0,4,0,951,A
3-PA,1447,953,0,0,0,953,A
3-PA,1448,0,954,0,1,955,T
3-PA,1449,0,952,0,1,953,T
3-PA,1450,0,1,0,951,952,C
3-PA,1451,1,1,0,951,953,C
3-PA,1452,1,0,0,951,952,C
3-PA,1453,954,0,0,0,954,A
3-PA,1454,0,967,0,1,968,T
3-PA,1455,0,1,969,0,970,G
3-PA,1456,966,1,2,0,969,A
3-PA,1457,0,962,0,1,963,T
3-PA,1458,959,0,3,1,963,A
3-PA,1459,961,0,1,0,962,A
3-PA,1460,0,0,961,0,961,G
3-PA,1461,1,1,0,957,959,C
3-PA,1462,956,0,0,0,956,A
3-PA,1463,936,0,1,0,937,A
3-PA,1464,0,0,948,0,948,G
3-PA,1465,0,943,0,1,944,T
3-PA,1466,0,0,942,0,942,G
3-PA,1467,4,0,0,935,939,C
3-PA,1468,934,1,2,0,937,A
3-PA,1469,0,1,946,0,947,G
3-PA,1470,944,0,1,0,945,A
3-PA,1471,961,0,0,0,961,A
3-PA,1472,0,0,1,958,959,C
3-PA,1473,0,935,0,0,935,T
3-PA,1474,941,0,0,0,941,A
3-PA,1475,944,1,0,0,945,A
3-PA,1476,942,0,1,1,944,A
3-PA,1477,0,0,942,0,942,G
3-PA,1478,898,0,1,0,899,A
3-PA,1479,0,5,896,0,901,G
3-PA,1480,1,2,878,0,881,G
3-PA,1481,0,0,877,0,877,G
3-PA,1482,867,0,1,0,868,A
3-PA,1483,850,0,1,0,851,A
3-PA,1484,1,1,848,0,850,G
3-PA,1485,0,1,853,0,854,G
3-PA,1486,1,1,0,846,848,C
3-PA,1487,0,1,848,0,849,G
3-PA,1488,844,0,1,0,845,A
3-PA,1489,848,0,1,0,849,A
3-PA,1490,849,0,1,0,850,A
3-PA,1491,846,0,1,0,847,A
3-PA,1492,849,0,0,0,849,A
3-PA,1493,0,0,0,848,848,C
3-PA,1494,2,1,0,837,840,C
3-PA,1495,839,0,1,0,840,A
3-PA,1496,848,0,0,0,848,A
3-PA,1497,0,845,0,0,845,T
3-PA,1498,0,842,0,1,843,T
3-PA,1499,0,852,0,0,852,T
3-PA,1500,854,0,0,0,854,A
3-PA,1501,0,850,0,1,851,T
3-PA,1502,849,0,1,1,851,A
3-PA,1503,0,849,0,1,850,T
3-PA,1504,1,0,836,0,837,G
3-PA,1505,1,1,828,0,830,G
3-PA,1506,832,0,1,0,833,A
3-PA,1507,0,826,0,1,827,T
3-PA,1508,0,823,0,0,823,T
3-PA,1509,2,0,0,818,820,C
3-PA,1510,815,1,1,0,817,A
3-PA,1511,0,824,0,0,824,T
3-PA,1512,0,0,0,825,825,C
3-PA,1513,826,0,0,0,826,A
3-PA,1514,0,820,0,0,820,T
3-PA,1515,819,0,1,0,820,A
3-PA,1516,815,0,0,1,816,A
3-PA,1517,817,0,1,0,818,A
3-PA,1518,0,1,806,0,807,G
3-PA,1519,1,1,796,0,798,G
3-PA,1520,0,0,789,0,789,G
3-PA,1521,780,0,3,0,783,A
3-PA,1522,781,0,1,0,782,A
3-PA,1523,0,0,789,0,789,G
3-PA,1524,780,0,0,0,780,A
3-PA,1525,0,775,0,2,777,T
3-PA,1526,0,0,0,778,778,C
3-PA,1527,0,765,0,1,766,T
3-PA,1528,0,0,0,782,782,C
3-PA,1529,779,0,1,0,780,A
3-PA,1530,0,779,0,0,779,T
3-PA,1531,3,773,0,0,776,T
3-PA,1532,0,767,0,0,767,T
3-PA,1533,759,0,1,0,760,A
3-PA,1534,757,0,2,0,759,A
3-PA,1535,0,3,754,0,757,G
3-PA,1536,0,1,756,0,757,G
3-PA,1537,717,1,0,0,718,A
3-PA,1538,715,0,1,0,716,A
3-PA,1539,1,701,10,1,713,T
3-PA,1540,1,3,717,0,721,G
3-PA,1541,737,1,2,0,740,A
3-PA,1542,1,1,0,738,740,C
3-PA,1543,736,1,1,0,738,A
3-PA,1544,0,0,0,733,733,C
3-PA,1545,718,0,1,0,719,A
3-PA,1546,0,0,724,0,724,G
3-PA,1547,710,0,1,0,711,A
3-PA,1548,0,0,0,705,705,C
3-PA,1549,0,0,696,0,696,G
3-PA,1550,0,656,0,1,657,T
3-PA,1551,0,3,651,0,654,G
3-PA,1552,0,1,658,0,659,G
3-PA,1553,0,660,0,1,661,T
3-PA,1554,660,0,0,0,660,A
3-PA,1555,652,0,0,0,652,A
3-PA,1556,654,0,0,0,654,A
3-PA,1557,0,647,0,0,647,T
3-PA,1558,0,636,0,0,636,T
3-PA,1559,0,636,0,0,636,T
3-PA,1560,0,628,0,0,628,T
3-PA,1561,0,0,628,0,628,G
3-PA,1562,0,616,0,0,616,T
3-PA,1563,0,0,618,0,618,G
3-PA,1564,614,0,0,0,614,A
3-PA,1565,0,0,612,0,612,G
3-PA,1566,0,0,0,612,612,C
3-PA,1567,612,0,0,0,612,A
3-PA,1568,0,609,0,1,610,T
3-PA,1569,0,0,611,0,611,G
3-PA,1570,1,2,612,0,615,G
3-PA,1571,615,0,0,0,615,A
3-PA,1572,0,0,613,0,613,G
3-PA,1573,0,600,0,4,604,T
3-PA,1574,0,597,0,1,598,T
3-PA,1575,0,599,0,0,599,T
3-PA,1576,0,594,0,0,594,T
3-PA,1577,2,1,0,597,600,C
3-PA,1578,0,594,0,1,595,T
3-PA,1579,1,0,0,591,592,C
3-PA,1580,0,583,0,0,583,T
3-PA,1581,1,0,0,581,582,C
3-PA,1582,582,0,0,0,582,A
3-PA,1583,0,0,0,580,580,C
3-PA,1584,1,570,0,0,571,T
3-PA,1585,0,0,575,0,575,G
3-PA,1586,573,0,0,0,573,A
3-PA,1587,0,0,0,574,574,C
3-PA,1588,2,0,0,571,573,C
3-PA,1589,1,0,0,566,567,C
3-PA,1590,0,0,566,0,566,G
3-PA,1591,563,0,1,0,564,A
3-PA,1592,0,1,566,0,567,G
3-PA,1593,564,0,1,0,565,A
3-PA,1594,1,0,0,559,560,C
3-PA,1595,0,552,0,1,553,T
3-PA,1596,0,531,0,1,532,T
3-PA,1597,0,1,527,0,528,G
3-PA,1598,526,1,0,0,527,A
3-PA,1599,0,0,530,0,530,G
3-PA,1600,0,0,0,528,528,C
3-PA,1601,1,0,0,510,511,C
3-PA,1602,518,0,0,0,518,A
3-PA,1603,0,1,0,511,512,C
3-PA,1604,512,0,1,0,513,A
3-PA,1605,0,513,0,0,513,T
3-PA,1606,508,0,0,0,508,A
3-PA,1607,503,0,1,0,504,A
3-PA,1608,506,0,1,0,507,A
3-PA,1609,0,505,1,0,506,T
3-PA,1610,0,2,500,0,502,G
3-PA,1611,0,0,476,0,476,G
3-PA,1612,0,0,479,0,479,G
3-PA,1613,470,0,0,0,470,A
3-PA,1614,0,1,471,0,472,G
3-PA,1615,466,0,0,0,466,A
3-PA,1616,467,0,0,0,467,A
3-PA,1617,473,0,0,0,473,A
3-PA,1618,0,473,0,0,473,T
3-PA,1619,471,0,0,0,471,A
3-PA,1620,2,268,0,180,450,T
3-PA,1621,0,361,0,0,361,T
3-PA,1622,0,0,360,0,360,G
3-PA,1623,0,324,0,0,324,T
3-PA,1624,0,0,320,0,320,G
3-PA,1625,0,293,0,1,294,T
3-PA,1626,0,0,0,289,289,C
3-PA,1627,1,0,0,280,281,C
3-PA,1628,0,277,0,0,277,T
3-PA,1629,0,277,0,1,278,T
3-PA,1630,0,1,285,0,286,G
3-PA,1631,294,0,1,0,295,A
3-PA,1632,0,0,296,0,296,G
3-PA,1633,289,0,0,0,289,A
3-PA,1634,0,289,0,0,289,T
3-PA,1635,283,0,1,0,284,A
3-PA,1636,1,1,288,0,290,G
3-PA,1637,0,1,290,0,291,G
3-PA,1638,289,0,0,0,289,A
3-PA,1639,2,0,285,1,288,G
3-PA,1640,280,0,3,0,283,A
3-PA,1641,1,279,0,0,280,T
3-PA,1642,287,0,0,0,287,A
3-PA,1643,0,288,0,0,288,T
3-PA,1644,0,0,290,0,290,G
3-PA,1645,0,291,0,0,291,T
3-PA,1646,0,290,0,0,290,T
3-PA,1647,298,0,1,0,299,A
3-PA,1648,0,0,0,300,300,C
3-PA,1649,0,295,0,0,295,T
3-PA,1650,297,0,0,0,297,A
3-PA,1651,292,0,0,0,292,A
3-PA,1652,0,1,298,0,299,G
3-PA,1653,293,0,1,0,294,A
3-PA,1654,286,0,0,0,286,A
3-PA,1655,0,0,283,0,283,G
3-PA,1656,0,291,0,0,291,T
3-PA,1657,0,1,294,0,295,G
3-PA,1658,0,1,0,295,296,C
3-PA,1659,0,0,0,295,295,C
3-PA,1660,297,0,0,0,297,A
3-PA,1661,0,292,0,0,292,T
3-PA,1662,291,0,0,0,291,A
3-PA,1663,0,0,297,0,297,G
3-PA,1664,0,0,299,0,299,G
3-PA,1665,0,0,0,294,294,C
3-PA,1666,0,1,0,295,296,C
3-PA,1667,297,0,0,0,297,A
3-PA,1668,301,0,1,0,302,A
3-PA,1669,302,0,0,0,302,A
3-PA,1670,0,301,0,1,302,T
3-PA,1671,0,303,0,0,303,T
3-PA,1672,1,300,0,0,301,T
3-PA,1673,1,0,0,302,303,C
3-PA,1674,299,0,1,0,300,A
3-PA,1675,300,0,0,0,300,A
3-PA,1676,0,0,294,0,294,G
3-PA,1677,0,0,300,0,300,G
3-PA,1678,0,1,0,298,299,C
3-PA,1679,0,0,0,298,298,C
3-PA,1680,0,0,298,0,298,G
3-PA,1681,300,1,0,0,301,A
3-PA,1682,0,301,0,0,301,T
3-PA,1683,0,0,305,0,305,G
3-PA,1684,0,305,0,0,305,T
3-PA,1685,0,318,0,0,318,T
3-PA,1686,0,0,0,319,319,C
3-PA,1687,0,317,0,1,318,T
3-PA,1688,0,318,0,0,318,T
3-PA,1689,0,0,320,0,320,G
3-PA,1690,0,314,0,0,314,T
3-PA,1691,317,0,0,0,317,A
3-PA,1692,0,307,0,0,307,T
3-PA,1693,0,0,308,0,308,G
3-PA,1694,1,293,0,0,294,T
3-PA,1695,0,0,289,0,289,G
3-PA,1696,287,0,0,0,287,A
3-PA,1697,0,0,288,0,288,G
3-PA,1698,0,0,288,0,288,G
3-PA,1699,289,0,0,0,289,A
3-PA,1700,0,0,0,290,290,C
3-PA,1701,283,0,0,0,283,A
3-PA,1702,282,0,0,0,282,A
3-PA,1703,286,0,0,0,286,A
3-PA,1704,0,0,0,283,283,C
3-PA,1705,1,1,280,0,282,G
3-PA,1706,0,0,282,0,282,G
3-PA,1707,281,0,0,0,281,A
3-PA,1708,282,0,0,0,282,A
3-PA,1709,0,0,0,282,282,C
3-PA,1710,282,0,1,0,283,A
3-PA,1711,0,283,0,0,283,T
3-PA,1712,0,0,0,283,283,C
3-PA,1713,281,0,0,0,281,A
3-PA,1714,281,0,0,0,281,A
3-PA,1715,276,0,1,0,277,A
3-PA,1716,0,0,281,0,281,G
3-PA,1717,0,0,282,0,282,G
3-PA,1718,1,278,0,0,279,T
3-PA,1719,279,0,0,0,279,A
3-PA,1720,281,0,0,0,281,A
3-PA,1721,281,0,1,0,282,A
3-PA,1722,284,0,0,0,284,A
3-PA,1723,283,0,0,0,283,A
3-PA,1724,0,283,0,0,283,T
3-PA,1725,0,0,282,0,282,G
3-PA,1726,280,0,0,0,280,A
3-PA,1727,278,0,0,0,278,A
3-PA,1728,279,0,0,0,279,A
3-PA,1729,0,279,0,0,279,T
3-PA,1730,0,2,283,0,285,G
3-PA,1731,0,0,286,0,286,G
3-PA,1732,0,0,283,0,283,G
3-PA,1733,0,0,282,0,282,G
3-PA,1734,284,0,0,0,284,A
3-PA,1735,280,0,1,0,281,A
3-PA,1736,0,285,0,0,285,T
3-PA,1737,0,1,284,0,285,G
3-PA,1738,1,0,285,0,286,G
3-PA,1739,280,0,0,0,280,A
3-PA,1740,0,1,281,0,282,G
3-PA,1741,282,0,0,0,282,A
3-PA,1742,0,276,0,1,277,T
3-PA,1743,0,0,278,0,278,G
3-PA,1744,279,0,0,0,279,A
3-PA,1745,1,0,278,0,279,G
3-PA,1746,277,0,0,0,277,A
3-PA,1747,0,0,0,274,274,C
3-PA,1748,0,0,275,0,275,G
3-PA,1749,0,265,0,1,266,T
3-PA,1750,0,265,0,0,265,T
3-PA,1751,0,0,268,0,268,G
3-PA,1752,0,0,0,267,267,C
3-PA,1753,0,0,0,268,268,C
3-PA,1754,0,268,0,0,268,T
3-PA,1755,0,0,0,270,270,C
3-PA,1756,1,0,0,271,272,C
3-PA,1757,0,273,0,0,273,T
3-PA,1758,0,276,0,0,276,T
3-PA,1759,0,0,0,277,277,C
3-PA,1760,276,0,0,0,276,A
3-PA,1761,0,0,277,0,277,G
3-PA,1762,0,275,0,0,275,T
3-PA,1763,0,0,0,276,276,C
3-PA,1764,273,0,0,0,273,A
3-PA,1765,0,0,0,289,289,C
3-PA,1766,0,289,0,0,289,T
3-PA,1767,0,0,0,292,292,C
3-PA,1768,1,0,0,290,291,C
3-PA,1769,294,0,0,0,294,A
3-PA,1770,0,0,292,0,292,G
3-PA,1771,0,0,0,294,294,C
3-PA,1772,290,0,1,0,291,A
3-PA,1773,0,1,293,0,294,G
3-PA,1774,283,0,0,0,283,A
3-PA,1775,0,282,0,0,282,T
3-PA,1776,1,0,0,282,283,C
3-PA,1777,0,0,283,0,283,G
3-PA,1778,283,0,0,0,283,A
3-PA,1779,0,0,286,0,286,G
3-PA,1780,281,0,1,0,282,A
3-PA,1781,1,0,282,0,283,G
3-PA,1782,0,0,0,283,283,C
3-PA,1783,280,0,0,0,280,A
3-PA,1784,0,283,0,0,283,T
3-PA,1785,0,1,292,0,293,G
3-PA,1786,295,0,0,0,295,A
3-PA,1787,0,298,0,0,298,T
3-PA,1788,0,298,0,0,298,T
3-PA,1789,0,1,296,0,297,G
3-PA,1790,294,0,0,0,294,A
3-PA,1791,294,0,0,0,294,A
3-PA,1792,0,0,293,0,293,G
3-PA,1793,0,0,0,293,293,C
3-PA,1794,0,0,0,288,288,C
3-PA,1795,0,1,288,0,289,G
3-PA,1796,288,0,0,0,288,A
3-PA,1797,0,0,292,0,292,G
3-PA,1798,0,293,0,0,293,T
3-PA,1799,1,0,0,293,294,C
3-PA,1800,1,0,0,294,295,C
3-PA,1801,0,292,0,2,294,T
3-PA,1802,0,0,0,297,297,C
3-PA,1803,0,1,299,0,300,G
3-PA,1804,0,0,309,0,309,G
3-PA,1805,0,307,0,0,307,T
3-PA,1806,0,301,0,0,301,T
3-PA,1807,300,0,1,0,301,A
3-PA,1808,300,0,0,0,300,A
3-PA,1809,300,0,1,0,301,A
3-PA,1810,0,0,305,0,305,G
3-PA,1811,299,0,1,0,300,A
3-PA,1812,0,0,300,0,300,G
3-PA,1813,285,0,2,0,287,A
3-PA,1814,288,0,0,0,288,A
3-PA,1815,289,0,0,0,289,A
3-PA,1816,0,0,291,0,291,G
3-PA,1817,290,0,1,0,291,A
3-PA,1818,0,1,0,290,291,C
3-PA,1819,287,0,0,0,287,A
3-PA,1820,0,287,0,0,287,T
3-PA,1821,0,1,286,0,287,G
3-PA,1822,288,0,2,0,290,A
3-PA,1823,0,0,0,286,286,C
3-PA,1824,0,0,0,288,288,C
3-PA,1825,286,0,0,0,286,A
3-PA,1826,284,0,0,0,284,A
3-PA,1827,284,0,0,0,284,A
3-PA,1828,0,1,285,0,286,G
3-PA,1829,282,0,0,0,282,A
3-PA,1830,0,0,283,0,283,G
3-PA,1831,0,281,0,0,281,T
3-PA,1832,0,278,0,0,278,T
3-PA,1833,0,274,0,1,275,T
3-PA,1834,1,278,0,0,279,T
3-PA,1835,0,279,0,0,279,T
3-PA,1836,0,280,0,0,280,T
3-PA,1837,0,0,280,0,280,G
3-PA,1838,279,0,0,0,279,A
3-PA,1839,0,2,278,0,280,G
3-PA,1840,278,0,1,0,279,A
3-PA,1841,280,0,0,0,280,A
3-PA,1842,0,281,0,0,281,T
3-PA,1843,280,0,2,0,282,A
3-PA,1844,284,0,0,0,284,A
3-PA,1845,284,0,0,0,284,A
3-PA,1846,0,286,0,0,286,T
3-PA,1847,0,0,0,285,285,C
3-PA,1848,281,0,0,0,281,A
3-PA,1849,0,0,282,0,282,G
3-PA,1850,282,0,0,0,282,A
3-PA,1851,282,0,1,0,283,A
3-PA,1852,0,0,288,0,288,G
3-PA,1853,0,0,0,283,283,C
3-PA,1854,279,0,0,0,279,A
3-PA,1855,0,279,0,0,279,T
3-PA,1856,0,0,280,0,280,G
3-PA,1857,0,0,283,0,283,G
3-PA,1858,0,0,0,283,283,C
3-PA,1859,0,0,0,291,291,C
3-PA,1860,2,1,0,290,293,C
3-PA,1861,302,0,1,0,303,A
3-PA,1862,0,303,0,0,303,T
3-PA,1863,0,300,0,0,300,T
3-PA,1864,0,0,304,0,304,G
3-PA,1865,0,1,300,0,301,G
3-PA,1866,0,1,295,0,296,G
3-PA,1867,0,1,294,0,295,G
3-PA,1868,280,0,1,1,282,A
3-PA,1869,0,0,290,0,290,G
3-PA,1870,0,286,0,2,288,T
3-PA,1871,0,0,0,293,293,C
3-PA,1872,1,0,0,299,300,C
3-PA,1873,0,0,0,296,296,C
3-PA,1874,0,0,0,300,300,C
3-PA,1875,1,0,0,298,299,C
3-PA,1876,298,0,0,0,298,A
3-PA,1877,299,0,1,0,300,A
3-PA,1878,0,3,299,0,302,G
3-PA,1879,0,1,296,0,297,G
3-PA,1880,0,0,295,0,295,G
3-PA,1881,264,0,0,0,264,A
3-PA,1882,0,0,268,0,268,G
3-PA,1883,0,266,0,0,266,T
3-PA,1884,0,0,265,0,265,G
3-PA,1885,0,0,267,0,267,G
3-PA,1886,266,0,0,0,266,A
3-PA,1887,267,0,0,0,267,A
3-PA,1888,0,0,266,0,266,G
3-PA,1889,265,1,0,0,266,A
3-PA,1890,267,0,1,0,268,A
3-PA,1891,0,0,265,0,265,G
3-PA,1892,0,0,269,0,269,G
3-PA,1893,0,267,0,0,267,T
3-PA,1894,1,263,0,0,264,T
3-PA,1895,1,0,0,261,262,C
3-PA,1896,0,0,0,266,266,C
3-PA,1897,266,0,0,0,266,A
3-PA,1898,0,265,0,0,265,T
3-PA,1899,0,265,0,0,265,T
3-PA,1900,0,1,266,0,267,G
3-PA,1901,0,0,264,0,264,G
3-PA,1902,0,0,265,0,265,G
3-PA,1903,266,0,0,0,266,A
3-PA,1904,262,0,0,0,262,A
3-PA,1905,265,0,0,0,265,A
3-PA,1906,0,0,274,0,274,G
3-PA,1907,0,273,0,0,273,T
3-PA,1908,0,0,0,278,278,C
3-PA,1909,0,277,0,1,278,T
3-PA,1910,0,0,279,0,279,G
3-PA,1911,0,278,0,0,278,T
3-PA,1912,278,0,0,0,278,A
3-PA,1913,0,1,278,0,279,G
3-PA,1914,0,1,276,0,277,G
3-PA,1915,265,0,0,0,265,A
3-PA,1916,0,0,0,266,266,C
3-PA,1917,1,254,0,0,255,T
3-PA,1918,1,0,1,267,269,C
3-PA,1919,0,267,0,0,267,T
3-PA,1920,267,0,0,0,267,A
3-PA,1921,0,269,0,0,269,T
3-PA,1922,0,269,0,0,269,T
3-PA,1923,0,0,270,0,270,G
3-PA,1924,0,0,269,0,269,G
3-PA,1925,0,0,0,267,267,C
3-PA,1926,0,265,0,0,265,T
3-PA,1927,248,0,0,0,248,A
3-PA,1928,251,0,0,0,251,A
3-PA,1929,0,0,252,0,252,G
3-PA,1930,0,253,0,0,253,T
3-PA,1931,1,0,0,252,253,C
3-PA,1932,244,0,0,0,244,A
3-PA,1933,0,0,253,0,253,G
3-PA,1934,1,252,0,0,253,T
3-PA,1935,260,0,1,0,261,A
3-PA,1936,0,261,0,1,262,T
3-PA,1937,0,266,0,0,266,T
3-PA,1938,0,0,0,262,262,C
3-PA,1939,263,0,0,0,263,A
3-PA,1940,262,0,0,0,262,A
3-PA,1941,0,263,0,0,263,T
3-PA,1942,257,0,0,0,257,A
3-PA,1943,0,0,258,0,258,G
3-PA,1944,0,0,0,254,254,C
3-PA,1945,0,0,0,253,253,C
3-PA,1946,0,252,0,0,252,T
3-PA,1947,0,0,259,0,259,G
3-PA,1948,0,259,0,0,259,T
3-PA,1949,260,0,0,0,260,A
3-PA,1950,0,258,0,1,259,T
3-PA,1951,0,0,253,0,253,G
3-PA,1952,0,0,0,250,250,C
3-PA,1953,244,0,0,0,244,A
3-PA,1954,0,242,0,0,242,T
3-PA,1955,0,0,0,243,243,C
3-PA,1956,236,0,0,0,236,A
3-PA,1957,0,0,0,238,238,C
3-PA,1958,0,0,0,239,239,C
3-PA,1959,239,0,0,0,239,A
3-PA,1960,0,0,0,239,239,C
3-PA,1961,234,0,0,0,234,A
3-PA,1962,232,0,1,0,233,A
3-PA,1963,0,235,0,1,236,T
3-PA,1964,0,236,0,0,236,T
3-PA,1965,0,0,233,0,233,G
3-PA,1966,0,0,233,0,233,G
3-PA,1967,230,0,1,0,231,A
3-PA,1968,231,0,1,0,232,A
3-PA,1969,0,0,231,0,231,G
3-PA,1970,0,1,231,0,232,G
3-PA,1971,231,0,0,0,231,A
3-PA,1972,0,231,0,0,231,T
3-PA,1973,0,231,0,0,231,T
3-PA,1974,0,231,0,0,231,T
3-PA,1975,0,231,0,0,231,T
3-PA,1976,0,0,0,230,230,C
3-PA,1977,230,0,0,0,230,A
3-PA,1978,0,0,231,0,231,G
3-PA,1979,0,0,0,230,230,C
3-PA,1980,0,0,229,0,229,G
3-PA,1981,0,1,228,0,229,G
3-PA,1982,230,0,0,0,230,A
3-PA,1983,0,0,235,0,235,G
3-PA,1984,0,234,0,1,235,T
3-PA,1985,0,0,0,236,236,C
3-PA,1986,237,0,1,0,238,A
3-PA,1987,237,0,0,0,237,A
3-PA,1988,0,0,239,0,239,G
3-PA,1989,239,0,0,0,239,A
3-PA,1990,236,0,0,0,236,A
3-PA,1991,237,0,0,0,237,A
3-PA,1992,232,0,0,0,232,A
3-PA,1993,1,0,0,232,233,C
3-PA,1994,0,229,0,0,229,T
3-PA,1995,0,0,231,0,231,G
3-PA,1996,0,0,0,230,230,C
3-PA,1997,0,228,0,1,229,T
3-PA,1998,1,0,0,229,230,C
3-PA,1999,0,0,0,228,228,C
3-PA,2000,0,227,0,0,227,T
3-PA,2001,0,227,0,0,227,T
3-PA,2002,0,0,226,0,226,G
3-PA,2003,0,226,0,1,227,T
3-PA,2004,0,222,0,1,223,T
3-PA,2005,0,0,224,0,224,G
3-PA,2006,0,224,0,0,224,T
3-PA,2007,0,221,0,1,222,T
3-PA,2008,0,0,0,224,224,C
3-PA,2009,220,0,0,0,220,A
3-PA,2010,0,0,221,0,221,G
3-PA,2011,0,0,221,0,221,G
3-PA,2012,0,0,0,221,221,C
3-PA,2013,0,222,0,0,222,T
3-PA,2014,0,0,0,221,221,C
3-PA,2015,0,224,0,0,224,T
3-PA,2016,0,223,0,0,223,T
3-PA,2017,224,0,0,0,224,A
3-PA,2018,0,2,222,0,224,G
3-PA,2019,0,0,219,0,219,G
3-PA,2020,0,0,219,0,219,G
3-PA,2021,212,0,1,0,213,A
3-PA,2022,1,0,0,212,213,C
3-PA,2023,194,0,1,0,195,A
3-PA,2024,198,0,0,0,198,A
3-PA,2025,0,0,0,202,202,C
3-PA,2026,0,0,0,198,198,C
3-PA,2027,0,197,0,0,197,T
3-PA,2028,0,0,0,195,195,C
3-PA,2029,1,0,195,0,196,G
3-PA,2030,195,0,0,0,195,A
3-PA,2031,197,0,0,0,197,A
3-PA,2032,0,0,0,197,197,C
3-PA,2033,0,0,0,193,193,C
3-PA,2034,0,188,0,0,188,T
3-PA,2035,0,1,186,0,187,G
3-PA,2036,0,0,186,0,186,G
3-PA,2037,0,0,185,0,185,G
3-PA,2038,185,0,1,0,186,A
3-PA,2039,0,0,0,185,185,C
3-PA,2040,1,1,0,183,185,C
3-PA,2041,0,178,0,2,180,T
3-PA,2042,1,178,0,0,179,T
3-PA,2043,0,178,0,0,178,T
3-PA,2044,0,0,179,0,179,G
3-PA,2045,180,0,1,0,181,A
3-PA,2046,0,179,0,0,179,T
3-PA,2047,0,1,0,179,180,C
3-PA,2048,0,173,0,0,173,T
3-PA,2049,0,173,0,0,173,T
3-PA,2050,0,1,173,0,174,G
3-PA,2051,0,1,171,0,172,G
3-PA,2052,0,0,173,0,173,G
3-PA,2053,0,1,171,0,172,G
3-PA,2054,0,0,167,0,167,G
3-PA,2055,0,0,168,0,168,G
3-PA,2056,0,0,0,169,169,C
3-PA,2057,0,166,0,0,166,T
3-PA,2058,173,0,0,0,173,A
3-PA,2059,0,174,0,0,174,T
3-PA,2060,175,0,0,0,175,A
3-PA,2061,0,173,0,0,173,T
3-PA,2062,0,0,164,0,164,G
3-PA,2063,160,0,0,0,160,A
3-PA,2064,161,0,0,0,161,A
3-PA,2065,0,0,159,0,159,G
3-PA,2066,0,0,0,163,163,C
3-PA,2067,157,0,0,0,157,A
3-PA,2068,162,0,0,1,163,A
3-PA,2069,0,164,0,0,164,T
3-PA,2070,0,164,0,0,164,T
3-PA,2071,0,0,165,0,165,G
3-PA,2072,164,0,0,0,164,A
3-PA,2073,0,0,164,0,164,G
3-PA,2074,0,0,164,0,164,G
3-PA,2075,159,0,0,0,159,A
3-PA,2076,0,0,159,0,159,G
3-PA,2077,0,146,0,0,146,T
3-PA,2078,0,0,146,0,146,G
3-PA,2079,0,0,0,144,144,C
3-PA,2080,0,0,0,145,145,C
3-PA,2081,0,143,0,1,144,T
3-PA,2082,0,1,147,0,148,G
3-PA,2083,148,0,0,0,148,A
3-PA,2084,0,147,0,0,147,T
3-PA,2085,0,139,0,1,140,T
3-PA,2086,137,0,0,0,137,A
3-PA,2087,137,0,0,0,137,A
3-PA,2088,0,136,0,0,136,T
3-PA,2089,0,0,136,0,136,G
3-PA,2090,136,0,0,0,136,A
3-PA,2091,0,131,0,0,131,T
3-PA,2092,0,0,0,133,133,C
3-PA,2093,0,0,0,130,130,C
3-PA,2094,0,0,0,131,131,C
3-PA,2095,0,129,0,0,129,T
3-PA,2096,0,1,129,0,130,G
3-PA,2097,0,1,129,0,130,G
3-PA,2098,0,0,130,0,130,G
3-PA,2099,0,128,0,0,128,T
3-PA,2100,0,125,0,0,125,T
3-PA,2101,0,123,0,2,125,T
3-PA,2102,0,124,0,0,124,T
3-PA,2103,0,0,125,0,125,G
3-PA,2104,0,0,0,125,125,C
3-PA,2105,0,124,0,0,124,T
3-PA,2106,0,0,0,124,124,C
3-PA,2107,121,0,0,0,121,A
3-PA,2108,121,0,0,0,121,A
3-PA,2109,0,121,0,0,121,T
3-PA,2110,0,0,121,0,121,G
3-PA,2111,0,0,0,121,121,C
3-PA,2112,0,0,118,0,118,G
3-PA,2113,0,118,0,0,118,T
3-PA,2114,0,0,0,118,118,C
3-PA,2115,0,117,0,0,117,T
3-PA,2116,0,117,0,0,117,T
3-PA,2117,0,0,114,0,114,G
3-PA,2118,0,0,115,0,115,G
3-PA,2119,0,112,0,1,113,T
3-PA,2120,0,111,0,2,113,T
3-PA,2121,1,0,0,112,113,C
3-PA,2122,110,0,0,0,110,A
3-PA,2123,111,0,0,0,111,A
3-PA,2124,0,0,0,110,110,C
3-PA,2125,0,108,0,0,108,T
3-PA,2126,0,0,0,109,109,C
3-PA,2127,0,0,0,107,107,C
3-PA,2128,0,107,0,0,107,T
3-PA,2129,0,107,0,0,107,T
3-PA,2130,0,0,0,106,106,C
3-PA,2131,0,0,0,106,106,C
3-PA,2132,0,101,0,0,101,T
3-PA,2133,0,0,102,0,102,G
3-PA,2134,101,0,1,0,102,A
3-PA,2135,1,0,0,100,101,C
3-PA,2136,93,0,1,0,94,A
3-PA,2137,0,0,0,88,88,C
3-PA,2138,87,0,0,0,87,A
3-PA,2139,0,86,0,0,86,T
3-PA,2140,1,0,85,0,86,G
3-PA,2141,0,0,0,86,86,C
3-PA,2142,84,0,0,0,84,A
3-PA,2143,0,84,0,0,84,T
3-PA,2144,0,83,0,0,83,T
3-PA,2145,83,0,0,0,83,A
3-PA,2146,82,0,1,0,83,A
3-PA,2147,82,0,0,0,82,A
3-PA,2148,83,0,0,0,83,A
3-PA,2149,0,82,0,0,82,T
3-PA,2150,60,0,0,0,60,A
3-PA,2151,0,0,60,0,60,G
4-HA,1,311,0,0,0,311,A
4-HA,2,0,311,0,0,311,T
4-HA,3,0,0,316,0,316,G
4-HA,4,321,0,0,0,321,A
4-HA,5,322,0,0,0,322,A
4-HA,6,0,0,354,0,354,G
4-HA,7,351,0,1,0,352,A
4-HA,8,0,0,0,382,382,C
4-HA,9,0,386,0,0,386,T
4-HA,10,401,0,0,0,401,A
4-HA,11,0,431,0,1,432,T
4-HA,12,1,0,0,434,435,C
4-HA,13,436,0,0,0,436,A
4-HA,14,0,437,0,0,437,T
4-HA,15,0,439,0,0,439,T
4-HA,16,0,0,490,0,490,G
4-HA,17,0,1,0,489,490,C
4-HA,18,0,491,0,1,492,T
4-HA,19,0,492,0,0,492,T
4-HA,20,0,490,0,0,490,T
4-HA,21,0,1,522,0,523,G
4-HA,22,525,1,0,0,526,A
4-HA,23,0,0,541,0,541,G
4-HA,24,0,0,0,544,544,C
4-HA,25,0,543,0,0,543,T
4-HA,26,581,0,0,0,581,A
4-HA,27,1,0,0,588,589,C
4-HA,28,604,0,0,0,604,A
4-HA,29,1,641,0,1,643,T
4-HA,30,0,639,0,1,640,T
4-HA,31,0,0,0,646,646,C
4-HA,32,0,645,0,0,645,T
4-HA,33,651,0,0,0,651,A
4-HA,34,0,649,0,0,649,T
4-HA,35,0,0,657,0,657,G
4-HA,36,0,659,0,0,659,T
4-HA,37,3,0,0,655,658,C
4-HA,38,1,654,0,1,656,T
4-HA,39,0,1,657,0,658,G
4-HA,40,0,0,650,0,650,G
4-HA,41,0,654,0,0,654,T
4-HA,42,0,659,0,0,659,T
4-HA,43,0,656,0,0,656,T
4-HA,44,0,656,0,1,657,T
4-HA,45,1,0,0,655,656,C
4-HA,46,0,0,657,0,657,G
4-HA,47,1,1,0,670,672,C
4-HA,48,0,665,0,2,667,T
4-HA,49,1,0,0,674,675,C
4-HA,50,677,1,0,0,678,A
4-HA,51,676,0,0,0,676,A
4-HA,52,679,0,0,0,679,A
4-HA,53,682,0,0,0,682,A
4-HA,54,682,0,2,0,684,A
4-HA,55,0,0,0,690,690,C
4-HA,56,0,688,0,1,689,T
4-HA,57,0,688,0,0,688,T
4-HA,58,1,1,0,688,690,C
4-HA,59,0,0,0,689,689,C
4-HA,60,0,686,0,1,687,T
4-HA,61,0,0,698,0,698,G
4-HA,62,0,3,693,0,696,G
4-HA,63,698,1,1,0,700,A
4-HA,64,712,0,0,0,712,A
4-HA,65,713,0,0,0,713,A
4-HA,66,0,722,0,0,722,T
4-HA,67,0,3,725,0,728,G
4-HA,68,724,0,4,0,728,A
4-HA,69,1,0,0,740,741,C
4-HA,70,739,0,1,0,740,A
4-HA,71,738,0,0,0,738,A
4-HA,72,0,0,1,761,762,C
4-HA,73,759,0,0,0,759,A
4-HA,74,0,1,764,0,765,G
4-HA,75,0,0,0,768,768,C
4-HA,76,768,0,1,0,769,A
4-HA,77,0,0,0,789,789,C
4-HA,78,0,0,786,0,786,G
4-HA,79,0,1,801,0,802,G
4-HA,80,0,0,0,801,801,C
4-HA,81,797,0,1,0,798,A
4-HA,82,808,0,0,0,808,A
4-HA,83,0,0,0,816,816,C
4-HA,84,0,0,822,0,822,G
4-HA,85,1,0,0,822,823,C
4-HA,86,0,807,0,1,808,T
4-HA,87,0,1,828,0,829,G
4-HA,88,0,827,0,1,828,T
4-HA,89,2,0,859,0,861,G
4-HA,90,0,2,0,877,879,C
4-HA,91,0,0,0,898,898,C
4-HA,92,0,899,0,1,900,T
4-HA,93,0,898,0,1,899,T
4-HA,94,0,2,901,0,903,G
4-HA,95,0,2,905,0,907,G
4-HA,96,0,0,919,0,919,G
4-HA,97,0,0,0,923,923,C
4-HA,98,908,0,1,0,909,A
4-HA,99,0,2,0,921,923,C
4-HA,100,3,0,0,910,913,C
4-HA,101,992,0,0,0,992,A
4-HA,102,0,995,0,1,996,T
4-HA,103,0,0,998,0,998,G
4-HA,104,0,0,0,1002,1002,C
4-HA,105,991,0,0,0,991,A
4-HA,106,0,1,1063,0,1064,G
4-HA,107,0,1063,0,2,1065,T
4-HA,108,1072,0,0,0,1072,A
4-HA,109,1,0,0,1068,1069,C
4-HA,110,0,0,0,1046,1046,C
4-HA,111,1050,0,1,0,1051,A
4-HA,112,1051,0,0,0,1051,A
4-HA,113,1050,0,0,0,1050,A
4-HA,114,0,2,0,1057,1059,C
4-HA,115,1,2,1041,0,1044,G
4-HA,116,0,0,1078,0,1078,G
4-HA,117,1074,0,1,0,1075,A
4-HA,118,1076,0,1,0,1077,A
4-HA,119,0,0,0,1077,1077,C
4-HA,120,1066,0,0,0,1066,A
4-HA,121,1091,1,0,0,1092,A
4-HA,122,0,1092,0,0,1092,T
4-HA,123,1104,0,1,1,1106,A
4-HA,124,0,0,1109,0,1109,G
4-HA,125,1,1099,0,0,1100,T
4-HA,126,0,1,1101,0,1102,G
4-HA,127,1094,1,2,0,1097,A
4-HA,128,1104,0,2,0,1106,A
4-HA,129,1102,0,2,0,1104,A
4-HA,130,1102,1,1,0,1104,A
4-HA,131,0,0,0,1128,1128,C
4-HA,132,1124,0,2,1,1127,A
4-HA,133,1133,0,0,1,1134,A
4-HA,134,0,1129,0,0,1129,T
4-HA,135,1,1,0,1128,1130,C
4-HA,136,1132,0,0,0,1132,A
4-HA,137,0,0,0,1136,1136,C
4-HA,138,0,4,1132,0,1136,G
4-HA,139,1133,0,3,0,1136,A
4-HA,140,1130,2,2,0,1134,A
4-HA,141,0,1135,0,0,1135,T
4-HA,142,0,4,1132,0,1136,G
4-HA,143,1135,1,6,0,1142,A
4-HA,144,0,0,0,1138,1138,C
4-HA,145,1,1,0,1136,1138,C
4-HA,146,1152,0,0,0,1152,A
4-HA,147,1156,1,1,0,1158,A
4-HA,148,1156,1,0,0,1157,A
4-HA,149,0,1158,0,0,1158,T
4-HA,150,1,1154,0,0,1155,T
4-HA,151,0,0,1160,0,1160,G
4-HA,152,1161,0,3,0,1164,A
4-HA,153,1165,0,2,0,1167,A
4-HA,154,0,0,1170,0,1170,G
4-HA,155,0,1167,0,2,1169,T
4-HA,156,0,1197,0,0,1197,T
4-HA,157,1198,0,0,1,1199,A
4-HA,158,0,0,0,1201,1201,C
4-HA,159,0,1206,0,0,1206,T
4-HA,160,1206,0,1,0,1207,A
4-HA,161,1223,0,1,0,1224,A
4-HA,162,0,1226,0,0,1226,T
4-HA,163,0,0,1223,0,1223,G
4-HA,164,0,0,0,1281,1281,C
4-HA,165,0,1270,0,1,1271,T
4-HA,166,1278,0,2,0,1280,A
4-HA,167,0,1,0,1276,1277,C
4-HA,168,0,1273,0,0,1273,T
4-HA,169,1,6,1265,0,1272,G
4-HA,170,1265,1,0,0,1266,A
4-HA,171,1,0,1272,0,1273,G
4-HA,172,0,0,0,1268,1268,C
4-HA,173,0,1248,0,0,1248,T
4-HA,174,0,2,1282,1,1285,G
4-HA,175,2,0,1290,0,1292,G
4-HA,176,0,1291,0,2,1293,T
4-HA,177,0,1295,0,3,1298,T
4-HA,178,3,2,0,1290,1295,C
4-HA,179,1290,2,0,0,1292,A
4-HA,180,0,3,1291,1,1295,G
4-HA,181,1295,0,3,0,1298,A
4-HA,182,0,0,1323,0,1323,G
4-HA,183,0,1310,0,1,1311,T
4-HA,184,0,1290,0,0,1290,T
4-HA,185,4,1,0,1294,1299,C
4-HA,186,2,0,0,1302,1304,C
4-HA,187,0,1296,0,0,1296,T
4-HA,188,0,2,0,1313,1315,C
4-HA,189,1311,0,0,0,1311,A
4-HA,190,1309,1,1,0,1311,A
4-HA,191,0,0,0,1319,1319,C
4-HA,192,1302,1,2,0,1305,A
4-HA,193,0,1,1318,1,1320,G
4-HA,194,0,0,1322,1,1323,G
4-HA,195,0,1316,0,1,1317,T
4-HA,196,0,0,1322,0,1322,G
4-HA,197,1323,1,1,0,1325,A
4-HA,198,1325,0,0,0,1325,A
4-HA,199,1365,0,0,0,1365,A
4-HA,200,0,1355,0,1,1356,T
4-HA,201,1376,0,0,0,1376,A
4-HA,202,0,1359,0,0,1359,T
4-HA,203,0,0,1355,0,1355,G
4-HA,204,0,8,0,1358,1366,C
4-HA,205,0,5,1355,0,1360,G
4-HA,206,1361,0,2,0,1363,A
4-HA,207,0,1,0,1363,1364,C
4-HA,208,1345,0,0,0,1345,A
4-HA,209,1,1,1427,0,1429,G
4-HA,210,0,1419,1,1,1421,T
4-HA,211,0,0,0,1429,1429,C
4-HA,212,2,1,0,1424,1427,C
4-HA,213,1,1419,0,1,1421,T
4-HA,214,1,0,0,1446,1447,C
4-HA,215,1441,0,1,0,1442,A
4-HA,216,0,1438,0,2,1440,T
4-HA,217,3,1,0,1439,1443,C
4-HA,218,1372,0,3,0,1375,A
4-HA,219,0,4,1381,0,1385,G
4-HA,220,1377,0,1,0,1378,A
4-HA,221,1,1377,0,2,1380,T
4-HA,222,2,0,0,1389,1391,C
4-HA,223,1,0,0,1385,1386,C
4-HA,224,0,1387,0,5,1392,T
4-HA,225,0,1393,0,1,1394,T
4-HA,226,0,0,1391,0,1391,G
4-HA,227,1403,0,1,0,1404,A
4-HA,228,0,1394,0,3,1397,T
4-HA,229,1,3,1410,0,1414,G
4-HA,230,0,1,1410,1,1412,G
4-HA,231,1392,0,4,0,1396,A
4-HA,232,0,1,1401,0,1402,G
4-HA,233,1385,0,2,1,1388,A
4-HA,234,0,4,1372,0,1376,G
4-HA,235,1407,0,1,0,1408,A
4-HA,236,1413,0,0,0,1413,A
4-HA,237,0,0,0,1424,1424,C
4-HA,238,0,1406,0,0,1406,T
4-HA,239,1,0,1421,0,1422,G
4-HA,240,0,0,0,1414,1414,C
4-HA,241,1419,0,2,0,1421,A
4-HA,242,1,0,0,1449,1450,C
4-HA,243,1431,1,1,0,1433,A
4-HA,244,0,0,1,1606,1607,C
4-HA,245,0,1603,0,1,1604,T
4-HA,246,1616,0,0,0,1616,A
4-HA,247,1610,0,2,0,1612,A
4-HA,248,1,1608,0,0,1609,T
4-HA,249,1608,1,0,0,1609,A
4-HA,250,0,3,1607,0,1610,G
4-HA,251,1578,0,2,0,1580,A
4-HA,252,0,1565,1,0,1566,T
4-HA,253,0,0,1485,0,1485,G
4-HA,254,0,0,0,1505,1505,C
4-HA,255,0,1494,0,3,1497,T
4-HA,256,1,0,0,1625,1626,C
4-HA,257,1,1628,0,0,1629,T
4-HA,258,1677,0,0,0,1677,A
4-HA,259,0,1675,0,0,1675,T
4-HA,260,0,1674,0,1,1675,T
4-HA,261,0,8,1684,0,1692,G
4-HA,262,0,1,1693,0,1694,G
4-HA,263,2,1,1699,1,1703,G
4-HA,264,1682,0,4,0,1686,A
4-HA,265,0,2,1667,0,1669,G
4-HA,266,1633,1,1,0,1635,A
4-HA,267,0,2,0,1881,1883,C
4-HA,268,1,0,0,1928,1929,C
4-HA,269,5,2,0,1955,1962,C
4-HA,270,0,1960,0,3,1963,T
4-HA,271,1,0,0,1987,1988,C
4-HA,272,1987,0,2,1,1990,A
4-HA,273,1576,0,482,0,2058,A
4-HA,274,0,2113,0,0,2113,T
4-HA,275,0,1,2144,0,2145,G
4-HA,276,0,2143,0,3,2146,T
4-HA,277,0,1,2142,0,2143,G
4-HA,278,2140,1,2,0,2143,A
4-HA,279,0,2142,0,0,2142,T
4-HA,280,2,1,2124,0,2127,G
4-HA,281,0,0,2134,0,2134,G
4-HA,282,0,1,0,2125,2126,C
4-HA,283,0,2133,0,2,2135,T
4-HA,284,0,2134,0,2,2136,T
4-HA,285,1,0,0,2138,2139,C
4-HA,286,2,2,0,2135,2139,C
4-HA,287,2137,0,4,1,2142,A
4-HA,288,2145,0,1,0,2146,A
4-HA,289,2150,0,1,0,2151,A
4-HA,290,2167,1,2,0,2170,A
4-HA,291,0,2177,0,0,2177,T
4-HA,292,2179,0,1,0,2180,A
4-HA,293,2178,1,0,0,2179,A
4-HA,294,1,5,2188,0,2194,G
4-HA,295,2218,0,2,0,2220,A
4-HA,296,2221,0,1,0,2222,A
4-HA,297,2211,1,3,1,2216,A
4-HA,298,1,2217,1,1,2220,T
4-HA,299,0,2,2216,0,2218,G
4-HA,300,1,5,2219,0,2225,G
4-HA,301,1,5,2210,1,2217,G
4-HA,302,2223,0,3,0,2226,A
4-HA,303,0,0,0,2239,2239,C
4-HA,304,0,2,0,2230,2232,C
4-HA,305,2,2263,1,6,2272,T
4-HA,306,0,2276,1,1,2278,T
4-HA,307,0,2272,1,3,2276,T
4-HA,308,0,2297,0,2,2299,T
4-HA,309,0,2300,0,0,2300,T
4-HA,310,0,0,2316,0,2316,G
4-HA,311,0,2306,1,2,2309,T
4-HA,312,0,2303,1,1,2305,T
4-HA,313,0,0,2305,0,2305,G
4-HA,314,2295,0,2,0,2297,A
4-HA,315,2304,0,0,0,2304,A
4-HA,316,3,0,0,2305,2308,C
4-HA,317,2,0,2296,0,2298,G
4-HA,318,0,0,0,2348,2348,C
4-HA,319,2339,0,2,0,2341,A
4-HA,320,1,1,2350,1,2353,G
4-HA,321,0,0,0,2358,2358,C
4-HA,322,2352,0,2,0,2354,A
4-HA,323,2360,0,2,0,2362,A
4-HA,324,2367,0,3,1,2371,A
4-HA,325,1,0,2481,0,2482,G
4-HA,326,2,0,0,2476,2478,C
4-HA,327,2,0,0,2473,2475,C
4-HA,328,2,2476,0,2,2480,T
4-HA,329,2473,0,3,0,2476,A
4-HA,330,2,3,0,2502,2507,C
4-HA,331,2502,0,0,0,2502,A
4-HA,332,0,1,2506,0,2507,G
4-HA,333,1,0,0,2503,2504,C
4-HA,334,2448,0,3,0,2451,A
4-HA,335,2482,0,2,0,2484,A
4-HA,336,0,3,0,2602,2605,C
4-HA,337,1,2592,0,1,2594,T
4-HA,338,0,1,2609,0,2610,G
4-HA,339,1,2585,1,3,2590,T
4-HA,340,0,2585,0,2,2587,T
4-HA,341,2596,0,1,0,2597,A
4-HA,342,1,1,1,2845,2848,C
4-HA,343,6,0,0,2855,2861,C
4-HA,344,8,0,0,2912,2920,C
4-HA,345,0,2829,0,2,2831,T
4-HA,346,0,2837,0,4,2841,T
4-HA,347,2855,0,0,0,2855,A
4-HA,348,0,2851,0,1,2852,T
4-HA,349,3,4,2846,0,2853,G
4-HA,350,2844,0,4,0,2848,A
4-HA,351,0,2671,0,2,2673,T
4-HA,352,1,1,2713,0,2715,G
4-HA,353,0,2676,0,2,2678,T
4-HA,354,0,1,2671,0,2672,G
4-HA,355,2,0,0,2680,2682,C
4-HA,356,11,1,0,2670,2682,C
4-HA,357,4,7,2720,1,2732,G
4-HA,358,0,3,2764,0,2767,G
4-HA,359,2768,2,1,0,2771,A
4-HA,360,0,2774,0,3,2777,T
4-HA,361,0,2738,0,0,2738,T
4-HA,362,2758,0,1,0,2759,A
4-HA,363,1,2752,0,4,2757,T
4-HA,364,2,0,2758,0,2760,G
4-HA,365,1,0,0,2760,2761,C
4-HA,366,3,0,0,2739,2742,C
4-HA,367,1,2742,0,5,2748,T
4-HA,368,4,1,0,2893,2898,C
4-HA,369,1,1,0,2920,2922,C
4-HA,370,6,1,0,2924,2931,C
4-HA,371,1,2902,0,6,2909,T
4-HA,372,1,2915,0,5,2921,T
4-HA,373,2911,1,1,0,2913,A
4-HA,374,0,4,2992,0,2996,G
4-HA,375,0,1,2999,0,3000,G
4-HA,376,1,2951,0,3,2955,T
4-HA,377,8,0,0,2889,2897,C
4-HA,378,2869,0,1,0,2870,A
4-HA,379,2,1,0,2936,2939,C
4-HA,380,0,2940,1,0,2941,T
4-HA,381,2942,0,3,0,2945,A
4-HA,382,1,1,2944,0,2946,G
4-HA,383,2,2908,0,2,2912,T
4-HA,384,0,2901,0,3,2904,T
4-HA,385,3,1,2937,2,2943,G
4-HA,386,2,2,0,2936,2940,C
4-HA,387,4,0,0,2938,2942,C
4-HA,388,2,2902,0,5,2909,T
4-HA,389,4,1,0,2926,2931,C
4-HA,390,3031,0,0,0,3031,A
4-HA,391,2,3030,0,3,3035,T
4-HA,392,4,2,0,3036,3042,C
4-HA,393,2,5,0,3040,3047,C
4-HA,394,2,9,3011,0,3022,G
4-HA,395,1,1,3041,0,3043,G
4-HA,396,0,1,1,3056,3058,C
4-HA,397,3083,0,1,0,3084,A
4-HA,398,0,1,0,3132,3133,C
4-HA,399,3062,0,4,0,3066,A
4-HA,400,1,1,0,3077,3079,C
4-HA,401,1,3068,0,6,3075,T
4-HA,402,0,2,3085,1,3088,G
4-HA,403,0,4,3099,0,3103,G
4-HA,404,3091,0,7,0,3098,A
4-HA,405,0,0,3134,0,3134,G
4-HA,406,1,3103,0,1,3105,T
4-HA,407,1,3084,1,0,3086,T
4-HA,408,1,3092,0,5,3098,T
4-HA,409,3073,0,1,1,3075,A
4-HA,410,3076,1,3,0,3080,A
4-HA,411,1,1,0,3102,3104,C
4-HA,412,3059,0,0,0,3059,A
4-HA,413,3058,0,4,0,3062,A
4-HA,414,0,3039,0,2,3041,T
4-HA,415,0,6,3036,0,3042,G
4-HA,416,3035,0,3,0,3038,A
4-HA,417,3030,0,0,0,3030,A
4-HA,418,3042,0,4,0,3046,A
4-HA,419,0,1,3055,0,3056,G
4-HA,420,2,2,0,3062,3066,C
4-HA,421,1,3054,0,6,3061,T
4-HA,422,0,3063,1,2,3066,T
4-HA,423,2,1,0,3087,3090,C
4-HA,424,3087,0,5,0,3092,A
4-HA,425,3093,1,2,0,3096,A
4-HA,426,0,3097,0,5,3102,T
4-HA,427,0,3095,0,1,3096,T
4-HA,428,1,8,3125,0,3134,G
4-HA,429,0,3,3185,0,3188,G
4-HA,430,3188,2,3,0,3193,A
4-HA,431,0,2,0,3196,3198,C
4-HA,432,0,3163,0,7,3170,T
4-HA,433,0,6,3172,0,3178,G
4-HA,434,0,1,3208,0,3209,G
4-HA,435,3201,0,2,0,3203,A
4-HA,436,1,1,3204,0,3206,G
4-HA,437,0,3147,0,6,3153,T
4-HA,438,4,1,1,3103,3109,C
4-HA,439,3150,0,2,0,3152,A
4-HA,440,1,0,0,3158,3159,C
4-HA,441,0,3155,0,0,3155,T
4-HA,442,6,0,0,3142,3148,C
4-HA,443,3118,0,1,0,3119,A
4-HA,444,3144,1,0,0,3145,A
4-HA,445,3132,0,0,0,3132,A
4-HA,446,3139,3,2,0,3144,A
4-HA,447,1,0,0,3144,3145,C
4-HA,448,0,3,3098,0,3101,G
4-HA,449,1,3,3155,0,3159,G
4-HA,450,3157,1,2,0,3160,A
4-HA,451,3156,0,1,1,3158,A
4-HA,452,0,0,0,3158,3158,C
4-HA,453,3139,1,3,0,3143,A
4-HA,454,3165,0,3,5,3173,A
4-HA,455,0,1,3203,0,3204,G
4-HA,456,1,0,0,3205,3206,C
4-HA,457,0,3176,0,7,3183,T
4-HA,458,5,1,0,3197,3203,C
4-HA,459,1,3182,0,2,3185,T
4-HA,460,2,1,3204,0,3207,G
4-HA,461,0,3,0,3200,3203,C
4-HA,462,1,3192,0,5,3198,T
4-HA,463,0,3265,0,4,3269,T
4-HA,464,2,0,3331,0,3333,G
4-HA,465,2,3,0,3363,3368,C
4-HA,466,3362,0,4,0,3366,A
4-HA,467,0,3351,0,1,3352,T
4-HA,468,3336,0,1,0,3337,A
4-HA,469,3322,0,2,0,3324,A
4-HA,470,1,3,3327,0,3331,G
4-HA,471,0,3,3333,0,3336,G
4-HA,472,3216,0,1,0,3217,A
4-HA,473,1,1,3193,0,3195,G
4-HA,474,3181,1,3,0,3185,A
4-HA,475,0,3314,0,0,3314,T
4-HA,476,2,2,0,3343,3347,C
4-HA,477,0,3360,0,2,3362,T
4-HA,478,3366,0,0,0,3366,A
4-HA,479,3359,0,4,0,3363,A
4-HA,480,1,3357,0,0,3358,T
4-HA,481,3370,0,2,0,3372,A
4-HA,482,3326,3,1,0,3330,A
4-HA,483,0,5,0,3349,3354,C
4-HA,484,3248,0,0,0,3248,A
4-HA,485,1,0,3302,0,3303,G
4-HA,486,0,3264,0,4,3268,T
4-HA,487,0,3319,0,0,3319,T
4-HA,488,0,3319,0,1,3320,T
4-HA,489,2,2,0,3406,3410,C
4-HA,490,0,3402,0,4,3406,T
4-HA,491,0,3416,0,4,3420,T
4-HA,492,0,3416,0,2,3418,T
4-HA,493,3407,0,0,0,3407,A
4-HA,494,1,2,3407,0,3410,G
4-HA,495,1,3395,0,1,3397,T
4-HA,496,3391,1,5,0,3397,A
4-HA,497,1,1,3405,0,3407,G
4-HA,498,3349,0,5,0,3354,A
4-HA,499,2,3353,0,7,3362,T
4-HA,500,1,3341,1,1,3344,T
4-HA,501,1,10,3394,0,3405,G
4-HA,502,3402,1,2,0,3405,A
4-HA,503,3402,0,2,1,3405,A
4-HA,504,0,3403,0,0,3403,T
4-HA,505,0,3389,0,0,3389,T
4-HA,506,2,5,3421,0,3428,G
4-HA,507,0,2,3421,0,3423,G
4-HA,508,1,3420,0,4,3425,T
4-HA,509,1,3406,0,3,3410,T
4-HA,510,0,9,3361,0,3370,G
4-HA,511,3374,2,4,1,3381,A
4-HA,512,1,3,0,3369,3373,C
4-HA,513,2,0,0,3354,3356,C
4-HA,514,9,0,0,3344,3353,C
4-HA,515,3335,2,3,8,3348,A
4-HA,516,0,0,0,3379,3379,C
4-HA,517,0,3379,0,0,3379,T
4-HA,518,1,3375,1,1,3378,T
4-HA,519,3372,2,0,0,3374,A
4-HA,520,3366,0,1,0,3367,A
4-HA,521,3364,1,1,0,3366,A
4-HA,522,3386,1,2,0,3389,A
4-HA,523,0,3455,0,0,3455,T
4-HA,524,0,3436,0,1,3437,T
4-HA,525,8,0,1,3468,3477,C
4-HA,526,3463,0,8,1,3472,A
4-HA,527,3468,1,4,0,3473,A
4-HA,528,3471,1,2,1,3475,A
4-HA,529,1,3474,0,2,3477,T
4-HA,530,3585,1,2,1,3589,A
4-HA,531,1,5,0,3585,3591,C
4-HA,532,4,3,0,3510,3517,C
4-HA,533,14,1,0,3508,3523,C
4-HA,534,3509,1,4,0,3514,A
4-HA,535,3,1,3663,0,3667,G
4-HA,536,7,2,0,3675,3684,C
4-HA,537,3682,0,1,0,3683,A
4-HA,538,0,3676,0,0,3676,T
4-HA,539,0,3616,1,1,3618,T
4-HA,540,4,11,3725,0,3740,G
4-HA,541,3747,0,1,1,3749,A
4-HA,542,3742,1,4,4,3751,A
4-HA,543,0,0,0,3750,3750,C
4-HA,544,6,2,3657,0,3665,G
4-HA,545,1,3695,0,3,3699,T
4-HA,546,0,8,3698,0,3706,G
4-HA,547,3703,0,4,0,3707,A
4-HA,548,1,1,0,3699,3701,C
4-HA,549,0,3602,0,1,3603,T
4-HA,550,3706,0,1,1,3708,A
4-HA,551,1,3696,0,2,3699,T
4-HA,552,5,1,3724,0,3730,G
4-HA,553,0,2,0,3720,3722,C
4-HA,554,5,1,1,3665,3672,C
4-HA,555,3669,2,3,0,3674,A
4-HA,556,3674,0,0,0,3674,A
4-HA,557,3711,1,8,1,3721,A
4-HA,558,3,2,0,3724,3729,C
4-HA,559,3650,2,1,0,3653,A
4-HA,560,3660,0,1,0,3661,A
4-HA,561,0,3636,0,4,3640,T
4-HA,562,1,13,3633,0,3647,G
4-HA,563,3639,2,4,1,3646,A
4-HA,564,3634,0,4,0,3638,A
4-HA,565,1,0,2,3586,3589,C
4-HA,566,3609,0,1,0,3610,A
4-HA,567,3632,0,3,0,3635,A
4-HA,568,1,3628,0,1,3630,T
4-HA,569,1,3631,0,1,3633,T
4-HA,570,1,3635,0,3,3639,T
4-HA,571,2,6,3612,0,3620,G
4-HA,572,3622,3,9,0,3634,A
4-HA,573,0,1,1,3632,3634,C
4-HA,574,3622,0,0,0,3622,A
4-HA,575,3643,0,2,0,3645,A
4-HA,576,3690,0,1,1,3692,A
4-HA,577,0,3718,0,3,3721,T
4-HA,578,0,3718,0,1,3719,T
4-HA,579,7,1,3741,0,3749,G
4-HA,580,0,3735,1,2,3738,T
4-HA,581,3743,1,3,1,3748,A
4-HA,582,2,2,0,3798,3802,C
4-HA,583,3817,0,3,0,3820,A
4-HA,584,0,3890,1,3,3894,T
4-HA,585,0,3843,2,0,3845,T
4-HA,586,0,3827,0,2,3829,T
4-HA,587,0,12,3804,0,3816,G
4-HA,588,0,10,3793,0,3803,G
4-HA,589,2,11,3788,1,3802,G
4-HA,590,1,14,3798,0,3813,G
4-HA,591,1,5,3752,0,3758,G
4-HA,592,1,8,3859,0,3868,G
4-HA,593,1,3816,2,8,3827,T
4-HA,594,1,3839,0,3,3843,T
4-HA,595,5,2,0,3838,3845,C
4-HA,596,3847,1,6,0,3854,A
4-HA,597,2,2,0,3868,3872,C
4-HA,598,5,0,0,3862,3867,C
4-HA,599,3869,0,3,0,3872,A
4-HA,600,2,1,0,3886,3889,C
4-HA,601,4,0,0,3830,3834,C
4-HA,602,11,4,0,3774,3789,C
4-HA,603,3,10,3788,2,3803,G
4-HA,604,3,5,3972,0,3980,G
4-HA,605,1,3,3989,0,3993,G
4-HA,606,2,3955,1,2,3960,T
4-HA,607,3967,0,1,0,3968,A
4-HA,608,0,13,1,3935,3949,C
4-HA,609,3,3,3882,0,3888,G
4-HA,610,1,2,3937,0,3940,G
4-HA,611,3944,1,1,0,3946,A
4-HA,612,0,2,0,3944,3946,C
4-HA,613,3723,0,0,0,3723,A
4-HA,614,3726,0,1,0,3727,A
4-HA,615,1,3723,0,3,3727,T
4-HA,616,1,7,3778,0,3786,G
4-HA,617,3796,0,5,0,3801,A
4-HA,618,1,1,0,3784,3786,C
4-HA,619,3,1,0,3744,3748,C
4-HA,620,3748,0,0,0,3748,A
4-HA,621,3736,0,3,0,3739,A
4-HA,622,3800,0,1,0,3801,A
4-HA,623,0,3808,0,1,3809,T
4-HA,624,1,1,0,3823,3825,C
4-HA,625,1,3722,0,3,3726,T
4-HA,626,1,3715,0,1,3717,T
4-HA,627,10,0,0,3745,3755,C
4-HA,628,4,2,0,3765,3771,C
4-HA,629,1,3752,0,5,3758,T
4-HA,630,1,0,3775,0,3776,G
4-HA,631,0,3720,0,6,3726,T
4-HA,632,3759,0,0,0,3759,A
4-HA,633,0,3739,0,5,3744,T
4-HA,634,2,2,3776,0,3780,G
4-HA,635,0,1,0,3788,3789,C
4-HA,636,0,3760,1,3,3764,T
4-HA,637,4,2,0,3760,3766,C
4-HA,638,3760,0,4,0,3764,A
4-HA,639,3756,0,7,0,3763,A
4-HA,640,2,1,3776,0,3779,G
4-HA,641,3,0,0,3781,3784,C
4-HA,642,3786,0,2,0,3788,A
4-HA,643,0,3762,1,0,3763,T
4-HA,644,3,2,0,3743,3748,C
4-HA,645,3735,1,5,1,3742,A
4-HA,646,1,1,3772,0,3774,G
4-HA,647,4,3,3777,0,3784,G
4-HA,648,3775,1,0,0,3776,A
4-HA,649,3746,0,7,0,3753,A
4-HA,650,3,6,3814,0,3823,G
4-HA,651,3818,0,4,0,3822,A
4-HA,652,3853,0,4,0,3857,A
4-HA,653,0,3875,1,4,3880,T
4-HA,654,11,0,0,3869,3880,C
4-HA,655,3848,1,1,0,3850,A
4-HA,656,1,1,1,3856,3859,C
4-HA,657,3849,1,3,0,3853,A
4-HA,658,1,0,3933,0,3934,G
4-HA,659,1,3878,0,2,3881,T
4-HA,660,6,1,0,3893,3900,C
4-HA,661,1,3833,0,8,3842,T
4-HA,662,4,1,0,3915,3920,C
4-HA,663,1,3922,0,6,3929,T
4-HA,664,3966,0,2,0,3968,A
4-HA,665,4,1,0,3951,3956,C
4-HA,666,9,3,0,3945,3957,C
4-HA,667,3899,0,0,0,3899,A
4-HA,668,3901,0,3,0,3904,A
4-HA,669,3890,2,2,0,3894,A
4-HA,670,3894,1,4,0,3899,A
4-HA,671,1,1,3891,1,3894,G
4-HA,672,3829,0,2,0,3831,A
4-HA,673,3811,0,3,1,3815,A
4-HA,674,1,2,3826,0,3829,G
4-HA,675,1,2,0,3829,3832,C
4-HA,676,8,1,0,3838,3847,C
4-HA,677,3838,1,1,0,3840,A
4-HA,678,3661,2,191,0,3854,A
4-HA,679,2,2,1,3849,3854,C
4-HA,680,3853,0,1,0,3854,A
4-HA,681,3851,1,2,2,3856,A
4-HA,682,3850,2,3,1,3856,A
4-HA,683,2,0,0,3932,3934,C
4-HA,684,0,3887,0,4,3891,T
4-HA,685,2,1,3900,0,3903,G
4-HA,686,0,3890,0,3,3893,T
4-HA,687,3892,0,1,0,3893,A
4-HA,688,3900,1,2,0,3903,A
4-HA,689,1,3870,1,2,3874,T
4-HA,690,5,2,2,3908,3917,C
4-HA,691,5,0,0,3912,3917,C
4-HA,692,7,1,1,3849,3858,C
4-HA,693,23,2,3851,0,3876,G
4-HA,694,3866,0,1,0,3867,A
4-HA,695,3869,0,4,0,3873,A
4-HA,696,1,3870,1,5,3877,T
4-HA,697,3879,1,2,0,3882,A
4-HA,698,3,3863,0,2,3868,T
4-HA,699,4,7,0,3825,3836,C
4-HA,700,10,8,3809,0,3827,G
4-HA,701,1,3,3911,0,3915,G
4-HA,702,3920,1,2,0,3923,A
4-HA,703,0,3954,0,2,3956,T
4-HA,704,5,0,0,3953,3958,C
4-HA,705,0,3946,0,12,3958,T
4-HA,706,3941,0,5,0,3946,A
4-HA,707,0,2,3967,0,3969,G
4-HA,708,3992,0,6,0,3998,A
4-HA,709,1,1,0,3983,3985,C
4-HA,710,12,1,0,3856,3869,C
4-HA,711,4,2,0,3852,3858,C
4-HA,712,3827,0,0,0,3827,A
4-HA,713,1,0,4043,0,4044,G
4-HA,714,4033,0,5,0,4038,A
4-HA,715,1,1,4085,0,4087,G
4-HA,716,0,4055,0,1,4056,T
4-HA,717,4018,0,2,0,4020,A
4-HA,718,4011,0,8,0,4019,A
4-HA,719,0,2,4082,0,4084,G
4-HA,720,0,11,4097,1,4109,G
4-HA,721,4059,0,1,0,4060,A
4-HA,722,3762,0,5,0,3767,A
4-HA,723,1,3749,0,2,3752,T
4-HA,724,3749,2,1,0,3752,A
4-HA,725,0,3745,1,2,3748,T
4-HA,726,1,1,0,3767,3769,C
4-HA,727,12,0,1,3760,3773,C
4-HA,728,6,0,0,3676,3682,C
4-HA,729,0,3659,0,1,3660,T
4-HA,730,3664,0,3,0,3667,A
4-HA,731,0,1,3674,0,3675,G
4-HA,732,2,3,0,3669,3674,C
4-HA,733,3602,0,1,0,3603,A
4-HA,734,0,5,3687,1,3693,G
4-HA,735,3647,1,4,0,3652,A
4-HA,736,3659,0,3,0,3662,A
4-HA,737,0,3669,0,0,3669,T
4-HA,738,3654,0,3,0,3657,A
4-HA,739,3671,0,5,0,3676,A
4-HA,740,0,2,3673,1,3676,G
4-HA,741,1,2,0,3679,3682,C
4-HA,742,3677,1,3,0,3681,A
4-HA,743,0,3564,1,6,3571,T
4-HA,744,4,0,0,3734,3738,C
4-HA,745,0,3727,0,1,3728,T
4-HA,746,3743,6,1,0,3750,A
4-HA,747,0,3739,0,4,3743,T
4-HA,748,0,3724,0,0,3724,T
4-HA,749,1,10,3729,0,3740,G
4-HA,750,2,1,3727,0,3730,G
4-HA,751,3719,1,6,0,3726,A
4-HA,752,0,2,0,3716,3718,C
4-HA,753,3355,0,2,0,3357,A
4-HA,754,3421,0,2,0,3423,A
4-HA,755,1,3606,0,0,3607,T
4-HA,756,3638,1,4,0,3643,A
4-HA,757,1,1,3705,0,3707,G
4-HA,758,0,3675,0,1,3676,T
4-HA,759,3678,0,2,1,3681,A
4-HA,760,3684,1,4,0,3689,A
4-HA,761,3751,0,6,0,3757,A
4-HA,762,3798,0,4,0,3802,A
4-HA,763,2,1,1,3831,3835,C
4-HA,764,4,1,0,3615,3620,C
4-HA,765,2,6,3611,2,3621,G
4-HA,766,2,4,3636,0,3642,G
4-HA,767,1,4,3689,0,3694,G
4-HA,768,3694,1,8,0,3703,A
4-HA,769,0,3,3742,0,3745,G
4-HA,770,3818,1,10,0,3829,A
4-HA,771,2,10,0,3822,3834,C
4-HA,772,3825,0,6,7,3838,A
4-HA,773,1,3844,0,2,3847,T
4-HA,774,3860,0,1,0,3861,A
4-HA,775,1,3,0,3946,3950,C
4-HA,776,1,3915,0,6,3922,T
4-HA,777,0,3955,0,5,3960,T
4-HA,778,0,3991,1,2,3994,T
4-HA,779,0,3970,0,8,3978,T
4-HA,780,2,5,4042,0,4049,G
4-HA,781,4064,3,5,2,4074,A
4-HA,782,0,4075,0,4,4079,T
4-HA,783,1,4223,0,3,4227,T
4-HA,784,4205,0,3,0,4208,A
4-HA,785,4219,0,5,0,4224,A
4-HA,786,0,1,0,4285,4286,C
4-HA,787,4278,0,2,0,4280,A
4-HA,788,2,3,4525,0,4530,G
4-HA,789,1,3,1,4497,4502,C
4-HA,790,4512,2,3,0,4517,A
4-HA,791,1,3,0,4558,4562,C
4-HA,792,4523,2,6,0,4531,A
4-HA,793,0,9,4617,1,4627,G
4-HA,794,1,3,4603,0,4607,G
4-HA,795,2,13,4807,0,4822,G
4-HA,796,4795,1,0,0,4796,A
4-HA,797,4854,0,13,0,4867,A
4-HA,798,0,4872,0,4,4876,T
4-HA,799,6,1,0,4886,4893,C
4-HA,800,0,4959,0,2,4961,T
4-HA,801,4975,0,7,0,4982,A
4-HA,802,4959,0,2,0,4961,A
4-HA,803,1,4947,1,3,4952,T
4-HA,804,1,4845,0,5,4851,T
4-HA,805,0,1,4903,0,4904,G
4-HA,806,6,1,2,5085,5094,C
4-HA,807,1,5271,0,9,5281,T
4-HA,808,10,2,0,5428,5440,C
4-HA,809,4,1,0,5448,5453,C
4-HA,810,1,5441,0,4,5446,T
4-HA,811,5457,0,1,0,5458,A
4-HA,812,1,12,5449,0,5462,G
4-HA,813,3,17,5511,0,5531,G
4-HA,814,2,6,5539,1,5548,G
4-HA,815,1,3,5492,1,5497,G
4-HA,816,0,5383,0,2,5385,T
4-HA,817,0,5350,0,2,5352,T
4-HA,818,5362,2,3,2,5369,A
4-HA,819,0,0,1,5472,5473,C
4-HA,820,1,5438,0,6,5445,T
4-HA,821,1,5482,1,0,5484,T
4-HA,822,3,1,0,5463,5467,C
4-HA,823,5451,1,3,1,5456,A
4-HA,824,5464,0,4,1,5469,A
4-HA,825,5478,1,3,0,5482,A
4-HA,826,5530,0,3,0,5533,A
4-HA,827,0,5532,0,1,5533,T
4-HA,828,5490,1,3,0,5494,A
4-HA,829,0,1,1,5493,5495,C
4-HA,830,0,8,5480,1,5489,G
4-HA,831,5494,0,4,1,5499,A
4-HA,832,5498,0,4,0,5502,A
4-HA,833,1,0,5573,0,5574,G
4-HA,834,41,5534,0,2,5577,T
4-HA,835,4,4,5625,0,5633,G
4-HA,836,5,10,5643,0,5658,G
4-HA,837,1,4,5671,0,5676,G
4-HA,838,5669,0,3,1,5673,A
4-HA,839,5668,0,7,0,5675,A
4-HA,840,5658,3,18,0,5679,A
4-HA,841,5641,1,20,0,5662,A
4-HA,842,0,1,5774,0,5775,G
4-HA,843,1,2,1,5770,5774,C
4-HA,844,1,5745,0,9,5755,T
4-HA,845,10,1,0,5826,5837,C
4-HA,846,5839,0,2,0,5841,A
4-HA,847,5909,1,3,0,5913,A
4-HA,848,1,5903,0,2,5906,T
4-HA,849,5991,0,1,0,5992,A
4-HA,850,5983,0,3,1,5987,A
4-HA,851,0,5886,0,3,5889,T
4-HA,852,4,8,5900,0,5912,G
4-HA,853,5861,2,12,0,5875,A
4-HA,854,2,6,6089,0,6097,G
4-HA,855,6091,0,9,1,6101,A
4-HA,856,0,6048,0,10,6058,T
4-HA,857,10,2,1,6178,6191,C
4-HA,858,6170,2,6,0,6178,A
4-HA,859,1,2,6305,0,6308,G
4-HA,860,6299,3,9,2,6313,A
4-HA,861,1,6289,0,9,6299,T
4-HA,862,5,2,6287,0,6294,G
4-HA,863,3,4,0,6210,6217,C
4-HA,864,6211,1,8,0,6220,A
4-HA,865,4,1,0,6355,6360,C
4-HA,866,8,6,1,6254,6269,C
4-HA,867,16,1,0,6283,6300,C
4-HA,868,6211,0,3,0,6214,A
4-HA,869,0,6206,1,6,6213,T
4-HA,870,1,6208,1,6,6216,T
4-HA,871,5,10,6295,0,6310,G
4-HA,872,8,2,6291,0,6301,G
4-HA,873,2,3,1,6284,6290,C
4-HA,874,6206,2,3,0,6211,A
4-HA,875,6202,1,6,0,6209,A
4-HA,876,6329,3,2,1,6335,A
4-HA,877,1,6330,0,5,6336,T
4-HA,878,2,2,6343,0,6347,G
4-HA,879,2,6,0,6335,6343,C
4-HA,880,6286,0,1,0,6287,A
4-HA,881,6434,0,8,0,6442,A
4-HA,882,0,6439,1,0,6440,T
4-HA,883,0,6481,0,3,6484,T
4-HA,884,12,8,0,6486,6506,C
4-HA,885,4,6393,0,3,6400,T
4-HA,886,2,11,6465,0,6478,G
4-HA,887,6470,1,4,0,6475,A
4-HA,888,6497,1,6,0,6504,A
4-HA,889,1,6505,0,4,6510,T
4-HA,890,2,0,6427,0,6429,G
4-HA,891,0,2,0,6462,6464,C
4-HA,892,6448,0,3,1,6452,A
4-HA,893,0,6460,0,4,6464,T
4-HA,894,9,2,0,6454,6465,C
4-HA,895,6460,0,12,0,6472,A
4-HA,896,0,0,0,6774,6774,C
4-HA,897,0,6723,0,11,6734,T
4-HA,898,11,3,0,6755,6769,C
4-HA,899,8,3,0,6740,6751,C
4-HA,900,6822,0,2,0,6824,A
4-HA,901,6811,0,2,1,6814,A
4-HA,902,6810,1,6,0,6817,A
4-HA,903,0,6606,0,12,6618,T
4-HA,904,4,8,6657,1,6670,G
4-HA,905,3,4,6675,1,6683,G
4-HA,906,6696,1,5,0,6702,A
4-HA,907,6650,0,23,0,6673,A
4-HA,908,2,0,6697,0,6699,G
4-HA,909,4,1,0,6639,6644,C
4-HA,910,6633,1,1,0,6635,A
4-HA,911,1,6646,0,6,6653,T
4-HA,912,0,6636,1,10,6647,T
4-HA,913,5,1,0,6834,6840,C
4-HA,914,12,6,1,6792,6811,C
4-HA,915,12,6,0,6809,6827,C
4-HA,916,6834,0,3,1,6838,A
4-HA,917,6943,0,2,2,6947,A
4-HA,918,0,7026,0,11,7037,T
4-HA,919,1,11,7033,0,7045,G
4-HA,920,7019,1,10,1,7031,A
4-HA,921,1,4,0,7026,7031,C
4-HA,922,6847,0,3,0,6850,A
4-HA,923,6866,2,6,0,6874,A
4-HA,924,6862,0,3,2,6867,A
4-HA,925,3,1,0,6895,6899,C
4-HA,926,6,11,0,6811,6828,C
4-HA,927,6722,0,8,1,6731,A
4-HA,928,2,6755,0,9,6766,T
4-HA,929,2,6759,2,5,6768,T
4-HA,930,11,1,1,6789,6802,C
4-HA,931,11,1,1,6795,6808,C
4-HA,932,6782,1,3,1,6787,A
4-HA,933,6781,0,7,0,6788,A
4-HA,934,6756,1,2,1,6760,A
4-HA,935,6884,0,3,0,6887,A
4-HA,936,0,6881,0,0,6881,T
4-HA,937,2,0,6856,0,6858,G
4-HA,938,0,6827,1,7,6835,T
4-HA,939,1,6809,1,3,6814,T
4-HA,940,6922,1,0,0,6923,A
4-HA,941,6922,0,6,0,6928,A
4-HA,942,1,3,0,6936,6940,C
4-HA,943,6877,1,7,0,6885,A
4-HA,944,0,8,6947,0,6955,G
4-HA,945,3,10,7010,0,7023,G
4-HA,946,7179,3,5,0,7187,A
4-HA,947,0,7173,0,8,7181,T
4-HA,948,10,1,0,7256,7267,C
4-HA,949,7308,4,8,0,7320,A
4-HA,950,2,4,0,7557,7563,C
4-HA,951,7569,0,5,1,7575,A
4-HA,952,1,7787,1,1,7790,T
4-HA,953,7636,1,15,0,7652,A
4-HA,954,1,7,1,7558,7567,C
4-HA,955,4,19,7314,1,7338,G
4-HA,956,1,14,7357,1,7373,G
4-HA,957,2,9,7316,0,7327,G
4-HA,958,1,4,7327,0,7332,G
4-HA,959,2,3,0,7189,7194,C
4-HA,960,5,1,0,7196,7202,C
4-HA,961,1,7051,0,5,7057,T
4-HA,962,2,0,7765,0,7767,G
4-HA,963,2,7771,0,16,7789,T
4-HA,964,11,1,0,7822,7834,C
4-HA,965,13,9,1,7790,7813,C
4-HA,966,12,0,1,7801,7814,C
4-HA,967,7768,1,12,0,7781,A
4-HA,968,1,6,7842,1,7850,G
4-HA,969,7814,0,12,0,7826,A
4-HA,970,1,7831,1,3,7836,T
4-HA,971,7309,1,4,1,7315,A
4-HA,972,0,7192,0,11,7203,T
4-HA,973,3,3,7237,0,7243,G
4-HA,974,1,7224,1,5,7231,T
4-HA,975,1,7123,0,3,7127,T
4-HA,976,7192,1,7,0,7200,A
4-HA,977,7117,1,2,3,7123,A
4-HA,978,1,7,7214,0,7222,G
4-HA,979,1,5,0,7208,7214,C
4-HA,980,7094,3,3,0,7100,A
4-HA,981,7086,0,8,4,7098,A
4-HA,982,7047,0,7,1,7055,A
4-HA,983,7054,1,14,1,7070,A
4-HA,984,2,1,0,7082,7085,C
4-HA,985,6981,2,4,0,6987,A
4-HA,986,16,2,3,7040,7061,C
4-HA,987,1,6940,0,3,6944,T
4-HA,988,9,0,0,6990,6999,C
4-HA,989,3,6979,1,7,6990,T
4-HA,990,5,3,7063,0,7071,G
4-HA,991,7053,1,10,0,7064,A
4-HA,992,7038,0,5,0,7043,A
4-HA,993,7050,0,7,1,7058,A
4-HA,994,0,7004,2,1,7007,T
4-HA,995,1,6941,1,1,6944,T
4-HA,996,0,9,7016,0,7025,G
4-HA,997,5,2,7006,0,7013,G
4-HA,998,2,4,0,7023,7029,C
4-HA,999,6972,1,6,0,6979,A
4-HA,1000,6983,3,3,1,6990,A
4-HA,1001,2,2,0,6989,6993,C
4-HA,1002,6986,3,4,0,6993,A
4-HA,1003,3,17,7046,0,7066,G
4-HA,1004,2,8,7029,1,7040,G
4-HA,1005,0,8,7039,0,7047,G
4-HA,1006,7038,4,17,1,7060,A
4-HA,1007,0,7025,0,5,7030,T
4-HA,1008,1,2,7027,0,7030,G
4-HA,1009,0,8,0,7011,7019,C
4-HA,1010,5,5,7053,0,7063,G
4-HA,1011,7133,1,5,1,7140,A
4-HA,1012,7000,0,10,1,7011,A
4-HA,1013,7061,2,7,1,7071,A
4-HA,1014,0,6977,0,19,6996,T
4-HA,1015,1,2,7100,0,7103,G
4-HA,1016,3,7097,0,3,7103,T
4-HA,1017,7067,2,11,0,7080,A
4-HA,1018,3,4,0,7077,7084,C
4-HA,1019,16,1,2,7012,7031,C
4-HA,1020,6942,0,5,0,6947,A
4-HA,1021,14,5,6949,0,6968,G
4-HA,1022,6846,1,11,0,6858,A
4-HA,1023,1,7,6940,0,6948,G
4-HA,1024,6827,3,11,1,6842,A
4-HA,1025,6827,1,6,0,6834,A
4-HA,1026,6853,2,10,0,6865,A
4-HA,1027,2,1,1,6850,6854,C
4-HA,1028,6818,0,1,0,6819,A
4-HA,1029,6935,0,3,1,6939,A
4-HA,1030,6914,0,11,0,6925,A
4-HA,1031,1,2,1,6969,6973,C
4-HA,1032,1,6902,1,3,6907,T
4-HA,1033,6856,1,8,0,6865,A
4-HA,1034,0,4,6889,0,6893,G
4-HA,1035,6844,1,9,1,6855,A
4-HA,1036,2,1,6955,0,6958,G
4-HA,1037,1,1,6945,1,6948,G
4-HA,1038,0,2,0,6810,6812,C
4-HA,1039,6829,1,8,1,6839,A
4-HA,1040,0,6826,2,8,6836,T
4-HA,1041,6896,0,0,0,6896,A
4-HA,1042,0,6865,1,8,6874,T
4-HA,1043,1,6854,1,1,6857,T
4-HA,1044,1,6850,0,3,6854,T
4-HA,1045,4,10,6649,1,6664,G
4-HA,1046,5,3,6677,1,6686,G
4-HA,1047,1,1,1,6655,6658,C
4-HA,1048,2,2,6647,0,6651,G
4-HA,1049,2,1,0,6612,6615,C
4-HA,1050,6575,0,1,0,6576,A
4-HA,1051,6642,1,0,0,6643,A
4-HA,1052,0,6614,0,5,6619,T
4-HA,1053,3,4,0,6640,6647,C
4-HA,1054,10,2,6637,0,6649,G
4-HA,1055,3,6,1,6610,6620,C
4-HA,1056,15,15,6594,2,6626,G
4-HA,1057,3,9,6663,0,6675,G
4-HA,1058,3,3,6693,0,6699,G
4-HA,1059,1,6652,3,14,6670,T
4-HA,1060,0,6603,0,6,6609,T
4-HA,1061,1,6598,5,11,6615,T
4-HA,1062,8,2,0,6624,6634,C
4-HA,1063,6646,1,5,0,6652,A
4-HA,1064,1,6654,0,3,6658,T
4-HA,1065,6658,0,3,1,6662,A
4-HA,1066,1,2,6733,1,6737,G
4-HA,1067,6608,0,4,0,6612,A
4-HA,1068,6601,1,15,1,6618,A
4-HA,1069,6618,1,2,2,6623,A
4-HA,1070,6649,1,5,1,6656,A
4-HA,1071,0,6646,0,2,6648,T
4-HA,1072,5,7,6715,0,6727,G
4-HA,1073,1,0,6768,2,6771,G
4-HA,1074,2,6714,0,4,6720,T
4-HA,1075,3,6617,0,5,6625,T
4-HA,1076,5,17,6617,0,6639,G
4-HA,1077,1,7,6703,1,6712,G
4-HA,1078,0,7,6750,0,6757,G
4-HA,1079,6688,2,15,0,6705,A
4-HA,1080,3,14,6736,0,6753,G
4-HA,1081,0,12,6660,0,6672,G
4-HA,1082,4,6,6844,0,6854,G
4-HA,1083,6820,0,9,1,6830,A
4-HA,1084,6894,0,7,1,6902,A
4-HA,1085,1,6887,0,16,6904,T
4-HA,1086,2,11,6872,0,6885,G
4-HA,1087,2,2,7028,0,7032,G
4-HA,1088,4,6959,0,0,6963,T
4-HA,1089,2,10,6922,1,6935,G
4-HA,1090,7,6,6879,1,6893,G
4-HA,1091,6738,4,35,1,6778,A
4-HA,1092,0,6759,0,30,6789,T
4-HA,1093,3,6,6876,1,6886,G
4-HA,1094,10,2,6993,0,7005,G
4-HA,1095,1,6885,0,4,6890,T
4-HA,1096,1,6707,0,6,6714,T
4-HA,1097,1,8,6707,0,6716,G
4-HA,1098,2,2,6843,1,6848,G
4-HA,1099,1,6820,0,5,6826,T
4-HA,1100,6826,2,3,1,6832,A
4-HA,1101,3,7,2,6507,6519,C
4-HA,1102,4,13,6547,0,6564,G
4-HA,1103,2,1,6802,0,6805,G
4-HA,1104,2,6785,2,13,6802,T
4-HA,1105,0,6781,0,4,6785,T
4-HA,1106,1,6779,1,6,6787,T
4-HA,1107,5,1,1,6682,6689,C
4-HA,1108,6673,1,7,1,6682,A
4-HA,1109,2,6,6671,0,6679,G
4-HA,1110,4,5,6662,1,6672,G
4-HA,1111,2,17,0,6633,6652,C
4-HA,1112,6412,2,6,0,6420,A
4-HA,1113,1,6436,2,7,6446,T
4-HA,1114,1,1,0,6449,6451,C
4-HA,1115,6473,0,1,0,6474,A
4-HA,1116,6471,2,1,0,6474,A
4-HA,1117,6452,1,6,0,6459,A
4-HA,1118,6495,7,3,0,6505,A
4-HA,1119,0,6478,0,4,6482,T
4-HA,1120,1,6481,1,5,6488,T
4-HA,1121,12,0,1,6497,6510,C
4-HA,1122,1,6460,0,8,6469,T
4-HA,1123,2,1,6463,0,6466,G
4-HA,1124,6438,0,7,0,6445,A
4-HA,1125,6389,0,8,0,6397,A
4-HA,1126,3,10,6442,1,6456,G
4-HA,1127,0,5,6526,0,6531,G
4-HA,1128,6527,0,2,1,6530,A
4-HA,1129,6507,2,15,0,6524,A
4-HA,1130,0,8,6482,0,6490,G
4-HA,1131,6542,2,7,0,6551,A
4-HA,1132,4,5,6591,0,6600,G
4-HA,1133,0,10,6620,2,6632,G
4-HA,1134,6635,0,16,0,6651,A
4-HA,1135,3,3,0,6639,6645,C
4-HA,1136,6598,1,3,0,6602,A
4-HA,1137,6591,1,6,8,6606,A
4-HA,1138,1,1,6607,0,6609,G
4-HA,1139,2,1,0,6616,6619,C
4-HA,1140,6535,4,7,0,6546,A
4-HA,1141,1,2,6554,0,6557,G
4-HA,1142,1,2,0,6522,6525,C
4-HA,1143,6505,1,3,3,6512,A
4-HA,1144,0,2,6593,1,6596,G
4-HA,1145,6543,0,12,1,6556,A
4-HA,1146,0,6708,0,6,6714,T
4-HA,1147,6,2,0,6732,6740,C
4-HA,1148,1,6678,0,11,6690,T
4-HA,1149,5,3,0,6731,6739,C
4-HA,1150,6712,0,4,0,6716,A
4-HA,1151,6707,1,4,0,6712,A
4-HA,1152,6711,0,1,0,6712,A
4-HA,1153,6573,1,12,1,6587,A
4-HA,1154,2,3,6593,0,6598,G
4-HA,1155,1,1,1,6477,6480,C
4-HA,1156,6443,1,4,0,6448,A
4-HA,1157,0,2,0,6564,6566,C
4-HA,1158,0,6514,0,17,6531,T
4-HA,1159,12,3,2,6539,6556,C
4-HA,1160,6545,1,6,0,6552,A
4-HA,1161,6664,0,10,0,6674,A
4-HA,1162,2,0,6678,0,6680,G
4-HA,1163,0,4,1,6653,6658,C
4-HA,1164,6604,0,7,0,6611,A
4-HA,1165,4,4,6631,1,6640,G
4-HA,1166,3,1,0,6514,6518,C
4-HA,1167,6492,0,2,1,6495,A
4-HA,1168,6478,0,3,1,6482,A
4-HA,1169,0,6470,0,2,6472,T
4-HA,1170,9,2,0,6342,6353,C
4-HA,1171,3,6,6357,0,6366,G
4-HA,1172,6364,2,3,0,6369,A
4-HA,1173,1,6336,0,6,6343,T
4-HA,1174,11,22,1,6285,6319,C
4-HA,1175,6301,0,5,0,6306,A
4-HA,1176,6447,2,7,1,6457,A
4-HA,1177,6468,1,4,0,6473,A
4-HA,1178,0,6454,1,5,6460,T
4-HA,1179,7,1,1,6468,6477,C
4-HA,1180,6390,0,2,0,6392,A
4-HA,1181,6444,0,2,0,6446,A
4-HA,1182,0,6434,0,2,6436,T
4-HA,1183,0,23,6433,1,6457,G
4-HA,1184,4,4,6435,0,6443,G
4-HA,1185,3,3,6342,0,6348,G
4-HA,1186,6348,4,18,1,6371,A
4-HA,1187,6363,0,5,0,6368,A
4-HA,1188,3,1,6472,0,6476,G
4-HA,1189,2,0,0,6492,6494,C
4-HA,1190,0,6451,1,5,6457,T
4-HA,1191,2,5,6707,0,6714,G
4-HA,1192,6702,0,8,0,6710,A
4-HA,1193,6690,2,15,0,6707,A
4-HA,1194,0,6712,0,1,6713,T
4-HA,1195,6561,2,4,1,6568,A
4-HA,1196,1,5,6558,0,6564,G
4-HA,1197,6056,1,7,1,6065,A
4-HA,1198,2,6071,0,5,6078,T
4-HA,1199,1,6096,0,6,6103,T
4-HA,1200,1,4,6139,1,6145,G
4-HA,1201,6122,2,5,0,6129,A
4-HA,1202,2,6097,1,2,6102,T
4-HA,1203,10,5,0,6116,6131,C
4-HA,1204,7,14,6112,0,6133,G
4-HA,1205,3,8,6104,0,6115,G
4-HA,1206,1,8,6147,1,6157,G
4-HA,1207,6133,1,11,0,6145,A
4-HA,1208,6141,0,2,0,6143,A
4-HA,1209,6103,0,10,0,6113,A
4-HA,1210,6131,1,9,1,6142,A
4-HA,1211,3,1,0,6136,6140,C
4-HA,1212,9,1,0,6143,6153,C
4-HA,1213,6108,0,4,1,6113,A
4-HA,1214,6104,0,2,1,6107,A
4-HA,1215,2,3,0,6124,6129,C
4-HA,1216,3,14,6112,0,6129,G
4-HA,1217,6126,2,8,0,6136,A
4-HA,1218,10,5,6121,0,6136,G
4-HA,1219,6120,1,8,0,6129,A
4-HA,1220,6122,1,8,0,6131,A
4-HA,1221,6128,1,8,0,6137,A
4-HA,1222,0,6144,0,6,6150,T
4-HA,1223,3,6130,0,14,6147,T
4-HA,1224,0,2,1,6166,6169,C
4-HA,1225,7,2,1,6126,6136,C
4-HA,1226,6126,3,7,2,6138,A
4-HA,1227,1,6122,0,4,6127,T
4-HA,1228,2,2,0,6127,6131,C
4-HA,1229,6094,1,1,0,6096,A
4-HA,1230,0,8,6123,0,6131,G
4-HA,1231,6093,1,4,0,6098,A
4-HA,1232,0,6094,0,5,6099,T
4-HA,1233,1,6043,0,4,6048,T
4-HA,1234,2,6,6100,1,6109,G
4-HA,1235,6078,0,11,1,6090,A
4-HA,1236,6103,1,3,1,6108,A
4-HA,1237,6104,0,8,0,6112,A
4-HA,1238,6104,1,3,0,6108,A
4-HA,1239,6029,1,17,0,6047,A
4-HA,1240,0,3,6062,0,6065,G
4-HA,1241,6044,0,7,0,6051,A
4-HA,1242,6063,1,3,0,6067,A
4-HA,1243,0,5973,2,2,5977,T
4-HA,1244,0,5972,1,5,5978,T
4-HA,1245,4,2,0,5994,6000,C
4-HA,1246,1,5983,1,6,5991,T
4-HA,1247,4,1,0,5993,5998,C
4-HA,1248,5990,0,2,0,5992,A
4-HA,1249,1,2,5997,1,6001,G
4-HA,1250,5982,0,2,0,5984,A
4-HA,1251,5946,0,13,0,5959,A
4-HA,1252,1,2,6012,0,6015,G
4-HA,1253,2,5977,1,3,5983,T
4-HA,1254,11,5,1,5955,5972,C
4-HA,1255,3,1,5980,0,5984,G
4-HA,1256,5967,2,12,0,5981,A
4-HA,1257,5964,1,13,0,5978,A
4-HA,1258,2,13,5955,0,5970,G
4-HA,1259,4,6,6005,1,6016,G
4-HA,1260,1,7,6011,1,6020,G
4-HA,1261,5884,1,14,0,5899,A
4-HA,1262,3,2,5925,0,5930,G
4-HA,1263,5886,0,24,1,5911,A
4-HA,1264,6253,0,4,1,6258,A
4-HA,1265,0,6245,0,5,6250,T
4-HA,1266,0,6233,0,5,6238,T
4-HA,1267,5,5,0,6228,6238,C
4-HA,1268,6115,2,9,0,6126,A
4-HA,1269,1,4,6129,0,6134,G
4-HA,1270,6,5,6112,0,6123,G
4-HA,1271,6100,0,6,0,6106,A
4-HA,1272,3,2,0,6120,6125,C
4-HA,1273,4,0,0,5674,5678,C
4-HA,1274,1,5631,0,5,5637,T
4-HA,1275,1,5539,0,125,5665,T
4-HA,1276,27,3,5682,0,5712,G
4-HA,1277,5698,0,10,3,5711,A
4-HA,1278,21,0,5812,0,5833,G
4-HA,1279,5774,0,11,0,5785,A
4-HA,1280,5508,3,2,0,5513,A
4-HA,1281,5473,0,7,0,5480,A
4-HA,1282,0,5401,1,4,5406,T
4-HA,1283,5592,1,1,0,5594,A
4-HA,1284,1,5550,0,6,5557,T
4-HA,1285,1,2,5624,0,5627,G
4-HA,1286,0,5605,1,7,5613,T
4-HA,1287,1,5425,0,7,5433,T
4-HA,1288,0,4,5447,0,5451,G
4-HA,1289,5383,1,6,0,5390,A
4-HA,1290,0,8,5410,0,5418,G
4-HA,1291,1,9,5389,0,5399,G
4-HA,1292,5296,0,15,0,5311,A
4-HA,1293,1,1,2,5432,5436,C
4-HA,1294,5373,0,10,0,5383,A
4-HA,1295,2,1,1,5522,5526,C
4-HA,1296,7,3,1,5539,5550,C
4-HA,1297,5538,1,3,0,5542,A
4-HA,1298,5653,1,8,1,5663,A
4-HA,1299,5642,0,13,0,5655,A
4-HA,1300,5701,1,1,0,5703,A
4-HA,1301,0,5701,0,2,5703,T
4-HA,1302,5530,1,3,0,5534,A
4-HA,1303,0,5,5560,0,5565,G
4-HA,1304,5434,0,6,0,5440,A
4-HA,1305,1,5471,0,5,5477,T
4-HA,1306,8,0,0,5476,5484,C
4-HA,1307,2,5376,1,8,5387,T
4-HA,1308,2,1,1,5512,5516,C
4-HA,1309,2,5490,0,2,5494,T
4-HA,1310,3,6,5576,1,5586,G
4-HA,1311,1,3,5706,0,5710,G
4-HA,1312,1,5661,1,18,5681,T
4-HA,1313,18,4,0,5661,5683,C
4-HA,1314,5715,1,3,0,5719,A
4-HA,1315,0,5733,0,4,5737,T
4-HA,1316,5731,1,4,0,5736,A
4-HA,1317,2,1,0,5724,5727,C
4-HA,1318,5556,0,6,0,5562,A
4-HA,1319,5612,1,7,0,5620,A
4-HA,1320,0,1,0,5436,5437,C
4-HA,1321,1,0,5437,0,5438,G
4-HA,1322,2,2,0,5430,5434,C
4-HA,1323,0,4,5380,0,5384,G
4-HA,1324,0,7,5398,1,5406,G
4-HA,1325,5400,1,6,0,5407,A
4-HA,1326,1,1,5495,1,5498,G
4-HA,1327,2,3,0,5494,5499,C
4-HA,1328,1,5437,0,12,5450,T
4-HA,1329,2,5480,4,11,5497,T
4-HA,1330,14,0,0,5499,5513,C
4-HA,1331,0,5520,2,12,5534,T
4-HA,1332,0,5521,0,12,5533,T
4-HA,1333,2,2,5530,0,5534,G
4-HA,1334,1,5509,0,7,5517,T
4-HA,1335,0,5404,0,5,5409,T
4-HA,1336,4,4,5506,0,5514,G
4-HA,1337,8,0,0,5490,5498,C
4-HA,1338,9,2,0,5464,5475,C
4-HA,1339,13,2,0,5501,5516,C
4-HA,1340,0,5487,0,6,5493,T
4-HA,1341,2,3,5536,1,5542,G
4-HA,1342,1,8,5539,0,5548,G
4-HA,1343,5530,1,15,0,5546,A
4-HA,1344,1,4,5585,1,5591,G
4-HA,1345,5468,0,7,0,5475,A
4-HA,1346,5518,0,6,0,5524,A
4-HA,1347,3,3,1,5589,5596,C
4-HA,1348,3,0,0,5558,5561,C
4-HA,1349,5551,1,6,0,5558,A
4-HA,1350,5794,1,4,0,5799,A
4-HA,1351,3,0,0,5809,5812,C
4-HA,1352,5846,0,5,0,5851,A
4-HA,1353,0,5830,0,2,5832,T
4-HA,1354,5802,0,2,0,5804,A
4-HA,1355,1,2,0,5938,5941,C
4-HA,1356,5801,0,1,0,5802,A
4-HA,1357,5809,1,7,0,5817,A
4-HA,1358,0,5788,1,4,5793,T
4-HA,1359,1,5576,0,5,5582,T
4-HA,1360,0,4,5675,0,5679,G
4-HA,1361,5704,2,7,0,5713,A
4-HA,1362,0,5694,0,4,5698,T
4-HA,1363,7,5,0,5708,5720,C
4-HA,1364,3,5610,0,9,5622,T
4-HA,1365,5691,0,1,1,5693,A
4-HA,1366,5679,2,3,0,5684,A
4-HA,1367,3,3,0,5680,5686,C
4-HA,1368,0,5633,0,10,5643,T
4-HA,1369,1,14,5593,0,5608,G
4-HA,1370,5656,1,8,0,5665,A
4-HA,1371,0,3,1,5648,5652,C
4-HA,1372,1,5624,0,6,5631,T
4-HA,1373,9,1,0,5645,5655,C
4-HA,1374,5600,19,3,0,5622,A
4-HA,1375,1,6,5731,0,5738,G
4-HA,1376,5723,2,6,0,5731,A
4-HA,1377,5732,0,2,0,5734,A
4-HA,1378,5732,0,4,0,5736,A
4-HA,1379,0,5694,0,5,5699,T
4-HA,1380,0,13,5749,0,5762,G
4-HA,1381,5750,1,4,0,5755,A
4-HA,1382,5749,0,12,0,5761,A
4-HA,1383,0,4,0,5750,5754,C
4-HA,1384,5670,0,1,0,5671,A
4-HA,1385,5670,0,1,0,5671,A
4-HA,1386,5659,0,5,0,5664,A
4-HA,1387,0,1,0,5701,5702,C
4-HA,1388,1,5650,0,1,5652,T
4-HA,1389,0,2,5677,0,5679,G
4-HA,1390,0,5613,1,5,5619,T
4-HA,1391,4,5609,0,6,5619,T
4-HA,1392,0,5628,0,6,5634,T
4-HA,1393,1,5,5633,0,5639,G
4-HA,1394,5631,0,3,0,5634,A
4-HA,1395,5634,1,3,0,5638,A
4-HA,1396,5605,0,5,2,5612,A
4-HA,1397,5614,1,3,1,5619,A
4-HA,1398,5577,1,8,0,5586,A
4-HA,1399,5608,0,4,1,5613,A
4-HA,1400,2,7,0,5613,5622,C
4-HA,1401,5626,0,1,0,5627,A
4-HA,1402,5614,0,5,0,5619,A
4-HA,1403,5621,1,4,0,5626,A
4-HA,1404,0,2,5647,1,5650,G
4-HA,1405,5669,1,7,0,5677,A
4-HA,1406,5657,0,13,0,5670,A
4-HA,1407,0,1,5672,0,5673,G
4-HA,1408,0,3,0,5669,5672,C
4-HA,1409,5665,0,7,0,5672,A
4-HA,1410,5692,0,7,0,5699,A
4-HA,1411,2,0,0,5705,5707,C
4-HA,1412,0,5666,0,2,5668,T
4-HA,1413,0,5,5705,0,5710,G
4-HA,1414,5649,0,14,0,5663,A
4-HA,1415,1,16,5694,0,5711,G
4-HA,1416,0,5,5735,0,5740,G
4-HA,1417,5,7,5715,1,5728,G
4-HA,1418,5725,0,8,0,5733,A
4-HA,1419,5694,2,2,7,5705,A
4-HA,1420,5682,2,7,1,5692,A
4-HA,1421,5725,0,6,0,5731,A
4-HA,1422,0,5728,2,3,5733,T
4-HA,1423,2,2,5756,0,5760,G
4-HA,1424,0,4,0,5750,5754,C
4-HA,1425,0,5685,1,10,5696,T
4-HA,1426,1,7,5695,0,5703,G
4-HA,1427,5695,1,12,1,5709,A
4-HA,1428,2,8,5970,0,5980,G
4-HA,1429,1,6,6073,0,6080,G
4-HA,1430,6000,1,7,0,6008,A
4-HA,1431,0,5992,1,2,5995,T
4-HA,1432,5955,0,4,0,5959,A
4-HA,1433,2,5939,0,6,5947,T
4-HA,1434,7,15,5990,0,6012,G
4-HA,1435,4,12,6030,0,6046,G
4-HA,1436,2,1,6038,0,6041,G
4-HA,1437,2,1,0,5760,5763,C
4-HA,1438,5608,0,1,2,5611,A
4-HA,1439,5607,0,8,1,5616,A
4-HA,1440,0,5609,2,6,5617,T
4-HA,1441,1,9,5631,1,5642,G
4-HA,1442,0,3,5632,1,5636,G
4-HA,1443,1,5570,2,1,5574,T
4-HA,1444,0,5446,0,3,5449,T
4-HA,1445,3,2,5478,0,5483,G
4-HA,1446,2,5518,1,10,5531,T
4-HA,1447,1,5496,1,9,5507,T
4-HA,1448,1,5517,0,7,5525,T
4-HA,1449,9,1,0,5529,5539,C
4-HA,1450,5521,0,2,0,5523,A
4-HA,1451,5542,0,5,1,5548,A
4-HA,1452,5544,1,2,1,5548,A
4-HA,1453,5594,1,6,0,5601,A
4-HA,1454,1,5569,0,3,5573,T
4-HA,1455,5525,0,1,0,5526,A
4-HA,1456,0,5540,1,4,5545,T
4-HA,1457,5536,0,4,0,5540,A
4-HA,1458,3,2,0,5583,5588,C
4-HA,1459,7,2,0,5562,5571,C
4-HA,1460,5564,0,0,0,5564,A
4-HA,1461,3,3,1,5572,5579,C
4-HA,1462,5560,0,2,0,5562,A
4-HA,1463,5572,0,3,0,5575,A
4-HA,1464,5578,0,2,0,5580,A
4-HA,1465,5,5571,0,4,5580,T
4-HA,1466,2,2,5601,0,5605,G
4-HA,1467,0,5540,0,5,5545,T
4-HA,1468,3,8,5580,0,5591,G
4-HA,1469,5583,0,14,1,5598,A
4-HA,1470,2,2,0,5580,5584,C
4-HA,1471,5505,1,4,0,5510,A
4-HA,1472,5496,2,2,1,5501,A
4-HA,1473,0,5578,0,5,5583,T
4-HA,1474,3,3,5611,0,5617,G
4-HA,1475,0,2,0,5575,5577,C
4-HA,1476,3,3,0,5577,5583,C
4-HA,1477,1,5533,0,9,5543,T
4-HA,1478,4,3,5743,0,5750,G
4-HA,1479,1,3,1,5747,5752,C
4-HA,1480,5747,0,4,1,5752,A
4-HA,1481,1,5751,0,2,5754,T
4-HA,1482,5549,0,7,1,5557,A
4-HA,1483,0,7,5580,0,5587,G
4-HA,1484,2,9,5554,0,5565,G
4-HA,1485,5536,0,7,1,5544,A
4-HA,1486,2,5522,1,4,5529,T
4-HA,1487,6,0,1,5225,5232,C
4-HA,1488,5219,1,3,2,5225,A
4-HA,1489,5245,0,1,1,5247,A
4-HA,1490,1,5235,0,6,5242,T
4-HA,1491,10,0,0,5245,5255,C
4-HA,1492,5142,1,8,0,5151,A
4-HA,1493,2,0,5174,0,5176,G
4-HA,1494,5183,0,2,0,5185,A
4-HA,1495,5165,0,24,0,5189,A
4-HA,1496,5182,0,5,0,5187,A
4-HA,1497,1,5156,0,3,5160,T
4-HA,1498,1,5,5137,1,5144,G
4-HA,1499,2,5,5155,1,5163,G
4-HA,1500,5152,0,4,0,5156,A
4-HA,1501,5190,0,3,0,5193,A
4-HA,1502,1,2,0,5160,5163,C
4-HA,1503,0,5095,1,5,5101,T
4-HA,1504,0,5115,0,2,5117,T
4-HA,1505,5119,0,3,0,5122,A
4-HA,1506,1,5117,0,2,5120,T
4-HA,1507,2,11,5104,0,5117,G
4-HA,1508,5107,0,8,0,5115,A
4-HA,1509,4,1,0,5105,5110,C
4-HA,1510,12,4,0,5037,5053,C
4-HA,1511,5037,1,7,2,5047,A
4-HA,1512,2,10,0,5151,5163,C
4-HA,1513,2,2,5299,0,5303,G
4-HA,1514,5409,1,0,0,5410,A
4-HA,1515,0,5464,1,4,5469,T
4-HA,1516,1,0,5691,0,5692,G
4-HA,1517,1,5640,0,5,5646,T
4-HA,1518,5836,0,5,0,5841,A
4-HA,1519,0,5835,0,2,5837,T
4-HA,1520,5818,1,6,1,5826,A
4-HA,1521,3,4,0,5802,5809,C
4-HA,1522,5185,2,5,1,5193,A
4-HA,1523,2,8,5228,0,5238,G
4-HA,1524,4903,3,6,0,4912,A
4-HA,1525,1,4,4742,0,4747,G
4-HA,1526,4721,1,1,0,4723,A
4-HA,1527,0,4398,0,5,4403,T
4-HA,1528,1,4,4390,0,4395,G
4-HA,1529,4391,1,1,0,4393,A
4-HA,1530,4357,0,17,0,4374,A
4-HA,1531,0,1,4462,0,4463,G
4-HA,1532,1,0,0,4363,4364,C
4-HA,1533,4343,0,8,0,4351,A
4-HA,1534,1,4316,0,7,4324,T
4-HA,1535,1,4320,1,0,4322,T
4-HA,1536,4351,0,1,0,4352,A
4-HA,1537,4337,1,5,0,4343,A
4-HA,1538,4348,0,3,1,4352,A
4-HA,1539,1,2,0,4347,4350,C
4-HA,1540,4195,2,5,1,4203,A
4-HA,1541,4200,2,1,0,4203,A
4-HA,1542,0,0,0,4183,4183,C
4-HA,1543,4,0,1,4151,4156,C
4-HA,1544,3,5,4147,0,4155,G
4-HA,1545,2,3,4205,0,4210,G
4-HA,1546,2,4213,0,7,4222,T
4-HA,1547,0,4193,0,9,4202,T
4-HA,1548,7,0,1,4202,4210,C
4-HA,1549,0,2,0,4219,4221,C
4-HA,1550,4194,0,10,0,4204,A
4-HA,1551,0,5,4230,0,4235,G
4-HA,1552,4242,1,1,0,4244,A
4-HA,1553,3,4219,0,3,4225,T
4-HA,1554,6,0,0,4051,4057,C
4-HA,1555,4038,0,2,0,4040,A
4-HA,1556,4057,0,2,0,4059,A
4-HA,1557,1,8,4044,0,4053,G
4-HA,1558,0,10,4019,0,4029,G
4-HA,1559,6,4,4029,0,4039,G
4-HA,1560,3856,0,8,1,3865,A
4-HA,1561,7,1,3883,0,3891,G
4-HA,1562,1,3888,0,2,3891,T
4-HA,1563,0,3885,0,6,3891,T
4-HA,1564,0,8,3910,0,3918,G
4-HA,1565,3892,2,3,0,3897,A
4-HA,1566,3,2,3911,0,3916,G
4-HA,1567,1,1,0,3905,3907,C
4-HA,1568,0,3859,0,1,3860,T
4-HA,1569,0,2,3872,0,3874,G
4-HA,1570,3844,1,1,0,3846,A
4-HA,1571,3852,0,5,0,3857,A
4-HA,1572,0,1,3859,0,3860,G
4-HA,1573,0,3786,0,4,3790,T
4-HA,1574,6,12,0,3757,3775,C
4-HA,1575,3724,0,3,0,3727,A
4-HA,1576,1,8,3710,0,3719,G
4-HA,1577,1,9,3702,0,3712,G
4-HA,1578,1,3,3618,0,3622,G
4-HA,1579,0,3725,0,1,3726,T
4-HA,1580,3727,0,6,1,3734,A
4-HA,1581,0,1,0,3721,3722,C
4-HA,1582,3715,0,2,1,3718,A
4-HA,1583,3707,0,2,1,3710,A
4-HA,1584,3706,0,3,1,3710,A
4-HA,1585,1,1,3728,0,3730,G
4-HA,1586,3637,1,0,0,3638,A
4-HA,1587,0,3514,0,0,3514,T
4-HA,1588,1,3473,0,1,3475,T
4-HA,1589,1,2,3467,0,3470,G
4-HA,1590,1,1,3465,2,3469,G
4-HA,1591,3472,0,3,0,3475,A
4-HA,1592,0,3487,1,2,3490,T
4-HA,1593,19,2,0,3462,3483,C
4-HA,1594,4,1,0,3421,3426,C
4-HA,1595,0,3393,0,3,3396,T
4-HA,1596,3405,0,3,0,3408,A
4-HA,1597,3,3400,0,6,3409,T
4-HA,1598,1,2,3387,0,3390,G
4-HA,1599,0,2,3393,0,3395,G
4-HA,1600,3327,1,0,0,3328,A
4-HA,1601,0,3303,0,8,3311,T
4-HA,1602,0,3255,1,2,3258,T
4-HA,1603,0,3254,1,3,3258,T
4-HA,1604,9,0,1,3252,3262,C
4-HA,1605,5,0,0,3246,3251,C
4-HA,1606,2,3199,1,4,3206,T
4-HA,1607,0,3194,0,2,3196,T
4-HA,1608,0,3178,0,3,3181,T
4-HA,1609,1,1,3202,0,3204,G
4-HA,1610,1,1,0,3195,3197,C
4-HA,1611,4,1,0,3193,3198,C
4-HA,1612,3130,0,3,0,3133,A
4-HA,1613,1,3105,0,5,3111,T
4-HA,1614,3130,1,2,0,3133,A
4-HA,1615,2,3123,0,8,3133,T
4-HA,1616,3,0,0,3115,3118,C
4-HA,1617,3114,0,2,0,3116,A
4-HA,1618,0,3069,1,3,3073,T
4-HA,1619,0,0,3082,0,3082,G
4-HA,1620,0,3074,1,3,3078,T
4-HA,1621,0,3044,0,3,3047,T
4-HA,1622,1,3031,1,5,3038,T
4-HA,1623,0,2975,0,2,2977,T
4-HA,1624,0,2973,0,2,2975,T
4-HA,1625,0,2970,0,0,2970,T
4-HA,1626,0,2,2977,0,2979,G
4-HA,1627,0,1,0,2971,2972,C
4-HA,1628,0,2889,1,6,2896,T
4-HA,1629,0,2887,0,2,2889,T
4-HA,1630,1,2883,1,1,2886,T
4-HA,1631,1,1,2916,0,2918,G
4-HA,1632,1,2918,0,3,2922,T
4-HA,1633,2,0,2918,0,2920,G
4-HA,1634,0,2922,0,4,2926,T
4-HA,1635,0,2846,0,3,2849,T
4-HA,1636,1,0,2859,1,2861,G
4-HA,1637,1,0,0,2854,2855,C
4-HA,1638,0,2831,1,3,2835,T
4-HA,1639,0,2842,1,0,2843,T
4-HA,1640,0,2673,0,0,2673,T
4-HA,1641,0,4,2695,0,2699,G
4-HA,1642,0,2692,0,4,2696,T
4-HA,1643,0,2676,0,4,2680,T
4-HA,1644,1,5,2674,0,2680,G
4-HA,1645,2,3,2630,0,2635,G
4-HA,1646,1,4,2613,0,2618,G
4-HA,1647,1,0,2629,1,2631,G
4-HA,1648,1,2550,0,7,2558,T
4-HA,1649,0,2539,0,3,2542,T
4-HA,1650,4,1,0,2503,2508,C
4-HA,1651,2470,0,4,0,2474,A
4-HA,1652,1,2471,0,7,2479,T
4-HA,1653,3,0,0,2458,2461,C
4-HA,1654,2444,1,2,0,2447,A
4-HA,1655,1,2368,0,0,2369,T
4-HA,1656,0,0,2352,0,2352,G
4-HA,1657,0,2300,0,2,2302,T
4-HA,1658,1,2,2281,1,2285,G
4-HA,1659,1,0,2227,0,2228,G
4-HA,1660,0,0,2222,1,2223,G
4-HA,1661,2,2,0,2143,2147,C
4-HA,1662,3,2,0,2082,2087,C
4-HA,1663,1,1957,0,2,1960,T
4-HA,1664,1,0,1969,0,1970,G
4-HA,1665,3,1,0,1953,1957,C
4-HA,1666,3,0,0,1968,1971,C
4-HA,1667,1961,0,2,1,1964,A
4-HA,1668,1952,0,1,0,1953,A
4-HA,1669,1945,0,3,0,1948,A
4-HA,1670,1948,0,0,0,1948,A
4-HA,1671,1940,0,9,0,1949,A
4-HA,1672,0,0,1945,0,1945,G
4-HA,1673,1,2,1869,0,1872,G
4-HA,1674,1,0,0,1845,1846,C
4-HA,1675,1833,0,5,0,1838,A
4-HA,1676,1841,0,4,0,1845,A
4-HA,1677,0,1,0,1844,1845,C
4-HA,1678,1839,0,0,0,1839,A
4-HA,1679,0,1829,0,1,1830,T
4-HA,1680,0,1815,0,0,1815,T
4-HA,1681,1740,1,2,0,1743,A
4-HA,1682,1,2,1729,1,1733,G
4-HA,1683,0,0,1728,1,1729,G
4-HA,1684,0,1677,0,2,1679,T
4-HA,1685,0,0,1541,0,1541,G
4-HA,1686,1,2,0,1478,1481,C
4-HA,1687,1450,0,1,0,1451,A
4-HA,1688,1447,0,3,1,1451,A
4-HA,1689,1,0,0,1447,1448,C
4-HA,1690,1415,3,1,0,1419,A
4-HA,1691,0,1386,0,0,1386,T
4-HA,1692,0,1299,1,6,1306,T
4-HA,1693,0,1299,0,4,1303,T
4-HA,1694,0,0,1302,0,1302,G
4-HA,1695,0,2,0,1288,1290,C
4-HA,1696,1284,0,1,0,1285,A
4-HA,1697,0,1203,0,1,1204,T
4-HA,1698,1,1164,0,0,1165,T
4-HA,1699,0,1126,0,0,1126,T
4-HA,1700,0,0,1121,0,1121,G
4-HA,1701,1067,0,0,0,1067,A
5-NP,1,716,0,0,0,716,A
5-NP,2,0,718,0,0,718,T
5-NP,3,0,0,716,0,716,G
5-NP,4,1,1,719,0,721,G
5-NP,5,0,0,0,726,726,C
5-NP,6,0,0,742,0,742,G
5-NP,7,0,778,0,2,780,T
5-NP,8,1,0,1,789,791,C
5-NP,9,3,0,0,800,803,C
5-NP,10,2,0,0,801,803,C
5-NP,11,801,0,1,0,802,A
5-NP,12,801,0,3,0,804,A
5-NP,13,0,0,821,0,821,G
5-NP,14,0,0,843,0,843,G
5-NP,15,0,2,0,847,849,C
5-NP,16,852,1,0,0,853,A
5-NP,17,0,0,0,861,861,C
5-NP,18,1,0,0,865,866,C
5-NP,19,873,0,0,0,873,A
5-NP,20,870,0,0,0,870,A
5-NP,21,878,0,0,0,878,A
5-NP,22,0,1,0,876,877,C
5-NP,23,1,2,880,0,883,G
5-NP,24,0,1,958,0,959,G
5-NP,25,0,956,0,2,958,T
5-NP,26,3,0,0,1049,1052,C
5-NP,27,0,1046,0,4,1050,T
5-NP,28,0,1061,0,2,1063,T
5-NP,29,1063,0,2,0,1065,A
5-NP,30,0,1065,0,1,1066,T
5-NP,31,0,3,1075,0,1078,G
5-NP,32,1074,0,1,0,1075,A
5-NP,33,1058,0,2,0,1060,A
5-NP,34,1,0,0,1062,1063,C
5-NP,35,1046,0,2,0,1048,A
5-NP,36,1,0,1122,0,1123,G
5-NP,37,1118,0,1,0,1119,A
5-NP,38,0,1122,0,0,1122,T
5-NP,39,0,2,1121,0,1123,G
5-NP,40,1,1,1128,0,1130,G
5-NP,41,1124,3,1,0,1128,A
5-NP,42,1133,0,1,0,1134,A
5-NP,43,1136,0,0,0,1136,A
5-NP,44,0,1,0,1174,1175,C
5-NP,45,0,1155,0,2,1157,T
5-NP,46,0,2,1180,0,1182,G
5-NP,47,1177,0,2,0,1179,A
5-NP,48,0,1179,1,0,1180,T
5-NP,49,0,4,1171,0,1175,G
5-NP,50,1,1,1173,0,1175,G
5-NP,51,1,4,1173,0,1178,G
5-NP,52,0,0,1181,0,1181,G
5-NP,53,1176,0,1,0,1177,A
5-NP,54,0,1179,0,0,1179,T
5-NP,55,0,0,1,1190,1191,C
5-NP,56,2,0,1195,0,1197,G
5-NP,57,0,1,0,1222,1223,C
5-NP,58,0,0,0,1227,1227,C
5-NP,59,1222,0,1,0,1223,A
5-NP,60,0,1,1237,0,1238,G
5-NP,61,1237,0,1,0,1238,A
5-NP,62,1247,1,0,0,1248,A
5-NP,63,0,1248,0,0,1248,T
5-NP,64,0,1,1250,0,1251,G
5-NP,65,0,0,0,1267,1267,C
5-NP,66,1255,0,2,0,1257,A
5-NP,67,1275,0,3,0,1278,A
5-NP,68,1,0,0,1276,1277,C
5-NP,69,0,1272,0,0,1272,T
5-NP,70,0,1,1291,0,1292,G
5-NP,71,1321,0,1,0,1322,A
5-NP,72,4,1,1385,0,1390,G
5-NP,73,1388,0,0,0,1388,A
5-NP,74,0,1379,0,0,1379,T
5-NP,75,0,1384,0,0,1384,T
5-NP,76,1373,0,1,0,1374,A
5-NP,77,1,5,1371,1,1378,G
5-NP,78,0,5,1376,0,1381,G
5-NP,79,1,0,1377,1,1379,G
5-NP,80,0,0,0,1363,1363,C
5-NP,81,1352,0,1,0,1353,A
5-NP,82,0,1351,0,1,1352,T
5-NP,83,0,0,0,1355,1355,C
5-NP,84,2,2,0,1356,1360,C
5-NP,85,0,1,1375,0,1376,G
5-NP,86,0,1376,0,1,1377,T
5-NP,87,1,1,0,1373,1375,C
5-NP,88,0,2,1379,0,1381,G
5-NP,89,0,0,1379,0,1379,G
5-NP,90,0,1,1388,0,1389,G
5-NP,91,1376,1,1,0,1378,A
5-NP,92,1378,0,3,0,1381,A
5-NP,93,0,0,1396,0,1396,G
5-NP,94,1389,0,1,0,1390,A
5-NP,95,0,1402,0,0,1402,T
5-NP,96,0,3,1405,0,1408,G
5-NP,97,1419,0,2,0,1421,A
5-NP,98,0,1420,0,1,1421,T
5-NP,99,1,1417,0,0,1418,T
5-NP,100,0,1,1421,0,1422,G
5-NP,101,1423,1,3,0,1427,A
5-NP,102,0,1424,0,0,1424,T
5-NP,103,0,4,1421,1,1426,G
5-NP,104,0,4,1407,0,1411,G
5-NP,105,3,0,1398,0,1401,G
5-NP,106,1486,0,1,0,1487,A
5-NP,107,2,1489,0,0,1491,T
5-NP,108,0,1493,0,1,1494,T
5-NP,109,1,3,1497,0,1501,G
5-NP,110,1,2,1507,0,1510,G
5-NP,111,0,2,1506,0,1508,G
5-NP,112,1504,1,2,0,1507,A
5-NP,113,0,1,1501,0,1502,G
5-NP,114,1477,0,3,0,1480,A
5-NP,115,0,1502,0,1,1503,T
5-NP,116,1,1508,0,1,1510,T
5-NP,117,0,0,0,1517,1517,C
5-NP,118,0,1509,0,0,1509,T
5-NP,119,1527,0,0,0,1527,A
5-NP,120,0,2,0,1531,1533,C
5-NP,121,1568,1,0,0,1569,A
5-NP,122,0,1577,0,0,1577,T
5-NP,123,0,0,0,1569,1569,C
5-NP,124,2,0,1,1571,1574,C
5-NP,125,1578,0,0,0,1578,A
5-NP,126,1602,0,0,1,1603,A
5-NP,127,1606,0,1,0,1607,A
5-NP,128,0,1591,0,1,1592,T
5-NP,129,0,0,1600,0,1600,G
5-NP,130,0,1583,1,1,1585,T
5-NP,131,0,0,1590,0,1590,G
5-NP,132,0,0,0,1596,1596,C
5-NP,133,1590,0,1,0,1591,A
5-NP,134,1,1,1,1586,1589,C
5-NP,135,0,1572,0,2,1574,T
5-NP,136,0,2,1641,0,1643,G
5-NP,137,1661,0,1,0,1662,A
5-NP,138,1696,0,0,1,1697,A
5-NP,139,0,0,0,1716,1716,C
5-NP,140,0,1699,0,3,1702,T
5-NP,141,0,1706,0,1,1707,T
5-NP,142,1703,1,0,0,1704,A
5-NP,143,1705,0,2,2,1709,A
5-NP,144,1710,0,1,0,1711,A
5-NP,145,0,0,0,1716,1716,C
5-NP,146,1,1647,0,1,1649,T
5-NP,147,1,1,0,1660,1662,C
5-NP,148,1644,0,2,0,1646,A
5-NP,149,0,0,1670,0,1670,G
5-NP,150,0,1666,0,2,1668,T
5-NP,151,1,2,1671,0,1674,G
5-NP,152,1703,0,2,2,1707,A
5-NP,153,1,1705,0,1,1707,T
5-NP,154,3,0,0,1736,1739,C
5-NP,155,1746,0,0,0,1746,A
5-NP,156,0,1743,0,1,1744,T
5-NP,157,0,1,1746,0,1747,G
5-NP,158,1735,1,2,0,1738,A
5-NP,159,1731,0,3,0,1734,A
5-NP,160,2,3,1722,2,1729,G
5-NP,161,1,1,1707,0,1709,G
5-NP,162,2,0,1716,0,1718,G
5-NP,163,0,2,0,1697,1699,C
5-NP,164,0,3,1715,0,1718,G
5-NP,165,0,0,1722,0,1722,G
5-NP,166,0,1721,0,1,1722,T
5-NP,167,0,1724,0,1,1725,T
5-NP,168,0,4,1723,0,1727,G
5-NP,169,1912,0,5,0,1917,A
5-NP,170,0,1919,0,1,1920,T
5-NP,171,2,0,0,1908,1910,C
5-NP,172,2,1,0,1918,1921,C
5-NP,173,1902,1,2,0,1905,A
5-NP,174,0,1,1921,0,1922,G
5-NP,175,1914,1,1,0,1916,A
5-NP,176,1918,0,2,0,1920,A
5-NP,177,1,1,0,1928,1930,C
5-NP,178,1802,0,1,1,1804,A
5-NP,179,0,0,1832,0,1832,G
5-NP,180,0,0,0,1832,1832,C
5-NP,181,0,1823,0,4,1827,T
5-NP,182,2,1845,0,0,1847,T
5-NP,183,0,3,1837,0,1840,G
5-NP,184,1847,0,6,1,1854,A
5-NP,185,1,1,0,1865,1867,C
5-NP,186,1858,0,1,0,1859,A
5-NP,187,1876,0,2,0,1878,A
5-NP,188,0,1863,0,0,1863,T
5-NP,189,1868,0,0,0,1868,A
5-NP,190,0,3,1877,0,1880,G
5-NP,191,1853,1,9,0,1863,A
5-NP,192,2,3,1872,0,1877,G
5-NP,193,1861,1,2,0,1864,A
5-NP,194,1901,0,0,0,1901,A
5-NP,195,1900,0,0,0,1900,A
5-NP,196,1948,0,0,0,1948,A
5-NP,197,0,1949,0,1,1950,T
5-NP,198,2,4,1942,0,1948,G
5-NP,199,1,2,1943,0,1946,G
5-NP,200,0,1940,0,3,1943,T
5-NP,201,1913,0,1,0,1914,A
5-NP,202,0,0,0,1932,1932,C
5-NP,203,0,1937,0,1,1938,T
5-NP,204,2,0,0,1961,1963,C
5-NP,205,0,1925,0,6,1931,T
5-NP,206,3,0,0,1944,1947,C
5-NP,207,0,1942,0,4,1946,T
5-NP,208,2,0,1956,0,1958,G
5-NP,209,0,1,0,1954,1955,C
5-NP,210,0,1943,1,4,1948,T
5-NP,211,1,1943,0,3,1947,T
5-NP,212,0,1940,0,0,1940,T
5-NP,213,0,1933,1,1,1935,T
5-NP,214,1,0,1942,0,1943,G
5-NP,215,1926,0,4,3,1933,A
5-NP,216,0,1923,0,9,1932,T
5-NP,217,1,1,1930,0,1932,G
5-NP,218,1923,1,1,0,1925,A
5-NP,219,1925,0,2,1,1928,A
5-NP,220,1927,0,4,0,1931,A
5-NP,221,0,1,1934,0,1935,G
5-NP,222,1931,1,3,0,1935,A
5-NP,223,1939,0,3,0,1942,A
5-NP,224,0,1,1950,0,1951,G
5-NP,225,0,1,2006,0,2007,G
5-NP,226,2006,1,4,0,2011,A
5-NP,227,2026,0,1,0,2027,A
5-NP,228,1,2023,0,0,2024,T
5-NP,229,2016,0,1,0,2017,A
5-NP,230,2010,0,2,0,2012,A
5-NP,231,2015,1,2,0,2018,A
5-NP,232,0,2007,0,2,2009,T
5-NP,233,2022,3,1,0,2026,A
5-NP,234,0,0,0,2021,2021,C
5-NP,235,2,0,0,1978,1980,C
5-NP,236,0,1982,0,1,1983,T
5-NP,237,0,2,1986,0,1988,G
5-NP,238,0,2,2006,0,2008,G
5-NP,239,2011,0,0,0,2011,A
5-NP,240,2009,0,1,0,2010,A
5-NP,241,0,4,2046,0,2050,G
5-NP,242,2025,1,5,0,2031,A
5-NP,243,2018,0,5,0,2023,A
5-NP,244,1,0,0,2020,2021,C
5-NP,245,2016,0,2,0,2018,A
5-NP,246,1,0,0,2069,2070,C
5-NP,247,1,1,0,2033,2035,C
5-NP,248,3,0,0,2039,2042,C
5-NP,249,3,0,0,2036,2039,C
5-NP,250,2029,0,0,0,2029,A
5-NP,251,0,0,2039,0,2039,G
5-NP,252,0,1,0,2022,2023,C
5-NP,253,1,0,2032,0,2033,G
5-NP,254,1,2,0,2026,2029,C
5-NP,255,4,3,1994,0,2001,G
5-NP,256,0,1,2010,0,2011,G
5-NP,257,0,6,2005,1,2012,G
5-NP,258,0,1,2022,0,2023,G
5-NP,259,2021,0,0,0,2021,A
5-NP,260,2017,0,2,1,2020,A
5-NP,261,2012,0,7,0,2019,A
5-NP,262,0,0,2022,0,2022,G
5-NP,263,2007,3,5,0,2015,A
5-NP,264,0,2009,0,1,2010,T
5-NP,265,1,0,0,1994,1995,C
5-NP,266,3,0,0,1987,1990,C
5-NP,267,3,0,0,1997,2000,C
5-NP,268,2009,0,0,1,2010,A
5-NP,269,2006,0,1,0,2007,A
5-NP,270,0,2,2022,0,2024,G
5-NP,271,2017,0,0,0,2017,A
5-NP,272,2029,2,0,1,2032,A
5-NP,273,2033,0,0,0,2033,A
5-NP,274,2029,0,7,0,2036,A
5-NP,275,0,1,0,2034,2035,C
5-NP,276,1,2015,0,1,2017,T
5-NP,277,1,3,2005,1,2010,G
5-NP,278,1,2,2010,0,2013,G
5-NP,279,2,7,2005,0,2014,G
5-NP,280,0,3,2005,0,2008,G
5-NP,281,2,2,2017,0,2021,G
5-NP,282,0,0,2049,0,2049,G
5-NP,283,1,2,0,2187,2190,C
5-NP,284,5,0,0,2179,2184,C
5-NP,285,7,0,0,2192,2199,C
5-NP,286,2512,1,3,0,2516,A
5-NP,287,1,2518,0,0,2519,T
5-NP,288,2687,0,0,0,2687,A
5-NP,289,1,2684,0,1,2686,T
5-NP,290,2665,0,3,0,2668,A
5-NP,291,0,0,0,2685,2685,C
5-NP,292,2466,0,2,0,2468,A
5-NP,293,0,3,2505,0,2508,G
5-NP,294,1,4,2498,0,2503,G
5-NP,295,2272,2,2,0,2276,A
5-NP,296,0,5,2288,0,2293,G
5-NP,297,2193,0,3,0,2196,A
5-NP,298,0,1,2221,0,2222,G
5-NP,299,1,2213,1,1,2216,T
5-NP,300,2195,0,0,0,2195,A
5-NP,301,0,1,2198,0,2199,G
5-NP,302,2177,0,4,0,2181,A
5-NP,303,0,2183,0,1,2184,T
5-NP,304,0,0,2178,0,2178,G
5-NP,305,0,2,2172,0,2174,G
5-NP,306,2173,0,2,0,2175,A
5-NP,307,2161,0,3,0,2164,A
5-NP,308,2162,0,1,0,2163,A
5-NP,309,2162,2,4,0,2168,A
5-NP,310,1,2169,0,0,2170,T
5-NP,311,0,2,2184,0,2186,G
5-NP,312,0,3,2178,0,2181,G
5-NP,313,2179,1,1,0,2181,A
5-NP,314,3,2160,0,0,2163,T
5-NP,315,1,6,2163,0,2170,G
5-NP,316,2168,2,4,0,2174,A
5-NP,317,0,3,2177,0,2180,G
5-NP,318,1,3,2167,0,2171,G
5-NP,319,0,0,2184,0,2184,G
5-NP,320,2217,0,3,0,2220,A
5-NP,321,2230,0,2,0,2232,A
5-NP,322,0,0,0,2276,2276,C
5-NP,323,0,2269,0,4,2273,T
5-NP,324,3,1,0,2321,2325,C
5-NP,325,2,1,2344,0,2347,G
5-NP,326,1,2351,0,3,2355,T
5-NP,327,3,0,0,2373,2376,C
5-NP,328,4,1,0,2686,2691,C
5-NP,329,0,2678,0,3,2681,T
5-NP,330,0,2705,0,0,2705,T
5-NP,331,0,2703,0,2,2705,T
5-NP,332,2718,0,4,0,2722,A
5-NP,333,0,2715,0,2,2717,T
5-NP,334,1,5,2711,0,2717,G
5-NP,335,2729,2,8,0,2739,A
5-NP,336,1,0,1,2745,2747,C
5-NP,337,2684,0,2,0,2686,A
5-NP,338,2698,0,1,0,2699,A
5-NP,339,2717,0,4,0,2721,A
5-NP,340,0,3,2885,0,2888,G
5-NP,341,2882,0,3,0,2885,A
5-NP,342,2883,0,11,0,2894,A
5-NP,343,2,2,3056,1,3061,G
5-NP,344,3081,1,3,0,3085,A
5-NP,345,3091,0,5,0,3096,A
5-NP,346,3086,0,3,0,3089,A
5-NP,347,0,3093,1,1,3095,T
5-NP,348,3087,1,2,0,3090,A
5-NP,349,3056,0,4,1,3061,A
5-NP,350,0,1,3097,0,3098,G
5-NP,351,3,1,3089,0,3093,G
5-NP,352,1,1,0,3080,3082,C
5-NP,353,2,4,3074,0,3080,G
5-NP,354,3104,0,1,0,3105,A
5-NP,355,3157,0,0,0,3157,A
5-NP,356,0,3169,1,2,3172,T
5-NP,357,0,1,0,3172,3173,C
5-NP,358,0,3161,2,11,3174,T
5-NP,359,2,1,3164,0,3167,G
5-NP,360,3,0,3173,0,3176,G
5-NP,361,1,3,0,3177,3181,C
5-NP,362,3,2,3184,0,3189,G
5-NP,363,3,1,0,3176,3180,C
5-NP,364,5,1,0,3177,3183,C
5-NP,365,3203,0,1,0,3204,A
5-NP,366,3269,0,3,0,3272,A
5-NP,367,0,0,3381,1,3382,G
5-NP,368,1,0,0,3387,3388,C
5-NP,369,7,2,0,3445,3454,C
5-NP,370,3463,0,3,0,3466,A
5-NP,371,3531,1,4,0,3536,A
5-NP,372,1,1,0,3591,3593,C
5-NP,373,3592,0,1,0,3593,A
5-NP,374,3670,1,4,0,3675,A
5-NP,375,1,3662,0,1,3664,T
5-NP,376,1,7,3770,0,3778,G
5-NP,377,3,3,3777,0,3783,G
5-NP,378,0,3743,0,6,3749,T
5-NP,379,1,0,3775,0,3776,G
5-NP,380,3752,2,10,0,3764,A
5-NP,381,1,4,3866,0,3871,G
5-NP,382,1,4,3862,0,3867,G
5-NP,383,3919,0,2,0,3921,A
5-NP,384,1,4360,0,1,4362,T
5-NP,385,0,2,4424,0,4426,G
5-NP,386,2,1,1,4446,4450,C
5-NP,387,0,4451,0,7,4458,T
5-NP,388,4481,0,3,0,4484,A
5-NP,389,0,0,1,4569,4570,C
5-NP,390,4554,1,2,0,4557,A
5-NP,391,0,4538,0,8,4546,T
5-NP,392,1,1,0,4522,4524,C
5-NP,393,1,4379,0,2,4382,T
5-NP,394,3,8,4584,0,4595,G
5-NP,395,1,0,4725,1,4727,G
5-NP,396,0,4718,0,7,4725,T
5-NP,397,7,2,0,4722,4731,C
5-NP,398,0,4703,0,4,4707,T
5-NP,399,4783,0,1,0,4784,A
5-NP,400,4781,0,5,0,4786,A
5-NP,401,2,0,0,4833,4835,C
5-NP,402,2,4819,0,12,4833,T
5-NP,403,5,1,0,4869,4875,C
5-NP,404,4845,2,5,0,4852,A
5-NP,405,0,0,0,5078,5078,C
5-NP,406,5072,0,4,1,5077,A
5-NP,407,1,5085,0,7,5093,T
5-NP,408,5062,0,4,0,5066,A
5-NP,409,5078,0,9,0,5087,A
5-NP,410,1,5116,1,3,5121,T
5-NP,411,1,10,5189,0,5200,G
5-NP,412,5192,1,1,0,5194,A
5-NP,413,0,5158,0,5,5163,T
5-NP,414,0,5092,1,2,5095,T
5-NP,415,1,5099,0,4,5104,T
5-NP,416,4,7,5078,2,5091,G
5-NP,417,14,2,5090,1,5107,G
5-NP,418,0,4,0,5105,5109,C
5-NP,419,5105,0,3,0,5108,A
5-NP,420,0,5096,0,7,5103,T
5-NP,421,2,5079,1,8,5090,T
5-NP,422,9,0,0,5092,5101,C
5-NP,423,2,0,0,5108,5110,C
5-NP,424,5192,0,3,0,5195,A
5-NP,425,5205,1,2,0,5208,A
5-NP,426,0,5194,1,5,5200,T
5-NP,427,0,5205,2,1,5208,T
5-NP,428,1,5196,0,1,5198,T
5-NP,429,0,12,5236,0,5248,G
5-NP,430,5231,0,8,1,5240,A
5-NP,431,5255,0,1,0,5256,A
5-NP,432,1,5273,0,1,5275,T
5-NP,433,0,10,5238,0,5248,G
5-NP,434,5474,1,11,0,5486,A
5-NP,435,0,5484,0,7,5491,T
5-NP,436,2,2,5518,0,5522,G
5-NP,437,3,5,1,5665,5674,C
5-NP,438,5655,3,8,0,5666,A
5-NP,439,5942,1,11,0,5954,A
5-NP,440,0,1,0,5953,5954,C
5-NP,441,6030,2,3,0,6035,A
5-NP,442,0,6188,0,3,6191,T
5-NP,443,6098,1,7,1,6107,A
5-NP,444,1,4,2,6186,6193,C
5-NP,445,9,0,0,6175,6184,C
5-NP,446,6073,2,4,0,6079,A
5-NP,447,2,6,6149,0,6157,G
5-NP,448,6030,2,12,0,6044,A
5-NP,449,0,11,6195,1,6207,G
5-NP,450,5,9,6179,0,6193,G
5-NP,451,6135,3,12,0,6150,A
5-NP,452,4,2,0,6198,6204,C
5-NP,453,6127,3,10,0,6140,A
5-NP,454,6122,0,10,1,6133,A
5-NP,455,0,6,6164,2,6172,G
5-NP,456,6097,0,13,0,6110,A
5-NP,457,2,6,6129,0,6137,G
5-NP,458,1,1,0,6132,6134,C
5-NP,459,1,6096,0,13,6110,T
5-NP,460,8,4,0,6116,6128,C
5-NP,461,0,6101,1,8,6110,T
5-NP,462,1,6137,1,1,6140,T
5-NP,463,1,2,6159,0,6162,G
5-NP,464,0,6142,0,4,6146,T
5-NP,465,1,6145,0,4,6150,T
5-NP,466,12,1,0,6125,6138,C
5-NP,467,1,17,6119,0,6137,G
5-NP,468,6242,3,2,0,6247,A
5-NP,469,6230,1,9,0,6240,A
5-NP,470,2,1,0,6298,6301,C
5-NP,471,1,6261,1,10,6273,T
5-NP,472,2,3,6370,0,6375,G
5-NP,473,5,10,6398,1,6414,G
5-NP,474,6404,1,8,0,6413,A
5-NP,475,6416,0,11,0,6427,A
5-NP,476,1,6401,0,3,6405,T
5-NP,477,2,16,6371,0,6389,G
5-NP,478,2,7,6407,0,6416,G
5-NP,479,6451,2,22,0,6475,A
5-NP,480,1,6512,1,9,6523,T
5-NP,481,3,0,0,6558,6561,C
5-NP,482,15,2,0,6553,6570,C
5-NP,483,16,1,0,6602,6619,C
5-NP,484,6711,0,10,3,6724,A
5-NP,485,0,5,6810,1,6816,G
5-NP,486,6835,1,4,0,6840,A
5-NP,487,6834,0,4,0,6838,A
5-NP,488,2,6774,0,1,6777,T
5-NP,489,3,1,6889,1,6894,G
5-NP,490,1,6851,1,6,6859,T
5-NP,491,3,4,6916,0,6923,G
5-NP,492,1,3,0,6926,6930,C
5-NP,493,1,6890,0,9,6900,T
5-NP,494,8,0,0,7352,7360,C
5-NP,495,0,7307,1,9,7317,T
5-NP,496,7,3,0,7652,7662,C
5-NP,497,0,7632,0,12,7644,T
5-NP,498,1,6,7655,2,7664,G
5-NP,499,7704,5,9,1,7719,A
5-NP,500,0,7683,0,5,7688,T
5-NP,501,1,3,7676,1,7681,G
5-NP,502,0,1,0,7677,7678,C
5-NP,503,7461,1,7,0,7469,A
5-NP,504,5,16,7672,0,7693,G
5-NP,505,2,14,7548,0,7564,G
5-NP,506,3,2,7649,0,7654,G
5-NP,507,5,1,1,7630,7637,C
5-NP,508,0,7596,0,13,7609,T
5-NP,509,10,3,0,7646,7659,C
5-NP,510,5,13,7642,0,7660,G
5-NP,511,7774,2,7,0,7783,A
5-NP,512,1,0,1,7783,7785,C
5-NP,513,2,7662,0,17,7681,T
5-NP,514,8,0,0,8098,8106,C
5-NP,515,2,8065,0,14,8081,T
5-NP,516,14,7,0,9250,9271,C
5-NP,517,5,2,0,9269,9276,C
5-NP,518,20,3,0,9263,9286,C
5-NP,519,0,9277,0,13,9290,T
5-NP,520,9249,0,5,0,9254,A
5-NP,521,18,6,9236,0,9260,G
5-NP,522,9234,0,6,0,9240,A
5-NP,523,8997,2,11,1,9011,A
5-NP,524,0,14,9014,0,9028,G
5-NP,525,10,4,8897,0,8911,G
5-NP,526,2,8800,0,6,8808,T
5-NP,527,6,2,1,8790,8799,C
5-NP,528,14,36,1,8754,8805,C
5-NP,529,19,10,8780,0,8809,G
5-NP,530,0,18,8850,1,8869,G
5-NP,531,8832,2,14,0,8848,A
5-NP,532,2,4,8954,0,8960,G
5-NP,533,3,3,0,8977,8983,C
5-NP,534,2,8860,0,25,8887,T
5-NP,535,4,5,8895,1,8905,G
5-NP,536,2,2,3,8926,8933,C
5-NP,537,8916,3,18,0,8937,A
5-NP,538,6,9,8964,0,8979,G
5-NP,539,2,7,8980,1,8990,G
5-NP,540,0,8988,1,6,8995,T
5-NP,541,1,5,8920,0,8926,G
5-NP,542,1,4,0,8957,8962,C
5-NP,543,3,8927,0,11,8941,T
5-NP,544,4,6,8954,0,8964,G
5-NP,545,0,4,1,8952,8957,C
5-NP,546,9057,1,12,0,9070,A
5-NP,547,0,3,9226,0,9229,G
5-NP,548,1,9162,1,10,9174,T
5-NP,549,14,4,1,9171,9190,C
5-NP,550,9188,1,3,0,9192,A
5-NP,551,9196,1,3,1,9201,A
5-NP,552,9169,3,26,1,9199,A
5-NP,553,3,8,9238,1,9250,G
5-NP,554,0,10,9290,0,9300,G
5-NP,555,9273,0,9,1,9283,A
5-NP,556,9218,0,9,1,9228,A
5-NP,557,1,9206,0,0,9207,T
5-NP,558,8,3,0,9180,9191,C
5-NP,559,7,20,9160,0,9187,G
5-NP,560,1,7,9432,1,9441,G
5-NP,561,3,13,9443,1,9460,G
5-NP,562,9403,2,24,0,9429,A
5-NP,563,4,5,1,9439,9449,C
5-NP,564,9360,0,9,0,9369,A
5-NP,565,9603,0,10,0,9613,A
5-NP,566,1,9635,1,16,9653,T
5-NP,567,4,13,9694,2,9713,G
5-NP,568,2,4,9966,1,9973,G
5-NP,569,1,9948,0,14,9963,T
5-NP,570,3,9,9970,2,9984,G
5-NP,571,9941,2,32,2,9977,A
5-NP,572,3,9933,0,12,9948,T
5-NP,573,9,17,9927,0,9953,G
5-NP,574,6,16,10062,1,10085,G
5-NP,575,10022,2,29,1,10054,A
5-NP,576,10033,1,9,0,10043,A
5-NP,577,5,17,1,10001,10024,C
5-NP,578,2,9700,2,9,9713,T
5-NP,579,1,18,10232,0,10251,G
5-NP,580,10228,3,9,0,10240,A
5-NP,581,2,10237,2,2,10243,T
5-NP,582,12,3,0,10249,10264,C
5-NP,583,10106,4,10,1,10121,A
5-NP,584,1,7,10471,1,10480,G
5-NP,585,10445,1,3,0,10449,A
5-NP,586,10434,1,15,0,10450,A
5-NP,587,0,10461,0,4,10465,T
5-NP,588,4,14,10283,2,10303,G
5-NP,589,5,5,10431,1,10442,G
5-NP,590,3,10420,2,18,10443,T
5-NP,591,16,2,0,10443,10461,C
5-NP,592,10447,0,6,0,10453,A
5-NP,593,10403,4,8,1,10416,A
5-NP,594,10416,0,12,0,10428,A
5-NP,595,2,26,0,10408,10436,C
5-NP,596,8,14,10390,0,10412,G
5-NP,597,1,24,10461,1,10487,G
5-NP,598,7,22,10381,0,10410,G
5-NP,599,3,20,10436,0,10459,G
5-NP,600,5,12,10449,1,10467,G
5-NP,601,10450,3,20,1,10474,A
5-NP,602,1,10394,2,20,10417,T
5-NP,603,10,8,0,10414,10432,C
5-NP,604,10430,5,9,0,10444,A
5-NP,605,10415,4,33,2,10454,A
5-NP,606,3,3,0,10363,10369,C
5-NP,607,2,11,10324,0,10337,G
5-NP,608,10307,3,14,2,10326,A
5-NP,609,2,10288,0,9,10299,T
5-NP,610,17,7,0,10284,10308,C
5-NP,611,0,9,10309,0,10318,G
5-NP,612,10295,5,2,0,10302,A
5-NP,613,10281,1,3,3,10288,A
5-NP,614,10295,1,6,1,10303,A
5-NP,615,3,10412,2,1,10418,T
5-NP,616,2,10388,4,3,10397,T
5-NP,617,0,10400,0,2,10402,T
5-NP,618,1,10438,3,0,10442,T
5-NP,619,4,10450,1,6,10461,T
5-NP,620,4,10,10462,0,10476,G
5-NP,621,0,17,10457,1,10475,G
5-NP,622,10389,4,12,0,10405,A
5-NP,623,1,8,10484,1,10494,G
5-NP,624,10314,3,23,1,10341,A
5-NP,625,1,10,10837,1,10849,G
5-NP,626,2,4,10884,0,10890,G
5-NP,627,1,10849,0,11,10861,T
5-NP,628,2,10,10913,0,10925,G
5-NP,629,10873,3,22,0,10898,A
5-NP,630,1,14,10951,0,10966,G
5-NP,631,10914,0,16,0,10930,A
5-NP,632,10888,1,17,1,10907,A
5-NP,633,1,10870,1,2,10874,T
5-NP,634,3,27,10512,1,10543,G
5-NP,635,1,8,10415,1,10425,G
5-NP,636,4,4,10457,2,10467,G
5-NP,637,3,6,1,10412,10422,C
5-NP,638,9,14,10413,1,10437,G
5-NP,639,3,16,10484,2,10505,G
5-NP,640,10482,2,4,0,10488,A
5-NP,641,10481,3,10,0,10494,A
5-NP,642,10681,2,5,1,10689,A
5-NP,643,10704,2,11,3,10720,A
5-NP,644,3,1,2,10783,10789,C
5-NP,645,10753,4,6,1,10764,A
5-NP,646,10733,3,15,0,10751,A
5-NP,647,1,11,10740,0,10752,G
5-NP,648,10486,1,18,0,10505,A
5-NP,649,10542,3,4,1,10550,A
5-NP,650,9,2,10801,0,10812,G
5-NP,651,2,10776,0,18,10796,T
5-NP,652,5,4,11289,0,11298,G
5-NP,653,4,4,0,11230,11238,C
5-NP,654,1,11233,1,19,11254,T
5-NP,655,0,11251,4,34,11289,T
5-NP,656,11438,0,3,0,11441,A
5-NP,657,0,11438,0,8,11446,T
5-NP,658,2,15,11471,1,11489,G
5-NP,659,11215,1,17,0,11233,A
5-NP,660,1,19,11261,0,11281,G
5-NP,661,10754,2,29,1,10786,A
5-NP,662,1,11,10835,1,10848,G
5-NP,663,10809,0,13,0,10822,A
5-NP,664,10928,0,3,0,10931,A
5-NP,665,2,10858,0,2,10862,T
5-NP,666,3,2,11012,1,11018,G
5-NP,667,2,10946,0,10,10958,T
5-NP,668,7,2,10987,0,10996,G
5-NP,669,2,2,1,10966,10971,C
5-NP,670,10951,1,10,0,10962,A
5-NP,671,10950,4,17,2,10973,A
5-NP,672,1,6,0,10937,10944,C
5-NP,673,10863,1,3,0,10867,A
5-NP,674,1,10880,1,6,10888,T
5-NP,675,2,10776,1,12,10791,T
5-NP,676,7,1,0,10817,10825,C
5-NP,677,1,10770,2,11,10784,T
5-NP,678,0,10782,0,1,10783,T
5-NP,679,10799,4,2,1,10806,A
5-NP,680,10758,3,2,0,10763,A
5-NP,681,10753,0,14,0,10767,A
5-NP,682,1,9,10763,0,10773,G
5-NP,683,1,7,10740,0,10748,G
5-NP,684,10724,1,11,0,10736,A
5-NP,685,10702,3,8,0,10713,A
5-NP,686,10690,2,7,3,10702,A
5-NP,687,10857,1,8,1,10867,A
5-NP,688,2,10817,1,8,10828,T
5-NP,689,4,10831,1,2,10838,T
5-NP,690,1,10875,0,3,10879,T
5-NP,691,5,4,1,10879,10889,C
5-NP,692,10883,0,5,1,10889,A
5-NP,693,10871,2,17,1,10891,A
5-NP,694,10877,0,14,0,10891,A
5-NP,695,2,1,0,11009,11012,C
5-NP,696,10893,1,3,3,10900,A
5-NP,697,4,0,11094,0,11098,G
5-NP,698,1,1,0,11095,11097,C
5-NP,699,6,11065,0,18,11089,T
5-NP,700,7,4,11298,0,11309,G
5-NP,701,5,7,1,11236,11249,C
5-NP,702,11363,2,17,0,11382,A
5-NP,703,5,3,1,11382,11391,C
5-NP,704,11312,1,6,0,11319,A
5-NP,705,11317,0,20,0,11337,A
5-NP,706,11073,1,13,0,11087,A
5-NP,707,0,20,11516,0,11536,G
5-NP,708,11484,4,26,1,11515,A
5-NP,709,2,1,11667,2,11672,G
5-NP,710,2,2,3,11633,11640,C
5-NP,711,11610,1,5,1,11617,A
5-NP,712,11961,0,8,0,11969,A
5-NP,713,1,11949,2,11,11963,T
5-NP,714,5,30,11983,1,12019,G
5-NP,715,3,4,12051,0,12058,G
5-NP,716,2,11719,1,11,11733,T
5-NP,717,10,11,11716,1,11738,G
5-NP,718,5,19,11815,0,11839,G
5-NP,719,11832,3,18,1,11854,A
5-NP,720,3,11792,0,31,11826,T
5-NP,721,18,1,1,11470,11490,C
5-NP,722,11515,0,12,0,11527,A
5-NP,723,11654,0,9,2,11665,A
5-NP,724,0,1,11700,0,11701,G
5-NP,725,3,11583,1,14,11601,T
5-NP,726,5,22,11577,0,11604,G
5-NP,727,11445,2,23,0,11470,A
5-NP,728,0,8,11534,0,11542,G
5-NP,729,11484,5,23,1,11513,A
5-NP,730,0,12,11500,0,11512,G
5-NP,731,11410,0,17,1,11428,A
5-NP,732,11248,0,3,1,11252,A
5-NP,733,11267,1,19,1,11288,A
5-NP,734,1,4,11353,1,11359,G
5-NP,735,4,11312,0,6,11322,T
5-NP,736,15,5,0,11290,11310,C
5-NP,737,12,16,11244,2,11274,G
5-NP,738,3,10,11285,1,11299,G
5-NP,739,11295,0,10,0,11305,A
5-NP,740,11342,1,10,0,11353,A
5-NP,741,6,2,1,11375,11384,C
5-NP,742,19,2,0,11289,11310,C
5-NP,743,23,4,2,11327,11356,C
5-NP,744,11325,2,12,11,11350,A
5-NP,745,4,12,11366,1,11383,G
5-NP,746,4,7,11382,0,11393,G
5-NP,747,11369,1,6,0,11376,A
5-NP,748,11358,1,9,1,11369,A
5-NP,749,11331,1,10,2,11344,A
5-NP,750,1,2,0,11391,11394,C
5-NP,751,9,1,11368,1,11379,G
5-NP,752,3,2,0,11354,11359,C
5-NP,753,2,11320,0,18,11340,T
5-NP,754,2,16,11349,0,11367,G
5-NP,755,11321,1,15,0,11337,A
5-NP,756,2,9,11491,0,11502,G
5-NP,757,11503,2,17,1,11523,A
5-NP,758,0,11487,2,7,11496,T
5-NP,759,11,4,0,11365,11380,C
5-NP,760,5,4,11401,1,11411,G
5-NP,761,11404,2,7,1,11414,A
5-NP,762,11389,2,12,0,11403,A
5-NP,763,0,4,11436,0,11440,G
5-NP,764,11449,1,7,1,11458,A
5-NP,765,3,11359,1,7,11370,T
5-NP,766,12,3,0,11451,11466,C
5-NP,767,3,11448,1,19,11471,T
5-NP,768,13,3,1,11564,11581,C
5-NP,769,11596,11,14,0,11621,A
5-NP,770,3,11587,0,6,11596,T
5-NP,771,11606,2,3,1,11612,A
5-NP,772,0,11570,1,5,11576,T
5-NP,773,2,11507,3,8,11520,T
5-NP,774,1,11465,1,5,11472,T
5-NP,775,2,11390,6,0,11398,T
5-NP,776,1,11412,2,2,11417,T
5-NP,777,11431,0,5,0,11436,A
5-NP,778,3,2,11420,0,11425,G
5-NP,779,2,5,1,11427,11435,C
5-NP,780,11399,3,3,2,11407,A
5-NP,781,11349,2,15,1,11367,A
5-NP,782,1,7,11755,0,11763,G
5-NP,783,11747,1,11,2,11761,A
5-NP,784,1,11749,0,8,11758,T
5-NP,785,9,1,1,11828,11839,C
5-NP,786,2,11763,1,17,11783,T
5-NP,787,6,2,12092,2,12102,G
5-NP,788,0,4,1,12123,12128,C
5-NP,789,12126,0,13,0,12139,A
5-NP,790,4,12217,1,7,12229,T
5-NP,791,2,11871,0,5,11878,T
5-NP,792,27,7,12572,0,12606,G
5-NP,793,12798,0,26,1,12825,A
5-NP,794,1,12808,0,6,12815,T
5-NP,795,12837,1,6,0,12844,A
5-NP,796,2,12590,0,12,12604,T
5-NP,797,0,12495,2,4,12501,T
5-NP,798,0,15,12580,2,12597,G
5-NP,799,12430,4,20,0,12454,A
5-NP,800,1,10,12543,0,12554,G
5-NP,801,11932,1,41,0,11974,A
5-NP,802,3,22,11740,1,11766,G
5-NP,803,7,18,11881,0,11906,G
5-NP,804,11869,3,19,0,11891,A
5-NP,805,1,11870,0,10,11881,T
5-NP,806,16,2,0,11885,11903,C
5-NP,807,11830,1,3,0,11834,A
5-NP,808,81,3,11817,0,11901,G
5-NP,809,1,11828,4,12,11845,T
5-NP,810,2,11756,0,2,11760,T
5-NP,811,2,5,11744,0,11751,G
5-NP,812,1,0,0,11630,11631,C
5-NP,813,3,11580,0,48,11631,T
5-NP,814,34,4,0,11640,11678,C
5-NP,815,11692,1,7,0,11700,A
5-NP,816,4,6,0,11707,11717,C
5-NP,817,11689,0,4,0,11693,A
5-NP,818,11736,6,6,1,11749,A
5-NP,819,11753,4,5,1,11763,A
5-NP,820,0,11749,1,5,11755,T
5-NP,821,10,3,0,11750,11763,C
5-NP,822,2,11727,0,9,11738,T
5-NP,823,3,11690,0,9,11702,T
5-NP,824,3,2,11751,0,11756,G
5-NP,825,5,3,1,11743,11752,C
5-NP,826,13,1,1,11903,11918,C
5-NP,827,1,11859,2,12,11874,T
5-NP,828,11912,2,22,1,11937,A
5-NP,829,3,0,0,11914,11917,C
5-NP,830,16,0,0,11909,11925,C
5-NP,831,4,11884,0,7,11895,T
5-NP,832,4,6,12077,1,12088,G
5-NP,833,2,6,0,12042,12050,C
5-NP,834,8,17,2,12046,12073,C
5-NP,835,2,11861,0,7,11870,T
5-NP,836,3,2,12009,0,12014,G
5-NP,837,2,11943,0,7,11952,T
5-NP,838,3,5,12079,0,12087,G
5-NP,839,5,10,0,12133,12148,C
5-NP,840,14,4,12300,1,12319,G
5-NP,841,0,12133,0,9,12142,T
5-NP,842,12106,2,5,0,12113,A
5-NP,843,3,12110,0,8,12121,T
5-NP,844,2,15,12109,1,12127,G
5-NP,845,0,15,12592,0,12607,G
5-NP,846,12538,4,24,1,12567,A
5-NP,847,9,22,0,12343,12374,C
5-NP,848,10,2,0,12341,12353,C
5-NP,849,0,12125,2,23,12150,T
5-NP,850,4,3,12706,1,12714,G
5-NP,851,5,5,0,12712,12722,C
5-NP,852,12728,1,15,0,12744,A
5-NP,853,5,9,12982,0,12996,G
5-NP,854,1,12367,0,7,12375,T
5-NP,855,12820,0,2,1,12823,A
5-NP,856,1,12762,0,14,12777,T
5-NP,857,11,5,1,12727,12744,C
5-NP,858,13,7,1,12746,12767,C
5-NP,859,12155,0,11,0,12166,A
5-NP,860,4,5,12215,0,12224,G
5-NP,861,1,12135,4,14,12154,T
5-NP,862,3,22,12242,1,12268,G
5-NP,863,1,20,12214,1,12236,G
5-NP,864,6,18,11995,0,12019,G
5-NP,865,0,11979,0,20,11999,T
5-NP,866,11963,3,10,0,11976,A
5-NP,867,1,10,1,11955,11967,C
5-NP,868,16,27,11870,0,11913,G
5-NP,869,11838,2,16,2,11858,A
5-NP,870,4,3,2,11841,11850,C
5-NP,871,2,11511,3,20,11536,T
5-NP,872,2,11554,0,2,11558,T
5-NP,873,7,10,0,11527,11544,C
5-NP,874,6,15,11543,1,11565,G
5-NP,875,11568,1,11,3,11583,A
5-NP,876,11566,0,3,2,11571,A
5-NP,877,11583,0,9,2,11594,A
5-NP,878,11385,2,195,0,11582,A
5-NP,879,11520,4,27,1,11552,A
5-NP,880,1,8,11597,0,11606,G
5-NP,881,11556,2,18,0,11576,A
5-NP,882,4,25,11626,1,11656,G
5-NP,883,2,22,11691,1,11716,G
5-NP,884,3,14,11723,1,11741,G
5-NP,885,11753,4,19,0,11776,A
5-NP,886,1,11748,0,11,11760,T
5-NP,887,11799,2,11,2,11814,A
5-NP,888,3,11780,0,16,11799,T
5-NP,889,2,11853,1,8,11864,T
5-NP,890,18,1,0,11901,11920,C
5-NP,891,12,2,1,11814,11829,C
5-NP,892,0,11665,2,10,11677,T
5-NP,893,3,11661,0,8,11672,T
5-NP,894,0,15,11753,1,11769,G
5-NP,895,2,2,11819,1,11824,G
5-NP,896,3,11734,1,13,11751,T
5-NP,897,3,30,11668,1,11702,G
5-NP,898,4,12,11678,1,11695,G
5-NP,899,6,13,12258,0,12277,G
5-NP,900,12251,0,17,2,12270,A
5-NP,901,12268,4,17,1,12290,A
5-NP,902,1,12283,0,6,12290,T
5-NP,903,12090,2,5,0,12097,A
5-NP,904,4,7,12090,1,12102,G
5-NP,905,11969,1,14,2,11986,A
5-NP,906,14,3,0,11958,11975,C
5-NP,907,19,3,0,11838,11860,C
5-NP,908,16,6,3,11478,11503,C
5-NP,909,1,11574,1,18,11594,T
5-NP,910,4,11590,0,10,11604,T
5-NP,911,0,11614,0,8,11622,T
5-NP,912,18,3,0,11613,11634,C
5-NP,913,11577,1,3,2,11583,A
5-NP,914,11588,0,4,0,11592,A
5-NP,915,11535,2,13,0,11550,A
5-NP,916,5,3,0,11574,11582,C
5-NP,917,0,11290,1,5,11296,T
5-NP,918,11192,2,14,1,11209,A
5-NP,919,3,2,0,11355,11360,C
5-NP,920,5,11271,2,32,11310,T
5-NP,921,3,11291,0,11,11305,T
5-NP,922,8,2,1,11340,11351,C
5-NP,923,11317,2,7,0,11326,A
5-NP,924,11335,0,2,0,11337,A
5-NP,925,11287,2,7,1,11297,A
5-NP,926,11273,1,9,2,11285,A
5-NP,927,4,11217,1,4,11226,T
5-NP,928,11076,1,3,1,11081,A
5-NP,929,5,2,11194,0,11201,G
5-NP,930,6,4,0,11234,11244,C
5-NP,931,6,12,2,11361,11381,C
5-NP,932,11381,3,4,0,11388,A
5-NP,933,11423,0,6,0,11429,A
5-NP,934,11768,2,11,0,11781,A
5-NP,935,2,11803,0,2,11807,T
5-NP,936,11840,3,6,0,11849,A
5-NP,937,2,11817,2,11,11832,T
5-NP,938,11620,6,14,0,11640,A
5-NP,939,5,0,0,11663,11668,C
5-NP,940,11360,1,16,1,11378,A
5-NP,941,1,3,11673,0,11677,G
5-NP,942,0,3,0,11655,11658,C
5-NP,943,1,11294,1,14,11310,T
5-NP,944,0,11411,1,3,11415,T
5-NP,945,11444,3,4,0,11451,A
5-NP,946,11450,1,8,1,11460,A
5-NP,947,0,11450,1,6,11457,T
5-NP,948,14,2,0,11413,11429,C
5-NP,949,11054,6,16,1,11077,A
5-NP,950,3,14,11159,0,11176,G
5-NP,951,11155,1,23,0,11179,A
5-NP,952,3,5,0,11231,11239,C
5-NP,953,8,3,0,11128,11139,C
5-NP,954,2,11006,0,10,11018,T
5-NP,955,11109,2,6,0,11117,A
5-NP,956,11107,1,14,0,11122,A
5-NP,957,1,4,0,11184,11189,C
5-NP,958,3,13,11171,1,11188,G
5-NP,959,10954,2,8,1,10965,A
5-NP,960,1,9,10969,1,10980,G
5-NP,961,10846,1,24,0,10871,A
5-NP,962,10973,2,9,0,10984,A
5-NP,963,1,10934,2,15,10952,T
5-NP,964,14,2,3,10826,10845,C
5-NP,965,15,3,0,10842,10860,C
5-NP,966,10675,2,18,0,10695,A
5-NP,967,9,2,10775,0,10786,G
5-NP,968,3,2,0,10766,10771,C
5-NP,969,10870,3,15,0,10888,A
5-NP,970,3,11,0,10914,10928,C
5-NP,971,10778,1,8,0,10787,A
5-NP,972,0,6,0,10815,10821,C
5-NP,973,10792,2,3,1,10798,A
5-NP,974,10819,1,32,1,10853,A
5-NP,975,1,11,10865,0,10877,G
5-NP,976,10722,1,28,1,10752,A
5-NP,977,1,3,10791,0,10795,G
5-NP,978,3,10572,1,16,10592,T
5-NP,979,15,0,0,10557,10572,C
5-NP,980,10535,0,17,0,10552,A
5-NP,981,2,0,10555,0,10557,G
5-NP,982,1,2,0,10549,10552,C
5-NP,983,0,10438,0,14,10452,T
5-NP,984,2,8,10604,0,10614,G
5-NP,985,2,4,10656,0,10662,G
5-NP,986,5,10586,1,6,10598,T
5-NP,987,5,4,10658,1,10668,G
5-NP,988,2,10524,0,15,10541,T
5-NP,989,4,16,10520,0,10540,G
5-NP,990,5,4,10505,1,10515,G
5-NP,991,10441,1,9,0,10451,A
5-NP,992,1,10466,1,10,10478,T
5-NP,993,1,16,10050,0,10067,G
5-NP,994,3,2,10029,0,10034,G
5-NP,995,4,4,1,10001,10010,C
5-NP,996,9902,1,5,2,9910,A
5-NP,997,11,9895,3,9,9918,T
5-NP,998,18,6,9826,0,9850,G
5-NP,999,6,14,1,9891,9912,C
5-NP,1000,15,3,1,9915,9934,C
5-NP,1001,9948,4,3,0,9955,A
5-NP,1002,3,9899,1,13,9916,T
5-NP,1003,1,9748,4,14,9767,T
5-NP,1004,11,2,1,9789,9803,C
5-NP,1005,2,9663,0,7,9672,T
5-NP,1006,4,3,9658,1,9666,G
5-NP,1007,2,5,1,9637,9645,C
5-NP,1008,0,9363,1,18,9382,T
5-NP,1009,6,0,9433,0,9439,G
5-NP,1010,3,1,0,9299,9303,C
5-NP,1011,9312,3,1,0,9316,A
5-NP,1012,1,9321,0,4,9326,T
5-NP,1013,2,9220,0,6,9228,T
5-NP,1014,4,9222,0,3,9229,T
5-NP,1015,1,8,9191,1,9201,G
5-NP,1016,9180,0,13,0,9193,A
5-NP,1017,9181,3,16,0,9200,A
5-NP,1018,0,2,9271,0,9273,G
5-NP,1019,9235,2,22,0,9259,A
5-NP,1020,1,9210,0,6,9217,T
5-NP,1021,0,9193,0,5,9198,T
5-NP,1022,3,9203,0,2,9208,T
5-NP,1023,9205,3,6,0,9214,A
5-NP,1024,9212,1,5,1,9219,A
5-NP,1025,0,5,9217,1,9223,G
5-NP,1026,9182,1,11,0,9194,A
5-NP,1027,3,9166,1,1,9171,T
5-NP,1028,1,8992,2,6,9001,T
5-NP,1029,2,2,9052,0,9056,G
5-NP,1030,0,9030,1,8,9039,T
5-NP,1031,1,9026,0,12,9039,T
5-NP,1032,9030,4,6,0,9040,A
5-NP,1033,9031,2,14,0,9047,A
5-NP,1034,1,1,9064,0,9066,G
5-NP,1035,2,4,0,9073,9079,C
5-NP,1036,0,8862,0,29,8891,T
5-NP,1037,1,8900,0,13,8914,T
5-NP,1038,12,5,1,8916,8934,C
5-NP,1039,8922,0,10,1,8933,A
5-NP,1040,0,8906,1,12,8919,T
5-NP,1041,5,1,0,8929,8935,C
5-NP,1042,8774,2,7,2,8785,A
5-NP,1043,0,4,8785,0,8789,G
5-NP,1044,8639,3,14,0,8656,A
5-NP,1045,1,25,8630,0,8656,G
5-NP,1046,3,15,8620,0,8638,G
5-NP,1047,2,12,8559,1,8574,G
5-NP,1048,8570,2,17,0,8589,A
5-NP,1049,1,2,0,8598,8601,C
5-NP,1050,8612,1,4,1,8618,A
5-NP,1051,8637,0,6,1,8644,A
5-NP,1052,8659,0,3,1,8663,A
5-NP,1053,8647,2,40,1,8690,A
5-NP,1054,2,2,8703,0,8707,G
5-NP,1055,1,8437,0,5,8443,T
5-NP,1056,8393,0,3,0,8396,A
5-NP,1057,2,8337,0,11,8350,T
5-NP,1058,10,3,0,8335,8348,C
5-NP,1059,4,8235,0,31,8270,T
5-NP,1060,16,0,0,8308,8324,C
5-NP,1061,8,2,0,8243,8253,C
5-NP,1062,2,8172,0,7,8181,T
5-NP,1063,15,6,0,8148,8169,C
5-NP,1064,2,11,8133,1,8147,G
5-NP,1065,1,19,8162,1,8183,G
5-NP,1066,6,18,8159,1,8184,G
5-NP,1067,4,7,8142,0,8153,G
5-NP,1068,3,9,8143,0,8155,G
5-NP,1069,8017,3,13,2,8035,A
5-NP,1070,8026,2,3,0,8031,A
5-NP,1071,8042,2,11,0,8055,A
5-NP,1072,0,1,0,8088,8089,C
5-NP,1073,1,8018,1,7,8027,T
5-NP,1074,3,5,8062,1,8071,G
5-NP,1075,3,7991,1,9,8004,T
5-NP,1076,10,2,3,7997,8012,C
5-NP,1077,8116,1,16,1,8134,A
5-NP,1078,8168,0,8,0,8176,A
5-NP,1079,2,3,0,8197,8202,C
5-NP,1080,0,8182,1,3,8186,T
5-NP,1081,8035,3,1,0,8039,A
5-NP,1082,1,9,8066,0,8076,G
5-NP,1083,7906,2,12,1,7921,A
5-NP,1084,3,9,7920,0,7932,G
5-NP,1085,0,9,7910,0,7919,G
5-NP,1086,7477,0,13,2,7492,A
5-NP,1087,1,2,7623,0,7626,G
5-NP,1088,1,7519,1,4,7525,T
5-NP,1089,7525,1,6,0,7532,A
5-NP,1090,3,1,1,7522,7527,C
5-NP,1091,7470,0,0,0,7470,A
5-NP,1092,7470,1,3,1,7475,A
5-NP,1093,7415,1,1,1,7418,A
5-NP,1094,0,7355,1,0,7356,T
5-NP,1095,1,7300,0,2,7303,T
5-NP,1096,1,1,7100,0,7102,G
5-NP,1097,3,1,0,7027,7031,C
5-NP,1098,1,7009,0,11,7021,T
5-NP,1099,5,7006,0,10,7021,T
5-NP,1100,5,0,1,7014,7020,C
5-NP,1101,7023,1,4,0,7028,A
5-NP,1102,7056,3,1,1,7061,A
5-NP,1103,7049,2,4,0,7055,A
5-NP,1104,2,7070,0,1,7073,T
5-NP,1105,1,14,7058,0,7073,G
5-NP,1106,6913,1,24,0,6938,A
5-NP,1107,0,4,6967,2,6973,G
5-NP,1108,6985,4,12,1,7002,A
5-NP,1109,6994,0,7,0,7001,A
5-NP,1110,1,1,1,7020,7023,C
5-NP,1111,6936,1,4,0,6941,A
5-NP,1112,2,6933,0,2,6937,T
5-NP,1113,5,6,7044,0,7055,G
5-NP,1114,2,3,7083,1,7089,G
5-NP,1115,7080,0,9,1,7090,A
5-NP,1116,1,6953,0,2,6956,T
5-NP,1117,6840,0,6,0,6846,A
5-NP,1118,7104,0,11,1,7116,A
5-NP,1119,2,6986,0,4,6992,T
5-NP,1120,6949,0,1,0,6950,A
5-NP,1121,0,6904,0,6,6910,T
5-NP,1122,75,13,6325,0,6413,G
5-NP,1123,1,8,6315,0,6324,G
5-NP,1124,2,6,6275,0,6283,G
5-NP,1125,6366,1,4,0,6371,A
5-NP,1126,1,6346,0,2,6349,T
5-NP,1127,5,1,0,5487,5493,C
5-NP,1128,2,5420,0,4,5426,T
5-NP,1129,5450,1,1,0,5452,A
5-NP,1130,1,2,5451,0,5454,G
5-NP,1131,2,3,1,5435,5441,C
5-NP,1132,5324,0,6,0,5330,A
5-NP,1133,4,1,0,5444,5449,C
5-NP,1134,1,5149,2,3,5155,T
5-NP,1135,6,3,0,5222,5231,C
5-NP,1136,1,5170,1,7,5179,T
5-NP,1137,1,5164,2,1,5168,T
5-NP,1138,3,15,5169,0,5187,G
5-NP,1139,5155,0,8,0,5163,A
5-NP,1140,5156,1,23,0,5180,A
5-NP,1141,1,96,0,5048,5145,C
5-NP,1142,0,4681,0,6,4687,T
5-NP,1143,0,6,4716,0,4722,G
5-NP,1144,4550,0,16,1,4567,A
5-NP,1145,0,0,4589,0,4589,G
5-NP,1146,4590,1,2,0,4593,A
5-NP,1147,4521,0,2,0,4523,A
5-NP,1148,0,1,4541,0,4542,G
5-NP,1149,2,0,0,4436,4438,C
5-NP,1150,5,13,4417,0,4435,G
5-NP,1151,3,2,4454,0,4459,G
5-NP,1152,3,3,4462,0,4468,G
5-NP,1153,1,4437,1,5,4444,T
5-NP,1154,4371,0,4,0,4375,A
5-NP,1155,2,0,1,4358,4361,C
5-NP,1156,1,3821,1,2,3825,T
5-NP,1157,2,9,3881,0,3892,G
5-NP,1158,2,5,3867,0,3874,G
5-NP,1159,1,3,3878,1,3883,G
5-NP,1160,3,1,0,3852,3856,C
5-NP,1161,5,0,0,3647,3652,C
5-NP,1162,3690,1,2,0,3693,A
5-NP,1163,0,3689,1,0,3690,T
5-NP,1164,3689,0,2,1,3692,A
5-NP,1165,3691,1,6,0,3698,A
5-NP,1166,1,4,3649,0,3654,G
5-NP,1167,0,10,3740,0,3750,G
5-NP,1168,3689,1,7,1,3698,A
5-NP,1169,1,3,0,3682,3686,C
5-NP,1170,3,1,0,3680,3684,C
5-NP,1171,3664,0,7,0,3671,A
5-NP,1172,0,7,3728,0,3735,G
5-NP,1173,1,4,3755,0,3760,G
5-NP,1174,3751,0,3,0,3754,A
5-NP,1175,1,1,3761,0,3763,G
5-NP,1176,1,3609,1,8,3619,T
5-NP,1177,1,2,3622,0,3625,G
5-NP,1178,0,5,3653,0,3658,G
5-NP,1179,3653,0,12,0,3665,A
5-NP,1180,0,4,3666,0,3670,G
5-NP,1181,0,2,3603,0,3605,G
5-NP,1182,3572,0,6,0,3578,A
5-NP,1183,3565,0,4,0,3569,A
5-NP,1184,3557,1,4,2,3564,A
5-NP,1185,1,0,0,3579,3580,C
5-NP,1186,3557,0,1,0,3558,A
5-NP,1187,1,0,0,3630,3631,C
5-NP,1188,0,3566,0,1,3567,T
5-NP,1189,3652,0,1,0,3653,A
5-NP,1190,3656,0,2,0,3658,A
5-NP,1191,2,3649,0,3,3654,T
5-NP,1192,2,1,0,3701,3704,C
5-NP,1193,3661,0,0,1,3662,A
5-NP,1194,3702,0,4,1,3707,A
5-NP,1195,0,0,0,3712,3712,C
5-NP,1196,3621,0,5,0,3626,A
5-NP,1197,2,4,3626,0,3632,G
5-NP,1198,3487,1,18,1,3507,A
5-NP,1199,0,3,3539,1,3543,G
5-NP,1200,0,4,3551,0,3555,G
5-NP,1201,2,0,3530,0,3532,G
5-NP,1202,1,1,0,3533,3535,C
5-NP,1203,7,0,0,3509,3516,C
5-NP,1204,0,3452,1,4,3457,T
5-NP,1205,2,1,0,3482,3485,C
5-NP,1206,3,2,1,3484,3490,C
5-NP,1207,3,0,3488,0,3491,G
5-NP,1208,1,1,0,3482,3484,C
5-NP,1209,3435,1,4,0,3440,A
5-NP,1210,0,5,3520,0,3525,G
5-NP,1211,1,1,3512,0,3514,G
5-NP,1212,0,1,0,3540,3541,C
5-NP,1213,6,1,0,3536,3543,C
5-NP,1214,3539,0,2,1,3542,A
5-NP,1215,3560,1,1,1,3563,A
5-NP,1216,3560,0,7,0,3567,A
5-NP,1217,0,0,0,3568,3568,C
5-NP,1218,0,3380,0,1,3381,T
5-NP,1219,3444,0,0,0,3444,A
5-NP,1220,0,0,3476,0,3476,G
5-NP,1221,0,3469,0,3,3472,T
5-NP,1222,0,3,3496,0,3499,G
5-NP,1223,1,3438,0,6,3445,T
5-NP,1224,2,1,3426,0,3429,G
5-NP,1225,1,2,1,3445,3449,C
5-NP,1226,3396,1,0,0,3397,A
5-NP,1227,3460,1,5,1,3467,A
5-NP,1228,1,0,1,3452,3454,C
5-NP,1229,3,0,0,3462,3465,C
5-NP,1230,0,3447,0,3,3450,T
5-NP,1231,3443,0,3,2,3448,A
5-NP,1232,3,0,0,3442,3445,C
5-NP,1233,1,2,3447,0,3450,G
5-NP,1234,1,3426,0,6,3433,T
5-NP,1235,2,3419,0,1,3422,T
5-NP,1236,0,3385,0,3,3388,T
5-NP,1237,2,3353,0,1,3356,T
5-NP,1238,1,1,0,3359,3361,C
5-NP,1239,1,3306,0,4,3311,T
5-NP,1240,3,1,3371,0,3375,G
5-NP,1241,0,3370,0,3,3373,T
5-NP,1242,3375,0,3,0,3378,A
5-NP,1243,1,1,0,3390,3392,C
5-NP,1244,3344,0,2,0,3346,A
5-NP,1245,3348,1,1,0,3350,A
5-NP,1246,3341,2,4,2,3349,A
5-NP,1247,1,2,3361,0,3364,G
5-NP,1248,3345,1,3,0,3349,A
5-NP,1249,3264,0,2,0,3266,A
5-NP,1250,3254,0,8,0,3262,A
5-NP,1251,2,1,0,3268,3271,C
5-NP,1252,3,1,1,3228,3233,C
5-NP,1253,1,3218,0,2,3221,T
5-NP,1254,4,0,1,3213,3218,C
5-NP,1255,3,0,0,3212,3215,C
5-NP,1256,13,0,0,3194,3207,C
5-NP,1257,3212,0,0,0,3212,A
5-NP,1258,1,3216,0,0,3217,T
5-NP,1259,0,3214,1,4,3219,T
5-NP,1260,0,3216,0,1,3217,T
5-NP,1261,1,4,3213,0,3218,G
5-NP,1262,3208,0,2,0,3210,A
5-NP,1263,3205,0,1,0,3206,A
5-NP,1264,3210,0,4,1,3215,A
5-NP,1265,3204,0,2,0,3206,A
5-NP,1266,1,0,3236,0,3237,G
5-NP,1267,2,3220,0,3,3225,T
5-NP,1268,4,0,0,3219,3223,C
5-NP,1269,3230,0,1,0,3231,A
5-NP,1270,3238,0,4,0,3242,A
5-NP,1271,0,1,0,3242,3243,C
5-NP,1272,3,1,0,3279,3283,C
5-NP,1273,3277,0,1,0,3278,A
5-NP,1274,0,3279,0,2,3281,T
5-NP,1275,2,2,0,3265,3269,C
5-NP,1276,3250,1,2,0,3253,A
5-NP,1277,0,3258,1,2,3261,T
5-NP,1278,0,4,3249,1,3254,G
5-NP,1279,0,0,3258,0,3258,G
5-NP,1280,0,2,0,3241,3243,C
5-NP,1281,3169,1,2,0,3172,A
5-NP,1282,1,0,3193,0,3194,G
5-NP,1283,3,1,0,3165,3169,C
5-NP,1284,3177,0,0,0,3177,A
5-NP,1285,0,3172,1,3,3176,T
5-NP,1286,0,3138,0,4,3142,T
5-NP,1287,4,1,0,3143,3148,C
5-NP,1288,3118,1,4,0,3123,A
5-NP,1289,0,0,0,3155,3155,C
5-NP,1290,1,3138,0,2,3141,T
5-NP,1291,0,0,3151,0,3151,G
5-NP,1292,10,1,3152,0,3163,G
5-NP,1293,3146,0,0,0,3146,A
5-NP,1294,3147,0,5,5,3157,A
5-NP,1295,3161,0,3,1,3165,A
5-NP,1296,0,3142,0,0,3142,T
5-NP,1297,3147,0,3,0,3150,A
5-NP,1298,1,2,0,3129,3132,C
5-NP,1299,3,8,3077,0,3088,G
5-NP,1300,1,2,3090,0,3093,G
5-NP,1301,2997,1,6,1,3005,A
5-NP,1302,1,8,3033,0,3042,G
5-NP,1303,1,6,3021,0,3028,G
5-NP,1304,0,7,3033,0,3040,G
5-NP,1305,3028,0,4,0,3032,A
5-NP,1306,3021,0,6,0,3027,A
5-NP,1307,0,3,3028,0,3031,G
5-NP,1308,3030,0,1,0,3031,A
5-NP,1309,3027,1,5,0,3033,A
5-NP,1310,1,0,0,3057,3058,C
5-NP,1311,0,3012,0,10,3022,T
5-NP,1312,1,3036,0,2,3039,T
5-NP,1313,4,0,0,3027,3031,C
5-NP,1314,3028,1,4,0,3033,A
5-NP,1315,1,3,3041,0,3045,G
5-NP,1316,3017,0,3,0,3020,A
5-NP,1317,1,0,0,3025,3026,C
5-NP,1318,2989,0,1,0,2990,A
5-NP,1319,0,2919,0,1,2920,T
5-NP,1320,2,2,2912,0,2916,G
5-NP,1321,2876,0,7,0,2883,A
5-NP,1322,1,12,2886,0,2899,G
5-NP,1323,1,3,2892,0,2896,G
5-NP,1324,2,1,2894,0,2897,G
5-NP,1325,0,0,0,2893,2893,C
5-NP,1326,2863,0,3,0,2866,A
5-NP,1327,2,1,2868,0,2871,G
5-NP,1328,2862,1,1,1,2865,A
5-NP,1329,2882,0,3,0,2885,A
5-NP,1330,2880,0,1,0,2881,A
5-NP,1331,0,2852,1,7,2860,T
5-NP,1332,1,1,0,2862,2864,C
5-NP,1333,2863,0,2,0,2865,A
5-NP,1334,0,2848,0,0,2848,T
5-NP,1335,2861,0,1,0,2862,A
5-NP,1336,2844,0,4,0,2848,A
5-NP,1337,0,8,2868,0,2876,G
5-NP,1338,2835,1,2,0,2838,A
5-NP,1339,2857,0,0,0,2857,A
5-NP,1340,0,2808,1,0,2809,T
5-NP,1341,0,1,2805,0,2806,G
5-NP,1342,2799,2,5,0,2806,A
5-NP,1343,0,2796,1,5,2802,T
5-NP,1344,2,2,2805,0,2809,G
5-NP,1345,0,3,2800,0,2803,G
5-NP,1346,2737,1,1,0,2739,A
5-NP,1347,2721,1,5,0,2727,A
5-NP,1348,0,8,2656,0,2664,G
5-NP,1349,0,1,2703,0,2704,G
5-NP,1350,1,2663,0,2,2666,T
5-NP,1351,1,2,2663,0,2666,G
5-NP,1352,1,0,0,2660,2661,C
5-NP,1353,2661,0,2,0,2663,A
5-NP,1354,2660,0,1,0,2661,A
5-NP,1355,2648,1,0,0,2649,A
5-NP,1356,2677,0,3,1,2681,A
5-NP,1357,1,2,0,2684,2687,C
5-NP,1358,4,3,0,2640,2647,C
5-NP,1359,2599,0,3,0,2602,A
5-NP,1360,1,1,2608,0,2610,G
5-NP,1361,2600,1,6,0,2607,A
5-NP,1362,2609,0,3,0,2612,A
5-NP,1363,0,0,2620,0,2620,G
5-NP,1364,2596,0,0,0,2596,A
5-NP,1365,2516,1,3,0,2520,A
5-NP,1366,2,1,2556,0,2559,G
5-NP,1367,1,2529,1,4,2535,T
5-NP,1368,1,0,2540,0,2541,G
5-NP,1369,0,2508,0,6,2514,T
5-NP,1370,6,0,0,2515,2521,C
5-NP,1371,2520,0,6,0,2526,A
5-NP,1372,0,2538,0,2,2540,T
5-NP,1373,0,2519,0,1,2520,T
5-NP,1374,3,0,0,2538,2541,C
5-NP,1375,2,3,0,2480,2485,C
5-NP,1376,2,5,2474,1,2482,G
5-NP,1377,0,8,2468,0,2476,G
5-NP,1378,1,6,2465,0,2472,G
5-NP,1379,0,3,2461,0,2464,G
5-NP,1380,3,3,2460,0,2466,G
5-NP,1381,2393,0,3,0,2396,A
5-NP,1382,1,5,2395,0,2401,G
5-NP,1383,0,6,2395,0,2401,G
5-NP,1384,0,0,2396,0,2396,G
5-NP,1385,1,6,2401,0,2408,G
5-NP,1386,2379,0,5,0,2384,A
5-NP,1387,0,1,2393,0,2394,G
5-NP,1388,0,2365,1,5,2371,T
5-NP,1389,1,2346,0,10,2357,T
5-NP,1390,0,2372,0,2,2374,T
5-NP,1391,1,2361,0,0,2362,T
5-NP,1392,4,1,1,2357,2363,C
5-NP,1393,1,1,2362,0,2364,G
5-NP,1394,2351,2,3,0,2356,A
5-NP,1395,1,0,2361,0,2362,G
5-NP,1396,0,1,0,2317,2318,C
5-NP,1397,0,2314,0,4,2318,T
5-NP,1398,1,1,0,2332,2334,C
5-NP,1399,0,2332,0,6,2338,T
5-NP,1400,0,4,0,2341,2345,C
5-NP,1401,2347,0,1,0,2348,A
5-NP,1402,2,0,2358,0,2360,G
5-NP,1403,2350,2,4,0,2356,A
5-NP,1404,1,1,0,2346,2348,C
5-NP,1405,2,5,2333,0,2340,G
5-NP,1406,2293,1,1,0,2295,A
5-NP,1407,0,2,2294,0,2296,G
5-NP,1408,2264,0,2,0,2266,A
5-NP,1409,2255,0,2,0,2257,A
5-NP,1410,0,1,2254,0,2255,G
5-NP,1411,0,0,2243,0,2243,G
5-NP,1412,0,3,0,2235,2238,C
5-NP,1413,2234,0,1,0,2235,A
5-NP,1414,2227,2,5,0,2234,A
5-NP,1415,3,0,0,2233,2236,C
5-NP,1416,0,1,2230,0,2231,G
5-NP,1417,2230,0,0,0,2230,A
5-NP,1418,2227,0,1,0,2228,A
5-NP,1419,0,0,0,2217,2217,C
5-NP,1420,2,0,0,2203,2205,C
5-NP,1421,5,3,0,2183,2191,C
5-NP,1422,2,3,2178,0,2183,G
5-NP,1423,2181,0,4,0,2185,A
5-NP,1424,0,2183,0,2,2185,T
5-NP,1425,4,1,0,2136,2141,C
5-NP,1426,1,0,2129,0,2130,G
5-NP,1427,0,2121,0,1,2122,T
5-NP,1428,1,0,2118,0,2119,G
5-NP,1429,1,2,0,2110,2113,C
5-NP,1430,5,0,0,2099,2104,C
5-NP,1431,7,1,0,2095,2103,C
5-NP,1432,0,2060,0,4,2064,T
5-NP,1433,4,0,0,2124,2128,C
5-NP,1434,0,2121,0,2,2123,T
5-NP,1435,0,2120,2,1,2123,T
5-NP,1436,1,2113,0,2,2116,T
5-NP,1437,0,2088,11,0,2099,T
5-NP,1438,0,0,2115,0,2115,G
5-NP,1439,2108,0,0,0,2108,A
5-NP,1440,0,2090,0,0,2090,T
5-NP,1441,2074,0,1,0,2075,A
5-NP,1442,0,1719,1,0,1720,T
5-NP,1443,1,3,1734,0,1738,G
5-NP,1444,1708,0,3,0,1711,A
5-NP,1445,4,0,1715,0,1719,G
5-NP,1446,0,1709,1,2,1712,T
5-NP,1447,1671,0,0,0,1671,A
5-NP,1448,1674,0,0,0,1674,A
5-NP,1449,0,1671,0,1,1672,T
5-NP,1450,1,0,1666,0,1667,G
5-NP,1451,1656,0,1,0,1657,A
5-NP,1452,1452,2,4,1,1459,A
5-NP,1453,1,1,1453,0,1455,G
5-NP,1454,0,2,1339,0,1341,G
5-NP,1455,1331,0,2,0,1333,A
5-NP,1456,0,1329,0,2,1331,T
5-NP,1457,2,1,0,1315,1318,C
5-NP,1458,0,1302,1,2,1305,T
5-NP,1459,0,1300,0,0,1300,T
5-NP,1460,1299,0,1,0,1300,A
5-NP,1461,1,1295,0,1,1297,T
5-NP,1462,0,1277,0,2,1279,T
5-NP,1463,0,1267,0,2,1269,T
5-NP,1464,2,0,0,1241,1243,C
5-NP,1465,1,1193,0,2,1196,T
5-NP,1466,1,1189,0,2,1192,T
5-NP,1467,2,1,0,1189,1192,C
5-NP,1468,3,0,1180,1,1184,G
5-NP,1469,0,2,1183,0,1185,G
5-NP,1470,1173,1,0,0,1174,A
5-NP,1471,0,1,1179,0,1180,G
5-NP,1472,1174,0,1,0,1175,A
5-NP,1473,0,0,0,1157,1157,C
5-NP,1474,1088,0,1,0,1089,A
5-NP,1475,1087,0,2,0,1089,A
5-NP,1476,0,1089,0,0,1089,T
5-NP,1477,0,0,1086,1,1087,G
5-NP,1478,0,0,0,1087,1087,C
5-NP,1479,1043,0,3,0,1046,A
5-NP,1480,1,0,1039,0,1040,G
5-NP,1481,1042,0,0,0,1042,A
5-NP,1482,967,0,2,0,969,A
5-NP,1483,0,0,969,0,969,G
5-NP,1484,610,0,3,0,613,A
5-NP,1485,0,0,613,0,613,G
5-NP,1486,0,562,0,0,562,T
5-NP,1487,557,0,1,0,558,A
5-NP,1488,0,1,0,555,556,C
5-NP,1489,0,0,505,0,505,G
5-NP,1490,501,1,3,0,505,A
5-NP,1491,0,0,0,499,499,C
5-NP,1492,366,0,0,0,366,A
5-NP,1493,364,0,0,0,364,A
5-NP,1494,0,288,0,1,289,T
5-NP,1495,0,274,0,0,274,T
5-NP,1496,274,0,0,0,274,A
5-NP,1497,260,0,0,0,260,A
6-NA,1,5,0,0,0,5,A
6-NA,2,0,5,0,0,5,T
6-NA,3,0,0,4,0,4,G
6-NA,4,4,0,1,0,5,A
6-NA,5,7,0,0,0,7,A
6-NA,6,0,7,0,0,7,T
6-NA,7,0,0,0,7,7,C
6-NA,8,0,0,0,7,7,C
6-NA,9,7,0,0,0,7,A
6-NA,10,7,0,0,0,7,A
6-NA,11,7,0,0,0,7,A
6-NA,12,0,7,0,0,7,T
6-NA,13,0,0,0,7,7,C
6-NA,14,7,0,0,0,7,A
6-NA,15,7,0,0,0,7,A
6-NA,16,7,0,0,0,7,A
6-NA,17,8,0,0,0,8,A
6-NA,18,0,0,9,0,9,G
6-NA,19,9,0,0,0,9,A
6-NA,20,0,9,0,0,9,T
6-NA,21,9,0,0,0,9,A
6-NA,22,9,0,0,0,9,A
6-NA,23,0,9,0,0,9,T
6-NA,24,9,0,0,0,9,A
6-NA,25,9,0,0,0,9,A
6-NA,26,0,0,0,10,10,C
6-NA,27,0,0,11,0,11,G
6-NA,28,10,0,0,0,10,A
6-NA,29,0,11,0,0,11,T
6-NA,30,0,11,0,0,11,T
6-NA,31,0,0,11,0,11,G
6-NA,32,0,0,11,0,11,G
6-NA,33,0,0,0,11,11,C
6-NA,34,0,11,0,0,11,T
6-NA,35,0,0,0,13,13,C
6-NA,36,0,13,0,0,13,T
6-NA,37,0,0,13,0,13,G
6-NA,38,0,13,0,0,13,T
6-NA,39,0,14,0,0,14,T
6-NA,40,0,14,0,0,14,T
6-NA,41,0,0,0,15,15,C
6-NA,42,0,15,0,0,15,T
6-NA,43,0,0,0,15,15,C
6-NA,44,0,15,0,0,15,T
6-NA,45,0,0,0,15,15,C
6-NA,46,14,0,0,0,14,A
6-NA,47,0,0,0,15,15,C
6-NA,48,0,0,0,15,15,C
6-NA,49,15,0,0,0,15,A
6-NA,50,0,15,0,1,16,T
6-NA,51,0,18,0,0,18,T
6-NA,52,0,18,0,0,18,T
6-NA,53,0,0,0,18,18,C
6-NA,54,0,0,0,17,17,C
6-NA,55,18,0,0,0,18,A
6-NA,56,0,0,0,18,18,C
6-NA,57,18,0,0,0,18,A
6-NA,58,19,0,0,0,19,A
6-NA,59,0,20,0,0,20,T
6-NA,60,20,0,0,0,20,A
6-NA,61,0,20,0,0,20,T
6-NA,62,1,0,19,0,20,G
6-NA,63,0,0,0,20,20,C
6-NA,64,0,20,0,0,20,T
6-NA,65,0,21,0,0,21,T
6-NA,66,0,0,0,21,21,C
6-NA,67,0,21,0,0,21,T
6-NA,68,0,21,0,0,21,T
6-NA,69,0,0,0,21,21,C
6-NA,70,21,0,0,0,21,A
6-NA,71,0,21,0,0,21,T
6-NA,72,0,0,21,0,21,G
6-NA,73,0,0,0,21,21,C
6-NA,74,22,0,0,0,22,A
6-NA,75,22,0,0,0,22,A
6-NA,76,22,0,0,0,22,A
6-NA,77,0,23,0,0,23,T
6-NA,78,0,23,0,0,23,T
6-NA,79,0,0,23,0,23,G
6-NA,80,0,0,0,23,23,C
6-NA,81,0,0,0,23,23,C
6-NA,82,23,0,0,0,23,A
6-NA,83,0,23,0,0,23,T
6-NA,84,0,0,0,25,25,C
6-NA,85,0,25,0,0,25,T
6-NA,86,0,25,0,0,25,T
6-NA,87,0,1,24,0,25,G
6-NA,88,25,0,0,0,25,A
6-NA,89,0,25,0,0,25,T
6-NA,90,25,0,0,0,25,A
6-NA,91,25,0,0,0,25,A
6-NA,92,0,0,0,29,29,C
6-NA,93,0,30,0,0,30,T
6-NA,94,30,0,0,0,30,A
6-NA,95,0,0,0,30,30,C
6-NA,96,0,30,0,0,30,T
6-NA,97,0,0,31,0,31,G
6-NA,98,0,31,0,0,31,T
6-NA,99,31,0,0,0,31,A
6-NA,100,30,0,0,0,30,A
6-NA,101,0,0,0,29,29,C
6-NA,102,29,0,0,0,29,A
6-NA,103,0,29,0,0,29,T
6-NA,104,0,28,0,0,28,T
6-NA,105,0,0,28,0,28,G
6-NA,106,0,0,0,28,28,C
6-NA,107,29,0,0,0,29,A
6-NA,108,0,29,0,0,29,T
6-NA,109,0,29,0,0,29,T
6-NA,110,0,29,0,0,29,T
6-NA,111,0,0,0,29,29,C
6-NA,112,29,0,0,0,29,A
6-NA,113,29,0,0,0,29,A
6-NA,114,0,0,28,0,28,G
6-NA,115,0,0,0,29,29,C
6-NA,116,29,0,0,0,29,A
6-NA,117,30,0,0,0,30,A
6-NA,118,0,30,0,0,30,T
6-NA,119,29,0,0,0,29,A
6-NA,120,0,30,0,0,30,T
6-NA,121,0,0,31,0,31,G
6-NA,122,30,0,0,0,30,A
6-NA,123,31,0,0,0,31,A
6-NA,124,0,32,0,0,32,T
6-NA,125,0,32,0,0,32,T
6-NA,126,0,0,0,32,32,C
6-NA,127,31,0,0,1,32,A
6-NA,128,32,0,0,0,32,A
6-NA,129,0,0,0,32,32,C
6-NA,130,0,31,0,0,31,T
6-NA,131,0,0,0,30,30,C
6-NA,132,0,0,0,30,30,C
6-NA,133,0,1,0,30,31,C
6-NA,134,0,0,0,31,31,C
6-NA,135,0,0,0,32,32,C
6-NA,136,0,0,0,32,32,C
6-NA,137,0,0,0,32,32,C
6-NA,138,32,0,0,0,32,A
6-NA,139,31,0,0,0,31,A
6-NA,140,32,0,0,0,32,A
6-NA,141,0,0,0,33,33,C
6-NA,142,33,0,0,0,33,A
6-NA,143,34,0,0,0,34,A
6-NA,144,0,0,0,35,35,C
6-NA,145,0,0,0,36,36,C
6-NA,146,37,0,0,0,37,A
6-NA,147,36,0,0,0,36,A
6-NA,148,0,0,39,0,39,G
6-NA,149,0,40,0,0,40,T
6-NA,150,0,0,39,0,39,G
6-NA,151,42,0,0,0,42,A
6-NA,152,0,42,0,0,42,T
6-NA,153,0,0,41,0,41,G
6-NA,154,0,0,0,42,42,C
6-NA,155,0,41,0,0,41,T
6-NA,156,1,1,43,0,45,G
6-NA,157,0,46,0,0,46,T
6-NA,158,0,1,44,0,45,G
6-NA,159,0,46,0,0,46,T
6-NA,160,0,0,45,0,45,G
6-NA,161,45,0,0,0,45,A
6-NA,162,45,0,0,0,45,A
6-NA,163,0,0,0,46,46,C
6-NA,164,1,0,0,45,46,C
6-NA,165,45,0,0,0,45,A
6-NA,166,45,0,0,0,45,A
6-NA,167,0,0,0,46,46,C
6-NA,168,46,0,0,0,46,A
6-NA,169,46,0,0,0,46,A
6-NA,170,0,46,1,0,47,T
6-NA,171,47,0,0,0,47,A
6-NA,172,47,0,0,0,47,A
6-NA,173,0,47,0,0,47,T
6-NA,174,46,0,0,0,46,A
6-NA,175,0,0,47,0,47,G
6-NA,176,46,0,0,0,46,A
6-NA,177,45,0,0,0,45,A
6-NA,178,47,0,0,0,47,A
6-NA,179,0,0,47,0,47,G
6-NA,180,50,0,0,0,50,A
6-NA,181,50,0,0,0,50,A
6-NA,182,55,0,0,0,55,A
6-NA,183,0,0,0,56,56,C
6-NA,184,56,0,0,0,56,A
6-NA,185,0,58,0,0,58,T
6-NA,186,58,0,0,0,58,A
6-NA,187,56,0,2,0,58,A
6-NA,188,0,0,0,59,59,C
6-NA,189,59,0,0,0,59,A
6-NA,190,0,0,59,0,59,G
6-NA,191,59,0,0,0,59,A
6-NA,192,0,0,60,0,60,G
6-NA,193,60,0,0,0,60,A
6-NA,194,0,58,0,0,58,T
6-NA,195,58,0,0,0,58,A
6-NA,196,1,0,58,0,59,G
6-NA,197,0,59,0,0,59,T
6-NA,198,0,0,60,0,60,G
6-NA,199,0,59,0,0,59,T
6-NA,200,60,0,0,0,60,A
6-NA,201,0,58,0,0,58,T
6-NA,202,0,0,0,60,60,C
6-NA,203,0,59,0,0,59,T
6-NA,204,0,0,60,0,60,G
6-NA,205,59,0,0,0,59,A
6-NA,206,0,0,0,59,59,C
6-NA,207,0,0,0,60,60,C
6-NA,208,60,0,0,0,60,A
6-NA,209,60,0,0,0,60,A
6-NA,210,0,0,0,61,61,C
6-NA,211,61,0,0,0,61,A
6-NA,212,0,0,0,64,64,C
6-NA,213,0,0,0,64,64,C
6-NA,214,65,0,0,0,65,A
6-NA,215,0,0,0,67,67,C
6-NA,216,1,0,0,66,67,C
6-NA,217,67,0,0,0,67,A
6-NA,218,0,67,0,0,67,T
6-NA,219,66,0,0,0,66,A
6-NA,220,0,1,65,0,66,G
6-NA,221,63,0,0,0,63,A
6-NA,222,0,0,63,0,63,G
6-NA,223,61,0,0,0,61,A
6-NA,224,62,0,0,0,62,A
6-NA,225,0,0,63,0,63,G
6-NA,226,0,0,63,0,63,G
6-NA,227,62,0,0,0,62,A
6-NA,228,66,0,0,0,66,A
6-NA,229,66,0,0,0,66,A
6-NA,230,0,66,0,0,66,T
6-NA,231,66,0,0,0,66,A
6-NA,232,0,66,0,0,66,T
6-NA,233,0,0,67,0,67,G
6-NA,234,0,0,0,68,68,C
6-NA,235,0,0,0,66,66,C
6-NA,236,0,0,0,67,67,C
6-NA,237,0,0,0,66,66,C
6-NA,238,67,0,0,0,67,A
6-NA,239,71,0,0,0,71,A
6-NA,240,71,0,0,0,71,A
6-NA,241,0,0,0,70,70,C
6-NA,242,0,71,0,0,71,T
6-NA,243,70,0,0,0,70,A
6-NA,244,0,0,70,0,70,G
6-NA,245,0,0,0,70,70,C
6-NA,246,69,0,0,0,69,A
6-NA,247,0,0,73,0,73,G
6-NA,248,73,0,0,0,73,A
6-NA,249,75,0,0,0,75,A
6-NA,250,0,75,0,0,75,T
6-NA,251,76,0,0,0,76,A
6-NA,252,0,0,0,76,76,C
6-NA,253,76,0,0,0,76,A
6-NA,254,0,0,77,0,77,G
6-NA,255,77,0,0,0,77,A
6-NA,256,77,0,0,0,77,A
6-NA,257,75,0,0,1,76,A
6-NA,258,0,75,0,0,75,T
6-NA,259,0,75,0,0,75,T
6-NA,260,0,0,78,0,78,G
6-NA,261,0,0,77,0,77,G
6-NA,262,1,75,0,1,77,T
6-NA,263,0,0,0,77,77,C
6-NA,264,77,0,0,0,77,A
6-NA,265,77,0,0,0,77,A
6-NA,266,77,0,0,0,77,A
6-NA,267,0,0,77,0,77,G
6-NA,268,0,0,0,77,77,C
6-NA,269,0,0,0,77,77,C
6-NA,270,0,0,76,0,76,G
6-NA,271,0,0,0,78,78,C
6-NA,272,78,0,0,0,78,A
6-NA,273,77,1,0,0,78,A
6-NA,274,0,78,0,0,78,T
6-NA,275,0,0,78,0,78,G
6-NA,276,0,0,0,78,78,C
6-NA,277,0,0,79,0,79,G
6-NA,278,78,0,1,0,79,A
6-NA,279,0,0,0,79,79,C
6-NA,280,79,0,0,0,79,A
6-NA,281,0,80,0,0,80,T
6-NA,282,0,79,0,0,79,T
6-NA,283,80,0,0,0,80,A
6-NA,284,0,0,0,79,79,C
6-NA,285,80,0,0,0,80,A
6-NA,286,0,0,80,0,80,G
6-NA,287,0,0,79,0,79,G
6-NA,288,79,0,0,0,79,A
6-NA,289,0,78,0,0,78,T
6-NA,290,0,78,0,0,78,T
6-NA,291,0,78,0,0,78,T
6-NA,292,0,0,77,0,77,G
6-NA,293,0,0,0,77,77,C
6-NA,294,77,0,0,0,77,A
6-NA,295,0,0,0,78,78,C
6-NA,296,1,0,0,78,79,C
6-NA,297,0,77,0,0,77,T
6-NA,298,0,79,0,0,79,T
6-NA,299,0,81,0,0,81,T
6-NA,300,0,81,0,0,81,T
6-NA,301,0,82,0,0,82,T
6-NA,302,0,0,0,84,84,C
6-NA,303,0,84,0,0,84,T
6-NA,304,84,0,0,0,84,A
6-NA,305,84,0,0,0,84,A
6-NA,306,0,0,85,0,85,G
6-NA,307,0,0,85,0,85,G
6-NA,308,84,0,1,0,85,A
6-NA,309,0,0,0,85,85,C
6-NA,310,84,0,0,0,84,A
6-NA,311,83,0,0,0,83,A
6-NA,312,0,85,0,0,85,T
6-NA,313,0,85,0,0,85,T
6-NA,314,0,0,0,86,86,C
6-NA,315,0,0,85,0,85,G
6-NA,316,85,0,0,0,85,A
6-NA,317,1,84,0,0,85,T
6-NA,318,0,84,0,0,84,T
6-NA,319,84,0,0,0,84,A
6-NA,320,0,0,83,0,83,G
6-NA,321,0,0,84,0,84,G
6-NA,322,0,0,0,84,84,C
6-NA,323,0,84,0,0,84,T
6-NA,324,0,83,1,0,84,T
6-NA,325,0,83,0,0,83,T
6-NA,326,0,0,0,84,84,C
6-NA,327,0,0,0,84,84,C
6-NA,328,0,0,84,0,84,G
6-NA,329,0,0,0,84,84,C
6-NA,330,0,83,0,0,83,T
6-NA,331,0,0,85,0,85,G
6-NA,332,0,0,85,0,85,G
6-NA,333,0,84,0,0,84,T
6-NA,334,0,0,84,0,84,G
6-NA,335,0,0,84,0,84,G
6-NA,336,1,0,83,0,84,G
6-NA,337,0,0,84,0,84,G
6-NA,338,84,0,0,0,84,A
6-NA,339,0,0,0,85,85,C
6-NA,340,85,0,0,0,85,A
6-NA,341,0,85,0,0,85,T
6-NA,342,0,1,0,84,85,C
6-NA,343,0,85,0,0,85,T
6-NA,344,0,1,84,0,85,G
6-NA,345,0,0,84,0,84,G
6-NA,346,0,0,84,0,84,G
6-NA,347,0,83,0,0,83,T
6-NA,348,0,0,81,0,81,G
6-NA,349,81,0,0,0,81,A
6-NA,350,0,0,0,95,95,C
6-NA,351,97,0,0,0,97,A
6-NA,352,197,0,0,0,197,A
6-NA,353,0,0,222,0,222,G
6-NA,354,232,0,0,0,232,A
6-NA,355,0,0,325,0,325,G
6-NA,356,394,0,0,0,394,A
6-NA,357,605,0,0,1,606,A
6-NA,358,0,0,0,1273,1273,C
6-NA,359,0,0,0,1556,1556,C
6-NA,360,1,1557,0,0,1558,T
6-NA,361,0,1606,0,2,1608,T
6-NA,362,1616,0,2,0,1618,A
6-NA,363,0,1635,1,0,1636,T
6-NA,364,0,0,1890,0,1890,G
6-NA,365,1,1932,0,2,1935,T
6-NA,366,1,0,2094,0,2095,G
6-NA,367,0,2105,0,0,2105,T
6-NA,368,3,0,0,2114,2117,C
6-NA,369,2119,22,0,42,2183,A
6-NA,370,0,2182,0,4,2186,T
6-NA,371,0,0,2177,0,2177,G
6-NA,372,0,2,0,2180,2182,C
6-NA,373,0,5,2187,0,2192,G
6-NA,374,2734,2,2,0,2738,A
6-NA,375,0,2747,0,1,2748,T
6-NA,376,1,1,0,2846,2848,C
6-NA,377,2,0,1,2855,2858,C
6-NA,378,0,2972,0,9,2981,T
6-NA,379,1,5,3034,1,3041,G
6-NA,380,3040,1,2,0,3043,A
6-NA,381,0,0,0,3056,3056,C
6-NA,382,3052,0,6,0,3058,A
6-NA,383,3077,0,2,1,3080,A
6-NA,384,1,1,3304,0,3306,G
6-NA,385,0,3311,6,2,3319,T
6-NA,386,1,0,3404,0,3405,G
6-NA,387,0,3405,1,10,3416,T
6-NA,388,0,3419,0,2,3421,T
6-NA,389,3417,0,1,0,3418,A
6-NA,390,1,3421,0,3,3425,T
6-NA,391,3,1,0,3505,3509,C
6-NA,392,3522,0,5,0,3527,A
6-NA,393,3519,1,3,2,3525,A
6-NA,394,2,3532,0,2,3536,T
6-NA,395,0,3521,0,6,3527,T
6-NA,396,0,3532,0,2,3534,T
6-NA,397,2,1,3567,0,3570,G
6-NA,398,0,1,0,3898,3899,C
6-NA,399,7,1,0,3899,3907,C
6-NA,400,3,11,0,3910,3924,C
6-NA,401,0,3916,0,8,3924,T
6-NA,402,0,3935,0,3,3938,T
6-NA,403,0,5,4032,1,4038,G
6-NA,404,10,7,4036,0,4053,G
6-NA,405,4081,1,5,0,4087,A
6-NA,406,0,1,0,4103,4104,C
6-NA,407,4074,0,4,0,4078,A
6-NA,408,3,8,4264,0,4275,G
6-NA,409,1,9,4262,1,4273,G
6-NA,410,4,6,4531,0,4541,G
6-NA,411,4539,2,7,1,4549,A
6-NA,412,4537,2,12,1,4552,A
6-NA,413,1,1,0,4573,4575,C
6-NA,414,4556,0,8,0,4564,A
6-NA,415,5225,1,5,0,5231,A
6-NA,416,1,2,0,5309,5312,C
6-NA,417,5307,0,12,0,5319,A
6-NA,418,1,2,0,5392,5395,C
6-NA,419,0,5352,0,2,5354,T
6-NA,420,5442,0,6,0,5448,A
6-NA,421,5447,0,4,0,5451,A
6-NA,422,5468,0,8,0,5476,A
6-NA,423,0,3,0,5476,5479,C
6-NA,424,5348,0,5,1,5354,A
6-NA,425,5380,1,3,0,5384,A
6-NA,426,1,2,0,5385,5388,C
6-NA,427,2,0,5395,0,5397,G
6-NA,428,0,5392,0,6,5398,T
6-NA,429,5,2,5393,0,5400,G
6-NA,430,2,1,0,5434,5437,C
6-NA,431,5447,0,2,1,5450,A
6-NA,432,1,5475,0,4,5480,T
6-NA,433,1,5489,0,7,5497,T
6-NA,434,6,1,0,5578,5585,C
6-NA,435,5682,0,11,0,5693,A
6-NA,436,5719,0,7,6,5732,A
6-NA,437,5773,0,5,1,5779,A
6-NA,438,1,5783,0,0,5784,T
6-NA,439,19,17,5747,0,5783,G
6-NA,440,5883,4,5,0,5892,A
6-NA,441,0,1,1,5914,5916,C
6-NA,442,5896,0,6,1,5903,A
6-NA,443,2,0,0,6015,6017,C
6-NA,444,5958,0,7,0,5965,A
6-NA,445,2,5,7704,0,7711,G
6-NA,446,1,7723,0,2,7726,T
6-NA,447,7842,0,5,0,7847,A
6-NA,448,2,5,0,7872,7879,C
6-NA,449,6,6,7871,0,7883,G
6-NA,450,0,8233,0,10,8243,T
6-NA,451,2,13,8228,1,8244,G
6-NA,452,8293,1,9,0,8303,A
6-NA,453,0,8348,0,8,8356,T
6-NA,454,7811,3,8,1,7823,A
6-NA,455,1,15,7802,1,7819,G
6-NA,456,3,10,7775,1,7789,G
6-NA,457,7814,0,11,2,7827,A
6-NA,458,5,3,0,7956,7964,C
6-NA,459,11,1,1,7878,7891,C
6-NA,460,12,11,1,7949,7973,C
6-NA,461,26,1,0,7997,8024,C
6-NA,462,2,8074,1,10,8087,T
6-NA,463,0,8213,0,2,8215,T
6-NA,464,8234,1,1,1,8237,A
6-NA,465,1,8257,0,5,8263,T
6-NA,466,5,5,0,8249,8259,C
6-NA,467,8,15,8193,0,8216,G
6-NA,468,5,16,8191,0,8212,G
6-NA,469,8210,4,11,1,8226,A
6-NA,470,3,2,0,8298,8303,C
6-NA,471,13,2,1,8244,8260,C
6-NA,472,17,1,0,8789,8807,C
6-NA,473,0,8791,0,7,8798,T
6-NA,474,8957,0,1,0,8958,A
6-NA,475,2,8959,1,2,8964,T
6-NA,476,1,8980,0,8,8989,T
6-NA,477,2,7,8996,0,9005,G
6-NA,478,9022,1,8,1,9032,A
6-NA,479,1,9001,0,6,9008,T
6-NA,480,4,20,8993,0,9017,G
6-NA,481,8799,1,12,1,8813,A
6-NA,482,8807,3,15,0,8825,A
6-NA,483,2,8844,0,1,8847,T
6-NA,484,0,18,8985,0,9003,G
6-NA,485,9143,2,11,2,9158,A
6-NA,486,26,4,9242,1,9273,G
6-NA,487,3,9257,0,4,9264,T
6-NA,488,0,9275,2,3,9280,T
6-NA,489,9290,3,12,0,9305,A
6-NA,490,1,12,9297,2,9312,G
6-NA,491,2,8,9332,2,9344,G
6-NA,492,1,9333,1,14,9349,T
6-NA,493,5,6,9324,0,9335,G
6-NA,494,0,9237,0,19,9256,T
6-NA,495,0,9233,0,15,9248,T
6-NA,496,17,2,0,9354,9373,C
6-NA,497,14,3,0,9415,9432,C
6-NA,498,0,9417,0,17,9434,T
6-NA,499,2,9423,0,9,9434,T
6-NA,500,5,9409,2,13,9429,T
6-NA,501,1,9418,1,15,9435,T
6-NA,502,6,4,1,9473,9484,C
6-NA,503,9460,1,5,1,9467,A
6-NA,504,2,9690,0,12,9704,T
6-NA,505,3,5,0,9697,9705,C
6-NA,506,2,9621,0,12,9635,T
6-NA,507,2,16,9604,0,9622,G
6-NA,508,3,31,9537,1,9572,G
6-NA,509,2,20,9567,1,9590,G
6-NA,510,6,11,9692,0,9709,G
6-NA,511,9721,0,17,1,9739,A
6-NA,512,3,1,0,9821,9825,C
6-NA,513,5,3,0,9728,9736,C
6-NA,514,9863,3,11,2,9879,A
6-NA,515,9898,2,10,3,9913,A
6-NA,516,4,3,9899,0,9906,G
6-NA,517,1,4,0,9932,9937,C
6-NA,518,9879,1,8,0,9888,A
6-NA,519,10027,0,9,0,10036,A
6-NA,520,1,2,10131,0,10134,G
6-NA,521,1,10092,0,4,10097,T
6-NA,522,3,0,10431,0,10434,G
6-NA,523,1,10325,1,12,10339,T
6-NA,524,4,2,10677,2,10685,G
6-NA,525,5,4,0,10669,10678,C
6-NA,526,10652,1,5,1,10659,A
6-NA,527,1,10754,1,6,10762,T
6-NA,528,10604,2,7,0,10613,A
6-NA,529,4,4,10928,0,10936,G
6-NA,530,2,3,1,10917,10923,C
6-NA,531,10729,1,13,1,10744,A
6-NA,532,0,10703,0,21,10724,T
6-NA,533,2,19,10517,1,10539,G
6-NA,534,7,6,11179,0,11192,G
6-NA,535,2,11195,0,27,11224,T
6-NA,536,19,3,1,11132,11155,C
6-NA,537,12,6,1,11194,11213,C
6-NA,538,11171,1,7,1,11180,A
6-NA,539,6,1,11482,0,11489,G
6-NA,540,3,3,0,11513,11519,C
6-NA,541,0,11444,1,40,11485,T
6-NA,542,16,2,0,11491,11509,C
6-NA,543,11268,4,5,1,11278,A
6-NA,544,11395,2,10,1,11408,A
6-NA,545,2,2,11452,0,11456,G
6-NA,546,0,11451,0,5,11456,T
6-NA,547,0,11438,0,8,11446,T
6-NA,548,4,4,11437,0,11445,G
6-NA,549,1,11454,0,8,11463,T
6-NA,550,28,4,0,11403,11435,C
6-NA,551,11433,4,12,3,11452,A
6-NA,552,1,9,3,11508,11521,C
6-NA,553,3,11,11475,1,11490,G
6-NA,554,11669,8,4,1,11682,A
6-NA,555,0,11689,2,11,11702,T
6-NA,556,7,14,11853,0,11874,G
6-NA,557,4,9,11926,1,11940,G
6-NA,558,11915,3,17,1,11936,A
6-NA,559,11935,0,11,1,11947,A
6-NA,560,12049,3,25,0,12077,A
6-NA,561,12042,0,40,0,12082,A
6-NA,562,1,2,12208,0,12211,G
6-NA,563,2,4,0,12163,12169,C
6-NA,564,12123,0,17,2,12142,A
6-NA,565,2,12144,0,10,12156,T
6-NA,566,5,14,12228,0,12247,G
6-NA,567,4,5,12291,0,12300,G
6-NA,568,6,3,0,12438,12447,C
6-NA,569,0,12380,0,16,12396,T
6-NA,570,5,3,12440,0,12448,G
6-NA,571,3,5,0,12401,12409,C
6-NA,572,12453,1,6,1,12461,A
6-NA,573,1,12887,0,7,12895,T
6-NA,574,4,5,12912,0,12921,G
6-NA,575,1,12959,2,9,12971,T
6-NA,576,0,13216,0,26,13242,T
6-NA,577,2,13200,1,14,13217,T
6-NA,578,8,5,13946,0,13959,G
6-NA,579,1,13921,2,10,13934,T
6-NA,580,13963,0,4,2,13969,A
6-NA,581,2,13980,0,24,14006,T
6-NA,582,13811,0,7,1,13819,A
6-NA,583,13839,3,46,3,13891,A
6-NA,584,3,12,1,13778,13794,C
6-NA,585,10,53,13617,1,13681,G
6-NA,586,7,29,13691,0,13727,G
6-NA,587,6,40,13454,2,13502,G
6-NA,588,14,13,13496,1,13524,G
6-NA,589,4,10,13560,1,13575,G
6-NA,590,13523,0,15,3,13541,A
6-NA,591,2,13570,1,16,13589,T
6-NA,592,4,12,13613,1,13630,G
6-NA,593,13693,7,17,2,13719,A
6-NA,594,4,13771,1,2,13778,T
6-NA,595,13706,1,12,1,13720,A
6-NA,596,13916,3,11,1,13931,A
6-NA,597,13926,3,20,3,13952,A
6-NA,598,13952,1,8,2,13963,A
6-NA,599,14004,2,8,0,14014,A
6-NA,600,1,13972,1,4,13978,T
6-NA,601,7,2,13973,0,13982,G
6-NA,602,3,6,1,13943,13953,C
6-NA,603,13913,1,13,2,13929,A
6-NA,604,13986,1,18,1,14006,A
6-NA,605,4,3,0,14114,14121,C
6-NA,606,1,14095,0,11,14107,T
6-NA,607,12,4,14140,2,14158,G
6-NA,608,3,1,1,14159,14164,C
6-NA,609,2,14164,0,13,14179,T
6-NA,610,14171,4,14,1,14190,A
6-NA,611,0,3,14189,0,14192,G
6-NA,612,5,2,0,14317,14324,C
6-NA,613,1,14286,4,23,14314,T
6-NA,614,1,14256,2,17,14276,T
6-NA,615,15,4,1,14431,14451,C
6-NA,616,14490,0,4,1,14495,A
6-NA,617,1,14484,3,13,14501,T
6-NA,618,3,14511,1,10,14525,T
6-NA,619,0,14612,3,3,14618,T
6-NA,620,14669,2,7,3,14681,A
6-NA,621,8,3,0,14762,14773,C
6-NA,622,14711,2,6,0,14719,A
6-NA,623,14824,1,21,4,14850,A
6-NA,624,1,14746,0,11,14758,T
6-NA,625,7,37,14688,4,14736,G
6-NA,626,4,15,14693,0,14712,G
6-NA,627,4,21,14659,2,14686,G
6-NA,628,14602,6,25,5,14638,A
6-NA,629,6,8,14971,1,14986,G
6-NA,630,9,9,15055,0,15073,G
6-NA,631,3,3,0,16057,16063,C
6-NA,632,4,16014,1,31,16050,T
6-NA,633,3,16236,0,9,16248,T
6-NA,634,4,2,16408,0,16414,G
6-NA,635,4,16391,1,10,16406,T
6-NA,636,16675,7,17,0,16699,A
6-NA,637,3,8,16751,1,16763,G
6-NA,638,16451,2,22,0,16475,A
6-NA,639,4,16492,0,8,16504,T
6-NA,640,15327,3,11,0,15341,A
6-NA,641,1,7,15365,0,15373,G
6-NA,642,3,15223,2,13,15241,T
6-NA,643,9,6,14943,1,14959,G
6-NA,644,0,15542,3,36,15581,T
6-NA,645,1,15572,0,13,15586,T
6-NA,646,3,5,15827,1,15836,G
6-NA,647,3,15751,0,38,15792,T
6-NA,648,7,15798,1,21,15827,T
6-NA,649,3,15828,2,29,15862,T
6-NA,650,16,4,1,15572,15593,C
6-NA,651,15568,1,24,0,15593,A
6-NA,652,3,15507,0,10,15520,T
6-NA,653,7,35,15471,1,15514,G
6-NA,654,2,4,16364,0,16370,G
6-NA,655,0,16213,1,25,16239,T
6-NA,656,22,6,0,16192,16220,C
6-NA,657,30,4,2,16169,16205,C
6-NA,658,16296,2,16,3,16317,A
6-NA,659,16369,4,48,3,16424,A
6-NA,660,16416,3,18,0,16437,A
6-NA,661,25,11,16494,0,16530,G
6-NA,662,16480,2,14,0,16496,A
6-NA,663,15950,2,48,0,16000,A
6-NA,664,15994,0,16,1,16011,A
6-NA,665,5,15985,2,10,16002,T
6-NA,666,9,1,1,16462,16473,C
6-NA,667,30,1,1,16429,16461,C
6-NA,668,0,16391,4,28,16423,T
6-NA,669,12,4,0,16437,16453,C
6-NA,670,16403,2,17,2,16424,A
6-NA,671,5,22,16547,1,16575,G
6-NA,672,3,36,16503,1,16543,G
6-NA,673,16911,3,19,12,16945,A
6-NA,674,4,17,0,16909,16930,C
6-NA,675,17,4,0,16657,16678,C
6-NA,676,34,8,2,16654,16698,C
6-NA,677,16692,8,22,0,16722,A
6-NA,678,3,20,16728,2,16753,G
6-NA,679,3,19,16774,2,16798,G
6-NA,680,16714,4,18,1,16737,A
6-NA,681,0,3,16928,1,16932,G
6-NA,682,5,16656,2,12,16675,T
6-NA,683,21,3,1,16680,16705,C
6-NA,684,16661,3,24,2,16690,A
6-NA,685,3,14,16794,2,16813,G
6-NA,686,16737,4,31,1,16773,A
6-NA,687,16773,1,12,0,16786,A
6-NA,688,0,16683,1,14,16698,T
6-NA,689,4,3,16769,0,16776,G
6-NA,690,3,21,0,16716,16740,C
6-NA,691,15,1,16820,1,16837,G
6-NA,692,2,16765,1,26,16794,T
6-NA,693,2,16780,3,24,16809,T
6-NA,694,2,16669,0,12,16683,T
6-NA,695,6,5,16804,0,16815,G
6-NA,696,3,16829,1,21,16854,T
6-NA,697,16848,2,16,0,16866,A
6-NA,698,4,16773,1,19,16797,T
6-NA,699,19,4,0,16780,16803,C
6-NA,700,16746,1,12,3,16762,A
6-NA,701,16751,6,7,1,16765,A
6-NA,702,0,16748,1,10,16759,T
6-NA,703,6,20,16737,2,16765,G
6-NA,704,7,21,16753,4,16785,G
6-NA,705,17022,4,24,0,17050,A
6-NA,706,17017,4,32,1,17054,A
6-NA,707,7,42,0,17161,17210,C
6-NA,708,3,17231,1,22,17257,T
6-NA,709,4,17217,1,5,17227,T
6-NA,710,5,2,17785,0,17792,G
6-NA,711,2,17777,1,8,17788,T
6-NA,712,17766,5,9,2,17782,A
6-NA,713,9,8,0,18010,18027,C
6-NA,714,17550,2,18,1,17571,A
6-NA,715,5,8,18755,0,18768,G
6-NA,716,3,18636,0,5,18644,T
6-NA,717,19319,2,14,1,19336,A
6-NA,718,6,2,19420,0,19428,G
6-NA,719,4,19022,2,19,19047,T
6-NA,720,19027,2,12,3,19044,A
6-NA,721,19023,2,11,1,19037,A
6-NA,722,1,18920,1,9,18931,T
6-NA,723,4,41,18964,0,19009,G
6-NA,724,18473,1,22,4,18500,A
6-NA,725,3,4,0,18671,18678,C
6-NA,726,2,18114,2,15,18133,T
6-NA,727,8,17,18203,0,18228,G
6-NA,728,18179,5,30,1,18215,A
6-NA,729,2,18276,0,16,18294,T
6-NA,730,10,44,18261,0,18315,G
6-NA,731,7,20,18189,1,18217,G
6-NA,732,5,29,18204,1,18239,G
6-NA,733,17973,0,21,0,17994,A
6-NA,734,28,3,17946,4,17981,G
6-NA,735,4,17848,2,19,17873,T
6-NA,736,26,2,17897,1,17926,G
6-NA,737,6,2,0,17930,17938,C
6-NA,738,1,17815,2,25,17843,T
6-NA,739,3,17862,0,10,17875,T
6-NA,740,18,4,0,17808,17830,C
6-NA,741,13,29,17730,4,17776,G
6-NA,742,6,16,17925,2,17949,G
6-NA,743,4,14,17952,0,17970,G
6-NA,744,17922,4,25,1,17952,A
6-NA,745,17846,2,9,0,17857,A
6-NA,746,17783,7,25,1,17816,A
6-NA,747,17863,5,28,1,17897,A
6-NA,748,18,3,17971,2,17994,G
6-NA,749,5,4,2,17967,17978,C
6-NA,750,0,17881,0,15,17896,T
6-NA,751,7,20,17881,1,17909,G
6-NA,752,17799,3,95,0,17897,A
6-NA,753,2,18082,3,5,18092,T
6-NA,754,18147,4,15,0,18166,A
6-NA,755,4,4,0,18929,18937,C
6-NA,756,2,18807,0,4,18813,T
6-NA,757,18807,0,23,0,18830,A
6-NA,758,18819,1,12,4,18836,A
6-NA,759,18832,2,7,0,18841,A
6-NA,760,19141,3,24,1,19169,A
6-NA,761,0,19181,1,7,19189,T
6-NA,762,19117,2,13,1,19133,A
6-NA,763,4,6,0,19228,19238,C
6-NA,764,3,18414,1,18,18436,T
6-NA,765,18670,1,12,0,18683,A
6-NA,766,1,18583,2,19,18605,T
6-NA,767,5,19888,3,15,19911,T
6-NA,768,32,2,1,20115,20150,C
6-NA,769,19833,1,39,0,19873,A
6-NA,770,1,19829,0,5,19835,T
6-NA,771,5,19829,1,1,19836,T
6-NA,772,19555,3,12,3,19573,A
6-NA,773,19614,1,13,3,19631,A
6-NA,774,3,28,19714,2,19747,G
6-NA,775,5,26,19727,0,19758,G
6-NA,776,18468,2,15,0,18485,A
6-NA,777,7,43,18636,1,18687,G
6-NA,778,5,46,18631,1,18683,G
6-NA,779,12,17,18718,3,18750,G
6-NA,780,1,18,18751,2,18772,G
6-NA,781,18695,10,27,1,18733,A
6-NA,782,18741,3,26,2,18772,A
6-NA,783,18686,0,18,0,18704,A
6-NA,784,18673,7,16,1,18697,A
6-NA,785,1,18680,1,8,18690,T
6-NA,786,24,2,1,18573,18600,C
6-NA,787,11,2,18809,1,18823,G
6-NA,788,2,18756,0,12,18770,T
6-NA,789,10,18697,3,36,18746,T
6-NA,790,37,3,1,18736,18777,C
6-NA,791,18761,2,15,3,18781,A
6-NA,792,1,19648,2,14,19665,T
6-NA,793,19620,11,7,1,19639,A
6-NA,794,7,4,2,19681,19694,C
6-NA,795,1,19638,0,10,19649,T
6-NA,796,19520,0,16,0,19536,A
6-NA,797,4,2,19558,0,19564,G
6-NA,798,4,12,2,19539,19557,C
6-NA,799,19581,2,15,2,19600,A
6-NA,800,2,5,1,19793,19801,C
6-NA,801,19235,3,10,0,19248,A
6-NA,802,0,19207,1,13,19221,T
6-NA,803,1,19134,1,8,19144,T
6-NA,804,18947,1,19,1,18968,A
6-NA,805,5,20877,0,12,20894,T
6-NA,806,18,6,2,20929,20955,C
6-NA,807,20938,7,27,2,20974,A
6-NA,808,4,26,21009,0,21039,G
6-NA,809,58,23,20884,0,20965,G
6-NA,810,20894,2,14,0,20910,A
6-NA,811,20327,1,27,1,20356,A
6-NA,812,7,4,20645,0,20656,G
6-NA,813,1,19659,0,20,19680,T
6-NA,814,6,8,19817,1,19832,G
6-NA,815,5,7,1,19784,19797,C
6-NA,816,1,19746,1,25,19773,T
6-NA,817,22,3,3,19816,19844,C
6-NA,818,19741,2,25,0,19768,A
6-NA,819,13,11,19906,0,19930,G
6-NA,820,5,5,4,19919,19933,C
6-NA,821,19821,2,15,2,19840,A
6-NA,822,2,19843,1,8,19854,T
6-NA,823,11,9,20476,1,20497,G
6-NA,824,6,20484,1,25,20516,T
6-NA,825,29,3,3,20466,20501,C
6-NA,826,16,28,20455,0,20499,G
6-NA,827,20447,1,18,1,20467,A
6-NA,828,4,26,20318,1,20349,G
6-NA,829,6,29,20328,0,20363,G
6-NA,830,20192,2,39,2,20235,A
6-NA,831,15,22,20535,0,20572,G
6-NA,832,0,19952,0,16,19968,T
6-NA,833,6,2,20022,1,20031,G
6-NA,834,4,10,1,20311,20326,C
6-NA,835,10,20233,2,32,20277,T
6-NA,836,33,6,2,20349,20390,C
6-NA,837,23,3,0,20421,20447,C
6-NA,838,3,20445,0,15,20463,T
6-NA,839,9,6,20536,0,20551,G
6-NA,840,5,4,1,20366,20376,C
6-NA,841,0,20221,0,16,20237,T
6-NA,842,20406,0,14,4,20424,A
6-NA,843,3,20017,2,30,20052,T
6-NA,844,22,24,0,20173,20219,C
6-NA,845,19,3,0,20164,20186,C
6-NA,846,1,20176,0,22,20199,T
6-NA,847,18,8,1,20320,20347,C
6-NA,848,11,22,20254,2,20289,G
6-NA,849,20486,2,26,1,20515,A
6-NA,850,2,20475,2,27,20506,T
6-NA,851,20523,0,6,2,20531,A
6-NA,852,0,20509,1,13,20523,T
6-NA,853,15,9,16,20416,20456,C
6-NA,854,27,2,0,20407,20436,C
6-NA,855,6,20289,3,16,20314,T
6-NA,856,8,18,20408,1,20435,G
6-NA,857,7,6,20510,0,20523,G
6-NA,858,2,20763,1,20,20786,T
6-NA,859,16,5,20818,0,20839,G
6-NA,860,1,20683,2,33,20719,T
6-NA,861,32,9,2,20676,20719,C
6-NA,862,20678,4,22,3,20707,A
6-NA,863,9,6,20739,1,20755,G
6-NA,864,20693,11,40,3,20747,A
6-NA,865,2,20528,1,17,20548,T
6-NA,866,9,6,20560,1,20576,G
6-NA,867,2,20309,1,12,20324,T
6-NA,868,4,7,20365,2,20378,G
6-NA,869,6,20317,1,28,20352,T
6-NA,870,24,4,3,20382,20413,C
6-NA,871,6,20320,3,32,20361,T
6-NA,872,6,7,20397,0,20410,G
6-NA,873,2,9,1,20384,20396,C
6-NA,874,20344,2,23,3,20372,A
6-NA,875,3,23,20372,1,20399,G
6-NA,876,20022,5,30,0,20057,A
6-NA,877,4,12,20118,3,20137,G
6-NA,878,20080,5,21,2,20108,A
6-NA,879,4,7,0,20248,20259,C
6-NA,880,20260,4,22,2,20288,A
6-NA,881,20372,4,20,1,20397,A
6-NA,882,7,6,1,20485,20499,C
6-NA,883,3,20463,1,20,20487,T
6-NA,884,11,11,20497,0,20519,G
6-NA,885,5,10,20457,1,20473,G
6-NA,886,20393,3,27,2,20425,A
6-NA,887,20373,4,30,2,20409,A
6-NA,888,19919,2,65,2,19988,A
6-NA,889,6,19,20255,0,20280,G
6-NA,890,6,10,20193,0,20209,G
6-NA,891,2,8,0,20169,20179,C
6-NA,892,5,20053,0,51,20109,T
6-NA,893,20,5,0,20484,20509,C
6-NA,894,25,11,2,20666,20704,C
6-NA,895,20782,5,19,3,20809,A
6-NA,896,20785,3,17,7,20812,A
6-NA,897,2,20815,1,12,20830,T
6-NA,898,20195,2,17,3,20217,A
6-NA,899,6,23,20109,0,20138,G
6-NA,900,4,8,20167,0,20179,G
6-NA,901,8,11,1,20154,20174,C
6-NA,902,22,5,2,19737,19766,C
6-NA,903,49,5,3,19516,19573,C
6-NA,904,19779,2,6,0,19787,A
6-NA,905,1,19933,1,31,19966,T
6-NA,906,17,14,0,19929,19960,C
6-NA,907,14,4,20029,0,20047,G
6-NA,908,1,19962,0,4,19967,T
6-NA,909,19657,1,8,0,19666,A
6-NA,910,4,12,20091,0,20107,G
6-NA,911,20130,3,27,5,20165,A
6-NA,912,4,20152,2,45,20203,T
6-NA,913,19859,3,9,1,19872,A
6-NA,914,4,19686,1,4,19695,T
6-NA,915,19666,1,7,1,19675,A
6-NA,916,19632,2,16,3,19653,A
6-NA,917,20017,4,19,7,20047,A
6-NA,918,4,3,0,20507,20514,C
6-NA,919,20014,1,3,0,20018,A
6-NA,920,1,19989,1,7,19998,T
6-NA,921,19829,0,12,0,19841,A
6-NA,922,19837,1,22,0,19860,A
6-NA,923,19811,2,47,1,19861,A
6-NA,924,3,25,20057,0,20085,G
6-NA,925,6,18,20209,1,20234,G
6-NA,926,19616,8,16,0,19640,A
6-NA,927,4,19556,1,19,19580,T
6-NA,928,35,5,0,19655,19695,C
6-NA,929,19772,4,65,2,19843,A
6-NA,930,4,19826,0,48,19878,T
6-NA,931,19835,3,28,2,19868,A
6-NA,932,300,6,19629,1,19936,G
6-NA,933,3,3,1,19694,19701,C
6-NA,934,19374,2,5,23,19404,A
6-NA,935,2,18806,0,11,18819,T
6-NA,936,2,18890,1,28,18921,T
6-NA,937,21,9,19448,0,19478,G
6-NA,938,1,19456,4,42,19503,T
6-NA,939,1,19704,4,46,19755,T
6-NA,940,4,19710,1,31,19746,T
6-NA,941,15,4,1,19635,19655,C
6-NA,942,14,8,3,19713,19738,C
6-NA,943,19977,1,12,2,19992,A
6-NA,944,3,6,20246,1,20256,G
6-NA,945,2,20188,1,15,20206,T
6-NA,946,1,19694,1,13,19709,T
6-NA,947,19685,1,30,3,19719,A
6-NA,948,3,19533,0,10,19546,T
6-NA,949,6,3,19557,0,19566,G
6-NA,950,3,19383,2,28,19416,T
6-NA,951,9,5,19466,0,19480,G
6-NA,952,4,19043,1,20,19068,T
6-NA,953,12,2,19526,0,19540,G
6-NA,954,5,19517,2,32,19556,T
6-NA,955,5,19474,2,14,19495,T
6-NA,956,35,12,0,19462,19509,C
6-NA,957,19337,4,32,1,19374,A
6-NA,958,5,21,19432,1,19459,G
6-NA,959,3,28,19419,1,19451,G
6-NA,960,19338,2,17,1,19358,A
6-NA,961,4,5,0,19365,19374,C
6-NA,962,3,18859,2,26,18890,T
6-NA,963,1,18938,1,14,18954,T
6-NA,964,3,5,19601,0,19609,G
6-NA,965,3,19588,2,29,19622,T
6-NA,966,3,19584,7,17,19611,T
6-NA,967,18,15,19460,2,19495,G
6-NA,968,10,29,19476,0,19515,G
6-NA,969,19456,5,50,1,19512,A
6-NA,970,3,31,19490,1,19525,G
6-NA,971,19422,4,33,1,19460,A
6-NA,972,9,6,2,19355,19372,C
6-NA,973,18705,2,26,2,18735,A
6-NA,974,7,5,1,18766,18779,C
6-NA,975,18805,3,17,0,18825,A
6-NA,976,12,13,1,18858,18884,C
6-NA,977,29,7,0,18740,18776,C
6-NA,978,42,5,0,18761,18808,C
6-NA,979,18785,1,13,1,18800,A
6-NA,980,0,13,18876,2,18891,G
6-NA,981,18831,1,17,1,18850,A
6-NA,982,18926,1,16,11,18954,A
6-NA,983,18833,0,9,3,18845,A
6-NA,984,18794,0,18,1,18813,A
6-NA,985,18721,0,13,0,18734,A
6-NA,986,18745,0,14,21,18780,A
6-NA,987,3,11,0,18795,18809,C
6-NA,988,5,29,18746,1,18781,G
6-NA,989,18723,1,23,1,18748,A
6-NA,990,8,6,1,18725,18740,C
6-NA,991,18654,2,22,0,18678,A
6-NA,992,4,2,18837,1,18844,G
6-NA,993,3,5,0,19376,19384,C
6-NA,994,5,19282,0,24,19311,T
6-NA,995,29,5,1,19324,19359,C
6-NA,996,25,6,2,19407,19440,C
6-NA,997,19420,2,29,0,19451,A
6-NA,998,4,3,19605,1,19613,G
6-NA,999,3,5,3,19602,19613,C
6-NA,1000,19527,2,21,1,19551,A
6-NA,1001,5,5,19524,0,19534,G
6-NA,1002,1,18771,0,11,18783,T
6-NA,1003,18769,1,13,0,18783,A
6-NA,1004,5,5,18793,1,18804,G
6-NA,1005,2,7,2,18808,18819,C
6-NA,1006,22,4,0,18835,18861,C
6-NA,1007,18644,2,8,0,18654,A
6-NA,1008,3,18637,2,11,18653,T
6-NA,1009,1,18639,0,4,18644,T
6-NA,1010,7,8,19034,0,19049,G
6-NA,1011,4,18913,3,20,18940,T
6-NA,1012,0,18896,2,17,18915,T
6-NA,1013,10,18871,1,15,18897,T
6-NA,1014,8,19,18737,0,18764,G
6-NA,1015,2,16,18928,2,18948,G
6-NA,1016,18881,2,12,0,18895,A
6-NA,1017,4,18908,0,20,18932,T
6-NA,1018,26,7,0,18887,18920,C
6-NA,1019,25,4,3,18553,18585,C
6-NA,1020,12,18597,1,6,18616,T
6-NA,1021,18634,1,15,3,18653,A
6-NA,1022,18661,3,15,0,18679,A
6-NA,1023,4,21,0,18985,19010,C
6-NA,1024,18613,1,9,1,18624,A
6-NA,1025,18815,4,9,0,18828,A
6-NA,1026,2,18781,1,11,18795,T
6-NA,1027,161,12,18806,2,18981,G
6-NA,1028,18916,4,17,0,18937,A
6-NA,1029,18772,4,41,2,18819,A
6-NA,1030,5,8,18895,0,18908,G
6-NA,1031,18751,3,59,1,18814,A
6-NA,1032,18234,2,29,1,18266,A
6-NA,1033,4,20,18294,2,18320,G
6-NA,1034,21,4,18321,0,18346,G
6-NA,1035,5,18060,3,9,18077,T
6-NA,1036,5,24,17963,0,17992,G
6-NA,1037,3,6,18437,0,18446,G
6-NA,1038,2,18347,3,31,18383,T
6-NA,1039,49,6,1,18201,18257,C
6-NA,1040,18264,2,19,1,18286,A
6-NA,1041,2,18195,2,20,18219,T
6-NA,1042,6,20,18175,2,18203,G
6-NA,1043,8,25,18304,0,18337,G
6-NA,1044,18217,1,38,0,18256,A
6-NA,1045,5,1,18707,1,18714,G
6-NA,1046,3,17945,1,11,17960,T
6-NA,1047,6,12,17980,1,17999,G
6-NA,1048,17958,0,18,0,17976,A
6-NA,1049,17938,2,26,2,17968,A
6-NA,1050,17918,1,74,4,17997,A
6-NA,1051,2,21,18031,0,18054,G
6-NA,1052,3,4,17893,1,17901,G
6-NA,1053,5,2,1,17845,17853,C
6-NA,1054,1,17277,1,18,17297,T
6-NA,1055,4,26,17273,1,17304,G
6-NA,1056,7,12,17274,0,17293,G
6-NA,1057,4,10,17439,1,17454,G
6-NA,1058,7,1,1,17424,17433,C
6-NA,1059,15,3,1,17444,17463,C
6-NA,1060,3,17234,1,26,17264,T
6-NA,1061,3,17298,1,8,17310,T
6-NA,1062,0,17301,1,13,17315,T
6-NA,1063,4,12,17352,0,17368,G
6-NA,1064,17310,5,27,3,17345,A
6-NA,1065,1,17212,2,12,17227,T
6-NA,1066,3,21,16919,1,16944,G
6-NA,1067,16752,3,27,1,16783,A
6-NA,1068,5,16798,1,27,16831,T
6-NA,1069,8,17,16835,0,16860,G
6-NA,1070,5,13,17030,1,17049,G
6-NA,1071,17008,2,39,0,17049,A
6-NA,1072,16973,1,36,1,17011,A
6-NA,1073,17027,0,13,2,17042,A
6-NA,1074,3,16985,4,16,17008,T
6-NA,1075,3,20,17025,0,17048,G
6-NA,1076,17008,6,20,1,17035,A
6-NA,1077,3,7,0,16959,16969,C
6-NA,1078,8,2,17021,0,17031,G
6-NA,1079,1,16616,0,12,16629,T
6-NA,1080,16,6,16741,0,16763,G
6-NA,1081,4,16679,2,16,16701,T
6-NA,1082,2,24,16716,1,16743,G
6-NA,1083,42,11,16785,2,16840,G
6-NA,1084,16708,3,20,1,16732,A
6-NA,1085,3,16707,3,10,16723,T
6-NA,1086,7,38,16616,1,16662,G
6-NA,1087,6,14,16558,1,16579,G
6-NA,1088,6,19,16641,2,16668,G
6-NA,1089,16539,3,14,2,16558,A
6-NA,1090,16473,2,37,2,16514,A
6-NA,1091,1,29,16462,0,16492,G
6-NA,1092,16280,3,15,1,16299,A
6-NA,1093,16296,1,28,1,16326,A
6-NA,1094,3,7,2,16223,16235,C
6-NA,1095,5,31,16085,0,16121,G
6-NA,1096,16071,2,13,2,16088,A
6-NA,1097,4,15845,3,8,15860,T
6-NA,1098,29,4,1,15838,15872,C
6-NA,1099,15868,0,15,2,15885,A
6-NA,1100,4,4,15917,0,15925,G
6-NA,1101,2,10,0,15865,15877,C
6-NA,1102,10,22,15855,0,15887,G
6-NA,1103,15824,7,18,0,15849,A
6-NA,1104,2,5,15866,0,15873,G
6-NA,1105,15829,0,13,2,15844,A
6-NA,1106,15835,2,24,2,15863,A
6-NA,1107,6,0,15960,1,15967,G
6-NA,1108,1,15838,1,18,15858,T
6-NA,1109,32,7,1,15655,15695,C
6-NA,1110,15664,0,24,1,15689,A
6-NA,1111,8,5,1,16048,16062,C
6-NA,1112,6,5,16063,0,16074,G
6-NA,1113,2,3,1,16061,16067,C
6-NA,1114,0,15916,3,35,15954,T
6-NA,1115,0,15981,0,11,15992,T
6-NA,1116,15745,2,14,0,15761,A
6-NA,1117,4,31,16076,2,16113,G
6-NA,1118,4,16,16049,1,16070,G
6-NA,1119,2,4,16330,2,16338,G
6-NA,1120,1,15290,2,8,15301,T
6-NA,1121,15271,1,8,0,15280,A
6-NA,1122,1,15214,0,17,15232,T
6-NA,1123,4,14,15199,2,15219,G
6-NA,1124,15162,6,27,0,15195,A
6-NA,1125,15163,3,7,1,15174,A
6-NA,1126,14474,0,21,0,14495,A
6-NA,1127,5,15,0,14454,14474,C
6-NA,1128,13,3,0,14071,14087,C
6-NA,1129,2,13743,4,23,13772,T
6-NA,1130,1,13749,1,15,13766,T
6-NA,1131,13,3,1,13758,13775,C
6-NA,1132,13760,1,8,0,13769,A
6-NA,1133,13779,3,7,0,13789,A
6-NA,1134,13770,3,10,1,13784,A
6-NA,1135,4,3,13870,1,13878,G
6-NA,1136,4,13587,2,7,13600,T
6-NA,1137,44,5,2,13580,13631,C
6-NA,1138,13817,0,10,0,13827,A
6-NA,1139,5,13819,2,10,13836,T
6-NA,1140,6,13818,3,12,13839,T
6-NA,1141,6,10,13829,1,13846,G
6-NA,1142,13783,3,13,2,13801,A
6-NA,1143,13786,3,31,0,13820,A
6-NA,1144,25,13,13771,0,13809,G
6-NA,1145,3,5,13777,0,13785,G
6-NA,1146,21,5,0,13710,13736,C
6-NA,1147,1,13182,0,14,13197,T
6-NA,1148,5,10,13266,0,13281,G
6-NA,1149,7,2,13511,1,13521,G
6-NA,1150,3,13488,1,16,13508,T
6-NA,1151,19,4,1,13447,13471,C
6-NA,1152,22,4,0,13359,13385,C
6-NA,1153,13339,3,20,0,13362,A
6-NA,1154,13438,0,8,0,13446,A
6-NA,1155,6,2,0,13483,13491,C
6-NA,1156,20,4,0,13427,13451,C
6-NA,1157,34,2,1,13376,13413,C
6-NA,1158,3,12676,1,9,12689,T
6-NA,1159,12688,3,4,0,12695,A
6-NA,1160,12682,2,8,2,12694,A
6-NA,1161,3,5,12786,0,12794,G
6-NA,1162,2,12682,1,20,12705,T
6-NA,1163,13,4,1,12616,12634,C
6-NA,1164,114,10,1,12255,12380,C
6-NA,1165,12330,0,5,1,12336,A
6-NA,1166,12309,0,8,1,12318,A
6-NA,1167,12324,1,4,1,12330,A
6-NA,1168,2,12345,0,6,12353,T
6-NA,1169,2,12259,0,2,12263,T
6-NA,1170,19,2,12179,0,12200,G
6-NA,1171,28,10,1,12091,12130,C
6-NA,1172,12091,1,21,1,12114,A
6-NA,1173,3,8,12158,0,12169,G
6-NA,1174,12124,1,5,2,12132,A
6-NA,1175,1,12336,0,1,12338,T
6-NA,1176,12324,1,3,0,12328,A
6-NA,1177,12284,1,16,0,12301,A
6-NA,1178,12270,4,31,0,12305,A
6-NA,1179,0,12216,3,4,12223,T
6-NA,1180,12137,4,13,0,12154,A
6-NA,1181,3,15,12137,0,12155,G
6-NA,1182,3,3,12036,0,12042,G
6-NA,1183,5,5,0,11985,11995,C
6-NA,1184,11530,0,6,1,11537,A
6-NA,1185,11608,3,15,1,11627,A
6-NA,1186,0,1,11696,0,11697,G
6-NA,1187,3,11630,3,31,11667,T
6-NA,1188,36,0,1,11624,11661,C
6-NA,1189,11686,1,14,0,11701,A
6-NA,1190,3,11660,0,7,11670,T
6-NA,1191,11735,1,8,1,11745,A
6-NA,1192,2,2,11772,0,11776,G
6-NA,1193,2,11714,0,31,11747,T
6-NA,1194,2,11211,0,7,11220,T
6-NA,1195,2,15,10985,0,11002,G
6-NA,1196,10926,3,23,1,10953,A
6-NA,1197,1,2,1,10947,10951,C
6-NA,1198,10723,1,10,0,10734,A
6-NA,1199,0,9,10856,0,10865,G
6-NA,1200,10644,2,24,0,10670,A
6-NA,1201,7,9,10949,0,10965,G
6-NA,1202,2,2,10979,1,10984,G
6-NA,1203,1,10912,0,7,10920,T
6-NA,1204,10858,2,6,2,10868,A
6-NA,1205,10817,24,20,2,10863,A
6-NA,1206,0,10850,0,12,10862,T
6-NA,1207,10782,1,25,0,10808,A
6-NA,1208,4,8,10406,1,10419,G
6-NA,1209,1,2,10050,1,10054,G
6-NA,1210,1,8717,1,15,8734,T
6-NA,1211,17,2,0,8631,8650,C
6-NA,1212,16,5,0,8536,8557,C
6-NA,1213,8,7,8553,0,8568,G
6-NA,1214,2,2,8593,0,8597,G
6-NA,1215,2,8532,0,27,8561,T
6-NA,1216,1,8524,0,4,8529,T
6-NA,1217,8397,2,0,0,8399,A
6-NA,1218,2,8166,2,3,8173,T
6-NA,1219,1,8142,0,8,8151,T
6-NA,1220,9,1,2,8138,8150,C
6-NA,1221,0,7610,0,7,7617,T
6-NA,1222,2,12,7616,2,7632,G
6-NA,1223,1,4,7621,0,7626,G
6-NA,1224,1,7578,0,0,7579,T
6-NA,1225,7578,0,2,0,7580,A
6-NA,1226,0,7461,1,6,7468,T
6-NA,1227,0,7459,1,8,7468,T
6-NA,1228,0,7458,0,11,7469,T
6-NA,1229,7,7488,2,15,7512,T
6-NA,1230,7,1,1,7511,7520,C
6-NA,1231,0,7385,0,13,7398,T
6-NA,1232,7,0,0,7428,7435,C
6-NA,1233,1,7394,1,5,7401,T
6-NA,1234,5,1,7529,0,7535,G
6-NA,1235,0,7517,1,10,7528,T
6-NA,1236,2,7463,2,7,7474,T
6-NA,1237,2,6,7469,2,7479,G
6-NA,1238,7379,0,14,1,7394,A
6-NA,1239,7371,0,12,0,7383,A
6-NA,1240,1,3,7449,0,7453,G
6-NA,1241,4,2,7422,0,7428,G
6-NA,1242,0,3,0,7426,7429,C
6-NA,1243,7302,0,6,0,7308,A
6-NA,1244,7289,1,27,0,7317,A
6-NA,1245,7321,1,12,1,7335,A
6-NA,1246,7325,12,13,1,7351,A
6-NA,1247,0,2,7357,0,7359,G
6-NA,1248,2,2,0,7354,7358,C
6-NA,1249,0,7224,0,7,7231,T
6-NA,1250,3,0,7313,0,7316,G
6-NA,1251,2,1,1,7296,7300,C
6-NA,1252,7312,0,11,0,7323,A
6-NA,1253,3,7292,0,4,7299,T
6-NA,1254,5,2,0,7235,7242,C
6-NA,1255,7221,2,2,1,7226,A
6-NA,1256,7225,2,2,0,7229,A
6-NA,1257,3,7215,0,3,7221,T
6-NA,1258,9,2,1,7226,7238,C
6-NA,1259,2,5,7143,0,7150,G
6-NA,1260,1,3,7261,0,7265,G
6-NA,1261,1,7237,1,5,7244,T
6-NA,1262,3,1,7269,0,7273,G
6-NA,1263,3,0,0,7308,7311,C
6-NA,1264,0,7256,1,13,7270,T
6-NA,1265,2,7341,1,9,7353,T
6-NA,1266,0,7350,0,8,7358,T
6-NA,1267,1,7377,1,1,7380,T
6-NA,1268,7400,25,2,0,7427,A
6-NA,1269,3,7121,3,15,7142,T
6-NA,1270,0,1,7146,0,7147,G
6-NA,1271,1,7045,0,15,7061,T
6-NA,1272,0,6,6984,1,6991,G
6-NA,1273,0,9,7051,0,7060,G
6-NA,1274,6880,2,15,1,6898,A
6-NA,1275,0,1,6990,0,6991,G
6-NA,1276,1,6938,0,11,6950,T
6-NA,1277,0,6895,0,11,6906,T
6-NA,1278,7,5,6960,0,6972,G
6-NA,1279,6934,1,13,0,6948,A
6-NA,1280,1,6940,1,6,6948,T
6-NA,1281,6911,0,9,0,6920,A
6-NA,1282,6704,1,7,1,6713,A
6-NA,1283,2,13,6728,1,6744,G
6-NA,1284,0,17,6644,1,6662,G
6-NA,1285,0,9,6596,0,6605,G
6-NA,1286,1,0,6599,0,6600,G
6-NA,1287,6480,1,10,1,6492,A
6-NA,1288,6469,3,11,1,6484,A
6-NA,1289,0,9,6507,0,6516,G
6-NA,1290,6493,2,4,1,6500,A
6-NA,1291,6492,0,5,0,6497,A
6-NA,1292,6422,2,9,0,6433,A
6-NA,1293,6318,0,9,1,6328,A
6-NA,1294,0,7,6339,0,6346,G
6-NA,1295,6252,0,15,1,6268,A
6-NA,1296,4,8,6266,0,6278,G
6-NA,1297,1,6,6251,1,6259,G
6-NA,1298,6193,1,10,0,6204,A
6-NA,1299,6208,0,4,0,6212,A
6-NA,1300,6224,0,5,0,6229,A
6-NA,1301,0,2,0,6255,6257,C
6-NA,1302,1,6238,0,4,6243,T
6-NA,1303,6,3,6242,1,6252,G
6-NA,1304,6225,0,7,1,6233,A
6-NA,1305,6207,2,15,0,6224,A
6-NA,1306,1,0,6259,0,6260,G
6-NA,1307,0,6216,0,12,6228,T
6-NA,1308,3,0,0,6284,6287,C
6-NA,1309,1,6226,0,23,6250,T
6-NA,1310,1,6198,1,4,6204,T
6-NA,1311,2,0,6204,0,6206,G
6-NA,1312,5,6167,2,6,6180,T
6-NA,1313,2,7,6172,1,6182,G
6-NA,1314,4,10,6153,0,6167,G
6-NA,1315,6111,1,9,1,6122,A
6-NA,1316,1,1,0,6119,6121,C
6-NA,1317,10,3,0,5899,5912,C
6-NA,1318,0,5903,1,5,5909,T
6-NA,1319,6,3,0,5886,5895,C
6-NA,1320,2,10,5814,0,5826,G
6-NA,1321,5876,1,7,0,5884,A
6-NA,1322,5873,0,7,1,5881,A
6-NA,1323,1,2,0,5912,5915,C
6-NA,1324,5782,0,2,1,5785,A
6-NA,1325,0,2,5948,0,5950,G
6-NA,1326,0,5915,0,0,5915,T
6-NA,1327,5897,0,5,0,5902,A
6-NA,1328,2,5912,0,3,5917,T
6-NA,1329,0,5783,1,2,5786,T
6-NA,1330,1,0,5835,0,5836,G
6-NA,1331,0,5805,2,15,5822,T
6-NA,1332,1,5626,0,7,5634,T
6-NA,1333,2,3,5649,1,5655,G
6-NA,1334,0,5103,0,7,5110,T
6-NA,1335,1,0,5119,0,5120,G
6-NA,1336,0,5083,1,2,5086,T
6-NA,1337,2,5007,0,20,5029,T
6-NA,1338,1,5022,0,4,5027,T
6-NA,1339,0,4914,0,7,4921,T
6-NA,1340,2,1,4912,0,4915,G
6-NA,1341,1,4918,1,3,4923,T
6-NA,1342,0,5,4861,0,4866,G
6-NA,1343,2,3,4852,0,4857,G
6-NA,1344,2,4,0,4788,4794,C
6-NA,1345,4759,1,7,0,4767,A
6-NA,1346,2,2,0,4807,4811,C
6-NA,1347,7,0,0,4799,4806,C
6-NA,1348,0,4785,1,6,4792,T
6-NA,1349,8,0,0,4798,4806,C
6-NA,1350,4781,1,6,1,4789,A
6-NA,1351,0,8,4813,1,4822,G
6-NA,1352,0,0,4831,0,4831,G
6-NA,1353,1,4809,0,5,4815,T
6-NA,1354,4778,1,2,0,4781,A
6-NA,1355,3,1,0,4558,4562,C
6-NA,1356,4489,0,4,0,4493,A
6-NA,1357,0,4487,0,1,4488,T
6-NA,1358,4349,0,9,0,4358,A
6-NA,1359,0,4341,0,5,4346,T
6-NA,1360,1,1,4040,1,4043,G
6-NA,1361,1,8,4048,0,4057,G
6-NA,1362,4028,2,0,1,4031,A
6-NA,1363,3991,1,7,0,3999,A
6-NA,1364,1,1,0,3961,3963,C
6-NA,1365,3292,0,1,0,3293,A
6-NA,1366,1,0,3296,1,3298,G
6-NA,1367,0,0,3294,0,3294,G
6-NA,1368,1,0,0,3311,3312,C
6-NA,1369,0,3291,0,2,3293,T
6-NA,1370,6,0,1,3088,3095,C
6-NA,1371,3067,0,5,0,3072,A
6-NA,1372,1,3065,0,1,3067,T
6-NA,1373,1,2,3072,0,3075,G
6-NA,1374,2,1,3061,0,3064,G
6-NA,1375,0,0,0,2961,2961,C
6-NA,1376,0,0,0,2925,2925,C
6-NA,1377,1,2762,0,1,2764,T
6-NA,1378,0,0,2764,0,2764,G
6-NA,1379,2758,0,3,0,2761,A
6-NA,1380,0,2760,0,0,2760,T
6-NA,1381,0,4,2711,1,2716,G
6-NA,1382,0,5,2637,0,2642,G
6-NA,1383,0,2,2491,0,2493,G
6-NA,1384,0,1,2492,0,2493,G
6-NA,1385,0,3,0,2429,2432,C
6-NA,1386,5,1,2420,0,2426,G
6-NA,1387,1,0,2395,0,2396,G
6-NA,1388,2360,0,1,0,2361,A
6-NA,1389,8,1,0,2345,2354,C
6-NA,1390,2330,8,0,0,2338,A
6-NA,1391,0,2311,0,3,2314,T
6-NA,1392,5,1,0,2271,2277,C
6-NA,1393,2243,0,2,0,2245,A
6-NA,1394,2241,0,2,2,2245,A
6-NA,1395,0,2241,0,2,2243,T
6-NA,1396,2,1,0,2185,2188,C
6-NA,1397,0,2119,0,3,2122,T
6-NA,1398,5,0,0,1796,1801,C
6-NA,1399,1786,0,4,0,1790,A
6-NA,1400,0,1774,0,1,1775,T
6-NA,1401,0,1,1770,0,1771,G
6-NA,1402,1,4,0,1762,1767,C
6-NA,1403,4,4,0,1695,1703,C
6-NA,1404,0,1515,0,2,1517,T
6-NA,1405,1494,0,3,0,1497,A
6-NA,1406,0,1492,1,1,1494,T
6-NA,1407,1467,0,2,0,1469,A
6-NA,1408,0,1460,0,0,1460,T
6-NA,1409,1343,0,0,0,1343,A
6-NA,1410,1291,0,0,0,1291,A
7-M,1,150,0,0,0,150,A
7-M,2,0,156,0,0,156,T
7-M,3,0,0,155,0,155,G
7-M,4,156,0,0,0,156,A
7-M,5,0,0,173,0,173,G
7-M,6,0,0,0,182,182,C
7-M,7,0,0,0,198,198,C
7-M,8,0,267,0,0,267,T
7-M,9,0,268,0,1,269,T
7-M,10,0,0,0,269,269,C
7-M,11,0,271,0,0,271,T
7-M,12,274,0,0,0,274,A
7-M,13,276,0,0,0,276,A
7-M,14,0,0,0,276,276,C
7-M,15,0,0,0,276,276,C
7-M,16,0,1,274,0,275,G
7-M,17,275,1,0,0,276,A
7-M,18,0,0,282,0,282,G
7-M,19,0,2,297,0,299,G
7-M,20,0,299,0,0,299,T
7-M,21,1,0,0,298,299,C
7-M,22,0,0,298,0,298,G
7-M,23,302,0,1,0,303,A
7-M,24,304,0,0,0,304,A
7-M,25,310,0,0,0,310,A
7-M,26,0,0,0,330,330,C
7-M,27,0,0,332,0,332,G
7-M,28,0,335,0,0,335,T
7-M,29,339,0,0,0,339,A
7-M,30,0,344,0,0,344,T
7-M,31,0,0,353,0,353,G
7-M,32,0,354,0,0,354,T
7-M,33,0,391,0,0,391,T
7-M,34,0,0,0,404,404,C
7-M,35,0,405,0,0,405,T
7-M,36,0,0,0,432,432,C
7-M,37,0,429,0,0,429,T
7-M,38,2,0,0,453,455,C
7-M,39,0,457,0,0,457,T
7-M,40,462,0,0,0,462,A
7-M,41,0,465,0,0,465,T
7-M,42,2,0,0,468,470,C
7-M,43,0,0,477,0,477,G
7-M,44,0,483,0,0,483,T
7-M,45,0,478,0,1,479,T
7-M,46,0,0,0,494,494,C
7-M,47,0,0,0,514,514,C
7-M,48,518,0,0,0,518,A
7-M,49,0,518,0,0,518,T
7-M,50,1,0,0,517,518,C
7-M,51,518,0,2,0,520,A
7-M,52,0,0,524,0,524,G
7-M,53,0,0,526,0,526,G
7-M,54,0,0,0,525,525,C
7-M,55,0,2,0,524,526,C
7-M,56,1,0,0,529,530,C
7-M,57,1,0,0,550,551,C
7-M,58,2,0,0,554,556,C
7-M,59,0,553,0,3,556,T
7-M,60,0,2,0,556,558,C
7-M,61,555,1,1,0,557,A
7-M,62,554,0,1,0,555,A
7-M,63,567,0,1,0,568,A
7-M,64,0,0,574,0,574,G
7-M,65,0,0,0,574,574,C
7-M,66,0,0,0,569,569,C
7-M,67,1,0,568,0,569,G
7-M,68,570,0,0,0,570,A
7-M,69,1,0,568,0,569,G
7-M,70,573,0,0,0,573,A
7-M,71,0,574,0,0,574,T
7-M,72,0,0,0,571,571,C
7-M,73,1,0,572,0,573,G
7-M,74,0,0,0,574,574,C
7-M,75,0,1,573,0,574,G
7-M,76,0,0,0,576,576,C
7-M,77,573,0,1,0,574,A
7-M,78,1,0,578,0,579,G
7-M,79,575,0,1,0,576,A
7-M,80,0,1,612,0,613,G
7-M,81,608,0,1,0,609,A
7-M,82,0,0,0,620,620,C
7-M,83,1,616,0,0,617,T
7-M,84,0,620,0,0,620,T
7-M,85,0,1,628,0,629,G
7-M,86,629,0,2,0,631,A
7-M,87,630,1,0,0,631,A
7-M,88,0,0,630,0,630,G
7-M,89,622,0,1,0,623,A
7-M,90,0,636,0,0,636,T
7-M,91,0,0,640,0,640,G
7-M,92,0,642,0,0,642,T
7-M,93,2,0,0,642,644,C
7-M,94,0,641,0,1,642,T
7-M,95,0,642,0,0,642,T
7-M,96,0,640,0,1,641,T
7-M,97,0,1,648,0,649,G
7-M,98,0,0,0,649,649,C
7-M,99,0,645,0,0,645,T
7-M,100,0,1,645,0,646,G
7-M,101,1,0,647,0,648,G
7-M,102,0,0,661,0,661,G
7-M,103,657,0,0,0,657,A
7-M,104,662,0,0,0,662,A
7-M,105,669,0,0,0,669,A
7-M,106,667,0,1,0,668,A
7-M,107,676,0,0,0,676,A
7-M,108,0,0,0,684,684,C
7-M,109,682,0,0,0,682,A
7-M,110,0,0,0,682,682,C
7-M,111,677,0,2,0,679,A
7-M,112,0,1,698,0,699,G
7-M,113,707,0,0,0,707,A
7-M,114,0,724,0,0,724,T
7-M,115,0,0,0,732,732,C
7-M,116,0,723,0,1,724,T
7-M,117,0,721,0,2,723,T
7-M,118,0,0,725,0,725,G
7-M,119,721,0,1,0,722,A
7-M,120,1,0,720,1,722,G
7-M,121,0,0,714,0,714,G
7-M,122,1,0,0,716,717,C
7-M,123,0,709,0,5,714,T
7-M,124,0,0,0,818,818,C
7-M,125,0,815,0,0,815,T
7-M,126,1,0,0,823,824,C
7-M,127,825,0,0,1,826,A
7-M,128,0,825,0,0,825,T
7-M,129,0,0,824,0,824,G
7-M,130,0,1,829,0,830,G
7-M,131,825,0,0,0,825,A
7-M,132,824,0,1,0,825,A
7-M,133,1,803,0,2,806,T
7-M,134,0,0,850,0,850,G
7-M,135,1,1,902,0,904,G
7-M,136,0,0,0,903,903,C
7-M,137,0,895,0,2,897,T
7-M,138,898,0,3,0,901,A
7-M,139,900,0,0,0,900,A
7-M,140,905,0,1,0,906,A
7-M,141,0,2,910,0,912,G
7-M,142,912,0,1,0,913,A
7-M,143,0,0,0,900,900,C
7-M,144,882,0,0,0,882,A
7-M,145,885,0,2,0,887,A
7-M,146,0,3,911,0,914,G
7-M,147,911,0,1,0,912,A
7-M,148,1,1,0,909,911,C
7-M,149,1,0,0,908,909,C
7-M,150,909,0,0,0,909,A
7-M,151,918,1,0,0,919,A
7-M,152,0,921,0,2,923,T
7-M,153,0,928,0,3,931,T
7-M,154,0,0,0,937,937,C
7-M,155,0,928,0,1,929,T
7-M,156,0,0,934,0,934,G
7-M,157,0,930,0,0,930,T
7-M,158,0,1,0,926,927,C
7-M,159,929,0,0,0,929,A
7-M,160,1,0,0,966,967,C
7-M,161,1,0,0,968,969,C
7-M,162,0,968,0,0,968,T
7-M,163,1,0,0,969,970,C
7-M,164,0,973,0,0,973,T
7-M,165,0,2,1005,0,1007,G
7-M,166,1008,0,0,0,1008,A
7-M,167,0,0,0,1013,1013,C
7-M,168,0,1011,0,0,1011,T
7-M,169,1001,0,0,0,1001,A
7-M,170,992,3,0,0,995,A
7-M,171,0,3,993,0,996,G
7-M,172,0,2,994,0,996,G
7-M,173,1,0,995,0,996,G
7-M,174,0,1,995,0,996,G
7-M,175,1010,0,1,0,1011,A
7-M,176,0,1011,0,0,1011,T
7-M,177,0,1008,0,0,1008,T
7-M,178,0,1014,0,0,1014,T
7-M,179,1,1015,0,0,1016,T
7-M,180,0,0,1014,1,1015,G
7-M,181,0,1,1016,0,1017,G
7-M,182,0,0,1019,0,1019,G
7-M,183,2,4,1018,0,1024,G
7-M,184,0,1010,0,1,1011,T
7-M,185,1,1008,0,0,1009,T
7-M,186,0,1009,0,0,1009,T
7-M,187,1,0,1037,0,1038,G
7-M,188,0,1042,0,0,1042,T
7-M,189,0,0,1048,0,1048,G
7-M,190,0,1049,0,0,1049,T
7-M,191,1,1047,0,2,1050,T
7-M,192,1,1,1,1051,1054,C
7-M,193,1051,1,0,0,1052,A
7-M,194,0,1,0,1072,1073,C
7-M,195,0,1,1070,0,1071,G
7-M,196,0,0,0,1069,1069,C
7-M,197,0,1059,0,2,1061,T
7-M,198,4,0,1,1090,1095,C
7-M,199,1096,0,2,0,1098,A
7-M,200,0,0,0,1108,1108,C
7-M,201,2,0,0,1097,1099,C
7-M,202,1,0,1108,0,1109,G
7-M,203,0,1116,0,1,1117,T
7-M,204,0,0,1120,0,1120,G
7-M,205,0,0,0,1125,1125,C
7-M,206,1,2,0,1116,1119,C
7-M,207,1,0,0,1132,1133,C
7-M,208,1121,0,1,0,1122,A
7-M,209,0,0,1134,0,1134,G
7-M,210,0,1128,0,1,1129,T
7-M,211,0,2,1132,0,1134,G
7-M,212,1143,0,2,0,1145,A
7-M,213,0,1,1143,0,1144,G
7-M,214,0,1,0,1139,1140,C
7-M,215,1,0,1144,0,1145,G
7-M,216,1138,0,1,0,1139,A
7-M,217,0,4,1144,0,1148,G
7-M,218,0,0,1153,0,1153,G
7-M,219,1148,0,1,0,1149,A
7-M,220,1,1,0,1174,1176,C
7-M,221,1,1152,0,1,1154,T
7-M,222,0,0,1157,0,1157,G
7-M,223,0,1,0,1155,1156,C
7-M,224,1159,0,0,0,1159,A
7-M,225,0,0,1182,0,1182,G
7-M,226,0,0,0,1174,1174,C
7-M,227,0,0,1175,0,1175,G
7-M,228,0,1175,0,0,1175,T
7-M,229,1168,0,1,0,1169,A
7-M,230,0,2,1164,0,1166,G
7-M,231,1162,0,1,0,1163,A
7-M,232,0,1,0,1170,1171,C
7-M,233,0,0,1173,0,1173,G
7-M,234,0,0,0,1166,1166,C
7-M,235,0,1151,1,1,1153,T
7-M,236,0,1149,0,1,1150,T
7-M,237,1,1144,0,2,1147,T
7-M,238,0,0,1178,0,1178,G
7-M,239,0,1173,0,3,1176,T
7-M,240,2,0,0,1176,1178,C
7-M,241,3,0,0,1182,1185,C
7-M,242,1178,0,1,1,1180,A
7-M,243,1181,0,1,0,1182,A
7-M,244,1181,0,0,0,1181,A
7-M,245,1181,0,1,0,1182,A
7-M,246,0,1181,0,0,1181,T
7-M,247,0,1,1168,0,1169,G
7-M,248,0,0,0,1168,1168,C
7-M,249,2,0,0,1166,1168,C
7-M,250,1,1,0,1178,1180,C
7-M,251,1,1177,0,1,1179,T
7-M,252,3,1,0,1216,1220,C
7-M,253,1225,0,0,0,1225,A
7-M,254,1231,0,2,0,1233,A
7-M,255,0,1243,0,0,1243,T
7-M,256,0,2,1242,0,1244,G
7-M,257,1,0,1256,0,1257,G
7-M,258,0,1,1267,0,1268,G
7-M,259,1260,1,1,0,1262,A
7-M,260,1260,0,1,0,1261,A
7-M,261,0,1241,0,3,1244,T
7-M,262,0,4,1233,1,1238,G
7-M,263,0,1,1233,1,1235,G
7-M,264,1223,0,3,0,1226,A
7-M,265,0,1,1224,0,1225,G
7-M,266,1205,0,6,0,1211,A
7-M,267,0,0,0,1192,1192,C
7-M,268,3,0,0,1237,1240,C
7-M,269,1,0,0,1246,1247,C
7-M,270,1262,0,1,0,1263,A
7-M,271,1263,0,0,1,1264,A
7-M,272,1261,0,5,0,1266,A
7-M,273,0,1266,0,0,1266,T
7-M,274,1299,1,0,1,1301,A
7-M,275,1302,0,0,0,1302,A
7-M,276,0,0,0,1281,1281,C
7-M,277,1276,0,0,0,1276,A
7-M,278,0,1274,1,0,1275,T
7-M,279,1,0,1303,1,1305,G
7-M,280,0,2,1302,0,1304,G
7-M,281,1303,0,1,0,1304,A
7-M,282,1,1,0,1301,1303,C
7-M,283,1272,0,0,0,1272,A
7-M,284,1273,0,3,1,1277,A
7-M,285,1272,0,3,0,1275,A
7-M,286,0,0,1282,0,1282,G
7-M,287,0,0,0,1310,1310,C
7-M,288,1284,0,2,0,1286,A
7-M,289,0,0,1305,0,1305,G
7-M,290,0,1304,0,0,1304,T
7-M,291,0,1300,0,1,1301,T
7-M,292,1314,1,0,0,1315,A
7-M,293,1307,1,1,1,1310,A
7-M,294,1316,0,1,0,1317,A
7-M,295,1,0,0,1318,1319,C
7-M,296,0,1274,0,1,1275,T
7-M,297,0,1,1367,0,1368,G
7-M,298,1,1350,0,2,1353,T
7-M,299,1364,0,0,0,1364,A
7-M,300,0,1360,0,0,1360,T
7-M,301,1355,0,2,0,1357,A
7-M,302,2,1,1353,0,1356,G
7-M,303,1279,0,4,0,1283,A
7-M,304,1291,0,1,0,1292,A
7-M,305,1291,0,0,0,1291,A
7-M,306,1312,0,1,1,1314,A
7-M,307,0,0,0,1334,1334,C
7-M,308,1,1326,0,0,1327,T
7-M,309,0,1331,0,2,1333,T
7-M,310,1336,0,1,0,1337,A
7-M,311,1332,0,3,0,1335,A
7-M,312,0,2,1335,0,1337,G
7-M,313,1328,0,2,0,1330,A
7-M,314,0,4,1334,0,1338,G
7-M,315,0,3,1335,0,1338,G
7-M,316,1,3,1351,0,1355,G
7-M,317,1352,0,2,0,1354,A
7-M,318,1,2,1364,1,1368,G
7-M,319,1374,0,2,0,1376,A
7-M,320,0,1376,0,1,1377,T
7-M,321,1374,0,1,0,1375,A
7-M,322,1372,0,5,0,1377,A
7-M,323,0,0,0,1382,1382,C
7-M,324,2,0,1374,0,1376,G
7-M,325,0,1372,0,1,1373,T
7-M,326,0,1363,0,3,1366,T
7-M,327,1,0,0,1383,1384,C
7-M,328,3,0,0,1367,1370,C
7-M,329,1372,0,1,0,1373,A
7-M,330,1,1365,1,1,1368,T
7-M,331,0,3,1363,0,1366,G
7-M,332,1,3,1362,0,1366,G
7-M,333,0,3,1359,0,1362,G
7-M,334,2,0,1364,0,1366,G
7-M,335,0,0,0,1360,1360,C
7-M,336,0,0,0,1361,1361,C
7-M,337,1365,0,1,0,1366,A
7-M,338,1374,0,0,0,1374,A
7-M,339,1370,0,2,2,1374,A
7-M,340,1,1,1384,0,1386,G
7-M,341,1387,1,0,0,1388,A
7-M,342,1379,0,0,1,1380,A
7-M,343,1379,0,0,0,1379,A
7-M,344,0,1382,0,0,1382,T
7-M,345,1372,0,4,0,1376,A
7-M,346,0,2,1374,0,1376,G
7-M,347,1,0,0,1367,1368,C
7-M,348,1,1355,0,4,1360,T
7-M,349,2,0,0,1356,1358,C
7-M,350,0,1355,0,0,1355,T
7-M,351,1,0,0,1397,1398,C
7-M,352,1398,0,2,0,1400,A
7-M,353,0,1,1393,0,1394,G
7-M,354,0,1381,0,2,1383,T
7-M,355,0,1400,0,1,1401,T
7-M,356,1408,0,0,0,1408,A
7-M,357,0,1406,0,2,1408,T
7-M,358,0,1405,0,3,1408,T
7-M,359,2,0,1,1411,1414,C
7-M,360,0,1366,0,1,1367,T
7-M,361,0,0,1377,0,1377,G
7-M,362,0,0,0,1374,1374,C
7-M,363,0,1369,0,0,1369,T
7-M,364,1,2,1366,0,1369,G
7-M,365,0,0,1374,0,1374,G
7-M,366,1,1372,0,1,1374,T
7-M,367,0,1,1373,0,1374,G
7-M,368,2,0,0,1368,1370,C
7-M,369,1369,0,3,0,1372,A
7-M,370,1,0,0,1370,1371,C
7-M,371,0,1361,0,2,1363,T
7-M,372,0,1373,0,0,1373,T
7-M,373,1,0,1375,0,1376,G
7-M,374,0,0,0,1371,1371,C
7-M,375,1,1,0,1377,1379,C
7-M,376,1378,0,1,0,1379,A
7-M,377,0,1,1380,0,1381,G
7-M,378,1,1384,0,1,1386,T
7-M,379,0,1382,0,3,1385,T
7-M,380,0,0,1395,0,1395,G
7-M,381,1,1,0,1377,1379,C
7-M,382,1379,0,3,0,1382,A
7-M,383,0,1377,0,3,1380,T
7-M,384,2,2,1375,0,1379,G
7-M,385,1,2,1396,0,1399,G
7-M,386,0,0,1418,0,1418,G
7-M,387,4,0,0,1423,1427,C
7-M,388,3,0,0,1463,1466,C
7-M,389,0,1467,0,2,1469,T
7-M,390,1,0,0,1486,1487,C
7-M,391,1565,0,1,0,1566,A
7-M,392,0,1571,0,0,1571,T
7-M,393,1613,0,1,0,1614,A
7-M,394,0,1595,0,0,1595,T
7-M,395,1577,0,1,0,1578,A
7-M,396,0,0,0,1687,1687,C
7-M,397,1608,0,1,1,1610,A
7-M,398,1608,0,2,0,1610,A
7-M,399,0,1604,0,0,1604,T
7-M,400,1554,0,1,0,1555,A
7-M,401,0,3,1570,0,1573,G
7-M,402,0,3,1540,0,1543,G
7-M,403,1537,0,2,0,1539,A
7-M,404,0,1536,0,1,1537,T
7-M,405,0,2,1453,0,1455,G
7-M,406,0,2,1455,0,1457,G
7-M,407,0,2,1449,0,1451,G
7-M,408,0,3,1464,0,1467,G
7-M,409,0,1,1461,0,1462,G
7-M,410,0,0,1,1456,1457,C
7-M,411,0,1440,0,4,1444,T
7-M,412,1,0,1456,0,1457,G
7-M,413,0,1450,0,0,1450,T
7-M,414,1457,0,1,0,1458,A
7-M,415,1455,0,0,0,1455,A
7-M,416,1,0,0,1460,1461,C
7-M,417,2,0,1,1445,1448,C
7-M,418,1427,0,2,0,1429,A
7-M,419,0,0,0,1432,1432,C
7-M,420,0,1423,0,1,1424,T
7-M,421,0,0,1431,0,1431,G
7-M,422,1426,0,1,0,1427,A
7-M,423,1417,0,1,0,1418,A
7-M,424,0,1,1430,0,1431,G
7-M,425,0,1407,0,2,1409,T
7-M,426,1,3,1403,0,1407,G
7-M,427,0,0,1413,0,1413,G
7-M,428,1,1,0,1412,1414,C
7-M,429,1419,0,0,0,1419,A
7-M,430,0,1406,1,2,1409,T
7-M,431,0,1410,0,1,1411,T
7-M,432,1,1411,0,2,1414,T
7-M,433,0,1,1443,0,1444,G
7-M,434,0,1,1445,0,1446,G
7-M,435,0,0,0,1439,1439,C
7-M,436,0,0,0,1438,1438,C
7-M,437,0,1421,0,2,1423,T
7-M,438,0,1,1484,0,1485,G
7-M,439,0,0,1495,0,1495,G
7-M,440,0,1495,0,0,1495,T
7-M,441,1501,0,3,1,1505,A
7-M,442,0,1452,0,1,1453,T
7-M,443,0,0,1483,0,1483,G
7-M,444,0,1483,0,3,1486,T
7-M,445,0,0,1484,0,1484,G
7-M,446,0,0,0,1487,1487,C
7-M,447,1434,1,2,0,1437,A
7-M,448,1430,0,4,0,1434,A
7-M,449,0,1,0,1441,1442,C
7-M,450,1434,0,1,0,1435,A
7-M,451,0,1441,0,1,1442,T
7-M,452,0,0,1424,0,1424,G
7-M,453,0,1396,0,2,1398,T
7-M,454,0,4,1394,0,1398,G
7-M,455,1382,0,2,0,1384,A
7-M,456,4,0,1387,0,1391,G
7-M,457,0,0,0,1389,1389,C
7-M,458,1361,0,1,0,1362,A
7-M,459,0,2,1376,0,1378,G
7-M,460,1367,0,3,0,1370,A
7-M,461,0,1367,1,3,1371,T
7-M,462,0,1368,0,1,1369,T
7-M,463,0,0,1375,0,1375,G
7-M,464,1,0,0,1373,1374,C
7-M,465,0,1368,0,2,1370,T
7-M,466,0,0,1370,0,1370,G
7-M,467,1369,1,2,0,1372,A
7-M,468,1,0,0,1440,1441,C
7-M,469,0,1439,0,3,1442,T
7-M,470,2,0,0,1440,1442,C
7-M,471,1,0,0,1434,1435,C
7-M,472,2,1,0,1442,1445,C
7-M,473,1438,0,1,0,1439,A
7-M,474,0,1,1443,0,1444,G
7-M,475,1,2,0,1436,1439,C
7-M,476,1447,0,1,0,1448,A
7-M,477,0,0,0,1446,1446,C
7-M,478,1347,0,4,0,1351,A
7-M,479,3,2,1367,0,1372,G
7-M,480,0,1,1376,0,1377,G
7-M,481,0,1368,0,1,1369,T
7-M,482,3,0,0,1394,1397,C
7-M,483,1,1375,0,1,1377,T
7-M,484,0,0,0,1384,1384,C
7-M,485,1382,0,0,0,1382,A
7-M,486,0,1379,0,1,1380,T
7-M,487,1384,1,0,0,1385,A
7-M,488,0,0,1366,0,1366,G
7-M,489,0,0,1359,0,1359,G
7-M,490,2,0,0,1352,1354,C
7-M,491,1298,0,0,0,1298,A
7-M,492,0,0,1288,0,1288,G
7-M,493,1290,0,4,0,1294,A
7-M,494,0,1295,0,0,1295,T
7-M,495,0,6,1290,1,1297,G
7-M,496,1,0,1294,0,1295,G
7-M,497,0,1287,0,1,1288,T
7-M,498,0,2,1298,0,1300,G
7-M,499,0,1,1303,0,1304,G
7-M,500,0,0,0,1304,1304,C
7-M,501,1293,0,2,0,1295,A
7-M,502,1296,3,2,0,1301,A
7-M,503,0,0,0,1313,1313,C
7-M,504,1318,0,0,0,1318,A
7-M,505,1319,0,1,0,1320,A
7-M,506,0,1,0,1319,1320,C
7-M,507,1,0,0,1310,1311,C
7-M,508,1299,0,1,0,1300,A
7-M,509,1305,0,0,0,1305,A
7-M,510,0,1297,0,2,1299,T
7-M,511,1,0,0,1309,1310,C
7-M,512,4,1,0,1294,1299,C
7-M,513,1279,0,0,9,1288,A
7-M,514,0,1284,0,1,1285,T
7-M,515,0,1291,1,0,1292,T
7-M,516,1299,0,1,0,1300,A
7-M,517,1306,0,0,0,1306,A
7-M,518,0,1302,0,0,1302,T
7-M,519,1289,0,2,0,1291,A
7-M,520,1291,0,1,0,1292,A
7-M,521,1274,1,3,0,1278,A
7-M,522,1285,0,0,0,1285,A
7-M,523,0,0,0,1312,1312,C
7-M,524,1306,0,3,0,1309,A
7-M,525,1,1303,0,1,1305,T
7-M,526,1,4,1301,0,1306,G
7-M,527,1301,0,1,0,1302,A
7-M,528,0,1,1311,0,1312,G
7-M,529,1307,0,5,0,1312,A
7-M,530,1312,0,1,0,1313,A
7-M,531,0,0,0,1321,1321,C
7-M,532,1282,0,3,0,1285,A
7-M,533,0,0,1303,0,1303,G
7-M,534,1293,1,3,0,1297,A
7-M,535,1298,1,1,0,1300,A
7-M,536,0,1287,0,0,1287,T
7-M,537,1,1,1283,0,1285,G
7-M,538,1,0,1286,0,1287,G
7-M,539,0,1278,0,2,1280,T
7-M,540,0,1244,0,1,1245,T
7-M,541,0,1274,0,0,1274,T
7-M,542,1,1275,0,0,1276,T
7-M,543,0,2,1286,0,1288,G
7-M,544,0,0,1284,0,1284,G
7-M,545,0,2,0,1280,1282,C
7-M,546,2,1,1,1282,1286,C
7-M,547,1260,0,0,0,1260,A
7-M,548,0,0,1316,0,1316,G
7-M,549,1,0,0,1320,1321,C
7-M,550,1334,0,0,0,1334,A
7-M,551,0,0,0,1360,1360,C
7-M,552,0,1338,0,0,1338,T
7-M,553,1345,0,0,0,1345,A
7-M,554,0,0,0,1359,1359,C
7-M,555,1371,0,1,0,1372,A
7-M,556,0,0,1401,0,1401,G
7-M,557,2,0,0,1340,1342,C
7-M,558,0,1323,0,1,1324,T
7-M,559,1328,0,0,0,1328,A
7-M,560,1294,0,2,0,1296,A
7-M,561,1,0,1312,0,1313,G
7-M,562,0,0,1312,0,1312,G
7-M,563,0,0,0,1303,1303,C
7-M,564,1,1237,0,1,1239,T
7-M,565,1237,0,1,0,1238,A
7-M,566,0,1234,0,1,1235,T
7-M,567,0,0,1235,0,1235,G
7-M,568,1,1,1250,0,1252,G
7-M,569,1217,0,3,0,1220,A
7-M,570,1,0,1224,0,1225,G
7-M,571,0,0,0,1212,1212,C
7-M,572,1202,0,1,0,1203,A
7-M,573,1205,0,0,0,1205,A
7-M,574,1199,0,1,0,1200,A
7-M,575,0,1217,0,0,1217,T
7-M,576,0,2,1211,0,1213,G
7-M,577,0,1,1199,0,1200,G
7-M,578,0,1,0,1197,1198,C
7-M,579,0,1183,0,3,1186,T
7-M,580,0,2,1184,0,1186,G
7-M,581,0,0,1204,0,1204,G
7-M,582,1207,0,1,0,1208,A
7-M,583,0,1199,0,0,1199,T
7-M,584,2,0,0,1182,1184,C
7-M,585,1184,0,1,0,1185,A
7-M,586,1192,0,1,0,1193,A
7-M,587,1,1,1197,0,1199,G
7-M,588,0,1195,0,1,1196,T
7-M,589,1,5,1196,0,1202,G
7-M,590,1167,2,2,0,1171,A
7-M,591,0,2,1176,0,1178,G
7-M,592,0,1,0,1176,1177,C
7-M,593,1169,0,1,0,1170,A
7-M,594,0,0,1174,0,1174,G
7-M,595,0,0,1160,0,1160,G
7-M,596,0,0,0,1164,1164,C
7-M,597,1165,0,0,0,1165,A
7-M,598,0,0,1182,0,1182,G
7-M,599,0,2,0,1177,1179,C
7-M,600,0,6,1170,0,1176,G
7-M,601,1,2,1172,0,1175,G
7-M,602,1169,0,1,0,1170,A
7-M,603,0,4,1188,0,1192,G
7-M,604,0,0,1194,0,1194,G
7-M,605,0,0,0,1189,1189,C
7-M,606,1,0,1,1194,1196,C
7-M,607,1188,0,0,0,1188,A
7-M,608,0,1188,0,4,1192,T
7-M,609,0,1,1195,0,1196,G
7-M,610,0,0,1193,0,1193,G
7-M,611,1187,0,1,1,1189,A
7-M,612,0,1,1194,0,1195,G
7-M,613,1152,2,0,0,1154,A
7-M,614,1,1171,0,0,1172,T
7-M,615,0,1171,0,0,1171,T
7-M,616,1,0,1170,0,1171,G
7-M,617,0,0,0,1171,1171,C
7-M,618,0,1168,0,1,1169,T
7-M,619,1169,0,1,0,1170,A
7-M,620,0,5,1166,0,1171,G
7-M,621,1,1162,0,2,1165,T
7-M,622,0,0,0,1166,1166,C
7-M,623,1134,0,1,0,1135,A
7-M,624,0,0,1156,0,1156,G
7-M,625,0,0,1155,0,1155,G
7-M,626,0,0,0,1153,1153,C
7-M,627,2,0,0,1153,1155,C
7-M,628,1147,0,1,0,1148,A
7-M,629,0,0,1169,0,1169,G
7-M,630,0,0,1160,0,1160,G
7-M,631,1,1,0,1167,1169,C
7-M,632,1160,0,3,0,1163,A
7-M,633,0,2,1152,0,1154,G
7-M,634,1148,0,3,0,1151,A
7-M,635,1,1147,0,1,1149,T
7-M,636,0,0,1155,0,1155,G
7-M,637,0,0,1185,0,1185,G
7-M,638,0,1168,0,1,1169,T
7-M,639,2,0,1166,0,1168,G
7-M,640,1,0,0,1166,1167,C
7-M,641,1155,1,2,0,1158,A
7-M,642,0,2,1174,0,1176,G
7-M,643,2,0,1169,0,1171,G
7-M,644,1,0,0,1171,1172,C
7-M,645,1175,0,0,0,1175,A
7-M,646,1148,0,2,0,1150,A
7-M,647,1,1145,0,0,1146,T
7-M,648,0,1,1144,0,1145,G
7-M,649,1140,0,4,0,1144,A
7-M,650,0,1,1137,0,1138,G
7-M,651,1114,0,1,0,1115,A
7-M,652,0,0,1125,0,1125,G
7-M,653,0,0,0,1126,1126,C
7-M,654,0,1,0,1133,1134,C
7-M,655,1149,0,1,0,1150,A
7-M,656,1,1145,0,2,1148,T
7-M,657,0,1142,0,3,1145,T
7-M,658,0,3,1144,0,1147,G
7-M,659,0,1,1140,0,1141,G
7-M,660,1,4,1146,0,1151,G
7-M,661,1151,0,0,0,1151,A
7-M,662,0,1,0,1145,1146,C
7-M,663,0,1099,0,0,1099,T
7-M,664,2,0,0,1105,1107,C
7-M,665,1116,0,1,0,1117,A
7-M,666,0,1170,0,3,1173,T
7-M,667,1,0,0,1171,1172,C
7-M,668,3,0,0,1164,1167,C
7-M,669,1,1165,0,0,1166,T
7-M,670,1162,0,0,0,1162,A
7-M,671,0,1,1186,0,1187,G
7-M,672,0,1280,0,1,1281,T
7-M,673,0,1264,0,4,1268,T
7-M,674,1,1,0,1256,1258,C
7-M,675,2,1,0,1225,1228,C
7-M,676,1216,0,3,0,1219,A
7-M,677,0,0,1241,0,1241,G
7-M,678,0,1239,0,1,1240,T
7-M,679,1240,0,0,0,1240,A
7-M,680,0,0,0,1233,1233,C
7-M,681,0,1099,0,0,1099,T
7-M,682,0,1,1149,0,1150,G
7-M,683,2,0,1172,0,1174,G
7-M,684,0,1166,0,0,1166,T
7-M,685,2,0,0,1170,1172,C
7-M,686,0,1148,0,0,1148,T
7-M,687,1147,0,0,1,1148,A
7-M,688,1144,0,2,0,1146,A
7-M,689,1,1,1151,0,1153,G
7-M,690,1144,0,2,0,1146,A
7-M,691,0,1,1125,0,1126,G
7-M,692,1074,0,2,0,1076,A
7-M,693,0,1076,0,3,1079,T
7-M,694,1,2,1071,0,1074,G
7-M,695,1066,0,1,0,1067,A
7-M,696,1,1064,2,2,1069,T
7-M,697,0,1,0,1070,1071,C
7-M,698,0,1057,1,0,1058,T
7-M,699,0,1061,0,0,1061,T
7-M,700,0,0,0,1063,1063,C
7-M,701,1,1059,0,3,1063,T
7-M,702,0,1062,0,0,1062,T
7-M,703,0,0,1062,0,1062,G
7-M,704,1061,0,0,0,1061,A
7-M,705,1058,0,0,2,1060,A
7-M,706,1064,0,0,0,1064,A
7-M,707,1060,0,1,0,1061,A
7-M,708,0,1066,0,0,1066,T
7-M,709,0,1070,1,1,1072,T
7-M,710,0,1076,0,0,1076,T
7-M,711,0,0,1071,0,1071,G
7-M,712,0,0,0,1073,1073,C
7-M,713,1074,0,1,0,1075,A
7-M,714,0,2,1076,0,1078,G
7-M,715,1077,0,1,0,1078,A
7-M,716,0,0,0,1093,1093,C
7-M,717,0,1,0,1085,1086,C
7-M,718,1,1084,0,0,1085,T
7-M,719,1105,0,1,0,1106,A
7-M,720,0,1106,0,1,1107,T
7-M,721,2,1,0,1103,1106,C
7-M,722,1106,0,0,1,1107,A
7-M,723,0,0,1104,0,1104,G
7-M,724,1102,0,1,0,1103,A
7-M,725,1068,0,2,0,1070,A
7-M,726,1074,0,0,0,1074,A
7-M,727,0,1,2,1081,1084,C
7-M,728,0,0,1080,0,1080,G
7-M,729,1076,0,0,0,1076,A
7-M,730,1072,0,2,0,1074,A
7-M,731,0,1079,0,0,1079,T
7-M,732,0,3,1064,0,1067,G
7-M,733,0,3,1075,0,1078,G
7-M,734,0,1,1080,0,1081,G
7-M,735,1,3,1072,0,1076,G
7-M,736,0,0,1077,0,1077,G
7-M,737,2,1048,0,2,1052,T
7-M,738,1,0,1052,0,1053,G
7-M,739,0,0,0,1051,1051,C
7-M,740,1048,1,4,0,1053,A
7-M,741,0,0,1060,0,1060,G
7-M,742,1040,0,1,0,1041,A
7-M,743,0,1030,0,0,1030,T
7-M,744,0,0,1030,0,1030,G
7-M,745,0,1,0,1019,1020,C
7-M,746,1010,0,2,0,1012,A
7-M,747,1014,0,1,0,1015,A
7-M,748,0,0,0,1014,1014,C
7-M,749,0,1,1014,0,1015,G
7-M,750,1017,0,1,0,1018,A
7-M,751,0,1018,0,1,1019,T
7-M,752,0,1012,0,2,1014,T
7-M,753,2,0,0,1019,1021,C
7-M,754,1002,0,0,0,1002,A
7-M,755,999,0,0,0,999,A
7-M,756,0,1,999,0,1000,G
7-M,757,1,986,0,0,987,T
7-M,758,0,1,979,0,980,G
7-M,759,978,0,0,0,978,A
7-M,760,0,0,0,975,975,C
7-M,761,1,1,0,968,970,C
7-M,762,2,0,0,970,972,C
7-M,763,3,0,975,0,978,G
7-M,764,0,0,0,977,977,C
7-M,765,1,971,0,3,975,T
7-M,766,0,979,0,0,979,T
7-M,767,0,1,978,0,979,G
7-M,768,0,976,0,0,976,T
7-M,769,0,971,0,2,973,T
7-M,770,0,0,971,0,971,G
7-M,771,0,960,0,0,960,T
7-M,772,0,949,0,2,951,T
7-M,773,1,0,951,0,952,G
7-M,774,0,0,0,950,950,C
7-M,775,0,2,1,941,944,C
7-M,776,0,0,952,0,952,G
7-M,777,0,0,0,951,951,C
7-M,778,0,1,953,0,954,G
7-M,779,954,0,0,0,954,A
7-M,780,955,0,1,0,956,A
7-M,781,0,962,1,1,964,T
7-M,782,962,0,0,0,962,A
7-M,783,0,972,0,1,973,T
7-M,784,1,2,0,984,987,C
7-M,785,987,0,0,0,987,A
7-M,786,1,983,0,0,984,T
7-M,787,0,977,0,1,978,T
7-M,788,0,2,972,0,974,G
7-M,789,0,1,973,0,974,G
7-M,790,1,0,973,0,974,G
7-M,791,976,0,2,0,978,A
7-M,792,0,959,0,5,964,T
7-M,793,0,0,0,935,935,C
7-M,794,0,925,0,2,927,T
7-M,795,0,926,0,1,927,T
7-M,796,3,0,933,0,936,G
7-M,797,0,0,0,934,934,C
7-M,798,933,0,0,0,933,A
7-M,799,0,0,0,937,937,C
7-M,800,0,918,0,0,918,T
7-M,801,1,924,0,0,925,T
7-M,802,0,3,923,0,926,G
7-M,803,922,0,1,0,923,A
7-M,804,0,931,0,0,931,T
7-M,805,908,0,0,0,908,A
7-M,806,0,907,0,4,911,T
7-M,807,0,899,0,1,900,T
7-M,808,0,0,901,0,901,G
7-M,809,0,897,0,1,898,T
7-M,810,5,0,888,0,893,G
7-M,811,0,0,892,0,892,G
7-M,812,875,1,0,0,876,A
7-M,813,1,868,0,0,869,T
7-M,814,0,876,0,1,877,T
7-M,815,1,0,0,873,874,C
7-M,816,2,869,0,0,871,T
7-M,817,0,863,0,0,863,T
7-M,818,0,1,863,0,864,G
7-M,819,853,0,2,0,855,A
7-M,820,0,855,0,2,857,T
7-M,821,1,0,0,845,846,C
7-M,822,0,0,844,0,844,G
7-M,823,0,838,1,2,841,T
7-M,824,0,0,1,835,836,C
7-M,825,0,835,0,4,839,T
7-M,826,0,841,0,0,841,T
7-M,827,0,838,0,1,839,T
7-M,828,0,841,0,0,841,T
7-M,829,0,839,0,2,841,T
7-M,830,0,842,0,2,844,T
7-M,831,0,842,0,2,844,T
7-M,832,1,1,0,838,840,C
7-M,833,836,0,0,0,836,A
7-M,834,835,0,0,0,835,A
7-M,835,836,0,0,0,836,A
7-M,836,0,838,0,0,838,T
7-M,837,0,0,839,0,839,G
7-M,838,1,0,0,837,838,C
7-M,839,1,0,840,0,841,G
7-M,840,0,847,0,3,850,T
7-M,841,0,0,0,850,850,C
7-M,842,1,850,0,0,851,T
7-M,843,850,1,1,0,852,A
7-M,844,0,852,0,1,853,T
7-M,845,1,0,0,846,847,C
7-M,846,0,0,849,0,849,G
7-M,847,844,0,0,0,844,A
7-M,848,1,0,0,844,845,C
7-M,849,0,814,0,2,816,T
7-M,850,2,0,0,833,835,C
7-M,851,0,829,0,4,833,T
7-M,852,0,836,0,0,836,T
7-M,853,1,1,0,834,836,C
7-M,854,835,0,1,0,836,A
7-M,855,836,0,0,0,836,A
7-M,856,836,0,0,0,836,A
7-M,857,0,0,0,832,832,C
7-M,858,827,0,1,0,828,A
7-M,859,1,0,0,787,788,C
7-M,860,1,1,769,0,771,G
7-M,861,0,1,794,0,795,G
7-M,862,0,0,0,794,794,C
7-M,863,1,0,0,792,793,C
7-M,864,0,795,0,2,797,T
7-M,865,0,799,0,0,799,T
7-M,866,801,0,0,0,801,A
7-M,867,803,0,0,0,803,A
7-M,868,802,0,0,0,802,A
7-M,869,801,0,1,0,802,A
7-M,870,0,1,791,0,792,G
7-M,871,686,0,0,0,686,A
7-M,872,1,0,681,0,682,G
7-M,873,0,0,681,0,681,G
7-M,874,0,0,0,683,683,C
7-M,875,0,0,0,680,680,C
7-M,876,0,0,0,682,682,C
7-M,877,0,678,0,2,680,T
7-M,878,0,684,0,0,684,T
7-M,879,1,0,0,686,687,C
7-M,880,0,688,0,0,688,T
7-M,881,687,1,1,0,689,A
7-M,882,2,1,1,684,688,C
7-M,883,1,1,674,0,676,G
7-M,884,0,0,677,0,677,G
7-M,885,664,0,0,0,664,A
7-M,886,666,0,0,0,666,A
7-M,887,0,1,659,1,661,G
7-M,888,0,3,659,0,662,G
7-M,889,658,0,2,0,660,A
7-M,890,0,0,659,0,659,G
7-M,891,0,657,0,1,658,T
7-M,892,659,0,1,0,660,A
7-M,893,0,0,0,655,655,C
7-M,894,2,1,0,653,656,C
7-M,895,0,650,0,0,650,T
7-M,896,0,2,650,0,652,G
7-M,897,622,0,1,0,623,A
7-M,898,0,0,634,0,634,G
7-M,899,1,613,0,2,616,T
7-M,900,0,0,0,617,617,C
7-M,901,0,605,1,0,606,T
7-M,902,604,0,0,0,604,A
7-M,903,1,602,0,0,603,T
7-M,904,1,0,604,0,605,G
7-M,905,590,0,1,0,591,A
7-M,906,0,3,583,0,586,G
7-M,907,0,0,536,0,536,G
7-M,908,0,1,532,0,533,G
7-M,909,530,0,1,0,531,A
7-M,910,527,0,0,0,527,A
7-M,911,0,1,525,0,526,G
7-M,912,511,0,1,0,512,A
7-M,913,512,0,0,0,512,A
7-M,914,0,507,1,0,508,T
7-M,915,496,0,1,0,497,A
7-M,916,0,495,0,2,497,T
7-M,917,0,3,0,484,487,C
7-M,918,0,0,492,0,492,G
7-M,919,490,0,1,0,491,A
7-M,920,483,0,0,0,483,A
7-M,921,481,0,1,0,482,A
7-M,922,0,1,476,0,477,G
7-M,923,0,0,481,0,481,G
7-M,924,479,0,0,0,479,A
7-M,925,477,0,2,0,479,A
7-M,926,0,0,0,480,480,C
7-M,927,459,0,0,0,459,A
7-M,928,0,0,464,0,464,G
7-M,929,0,0,0,461,461,C
7-M,930,462,0,0,0,462,A
7-M,931,1,0,460,0,461,G
7-M,932,434,0,0,0,434,A
7-M,933,433,0,1,0,434,A
7-M,934,0,433,0,0,433,T
7-M,935,0,0,420,0,420,G
7-M,936,0,0,0,422,422,C
7-M,937,0,390,0,0,390,T
7-M,938,0,0,390,0,390,G
7-M,939,0,388,0,0,388,T
7-M,940,0,0,385,0,385,G
7-M,941,0,0,384,0,384,G
7-M,942,370,1,0,0,371,A
7-M,943,0,369,0,0,369,T
7-M,944,0,0,360,0,360,G
7-M,945,0,0,0,347,347,C
7-M,946,0,297,0,0,297,T
7-M,947,0,0,290,0,290,G
7-M,948,291,0,0,0,291,A
7-M,949,0,0,0,286,286,C
7-M,950,0,0,286,0,286,G
7-M,951,282,0,1,0,283,A
7-M,952,0,0,0,283,283,C
7-M,953,272,0,0,0,272,A
7-M,954,2,0,271,0,273,G
7-M,955,0,267,0,1,268,T
7-M,956,2,0,0,268,270,C
7-M,957,270,0,1,0,271,A
7-M,958,0,268,0,0,268,T
7-M,959,0,268,0,0,268,T
7-M,960,0,265,0,0,265,T
7-M,961,0,260,0,0,260,T
7-M,962,0,0,262,0,262,G
7-M,963,0,243,0,0,243,T
7-M,964,0,0,0,244,244,C
7-M,965,234,0,1,0,235,A
7-M,966,0,0,235,0,235,G
7-M,967,0,0,0,234,234,C
7-M,968,234,0,0,0,234,A
7-M,969,0,231,3,0,234,T
7-M,970,220,0,0,0,220,A
7-M,971,0,0,220,0,220,G
7-M,972,210,0,1,0,211,A
7-M,973,0,0,211,0,211,G
7-M,974,0,200,0,0,200,T
7-M,975,0,139,0,0,139,T
7-M,976,0,0,137,0,137,G
7-M,977,0,0,137,0,137,G
7-M,978,136,0,0,0,136,A
7-M,979,0,0,136,0,136,G
7-M,980,0,86,0,0,86,T
7-M,981,81,0,0,0,81,A
7-M,982,79,0,0,0,79,A
8-NS,1,413,0,0,0,413,A
8-NS,2,0,412,0,0,412,T
8-NS,3,0,0,440,0,440,G
8-NS,4,0,0,467,0,467,G
8-NS,5,504,0,1,0,505,A
8-NS,6,0,1015,0,0,1015,T
8-NS,7,0,1013,0,1,1014,T
8-NS,8,1,0,0,1052,1053,C
8-NS,9,0,0,1,1057,1058,C
8-NS,10,1054,0,1,0,1055,A
8-NS,11,1068,0,3,0,1071,A
8-NS,12,0,0,0,1075,1075,C
8-NS,13,1076,0,0,0,1076,A
8-NS,14,0,0,0,1087,1087,C
8-NS,15,0,1086,0,2,1088,T
8-NS,16,1,2,1197,0,1200,G
8-NS,17,0,1206,0,1,1207,T
8-NS,18,0,0,1213,0,1213,G
8-NS,19,0,1215,0,3,1218,T
8-NS,20,1,1,0,1220,1222,C
8-NS,21,1219,0,0,0,1219,A
8-NS,22,1216,1,3,0,1220,A
8-NS,23,0,0,1243,0,1243,G
8-NS,24,0,1263,0,1,1264,T
8-NS,25,1,1251,0,2,1254,T
8-NS,26,1,1269,0,0,1270,T
8-NS,27,2,0,0,1266,1268,C
8-NS,28,1,0,0,1271,1272,C
8-NS,29,1272,1,0,0,1273,A
8-NS,30,1,2,1282,0,1285,G
8-NS,31,1,7,1287,0,1295,G
8-NS,32,0,1295,0,1,1296,T
8-NS,33,1298,0,1,0,1299,A
8-NS,34,0,1,1306,0,1307,G
8-NS,35,1305,0,0,0,1305,A
8-NS,36,0,1313,0,1,1314,T
8-NS,37,0,1308,0,3,1311,T
8-NS,38,1,0,1336,0,1337,G
8-NS,39,0,1,0,1338,1339,C
8-NS,40,0,1339,0,2,1341,T
8-NS,41,0,1349,0,0,1349,T
8-NS,42,1,1359,0,1,1361,T
8-NS,43,2,0,0,1390,1392,C
8-NS,44,0,1392,0,0,1392,T
8-NS,45,2,1393,0,0,1395,T
8-NS,46,0,1392,0,1,1393,T
8-NS,47,1,2,1401,0,1404,G
8-NS,48,0,0,1403,0,1403,G
8-NS,49,0,0,0,1405,1405,C
8-NS,50,1398,0,3,0,1401,A
8-NS,51,0,1400,0,1,1401,T
8-NS,52,1415,0,2,0,1417,A
8-NS,53,0,1445,0,0,1445,T
8-NS,54,0,0,0,1444,1444,C
8-NS,55,4,1,0,1440,1445,C
8-NS,56,1,2,1443,0,1446,G
8-NS,57,1,1,1454,0,1456,G
8-NS,58,1458,0,1,0,1459,A
8-NS,59,1459,0,0,0,1459,A
8-NS,60,1467,0,2,0,1469,A
8-NS,61,0,0,0,1492,1492,C
8-NS,62,1489,0,1,4,1494,A
8-NS,63,1495,0,1,0,1496,A
8-NS,64,1,1,1559,0,1561,G
8-NS,65,0,1569,0,0,1569,T
8-NS,66,0,1561,0,0,1561,T
8-NS,67,0,0,1572,0,1572,G
8-NS,68,0,1570,0,2,1572,T
8-NS,69,1566,0,2,0,1568,A
8-NS,70,2,4,1570,1,1577,G
8-NS,71,1659,0,2,0,1661,A
8-NS,72,2,0,0,1681,1683,C
8-NS,73,2,2,0,1656,1660,C
8-NS,74,1661,0,1,0,1662,A
8-NS,75,1664,1,1,0,1666,A
8-NS,76,0,2,1752,0,1754,G
8-NS,77,1742,0,6,0,1748,A
8-NS,78,1763,1,0,0,1764,A
8-NS,79,0,1,0,1762,1763,C
8-NS,80,0,1744,0,1,1745,T
8-NS,81,0,0,1758,0,1758,G
8-NS,82,1752,0,2,0,1754,A
8-NS,83,3,0,1783,2,1788,G
8-NS,84,0,1787,1,1,1789,T
8-NS,85,0,3,1766,0,1769,G
8-NS,86,1775,0,3,1,1779,A
8-NS,87,1,1776,0,0,1777,T
8-NS,88,0,1,1795,0,1796,G
8-NS,89,0,2,0,1833,1835,C
8-NS,90,4,0,1,1836,1841,C
8-NS,91,4,0,0,1844,1848,C
8-NS,92,2,0,1,1841,1844,C
8-NS,93,1843,0,1,0,1844,A
8-NS,94,0,1864,0,3,1867,T
8-NS,95,1,1884,0,2,1887,T
8-NS,96,2,1,0,1896,1899,C
8-NS,97,0,1,0,1882,1883,C
8-NS,98,0,1883,0,5,1888,T
8-NS,99,0,1877,0,1,1878,T
8-NS,100,0,6,1874,0,1880,G
8-NS,101,1870,0,1,0,1871,A
8-NS,102,0,1875,0,3,1878,T
8-NS,103,2,1,0,1870,1873,C
8-NS,104,0,4,1862,0,1866,G
8-NS,105,0,0,1880,0,1880,G
8-NS,106,0,0,0,1883,1883,C
8-NS,107,0,1867,0,4,1871,T
8-NS,108,1,1879,0,1,1881,T
8-NS,109,1,1,0,1879,1881,C
8-NS,110,0,3,1881,0,1884,G
8-NS,111,2,1,0,1885,1888,C
8-NS,112,0,0,0,1887,1887,C
8-NS,113,1,2,1887,0,1890,G
8-NS,114,1884,1,2,0,1887,A
8-NS,115,2,1,1965,0,1968,G
8-NS,116,1960,1,2,0,1963,A
8-NS,117,0,1976,0,0,1976,T
8-NS,118,2,4,0,1973,1979,C
8-NS,119,1974,1,2,0,1977,A
8-NS,120,1,1,1978,1,1981,G
8-NS,121,1972,0,7,0,1979,A
8-NS,122,0,2,1986,0,1988,G
8-NS,123,0,0,2027,0,2027,G
8-NS,124,1,2031,0,2,2034,T
8-NS,125,3,0,0,2177,2180,C
8-NS,126,3,0,0,2187,2190,C
8-NS,127,4,0,0,2200,2204,C
8-NS,128,1,2208,0,1,2210,T
8-NS,129,2209,0,1,0,2210,A
8-NS,130,2206,0,6,0,2212,A
8-NS,131,7,4,2241,0,2252,G
8-NS,132,9,4,2234,0,2247,G
8-NS,133,0,3,2235,0,2238,G
8-NS,134,3,5,2181,0,2189,G
8-NS,135,2177,0,5,0,2182,A
8-NS,136,2185,0,4,0,2189,A
8-NS,137,0,3,2200,0,2203,G
8-NS,138,2237,1,3,0,2241,A
8-NS,139,0,1,2258,0,2259,G
8-NS,140,2,1,2249,1,2253,G
8-NS,141,0,1,0,2266,2267,C
8-NS,142,2256,0,2,1,2259,A
8-NS,143,2261,1,2,0,2264,A
8-NS,144,0,2266,0,0,2266,T
8-NS,145,2290,0,1,0,2291,A
8-NS,146,1,0,0,2325,2326,C
8-NS,147,0,2297,0,1,2298,T
8-NS,148,1,2,0,2300,2303,C
8-NS,149,0,2288,0,0,2288,T
8-NS,150,4,2,0,2298,2304,C
8-NS,151,0,5,2329,0,2334,G
8-NS,152,2,0,2453,0,2455,G
8-NS,153,1,2456,0,0,2457,T
8-NS,154,6,0,0,2464,2470,C
8-NS,155,0,2446,0,13,2459,T
8-NS,156,2472,2,1,0,2475,A
8-NS,157,0,3,2471,0,2474,G
8-NS,158,2474,0,3,0,2477,A
8-NS,159,1,1,0,2535,2537,C
8-NS,160,2485,0,1,0,2486,A
8-NS,161,0,2456,0,0,2456,T
8-NS,162,4,0,0,2445,2449,C
8-NS,163,2450,1,1,0,2452,A
8-NS,164,2448,1,0,0,2449,A
8-NS,165,2436,0,7,1,2444,A
8-NS,166,0,1,2451,0,2452,G
8-NS,167,0,2,0,2454,2456,C
8-NS,168,2424,1,2,0,2427,A
8-NS,169,0,6,2431,0,2437,G
8-NS,170,1,2,1,2432,2436,C
8-NS,171,6,2,0,2427,2435,C
8-NS,172,2450,1,1,0,2452,A
8-NS,173,1,0,0,2497,2498,C
8-NS,174,1,1,0,2497,2499,C
8-NS,175,5,1,0,2497,2503,C
8-NS,176,2530,2,3,0,2535,A
8-NS,177,0,2534,0,3,2537,T
8-NS,178,0,0,2534,0,2534,G
8-NS,179,1,2522,2,4,2529,T
8-NS,180,0,2522,1,4,2527,T
8-NS,181,1,4,2526,0,2531,G
8-NS,182,0,3,2517,0,2520,G
8-NS,183,2512,0,3,0,2515,A
8-NS,184,2512,1,0,1,2514,A
8-NS,185,2492,0,3,0,2495,A
8-NS,186,0,1,2512,0,2513,G
8-NS,187,1,1,0,2510,2512,C
8-NS,188,2505,0,0,0,2505,A
8-NS,189,2498,0,4,0,2502,A
8-NS,190,2493,0,1,0,2494,A
8-NS,191,0,2508,0,2,2510,T
8-NS,192,0,2510,0,2,2512,T
8-NS,193,2,1,2558,0,2561,G
8-NS,194,0,2553,0,1,2554,T
8-NS,195,2538,0,2,0,2540,A
8-NS,196,0,4,2537,0,2541,G
8-NS,197,2538,0,2,0,2540,A
8-NS,198,2534,0,1,0,2535,A
8-NS,199,2532,1,1,1,2535,A
8-NS,200,2523,0,4,0,2527,A
8-NS,201,0,1,2539,0,2540,G
8-NS,202,2507,0,2,0,2509,A
8-NS,203,0,2506,2,1,2509,T
8-NS,204,0,2505,0,3,2508,T
8-NS,205,1,0,1,2510,2512,C
8-NS,206,1,2519,0,0,2520,T
8-NS,207,1,2,2520,0,2523,G
8-NS,208,2520,0,3,0,2523,A
8-NS,209,2517,0,1,0,2518,A
8-NS,210,2510,1,3,0,2514,A
8-NS,211,1,2,2525,0,2528,G
8-NS,212,2524,0,4,1,2529,A
8-NS,213,2530,0,1,2,2533,A
8-NS,214,1,4,2545,0,2550,G
8-NS,215,2576,0,1,0,2577,A
8-NS,216,2586,0,2,0,2588,A
8-NS,217,0,2578,0,2,2580,T
8-NS,218,2,1,0,2599,2602,C
8-NS,219,0,2595,0,2,2597,T
8-NS,220,0,3,2609,1,2613,G
8-NS,221,2612,0,5,0,2617,A
8-NS,222,0,2616,0,0,2616,T
8-NS,223,0,2,2598,0,2600,G
8-NS,224,2571,0,4,0,2575,A
8-NS,225,1,1,2568,1,2571,G
8-NS,226,3,1,2561,0,2565,G
8-NS,227,0,1,0,2566,2567,C
8-NS,228,2573,0,4,0,2577,A
8-NS,229,0,2,0,2639,2641,C
8-NS,230,2,2632,0,1,2635,T
8-NS,231,1,2645,0,13,2659,T
8-NS,232,2664,0,3,0,2667,A
8-NS,233,2671,0,3,0,2674,A
8-NS,234,2660,1,2,1,2664,A
8-NS,235,2656,0,4,1,2661,A
8-NS,236,0,2657,0,0,2657,T
8-NS,237,1,4,2657,0,2662,G
8-NS,238,2666,0,1,0,2667,A
8-NS,239,3,1,0,2663,2667,C
8-NS,240,3,2,0,2643,2648,C
8-NS,241,2658,1,0,0,2659,A
8-NS,242,0,2651,0,2,2653,T
8-NS,243,0,12,2711,0,2723,G
8-NS,244,1,2,2747,1,2751,G
8-NS,245,0,2754,0,3,2757,T
8-NS,246,6,3,0,2878,2887,C
8-NS,247,0,2873,0,6,2879,T
8-NS,248,3,0,0,2916,2919,C
8-NS,249,3,2,1,2916,2922,C
8-NS,250,2924,0,2,0,2926,A
8-NS,251,1,2,0,2930,2933,C
8-NS,252,2893,0,4,0,2897,A
8-NS,253,1,0,0,2890,2891,C
8-NS,254,2,3,0,2856,2861,C
8-NS,255,2,2742,0,4,2748,T
8-NS,256,0,1,2768,0,2769,G
8-NS,257,0,0,0,2749,2749,C
8-NS,258,0,2724,0,2,2726,T
8-NS,259,0,2750,0,1,2751,T
8-NS,260,0,0,0,2741,2741,C
8-NS,261,0,1,2755,1,2757,G
8-NS,262,2,1,0,2752,2755,C
8-NS,263,5,3,2744,0,2752,G
8-NS,264,2869,1,4,0,2874,A
8-NS,265,1,2874,0,0,2875,T
8-NS,266,2951,1,1,0,2953,A
8-NS,267,1,1,0,2962,2964,C
8-NS,268,2951,0,3,0,2954,A
8-NS,269,1,3010,0,2,3013,T
8-NS,270,2983,0,5,0,2988,A
8-NS,271,2994,0,4,0,2998,A
8-NS,272,1,1,0,2999,3001,C
8-NS,273,0,2899,0,1,2900,T
8-NS,274,0,3,2927,0,2930,G
8-NS,275,2882,0,3,0,2885,A
8-NS,276,2,0,0,2892,2894,C
8-NS,277,2882,0,4,0,2886,A
8-NS,278,0,2862,0,1,2863,T
8-NS,279,1,3,2859,0,2863,G
8-NS,280,2854,0,6,0,2860,A
8-NS,281,5,0,0,2936,2941,C
8-NS,282,0,2930,0,1,2931,T
8-NS,283,2960,3,0,0,2963,A
8-NS,284,0,2965,0,3,2968,T
8-NS,285,0,2934,0,0,2934,T
8-NS,286,0,1,2938,0,2939,G
8-NS,287,2917,0,10,0,2927,A
8-NS,288,1,3,2924,0,2928,G
8-NS,289,0,2,2934,0,2936,G
8-NS,290,2861,0,3,0,2864,A
8-NS,291,2874,0,2,0,2876,A
8-NS,292,0,2810,0,25,2835,T
8-NS,293,0,2836,0,2,2838,T
8-NS,294,1,0,2930,0,2931,G
8-NS,295,1,2921,0,2,2924,T
8-NS,296,6,1,0,2920,2927,C
8-NS,297,2914,1,3,0,2918,A
8-NS,298,2918,0,0,1,2919,A
8-NS,299,14,4,2897,0,2915,G
8-NS,300,2,6,2864,0,2872,G
8-NS,301,2940,1,5,0,2946,A
8-NS,302,2950,0,7,0,2957,A
8-NS,303,0,0,0,2958,2958,C
8-NS,304,0,2906,0,1,2907,T
8-NS,305,1,4,2954,0,2959,G
8-NS,306,2,2,3011,0,3015,G
8-NS,307,3,2999,0,5,3007,T
8-NS,308,0,2992,1,6,2999,T
8-NS,309,9,2,0,2945,2956,C
8-NS,310,2960,0,2,1,2963,A
8-NS,311,0,2992,1,2,2995,T
8-NS,312,1,0,3015,0,3016,G
8-NS,313,0,1,1,3037,3039,C
8-NS,314,0,2994,0,3,2997,T
8-NS,315,2946,1,2,0,2949,A
8-NS,316,2986,0,2,1,2989,A
8-NS,317,0,3007,0,1,3008,T
8-NS,318,0,1,3008,0,3009,G
8-NS,319,2,1,0,3007,3010,C
8-NS,320,3,1,0,2978,2982,C
8-NS,321,6,0,0,2971,2977,C
8-NS,322,2969,1,0,1,2971,A
8-NS,323,2988,0,1,0,2989,A
8-NS,324,1,2,2989,0,2992,G
8-NS,325,0,1,0,2996,2997,C
8-NS,326,2975,0,5,0,2980,A
8-NS,327,0,2,2998,0,3000,G
8-NS,328,2989,0,4,0,2993,A
8-NS,329,2997,0,4,0,3001,A
8-NS,330,2994,0,1,0,2995,A
8-NS,331,1,1,3041,0,3043,G
8-NS,332,0,3024,0,2,3026,T
8-NS,333,2,5,3016,0,3023,G
8-NS,334,0,1,3020,0,3021,G
8-NS,335,3018,0,3,1,3022,A
8-NS,336,2996,0,8,0,3004,A
8-NS,337,0,4,2988,0,2992,G
8-NS,338,0,4,2995,0,2999,G
8-NS,339,3003,0,3,0,3006,A
8-NS,340,2,0,0,2992,2994,C
8-NS,341,3,1,0,2985,2989,C
8-NS,342,0,2972,3,3,2978,T
8-NS,343,0,0,0,3027,3027,C
8-NS,344,0,3020,0,4,3024,T
8-NS,345,0,3033,0,1,3034,T
8-NS,346,2,3030,0,2,3034,T
8-NS,347,1,1,3031,0,3033,G
8-NS,348,2,1,1,3059,3063,C
8-NS,349,3047,1,3,0,3051,A
8-NS,350,0,3056,0,4,3060,T
8-NS,351,1,1,0,3054,3056,C
8-NS,352,3084,0,3,0,3087,A
8-NS,353,3,3,3181,0,3187,G
8-NS,354,3172,0,2,1,3175,A
8-NS,355,3170,1,2,0,3173,A
8-NS,356,0,3166,1,1,3168,T
8-NS,357,2,2,3129,0,3133,G
8-NS,358,4,6,3154,0,3164,G
8-NS,359,3157,0,4,1,3162,A
8-NS,360,1,0,0,3154,3155,C
8-NS,361,7,0,0,3079,3086,C
8-NS,362,3037,2,0,1,3040,A
8-NS,363,1,2,3075,0,3078,G
8-NS,364,3,1,3074,0,3078,G
8-NS,365,1,0,1,3086,3088,C
8-NS,366,3069,0,4,0,3073,A
8-NS,367,3073,0,5,0,3078,A
8-NS,368,0,3076,0,5,3081,T
8-NS,369,3,0,1,3070,3074,C
8-NS,370,3069,2,4,0,3075,A
8-NS,371,0,3069,0,2,3071,T
8-NS,372,2,5,3026,0,3033,G
8-NS,373,0,4,3041,0,3045,G
8-NS,374,3033,1,6,1,3041,A
8-NS,375,0,1,3061,0,3062,G
8-NS,376,3024,0,0,0,3024,A
8-NS,377,3031,0,1,0,3032,A
8-NS,378,3031,0,1,2,3034,A
8-NS,379,3025,1,0,1,3027,A
8-NS,380,3032,0,3,0,3035,A
8-NS,381,0,1,0,3050,3051,C
8-NS,382,3032,1,2,0,3035,A
8-NS,383,2,3027,0,3,3032,T
8-NS,384,5,0,0,3001,3006,C
8-NS,385,2998,2,7,0,3007,A
8-NS,386,1,3024,0,0,3025,T
8-NS,387,0,0,3031,0,3031,G
8-NS,388,0,3021,0,4,3025,T
8-NS,389,1,3006,0,0,3007,T
8-NS,390,0,4,2990,4,2998,G
8-NS,391,2993,0,3,0,2996,A
8-NS,392,2987,0,3,0,2990,A
8-NS,393,2991,0,3,0,2994,A
8-NS,394,0,1,3005,0,3006,G
8-NS,395,0,1,0,2985,2986,C
8-NS,396,0,7,2986,0,2993,G
8-NS,397,2986,0,4,1,2991,A
8-NS,398,2990,3,1,1,2995,A
8-NS,399,1,2988,0,6,2995,T
8-NS,400,0,2988,0,6,2994,T
8-NS,401,0,2994,0,0,2994,T
8-NS,402,5,0,0,2994,2999,C
8-NS,403,2969,2,5,0,2976,A
8-NS,404,0,1,2978,1,2980,G
8-NS,405,0,2967,0,6,2973,T
8-NS,406,1,1,2971,0,2973,G
8-NS,407,0,2958,0,5,2963,T
8-NS,408,0,3,2973,0,2976,G
8-NS,409,2994,0,3,0,2997,A
8-NS,410,2,2981,0,0,2983,T
8-NS,411,1,2978,0,2,2981,T
8-NS,412,0,2982,0,2,2984,T
8-NS,413,0,2978,0,3,2981,T
8-NS,414,0,2976,0,7,2983,T
8-NS,415,2,7,2971,0,2980,G
8-NS,416,2979,0,3,0,2982,A
8-NS,417,1,0,0,2973,2974,C
8-NS,418,7,6,0,2938,2951,C
8-NS,419,1,3,2960,0,2964,G
8-NS,420,3106,0,0,0,3106,A
8-NS,421,0,1,0,3159,3160,C
8-NS,422,0,3164,0,3,3167,T
8-NS,423,3180,0,1,1,3182,A
8-NS,424,0,1,3178,0,3179,G
8-NS,425,3171,0,15,0,3186,A
8-NS,426,1,8,3197,0,3206,G
8-NS,427,3213,0,2,0,3215,A
8-NS,428,0,1,0,3292,3293,C
8-NS,429,7,2,0,3161,3170,C
8-NS,430,3078,1,4,0,3083,A
8-NS,431,1,3218,0,20,3239,T
8-NS,432,3210,0,3,0,3213,A
8-NS,433,1,1,3454,0,3456,G
8-NS,434,0,3436,0,1,3437,T
8-NS,435,3418,0,0,0,3418,A
8-NS,436,1,3419,0,3,3423,T
8-NS,437,0,3319,0,2,3321,T
8-NS,438,3383,0,1,0,3384,A
8-NS,439,0,0,0,3384,3384,C
8-NS,440,1,3198,0,1,3200,T
8-NS,441,3185,0,1,0,3186,A
8-NS,442,2889,0,2,0,2891,A
8-NS,443,2,5,2907,0,2914,G
8-NS,444,2,1,2901,0,2904,G
8-NS,445,0,1,2909,0,2910,G
8-NS,446,0,0,0,2877,2877,C
8-NS,447,0,2811,1,13,2825,T
8-NS,448,0,2813,0,5,2818,T
8-NS,449,0,2850,0,4,2854,T
8-NS,450,1,2,1,2859,2863,C
8-NS,451,2907,0,5,0,2912,A
8-NS,452,3,3,0,2914,2920,C
8-NS,453,2,4,0,2874,2880,C
8-NS,454,1,2,2881,0,2884,G
8-NS,455,2883,0,0,0,2883,A
8-NS,456,2877,1,7,0,2885,A
8-NS,457,0,4,2893,0,2897,G
8-NS,458,2852,1,9,0,2862,A
8-NS,459,0,9,2864,1,2874,G
8-NS,460,0,1,2818,1,2820,G
8-NS,461,1,4,2826,0,2831,G
8-NS,462,2820,1,12,0,2833,A
8-NS,463,4,0,2830,0,2834,G
8-NS,464,0,1,0,2835,2836,C
8-NS,465,2836,0,0,0,2836,A
8-NS,466,2836,1,4,0,2841,A
8-NS,467,3,2838,0,0,2841,T
8-NS,468,0,2828,0,0,2828,T
8-NS,469,3,0,2825,0,2828,G
8-NS,470,1,2785,0,13,2799,T
8-NS,471,0,2796,0,2,2798,T
8-NS,472,2,6,2787,0,2795,G
8-NS,473,3,1,2792,0,2796,G
8-NS,474,1,1,0,2800,2802,C
8-NS,475,3,3,2790,1,2797,G
8-NS,476,2798,1,2,1,2802,A
8-NS,477,2814,1,1,0,2816,A
8-NS,478,2821,0,0,1,2822,A
8-NS,479,0,2826,0,2,2828,T
8-NS,480,1,1,0,2827,2829,C
8-NS,481,1,2813,1,3,2818,T
8-NS,482,5,1,0,2822,2828,C
8-NS,483,2830,0,4,0,2834,A
8-NS,484,0,0,2,2844,2846,C
8-NS,485,4,1,1,2843,2849,C
8-NS,486,2823,2,1,0,2826,A
8-NS,487,0,2814,0,3,2817,T
8-NS,488,0,2804,0,0,2804,T
8-NS,489,1,1,2812,0,2814,G
8-NS,490,0,2,0,2799,2801,C
8-NS,491,4,1,0,2796,2801,C
8-NS,492,0,2802,0,7,2809,T
8-NS,493,0,2792,1,3,2796,T
8-NS,494,2,1,0,2814,2817,C
8-NS,495,0,2797,0,6,2803,T
8-NS,496,0,2803,1,3,2807,T
8-NS,497,0,2847,0,6,2853,T
8-NS,498,0,2838,0,1,2839,T
8-NS,499,1,0,0,2842,2843,C
8-NS,500,2,0,0,2847,2849,C
8-NS,501,2827,1,3,0,2831,A
8-NS,502,0,3,2854,0,2857,G
8-NS,503,1,5,2851,0,2857,G
8-NS,504,2911,0,4,0,2915,A
8-NS,505,0,2,0,2916,2918,C
8-NS,506,2933,0,9,0,2942,A
8-NS,507,0,2941,0,8,2949,T
8-NS,508,2954,0,3,0,2957,A
8-NS,509,2,1,0,3145,3148,C
8-NS,510,0,3140,0,1,3141,T
8-NS,511,3119,0,3,0,3122,A
8-NS,512,0,3110,1,3,3114,T
8-NS,513,0,3000,0,4,3004,T
8-NS,514,0,6,3000,0,3006,G
8-NS,515,2899,0,4,0,2903,A
8-NS,516,2,2,2896,0,2900,G
8-NS,517,0,3,2891,0,2894,G
8-NS,518,2591,0,0,0,2591,A
8-NS,519,0,2589,0,3,2592,T
8-NS,520,1,0,2585,0,2586,G
8-NS,521,0,2577,0,7,2584,T
8-NS,522,5,1,1,2578,2585,C
8-NS,523,2590,0,1,0,2591,A
8-NS,524,2590,2,0,0,2592,A
8-NS,525,2586,0,1,0,2587,A
8-NS,526,2574,1,2,1,2578,A
8-NS,527,2597,0,1,0,2598,A
8-NS,528,0,2588,0,0,2588,T
8-NS,529,0,1,2579,0,2580,G
8-NS,530,0,2,0,2600,2602,C
8-NS,531,2604,0,1,0,2605,A
8-NS,532,2609,0,1,1,2611,A
8-NS,533,0,2617,0,0,2617,T
8-NS,534,0,2618,0,0,2618,T
8-NS,535,0,9,2603,0,2612,G
8-NS,536,1,8,2594,0,2603,G
8-NS,537,0,1,2612,0,2613,G
8-NS,538,0,1,2643,0,2644,G
8-NS,539,1,2595,0,3,2599,T
8-NS,540,3,0,0,2625,2628,C
8-NS,541,4,1,1,2627,2633,C
8-NS,542,0,2628,0,3,2631,T
8-NS,543,4,1,0,2670,2675,C
8-NS,544,2674,1,0,0,2675,A
8-NS,545,0,2673,1,3,2677,T
8-NS,546,2,3,0,2675,2680,C
8-NS,547,3,2,2655,0,2660,G
8-NS,548,2,2,2660,1,2665,G
8-NS,549,2623,0,1,0,2624,A
8-NS,550,1,1,2624,1,2627,G
8-NS,551,0,4,2624,0,2628,G
8-NS,552,2595,0,5,0,2600,A
8-NS,553,0,0,0,2621,2621,C
8-NS,554,0,2611,0,7,2618,T
8-NS,555,0,2627,0,0,2627,T
8-NS,556,0,4,2632,0,2636,G
8-NS,557,2624,0,1,0,2625,A
8-NS,558,2621,0,3,0,2624,A
8-NS,559,1,2617,0,0,2618,T
8-NS,560,2,3,2570,0,2575,G
8-NS,561,1,1,2603,0,2605,G
8-NS,562,2573,0,1,0,2574,A
8-NS,563,2584,0,5,0,2589,A
8-NS,564,0,2697,0,1,2698,T
8-NS,565,0,2,2720,0,2722,G
8-NS,566,2723,1,3,0,2727,A
8-NS,567,0,2726,1,2,2729,T
8-NS,568,2726,0,2,0,2728,A
8-NS,569,2726,0,3,1,2730,A
8-NS,570,2,2,0,2701,2705,C
8-NS,571,2651,1,3,0,2655,A
8-NS,572,0,1,0,2670,2671,C
8-NS,573,2452,0,2,0,2454,A
8-NS,574,1,1,2508,0,2510,G
8-NS,575,4,2480,1,3,2488,T
8-NS,576,2,2481,0,4,2487,T
8-NS,577,9,1,0,2480,2490,C
8-NS,578,2,5,2465,0,2472,G
8-NS,579,2460,2,2,1,2465,A
8-NS,580,0,1,2468,1,2470,G
8-NS,581,0,2428,0,4,2432,T
8-NS,582,2,0,0,2449,2451,C
8-NS,583,2,2385,0,4,2391,T
8-NS,584,3,0,0,2402,2405,C
8-NS,585,1,2409,0,4,2414,T
8-NS,586,2418,0,1,0,2419,A
8-NS,587,2415,1,1,1,2418,A
8-NS,588,2412,0,0,0,2412,A
8-NS,589,2435,0,1,0,2436,A
8-NS,590,2436,1,0,0,2437,A
8-NS,591,0,2399,0,0,2399,T
8-NS,592,2,1,0,2422,2425,C
8-NS,593,0,2410,0,1,2411,T
8-NS,594,2417,0,0,1,2418,A
8-NS,595,1,0,2,2416,2419,C
8-NS,596,2409,3,2,0,2414,A
8-NS,597,0,0,2418,0,2418,G
8-NS,598,2365,1,6,0,2372,A
8-NS,599,0,3,2385,0,2388,G
8-NS,600,2383,0,1,0,2384,A
8-NS,601,0,2355,0,1,2356,T
8-NS,602,0,2361,0,2,2363,T
8-NS,603,1,0,0,2354,2355,C
8-NS,604,3,1,2359,0,2363,G
8-NS,605,1,0,0,2364,2365,C
8-NS,606,1,2359,0,1,2361,T
8-NS,607,0,2365,0,1,2366,T
8-NS,608,1,2,2348,0,2351,G
8-NS,609,1,5,2355,0,2361,G
8-NS,610,2356,2,3,1,2362,A
8-NS,611,1,1,2359,0,2361,G
8-NS,612,2359,0,2,0,2361,A
8-NS,613,2331,1,5,0,2337,A
8-NS,614,0,2,2387,0,2389,G
8-NS,615,0,2,0,2390,2392,C
8-NS,616,2385,2,2,1,2390,A
8-NS,617,1,2,2429,0,2432,G
8-NS,618,1,2397,0,1,2399,T
8-NS,619,2414,0,0,0,2414,A
8-NS,620,2411,0,2,0,2413,A
8-NS,621,0,2409,0,2,2411,T
8-NS,622,18,2,2400,0,2420,G
8-NS,623,2313,0,2,0,2315,A
8-NS,624,1,2,2356,0,2359,G
8-NS,625,2339,0,7,0,2346,A
8-NS,626,2274,2,3,0,2279,A
8-NS,627,0,2261,0,2,2263,T
8-NS,628,0,8,2225,0,2233,G
8-NS,629,0,5,2230,0,2235,G
8-NS,630,1,3,2218,0,2222,G
8-NS,631,0,2,2212,1,2215,G
8-NS,632,1,4,2215,0,2220,G
8-NS,633,2170,1,2,0,2173,A
8-NS,634,1,0,0,2189,2190,C
8-NS,635,4,1,0,2173,2178,C
8-NS,636,2,2127,0,3,2132,T
8-NS,637,3,0,0,2150,2153,C
8-NS,638,2,0,0,2144,2146,C
8-NS,639,2156,0,1,0,2157,A
8-NS,640,0,0,0,2155,2155,C
8-NS,641,0,2129,1,1,2131,T
8-NS,642,0,2112,0,6,2118,T
8-NS,643,2045,1,1,0,2047,A
8-NS,644,0,0,0,2061,2061,C
8-NS,645,1,2050,0,2,2053,T
8-NS,646,6,3,0,2025,2034,C
8-NS,647,5,1,0,1999,2005,C
8-NS,648,2003,0,1,0,2004,A
8-NS,649,2011,0,1,0,2012,A
8-NS,650,2013,0,0,0,2013,A
8-NS,651,2007,0,3,1,2011,A
8-NS,652,1,0,0,2014,2015,C
8-NS,653,1952,0,0,0,1952,A
8-NS,654,0,4,1954,0,1958,G
8-NS,655,1946,0,3,0,1949,A
8-NS,656,1947,0,0,0,1947,A
8-NS,657,1946,0,2,0,1948,A
8-NS,658,0,1,0,1945,1946,C
8-NS,659,0,4,1936,1,1941,G
8-NS,660,0,1,1944,0,1945,G
8-NS,661,0,0,1947,0,1947,G
8-NS,662,1946,0,1,1,1948,A
8-NS,663,1941,0,2,0,1943,A
8-NS,664,1930,0,7,1,1938,A
8-NS,665,0,1932,0,2,1934,T
8-NS,666,2,2,1935,0,1939,G
8-NS,667,1,1,1938,0,1940,G
8-NS,668,0,3,0,1927,1930,C
8-NS,669,1,6,1920,0,1927,G
8-NS,670,1923,0,1,0,1924,A
8-NS,671,0,2,1936,1,1939,G
8-NS,672,1941,0,1,0,1942,A
8-NS,673,1943,0,0,0,1943,A
8-NS,674,0,0,0,1950,1950,C
8-NS,675,1906,1,2,0,1909,A
8-NS,676,2,1,1908,0,1911,G
8-NS,677,0,0,0,1904,1904,C
8-NS,678,0,1903,0,1,1904,T
8-NS,679,1897,1,0,0,1898,A
8-NS,680,1,0,1874,0,1875,G
8-NS,681,0,0,1883,0,1883,G
8-NS,682,1,1872,0,4,1877,T
8-NS,683,4,0,0,1849,1853,C
8-NS,684,1849,0,1,0,1850,A
8-NS,685,1841,1,2,0,1844,A
8-NS,686,1845,0,1,0,1846,A
8-NS,687,1859,0,0,0,1859,A
8-NS,688,1,0,1866,0,1867,G
8-NS,689,0,1818,1,1,1820,T
8-NS,690,0,1811,1,0,1812,T
8-NS,691,0,1816,0,0,1816,T
8-NS,692,0,4,1818,0,1822,G
8-NS,693,1820,1,2,1,1824,A
8-NS,694,1815,1,5,0,1821,A
8-NS,695,2,2,1832,0,1836,G
8-NS,696,1822,0,2,0,1824,A
8-NS,697,0,0,1830,0,1830,G
8-NS,698,1824,0,5,0,1829,A
8-NS,699,0,1831,0,0,1831,T
8-NS,700,1832,0,1,0,1833,A
8-NS,701,1825,0,0,0,1825,A
8-NS,702,0,2,1820,0,1822,G
8-NS,703,1700,0,2,0,1702,A
8-NS,704,2,1698,0,1,1701,T
8-NS,705,0,1,1705,0,1706,G
8-NS,706,0,0,1708,0,1708,G
8-NS,707,2,0,0,1693,1695,C
8-NS,708,0,1686,1,2,1689,T
8-NS,709,1688,0,0,0,1688,A
8-NS,710,1681,0,1,0,1682,A
8-NS,711,0,1696,0,1,1697,T
8-NS,712,0,1684,0,1,1685,T
8-NS,713,0,1,1690,0,1691,G
8-NS,714,1668,0,1,1,1670,A
8-NS,715,1669,0,1,0,1670,A
8-NS,716,0,2,1672,0,1674,G
8-NS,717,1665,1,0,0,1666,A
8-NS,718,1654,0,2,1,1657,A
8-NS,719,1,0,1678,0,1679,G
8-NS,720,0,1649,0,0,1649,T
8-NS,721,0,2,1653,0,1655,G
8-NS,722,1627,0,2,2,1631,A
8-NS,723,2,2,1633,0,1637,G
8-NS,724,1634,0,3,0,1637,A
8-NS,725,1,0,0,1622,1623,C
8-NS,726,1612,2,1,0,1615,A
8-NS,727,1,1,0,1609,1611,C
8-NS,728,1484,0,0,0,1484,A
8-NS,729,0,1,1511,0,1512,G
8-NS,730,1501,0,6,0,1507,A
8-NS,731,3,1489,0,4,1496,T
8-NS,732,0,1495,0,2,1497,T
8-NS,733,1492,0,1,0,1493,A
8-NS,734,1490,0,1,0,1491,A
8-NS,735,1485,0,1,0,1486,A
8-NS,736,1484,0,1,0,1485,A
8-NS,737,1484,1,1,0,1486,A
8-NS,738,1,0,0,1437,1438,C
8-NS,739,1381,0,0,0,1381,A
8-NS,740,1387,1,3,0,1391,A
8-NS,741,0,0,0,1390,1390,C
8-NS,742,1,1382,0,2,1385,T
8-NS,743,0,0,1391,0,1391,G
8-NS,744,1393,0,0,0,1393,A
8-NS,745,1394,0,1,0,1395,A
8-NS,746,1394,0,2,0,1396,A
8-NS,747,1376,0,0,0,1376,A
8-NS,748,0,1375,0,0,1375,T
8-NS,749,1366,0,1,0,1367,A
8-NS,750,0,1,1373,0,1374,G
8-NS,751,0,0,0,1368,1368,C
8-NS,752,0,1336,0,2,1338,T
8-NS,753,0,1336,0,2,1338,T
8-NS,754,1,1326,0,0,1327,T
8-NS,755,1,0,1332,0,1333,G
8-NS,756,1334,0,0,0,1334,A
8-NS,757,1331,1,2,0,1334,A
8-NS,758,1,0,0,1331,1332,C
8-NS,759,1294,0,0,0,1294,A
8-NS,760,1298,0,1,0,1299,A
8-NS,761,1295,0,1,0,1296,A
8-NS,762,0,1299,0,1,1300,T
8-NS,763,1295,0,2,0,1297,A
8-NS,764,1258,0,5,0,1263,A
8-NS,765,0,0,0,1261,1261,C
8-NS,766,1255,0,1,0,1256,A
8-NS,767,0,1236,0,0,1236,T
8-NS,768,1,1208,1,2,1212,T
8-NS,769,2,0,1,1177,1180,C
8-NS,770,1175,0,0,0,1175,A
8-NS,771,0,1172,0,0,1172,T
8-NS,772,1,0,1171,0,1172,G
8-NS,773,0,1,0,1146,1147,C
8-NS,774,1128,0,0,0,1128,A
8-NS,775,1124,0,3,0,1127,A
8-NS,776,0,0,1121,0,1121,G
8-NS,777,1,0,0,1134,1135,C
8-NS,778,1112,0,1,0,1113,A
8-NS,779,0,1115,0,2,1117,T
8-NS,780,0,1112,0,0,1112,T
8-NS,781,1112,0,1,0,1113,A
8-NS,782,0,3,1,1110,1114,C
8-NS,783,1108,0,0,1,1109,A
8-NS,784,1089,1,2,0,1092,A
8-NS,785,1,1,0,1083,1085,C
8-NS,786,0,919,0,0,919,T
8-NS,787,0,0,917,0,917,G
8-NS,788,0,0,0,896,896,C
8-NS,789,0,862,0,1,863,T
8-NS,790,0,0,867,0,867,G
8-NS,791,2,849,0,1,852,T
8-NS,792,0,851,0,0,851,T
8-NS,793,0,850,0,0,850,T
8-NS,794,0,0,833,0,833,G
8-NS,795,831,0,4,0,835,A
8-NS,796,814,0,0,0,814,A
8-NS,797,0,0,815,0,815,G
8-NS,798,1,800,0,0,801,T
8-NS,799,0,2,766,0,768,G
8-NS,800,0,0,766,0,766,G
8-NS,801,763,0,2,0,765,A
8-NS,802,764,0,2,0,766,A
8-NS,803,0,0,0,764,764,C
8-NS,804,735,1,1,0,737,A
8-NS,805,1,1,738,0,740,G
8-NS,806,0,0,728,0,728,G
8-NS,807,716,2,1,0,719,A
8-NS,808,0,0,720,0,720,G
8-NS,809,588,0,4,0,592,A
8-NS,810,0,592,0,0,592,T
8-NS,811,589,0,1,0,590,A
8-NS,812,580,0,2,0,582,A
8-NS,813,0,0,582,0,582,G
8-NS,814,524,0,1,0,525,A
8-NS,815,522,0,0,0,522,A
8-NS,816,0,0,0,518,518,C
8-NS,817,0,443,0,1,444,T
8-NS,818,0,440,0,0,440,T
8-NS,819,0,437,0,0,437,T
8-NS,820,2,0,0,437,439,C
8-NS,821,0,435,0,0,435,T
8-NS,822,1,1,0,424,426,C
8-NS,823,414,0,0,0,414,A
8-NS,824,0,412,0,0,412,T
8-NS,825,0,401,0,1,402,T
8-NS,826,0,402,0,0,402,T
8-NS,827,0,0,0,399,399,C
8-NS,828,385,0,1,0,386,A
8-NS,829,0,0,387,0,387,G
8-NS,830,0,0,0,385,385,C
8-NS,831,1,354,0,1,356,T
8-NS,832,0,354,0,0,354,T
8-NS,833,345,0,0,0,345,A
8-NS,834,0,346,0,0,346,T
8-NS,835,0,346,0,0,346,T
8-NS,836,0,345,0,0,345,T
8-NS,837,329,0,0,0,329,A
8-NS,838,320,0,0,0,320,A
8-NS,839,0,314,0,0,314,T
8-NS,840,0,0,308,0,308,G
8-NS,841,300,0,0,0,300,A
8-NS,842,0,270,0,0,270,T
8-NS,843,268,0,0,0,268,A
8-NS,844,266,0,2,0,268,A
8-NS,845,266,0,1,0,267,A
8-NS,846,265,0,1,0,266,A
8-NS,847,260,0,3,0,263,A
8-NS,848,260,0,2,0,262,A
8-NS,849,0,0,0,259,259,C
8-NS,850,214,0,0,0,214,A
8-NS,851,0,0,0,212,212,C
8-NS,852,1,0,0,197,198,C
8-NS,853,1,0,0,187,188,C
8-NS,854,0,172,0,0,172,T
8-NS,855,0,165,0,0,165,T
8-NS,856,1,0,163,0,164,G
8-NS,857,0,159,0,0,159,T
8-NS,858,0,156,0,0,156,T
8-NS,859,0,149,0,0,149,T
8-NS,860,0,0,0,73,73,C
8-NS,861,0,46,0,0,46,T
8-NS,862,33,0,0,0,33,A
8-NS,863,0,0,0,33,33,C
