Gene,Position,A,T,G,C,Coverage,Consensus
1-PB2,1,272,0,0,0,272,A
1-PB2,2,0,273,0,0,273,T
1-PB2,3,0,0,277,0,277,G
1-PB2,4,0,2,279,0,281,G
1-PB2,5,282,0,0,0,282,A
1-PB2,6,278,0,1,0,279,A
1-PB2,7,282,0,0,0,282,A
1-PB2,8,0,0,312,0,312,G
1-PB2,9,314,0,0,0,314,A
1-PB2,10,316,0,0,0,316,A
1-PB2,11,0,325,0,1,326,T
1-PB2,12,327,0,0,0,327,A
1-PB2,13,328,0,0,0,328,A
1-PB2,14,329,0,0,0,329,A
1-PB2,15,328,0,1,0,329,A
1-PB2,16,0,0,345,0,345,G
1-PB2,17,343,0,0,0,343,A
1-PB2,18,345,0,0,0,345,A
1-PB2,19,0,0,0,348,348,C
1-PB2,20,0,348,0,0,348,T
1-PB2,21,353,0,0,0,353,A
1-PB2,22,1,0,0,351,352,C
1-PB2,23,0,1,354,0,355,G
1-PB2,24,0,0,360,0,360,G
1-PB2,25,360,0,0,0,360,A
1-PB2,26,365,0,0,0,365,A
1-PB2,27,0,368,0,0,368,T
1-PB2,28,1,0,0,371,372,C
1-PB2,29,0,373,0,0,373,T
1-PB2,30,0,0,374,0,374,G
1-PB2,31,381,0,0,0,381,A
1-PB2,32,0,381,0,0,381,T
1-PB2,33,0,0,379,1,380,G
1-PB2,34,0,389,0,0,389,T
1-PB2,35,2,0,0,386,388,C
1-PB2,36,0,0,389,0,389,G
1-PB2,37,1,0,0,386,387,C
1-PB2,38,384,1,1,1,387,A
1-PB2,39,0,1,406,0,407,G
1-PB2,40,0,409,0,0,409,T
1-PB2,41,1,0,0,410,411,C
1-PB2,42,0,410,0,0,410,T
1-PB2,43,0,1,1,409,411,C
1-PB2,44,0,0,412,0,412,G
1-PB2,45,1,0,0,410,411,C
1-PB2,46,412,0,1,0,413,A
1-PB2,47,2,0,0,419,421,C
1-PB2,48,0,420,0,0,420,T
1-PB2,49,4,0,0,428,432,C
1-PB2,50,0,0,433,0,433,G
1-PB2,51,0,3,0,432,435,C
1-PB2,52,0,3,433,0,436,G
1-PB2,53,439,0,0,0,439,A
1-PB2,54,0,0,441,0,441,G
1-PB2,55,459,0,0,0,459,A
1-PB2,56,0,461,0,0,461,T
1-PB2,57,459,0,1,0,460,A
1-PB2,58,0,0,0,457,457,C
1-PB2,59,0,448,0,0,448,T
1-PB2,60,0,1,460,0,461,G
1-PB2,61,462,0,0,0,462,A
1-PB2,62,0,0,0,463,463,C
1-PB2,63,463,0,0,0,463,A
1-PB2,64,462,0,0,0,462,A
1-PB2,65,472,0,0,0,472,A
1-PB2,66,489,0,0,0,489,A
1-PB2,67,491,0,0,0,491,A
1-PB2,68,0,0,0,499,499,C
1-PB2,69,4,0,0,495,499,C
1-PB2,70,510,0,0,0,510,A
1-PB2,71,0,0,0,516,516,C
1-PB2,72,513,0,0,0,513,A
1-PB2,73,0,1,525,0,526,G
1-PB2,74,0,529,1,0,530,T
1-PB2,75,0,4,537,0,541,G
1-PB2,76,0,7,535,0,542,G
1-PB2,77,540,0,0,0,540,A
1-PB2,78,0,0,0,568,568,C
1-PB2,79,3,0,0,562,565,C
1-PB2,80,569,0,1,0,570,A
1-PB2,81,1,573,0,1,575,T
1-PB2,82,565,0,0,0,565,A
1-PB2,83,0,565,0,0,565,T
1-PB2,84,0,2,563,0,565,G
1-PB2,85,1,1,564,0,566,G
1-PB2,86,1,0,0,566,567,C
1-PB2,87,1,0,0,563,564,C
1-PB2,88,561,0,1,0,562,A
1-PB2,89,0,610,0,0,610,T
1-PB2,90,606,0,0,0,606,A
1-PB2,91,644,0,2,0,646,A
1-PB2,92,0,642,0,0,642,T
1-PB2,93,0,645,0,0,645,T
1-PB2,94,655,0,0,0,655,A
1-PB2,95,653,0,0,1,654,A
1-PB2,96,0,1,678,0,679,G
1-PB2,97,676,0,1,0,677,A
1-PB2,98,669,0,1,0,670,A
1-PB2,99,3,1,694,0,698,G
1-PB2,100,0,695,0,0,695,T
1-PB2,101,693,0,0,0,693,A
1-PB2,102,1,1,0,693,695,C
1-PB2,103,701,0,1,0,702,A
1-PB2,104,0,1,0,723,724,C
1-PB2,105,725,0,0,0,725,A
1-PB2,106,0,727,0,0,727,T
1-PB2,107,0,0,0,727,727,C
1-PB2,108,2,10,709,0,721,G
1-PB2,109,0,1,723,0,724,G
1-PB2,110,0,3,718,0,721,G
1-PB2,111,0,3,718,0,721,G
1-PB2,112,719,0,0,0,719,A
1-PB2,113,0,0,727,0,727,G
1-PB2,114,725,1,0,0,726,A
1-PB2,115,0,1,0,730,731,C
1-PB2,116,731,0,0,0,731,A
1-PB2,117,0,1,742,0,743,G
1-PB2,118,0,4,751,0,755,G
1-PB2,119,759,0,0,0,759,A
1-PB2,120,759,0,0,0,759,A
1-PB2,121,758,0,0,0,758,A
1-PB2,122,752,0,2,0,754,A
1-PB2,123,0,4,753,0,757,G
1-PB2,124,753,0,1,0,754,A
1-PB2,125,759,0,0,0,759,A
1-PB2,126,0,0,0,753,753,C
1-PB2,127,3,0,0,748,751,C
1-PB2,128,4,2,0,746,752,C
1-PB2,129,1,0,757,0,758,G
1-PB2,130,0,756,0,0,756,T
1-PB2,131,3,1,0,758,762,C
1-PB2,132,769,0,0,0,769,A
1-PB2,133,0,0,0,773,773,C
1-PB2,134,1,767,0,1,769,T
1-PB2,135,0,772,0,0,772,T
1-PB2,136,769,0,0,0,769,A
1-PB2,137,0,0,780,0,780,G
1-PB2,138,0,2,784,0,786,G
1-PB2,139,780,0,1,0,781,A
1-PB2,140,0,782,0,0,782,T
1-PB2,141,0,2,794,0,796,G
1-PB2,142,803,0,1,0,804,A
1-PB2,143,798,0,1,0,799,A
1-PB2,144,804,0,1,0,805,A
1-PB2,145,0,803,0,0,803,T
1-PB2,146,0,5,794,0,799,G
1-PB2,147,0,1,804,0,805,G
1-PB2,148,803,0,1,0,804,A
1-PB2,149,1,801,0,0,802,T
1-PB2,150,0,2,799,0,801,G
1-PB2,151,786,0,1,0,787,A
1-PB2,152,0,790,0,0,790,T
1-PB2,153,0,1,789,1,791,G
1-PB2,154,0,1,792,0,793,G
1-PB2,155,0,1,0,792,793,C
1-PB2,156,788,0,0,1,789,A
1-PB2,157,793,0,1,0,794,A
1-PB2,158,1,795,0,1,797,T
1-PB2,159,0,1,827,0,828,G
1-PB2,160,823,1,0,0,824,A
1-PB2,161,822,0,0,0,822,A
1-PB2,162,830,0,0,0,830,A
1-PB2,163,0,841,0,0,841,T
1-PB2,164,844,0,0,1,845,A
1-PB2,165,1,2,0,857,860,C
1-PB2,166,5,0,1,848,854,C
1-PB2,167,4,0,0,855,859,C
1-PB2,168,860,0,0,0,860,A
1-PB2,169,865,0,0,0,865,A
1-PB2,170,0,863,0,0,863,T
1-PB2,171,5,2,0,858,865,C
1-PB2,172,861,0,0,0,861,A
1-PB2,173,0,0,0,879,879,C
1-PB2,174,1,875,0,0,876,T
1-PB2,175,1,0,875,0,876,G
1-PB2,176,1,0,0,872,873,C
1-PB2,177,0,871,0,2,873,T
1-PB2,178,0,4,877,0,881,G
1-PB2,179,884,0,0,0,884,A
1-PB2,180,0,1,0,888,889,C
1-PB2,181,888,1,0,0,889,A
1-PB2,182,875,0,0,0,875,A
1-PB2,183,874,0,0,0,874,A
1-PB2,184,874,0,2,1,877,A
1-PB2,185,2,3,888,0,893,G
1-PB2,186,0,4,889,0,893,G
1-PB2,187,888,0,0,0,888,A
1-PB2,188,0,889,0,0,889,T
1-PB2,189,879,0,0,0,879,A
1-PB2,190,881,0,1,0,882,A
1-PB2,191,1,0,0,892,893,C
1-PB2,192,893,0,0,0,893,A
1-PB2,193,0,0,896,0,896,G
1-PB2,194,883,0,0,0,883,A
1-PB2,195,883,1,0,0,884,A
1-PB2,196,883,0,0,0,883,A
1-PB2,197,0,885,0,1,886,T
1-PB2,198,1,7,882,0,890,G
1-PB2,199,0,1,911,0,912,G
1-PB2,200,0,904,0,0,904,T
1-PB2,201,0,898,0,0,898,T
1-PB2,202,1,0,0,889,890,C
1-PB2,203,2,0,0,891,893,C
1-PB2,204,893,0,0,0,893,A
1-PB2,205,0,3,895,0,898,G
1-PB2,206,895,1,0,0,896,A
1-PB2,207,0,1,900,0,901,G
1-PB2,208,894,0,1,0,895,A
1-PB2,209,1,2,914,0,917,G
1-PB2,210,916,0,0,0,916,A
1-PB2,211,913,0,1,0,914,A
1-PB2,212,915,0,0,1,916,A
1-PB2,213,0,916,0,0,916,T
1-PB2,214,0,5,921,0,926,G
1-PB2,215,921,0,0,0,921,A
1-PB2,216,926,0,1,0,927,A
1-PB2,217,0,0,0,920,920,C
1-PB2,218,915,0,0,0,915,A
1-PB2,219,920,1,0,0,921,A
1-PB2,220,0,2,926,0,928,G
1-PB2,221,1,3,939,0,943,G
1-PB2,222,944,0,0,0,944,A
1-PB2,223,1,0,0,940,941,C
1-PB2,224,941,0,0,0,941,A
1-PB2,225,939,0,3,0,942,A
1-PB2,226,987,0,1,0,988,A
1-PB2,227,0,0,0,1003,1003,C
1-PB2,228,0,988,0,0,988,T
1-PB2,229,0,0,0,1013,1013,C
1-PB2,230,0,996,0,1,997,T
1-PB2,231,1012,0,0,0,1012,A
1-PB2,232,0,1007,0,0,1007,T
1-PB2,233,0,6,1003,0,1009,G
1-PB2,234,0,5,1019,0,1024,G
1-PB2,235,997,0,2,0,999,A
1-PB2,236,0,0,1008,0,1008,G
1-PB2,237,0,1001,0,0,1001,T
1-PB2,238,998,0,1,0,999,A
1-PB2,239,1002,0,1,0,1003,A
1-PB2,240,997,1,0,0,998,A
1-PB2,241,1002,0,1,0,1003,A
1-PB2,242,1,991,0,0,992,T
1-PB2,243,0,2,991,0,993,G
1-PB2,244,979,0,1,1,981,A
1-PB2,245,0,3,982,0,985,G
1-PB2,246,0,972,0,0,972,T
1-PB2,247,0,2,972,1,975,G
1-PB2,248,993,0,0,0,993,A
1-PB2,249,0,996,0,1,997,T
1-PB2,250,0,1,993,0,994,G
1-PB2,251,0,0,0,996,996,C
1-PB2,252,1,987,0,0,988,T
1-PB2,253,0,2,1019,0,1021,G
1-PB2,254,0,2,1017,0,1019,G
1-PB2,255,1033,0,0,0,1033,A
1-PB2,256,0,1030,0,0,1030,T
1-PB2,257,2,0,0,1041,1043,C
1-PB2,258,1050,1,1,0,1052,A
1-PB2,259,0,2,1080,0,1082,G
1-PB2,260,1084,0,0,0,1084,A
1-PB2,261,0,1085,0,0,1085,T
1-PB2,262,1046,1,1,0,1048,A
1-PB2,263,0,3,1072,0,1075,G
1-PB2,264,1067,0,4,0,1071,A
1-PB2,265,0,0,1079,0,1079,G
1-PB2,266,0,1064,0,0,1064,T
1-PB2,267,1,1,1056,1,1059,G
1-PB2,268,1049,0,3,0,1052,A
1-PB2,269,0,1053,0,1,1054,T
1-PB2,270,0,3,1072,0,1075,G
1-PB2,271,0,3,1089,0,1092,G
1-PB2,272,0,1063,0,0,1063,T
1-PB2,273,1071,0,0,0,1071,A
1-PB2,274,0,1049,0,2,1051,T
1-PB2,275,1,0,0,1043,1044,C
1-PB2,276,1064,0,2,0,1066,A
1-PB2,277,1,0,0,1075,1076,C
1-PB2,278,3,0,0,1076,1079,C
1-PB2,279,0,1053,0,0,1053,T
1-PB2,280,0,1048,0,1,1049,T
1-PB2,281,0,1053,0,1,1054,T
1-PB2,282,0,8,1058,0,1066,G
1-PB2,283,0,0,1073,0,1073,G
1-PB2,284,0,0,0,1081,1081,C
1-PB2,285,0,1064,0,3,1067,T
1-PB2,286,0,0,1074,0,1074,G
1-PB2,287,0,1082,0,0,1082,T
1-PB2,288,1083,0,0,0,1083,A
1-PB2,289,1089,0,0,0,1089,A
1-PB2,290,0,0,0,1089,1089,C
1-PB2,291,1076,0,0,0,1076,A
1-PB2,292,0,1075,0,0,1075,T
1-PB2,293,0,1,1063,0,1064,G
1-PB2,294,1,0,1084,0,1085,G
1-PB2,295,0,1077,0,0,1077,T
1-PB2,296,0,8,1060,1,1069,G
1-PB2,297,0,3,1085,0,1088,G
1-PB2,298,1085,0,0,0,1085,A
1-PB2,299,1091,0,0,0,1091,A
1-PB2,300,0,1093,0,0,1093,T
1-PB2,301,1090,0,1,0,1091,A
1-PB2,302,0,1,1108,0,1109,G
1-PB2,303,1102,0,0,0,1102,A
1-PB2,304,1101,0,1,0,1102,A
1-PB2,305,1103,0,0,0,1103,A
1-PB2,306,1,1087,0,1,1089,T
1-PB2,307,1,5,1080,0,1086,G
1-PB2,308,0,3,1080,0,1083,G
1-PB2,309,1087,0,1,0,1088,A
1-PB2,310,2,0,0,1089,1091,C
1-PB2,311,6,1,0,1067,1074,C
1-PB2,312,7,0,0,1078,1085,C
1-PB2,313,2,0,1088,0,1090,G
1-PB2,314,0,1096,0,0,1096,T
1-PB2,315,0,4,1120,0,1124,G
1-PB2,316,1120,1,0,0,1121,A
1-PB2,317,1,0,0,1117,1118,C
1-PB2,318,1120,0,1,2,1123,A
1-PB2,319,1122,0,0,1,1123,A
1-PB2,320,0,1,1149,0,1150,G
1-PB2,321,1,1145,0,1,1147,T
1-PB2,322,1140,0,0,0,1140,A
1-PB2,323,1,0,0,1132,1133,C
1-PB2,324,0,8,1105,0,1113,G
1-PB2,325,0,0,1140,0,1140,G
1-PB2,326,0,1129,0,1,1130,T
1-PB2,327,7,1,0,1138,1146,C
1-PB2,328,7,0,0,1135,1142,C
1-PB2,329,1125,0,0,1,1126,A
1-PB2,330,0,1123,1,1,1125,T
1-PB2,331,0,1127,1,0,1128,T
1-PB2,332,1169,0,2,0,1171,A
1-PB2,333,4,0,0,1170,1174,C
1-PB2,334,6,0,0,1148,1154,C
1-PB2,335,3,0,0,1149,1152,C
1-PB2,336,1152,0,0,0,1152,A
1-PB2,337,1156,0,0,0,1156,A
1-PB2,338,1149,0,1,0,1150,A
1-PB2,339,1149,0,2,1,1152,A
1-PB2,340,0,0,1167,0,1167,G
1-PB2,341,0,1130,1,2,1133,T
1-PB2,342,0,1,1152,0,1153,G
1-PB2,343,0,1155,1,1,1157,T
1-PB2,344,1155,1,0,0,1156,A
1-PB2,345,1,0,0,1147,1148,C
1-PB2,346,1145,0,0,0,1145,A
1-PB2,347,1148,1,1,0,1150,A
1-PB2,348,0,4,1161,0,1165,G
1-PB2,349,1149,0,1,0,1150,A
1-PB2,350,1,0,0,1147,1148,C
1-PB2,351,0,1126,1,2,1129,T
1-PB2,352,0,1133,0,0,1133,T
1-PB2,353,1135,0,1,0,1136,A
1-PB2,354,0,1133,0,0,1133,T
1-PB2,355,0,1134,1,0,1135,T
1-PB2,356,0,1129,1,1,1131,T
1-PB2,357,3,0,0,1114,1117,C
1-PB2,358,1,6,1102,0,1109,G
1-PB2,359,1112,0,1,0,1113,A
1-PB2,360,1,2,0,1103,1106,C
1-PB2,361,1108,0,0,0,1108,A
1-PB2,362,1108,0,0,0,1108,A
1-PB2,363,1109,0,0,0,1109,A
1-PB2,364,0,0,1122,0,1122,G
1-PB2,365,1,1120,0,1,1122,T
1-PB2,366,1,1,0,1120,1122,C
1-PB2,367,0,1,1120,2,1123,G
1-PB2,368,1120,0,0,0,1120,A
1-PB2,369,1115,0,2,0,1117,A
1-PB2,370,1120,1,0,0,1121,A
1-PB2,371,0,2,1152,0,1154,G
1-PB2,372,1,0,1159,0,1160,G
1-PB2,373,0,1147,0,1,1148,T
1-PB2,374,1,1146,0,1,1148,T
1-PB2,375,1146,0,0,0,1146,A
1-PB2,376,1145,1,1,0,1147,A
1-PB2,377,1144,0,0,0,1144,A
1-PB2,378,1161,0,0,0,1161,A
1-PB2,379,1,1,0,1166,1168,C
1-PB2,380,1135,0,0,0,1135,A
1-PB2,381,0,1133,0,1,1134,T
1-PB2,382,0,3,1123,0,1126,G
1-PB2,383,0,1,1133,0,1134,G
1-PB2,384,1133,0,1,0,1134,A
1-PB2,385,1132,0,2,0,1134,A
1-PB2,386,3,0,0,1157,1160,C
1-PB2,387,3,0,0,1167,1170,C
1-PB2,388,0,1156,0,0,1156,T
1-PB2,389,0,1154,0,1,1155,T
1-PB2,390,1,1159,0,1,1161,T
1-PB2,391,1,2,1151,0,1154,G
1-PB2,392,0,2,1150,0,1152,G
1-PB2,393,0,2,1,1141,1144,C
1-PB2,394,4,0,0,1137,1141,C
1-PB2,395,4,1,0,1136,1141,C
1-PB2,396,0,1104,0,0,1104,T
1-PB2,397,0,0,1115,0,1115,G
1-PB2,398,0,1117,0,0,1117,T
1-PB2,399,1,1114,0,0,1115,T
1-PB2,400,2,0,0,1115,1117,C
1-PB2,401,1106,0,0,0,1106,A
1-PB2,402,0,1108,0,0,1108,T
1-PB2,403,0,1101,0,0,1101,T
1-PB2,404,0,1108,0,0,1108,T
1-PB2,405,0,1113,0,1,1114,T
1-PB2,406,1103,0,0,0,1103,A
1-PB2,407,0,2,1101,0,1103,G
1-PB2,408,1098,0,1,0,1099,A
1-PB2,409,1100,0,0,0,1100,A
1-PB2,410,1098,0,0,0,1098,A
1-PB2,411,0,1092,0,0,1092,T
1-PB2,412,5,0,1,1093,1099,C
1-PB2,413,1101,0,0,0,1101,A
1-PB2,414,1106,1,0,0,1107,A
1-PB2,415,0,0,1110,0,1110,G
1-PB2,416,0,1111,0,0,1111,T
1-PB2,417,3,0,0,1106,1109,C
1-PB2,418,1116,0,0,0,1116,A
1-PB2,419,1122,0,2,0,1124,A
1-PB2,420,1,3,1122,0,1126,G
1-PB2,421,1120,0,2,0,1122,A
1-PB2,422,0,1119,1,0,1120,T
1-PB2,423,1136,0,0,0,1136,A
1-PB2,424,0,0,0,1133,1133,C
1-PB2,425,0,2,1132,0,1134,G
1-PB2,426,1,1,0,1143,1145,C
1-PB2,427,1137,0,1,0,1138,A
1-PB2,428,0,1,1148,0,1149,G
1-PB2,429,1145,0,0,0,1145,A
1-PB2,430,1138,0,1,0,1139,A
1-PB2,431,0,5,1153,0,1158,G
1-PB2,432,1130,0,3,0,1133,A
1-PB2,433,1,3,1131,0,1135,G
1-PB2,434,0,1129,0,0,1129,T
1-PB2,435,1117,0,1,0,1118,A
1-PB2,436,0,1,1134,2,1137,G
1-PB2,437,1123,0,2,0,1125,A
1-PB2,438,0,0,0,1165,1165,C
1-PB2,439,1148,0,0,0,1148,A
1-PB2,440,0,1124,0,0,1124,T
1-PB2,441,1122,0,0,0,1122,A
1-PB2,442,1119,1,0,0,1120,A
1-PB2,443,1128,1,3,0,1132,A
1-PB2,444,2,0,0,1129,1131,C
1-PB2,445,6,0,1,1103,1110,C
1-PB2,446,1,0,0,1098,1099,C
1-PB2,447,0,1035,0,0,1035,T
1-PB2,448,1,2,1037,0,1040,G
1-PB2,449,0,2,1047,1,1050,G
1-PB2,450,0,1053,0,0,1053,T
1-PB2,451,3,0,0,1044,1047,C
1-PB2,452,1061,0,1,0,1062,A
1-PB2,453,0,1054,0,0,1054,T
1-PB2,454,1,1,1061,0,1063,G
1-PB2,455,5,0,0,1055,1060,C
1-PB2,456,1052,0,0,0,1052,A
1-PB2,457,1,1,1057,0,1059,G
1-PB2,458,1040,1,0,0,1041,A
1-PB2,459,0,0,0,1053,1053,C
1-PB2,460,3,0,1,1049,1053,C
1-PB2,461,1,1030,1,2,1034,T
1-PB2,462,4,2,0,1027,1033,C
1-PB2,463,1031,0,0,0,1031,A
1-PB2,464,2,0,1045,1,1048,G
1-PB2,465,0,1039,0,0,1039,T
1-PB2,466,1,0,1040,0,1041,G
1-PB2,467,0,1,0,1039,1040,C
1-PB2,468,2,0,0,1021,1023,C
1-PB2,469,1018,0,1,0,1019,A
1-PB2,470,1019,0,0,0,1019,A
1-PB2,471,1017,0,1,1,1019,A
1-PB2,472,0,2,1022,0,1024,G
1-PB2,473,994,0,1,0,995,A
1-PB2,474,0,4,1001,0,1005,G
1-PB2,475,0,0,1003,0,1003,G
1-PB2,476,0,0,0,1007,1007,C
1-PB2,477,1009,0,1,0,1010,A
1-PB2,478,1,0,0,1011,1012,C
1-PB2,479,1013,0,0,0,1013,A
1-PB2,480,1040,0,1,0,1041,A
1-PB2,481,0,2,1048,0,1050,G
1-PB2,482,1060,0,0,0,1060,A
1-PB2,483,0,1058,0,0,1058,T
1-PB2,484,0,0,1057,0,1057,G
1-PB2,485,0,1058,0,0,1058,T
1-PB2,486,1057,0,0,0,1057,A
1-PB2,487,1062,0,0,0,1062,A
1-PB2,488,0,1061,1,0,1062,T
1-PB2,489,1,1027,0,0,1028,T
1-PB2,490,1024,0,0,0,1024,A
1-PB2,491,0,994,0,0,994,T
1-PB2,492,0,2,990,1,993,G
1-PB2,493,0,1,992,0,993,G
1-PB2,494,997,0,0,0,997,A
1-PB2,495,995,0,0,0,995,A
1-PB2,496,0,0,994,1,995,G
1-PB2,497,0,990,0,0,990,T
1-PB2,498,0,984,0,0,984,T
1-PB2,499,0,0,991,0,991,G
1-PB2,500,1,987,0,0,988,T
1-PB2,501,0,981,0,1,982,T
1-PB2,502,0,983,0,0,983,T
1-PB2,503,0,980,0,1,981,T
1-PB2,504,0,986,0,0,986,T
1-PB2,505,1,1,0,978,980,C
1-PB2,506,1,2,1,975,979,C
1-PB2,507,4,0,1,981,986,C
1-PB2,508,984,0,0,0,984,A
1-PB2,509,981,0,2,0,983,A
1-PB2,510,0,986,0,0,986,T
1-PB2,511,0,2,985,0,987,G
1-PB2,512,985,0,0,0,985,A
1-PB2,513,986,0,0,0,986,A
1-PB2,514,0,0,1001,0,1001,G
1-PB2,515,0,999,0,0,999,T
1-PB2,516,0,3,989,0,992,G
1-PB2,517,1,8,981,0,990,G
1-PB2,518,0,4,986,0,990,G
1-PB2,519,990,0,2,0,992,A
1-PB2,520,0,0,991,0,991,G
1-PB2,521,0,0,0,992,992,C
1-PB2,522,2,1,0,996,999,C
1-PB2,523,999,0,1,0,1000,A
1-PB2,524,0,5,1025,0,1030,G
1-PB2,525,0,3,1028,0,1031,G
1-PB2,526,1034,0,0,0,1034,A
1-PB2,527,0,1027,0,1,1028,T
1-PB2,528,1032,0,0,0,1032,A
1-PB2,529,1,0,0,1033,1034,C
1-PB2,530,1,1021,0,2,1024,T
1-PB2,531,1020,1,1,0,1022,A
1-PB2,532,1013,0,0,0,1013,A
1-PB2,533,0,0,0,1017,1017,C
1-PB2,534,986,0,0,0,986,A
1-PB2,535,0,973,0,1,974,T
1-PB2,536,2,0,0,974,976,C
1-PB2,537,962,0,2,0,964,A
1-PB2,538,0,5,965,0,970,G
1-PB2,539,971,0,0,0,971,A
1-PB2,540,966,0,0,0,966,A
1-PB2,541,0,962,0,2,964,T
1-PB2,542,2,0,1,945,948,C
1-PB2,543,946,0,1,0,947,A
1-PB2,544,0,0,0,958,958,C
1-PB2,545,956,1,0,0,957,A
1-PB2,546,969,0,0,0,969,A
1-PB2,547,0,959,1,0,960,T
1-PB2,548,0,963,0,0,963,T
1-PB2,549,965,0,0,0,965,A
1-PB2,550,971,0,1,0,972,A
1-PB2,551,3,1,0,973,977,C
1-PB2,552,975,0,0,0,975,A
1-PB2,553,967,0,0,0,967,A
1-PB2,554,0,976,0,1,977,T
1-PB2,555,968,0,0,0,968,A
1-PB2,556,969,0,1,0,970,A
1-PB2,557,1,0,0,971,972,C
1-PB2,558,0,967,0,1,968,T
1-PB2,559,968,1,0,0,969,A
1-PB2,560,959,0,2,0,961,A
1-PB2,561,962,0,1,0,963,A
1-PB2,562,0,3,959,0,962,G
1-PB2,563,939,0,0,0,939,A
1-PB2,564,0,2,946,0,948,G
1-PB2,565,943,1,1,0,945,A
1-PB2,566,944,0,0,0,944,A
1-PB2,567,946,0,2,0,948,A
1-PB2,568,947,0,0,0,947,A
1-PB2,569,951,0,1,0,952,A
1-PB2,570,950,0,2,0,952,A
1-PB2,571,0,1,956,0,957,G
1-PB2,572,956,0,0,0,956,A
1-PB2,573,943,0,0,0,943,A
1-PB2,574,0,4,947,0,951,G
1-PB2,575,948,0,1,0,949,A
1-PB2,576,952,0,0,0,952,A
1-PB2,577,0,1,0,957,958,C
1-PB2,578,0,944,0,0,944,T
1-PB2,579,2,0,1,948,951,C
1-PB2,580,3,0,0,950,953,C
1-PB2,581,0,5,946,0,951,G
1-PB2,582,949,0,3,0,952,A
1-PB2,583,0,2,954,0,956,G
1-PB2,584,949,1,0,0,950,A
1-PB2,585,0,922,0,26,948,T
1-PB2,586,0,934,0,1,935,T
1-PB2,587,0,0,932,0,932,G
1-PB2,588,0,0,0,934,934,C
1-PB2,589,935,0,1,0,936,A
1-PB2,590,939,0,0,0,939,A
1-PB2,591,940,0,0,0,940,A
1-PB2,592,951,0,0,0,951,A
1-PB2,593,0,947,0,0,947,T
1-PB2,594,0,945,0,0,945,T
1-PB2,595,1,943,0,0,944,T
1-PB2,596,5,0,0,934,939,C
1-PB2,597,0,938,0,1,939,T
1-PB2,598,2,1,0,1002,1005,C
1-PB2,599,2,1,0,999,1002,C
1-PB2,600,5,0,0,1087,1092,C
1-PB2,601,1,1081,0,0,1082,T
1-PB2,602,1,1097,0,1,1099,T
1-PB2,603,0,2,1101,0,1103,G
1-PB2,604,1109,0,1,0,1110,A
1-PB2,605,0,1132,0,0,1132,T
1-PB2,606,0,8,1147,0,1155,G
1-PB2,607,1,0,1278,0,1279,G
1-PB2,608,0,1319,0,0,1319,T
1-PB2,609,0,1315,0,1,1316,T
1-PB2,610,0,1,1422,0,1423,G
1-PB2,611,0,0,0,1439,1439,C
1-PB2,612,1464,1,1,0,1466,A
1-PB2,613,0,1469,0,1,1470,T
1-PB2,614,1472,0,0,1,1473,A
1-PB2,615,2,0,0,1549,1551,C
1-PB2,616,1745,0,0,3,1748,A
1-PB2,617,0,1791,0,0,1791,T
1-PB2,618,2,1,1896,0,1899,G
1-PB2,619,0,1879,0,0,1879,T
1-PB2,620,0,1878,0,0,1878,T
1-PB2,621,1875,1,1,1,1878,A
1-PB2,622,1,7,1876,0,1884,G
1-PB2,623,1913,0,1,0,1914,A
1-PB2,624,1,7,1929,0,1937,G
1-PB2,625,1873,0,1,0,1874,A
1-PB2,626,1,5,1885,1,1892,G
1-PB2,627,1862,1,4,0,1867,A
1-PB2,628,0,10,1866,0,1876,G
1-PB2,629,1891,0,2,1,1894,A
1-PB2,630,1899,0,0,0,1899,A
1-PB2,631,1,0,0,1902,1903,C
1-PB2,632,0,1894,0,0,1894,T
1-PB2,633,0,1889,0,0,1889,T
1-PB2,634,1,1,1891,0,1893,G
1-PB2,635,1,1888,0,0,1889,T
1-PB2,636,1890,0,2,0,1892,A
1-PB2,637,2,2,0,1879,1883,C
1-PB2,638,0,10,1863,0,1873,G
1-PB2,639,1879,1,1,0,1881,A
1-PB2,640,1882,0,0,0,1882,A
1-PB2,641,1903,0,1,0,1904,A
1-PB2,642,1898,0,0,1,1899,A
1-PB2,643,1902,0,1,0,1903,A
1-PB2,644,3,3,0,1905,1911,C
1-PB2,645,1911,0,0,0,1911,A
1-PB2,646,1911,0,1,1,1913,A
1-PB2,647,0,4,1922,0,1926,G
1-PB2,648,1929,0,0,1,1930,A
1-PB2,649,0,1932,0,4,1936,T
1-PB2,650,0,1931,0,1,1932,T
1-PB2,651,0,1941,0,0,1941,T
1-PB2,652,2,2,0,1948,1952,C
1-PB2,653,0,1946,1,4,1951,T
1-PB2,654,8,0,0,1953,1961,C
1-PB2,655,8,0,0,1948,1956,C
1-PB2,656,7,0,0,1955,1962,C
1-PB2,657,1967,0,1,0,1968,A
1-PB2,658,0,3,1980,1,1984,G
1-PB2,659,0,1979,0,0,1979,T
1-PB2,660,0,1975,0,0,1975,T
1-PB2,661,2,1,1973,0,1976,G
1-PB2,662,0,1,0,1976,1977,C
1-PB2,663,0,1973,1,1,1975,T
1-PB2,664,2,7,1971,0,1980,G
1-PB2,665,0,2,1966,0,1968,G
1-PB2,666,3,5,0,1967,1975,C
1-PB2,667,2,9,1978,0,1989,G
1-PB2,668,0,5,2007,0,2012,G
1-PB2,669,2026,0,1,1,2028,A
1-PB2,670,2020,0,2,0,2022,A
1-PB2,671,1,0,0,2028,2029,C
1-PB2,672,2044,0,0,0,2044,A
1-PB2,673,2034,1,2,0,2037,A
1-PB2,674,0,0,2121,0,2121,G
1-PB2,675,1,0,0,2178,2179,C
1-PB2,676,2188,0,1,1,2190,A
1-PB2,677,0,2,2685,0,2687,G
1-PB2,678,2,2683,0,1,2686,T
1-PB2,679,2701,0,1,0,2702,A
1-PB2,680,0,2696,0,2,2698,T
1-PB2,681,2712,1,1,0,2714,A
1-PB2,682,0,2723,0,0,2723,T
1-PB2,683,2684,0,0,0,2684,A
1-PB2,684,3,2,0,2702,2707,C
1-PB2,685,2599,0,0,0,2599,A
1-PB2,686,2,2488,1,0,2491,T
1-PB2,687,0,2408,0,1,2409,T
1-PB2,688,2,7,2396,0,2405,G
1-PB2,689,2409,0,2,0,2411,A
1-PB2,690,2385,1,1,0,2387,A
1-PB2,691,0,1,2425,0,2426,G
1-PB2,692,0,2417,2,0,2419,T
1-PB2,693,0,2396,0,1,2397,T
1-PB2,694,0,2401,0,2,2403,T
1-PB2,695,0,2405,1,1,2407,T
1-PB2,696,2427,0,2,0,2429,A
1-PB2,697,2,0,0,2439,2441,C
1-PB2,698,2434,0,1,0,2435,A
1-PB2,699,0,2429,0,1,2430,T
1-PB2,700,0,2410,0,2,2412,T
1-PB2,701,2,2422,0,0,2424,T
1-PB2,702,2,8,2444,0,2454,G
1-PB2,703,2462,0,3,0,2465,A
1-PB2,704,1,0,0,2482,2483,C
1-PB2,705,0,2459,0,2,2461,T
1-PB2,706,9,1,0,2451,2461,C
1-PB2,707,2449,0,2,1,2452,A
1-PB2,708,1,15,2416,4,2436,G
1-PB2,709,0,9,2493,0,2502,G
1-PB2,710,0,7,2501,0,2508,G
1-PB2,711,2509,4,2,0,2515,A
1-PB2,712,2513,0,2,0,2515,A
1-PB2,713,0,3,0,2508,2511,C
1-PB2,714,1,3,2529,0,2533,G
1-PB2,715,0,2541,0,0,2541,T
1-PB2,716,1,1,2556,0,2558,G
1-PB2,717,1,2538,0,0,2539,T
1-PB2,718,0,2540,0,1,2541,T
1-PB2,719,1,9,2540,2,2552,G
1-PB2,720,0,11,2529,1,2541,G
1-PB2,721,0,5,2560,2,2567,G
1-PB2,722,2549,1,2,0,2552,A
1-PB2,723,2529,0,5,1,2535,A
1-PB2,724,3,0,0,2599,2602,C
1-PB2,725,2596,0,0,0,2596,A
1-PB2,726,2679,1,0,0,2680,A
1-PB2,727,2688,0,0,1,2689,A
1-PB2,728,0,2723,0,2,2725,T
1-PB2,729,1,1,2771,0,2773,G
1-PB2,730,0,2757,0,3,2760,T
1-PB2,731,2769,1,2,0,2772,A
1-PB2,732,3,3,0,2770,2776,C
1-PB2,733,2739,1,0,0,2740,A
1-PB2,734,1,0,0,2733,2734,C
1-PB2,735,1,2650,0,2,2653,T
1-PB2,736,10,0,0,2906,2916,C
1-PB2,737,6,1,5,2913,2925,C
1-PB2,738,2971,0,4,0,2975,A
1-PB2,739,1,6,2990,0,2997,G
1-PB2,740,0,2,3052,0,3054,G
1-PB2,741,0,3054,0,0,3054,T
1-PB2,742,2,11,3041,0,3054,G
1-PB2,743,0,17,2972,0,2989,G
1-PB2,744,2948,0,5,1,2954,A
1-PB2,745,2,17,2953,2,2974,G
1-PB2,746,1,18,2962,0,2981,G
1-PB2,747,2930,1,0,1,2932,A
1-PB2,748,1,2,2960,0,2963,G
1-PB2,749,0,2899,0,2,2901,T
1-PB2,750,0,11,2905,0,2916,G
1-PB2,751,2914,3,5,0,2922,A
1-PB2,752,1,14,2914,0,2929,G
1-PB2,753,3,11,2924,0,2938,G
1-PB2,754,2918,0,0,0,2918,A
1-PB2,755,2919,0,1,0,2920,A
1-PB2,756,1,2914,1,0,2916,T
1-PB2,757,1,11,2881,0,2893,G
1-PB2,758,2892,0,2,1,2895,A
1-PB2,759,3,1,1,2873,2878,C
1-PB2,760,4,2,2868,0,2874,G
1-PB2,761,2904,1,0,0,2905,A
1-PB2,762,0,2884,0,1,2885,T
1-PB2,763,2,2,2907,0,2911,G
1-PB2,764,1,2901,0,3,2905,T
1-PB2,765,1,2880,0,1,2882,T
1-PB2,766,1,11,2883,1,2896,G
1-PB2,767,2903,0,3,1,2907,A
1-PB2,768,2,0,0,2899,2901,C
1-PB2,769,12,1,1,2883,2897,C
1-PB2,770,2874,0,0,0,2874,A
1-PB2,771,2875,0,1,0,2876,A
1-PB2,772,2893,0,1,0,2894,A
1-PB2,773,0,0,2952,0,2952,G
1-PB2,774,1,0,0,2948,2949,C
1-PB2,775,10,0,0,2931,2941,C
1-PB2,776,1,2964,0,1,2966,T
1-PB2,777,2973,0,1,0,2974,A
1-PB2,778,2975,0,1,0,2976,A
1-PB2,779,1,2978,0,0,2979,T
1-PB2,780,0,2965,1,0,2966,T
1-PB2,781,2947,0,0,0,2947,A
1-PB2,782,0,2888,0,1,2889,T
1-PB2,783,0,2867,0,2,2869,T
1-PB2,784,1,6,2845,0,2852,G
1-PB2,785,2,1,0,2857,2860,C
1-PB2,786,2,11,2838,0,2851,G
1-PB2,787,0,1,2894,0,2895,G
1-PB2,788,1,0,0,2894,2895,C
1-PB2,789,6,2,0,2890,2898,C
1-PB2,790,2903,0,2,1,2906,A
1-PB2,791,1,5,2943,0,2949,G
1-PB2,792,5,7,2955,0,2967,G
1-PB2,793,2969,0,4,0,2973,A
1-PB2,794,2984,0,3,0,2987,A
1-PB2,795,3,0,0,2998,3001,C
1-PB2,796,2952,1,5,0,2958,A
1-PB2,797,0,3001,0,0,3001,T
1-PB2,798,3043,0,2,0,3045,A
1-PB2,799,2,2,3078,2,3084,G
1-PB2,800,1,3037,0,2,3040,T
1-PB2,801,3035,0,1,0,3036,A
1-PB2,802,3030,0,1,1,3032,A
1-PB2,803,0,7,3029,0,3036,G
1-PB2,804,3016,0,1,0,3017,A
1-PB2,805,2971,0,3,0,2974,A
1-PB2,806,0,4,2968,1,2973,G
1-PB2,807,2898,0,0,0,2898,A
1-PB2,808,0,1,2910,0,2911,G
1-PB2,809,1,0,0,2911,2912,C
1-PB2,810,12,2,0,2888,2902,C
1-PB2,811,3,2,2917,0,2922,G
1-PB2,812,1,0,0,2938,2939,C
1-PB2,813,2946,0,2,0,2948,A
1-PB2,814,0,3,3132,1,3136,G
1-PB2,815,0,3129,0,1,3130,T
1-PB2,816,3138,0,0,0,3138,A
1-PB2,817,0,3119,0,1,3120,T
1-PB2,818,17,1,0,3113,3131,C
1-PB2,819,3124,0,4,1,3129,A
1-PB2,820,0,1,3129,0,3130,G
1-PB2,821,5,0,0,3126,3131,C
1-PB2,822,3027,3,3,0,3033,A
1-PB2,823,0,5,2997,0,3002,G
1-PB2,824,3005,0,1,0,3006,A
1-PB2,825,1,3001,0,2,3004,T
1-PB2,826,12,0,0,2997,3009,C
1-PB2,827,10,1,0,3005,3016,C
1-PB2,828,3021,2,1,0,3024,A
1-PB2,829,4,1,0,3025,3030,C
1-PB2,830,1,3019,0,2,3022,T
1-PB2,831,3028,0,3,0,3031,A
1-PB2,832,0,0,3026,0,3026,G
1-PB2,833,0,0,0,3004,3004,C
1-PB2,834,3000,1,0,0,3001,A
1-PB2,835,0,3004,0,1,3005,T
1-PB2,836,5,1,1,3021,3028,C
1-PB2,837,0,3016,0,1,3017,T
1-PB2,838,0,3080,0,1,3081,T
1-PB2,839,1,3092,1,1,3095,T
1-PB2,840,3087,0,0,0,3087,A
1-PB2,841,0,3096,0,1,3097,T
1-PB2,842,0,3076,0,5,3081,T
1-PB2,843,3,8,3062,1,3074,G
1-PB2,844,0,6,3074,0,3080,G
1-PB2,845,3048,0,1,0,3049,A
1-PB2,846,1,3,3041,0,3045,G
1-PB2,847,3005,0,0,0,3005,A
1-PB2,848,0,2984,0,3,2987,T
1-PB2,849,0,3,3040,0,3043,G
1-PB2,850,0,3036,0,3,3039,T
1-PB2,851,2,4,3032,0,3038,G
1-PB2,852,2,0,0,3035,3037,C
1-PB2,853,12,4,1,3014,3031,C
1-PB2,854,3030,1,2,2,3035,A
1-PB2,855,1,1,0,3030,3032,C
1-PB2,856,2993,0,4,0,2997,A
1-PB2,857,2,2,3033,0,3037,G
1-PB2,858,0,1,0,2966,2967,C
1-PB2,859,2960,0,2,0,2962,A
1-PB2,860,0,0,0,2960,2960,C
1-PB2,861,2952,0,3,0,2955,A
1-PB2,862,1,1,1,2972,2975,C
1-PB2,863,2960,0,2,0,2962,A
1-PB2,864,2958,0,1,0,2959,A
1-PB2,865,2961,0,0,0,2961,A
1-PB2,866,0,2884,0,2,2886,T
1-PB2,867,1,2883,1,0,2885,T
1-PB2,868,1,10,2866,0,2877,G
1-PB2,869,3,6,2865,0,2874,G
1-PB2,870,0,1,0,2864,2865,C
1-PB2,871,0,8,2850,0,2858,G
1-PB2,872,2,9,2905,1,2917,G
1-PB2,873,2,8,2923,0,2933,G
1-PB2,874,2931,1,3,0,2935,A
1-PB2,875,3,0,0,2920,2923,C
1-PB2,876,2939,1,2,0,2942,A
1-PB2,877,2940,0,3,1,2944,A
1-PB2,878,0,3,2960,1,2964,G
1-PB2,879,3,3,2956,3,2965,G
1-PB2,880,2980,1,0,0,2981,A
1-PB2,881,2,2863,0,0,2865,T
1-PB2,882,1,11,2809,2,2823,G
1-PB2,883,1,4,2843,1,2849,G
1-PB2,884,1,2819,0,1,2821,T
1-PB2,885,1,0,2809,0,2810,G
1-PB2,886,4,4,2805,1,2814,G
1-PB2,887,2761,1,3,0,2765,A
1-PB2,888,1,1,0,2758,2760,C
1-PB2,889,2727,0,1,0,2728,A
1-PB2,890,0,3077,0,0,3077,T
1-PB2,891,1,3075,0,2,3078,T
1-PB2,892,7,1,0,3060,3068,C
1-PB2,893,0,3060,0,2,3062,T
1-PB2,894,0,3050,0,3,3053,T
1-PB2,895,3057,1,0,0,3058,A
1-PB2,896,1,3,3066,0,3070,G
1-PB2,897,3057,0,5,0,3062,A
1-PB2,898,3,1,0,3056,3060,C
1-PB2,899,2553,0,4,0,2557,A
1-PB2,900,1,3,2594,0,2598,G
1-PB2,901,2590,0,1,0,2591,A
1-PB2,902,2605,1,1,0,2607,A
1-PB2,903,1,3,0,2593,2597,C
1-PB2,904,16,2,0,2575,2593,C
1-PB2,905,16,1,0,2576,2593,C
1-PB2,906,105,11,2480,0,2596,G
1-PB2,907,2599,1,1,0,2601,A
1-PB2,908,2,0,0,2606,2608,C
1-PB2,909,1,2578,0,2,2581,T
1-PB2,910,0,1,2603,0,2604,G
1-PB2,911,2580,1,3,0,2584,A
1-PB2,912,2586,2,3,2,2593,A
1-PB2,913,1,6,2595,0,2602,G
1-PB2,914,2595,1,1,0,2597,A
1-PB2,915,2590,0,2,0,2592,A
1-PB2,916,0,0,0,2599,2599,C
1-PB2,917,2584,0,2,0,2586,A
1-PB2,918,2602,0,1,0,2603,A
1-PB2,919,0,1,2628,0,2629,G
1-PB2,920,1,1,0,2642,2644,C
1-PB2,921,0,2623,1,1,2625,T
1-PB2,922,0,4,2656,1,2661,G
1-PB2,923,0,2653,0,1,2654,T
1-PB2,924,0,8,2679,1,2688,G
1-PB2,925,1,5,2784,0,2790,G
1-PB2,926,2787,2,4,0,2793,A
1-PB2,927,0,2773,0,0,2773,T
1-PB2,928,2749,1,1,0,2751,A
1-PB2,929,0,2717,1,0,2718,T
1-PB2,930,2820,0,0,0,2820,A
1-PB2,931,0,2764,0,1,2765,T
1-PB2,932,1,1,2751,0,2753,G
1-PB2,933,0,0,0,2717,2717,C
1-PB2,934,2615,0,2,0,2617,A
1-PB2,935,2619,0,2,0,2621,A
1-PB2,936,0,5,2610,1,2616,G
1-PB2,937,0,1,2628,0,2629,G
1-PB2,938,1,0,0,2629,2630,C
1-PB2,939,0,2572,0,1,2573,T
1-PB2,940,0,1,2579,0,2580,G
1-PB2,941,1,1,0,2574,2576,C
1-PB2,942,2579,0,2,0,2581,A
1-PB2,943,2587,0,1,0,2588,A
1-PB2,944,1,2574,0,0,2575,T
1-PB2,945,0,11,2568,0,2579,G
1-PB2,946,0,6,2558,0,2564,G
1-PB2,947,2,8,2555,0,2565,G
1-PB2,948,2565,1,3,0,2569,A
1-PB2,949,0,2551,0,1,2552,T
1-PB2,950,0,2526,0,0,2526,T
1-PB2,951,0,6,2530,0,2536,G
1-PB2,952,2520,1,4,1,2526,A
1-PB2,953,1,3,2545,0,2549,G
1-PB2,954,2519,0,2,0,2521,A
1-PB2,955,2505,0,0,0,2505,A
1-PB2,956,0,2486,0,2,2488,T
1-PB2,957,3,0,0,2491,2494,C
1-PB2,958,2481,0,3,0,2484,A
1-PB2,959,1,4,2496,0,2501,G
1-PB2,960,2,0,0,2486,2488,C
1-PB2,961,0,2478,1,2,2481,T
1-PB2,962,11,1,0,2471,2483,C
1-PB2,963,2481,0,3,0,2484,A
1-PB2,964,0,2531,0,1,2532,T
1-PB2,965,9,0,0,2530,2539,C
1-PB2,966,9,1,0,2548,2558,C
1-PB2,967,1,2547,0,4,2552,T
1-PB2,968,2,2530,0,4,2536,T
1-PB2,969,3,3,0,2541,2547,C
1-PB2,970,2545,0,2,0,2547,A
1-PB2,971,1,2,2595,0,2598,G
1-PB2,972,0,1,0,2587,2588,C
1-PB2,973,0,2545,0,5,2550,T
1-PB2,974,0,2560,0,1,2561,T
1-PB2,975,0,2540,1,0,2541,T
1-PB2,976,2,15,2527,1,2545,G
1-PB2,977,1,1,2546,0,2548,G
1-PB2,978,0,2546,0,1,2547,T
1-PB2,979,2,19,2534,0,2555,G
1-PB2,980,1,8,2535,0,2544,G
1-PB2,981,1,4,2552,1,2558,G
1-PB2,982,1,2544,1,2,2548,T
1-PB2,983,2,2528,0,4,2534,T
1-PB2,984,0,2539,0,0,2539,T
1-PB2,985,2545,1,1,0,2547,A
1-PB2,986,2,1,0,2544,2547,C
1-PB2,987,2544,0,2,0,2546,A
1-PB2,988,0,2541,0,0,2541,T
1-PB2,989,0,2475,0,0,2475,T
1-PB2,990,0,2490,0,0,2490,T
1-PB2,991,2483,0,1,0,2484,A
1-PB2,992,2484,0,0,0,2484,A
1-PB2,993,2491,0,0,0,2491,A
1-PB2,994,2482,0,3,0,2485,A
1-PB2,995,1,8,2501,1,2511,G
1-PB2,996,2497,0,1,0,2498,A
1-PB2,997,2498,2,1,0,2501,A
1-PB2,998,1,3,0,2498,2502,C
1-PB2,999,2496,0,0,0,2496,A
1-PB2,1000,2503,0,2,1,2506,A
1-PB2,1001,0,0,2507,0,2507,G
1-PB2,1002,2,3,0,2499,2504,C
1-PB2,1003,1,17,2486,0,2504,G
1-PB2,1004,3,9,2503,0,2515,G
1-PB2,1005,3,6,2515,0,2524,G
1-PB2,1006,0,2511,0,4,2515,T
1-PB2,1007,8,0,0,2494,2502,C
1-PB2,1008,2519,0,0,0,2519,A
1-PB2,1009,0,2514,0,1,2515,T
1-PB2,1010,2,1,0,2508,2511,C
1-PB2,1011,2502,0,0,0,2502,A
1-PB2,1012,2,3,2519,0,2524,G
1-PB2,1013,0,2500,0,0,2500,T
1-PB2,1014,10,2,0,2486,2498,C
1-PB2,1015,2508,0,2,0,2510,A
1-PB2,1016,2515,0,0,0,2515,A
1-PB2,1017,2513,0,1,1,2515,A
1-PB2,1018,2512,0,1,0,2513,A
1-PB2,1019,2529,0,0,0,2529,A
1-PB2,1020,2520,0,4,0,2524,A
1-PB2,1021,0,8,2521,0,2529,G
1-PB2,1022,2518,1,0,0,2519,A
1-PB2,1023,2510,0,2,0,2512,A
1-PB2,1024,0,0,2514,1,2515,G
1-PB2,1025,2506,0,1,1,2508,A
1-PB2,1026,2441,0,5,0,2446,A
1-PB2,1027,2,4,2438,0,2444,G
1-PB2,1028,2439,0,2,0,2441,A
1-PB2,1029,10,7,2424,0,2441,G
1-PB2,1030,0,1,2493,0,2494,G
1-PB2,1031,0,2485,0,2,2487,T
1-PB2,1032,2,1,2528,0,2531,G
1-PB2,1033,0,3,1,2542,2546,C
1-PB2,1034,0,2547,0,3,2550,T
1-PB2,1035,0,2559,0,1,2560,T
1-PB2,1036,2552,0,1,0,2553,A
1-PB2,1037,4,1,0,2550,2555,C
1-PB2,1038,2535,1,3,0,2539,A
1-PB2,1039,0,11,2532,0,2543,G
1-PB2,1040,0,2,2535,0,2537,G
1-PB2,1041,1,1,0,2493,2495,C
1-PB2,1042,2464,1,0,0,2465,A
1-PB2,1043,2491,0,0,0,2491,A
1-PB2,1044,0,2519,0,5,2524,T
1-PB2,1045,11,0,0,2531,2542,C
1-PB2,1046,1,2525,0,3,2529,T
1-PB2,1047,13,1,1,2520,2535,C
1-PB2,1048,5,0,0,2525,2530,C
1-PB2,1049,2536,0,0,0,2536,A
1-PB2,1050,2530,0,1,0,2531,A
1-PB2,1051,2531,2,0,0,2533,A
1-PB2,1052,1,1,0,2538,2540,C
1-PB2,1053,2467,0,3,0,2470,A
1-PB2,1054,0,2443,0,1,2444,T
1-PB2,1055,0,2449,0,0,2449,T
1-PB2,1056,0,4,2477,0,2481,G
1-PB2,1057,2472,0,3,0,2475,A
1-PB2,1058,2491,0,0,0,2491,A
1-PB2,1059,2496,0,0,0,2496,A
1-PB2,1060,2498,0,1,0,2499,A
1-PB2,1061,0,2513,0,0,2513,T
1-PB2,1062,2507,1,2,0,2510,A
1-PB2,1063,2499,1,5,0,2505,A
1-PB2,1064,0,12,2533,0,2545,G
1-PB2,1065,2508,0,2,1,2511,A
1-PB2,1066,1,0,2597,0,2598,G
1-PB2,1067,0,2570,0,3,2573,T
1-PB2,1068,2708,1,0,0,2709,A
1-PB2,1069,2,0,0,2795,2797,C
1-PB2,1070,2776,1,2,0,2779,A
1-PB2,1071,1,2768,0,0,2769,T
1-PB2,1072,332,7,2424,0,2763,G
1-PB2,1073,2722,1,6,0,2729,A
1-PB2,1074,1,7,2732,0,2740,G
1-PB2,1075,0,10,2737,0,2747,G
1-PB2,1076,2,13,2813,0,2828,G
1-PB2,1077,4,6,2741,1,2752,G
1-PB2,1078,0,2638,0,0,2638,T
1-PB2,1079,2652,0,1,0,2653,A
1-PB2,1080,1,2640,0,0,2641,T
1-PB2,1081,2,10,2645,0,2657,G
1-PB2,1082,2641,0,3,1,2645,A
1-PB2,1083,1,9,2634,0,2644,G
1-PB2,1084,1,9,2614,0,2624,G
1-PB2,1085,2437,0,2,2,2441,A
1-PB2,1086,1,0,2525,0,2526,G
1-PB2,1087,0,2502,0,4,2506,T
1-PB2,1088,0,2582,0,4,2586,T
1-PB2,1089,13,0,0,2575,2588,C
1-PB2,1090,2590,2,6,0,2598,A
1-PB2,1091,1,0,0,2601,2602,C
1-PB2,1092,2585,1,0,1,2587,A
1-PB2,1093,2593,0,0,0,2593,A
1-PB2,1094,0,2582,0,1,2583,T
1-PB2,1095,5,7,2543,2,2557,G
1-PB2,1096,0,3,2575,1,2579,G
1-PB2,1097,1,2502,0,6,2509,T
1-PB2,1098,1,16,2482,0,2499,G
1-PB2,1099,1,9,2507,0,2517,G
1-PB2,1100,2,8,2505,1,2516,G
1-PB2,1101,0,4,2542,0,2546,G
1-PB2,1102,2534,0,1,0,2535,A
1-PB2,1103,2536,0,0,0,2536,A
1-PB2,1104,2525,1,2,0,2528,A
1-PB2,1105,2481,0,10,0,2491,A
1-PB2,1106,2,8,2521,1,2532,G
1-PB2,1107,2523,0,1,0,2524,A
1-PB2,1108,0,0,2538,0,2538,G
1-PB2,1109,0,5,1,2526,2532,C
1-PB2,1110,2519,1,1,0,2521,A
1-PB2,1111,2523,1,7,0,2531,A
1-PB2,1112,3,1,0,2602,2606,C
1-PB2,1113,2590,1,5,1,2597,A
1-PB2,1114,1,2,2633,0,2636,G
1-PB2,1115,0,0,0,2615,2615,C
1-PB2,1116,0,2610,0,2,2612,T
1-PB2,1117,2697,0,0,1,2698,A
1-PB2,1118,1,2690,0,0,2691,T
1-PB2,1119,2707,0,0,2,2709,A
1-PB2,1120,1,1,0,2702,2704,C
1-PB2,1121,0,2573,0,0,2573,T
1-PB2,1122,2579,0,1,0,2580,A
1-PB2,1123,2532,2,3,0,2537,A
1-PB2,1124,0,9,2533,0,2542,G
1-PB2,1125,2536,1,0,0,2537,A
1-PB2,1126,2465,0,1,1,2467,A
1-PB2,1127,2465,0,1,0,2466,A
1-PB2,1128,2451,0,7,0,2458,A
1-PB2,1129,0,1,2465,0,2466,G
1-PB2,1130,1,1,0,2462,2464,C
1-PB2,1131,2455,0,1,0,2456,A
1-PB2,1132,2462,0,1,0,2463,A
1-PB2,1133,2,0,0,2463,2465,C
1-PB2,1134,15,0,1,2451,2467,C
1-PB2,1135,2462,1,1,1,2465,A
1-PB2,1136,0,5,2479,0,2484,G
1-PB2,1137,2481,1,0,0,2482,A
1-PB2,1138,2476,0,1,1,2478,A
1-PB2,1139,0,6,2489,0,2495,G
1-PB2,1140,2490,0,2,0,2492,A
1-PB2,1141,0,2478,1,1,2480,T
1-PB2,1142,0,2459,0,2,2461,T
1-PB2,1143,1,13,2463,0,2477,G
1-PB2,1144,2,0,2502,1,2505,G
1-PB2,1145,0,2502,0,1,2503,T
1-PB2,1146,1,2490,0,1,2492,T
1-PB2,1147,8,2,1,2480,2491,C
1-PB2,1148,2518,0,2,0,2520,A
1-PB2,1149,5,0,2625,0,2630,G
1-PB2,1150,0,0,0,2635,2635,C
1-PB2,1151,0,2634,0,0,2634,T
1-PB2,1152,5,1,1,2646,2653,C
1-PB2,1153,2632,0,0,1,2633,A
1-PB2,1154,0,2636,1,3,2640,T
1-PB2,1155,2647,0,0,0,2647,A
1-PB2,1156,1,2,2654,0,2657,G
1-PB2,1157,0,2513,0,4,2517,T
1-PB2,1158,1,9,2507,1,2518,G
1-PB2,1159,2438,0,2,1,2441,A
1-PB2,1160,8,1,2478,0,2487,G
1-PB2,1161,0,2464,0,2,2466,T
1-PB2,1162,0,8,2454,0,2462,G
1-PB2,1163,1,4,2473,0,2478,G
1-PB2,1164,2477,1,1,0,2479,A
1-PB2,1165,2449,0,5,0,2454,A
1-PB2,1166,0,10,2471,0,2481,G
1-PB2,1167,2437,0,2,0,2439,A
1-PB2,1168,0,3,2453,0,2456,G
1-PB2,1169,2434,2,3,0,2439,A
1-PB2,1170,3,5,0,2424,2432,C
1-PB2,1171,1,7,2431,1,2440,G
1-PB2,1172,2417,0,1,0,2418,A
1-PB2,1173,2426,0,1,0,2427,A
1-PB2,1174,2,0,0,2427,2429,C
1-PB2,1175,2413,0,1,0,2414,A
1-PB2,1176,0,1,2533,0,2534,G
1-PB2,1177,1,2510,0,3,2514,T
1-PB2,1178,10,1,2,2492,2505,C
1-PB2,1179,2513,0,2,0,2515,A
1-PB2,1180,2510,0,1,0,2511,A
1-PB2,1181,0,2513,0,0,2513,T
1-PB2,1182,2504,0,2,0,2506,A
1-PB2,1183,0,0,2504,0,2504,G
1-PB2,1184,0,1,0,2480,2481,C
1-PB2,1185,2,2,0,2395,2399,C
1-PB2,1186,0,2,2383,0,2385,G
1-PB2,1187,2392,1,0,0,2393,A
1-PB2,1188,2394,0,6,1,2401,A
1-PB2,1189,0,3,2428,0,2431,G
1-PB2,1190,3,1,0,2481,2485,C
1-PB2,1191,2488,0,3,1,2492,A
1-PB2,1192,2491,0,0,1,2492,A
1-PB2,1193,0,2492,0,1,2493,T
1-PB2,1194,2503,0,0,2,2505,A
1-PB2,1195,2526,1,0,0,2527,A
1-PB2,1196,0,2518,0,0,2518,T
1-PB2,1197,5,3,0,2495,2503,C
1-PB2,1198,3,0,2497,0,2500,G
1-PB2,1199,0,2441,0,2,2443,T
1-PB2,1200,1,4,2419,0,2424,G
1-PB2,1201,0,2,2455,1,2458,G
1-PB2,1202,2,1,2,2458,2463,C
1-PB2,1203,6,2,0,2451,2459,C
1-PB2,1204,2432,0,1,0,2433,A
1-PB2,1205,0,2437,0,0,2437,T
1-PB2,1206,2,8,2427,0,2437,G
1-PB2,1207,0,1,2486,0,2487,G
1-PB2,1208,1,2468,0,2,2471,T
1-PB2,1209,2,0,2488,0,2490,G
1-PB2,1210,0,2445,3,1,2449,T
1-PB2,1211,1,2464,0,2,2467,T
1-PB2,1212,1,2467,0,0,2468,T
1-PB2,1213,0,2482,0,1,2483,T
1-PB2,1214,5,0,0,2504,2509,C
1-PB2,1215,2508,0,0,0,2508,A
1-PB2,1216,1,4,0,2612,2617,C
1-PB2,1217,2570,0,0,1,2571,A
1-PB2,1218,2582,0,3,1,2586,A
1-PB2,1219,0,3,2601,0,2604,G
1-PB2,1220,2580,0,2,0,2582,A
1-PB2,1221,111,5,2488,1,2605,G
1-PB2,1222,0,6,2611,1,2618,G
1-PB2,1223,2595,1,0,1,2597,A
1-PB2,1224,1,2595,1,0,2597,T
1-PB2,1225,0,2560,0,0,2560,T
1-PB2,1226,0,2,2551,0,2553,G
1-PB2,1227,3,0,0,2505,2508,C
1-PB2,1228,2530,0,3,0,2533,A
1-PB2,1229,0,2546,0,2,2548,T
1-PB2,1230,1,5,2623,0,2629,G
1-PB2,1231,2658,1,0,0,2659,A
1-PB2,1232,0,2672,0,0,2672,T
1-PB2,1233,2650,0,0,0,2650,A
1-PB2,1234,2646,0,0,0,2646,A
1-PB2,1235,2643,0,0,2,2645,A
1-PB2,1236,2648,0,9,0,2657,A
1-PB2,1237,0,2,2652,0,2654,G
1-PB2,1238,4,1,0,2698,2703,C
1-PB2,1239,2758,0,1,0,2759,A
1-PB2,1240,0,3,2840,0,2843,G
1-PB2,1241,0,2832,0,1,2833,T
1-PB2,1242,0,2834,0,0,2834,T
1-PB2,1243,2824,4,3,0,2831,A
1-PB2,1244,1,8,2833,0,2842,G
1-PB2,1245,2812,2,4,0,2818,A
1-PB2,1246,0,14,2814,0,2828,G
1-PB2,1247,1,3,2817,0,2821,G
1-PB2,1248,0,2706,0,2,2708,T
1-PB2,1249,3,12,2713,0,2728,G
1-PB2,1250,2735,0,2,0,2737,A
1-PB2,1251,2,2,0,2726,2730,C
1-PB2,1252,9,0,0,2731,2740,C
1-PB2,1253,0,2708,1,6,2715,T
1-PB2,1254,1,6,2726,0,2733,G
1-PB2,1255,2725,0,2,0,2727,A
1-PB2,1256,2734,0,0,0,2734,A
1-PB2,1257,0,2727,0,1,2728,T
1-PB2,1258,0,2743,2,2,2747,T
1-PB2,1259,0,2758,0,1,2759,T
1-PB2,1260,6,2,0,2746,2754,C
1-PB2,1261,2,3,2752,0,2757,G
1-PB2,1262,0,2748,0,2,2750,T
1-PB2,1263,8,0,0,2746,2754,C
1-PB2,1264,2745,0,1,0,2746,A
1-PB2,1265,2747,0,0,0,2747,A
1-PB2,1266,2,0,0,2747,2749,C
1-PB2,1267,2723,0,0,0,2723,A
1-PB2,1268,0,8,2749,0,2757,G
1-PB2,1269,2737,1,1,0,2739,A
1-PB2,1270,1,3,2753,0,2757,G
1-PB2,1271,3,0,5,2741,2749,C
1-PB2,1272,2759,0,2,0,2761,A
1-PB2,1273,2784,0,1,0,2785,A
1-PB2,1274,2771,0,1,0,2772,A
1-PB2,1275,0,2770,1,1,2772,T
1-PB2,1276,1,0,0,2775,2776,C
1-PB2,1277,2750,0,2,1,2753,A
1-PB2,1278,4,2,2751,0,2757,G
1-PB2,1279,2,1,0,2761,2764,C
1-PB2,1280,3,20,2745,0,2768,G
1-PB2,1281,0,2,2922,0,2924,G
1-PB2,1282,0,2893,0,2,2895,T
1-PB2,1283,0,2900,0,2,2902,T
1-PB2,1284,0,2,2911,0,2913,G
1-PB2,1285,2912,0,4,0,2916,A
1-PB2,1286,2941,0,3,0,2944,A
1-PB2,1287,4,1,0,2947,2952,C
1-PB2,1288,15,3,2,2914,2934,C
1-PB2,1289,15,3,0,2944,2962,C
1-PB2,1290,9,3,0,2872,2884,C
1-PB2,1291,2904,1,1,1,2907,A
1-PB2,1292,2,2909,3,1,2915,T
1-PB2,1293,0,1,2918,0,2919,G
1-PB2,1294,1,0,0,2925,2926,C
1-PB2,1295,2914,0,1,0,2915,A
1-PB2,1296,0,2879,0,5,2884,T
1-PB2,1297,4,1,1,2872,2878,C
1-PB2,1298,2858,0,0,0,2858,A
1-PB2,1299,1,0,2909,0,2910,G
1-PB2,1300,2,0,0,2911,2913,C
1-PB2,1301,1,2900,1,3,2905,T
1-PB2,1302,1,2903,0,2,2906,T
1-PB2,1303,0,2907,0,0,2907,T
1-PB2,1304,1,2905,0,0,2906,T
1-PB2,1305,2912,0,0,0,2912,A
1-PB2,1306,2900,1,4,1,2906,A
1-PB2,1307,0,8,2899,1,2908,G
1-PB2,1308,2,2,2886,0,2890,G
1-PB2,1309,4,1,0,2877,2882,C
1-PB2,1310,2871,0,0,0,2871,A
1-PB2,1311,0,2880,0,2,2882,T
1-PB2,1312,0,2880,0,2,2882,T
1-PB2,1313,0,2893,0,2,2895,T
1-PB2,1314,1,2900,0,1,2902,T
1-PB2,1315,7,0,0,2895,2902,C
1-PB2,1316,2891,3,5,1,2900,A
1-PB2,1317,1,3,2896,0,2900,G
1-PB2,1318,2891,0,4,0,2895,A
1-PB2,1319,2890,0,3,0,2893,A
1-PB2,1320,2889,0,0,0,2889,A
1-PB2,1321,0,5,2902,0,2907,G
1-PB2,1322,2921,1,0,0,2922,A
1-PB2,1323,0,2921,0,1,2922,T
1-PB2,1324,0,4,2916,0,2920,G
1-PB2,1325,2,0,0,2925,2927,C
1-PB2,1326,4,9,2917,0,2930,G
1-PB2,1327,2924,1,2,0,2927,A
1-PB2,1328,2924,2,0,1,2927,A
1-PB2,1329,2917,0,0,0,2917,A
1-PB2,1330,3,2,2920,1,2926,G
1-PB2,1331,0,2906,1,2,2909,T
1-PB2,1332,1,2,2900,1,2904,G
1-PB2,1333,0,0,0,2891,2891,C
1-PB2,1334,0,2890,1,1,2892,T
1-PB2,1335,0,2889,0,3,2892,T
1-PB2,1336,1,2897,0,2,2900,T
1-PB2,1337,0,2901,1,4,2906,T
1-PB2,1338,0,2904,0,1,2905,T
1-PB2,1339,8,1,0,2891,2900,C
1-PB2,1340,2904,2,5,1,2912,A
1-PB2,1341,2927,0,1,0,2928,A
1-PB2,1342,2916,0,0,0,2916,A
1-PB2,1343,2934,0,2,0,2936,A
1-PB2,1344,1,2925,0,1,2927,T
1-PB2,1345,0,2936,1,0,2937,T
1-PB2,1346,0,10,2929,0,2939,G
1-PB2,1347,1,16,2911,0,2928,G
1-PB2,1348,2,12,2908,0,2922,G
1-PB2,1349,0,4,2971,0,2975,G
1-PB2,1350,2956,0,0,0,2956,A
1-PB2,1351,0,2,3025,0,3027,G
1-PB2,1352,1,3016,0,3,3020,T
1-PB2,1353,2,3021,1,0,3024,T
1-PB2,1354,3,7,3026,0,3036,G
1-PB2,1355,3029,1,5,0,3035,A
1-PB2,1356,3040,2,8,0,3050,A
1-PB2,1357,5,0,0,3112,3117,C
1-PB2,1358,3073,1,0,0,3074,A
1-PB2,1359,5,1,0,3119,3125,C
1-PB2,1360,3098,0,1,1,3100,A
1-PB2,1361,0,3093,4,1,3098,T
1-PB2,1362,6,4,0,3101,3111,C
1-PB2,1363,1,8,3100,0,3109,G
1-PB2,1364,3132,1,1,0,3134,A
1-PB2,1365,2,0,0,3117,3119,C
1-PB2,1366,3021,1,3,0,3025,A
1-PB2,1367,2,2,3106,1,3111,G
1-PB2,1368,1,3023,0,2,3026,T
1-PB2,1369,1,1,3069,0,3071,G
1-PB2,1370,0,3054,0,0,3054,T
1-PB2,1371,1,8,3058,0,3067,G
1-PB2,1372,3060,1,6,0,3067,A
1-PB2,1373,0,3043,0,1,3044,T
1-PB2,1374,1,10,3050,1,3062,G
1-PB2,1375,0,8,3041,1,3050,G
1-PB2,1376,1,8,2994,0,3003,G
1-PB2,1377,2980,1,1,0,2982,A
1-PB2,1378,2957,1,1,0,2959,A
1-PB2,1379,0,2965,0,1,2966,T
1-PB2,1380,0,14,2977,0,2991,G
1-PB2,1381,3001,0,1,0,3002,A
1-PB2,1382,0,3002,0,1,3003,T
1-PB2,1383,0,2993,0,5,2998,T
1-PB2,1384,4,8,2964,4,2980,G
1-PB2,1385,1,15,3025,0,3041,G
1-PB2,1386,3018,2,5,0,3025,A
1-PB2,1387,1,2,3060,0,3063,G
1-PB2,1388,1,3034,0,0,3035,T
1-PB2,1389,3012,0,0,0,3012,A
1-PB2,1390,0,3037,0,0,3037,T
1-PB2,1391,0,3053,1,4,3058,T
1-PB2,1392,3081,0,2,0,3083,A
1-PB2,1393,3,0,0,3080,3083,C
1-PB2,1394,19,1,0,3016,3036,C
1-PB2,1395,3019,0,5,0,3024,A
1-PB2,1396,2,4,3035,0,3041,G
1-PB2,1397,3083,0,1,1,3085,A
1-PB2,1398,1,3048,0,3,3052,T
1-PB2,1399,3027,0,2,5,3034,A
1-PB2,1400,0,3014,0,1,3015,T
1-PB2,1401,0,10,2979,1,2990,G
1-PB2,1402,2991,2,1,0,2994,A
1-PB2,1403,4,1,0,3011,3016,C
1-PB2,1404,0,2999,0,7,3006,T
1-PB2,1405,4,0,0,2984,2988,C
1-PB2,1406,13,4,1,2937,2955,C
1-PB2,1407,2967,2,1,0,2970,A
1-PB2,1408,2986,1,1,1,2989,A
1-PB2,1409,2,2,3044,0,3048,G
1-PB2,1410,2,1,0,3022,3025,C
1-PB2,1411,3035,1,3,0,3039,A
1-PB2,1412,4,1,0,3028,3033,C
1-PB2,1413,3014,0,3,0,3017,A
1-PB2,1414,0,8,3018,1,3027,G
1-PB2,1415,3007,1,1,0,3009,A
1-PB2,1416,0,5,3027,0,3032,G
1-PB2,1417,3039,3,0,0,3042,A
1-PB2,1418,1,2961,0,4,2966,T
1-PB2,1419,1,1,2995,0,2997,G
1-PB2,1420,1,2975,0,2,2978,T
1-PB2,1421,8,1,2,2942,2953,C
1-PB2,1422,2966,2,2,0,2970,A
1-PB2,1423,2959,0,0,0,2959,A
1-PB2,1424,1,2950,0,0,2951,T
1-PB2,1425,0,11,2940,0,2951,G
1-PB2,1426,2915,0,0,0,2915,A
1-PB2,1427,1,7,2922,0,2930,G
1-PB2,1428,2879,1,6,0,2886,A
1-PB2,1429,0,7,2879,0,2886,G
1-PB2,1430,0,5,2989,0,2994,G
1-PB2,1431,2995,1,0,0,2996,A
1-PB2,1432,2993,0,3,0,2996,A
1-PB2,1433,0,2996,0,0,2996,T
1-PB2,1434,2994,0,2,0,2996,A
1-PB2,1435,2984,0,3,1,2988,A
1-PB2,1436,0,10,2978,0,2988,G
1-PB2,1437,2970,1,2,0,2973,A
1-PB2,1438,0,2,2976,0,2978,G
1-PB2,1439,0,2805,0,0,2805,T
1-PB2,1440,11,0,0,2790,2801,C
1-PB2,1441,2799,0,3,1,2803,A
1-PB2,1442,0,0,2823,0,2823,G
1-PB2,1443,1,3,0,2826,2830,C
1-PB2,1444,2827,0,4,0,2831,A
1-PB2,1445,2837,1,1,0,2839,A
1-PB2,1446,2823,0,1,0,2824,A
1-PB2,1447,2827,0,3,0,2830,A
1-PB2,1448,0,2828,0,0,2828,T
1-PB2,1449,0,8,2818,0,2826,G
1-PB2,1450,2,12,2811,0,2825,G
1-PB2,1451,0,3,2837,1,2841,G
1-PB2,1452,0,2806,0,0,2806,T
1-PB2,1453,0,3,2808,0,2811,G
1-PB2,1454,0,2795,0,4,2799,T
1-PB2,1455,8,5,2791,0,2804,G
1-PB2,1456,1,1,2837,0,2839,G
1-PB2,1457,2829,1,4,0,2834,A
1-PB2,1458,0,2817,1,1,2819,T
1-PB2,1459,4,10,2805,2,2821,G
1-PB2,1460,2793,1,1,1,2796,A
1-PB2,1461,2807,1,0,0,2808,A
1-PB2,1462,0,2807,0,0,2807,T
1-PB2,1463,2788,0,0,0,2788,A
1-PB2,1464,1,11,0,2948,2960,C
1-PB2,1465,0,2889,1,0,2890,T
1-PB2,1466,17,0,0,2911,2928,C
1-PB2,1467,14,2,1,2919,2936,C
1-PB2,1468,2905,0,2,0,2907,A
1-PB2,1469,3,3,3010,0,3016,G
1-PB2,1470,1,2997,0,2,3000,T
1-PB2,1471,3024,1,1,0,3026,A
1-PB2,1472,1,2,0,3030,3033,C
1-PB2,1473,2727,1,1,0,2729,A
1-PB2,1474,1,5,2744,1,2751,G
1-PB2,1475,2649,0,5,0,2654,A
1-PB2,1476,0,6,2672,0,2678,G
1-PB2,1477,2603,0,2,0,2605,A
1-PB2,1478,1,9,2505,0,2515,G
1-PB2,1479,0,15,2491,1,2507,G
1-PB2,1480,0,2,2500,0,2502,G
1-PB2,1481,0,2464,1,1,2466,T
1-PB2,1482,1,9,2444,0,2454,G
1-PB2,1483,4,4,2454,0,2462,G
1-PB2,1484,1,2424,0,1,2426,T
1-PB2,1485,1,13,2469,0,2483,G
1-PB2,1486,0,1,2491,0,2492,G
1-PB2,1487,0,2428,1,0,2429,T
1-PB2,1488,0,2420,0,4,2424,T
1-PB2,1489,2390,1,1,0,2392,A
1-PB2,1490,1,2,2394,0,2397,G
1-PB2,1491,3,1,0,2382,2386,C
1-PB2,1492,2378,0,0,0,2378,A
1-PB2,1493,0,2371,0,0,2371,T
1-PB2,1494,1,2236,0,0,2237,T
1-PB2,1495,0,9,2219,1,2229,G
1-PB2,1496,2238,0,0,0,2238,A
1-PB2,1497,1,2225,0,3,2229,T
1-PB2,1498,14,0,0,2222,2236,C
1-PB2,1499,3,4,2216,0,2223,G
1-PB2,1500,1,1,2249,0,2251,G
1-PB2,1501,1,2239,0,3,2243,T
1-PB2,1502,0,2241,0,0,2241,T
1-PB2,1503,0,2239,0,0,2239,T
1-PB2,1504,1,2236,0,1,2238,T
1-PB2,1505,0,2245,0,1,2246,T
1-PB2,1506,0,5,2239,0,2244,G
1-PB2,1507,2227,1,4,0,2232,A
1-PB2,1508,0,2,2239,0,2241,G
1-PB2,1509,2164,0,1,0,2165,A
1-PB2,1510,0,1,2178,0,2179,G
1-PB2,1511,0,2187,0,3,2190,T
1-PB2,1512,2,2184,0,0,2186,T
1-PB2,1513,11,0,1,2179,2191,C
1-PB2,1514,1,11,2178,0,2190,G
1-PB2,1515,2191,0,5,0,2196,A
1-PB2,1516,0,5,2192,0,2197,G
1-PB2,1517,2192,0,1,0,2193,A
1-PB2,1518,2,0,1,2178,2181,C
1-PB2,1519,8,0,0,2172,2180,C
1-PB2,1520,2148,0,2,0,2150,A
1-PB2,1521,2171,0,2,0,2173,A
1-PB2,1522,2,1,0,2172,2175,C
1-PB2,1523,0,1,2173,0,2174,G
1-PB2,1524,0,2157,0,2,2159,T
1-PB2,1525,0,9,2144,0,2153,G
1-PB2,1526,0,3,2164,1,2168,G
1-PB2,1527,2,5,2166,0,2173,G
1-PB2,1528,2147,0,0,0,2147,A
1-PB2,1529,2139,0,0,0,2139,A
1-PB2,1530,0,2061,0,0,2061,T
1-PB2,1531,1,2,2122,0,2125,G
1-PB2,1532,0,2112,0,1,2113,T
1-PB2,1533,2116,0,0,0,2116,A
1-PB2,1534,1,2114,0,1,2116,T
1-PB2,1535,1,2081,0,3,2085,T
1-PB2,1536,2100,0,0,0,2100,A
1-PB2,1537,5,2080,0,1,2086,T
1-PB2,1538,0,2067,0,0,2067,T
1-PB2,1539,2066,0,1,0,2067,A
1-PB2,1540,0,1851,0,2,1853,T
1-PB2,1541,2,0,0,1898,1900,C
1-PB2,1542,0,1880,0,1,1881,T
1-PB2,1543,6,1,0,1880,1887,C
1-PB2,1544,6,0,1,1885,1892,C
1-PB2,1545,1,1841,2,3,1847,T
1-PB2,1546,0,2,1850,1,1853,G
1-PB2,1547,1840,0,1,0,1841,A
1-PB2,1548,1,3,1840,0,1844,G
1-PB2,1549,0,4,1834,0,1838,G
1-PB2,1550,1616,0,1,0,1617,A
1-PB2,1551,0,4,1627,0,1631,G
1-PB2,1552,0,3,1624,0,1627,G
1-PB2,1553,0,1573,0,0,1573,T
1-PB2,1554,7,0,0,1569,1576,C
1-PB2,1555,1557,1,1,0,1559,A
1-PB2,1556,0,2,1567,0,1569,G
1-PB2,1557,1,1562,0,1,1564,T
1-PB2,1558,0,3,1554,0,1557,G
1-PB2,1559,1555,0,0,0,1555,A
1-PB2,1560,1472,1,0,0,1473,A
1-PB2,1561,1474,0,2,0,1476,A
1-PB2,1562,3,0,0,1470,1473,C
1-PB2,1563,1450,0,2,0,1452,A
1-PB2,1564,1,1,0,1451,1453,C
1-PB2,1565,1363,0,1,0,1364,A
1-PB2,1566,0,3,1371,0,1374,G
1-PB2,1567,0,7,1363,0,1370,G
1-PB2,1568,1,9,1364,0,1374,G
1-PB2,1569,1364,0,1,0,1365,A
1-PB2,1570,1340,0,2,0,1342,A
1-PB2,1571,3,1,1,1336,1341,C
1-PB2,1572,0,1310,0,0,1310,T
1-PB2,1573,0,2,1304,0,1306,G
1-PB2,1574,1293,0,2,0,1295,A
1-PB2,1575,1,1,1295,0,1297,G
1-PB2,1576,1262,0,3,0,1265,A
1-PB2,1577,0,4,1179,0,1183,G
1-PB2,1578,1175,1,2,0,1178,A
1-PB2,1579,1,0,0,1174,1175,C
1-PB2,1580,0,1121,0,0,1121,T
1-PB2,1581,0,2,1138,0,1140,G
1-PB2,1582,1137,0,1,0,1138,A
1-PB2,1583,0,1,0,1132,1133,C
1-PB2,1584,1130,0,0,0,1130,A
1-PB2,1585,1130,0,0,0,1130,A
1-PB2,1586,1,1120,0,0,1121,T
1-PB2,1587,1109,0,0,0,1109,A
1-PB2,1588,1108,0,2,0,1110,A
1-PB2,1589,1,2,0,1110,1113,C
1-PB2,1590,0,1038,0,1,1039,T
1-PB2,1591,0,1020,0,0,1020,T
1-PB2,1592,1009,0,0,0,1009,A
1-PB2,1593,0,1008,0,0,1008,T
1-PB2,1594,0,1000,0,1,1001,T
1-PB2,1595,6,0,1,987,994,C
1-PB2,1596,918,0,0,0,918,A
1-PB2,1597,0,916,0,0,916,T
1-PB2,1598,4,0,0,879,883,C
1-PB2,1599,1,1,887,0,889,G
1-PB2,1600,1,884,0,0,885,T
1-PB2,1601,0,2,1,867,870,C
1-PB2,1602,0,4,871,0,875,G
1-PB2,1603,877,0,1,0,878,A
1-PB2,1604,2,876,0,0,878,T
1-PB2,1605,1,0,872,0,873,G
1-PB2,1606,874,0,1,0,875,A
1-PB2,1607,0,870,0,0,870,T
1-PB2,1608,0,0,859,0,859,G
1-PB2,1609,1,815,1,0,817,T
1-PB2,1610,0,7,807,0,814,G
1-PB2,1611,0,4,808,0,812,G
1-PB2,1612,0,2,810,0,812,G
1-PB2,1613,780,0,0,0,780,A
1-PB2,1614,0,0,761,0,761,G
1-PB2,1615,695,0,1,0,696,A
1-PB2,1616,0,659,0,1,660,T
1-PB2,1617,0,633,0,0,633,T
1-PB2,1618,629,0,0,0,629,A
1-PB2,1619,621,0,0,0,621,A
1-PB2,1620,0,0,0,615,615,C
1-PB2,1621,0,2,559,0,561,G
1-PB2,1622,0,0,566,0,566,G
1-PB2,1623,0,482,0,1,483,T
1-PB2,1624,2,0,0,471,473,C
1-PB2,1625,1,0,0,470,471,C
1-PB2,1626,0,427,1,0,428,T
1-PB2,1627,0,2,431,0,433,G
1-PB2,1628,434,0,0,0,434,A
1-PB2,1629,0,0,429,1,430,G
1-PB2,1630,1,434,0,0,435,T
1-PB2,1631,2,0,0,418,420,C
1-PB2,1632,0,0,421,1,422,G
1-PB2,1633,0,0,432,0,432,G
1-PB2,1634,0,428,0,0,428,T
1-PB2,1635,0,430,0,0,430,T
1-PB2,1636,0,427,0,0,427,T
1-PB2,1637,0,427,0,0,427,T
1-PB2,1638,0,1,436,0,437,G
1-PB2,1639,0,0,439,0,439,G
1-PB2,1640,2,440,0,0,442,T
1-PB2,1641,1,0,0,439,440,C
1-PB2,1642,433,0,0,0,433,A
1-PB2,1643,452,0,0,0,452,A
1-PB2,1644,0,450,0,1,451,T
1-PB2,1645,454,0,0,0,454,A
1-PB2,1646,1,0,0,459,460,C
1-PB2,1647,0,0,0,444,444,C
1-PB2,1648,0,441,0,1,442,T
1-PB2,1649,446,0,1,0,447,A
1-PB2,1650,1,441,0,0,442,T
1-PB2,1651,2,0,0,443,445,C
1-PB2,1652,429,0,0,1,430,A
1-PB2,1653,429,0,0,0,429,A
1-PB2,1654,0,431,0,0,431,T
1-PB2,1655,0,2,409,0,411,G
1-PB2,1656,0,0,413,0,413,G
1-PB2,1657,409,0,1,0,410,A
1-PB2,1658,0,396,0,0,396,T
1-PB2,1659,0,1,0,394,395,C
1-PB2,1660,392,1,0,0,393,A
1-PB2,1661,0,394,0,0,394,T
1-PB2,1662,1,0,0,393,394,C
1-PB2,1663,395,0,0,0,395,A
1-PB2,1664,0,0,398,0,398,G
1-PB2,1665,396,0,0,0,396,A
1-PB2,1666,397,0,0,0,397,A
1-PB2,1667,398,0,0,0,398,A
1-PB2,1668,0,403,0,0,403,T
1-PB2,1669,0,398,0,0,398,T
1-PB2,1670,1,1,396,0,398,G
1-PB2,1671,0,3,390,0,393,G
1-PB2,1672,0,0,395,0,395,G
1-PB2,1673,393,0,0,0,393,A
1-PB2,1674,396,0,0,0,396,A
1-PB2,1675,1,0,397,0,398,G
1-PB2,1676,0,0,0,397,397,C
1-PB2,1677,0,396,0,0,396,T
1-PB2,1678,0,0,398,0,398,G
1-PB2,1679,0,398,0,0,398,T
1-PB2,1680,1,0,0,396,397,C
1-PB2,1681,399,0,0,0,399,A
1-PB2,1682,399,0,0,0,399,A
1-PB2,1683,394,0,2,1,397,A
1-PB2,1684,403,0,1,0,404,A
1-PB2,1685,0,401,0,0,401,T
1-PB2,1686,0,403,0,0,403,T
1-PB2,1687,2,1,0,398,401,C
1-PB2,1688,400,0,0,0,400,A
1-PB2,1689,399,0,0,0,399,A
1-PB2,1690,0,401,0,0,401,T
1-PB2,1691,0,2,401,0,403,G
1-PB2,1692,0,0,405,0,405,G
1-PB2,1693,0,411,0,1,412,T
1-PB2,1694,1,0,0,413,414,C
1-PB2,1695,0,414,0,0,414,T
1-PB2,1696,2,0,0,412,414,C
1-PB2,1697,413,0,0,0,413,A
1-PB2,1698,0,1,413,0,414,G
1-PB2,1699,417,0,0,0,417,A
1-PB2,1700,418,0,0,0,418,A
1-PB2,1701,0,406,0,0,406,T
1-PB2,1702,5,0,0,390,395,C
1-PB2,1703,1,0,0,398,399,C
1-PB2,1704,0,400,0,0,400,T
1-PB2,1705,0,0,401,0,401,G
1-PB2,1706,0,0,0,401,401,C
1-PB2,1707,397,0,1,0,398,A
1-PB2,1708,403,0,0,0,403,A
1-PB2,1709,0,396,0,0,396,T
1-PB2,1710,0,0,412,0,412,G
1-PB2,1711,0,411,0,1,412,T
1-PB2,1712,0,396,0,0,396,T
1-PB2,1713,0,0,401,0,401,G
1-PB2,1714,0,400,0,0,400,T
1-PB2,1715,401,0,1,0,402,A
1-PB2,1716,0,0,0,398,398,C
1-PB2,1717,391,0,0,0,391,A
1-PB2,1718,395,0,1,0,396,A
1-PB2,1719,0,1,0,391,392,C
1-PB2,1720,381,0,0,0,381,A
1-PB2,1721,381,0,1,0,382,A
1-PB2,1722,373,1,0,0,374,A
1-PB2,1723,379,0,0,0,379,A
1-PB2,1724,0,380,0,0,380,T
1-PB2,1725,0,0,375,0,375,G
1-PB2,1726,0,2,377,0,379,G
1-PB2,1727,375,0,1,0,376,A
1-PB2,1728,374,0,0,0,374,A
1-PB2,1729,0,376,0,0,376,T
1-PB2,1730,0,373,0,0,373,T
1-PB2,1731,0,375,0,0,375,T
1-PB2,1732,0,1,371,0,372,G
1-PB2,1733,377,0,0,0,377,A
1-PB2,1734,377,0,0,0,377,A
1-PB2,1735,1,0,0,377,378,C
1-PB2,1736,5,0,0,364,369,C
1-PB2,1737,375,0,0,1,376,A
1-PB2,1738,0,381,0,0,381,T
1-PB2,1739,0,381,0,0,381,T
1-PB2,1740,0,382,0,0,382,T
1-PB2,1741,0,0,0,382,382,C
1-PB2,1742,382,0,0,0,382,A
1-PB2,1743,378,0,0,0,378,A
1-PB2,1744,0,377,0,0,377,T
1-PB2,1745,0,0,0,388,388,C
1-PB2,1746,0,381,0,0,381,T
1-PB2,1747,0,377,1,0,378,T
1-PB2,1748,0,380,0,0,380,T
1-PB2,1749,383,0,0,0,383,A
1-PB2,1750,0,0,384,0,384,G
1-PB2,1751,0,382,0,1,383,T
1-PB2,1752,3,0,0,387,390,C
1-PB2,1753,0,0,0,384,384,C
1-PB2,1754,1,0,0,382,383,C
1-PB2,1755,2,0,0,385,387,C
1-PB2,1756,384,1,0,0,385,A
1-PB2,1757,383,0,0,0,383,A
1-PB2,1758,0,1,387,0,388,G
1-PB2,1759,1,0,385,0,386,G
1-PB2,1760,0,0,0,383,383,C
1-PB2,1761,2,1,0,372,375,C
1-PB2,1762,377,0,0,0,377,A
1-PB2,1763,0,393,0,0,393,T
1-PB2,1764,0,391,0,1,392,T
1-PB2,1765,391,0,0,0,391,A
1-PB2,1766,0,1,389,0,390,G
1-PB2,1767,379,1,0,0,380,A
1-PB2,1768,399,0,0,0,399,A
1-PB2,1769,0,0,402,0,402,G
1-PB2,1770,0,0,0,401,401,C
1-PB2,1771,3,0,0,404,407,C
1-PB2,1772,401,0,0,0,401,A
1-PB2,1773,405,0,0,0,405,A
1-PB2,1774,0,410,0,0,410,T
1-PB2,1775,415,0,0,0,415,A
1-PB2,1776,0,1,0,413,414,C
1-PB2,1777,388,0,0,0,388,A
1-PB2,1778,0,0,387,0,387,G
1-PB2,1779,0,380,0,1,381,T
1-PB2,1780,0,2,381,0,383,G
1-PB2,1781,0,1,382,0,383,G
1-PB2,1782,0,0,380,0,380,G
1-PB2,1783,0,377,0,0,377,T
1-PB2,1784,0,376,0,0,376,T
1-PB2,1785,0,377,0,0,377,T
1-PB2,1786,0,0,382,0,382,G
1-PB2,1787,0,381,0,0,381,T
1-PB2,1788,2,0,0,375,377,C
1-PB2,1789,377,0,0,1,378,A
1-PB2,1790,0,2,379,0,381,G
1-PB2,1791,380,0,0,0,380,A
1-PB2,1792,380,0,0,0,380,A
1-PB2,1793,0,0,0,378,378,C
1-PB2,1794,0,370,0,0,370,T
1-PB2,1795,1,0,0,378,379,C
1-PB2,1796,0,382,0,0,382,T
1-PB2,1797,383,1,0,0,384,A
1-PB2,1798,0,384,0,0,384,T
1-PB2,1799,0,382,0,0,382,T
1-PB2,1800,0,0,1,381,382,C
1-PB2,1801,0,0,0,377,377,C
1-PB2,1802,378,0,0,0,378,A
1-PB2,1803,378,0,0,0,378,A
1-PB2,1804,3,0,0,373,376,C
1-PB2,1805,378,1,0,0,379,A
1-PB2,1806,380,0,0,0,380,A
1-PB2,1807,380,0,1,0,381,A
1-PB2,1808,0,382,0,0,382,T
1-PB2,1809,0,1,379,0,380,G
1-PB2,1810,376,0,0,1,377,A
1-PB2,1811,0,1,382,0,383,G
1-PB2,1812,384,0,1,0,385,A
1-PB2,1813,0,0,386,0,386,G
1-PB2,1814,383,0,1,0,384,A
1-PB2,1815,0,0,0,378,378,C
1-PB2,1816,0,0,382,0,382,G
1-PB2,1817,0,380,0,0,380,T
1-PB2,1818,386,1,0,0,387,A
1-PB2,1819,0,0,0,385,385,C
1-PB2,1820,0,380,0,0,380,T
1-PB2,1821,0,379,0,0,379,T
1-PB2,1822,0,1,375,0,376,G
1-PB2,1823,0,2,377,0,379,G
1-PB2,1824,0,2,375,0,377,G
1-PB2,1825,379,0,0,0,379,A
1-PB2,1826,0,0,0,381,381,C
1-PB2,1827,376,0,0,0,376,A
1-PB2,1828,0,377,0,0,377,T
1-PB2,1829,0,378,0,0,378,T
1-PB2,1830,0,380,0,0,380,T
1-PB2,1831,0,2,376,0,378,G
1-PB2,1832,380,0,0,0,380,A
1-PB2,1833,0,0,0,377,377,C
1-PB2,1834,380,0,0,0,380,A
1-PB2,1835,1,0,0,378,379,C
1-PB2,1836,3,0,0,364,367,C
1-PB2,1837,371,0,0,0,371,A
1-PB2,1838,1,0,0,372,373,C
1-PB2,1839,3,0,0,369,372,C
1-PB2,1840,4,0,0,368,372,C
1-PB2,1841,375,0,0,0,375,A
1-PB2,1842,0,0,380,0,380,G
1-PB2,1843,377,0,0,0,377,A
1-PB2,1844,0,392,0,0,392,T
1-PB2,1845,388,0,0,0,388,A
1-PB2,1846,383,1,0,0,384,A
1-PB2,1847,0,385,0,0,385,T
1-PB2,1848,383,0,0,0,383,A
1-PB2,1849,382,0,0,0,382,A
1-PB2,1850,380,0,0,0,380,A
1-PB2,1851,0,0,381,0,381,G
1-PB2,1852,0,0,0,377,377,C
1-PB2,1853,0,366,0,0,366,T
1-PB2,1854,0,365,0,0,365,T
1-PB2,1855,0,0,0,367,367,C
1-PB2,1856,0,364,0,1,365,T
1-PB2,1857,3,0,0,364,367,C
1-PB2,1858,2,0,0,364,366,C
1-PB2,1859,2,1,0,370,373,C
1-PB2,1860,0,371,0,0,371,T
1-PB2,1861,1,371,0,0,372,T
1-PB2,1862,0,373,0,0,373,T
1-PB2,1863,0,369,0,0,369,T
1-PB2,1864,0,0,371,0,371,G
1-PB2,1865,1,0,0,373,374,C
1-PB2,1866,367,0,2,1,370,A
1-PB2,1867,0,0,368,0,368,G
1-PB2,1868,1,0,0,370,371,C
1-PB2,1869,0,371,0,0,371,T
1-PB2,1870,0,0,373,0,373,G
1-PB2,1871,0,1,0,373,374,C
1-PB2,1872,0,371,0,1,372,T
1-PB2,1873,3,0,0,374,377,C
1-PB2,1874,3,1,0,375,379,C
1-PB2,1875,379,1,0,0,380,A
1-PB2,1876,0,0,0,379,379,C
1-PB2,1877,1,0,0,376,377,C
1-PB2,1878,373,0,0,0,373,A
1-PB2,1879,374,0,0,0,374,A
1-PB2,1880,372,0,1,0,373,A
1-PB2,1881,0,0,373,0,373,G
1-PB2,1882,0,1,0,373,374,C
1-PB2,1883,369,0,0,0,369,A
1-PB2,1884,371,0,0,0,371,A
1-PB2,1885,371,0,0,0,371,A
1-PB2,1886,0,1,371,0,372,G
1-PB2,1887,1,0,0,372,373,C
1-PB2,1888,370,0,0,0,370,A
1-PB2,1889,0,1,368,0,369,G
1-PB2,1890,366,1,0,0,367,A
1-PB2,1891,378,0,0,0,378,A
1-PB2,1892,0,379,0,0,379,T
1-PB2,1893,0,0,378,0,378,G
1-PB2,1894,0,0,0,377,377,C
1-PB2,1895,373,0,0,0,373,A
1-PB2,1896,0,0,378,0,378,G
1-PB2,1897,0,377,0,0,377,T
1-PB2,1898,0,392,0,0,392,T
1-PB2,1899,1,0,0,395,396,C
1-PB2,1900,1,386,0,0,387,T
1-PB2,1901,5,0,0,394,399,C
1-PB2,1902,0,396,0,1,397,T
1-PB2,1903,0,396,0,0,396,T
1-PB2,1904,1,0,0,398,399,C
1-PB2,1905,393,0,0,0,393,A
1-PB2,1906,1,0,0,393,394,C
1-PB2,1907,0,375,0,0,375,T
1-PB2,1908,0,1,377,0,378,G
1-PB2,1909,378,0,0,0,378,A
1-PB2,1910,0,0,0,385,385,C
1-PB2,1911,0,381,0,0,381,T
1-PB2,1912,0,0,388,0,388,G
1-PB2,1913,0,385,0,1,386,T
1-PB2,1914,0,2,387,0,389,G
1-PB2,1915,389,0,0,0,389,A
1-PB2,1916,391,0,0,0,391,A
1-PB2,1917,0,382,0,0,382,T
1-PB2,1918,0,0,384,0,384,G
1-PB2,1919,1,370,0,0,371,T
1-PB2,1920,0,1,374,0,375,G
1-PB2,1921,366,0,0,0,366,A
1-PB2,1922,0,2,369,0,371,G
1-PB2,1923,0,1,364,0,365,G
1-PB2,1924,0,0,365,0,365,G
1-PB2,1925,0,0,376,0,376,G
1-PB2,1926,373,0,1,0,374,A
1-PB2,1927,0,373,0,0,373,T
1-PB2,1928,0,0,0,375,375,C
1-PB2,1929,373,0,0,1,374,A
1-PB2,1930,0,0,379,0,379,G
1-PB2,1931,0,1,376,0,377,G
1-PB2,1932,1,0,376,0,377,G
1-PB2,1933,378,0,0,0,378,A
1-PB2,1934,1,360,0,0,361,T
1-PB2,1935,0,0,363,0,363,G
1-PB2,1936,362,0,1,0,363,A
1-PB2,1937,0,0,368,1,369,G
1-PB2,1938,367,1,0,0,368,A
1-PB2,1939,365,0,0,0,365,A
1-PB2,1940,0,369,0,0,369,T
1-PB2,1941,366,0,1,0,367,A
1-PB2,1942,0,0,0,377,377,C
1-PB2,1943,0,373,0,2,375,T
1-PB2,1944,0,379,0,0,379,T
1-PB2,1945,1,1,379,0,381,G
1-PB2,1946,0,374,0,1,375,T
1-PB2,1947,374,0,0,0,374,A
1-PB2,1948,370,0,0,0,370,A
1-PB2,1949,0,1,364,0,365,G
1-PB2,1950,0,2,361,0,363,G
1-PB2,1951,0,2,356,0,358,G
1-PB2,1952,0,0,361,0,361,G
1-PB2,1953,0,0,0,359,359,C
1-PB2,1954,359,0,0,0,359,A
1-PB2,1955,375,0,0,0,375,A
1-PB2,1956,0,376,0,0,376,T
1-PB2,1957,0,375,0,0,375,T
1-PB2,1958,2,0,0,381,383,C
1-PB2,1959,0,374,0,1,375,T
1-PB2,1960,2,0,0,380,382,C
1-PB2,1961,2,0,0,382,384,C
1-PB2,1962,0,382,0,0,382,T
1-PB2,1963,0,0,392,0,392,G
1-PB2,1964,0,383,0,0,383,T
1-PB2,1965,382,0,0,0,382,A
1-PB2,1966,0,383,0,0,383,T
1-PB2,1967,0,376,0,0,376,T
1-PB2,1968,2,0,0,380,382,C
1-PB2,1969,381,0,0,0,381,A
1-PB2,1970,387,0,1,0,388,A
1-PB2,1971,1,0,0,390,391,C
1-PB2,1972,0,383,0,1,384,T
1-PB2,1973,383,0,0,0,383,A
1-PB2,1974,1,0,0,387,388,C
1-PB2,1975,389,0,0,0,389,A
1-PB2,1976,388,0,0,0,388,A
1-PB2,1977,0,0,0,383,383,C
1-PB2,1978,383,0,0,0,383,A
1-PB2,1979,381,0,0,0,381,A
1-PB2,1980,0,0,384,1,385,G
1-PB2,1981,384,0,0,0,384,A
1-PB2,1982,1,1,0,382,384,C
1-PB2,1983,8,0,0,364,372,C
1-PB2,1984,375,0,0,0,375,A
1-PB2,1985,0,0,0,381,381,C
1-PB2,1986,0,377,0,1,378,T
1-PB2,1987,378,0,0,1,379,A
1-PB2,1988,377,0,0,0,377,A
1-PB2,1989,374,0,0,0,374,A
1-PB2,1990,376,0,1,0,377,A
1-PB2,1991,0,2,375,0,377,G
1-PB2,1992,372,0,0,0,372,A
1-PB2,1993,0,0,0,372,372,C
1-PB2,1994,0,362,0,0,362,T
1-PB2,1995,362,0,0,0,362,A
1-PB2,1996,363,0,0,0,363,A
1-PB2,1997,0,0,0,364,364,C
1-PB2,1998,364,0,0,0,364,A
1-PB2,1999,363,0,0,0,363,A
1-PB2,2000,0,359,0,0,359,T
1-PB2,2001,0,360,0,0,360,T
1-PB2,2002,2,0,0,358,360,C
1-PB2,2003,0,361,0,0,361,T
1-PB2,2004,0,0,0,363,363,C
1-PB2,2005,0,0,363,0,363,G
1-PB2,2006,0,0,361,0,361,G
1-PB2,2007,363,0,0,0,363,A
1-PB2,2008,360,1,0,0,361,A
1-PB2,2009,361,0,0,0,361,A
1-PB2,2010,361,0,0,0,361,A
1-PB2,2011,0,0,360,0,360,G
1-PB2,2012,362,0,0,0,362,A
1-PB2,2013,0,361,0,0,361,T
1-PB2,2014,0,0,363,0,363,G
1-PB2,2015,1,1,0,358,360,C
1-PB2,2016,0,1,0,360,361,C
1-PB2,2017,0,1,359,0,360,G
1-PB2,2018,0,0,360,0,360,G
1-PB2,2019,0,0,0,361,361,C
1-PB2,2020,362,0,0,0,362,A
1-PB2,2021,1,0,0,363,364,C
1-PB2,2022,0,362,0,0,362,T
1-PB2,2023,0,360,0,0,360,T
1-PB2,2024,0,361,0,0,361,T
1-PB2,2025,362,0,0,0,362,A
1-PB2,2026,366,0,0,0,366,A
1-PB2,2027,1,364,0,0,365,T
1-PB2,2028,1,363,0,0,364,T
1-PB2,2029,0,1,364,0,365,G
1-PB2,2030,356,0,0,0,356,A
1-PB2,2031,356,0,0,0,356,A
1-PB2,2032,0,1,357,0,358,G
1-PB2,2033,364,0,0,0,364,A
1-PB2,2034,0,0,0,362,362,C
1-PB2,2035,1,0,0,362,363,C
1-PB2,2036,0,0,0,363,363,C
1-PB2,2037,363,0,0,0,363,A
1-PB2,2038,0,1,370,0,371,G
1-PB2,2039,370,1,0,0,371,A
1-PB2,2040,0,371,0,0,371,T
1-PB2,2041,0,0,367,0,367,G
1-PB2,2042,358,0,0,0,358,A
1-PB2,2043,357,0,0,0,357,A
1-PB2,2044,358,0,0,0,358,A
1-PB2,2045,1,0,356,0,357,G
1-PB2,2046,0,0,0,358,358,C
1-PB2,2047,349,0,0,0,349,A
1-PB2,2048,0,0,0,351,351,C
1-PB2,2049,350,0,1,0,351,A
1-PB2,2050,1,343,1,0,345,T
1-PB2,2051,2,0,0,351,353,C
1-PB2,2052,1,0,0,352,353,C
1-PB2,2053,0,0,351,0,351,G
1-PB2,2054,0,0,354,0,354,G
1-PB2,2055,349,0,0,0,349,A
1-PB2,2056,0,0,353,0,353,G
1-PB2,2057,0,347,0,0,347,T
1-PB2,2058,0,0,343,0,343,G
1-PB2,2059,0,0,346,0,346,G
1-PB2,2060,339,0,0,0,339,A
1-PB2,2061,0,0,337,0,337,G
1-PB2,2062,1,331,0,0,332,T
1-PB2,2063,0,0,0,330,330,C
1-PB2,2064,0,0,0,327,327,C
1-PB2,2065,0,1,327,0,328,G
1-PB2,2066,0,0,0,325,325,C
1-PB2,2067,5,0,0,322,327,C
1-PB2,2068,1,0,332,0,333,G
1-PB2,2069,0,331,0,1,332,T
1-PB2,2070,1,0,0,334,335,C
1-PB2,2071,0,335,0,0,335,T
1-PB2,2072,0,338,0,0,338,T
1-PB2,2073,0,0,335,0,335,G
1-PB2,2074,334,0,0,0,334,A
1-PB2,2075,0,0,336,0,336,G
1-PB2,2076,334,0,0,0,334,A
1-PB2,2077,0,2,312,0,314,G
1-PB2,2078,0,2,309,0,311,G
1-PB2,2079,1,0,311,0,312,G
1-PB2,2080,0,311,0,0,311,T
1-PB2,2081,0,309,0,0,309,T
1-PB2,2082,0,310,0,0,310,T
1-PB2,2083,0,0,0,308,308,C
1-PB2,2084,0,309,0,0,309,T
1-PB2,2085,1,0,0,316,317,C
1-PB2,2086,316,0,0,0,316,A
1-PB2,2087,0,314,0,0,314,T
1-PB2,2088,0,316,0,0,316,T
1-PB2,2089,316,0,0,0,316,A
1-PB2,2090,0,316,0,0,316,T
1-PB2,2091,314,0,0,0,314,A
1-PB2,2092,0,0,316,0,316,G
1-PB2,2093,0,0,316,0,316,G
1-PB2,2094,0,297,0,0,297,T
1-PB2,2095,296,0,0,1,297,A
1-PB2,2096,297,0,1,0,298,A
1-PB2,2097,0,0,299,0,299,G
1-PB2,2098,0,1,298,1,300,G
1-PB2,2099,298,0,1,0,299,A
1-PB2,2100,296,0,0,0,296,A
1-PB2,2101,0,0,295,0,295,G
1-PB2,2102,293,0,0,0,293,A
1-PB2,2103,0,0,0,294,294,C
1-PB2,2104,292,0,0,0,292,A
1-PB2,2105,0,1,292,0,293,G
1-PB2,2106,292,0,0,0,292,A
1-PB2,2107,289,0,0,0,289,A
1-PB2,2108,1,0,289,1,291,G
1-PB2,2109,293,0,0,0,293,A
1-PB2,2110,0,291,0,0,291,T
1-PB2,2111,293,0,0,0,293,A
1-PB2,2112,0,0,0,290,290,C
1-PB2,2113,0,4,283,0,287,G
1-PB2,2114,0,2,293,0,295,G
1-PB2,2115,294,0,0,0,294,A
1-PB2,2116,3,0,0,286,289,C
1-PB2,2117,1,0,1,289,291,C
1-PB2,2118,284,0,0,0,284,A
1-PB2,2119,0,0,296,0,296,G
1-PB2,2120,1,1,0,293,295,C
1-PB2,2121,297,0,0,0,297,A
1-PB2,2122,0,295,0,0,295,T
1-PB2,2123,0,281,0,0,281,T
1-PB2,2124,281,0,0,0,281,A
1-PB2,2125,281,0,1,0,282,A
1-PB2,2126,0,0,283,0,283,G
1-PB2,2127,0,0,0,282,282,C
1-PB2,2128,262,0,0,0,262,A
1-PB2,2129,0,261,0,0,261,T
1-PB2,2130,0,0,0,261,261,C
1-PB2,2131,263,0,0,0,263,A
1-PB2,2132,264,0,0,0,264,A
1-PB2,2133,0,264,0,0,264,T
1-PB2,2134,0,1,263,0,264,G
1-PB2,2135,260,0,0,0,260,A
1-PB2,2136,261,0,0,0,261,A
1-PB2,2137,0,0,0,260,260,C
1-PB2,2138,0,247,0,1,248,T
1-PB2,2139,0,2,252,0,254,G
1-PB2,2140,251,0,1,0,252,A
1-PB2,2141,0,0,253,0,253,G
1-PB2,2142,0,251,0,0,251,T
1-PB2,2143,247,0,0,0,247,A
1-PB2,2144,248,0,0,0,248,A
1-PB2,2145,0,0,0,248,248,C
1-PB2,2146,1,0,0,240,241,C
1-PB2,2147,0,242,0,0,242,T
1-PB2,2148,0,233,0,0,233,T
1-PB2,2149,0,0,233,0,233,G
1-PB2,2150,1,0,0,232,233,C
1-PB2,2151,234,0,0,0,234,A
1-PB2,2152,232,0,0,0,232,A
1-PB2,2153,227,0,0,0,227,A
1-PB2,2154,226,0,0,0,226,A
1-PB2,2155,0,1,227,0,228,G
1-PB2,2156,1,0,226,0,227,G
1-PB2,2157,0,0,227,0,227,G
1-PB2,2158,0,1,224,0,225,G
1-PB2,2159,223,0,1,0,224,A
1-PB2,2160,224,0,0,0,224,A
1-PB2,2161,224,0,0,0,224,A
1-PB2,2162,223,0,0,0,223,A
1-PB2,2163,0,0,225,0,225,G
1-PB2,2164,0,0,226,0,226,G
1-PB2,2165,0,1,0,223,224,C
1-PB2,2166,0,223,0,0,223,T
1-PB2,2167,220,0,0,0,220,A
1-PB2,2168,218,0,0,0,218,A
1-PB2,2169,0,220,0,0,220,T
1-PB2,2170,0,0,220,0,220,G
1-PB2,2171,0,210,0,1,211,T
1-PB2,2172,0,0,210,0,210,G
1-PB2,2173,0,0,0,209,209,C
1-PB2,2174,0,210,0,0,210,T
1-PB2,2175,212,0,0,0,212,A
1-PB2,2176,212,0,0,0,212,A
1-PB2,2177,0,210,0,0,210,T
1-PB2,2178,0,0,0,210,210,C
1-PB2,2179,0,0,206,0,206,G
1-PB2,2180,0,0,208,0,208,G
1-PB2,2181,0,0,206,0,206,G
1-PB2,2182,0,0,0,206,206,C
1-PB2,2183,207,0,0,0,207,A
1-PB2,2184,204,0,0,0,204,A
1-PB2,2185,0,0,203,0,203,G
1-PB2,2186,0,1,203,0,204,G
1-PB2,2187,205,0,0,0,205,A
1-PB2,2188,0,0,203,0,203,G
1-PB2,2189,196,0,0,0,196,A
1-PB2,2190,0,0,0,193,193,C
1-PB2,2191,0,0,194,0,194,G
1-PB2,2192,0,192,0,0,192,T
1-PB2,2193,0,1,191,0,192,G
1-PB2,2194,0,0,191,0,191,G
1-PB2,2195,0,186,0,0,186,T
1-PB2,2196,0,0,185,0,185,G
1-PB2,2197,0,182,0,0,182,T
1-PB2,2198,0,182,0,0,182,T
1-PB2,2199,0,0,183,0,183,G
1-PB2,2200,0,0,179,0,179,G
1-PB2,2201,0,178,0,0,178,T
1-PB2,2202,174,0,0,0,174,A
1-PB2,2203,169,0,0,0,169,A
1-PB2,2204,0,163,0,0,163,T
1-PB2,2205,0,0,163,0,163,G
1-PB2,2206,163,0,0,0,163,A
1-PB2,2207,159,0,0,0,159,A
1-PB2,2208,159,0,0,0,159,A
1-PB2,2209,0,0,0,158,158,C
1-PB2,2210,0,0,157,0,157,G
1-PB2,2211,157,0,0,0,157,A
1-PB2,2212,158,0,0,0,158,A
1-PB2,2213,158,0,0,0,158,A
1-PB2,2214,158,0,0,0,158,A
1-PB2,2215,0,0,0,158,158,C
1-PB2,2216,0,0,158,0,158,G
1-PB2,2217,0,0,159,0,159,G
1-PB2,2218,0,0,159,0,159,G
1-PB2,2219,158,0,0,0,158,A
1-PB2,2220,0,0,0,158,158,C
1-PB2,2221,0,159,0,0,159,T
1-PB2,2222,1,1,0,161,163,C
1-PB2,2223,0,164,0,0,164,T
1-PB2,2224,163,0,0,0,163,A
1-PB2,2225,0,1,161,0,162,G
1-PB2,2226,0,0,0,162,162,C
1-PB2,2227,163,0,0,0,163,A
1-PB2,2228,0,161,0,0,161,T
1-PB2,2229,159,0,0,0,159,A
1-PB2,2230,0,0,0,162,162,C
1-PB2,2231,0,141,0,0,141,T
1-PB2,2232,0,139,0,0,139,T
1-PB2,2233,136,0,0,0,136,A
1-PB2,2234,0,0,0,136,136,C
1-PB2,2235,0,135,0,0,135,T
1-PB2,2236,0,0,134,0,134,G
1-PB2,2237,134,0,0,0,134,A
1-PB2,2238,0,0,0,133,133,C
1-PB2,2239,119,0,0,0,119,A
1-PB2,2240,0,0,119,0,119,G
1-PB2,2241,0,0,0,117,117,C
1-PB2,2242,1,0,0,117,118,C
1-PB2,2243,116,0,0,0,116,A
1-PB2,2244,0,0,116,0,116,G
1-PB2,2245,115,0,0,0,115,A
1-PB2,2246,1,0,0,113,114,C
1-PB2,2247,105,0,0,0,105,A
1-PB2,2248,0,0,105,0,105,G
1-PB2,2249,1,0,0,98,99,C
1-PB2,2250,0,0,99,0,99,G
1-PB2,2251,99,0,0,0,99,A
1-PB2,2252,1,0,0,98,99,C
1-PB2,2253,0,0,0,98,98,C
1-PB2,2254,98,0,0,0,98,A
1-PB2,2255,98,0,0,0,98,A
1-PB2,2256,98,0,0,0,98,A
1-PB2,2257,97,0,0,0,97,A
1-PB2,2258,0,0,97,0,97,G
1-PB2,2259,96,0,1,0,97,A
1-PB2,2260,97,0,0,0,97,A
1-PB2,2261,0,96,0,0,96,T
1-PB2,2262,0,97,0,0,97,T
1-PB2,2263,0,0,0,97,97,C
1-PB2,2264,0,1,93,0,94,G
1-PB2,2265,0,1,94,0,95,G
1-PB2,2266,95,0,0,0,95,A
1-PB2,2267,0,90,0,0,90,T
1-PB2,2268,0,1,88,0,89,G
1-PB2,2269,0,0,87,0,87,G
1-PB2,2270,0,0,0,88,88,C
1-PB2,2271,0,0,0,88,88,C
1-PB2,2272,88,0,0,0,88,A
1-PB2,2273,0,87,0,0,87,T
1-PB2,2274,1,0,0,87,88,C
1-PB2,2275,87,0,0,0,87,A
1-PB2,2276,88,0,0,0,88,A
1-PB2,2277,0,87,0,0,87,T
1-PB2,2278,0,78,0,0,78,T
1-PB2,2279,77,0,0,0,77,A
1-PB2,2280,75,0,0,0,75,A
2-PB1,1,185,0,0,0,185,A
2-PB1,2,0,185,0,0,185,T
2-PB1,3,0,0,191,0,191,G
2-PB1,4,0,1,211,0,212,G
2-PB1,5,236,0,0,0,236,A
2-PB1,6,0,249,0,0,249,T
2-PB1,7,0,0,251,0,251,G
2-PB1,8,0,252,0,1,253,T
2-PB1,9,1,0,0,279,280,C
2-PB1,10,287,0,0,0,287,A
2-PB1,11,306,0,0,0,306,A
2-PB1,12,0,304,1,0,305,T
2-PB1,13,1,0,0,306,307,C
2-PB1,14,0,2,0,330,332,C
2-PB1,15,1,3,331,0,335,G
2-PB1,16,377,1,0,0,378,A
2-PB1,17,0,0,0,384,384,C
2-PB1,18,0,384,0,1,385,T
2-PB1,19,0,0,0,461,461,C
2-PB1,20,0,464,0,0,464,T
2-PB1,21,466,0,0,1,467,A
2-PB1,22,0,0,0,468,468,C
2-PB1,23,0,468,0,0,468,T
2-PB1,24,0,2,528,0,530,G
2-PB1,25,0,536,0,0,536,T
2-PB1,26,0,536,0,0,536,T
2-PB1,27,2,0,0,532,534,C
2-PB1,28,1,1,0,533,535,C
2-PB1,29,0,616,0,0,616,T
2-PB1,30,627,0,0,0,627,A
2-PB1,31,628,0,0,0,628,A
2-PB1,32,627,0,1,1,629,A
2-PB1,33,0,3,634,0,637,G
2-PB1,34,0,1,640,0,641,G
2-PB1,35,0,637,0,2,639,T
2-PB1,36,0,638,0,1,639,T
2-PB1,37,1,1,0,637,639,C
2-PB1,38,2,0,0,635,637,C
2-PB1,39,640,0,0,0,640,A
2-PB1,40,0,1,645,0,646,G
2-PB1,41,2,0,0,640,642,C
2-PB1,42,1,0,644,0,645,G
2-PB1,43,0,0,0,644,644,C
2-PB1,44,647,0,0,0,647,A
2-PB1,45,644,1,1,1,647,A
2-PB1,46,647,0,0,0,647,A
2-PB1,47,654,0,0,0,654,A
2-PB1,48,0,656,0,1,657,T
2-PB1,49,0,0,690,0,690,G
2-PB1,50,0,0,0,691,691,C
2-PB1,51,0,0,0,693,693,C
2-PB1,52,693,0,1,0,694,A
2-PB1,53,0,699,0,1,700,T
2-PB1,54,750,0,1,0,751,A
2-PB1,55,750,0,0,0,750,A
2-PB1,56,0,0,790,0,790,G
2-PB1,57,0,0,0,794,794,C
2-PB1,58,785,0,0,0,785,A
2-PB1,59,1,0,0,820,821,C
2-PB1,60,822,0,0,0,822,A
2-PB1,61,872,0,1,0,873,A
2-PB1,62,0,0,0,874,874,C
2-PB1,63,873,0,0,0,873,A
2-PB1,64,0,888,0,0,888,T
2-PB1,65,0,880,0,1,881,T
2-PB1,66,1,0,0,1073,1074,C
2-PB1,67,1,0,0,1076,1077,C
2-PB1,68,5,0,0,1075,1080,C
2-PB1,69,0,1091,0,0,1091,T
2-PB1,70,3,1082,0,2,1087,T
2-PB1,71,1187,0,0,0,1187,A
2-PB1,72,1,1195,0,0,1196,T
2-PB1,73,1201,0,0,1,1202,A
2-PB1,74,0,0,0,1213,1213,C
2-PB1,75,0,1189,0,3,1192,T
2-PB1,76,1,6,1198,1,1206,G
2-PB1,77,0,5,1206,0,1211,G
2-PB1,78,1207,0,1,0,1208,A
2-PB1,79,0,4,1215,0,1219,G
2-PB1,80,1205,0,1,0,1206,A
2-PB1,81,0,1217,0,0,1217,T
2-PB1,82,2,0,0,1280,1282,C
2-PB1,83,2,0,0,1280,1282,C
2-PB1,84,0,1293,0,0,1293,T
2-PB1,85,0,0,0,1376,1376,C
2-PB1,86,2,1,1,1374,1378,C
2-PB1,87,1396,0,0,0,1396,A
2-PB1,88,0,1400,0,0,1400,T
2-PB1,89,1398,0,0,0,1398,A
2-PB1,90,2,0,0,1400,1402,C
2-PB1,91,1389,1,0,0,1390,A
2-PB1,92,0,2,1459,0,1461,G
2-PB1,93,0,1,0,1467,1468,C
2-PB1,94,4,1,0,1464,1469,C
2-PB1,95,1468,0,1,0,1469,A
2-PB1,96,0,1467,0,3,1470,T
2-PB1,97,0,6,1468,0,1474,G
2-PB1,98,0,4,1522,0,1526,G
2-PB1,99,1537,0,0,0,1537,A
2-PB1,100,1537,0,1,0,1538,A
2-PB1,101,0,1,0,1544,1545,C
2-PB1,102,1524,0,5,0,1529,A
2-PB1,103,1,6,1566,1,1574,G
2-PB1,104,0,9,1588,0,1597,G
2-PB1,105,1597,0,2,0,1599,A
2-PB1,106,1604,0,1,0,1605,A
2-PB1,107,0,0,0,1615,1615,C
2-PB1,108,1597,0,1,0,1598,A
2-PB1,109,0,11,1757,0,1768,G
2-PB1,110,1,18,1753,0,1772,G
2-PB1,111,0,2,1803,0,1805,G
2-PB1,112,0,1795,0,1,1796,T
2-PB1,113,1789,1,1,0,1791,A
2-PB1,114,1,0,0,1804,1805,C
2-PB1,115,1875,0,4,0,1879,A
2-PB1,116,0,0,0,1941,1941,C
2-PB1,117,14,1,0,1915,1930,C
2-PB1,118,1883,0,2,0,1885,A
2-PB1,119,0,1885,0,1,1886,T
2-PB1,120,1,5,1887,1,1894,G
2-PB1,121,1,8,1885,0,1894,G
2-PB1,122,1893,0,0,0,1893,A
2-PB1,123,1,1,0,1895,1897,C
2-PB1,124,1857,0,1,0,1858,A
2-PB1,125,1,1,0,1893,1895,C
2-PB1,126,1886,0,1,0,1887,A
2-PB1,127,0,1,1920,0,1921,G
2-PB1,128,1,1912,0,4,1917,T
2-PB1,129,3,1,1,1967,1972,C
2-PB1,130,1965,1,2,0,1968,A
2-PB1,131,1987,1,3,2,1993,A
2-PB1,132,2,0,0,1994,1996,C
2-PB1,133,1987,0,0,0,1987,A
2-PB1,134,0,6,2005,0,2011,G
2-PB1,135,1981,0,0,0,1981,A
2-PB1,136,1983,0,1,0,1984,A
2-PB1,137,0,1,0,1983,1984,C
2-PB1,138,1957,0,0,0,1957,A
2-PB1,139,2,0,1,2013,2016,C
2-PB1,140,2013,1,0,0,2014,A
2-PB1,141,1,1,1,2088,2091,C
2-PB1,142,6,0,0,2080,2086,C
2-PB1,143,2085,0,2,0,2087,A
2-PB1,144,2095,1,0,1,2097,A
2-PB1,145,2,2146,0,1,2149,T
2-PB1,146,2208,0,1,0,2209,A
2-PB1,147,0,2204,0,2,2206,T
2-PB1,148,0,2190,0,1,2191,T
2-PB1,149,4,0,0,2192,2196,C
2-PB1,150,2166,0,0,0,2166,A
2-PB1,151,0,4,2164,0,2168,G
2-PB1,152,2147,0,0,0,2147,A
2-PB1,153,0,6,2152,0,2158,G
2-PB1,154,2118,0,2,0,2120,A
2-PB1,155,2,7,2062,0,2071,G
2-PB1,156,1,14,2056,1,2072,G
2-PB1,157,0,10,2128,0,2138,G
2-PB1,158,0,8,2134,1,2143,G
2-PB1,159,0,5,2160,0,2165,G
2-PB1,160,2150,0,1,1,2152,A
2-PB1,161,2163,0,3,0,2166,A
2-PB1,162,3,0,2180,0,2183,G
2-PB1,163,0,2166,0,0,2166,T
2-PB1,164,1,7,2152,0,2160,G
2-PB1,165,0,4,2149,0,2153,G
2-PB1,166,2142,0,7,0,2149,A
2-PB1,167,1,5,0,2157,2163,C
2-PB1,168,2,9,2153,0,2164,G
2-PB1,169,2177,1,0,0,2178,A
2-PB1,170,2,0,0,2193,2195,C
2-PB1,171,2189,1,0,0,2190,A
2-PB1,172,2189,0,0,0,2189,A
2-PB1,173,2199,2,2,0,2203,A
2-PB1,174,0,2224,0,9,2233,T
2-PB1,175,2238,0,3,0,2241,A
2-PB1,176,1,0,0,2237,2238,C
2-PB1,177,2227,0,1,0,2228,A
2-PB1,178,0,4,2236,0,2240,G
2-PB1,179,2229,0,0,0,2229,A
2-PB1,180,2252,2,0,0,2254,A
2-PB1,181,2254,0,1,0,2255,A
2-PB1,182,0,0,0,2247,2247,C
2-PB1,183,0,2216,0,0,2216,T
2-PB1,184,0,17,2200,0,2217,G
2-PB1,185,0,6,2194,1,2201,G
2-PB1,186,0,9,2200,1,2210,G
2-PB1,187,2,1,2215,0,2218,G
2-PB1,188,1,2,0,2210,2213,C
2-PB1,189,2220,0,0,0,2220,A
2-PB1,190,4,1,0,2313,2318,C
2-PB1,191,13,0,0,2296,2309,C
2-PB1,192,7,0,0,2296,2303,C
2-PB1,193,8,0,1,2306,2315,C
2-PB1,194,2322,2,0,1,2325,A
2-PB1,195,2335,0,0,0,2335,A
2-PB1,196,0,0,0,2330,2330,C
2-PB1,197,0,2325,0,0,2325,T
2-PB1,198,8,0,0,2322,2330,C
2-PB1,199,2267,2,1,0,2270,A
2-PB1,200,2310,0,2,0,2312,A
2-PB1,201,1,1,0,2302,2304,C
2-PB1,202,9,0,0,2293,2302,C
2-PB1,203,8,1,0,2291,2300,C
2-PB1,204,2308,1,0,0,2309,A
2-PB1,205,2317,0,1,0,2318,A
2-PB1,206,0,2327,0,0,2327,T
2-PB1,207,1,2317,0,1,2319,T
2-PB1,208,1,8,2322,0,2331,G
2-PB1,209,2310,0,0,0,2310,A
2-PB1,210,0,2305,0,1,2306,T
2-PB1,211,1,7,2301,0,2309,G
2-PB1,212,0,6,2319,0,2325,G
2-PB1,213,2348,1,2,0,2351,A
2-PB1,214,1,0,0,2362,2363,C
2-PB1,215,15,1,0,2335,2351,C
2-PB1,216,2354,0,3,0,2357,A
2-PB1,217,2,0,0,2398,2400,C
2-PB1,218,1,2394,0,0,2395,T
2-PB1,219,2436,1,3,0,2440,A
2-PB1,220,3,1,0,2453,2457,C
2-PB1,221,8,0,0,2434,2442,C
2-PB1,222,0,2401,0,1,2402,T
2-PB1,223,0,8,2405,0,2413,G
2-PB1,224,2403,1,1,0,2405,A
2-PB1,225,1,6,2418,0,2425,G
2-PB1,226,0,7,2396,1,2404,G
2-PB1,227,2409,0,1,0,2410,A
2-PB1,228,0,2396,0,1,2397,T
2-PB1,229,2355,0,2,0,2357,A
2-PB1,230,2352,0,1,0,2353,A
2-PB1,231,0,2359,0,1,2360,T
2-PB1,232,0,13,2339,1,2353,G
2-PB1,233,2356,0,1,0,2357,A
2-PB1,234,2342,0,4,0,2346,A
2-PB1,235,0,0,0,2347,2347,C
2-PB1,236,13,1,1,2306,2321,C
2-PB1,237,2323,1,0,0,2324,A
2-PB1,238,2337,0,0,0,2337,A
2-PB1,239,1,4,2347,0,2352,G
2-PB1,240,0,2343,0,1,2344,T
2-PB1,241,4,8,2325,1,2338,G
2-PB1,242,0,11,2355,0,2366,G
2-PB1,243,2362,0,1,1,2364,A
2-PB1,244,1,2346,0,0,2347,T
2-PB1,245,2354,2,0,0,2356,A
2-PB1,246,0,2386,0,1,2387,T
2-PB1,247,2,0,2396,0,2398,G
2-PB1,248,3,1,0,2383,2387,C
2-PB1,249,2384,0,3,0,2387,A
2-PB1,250,0,1,0,2447,2448,C
2-PB1,251,2394,0,2,1,2397,A
2-PB1,252,2438,0,0,0,2438,A
2-PB1,253,2444,0,1,0,2445,A
2-PB1,254,1,1,0,2444,2446,C
2-PB1,255,2371,0,1,0,2372,A
2-PB1,256,0,9,2394,0,2403,G
2-PB1,257,2380,0,3,0,2383,A
2-PB1,258,3,0,0,2389,2392,C
2-PB1,259,0,2319,0,0,2319,T
2-PB1,260,0,0,2377,0,2377,G
2-PB1,261,1,2341,0,4,2346,T
2-PB1,262,0,2,2453,0,2455,G
2-PB1,263,1,2445,0,4,2450,T
2-PB1,264,10,1,0,2446,2457,C
2-PB1,265,4,0,0,2448,2452,C
2-PB1,266,0,2435,0,3,2438,T
2-PB1,267,1,9,2425,1,2436,G
2-PB1,268,0,7,2427,0,2434,G
2-PB1,269,2377,0,1,0,2378,A
2-PB1,270,0,1,2418,0,2419,G
2-PB1,271,0,2,2338,0,2340,G
2-PB1,272,1,0,0,2341,2342,C
2-PB1,273,0,2318,0,3,2321,T
2-PB1,274,2331,0,1,0,2332,A
2-PB1,275,0,2326,0,3,2329,T
2-PB1,276,0,6,2317,0,2323,G
2-PB1,277,0,2,2330,0,2332,G
2-PB1,278,1,2,0,2313,2316,C
2-PB1,279,2,0,0,2277,2279,C
2-PB1,280,0,2250,1,0,2251,T
2-PB1,281,0,2356,0,1,2357,T
2-PB1,282,8,0,0,2355,2363,C
2-PB1,283,6,0,0,2357,2363,C
2-PB1,284,0,2366,0,0,2366,T
2-PB1,285,0,2361,0,1,2362,T
2-PB1,286,6,2,2359,0,2367,G
2-PB1,287,2367,1,0,1,2369,A
2-PB1,288,2372,1,0,0,2373,A
2-PB1,289,0,5,2373,0,2378,G
2-PB1,290,2267,1,0,0,2268,A
2-PB1,291,2295,1,0,0,2296,A
2-PB1,292,1,2284,0,1,2286,T
2-PB1,293,7,3,0,2285,2295,C
2-PB1,294,9,0,1,2274,2284,C
2-PB1,295,8,0,0,2266,2274,C
2-PB1,296,2281,0,3,0,2284,A
2-PB1,297,1,0,0,2298,2299,C
2-PB1,298,9,1,1,2279,2290,C
2-PB1,299,10,0,0,2279,2289,C
2-PB1,300,2273,1,1,0,2275,A
2-PB1,301,1,6,2284,0,2291,G
2-PB1,302,0,4,2290,0,2294,G
2-PB1,303,0,2288,0,2,2290,T
2-PB1,304,2312,1,0,0,2313,A
2-PB1,305,0,2286,1,1,2288,T
2-PB1,306,3,0,0,2298,2301,C
2-PB1,307,0,2309,0,0,2309,T
2-PB1,308,0,2307,0,2,2309,T
2-PB1,309,0,2297,0,0,2297,T
2-PB1,310,1,8,2277,1,2287,G
2-PB1,311,2272,0,1,0,2273,A
2-PB1,312,2,9,2265,0,2276,G
2-PB1,313,2243,1,0,0,2244,A
2-PB1,314,2253,1,0,0,2254,A
2-PB1,315,1,0,0,2269,2270,C
2-PB1,316,1,2236,0,1,2238,T
2-PB1,317,6,0,0,2237,2243,C
2-PB1,318,2231,1,1,0,2233,A
2-PB1,319,1,2235,0,1,2237,T
2-PB1,320,1,3,2240,0,2244,G
2-PB1,321,0,2,0,2259,2261,C
2-PB1,322,5,0,0,2264,2269,C
2-PB1,323,0,2260,0,0,2260,T
2-PB1,324,0,2247,0,0,2247,T
2-PB1,325,1,3,2252,0,2256,G
2-PB1,326,2257,3,0,0,2260,A
2-PB1,327,2264,0,3,0,2267,A
2-PB1,328,2263,0,3,1,2267,A
2-PB1,329,1,2,0,2288,2291,C
2-PB1,330,2244,0,2,0,2246,A
2-PB1,331,2265,0,0,0,2265,A
2-PB1,332,0,2259,0,3,2262,T
2-PB1,333,0,9,2253,0,2262,G
2-PB1,334,0,4,2249,0,2253,G
2-PB1,335,2240,1,0,1,2242,A
2-PB1,336,2233,0,4,0,2237,A
2-PB1,337,1,0,2234,0,2235,G
2-PB1,338,0,0,0,2246,2246,C
2-PB1,339,8,0,1,2214,2223,C
2-PB1,340,3,0,2240,1,2244,G
2-PB1,341,0,2233,0,3,2236,T
2-PB1,342,1,2243,0,0,2244,T
2-PB1,343,4,0,0,2256,2260,C
2-PB1,344,2258,0,1,0,2259,A
2-PB1,345,2279,1,4,0,2284,A
2-PB1,346,0,2,0,2290,2292,C
2-PB1,347,2298,0,2,0,2300,A
2-PB1,348,0,7,2311,0,2318,G
2-PB1,349,2272,1,1,0,2274,A
2-PB1,350,1,0,0,2277,2278,C
2-PB1,351,2275,2,1,0,2278,A
2-PB1,352,2277,0,0,0,2277,A
2-PB1,353,0,13,2274,0,2287,G
2-PB1,354,2,12,2243,1,2258,G
2-PB1,355,0,1,2265,0,2266,G
2-PB1,356,0,2225,0,2,2227,T
2-PB1,357,0,4,2218,0,2222,G
2-PB1,358,1,7,2205,0,2213,G
2-PB1,359,2212,0,1,0,2213,A
2-PB1,360,3,0,0,2214,2217,C
2-PB1,361,2174,2,0,0,2176,A
2-PB1,362,2206,1,1,0,2208,A
2-PB1,363,2206,1,0,0,2207,A
2-PB1,364,3,0,0,2210,2213,C
2-PB1,365,0,2195,0,5,2200,T
2-PB1,366,2197,1,2,1,2201,A
2-PB1,367,2220,0,1,0,2221,A
2-PB1,368,3,0,2,2215,2220,C
2-PB1,369,6,0,0,2215,2221,C
2-PB1,370,16,0,1,2199,2216,C
2-PB1,371,2171,0,0,0,2171,A
2-PB1,372,2168,0,1,1,2170,A
2-PB1,373,0,7,2164,0,2171,G
2-PB1,374,1,0,2168,0,2169,G
2-PB1,375,1,2173,0,3,2177,T
2-PB1,376,4,0,0,2152,2156,C
2-PB1,377,1,3,2161,0,2165,G
2-PB1,378,4,1,1,2144,2150,C
2-PB1,379,4,0,1,2159,2164,C
2-PB1,380,2165,0,1,0,2166,A
2-PB1,381,0,4,2203,0,2207,G
2-PB1,382,2233,0,1,0,2234,A
2-PB1,383,4,1,1,2234,2240,C
2-PB1,384,0,2213,0,6,2219,T
2-PB1,385,0,2212,1,0,2213,T
2-PB1,386,2214,1,0,0,2215,A
2-PB1,387,0,2218,0,1,2219,T
2-PB1,388,0,3,2221,1,2225,G
2-PB1,389,2219,1,1,1,2222,A
2-PB1,390,1,2170,0,1,2172,T
2-PB1,391,0,2123,0,0,2123,T
2-PB1,392,1,6,2101,0,2108,G
2-PB1,393,0,6,2106,0,2112,G
2-PB1,394,2132,0,0,0,2132,A
2-PB1,395,0,1,0,2133,2134,C
2-PB1,396,2111,0,0,0,2111,A
2-PB1,397,0,2095,0,0,2095,T
2-PB1,398,0,2111,0,0,2111,T
2-PB1,399,2127,1,3,0,2131,A
2-PB1,400,2124,0,0,0,2124,A
2-PB1,401,2130,0,1,0,2131,A
2-PB1,402,0,1,0,2130,2131,C
2-PB1,403,2093,1,0,0,2094,A
2-PB1,404,0,5,2101,0,2106,G
2-PB1,405,2099,0,3,0,2102,A
2-PB1,406,2099,1,3,0,2103,A
2-PB1,407,2106,0,0,0,2106,A
2-PB1,408,0,2072,0,0,2072,T
2-PB1,409,4,0,0,2083,2087,C
2-PB1,410,2087,0,1,0,2088,A
2-PB1,411,2092,0,2,0,2094,A
2-PB1,412,3,0,0,2084,2087,C
2-PB1,413,14,1,0,2068,2083,C
2-PB1,414,0,8,2075,0,2083,G
2-PB1,415,0,2,2089,1,2092,G
2-PB1,416,2,2,0,2089,2093,C
2-PB1,417,2091,1,0,0,2092,A
2-PB1,418,1,2,2090,0,2093,G
2-PB1,419,0,0,1,2117,2118,C
2-PB1,420,2116,1,2,0,2119,A
2-PB1,421,2125,0,0,0,2125,A
2-PB1,422,3,0,0,2119,2122,C
2-PB1,423,0,2107,0,4,2111,T
2-PB1,424,0,0,2193,0,2193,G
2-PB1,425,1,1,0,2193,2195,C
2-PB1,426,2200,0,0,0,2200,A
2-PB1,427,0,2191,0,5,2196,T
2-PB1,428,0,2177,0,0,2177,T
2-PB1,429,2317,1,2,0,2320,A
2-PB1,430,1,3,2324,0,2328,G
2-PB1,431,1,1,0,2295,2297,C
2-PB1,432,5,1,1,2297,2304,C
2-PB1,433,2218,0,0,0,2218,A
2-PB1,434,2233,0,0,0,2233,A
2-PB1,435,0,0,0,2244,2244,C
2-PB1,436,2250,1,0,0,2251,A
2-PB1,437,3,1,0,2289,2293,C
2-PB1,438,12,0,0,2125,2137,C
2-PB1,439,2127,0,3,0,2130,A
2-PB1,440,0,2124,0,0,2124,T
2-PB1,441,2128,1,2,0,2131,A
2-PB1,442,0,0,2133,0,2133,G
2-PB1,443,2116,2,0,0,2118,A
2-PB1,444,2092,1,0,0,2093,A
2-PB1,445,1,0,2112,0,2113,G
2-PB1,446,0,2069,0,0,2069,T
2-PB1,447,0,2055,0,0,2055,T
2-PB1,448,0,2055,0,1,2056,T
2-PB1,449,0,2063,0,0,2063,T
2-PB1,450,0,2064,0,0,2064,T
2-PB1,451,2059,2,0,0,2061,A
2-PB1,452,0,3,2060,0,2063,G
2-PB1,453,2057,0,1,0,2058,A
2-PB1,454,0,2047,0,0,2047,T
2-PB1,455,6,1,0,2031,2038,C
2-PB1,456,0,6,2028,0,2034,G
2-PB1,457,2037,0,1,0,2038,A
2-PB1,458,2043,0,1,0,2044,A
2-PB1,459,1,0,0,2055,2056,C
2-PB1,460,1,12,2045,0,2058,G
2-PB1,461,0,7,2137,0,2144,G
2-PB1,462,2136,0,3,0,2139,A
2-PB1,463,0,2127,0,1,2128,T
2-PB1,464,1,2133,0,0,2134,T
2-PB1,465,2130,0,3,0,2133,A
2-PB1,466,2131,0,2,0,2133,A
2-PB1,467,1,0,0,2147,2148,C
2-PB1,468,2133,0,0,0,2133,A
2-PB1,469,0,1,2147,1,2149,G
2-PB1,470,2,0,0,2061,2063,C
2-PB1,471,0,2057,0,2,2059,T
2-PB1,472,2061,0,1,0,2062,A
2-PB1,473,2057,1,0,0,2058,A
2-PB1,474,0,2048,0,1,2049,T
2-PB1,475,0,5,2075,0,2080,G
2-PB1,476,2074,0,0,0,2074,A
2-PB1,477,2080,1,0,0,2081,A
2-PB1,478,0,2034,5,1,2040,T
2-PB1,479,2,0,1,2043,2046,C
2-PB1,480,2043,1,0,1,2045,A
2-PB1,481,0,2,2043,0,2045,G
2-PB1,482,0,4,2040,0,2044,G
2-PB1,483,2033,0,2,0,2035,A
2-PB1,484,2006,0,1,1,2008,A
2-PB1,485,1,3,2080,0,2084,G
2-PB1,486,0,0,2093,0,2093,G
2-PB1,487,3,1,0,2080,2084,C
2-PB1,488,0,2081,0,3,2084,T
2-PB1,489,2086,0,1,0,2087,A
2-PB1,490,2088,0,1,0,2089,A
2-PB1,491,0,2088,0,0,2088,T
2-PB1,492,2086,0,0,0,2086,A
2-PB1,493,0,2,2089,0,2091,G
2-PB1,494,1977,0,0,0,1977,A
2-PB1,495,0,1961,1,3,1965,T
2-PB1,496,0,1953,0,3,1956,T
2-PB1,497,0,1946,0,2,1948,T
2-PB1,498,4,0,0,2009,2013,C
2-PB1,499,8,0,0,2009,2017,C
2-PB1,500,0,2016,0,0,2016,T
2-PB1,501,7,1,0,2012,2020,C
2-PB1,502,2021,1,0,0,2022,A
2-PB1,503,2025,1,0,0,2026,A
2-PB1,504,1,3,2026,0,2030,G
2-PB1,505,0,9,2040,0,2049,G
2-PB1,506,2044,0,1,1,2046,A
2-PB1,507,0,1986,0,0,1986,T
2-PB1,508,2,1,2006,0,2009,G
2-PB1,509,0,1997,0,0,1997,T
2-PB1,510,0,12,2002,0,2014,G
2-PB1,511,2011,2,0,0,2013,A
2-PB1,512,0,2000,0,0,2000,T
2-PB1,513,5,9,1977,0,1991,G
2-PB1,514,0,1,1979,0,1980,G
2-PB1,515,1978,0,1,0,1979,A
2-PB1,516,1977,0,0,0,1977,A
2-PB1,517,1,1950,0,0,1951,T
2-PB1,518,6,0,0,1955,1961,C
2-PB1,519,1933,0,0,0,1933,A
2-PB1,520,1940,0,0,0,1940,A
2-PB1,521,1,1940,0,0,1941,T
2-PB1,522,2,4,1953,0,1959,G
2-PB1,523,0,3,1960,0,1963,G
2-PB1,524,1957,0,0,0,1957,A
2-PB1,525,1,1949,0,1,1951,T
2-PB1,526,1950,0,0,0,1950,A
2-PB1,527,1939,0,0,1,1940,A
2-PB1,528,1936,0,5,0,1941,A
2-PB1,529,0,7,1961,0,1968,G
2-PB1,530,1957,0,0,0,1957,A
2-PB1,531,1,0,1946,0,1947,G
2-PB1,532,0,5,1936,0,1941,G
2-PB1,533,1928,0,0,1,1929,A
2-PB1,534,1928,0,2,0,1930,A
2-PB1,535,1939,1,0,1,1941,A
2-PB1,536,0,1936,0,0,1936,T
2-PB1,537,0,5,1960,0,1965,G
2-PB1,538,0,7,1952,0,1959,G
2-PB1,539,1934,0,3,0,1937,A
2-PB1,540,0,1,1958,1,1960,G
2-PB1,541,1942,0,0,0,1942,A
2-PB1,542,1,1981,0,1,1983,T
2-PB1,543,1974,0,1,0,1975,A
2-PB1,544,1998,0,0,0,1998,A
2-PB1,545,1,1,0,2000,2002,C
2-PB1,546,1964,0,2,2,1968,A
2-PB1,547,1971,0,1,0,1972,A
2-PB1,548,3,0,0,1970,1973,C
2-PB1,549,1954,3,1,0,1958,A
2-PB1,550,1,0,0,1956,1957,C
2-PB1,551,1910,1,4,0,1915,A
2-PB1,552,0,1,1,1921,1923,C
2-PB1,553,0,1883,0,1,1884,T
2-PB1,554,0,1883,0,0,1883,T
2-PB1,555,1,1886,0,1,1888,T
2-PB1,556,8,2,0,1881,1891,C
2-PB1,557,1886,1,2,0,1889,A
2-PB1,558,1890,0,0,0,1890,A
2-PB1,559,1893,0,1,0,1894,A
2-PB1,560,0,3,1910,0,1913,G
2-PB1,561,1879,1,1,0,1881,A
2-PB1,562,1883,0,1,0,1884,A
2-PB1,563,1881,1,2,0,1884,A
2-PB1,564,1887,0,0,1,1888,A
2-PB1,565,1884,0,1,0,1885,A
2-PB1,566,0,8,1882,0,1890,G
2-PB1,567,0,9,1880,1,1890,G
2-PB1,568,1868,1,2,0,1871,A
2-PB1,569,1,3,1909,0,1913,G
2-PB1,570,1903,0,3,0,1906,A
2-PB1,571,1,0,1970,0,1971,G
2-PB1,572,1,1954,0,0,1955,T
2-PB1,573,1959,0,1,0,1960,A
2-PB1,574,1960,0,2,0,1962,A
2-PB1,575,0,8,1949,1,1958,G
2-PB1,576,0,7,1965,0,1972,G
2-PB1,577,0,7,1959,0,1966,G
2-PB1,578,1934,0,1,0,1935,A
2-PB1,579,1,0,0,1947,1948,C
2-PB1,580,1867,0,1,0,1868,A
2-PB1,581,1875,0,1,0,1876,A
2-PB1,582,2,0,0,1870,1872,C
2-PB1,583,1868,0,2,0,1870,A
2-PB1,584,0,1847,0,0,1847,T
2-PB1,585,0,12,1813,0,1825,G
2-PB1,586,1824,0,1,0,1825,A
2-PB1,587,2,0,0,1813,1815,C
2-PB1,588,3,0,0,1788,1791,C
2-PB1,589,1798,0,1,0,1799,A
2-PB1,590,1796,0,1,0,1797,A
2-PB1,591,3,2,1803,0,1808,G
2-PB1,592,1808,0,0,0,1808,A
2-PB1,593,1805,0,0,0,1805,A
2-PB1,594,1797,0,1,0,1798,A
2-PB1,595,1793,0,1,0,1794,A
2-PB1,596,2,1788,0,0,1790,T
2-PB1,597,2,9,1780,0,1791,G
2-PB1,598,0,0,1791,1,1792,G
2-PB1,599,1,1753,0,3,1757,T
2-PB1,600,9,2,0,1707,1718,C
2-PB1,601,1734,0,2,0,1736,A
2-PB1,602,0,1,0,1856,1857,C
2-PB1,603,1884,0,1,0,1885,A
2-PB1,604,1,0,1,1887,1889,C
2-PB1,605,1880,0,0,1,1881,A
2-PB1,606,1971,0,0,0,1971,A
2-PB1,607,1954,0,0,1,1955,A
2-PB1,608,0,3,2103,0,2106,G
2-PB1,609,2103,2,0,0,2105,A
2-PB1,610,2128,2,0,0,2130,A
2-PB1,611,0,0,0,2203,2203,C
2-PB1,612,2148,0,0,0,2148,A
2-PB1,613,2160,0,2,0,2162,A
2-PB1,614,0,2158,0,1,2159,T
2-PB1,615,2134,0,0,1,2135,A
2-PB1,616,1,6,2124,0,2131,G
2-PB1,617,0,10,2064,0,2074,G
2-PB1,618,0,4,2071,1,2076,G
2-PB1,619,2076,1,0,0,2077,A
2-PB1,620,2057,0,0,0,2057,A
2-PB1,621,1,4,2071,0,2076,G
2-PB1,622,2076,0,1,0,2077,A
2-PB1,623,2079,0,2,1,2082,A
2-PB1,624,2083,0,1,0,2084,A
2-PB1,625,2101,1,0,0,2102,A
2-PB1,626,2158,0,0,2,2160,A
2-PB1,627,2159,0,0,3,2162,A
2-PB1,628,0,1,0,2167,2168,C
2-PB1,629,2162,0,0,1,2163,A
2-PB1,630,2160,0,2,0,2162,A
2-PB1,631,2155,0,1,1,2157,A
2-PB1,632,0,15,2179,1,2195,G
2-PB1,633,2195,0,0,0,2195,A
2-PB1,634,0,3,2251,0,2254,G
2-PB1,635,0,2217,0,1,2218,T
2-PB1,636,0,7,2360,0,2367,G
2-PB1,637,2367,0,3,0,2370,A
2-PB1,638,2376,0,0,0,2376,A
2-PB1,639,0,2418,0,0,2418,T
2-PB1,640,2438,1,0,0,2439,A
2-PB1,641,2424,3,2,0,2429,A
2-PB1,642,0,7,2420,0,2427,G
2-PB1,643,2390,0,2,1,2393,A
2-PB1,644,2327,0,2,0,2329,A
2-PB1,645,2371,1,1,0,2373,A
2-PB1,646,0,5,2392,0,2397,G
2-PB1,647,0,0,2400,0,2400,G
2-PB1,648,1,1,0,2398,2400,C
2-PB1,649,0,2379,0,0,2379,T
2-PB1,650,2462,0,0,1,2463,A
2-PB1,651,1,3,0,2573,2577,C
2-PB1,652,13,0,0,2568,2581,C
2-PB1,653,0,2604,0,3,2607,T
2-PB1,654,2710,0,0,0,2710,A
2-PB1,655,2702,2,0,0,2704,A
2-PB1,656,0,2700,0,0,2700,T
2-PB1,657,2696,0,1,0,2697,A
2-PB1,658,2688,0,2,0,2690,A
2-PB1,659,1,13,2693,0,2707,G
2-PB1,660,2650,1,2,0,2653,A
2-PB1,661,0,0,2683,0,2683,G
2-PB1,662,1,2,0,2685,2688,C
2-PB1,663,0,2637,0,1,2638,T
2-PB1,664,0,2656,0,2,2658,T
2-PB1,665,1,2657,0,1,2659,T
2-PB1,666,2,12,2646,0,2660,G
2-PB1,667,2708,2,4,1,2715,A
2-PB1,668,1,0,0,2720,2721,C
2-PB1,669,2707,1,0,1,2709,A
2-PB1,670,0,2696,0,0,2696,T
2-PB1,671,0,2690,0,1,2691,T
2-PB1,672,0,10,2751,1,2762,G
2-PB1,673,2757,0,3,0,2760,A
2-PB1,674,2763,0,4,0,2767,A
2-PB1,675,1,2,0,2768,2771,C
2-PB1,676,2747,0,0,5,2752,A
2-PB1,677,0,4,0,2759,2763,C
2-PB1,678,1,16,2735,1,2753,G
2-PB1,679,2776,0,1,0,2777,A
2-PB1,680,1,2784,0,0,2785,T
2-PB1,681,0,15,2813,0,2828,G
2-PB1,682,2840,2,6,0,2848,A
2-PB1,683,3,1,0,2846,2850,C
2-PB1,684,10,1,1,2831,2843,C
2-PB1,685,2850,0,1,0,2851,A
2-PB1,686,2891,0,3,0,2894,A
2-PB1,687,2890,0,3,1,2894,A
2-PB1,688,1,4,2963,0,2968,G
2-PB1,689,2993,1,3,0,2997,A
2-PB1,690,0,2945,0,0,2945,T
2-PB1,691,2,4,2955,0,2961,G
2-PB1,692,1,0,0,2948,2949,C
2-PB1,693,2950,0,3,1,2954,A
2-PB1,694,0,7,2984,0,2991,G
2-PB1,695,2957,1,1,0,2959,A
2-PB1,696,0,8,2951,0,2959,G
2-PB1,697,2883,0,1,0,2884,A
2-PB1,698,0,5,2874,0,2879,G
2-PB1,699,2843,1,8,0,2852,A
2-PB1,700,0,6,2850,0,2856,G
2-PB1,701,1,3,2845,0,2849,G
2-PB1,702,1,0,0,2841,2842,C
2-PB1,703,2835,0,0,1,2836,A
2-PB1,704,2845,0,0,1,2846,A
2-PB1,705,2855,2,1,1,2859,A
2-PB1,706,0,2845,1,1,2847,T
2-PB1,707,0,2851,1,0,2852,T
2-PB1,708,2862,0,1,2,2865,A
2-PB1,709,2855,0,1,1,2857,A
2-PB1,710,2855,1,2,1,2859,A
2-PB1,711,2877,0,0,0,2877,A
2-PB1,712,2888,0,3,0,2891,A
2-PB1,713,2,7,2884,0,2893,G
2-PB1,714,2878,0,1,0,2879,A
2-PB1,715,2868,0,2,0,2870,A
2-PB1,716,1,13,2889,0,2903,G
2-PB1,717,0,8,2942,0,2950,G
2-PB1,718,0,1,2955,0,2956,G
2-PB1,719,2,2,0,2981,2985,C
2-PB1,720,0,2976,0,0,2976,T
2-PB1,721,2998,1,1,0,3000,A
2-PB1,722,1,3034,1,0,3036,T
2-PB1,723,1,3037,1,0,3039,T
2-PB1,724,1,1,3062,0,3064,G
2-PB1,725,1,2,0,3042,3045,C
2-PB1,726,2985,0,8,2,2995,A
2-PB1,727,3013,0,2,2,3017,A
2-PB1,728,2,2,0,3013,3017,C
2-PB1,729,3013,1,0,2,3016,A
2-PB1,730,2,1,0,3023,3026,C
2-PB1,731,16,3,2,2938,2959,C
2-PB1,732,14,0,1,2950,2965,C
2-PB1,733,4,17,2937,1,2959,G
2-PB1,734,1,10,2963,2,2976,G
2-PB1,735,1,10,2971,0,2982,G
2-PB1,736,2998,2,2,0,3002,A
2-PB1,737,1,2980,0,0,2981,T
2-PB1,738,2,3,2989,0,2994,G
2-PB1,739,1,1,1,2984,2987,C
2-PB1,740,3025,2,1,2,3030,A
2-PB1,741,3060,0,1,1,3062,A
2-PB1,742,3098,0,1,1,3100,A
2-PB1,743,0,3089,1,1,3091,T
2-PB1,744,0,3091,0,3,3094,T
2-PB1,745,3074,1,0,0,3075,A
2-PB1,746,4,12,3063,0,3079,G
2-PB1,747,3055,0,8,1,3064,A
2-PB1,748,1,12,3068,0,3081,G
2-PB1,749,0,21,3008,1,3030,G
2-PB1,750,2,2,3122,0,3126,G
2-PB1,751,0,3118,1,1,3120,T
2-PB1,752,0,3101,1,6,3108,T
2-PB1,753,14,1,0,3094,3109,C
2-PB1,754,6,1,3145,1,3153,G
2-PB1,755,1,3137,0,7,3145,T
2-PB1,756,2,2,3149,0,3153,G
2-PB1,757,0,3141,0,3,3144,T
2-PB1,758,3136,0,0,0,3136,A
2-PB1,759,3,0,0,3128,3131,C
2-PB1,760,0,2984,0,2,2986,T
2-PB1,761,0,2992,1,0,2993,T
2-PB1,762,9,2,0,2977,2988,C
2-PB1,763,0,1,2979,1,2981,G
2-PB1,764,1,2975,0,0,2976,T
2-PB1,765,1,2967,0,4,2972,T
2-PB1,766,0,6,2963,0,2969,G
2-PB1,767,2967,0,2,0,2969,A
2-PB1,768,2971,0,0,0,2971,A
2-PB1,769,2990,0,1,0,2991,A
2-PB1,770,3,0,0,3005,3008,C
2-PB1,771,0,2987,0,1,2988,T
2-PB1,772,0,2963,0,2,2965,T
2-PB1,773,1,2979,0,0,2980,T
2-PB1,774,3030,0,4,0,3034,A
2-PB1,775,1,1,3039,0,3041,G
2-PB1,776,1,0,0,3041,3042,C
2-PB1,777,0,3038,0,2,3040,T
2-PB1,778,3009,2,0,0,3011,A
2-PB1,779,0,3,2996,1,3000,G
2-PB1,780,2996,0,1,0,2997,A
2-PB1,781,2995,1,4,1,3001,A
2-PB1,782,2,0,3001,0,3003,G
2-PB1,783,2,1,1,2954,2958,C
2-PB1,784,2953,1,0,0,2954,A
2-PB1,785,0,2946,0,1,2947,T
2-PB1,786,0,2945,0,0,2945,T
2-PB1,787,0,2949,0,0,2949,T
2-PB1,788,4,3,2949,1,2957,G
2-PB1,789,3,7,0,2940,2950,C
2-PB1,790,3,3,2947,0,2953,G
2-PB1,791,2943,0,1,1,2945,A
2-PB1,792,2932,0,2,0,2934,A
2-PB1,793,2938,0,0,0,2938,A
2-PB1,794,3025,0,3,0,3028,A
2-PB1,795,3,0,3042,0,3045,G
2-PB1,796,0,0,0,3057,3057,C
2-PB1,797,1,3042,0,3,3046,T
2-PB1,798,1,3050,0,4,3055,T
2-PB1,799,0,9,3058,0,3067,G
2-PB1,800,3060,1,3,0,3064,A
2-PB1,801,3069,0,1,0,3070,A
2-PB1,802,1,0,0,3080,3081,C
2-PB1,803,2984,0,1,0,2985,A
2-PB1,804,0,3,3253,0,3256,G
2-PB1,805,0,3222,0,4,3226,T
2-PB1,806,11,0,0,3225,3236,C
2-PB1,807,1,3237,0,4,3242,T
2-PB1,808,0,6,3237,0,3243,G
2-PB1,809,2,6,3233,0,3241,G
2-PB1,810,3252,1,2,0,3255,A
2-PB1,811,5,1,0,3256,3262,C
2-PB1,812,0,3136,1,2,3139,T
2-PB1,813,0,2937,0,2,2939,T
2-PB1,814,4,1,0,2934,2939,C
2-PB1,815,10,1,0,2934,2945,C
2-PB1,816,2,12,2942,0,2956,G
2-PB1,817,2,1,2954,0,2957,G
2-PB1,818,0,2938,0,3,2941,T
2-PB1,819,0,2926,0,3,2929,T
2-PB1,820,0,10,2907,1,2918,G
2-PB1,821,1,13,2924,0,2938,G
2-PB1,822,1,11,2925,0,2937,G
2-PB1,823,1,14,2917,1,2933,G
2-PB1,824,1,0,2953,0,2954,G
2-PB1,825,1,2937,1,1,2940,T
2-PB1,826,2923,0,0,1,2924,A
2-PB1,827,2941,0,3,1,2945,A
2-PB1,828,1,2948,0,0,2949,T
2-PB1,829,1,6,2954,0,2961,G
2-PB1,830,2916,0,4,0,2920,A
2-PB1,831,2880,0,0,0,2880,A
2-PB1,832,2890,2,1,1,2894,A
2-PB1,833,2870,0,5,0,2875,A
2-PB1,834,2,4,2869,0,2875,G
2-PB1,835,2842,0,2,0,2844,A
2-PB1,836,2817,0,5,0,2822,A
2-PB1,837,0,4,2824,0,2828,G
2-PB1,838,2,3,2810,0,2815,G
2-PB1,839,3,0,0,2810,2813,C
2-PB1,840,7,0,0,2807,2814,C
2-PB1,841,2820,0,1,2,2823,A
2-PB1,842,2819,0,2,0,2821,A
2-PB1,843,2822,1,0,1,2824,A
2-PB1,844,4,0,0,2819,2823,C
2-PB1,845,0,2826,0,0,2826,T
2-PB1,846,1,8,2860,0,2869,G
2-PB1,847,1,0,2851,0,2852,G
2-PB1,848,2,0,0,2868,2870,C
2-PB1,849,2870,0,1,0,2871,A
2-PB1,850,2863,0,1,0,2864,A
2-PB1,851,2862,1,2,0,2865,A
2-PB1,852,0,2863,0,0,2863,T
2-PB1,853,1,2,2864,0,2867,G
2-PB1,854,0,2854,1,0,2855,T
2-PB1,855,0,2799,0,1,2800,T
2-PB1,856,2,3,2797,0,2802,G
2-PB1,857,0,2799,0,0,2799,T
2-PB1,858,4,12,2785,0,2801,G
2-PB1,859,2799,0,1,0,2800,A
2-PB1,860,0,6,2807,0,2813,G
2-PB1,861,2801,0,0,1,2802,A
2-PB1,862,2793,0,1,0,2794,A
2-PB1,863,2791,0,1,0,2792,A
2-PB1,864,2798,0,0,0,2798,A
2-PB1,865,2807,1,1,1,2810,A
2-PB1,866,0,2791,0,0,2791,T
2-PB1,867,0,5,2791,0,2796,G
2-PB1,868,2786,0,3,0,2789,A
2-PB1,869,0,2747,0,2,2749,T
2-PB1,870,1,4,2779,0,2784,G
2-PB1,871,2784,1,1,1,2787,A
2-PB1,872,1,3,0,2809,2813,C
2-PB1,873,1,2802,2,1,2806,T
2-PB1,874,2797,0,0,1,2798,A
2-PB1,875,2839,0,2,1,2842,A
2-PB1,876,0,2817,0,2,2819,T
2-PB1,877,0,2856,0,1,2857,T
2-PB1,878,12,0,0,2855,2867,C
2-PB1,879,2884,1,0,0,2885,A
2-PB1,880,1,2,0,2886,2889,C
2-PB1,881,2865,0,0,0,2865,A
2-PB1,882,2864,0,2,1,2867,A
2-PB1,883,7,7,2855,0,2869,G
2-PB1,884,2924,2,0,0,2926,A
2-PB1,885,5,2,0,2916,2923,C
2-PB1,886,2905,0,2,0,2907,A
2-PB1,887,2,1,1,2897,2901,C
2-PB1,888,2862,0,0,1,2863,A
2-PB1,889,3,4,2872,0,2879,G
2-PB1,890,2855,0,3,0,2858,A
2-PB1,891,0,1,2885,1,2887,G
2-PB1,892,0,0,0,2863,2863,C
2-PB1,893,0,2802,1,0,2803,T
2-PB1,894,0,2833,0,0,2833,T
2-PB1,895,1,2830,0,3,2834,T
2-PB1,896,6,0,0,2827,2833,C
2-PB1,897,1,2828,0,3,2832,T
2-PB1,898,0,2807,1,0,2808,T
2-PB1,899,0,2804,1,4,2809,T
2-PB1,900,8,1,1,2801,2811,C
2-PB1,901,2806,1,4,0,2811,A
2-PB1,902,1,0,1,2812,2814,C
2-PB1,903,2790,0,3,1,2794,A
2-PB1,904,2815,0,4,0,2819,A
2-PB1,905,0,2829,0,2,2831,T
2-PB1,906,11,0,0,2864,2875,C
2-PB1,907,2895,0,2,0,2897,A
2-PB1,908,3,0,0,2905,2908,C
2-PB1,909,0,2883,0,2,2885,T
2-PB1,910,4,4,2899,0,2907,G
2-PB1,911,4,27,2860,0,2891,G
2-PB1,912,1,17,2951,1,2970,G
2-PB1,913,0,5,2961,0,2966,G
2-PB1,914,2919,0,7,0,2926,A
2-PB1,915,2,1,0,2776,2779,C
2-PB1,916,2821,1,3,0,2825,A
2-PB1,917,3004,1,3,0,3008,A
2-PB1,918,5,0,0,3020,3025,C
2-PB1,919,3007,0,5,0,3012,A
2-PB1,920,5,0,0,2994,2999,C
2-PB1,921,1,2890,0,2,2893,T
2-PB1,922,2904,0,0,1,2905,A
2-PB1,923,2905,0,1,0,2906,A
2-PB1,924,0,2,2921,0,2923,G
2-PB1,925,1,2904,0,1,2906,T
2-PB1,926,0,10,2668,1,2679,G
2-PB1,927,0,5,2648,2,2655,G
2-PB1,928,2651,0,1,0,2652,A
2-PB1,929,2646,2,3,0,2651,A
2-PB1,930,0,2647,0,0,2647,T
2-PB1,931,0,10,2627,0,2637,G
2-PB1,932,2632,1,2,1,2636,A
2-PB1,933,2593,0,0,0,2593,A
2-PB1,934,2613,1,2,1,2617,A
2-PB1,935,2622,1,2,0,2625,A
2-PB1,936,0,2614,0,1,2615,T
2-PB1,937,9,1,0,2603,2613,C
2-PB1,938,2615,0,1,0,2616,A
2-PB1,939,2616,0,1,0,2617,A
2-PB1,940,2607,0,1,0,2608,A
2-PB1,941,2602,0,2,1,2605,A
2-PB1,942,2,1,0,2613,2616,C
2-PB1,943,11,1,1,2585,2598,C
2-PB1,944,8,1,0,2588,2597,C
2-PB1,945,3,2582,0,2,2587,T
2-PB1,946,4,2,0,2593,2599,C
2-PB1,947,1,5,2596,0,2602,G
2-PB1,948,2602,0,0,0,2602,A
2-PB1,949,2597,0,2,0,2599,A
2-PB1,950,0,2605,0,2,2607,T
2-PB1,951,0,0,2615,0,2615,G
2-PB1,952,0,2583,1,2,2586,T
2-PB1,953,1,2581,0,3,2585,T
2-PB1,954,0,2595,0,0,2595,T
2-PB1,955,0,2601,0,0,2601,T
2-PB1,956,0,2597,0,0,2597,T
2-PB1,957,0,9,2590,0,2599,G
2-PB1,958,0,4,2587,0,2591,G
2-PB1,959,2,0,0,2591,2593,C
2-PB1,960,1,2,2575,0,2578,G
2-PB1,961,2576,0,1,0,2577,A
2-PB1,962,0,2651,0,0,2651,T
2-PB1,963,0,6,2713,0,2719,G
2-PB1,964,2852,0,0,0,2852,A
2-PB1,965,0,2853,0,2,2855,T
2-PB1,966,0,2852,0,1,2853,T
2-PB1,967,2871,1,2,0,2874,A
2-PB1,968,2,1,0,2873,2876,C
2-PB1,969,2879,1,3,0,2883,A
2-PB1,970,0,2869,0,2,2871,T
2-PB1,971,2728,1,0,0,2729,A
2-PB1,972,6,0,0,2738,2744,C
2-PB1,973,2465,0,0,0,2465,A
2-PB1,974,0,2451,0,0,2451,T
2-PB1,975,11,0,0,2437,2448,C
2-PB1,976,2430,2,0,0,2432,A
2-PB1,977,3,1,0,2428,2432,C
2-PB1,978,2408,1,2,0,2411,A
2-PB1,979,2405,0,0,0,2405,A
2-PB1,980,2391,0,0,0,2391,A
2-PB1,981,0,9,2294,0,2303,G
2-PB1,982,2406,0,0,0,2406,A
2-PB1,983,2399,1,2,0,2402,A
2-PB1,984,0,2398,0,1,2399,T
2-PB1,985,10,0,1,2403,2414,C
2-PB1,986,2427,0,3,0,2430,A
2-PB1,987,2447,0,0,0,2447,A
2-PB1,988,5,0,0,2442,2447,C
2-PB1,989,8,1,0,2443,2452,C
2-PB1,990,0,2328,0,1,2329,T
2-PB1,991,0,7,2349,1,2357,G
2-PB1,992,2342,1,2,0,2345,A
2-PB1,993,1,2,2349,0,2352,G
2-PB1,994,0,2335,0,1,2336,T
2-PB1,995,3,9,2274,0,2286,G
2-PB1,996,1,3,2406,0,2410,G
2-PB1,997,0,2384,0,1,2385,T
2-PB1,998,0,2388,1,0,2389,T
2-PB1,999,6,1,0,2385,2392,C
2-PB1,1000,2354,1,1,0,2356,A
2-PB1,1001,0,5,2405,0,2410,G
2-PB1,1002,2408,0,1,0,2409,A
2-PB1,1003,2406,2,2,0,2410,A
2-PB1,1004,2397,0,1,0,2398,A
2-PB1,1005,1,0,0,2208,2209,C
2-PB1,1006,2230,0,0,0,2230,A
2-PB1,1007,0,2227,0,0,2227,T
2-PB1,1008,7,0,0,2237,2244,C
2-PB1,1009,4,0,0,2243,2247,C
2-PB1,1010,0,2188,1,0,2189,T
2-PB1,1011,0,9,2182,0,2191,G
2-PB1,1012,2179,0,1,0,2180,A
2-PB1,1013,1,1,2211,0,2213,G
2-PB1,1014,0,0,1,2199,2200,C
2-PB1,1015,2130,0,0,0,2130,A
2-PB1,1016,0,2141,0,1,2142,T
2-PB1,1017,11,2,0,2108,2121,C
2-PB1,1018,2,1,2121,0,2124,G
2-PB1,1019,2,3,0,2179,2184,C
2-PB1,1020,2189,1,2,0,2192,A
2-PB1,1021,4,0,0,2259,2263,C
2-PB1,1022,17,2,1,2244,2264,C
2-PB1,1023,2266,0,1,0,2267,A
2-PB1,1024,2303,0,1,0,2304,A
2-PB1,1025,0,2294,2,1,2297,T
2-PB1,1026,2301,0,0,0,2301,A
2-PB1,1027,2301,0,2,0,2303,A
2-PB1,1028,0,2218,0,0,2218,T
2-PB1,1029,0,1,2229,0,2230,G
2-PB1,1030,0,2177,0,0,2177,T
2-PB1,1031,0,2153,0,6,2159,T
2-PB1,1032,2,0,0,2161,2163,C
2-PB1,1033,0,2153,1,2,2156,T
2-PB1,1034,9,0,0,2151,2160,C
2-PB1,1035,2170,1,2,0,2173,A
2-PB1,1036,2168,1,0,0,2169,A
2-PB1,1037,2173,1,1,0,2175,A
2-PB1,1038,1,1,1,2168,2171,C
2-PB1,1039,2173,0,0,1,2174,A
2-PB1,1040,2175,0,0,0,2175,A
2-PB1,1041,2172,0,0,0,2172,A
2-PB1,1042,2180,0,3,1,2184,A
2-PB1,1043,0,2221,0,0,2221,T
2-PB1,1044,1,13,2207,0,2221,G
2-PB1,1045,0,4,2216,0,2220,G
2-PB1,1046,3,1,0,2213,2217,C
2-PB1,1047,2214,0,2,1,2217,A
2-PB1,1048,2221,0,4,0,2225,A
2-PB1,1049,0,9,2233,0,2242,G
2-PB1,1050,2240,0,2,0,2242,A
2-PB1,1051,2,0,0,2237,2239,C
2-PB1,1052,0,2221,0,0,2221,T
2-PB1,1053,3,7,2245,0,2255,G
2-PB1,1054,0,7,2250,1,2258,G
2-PB1,1055,1,5,2271,0,2277,G
2-PB1,1056,2274,0,4,0,2278,A
2-PB1,1057,2279,0,0,0,2279,A
2-PB1,1058,2259,0,0,0,2259,A
2-PB1,1059,2247,1,1,0,2249,A
2-PB1,1060,0,7,2299,0,2306,G
2-PB1,1061,1,6,2293,0,2300,G
2-PB1,1062,2288,0,1,0,2289,A
2-PB1,1063,1,2279,0,0,2280,T
2-PB1,1064,2269,0,2,0,2271,A
2-PB1,1065,1,2,0,2264,2267,C
2-PB1,1066,2279,0,1,0,2280,A
2-PB1,1067,0,2274,0,1,2275,T
2-PB1,1068,0,1,2293,0,2294,G
2-PB1,1069,1,2242,0,3,2246,T
2-PB1,1070,1,2241,0,1,2243,T
2-PB1,1071,5,3,0,2230,2238,C
2-PB1,1072,1,12,2232,0,2245,G
2-PB1,1073,2241,0,2,0,2243,A
2-PB1,1074,0,8,2286,0,2294,G
2-PB1,1075,2264,0,2,1,2267,A
2-PB1,1076,2,0,2298,1,2301,G
2-PB1,1077,0,2270,0,0,2270,T
2-PB1,1078,2268,1,1,0,2270,A
2-PB1,1079,2281,1,2,0,2284,A
2-PB1,1080,0,7,2287,0,2294,G
2-PB1,1081,2289,2,0,0,2291,A
2-PB1,1082,0,7,2315,0,2322,G
2-PB1,1083,2262,1,2,0,2265,A
2-PB1,1084,2283,1,3,1,2288,A
2-PB1,1085,0,2263,0,2,2265,T
2-PB1,1086,0,7,2255,0,2262,G
2-PB1,1087,2262,0,3,0,2265,A
2-PB1,1088,2242,0,4,0,2246,A
2-PB1,1089,0,1,2254,0,2255,G
2-PB1,1090,1,0,0,2243,2244,C
2-PB1,1091,1,2225,0,1,2227,T
2-PB1,1092,5,0,1,2225,2231,C
2-PB1,1093,11,0,0,2218,2229,C
2-PB1,1094,1,7,2229,0,2237,G
2-PB1,1095,2,2,2240,0,2244,G
2-PB1,1096,2255,0,0,0,2255,A
2-PB1,1097,1,0,0,2277,2278,C
2-PB1,1098,2284,0,1,0,2285,A
2-PB1,1099,4,0,0,2291,2295,C
2-PB1,1100,2287,1,1,0,2289,A
2-PB1,1101,2305,0,1,0,2306,A
2-PB1,1102,2300,0,0,0,2300,A
2-PB1,1103,0,2311,0,0,2311,T
2-PB1,1104,2319,1,0,0,2320,A
2-PB1,1105,2,0,0,2304,2306,C
2-PB1,1106,5,0,0,2296,2301,C
2-PB1,1107,0,2273,0,4,2277,T
2-PB1,1108,1,3,2303,0,2307,G
2-PB1,1109,1,0,0,2305,2306,C
2-PB1,1110,2310,0,2,0,2312,A
2-PB1,1111,0,2,2313,0,2315,G
2-PB1,1112,2303,1,1,1,2306,A
2-PB1,1113,2293,1,2,0,2296,A
2-PB1,1114,2302,0,0,1,2303,A
2-PB1,1115,0,2297,0,0,2297,T
2-PB1,1116,0,4,2306,0,2310,G
2-PB1,1117,1,1,0,2290,2292,C
2-PB1,1118,1,2292,0,2,2295,T
2-PB1,1119,2320,0,4,0,2324,A
2-PB1,1120,0,1,2320,0,2321,G
2-PB1,1121,2,0,0,2321,2323,C
2-PB1,1122,2325,1,2,0,2328,A
2-PB1,1123,2317,0,0,0,2317,A
2-PB1,1124,0,2,2302,0,2304,G
2-PB1,1125,0,0,0,2298,2298,C
2-PB1,1126,2265,1,0,0,2266,A
2-PB1,1127,0,2293,1,3,2297,T
2-PB1,1128,1,2306,0,0,2307,T
2-PB1,1129,2,7,2354,0,2363,G
2-PB1,1130,2389,2,0,0,2391,A
2-PB1,1131,2,0,0,2365,2367,C
2-PB1,1132,8,1,1,2379,2389,C
2-PB1,1133,1,2336,0,3,2340,T
2-PB1,1134,1,8,2366,0,2375,G
2-PB1,1135,2386,0,0,0,2386,A
2-PB1,1136,2381,0,0,0,2381,A
2-PB1,1137,3,1,2423,0,2427,G
2-PB1,1138,0,2335,0,0,2335,T
2-PB1,1139,2349,0,0,0,2349,A
2-PB1,1140,0,2323,0,2,2325,T
2-PB1,1141,2,2323,0,3,2328,T
2-PB1,1142,0,2325,0,1,2326,T
2-PB1,1143,5,0,0,2280,2285,C
2-PB1,1144,2289,0,2,0,2291,A
2-PB1,1145,2301,0,0,0,2301,A
2-PB1,1146,0,2272,0,0,2272,T
2-PB1,1147,0,14,2266,0,2280,G
2-PB1,1148,2271,0,0,0,2271,A
2-PB1,1149,2273,1,1,0,2275,A
2-PB1,1150,0,2255,0,3,2258,T
2-PB1,1151,7,1,2,2271,2281,C
2-PB1,1152,2273,0,7,0,2280,A
2-PB1,1153,2287,0,0,0,2287,A
2-PB1,1154,1,0,0,2280,2281,C
2-PB1,1155,2278,1,1,1,2281,A
2-PB1,1156,2270,0,0,0,2270,A
2-PB1,1157,1,10,2253,1,2265,G
2-PB1,1158,0,8,2269,0,2277,G
2-PB1,1159,2272,0,1,1,2274,A
2-PB1,1160,2276,0,1,0,2277,A
2-PB1,1161,0,6,2270,0,2276,G
2-PB1,1162,2266,0,1,0,2267,A
2-PB1,1163,2267,0,0,1,2268,A
2-PB1,1164,2265,0,1,1,2267,A
2-PB1,1165,2262,1,1,1,2265,A
2-PB1,1166,0,2246,0,0,2246,T
2-PB1,1167,1,2241,0,1,2243,T
2-PB1,1168,0,6,2244,0,2250,G
2-PB1,1169,2244,0,5,0,2249,A
2-PB1,1170,1,4,2247,0,2252,G
2-PB1,1171,2243,0,0,0,2243,A
2-PB1,1172,2270,0,1,0,2271,A
2-PB1,1173,2301,0,1,0,2302,A
2-PB1,1174,2303,0,1,0,2304,A
2-PB1,1175,1,2304,0,1,2306,T
2-PB1,1176,2307,0,1,0,2308,A
2-PB1,1177,2302,1,3,1,2307,A
2-PB1,1178,1,4,2305,0,2310,G
2-PB1,1179,3,1,2312,0,2316,G
2-PB1,1180,4,0,0,2288,2292,C
2-PB1,1181,8,1,0,2282,2291,C
2-PB1,1182,0,2299,0,3,2302,T
2-PB1,1183,4,0,0,2574,2578,C
2-PB1,1184,1,2607,0,4,2612,T
2-PB1,1185,1,2611,0,0,2612,T
2-PB1,1186,7,1,0,2666,2674,C
2-PB1,1187,1,2657,0,0,2658,T
2-PB1,1188,2672,0,0,0,2672,A
2-PB1,1189,2675,1,1,0,2677,A
2-PB1,1190,0,2671,0,0,2671,T
2-PB1,1191,2702,0,0,0,2702,A
2-PB1,1192,0,10,2642,0,2652,G
2-PB1,1193,2439,0,1,0,2440,A
2-PB1,1194,0,2444,0,0,2444,T
2-PB1,1195,0,16,2386,0,2402,G
2-PB1,1196,3,1,2444,1,2449,G
2-PB1,1197,1,0,0,2424,2425,C
2-PB1,1198,2458,1,1,0,2460,A
2-PB1,1199,1,0,0,2458,2459,C
2-PB1,1200,2425,0,2,0,2427,A
2-PB1,1201,0,2,2498,0,2500,G
2-PB1,1202,1,0,0,2494,2495,C
2-PB1,1203,2493,1,4,0,2498,A
2-PB1,1204,1,2546,0,1,2548,T
2-PB1,1205,6,0,1,2506,2513,C
2-PB1,1206,2530,0,5,0,2535,A
2-PB1,1207,0,2528,0,1,2529,T
2-PB1,1208,0,2516,0,1,2517,T
2-PB1,1209,4,5,2502,1,2512,G
2-PB1,1210,2426,0,1,1,2428,A
2-PB1,1211,1,1,2503,0,2505,G
2-PB1,1212,5,1,0,2489,2495,C
2-PB1,1213,8,1,0,2455,2464,C
2-PB1,1214,8,1,1,2493,2503,C
2-PB1,1215,3,2487,0,4,2494,T
2-PB1,1216,1,8,2650,0,2659,G
2-PB1,1217,0,3,2707,0,2710,G
2-PB1,1218,2703,1,3,0,2707,A
2-PB1,1219,2772,0,2,0,2774,A
2-PB1,1220,0,2689,0,2,2691,T
2-PB1,1221,0,6,2770,1,2777,G
2-PB1,1222,2823,0,0,0,2823,A
2-PB1,1223,0,2822,0,1,2823,T
2-PB1,1224,0,8,2824,0,2832,G
2-PB1,1225,2799,0,1,0,2800,A
2-PB1,1226,0,2760,0,0,2760,T
2-PB1,1227,4,12,2742,0,2758,G
2-PB1,1228,10,10,2784,0,2804,G
2-PB1,1229,1,1,2813,0,2815,G
2-PB1,1230,2,1,0,2786,2789,C
2-PB1,1231,2797,0,1,0,2798,A
2-PB1,1232,0,2812,0,1,2813,T
2-PB1,1233,5,3,2880,0,2888,G
2-PB1,1234,0,2887,0,7,2894,T
2-PB1,1235,2,2899,0,3,2904,T
2-PB1,1236,16,1,0,2894,2911,C
2-PB1,1237,2901,1,3,1,2906,A
2-PB1,1238,2916,0,1,1,2918,A
2-PB1,1239,3,0,0,2915,2918,C
2-PB1,1240,2934,1,1,1,2937,A
2-PB1,1241,1,2944,0,4,2949,T
2-PB1,1242,1,0,2999,0,3000,G
2-PB1,1243,3,0,0,2995,2998,C
2-PB1,1244,0,3001,0,3,3004,T
2-PB1,1245,3034,0,1,0,3035,A
2-PB1,1246,3026,0,2,1,3029,A
2-PB1,1247,0,5,3082,0,3087,G
2-PB1,1248,1,3086,0,1,3088,T
2-PB1,1249,3075,0,0,0,3075,A
2-PB1,1250,1,4,0,3083,3088,C
2-PB1,1251,2,24,3075,0,3101,G
2-PB1,1252,0,5,3291,0,3296,G
2-PB1,1253,0,3295,0,1,3296,T
2-PB1,1254,0,3283,0,1,3284,T
2-PB1,1255,1,3282,0,1,3284,T
2-PB1,1256,0,3260,2,1,3263,T
2-PB1,1257,3259,0,1,0,3260,A
2-PB1,1258,0,12,3247,2,3261,G
2-PB1,1259,1,15,3239,0,3255,G
2-PB1,1260,3199,1,5,0,3205,A
2-PB1,1261,0,1,3180,0,3181,G
2-PB1,1262,0,3217,0,1,3218,T
2-PB1,1263,9,2,0,3221,3232,C
2-PB1,1264,0,3225,0,7,3232,T
2-PB1,1265,9,0,0,3226,3235,C
2-PB1,1266,0,12,3230,0,3242,G
2-PB1,1267,3337,1,0,0,3338,A
2-PB1,1268,0,3345,0,1,3346,T
2-PB1,1269,3362,0,3,1,3366,A
2-PB1,1270,8,0,1,3359,3368,C
2-PB1,1271,2,3313,0,3,3318,T
2-PB1,1272,2,9,3323,0,3334,G
2-PB1,1273,3319,2,0,1,3322,A
2-PB1,1274,3378,0,0,1,3379,A
2-PB1,1275,1,3371,0,4,3376,T
2-PB1,1276,9,1,0,3304,3314,C
2-PB1,1277,0,3300,0,1,3301,T
2-PB1,1278,0,3286,1,1,3288,T
2-PB1,1279,1,9,3279,1,3290,G
2-PB1,1280,1,5,3291,1,3298,G
2-PB1,1281,3284,0,5,0,3289,A
2-PB1,1282,0,0,1,3302,3303,C
2-PB1,1283,3255,0,1,0,3256,A
2-PB1,1284,3279,0,0,0,3279,A
2-PB1,1285,3282,0,1,0,3283,A
2-PB1,1286,3289,0,6,0,3295,A
2-PB1,1287,0,3,3349,0,3352,G
2-PB1,1288,3357,0,1,0,3358,A
2-PB1,1289,3349,1,1,1,3352,A
2-PB1,1290,3361,2,1,0,3364,A
2-PB1,1291,0,3364,0,1,3365,T
2-PB1,1292,3371,0,5,0,3376,A
2-PB1,1293,2,0,0,3470,3472,C
2-PB1,1294,3446,0,5,0,3451,A
2-PB1,1295,6,0,0,3463,3469,C
2-PB1,1296,22,1,1,3394,3418,C
2-PB1,1297,3429,1,0,0,3430,A
2-PB1,1298,3471,0,2,0,3473,A
2-PB1,1299,0,11,3558,0,3569,G
2-PB1,1300,3603,3,4,0,3610,A
2-PB1,1301,2,1,0,3627,3630,C
2-PB1,1302,3557,0,0,1,3558,A
2-PB1,1303,3690,1,2,0,3693,A
2-PB1,1304,4,1,1,3698,3704,C
2-PB1,1305,3771,0,3,1,3775,A
2-PB1,1306,0,3784,1,0,3785,T
2-PB1,1307,3772,0,2,0,3774,A
2-PB1,1308,8,1,0,3819,3828,C
2-PB1,1309,0,3731,3,2,3736,T
2-PB1,1310,0,16,3774,0,3790,G
2-PB1,1311,1,9,3782,0,3792,G
2-PB1,1312,1,3718,0,1,3720,T
2-PB1,1313,0,22,3683,0,3705,G
2-PB1,1314,1,12,3656,0,3669,G
2-PB1,1315,0,6,3678,0,3684,G
2-PB1,1316,3677,0,4,0,3681,A
2-PB1,1317,1,3615,0,4,3620,T
2-PB1,1318,2,19,3593,0,3614,G
2-PB1,1319,1,11,3567,0,3579,G
2-PB1,1320,2,0,3595,1,3598,G
2-PB1,1321,2,1,1,3645,3649,C
2-PB1,1322,0,3633,0,5,3638,T
2-PB1,1323,13,0,0,3641,3654,C
2-PB1,1324,13,3,0,3629,3645,C
2-PB1,1325,3659,0,0,0,3659,A
2-PB1,1326,3664,0,1,0,3665,A
2-PB1,1327,0,3648,0,0,3648,T
2-PB1,1328,11,0,0,3635,3646,C
2-PB1,1329,8,0,0,3609,3617,C
2-PB1,1330,1,3586,0,3,3590,T
2-PB1,1331,10,0,0,3581,3591,C
2-PB1,1332,8,1,0,3572,3581,C
2-PB1,1333,3,8,3573,0,3584,G
2-PB1,1334,3585,1,0,0,3586,A
2-PB1,1335,2,7,0,3575,3584,C
2-PB1,1336,2,7,3581,0,3590,G
2-PB1,1337,3614,0,0,0,3614,A
2-PB1,1338,0,3606,0,1,3607,T
2-PB1,1339,1,3593,0,1,3595,T
2-PB1,1340,1,3585,0,1,3587,T
2-PB1,1341,0,3599,0,1,3600,T
2-PB1,1342,0,2,3605,1,3608,G
2-PB1,1343,3,3,0,3633,3639,C
2-PB1,1344,17,0,0,3623,3640,C
2-PB1,1345,17,1,1,3748,3767,C
2-PB1,1346,1,3707,0,6,3714,T
2-PB1,1347,8,0,0,3862,3870,C
2-PB1,1348,3902,0,0,0,3902,A
2-PB1,1349,1,3910,0,5,3916,T
2-PB1,1350,3910,1,1,1,3913,A
2-PB1,1351,1,3,3944,0,3948,G
2-PB1,1352,1,3901,0,2,3904,T
2-PB1,1353,1,13,3912,0,3926,G
2-PB1,1354,3816,1,2,1,3820,A
2-PB1,1355,3816,0,2,0,3818,A
2-PB1,1356,0,3651,0,0,3651,T
2-PB1,1357,0,1,3637,1,3639,G
2-PB1,1358,2,2,0,3666,3670,C
2-PB1,1359,3676,0,1,0,3677,A
2-PB1,1360,8,1,0,3655,3664,C
2-PB1,1361,27,1,0,3627,3655,C
2-PB1,1362,3634,1,0,0,3635,A
2-PB1,1363,3635,0,1,1,3637,A
2-PB1,1364,3629,0,0,2,3631,A
2-PB1,1365,0,3538,0,0,3538,T
2-PB1,1366,14,0,1,3609,3624,C
2-PB1,1367,3634,1,2,0,3637,A
2-PB1,1368,0,3635,0,2,3637,T
2-PB1,1369,0,8,3637,0,3645,G
2-PB1,1370,3635,0,5,0,3640,A
2-PB1,1371,0,13,3648,0,3661,G
2-PB1,1372,2,9,3638,0,3649,G
2-PB1,1373,6,13,3634,0,3653,G
2-PB1,1374,3621,0,7,0,3628,A
2-PB1,1375,3685,0,1,0,3686,A
2-PB1,1376,0,3692,0,2,3694,T
2-PB1,1377,3703,0,0,0,3703,A
2-PB1,1378,5,1,0,3703,3709,C
2-PB1,1379,3710,0,2,0,3712,A
2-PB1,1380,3694,3,4,0,3701,A
2-PB1,1381,3,3,3682,0,3688,G
2-PB1,1382,5,2,0,3654,3661,C
2-PB1,1383,3643,0,0,1,3644,A
2-PB1,1384,2,9,3673,0,3684,G
2-PB1,1385,0,12,3668,1,3681,G
2-PB1,1386,3649,2,1,0,3652,A
2-PB1,1387,1,8,3670,1,3680,G
2-PB1,1388,0,3613,0,1,3614,T
2-PB1,1389,1,9,3647,0,3657,G
2-PB1,1390,1,12,3649,0,3662,G
2-PB1,1391,3652,0,4,0,3656,A
2-PB1,1392,1,3653,0,2,3656,T
2-PB1,1393,3597,0,3,1,3601,A
2-PB1,1394,1,8,3635,0,3644,G
2-PB1,1395,3661,1,1,1,3664,A
2-PB1,1396,1,3665,1,1,3668,T
2-PB1,1397,0,3649,1,1,3651,T
2-PB1,1398,7,1,0,3751,3759,C
2-PB1,1399,1,3731,0,0,3732,T
2-PB1,1400,3736,1,1,0,3738,A
2-PB1,1401,1,0,0,3723,3724,C
2-PB1,1402,3662,0,3,0,3665,A
2-PB1,1403,0,13,3664,0,3677,G
2-PB1,1404,1,14,3587,0,3602,G
2-PB1,1405,3650,0,2,0,3652,A
2-PB1,1406,5,1,0,3612,3618,C
2-PB1,1407,12,1,0,3556,3569,C
2-PB1,1408,0,3527,1,6,3534,T
2-PB1,1409,2,2,3532,0,3536,G
2-PB1,1410,4,3,1,3516,3524,C
2-PB1,1411,3542,0,2,0,3544,A
2-PB1,1412,3553,1,3,2,3559,A
2-PB1,1413,2,3,3563,0,3568,G
2-PB1,1414,0,3499,0,1,3500,T
2-PB1,1415,0,3496,0,1,3497,T
2-PB1,1416,3446,1,1,0,3448,A
2-PB1,1417,1,4,3452,0,3457,G
2-PB1,1418,1,3434,0,1,3436,T
2-PB1,1419,1,19,3421,0,3441,G
2-PB1,1420,1,11,3409,0,3421,G
2-PB1,1421,3,11,3446,0,3460,G
2-PB1,1422,3430,4,1,0,3435,A
2-PB1,1423,3449,0,0,0,3449,A
2-PB1,1424,1,3431,0,2,3434,T
2-PB1,1425,12,1,0,3426,3439,C
2-PB1,1426,3434,0,4,1,3439,A
2-PB1,1427,3443,1,6,1,3451,A
2-PB1,1428,3,0,0,3441,3444,C
2-PB1,1429,3444,0,0,0,3444,A
2-PB1,1430,1,3385,0,0,3386,T
2-PB1,1431,2,17,3372,0,3391,G
2-PB1,1432,3393,0,6,1,3400,A
2-PB1,1433,2,3,3408,0,3413,G
2-PB1,1434,3,4,0,3393,3400,C
2-PB1,1435,3396,0,2,1,3399,A
2-PB1,1436,3403,2,1,2,3408,A
2-PB1,1437,3391,1,5,1,3398,A
2-PB1,1438,3422,0,6,1,3429,A
2-PB1,1439,3428,0,1,0,3429,A
2-PB1,1440,0,5,3426,0,3431,G
2-PB1,1441,3382,0,2,1,3385,A
2-PB1,1442,3360,1,2,1,3364,A
2-PB1,1443,0,0,3469,0,3469,G
2-PB1,1444,1,3460,0,1,3462,T
2-PB1,1445,16,0,0,3425,3441,C
2-PB1,1446,13,0,0,3455,3468,C
2-PB1,1447,1,3459,0,1,3461,T
2-PB1,1448,3503,0,3,0,3506,A
2-PB1,1449,1,3496,0,0,3497,T
2-PB1,1450,3492,0,5,0,3497,A
2-PB1,1451,1,3497,0,0,3498,T
2-PB1,1452,3416,0,0,0,3416,A
2-PB1,1453,3413,0,0,0,3413,A
2-PB1,1454,3418,0,0,0,3418,A
2-PB1,1455,0,3402,1,0,3403,T
2-PB1,1456,3381,0,0,0,3381,A
2-PB1,1457,3373,1,2,0,3376,A
2-PB1,1458,3386,0,2,0,3388,A
2-PB1,1459,3398,1,2,1,3402,A
2-PB1,1460,3,2,0,3398,3403,C
2-PB1,1461,3253,0,4,0,3257,A
2-PB1,1462,1,12,3239,0,3252,G
2-PB1,1463,0,14,3226,0,3240,G
2-PB1,1464,0,10,3252,0,3262,G
2-PB1,1465,3255,0,6,0,3261,A
2-PB1,1466,2,0,0,3264,3266,C
2-PB1,1467,3248,0,2,0,3250,A
2-PB1,1468,1,3257,0,1,3259,T
2-PB1,1469,0,3256,1,1,3258,T
2-PB1,1470,0,3272,0,0,3272,T
2-PB1,1471,0,8,3255,1,3264,G
2-PB1,1472,3255,0,4,0,3259,A
2-PB1,1473,3267,0,0,0,3267,A
2-PB1,1474,0,3259,0,1,3260,T
2-PB1,1475,0,3189,0,0,3189,T
2-PB1,1476,15,0,0,3205,3220,C
2-PB1,1477,3188,1,2,1,3192,A
2-PB1,1478,3,0,0,3193,3196,C
2-PB1,1479,0,3184,0,7,3191,T
2-PB1,1480,3192,0,3,0,3195,A
2-PB1,1481,1,2,3191,0,3194,G
2-PB1,1482,0,3,0,3183,3186,C
2-PB1,1483,1,3156,0,5,3162,T
2-PB1,1484,1,3191,0,1,3193,T
2-PB1,1485,0,3181,0,4,3185,T
2-PB1,1486,1,3184,0,1,3186,T
2-PB1,1487,0,3188,0,0,3188,T
2-PB1,1488,0,3180,1,2,3183,T
2-PB1,1489,0,3177,0,2,3179,T
2-PB1,1490,3181,0,0,0,3181,A
2-PB1,1491,0,3169,0,0,3169,T
2-PB1,1492,7,0,0,3167,3174,C
2-PB1,1493,0,11,3182,0,3193,G
2-PB1,1494,3293,1,0,0,3294,A
2-PB1,1495,1,3286,0,1,3288,T
2-PB1,1496,3300,2,2,0,3304,A
2-PB1,1497,2,3319,0,0,3321,T
2-PB1,1498,9,10,3284,0,3303,G
2-PB1,1499,0,7,3314,0,3321,G
2-PB1,1500,3320,0,3,0,3323,A
2-PB1,1501,1,3298,0,0,3299,T
2-PB1,1502,0,3276,0,1,3277,T
2-PB1,1503,0,3193,1,1,3195,T
2-PB1,1504,0,3,3202,0,3205,G
2-PB1,1505,1,3192,0,1,3194,T
2-PB1,1506,1,9,3171,0,3181,G
2-PB1,1507,1,5,3179,0,3185,G
2-PB1,1508,0,0,1,3151,3152,C
2-PB1,1509,0,3148,1,2,3151,T
2-PB1,1510,3161,0,1,0,3162,A
2-PB1,1511,3181,0,1,0,3182,A
2-PB1,1512,0,3197,0,0,3197,T
2-PB1,1513,0,3194,0,3,3197,T
2-PB1,1514,0,3205,0,0,3205,T
2-PB1,1515,0,3207,1,1,3209,T
2-PB1,1516,3205,0,2,0,3207,A
2-PB1,1517,0,2,3219,0,3221,G
2-PB1,1518,2,3,0,3203,3208,C
2-PB1,1519,3204,1,4,0,3209,A
2-PB1,1520,0,3179,0,1,3180,T
2-PB1,1521,4,12,3128,0,3144,G
2-PB1,1522,0,10,3175,0,3185,G
2-PB1,1523,3179,0,2,0,3181,A
2-PB1,1524,2,1,3179,0,3182,G
2-PB1,1525,2,3,0,3168,3173,C
2-PB1,1526,0,3122,0,1,3123,T
2-PB1,1527,0,2,3147,0,3149,G
2-PB1,1528,3,2,2,3137,3144,C
2-PB1,1529,13,0,0,3107,3120,C
2-PB1,1530,13,1,0,3132,3146,C
2-PB1,1531,3051,1,2,0,3054,A
2-PB1,1532,1,1,3176,0,3178,G
2-PB1,1533,0,3182,1,1,3184,T
2-PB1,1534,0,3181,0,0,3181,T
2-PB1,1535,1,3172,1,1,3175,T
2-PB1,1536,1,3137,1,2,3141,T
2-PB1,1537,4,12,3106,0,3122,G
2-PB1,1538,2,16,3118,0,3136,G
2-PB1,1539,3126,0,5,0,3131,A
2-PB1,1540,5,1,3125,0,3131,G
2-PB1,1541,1,2909,0,0,2910,T
2-PB1,1542,2903,1,2,0,2906,A
2-PB1,1543,1,2996,0,3,3000,T
2-PB1,1544,5,0,0,3002,3007,C
2-PB1,1545,1,3004,0,0,3005,T
2-PB1,1546,1,8,3010,0,3019,G
2-PB1,1547,0,2,3037,0,3039,G
2-PB1,1548,3033,0,0,0,3033,A
2-PB1,1549,3049,1,2,1,3053,A
2-PB1,1550,0,3033,1,1,3035,T
2-PB1,1551,2930,0,2,1,2933,A
2-PB1,1552,2928,1,2,1,2932,A
2-PB1,1553,2924,0,0,1,2925,A
2-PB1,1554,0,2,0,2937,2939,C
2-PB1,1555,4,11,2885,1,2901,G
2-PB1,1556,2875,0,1,0,2876,A
2-PB1,1557,1,2,2874,0,2877,G
2-PB1,1558,1,2860,0,2,2863,T
2-PB1,1559,16,0,0,2880,2896,C
2-PB1,1560,2880,0,8,0,2888,A
2-PB1,1561,0,0,2922,0,2922,G
2-PB1,1562,1,1,0,2913,2915,C
2-PB1,1563,2,2878,1,32,2913,T
2-PB1,1564,0,6,3000,0,3006,G
2-PB1,1565,2991,0,1,0,2992,A
2-PB1,1566,0,2982,0,1,2983,T
2-PB1,1567,2985,0,1,0,2986,A
2-PB1,1568,0,2921,0,0,2921,T
2-PB1,1569,1,9,2921,0,2931,G
2-PB1,1570,2823,1,5,0,2829,A
2-PB1,1571,1,1,2864,0,2866,G
2-PB1,1572,0,2,0,2869,2871,C
2-PB1,1573,2713,1,1,0,2715,A
2-PB1,1574,0,2716,0,1,2717,T
2-PB1,1575,0,2709,0,2,2711,T
2-PB1,1576,2,9,2728,1,2740,G
2-PB1,1577,0,14,2828,0,2842,G
2-PB1,1578,2783,0,5,0,2788,A
2-PB1,1579,0,0,2792,0,2792,G
2-PB1,1580,0,2681,0,3,2684,T
2-PB1,1581,2671,0,0,0,2671,A
2-PB1,1582,2665,0,3,0,2668,A
2-PB1,1583,2,1,0,2675,2678,C
2-PB1,1584,2654,0,0,0,2654,A
2-PB1,1585,0,0,2694,0,2694,G
2-PB1,1586,0,2388,0,1,2389,T
2-PB1,1587,0,13,2395,0,2408,G
2-PB1,1588,2440,0,2,0,2442,A
2-PB1,1589,2,2429,0,1,2432,T
2-PB1,1590,2425,0,1,0,2426,A
2-PB1,1591,2421,0,0,0,2421,A
2-PB1,1592,2337,0,6,0,2343,A
2-PB1,1593,0,9,2366,0,2375,G
2-PB1,1594,2268,2,1,0,2271,A
2-PB1,1595,2266,0,2,0,2268,A
2-PB1,1596,1,0,0,2274,2275,C
2-PB1,1597,2181,0,1,0,2182,A
2-PB1,1598,2198,0,3,0,2201,A
2-PB1,1599,3,0,0,2201,2204,C
2-PB1,1600,2215,0,0,0,2215,A
2-PB1,1601,1,2212,4,1,2218,T
2-PB1,1602,0,6,2173,1,2180,G
2-PB1,1603,2173,1,4,0,2178,A
2-PB1,1604,0,2178,0,1,2179,T
2-PB1,1605,2154,1,0,0,2155,A
2-PB1,1606,2166,1,3,0,2170,A
2-PB1,1607,2163,0,3,0,2166,A
2-PB1,1608,0,2,0,2174,2176,C
2-PB1,1609,2087,0,0,0,2087,A
2-PB1,1610,2081,0,0,2,2083,A
2-PB1,1611,0,2043,0,2,2045,T
2-PB1,1612,0,10,2037,0,2047,G
2-PB1,1613,2090,1,3,0,2094,A
2-PB1,1614,5,0,0,2103,2108,C
2-PB1,1615,5,1,0,2065,2071,C
2-PB1,1616,0,2016,0,2,2018,T
2-PB1,1617,0,1984,0,0,1984,T
2-PB1,1618,0,8,1979,0,1987,G
2-PB1,1619,2,5,1994,0,2001,G
2-PB1,1620,2023,0,3,0,2026,A
2-PB1,1621,0,2,0,2014,2016,C
2-PB1,1622,10,1,0,1987,1998,C
2-PB1,1623,1976,0,3,0,1979,A
2-PB1,1624,2,2,2007,0,2011,G
2-PB1,1625,1,0,0,2012,2013,C
2-PB1,1626,2019,1,1,0,2021,A
2-PB1,1627,2019,0,0,0,2019,A
2-PB1,1628,3,0,0,2008,2011,C
2-PB1,1629,1999,0,0,0,1999,A
2-PB1,1630,1,0,2047,0,2048,G
2-PB1,1631,2,1,0,2031,2034,C
2-PB1,1632,6,2,0,2032,2040,C
2-PB1,1633,7,1,0,2032,2040,C
2-PB1,1634,2045,1,0,0,2046,A
2-PB1,1635,2047,0,0,0,2047,A
2-PB1,1636,2044,0,1,0,2045,A
2-PB1,1637,0,2045,0,2,2047,T
2-PB1,1638,0,3,2033,0,2036,G
2-PB1,1639,0,0,2001,0,2001,G
2-PB1,1640,2,0,0,2021,2023,C
2-PB1,1641,0,1998,0,6,2004,T
2-PB1,1642,8,0,0,2044,2052,C
2-PB1,1643,2,2052,0,6,2060,T
2-PB1,1644,7,2,0,2055,2064,C
2-PB1,1645,5,2,1,2067,2075,C
2-PB1,1646,2084,0,0,0,2084,A
2-PB1,1647,2084,0,0,0,2084,A
2-PB1,1648,0,2070,0,3,2073,T
2-PB1,1649,0,2048,0,1,2049,T
2-PB1,1650,0,3,2058,0,2061,G
2-PB1,1651,1,2020,0,0,2021,T
2-PB1,1652,0,2015,0,1,2016,T
2-PB1,1653,15,1,0,1995,2011,C
2-PB1,1654,2017,0,1,0,2018,A
2-PB1,1655,0,2011,0,3,2014,T
2-PB1,1656,6,0,0,2012,2018,C
2-PB1,1657,2027,0,2,0,2029,A
2-PB1,1658,2020,0,0,1,2021,A
2-PB1,1659,2021,0,5,0,2026,A
2-PB1,1660,0,7,2070,0,2077,G
2-PB1,1661,2072,0,0,0,2072,A
2-PB1,1662,0,2083,0,0,2083,T
2-PB1,1663,0,2080,0,0,2080,T
2-PB1,1664,2089,0,2,1,2092,A
2-PB1,1665,2,2,0,2123,2127,C
2-PB1,1666,2114,0,1,0,2115,A
2-PB1,1667,0,7,2132,0,2139,G
2-PB1,1668,2139,0,2,1,2142,A
2-PB1,1669,0,2174,0,2,2176,T
2-PB1,1670,2178,2,0,0,2180,A
2-PB1,1671,3,1,0,2303,2307,C
2-PB1,1672,2333,1,2,0,2336,A
2-PB1,1673,3,3,0,2470,2476,C
2-PB1,1674,2438,0,1,0,2439,A
2-PB1,1675,0,2453,0,0,2453,T
2-PB1,1676,2433,1,0,0,2434,A
2-PB1,1677,1,2425,0,1,2427,T
2-PB1,1678,2361,0,2,0,2363,A
2-PB1,1679,1,11,2350,0,2362,G
2-PB1,1680,1,2,2329,0,2332,G
2-PB1,1681,1,2242,0,0,2243,T
2-PB1,1682,0,4,2206,0,2210,G
2-PB1,1683,2,0,0,2290,2292,C
2-PB1,1684,9,0,1,2267,2277,C
2-PB1,1685,2313,2,1,1,2317,A
2-PB1,1686,0,2319,0,0,2319,T
2-PB1,1687,2326,0,0,1,2327,A
2-PB1,1688,0,4,2331,0,2335,G
2-PB1,1689,2278,1,4,0,2283,A
2-PB1,1690,1,8,2274,1,2284,G
2-PB1,1691,0,10,2275,0,2285,G
2-PB1,1692,2186,2,3,0,2191,A
2-PB1,1693,0,7,2202,0,2209,G
2-PB1,1694,2187,0,6,0,2193,A
2-PB1,1695,0,0,1,2194,2195,C
2-PB1,1696,2173,0,7,0,2180,A
2-PB1,1697,2,0,0,2197,2199,C
2-PB1,1698,2204,2,1,0,2207,A
2-PB1,1699,0,2,0,2205,2207,C
2-PB1,1700,2179,0,3,0,2182,A
2-PB1,1701,2201,0,1,0,2202,A
2-PB1,1702,2218,0,0,0,2218,A
2-PB1,1703,1,2212,1,2,2216,T
2-PB1,1704,3,0,0,2214,2217,C
2-PB1,1705,6,1,1,2216,2224,C
2-PB1,1706,2201,0,0,0,2201,A
2-PB1,1707,0,8,2202,0,2210,G
2-PB1,1708,2215,0,1,0,2216,A
2-PB1,1709,1,2,0,2227,2230,C
2-PB1,1710,7,8,2199,0,2214,G
2-PB1,1711,2192,1,1,2,2196,A
2-PB1,1712,0,5,2195,0,2200,G
2-PB1,1713,2199,0,3,0,2202,A
2-PB1,1714,2193,0,3,0,2196,A
2-PB1,1715,0,7,2195,0,2202,G
2-PB1,1716,2193,1,0,0,2194,A
2-PB1,1717,0,2186,0,1,2187,T
2-PB1,1718,9,1,1,2156,2167,C
2-PB1,1719,2184,0,1,0,2185,A
2-PB1,1720,2,2178,0,0,2180,T
2-PB1,1721,1,2178,0,0,2179,T
2-PB1,1722,8,1,0,2169,2178,C
2-PB1,1723,2,5,2176,1,2184,G
2-PB1,1724,2162,0,1,1,2164,A
2-PB1,1725,0,4,2168,1,2173,G
2-PB1,1726,2158,0,3,0,2161,A
2-PB1,1727,0,2222,0,0,2222,T
2-PB1,1728,2223,0,0,0,2223,A
2-PB1,1729,2227,1,0,0,2228,A
2-PB1,1730,2226,0,3,0,2229,A
2-PB1,1731,2,0,2230,0,2232,G
2-PB1,1732,2230,0,0,0,2230,A
2-PB1,1733,2187,1,0,0,2188,A
2-PB1,1734,0,0,2198,0,2198,G
2-PB1,1735,2,1,0,2192,2195,C
2-PB1,1736,0,2182,0,0,2182,T
2-PB1,1737,0,0,2194,0,2194,G
2-PB1,1738,2,2184,0,0,2186,T
2-PB1,1739,1,10,2160,1,2172,G
2-PB1,1740,0,10,2167,0,2177,G
2-PB1,1741,0,12,2194,0,2206,G
2-PB1,1742,2205,0,5,0,2210,A
2-PB1,1743,0,2188,0,2,2190,T
2-PB1,1744,7,1,0,2170,2178,C
2-PB1,1745,2175,1,0,1,2177,A
2-PB1,1746,2184,0,6,0,2190,A
2-PB1,1747,2195,2,2,0,2199,A
2-PB1,1748,2,0,0,2186,2188,C
2-PB1,1749,9,0,0,2173,2182,C
2-PB1,1750,10,0,0,2179,2189,C
2-PB1,1751,2186,1,0,0,2187,A
2-PB1,1752,2221,1,1,0,2223,A
2-PB1,1753,0,2205,0,0,2205,T
2-PB1,1754,7,0,0,2216,2223,C
2-PB1,1755,2190,1,2,0,2193,A
2-PB1,1756,2181,0,3,0,2184,A
2-PB1,1757,1,13,2208,1,2223,G
2-PB1,1758,0,6,2208,0,2214,G
2-PB1,1759,0,2,2206,0,2208,G
2-PB1,1760,0,1,0,2206,2207,C
2-PB1,1761,2173,0,4,0,2177,A
2-PB1,1762,0,5,2215,0,2220,G
2-PB1,1763,2,6,2224,1,2233,G
2-PB1,1764,2244,2,3,0,2249,A
2-PB1,1765,1,0,0,2280,2281,C
2-PB1,1766,0,2230,1,1,2232,T
2-PB1,1767,2290,1,3,0,2294,A
2-PB1,1768,0,2284,1,3,2288,T
2-PB1,1769,0,2285,1,1,2287,T
2-PB1,1770,2,19,2257,0,2278,G
2-PB1,1771,1,3,2309,0,2313,G
2-PB1,1772,1,2293,0,2,2296,T
2-PB1,1773,2297,0,1,0,2298,A
2-PB1,1774,0,2256,1,1,2258,T
2-PB1,1775,3,0,0,2273,2276,C
2-PB1,1776,2217,0,0,0,2217,A
2-PB1,1777,0,2,2235,0,2237,G
2-PB1,1778,2237,0,2,0,2239,A
2-PB1,1779,0,2219,1,0,2220,T
2-PB1,1780,1,8,2138,0,2147,G
2-PB1,1781,1,16,2126,0,2143,G
2-PB1,1782,2,10,2135,0,2147,G
2-PB1,1783,1,8,2133,1,2143,G
2-PB1,1784,2,9,2138,0,2149,G
2-PB1,1785,2140,1,3,0,2144,A
2-PB1,1786,2,1,0,2137,2140,C
2-PB1,1787,10,0,0,2103,2113,C
2-PB1,1788,2118,0,0,0,2118,A
2-PB1,1789,2263,0,0,1,2264,A
2-PB1,1790,2268,0,3,0,2271,A
2-PB1,1791,1,0,0,2335,2336,C
2-PB1,1792,0,2317,1,0,2318,T
2-PB1,1793,0,2315,0,0,2315,T
2-PB1,1794,2334,0,0,0,2334,A
2-PB1,1795,0,2328,2,0,2330,T
2-PB1,1796,2339,0,0,0,2339,A
2-PB1,1797,3,1,0,2335,2339,C
2-PB1,1798,2170,0,0,0,2170,A
2-PB1,1799,2177,0,1,1,2179,A
2-PB1,1800,0,2123,0,5,2128,T
2-PB1,1801,2162,1,0,0,2163,A
2-PB1,1802,0,2153,0,0,2153,T
2-PB1,1803,2,1,0,2141,2144,C
2-PB1,1804,4,1,0,2140,2145,C
2-PB1,1805,1,5,2146,1,2153,G
2-PB1,1806,2,4,2145,1,2152,G
2-PB1,1807,2152,0,1,0,2153,A
2-PB1,1808,2155,0,1,2,2158,A
2-PB1,1809,1,2156,0,0,2157,T
2-PB1,1810,4,2,0,2168,2174,C
2-PB1,1811,1,2153,1,0,2155,T
2-PB1,1812,2,2168,0,10,2180,T
2-PB1,1813,6,0,0,2177,2183,C
2-PB1,1814,2184,0,0,0,2184,A
2-PB1,1815,2,2,0,2188,2192,C
2-PB1,1816,2180,1,4,0,2185,A
2-PB1,1817,0,2359,0,0,2359,T
2-PB1,1818,5,0,0,2353,2358,C
2-PB1,1819,8,0,0,2369,2377,C
2-PB1,1820,11,0,1,2370,2382,C
2-PB1,1821,0,2386,0,3,2389,T
2-PB1,1822,1,4,2388,0,2393,G
2-PB1,1823,2388,0,2,0,2390,A
2-PB1,1824,2382,0,1,1,2384,A
2-PB1,1825,0,0,2390,1,2391,G
2-PB1,1826,0,2250,0,4,2254,T
2-PB1,1827,2,0,0,2251,2253,C
2-PB1,1828,0,2222,0,1,2223,T
2-PB1,1829,3,1,2269,0,2273,G
2-PB1,1830,0,0,0,2272,2272,C
2-PB1,1831,0,2265,0,1,2266,T
2-PB1,1832,0,2260,0,1,2261,T
2-PB1,1833,2259,0,3,0,2262,A
2-PB1,1834,2267,1,0,0,2268,A
2-PB1,1835,2263,1,5,1,2270,A
2-PB1,1836,1,2,2288,0,2291,G
2-PB1,1837,0,2254,0,2,2256,T
2-PB1,1838,1,7,2219,0,2227,G
2-PB1,1839,1,3,2223,0,2227,G
2-PB1,1840,1,11,2213,0,2225,G
2-PB1,1841,2223,0,2,0,2225,A
2-PB1,1842,3,0,2227,0,2230,G
2-PB1,1843,6,0,0,2222,2228,C
2-PB1,1844,0,2203,1,2,2206,T
2-PB1,1845,0,3,2201,0,2204,G
2-PB1,1846,2197,1,3,0,2201,A
2-PB1,1847,1,2200,0,1,2202,T
2-PB1,1848,1,5,2197,0,2203,G
2-PB1,1849,0,3,2200,0,2203,G
2-PB1,1850,2196,1,1,1,2199,A
2-PB1,1851,0,2189,0,2,2191,T
2-PB1,1852,0,3,2192,0,2195,G
2-PB1,1853,2184,0,1,0,2185,A
2-PB1,1854,0,6,2208,0,2214,G
2-PB1,1855,2204,1,1,0,2206,A
2-PB1,1856,2205,0,0,0,2205,A
2-PB1,1857,0,2191,0,1,2192,T
2-PB1,1858,0,2182,0,0,2182,T
2-PB1,1859,2179,0,2,0,2181,A
2-PB1,1860,0,2182,0,1,2183,T
2-PB1,1861,2,0,0,2181,2183,C
2-PB1,1862,0,9,2188,0,2197,G
2-PB1,1863,1,8,2173,0,2182,G
2-PB1,1864,0,6,2171,0,2177,G
2-PB1,1865,0,1,2181,0,2182,G
2-PB1,1866,2173,1,2,0,2176,A
2-PB1,1867,2179,0,4,0,2183,A
2-PB1,1868,0,4,2195,0,2199,G
2-PB1,1869,2207,0,2,0,2209,A
2-PB1,1870,0,0,0,2214,2214,C
2-PB1,1871,0,2184,0,0,2184,T
2-PB1,1872,1,2228,1,1,2231,T
2-PB1,1873,0,2228,0,0,2228,T
2-PB1,1874,1,1,2246,0,2248,G
2-PB1,1875,0,2250,0,0,2250,T
2-PB1,1876,2242,0,1,0,2243,A
2-PB1,1877,2236,1,3,0,2240,A
2-PB1,1878,0,2185,0,0,2185,T
2-PB1,1879,4,2,0,2194,2200,C
2-PB1,1880,11,1,0,2178,2190,C
2-PB1,1881,11,0,1,2165,2177,C
2-PB1,1882,9,2,1,2201,2213,C
2-PB1,1883,0,2202,0,5,2207,T
2-PB1,1884,3,9,2194,0,2206,G
2-PB1,1885,2205,2,0,0,2207,A
2-PB1,1886,2218,1,2,0,2221,A
2-PB1,1887,0,2223,1,0,2224,T
2-PB1,1888,11,0,0,2193,2204,C
2-PB1,1889,9,0,0,2179,2188,C
2-PB1,1890,8,0,0,2176,2184,C
2-PB1,1891,0,2182,0,2,2184,T
2-PB1,1892,0,2194,0,1,2195,T
2-PB1,1893,0,2188,0,0,2188,T
2-PB1,1894,0,0,2193,0,2193,G
2-PB1,1895,0,2178,0,2,2180,T
2-PB1,1896,4,0,1,2177,2182,C
2-PB1,1897,2166,0,1,0,2167,A
2-PB1,1898,0,2,2193,0,2195,G
2-PB1,1899,0,0,0,2180,2180,C
2-PB1,1900,4,0,1,2185,2190,C
2-PB1,1901,2198,0,1,0,2199,A
2-PB1,1902,0,2200,1,1,2202,T
2-PB1,1903,2195,0,1,0,2196,A
2-PB1,1904,2196,0,2,0,2198,A
2-PB1,1905,2196,0,1,0,2197,A
2-PB1,1906,0,1,2209,0,2210,G
2-PB1,1907,2150,0,0,0,2150,A
2-PB1,1908,2158,0,2,0,2160,A
2-PB1,1909,2158,0,1,0,2159,A
2-PB1,1910,0,2159,0,1,2160,T
2-PB1,1911,0,2156,0,0,2156,T
2-PB1,1912,0,7,2150,0,2157,G
2-PB1,1913,2144,0,0,0,2144,A
2-PB1,1914,2109,1,1,0,2111,A
2-PB1,1915,0,2168,1,2,2171,T
2-PB1,1916,6,0,0,2186,2192,C
2-PB1,1917,2,2191,0,1,2194,T
2-PB1,1918,0,0,2231,0,2231,G
2-PB1,1919,4,2222,0,1,2227,T
2-PB1,1920,2256,1,1,0,2258,A
2-PB1,1921,2262,0,0,0,2262,A
2-PB1,1922,2265,3,0,0,2268,A
2-PB1,1923,1,0,0,2269,2270,C
2-PB1,1924,2218,0,0,0,2218,A
2-PB1,1925,2273,0,0,0,2273,A
2-PB1,1926,0,2280,0,2,2282,T
2-PB1,1927,0,3,2267,0,2270,G
2-PB1,1928,2,1,0,2280,2283,C
2-PB1,1929,0,2257,0,2,2259,T
2-PB1,1930,0,0,2328,0,2328,G
2-PB1,1931,1,2326,0,3,2330,T
2-PB1,1932,2371,0,0,0,2371,A
2-PB1,1933,2,6,2367,0,2375,G
2-PB1,1934,0,2319,0,1,2320,T
2-PB1,1935,2310,0,1,1,2312,A
2-PB1,1936,2307,0,0,0,2307,A
2-PB1,1937,1,2272,1,2,2276,T
2-PB1,1938,0,0,2278,0,2278,G
2-PB1,1939,0,0,1,2233,2234,C
2-PB1,1940,4,0,0,2205,2209,C
2-PB1,1941,2169,0,4,0,2173,A
2-PB1,1942,1,1,2180,0,2182,G
2-PB1,1943,0,0,3,2229,2232,C
2-PB1,1944,5,0,0,2220,2225,C
2-PB1,1945,8,1,1,2216,2226,C
2-PB1,1946,2226,1,1,0,2228,A
2-PB1,1947,0,2229,0,1,2230,T
2-PB1,1948,1,7,2217,5,2230,G
2-PB1,1949,1,2,2234,1,2238,G
2-PB1,1950,0,2221,0,2,2223,T
2-PB1,1951,4,2,0,2187,2193,C
2-PB1,1952,5,1,0,2115,2121,C
2-PB1,1953,4,14,2113,0,2131,G
2-PB1,1954,3,1,2127,1,2132,G
2-PB1,1955,0,1,0,2126,2127,C
2-PB1,1956,9,1,0,2117,2127,C
2-PB1,1957,2135,1,1,0,2137,A
2-PB1,1958,2129,0,0,1,2130,A
2-PB1,1959,2132,1,0,0,2133,A
2-PB1,1960,2138,0,1,0,2139,A
2-PB1,1961,1,2,2177,0,2180,G
2-PB1,1962,2,2117,0,1,2120,T
2-PB1,1963,2138,1,1,0,2140,A
2-PB1,1964,0,2135,0,2,2137,T
2-PB1,1965,5,5,2128,0,2138,G
2-PB1,1966,2,1,2166,0,2169,G
2-PB1,1967,2154,0,1,0,2155,A
2-PB1,1968,2173,1,1,0,2175,A
2-PB1,1969,0,2161,0,1,2162,T
2-PB1,1970,2132,0,0,0,2132,A
2-PB1,1971,0,2127,0,2,2129,T
2-PB1,1972,0,7,2105,0,2112,G
2-PB1,1973,2110,0,2,0,2112,A
2-PB1,1974,0,2103,1,2,2106,T
2-PB1,1975,0,1,2050,0,2051,G
2-PB1,1976,4,6,0,2043,2053,C
2-PB1,1977,12,0,0,2020,2032,C
2-PB1,1978,4,3,2025,0,2032,G
2-PB1,1979,0,2023,0,1,2024,T
2-PB1,1980,0,2021,0,1,2022,T
2-PB1,1981,1,0,2028,0,2029,G
2-PB1,1982,0,2,0,2076,2078,C
2-PB1,1983,2082,0,2,0,2084,A
2-PB1,1984,2106,2,1,0,2109,A
2-PB1,1985,0,1,0,2113,2114,C
2-PB1,1986,0,2111,0,0,2111,T
2-PB1,1987,2113,1,4,0,2118,A
2-PB1,1988,0,0,0,2113,2113,C
2-PB1,1989,2106,1,4,0,2111,A
2-PB1,1990,3,0,0,2109,2112,C
2-PB1,1991,2025,0,1,0,2026,A
2-PB1,1992,4,0,0,2196,2200,C
2-PB1,1993,2,2150,0,0,2152,T
2-PB1,1994,9,0,0,2157,2166,C
2-PB1,1995,7,1,0,2162,2170,C
2-PB1,1996,0,2152,1,2,2155,T
2-PB1,1997,2,10,2142,0,2154,G
2-PB1,1998,0,3,2152,0,2155,G
2-PB1,1999,2153,0,2,0,2155,A
2-PB1,2000,0,2155,1,1,2157,T
2-PB1,2001,0,1941,0,0,1941,T
2-PB1,2002,6,0,0,1966,1972,C
2-PB1,2003,9,0,1,1959,1969,C
2-PB1,2004,8,0,1,1960,1969,C
2-PB1,2005,1975,0,0,0,1975,A
2-PB1,2006,1976,0,0,0,1976,A
2-PB1,2007,0,3,1976,0,1979,G
2-PB1,2008,1968,0,2,0,1970,A
2-PB1,2009,0,8,1959,0,1967,G
2-PB1,2010,1,8,1963,0,1972,G
2-PB1,2011,1938,1,0,0,1939,A
2-PB1,2012,1935,0,1,0,1936,A
2-PB1,2013,3,1,0,1929,1933,C
2-PB1,2014,10,0,0,1913,1923,C
2-PB1,2015,0,2,1957,0,1959,G
2-PB1,2016,0,1,0,1954,1955,C
2-PB1,2017,1,1950,0,0,1951,T
2-PB1,2018,5,0,0,1957,1962,C
2-PB1,2019,1,1952,0,1,1954,T
2-PB1,2020,2076,0,1,0,2077,A
2-PB1,2021,0,2072,0,2,2074,T
2-PB1,2022,0,2071,0,1,2072,T
2-PB1,2023,6,0,0,2076,2082,C
2-PB1,2024,0,2006,1,1,2008,T
2-PB1,2025,2013,0,1,0,2014,A
2-PB1,2026,2006,0,2,0,2008,A
2-PB1,2027,2010,0,1,0,2011,A
2-PB1,2028,0,0,0,2008,2008,C
2-PB1,2029,1871,0,1,0,1872,A
2-PB1,2030,5,0,0,1863,1868,C
2-PB1,2031,1845,1,1,0,1847,A
2-PB1,2032,1853,0,2,1,1856,A
2-PB1,2033,1,0,1864,0,1865,G
2-PB1,2034,1,0,0,1857,1858,C
2-PB1,2035,8,0,0,1860,1868,C
2-PB1,2036,1853,0,1,0,1854,A
2-PB1,2037,1853,0,1,0,1854,A
2-PB1,2038,1849,0,1,0,1850,A
2-PB1,2039,1,7,1852,1,1861,G
2-PB1,2040,0,5,1856,0,1861,G
2-PB1,2041,1,2,1825,0,1828,G
2-PB1,2042,0,3,1819,0,1822,G
2-PB1,2043,1816,0,0,1,1817,A
2-PB1,2044,1825,0,1,0,1826,A
2-PB1,2045,0,1824,0,0,1824,T
2-PB1,2046,0,1827,0,0,1827,T
2-PB1,2047,4,0,0,1827,1831,C
2-PB1,2048,0,1805,0,3,1808,T
2-PB1,2049,1,1810,0,1,1812,T
2-PB1,2050,1,2,1804,0,1807,G
2-PB1,2051,1807,0,3,0,1810,A
2-PB1,2052,0,5,1804,0,1809,G
2-PB1,2053,1,6,1811,0,1818,G
2-PB1,2054,1816,0,1,0,1817,A
2-PB1,2055,0,1815,0,1,1816,T
2-PB1,2056,1,11,1814,0,1826,G
2-PB1,2057,1819,1,3,0,1823,A
2-PB1,2058,1825,0,0,0,1825,A
2-PB1,2059,1,0,0,1824,1825,C
2-PB1,2060,1805,0,0,0,1805,A
2-PB1,2061,0,4,1826,1,1831,G
2-PB1,2062,1822,0,2,0,1824,A
2-PB1,2063,1,1829,0,0,1830,T
2-PB1,2064,0,2,1841,0,1843,G
2-PB1,2065,0,1889,0,1,1890,T
2-PB1,2066,1894,0,1,0,1895,A
2-PB1,2067,2,0,0,1881,1883,C
2-PB1,2068,6,0,0,1866,1872,C
2-PB1,2069,1853,0,0,0,1853,A
2-PB1,2070,0,1,1816,0,1817,G
2-PB1,2071,1796,0,2,0,1798,A
2-PB1,2072,1791,0,1,1,1793,A
2-PB1,2073,1,1,1796,0,1798,G
2-PB1,2074,0,1690,0,1,1691,T
2-PB1,2075,1,1,1702,0,1704,G
2-PB1,2076,0,1,0,1695,1696,C
2-PB1,2077,2,1683,0,3,1688,T
2-PB1,2078,1,1,1691,0,1693,G
2-PB1,2079,3,0,0,1687,1690,C
2-PB1,2080,1689,0,0,0,1689,A
2-PB1,2081,1694,0,1,0,1695,A
2-PB1,2082,0,0,0,1674,1674,C
2-PB1,2083,1,1662,0,4,1667,T
2-PB1,2084,0,1653,0,1,1654,T
2-PB1,2085,6,0,1647,0,1653,G
2-PB1,2086,1,1648,0,0,1649,T
2-PB1,2087,0,1649,0,0,1649,T
2-PB1,2088,6,0,0,1643,1649,C
2-PB1,2089,1,2,1641,0,1644,G
2-PB1,2090,1648,0,0,0,1648,A
2-PB1,2091,4,2,1638,0,1644,G
2-PB1,2092,1640,0,2,0,1642,A
2-PB1,2093,1644,0,0,0,1644,A
2-PB1,2094,1644,0,0,0,1644,A
2-PB1,2095,0,1639,0,0,1639,T
2-PB1,2096,0,1640,0,1,1641,T
2-PB1,2097,1,1641,0,0,1642,T
2-PB1,2098,0,1641,0,0,1641,T
2-PB1,2099,0,1636,0,1,1637,T
2-PB1,2100,2,0,1,1644,1647,C
2-PB1,2101,10,0,0,1640,1650,C
2-PB1,2102,9,0,0,1646,1655,C
2-PB1,2103,1,1649,0,0,1650,T
2-PB1,2104,1654,0,0,0,1654,A
2-PB1,2105,1,3,1649,0,1653,G
2-PB1,2106,0,1651,0,0,1651,T
2-PB1,2107,1663,0,0,0,1663,A
2-PB1,2108,1,0,1677,0,1678,G
2-PB1,2109,0,1661,0,1,1662,T
2-PB1,2110,1,1713,0,0,1714,T
2-PB1,2111,9,0,0,1713,1722,C
2-PB1,2112,1754,0,1,0,1755,A
2-PB1,2113,0,1753,0,0,1753,T
2-PB1,2114,1747,0,2,0,1749,A
2-PB1,2115,0,1743,0,3,1746,T
2-PB1,2116,1686,1,0,0,1687,A
2-PB1,2117,1,1,1672,0,1674,G
2-PB1,2118,0,3,1661,0,1664,G
2-PB1,2119,1490,0,2,0,1492,A
2-PB1,2120,0,3,1485,0,1488,G
2-PB1,2121,1394,0,1,0,1395,A
2-PB1,2122,2,1,0,1387,1390,C
2-PB1,2123,7,0,0,1324,1331,C
2-PB1,2124,0,3,1334,0,1337,G
2-PB1,2125,1332,0,1,0,1333,A
2-PB1,2126,0,1331,0,1,1332,T
2-PB1,2127,0,1328,0,0,1328,T
2-PB1,2128,0,0,1329,0,1329,G
2-PB1,2129,0,4,1327,0,1331,G
2-PB1,2130,1328,0,0,0,1328,A
2-PB1,2131,1321,0,1,0,1322,A
2-PB1,2132,0,1324,0,0,1324,T
2-PB1,2133,0,1326,0,0,1326,T
2-PB1,2134,0,1329,0,1,1330,T
2-PB1,2135,4,0,0,1321,1325,C
2-PB1,2136,0,1326,0,0,1326,T
2-PB1,2137,1318,0,3,0,1321,A
2-PB1,2138,0,2,1325,0,1327,G
2-PB1,2139,2,0,0,1319,1321,C
2-PB1,2140,1318,2,0,0,1320,A
2-PB1,2141,0,1319,1,0,1320,T
2-PB1,2142,0,3,1301,0,1304,G
2-PB1,2143,0,1,1329,0,1330,G
2-PB1,2144,0,1331,0,0,1331,T
2-PB1,2145,0,4,1328,0,1332,G
2-PB1,2146,0,1,1330,0,1331,G
2-PB1,2147,1309,0,1,0,1310,A
2-PB1,2148,1,2,1314,0,1317,G
2-PB1,2149,0,2,1308,0,1310,G
2-PB1,2150,3,0,0,1305,1308,C
2-PB1,2151,7,1,1,1291,1300,C
2-PB1,2152,1217,0,2,0,1219,A
2-PB1,2153,0,1214,1,0,1215,T
2-PB1,2154,0,2,1217,1,1220,G
2-PB1,2155,1,3,1223,0,1227,G
2-PB1,2156,0,1176,0,0,1176,T
2-PB1,2157,0,0,1192,0,1192,G
2-PB1,2158,0,1173,0,2,1175,T
2-PB1,2159,3,0,0,1159,1162,C
2-PB1,2160,0,1162,0,0,1162,T
2-PB1,2161,1140,0,1,0,1141,A
2-PB1,2162,2,1,1133,0,1136,G
2-PB1,2163,1,6,1095,0,1102,G
2-PB1,2164,0,2,1088,1,1091,G
2-PB1,2165,2,0,0,1065,1067,C
2-PB1,2166,4,0,0,1019,1023,C
2-PB1,2167,5,0,0,990,995,C
2-PB1,2168,1,3,988,0,992,G
2-PB1,2169,3,3,986,0,992,G
2-PB1,2170,993,0,0,0,993,A
2-PB1,2171,0,991,0,0,991,T
2-PB1,2172,0,951,0,1,952,T
2-PB1,2173,0,0,935,0,935,G
2-PB1,2174,928,1,1,0,930,A
2-PB1,2175,0,932,0,0,932,T
2-PB1,2176,1,0,929,0,930,G
2-PB1,2177,1,0,0,922,923,C
2-PB1,2178,2,2,0,911,915,C
2-PB1,2179,910,0,0,0,910,A
2-PB1,2180,0,3,907,0,910,G
2-PB1,2181,906,0,0,0,906,A
2-PB1,2182,905,0,0,0,905,A
2-PB1,2183,0,894,1,0,895,T
2-PB1,2184,1,879,1,0,881,T
2-PB1,2185,0,2,880,0,882,G
2-PB1,2186,877,0,0,0,877,A
2-PB1,2187,0,2,0,872,874,C
2-PB1,2188,0,863,0,5,868,T
2-PB1,2189,0,865,0,0,865,T
2-PB1,2190,1,0,0,859,860,C
2-PB1,2191,1,2,853,0,856,G
2-PB1,2192,857,0,0,0,857,A
2-PB1,2193,1,0,832,1,834,G
2-PB1,2194,0,846,0,1,847,T
2-PB1,2195,2,0,0,847,849,C
2-PB1,2196,1,847,0,0,848,T
2-PB1,2197,0,3,844,0,847,G
2-PB1,2198,0,1,844,0,845,G
2-PB1,2199,845,0,0,0,845,A
2-PB1,2200,770,0,2,4,776,A
2-PB1,2201,0,0,779,0,779,G
2-PB1,2202,0,3,785,0,788,G
2-PB1,2203,787,0,0,0,787,A
2-PB1,2204,0,782,0,0,782,T
2-PB1,2205,0,786,0,0,786,T
2-PB1,2206,784,0,5,0,789,A
2-PB1,2207,782,1,1,0,784,A
2-PB1,2208,0,2,783,0,785,G
2-PB1,2209,784,0,0,0,784,A
2-PB1,2210,756,0,1,0,757,A
2-PB1,2211,0,1,702,1,704,G
2-PB1,2212,0,2,703,0,705,G
2-PB1,2213,708,0,0,0,708,A
2-PB1,2214,702,0,0,0,702,A
2-PB1,2215,0,0,703,0,703,G
2-PB1,2216,671,0,1,0,672,A
2-PB1,2217,1,0,670,0,671,G
2-PB1,2218,0,641,0,0,641,T
2-PB1,2219,0,631,0,1,632,T
2-PB1,2220,2,0,0,636,638,C
2-PB1,2221,1,617,1,0,619,T
2-PB1,2222,5,0,0,614,619,C
2-PB1,2223,0,616,0,0,616,T
2-PB1,2224,0,0,614,0,614,G
2-PB1,2225,601,0,1,0,602,A
2-PB1,2226,0,2,588,0,590,G
2-PB1,2227,584,0,0,0,584,A
2-PB1,2228,0,577,0,0,577,T
2-PB1,2229,4,0,1,536,541,C
2-PB1,2230,547,0,0,0,547,A
2-PB1,2231,0,542,0,0,542,T
2-PB1,2232,0,1,543,0,544,G
2-PB1,2233,545,0,0,0,545,A
2-PB1,2234,538,0,0,0,538,A
2-PB1,2235,0,2,531,0,533,G
2-PB1,2236,528,0,0,0,528,A
2-PB1,2237,1,523,0,0,524,T
2-PB1,2238,3,0,0,508,511,C
2-PB1,2239,0,486,0,0,486,T
2-PB1,2240,1,2,486,0,489,G
2-PB1,2241,0,485,0,4,489,T
2-PB1,2242,0,487,0,1,488,T
2-PB1,2243,0,1,0,485,486,C
2-PB1,2244,2,1,0,466,469,C
2-PB1,2245,465,0,2,1,468,A
2-PB1,2246,2,0,0,462,464,C
2-PB1,2247,4,0,0,438,442,C
2-PB1,2248,429,0,0,1,430,A
2-PB1,2249,0,393,0,1,394,T
2-PB1,2250,0,374,0,1,375,T
2-PB1,2251,0,0,376,0,376,G
2-PB1,2252,374,0,0,0,374,A
2-PB1,2253,374,0,0,0,374,A
2-PB1,2254,0,0,375,0,375,G
2-PB1,2255,318,0,2,0,320,A
2-PB1,2256,317,0,1,0,318,A
2-PB1,2257,0,0,0,317,317,C
2-PB1,2258,0,305,0,0,305,T
2-PB1,2259,1,0,0,302,303,C
2-PB1,2260,290,0,1,0,291,A
2-PB1,2261,0,0,291,0,291,G
2-PB1,2262,290,0,0,0,290,A
2-PB1,2263,0,0,0,280,280,C
2-PB1,2264,0,4,271,0,275,G
2-PB1,2265,1,0,270,0,271,G
2-PB1,2266,0,0,0,267,267,C
2-PB1,2267,267,0,0,0,267,A
2-PB1,2268,266,0,0,0,266,A
2-PB1,2269,265,0,0,0,265,A
2-PB1,2270,263,0,0,0,263,A
2-PB1,2271,262,1,0,0,263,A
2-PB1,2272,0,259,0,0,259,T
2-PB1,2273,253,0,0,0,253,A
2-PB1,2274,252,0,0,0,252,A
3-PA,1,45,0,0,0,45,A
3-PA,2,0,45,0,0,45,T
3-PA,3,0,0,48,0,48,G
3-PA,4,0,0,50,0,50,G
3-PA,5,50,0,0,0,50,A
3-PA,6,51,0,0,0,51,A
3-PA,7,0,0,50,0,50,G
3-PA,8,54,0,0,0,54,A
3-PA,9,0,54,0,0,54,T
3-PA,10,0,54,0,0,54,T
3-PA,11,0,54,0,0,54,T
3-PA,12,0,55,0,0,55,T
3-PA,13,0,0,57,0,57,G
3-PA,14,0,57,0,0,57,T
3-PA,15,0,0,57,0,57,G
3-PA,16,0,0,0,59,59,C
3-PA,17,0,2,57,0,59,G
3-PA,18,66,0,0,0,66,A
3-PA,19,0,0,0,70,70,C
3-PA,20,71,0,0,0,71,A
3-PA,21,72,0,0,0,72,A
3-PA,22,0,79,0,0,79,T
3-PA,23,0,0,98,0,98,G
3-PA,24,1,0,0,101,102,C
3-PA,25,0,102,0,0,102,T
3-PA,26,0,102,0,0,102,T
3-PA,27,0,0,0,103,103,C
3-PA,28,104,0,1,0,105,A
3-PA,29,109,0,0,0,109,A
3-PA,30,0,0,0,109,109,C
3-PA,31,0,0,0,111,111,C
3-PA,32,1,0,0,111,112,C
3-PA,33,0,0,112,0,112,G
3-PA,34,112,0,0,0,112,A
3-PA,35,0,112,0,0,112,T
3-PA,36,0,0,112,0,112,G
3-PA,37,115,0,0,0,115,A
3-PA,38,0,116,0,1,117,T
3-PA,39,0,118,0,0,118,T
3-PA,40,0,0,118,0,118,G
3-PA,41,0,117,0,1,118,T
3-PA,42,0,0,0,116,116,C
3-PA,43,0,1,116,0,117,G
3-PA,44,118,0,0,0,118,A
3-PA,45,118,0,0,0,118,A
3-PA,46,0,0,0,118,118,C
3-PA,47,0,119,0,0,119,T
3-PA,48,0,119,0,0,119,T
3-PA,49,0,0,119,0,119,G
3-PA,50,0,0,0,119,119,C
3-PA,51,119,0,0,0,119,A
3-PA,52,0,1,119,0,120,G
3-PA,53,118,1,0,0,119,A
3-PA,54,120,0,0,0,120,A
3-PA,55,120,0,0,0,120,A
3-PA,56,120,0,0,0,120,A
3-PA,57,120,0,0,0,120,A
3-PA,58,0,0,119,0,119,G
3-PA,59,0,0,0,122,122,C
3-PA,60,123,0,0,0,123,A
3-PA,61,132,0,0,0,132,A
3-PA,62,0,133,0,0,133,T
3-PA,63,0,1,134,0,135,G
3-PA,64,146,1,0,0,147,A
3-PA,65,147,0,0,0,147,A
3-PA,66,149,0,0,0,149,A
3-PA,67,0,1,157,0,158,G
3-PA,68,169,0,0,0,169,A
3-PA,69,0,0,194,0,194,G
3-PA,70,0,190,0,0,190,T
3-PA,71,191,0,0,0,191,A
3-PA,72,0,191,0,1,192,T
3-PA,73,0,1,192,0,193,G
3-PA,74,0,1,197,0,198,G
3-PA,75,0,0,198,0,198,G
3-PA,76,0,1,197,0,198,G
3-PA,77,197,0,0,0,197,A
3-PA,78,0,0,196,0,196,G
3-PA,79,0,2,197,0,199,G
3-PA,80,196,0,0,0,196,A
3-PA,81,0,199,0,0,199,T
3-PA,82,0,0,0,199,199,C
3-PA,83,0,197,0,0,197,T
3-PA,84,1,1,196,0,198,G
3-PA,85,198,0,0,0,198,A
3-PA,86,197,0,1,0,198,A
3-PA,87,199,0,0,0,199,A
3-PA,88,198,0,1,0,199,A
3-PA,89,0,199,0,0,199,T
3-PA,90,0,199,0,0,199,T
3-PA,91,0,3,194,0,197,G
3-PA,92,199,0,0,0,199,A
3-PA,93,199,0,0,0,199,A
3-PA,94,196,0,0,0,196,A
3-PA,95,0,0,0,199,199,C
3-PA,96,198,0,0,0,198,A
3-PA,97,199,0,0,0,199,A
3-PA,98,198,0,0,0,198,A
3-PA,99,0,0,0,202,202,C
3-PA,100,201,0,0,0,201,A
3-PA,101,204,0,0,0,204,A
3-PA,102,207,0,0,0,207,A
3-PA,103,0,209,0,0,209,T
3-PA,104,0,209,0,0,209,T
3-PA,105,0,208,0,0,208,T
3-PA,106,0,0,208,0,208,G
3-PA,107,0,0,0,209,209,C
3-PA,108,208,0,0,0,208,A
3-PA,109,0,0,216,0,216,G
3-PA,110,0,0,0,216,216,C
3-PA,111,225,0,0,0,225,A
3-PA,112,229,0,0,0,229,A
3-PA,113,0,230,0,0,230,T
3-PA,114,228,0,0,1,229,A
3-PA,115,0,230,0,0,230,T
3-PA,116,0,0,230,0,230,G
3-PA,117,0,0,0,232,232,C
3-PA,118,230,1,0,0,231,A
3-PA,119,0,0,0,233,233,C
3-PA,120,0,231,0,0,231,T
3-PA,121,1,0,0,269,270,C
3-PA,122,282,0,0,0,282,A
3-PA,123,0,0,0,284,284,C
3-PA,124,0,284,0,0,284,T
3-PA,125,0,285,0,0,285,T
3-PA,126,0,0,286,0,286,G
3-PA,127,0,1,291,0,292,G
3-PA,128,292,0,0,0,292,A
3-PA,129,0,2,292,0,294,G
3-PA,130,1,2,287,0,290,G
3-PA,131,0,281,0,0,281,T
3-PA,132,0,0,293,0,293,G
3-PA,133,0,291,0,1,292,T
3-PA,134,0,1,302,0,303,G
3-PA,135,0,304,0,0,304,T
3-PA,136,0,305,0,0,305,T
3-PA,137,0,303,0,0,303,T
3-PA,138,1,0,0,304,305,C
3-PA,139,303,0,1,0,304,A
3-PA,140,1,305,0,0,306,T
3-PA,141,0,1,306,0,307,G
3-PA,142,0,306,0,0,306,T
3-PA,143,304,0,1,0,305,A
3-PA,144,0,302,0,1,303,T
3-PA,145,0,305,0,0,305,T
3-PA,146,0,1,0,305,306,C
3-PA,147,305,0,0,0,305,A
3-PA,148,0,0,310,0,310,G
3-PA,149,309,0,0,0,309,A
3-PA,150,0,310,0,0,310,T
3-PA,151,0,310,0,0,310,T
3-PA,152,0,306,0,1,307,T
3-PA,153,1,0,0,307,308,C
3-PA,154,1,0,0,314,315,C
3-PA,155,314,2,0,0,316,A
3-PA,156,0,315,0,0,315,T
3-PA,157,0,314,0,0,314,T
3-PA,158,0,317,0,0,317,T
3-PA,159,0,0,0,316,316,C
3-PA,160,317,0,0,0,317,A
3-PA,161,0,330,0,0,330,T
3-PA,162,0,0,0,330,330,C
3-PA,163,327,0,0,0,327,A
3-PA,164,328,0,0,0,328,A
3-PA,165,0,329,0,0,329,T
3-PA,166,0,2,336,0,338,G
3-PA,167,335,0,0,0,335,A
3-PA,168,338,0,0,0,338,A
3-PA,169,0,0,0,337,337,C
3-PA,170,331,0,0,0,331,A
3-PA,171,332,0,0,0,332,A
3-PA,172,0,3,329,0,332,G
3-PA,173,0,0,332,0,332,G
3-PA,174,0,0,0,334,334,C
3-PA,175,1,0,330,0,331,G
3-PA,176,354,0,0,0,354,A
3-PA,177,355,0,0,0,355,A
3-PA,178,0,356,0,0,356,T
3-PA,179,1,0,0,363,364,C
3-PA,180,365,0,0,0,365,A
3-PA,181,363,0,0,0,363,A
3-PA,182,0,365,0,0,365,T
3-PA,183,362,0,0,0,362,A
3-PA,184,0,0,370,0,370,G
3-PA,185,0,373,0,0,373,T
3-PA,186,0,6,368,1,375,G
3-PA,187,0,0,374,0,374,G
3-PA,188,0,372,0,2,374,T
3-PA,189,369,0,1,0,370,A
3-PA,190,0,2,371,0,373,G
3-PA,191,375,0,1,0,376,A
3-PA,192,375,0,0,0,375,A
3-PA,193,1,0,0,377,378,C
3-PA,194,0,368,0,0,368,T
3-PA,195,0,370,0,0,370,T
3-PA,196,0,0,366,0,366,G
3-PA,197,365,0,2,0,367,A
3-PA,198,0,2,0,367,369,C
3-PA,199,0,1,366,0,367,G
3-PA,200,375,0,0,0,375,A
3-PA,201,0,382,0,0,382,T
3-PA,202,0,0,0,384,384,C
3-PA,203,3,0,0,386,389,C
3-PA,204,387,0,0,0,387,A
3-PA,205,390,0,0,0,390,A
3-PA,206,391,0,0,0,391,A
3-PA,207,0,389,0,0,389,T
3-PA,208,0,0,393,0,393,G
3-PA,209,1,0,0,389,390,C
3-PA,210,384,0,0,0,384,A
3-PA,211,1,0,0,398,399,C
3-PA,212,0,390,1,0,391,T
3-PA,213,0,0,458,0,458,G
3-PA,214,0,458,0,0,458,T
3-PA,215,0,458,0,0,458,T
3-PA,216,458,0,0,0,458,A
3-PA,217,455,0,0,0,455,A
3-PA,218,458,0,0,0,458,A
3-PA,219,0,0,460,0,460,G
3-PA,220,0,0,0,453,453,C
3-PA,221,453,0,0,0,453,A
3-PA,222,0,0,0,454,454,C
3-PA,223,431,0,2,0,433,A
3-PA,224,0,1,448,0,449,G
3-PA,225,452,0,0,0,452,A
3-PA,226,0,452,0,0,452,T
3-PA,227,0,453,0,0,453,T
3-PA,228,0,451,0,0,451,T
3-PA,229,0,2,450,0,452,G
3-PA,230,456,0,0,0,456,A
3-PA,231,451,0,2,0,453,A
3-PA,232,456,0,1,0,457,A
3-PA,233,0,447,0,0,447,T
3-PA,234,446,0,0,0,446,A
3-PA,235,453,0,0,0,453,A
3-PA,236,0,452,0,1,453,T
3-PA,237,0,0,0,458,458,C
3-PA,238,0,1,455,0,456,G
3-PA,239,455,0,0,0,455,A
3-PA,240,2,3,451,0,456,G
3-PA,241,1,4,460,0,465,G
3-PA,242,0,3,465,0,468,G
3-PA,243,1,0,469,0,470,G
3-PA,244,462,0,2,0,464,A
3-PA,245,0,1,466,0,467,G
3-PA,246,477,1,1,0,479,A
3-PA,247,0,1,481,0,482,G
3-PA,248,478,1,0,0,479,A
3-PA,249,0,0,0,482,482,C
3-PA,250,472,0,1,0,473,A
3-PA,251,0,1,480,0,481,G
3-PA,252,480,0,0,0,480,A
3-PA,253,495,1,1,0,497,A
3-PA,254,0,1,0,491,492,C
3-PA,255,486,0,0,0,486,A
3-PA,256,487,0,0,0,487,A
3-PA,257,0,486,1,0,487,T
3-PA,258,0,2,505,0,507,G
3-PA,259,2,1,505,0,508,G
3-PA,260,0,0,0,503,503,C
3-PA,261,2,0,0,504,506,C
3-PA,262,0,503,1,1,505,T
3-PA,263,0,1,515,0,516,G
3-PA,264,0,2,513,0,515,G
3-PA,265,514,0,1,0,515,A
3-PA,266,0,0,0,519,519,C
3-PA,267,497,0,0,0,497,A
3-PA,268,0,1,539,1,541,G
3-PA,269,0,542,0,0,542,T
3-PA,270,547,0,1,0,548,A
3-PA,271,0,0,549,0,549,G
3-PA,272,0,540,0,1,541,T
3-PA,273,546,0,0,0,546,A
3-PA,274,545,0,0,0,545,A
3-PA,275,544,0,0,0,544,A
3-PA,276,0,0,0,550,550,C
3-PA,277,505,0,0,0,505,A
3-PA,278,0,1,519,0,520,G
3-PA,279,1,519,0,0,520,T
3-PA,280,524,0,0,0,524,A
3-PA,281,0,523,0,0,523,T
3-PA,282,0,0,0,540,540,C
3-PA,283,0,537,0,0,537,T
3-PA,284,0,0,537,0,537,G
3-PA,285,2,1,0,533,536,C
3-PA,286,531,0,0,0,531,A
3-PA,287,527,0,0,0,527,A
3-PA,288,0,0,1,534,535,C
3-PA,289,533,0,0,0,533,A
3-PA,290,0,0,0,550,550,C
3-PA,291,0,541,0,1,542,T
3-PA,292,546,0,1,0,547,A
3-PA,293,1,1,0,544,546,C
3-PA,294,0,543,0,0,543,T
3-PA,295,0,6,537,0,543,G
3-PA,296,0,7,532,0,539,G
3-PA,297,533,0,3,0,536,A
3-PA,298,0,1,537,0,538,G
3-PA,299,0,0,0,526,526,C
3-PA,300,0,527,0,0,527,T
3-PA,301,0,3,520,0,523,G
3-PA,302,0,0,525,0,525,G
3-PA,303,523,0,0,0,523,A
3-PA,304,524,0,0,0,524,A
3-PA,305,526,0,0,0,526,A
3-PA,306,523,1,1,3,528,A
3-PA,307,1,0,0,528,529,C
3-PA,308,5,0,0,524,529,C
3-PA,309,0,0,528,0,528,G
3-PA,310,529,0,0,0,529,A
3-PA,311,531,0,0,0,531,A
3-PA,312,0,0,537,0,537,G
3-PA,313,0,532,0,0,532,T
3-PA,314,0,536,0,0,536,T
3-PA,315,0,536,0,0,536,T
3-PA,316,0,0,0,542,542,C
3-PA,317,0,546,0,1,547,T
3-PA,318,548,0,0,0,548,A
3-PA,319,0,0,0,545,545,C
3-PA,320,0,0,1,548,549,C
3-PA,321,543,0,1,0,544,A
3-PA,322,0,1,542,0,543,G
3-PA,323,542,0,0,0,542,A
3-PA,324,0,0,0,535,535,C
3-PA,325,0,546,0,0,546,T
3-PA,326,0,549,0,0,549,T
3-PA,327,0,0,552,0,552,G
3-PA,328,0,549,0,0,549,T
3-PA,329,551,1,1,0,553,A
3-PA,330,0,554,0,1,555,T
3-PA,331,0,1,542,0,543,G
3-PA,332,557,0,1,0,558,A
3-PA,333,0,547,0,1,548,T
3-PA,334,0,547,0,0,547,T
3-PA,335,545,1,0,0,546,A
3-PA,336,0,1,0,539,540,C
3-PA,337,543,0,1,0,544,A
3-PA,338,547,0,0,0,547,A
3-PA,339,0,1,551,0,552,G
3-PA,340,0,1,552,0,553,G
3-PA,341,531,2,0,0,533,A
3-PA,342,0,1,537,0,538,G
3-PA,343,539,0,0,0,539,A
3-PA,344,537,0,2,0,539,A
3-PA,345,0,0,0,539,539,C
3-PA,346,540,0,0,0,540,A
3-PA,347,0,1,539,0,540,G
3-PA,348,538,0,0,0,538,A
3-PA,349,0,525,0,1,526,T
3-PA,350,0,527,0,0,527,T
3-PA,351,1,0,0,519,520,C
3-PA,352,1,0,519,1,521,G
3-PA,353,0,520,0,1,521,T
3-PA,354,1,0,0,520,521,C
3-PA,355,0,2,520,0,522,G
3-PA,356,526,0,0,0,526,A
3-PA,357,524,0,0,0,524,A
3-PA,358,524,0,2,0,526,A
3-PA,359,0,524,0,0,524,T
3-PA,360,1,521,0,0,522,T
3-PA,361,0,1,523,0,524,G
3-PA,362,0,1,521,0,522,G
3-PA,363,1,3,518,0,522,G
3-PA,364,0,0,527,0,527,G
3-PA,365,0,516,0,0,516,T
3-PA,366,0,3,519,0,522,G
3-PA,367,523,0,0,0,523,A
3-PA,368,2,0,0,524,526,C
3-PA,369,533,0,0,0,533,A
3-PA,370,532,0,1,0,533,A
3-PA,371,1,0,536,0,537,G
3-PA,372,1,0,539,0,540,G
3-PA,373,539,0,0,0,539,A
3-PA,374,0,1,537,0,538,G
3-PA,375,525,1,1,0,527,A
3-PA,376,0,1,529,0,530,G
3-PA,377,519,0,2,0,521,A
3-PA,378,516,0,0,0,516,A
3-PA,379,0,0,536,0,536,G
3-PA,380,0,526,0,0,526,T
3-PA,381,3,0,0,520,523,C
3-PA,382,1,0,0,526,527,C
3-PA,383,531,0,0,0,531,A
3-PA,384,0,0,0,542,542,C
3-PA,385,549,0,0,0,549,A
3-PA,386,0,557,0,0,557,T
3-PA,387,569,0,0,0,569,A
3-PA,388,0,551,0,0,551,T
3-PA,389,548,0,0,0,548,A
3-PA,390,1,544,0,0,545,T
3-PA,391,0,546,0,0,546,T
3-PA,392,565,0,0,0,565,A
3-PA,393,0,1,0,560,561,C
3-PA,394,2,0,0,541,543,C
3-PA,395,0,531,0,0,531,T
3-PA,396,0,513,0,2,515,T
3-PA,397,0,0,521,0,521,G
3-PA,398,520,0,0,0,520,A
3-PA,399,522,0,0,0,522,A
3-PA,400,521,0,0,0,521,A
3-PA,401,500,0,0,0,500,A
3-PA,402,0,4,496,0,500,G
3-PA,403,0,0,505,0,505,G
3-PA,404,0,0,0,504,504,C
3-PA,405,0,1,0,502,503,C
3-PA,406,504,0,0,0,504,A
3-PA,407,503,0,0,0,503,A
3-PA,408,0,504,0,0,504,T
3-PA,409,504,0,0,0,504,A
3-PA,410,502,0,0,0,502,A
3-PA,411,0,1,515,0,516,G
3-PA,412,509,2,0,0,511,A
3-PA,413,0,512,0,0,512,T
3-PA,414,0,513,0,0,513,T
3-PA,415,511,0,0,0,511,A
3-PA,416,512,0,0,0,512,A
3-PA,417,513,0,0,0,513,A
3-PA,418,0,516,1,0,517,T
3-PA,419,0,0,0,518,518,C
3-PA,420,0,503,0,0,503,T
3-PA,421,0,3,504,0,507,G
3-PA,422,509,0,0,0,509,A
3-PA,423,0,1,510,0,511,G
3-PA,424,511,0,0,0,511,A
3-PA,425,510,0,1,0,511,A
3-PA,426,0,0,0,510,510,C
3-PA,427,507,0,1,0,508,A
3-PA,428,0,1,0,513,514,C
3-PA,429,510,0,0,0,510,A
3-PA,430,0,0,0,514,514,C
3-PA,431,510,0,0,0,510,A
3-PA,432,0,0,1,519,520,C
3-PA,433,516,0,0,0,516,A
3-PA,434,0,512,0,0,512,T
3-PA,435,0,510,0,1,511,T
3-PA,436,2,0,0,510,512,C
3-PA,437,508,0,1,0,509,A
3-PA,438,0,0,0,512,512,C
3-PA,439,504,0,1,0,505,A
3-PA,440,0,506,0,1,507,T
3-PA,441,0,498,0,1,499,T
3-PA,442,0,510,0,0,510,T
3-PA,443,1,509,0,0,510,T
3-PA,444,0,0,0,519,519,C
3-PA,445,0,515,0,1,516,T
3-PA,446,2,0,0,514,516,C
3-PA,447,516,0,0,0,516,A
3-PA,448,1,515,0,0,516,T
3-PA,449,1,520,0,0,521,T
3-PA,450,2,0,0,521,523,C
3-PA,451,515,0,0,0,515,A
3-PA,452,1,0,0,526,527,C
3-PA,453,1,523,0,0,524,T
3-PA,454,0,1,532,0,533,G
3-PA,455,0,4,526,0,530,G
3-PA,456,0,2,534,0,536,G
3-PA,457,0,1,533,0,534,G
3-PA,458,529,0,1,0,530,A
3-PA,459,0,3,528,0,531,G
3-PA,460,0,4,532,0,536,G
3-PA,461,531,0,0,0,531,A
3-PA,462,528,0,0,1,529,A
3-PA,463,523,0,0,0,523,A
3-PA,464,0,512,0,0,512,T
3-PA,465,0,0,519,0,519,G
3-PA,466,0,0,519,0,519,G
3-PA,467,0,1,0,517,518,C
3-PA,468,2,0,0,517,519,C
3-PA,469,519,0,0,0,519,A
3-PA,470,1,0,0,522,523,C
3-PA,471,521,0,0,0,521,A
3-PA,472,522,1,0,0,523,A
3-PA,473,526,0,0,0,526,A
3-PA,474,0,1,525,0,526,G
3-PA,475,1,0,525,0,526,G
3-PA,476,0,0,0,528,528,C
3-PA,477,527,0,1,0,528,A
3-PA,478,0,0,549,0,549,G
3-PA,479,542,0,3,0,545,A
3-PA,480,0,0,0,546,546,C
3-PA,481,0,544,0,0,544,T
3-PA,482,542,0,1,0,543,A
3-PA,483,1,1,0,540,542,C
3-PA,484,540,0,0,0,540,A
3-PA,485,2,0,0,543,545,C
3-PA,486,0,535,0,0,535,T
3-PA,487,2,0,0,532,534,C
3-PA,488,0,535,0,0,535,T
3-PA,489,3,0,0,530,533,C
3-PA,490,0,0,532,0,532,G
3-PA,491,530,0,0,0,530,A
3-PA,492,0,0,0,530,530,C
3-PA,493,0,0,533,0,533,G
3-PA,494,527,0,0,0,527,A
3-PA,495,0,1,525,0,526,G
3-PA,496,0,2,521,0,523,G
3-PA,497,523,0,0,0,523,A
3-PA,498,527,0,1,0,528,A
3-PA,499,525,0,1,0,526,A
3-PA,500,0,0,526,0,526,G
3-PA,501,0,0,0,523,523,C
3-PA,502,518,0,0,0,518,A
3-PA,503,0,1,524,0,525,G
3-PA,504,1,2,529,0,532,G
3-PA,505,0,1,530,0,531,G
3-PA,506,0,1,0,530,531,C
3-PA,507,0,527,0,0,527,T
3-PA,508,525,0,0,0,525,A
3-PA,509,1,1,534,1,537,G
3-PA,510,0,2,560,0,562,G
3-PA,511,565,0,1,0,566,A
3-PA,512,0,553,0,0,553,T
3-PA,513,0,540,0,0,540,T
3-PA,514,534,0,0,0,534,A
3-PA,515,545,0,1,0,546,A
3-PA,516,0,2,549,0,551,G
3-PA,517,547,0,0,0,547,A
3-PA,518,1,0,0,543,544,C
3-PA,519,1,0,0,509,510,C
3-PA,520,497,0,1,0,498,A
3-PA,521,0,1,502,0,503,G
3-PA,522,0,1,501,0,502,G
3-PA,523,0,0,0,503,503,C
3-PA,524,0,496,0,0,496,T
3-PA,525,0,0,509,0,509,G
3-PA,526,0,503,0,0,503,T
3-PA,527,0,507,0,0,507,T
3-PA,528,0,507,0,0,507,T
3-PA,529,504,0,0,0,504,A
3-PA,530,0,0,0,513,513,C
3-PA,531,2,0,1,497,500,C
3-PA,532,497,0,0,0,497,A
3-PA,533,0,497,0,0,497,T
3-PA,534,472,0,0,1,473,A
3-PA,535,473,0,0,0,473,A
3-PA,536,1,0,485,0,486,G
3-PA,537,484,1,0,0,485,A
3-PA,538,1,0,0,485,486,C
3-PA,539,474,0,0,0,474,A
3-PA,540,476,0,0,0,476,A
3-PA,541,0,0,479,0,479,G
3-PA,542,473,0,0,0,473,A
3-PA,543,471,0,1,0,472,A
3-PA,544,469,0,0,0,469,A
3-PA,545,0,460,0,0,460,T
3-PA,546,0,1,460,0,461,G
3-PA,547,0,1,458,0,459,G
3-PA,548,0,0,0,456,456,C
3-PA,549,1,0,0,458,459,C
3-PA,550,457,0,0,0,457,A
3-PA,551,465,0,0,0,465,A
3-PA,552,1,0,0,462,463,C
3-PA,553,460,0,0,0,460,A
3-PA,554,0,0,460,0,460,G
3-PA,555,444,0,0,0,444,A
3-PA,556,1,1,446,0,448,G
3-PA,557,0,1,445,0,446,G
3-PA,558,0,0,0,446,446,C
3-PA,559,1,0,0,448,449,C
3-PA,560,0,434,0,0,434,T
3-PA,561,0,0,0,442,442,C
3-PA,562,0,442,0,0,442,T
3-PA,563,0,1,440,0,441,G
3-PA,564,0,2,436,0,438,G
3-PA,565,0,2,434,0,436,G
3-PA,566,431,0,0,0,431,A
3-PA,567,0,413,0,1,414,T
3-PA,568,1,403,0,0,404,T
3-PA,569,0,0,0,477,477,C
3-PA,570,0,0,0,464,464,C
3-PA,571,0,458,0,0,458,T
3-PA,572,0,458,0,0,458,T
3-PA,573,0,458,0,0,458,T
3-PA,574,0,0,0,464,464,C
3-PA,575,0,1,464,0,465,G
3-PA,576,0,465,0,0,465,T
3-PA,577,1,1,0,460,462,C
3-PA,578,464,0,1,0,465,A
3-PA,579,0,0,561,0,561,G
3-PA,580,0,560,0,0,560,T
3-PA,581,0,0,0,563,563,C
3-PA,582,4,1,0,564,569,C
3-PA,583,1,3,572,0,576,G
3-PA,584,579,0,0,0,579,A
3-PA,585,580,0,0,0,580,A
3-PA,586,580,0,0,0,580,A
3-PA,587,0,2,587,0,589,G
3-PA,588,568,0,0,0,568,A
3-PA,589,0,1,586,0,587,G
3-PA,590,0,0,591,0,591,G
3-PA,591,1,1,0,587,589,C
3-PA,592,0,0,591,0,591,G
3-PA,593,587,1,0,1,589,A
3-PA,594,593,0,0,0,593,A
3-PA,595,0,3,596,0,599,G
3-PA,596,601,0,0,0,601,A
3-PA,597,599,0,1,0,600,A
3-PA,598,596,0,0,0,596,A
3-PA,599,2,0,0,605,607,C
3-PA,600,605,0,0,0,605,A
3-PA,601,604,0,0,0,604,A
3-PA,602,1,602,0,0,603,T
3-PA,603,0,601,0,1,602,T
3-PA,604,0,1,604,0,605,G
3-PA,605,604,1,0,0,605,A
3-PA,606,602,0,1,0,603,A
3-PA,607,0,0,608,0,608,G
3-PA,608,603,0,0,0,603,A
3-PA,609,600,0,1,0,601,A
3-PA,610,603,0,0,0,603,A
3-PA,611,603,0,1,0,604,A
3-PA,612,603,0,0,0,603,A
3-PA,613,0,603,0,0,603,T
3-PA,614,0,605,0,0,605,T
3-PA,615,0,602,0,1,603,T
3-PA,616,0,2,603,0,605,G
3-PA,617,606,0,0,0,606,A
3-PA,618,601,0,0,1,602,A
3-PA,619,603,1,0,0,604,A
3-PA,620,0,617,0,0,617,T
3-PA,621,3,0,0,704,707,C
3-PA,622,710,0,0,0,710,A
3-PA,623,1,0,0,719,720,C
3-PA,624,717,0,0,0,717,A
3-PA,625,1,1,738,0,740,G
3-PA,626,1,6,767,0,774,G
3-PA,627,788,0,0,0,788,A
3-PA,628,804,0,1,0,805,A
3-PA,629,0,1,0,812,813,C
3-PA,630,0,789,0,1,790,T
3-PA,631,876,0,1,0,877,A
3-PA,632,0,894,0,0,894,T
3-PA,633,1,0,941,0,942,G
3-PA,634,0,2,0,934,936,C
3-PA,635,0,1,933,0,934,G
3-PA,636,0,925,0,5,930,T
3-PA,637,925,0,1,0,926,A
3-PA,638,0,6,927,0,933,G
3-PA,639,0,1,926,0,927,G
3-PA,640,0,0,0,921,921,C
3-PA,641,0,912,0,1,913,T
3-PA,642,0,908,0,0,908,T
3-PA,643,0,1,905,1,907,G
3-PA,644,0,0,0,901,901,C
3-PA,645,7,2,0,892,901,C
3-PA,646,1,5,906,0,912,G
3-PA,647,919,0,0,1,920,A
3-PA,648,1,0,0,925,926,C
3-PA,649,5,0,0,926,931,C
3-PA,650,931,1,0,0,932,A
3-PA,651,933,0,0,0,933,A
3-PA,652,934,0,2,0,936,A
3-PA,653,0,1,964,0,965,G
3-PA,654,1,956,0,1,958,T
3-PA,655,2,0,0,964,966,C
3-PA,656,0,963,0,3,966,T
3-PA,657,4,1,0,967,972,C
3-PA,658,2,0,0,976,978,C
3-PA,659,10,0,0,979,989,C
3-PA,660,997,0,0,0,997,A
3-PA,661,1,0,0,1003,1004,C
3-PA,662,5,2,0,988,995,C
3-PA,663,1,3,1010,0,1014,G
3-PA,664,1030,0,0,0,1030,A
3-PA,665,1024,0,0,0,1024,A
3-PA,666,1,0,0,1038,1039,C
3-PA,667,0,1034,0,0,1034,T
3-PA,668,0,1055,0,0,1055,T
3-PA,669,2,0,0,1077,1079,C
3-PA,670,0,1080,0,1,1081,T
3-PA,671,5,2,0,1073,1080,C
3-PA,672,1,1,0,1081,1083,C
3-PA,673,0,1075,0,1,1076,T
3-PA,674,0,0,1079,0,1079,G
3-PA,675,0,1,0,1078,1079,C
3-PA,676,2,1,1,1071,1075,C
3-PA,677,2,1068,1,1,1072,T
3-PA,678,0,1068,0,0,1068,T
3-PA,679,0,2,1068,0,1070,G
3-PA,680,1074,0,0,0,1074,A
3-PA,681,0,1,1089,0,1090,G
3-PA,682,1090,0,2,0,1092,A
3-PA,683,1101,0,0,1,1102,A
3-PA,684,1,1117,0,0,1118,T
3-PA,685,0,1124,2,1,1127,T
3-PA,686,0,1131,0,0,1131,T
3-PA,687,0,1131,0,0,1131,T
3-PA,688,1132,0,0,0,1132,A
3-PA,689,1,2,1133,0,1136,G
3-PA,690,1126,0,3,0,1129,A
3-PA,691,0,0,1184,0,1184,G
3-PA,692,2,1,0,1173,1176,C
3-PA,693,5,0,0,1195,1200,C
3-PA,694,0,1226,0,2,1228,T
3-PA,695,1295,0,0,0,1295,A
3-PA,696,0,1304,0,0,1304,T
3-PA,697,0,0,1313,0,1313,G
3-PA,698,0,1311,0,0,1311,T
3-PA,699,1,3,1317,0,1321,G
3-PA,700,0,2,1308,0,1310,G
3-PA,701,1301,0,1,0,1302,A
3-PA,702,0,1291,0,0,1291,T
3-PA,703,0,9,1263,0,1272,G
3-PA,704,0,3,1296,0,1299,G
3-PA,705,1302,0,0,0,1302,A
3-PA,706,0,1291,0,1,1292,T
3-PA,707,0,1289,0,1,1290,T
3-PA,708,3,0,1,1280,1284,C
3-PA,709,5,5,1277,0,1287,G
3-PA,710,1289,1,1,0,1291,A
3-PA,711,1291,0,1,0,1292,A
3-PA,712,0,0,0,1306,1306,C
3-PA,713,6,0,0,1268,1274,C
3-PA,714,0,5,1273,0,1278,G
3-PA,715,1277,0,0,1,1278,A
3-PA,716,1278,0,3,0,1281,A
3-PA,717,0,2,0,1296,1298,C
3-PA,718,0,7,1281,0,1288,G
3-PA,719,0,1,1325,0,1326,G
3-PA,720,0,0,0,1332,1332,C
3-PA,721,0,1330,0,1,1331,T
3-PA,722,0,0,1363,1,1364,G
3-PA,723,0,0,0,1367,1367,C
3-PA,724,1380,0,0,0,1380,A
3-PA,725,0,1379,0,2,1381,T
3-PA,726,1,1366,0,0,1367,T
3-PA,727,0,4,1368,0,1372,G
3-PA,728,1339,0,0,0,1339,A
3-PA,729,0,6,1363,0,1369,G
3-PA,730,0,5,1364,0,1369,G
3-PA,731,0,0,1361,0,1361,G
3-PA,732,0,0,0,1352,1352,C
3-PA,733,1348,0,3,0,1351,A
3-PA,734,1350,1,3,0,1354,A
3-PA,735,0,0,1362,0,1362,G
3-PA,736,0,0,1,1364,1365,C
3-PA,737,0,1361,0,4,1365,T
3-PA,738,0,1357,0,0,1357,T
3-PA,739,0,1372,0,0,1372,T
3-PA,740,2,0,0,1370,1372,C
3-PA,741,0,1370,0,1,1371,T
3-PA,742,1,1,0,1378,1380,C
3-PA,743,1374,0,0,0,1374,A
3-PA,744,1369,0,0,0,1369,A
3-PA,745,1365,0,0,0,1365,A
3-PA,746,0,1360,0,0,1360,T
3-PA,747,0,2,1405,0,1407,G
3-PA,748,0,1408,0,0,1408,T
3-PA,749,4,0,0,1408,1412,C
3-PA,750,1,0,0,1420,1421,C
3-PA,751,1423,0,1,0,1424,A
3-PA,752,1425,0,0,0,1425,A
3-PA,753,1424,0,0,0,1424,A
3-PA,754,0,3,1434,1,1438,G
3-PA,755,1437,1,0,0,1438,A
3-PA,756,1401,0,1,0,1402,A
3-PA,757,0,0,1404,0,1404,G
3-PA,758,0,1397,0,1,1398,T
3-PA,759,0,6,1392,0,1398,G
3-PA,760,1398,0,0,0,1398,A
3-PA,761,1396,0,0,0,1396,A
3-PA,762,0,1399,0,0,1399,T
3-PA,763,0,1,1389,0,1390,G
3-PA,764,0,0,0,1397,1397,C
3-PA,765,6,0,1,1385,1392,C
3-PA,766,4,0,0,1381,1385,C
3-PA,767,1400,0,2,0,1402,A
3-PA,768,1420,0,0,0,1420,A
3-PA,769,1418,0,0,4,1422,A
3-PA,770,0,1423,0,0,1423,T
3-PA,771,0,1416,0,0,1416,T
3-PA,772,0,7,1405,0,1412,G
3-PA,773,1411,1,0,0,1412,A
3-PA,774,1411,1,3,0,1415,A
3-PA,775,3,0,0,1416,1419,C
3-PA,776,5,0,0,1417,1422,C
3-PA,777,0,1402,0,2,1404,T
3-PA,778,1,1443,0,1,1445,T
3-PA,779,0,1450,0,0,1450,T
3-PA,780,0,1471,0,0,1471,T
3-PA,781,0,0,0,1471,1471,C
3-PA,782,0,1466,0,1,1467,T
3-PA,783,0,2,1468,0,1470,G
3-PA,784,1468,0,0,0,1468,A
3-PA,785,1494,0,0,0,1494,A
3-PA,786,0,4,1505,0,1509,G
3-PA,787,1501,1,3,1,1506,A
3-PA,788,1,0,0,1508,1509,C
3-PA,789,1479,0,0,0,1479,A
3-PA,790,1501,1,1,0,1503,A
3-PA,791,2,1,0,1675,1678,C
3-PA,792,1684,1,2,0,1687,A
3-PA,793,2,0,0,1683,1685,C
3-PA,794,11,1,1,1655,1668,C
3-PA,795,1669,0,1,1,1671,A
3-PA,796,1672,0,0,0,1672,A
3-PA,797,0,12,1666,0,1678,G
3-PA,798,1677,1,2,0,1680,A
3-PA,799,0,0,0,1676,1676,C
3-PA,800,8,0,0,1547,1555,C
3-PA,801,1550,0,0,1,1551,A
3-PA,802,1546,0,2,1,1549,A
3-PA,803,0,1544,0,1,1545,T
3-PA,804,2,1,0,1547,1550,C
3-PA,805,1545,1,0,0,1546,A
3-PA,806,1548,0,0,0,1548,A
3-PA,807,1544,0,2,0,1546,A
3-PA,808,1,0,0,1571,1572,C
3-PA,809,0,1553,0,1,1554,T
3-PA,810,0,1563,0,0,1563,T
3-PA,811,2,0,0,1571,1573,C
3-PA,812,8,0,0,1566,1574,C
3-PA,813,2,4,1580,0,1586,G
3-PA,814,1586,1,0,0,1587,A
3-PA,815,1583,0,1,0,1584,A
3-PA,816,0,1590,0,0,1590,T
3-PA,817,0,7,1572,0,1579,G
3-PA,818,0,5,1585,0,1590,G
3-PA,819,1599,0,3,0,1602,A
3-PA,820,2,0,0,1608,1610,C
3-PA,821,8,1,0,1594,1603,C
3-PA,822,2,1639,0,1,1642,T
3-PA,823,2,0,0,1689,1691,C
3-PA,824,8,1,0,1693,1702,C
3-PA,825,0,1696,0,1,1697,T
3-PA,826,0,1706,0,0,1706,T
3-PA,827,0,2,1772,1,1775,G
3-PA,828,1,1759,0,2,1762,T
3-PA,829,0,1761,0,1,1762,T
3-PA,830,1754,0,2,2,1758,A
3-PA,831,0,1710,0,1,1711,T
3-PA,832,2,1,0,1699,1702,C
3-PA,833,1668,0,0,1,1669,A
3-PA,834,0,0,1669,0,1669,G
3-PA,835,0,0,0,1664,1664,C
3-PA,836,2,7,1622,0,1631,G
3-PA,837,2,0,1681,0,1683,G
3-PA,838,0,1686,0,2,1688,T
3-PA,839,7,0,0,1678,1685,C
3-PA,840,3,1,0,1687,1691,C
3-PA,841,1698,0,0,0,1698,A
3-PA,842,1702,0,0,0,1702,A
3-PA,843,1703,0,1,1,1705,A
3-PA,844,1,1707,0,1,1709,T
3-PA,845,0,1705,0,0,1705,T
3-PA,846,5,2,0,1700,1707,C
3-PA,847,4,1,0,1703,1708,C
3-PA,848,0,1706,0,0,1706,T
3-PA,849,8,0,0,1709,1717,C
3-PA,850,4,0,0,1714,1718,C
3-PA,851,0,1712,0,2,1714,T
3-PA,852,0,1,1732,0,1733,G
3-PA,853,1727,1,2,0,1730,A
3-PA,854,0,1733,0,1,1734,T
3-PA,855,7,2,1713,0,1722,G
3-PA,856,0,2,1709,0,1711,G
3-PA,857,1709,0,3,0,1712,A
3-PA,858,0,1692,0,0,1692,T
3-PA,859,1,0,1694,0,1695,G
3-PA,860,2,0,0,1786,1788,C
3-PA,861,0,1777,0,0,1777,T
3-PA,862,0,1780,0,2,1782,T
3-PA,863,1,1779,0,0,1780,T
3-PA,864,1776,1,0,1,1778,A
3-PA,865,1780,0,0,1,1781,A
3-PA,866,1784,0,0,1,1785,A
3-PA,867,1787,0,0,1,1788,A
3-PA,868,0,1786,0,0,1786,T
3-PA,869,0,1673,0,0,1673,T
3-PA,870,0,8,1671,0,1679,G
3-PA,871,1666,0,4,1,1671,A
3-PA,872,0,0,1692,0,1692,G
3-PA,873,0,0,0,1688,1688,C
3-PA,874,1688,0,0,1,1689,A
3-PA,875,1,1713,0,1,1715,T
3-PA,876,0,1715,0,0,1715,T
3-PA,877,0,0,1715,0,1715,G
3-PA,878,1719,0,1,1,1721,A
3-PA,879,1703,0,5,2,1710,A
3-PA,880,0,4,1709,0,1713,G
3-PA,881,1705,0,2,0,1707,A
3-PA,882,1,0,0,1715,1716,C
3-PA,883,5,1,0,1694,1700,C
3-PA,884,6,1,0,1669,1676,C
3-PA,885,1675,0,1,0,1676,A
3-PA,886,1679,0,3,1,1683,A
3-PA,887,0,0,1693,1,1694,G
3-PA,888,0,1702,0,2,1704,T
3-PA,889,7,0,0,1691,1698,C
3-PA,890,1707,0,0,0,1707,A
3-PA,891,0,0,0,1699,1699,C
3-PA,892,0,1,1699,0,1700,G
3-PA,893,1732,0,0,1,1733,A
3-PA,894,1732,1,1,1,1735,A
3-PA,895,0,4,1783,0,1787,G
3-PA,896,1,9,1766,1,1777,G
3-PA,897,1764,1,3,0,1768,A
3-PA,898,0,2,1782,0,1784,G
3-PA,899,1787,0,3,0,1790,A
3-PA,900,1786,1,4,0,1791,A
3-PA,901,1,3,1784,0,1788,G
3-PA,902,0,9,1761,0,1770,G
3-PA,903,1,6,1772,0,1779,G
3-PA,904,1731,0,1,0,1732,A
3-PA,905,0,1725,0,1,1726,T
3-PA,906,4,0,0,1731,1735,C
3-PA,907,5,1,2,1837,1845,C
3-PA,908,8,0,0,1862,1870,C
3-PA,909,1895,0,0,0,1895,A
3-PA,910,1,1893,0,0,1894,T
3-PA,911,0,1902,0,1,1903,T
3-PA,912,1954,0,4,0,1958,A
3-PA,913,1,1954,0,0,1955,T
3-PA,914,1952,0,2,0,1954,A
3-PA,915,0,1947,0,1,1948,T
3-PA,916,0,4,1780,0,1784,G
3-PA,917,1772,0,0,0,1772,A
3-PA,918,0,1746,0,2,1748,T
3-PA,919,0,0,1755,0,1755,G
3-PA,920,1,0,0,1733,1734,C
3-PA,921,2,10,1715,0,1727,G
3-PA,922,1740,1,1,0,1742,A
3-PA,923,1,1736,0,1,1738,T
3-PA,924,6,0,0,1738,1744,C
3-PA,925,1739,0,0,0,1739,A
3-PA,926,1725,0,5,0,1730,A
3-PA,927,0,0,1742,0,1742,G
3-PA,928,0,1723,0,2,1725,T
3-PA,929,2,4,1739,0,1745,G
3-PA,930,0,0,1,1741,1742,C
3-PA,931,1734,0,4,0,1738,A
3-PA,932,0,1742,0,0,1742,T
3-PA,933,1737,0,0,0,1737,A
3-PA,934,1755,0,1,0,1756,A
3-PA,935,1760,0,0,0,1760,A
3-PA,936,1737,0,1,0,1738,A
3-PA,937,1742,2,1,0,1745,A
3-PA,938,0,1,0,1744,1745,C
3-PA,939,1730,0,0,0,1730,A
3-PA,940,1,1734,0,1,1736,T
3-PA,941,0,1745,0,0,1745,T
3-PA,942,6,0,0,1738,1744,C
3-PA,943,0,1726,0,2,1728,T
3-PA,944,1,1722,0,0,1723,T
3-PA,945,0,1723,0,1,1724,T
3-PA,946,0,7,1727,0,1734,G
3-PA,947,0,0,1736,0,1736,G
3-PA,948,1726,2,3,0,1731,A
3-PA,949,0,1732,0,0,1732,T
3-PA,950,1,3,1747,0,1751,G
3-PA,951,0,1,1783,1,1785,G
3-PA,952,1785,0,2,0,1787,A
3-PA,953,1785,0,1,1,1787,A
3-PA,954,1785,1,2,0,1788,A
3-PA,955,5,4,1807,0,1816,G
3-PA,956,1791,0,8,4,1803,A
3-PA,957,1950,0,1,0,1951,A
3-PA,958,3,1,0,1958,1962,C
3-PA,959,1,0,0,1966,1967,C
3-PA,960,0,1948,0,0,1948,T
3-PA,961,0,1981,0,0,1981,T
3-PA,962,1982,0,2,0,1984,A
3-PA,963,0,1980,0,1,1981,T
3-PA,964,1973,0,0,0,1973,A
3-PA,965,0,2008,0,0,2008,T
3-PA,966,1857,0,2,0,1859,A
3-PA,967,1,3,1873,0,1877,G
3-PA,968,0,1864,0,1,1865,T
3-PA,969,6,1,0,1852,1859,C
3-PA,970,1834,0,1,1,1836,A
3-PA,971,1837,2,1,0,1840,A
3-PA,972,1840,1,0,1,1842,A
3-PA,973,4,0,0,1846,1850,C
3-PA,974,12,0,0,1813,1825,C
3-PA,975,1820,1,2,0,1823,A
3-PA,976,0,1,0,1823,1824,C
3-PA,977,1828,0,2,0,1830,A
3-PA,978,0,1,0,1839,1840,C
3-PA,979,1,4,1836,0,1841,G
3-PA,980,1839,0,3,2,1844,A
3-PA,981,1843,1,0,0,1844,A
3-PA,982,1837,1,0,0,1838,A
3-PA,983,1824,1,3,2,1830,A
3-PA,984,1,5,1840,0,1846,G
3-PA,985,0,9,1816,0,1825,G
3-PA,986,0,5,1827,0,1832,G
3-PA,987,1822,1,2,1,1826,A
3-PA,988,1828,0,1,1,1830,A
3-PA,989,0,1824,0,1,1825,T
3-PA,990,1824,0,1,1,1826,A
3-PA,991,1827,0,0,1,1828,A
3-PA,992,1834,0,0,0,1834,A
3-PA,993,0,1824,0,0,1824,T
3-PA,994,0,1816,0,1,1817,T
3-PA,995,7,0,0,1817,1824,C
3-PA,996,1823,0,0,0,1823,A
3-PA,997,1832,0,1,1,1834,A
3-PA,998,1828,3,0,0,1831,A
3-PA,999,0,1838,0,1,1839,T
3-PA,1000,1,1843,0,0,1844,T
3-PA,1001,1866,0,0,0,1866,A
3-PA,1002,1,0,0,1853,1854,C
3-PA,1003,13,0,0,1847,1860,C
3-PA,1004,0,1846,0,2,1848,T
3-PA,1005,3,0,1866,0,1869,G
3-PA,1006,0,0,0,1875,1875,C
3-PA,1007,0,1870,0,2,1872,T
3-PA,1008,1,2,1917,0,1920,G
3-PA,1009,0,1904,0,3,1907,T
3-PA,1010,9,0,0,1903,1912,C
3-PA,1011,1920,1,1,0,1922,A
3-PA,1012,0,1915,0,1,1916,T
3-PA,1013,0,11,1908,1,1920,G
3-PA,1014,1,2,1911,1,1915,G
3-PA,1015,1915,1,3,0,1919,A
3-PA,1016,1957,0,4,0,1961,A
3-PA,1017,2,2,1941,0,1945,G
3-PA,1018,3,1,0,1939,1943,C
3-PA,1019,1939,0,1,0,1940,A
3-PA,1020,1942,0,5,1,1948,A
3-PA,1021,0,1,1959,0,1960,G
3-PA,1022,0,1954,1,0,1955,T
3-PA,1023,1947,0,1,0,1948,A
3-PA,1024,2,0,0,1950,1952,C
3-PA,1025,0,1915,0,0,1915,T
3-PA,1026,3,1,1932,0,1936,G
3-PA,1027,1,1917,0,1,1919,T
3-PA,1028,6,0,0,1916,1922,C
3-PA,1029,1925,0,1,0,1926,A
3-PA,1030,0,6,1931,1,1938,G
3-PA,1031,1937,1,1,0,1939,A
3-PA,1032,1936,0,1,0,1937,A
3-PA,1033,1,1970,0,4,1975,T
3-PA,1034,1,1967,0,1,1969,T
3-PA,1035,1,2,1962,0,1965,G
3-PA,1036,0,0,0,1962,1962,C
3-PA,1037,1961,0,3,0,1964,A
3-PA,1038,0,4,1959,0,1963,G
3-PA,1039,0,2,1947,0,1949,G
3-PA,1040,1960,0,4,0,1964,A
3-PA,1041,4,1,0,1972,1977,C
3-PA,1042,1950,0,1,0,1951,A
3-PA,1043,0,1960,1,0,1961,T
3-PA,1044,0,1959,0,0,1959,T
3-PA,1045,0,2,1976,0,1978,G
3-PA,1046,1976,0,8,0,1984,A
3-PA,1047,1978,0,0,0,1978,A
3-PA,1048,1974,0,2,0,1976,A
3-PA,1049,1985,0,1,0,1986,A
3-PA,1050,0,1973,0,1,1974,T
3-PA,1051,0,1,1997,0,1998,G
3-PA,1052,1986,0,3,0,1989,A
3-PA,1053,1,10,1980,1,1992,G
3-PA,1054,2,14,1977,0,1993,G
3-PA,1055,1988,0,1,0,1989,A
3-PA,1056,4,3,1995,0,2002,G
3-PA,1057,1999,2,8,0,2009,A
3-PA,1058,1997,0,2,0,1999,A
3-PA,1059,2,3,1988,0,1993,G
3-PA,1060,1,1,1958,0,1960,G
3-PA,1061,0,2046,0,2,2048,T
3-PA,1062,1,2059,1,0,2061,T
3-PA,1063,5,0,0,2050,2055,C
3-PA,1064,6,3,0,2051,2060,C
3-PA,1065,2053,0,2,0,2055,A
3-PA,1066,2046,0,0,0,2046,A
3-PA,1067,0,9,2059,0,2068,G
3-PA,1068,0,3,2075,0,2078,G
3-PA,1069,2054,0,2,0,2056,A
3-PA,1070,0,0,0,2058,2058,C
3-PA,1071,0,2057,0,2,2059,T
3-PA,1072,2061,0,1,0,2062,A
3-PA,1073,2061,0,0,0,2061,A
3-PA,1074,2065,0,1,0,2066,A
3-PA,1075,2071,0,0,0,2071,A
3-PA,1076,2056,1,3,0,2060,A
3-PA,1077,0,1,0,2043,2044,C
3-PA,1078,2038,0,1,0,2039,A
3-PA,1079,0,2022,0,1,2023,T
3-PA,1080,0,3,2041,0,2044,G
3-PA,1081,2044,0,3,0,2047,A
3-PA,1082,2047,0,2,2,2051,A
3-PA,1083,0,6,2060,0,2066,G
3-PA,1084,2059,0,2,1,2062,A
3-PA,1085,2067,0,0,0,2067,A
3-PA,1086,2053,0,1,0,2054,A
3-PA,1087,2050,0,1,0,2051,A
3-PA,1088,0,1,0,2064,2065,C
3-PA,1089,1,10,2044,0,2055,G
3-PA,1090,2065,0,2,0,2067,A
3-PA,1091,0,0,2073,0,2073,G
3-PA,1092,0,2071,0,1,2072,T
3-PA,1093,9,2,0,2097,2108,C
3-PA,1094,2109,0,1,6,2116,A
3-PA,1095,2143,0,2,0,2145,A
3-PA,1096,2,1,0,2147,2150,C
3-PA,1097,0,2144,0,0,2144,T
3-PA,1098,0,5,2176,0,2181,G
3-PA,1099,2170,1,1,0,2172,A
3-PA,1100,2176,0,4,0,2180,A
3-PA,1101,1,1,2186,0,2188,G
3-PA,1102,0,2153,0,0,2153,T
3-PA,1103,1,12,2138,1,2152,G
3-PA,1104,1,14,2130,0,2145,G
3-PA,1105,1,2,2157,0,2160,G
3-PA,1106,2,1,0,2142,2145,C
3-PA,1107,0,2130,0,2,2132,T
3-PA,1108,6,0,0,2149,2155,C
3-PA,1109,0,2147,0,0,2147,T
3-PA,1110,0,2160,0,0,2160,T
3-PA,1111,0,11,2197,0,2208,G
3-PA,1112,0,2,2198,1,2201,G
3-PA,1113,1,2202,0,2,2205,T
3-PA,1114,0,2,2202,0,2204,G
3-PA,1115,2192,0,1,0,2193,A
3-PA,1116,2208,0,3,0,2211,A
3-PA,1117,2200,1,5,0,2206,A
3-PA,1118,2215,0,1,0,2216,A
3-PA,1119,2,0,0,2219,2221,C
3-PA,1120,2186,1,1,0,2188,A
3-PA,1121,0,2185,0,2,2187,T
3-PA,1122,1,9,2168,0,2178,G
3-PA,1123,3,0,2228,0,2231,G
3-PA,1124,2,0,0,2218,2220,C
3-PA,1125,2231,1,2,1,2235,A
3-PA,1126,1,1,0,2220,2222,C
3-PA,1127,17,0,0,2221,2238,C
3-PA,1128,2278,0,4,0,2282,A
3-PA,1129,0,7,2294,0,2301,G
3-PA,1130,2295,0,3,0,2298,A
3-PA,1131,1,4,2316,0,2321,G
3-PA,1132,2310,0,0,0,2310,A
3-PA,1133,2295,1,2,0,2298,A
3-PA,1134,0,11,2293,1,2305,G
3-PA,1135,3,5,2290,0,2298,G
3-PA,1136,1,2284,1,0,2286,T
3-PA,1137,2257,0,2,0,2259,A
3-PA,1138,0,5,2250,0,2255,G
3-PA,1139,2233,0,1,0,2234,A
3-PA,1140,0,0,1,2250,2251,C
3-PA,1141,0,2221,0,1,2222,T
3-PA,1142,0,2200,0,2,2202,T
3-PA,1143,0,2213,0,2,2215,T
3-PA,1144,1,2,2219,0,2222,G
3-PA,1145,2215,0,1,0,2216,A
3-PA,1146,2221,0,1,0,2222,A
3-PA,1147,2223,0,1,0,2224,A
3-PA,1148,2212,1,1,0,2214,A
3-PA,1149,0,0,0,2261,2261,C
3-PA,1150,0,2246,0,3,2249,T
3-PA,1151,1,1,2276,0,2278,G
3-PA,1152,0,1,0,2274,2275,C
3-PA,1153,2273,0,2,0,2275,A
3-PA,1154,0,2,2277,0,2279,G
3-PA,1155,2257,3,1,0,2261,A
3-PA,1156,2,3,2349,0,2354,G
3-PA,1157,2360,0,2,1,2363,A
3-PA,1158,2,0,0,2340,2342,C
3-PA,1159,2331,0,2,1,2334,A
3-PA,1160,0,2312,0,0,2312,T
3-PA,1161,2315,0,2,0,2317,A
3-PA,1162,2314,1,5,0,2320,A
3-PA,1163,0,2,2303,0,2305,G
3-PA,1164,1,2,0,2299,2302,C
3-PA,1165,0,6,2246,0,2252,G
3-PA,1166,2303,0,1,0,2304,A
3-PA,1167,1,2285,1,0,2287,T
3-PA,1168,1,2279,1,0,2281,T
3-PA,1169,1,2284,1,1,2287,T
3-PA,1170,0,5,2283,0,2288,G
3-PA,1171,2291,0,3,0,2294,A
3-PA,1172,2294,0,8,0,2302,A
3-PA,1173,0,3,2306,0,2309,G
3-PA,1174,3,0,0,2341,2344,C
3-PA,1175,2325,0,0,0,2325,A
3-PA,1176,2505,0,1,0,2506,A
3-PA,1177,0,2501,1,1,2503,T
3-PA,1178,2513,0,0,0,2513,A
3-PA,1179,1,2512,0,2,2515,T
3-PA,1180,1,10,2513,0,2524,G
3-PA,1181,2539,1,3,0,2543,A
3-PA,1182,0,2534,0,1,2535,T
3-PA,1183,2475,0,1,0,2476,A
3-PA,1184,0,1,2487,0,2488,G
3-PA,1185,0,2380,0,1,2381,T
3-PA,1186,0,6,2381,1,2388,G
3-PA,1187,2384,1,3,0,2388,A
3-PA,1188,1,2,1,2371,2375,C
3-PA,1189,3,5,2358,0,2366,G
3-PA,1190,2378,1,0,0,2379,A
3-PA,1191,2379,0,4,0,2383,A
3-PA,1192,1,0,0,2401,2402,C
3-PA,1193,9,0,0,2390,2399,C
3-PA,1194,0,2392,0,1,2393,T
3-PA,1195,0,8,2439,0,2447,G
3-PA,1196,2450,0,1,0,2451,A
3-PA,1197,2455,0,1,0,2456,A
3-PA,1198,1,2456,0,1,2458,T
3-PA,1199,1,2424,0,1,2426,T
3-PA,1200,2419,0,1,0,2420,A
3-PA,1201,2403,0,3,2,2408,A
3-PA,1202,0,11,2398,0,2409,G
3-PA,1203,0,1,2401,0,2402,G
3-PA,1204,0,2371,0,1,2372,T
3-PA,1205,10,0,1,2340,2351,C
3-PA,1206,2373,0,0,0,2373,A
3-PA,1207,6,0,0,2417,2423,C
3-PA,1208,0,2417,1,3,2421,T
3-PA,1209,4,2424,1,0,2429,T
3-PA,1210,1,2432,0,0,2433,T
3-PA,1211,6,0,1,2423,2430,C
3-PA,1212,2430,1,2,1,2434,A
3-PA,1213,2426,1,2,0,2429,A
3-PA,1214,0,2,2463,0,2465,G
3-PA,1215,0,1,0,2458,2459,C
3-PA,1216,0,2404,0,0,2404,T
3-PA,1217,0,7,2472,1,2480,G
3-PA,1218,0,3,2490,1,2494,G
3-PA,1219,2530,0,2,1,2533,A
3-PA,1220,0,2561,0,0,2561,T
3-PA,1221,2562,1,1,0,2564,A
3-PA,1222,0,3,0,2562,2565,C
3-PA,1223,2523,0,1,0,2524,A
3-PA,1224,2,2,2532,0,2536,G
3-PA,1225,2526,0,0,1,2527,A
3-PA,1226,2496,0,1,0,2497,A
3-PA,1227,1,2478,0,0,2479,T
3-PA,1228,0,13,2474,0,2487,G
3-PA,1229,2452,0,5,0,2457,A
3-PA,1230,2,1,2503,0,2506,G
3-PA,1231,1,2484,1,4,2490,T
3-PA,1232,0,2480,1,0,2481,T
3-PA,1233,7,4,0,2488,2499,C
3-PA,1234,2517,1,0,0,2518,A
3-PA,1235,2517,0,4,0,2521,A
3-PA,1236,2,1,0,2520,2523,C
3-PA,1237,2495,0,0,0,2495,A
3-PA,1238,2489,0,3,0,2492,A
3-PA,1239,0,10,2473,0,2483,G
3-PA,1240,4,1,2487,1,2493,G
3-PA,1241,2,1,0,2494,2497,C
3-PA,1242,4,0,0,2479,2483,C
3-PA,1243,0,2473,0,6,2479,T
3-PA,1244,1,1,2493,0,2495,G
3-PA,1245,1,2495,0,0,2496,T
3-PA,1246,1,11,2518,0,2530,G
3-PA,1247,2534,0,0,0,2534,A
3-PA,1248,1,0,2531,0,2532,G
3-PA,1249,2,3,0,2506,2511,C
3-PA,1250,0,2498,0,2,2500,T
3-PA,1251,2560,0,1,0,2561,A
3-PA,1252,2562,0,1,0,2563,A
3-PA,1253,0,0,0,2572,2572,C
3-PA,1254,1,2546,1,3,2551,T
3-PA,1255,1,10,2530,0,2541,G
3-PA,1256,2529,0,0,0,2529,A
3-PA,1257,2,2522,0,1,2525,T
3-PA,1258,0,2522,0,3,2525,T
3-PA,1259,11,0,0,2522,2533,C
3-PA,1260,2584,0,1,0,2585,A
3-PA,1261,1,3,2615,0,2619,G
3-PA,1262,1,2591,0,2,2594,T
3-PA,1263,10,0,1,2595,2606,C
3-PA,1264,0,2587,0,0,2587,T
3-PA,1265,0,11,2713,1,2725,G
3-PA,1266,1,5,2723,1,2730,G
3-PA,1267,2723,0,3,1,2727,A
3-PA,1268,0,2735,0,2,2737,T
3-PA,1269,2615,0,0,0,2615,A
3-PA,1270,0,9,2611,0,2620,G
3-PA,1271,2618,0,5,0,2623,A
3-PA,1272,0,0,2633,0,2633,G
3-PA,1273,2,1,0,2618,2621,C
3-PA,1274,1,2545,0,3,2549,T
3-PA,1275,1,2533,0,1,2535,T
3-PA,1276,0,2,2545,0,2547,G
3-PA,1277,2548,0,2,1,2551,A
3-PA,1278,0,2550,1,0,2551,T
3-PA,1279,0,4,2533,0,2537,G
3-PA,1280,2566,1,0,0,2567,A
3-PA,1281,2567,0,0,0,2567,A
3-PA,1282,2572,0,0,0,2572,A
3-PA,1283,0,2565,0,0,2565,T
3-PA,1284,1,2571,0,7,2579,T
3-PA,1285,1,4,2581,0,2586,G
3-PA,1286,0,3,2578,0,2581,G
3-PA,1287,2580,0,4,0,2584,A
3-PA,1288,0,3,2591,0,2594,G
3-PA,1289,2563,0,4,0,2567,A
3-PA,1290,0,4,2595,1,2600,G
3-PA,1291,0,8,2588,0,2596,G
3-PA,1292,2621,0,4,0,2625,A
3-PA,1293,1,0,0,2631,2632,C
3-PA,1294,0,0,2615,0,2615,G
3-PA,1295,2,2607,0,0,2609,T
3-PA,1296,2632,0,3,0,2635,A
3-PA,1297,0,1,2653,0,2654,G
3-PA,1298,1,4,0,2662,2667,C
3-PA,1299,2,1,0,2638,2641,C
3-PA,1300,11,2,2,2610,2625,C
3-PA,1301,11,0,1,2610,2622,C
3-PA,1302,2631,0,0,0,2631,A
3-PA,1303,2702,0,0,0,2702,A
3-PA,1304,0,2699,0,1,2700,T
3-PA,1305,0,2671,0,0,2671,T
3-PA,1306,0,9,2657,0,2666,G
3-PA,1307,2621,1,1,0,2623,A
3-PA,1308,7,3,2623,0,2633,G
3-PA,1309,3,3,0,2613,2619,C
3-PA,1310,2622,0,0,0,2622,A
3-PA,1311,1,1,0,2669,2671,C
3-PA,1312,2602,0,0,1,2603,A
3-PA,1313,0,2654,0,3,2657,T
3-PA,1314,0,2646,0,8,2654,T
3-PA,1315,0,1,2664,0,2665,G
3-PA,1316,2,0,0,2660,2662,C
3-PA,1317,2659,0,0,0,2659,A
3-PA,1318,2658,0,5,0,2663,A
3-PA,1319,0,2,2662,0,2664,G
3-PA,1320,3,0,0,2622,2625,C
3-PA,1321,2634,0,0,0,2634,A
3-PA,1322,1,2560,0,1,2562,T
3-PA,1323,2,7,2559,1,2569,G
3-PA,1324,2554,0,2,0,2556,A
3-PA,1325,1,3,2560,0,2564,G
3-PA,1326,2554,1,4,0,2559,A
3-PA,1327,2553,0,3,0,2556,A
3-PA,1328,0,1,2552,0,2553,G
3-PA,1329,0,5,2542,0,2547,G
3-PA,1330,2556,0,1,0,2557,A
3-PA,1331,2546,2,0,1,2549,A
3-PA,1332,1,2547,0,0,2548,T
3-PA,1333,0,2539,0,1,2540,T
3-PA,1334,2535,0,0,0,2535,A
3-PA,1335,0,2539,0,1,2540,T
3-PA,1336,1,2537,0,3,2541,T
3-PA,1337,1,2538,0,1,2540,T
3-PA,1338,6,1,0,2527,2534,C
3-PA,1339,2527,1,2,0,2530,A
3-PA,1340,2,0,0,2582,2584,C
3-PA,1341,2563,0,6,1,2570,A
3-PA,1342,3,1,2595,0,2599,G
3-PA,1343,0,1,0,2594,2595,C
3-PA,1344,2589,0,0,0,2589,A
3-PA,1345,0,11,2591,0,2602,G
3-PA,1346,2588,1,3,0,2592,A
3-PA,1347,0,6,2598,1,2605,G
3-PA,1348,0,6,2596,0,2602,G
3-PA,1349,1,2507,1,6,2515,T
3-PA,1350,1,2,2545,0,2548,G
3-PA,1351,1,2520,1,5,2527,T
3-PA,1352,9,2,0,2507,2518,C
3-PA,1353,13,1,0,2530,2544,C
3-PA,1354,15,1,0,2514,2530,C
3-PA,1355,2562,0,0,0,2562,A
3-PA,1356,1,2579,1,0,2581,T
3-PA,1357,0,2577,0,0,2577,T
3-PA,1358,0,1,2585,0,2586,G
3-PA,1359,2,2539,0,1,2542,T
3-PA,1360,2510,0,0,0,2510,A
3-PA,1361,0,6,2511,0,2517,G
3-PA,1362,2444,2,5,0,2451,A
3-PA,1363,0,0,2465,0,2465,G
3-PA,1364,0,2,0,2431,2433,C
3-PA,1365,16,2,0,2393,2411,C
3-PA,1366,2434,1,0,0,2435,A
3-PA,1367,2,1,1,2440,2444,C
3-PA,1368,0,2422,0,1,2423,T
3-PA,1369,0,10,2417,0,2427,G
3-PA,1370,2416,1,0,0,2417,A
3-PA,1371,2370,1,2,0,2373,A
3-PA,1372,0,2447,1,1,2449,T
3-PA,1373,2463,0,2,0,2465,A
3-PA,1374,1,1,0,2484,2486,C
3-PA,1375,2418,0,0,0,2418,A
3-PA,1376,0,2429,0,1,2430,T
3-PA,1377,2409,0,1,0,2410,A
3-PA,1378,2422,1,0,0,2423,A
3-PA,1379,1,2418,0,0,2419,T
3-PA,1380,0,4,2393,0,2397,G
3-PA,1381,2387,0,0,0,2387,A
3-PA,1382,2344,2,2,0,2348,A
3-PA,1383,0,11,2327,0,2338,G
3-PA,1384,2,8,2320,0,2330,G
3-PA,1385,0,11,2334,0,2345,G
3-PA,1386,2,11,2326,0,2339,G
3-PA,1387,1,2,2361,1,2365,G
3-PA,1388,0,2329,1,0,2330,T
3-PA,1389,2340,0,1,0,2341,A
3-PA,1390,0,2352,0,1,2353,T
3-PA,1391,2371,1,2,0,2374,A
3-PA,1392,3,0,0,2545,2548,C
3-PA,1393,2459,0,1,0,2460,A
3-PA,1394,0,2415,0,0,2415,T
3-PA,1395,0,2382,0,6,2388,T
3-PA,1396,2357,1,0,0,2358,A
3-PA,1397,2389,0,5,0,2394,A
3-PA,1398,0,4,0,2394,2398,C
3-PA,1399,2349,0,0,0,2349,A
3-PA,1400,1,0,0,2347,2348,C
3-PA,1401,0,2070,1,0,2071,T
3-PA,1402,1,1,2152,0,2154,G
3-PA,1403,1,1,0,2147,2149,C
3-PA,1404,10,1,0,2138,2149,C
3-PA,1405,9,0,0,2145,2154,C
3-PA,1406,1,2097,0,2,2100,T
3-PA,1407,0,1,2166,0,2167,G
3-PA,1408,1,2,0,2161,2164,C
3-PA,1409,0,2153,0,0,2153,T
3-PA,1410,10,1,0,2198,2209,C
3-PA,1411,2124,0,0,0,2124,A
3-PA,1412,2149,0,1,0,2150,A
3-PA,1413,1,2149,0,2,2152,T
3-PA,1414,0,2,2147,0,2149,G
3-PA,1415,1,0,0,2137,2138,C
3-PA,1416,2071,0,1,0,2072,A
3-PA,1417,0,2065,0,8,2073,T
3-PA,1418,4,0,0,2061,2065,C
3-PA,1419,7,1,0,2072,2080,C
3-PA,1420,1,1997,0,3,2001,T
3-PA,1421,2,0,2048,0,2050,G
3-PA,1422,1,2039,1,2,2043,T
3-PA,1423,0,0,2035,0,2035,G
3-PA,1424,2,4,0,2032,2038,C
3-PA,1425,2008,0,1,0,2009,A
3-PA,1426,0,0,2025,0,2025,G
3-PA,1427,0,0,0,2017,2017,C
3-PA,1428,1999,0,0,0,1999,A
3-PA,1429,1997,0,0,1,1998,A
3-PA,1430,1,1925,0,0,1926,T
3-PA,1431,0,5,1920,0,1925,G
3-PA,1432,0,4,1922,0,1926,G
3-PA,1433,1927,0,0,0,1927,A
3-PA,1434,0,2,0,1923,1925,C
3-PA,1435,1,6,1901,0,1908,G
3-PA,1436,1920,0,0,1,1921,A
3-PA,1437,0,1913,0,1,1914,T
3-PA,1438,0,1917,0,0,1917,T
3-PA,1439,0,1909,0,0,1909,T
3-PA,1440,1,1911,0,1,1913,T
3-PA,1441,6,0,0,1906,1912,C
3-PA,1442,1918,0,0,0,1918,A
3-PA,1443,1919,1,1,1,1922,A
3-PA,1444,0,0,0,1922,1922,C
3-PA,1445,0,1892,0,0,1892,T
3-PA,1446,1886,0,1,0,1887,A
3-PA,1447,1888,0,3,0,1891,A
3-PA,1448,1,1886,0,2,1889,T
3-PA,1449,1,1876,0,1,1878,T
3-PA,1450,6,0,0,1879,1885,C
3-PA,1451,5,0,0,1888,1893,C
3-PA,1452,3,1,0,1878,1882,C
3-PA,1453,1877,0,1,0,1878,A
3-PA,1454,1,1902,0,1,1904,T
3-PA,1455,0,5,1907,0,1912,G
3-PA,1456,1905,1,0,0,1906,A
3-PA,1457,1,1901,0,0,1902,T
3-PA,1458,1894,0,0,0,1894,A
3-PA,1459,1895,0,2,0,1897,A
3-PA,1460,0,0,1899,0,1899,G
3-PA,1461,3,2,0,1885,1890,C
3-PA,1462,1878,0,3,0,1881,A
3-PA,1463,1830,0,3,0,1833,A
3-PA,1464,1,1,1858,0,1860,G
3-PA,1465,1,1831,0,6,1838,T
3-PA,1466,0,0,1833,0,1833,G
3-PA,1467,3,1,0,1828,1832,C
3-PA,1468,1816,0,3,0,1819,A
3-PA,1469,0,5,1835,0,1840,G
3-PA,1470,1829,0,0,0,1829,A
3-PA,1471,1848,0,2,0,1850,A
3-PA,1472,1,0,0,1852,1853,C
3-PA,1473,0,1799,0,0,1799,T
3-PA,1474,1818,0,1,0,1819,A
3-PA,1475,1807,1,0,0,1808,A
3-PA,1476,1806,0,3,0,1809,A
3-PA,1477,0,3,1815,0,1818,G
3-PA,1478,1743,0,0,0,1743,A
3-PA,1479,1,5,1736,0,1742,G
3-PA,1480,0,7,1691,0,1698,G
3-PA,1481,0,1,1691,1,1693,G
3-PA,1482,1677,0,4,0,1681,A
3-PA,1483,1644,0,4,0,1648,A
3-PA,1484,1,2,1634,0,1637,G
3-PA,1485,2,0,1636,0,1638,G
3-PA,1486,1,0,0,1625,1626,C
3-PA,1487,0,2,1633,0,1635,G
3-PA,1488,1623,0,0,0,1623,A
3-PA,1489,1622,0,0,0,1622,A
3-PA,1490,1624,0,0,1,1625,A
3-PA,1491,1626,0,1,0,1627,A
3-PA,1492,1625,1,2,0,1628,A
3-PA,1493,0,0,0,1620,1620,C
3-PA,1494,6,0,0,1615,1621,C
3-PA,1495,1620,0,2,0,1622,A
3-PA,1496,1629,1,1,0,1631,A
3-PA,1497,0,1620,0,0,1620,T
3-PA,1498,0,1615,1,0,1616,T
3-PA,1499,0,1624,0,1,1625,T
3-PA,1500,1633,0,2,0,1635,A
3-PA,1501,1,1628,0,1,1630,T
3-PA,1502,1627,1,1,0,1629,A
3-PA,1503,1,1620,0,2,1623,T
3-PA,1504,0,4,1590,0,1594,G
3-PA,1505,0,3,1581,0,1584,G
3-PA,1506,1586,0,1,0,1587,A
3-PA,1507,0,1579,0,1,1580,T
3-PA,1508,0,1558,0,1,1559,T
3-PA,1509,2,0,0,1553,1555,C
3-PA,1510,1555,0,2,0,1557,A
3-PA,1511,0,1559,0,4,1563,T
3-PA,1512,2,3,0,1560,1565,C
3-PA,1513,1560,0,1,0,1561,A
3-PA,1514,1,1544,0,0,1545,T
3-PA,1515,1533,0,0,0,1533,A
3-PA,1516,1530,0,0,0,1530,A
3-PA,1517,1525,1,5,0,1531,A
3-PA,1518,0,1,1527,0,1528,G
3-PA,1519,0,6,1482,0,1488,G
3-PA,1520,0,2,1472,1,1475,G
3-PA,1521,1455,0,0,0,1455,A
3-PA,1522,1430,0,0,0,1430,A
3-PA,1523,0,1,1429,1,1431,G
3-PA,1524,1413,0,0,0,1413,A
3-PA,1525,0,1408,0,0,1408,T
3-PA,1526,3,0,0,1394,1397,C
3-PA,1527,1,1366,0,1,1368,T
3-PA,1528,4,0,0,1377,1381,C
3-PA,1529,1377,0,0,0,1377,A
3-PA,1530,0,1362,0,0,1362,T
3-PA,1531,1,1365,0,1,1367,T
3-PA,1532,0,1350,0,0,1350,T
3-PA,1533,1351,0,0,0,1351,A
3-PA,1534,1344,0,1,0,1345,A
3-PA,1535,0,0,1349,0,1349,G
3-PA,1536,1283,0,0,0,1283,A
3-PA,1537,1287,0,0,0,1287,A
3-PA,1538,1288,0,1,0,1289,A
3-PA,1539,1,1291,0,0,1292,T
3-PA,1540,0,7,1290,0,1297,G
3-PA,1541,1304,0,2,0,1306,A
3-PA,1542,0,0,0,1306,1306,C
3-PA,1543,1300,0,2,0,1302,A
3-PA,1544,1,0,0,1302,1303,C
3-PA,1545,1268,0,2,0,1270,A
3-PA,1546,1,2,1279,0,1282,G
3-PA,1547,1275,0,0,0,1275,A
3-PA,1548,1,0,0,1250,1251,C
3-PA,1549,0,0,1236,0,1236,G
3-PA,1550,0,1173,0,2,1175,T
3-PA,1551,0,3,1174,0,1177,G
3-PA,1552,0,0,1178,0,1178,G
3-PA,1553,0,1180,0,0,1180,T
3-PA,1554,1177,0,0,0,1177,A
3-PA,1555,1145,0,0,0,1145,A
3-PA,1556,1142,1,0,0,1143,A
3-PA,1557,0,1135,0,1,1136,T
3-PA,1558,0,1113,1,0,1114,T
3-PA,1559,0,1114,0,0,1114,T
3-PA,1560,0,1096,0,0,1096,T
3-PA,1561,0,1,1098,0,1099,G
3-PA,1562,0,1077,0,2,1079,T
3-PA,1563,0,4,1074,0,1078,G
3-PA,1564,1074,0,0,0,1074,A
3-PA,1565,0,0,1075,0,1075,G
3-PA,1566,0,1,0,1065,1066,C
3-PA,1567,1073,0,0,0,1073,A
3-PA,1568,0,1073,0,0,1073,T
3-PA,1569,0,3,1067,0,1070,G
3-PA,1570,0,1,1068,0,1069,G
3-PA,1571,1071,0,0,0,1071,A
3-PA,1572,0,2,1069,0,1071,G
3-PA,1573,0,1041,0,2,1043,T
3-PA,1574,0,1018,1,1,1020,T
3-PA,1575,0,1024,0,0,1024,T
3-PA,1576,0,1017,1,1,1019,T
3-PA,1577,4,0,0,1017,1021,C
3-PA,1578,0,1005,0,2,1007,T
3-PA,1579,3,0,0,1001,1004,C
3-PA,1580,0,973,0,3,976,T
3-PA,1581,2,0,0,970,972,C
3-PA,1582,970,1,0,0,971,A
3-PA,1583,0,0,0,966,966,C
3-PA,1584,0,943,0,0,943,T
3-PA,1585,0,2,940,0,942,G
3-PA,1586,933,0,0,0,933,A
3-PA,1587,1,0,0,931,932,C
3-PA,1588,7,0,0,921,928,C
3-PA,1589,8,0,0,901,909,C
3-PA,1590,1,3,902,0,906,G
3-PA,1591,902,0,0,1,903,A
3-PA,1592,0,1,903,0,904,G
3-PA,1593,902,1,0,1,904,A
3-PA,1594,0,0,0,880,880,C
3-PA,1595,0,852,0,0,852,T
3-PA,1596,0,781,0,0,781,T
3-PA,1597,0,2,773,0,775,G
3-PA,1598,772,0,1,1,774,A
3-PA,1599,0,0,773,0,773,G
3-PA,1600,0,0,0,763,763,C
3-PA,1601,3,1,0,724,728,C
3-PA,1602,730,0,2,0,732,A
3-PA,1603,0,0,1,725,726,C
3-PA,1604,728,1,0,0,729,A
3-PA,1605,0,729,0,1,730,T
3-PA,1606,720,0,0,0,720,A
3-PA,1607,717,0,0,0,717,A
3-PA,1608,715,0,0,0,715,A
3-PA,1609,0,703,0,0,703,T
3-PA,1610,1,3,695,0,699,G
3-PA,1611,0,1,605,0,606,G
3-PA,1612,0,1,582,0,583,G
3-PA,1613,568,0,0,0,568,A
3-PA,1614,0,1,565,0,566,G
3-PA,1615,554,0,0,0,554,A
3-PA,1616,538,0,1,0,539,A
3-PA,1617,533,0,0,0,533,A
3-PA,1618,0,529,0,0,529,T
3-PA,1619,520,0,0,0,520,A
3-PA,1620,1,0,0,511,512,C
3-PA,1621,0,275,0,0,275,T
3-PA,1622,1,1,272,0,274,G
3-PA,1623,0,172,0,0,172,T
3-PA,1624,0,0,169,0,169,G
3-PA,1625,0,154,0,0,154,T
3-PA,1626,0,0,0,96,96,C
3-PA,1627,0,0,0,88,88,C
3-PA,1628,0,85,0,0,85,T
3-PA,1629,0,84,0,1,85,T
3-PA,1630,0,0,88,0,88,G
3-PA,1631,86,0,0,0,86,A
3-PA,1632,0,0,92,0,92,G
3-PA,1633,89,0,0,0,89,A
3-PA,1634,0,89,0,0,89,T
3-PA,1635,89,0,0,0,89,A
3-PA,1636,0,0,95,0,95,G
3-PA,1637,0,0,95,0,95,G
3-PA,1638,95,0,0,0,95,A
3-PA,1639,0,0,94,0,94,G
3-PA,1640,95,0,0,0,95,A
3-PA,1641,0,95,0,0,95,T
3-PA,1642,96,0,0,0,96,A
3-PA,1643,0,96,0,0,96,T
3-PA,1644,0,0,96,0,96,G
3-PA,1645,0,98,0,0,98,T
3-PA,1646,0,98,0,0,98,T
3-PA,1647,100,0,0,0,100,A
3-PA,1648,0,0,0,100,100,C
3-PA,1649,0,100,0,0,100,T
3-PA,1650,100,0,0,0,100,A
3-PA,1651,100,0,0,0,100,A
3-PA,1652,0,2,99,0,101,G
3-PA,1653,98,0,1,0,99,A
3-PA,1654,95,0,0,0,95,A
3-PA,1655,0,0,96,0,96,G
3-PA,1656,0,96,0,0,96,T
3-PA,1657,0,0,95,0,95,G
3-PA,1658,0,0,0,93,93,C
3-PA,1659,1,0,0,94,95,C
3-PA,1660,97,0,0,0,97,A
3-PA,1661,0,95,0,0,95,T
3-PA,1662,96,0,0,0,96,A
3-PA,1663,0,0,99,0,99,G
3-PA,1664,2,0,96,0,98,G
3-PA,1665,0,0,0,97,97,C
3-PA,1666,0,0,0,96,96,C
3-PA,1667,95,0,0,0,95,A
3-PA,1668,96,0,0,0,96,A
3-PA,1669,96,0,0,0,96,A
3-PA,1670,0,95,0,0,95,T
3-PA,1671,0,95,0,0,95,T
3-PA,1672,0,95,0,0,95,T
3-PA,1673,0,0,0,95,95,C
3-PA,1674,93,0,0,0,93,A
3-PA,1675,92,0,0,0,92,A
3-PA,1676,0,0,92,0,92,G
3-PA,1677,0,0,94,0,94,G
3-PA,1678,1,0,0,94,95,C
3-PA,1679,0,0,0,94,94,C
3-PA,1680,0,0,94,0,94,G
3-PA,1681,98,0,0,0,98,A
3-PA,1682,0,97,0,0,97,T
3-PA,1683,0,0,99,0,99,G
3-PA,1684,0,100,0,0,100,T
3-PA,1685,0,98,0,0,98,T
3-PA,1686,1,0,0,99,100,C
3-PA,1687,0,100,0,0,100,T
3-PA,1688,0,100,0,0,100,T
3-PA,1689,0,0,101,0,101,G
3-PA,1690,0,100,0,0,100,T
3-PA,1691,100,0,0,0,100,A
3-PA,1692,0,96,0,0,96,T
3-PA,1693,0,0,97,0,97,G
3-PA,1694,0,97,0,0,97,T
3-PA,1695,0,0,97,0,97,G
3-PA,1696,94,0,0,0,94,A
3-PA,1697,0,0,93,0,93,G
3-PA,1698,0,0,92,1,93,G
3-PA,1699,93,0,0,0,93,A
3-PA,1700,0,0,0,93,93,C
3-PA,1701,91,0,0,0,91,A
3-PA,1702,91,0,0,0,91,A
3-PA,1703,91,0,1,0,92,A
3-PA,1704,0,0,0,92,92,C
3-PA,1705,1,0,91,0,92,G
3-PA,1706,0,0,92,0,92,G
3-PA,1707,93,0,0,0,93,A
3-PA,1708,92,0,1,0,93,A
3-PA,1709,0,0,0,94,94,C
3-PA,1710,96,0,0,0,96,A
3-PA,1711,0,95,0,0,95,T
3-PA,1712,1,0,0,95,96,C
3-PA,1713,96,0,0,0,96,A
3-PA,1714,96,0,0,0,96,A
3-PA,1715,94,0,0,1,95,A
3-PA,1716,0,0,96,0,96,G
3-PA,1717,1,0,95,0,96,G
3-PA,1718,0,96,0,0,96,T
3-PA,1719,1,0,0,94,95,C
3-PA,1720,95,0,1,0,96,A
3-PA,1721,96,0,0,0,96,A
3-PA,1722,96,0,0,0,96,A
3-PA,1723,96,0,0,0,96,A
3-PA,1724,0,97,0,0,97,T
3-PA,1725,0,0,97,0,97,G
3-PA,1726,96,0,0,0,96,A
3-PA,1727,96,0,0,0,96,A
3-PA,1728,96,0,0,0,96,A
3-PA,1729,0,95,0,0,95,T
3-PA,1730,0,0,95,0,95,G
3-PA,1731,0,0,96,0,96,G
3-PA,1732,0,0,94,0,94,G
3-PA,1733,0,0,96,0,96,G
3-PA,1734,95,0,0,0,95,A
3-PA,1735,95,0,0,0,95,A
3-PA,1736,0,94,0,0,94,T
3-PA,1737,0,0,96,0,96,G
3-PA,1738,0,0,96,0,96,G
3-PA,1739,94,0,0,0,94,A
3-PA,1740,0,0,95,0,95,G
3-PA,1741,93,0,0,0,93,A
3-PA,1742,0,94,0,0,94,T
3-PA,1743,0,0,93,0,93,G
3-PA,1744,92,0,0,0,92,A
3-PA,1745,0,0,93,0,93,G
3-PA,1746,93,0,0,0,93,A
3-PA,1747,0,0,0,91,91,C
3-PA,1748,0,0,91,0,91,G
3-PA,1749,0,92,0,0,92,T
3-PA,1750,0,93,0,0,93,T
3-PA,1751,0,0,93,0,93,G
3-PA,1752,0,0,0,92,92,C
3-PA,1753,1,0,0,91,92,C
3-PA,1754,0,91,0,1,92,T
3-PA,1755,1,0,0,91,92,C
3-PA,1756,0,0,0,93,93,C
3-PA,1757,0,94,0,0,94,T
3-PA,1758,0,93,0,1,94,T
3-PA,1759,0,0,0,93,93,C
3-PA,1760,93,0,0,0,93,A
3-PA,1761,0,0,93,0,93,G
3-PA,1762,0,92,0,0,92,T
3-PA,1763,0,0,0,94,94,C
3-PA,1764,93,0,0,0,93,A
3-PA,1765,0,0,0,99,99,C
3-PA,1766,0,98,0,0,98,T
3-PA,1767,2,0,0,95,97,C
3-PA,1768,1,0,0,97,98,C
3-PA,1769,99,0,0,0,99,A
3-PA,1770,0,0,99,0,99,G
3-PA,1771,0,0,0,100,100,C
3-PA,1772,98,0,0,0,98,A
3-PA,1773,0,0,100,0,100,G
3-PA,1774,97,0,0,0,97,A
3-PA,1775,0,96,0,0,96,T
3-PA,1776,0,0,0,96,96,C
3-PA,1777,0,0,98,0,98,G
3-PA,1778,98,0,0,0,98,A
3-PA,1779,0,1,97,0,98,G
3-PA,1780,98,0,0,0,98,A
3-PA,1781,0,0,99,0,99,G
3-PA,1782,0,0,0,98,98,C
3-PA,1783,98,0,0,0,98,A
3-PA,1784,0,98,0,0,98,T
3-PA,1785,0,0,100,0,100,G
3-PA,1786,99,0,0,0,99,A
3-PA,1787,0,99,0,0,99,T
3-PA,1788,0,98,0,0,98,T
3-PA,1789,0,0,99,0,99,G
3-PA,1790,98,0,0,0,98,A
3-PA,1791,98,0,0,0,98,A
3-PA,1792,0,0,98,0,98,G
3-PA,1793,0,0,0,98,98,C
3-PA,1794,0,0,0,94,94,C
3-PA,1795,0,0,94,0,94,G
3-PA,1796,94,0,0,0,94,A
3-PA,1797,0,0,95,0,95,G
3-PA,1798,0,94,0,0,94,T
3-PA,1799,0,0,0,92,92,C
3-PA,1800,0,0,0,95,95,C
3-PA,1801,1,94,0,0,95,T
3-PA,1802,1,0,0,95,96,C
3-PA,1803,0,1,95,0,96,G
3-PA,1804,0,0,101,0,101,G
3-PA,1805,0,101,0,0,101,T
3-PA,1806,0,100,0,0,100,T
3-PA,1807,99,0,0,0,99,A
3-PA,1808,99,0,0,0,99,A
3-PA,1809,101,0,0,0,101,A
3-PA,1810,0,1,102,0,103,G
3-PA,1811,100,1,0,0,101,A
3-PA,1812,0,0,101,0,101,G
3-PA,1813,93,0,0,0,93,A
3-PA,1814,93,0,0,0,93,A
3-PA,1815,93,0,0,0,93,A
3-PA,1816,0,1,92,0,93,G
3-PA,1817,93,0,0,0,93,A
3-PA,1818,0,0,0,93,93,C
3-PA,1819,92,0,0,0,92,A
3-PA,1820,0,90,0,0,90,T
3-PA,1821,0,0,89,0,89,G
3-PA,1822,90,0,0,0,90,A
3-PA,1823,0,0,0,89,89,C
3-PA,1824,0,0,0,90,90,C
3-PA,1825,88,0,0,0,88,A
3-PA,1826,89,0,0,0,89,A
3-PA,1827,89,0,0,0,89,A
3-PA,1828,0,0,89,0,89,G
3-PA,1829,89,0,0,0,89,A
3-PA,1830,88,0,0,0,88,A
3-PA,1831,0,88,0,0,88,T
3-PA,1832,0,88,0,1,89,T
3-PA,1833,0,88,0,0,88,T
3-PA,1834,0,89,0,0,89,T
3-PA,1835,0,89,0,0,89,T
3-PA,1836,0,89,0,0,89,T
3-PA,1837,0,1,87,1,89,G
3-PA,1838,89,0,0,0,89,A
3-PA,1839,0,1,90,0,91,G
3-PA,1840,91,0,0,0,91,A
3-PA,1841,90,0,0,0,90,A
3-PA,1842,0,89,0,0,89,T
3-PA,1843,90,0,0,0,90,A
3-PA,1844,91,0,0,0,91,A
3-PA,1845,0,0,91,0,91,G
3-PA,1846,0,93,0,0,93,T
3-PA,1847,1,0,0,92,93,C
3-PA,1848,93,0,0,0,93,A
3-PA,1849,0,0,93,0,93,G
3-PA,1850,92,0,0,0,92,A
3-PA,1851,92,0,0,0,92,A
3-PA,1852,0,0,93,0,93,G
3-PA,1853,0,0,0,90,90,C
3-PA,1854,90,0,0,0,90,A
3-PA,1855,0,87,0,0,87,T
3-PA,1856,0,0,86,0,86,G
3-PA,1857,0,0,87,0,87,G
3-PA,1858,0,0,0,86,86,C
3-PA,1859,1,0,0,87,88,C
3-PA,1860,0,0,0,87,87,C
3-PA,1861,88,0,0,0,88,A
3-PA,1862,0,88,0,0,88,T
3-PA,1863,0,87,0,0,87,T
3-PA,1864,0,0,88,0,88,G
3-PA,1865,0,0,86,0,86,G
3-PA,1866,0,0,86,0,86,G
3-PA,1867,0,0,86,0,86,G
3-PA,1868,82,0,0,0,82,A
3-PA,1869,0,0,83,0,83,G
3-PA,1870,0,82,0,0,82,T
3-PA,1871,0,0,0,83,83,C
3-PA,1872,0,0,0,87,87,C
3-PA,1873,0,0,0,87,87,C
3-PA,1874,0,0,0,87,87,C
3-PA,1875,0,0,0,87,87,C
3-PA,1876,86,0,0,0,86,A
3-PA,1877,87,0,0,0,87,A
3-PA,1878,0,1,85,0,86,G
3-PA,1879,0,0,85,0,85,G
3-PA,1880,0,0,85,0,85,G
3-PA,1881,82,0,0,0,82,A
3-PA,1882,0,0,82,0,82,G
3-PA,1883,0,81,0,0,81,T
3-PA,1884,0,0,82,0,82,G
3-PA,1885,0,1,82,0,83,G
3-PA,1886,83,0,0,0,83,A
3-PA,1887,82,0,0,0,82,A
3-PA,1888,0,0,81,0,81,G
3-PA,1889,81,0,0,0,81,A
3-PA,1890,80,0,0,0,80,A
3-PA,1891,0,0,79,0,79,G
3-PA,1892,0,0,78,0,78,G
3-PA,1893,0,79,0,0,79,T
3-PA,1894,0,74,0,0,74,T
3-PA,1895,0,0,0,73,73,C
3-PA,1896,0,0,0,75,75,C
3-PA,1897,75,0,0,0,75,A
3-PA,1898,0,76,0,0,76,T
3-PA,1899,0,74,0,0,74,T
3-PA,1900,0,1,74,0,75,G
3-PA,1901,0,0,75,0,75,G
3-PA,1902,0,0,75,0,75,G
3-PA,1903,74,0,0,0,74,A
3-PA,1904,76,0,0,0,76,A
3-PA,1905,74,0,0,0,74,A
3-PA,1906,0,0,75,0,75,G
3-PA,1907,0,73,0,0,73,T
3-PA,1908,0,0,0,75,75,C
3-PA,1909,0,76,0,0,76,T
3-PA,1910,0,0,76,0,76,G
3-PA,1911,0,75,0,0,75,T
3-PA,1912,74,0,1,0,75,A
3-PA,1913,0,0,74,0,74,G
3-PA,1914,0,1,73,0,74,G
3-PA,1915,69,0,0,0,69,A
3-PA,1916,0,0,0,69,69,C
3-PA,1917,0,67,0,0,67,T
3-PA,1918,0,0,0,70,70,C
3-PA,1919,0,69,0,0,69,T
3-PA,1920,68,0,1,0,69,A
3-PA,1921,0,69,0,0,69,T
3-PA,1922,0,68,0,0,68,T
3-PA,1923,0,0,69,0,69,G
3-PA,1924,0,0,67,0,67,G
3-PA,1925,0,0,0,68,68,C
3-PA,1926,0,66,0,0,66,T
3-PA,1927,62,0,0,0,62,A
3-PA,1928,65,0,0,0,65,A
3-PA,1929,0,0,65,0,65,G
3-PA,1930,0,64,0,0,64,T
3-PA,1931,1,0,0,63,64,C
3-PA,1932,64,0,0,0,64,A
3-PA,1933,0,0,65,0,65,G
3-PA,1934,0,65,0,0,65,T
3-PA,1935,67,0,0,0,67,A
3-PA,1936,0,67,0,0,67,T
3-PA,1937,0,67,0,0,67,T
3-PA,1938,0,0,0,67,67,C
3-PA,1939,66,0,0,0,66,A
3-PA,1940,66,0,0,0,66,A
3-PA,1941,0,66,0,0,66,T
3-PA,1942,64,0,0,0,64,A
3-PA,1943,0,0,66,0,66,G
3-PA,1944,0,0,0,64,64,C
3-PA,1945,0,0,0,64,64,C
3-PA,1946,0,61,0,0,61,T
3-PA,1947,1,1,60,0,62,G
3-PA,1948,0,62,0,0,62,T
3-PA,1949,63,0,0,0,63,A
3-PA,1950,0,63,0,0,63,T
3-PA,1951,0,0,62,0,62,G
3-PA,1952,0,0,0,64,64,C
3-PA,1953,63,0,0,0,63,A
3-PA,1954,0,63,0,0,63,T
3-PA,1955,0,0,0,63,63,C
3-PA,1956,63,0,0,0,63,A
3-PA,1957,0,0,0,63,63,C
3-PA,1958,0,0,0,62,62,C
3-PA,1959,63,0,0,0,63,A
3-PA,1960,0,0,0,62,62,C
3-PA,1961,60,1,0,0,61,A
3-PA,1962,62,0,0,0,62,A
3-PA,1963,0,61,0,0,61,T
3-PA,1964,0,61,0,0,61,T
3-PA,1965,0,0,61,0,61,G
3-PA,1966,0,0,59,0,59,G
3-PA,1967,56,0,0,0,56,A
3-PA,1968,58,0,0,0,58,A
3-PA,1969,0,0,58,0,58,G
3-PA,1970,0,0,59,0,59,G
3-PA,1971,57,0,0,0,57,A
3-PA,1972,0,58,0,0,58,T
3-PA,1973,0,59,0,0,59,T
3-PA,1974,1,56,0,0,57,T
3-PA,1975,0,58,0,0,58,T
3-PA,1976,0,0,0,57,57,C
3-PA,1977,56,0,0,0,56,A
3-PA,1978,0,0,57,0,57,G
3-PA,1979,0,0,0,57,57,C
3-PA,1980,0,0,56,0,56,G
3-PA,1981,0,0,57,0,57,G
3-PA,1982,56,0,0,0,56,A
3-PA,1983,0,0,57,0,57,G
3-PA,1984,0,57,0,0,57,T
3-PA,1985,0,0,0,58,58,C
3-PA,1986,59,0,0,0,59,A
3-PA,1987,59,0,0,0,59,A
3-PA,1988,0,0,59,0,59,G
3-PA,1989,59,0,0,0,59,A
3-PA,1990,57,0,0,0,57,A
3-PA,1991,57,0,0,0,57,A
3-PA,1992,58,0,0,0,58,A
3-PA,1993,0,0,0,58,58,C
3-PA,1994,0,56,0,0,56,T
3-PA,1995,0,0,54,0,54,G
3-PA,1996,0,0,0,56,56,C
3-PA,1997,0,54,0,0,54,T
3-PA,1998,0,0,0,56,56,C
3-PA,1999,0,0,0,56,56,C
3-PA,2000,0,53,0,0,53,T
3-PA,2001,0,55,0,0,55,T
3-PA,2002,0,0,55,0,55,G
3-PA,2003,0,55,0,0,55,T
3-PA,2004,0,53,0,0,53,T
3-PA,2005,0,0,55,0,55,G
3-PA,2006,0,55,0,0,55,T
3-PA,2007,0,55,0,0,55,T
3-PA,2008,0,0,0,56,56,C
3-PA,2009,54,0,0,0,54,A
3-PA,2010,0,0,54,0,54,G
3-PA,2011,0,0,54,0,54,G
3-PA,2012,0,0,0,54,54,C
3-PA,2013,0,52,0,0,52,T
3-PA,2014,0,0,0,55,55,C
3-PA,2015,0,55,0,0,55,T
3-PA,2016,0,55,0,0,55,T
3-PA,2017,54,0,0,0,54,A
3-PA,2018,0,0,55,0,55,G
3-PA,2019,0,0,55,0,55,G
3-PA,2020,0,1,52,0,53,G
3-PA,2021,55,0,0,0,55,A
3-PA,2022,0,0,0,55,55,C
3-PA,2023,51,0,0,0,51,A
3-PA,2024,50,0,0,0,50,A
3-PA,2025,0,0,0,53,53,C
3-PA,2026,0,0,0,52,52,C
3-PA,2027,0,52,0,0,52,T
3-PA,2028,0,0,0,52,52,C
3-PA,2029,0,0,52,0,52,G
3-PA,2030,51,0,0,0,51,A
3-PA,2031,52,0,0,0,52,A
3-PA,2032,0,0,0,52,52,C
3-PA,2033,0,0,0,51,51,C
3-PA,2034,0,51,0,0,51,T
3-PA,2035,0,0,51,0,51,G
3-PA,2036,0,0,50,1,51,G
3-PA,2037,0,1,50,0,51,G
3-PA,2038,51,0,0,0,51,A
3-PA,2039,1,0,0,50,51,C
3-PA,2040,0,0,0,51,51,C
3-PA,2041,0,49,0,0,49,T
3-PA,2042,0,49,0,0,49,T
3-PA,2043,0,49,0,0,49,T
3-PA,2044,0,0,48,0,48,G
3-PA,2045,48,0,0,0,48,A
3-PA,2046,0,49,0,0,49,T
3-PA,2047,0,0,0,50,50,C
3-PA,2048,0,49,0,0,49,T
3-PA,2049,0,48,1,0,49,T
3-PA,2050,0,0,49,0,49,G
3-PA,2051,0,1,48,0,49,G
3-PA,2052,0,0,49,0,49,G
3-PA,2053,0,0,48,0,48,G
3-PA,2054,0,0,47,0,47,G
3-PA,2055,0,0,47,0,47,G
3-PA,2056,0,0,0,46,46,C
3-PA,2057,0,46,0,0,46,T
3-PA,2058,48,0,0,0,48,A
3-PA,2059,0,48,0,0,48,T
3-PA,2060,47,0,0,0,47,A
3-PA,2061,0,47,0,0,47,T
3-PA,2062,0,0,47,0,47,G
3-PA,2063,47,0,0,0,47,A
3-PA,2064,44,0,0,0,44,A
3-PA,2065,0,0,44,0,44,G
3-PA,2066,0,0,0,44,44,C
3-PA,2067,44,0,0,0,44,A
3-PA,2068,46,0,0,0,46,A
3-PA,2069,0,46,0,0,46,T
3-PA,2070,0,44,0,0,44,T
3-PA,2071,0,0,45,0,45,G
3-PA,2072,44,0,0,0,44,A
3-PA,2073,0,0,44,0,44,G
3-PA,2074,0,0,44,0,44,G
3-PA,2075,41,0,0,0,41,A
3-PA,2076,0,0,41,0,41,G
3-PA,2077,0,34,0,0,34,T
3-PA,2078,0,0,33,0,33,G
3-PA,2079,0,0,0,34,34,C
3-PA,2080,0,0,0,34,34,C
3-PA,2081,0,33,0,0,33,T
3-PA,2082,0,0,34,0,34,G
3-PA,2083,34,0,0,0,34,A
3-PA,2084,0,33,0,0,33,T
3-PA,2085,0,34,0,0,34,T
3-PA,2086,33,0,0,0,33,A
3-PA,2087,33,0,0,0,33,A
3-PA,2088,0,33,0,0,33,T
3-PA,2089,0,0,33,0,33,G
3-PA,2090,32,0,0,0,32,A
3-PA,2091,0,30,0,0,30,T
3-PA,2092,0,0,0,30,30,C
3-PA,2093,0,0,0,31,31,C
3-PA,2094,0,0,0,31,31,C
3-PA,2095,0,31,0,0,31,T
3-PA,2096,0,0,31,0,31,G
3-PA,2097,0,0,31,0,31,G
3-PA,2098,0,0,31,0,31,G
3-PA,2099,0,30,0,0,30,T
3-PA,2100,0,28,0,0,28,T
3-PA,2101,0,27,0,0,27,T
3-PA,2102,0,28,0,0,28,T
3-PA,2103,0,0,28,0,28,G
3-PA,2104,0,0,0,28,28,C
3-PA,2105,0,28,0,0,28,T
3-PA,2106,1,0,0,27,28,C
3-PA,2107,27,0,0,0,27,A
3-PA,2108,27,0,0,0,27,A
3-PA,2109,0,27,0,0,27,T
3-PA,2110,0,0,27,0,27,G
3-PA,2111,0,0,0,26,26,C
3-PA,2112,0,0,27,0,27,G
3-PA,2113,0,27,0,0,27,T
3-PA,2114,0,0,0,27,27,C
3-PA,2115,0,26,0,0,26,T
3-PA,2116,0,26,0,0,26,T
3-PA,2117,0,0,26,0,26,G
3-PA,2118,0,0,26,0,26,G
3-PA,2119,0,26,0,0,26,T
3-PA,2120,0,26,0,0,26,T
3-PA,2121,0,0,0,25,25,C
3-PA,2122,23,0,0,0,23,A
3-PA,2123,23,0,0,0,23,A
3-PA,2124,0,0,0,24,24,C
3-PA,2125,0,23,0,0,23,T
3-PA,2126,0,0,0,23,23,C
3-PA,2127,0,0,0,22,22,C
3-PA,2128,0,22,0,0,22,T
3-PA,2129,0,22,0,0,22,T
3-PA,2130,0,0,0,22,22,C
3-PA,2131,0,0,0,22,22,C
3-PA,2132,0,19,0,0,19,T
3-PA,2133,0,0,19,0,19,G
3-PA,2134,19,0,0,0,19,A
3-PA,2135,0,0,0,19,19,C
3-PA,2136,18,0,0,0,18,A
3-PA,2137,0,0,0,16,16,C
3-PA,2138,15,0,0,0,15,A
3-PA,2139,0,15,0,0,15,T
3-PA,2140,0,0,15,0,15,G
3-PA,2141,0,0,0,15,15,C
3-PA,2142,14,0,0,0,14,A
3-PA,2143,0,14,0,0,14,T
3-PA,2144,0,14,0,0,14,T
3-PA,2145,14,0,0,0,14,A
3-PA,2146,14,0,0,0,14,A
3-PA,2147,14,0,0,0,14,A
3-PA,2148,14,0,0,0,14,A
3-PA,2149,0,14,0,0,14,T
3-PA,2150,13,0,0,0,13,A
3-PA,2151,0,0,13,0,13,G
4-HA,1,255,0,0,0,255,A
4-HA,2,0,256,0,0,256,T
4-HA,3,0,0,266,0,266,G
4-HA,4,272,0,0,1,273,A
4-HA,5,279,0,0,0,279,A
4-HA,6,0,1,309,0,310,G
4-HA,7,309,0,0,0,309,A
4-HA,8,0,0,0,331,331,C
4-HA,9,0,334,0,0,334,T
4-HA,10,349,0,0,1,350,A
4-HA,11,0,373,0,0,373,T
4-HA,12,0,0,0,378,378,C
4-HA,13,379,0,0,1,380,A
4-HA,14,0,382,0,0,382,T
4-HA,15,0,384,0,0,384,T
4-HA,16,0,0,416,0,416,G
4-HA,17,0,0,0,416,416,C
4-HA,18,0,418,0,0,418,T
4-HA,19,0,418,0,0,418,T
4-HA,20,0,420,0,0,420,T
4-HA,21,0,3,448,0,451,G
4-HA,22,450,1,0,0,451,A
4-HA,23,0,0,465,0,465,G
4-HA,24,0,0,0,468,468,C
4-HA,25,0,467,0,0,467,T
4-HA,26,498,0,0,1,499,A
4-HA,27,0,0,0,504,504,C
4-HA,28,510,0,0,1,511,A
4-HA,29,0,529,0,2,531,T
4-HA,30,0,530,0,0,530,T
4-HA,31,0,0,0,537,537,C
4-HA,32,1,534,0,0,535,T
4-HA,33,547,0,1,0,548,A
4-HA,34,0,549,1,0,550,T
4-HA,35,1,0,552,0,553,G
4-HA,36,0,555,0,0,555,T
4-HA,37,1,1,0,553,555,C
4-HA,38,0,554,0,0,554,T
4-HA,39,1,3,553,0,557,G
4-HA,40,0,0,557,0,557,G
4-HA,41,0,554,0,0,554,T
4-HA,42,0,558,0,0,558,T
4-HA,43,0,560,0,0,560,T
4-HA,44,0,559,0,0,559,T
4-HA,45,0,1,0,556,557,C
4-HA,46,0,0,558,0,558,G
4-HA,47,1,1,0,571,573,C
4-HA,48,0,571,0,0,571,T
4-HA,49,0,0,0,571,571,C
4-HA,50,571,0,0,0,571,A
4-HA,51,569,0,0,1,570,A
4-HA,52,571,0,0,1,572,A
4-HA,53,571,0,0,0,571,A
4-HA,54,570,0,0,0,570,A
4-HA,55,0,0,0,579,579,C
4-HA,56,0,578,0,0,578,T
4-HA,57,0,577,0,0,577,T
4-HA,58,2,0,0,577,579,C
4-HA,59,0,0,0,580,580,C
4-HA,60,0,577,0,0,577,T
4-HA,61,0,2,578,0,580,G
4-HA,62,0,2,581,0,583,G
4-HA,63,581,1,1,0,583,A
4-HA,64,595,0,0,0,595,A
4-HA,65,599,0,0,0,599,A
4-HA,66,0,606,0,0,606,T
4-HA,67,0,3,606,0,609,G
4-HA,68,611,0,0,0,611,A
4-HA,69,1,0,0,615,616,C
4-HA,70,615,0,0,0,615,A
4-HA,71,615,0,0,1,616,A
4-HA,72,0,0,0,630,630,C
4-HA,73,627,0,0,0,627,A
4-HA,74,0,0,641,0,641,G
4-HA,75,0,0,0,638,638,C
4-HA,76,639,0,0,0,639,A
4-HA,77,0,0,0,654,654,C
4-HA,78,0,5,645,0,650,G
4-HA,79,0,1,654,1,656,G
4-HA,80,0,1,0,656,657,C
4-HA,81,657,0,0,1,658,A
4-HA,82,668,1,1,0,670,A
4-HA,83,0,1,0,673,674,C
4-HA,84,0,1,680,0,681,G
4-HA,85,0,0,0,683,683,C
4-HA,86,0,678,0,0,678,T
4-HA,87,0,1,682,0,683,G
4-HA,88,0,683,0,0,683,T
4-HA,89,1,1,700,0,702,G
4-HA,90,1,0,0,705,706,C
4-HA,91,0,0,0,722,722,C
4-HA,92,0,720,0,0,720,T
4-HA,93,0,717,0,0,717,T
4-HA,94,0,3,719,0,722,G
4-HA,95,2,2,723,0,727,G
4-HA,96,0,3,736,0,739,G
4-HA,97,0,0,0,749,749,C
4-HA,98,743,0,0,0,743,A
4-HA,99,1,0,0,748,749,C
4-HA,100,3,0,0,736,739,C
4-HA,101,797,0,2,0,799,A
4-HA,102,0,803,0,0,803,T
4-HA,103,0,1,799,0,800,G
4-HA,104,0,1,0,802,803,C
4-HA,105,790,0,1,0,791,A
4-HA,106,0,1,836,0,837,G
4-HA,107,0,837,0,0,837,T
4-HA,108,834,0,1,0,835,A
4-HA,109,0,0,0,838,838,C
4-HA,110,4,0,0,809,813,C
4-HA,111,818,0,0,0,818,A
4-HA,112,816,0,0,0,816,A
4-HA,113,817,0,0,0,817,A
4-HA,114,0,0,0,827,827,C
4-HA,115,0,6,802,0,808,G
4-HA,116,1,4,836,0,841,G
4-HA,117,837,1,1,0,839,A
4-HA,118,841,0,1,0,842,A
4-HA,119,1,0,0,841,842,C
4-HA,120,836,0,0,0,836,A
4-HA,121,860,0,0,0,860,A
4-HA,122,0,863,0,0,863,T
4-HA,123,868,0,1,0,869,A
4-HA,124,0,2,869,0,871,G
4-HA,125,1,857,0,1,859,T
4-HA,126,1,3,858,0,862,G
4-HA,127,858,0,0,0,858,A
4-HA,128,861,0,0,0,861,A
4-HA,129,858,0,2,1,861,A
4-HA,130,854,1,0,1,856,A
4-HA,131,1,1,0,861,863,C
4-HA,132,856,0,0,0,856,A
4-HA,133,858,0,2,0,860,A
4-HA,134,0,860,0,0,860,T
4-HA,135,6,0,0,849,855,C
4-HA,136,857,0,0,0,857,A
4-HA,137,1,0,0,860,861,C
4-HA,138,1,6,854,0,861,G
4-HA,139,858,0,0,0,858,A
4-HA,140,859,0,0,0,859,A
4-HA,141,0,859,0,0,859,T
4-HA,142,0,8,851,0,859,G
4-HA,143,866,0,1,0,867,A
4-HA,144,0,0,0,864,864,C
4-HA,145,2,2,0,858,862,C
4-HA,146,867,1,0,0,868,A
4-HA,147,867,0,0,0,867,A
4-HA,148,869,0,0,1,870,A
4-HA,149,1,872,0,0,873,T
4-HA,150,0,868,0,0,868,T
4-HA,151,0,5,868,0,873,G
4-HA,152,869,0,1,0,870,A
4-HA,153,870,0,1,0,871,A
4-HA,154,1,0,880,0,881,G
4-HA,155,0,878,0,0,878,T
4-HA,156,0,895,0,0,895,T
4-HA,157,900,0,0,0,900,A
4-HA,158,2,0,0,904,906,C
4-HA,159,0,904,0,0,904,T
4-HA,160,902,0,0,0,902,A
4-HA,161,919,0,0,0,919,A
4-HA,162,0,919,0,0,919,T
4-HA,163,0,0,922,0,922,G
4-HA,164,2,1,0,945,948,C
4-HA,165,0,944,0,0,944,T
4-HA,166,946,0,0,0,946,A
4-HA,167,2,0,0,944,946,C
4-HA,168,0,943,0,0,943,T
4-HA,169,0,3,951,0,954,G
4-HA,170,937,1,2,0,940,A
4-HA,171,0,0,940,0,940,G
4-HA,172,0,0,0,940,940,C
4-HA,173,0,911,0,0,911,T
4-HA,174,0,4,931,0,935,G
4-HA,175,1,3,943,0,947,G
4-HA,176,0,952,0,0,952,T
4-HA,177,1,948,0,0,949,T
4-HA,178,2,0,0,943,945,C
4-HA,179,940,1,0,0,941,A
4-HA,180,0,3,943,0,946,G
4-HA,181,942,0,1,0,943,A
4-HA,182,0,1,963,0,964,G
4-HA,183,1,944,1,0,946,T
4-HA,184,0,937,0,0,937,T
4-HA,185,2,1,0,943,946,C
4-HA,186,5,1,1,943,950,C
4-HA,187,0,941,0,1,942,T
4-HA,188,4,0,0,947,951,C
4-HA,189,950,0,0,1,951,A
4-HA,190,954,0,0,0,954,A
4-HA,191,1,0,0,953,954,C
4-HA,192,936,0,0,0,936,A
4-HA,193,0,7,948,1,956,G
4-HA,194,1,2,956,0,959,G
4-HA,195,0,955,0,0,955,T
4-HA,196,0,2,958,0,960,G
4-HA,197,965,0,0,0,965,A
4-HA,198,966,0,1,1,968,A
4-HA,199,996,0,0,0,996,A
4-HA,200,0,989,0,0,989,T
4-HA,201,994,0,0,0,994,A
4-HA,202,0,983,0,0,983,T
4-HA,203,0,0,983,0,983,G
4-HA,204,0,1,0,988,989,C
4-HA,205,1,1,986,0,988,G
4-HA,206,991,0,0,0,991,A
4-HA,207,1,1,0,989,991,C
4-HA,208,969,0,1,0,970,A
4-HA,209,0,2,1044,0,1046,G
4-HA,210,0,1038,0,0,1038,T
4-HA,211,3,1,0,1045,1049,C
4-HA,212,2,0,0,1044,1046,C
4-HA,213,0,1043,1,0,1044,T
4-HA,214,2,0,0,1063,1065,C
4-HA,215,1062,0,1,0,1063,A
4-HA,216,1,1061,0,0,1062,T
4-HA,217,2,0,0,1068,1070,C
4-HA,218,1030,0,0,0,1030,A
4-HA,219,0,3,1034,0,1037,G
4-HA,220,1025,0,0,0,1025,A
4-HA,221,0,1026,0,0,1026,T
4-HA,222,2,0,0,1033,1035,C
4-HA,223,2,0,0,1032,1034,C
4-HA,224,0,1030,0,0,1030,T
4-HA,225,1,1035,0,0,1036,T
4-HA,226,1,4,1032,0,1037,G
4-HA,227,1034,0,2,1,1037,A
4-HA,228,0,1028,0,0,1028,T
4-HA,229,1,8,1034,1,1044,G
4-HA,230,0,3,1042,0,1045,G
4-HA,231,1040,0,2,0,1042,A
4-HA,232,0,4,1039,0,1043,G
4-HA,233,1029,1,1,0,1031,A
4-HA,234,0,1,1025,0,1026,G
4-HA,235,1057,0,0,0,1057,A
4-HA,236,1059,0,1,0,1060,A
4-HA,237,4,0,0,1063,1067,C
4-HA,238,0,1046,0,0,1046,T
4-HA,239,0,0,1065,0,1065,G
4-HA,240,0,0,0,1063,1063,C
4-HA,241,1064,0,2,1,1067,A
4-HA,242,1,1,0,1094,1096,C
4-HA,243,1083,0,0,0,1083,A
4-HA,244,1,0,0,1190,1191,C
4-HA,245,0,1187,0,0,1187,T
4-HA,246,1199,0,0,0,1199,A
4-HA,247,1196,1,0,0,1197,A
4-HA,248,0,1192,1,0,1193,T
4-HA,249,1192,0,0,0,1192,A
4-HA,250,0,1,1192,0,1193,G
4-HA,251,1168,0,0,0,1168,A
4-HA,252,0,1150,0,0,1150,T
4-HA,253,0,2,1108,0,1110,G
4-HA,254,0,0,0,1116,1116,C
4-HA,255,0,1106,0,0,1106,T
4-HA,256,2,0,0,1185,1187,C
4-HA,257,0,1189,0,0,1189,T
4-HA,258,1225,0,0,0,1225,A
4-HA,259,0,1227,1,0,1228,T
4-HA,260,0,1219,1,0,1220,T
4-HA,261,0,3,1222,0,1225,G
4-HA,262,1,1,1212,0,1214,G
4-HA,263,0,5,1220,0,1225,G
4-HA,264,1206,0,2,0,1208,A
4-HA,265,0,2,1192,0,1194,G
4-HA,266,1166,0,3,0,1169,A
4-HA,267,0,0,0,1252,1252,C
4-HA,268,4,0,0,1269,1273,C
4-HA,269,9,0,0,1279,1288,C
4-HA,270,0,1293,1,0,1294,T
4-HA,271,1,0,0,1305,1306,C
4-HA,272,1309,0,0,0,1309,A
4-HA,273,1123,0,177,0,1300,A
4-HA,274,0,1333,0,0,1333,T
4-HA,275,0,2,1349,0,1351,G
4-HA,276,0,1348,0,1,1349,T
4-HA,277,0,1,1348,0,1349,G
4-HA,278,1343,0,1,0,1344,A
4-HA,279,0,1344,0,0,1344,T
4-HA,280,0,1,1336,0,1337,G
4-HA,281,0,0,1336,0,1336,G
4-HA,282,1,0,0,1342,1343,C
4-HA,283,0,1346,0,0,1346,T
4-HA,284,0,1342,0,0,1342,T
4-HA,285,4,0,0,1340,1344,C
4-HA,286,3,1,0,1337,1341,C
4-HA,287,1347,0,0,0,1347,A
4-HA,288,1343,0,0,0,1343,A
4-HA,289,1347,0,1,0,1348,A
4-HA,290,1351,0,0,0,1351,A
4-HA,291,0,1357,0,0,1357,T
4-HA,292,1348,0,0,1,1349,A
4-HA,293,1357,0,1,0,1358,A
4-HA,294,0,0,1358,0,1358,G
4-HA,295,1368,0,0,0,1368,A
4-HA,296,1373,0,0,0,1373,A
4-HA,297,1372,0,0,0,1372,A
4-HA,298,0,1373,0,0,1373,T
4-HA,299,1,10,1363,0,1374,G
4-HA,300,0,4,1368,0,1372,G
4-HA,301,6,2,1362,0,1370,G
4-HA,302,1372,0,2,0,1374,A
4-HA,303,6,0,0,1370,1376,C
4-HA,304,4,0,0,1371,1375,C
4-HA,305,0,1398,0,2,1400,T
4-HA,306,0,1400,0,0,1400,T
4-HA,307,0,1394,0,0,1394,T
4-HA,308,1,1412,0,0,1413,T
4-HA,309,0,1410,0,0,1410,T
4-HA,310,1,1,1413,0,1415,G
4-HA,311,0,1411,0,1,1412,T
4-HA,312,0,1407,0,1,1408,T
4-HA,313,1,6,1402,0,1409,G
4-HA,314,1393,1,0,0,1394,A
4-HA,315,1397,0,1,0,1398,A
4-HA,316,0,0,0,1405,1405,C
4-HA,317,0,1,1392,0,1393,G
4-HA,318,0,1,0,1415,1416,C
4-HA,319,1408,0,1,0,1409,A
4-HA,320,1,0,1412,0,1413,G
4-HA,321,0,0,0,1416,1416,C
4-HA,322,1418,0,1,0,1419,A
4-HA,323,1418,0,2,0,1420,A
4-HA,324,1419,0,3,1,1423,A
4-HA,325,0,1,1476,1,1478,G
4-HA,326,1,0,0,1475,1476,C
4-HA,327,7,0,0,1474,1481,C
4-HA,328,0,1475,0,0,1475,T
4-HA,329,1474,0,0,0,1474,A
4-HA,330,1,1,0,1495,1497,C
4-HA,331,1487,0,1,0,1488,A
4-HA,332,1,1,1488,0,1490,G
4-HA,333,0,1,0,1482,1483,C
4-HA,334,1456,0,0,0,1456,A
4-HA,335,1466,0,1,0,1467,A
4-HA,336,2,1,0,1526,1529,C
4-HA,337,0,1521,0,0,1521,T
4-HA,338,0,1,1525,0,1526,G
4-HA,339,0,1515,0,0,1515,T
4-HA,340,0,1515,1,0,1516,T
4-HA,341,1522,0,1,0,1523,A
4-HA,342,0,0,0,1623,1623,C
4-HA,343,8,0,1,1618,1627,C
4-HA,344,11,0,0,1644,1655,C
4-HA,345,1,1608,1,0,1610,T
4-HA,346,1,1607,0,1,1609,T
4-HA,347,1610,0,0,0,1610,A
4-HA,348,0,1607,0,2,1609,T
4-HA,349,1,1,1605,0,1607,G
4-HA,350,1605,0,0,0,1605,A
4-HA,351,0,1499,0,1,1500,T
4-HA,352,0,2,1533,0,1535,G
4-HA,353,0,1502,0,0,1502,T
4-HA,354,1,0,1493,1,1495,G
4-HA,355,0,0,0,1490,1490,C
4-HA,356,6,1,0,1491,1498,C
4-HA,357,1,3,1528,0,1532,G
4-HA,358,0,3,1550,0,1553,G
4-HA,359,1549,0,0,0,1549,A
4-HA,360,1,1554,0,1,1556,T
4-HA,361,0,1533,0,0,1533,T
4-HA,362,1545,0,1,0,1546,A
4-HA,363,0,1543,0,0,1543,T
4-HA,364,1,1,1548,0,1550,G
4-HA,365,2,0,0,1542,1544,C
4-HA,366,6,0,0,1531,1537,C
4-HA,367,0,1549,1,0,1550,T
4-HA,368,8,0,0,1614,1622,C
4-HA,369,6,1,1,1633,1641,C
4-HA,370,4,0,0,1643,1647,C
4-HA,371,1,1629,0,0,1630,T
4-HA,372,0,1641,0,0,1641,T
4-HA,373,1643,0,4,0,1647,A
4-HA,374,1,3,1687,0,1691,G
4-HA,375,1,0,1695,0,1696,G
4-HA,376,0,1671,0,4,1675,T
4-HA,377,6,1,0,1626,1633,C
4-HA,378,1599,0,0,0,1599,A
4-HA,379,2,0,0,1622,1624,C
4-HA,380,0,1623,0,0,1623,T
4-HA,381,1620,0,0,0,1620,A
4-HA,382,3,3,1617,0,1623,G
4-HA,383,1,1598,0,0,1599,T
4-HA,384,0,1591,1,1,1593,T
4-HA,385,1,0,1613,0,1614,G
4-HA,386,1,0,1,1610,1612,C
4-HA,387,2,0,0,1608,1610,C
4-HA,388,0,1586,0,1,1587,T
4-HA,389,4,0,0,1594,1598,C
4-HA,390,1644,1,0,0,1645,A
4-HA,391,0,1644,0,1,1645,T
4-HA,392,3,0,0,1645,1648,C
4-HA,393,8,1,0,1642,1651,C
4-HA,394,0,4,1633,0,1637,G
4-HA,395,0,2,1641,0,1643,G
4-HA,396,1,0,0,1647,1648,C
4-HA,397,1658,0,1,0,1659,A
4-HA,398,3,1,2,1668,1674,C
4-HA,399,1637,1,1,0,1639,A
4-HA,400,0,1,0,1641,1642,C
4-HA,401,0,1632,0,2,1634,T
4-HA,402,0,4,1648,0,1652,G
4-HA,403,0,0,1660,0,1660,G
4-HA,404,1652,0,4,0,1656,A
4-HA,405,6,0,1681,0,1687,G
4-HA,406,0,1669,0,0,1669,T
4-HA,407,1,1665,0,0,1666,T
4-HA,408,0,1654,1,7,1662,T
4-HA,409,1661,1,0,0,1662,A
4-HA,410,1661,0,2,0,1663,A
4-HA,411,0,0,0,1671,1671,C
4-HA,412,1642,0,1,0,1643,A
4-HA,413,1640,1,2,0,1643,A
4-HA,414,0,1629,1,0,1630,T
4-HA,415,1,2,1625,0,1628,G
4-HA,416,1631,0,1,0,1632,A
4-HA,417,1622,1,1,0,1624,A
4-HA,418,1619,0,3,2,1624,A
4-HA,419,0,0,1629,0,1629,G
4-HA,420,0,0,0,1657,1657,C
4-HA,421,0,1654,0,0,1654,T
4-HA,422,0,1652,0,1,1653,T
4-HA,423,7,0,0,1662,1669,C
4-HA,424,1668,0,3,0,1671,A
4-HA,425,1667,1,2,1,1671,A
4-HA,426,0,1675,0,3,1678,T
4-HA,427,1,1672,0,0,1673,T
4-HA,428,1,9,1699,0,1709,G
4-HA,429,0,6,1718,0,1724,G
4-HA,430,1722,0,2,0,1724,A
4-HA,431,0,0,0,1726,1726,C
4-HA,432,0,1711,1,1,1713,T
4-HA,433,2,6,1713,0,1721,G
4-HA,434,1,5,1729,0,1735,G
4-HA,435,1733,0,0,1,1734,A
4-HA,436,1,1,1739,0,1741,G
4-HA,437,0,1711,1,3,1715,T
4-HA,438,7,0,0,1696,1703,C
4-HA,439,1721,0,1,0,1722,A
4-HA,440,0,0,0,1730,1730,C
4-HA,441,1,1711,2,2,1716,T
4-HA,442,8,0,0,1713,1721,C
4-HA,443,1697,0,1,0,1698,A
4-HA,444,1714,0,0,0,1714,A
4-HA,445,1710,0,2,0,1712,A
4-HA,446,1716,0,3,1,1720,A
4-HA,447,0,2,0,1719,1721,C
4-HA,448,0,7,1696,0,1703,G
4-HA,449,1,10,1706,0,1717,G
4-HA,450,1722,0,0,0,1722,A
4-HA,451,1725,0,1,0,1726,A
4-HA,452,0,1,0,1724,1725,C
4-HA,453,1709,0,0,0,1709,A
4-HA,454,1723,0,3,0,1726,A
4-HA,455,0,0,1733,0,1733,G
4-HA,456,2,0,0,1736,1738,C
4-HA,457,0,1723,0,3,1726,T
4-HA,458,7,0,0,1738,1745,C
4-HA,459,0,1735,0,0,1735,T
4-HA,460,1,1,1746,0,1748,G
4-HA,461,2,0,1,1742,1745,C
4-HA,462,0,1741,0,5,1746,T
4-HA,463,0,1777,0,1,1778,T
4-HA,464,2,1,1805,0,1808,G
4-HA,465,0,0,0,1820,1820,C
4-HA,466,1816,0,0,1,1817,A
4-HA,467,0,1806,0,0,1806,T
4-HA,468,1801,0,0,1,1802,A
4-HA,469,1787,1,1,1,1790,A
4-HA,470,4,9,1774,0,1787,G
4-HA,471,0,8,1782,0,1790,G
4-HA,472,1731,0,0,1,1732,A
4-HA,473,0,2,1727,0,1729,G
4-HA,474,1704,0,1,0,1705,A
4-HA,475,0,1755,0,0,1755,T
4-HA,476,3,0,0,1764,1767,C
4-HA,477,0,1778,0,1,1779,T
4-HA,478,1784,0,0,0,1784,A
4-HA,479,1776,0,2,0,1778,A
4-HA,480,0,1777,0,0,1777,T
4-HA,481,1771,0,1,0,1772,A
4-HA,482,1749,0,0,0,1749,A
4-HA,483,2,1,0,1745,1748,C
4-HA,484,1702,2,0,0,1704,A
4-HA,485,0,0,1707,0,1707,G
4-HA,486,0,1692,0,2,1694,T
4-HA,487,0,1715,0,4,1719,T
4-HA,488,0,1718,0,0,1718,T
4-HA,489,5,1,0,1753,1759,C
4-HA,490,0,1757,1,0,1758,T
4-HA,491,0,1758,0,0,1758,T
4-HA,492,0,1758,0,2,1760,T
4-HA,493,1743,0,0,0,1743,A
4-HA,494,0,1,1748,0,1749,G
4-HA,495,0,1732,0,0,1732,T
4-HA,496,1732,0,1,0,1733,A
4-HA,497,0,4,1730,0,1734,G
4-HA,498,1700,0,0,0,1700,A
4-HA,499,1,1699,0,0,1700,T
4-HA,500,0,1695,0,0,1695,T
4-HA,501,1,5,1727,0,1733,G
4-HA,502,1729,0,0,0,1729,A
4-HA,503,1732,0,0,0,1732,A
4-HA,504,0,1728,0,0,1728,T
4-HA,505,0,1708,0,0,1708,T
4-HA,506,0,8,1707,0,1715,G
4-HA,507,1,1,1715,0,1717,G
4-HA,508,0,1719,0,1,1720,T
4-HA,509,0,1716,0,0,1716,T
4-HA,510,1,6,1696,0,1703,G
4-HA,511,1700,0,1,0,1701,A
4-HA,512,0,1,0,1684,1685,C
4-HA,513,6,0,0,1674,1680,C
4-HA,514,13,0,0,1671,1684,C
4-HA,515,1686,0,0,0,1686,A
4-HA,516,0,0,0,1693,1693,C
4-HA,517,1,1688,0,0,1689,T
4-HA,518,0,1692,0,1,1693,T
4-HA,519,1687,0,5,0,1692,A
4-HA,520,1687,0,0,1,1688,A
4-HA,521,1688,0,0,0,1688,A
4-HA,522,1691,0,0,0,1691,A
4-HA,523,0,1724,0,0,1724,T
4-HA,524,0,1713,0,0,1713,T
4-HA,525,8,0,1,1707,1716,C
4-HA,526,1715,0,1,0,1716,A
4-HA,527,1717,0,0,0,1717,A
4-HA,528,1717,0,2,0,1719,A
4-HA,529,0,1722,0,1,1723,T
4-HA,530,1770,0,1,0,1771,A
4-HA,531,2,0,0,1774,1776,C
4-HA,532,9,0,0,1726,1735,C
4-HA,533,9,2,2,1727,1740,C
4-HA,534,1728,0,0,0,1728,A
4-HA,535,0,0,1790,0,1790,G
4-HA,536,1,0,0,1792,1793,C
4-HA,537,1791,0,0,0,1791,A
4-HA,538,0,1784,0,2,1786,T
4-HA,539,0,1739,0,1,1740,T
4-HA,540,1,8,1773,0,1782,G
4-HA,541,1790,0,1,0,1791,A
4-HA,542,1786,0,2,0,1788,A
4-HA,543,0,1,0,1792,1793,C
4-HA,544,1,0,1747,0,1748,G
4-HA,545,0,1758,0,1,1759,T
4-HA,546,1,8,1751,0,1760,G
4-HA,547,1761,0,1,0,1762,A
4-HA,548,2,1,1,1755,1759,C
4-HA,549,2,1694,0,1,1697,T
4-HA,550,1738,0,0,0,1738,A
4-HA,551,1,1735,0,1,1737,T
4-HA,552,0,1,1747,0,1748,G
4-HA,553,1,0,0,1749,1750,C
4-HA,554,8,1,0,1711,1720,C
4-HA,555,1718,0,0,0,1718,A
4-HA,556,1713,1,1,0,1715,A
4-HA,557,1739,1,1,0,1741,A
4-HA,558,0,0,0,1749,1749,C
4-HA,559,1708,0,0,0,1708,A
4-HA,560,1707,0,1,0,1708,A
4-HA,561,0,1695,0,1,1696,T
4-HA,562,1,7,1689,1,1698,G
4-HA,563,1706,1,0,0,1707,A
4-HA,564,1703,0,0,0,1703,A
4-HA,565,3,0,0,1659,1662,C
4-HA,566,1671,0,0,0,1671,A
4-HA,567,1679,0,0,0,1679,A
4-HA,568,0,1668,0,1,1669,T
4-HA,569,0,1673,1,2,1676,T
4-HA,570,0,1682,0,0,1682,T
4-HA,571,0,7,1667,1,1675,G
4-HA,572,1677,1,1,0,1679,A
4-HA,573,4,1,0,1674,1679,C
4-HA,574,1677,0,1,0,1678,A
4-HA,575,1683,0,0,0,1683,A
4-HA,576,1699,0,0,0,1699,A
4-HA,577,0,1718,1,0,1719,T
4-HA,578,0,1717,0,0,1717,T
4-HA,579,0,2,1728,0,1730,G
4-HA,580,0,1720,0,2,1722,T
4-HA,581,1731,0,1,0,1732,A
4-HA,582,3,2,0,1760,1765,C
4-HA,583,1764,0,0,0,1764,A
4-HA,584,1,1793,0,0,1794,T
4-HA,585,0,1775,0,1,1776,T
4-HA,586,0,1764,0,1,1765,T
4-HA,587,3,6,1746,0,1755,G
4-HA,588,1,12,1731,0,1744,G
4-HA,589,1,6,1734,0,1741,G
4-HA,590,1,3,1743,0,1747,G
4-HA,591,0,5,1722,0,1727,G
4-HA,592,2,3,1758,0,1763,G
4-HA,593,1,1735,1,1,1738,T
4-HA,594,0,1741,0,0,1741,T
4-HA,595,1,0,0,1727,1728,C
4-HA,596,1738,0,2,0,1740,A
4-HA,597,2,0,0,1749,1751,C
4-HA,598,5,0,0,1745,1750,C
4-HA,599,1754,0,2,0,1756,A
4-HA,600,1,0,0,1775,1776,C
4-HA,601,10,0,0,1725,1735,C
4-HA,602,15,0,1,1710,1726,C
4-HA,603,2,10,1720,0,1732,G
4-HA,604,0,4,1812,1,1817,G
4-HA,605,0,3,1819,0,1822,G
4-HA,606,0,1814,0,0,1814,T
4-HA,607,1812,0,1,0,1813,A
4-HA,608,0,4,0,1799,1803,C
4-HA,609,0,8,1765,0,1773,G
4-HA,610,1,5,1789,0,1795,G
4-HA,611,1799,1,0,0,1800,A
4-HA,612,2,0,0,1799,1801,C
4-HA,613,1673,1,1,0,1675,A
4-HA,614,1681,0,0,0,1681,A
4-HA,615,1,1682,0,0,1683,T
4-HA,616,0,12,1690,0,1702,G
4-HA,617,1704,0,1,0,1705,A
4-HA,618,1,0,0,1698,1699,C
4-HA,619,9,0,0,1665,1674,C
4-HA,620,1677,0,1,0,1678,A
4-HA,621,1676,0,1,2,1679,A
4-HA,622,1720,1,0,0,1721,A
4-HA,623,0,1713,0,1,1714,T
4-HA,624,3,0,0,1720,1723,C
4-HA,625,1,1689,0,2,1692,T
4-HA,626,0,1687,0,1,1688,T
4-HA,627,2,0,0,1703,1705,C
4-HA,628,5,2,1,1704,1712,C
4-HA,629,1,1700,0,1,1702,T
4-HA,630,1,0,1714,1,1716,G
4-HA,631,0,1692,0,1,1693,T
4-HA,632,1719,0,0,0,1719,A
4-HA,633,0,1707,0,0,1707,T
4-HA,634,0,0,1716,0,1716,G
4-HA,635,1,0,0,1715,1716,C
4-HA,636,0,1704,0,3,1707,T
4-HA,637,7,2,0,1707,1716,C
4-HA,638,1706,0,3,1,1710,A
4-HA,639,1704,0,1,1,1706,A
4-HA,640,0,0,1716,0,1716,G
4-HA,641,0,0,0,1719,1719,C
4-HA,642,1722,1,1,0,1724,A
4-HA,643,0,1711,0,0,1711,T
4-HA,644,8,0,0,1692,1700,C
4-HA,645,1697,0,0,0,1697,A
4-HA,646,0,8,1700,0,1708,G
4-HA,647,1,6,1706,0,1713,G
4-HA,648,1712,0,1,0,1713,A
4-HA,649,1702,0,4,0,1706,A
4-HA,650,0,3,1732,0,1735,G
4-HA,651,1728,1,1,0,1730,A
4-HA,652,1746,0,1,0,1747,A
4-HA,653,1,1761,0,2,1764,T
4-HA,654,6,0,0,1760,1766,C
4-HA,655,1750,0,4,1,1755,A
4-HA,656,3,0,0,1759,1762,C
4-HA,657,1756,0,0,0,1756,A
4-HA,658,0,0,1784,0,1784,G
4-HA,659,1,1744,0,1,1746,T
4-HA,660,7,1,0,1750,1758,C
4-HA,661,0,1734,0,0,1734,T
4-HA,662,7,0,0,1788,1795,C
4-HA,663,1,1796,1,0,1798,T
4-HA,664,1821,0,0,0,1821,A
4-HA,665,2,1,0,1811,1814,C
4-HA,666,8,3,0,1812,1823,C
4-HA,667,1782,0,0,0,1782,A
4-HA,668,1782,1,0,0,1783,A
4-HA,669,1771,0,0,0,1771,A
4-HA,670,1778,0,0,0,1778,A
4-HA,671,0,2,1780,0,1782,G
4-HA,672,1740,0,0,1,1741,A
4-HA,673,1733,0,1,0,1734,A
4-HA,674,0,0,1732,0,1732,G
4-HA,675,0,1,0,1738,1739,C
4-HA,676,3,0,0,1736,1739,C
4-HA,677,1748,0,0,0,1748,A
4-HA,678,1754,1,0,0,1755,A
4-HA,679,2,1,0,1750,1753,C
4-HA,680,1752,0,0,0,1752,A
4-HA,681,1754,0,0,1,1755,A
4-HA,682,1747,0,0,0,1747,A
4-HA,683,2,1,0,1792,1795,C
4-HA,684,0,1779,1,0,1780,T
4-HA,685,0,2,1791,0,1793,G
4-HA,686,0,1783,0,1,1784,T
4-HA,687,1789,0,0,0,1789,A
4-HA,688,1796,0,0,0,1796,A
4-HA,689,1,1779,0,0,1780,T
4-HA,690,2,1,1,1794,1798,C
4-HA,691,2,2,0,1794,1798,C
4-HA,692,7,2,0,1758,1767,C
4-HA,693,0,6,1763,0,1769,G
4-HA,694,1766,0,0,0,1766,A
4-HA,695,1768,0,1,0,1769,A
4-HA,696,0,1767,0,0,1767,T
4-HA,697,1779,0,0,1,1780,A
4-HA,698,0,1774,0,2,1776,T
4-HA,699,7,1,0,1749,1757,C
4-HA,700,1,5,1752,0,1758,G
4-HA,701,0,5,1815,0,1820,G
4-HA,702,1819,0,1,0,1820,A
4-HA,703,0,1825,0,0,1825,T
4-HA,704,1,1,0,1829,1831,C
4-HA,705,0,1819,0,2,1821,T
4-HA,706,1818,0,1,0,1819,A
4-HA,707,0,2,1829,0,1831,G
4-HA,708,1840,0,1,0,1841,A
4-HA,709,0,1,0,1840,1841,C
4-HA,710,5,3,0,1775,1783,C
4-HA,711,7,1,0,1782,1790,C
4-HA,712,1780,0,0,0,1780,A
4-HA,713,0,4,1909,0,1913,G
4-HA,714,1906,1,2,1,1910,A
4-HA,715,2,2,1934,0,1938,G
4-HA,716,0,1923,0,0,1923,T
4-HA,717,1908,0,0,0,1908,A
4-HA,718,1910,0,1,0,1911,A
4-HA,719,1,6,1941,0,1948,G
4-HA,720,1,6,1962,0,1969,G
4-HA,721,1943,1,1,0,1945,A
4-HA,722,1801,0,0,0,1801,A
4-HA,723,1,1802,0,0,1803,T
4-HA,724,1802,0,0,0,1802,A
4-HA,725,1,1788,0,2,1791,T
4-HA,726,1,1,0,1806,1808,C
4-HA,727,1,0,0,1804,1805,C
4-HA,728,9,1,0,1772,1782,C
4-HA,729,0,1771,0,0,1771,T
4-HA,730,1781,0,1,0,1782,A
4-HA,731,1,0,1788,0,1789,G
4-HA,732,2,0,1,1787,1790,C
4-HA,733,1760,1,0,0,1761,A
4-HA,734,1,4,1803,0,1808,G
4-HA,735,1783,1,0,0,1784,A
4-HA,736,1793,0,1,0,1794,A
4-HA,737,0,1794,0,0,1794,T
4-HA,738,1789,0,1,0,1790,A
4-HA,739,1809,1,1,0,1811,A
4-HA,740,0,1,1796,0,1797,G
4-HA,741,1,1,0,1804,1806,C
4-HA,742,1803,0,0,0,1803,A
4-HA,743,1,1757,0,0,1758,T
4-HA,744,5,0,0,1838,1843,C
4-HA,745,2,1838,0,0,1840,T
4-HA,746,1854,3,0,0,1857,A
4-HA,747,1,1854,0,0,1855,T
4-HA,748,0,1850,0,0,1850,T
4-HA,749,5,8,1848,0,1861,G
4-HA,750,0,2,1848,0,1850,G
4-HA,751,1857,0,1,0,1858,A
4-HA,752,1,1,0,1854,1856,C
4-HA,753,1750,0,0,0,1750,A
4-HA,754,1788,1,1,0,1790,A
4-HA,755,0,1866,0,1,1867,T
4-HA,756,1876,0,0,0,1876,A
4-HA,757,1,0,1891,0,1892,G
4-HA,758,1,1876,1,0,1878,T
4-HA,759,1877,1,0,0,1878,A
4-HA,760,1884,0,0,0,1884,A
4-HA,761,1896,1,0,0,1897,A
4-HA,762,1910,2,1,0,1913,A
4-HA,763,0,3,1,1917,1921,C
4-HA,764,5,3,0,1808,1816,C
4-HA,765,0,12,1797,1,1810,G
4-HA,766,1,7,1796,1,1805,G
4-HA,767,0,3,1821,0,1824,G
4-HA,768,1831,0,2,0,1833,A
4-HA,769,0,4,1839,0,1843,G
4-HA,770,1865,0,2,0,1867,A
4-HA,771,2,4,0,1857,1863,C
4-HA,772,1853,0,2,5,1860,A
4-HA,773,0,1868,0,1,1869,T
4-HA,774,1880,0,0,0,1880,A
4-HA,775,1,0,0,1897,1898,C
4-HA,776,0,1866,1,1,1868,T
4-HA,777,0,1882,0,2,1884,T
4-HA,778,0,1887,0,1,1888,T
4-HA,779,0,1878,0,0,1878,T
4-HA,780,0,9,1885,0,1894,G
4-HA,781,1906,0,0,0,1906,A
4-HA,782,0,1902,0,0,1902,T
4-HA,783,0,1948,1,0,1949,T
4-HA,784,1940,1,0,0,1941,A
4-HA,785,1951,0,2,0,1953,A
4-HA,786,3,1,0,1980,1984,C
4-HA,787,1977,0,3,0,1980,A
4-HA,788,1,0,2048,0,2049,G
4-HA,789,0,1,0,2037,2038,C
4-HA,790,2037,0,1,0,2038,A
4-HA,791,0,2,0,2058,2060,C
4-HA,792,2037,0,0,0,2037,A
4-HA,793,0,10,2049,1,2060,G
4-HA,794,1,8,2037,0,2046,G
4-HA,795,0,4,2102,0,2106,G
4-HA,796,2100,0,4,0,2104,A
4-HA,797,2103,0,1,0,2104,A
4-HA,798,0,2096,0,0,2096,T
4-HA,799,6,0,0,2103,2109,C
4-HA,800,0,2112,0,0,2112,T
4-HA,801,2129,0,0,0,2129,A
4-HA,802,2117,0,0,0,2117,A
4-HA,803,0,2104,1,0,2105,T
4-HA,804,0,2029,0,2,2031,T
4-HA,805,0,2,2055,0,2057,G
4-HA,806,0,0,0,2100,2100,C
4-HA,807,1,2136,0,1,2138,T
4-HA,808,4,1,0,2188,2193,C
4-HA,809,5,0,0,2187,2192,C
4-HA,810,0,2179,0,1,2180,T
4-HA,811,2192,0,0,1,2193,A
4-HA,812,1,13,2182,1,2197,G
4-HA,813,1,19,2183,0,2203,G
4-HA,814,1,4,2208,0,2213,G
4-HA,815,0,2,2201,0,2203,G
4-HA,816,1,2161,0,0,2162,T
4-HA,817,0,2144,0,2,2146,T
4-HA,818,2148,0,2,1,2151,A
4-HA,819,2,0,0,2188,2190,C
4-HA,820,0,2170,1,1,2172,T
4-HA,821,1,2181,0,0,2182,T
4-HA,822,5,0,0,2178,2183,C
4-HA,823,2174,1,0,0,2175,A
4-HA,824,2180,0,0,1,2181,A
4-HA,825,2184,0,1,0,2185,A
4-HA,826,2210,0,0,0,2210,A
4-HA,827,0,2202,0,0,2202,T
4-HA,828,2185,0,0,0,2185,A
4-HA,829,0,1,0,2182,2183,C
4-HA,830,2,4,2172,0,2178,G
4-HA,831,2189,0,2,0,2191,A
4-HA,832,2181,1,1,0,2183,A
4-HA,833,0,1,2220,0,2221,G
4-HA,834,0,2214,0,0,2214,T
4-HA,835,0,13,2213,0,2226,G
4-HA,836,0,7,2216,1,2224,G
4-HA,837,2,3,2225,0,2230,G
4-HA,838,2235,0,1,0,2236,A
4-HA,839,2239,0,0,0,2239,A
4-HA,840,2232,0,2,0,2234,A
4-HA,841,2215,0,1,0,2216,A
4-HA,842,0,1,2262,0,2263,G
4-HA,843,1,0,0,2258,2259,C
4-HA,844,0,2249,1,0,2250,T
4-HA,845,12,0,0,2261,2273,C
4-HA,846,2282,0,0,0,2282,A
4-HA,847,2293,0,1,0,2294,A
4-HA,848,1,2297,0,0,2298,T
4-HA,849,2314,0,0,0,2314,A
4-HA,850,2309,0,0,0,2309,A
4-HA,851,0,2281,0,0,2281,T
4-HA,852,0,6,2286,0,2292,G
4-HA,853,2274,0,1,1,2276,A
4-HA,854,0,8,2325,0,2333,G
4-HA,855,2332,0,0,0,2332,A
4-HA,856,1,2320,0,0,2321,T
4-HA,857,4,0,1,2364,2369,C
4-HA,858,2352,0,0,0,2352,A
4-HA,859,0,2,2397,0,2399,G
4-HA,860,2394,1,1,1,2397,A
4-HA,861,1,2396,0,1,2398,T
4-HA,862,0,4,2397,0,2401,G
4-HA,863,2,2,0,2355,2359,C
4-HA,864,2362,0,2,0,2364,A
4-HA,865,2,1,1,2399,2403,C
4-HA,866,10,1,0,2361,2372,C
4-HA,867,8,1,0,2383,2392,C
4-HA,868,2354,0,2,0,2356,A
4-HA,869,0,2349,1,0,2350,T
4-HA,870,0,2347,0,1,2348,T
4-HA,871,1,8,2345,0,2354,G
4-HA,872,0,2,2348,0,2350,G
4-HA,873,1,0,0,2351,2352,C
4-HA,874,2327,0,1,0,2328,A
4-HA,875,2319,1,3,0,2323,A
4-HA,876,2352,0,0,0,2352,A
4-HA,877,0,2348,0,2,2350,T
4-HA,878,1,1,2343,0,2345,G
4-HA,879,3,0,0,2336,2339,C
4-HA,880,2323,0,1,0,2324,A
4-HA,881,2390,0,0,0,2390,A
4-HA,882,2,2381,0,1,2384,T
4-HA,883,0,2405,0,1,2406,T
4-HA,884,7,0,1,2398,2406,C
4-HA,885,0,2380,0,0,2380,T
4-HA,886,0,7,2399,1,2407,G
4-HA,887,2404,0,1,1,2406,A
4-HA,888,2418,0,0,0,2418,A
4-HA,889,0,2417,0,1,2418,T
4-HA,890,0,0,2406,1,2407,G
4-HA,891,2,0,1,2424,2427,C
4-HA,892,2423,0,1,0,2424,A
4-HA,893,0,2426,0,2,2428,T
4-HA,894,3,0,0,2410,2413,C
4-HA,895,2423,0,1,0,2424,A
4-HA,896,3,1,0,2504,2508,C
4-HA,897,0,2498,0,3,2501,T
4-HA,898,8,0,0,2500,2508,C
4-HA,899,9,0,0,2489,2498,C
4-HA,900,2494,1,1,0,2496,A
4-HA,901,2495,0,1,0,2496,A
4-HA,902,2494,0,0,0,2494,A
4-HA,903,0,2395,0,0,2395,T
4-HA,904,0,10,2399,0,2409,G
4-HA,905,0,5,2407,0,2412,G
4-HA,906,2416,1,0,0,2417,A
4-HA,907,2410,0,1,0,2411,A
4-HA,908,0,1,2421,0,2422,G
4-HA,909,3,0,0,2400,2403,C
4-HA,910,2402,0,2,0,2404,A
4-HA,911,0,2408,0,2,2410,T
4-HA,912,0,2400,0,1,2401,T
4-HA,913,5,1,0,2453,2459,C
4-HA,914,12,0,1,2437,2450,C
4-HA,915,16,0,0,2436,2452,C
4-HA,916,2451,0,2,0,2453,A
4-HA,917,2482,0,0,0,2482,A
4-HA,918,0,2517,0,0,2517,T
4-HA,919,0,10,2502,0,2512,G
4-HA,920,2508,1,3,0,2512,A
4-HA,921,2,1,0,2511,2514,C
4-HA,922,2450,0,0,0,2450,A
4-HA,923,2444,0,1,0,2445,A
4-HA,924,2448,0,2,0,2450,A
4-HA,925,3,1,0,2458,2462,C
4-HA,926,12,0,0,2425,2437,C
4-HA,927,2402,0,1,0,2403,A
4-HA,928,2,2402,0,3,2407,T
4-HA,929,2,2394,1,1,2398,T
4-HA,930,7,0,0,2411,2418,C
4-HA,931,9,1,0,2414,2424,C
4-HA,932,2415,0,0,0,2415,A
4-HA,933,2417,0,0,0,2417,A
4-HA,934,2390,0,1,0,2391,A
4-HA,935,2428,1,0,0,2429,A
4-HA,936,1,2423,0,0,2424,T
4-HA,937,2,1,2412,0,2415,G
4-HA,938,0,2403,0,0,2403,T
4-HA,939,0,2396,0,2,2398,T
4-HA,940,2430,1,0,1,2432,A
4-HA,941,2432,0,0,0,2432,A
4-HA,942,5,0,0,2433,2438,C
4-HA,943,2425,0,0,0,2425,A
4-HA,944,0,10,2429,0,2439,G
4-HA,945,0,10,2466,0,2476,G
4-HA,946,2524,0,1,0,2525,A
4-HA,947,0,2526,1,1,2528,T
4-HA,948,10,2,0,2534,2546,C
4-HA,949,2551,1,2,0,2554,A
4-HA,950,6,0,0,2638,2644,C
4-HA,951,2636,1,1,0,2638,A
4-HA,952,0,2707,1,3,2711,T
4-HA,953,2665,0,0,0,2665,A
4-HA,954,0,6,1,2617,2624,C
4-HA,955,5,19,2510,1,2535,G
4-HA,956,0,10,2536,0,2546,G
4-HA,957,0,6,2513,0,2519,G
4-HA,958,1,3,2538,0,2542,G
4-HA,959,3,0,0,2488,2491,C
4-HA,960,3,0,0,2471,2474,C
4-HA,961,0,2414,1,1,2416,T
4-HA,962,0,0,2626,0,2626,G
4-HA,963,1,2623,1,3,2628,T
4-HA,964,9,0,0,2625,2634,C
4-HA,965,5,1,0,2613,2619,C
4-HA,966,14,0,0,2608,2622,C
4-HA,967,2608,1,0,0,2609,A
4-HA,968,2,2,2620,0,2624,G
4-HA,969,2615,0,2,0,2617,A
4-HA,970,0,2600,0,1,2601,T
4-HA,971,2374,0,1,1,2376,A
4-HA,972,0,2317,0,2,2319,T
4-HA,973,0,1,2326,1,2328,G
4-HA,974,0,2318,0,0,2318,T
4-HA,975,0,2288,0,0,2288,T
4-HA,976,2306,1,1,0,2308,A
4-HA,977,2283,0,3,0,2286,A
4-HA,978,0,2,2312,0,2314,G
4-HA,979,2,0,0,2304,2306,C
4-HA,980,2264,1,0,0,2265,A
4-HA,981,2262,0,2,3,2267,A
4-HA,982,2252,1,1,0,2254,A
4-HA,983,2255,0,4,1,2260,A
4-HA,984,1,0,0,2258,2259,C
4-HA,985,2231,1,0,0,2232,A
4-HA,986,2,0,0,2248,2250,C
4-HA,987,2,2198,0,0,2200,T
4-HA,988,8,0,0,2211,2219,C
4-HA,989,1,2215,0,3,2219,T
4-HA,990,1,6,2242,0,2249,G
4-HA,991,2247,0,1,0,2248,A
4-HA,992,2240,0,1,1,2242,A
4-HA,993,2250,0,0,0,2250,A
4-HA,994,0,2220,0,1,2221,T
4-HA,995,0,2194,1,0,2195,T
4-HA,996,1,6,2219,0,2226,G
4-HA,997,0,1,2217,0,2218,G
4-HA,998,0,0,0,2226,2226,C
4-HA,999,2200,0,1,0,2201,A
4-HA,1000,2215,0,0,0,2215,A
4-HA,1001,2,1,0,2217,2220,C
4-HA,1002,2210,0,0,1,2211,A
4-HA,1003,0,9,2222,0,2231,G
4-HA,1004,1,1,2224,1,2227,G
4-HA,1005,0,5,2210,0,2215,G
4-HA,1006,2209,0,0,0,2209,A
4-HA,1007,0,2196,0,0,2196,T
4-HA,1008,0,1,2204,0,2205,G
4-HA,1009,2,1,0,2197,2200,C
4-HA,1010,0,5,2197,0,2202,G
4-HA,1011,2232,0,1,0,2233,A
4-HA,1012,2191,0,1,0,2192,A
4-HA,1013,2211,0,2,0,2213,A
4-HA,1014,1,2174,1,0,2176,T
4-HA,1015,0,1,2209,0,2210,G
4-HA,1016,1,2198,1,2,2202,T
4-HA,1017,2194,0,3,0,2197,A
4-HA,1018,1,1,0,2188,2190,C
4-HA,1019,20,0,1,2159,2180,C
4-HA,1020,2147,0,0,0,2147,A
4-HA,1021,1,6,2153,0,2160,G
4-HA,1022,2105,2,1,1,2109,A
4-HA,1023,0,1,2132,0,2133,G
4-HA,1024,2086,1,1,0,2088,A
4-HA,1025,2084,0,1,1,2086,A
4-HA,1026,2089,0,2,0,2091,A
4-HA,1027,0,0,0,2088,2088,C
4-HA,1028,2071,0,2,0,2073,A
4-HA,1029,2105,1,2,0,2108,A
4-HA,1030,2110,0,0,0,2110,A
4-HA,1031,3,0,0,2129,2132,C
4-HA,1032,0,2106,0,4,2110,T
4-HA,1033,2092,0,1,0,2093,A
4-HA,1034,2,4,2073,1,2080,G
4-HA,1035,2073,0,2,2,2077,A
4-HA,1036,0,5,2108,0,2113,G
4-HA,1037,1,1,2107,0,2109,G
4-HA,1038,2,1,0,2064,2067,C
4-HA,1039,2058,0,3,0,2061,A
4-HA,1040,0,2063,1,1,2065,T
4-HA,1041,2081,0,0,0,2081,A
4-HA,1042,0,2067,1,1,2069,T
4-HA,1043,0,2059,0,1,2060,T
4-HA,1044,0,2064,1,0,2065,T
4-HA,1045,3,7,1993,0,2003,G
4-HA,1046,2,1,2010,0,2013,G
4-HA,1047,3,1,0,2004,2008,C
4-HA,1048,0,0,2003,0,2003,G
4-HA,1049,2,0,0,1991,1993,C
4-HA,1050,1983,0,0,0,1983,A
4-HA,1051,1995,0,1,0,1996,A
4-HA,1052,0,1987,0,1,1988,T
4-HA,1053,6,0,0,1987,1993,C
4-HA,1054,1,0,1996,0,1997,G
4-HA,1055,1,1,1,1983,1986,C
4-HA,1056,1,1,1987,0,1989,G
4-HA,1057,2,5,1993,0,2000,G
4-HA,1058,1,1,2009,0,2011,G
4-HA,1059,0,1986,1,2,1989,T
4-HA,1060,0,1972,0,0,1972,T
4-HA,1061,0,1970,0,0,1970,T
4-HA,1062,6,1,0,1968,1975,C
4-HA,1063,1970,1,1,1,1973,A
4-HA,1064,0,1978,0,1,1979,T
4-HA,1065,1971,0,0,0,1971,A
4-HA,1066,0,8,1984,0,1992,G
4-HA,1067,1937,0,1,0,1938,A
4-HA,1068,1936,1,0,0,1937,A
4-HA,1069,1932,1,1,0,1934,A
4-HA,1070,1944,0,2,1,1947,A
4-HA,1071,0,1946,1,0,1947,T
4-HA,1072,2,7,1958,0,1967,G
4-HA,1073,0,5,1981,0,1986,G
4-HA,1074,0,1967,0,2,1969,T
4-HA,1075,1,1932,0,0,1933,T
4-HA,1076,0,6,1932,0,1938,G
4-HA,1077,15,6,1931,0,1952,G
4-HA,1078,0,3,1957,1,1961,G
4-HA,1079,1929,0,4,1,1934,A
4-HA,1080,0,9,1926,0,1935,G
4-HA,1081,0,5,1890,0,1895,G
4-HA,1082,1,4,1943,0,1948,G
4-HA,1083,1937,0,4,0,1941,A
4-HA,1084,1954,1,0,0,1955,A
4-HA,1085,0,1960,0,0,1960,T
4-HA,1086,0,8,1951,0,1959,G
4-HA,1087,1,0,1991,0,1992,G
4-HA,1088,0,1964,0,1,1965,T
4-HA,1089,0,7,1959,0,1966,G
4-HA,1090,0,2,1956,0,1958,G
4-HA,1091,1915,0,1,1,1917,A
4-HA,1092,0,1919,0,0,1919,T
4-HA,1093,0,16,1946,0,1962,G
4-HA,1094,0,1,1979,0,1980,G
4-HA,1095,0,1926,0,1,1927,T
4-HA,1096,0,1905,0,1,1906,T
4-HA,1097,0,7,1900,1,1908,G
4-HA,1098,3,0,1931,0,1934,G
4-HA,1099,0,1929,0,0,1929,T
4-HA,1100,1929,1,1,0,1931,A
4-HA,1101,0,3,0,1817,1820,C
4-HA,1102,3,7,1825,0,1835,G
4-HA,1103,0,1,1886,0,1887,G
4-HA,1104,0,1886,0,1,1887,T
4-HA,1105,0,1884,0,0,1884,T
4-HA,1106,0,1881,1,0,1882,T
4-HA,1107,2,0,1,1846,1849,C
4-HA,1108,1841,1,6,1,1849,A
4-HA,1109,1,8,1838,1,1848,G
4-HA,1110,1,1,1844,0,1846,G
4-HA,1111,3,1,0,1836,1840,C
4-HA,1112,1769,1,2,1,1773,A
4-HA,1113,0,1779,0,1,1780,T
4-HA,1114,5,0,1,1773,1779,C
4-HA,1115,1788,0,2,0,1790,A
4-HA,1116,1785,1,2,0,1788,A
4-HA,1117,1784,0,0,0,1784,A
4-HA,1118,1785,0,1,0,1786,A
4-HA,1119,0,1780,1,0,1781,T
4-HA,1120,3,1774,0,4,1781,T
4-HA,1121,3,0,0,1788,1791,C
4-HA,1122,1,1779,0,3,1783,T
4-HA,1123,0,2,1780,1,1783,G
4-HA,1124,1777,1,1,0,1779,A
4-HA,1125,1767,0,4,0,1771,A
4-HA,1126,0,5,1778,1,1784,G
4-HA,1127,0,3,1801,0,1804,G
4-HA,1128,1804,0,0,0,1804,A
4-HA,1129,1799,0,1,0,1800,A
4-HA,1130,0,5,1775,0,1780,G
4-HA,1131,1814,0,1,0,1815,A
4-HA,1132,1,6,1818,1,1826,G
4-HA,1133,1,6,1824,0,1831,G
4-HA,1134,1839,0,0,0,1839,A
4-HA,1135,1,0,0,1837,1838,C
4-HA,1136,1816,0,0,0,1816,A
4-HA,1137,1812,0,2,0,1814,A
4-HA,1138,0,3,1810,0,1813,G
4-HA,1139,1,1,0,1810,1812,C
4-HA,1140,1799,0,0,0,1799,A
4-HA,1141,1,1,1804,1,1807,G
4-HA,1142,3,0,0,1799,1802,C
4-HA,1143,1792,0,2,0,1794,A
4-HA,1144,0,2,1811,0,1813,G
4-HA,1145,1793,1,0,0,1794,A
4-HA,1146,0,1816,0,0,1816,T
4-HA,1147,0,2,0,1825,1827,C
4-HA,1148,1,1817,0,2,1820,T
4-HA,1149,5,0,0,1841,1846,C
4-HA,1150,1841,1,0,0,1842,A
4-HA,1151,1834,1,2,1,1838,A
4-HA,1152,1839,0,0,0,1839,A
4-HA,1153,1790,0,3,0,1793,A
4-HA,1154,0,0,1801,0,1801,G
4-HA,1155,1,2,0,1757,1760,C
4-HA,1156,1757,1,0,0,1758,A
4-HA,1157,2,0,3,1777,1782,C
4-HA,1158,0,1772,0,3,1775,T
4-HA,1159,2,0,0,1775,1777,C
4-HA,1160,1784,0,0,1,1785,A
4-HA,1161,1810,0,3,0,1813,A
4-HA,1162,0,0,1813,0,1813,G
4-HA,1163,1,3,0,1801,1805,C
4-HA,1164,1793,0,0,0,1793,A
4-HA,1165,0,1,1807,0,1808,G
4-HA,1166,0,0,0,1775,1775,C
4-HA,1167,1774,1,0,0,1775,A
4-HA,1168,1766,0,0,0,1766,A
4-HA,1169,0,1754,0,0,1754,T
4-HA,1170,7,1,0,1711,1719,C
4-HA,1171,1,6,1718,0,1725,G
4-HA,1172,1717,2,1,0,1720,A
4-HA,1173,3,1703,0,4,1710,T
4-HA,1174,4,1,0,1700,1705,C
4-HA,1175,1698,0,1,0,1699,A
4-HA,1176,1729,0,0,1,1730,A
4-HA,1177,1732,0,0,0,1732,A
4-HA,1178,0,1718,0,0,1718,T
4-HA,1179,7,0,0,1724,1731,C
4-HA,1180,1710,0,0,0,1710,A
4-HA,1181,1722,0,1,0,1723,A
4-HA,1182,0,1724,0,0,1724,T
4-HA,1183,1,8,1717,1,1727,G
4-HA,1184,1,5,1714,0,1720,G
4-HA,1185,0,3,1683,0,1686,G
4-HA,1186,1696,0,0,0,1696,A
4-HA,1187,1684,0,3,0,1687,A
4-HA,1188,1,1,1714,0,1716,G
4-HA,1189,1,0,0,1718,1719,C
4-HA,1190,0,1704,0,0,1704,T
4-HA,1191,2,3,1777,1,1783,G
4-HA,1192,1782,0,0,0,1782,A
4-HA,1193,1783,0,0,0,1783,A
4-HA,1194,0,1780,0,1,1781,T
4-HA,1195,1737,0,1,0,1738,A
4-HA,1196,0,5,1731,0,1736,G
4-HA,1197,1611,0,0,1,1612,A
4-HA,1198,0,1623,0,2,1625,T
4-HA,1199,2,1629,0,1,1632,T
4-HA,1200,0,10,1625,0,1635,G
4-HA,1201,1631,0,0,0,1631,A
4-HA,1202,0,1621,0,0,1621,T
4-HA,1203,7,0,0,1616,1623,C
4-HA,1204,0,7,1620,0,1627,G
4-HA,1205,5,4,1610,0,1619,G
4-HA,1206,0,4,1618,0,1622,G
4-HA,1207,1621,0,1,0,1622,A
4-HA,1208,1622,0,1,0,1623,A
4-HA,1209,1614,0,2,0,1616,A
4-HA,1210,1618,0,3,0,1621,A
4-HA,1211,3,1,0,1619,1623,C
4-HA,1212,3,0,0,1620,1623,C
4-HA,1213,1613,0,1,0,1614,A
4-HA,1214,1607,0,2,1,1610,A
4-HA,1215,0,1,0,1617,1618,C
4-HA,1216,0,3,1615,0,1618,G
4-HA,1217,1623,0,0,0,1623,A
4-HA,1218,0,3,1620,0,1623,G
4-HA,1219,1624,0,0,0,1624,A
4-HA,1220,1625,0,0,0,1625,A
4-HA,1221,1629,0,0,0,1629,A
4-HA,1222,0,1637,0,1,1638,T
4-HA,1223,1,1626,0,1,1628,T
4-HA,1224,10,1,0,1621,1632,C
4-HA,1225,1,0,0,1630,1631,C
4-HA,1226,1630,0,0,1,1631,A
4-HA,1227,0,1625,0,0,1625,T
4-HA,1228,4,0,0,1621,1625,C
4-HA,1229,1617,1,0,0,1618,A
4-HA,1230,0,1,1624,1,1626,G
4-HA,1231,1617,0,0,0,1617,A
4-HA,1232,0,1611,0,1,1612,T
4-HA,1233,0,1603,0,1,1604,T
4-HA,1234,0,2,1613,0,1615,G
4-HA,1235,1617,0,1,0,1618,A
4-HA,1236,1619,0,0,0,1619,A
4-HA,1237,1618,1,1,0,1620,A
4-HA,1238,1619,0,0,0,1619,A
4-HA,1239,1596,0,3,0,1599,A
4-HA,1240,0,6,1602,0,1608,G
4-HA,1241,1609,0,0,0,1609,A
4-HA,1242,1615,0,0,0,1615,A
4-HA,1243,0,1601,0,0,1601,T
4-HA,1244,0,1594,0,0,1594,T
4-HA,1245,2,1,0,1603,1606,C
4-HA,1246,1,1603,0,1,1605,T
4-HA,1247,2,0,0,1600,1602,C
4-HA,1248,1596,0,3,0,1599,A
4-HA,1249,0,2,1604,0,1606,G
4-HA,1250,1604,1,0,0,1605,A
4-HA,1251,1587,0,2,0,1589,A
4-HA,1252,0,1,1614,0,1615,G
4-HA,1253,0,1604,0,0,1604,T
4-HA,1254,9,0,0,1591,1600,C
4-HA,1255,0,1,1596,0,1597,G
4-HA,1256,1598,0,1,0,1599,A
4-HA,1257,1599,0,2,1,1602,A
4-HA,1258,0,5,1590,0,1595,G
4-HA,1259,1,7,1598,1,1607,G
4-HA,1260,2,4,1600,0,1606,G
4-HA,1261,1566,0,2,0,1568,A
4-HA,1262,0,5,1571,0,1576,G
4-HA,1263,1566,0,1,0,1567,A
4-HA,1264,1666,0,1,1,1668,A
4-HA,1265,0,1676,0,0,1676,T
4-HA,1266,0,1666,0,0,1666,T
4-HA,1267,7,0,0,1656,1663,C
4-HA,1268,1628,0,5,1,1634,A
4-HA,1269,0,6,1630,0,1636,G
4-HA,1270,0,5,1630,0,1635,G
4-HA,1271,1631,0,2,0,1633,A
4-HA,1272,1,0,0,1630,1631,C
4-HA,1273,6,0,0,1505,1511,C
4-HA,1274,0,1505,0,0,1505,T
4-HA,1275,0,1462,0,41,1503,T
4-HA,1276,0,2,1515,0,1517,G
4-HA,1277,1513,0,1,0,1514,A
4-HA,1278,0,4,1554,1,1559,G
4-HA,1279,1544,0,1,0,1545,A
4-HA,1280,1450,0,1,0,1451,A
4-HA,1281,1445,0,1,0,1446,A
4-HA,1282,0,1420,0,1,1421,T
4-HA,1283,1461,0,1,0,1462,A
4-HA,1284,0,1453,0,0,1453,T
4-HA,1285,0,3,1468,0,1471,G
4-HA,1286,1,1466,0,1,1468,T
4-HA,1287,0,1423,0,0,1423,T
4-HA,1288,0,5,1428,1,1434,G
4-HA,1289,1421,0,1,0,1422,A
4-HA,1290,0,5,1424,0,1429,G
4-HA,1291,0,4,1413,0,1417,G
4-HA,1292,1398,0,1,0,1399,A
4-HA,1293,1,2,0,1432,1435,C
4-HA,1294,1407,0,1,0,1408,A
4-HA,1295,3,0,0,1435,1438,C
4-HA,1296,2,0,0,1433,1435,C
4-HA,1297,1445,0,0,0,1445,A
4-HA,1298,1480,0,0,0,1480,A
4-HA,1299,1479,0,0,0,1479,A
4-HA,1300,1498,0,0,0,1498,A
4-HA,1301,0,1496,0,0,1496,T
4-HA,1302,1457,1,0,0,1458,A
4-HA,1303,0,7,1463,0,1470,G
4-HA,1304,1450,0,0,0,1450,A
4-HA,1305,0,1471,1,0,1472,T
4-HA,1306,1,1,0,1471,1473,C
4-HA,1307,0,1438,0,0,1438,T
4-HA,1308,4,1,0,1469,1474,C
4-HA,1309,0,1467,0,1,1468,T
4-HA,1310,0,4,1493,2,1499,G
4-HA,1311,1,0,1538,0,1539,G
4-HA,1312,0,1529,0,2,1531,T
4-HA,1313,5,0,0,1524,1529,C
4-HA,1314,1531,0,1,0,1532,A
4-HA,1315,0,1529,0,1,1530,T
4-HA,1316,1531,0,1,0,1532,A
4-HA,1317,1,1,0,1529,1531,C
4-HA,1318,1492,0,1,0,1493,A
4-HA,1319,1507,0,2,0,1509,A
4-HA,1320,0,1,0,1467,1468,C
4-HA,1321,2,0,1468,0,1470,G
4-HA,1322,0,0,0,1466,1466,C
4-HA,1323,2,12,1442,0,1456,G
4-HA,1324,1,4,1466,0,1471,G
4-HA,1325,1474,0,0,0,1474,A
4-HA,1326,0,0,1500,0,1500,G
4-HA,1327,0,0,0,1499,1499,C
4-HA,1328,0,1480,0,1,1481,T
4-HA,1329,1,1490,3,3,1497,T
4-HA,1330,5,1,0,1483,1489,C
4-HA,1331,1,1503,0,1,1505,T
4-HA,1332,0,1509,0,0,1509,T
4-HA,1333,1,0,1503,0,1504,G
4-HA,1334,1,1502,0,3,1506,T
4-HA,1335,2,1462,0,1,1465,T
4-HA,1336,0,0,1496,0,1496,G
4-HA,1337,1,0,0,1478,1479,C
4-HA,1338,5,0,0,1470,1475,C
4-HA,1339,6,1,0,1477,1484,C
4-HA,1340,0,1487,0,1,1488,T
4-HA,1341,0,5,1507,0,1512,G
4-HA,1342,1,3,1516,0,1520,G
4-HA,1343,1520,0,0,0,1520,A
4-HA,1344,1,3,1522,0,1526,G
4-HA,1345,1495,0,1,0,1496,A
4-HA,1346,1505,0,2,0,1507,A
4-HA,1347,2,0,1,1522,1525,C
4-HA,1348,4,0,1,1521,1526,C
4-HA,1349,1524,0,1,0,1525,A
4-HA,1350,1600,0,1,0,1601,A
4-HA,1351,0,1,0,1596,1597,C
4-HA,1352,1605,1,0,0,1606,A
4-HA,1353,0,1603,0,2,1605,T
4-HA,1354,1602,0,1,0,1603,A
4-HA,1355,1,0,0,1627,1628,C
4-HA,1356,1604,0,1,0,1605,A
4-HA,1357,1605,0,1,0,1606,A
4-HA,1358,1,1600,0,1,1602,T
4-HA,1359,1,1546,0,1,1548,T
4-HA,1360,0,6,1566,0,1572,G
4-HA,1361,1583,1,0,0,1584,A
4-HA,1362,1,1575,0,3,1579,T
4-HA,1363,7,0,0,1580,1587,C
4-HA,1364,0,1563,0,0,1563,T
4-HA,1365,1580,0,0,0,1580,A
4-HA,1366,1580,0,0,0,1580,A
4-HA,1367,1,0,0,1579,1580,C
4-HA,1368,1,1564,0,1,1566,T
4-HA,1369,1,5,1537,0,1543,G
4-HA,1370,1541,1,3,0,1545,A
4-HA,1371,2,0,0,1543,1545,C
4-HA,1372,0,1543,0,2,1545,T
4-HA,1373,7,0,1,1541,1549,C
4-HA,1374,1545,0,1,0,1546,A
4-HA,1375,0,6,1560,0,1566,G
4-HA,1376,1560,0,1,1,1562,A
4-HA,1377,1568,0,1,0,1569,A
4-HA,1378,1570,0,0,0,1570,A
4-HA,1379,0,1547,0,0,1547,T
4-HA,1380,1,9,1550,0,1560,G
4-HA,1381,1558,0,3,0,1561,A
4-HA,1382,1561,0,3,0,1564,A
4-HA,1383,0,0,1,1564,1565,C
4-HA,1384,1527,1,0,0,1528,A
4-HA,1385,1528,0,1,0,1529,A
4-HA,1386,1527,0,1,0,1528,A
4-HA,1387,2,1,0,1531,1534,C
4-HA,1388,0,1523,0,0,1523,T
4-HA,1389,0,1,1530,0,1531,G
4-HA,1390,0,1514,0,0,1514,T
4-HA,1391,1,1510,0,0,1511,T
4-HA,1392,1,1515,0,1,1517,T
4-HA,1393,0,2,1516,0,1518,G
4-HA,1394,1519,0,0,0,1519,A
4-HA,1395,1520,0,0,0,1520,A
4-HA,1396,1513,0,0,0,1513,A
4-HA,1397,1522,0,0,0,1522,A
4-HA,1398,1511,1,1,0,1513,A
4-HA,1399,1522,0,0,1,1523,A
4-HA,1400,3,0,0,1526,1529,C
4-HA,1401,1528,0,1,0,1529,A
4-HA,1402,1528,0,0,1,1529,A
4-HA,1403,1520,0,3,0,1523,A
4-HA,1404,3,2,1526,0,1531,G
4-HA,1405,1531,0,0,0,1531,A
4-HA,1406,1528,1,0,0,1529,A
4-HA,1407,1,3,1524,0,1528,G
4-HA,1408,1,1,0,1518,1520,C
4-HA,1409,1517,0,0,0,1517,A
4-HA,1410,1521,0,0,1,1522,A
4-HA,1411,2,1,0,1528,1531,C
4-HA,1412,1,1527,0,1,1529,T
4-HA,1413,1,1,1529,1,1532,G
4-HA,1414,1521,0,1,0,1522,A
4-HA,1415,0,8,1524,0,1532,G
4-HA,1416,0,3,1531,0,1534,G
4-HA,1417,1,5,1531,0,1537,G
4-HA,1418,1535,0,2,0,1537,A
4-HA,1419,1531,1,2,0,1534,A
4-HA,1420,1524,0,2,0,1526,A
4-HA,1421,1540,0,0,0,1540,A
4-HA,1422,1,1533,0,0,1534,T
4-HA,1423,0,0,1540,0,1540,G
4-HA,1424,0,1,0,1536,1537,C
4-HA,1425,0,1522,0,2,1524,T
4-HA,1426,3,2,1521,0,1526,G
4-HA,1427,1526,0,2,0,1528,A
4-HA,1428,0,6,1571,0,1577,G
4-HA,1429,0,6,1598,0,1604,G
4-HA,1430,1600,0,0,0,1600,A
4-HA,1431,1,1597,0,0,1598,T
4-HA,1432,1598,0,0,0,1598,A
4-HA,1433,0,1587,0,1,1588,T
4-HA,1434,1,1,1600,1,1603,G
4-HA,1435,1,3,1605,0,1609,G
4-HA,1436,0,0,1607,0,1607,G
4-HA,1437,2,0,1,1507,1510,C
4-HA,1438,1472,0,1,0,1473,A
4-HA,1439,1472,0,0,0,1472,A
4-HA,1440,0,1470,0,0,1470,T
4-HA,1441,0,6,1466,0,1472,G
4-HA,1442,0,1,1473,0,1474,G
4-HA,1443,1,1452,0,1,1454,T
4-HA,1444,0,1423,0,0,1423,T
4-HA,1445,1,0,1428,0,1429,G
4-HA,1446,0,1425,0,1,1426,T
4-HA,1447,0,1425,0,1,1426,T
4-HA,1448,0,1428,0,0,1428,T
4-HA,1449,2,0,0,1435,1437,C
4-HA,1450,1434,0,0,0,1434,A
4-HA,1451,1442,0,0,0,1442,A
4-HA,1452,1442,0,0,0,1442,A
4-HA,1453,1459,0,0,0,1459,A
4-HA,1454,0,1452,0,0,1452,T
4-HA,1455,1444,0,0,0,1444,A
4-HA,1456,0,1443,1,0,1444,T
4-HA,1457,1443,0,1,0,1444,A
4-HA,1458,2,1,0,1480,1483,C
4-HA,1459,16,0,1,1458,1475,C
4-HA,1460,1479,0,0,1,1480,A
4-HA,1461,1,0,0,1498,1499,C
4-HA,1462,1490,0,0,0,1490,A
4-HA,1463,1491,0,0,0,1491,A
4-HA,1464,1375,0,0,114,1489,A
4-HA,1465,0,1492,0,1,1493,T
4-HA,1466,0,0,1502,0,1502,G
4-HA,1467,0,1474,0,0,1474,T
4-HA,1468,0,4,1483,0,1487,G
4-HA,1469,1477,0,1,0,1478,A
4-HA,1470,3,0,0,1464,1467,C
4-HA,1471,1446,1,0,0,1447,A
4-HA,1472,1444,0,0,0,1444,A
4-HA,1473,0,1464,0,0,1464,T
4-HA,1474,0,0,1476,1,1477,G
4-HA,1475,1,0,0,1463,1464,C
4-HA,1476,0,0,0,1468,1468,C
4-HA,1477,1,1457,0,2,1460,T
4-HA,1478,1,2,1529,0,1532,G
4-HA,1479,0,1,0,1528,1529,C
4-HA,1480,1535,1,0,0,1536,A
4-HA,1481,0,1536,0,0,1536,T
4-HA,1482,1481,0,0,0,1481,A
4-HA,1483,0,2,1490,0,1492,G
4-HA,1484,1,7,1473,1,1482,G
4-HA,1485,1474,0,0,0,1474,A
4-HA,1486,0,1466,0,1,1467,T
4-HA,1487,7,1,0,1404,1412,C
4-HA,1488,1415,1,0,0,1416,A
4-HA,1489,1425,1,0,0,1426,A
4-HA,1490,1,1418,1,0,1420,T
4-HA,1491,4,0,0,1424,1428,C
4-HA,1492,1403,0,1,0,1404,A
4-HA,1493,0,2,1418,0,1420,G
4-HA,1494,1424,0,2,0,1426,A
4-HA,1495,1427,0,0,0,1427,A
4-HA,1496,1419,1,6,0,1426,A
4-HA,1497,0,1419,0,1,1420,T
4-HA,1498,0,7,1409,1,1417,G
4-HA,1499,0,5,1412,0,1417,G
4-HA,1500,1419,0,0,0,1419,A
4-HA,1501,1430,0,1,0,1431,A
4-HA,1502,0,0,0,1423,1423,C
4-HA,1503,0,1411,1,0,1412,T
4-HA,1504,0,1418,1,1,1420,T
4-HA,1505,1421,0,2,0,1423,A
4-HA,1506,0,1424,0,0,1424,T
4-HA,1507,2,6,1416,0,1424,G
4-HA,1508,1414,0,1,0,1415,A
4-HA,1509,2,0,0,1409,1411,C
4-HA,1510,11,0,0,1385,1396,C
4-HA,1511,1397,1,1,0,1399,A
4-HA,1512,1,1,0,1431,1433,C
4-HA,1513,0,1,1471,0,1472,G
4-HA,1514,1494,1,0,0,1495,A
4-HA,1515,0,1513,0,1,1514,T
4-HA,1516,0,2,1545,0,1547,G
4-HA,1517,0,1532,0,1,1533,T
4-HA,1518,1589,0,2,0,1591,A
4-HA,1519,1,1587,0,1,1589,T
4-HA,1520,1589,0,0,0,1589,A
4-HA,1521,1,0,0,1582,1583,C
4-HA,1522,1418,0,2,0,1420,A
4-HA,1523,0,2,1434,0,1436,G
4-HA,1524,1351,0,0,1,1352,A
4-HA,1525,0,2,1311,0,1313,G
4-HA,1526,1303,0,0,0,1303,A
4-HA,1527,0,1200,0,0,1200,T
4-HA,1528,1,5,1194,0,1200,G
4-HA,1529,1197,0,0,0,1197,A
4-HA,1530,1192,0,3,0,1195,A
4-HA,1531,1,1,1208,0,1210,G
4-HA,1532,0,0,0,1186,1186,C
4-HA,1533,1177,1,0,0,1178,A
4-HA,1534,0,1167,0,0,1167,T
4-HA,1535,0,1161,0,1,1162,T
4-HA,1536,1166,0,2,0,1168,A
4-HA,1537,1168,0,0,0,1168,A
4-HA,1538,1168,2,0,0,1170,A
4-HA,1539,2,2,0,1167,1171,C
4-HA,1540,1125,0,0,0,1125,A
4-HA,1541,1134,0,0,0,1134,A
4-HA,1542,0,1,0,1130,1131,C
4-HA,1543,4,3,0,1115,1122,C
4-HA,1544,1,2,1119,0,1122,G
4-HA,1545,0,2,1130,0,1132,G
4-HA,1546,0,1137,0,1,1138,T
4-HA,1547,0,1127,0,0,1127,T
4-HA,1548,3,0,0,1126,1129,C
4-HA,1549,9,1,0,1119,1129,C
4-HA,1550,1121,0,0,0,1121,A
4-HA,1551,0,2,1133,0,1135,G
4-HA,1552,1129,0,0,1,1130,A
4-HA,1553,0,1131,0,0,1131,T
4-HA,1554,1,0,0,1088,1089,C
4-HA,1555,1078,0,2,0,1080,A
4-HA,1556,1081,0,0,0,1081,A
4-HA,1557,0,4,1080,0,1084,G
4-HA,1558,0,5,1073,0,1078,G
4-HA,1559,0,4,1074,0,1078,G
4-HA,1560,1022,1,2,0,1025,A
4-HA,1561,0,0,1037,0,1037,G
4-HA,1562,0,1036,0,1,1037,T
4-HA,1563,0,1035,0,0,1035,T
4-HA,1564,0,4,1040,0,1044,G
4-HA,1565,1038,0,1,0,1039,A
4-HA,1566,0,3,1041,0,1044,G
4-HA,1567,2,0,0,1043,1045,C
4-HA,1568,0,1033,0,1,1034,T
4-HA,1569,0,2,1035,0,1037,G
4-HA,1570,1028,0,0,0,1028,A
4-HA,1571,1030,0,0,0,1030,A
4-HA,1572,1,1,1030,0,1032,G
4-HA,1573,0,1004,0,0,1004,T
4-HA,1574,4,0,0,996,1000,C
4-HA,1575,983,0,1,0,984,A
4-HA,1576,0,4,981,0,985,G
4-HA,1577,0,4,976,0,980,G
4-HA,1578,0,1,962,0,963,G
4-HA,1579,0,984,0,0,984,T
4-HA,1580,986,0,0,0,986,A
4-HA,1581,2,0,0,977,979,C
4-HA,1582,979,0,0,0,979,A
4-HA,1583,979,0,0,0,979,A
4-HA,1584,975,0,0,0,975,A
4-HA,1585,0,1,993,0,994,G
4-HA,1586,968,0,0,0,968,A
4-HA,1587,0,937,0,0,937,T
4-HA,1588,0,928,0,0,928,T
4-HA,1589,0,3,918,0,921,G
4-HA,1590,0,1,922,1,924,G
4-HA,1591,923,0,1,0,924,A
4-HA,1592,0,922,0,0,922,T
4-HA,1593,0,0,0,926,926,C
4-HA,1594,0,0,0,910,910,C
4-HA,1595,0,894,0,1,895,T
4-HA,1596,895,1,0,0,896,A
4-HA,1597,0,898,0,0,898,T
4-HA,1598,0,2,897,0,899,G
4-HA,1599,0,1,897,0,898,G
4-HA,1600,883,0,0,0,883,A
4-HA,1601,0,884,1,0,885,T
4-HA,1602,0,870,0,0,870,T
4-HA,1603,0,869,0,0,869,T
4-HA,1604,5,0,0,861,866,C
4-HA,1605,3,0,0,865,868,C
4-HA,1606,0,857,0,0,857,T
4-HA,1607,0,861,0,0,861,T
4-HA,1608,0,851,1,0,852,T
4-HA,1609,0,1,855,0,856,G
4-HA,1610,1,0,0,850,851,C
4-HA,1611,7,1,0,846,854,C
4-HA,1612,824,0,0,0,824,A
4-HA,1613,0,818,0,0,818,T
4-HA,1614,815,0,1,1,817,A
4-HA,1615,0,813,0,2,815,T
4-HA,1616,3,0,0,809,812,C
4-HA,1617,816,0,0,0,816,A
4-HA,1618,0,806,0,0,806,T
4-HA,1619,1,0,808,0,809,G
4-HA,1620,0,803,0,0,803,T
4-HA,1621,0,799,0,0,799,T
4-HA,1622,0,796,1,1,798,T
4-HA,1623,0,780,0,0,780,T
4-HA,1624,0,777,0,0,777,T
4-HA,1625,0,777,0,0,777,T
4-HA,1626,0,2,776,0,778,G
4-HA,1627,1,0,0,778,779,C
4-HA,1628,0,753,0,2,755,T
4-HA,1629,0,756,0,0,756,T
4-HA,1630,1,750,1,0,752,T
4-HA,1631,0,2,763,0,765,G
4-HA,1632,0,764,0,0,764,T
4-HA,1633,0,1,764,0,765,G
4-HA,1634,0,761,0,1,762,T
4-HA,1635,0,746,0,0,746,T
4-HA,1636,0,0,753,0,753,G
4-HA,1637,0,1,0,752,753,C
4-HA,1638,0,745,1,1,747,T
4-HA,1639,0,750,0,1,751,T
4-HA,1640,0,710,0,0,710,T
4-HA,1641,0,0,708,0,708,G
4-HA,1642,0,701,0,0,701,T
4-HA,1643,0,699,0,0,699,T
4-HA,1644,0,0,696,0,696,G
4-HA,1645,0,6,674,0,680,G
4-HA,1646,1,2,677,0,680,G
4-HA,1647,0,1,681,0,682,G
4-HA,1648,0,660,0,0,660,T
4-HA,1649,0,651,0,1,652,T
4-HA,1650,4,0,0,630,634,C
4-HA,1651,619,0,0,0,619,A
4-HA,1652,0,616,0,0,616,T
4-HA,1653,1,0,0,613,614,C
4-HA,1654,610,0,0,0,610,A
4-HA,1655,0,590,0,1,591,T
4-HA,1656,1,0,590,0,591,G
4-HA,1657,1,576,0,1,578,T
4-HA,1658,0,2,570,0,572,G
4-HA,1659,1,0,551,0,552,G
4-HA,1660,0,0,553,0,553,G
4-HA,1661,1,0,1,535,537,C
4-HA,1662,2,0,0,526,528,C
4-HA,1663,0,484,0,0,484,T
4-HA,1664,0,1,485,0,486,G
4-HA,1665,1,0,0,480,481,C
4-HA,1666,4,0,0,478,482,C
4-HA,1667,483,0,0,0,483,A
4-HA,1668,480,0,0,0,480,A
4-HA,1669,479,0,0,0,479,A
4-HA,1670,477,0,0,0,477,A
4-HA,1671,477,0,0,0,477,A
4-HA,1672,0,1,476,0,477,G
4-HA,1673,0,0,458,0,458,G
4-HA,1674,0,0,0,454,454,C
4-HA,1675,455,0,1,0,456,A
4-HA,1676,460,0,1,0,461,A
4-HA,1677,0,1,0,459,460,C
4-HA,1678,461,0,0,0,461,A
4-HA,1679,1,460,0,0,461,T
4-HA,1680,0,458,0,1,459,T
4-HA,1681,443,0,1,0,444,A
4-HA,1682,0,1,442,0,443,G
4-HA,1683,1,0,440,0,441,G
4-HA,1684,0,427,0,1,428,T
4-HA,1685,0,4,388,0,392,G
4-HA,1686,0,1,0,368,369,C
4-HA,1687,358,0,0,0,358,A
4-HA,1688,359,0,0,0,359,A
4-HA,1689,0,0,0,358,358,C
4-HA,1690,353,0,1,0,354,A
4-HA,1691,0,349,0,0,349,T
4-HA,1692,0,327,0,1,328,T
4-HA,1693,0,328,0,1,329,T
4-HA,1694,0,1,329,0,330,G
4-HA,1695,1,0,0,327,328,C
4-HA,1696,328,0,0,0,328,A
4-HA,1697,1,306,0,0,307,T
4-HA,1698,0,298,0,1,299,T
4-HA,1699,0,285,0,0,285,T
4-HA,1700,0,0,282,0,282,G
4-HA,1701,265,0,0,0,265,A
5-NP,1,452,0,0,0,452,A
5-NP,2,0,451,0,0,451,T
5-NP,3,0,0,448,0,448,G
5-NP,4,0,1,450,0,451,G
5-NP,5,0,0,0,458,458,C
5-NP,6,0,0,467,1,468,G
5-NP,7,0,489,0,0,489,T
5-NP,8,2,0,0,496,498,C
5-NP,9,1,0,0,497,498,C
5-NP,10,2,1,0,496,499,C
5-NP,11,501,0,0,0,501,A
5-NP,12,502,0,0,0,502,A
5-NP,13,0,3,511,0,514,G
5-NP,14,0,0,531,0,531,G
5-NP,15,2,0,0,530,532,C
5-NP,16,534,0,0,0,534,A
5-NP,17,0,0,0,540,540,C
5-NP,18,2,0,0,538,540,C
5-NP,19,544,0,0,0,544,A
5-NP,20,543,0,0,0,543,A
5-NP,21,547,0,0,0,547,A
5-NP,22,1,1,0,549,551,C
5-NP,23,0,5,545,0,550,G
5-NP,24,0,2,589,0,591,G
5-NP,25,2,587,0,0,589,T
5-NP,26,1,0,0,639,640,C
5-NP,27,0,641,0,0,641,T
5-NP,28,0,648,0,0,648,T
5-NP,29,651,0,0,0,651,A
5-NP,30,0,651,0,0,651,T
5-NP,31,0,8,651,0,659,G
5-NP,32,658,0,0,0,658,A
5-NP,33,652,0,0,0,652,A
5-NP,34,0,0,0,658,658,C
5-NP,35,639,0,1,0,640,A
5-NP,36,1,1,684,0,686,G
5-NP,37,681,0,0,0,681,A
5-NP,38,0,687,0,0,687,T
5-NP,39,0,5,685,0,690,G
5-NP,40,0,1,693,0,694,G
5-NP,41,696,1,0,0,697,A
5-NP,42,702,0,1,0,703,A
5-NP,43,704,0,2,0,706,A
5-NP,44,1,0,0,732,733,C
5-NP,45,0,726,0,0,726,T
5-NP,46,0,1,732,0,733,G
5-NP,47,728,0,0,0,728,A
5-NP,48,0,733,0,0,733,T
5-NP,49,0,1,729,1,731,G
5-NP,50,0,4,728,0,732,G
5-NP,51,1,1,733,0,735,G
5-NP,52,1,2,731,0,734,G
5-NP,53,731,0,0,0,731,A
5-NP,54,0,736,0,0,736,T
5-NP,55,1,1,0,739,741,C
5-NP,56,0,1,742,0,743,G
5-NP,57,0,0,0,751,751,C
5-NP,58,5,1,0,744,750,C
5-NP,59,752,0,0,0,752,A
5-NP,60,0,1,761,0,762,G
5-NP,61,757,0,2,0,759,A
5-NP,62,774,0,0,0,774,A
5-NP,63,0,774,0,0,774,T
5-NP,64,0,0,775,0,775,G
5-NP,65,0,0,0,786,786,C
5-NP,66,779,0,1,0,780,A
5-NP,67,796,1,1,0,798,A
5-NP,68,1,0,0,796,797,C
5-NP,69,1,793,1,0,795,T
5-NP,70,0,0,802,0,802,G
5-NP,71,819,0,1,0,820,A
5-NP,72,0,1,853,0,854,G
5-NP,73,848,0,0,0,848,A
5-NP,74,0,852,0,0,852,T
5-NP,75,1,850,0,0,851,T
5-NP,76,849,0,1,0,850,A
5-NP,77,0,3,847,0,850,G
5-NP,78,1,4,850,0,855,G
5-NP,79,2,0,853,0,855,G
5-NP,80,0,0,0,837,837,C
5-NP,81,827,0,0,0,827,A
5-NP,82,0,832,0,0,832,T
5-NP,83,3,0,0,828,831,C
5-NP,84,3,0,0,829,832,C
5-NP,85,0,0,845,0,845,G
5-NP,86,0,846,0,1,847,T
5-NP,87,3,0,0,845,848,C
5-NP,88,1,0,848,0,849,G
5-NP,89,0,3,847,0,850,G
5-NP,90,0,0,853,0,853,G
5-NP,91,849,0,0,0,849,A
5-NP,92,851,1,1,0,853,A
5-NP,93,0,1,859,0,860,G
5-NP,94,856,0,0,0,856,A
5-NP,95,0,861,0,0,861,T
5-NP,96,0,2,864,0,866,G
5-NP,97,865,0,0,0,865,A
5-NP,98,0,867,0,0,867,T
5-NP,99,0,866,0,0,866,T
5-NP,100,0,3,865,0,868,G
5-NP,101,864,0,1,0,865,A
5-NP,102,0,866,0,0,866,T
5-NP,103,1,4,858,0,863,G
5-NP,104,0,1,856,0,857,G
5-NP,105,0,2,848,0,850,G
5-NP,106,911,0,0,0,911,A
5-NP,107,0,917,0,0,917,T
5-NP,108,0,917,0,0,917,T
5-NP,109,0,2,917,0,919,G
5-NP,110,0,2,916,0,918,G
5-NP,111,0,0,920,0,920,G
5-NP,112,922,0,1,0,923,A
5-NP,113,1,2,925,1,929,G
5-NP,114,928,0,0,0,928,A
5-NP,115,0,943,0,0,943,T
5-NP,116,0,944,0,0,944,T
5-NP,117,3,0,0,946,949,C
5-NP,118,0,948,0,0,948,T
5-NP,119,958,0,0,0,958,A
5-NP,120,0,0,0,958,958,C
5-NP,121,985,0,0,0,985,A
5-NP,122,1,982,0,0,983,T
5-NP,123,3,1,0,975,979,C
5-NP,124,2,0,0,978,980,C
5-NP,125,984,0,0,0,984,A
5-NP,126,1004,0,0,0,1004,A
5-NP,127,1002,0,0,0,1002,A
5-NP,128,0,999,0,0,999,T
5-NP,129,0,1,995,0,996,G
5-NP,130,0,989,0,0,989,T
5-NP,131,0,0,993,0,993,G
5-NP,132,0,0,1,995,996,C
5-NP,133,996,0,0,0,996,A
5-NP,134,1,0,0,998,999,C
5-NP,135,1,982,0,0,983,T
5-NP,136,0,2,1023,0,1025,G
5-NP,137,1034,0,0,0,1034,A
5-NP,138,1049,0,1,1,1051,A
5-NP,139,0,0,0,1070,1070,C
5-NP,140,0,1055,0,0,1055,T
5-NP,141,0,1062,0,0,1062,T
5-NP,142,1059,2,1,0,1062,A
5-NP,143,1062,0,1,0,1063,A
5-NP,144,1066,0,1,0,1067,A
5-NP,145,0,1,0,1064,1065,C
5-NP,146,0,1035,0,0,1035,T
5-NP,147,3,0,0,1038,1041,C
5-NP,148,1038,0,0,0,1038,A
5-NP,149,0,1,1051,0,1052,G
5-NP,150,0,1051,0,0,1051,T
5-NP,151,0,4,1061,0,1065,G
5-NP,152,1071,1,0,0,1072,A
5-NP,153,0,1071,0,0,1071,T
5-NP,154,6,0,1,1082,1089,C
5-NP,155,1088,0,1,0,1089,A
5-NP,156,1,1083,1,1,1086,T
5-NP,157,0,2,1088,0,1090,G
5-NP,158,1076,0,0,0,1076,A
5-NP,159,1081,0,1,0,1082,A
5-NP,160,0,4,1077,0,1081,G
5-NP,161,0,2,1074,0,1076,G
5-NP,162,1,1,1065,0,1067,G
5-NP,163,2,1,0,1061,1064,C
5-NP,164,1,5,1060,1,1067,G
5-NP,165,0,0,1074,0,1074,G
5-NP,166,1,1065,0,1,1067,T
5-NP,167,0,1072,0,0,1072,T
5-NP,168,0,6,1067,0,1073,G
5-NP,169,1194,0,0,0,1194,A
5-NP,170,0,1188,0,0,1188,T
5-NP,171,6,1,0,1182,1189,C
5-NP,172,5,0,0,1187,1192,C
5-NP,173,1192,0,0,0,1192,A
5-NP,174,0,1,1197,0,1198,G
5-NP,175,1200,0,0,0,1200,A
5-NP,176,1199,0,0,0,1199,A
5-NP,177,3,1,0,1194,1198,C
5-NP,178,1111,0,1,0,1112,A
5-NP,179,0,2,1130,0,1132,G
5-NP,180,1,1,0,1129,1131,C
5-NP,181,0,1128,2,0,1130,T
5-NP,182,0,1132,1,0,1133,T
5-NP,183,0,0,1125,0,1125,G
5-NP,184,1130,1,0,0,1131,A
5-NP,185,1,0,0,1134,1135,C
5-NP,186,1131,0,1,0,1132,A
5-NP,187,1142,1,0,0,1143,A
5-NP,188,0,1129,0,0,1129,T
5-NP,189,1129,0,0,0,1129,A
5-NP,190,0,3,1129,0,1132,G
5-NP,191,1129,0,0,0,1129,A
5-NP,192,0,1,1129,0,1130,G
5-NP,193,1126,0,1,0,1127,A
5-NP,194,1159,0,0,0,1159,A
5-NP,195,1157,0,1,0,1158,A
5-NP,196,1190,0,0,1,1191,A
5-NP,197,0,1195,0,0,1195,T
5-NP,198,0,14,1175,1,1190,G
5-NP,199,0,2,1190,1,1193,G
5-NP,200,0,1181,0,1,1182,T
5-NP,201,1172,0,0,0,1172,A
5-NP,202,0,0,0,1184,1184,C
5-NP,203,0,1188,0,1,1189,T
5-NP,204,3,0,0,1206,1209,C
5-NP,205,0,1180,0,1,1181,T
5-NP,206,0,0,0,1196,1196,C
5-NP,207,0,1193,0,1,1194,T
5-NP,208,4,0,1200,0,1204,G
5-NP,209,1,0,0,1203,1204,C
5-NP,210,0,1190,0,0,1190,T
5-NP,211,1,1189,0,1,1191,T
5-NP,212,0,1193,0,0,1193,T
5-NP,213,0,1188,0,0,1188,T
5-NP,214,0,5,1188,0,1193,G
5-NP,215,1182,0,0,2,1184,A
5-NP,216,0,1184,0,1,1185,T
5-NP,217,0,4,1184,0,1188,G
5-NP,218,1178,2,2,0,1182,A
5-NP,219,1185,0,0,0,1185,A
5-NP,220,1184,0,1,0,1185,A
5-NP,221,0,1,1183,0,1184,G
5-NP,222,1187,0,0,0,1187,A
5-NP,223,1184,2,1,0,1187,A
5-NP,224,0,5,1199,0,1204,G
5-NP,225,1,4,1225,0,1230,G
5-NP,226,1229,0,1,0,1230,A
5-NP,227,1239,0,0,0,1239,A
5-NP,228,0,1238,0,1,1239,T
5-NP,229,1238,0,1,0,1239,A
5-NP,230,1242,0,1,0,1243,A
5-NP,231,1248,0,0,0,1248,A
5-NP,232,0,1247,0,0,1247,T
5-NP,233,1256,0,0,0,1256,A
5-NP,234,1,0,1,1257,1259,C
5-NP,235,2,2,0,1228,1232,C
5-NP,236,0,1229,0,0,1229,T
5-NP,237,4,2,1226,0,1232,G
5-NP,238,0,1,1246,1,1248,G
5-NP,239,1247,0,1,0,1248,A
5-NP,240,1244,0,0,0,1244,A
5-NP,241,3,1,1257,0,1261,G
5-NP,242,1254,0,0,0,1254,A
5-NP,243,1242,0,1,0,1243,A
5-NP,244,0,1,0,1242,1243,C
5-NP,245,1241,1,1,0,1243,A
5-NP,246,3,0,0,1270,1273,C
5-NP,247,0,1,0,1255,1256,C
5-NP,248,3,0,1,1257,1261,C
5-NP,249,5,0,0,1262,1267,C
5-NP,250,1247,0,2,0,1249,A
5-NP,251,0,1,1256,0,1257,G
5-NP,252,0,0,2,1247,1249,C
5-NP,253,0,1,1254,0,1255,G
5-NP,254,2,0,0,1258,1260,C
5-NP,255,1,5,1243,1,1250,G
5-NP,256,0,4,1249,0,1253,G
5-NP,257,1,3,1244,0,1248,G
5-NP,258,2,3,1254,1,1260,G
5-NP,259,1255,1,0,0,1256,A
5-NP,260,1251,0,1,0,1252,A
5-NP,261,1249,1,0,1,1251,A
5-NP,262,0,0,1252,0,1252,G
5-NP,263,1254,0,0,1,1255,A
5-NP,264,0,1241,0,1,1242,T
5-NP,265,0,1,0,1240,1241,C
5-NP,266,4,0,0,1238,1242,C
5-NP,267,8,1,0,1235,1244,C
5-NP,268,1256,0,0,0,1256,A
5-NP,269,1254,0,1,0,1255,A
5-NP,270,0,3,1262,0,1265,G
5-NP,271,1262,0,2,0,1264,A
5-NP,272,1261,0,1,0,1262,A
5-NP,273,1265,0,0,1,1266,A
5-NP,274,1270,0,2,0,1272,A
5-NP,275,0,2,0,1267,1269,C
5-NP,276,0,1258,1,1,1260,T
5-NP,277,1,7,1256,1,1265,G
5-NP,278,1,6,1257,0,1264,G
5-NP,279,1,6,1251,0,1258,G
5-NP,280,0,3,1253,0,1256,G
5-NP,281,2,3,1252,0,1257,G
5-NP,282,1,0,1276,0,1277,G
5-NP,283,1,0,0,1369,1370,C
5-NP,284,6,1,0,1364,1371,C
5-NP,285,14,0,0,1363,1377,C
5-NP,286,1553,0,0,7,1560,A
5-NP,287,0,1557,1,1,1559,T
5-NP,288,1638,2,0,0,1640,A
5-NP,289,0,1642,0,1,1643,T
5-NP,290,1630,1,0,0,1631,A
5-NP,291,3,0,0,1642,1645,C
5-NP,292,1538,0,0,0,1538,A
5-NP,293,0,7,1560,1,1568,G
5-NP,294,1,4,1562,1,1568,G
5-NP,295,1418,0,1,0,1419,A
5-NP,296,0,7,1423,0,1430,G
5-NP,297,1361,0,0,0,1361,A
5-NP,298,0,0,1379,0,1379,G
5-NP,299,0,1373,0,0,1373,T
5-NP,300,1363,0,1,0,1364,A
5-NP,301,5,4,1361,0,1370,G
5-NP,302,1352,0,1,1,1354,A
5-NP,303,0,1352,0,1,1353,T
5-NP,304,1,6,1342,0,1349,G
5-NP,305,0,2,1351,0,1353,G
5-NP,306,1351,0,0,0,1351,A
5-NP,307,1337,0,1,1,1339,A
5-NP,308,1343,0,0,1,1344,A
5-NP,309,1349,1,1,0,1351,A
5-NP,310,0,1341,0,0,1341,T
5-NP,311,0,2,1358,0,1360,G
5-NP,312,0,2,1361,1,1364,G
5-NP,313,1363,1,0,0,1364,A
5-NP,314,0,1356,0,0,1356,T
5-NP,315,1,3,1355,0,1359,G
5-NP,316,1357,1,0,0,1358,A
5-NP,317,4,4,1364,0,1372,G
5-NP,318,1,6,1352,0,1359,G
5-NP,319,0,4,1363,2,1369,G
5-NP,320,1385,0,0,0,1385,A
5-NP,321,1389,0,1,0,1390,A
5-NP,322,2,0,0,1412,1414,C
5-NP,323,1,1405,0,0,1406,T
5-NP,324,6,0,0,1430,1436,C
5-NP,325,0,0,1442,0,1442,G
5-NP,326,1,1455,0,1,1457,T
5-NP,327,4,0,0,1461,1465,C
5-NP,328,4,0,0,1596,1600,C
5-NP,329,0,1591,0,1,1592,T
5-NP,330,1,1593,0,0,1594,T
5-NP,331,0,1598,0,0,1598,T
5-NP,332,1600,2,1,0,1603,A
5-NP,333,0,1601,0,0,1601,T
5-NP,334,1,13,1589,1,1604,G
5-NP,335,1619,0,0,0,1619,A
5-NP,336,1,0,0,1622,1623,C
5-NP,337,1588,0,0,0,1588,A
5-NP,338,1585,0,0,0,1585,A
5-NP,339,1591,0,0,0,1591,A
5-NP,340,0,5,1645,0,1650,G
5-NP,341,1646,0,0,0,1646,A
5-NP,342,1651,0,1,0,1652,A
5-NP,343,0,4,1707,1,1712,G
5-NP,344,1721,0,0,0,1721,A
5-NP,345,1728,0,1,0,1729,A
5-NP,346,1727,0,0,0,1727,A
5-NP,347,0,1727,0,0,1727,T
5-NP,348,1729,0,0,0,1729,A
5-NP,349,1721,0,0,1,1722,A
5-NP,350,0,1,1736,0,1737,G
5-NP,351,0,0,1736,0,1736,G
5-NP,352,1,0,0,1719,1720,C
5-NP,353,0,4,1718,0,1722,G
5-NP,354,1731,1,1,0,1733,A
5-NP,355,1756,0,1,0,1757,A
5-NP,356,0,1756,0,1,1757,T
5-NP,357,5,0,0,1762,1767,C
5-NP,358,0,1764,0,0,1764,T
5-NP,359,1,5,1745,1,1752,G
5-NP,360,0,1,1763,0,1764,G
5-NP,361,1,0,0,1764,1765,C
5-NP,362,1,0,1765,0,1766,G
5-NP,363,0,0,0,1761,1761,C
5-NP,364,1,2,0,1756,1759,C
5-NP,365,1778,0,0,0,1778,A
5-NP,366,1807,0,0,0,1807,A
5-NP,367,0,0,1865,0,1865,G
5-NP,368,1,0,0,1865,1866,C
5-NP,369,6,1,0,1876,1883,C
5-NP,370,1886,0,1,0,1887,A
5-NP,371,1921,0,1,1,1923,A
5-NP,372,1,1,0,1964,1966,C
5-NP,373,1966,0,1,0,1967,A
5-NP,374,2010,0,1,0,2011,A
5-NP,375,0,2012,0,0,2012,T
5-NP,376,0,11,2028,2,2041,G
5-NP,377,2,4,2042,0,2048,G
5-NP,378,0,2024,0,2,2026,T
5-NP,379,2,4,2026,0,2032,G
5-NP,380,2019,1,1,0,2021,A
5-NP,381,0,12,2060,0,2072,G
5-NP,382,0,3,2078,0,2081,G
5-NP,383,2093,0,2,0,2095,A
5-NP,384,0,2245,0,0,2245,T
5-NP,385,0,1,2261,0,2262,G
5-NP,386,3,0,1,2270,2274,C
5-NP,387,0,2277,0,2,2279,T
5-NP,388,2294,1,4,0,2299,A
5-NP,389,2,1,0,2334,2337,C
5-NP,390,2329,0,0,3,2332,A
5-NP,391,0,2325,0,1,2326,T
5-NP,392,1,0,0,2323,2324,C
5-NP,393,0,2242,0,1,2243,T
5-NP,394,0,5,2323,3,2331,G
5-NP,395,0,2,2374,0,2376,G
5-NP,396,0,2374,2,1,2377,T
5-NP,397,9,1,0,2371,2381,C
5-NP,398,0,2365,0,1,2366,T
5-NP,399,2404,0,0,0,2404,A
5-NP,400,2406,1,1,0,2408,A
5-NP,401,5,0,0,2441,2446,C
5-NP,402,0,2430,0,2,2432,T
5-NP,403,8,1,1,2431,2441,C
5-NP,404,2420,2,1,1,2424,A
5-NP,405,1,0,0,2518,2519,C
5-NP,406,2521,0,1,0,2522,A
5-NP,407,0,2523,0,4,2527,T
5-NP,408,2504,0,2,0,2506,A
5-NP,409,2505,1,0,0,2506,A
5-NP,410,0,2517,0,1,2518,T
5-NP,411,0,5,2548,0,2553,G
5-NP,412,2543,0,1,0,2544,A
5-NP,413,1,2527,0,1,2529,T
5-NP,414,0,2480,0,0,2480,T
5-NP,415,0,2488,0,0,2488,T
5-NP,416,0,10,2465,0,2475,G
5-NP,417,1,2,2481,0,2484,G
5-NP,418,2,0,0,2486,2488,C
5-NP,419,2489,1,0,0,2490,A
5-NP,420,0,2479,0,1,2480,T
5-NP,421,0,2477,0,3,2480,T
5-NP,422,5,0,0,2472,2477,C
5-NP,423,4,1,0,2478,2483,C
5-NP,424,2507,0,0,0,2507,A
5-NP,425,2511,0,0,1,2512,A
5-NP,426,0,2513,0,0,2513,T
5-NP,427,0,2517,0,0,2517,T
5-NP,428,0,2512,0,1,2513,T
5-NP,429,0,2,2535,0,2537,G
5-NP,430,2535,0,2,0,2537,A
5-NP,431,2540,1,2,1,2544,A
5-NP,432,0,2558,0,0,2558,T
5-NP,433,0,8,2538,0,2546,G
5-NP,434,2665,0,0,0,2665,A
5-NP,435,1,2669,0,0,2670,T
5-NP,436,0,2,2678,0,2680,G
5-NP,437,1,1,0,2742,2744,C
5-NP,438,2726,0,4,0,2730,A
5-NP,439,2854,1,2,1,2858,A
5-NP,440,3,1,0,2851,2855,C
5-NP,441,2907,0,1,0,2908,A
5-NP,442,0,2975,1,1,2977,T
5-NP,443,2927,0,0,0,2927,A
5-NP,444,7,0,0,2961,2968,C
5-NP,445,7,1,1,2957,2966,C
5-NP,446,2908,0,1,0,2909,A
5-NP,447,0,6,2948,0,2954,G
5-NP,448,2878,1,2,0,2881,A
5-NP,449,0,7,2951,0,2958,G
5-NP,450,0,8,2933,1,2942,G
5-NP,451,2929,0,2,0,2931,A
5-NP,452,1,1,0,2957,2959,C
5-NP,453,2920,0,2,1,2923,A
5-NP,454,2920,0,2,1,2923,A
5-NP,455,0,6,2915,0,2921,G
5-NP,456,2881,0,8,2,2891,A
5-NP,457,2,3,2914,0,2919,G
5-NP,458,1,1,1,2890,2893,C
5-NP,459,0,2886,0,2,2888,T
5-NP,460,8,0,0,2899,2907,C
5-NP,461,1,2895,0,0,2896,T
5-NP,462,0,2904,0,0,2904,T
5-NP,463,0,2,2917,0,2919,G
5-NP,464,0,2904,0,2,2906,T
5-NP,465,1,2905,0,2,2908,T
5-NP,466,11,1,0,2886,2898,C
5-NP,467,0,18,2889,0,2907,G
5-NP,468,2953,1,2,0,2956,A
5-NP,469,2963,0,0,0,2963,A
5-NP,470,2,4,0,2978,2984,C
5-NP,471,0,2970,0,2,2972,T
5-NP,472,0,7,3002,0,3009,G
5-NP,473,4,10,3012,0,3026,G
5-NP,474,3023,0,0,0,3023,A
5-NP,475,3026,0,3,0,3029,A
5-NP,476,0,3031,0,0,3031,T
5-NP,477,2,8,3023,0,3033,G
5-NP,478,1,12,3030,0,3043,G
5-NP,479,3056,1,0,1,3058,A
5-NP,480,0,3087,1,1,3089,T
5-NP,481,7,0,0,3111,3118,C
5-NP,482,8,0,0,3113,3121,C
5-NP,483,11,1,0,3121,3133,C
5-NP,484,3174,0,2,0,3176,A
5-NP,485,2,7,3210,0,3219,G
5-NP,486,3206,0,0,0,3206,A
5-NP,487,3215,0,0,0,3215,A
5-NP,488,1,3193,0,1,3195,T
5-NP,489,1,3,3242,0,3246,G
5-NP,490,0,3225,0,0,3225,T
5-NP,491,0,1,3247,0,3248,G
5-NP,492,0,0,0,3259,3259,C
5-NP,493,1,3240,1,2,3244,T
5-NP,494,11,1,2,3431,3445,C
5-NP,495,0,3435,0,1,3436,T
5-NP,496,4,0,0,3579,3583,C
5-NP,497,1,3574,1,2,3578,T
5-NP,498,3,5,3586,0,3594,G
5-NP,499,3613,2,0,0,3615,A
5-NP,500,1,3612,0,0,3613,T
5-NP,501,2,2,3611,0,3615,G
5-NP,502,0,1,0,3612,3613,C
5-NP,503,3511,0,1,0,3512,A
5-NP,504,1,18,3576,0,3595,G
5-NP,505,1,10,3517,0,3528,G
5-NP,506,3,5,3554,0,3562,G
5-NP,507,0,0,0,3562,3562,C
5-NP,508,0,3550,0,3,3553,T
5-NP,509,8,2,0,3547,3557,C
5-NP,510,1,11,3552,0,3564,G
5-NP,511,3623,0,2,1,3626,A
5-NP,512,4,1,0,3613,3618,C
5-NP,513,1,3564,0,5,3570,T
5-NP,514,11,0,0,3767,3778,C
5-NP,515,4,3761,1,4,3770,T
5-NP,516,7,0,2,4239,4248,C
5-NP,517,15,1,1,4236,4253,C
5-NP,518,10,1,0,4246,4257,C
5-NP,519,1,4250,1,1,4253,T
5-NP,520,4236,0,2,0,4238,A
5-NP,521,1,7,4227,0,4235,G
5-NP,522,4228,1,0,0,4229,A
5-NP,523,4101,1,2,0,4104,A
5-NP,524,0,16,4102,0,4118,G
5-NP,525,2,5,4050,0,4057,G
5-NP,526,0,3987,0,2,3989,T
5-NP,527,11,1,0,3978,3990,C
5-NP,528,12,4,0,3971,3987,C
5-NP,529,4,19,3955,0,3978,G
5-NP,530,1,9,3995,0,4005,G
5-NP,531,3991,0,3,0,3994,A
5-NP,532,0,0,4050,0,4050,G
5-NP,533,1,1,0,4063,4065,C
5-NP,534,1,4016,0,3,4020,T
5-NP,535,4,1,4015,2,4022,G
5-NP,536,1,2,1,4032,4036,C
5-NP,537,4031,1,6,1,4039,A
5-NP,538,1,12,4037,0,4050,G
5-NP,539,0,2,4066,0,4068,G
5-NP,540,2,4060,0,1,4063,T
5-NP,541,2,7,4010,0,4019,G
5-NP,542,2,1,0,4035,4038,C
5-NP,543,0,4031,0,2,4033,T
5-NP,544,2,2,4037,0,4041,G
5-NP,545,2,0,0,4034,4036,C
5-NP,546,4077,2,2,0,4081,A
5-NP,547,5,2,4140,1,4148,G
5-NP,548,0,4111,0,2,4113,T
5-NP,549,8,1,0,4114,4123,C
5-NP,550,4117,1,0,0,4118,A
5-NP,551,4126,0,1,1,4128,A
5-NP,552,4117,1,8,2,4128,A
5-NP,553,2,5,4139,0,4146,G
5-NP,554,0,15,4157,0,4172,G
5-NP,555,4164,2,2,0,4168,A
5-NP,556,4147,0,1,0,4148,A
5-NP,557,0,4144,0,0,4144,T
5-NP,558,7,1,0,4129,4137,C
5-NP,559,3,9,4124,0,4136,G
5-NP,560,0,5,4230,0,4235,G
5-NP,561,0,9,4237,1,4247,G
5-NP,562,4238,3,1,1,4243,A
5-NP,563,3,1,0,4232,4236,C
5-NP,564,4187,0,1,0,4188,A
5-NP,565,4297,0,3,0,4300,A
5-NP,566,0,4311,1,1,4313,T
5-NP,567,1,19,4307,1,4328,G
5-NP,568,0,12,4442,0,4454,G
5-NP,569,3,4447,0,2,4452,T
5-NP,570,1,7,4461,0,4469,G
5-NP,571,4465,0,1,0,4466,A
5-NP,572,0,4448,0,1,4449,T
5-NP,573,0,27,4435,0,4462,G
5-NP,574,3,16,4497,2,4518,G
5-NP,575,4486,0,6,0,4492,A
5-NP,576,4500,1,1,0,4502,A
5-NP,577,5,3,0,4490,4498,C
5-NP,578,0,4375,0,0,4375,T
5-NP,579,0,14,4578,0,4592,G
5-NP,580,4570,2,5,0,4577,A
5-NP,581,1,4575,0,2,4578,T
5-NP,582,9,0,0,4585,4594,C
5-NP,583,4520,2,3,0,4525,A
5-NP,584,0,5,4618,0,4623,G
5-NP,585,4600,0,2,0,4602,A
5-NP,586,4601,1,2,0,4604,A
5-NP,587,0,4612,1,2,4615,T
5-NP,588,2,16,4495,1,4514,G
5-NP,589,1,5,4553,3,4562,G
5-NP,590,0,4547,1,6,4554,T
5-NP,591,13,2,0,4550,4565,C
5-NP,592,4570,0,2,0,4572,A
5-NP,593,4556,0,2,0,4558,A
5-NP,594,4559,0,3,0,4562,A
5-NP,595,3,1,0,4568,4572,C
5-NP,596,0,11,4558,0,4569,G
5-NP,597,11,8,4556,1,4576,G
5-NP,598,3,12,4509,2,4526,G
5-NP,599,5,13,4513,0,4531,G
5-NP,600,4492,0,6,1,4499,A
5-NP,601,4539,1,3,1,4544,A
5-NP,602,0,4535,0,3,4538,T
5-NP,603,9,2,1,4527,4539,C
5-NP,604,4525,0,2,0,4527,A
5-NP,605,4532,0,3,0,4535,A
5-NP,606,4,1,0,4506,4511,C
5-NP,607,5,7,4486,0,4498,G
5-NP,608,4496,1,0,0,4497,A
5-NP,609,2,4481,0,0,4483,T
5-NP,610,15,2,0,4464,4481,C
5-NP,611,1,8,4484,0,4493,G
5-NP,612,4471,4,0,1,4476,A
5-NP,613,4461,0,1,1,4463,A
5-NP,614,4468,2,1,0,4471,A
5-NP,615,0,4487,1,1,4489,T
5-NP,616,1,4502,0,1,4504,T
5-NP,617,0,4515,0,2,4517,T
5-NP,618,1,4540,0,0,4541,T
5-NP,619,2,4558,0,0,4560,T
5-NP,620,2,10,4547,0,4559,G
5-NP,621,0,20,4548,0,4568,G
5-NP,622,4522,3,5,2,4532,A
5-NP,623,1,10,4559,0,4570,G
5-NP,624,4501,0,0,0,4501,A
5-NP,625,0,18,4690,0,4708,G
5-NP,626,1,3,4729,0,4733,G
5-NP,627,0,4712,0,5,4717,T
5-NP,628,3,12,4723,0,4738,G
5-NP,629,4720,1,7,0,4728,A
5-NP,630,1,12,4742,0,4755,G
5-NP,631,4741,2,4,2,4749,A
5-NP,632,4735,0,4,0,4739,A
5-NP,633,1,4713,0,2,4716,T
5-NP,634,1,24,4574,0,4599,G
5-NP,635,0,14,4536,1,4551,G
5-NP,636,1,5,4565,0,4571,G
5-NP,637,2,4,0,4549,4555,C
5-NP,638,2,11,4550,0,4563,G
5-NP,639,0,10,4565,0,4575,G
5-NP,640,4560,0,4,0,4564,A
5-NP,641,4560,2,2,1,4565,A
5-NP,642,4636,1,3,0,4640,A
5-NP,643,4652,3,2,3,4660,A
5-NP,644,2,2,0,4679,4683,C
5-NP,645,4677,2,1,0,4680,A
5-NP,646,4665,1,1,0,4667,A
5-NP,647,0,7,4664,1,4672,G
5-NP,648,4553,0,3,3,4559,A
5-NP,649,4574,0,2,0,4576,A
5-NP,650,0,2,4698,0,4700,G
5-NP,651,1,4675,0,2,4678,T
5-NP,652,1,1,4897,0,4899,G
5-NP,653,2,3,0,4865,4870,C
5-NP,654,0,4857,0,3,4860,T
5-NP,655,2,4888,1,1,4892,T
5-NP,656,4945,2,0,0,4947,A
5-NP,657,1,4950,0,0,4951,T
5-NP,658,3,16,4951,0,4970,G
5-NP,659,4870,2,3,0,4875,A
5-NP,660,1,17,4871,0,4889,G
5-NP,661,4667,1,4,1,4673,A
5-NP,662,1,12,4683,0,4696,G
5-NP,663,4696,0,2,0,4698,A
5-NP,664,4741,0,3,0,4744,A
5-NP,665,0,4701,0,1,4702,T
5-NP,666,7,2,4744,0,4753,G
5-NP,667,1,4722,0,3,4726,T
5-NP,668,1,3,4736,1,4741,G
5-NP,669,7,3,0,4707,4717,C
5-NP,670,4720,0,2,0,4722,A
5-NP,671,4718,2,8,0,4728,A
5-NP,672,4,2,0,4714,4720,C
5-NP,673,4669,0,1,0,4670,A
5-NP,674,1,4653,0,1,4655,T
5-NP,675,0,4623,1,4,4628,T
5-NP,676,7,1,0,4627,4635,C
5-NP,677,1,4614,0,1,4616,T
5-NP,678,0,4616,0,1,4617,T
5-NP,679,4626,1,1,0,4628,A
5-NP,680,4607,0,0,0,4607,A
5-NP,681,4613,0,2,1,4616,A
5-NP,682,0,13,4602,1,4616,G
5-NP,683,1,11,4594,0,4606,G
5-NP,684,4587,2,3,1,4593,A
5-NP,685,4583,1,1,0,4585,A
5-NP,686,4584,1,3,0,4588,A
5-NP,687,4650,1,0,0,4651,A
5-NP,688,0,4622,0,3,4625,T
5-NP,689,0,4621,1,1,4623,T
5-NP,690,0,4642,0,1,4643,T
5-NP,691,20,5,0,4633,4658,C
5-NP,692,4662,1,2,1,4666,A
5-NP,693,4656,0,1,0,4657,A
5-NP,694,4656,0,1,1,4658,A
5-NP,695,3,1,0,4696,4700,C
5-NP,696,4641,0,0,0,4641,A
5-NP,697,0,3,4758,0,4761,G
5-NP,698,0,0,0,4757,4757,C
5-NP,699,1,4755,0,1,4757,T
5-NP,700,2,4,4849,0,4855,G
5-NP,701,6,4,0,4830,4840,C
5-NP,702,4881,1,6,0,4888,A
5-NP,703,3,4,0,4883,4890,C
5-NP,704,4852,0,1,0,4853,A
5-NP,705,4865,0,2,0,4867,A
5-NP,706,4728,1,12,0,4741,A
5-NP,707,1,18,4890,1,4910,G
5-NP,708,4886,1,6,0,4893,A
5-NP,709,0,6,4946,0,4952,G
5-NP,710,4,1,0,4930,4935,C
5-NP,711,4945,0,2,0,4947,A
5-NP,712,5085,0,5,0,5090,A
5-NP,713,0,5084,0,1,5085,T
5-NP,714,0,19,5075,1,5095,G
5-NP,715,1,2,5119,0,5122,G
5-NP,716,2,4967,1,0,4970,T
5-NP,717,2,20,4935,0,4957,G
5-NP,718,0,18,4962,0,4980,G
5-NP,719,4981,2,2,0,4985,A
5-NP,720,3,4962,0,4,4969,T
5-NP,721,12,1,0,4794,4807,C
5-NP,722,4830,0,2,0,4832,A
5-NP,723,4864,0,6,1,4871,A
5-NP,724,0,6,4890,0,4896,G
5-NP,725,1,4848,0,1,4850,T
5-NP,726,2,17,4831,2,4852,G
5-NP,727,4777,1,4,1,4783,A
5-NP,728,0,12,4794,0,4806,G
5-NP,729,4785,1,8,0,4794,A
5-NP,730,2,10,4785,0,4797,G
5-NP,731,4758,0,3,0,4761,A
5-NP,732,4686,1,1,1,4689,A
5-NP,733,4712,0,3,0,4715,A
5-NP,734,0,2,4738,0,4740,G
5-NP,735,1,4710,0,1,4712,T
5-NP,736,14,3,1,4696,4714,C
5-NP,737,2,20,4693,0,4715,G
5-NP,738,1,11,4709,2,4723,G
5-NP,739,4724,3,4,0,4731,A
5-NP,740,4760,0,1,0,4761,A
5-NP,741,8,0,0,4747,4755,C
5-NP,742,17,3,0,4699,4719,C
5-NP,743,13,2,0,4723,4738,C
5-NP,744,4745,1,3,1,4750,A
5-NP,745,0,9,4745,1,4755,G
5-NP,746,0,8,4740,0,4748,G
5-NP,747,4739,1,3,1,4744,A
5-NP,748,4743,2,4,0,4749,A
5-NP,749,4726,1,3,0,4730,A
5-NP,750,3,6,0,4727,4736,C
5-NP,751,3,5,4710,0,4718,G
5-NP,752,3,2,0,4700,4705,C
5-NP,753,1,4696,0,2,4699,T
5-NP,754,0,11,4704,0,4715,G
5-NP,755,4696,0,2,0,4698,A
5-NP,756,1,7,4745,0,4753,G
5-NP,757,4748,1,2,0,4751,A
5-NP,758,0,4745,1,4,4750,T
5-NP,759,7,4,1,4696,4708,C
5-NP,760,3,7,4706,0,4716,G
5-NP,761,4720,1,0,0,4721,A
5-NP,762,4716,1,0,0,4717,A
5-NP,763,0,5,4705,0,4710,G
5-NP,764,4737,1,1,0,4739,A
5-NP,765,2,4694,0,1,4697,T
5-NP,766,3,0,0,4719,4722,C
5-NP,767,1,4714,0,2,4717,T
5-NP,768,18,1,0,4745,4764,C
5-NP,769,4780,1,2,0,4783,A
5-NP,770,0,4772,0,1,4773,T
5-NP,771,4804,0,0,0,4804,A
5-NP,772,0,4776,0,0,4776,T
5-NP,773,1,4745,1,5,4752,T
5-NP,774,0,4719,2,3,4724,T
5-NP,775,0,4687,0,3,4690,T
5-NP,776,0,4699,1,2,4702,T
5-NP,777,4717,1,2,0,4720,A
5-NP,778,2,2,4704,0,4708,G
5-NP,779,1,2,0,4707,4710,C
5-NP,780,4693,4,0,1,4698,A
5-NP,781,4685,1,4,2,4692,A
5-NP,782,1,12,4855,0,4868,G
5-NP,783,4863,0,3,0,4866,A
5-NP,784,0,4854,0,1,4855,T
5-NP,785,6,1,1,4883,4891,C
5-NP,786,1,4862,3,5,4871,T
5-NP,787,0,2,4978,0,4980,G
5-NP,788,0,0,0,4985,4985,C
5-NP,789,4998,0,1,0,4999,A
5-NP,790,0,5031,0,3,5034,T
5-NP,791,0,4862,0,1,4863,T
5-NP,792,6,12,5125,1,5144,G
5-NP,793,5235,0,2,0,5237,A
5-NP,794,0,5224,0,1,5225,T
5-NP,795,5246,1,2,0,5249,A
5-NP,796,1,5133,0,0,5134,T
5-NP,797,0,5097,0,1,5098,T
5-NP,798,2,11,5135,0,5148,G
5-NP,799,5098,1,7,0,5106,A
5-NP,800,0,10,5130,0,5140,G
5-NP,801,4878,0,4,0,4882,A
5-NP,802,1,26,4769,1,4797,G
5-NP,803,1,17,4849,0,4867,G
5-NP,804,4856,1,3,0,4860,A
5-NP,805,0,4835,0,3,4838,T
5-NP,806,17,2,0,4840,4859,C
5-NP,807,4819,1,2,0,4822,A
5-NP,808,0,3,4856,0,4859,G
5-NP,809,2,4826,0,4,4832,T
5-NP,810,0,4788,1,2,4791,T
5-NP,811,1,1,4801,0,4803,G
5-NP,812,5,2,1,4732,4740,C
5-NP,813,2,4727,0,7,4736,T
5-NP,814,23,1,0,4737,4761,C
5-NP,815,4770,2,2,0,4774,A
5-NP,816,2,0,0,4774,4776,C
5-NP,817,4768,0,1,0,4769,A
5-NP,818,4802,3,1,0,4806,A
5-NP,819,4804,1,3,4,4812,A
5-NP,820,1,4801,0,0,4802,T
5-NP,821,14,1,0,4803,4818,C
5-NP,822,0,4813,1,0,4814,T
5-NP,823,1,4797,0,0,4798,T
5-NP,824,0,3,4807,1,4811,G
5-NP,825,1,4,0,4817,4822,C
5-NP,826,11,1,0,4889,4901,C
5-NP,827,0,4891,0,0,4891,T
5-NP,828,4924,0,1,0,4925,A
5-NP,829,5,1,0,4909,4915,C
5-NP,830,14,0,0,4906,4920,C
5-NP,831,0,4911,0,1,4912,T
5-NP,832,3,2,4981,0,4986,G
5-NP,833,4,3,0,4949,4956,C
5-NP,834,24,0,1,4937,4962,C
5-NP,835,0,4880,0,3,4883,T
5-NP,836,7,3,4925,0,4935,G
5-NP,837,3,4898,1,3,4905,T
5-NP,838,1,3,4938,0,4942,G
5-NP,839,8,3,0,4963,4974,C
5-NP,840,2,3,5044,0,5049,G
5-NP,841,1,4956,0,5,4962,T
5-NP,842,4959,0,0,0,4959,A
5-NP,843,0,4955,0,1,4956,T
5-NP,844,0,27,4935,2,4964,G
5-NP,845,0,12,5174,0,5186,G
5-NP,846,5170,2,2,0,5174,A
5-NP,847,9,3,2,5068,5082,C
5-NP,848,18,0,0,5048,5066,C
5-NP,849,1,4974,1,2,4978,T
5-NP,850,1,2,5200,0,5203,G
5-NP,851,1,2,0,5201,5204,C
5-NP,852,5213,0,5,1,5219,A
5-NP,853,5,5,5310,1,5321,G
5-NP,854,0,5069,0,2,5071,T
5-NP,855,5279,0,0,0,5279,A
5-NP,856,2,5253,0,2,5257,T
5-NP,857,10,1,0,5229,5240,C
5-NP,858,12,1,1,5238,5252,C
5-NP,859,4995,0,1,0,4996,A
5-NP,860,4,3,5014,0,5021,G
5-NP,861,0,4991,0,3,4994,T
5-NP,862,1,16,5021,0,5038,G
5-NP,863,1,26,4985,2,5014,G
5-NP,864,2,8,4898,0,4908,G
5-NP,865,0,4892,1,2,4895,T
5-NP,866,4875,2,2,0,4879,A
5-NP,867,4,2,0,4863,4869,C
5-NP,868,3,17,4819,0,4839,G
5-NP,869,4812,0,5,0,4817,A
5-NP,870,3,1,0,4809,4813,C
5-NP,871,0,4690,1,1,4692,T
5-NP,872,1,4694,0,2,4697,T
5-NP,873,12,2,0,4687,4701,C
5-NP,874,0,8,4694,0,4702,G
5-NP,875,4708,0,4,0,4712,A
5-NP,876,4713,0,1,1,4715,A
5-NP,877,4722,1,0,0,4723,A
5-NP,878,4711,0,0,1,4712,A
5-NP,879,4708,3,2,1,4714,A
5-NP,880,1,7,4727,0,4735,G
5-NP,881,4704,0,7,1,4712,A
5-NP,882,4,13,4739,0,4756,G
5-NP,883,2,17,4764,1,4784,G
5-NP,884,1,18,4787,0,4806,G
5-NP,885,4812,0,5,1,4818,A
5-NP,886,2,4816,0,2,4820,T
5-NP,887,4835,0,1,3,4839,A
5-NP,888,1,4824,0,2,4827,T
5-NP,889,3,4842,0,2,4847,T
5-NP,890,13,0,0,4869,4882,C
5-NP,891,8,2,0,4851,4861,C
5-NP,892,0,4802,1,0,4803,T
5-NP,893,0,4799,0,2,4801,T
5-NP,894,1,17,4829,0,4847,G
5-NP,895,4,3,4864,1,4872,G
5-NP,896,1,4846,0,5,4852,T
5-NP,897,1,22,4801,1,4825,G
5-NP,898,3,8,4790,1,4802,G
5-NP,899,1,17,5026,0,5044,G
5-NP,900,5024,1,2,0,5027,A
5-NP,901,5021,2,3,1,5027,A
5-NP,902,0,5035,0,1,5036,T
5-NP,903,4949,1,2,0,4952,A
5-NP,904,2,13,4950,0,4965,G
5-NP,905,4915,2,9,2,4928,A
5-NP,906,8,1,0,4910,4919,C
5-NP,907,29,0,0,4840,4869,C
5-NP,908,16,0,0,4695,4711,C
5-NP,909,2,4509,1,244,4756,T
5-NP,910,0,4766,0,4,4770,T
5-NP,911,1,4765,0,11,4777,T
5-NP,912,9,2,0,4772,4783,C
5-NP,913,4754,1,3,0,4758,A
5-NP,914,4755,1,0,1,4757,A
5-NP,915,4740,3,1,0,4744,A
5-NP,916,3,0,0,4737,4740,C
5-NP,917,1,4633,0,2,4636,T
5-NP,918,4589,0,0,1,4590,A
5-NP,919,4,1,0,4643,4648,C
5-NP,920,1,4631,0,2,4634,T
5-NP,921,3,4618,0,4,4625,T
5-NP,922,6,2,0,4631,4639,C
5-NP,923,4628,1,2,0,4631,A
5-NP,924,4625,0,1,0,4626,A
5-NP,925,4611,0,2,0,4613,A
5-NP,926,4608,2,1,0,4611,A
5-NP,927,1,4579,0,0,4580,T
5-NP,928,4519,0,0,0,4519,A
5-NP,929,0,2,4574,0,4576,G
5-NP,930,2,5,1,4596,4604,C
5-NP,931,8,2,1,4632,4643,C
5-NP,932,4652,1,1,0,4654,A
5-NP,933,4662,1,2,0,4665,A
5-NP,934,4803,1,1,1,4806,A
5-NP,935,0,4828,0,0,4828,T
5-NP,936,4845,2,2,0,4849,A
5-NP,937,0,4857,0,0,4857,T
5-NP,938,4802,0,1,0,4803,A
5-NP,939,2,1,0,4811,4814,C
5-NP,940,4709,0,3,0,4712,A
5-NP,941,3,3,4814,0,4820,G
5-NP,942,7,0,0,4801,4808,C
5-NP,943,0,4668,0,3,4671,T
5-NP,944,0,4727,0,0,4727,T
5-NP,945,4739,0,0,0,4739,A
5-NP,946,4729,0,2,1,4732,A
5-NP,947,1,4734,2,0,4737,T
5-NP,948,20,11,0,4701,4732,C
5-NP,949,4585,1,2,0,4588,A
5-NP,950,1,19,4619,0,4639,G
5-NP,951,4646,0,2,1,4649,A
5-NP,952,4,1,0,4677,4682,C
5-NP,953,17,3,0,4617,4637,C
5-NP,954,0,4593,0,3,4596,T
5-NP,955,4639,1,4,0,4644,A
5-NP,956,4634,0,2,0,4636,A
5-NP,957,2,3,0,4654,4659,C
5-NP,958,3,17,4636,2,4658,G
5-NP,959,4570,2,1,0,4573,A
5-NP,960,0,11,4569,0,4580,G
5-NP,961,4539,0,3,0,4542,A
5-NP,962,4586,0,0,0,4586,A
5-NP,963,1,4574,0,4,4579,T
5-NP,964,12,1,0,4516,4529,C
5-NP,965,13,1,0,4516,4530,C
5-NP,966,4457,0,5,0,4462,A
5-NP,967,1,0,4492,0,4493,G
5-NP,968,4,1,0,4483,4488,C
5-NP,969,4522,0,1,0,4523,A
5-NP,970,2,2,0,4542,4546,C
5-NP,971,4476,0,2,0,4478,A
5-NP,972,4,2,0,4468,4474,C
5-NP,973,4466,1,1,0,4468,A
5-NP,974,4475,1,7,0,4483,A
5-NP,975,1,9,4487,0,4497,G
5-NP,976,4458,1,2,0,4461,A
5-NP,977,3,4,4468,0,4475,G
5-NP,978,0,4380,0,4,4384,T
5-NP,979,9,3,0,4365,4377,C
5-NP,980,4361,0,6,0,4367,A
5-NP,981,2,1,4369,0,4372,G
5-NP,982,2,0,0,4355,4357,C
5-NP,983,0,4318,0,1,4319,T
5-NP,984,4,17,4342,1,4364,G
5-NP,985,1,3,4373,0,4377,G
5-NP,986,0,4358,1,1,4360,T
5-NP,987,1,2,4391,1,4395,G
5-NP,988,1,4346,0,2,4349,T
5-NP,989,2,10,4313,0,4325,G
5-NP,990,2,6,4310,0,4318,G
5-NP,991,4292,0,4,0,4296,A
5-NP,992,0,4301,0,3,4304,T
5-NP,993,1,21,4085,0,4107,G
5-NP,994,1,2,4083,0,4086,G
5-NP,995,2,2,0,4068,4072,C
5-NP,996,4015,1,3,0,4019,A
5-NP,997,0,4006,1,1,4008,T
5-NP,998,3,3,3963,0,3969,G
5-NP,999,4,4,0,3982,3990,C
5-NP,1000,13,1,0,3980,3994,C
5-NP,1001,4019,0,1,0,4020,A
5-NP,1002,0,3999,0,1,4000,T
5-NP,1003,0,3950,0,1,3951,T
5-NP,1004,5,0,0,3963,3968,C
5-NP,1005,1,3908,0,0,3909,T
5-NP,1006,1,1,3909,0,3911,G
5-NP,1007,0,1,0,3900,3901,C
5-NP,1008,0,3761,0,6,3767,T
5-NP,1009,1,6,3785,0,3792,G
5-NP,1010,2,4,0,3737,3743,C
5-NP,1011,3743,0,1,0,3744,A
5-NP,1012,0,3744,0,0,3744,T
5-NP,1013,0,3694,2,1,3697,T
5-NP,1014,0,3692,0,2,3694,T
5-NP,1015,0,8,3684,0,3692,G
5-NP,1016,3692,1,2,0,3695,A
5-NP,1017,3687,1,4,0,3692,A
5-NP,1018,0,3,3733,0,3736,G
5-NP,1019,3716,1,3,2,3722,A
5-NP,1020,1,3697,0,0,3698,T
5-NP,1021,0,3696,0,2,3698,T
5-NP,1022,0,3702,0,0,3702,T
5-NP,1023,3709,0,0,0,3709,A
5-NP,1024,3707,0,0,0,3707,A
5-NP,1025,1,6,3705,0,3712,G
5-NP,1026,3705,0,5,2,3712,A
5-NP,1027,3,3695,0,1,3699,T
5-NP,1028,0,3634,0,0,3634,T
5-NP,1029,3,2,3659,0,3664,G
5-NP,1030,0,3659,0,2,3661,T
5-NP,1031,1,3652,1,1,3655,T
5-NP,1032,3657,1,1,0,3659,A
5-NP,1033,3671,0,1,0,3672,A
5-NP,1034,1,1,3673,0,3675,G
5-NP,1035,6,0,0,3655,3661,C
5-NP,1036,0,3594,2,8,3604,T
5-NP,1037,1,3609,0,2,3612,T
5-NP,1038,11,2,0,3603,3616,C
5-NP,1039,3617,2,5,1,3625,A
5-NP,1040,0,3614,0,4,3618,T
5-NP,1041,7,2,0,3618,3627,C
5-NP,1042,3572,1,1,0,3574,A
5-NP,1043,0,5,3569,0,3574,G
5-NP,1044,3525,0,2,0,3527,A
5-NP,1045,1,9,3520,0,3530,G
5-NP,1046,2,15,3506,0,3523,G
5-NP,1047,1,17,3491,1,3510,G
5-NP,1048,3506,1,7,0,3514,A
5-NP,1049,4,1,0,3506,3511,C
5-NP,1050,3508,0,5,0,3513,A
5-NP,1051,3526,0,3,0,3529,A
5-NP,1052,3520,0,3,0,3523,A
5-NP,1053,3526,0,4,2,3532,A
5-NP,1054,0,2,3545,0,3547,G
5-NP,1055,0,3474,0,0,3474,T
5-NP,1056,3456,0,3,0,3459,A
5-NP,1057,0,3431,0,7,3438,T
5-NP,1058,8,2,0,3430,3440,C
5-NP,1059,1,3413,0,4,3418,T
5-NP,1060,9,0,0,3419,3428,C
5-NP,1061,8,1,0,3393,3402,C
5-NP,1062,0,3374,0,0,3374,T
5-NP,1063,11,1,0,3366,3378,C
5-NP,1064,3,10,3358,2,3373,G
5-NP,1065,4,18,3352,2,3376,G
5-NP,1066,1,13,3361,0,3375,G
5-NP,1067,3,11,3358,0,3372,G
5-NP,1068,3,5,3365,0,3373,G
5-NP,1069,3313,0,0,0,3313,A
5-NP,1070,3311,0,5,1,3317,A
5-NP,1071,3320,0,1,0,3321,A
5-NP,1072,5,0,0,3342,3347,C
5-NP,1073,1,3318,0,1,3320,T
5-NP,1074,1,2,3342,0,3345,G
5-NP,1075,0,3315,0,1,3316,T
5-NP,1076,15,2,0,3298,3315,C
5-NP,1077,3364,0,2,0,3366,A
5-NP,1078,3389,0,0,0,3389,A
5-NP,1079,7,2,3,3380,3392,C
5-NP,1080,0,3386,0,1,3387,T
5-NP,1081,3322,0,3,0,3325,A
5-NP,1082,0,6,3318,1,3325,G
5-NP,1083,3268,0,3,1,3272,A
5-NP,1084,1,12,3257,0,3270,G
5-NP,1085,0,8,3267,0,3275,G
5-NP,1086,3131,0,0,0,3131,A
5-NP,1087,3,2,3185,0,3190,G
5-NP,1088,1,3156,0,1,3158,T
5-NP,1089,3160,0,3,0,3163,A
5-NP,1090,6,0,0,3152,3158,C
5-NP,1091,3117,0,0,0,3117,A
5-NP,1092,3119,0,1,0,3120,A
5-NP,1093,3086,0,1,1,3088,A
5-NP,1094,0,3061,0,0,3061,T
5-NP,1095,0,3030,0,0,3030,T
5-NP,1096,0,4,2941,0,2945,G
5-NP,1097,1,0,0,2912,2913,C
5-NP,1098,0,2898,0,5,2903,T
5-NP,1099,1,2900,0,2,2903,T
5-NP,1100,10,0,0,2894,2904,C
5-NP,1101,2906,1,1,0,2908,A
5-NP,1102,2918,1,3,0,2922,A
5-NP,1103,2923,0,0,0,2923,A
5-NP,1104,2,2931,0,0,2933,T
5-NP,1105,1,5,2923,0,2929,G
5-NP,1106,2874,0,4,0,2878,A
5-NP,1107,2,11,2870,0,2883,G
5-NP,1108,2890,2,2,0,2894,A
5-NP,1109,2890,1,2,0,2893,A
5-NP,1110,0,0,0,2892,2892,C
5-NP,1111,2846,0,0,0,2846,A
5-NP,1112,0,2850,0,0,2850,T
5-NP,1113,3,7,2863,1,2874,G
5-NP,1114,1,6,2878,0,2885,G
5-NP,1115,2880,0,1,0,2881,A
5-NP,1116,0,2834,0,1,2835,T
5-NP,1117,2815,0,1,0,2816,A
5-NP,1118,2953,0,0,0,2953,A
5-NP,1119,0,2877,0,0,2877,T
5-NP,1120,2863,0,0,0,2863,A
5-NP,1121,0,2849,0,0,2849,T
5-NP,1122,0,8,2670,0,2678,G
5-NP,1123,2,13,2617,0,2632,G
5-NP,1124,1,5,2610,0,2616,G
5-NP,1125,2594,0,1,0,2595,A
5-NP,1126,1,2590,0,1,2592,T
5-NP,1127,5,0,0,2084,2089,C
5-NP,1128,2,1,2091,0,2094,G
5-NP,1129,2080,0,0,1,2081,A
5-NP,1130,0,1,2080,0,2081,G
5-NP,1131,0,0,0,2070,2070,C
5-NP,1132,2054,0,0,0,2054,A
5-NP,1133,1,0,0,2150,2151,C
5-NP,1134,0,2113,0,1,2114,T
5-NP,1135,4,0,0,2130,2134,C
5-NP,1136,1,2119,0,3,2123,T
5-NP,1137,0,2093,1,2,2096,T
5-NP,1138,0,6,2096,0,2102,G
5-NP,1139,2091,0,1,0,2092,A
5-NP,1140,2096,0,1,1,2098,A
5-NP,1141,1,2,0,2091,2094,C
5-NP,1142,0,1670,1,1,1672,T
5-NP,1143,1,1,1686,0,1688,G
5-NP,1144,1624,0,5,0,1629,A
5-NP,1145,0,0,1640,0,1640,G
5-NP,1146,1635,0,0,0,1635,A
5-NP,1147,1620,0,1,0,1621,A
5-NP,1148,1,0,1633,0,1634,G
5-NP,1149,2,0,1,1599,1602,C
5-NP,1150,0,5,1589,1,1595,G
5-NP,1151,0,8,1589,0,1597,G
5-NP,1152,3,1,1584,0,1588,G
5-NP,1153,0,1576,0,1,1577,T
5-NP,1154,1535,0,1,0,1536,A
5-NP,1155,0,1,0,1538,1539,C
5-NP,1156,0,1337,0,3,1340,T
5-NP,1157,1,3,1346,0,1350,G
5-NP,1158,0,4,1341,0,1345,G
5-NP,1159,1,1,1344,0,1346,G
5-NP,1160,1,2,1,1326,1330,C
5-NP,1161,6,0,0,1271,1277,C
5-NP,1162,1290,1,0,0,1291,A
5-NP,1163,0,1286,0,0,1286,T
5-NP,1164,1288,0,1,0,1289,A
5-NP,1165,1292,1,0,0,1293,A
5-NP,1166,1,7,1268,0,1276,G
5-NP,1167,0,3,1294,0,1297,G
5-NP,1168,1281,2,0,1,1284,A
5-NP,1169,1,0,0,1280,1281,C
5-NP,1170,2,1,0,1279,1282,C
5-NP,1171,1276,2,1,0,1279,A
5-NP,1172,0,4,1294,0,1298,G
5-NP,1173,0,5,1295,0,1300,G
5-NP,1174,1295,0,1,0,1296,A
5-NP,1175,0,3,1307,0,1310,G
5-NP,1176,0,1252,0,1,1253,T
5-NP,1177,0,2,1253,1,1256,G
5-NP,1178,1,3,1261,1,1266,G
5-NP,1179,1273,0,0,0,1273,A
5-NP,1180,0,2,1274,0,1276,G
5-NP,1181,1,5,1244,0,1250,G
5-NP,1182,1240,1,0,0,1241,A
5-NP,1183,1241,2,0,0,1243,A
5-NP,1184,1240,1,0,1,1242,A
5-NP,1185,0,1,0,1252,1253,C
5-NP,1186,1243,1,2,0,1246,A
5-NP,1187,2,1,0,1284,1287,C
5-NP,1188,0,1274,0,0,1274,T
5-NP,1189,1299,0,0,0,1299,A
5-NP,1190,1302,0,0,0,1302,A
5-NP,1191,1,1304,0,0,1305,T
5-NP,1192,4,0,0,1307,1311,C
5-NP,1193,1298,0,0,0,1298,A
5-NP,1194,1309,0,1,0,1310,A
5-NP,1195,0,0,0,1311,1311,C
5-NP,1196,1274,0,1,0,1275,A
5-NP,1197,0,0,1276,0,1276,G
5-NP,1198,1237,1,0,0,1238,A
5-NP,1199,1,11,1244,0,1256,G
5-NP,1200,1,4,1242,0,1247,G
5-NP,1201,1,0,1250,0,1251,G
5-NP,1202,1,0,0,1244,1245,C
5-NP,1203,4,0,0,1235,1239,C
5-NP,1204,0,1228,0,1,1229,T
5-NP,1205,3,0,0,1240,1243,C
5-NP,1206,5,2,0,1232,1239,C
5-NP,1207,3,1,1240,0,1244,G
5-NP,1208,0,2,0,1242,1244,C
5-NP,1209,1224,1,1,0,1226,A
5-NP,1210,1,5,1268,0,1274,G
5-NP,1211,0,1,1271,0,1272,G
5-NP,1212,2,0,0,1268,1270,C
5-NP,1213,1,0,0,1268,1269,C
5-NP,1214,1257,0,0,0,1257,A
5-NP,1215,1264,0,1,0,1265,A
5-NP,1216,1268,0,2,0,1270,A
5-NP,1217,5,0,0,1265,1270,C
5-NP,1218,7,0,0,1270,1277,C
5-NP,1219,1196,1,0,0,1197,A
5-NP,1220,0,1,1225,0,1226,G
5-NP,1221,0,1210,1,2,1213,T
5-NP,1222,1,1,1215,0,1217,G
5-NP,1223,1,1217,0,1,1219,T
5-NP,1224,0,1,1219,0,1220,G
5-NP,1225,0,0,0,1222,1222,C
5-NP,1226,1209,0,0,0,1209,A
5-NP,1227,1228,0,0,0,1228,A
5-NP,1228,0,1,0,1219,1220,C
5-NP,1229,3,1,0,1209,1213,C
5-NP,1230,0,1193,0,0,1193,T
5-NP,1231,1192,0,2,0,1194,A
5-NP,1232,1,1,0,1191,1193,C
5-NP,1233,4,1,1188,0,1193,G
5-NP,1234,0,1188,0,0,1188,T
5-NP,1235,0,1192,0,0,1192,T
5-NP,1236,0,1178,0,0,1178,T
5-NP,1237,0,1174,0,0,1174,T
5-NP,1238,1,0,0,1176,1177,C
5-NP,1239,0,1166,0,1,1167,T
5-NP,1240,2,1,1186,0,1189,G
5-NP,1241,0,1188,0,0,1188,T
5-NP,1242,1192,0,0,0,1192,A
5-NP,1243,0,1,0,1202,1203,C
5-NP,1244,1186,0,0,0,1186,A
5-NP,1245,1185,1,2,0,1188,A
5-NP,1246,1186,0,0,0,1186,A
5-NP,1247,0,8,1184,0,1192,G
5-NP,1248,1187,0,0,1,1188,A
5-NP,1249,1160,0,0,0,1160,A
5-NP,1250,1156,0,1,0,1157,A
5-NP,1251,1,0,0,1158,1159,C
5-NP,1252,3,0,0,1142,1145,C
5-NP,1253,0,1144,0,0,1144,T
5-NP,1254,4,1,0,1139,1144,C
5-NP,1255,5,0,0,1134,1139,C
5-NP,1256,6,0,0,1137,1143,C
5-NP,1257,1142,0,1,0,1143,A
5-NP,1258,0,1142,0,1,1143,T
5-NP,1259,0,1148,0,0,1148,T
5-NP,1260,1,1137,0,1,1139,T
5-NP,1261,1,1,1143,0,1145,G
5-NP,1262,1142,0,0,0,1142,A
5-NP,1263,1138,0,0,0,1138,A
5-NP,1264,1137,1,1,0,1139,A
5-NP,1265,1139,0,0,0,1139,A
5-NP,1266,0,0,1148,1,1149,G
5-NP,1267,0,1146,0,0,1146,T
5-NP,1268,5,0,0,1141,1146,C
5-NP,1269,1149,0,0,0,1149,A
5-NP,1270,1155,0,0,0,1155,A
5-NP,1271,1,1,0,1153,1155,C
5-NP,1272,3,1,0,1167,1171,C
5-NP,1273,1168,0,0,0,1168,A
5-NP,1274,0,1171,0,0,1171,T
5-NP,1275,1,0,0,1171,1172,C
5-NP,1276,1161,2,0,0,1163,A
5-NP,1277,0,1165,0,3,1168,T
5-NP,1278,0,3,1164,2,1169,G
5-NP,1279,0,0,1171,1,1172,G
5-NP,1280,0,1,0,1165,1166,C
5-NP,1281,1145,0,0,0,1145,A
5-NP,1282,1,0,1146,0,1147,G
5-NP,1283,1,0,0,1136,1137,C
5-NP,1284,1139,0,0,0,1139,A
5-NP,1285,0,1133,0,0,1133,T
5-NP,1286,0,1125,0,2,1127,T
5-NP,1287,2,0,0,1125,1127,C
5-NP,1288,1116,0,0,0,1116,A
5-NP,1289,1,0,0,1124,1125,C
5-NP,1290,0,1118,0,2,1120,T
5-NP,1291,0,3,1118,1,1122,G
5-NP,1292,0,1,1129,1,1131,G
5-NP,1293,1124,1,0,0,1125,A
5-NP,1294,1120,0,1,0,1121,A
5-NP,1295,1130,1,0,0,1131,A
5-NP,1296,0,1114,0,0,1114,T
5-NP,1297,1115,0,1,0,1116,A
5-NP,1298,2,0,0,1115,1117,C
5-NP,1299,0,3,1104,0,1107,G
5-NP,1300,0,4,1103,0,1107,G
5-NP,1301,1084,0,0,0,1084,A
5-NP,1302,0,2,1091,0,1093,G
5-NP,1303,1,4,1086,0,1091,G
5-NP,1304,0,1,1090,0,1091,G
5-NP,1305,1089,1,0,0,1090,A
5-NP,1306,1089,0,0,0,1089,A
5-NP,1307,1,1,1091,0,1093,G
5-NP,1308,1087,0,0,0,1087,A
5-NP,1309,1086,0,0,0,1086,A
5-NP,1310,1,0,0,1082,1083,C
5-NP,1311,0,1068,0,0,1068,T
5-NP,1312,0,1070,1,0,1071,T
5-NP,1313,4,1,0,1061,1066,C
5-NP,1314,1066,0,3,0,1069,A
5-NP,1315,0,3,1068,0,1071,G
5-NP,1316,1061,1,0,0,1062,A
5-NP,1317,1,0,0,1065,1066,C
5-NP,1318,1055,0,0,0,1055,A
5-NP,1319,0,1033,0,0,1033,T
5-NP,1320,0,2,1038,0,1040,G
5-NP,1321,1019,0,1,0,1020,A
5-NP,1322,0,4,1017,0,1021,G
5-NP,1323,0,2,1019,0,1021,G
5-NP,1324,0,1,1018,0,1019,G
5-NP,1325,0,0,0,1018,1018,C
5-NP,1326,1007,0,0,0,1007,A
5-NP,1327,1,4,1007,0,1012,G
5-NP,1328,1004,0,0,0,1004,A
5-NP,1329,1015,0,0,0,1015,A
5-NP,1330,1015,0,0,0,1015,A
5-NP,1331,0,1002,0,0,1002,T
5-NP,1332,2,0,0,1008,1010,C
5-NP,1333,1008,0,0,0,1008,A
5-NP,1334,2,1003,0,0,1005,T
5-NP,1335,1009,0,1,0,1010,A
5-NP,1336,1004,0,1,0,1005,A
5-NP,1337,0,1,1016,0,1017,G
5-NP,1338,999,0,1,0,1000,A
5-NP,1339,1007,1,1,1,1010,A
5-NP,1340,1,993,0,0,994,T
5-NP,1341,1,1,992,0,994,G
5-NP,1342,994,0,2,0,996,A
5-NP,1343,0,992,0,1,993,T
5-NP,1344,0,0,995,0,995,G
5-NP,1345,0,2,992,0,994,G
5-NP,1346,970,0,0,0,970,A
5-NP,1347,966,1,0,0,967,A
5-NP,1348,1,3,939,0,943,G
5-NP,1349,0,1,959,0,960,G
5-NP,1350,0,941,0,6,947,T
5-NP,1351,2,0,948,0,950,G
5-NP,1352,0,1,0,946,947,C
5-NP,1353,944,0,1,0,945,A
5-NP,1354,946,0,0,0,946,A
5-NP,1355,940,0,0,0,940,A
5-NP,1356,952,0,0,0,952,A
5-NP,1357,0,0,0,953,953,C
5-NP,1358,4,0,0,937,941,C
5-NP,1359,932,0,0,0,932,A
5-NP,1360,0,3,932,1,936,G
5-NP,1361,935,1,1,0,937,A
5-NP,1362,936,0,0,0,936,A
5-NP,1363,0,2,940,0,942,G
5-NP,1364,929,0,0,0,929,A
5-NP,1365,901,0,2,0,903,A
5-NP,1366,0,1,918,0,919,G
5-NP,1367,0,896,0,1,897,T
5-NP,1368,0,0,910,0,910,G
5-NP,1369,0,895,0,2,897,T
5-NP,1370,4,0,0,900,904,C
5-NP,1371,910,0,0,0,910,A
5-NP,1372,1,909,0,0,910,T
5-NP,1373,0,894,0,0,894,T
5-NP,1374,1,0,0,910,911,C
5-NP,1375,3,1,0,882,886,C
5-NP,1376,1,3,882,1,887,G
5-NP,1377,2,2,882,1,887,G
5-NP,1378,0,2,883,1,886,G
5-NP,1379,0,2,883,0,885,G
5-NP,1380,0,3,888,0,891,G
5-NP,1381,854,0,2,0,856,A
5-NP,1382,0,1,853,0,854,G
5-NP,1383,0,3,846,0,849,G
5-NP,1384,0,4,845,0,849,G
5-NP,1385,1,1,849,0,851,G
5-NP,1386,847,0,0,0,847,A
5-NP,1387,1,2,845,0,848,G
5-NP,1388,0,837,1,0,838,T
5-NP,1389,0,834,0,0,834,T
5-NP,1390,0,838,0,0,838,T
5-NP,1391,0,835,0,0,835,T
5-NP,1392,1,2,0,832,835,C
5-NP,1393,0,2,832,0,834,G
5-NP,1394,830,0,0,0,830,A
5-NP,1395,0,1,836,0,837,G
5-NP,1396,0,0,0,828,828,C
5-NP,1397,0,819,0,2,821,T
5-NP,1398,3,0,0,831,834,C
5-NP,1399,0,826,0,2,828,T
5-NP,1400,1,0,0,831,832,C
5-NP,1401,833,0,1,0,834,A
5-NP,1402,0,1,836,0,837,G
5-NP,1403,833,0,2,0,835,A
5-NP,1404,1,1,0,828,830,C
5-NP,1405,1,2,825,0,828,G
5-NP,1406,808,0,0,0,808,A
5-NP,1407,0,3,806,0,809,G
5-NP,1408,802,0,1,0,803,A
5-NP,1409,799,0,1,0,800,A
5-NP,1410,0,3,800,0,803,G
5-NP,1411,0,0,794,0,794,G
5-NP,1412,1,1,1,781,784,C
5-NP,1413,788,1,1,0,790,A
5-NP,1414,791,0,0,0,791,A
5-NP,1415,0,0,0,789,789,C
5-NP,1416,0,1,784,0,785,G
5-NP,1417,784,0,1,0,785,A
5-NP,1418,778,0,3,0,781,A
5-NP,1419,0,1,0,781,782,C
5-NP,1420,6,0,0,769,775,C
5-NP,1421,6,1,0,760,767,C
5-NP,1422,0,2,760,0,762,G
5-NP,1423,769,0,1,0,770,A
5-NP,1424,0,764,0,0,764,T
5-NP,1425,2,0,0,755,757,C
5-NP,1426,1,0,755,0,756,G
5-NP,1427,0,741,0,0,741,T
5-NP,1428,0,0,743,0,743,G
5-NP,1429,0,0,0,735,735,C
5-NP,1430,1,0,0,734,735,C
5-NP,1431,0,0,0,739,739,C
5-NP,1432,0,727,0,0,727,T
5-NP,1433,2,0,0,748,750,C
5-NP,1434,0,742,0,1,743,T
5-NP,1435,0,739,2,1,742,T
5-NP,1436,0,745,0,0,745,T
5-NP,1437,0,736,0,0,736,T
5-NP,1438,2,1,736,0,739,G
5-NP,1439,740,0,0,0,740,A
5-NP,1440,0,733,0,0,733,T
5-NP,1441,721,0,0,0,721,A
5-NP,1442,0,598,0,0,598,T
5-NP,1443,0,2,605,0,607,G
5-NP,1444,596,0,1,0,597,A
5-NP,1445,1,0,602,0,603,G
5-NP,1446,0,603,0,1,604,T
5-NP,1447,590,0,0,0,590,A
5-NP,1448,591,0,0,0,591,A
5-NP,1449,0,586,0,1,587,T
5-NP,1450,0,0,585,0,585,G
5-NP,1451,582,0,0,0,582,A
5-NP,1452,515,0,1,0,516,A
5-NP,1453,0,1,515,0,516,G
5-NP,1454,1,4,475,1,481,G
5-NP,1455,476,0,1,0,477,A
5-NP,1456,0,473,0,0,473,T
5-NP,1457,0,0,0,474,474,C
5-NP,1458,0,465,0,1,466,T
5-NP,1459,0,463,0,0,463,T
5-NP,1460,463,0,0,0,463,A
5-NP,1461,0,464,0,0,464,T
5-NP,1462,0,459,0,0,459,T
5-NP,1463,0,456,0,0,456,T
5-NP,1464,0,0,1,441,442,C
5-NP,1465,0,426,0,0,426,T
5-NP,1466,2,424,0,0,426,T
5-NP,1467,3,0,0,423,426,C
5-NP,1468,0,1,422,0,423,G
5-NP,1469,0,1,422,0,423,G
5-NP,1470,423,0,0,0,423,A
5-NP,1471,0,3,418,0,421,G
5-NP,1472,419,0,0,0,419,A
5-NP,1473,0,0,0,413,413,C
5-NP,1474,390,0,0,0,390,A
5-NP,1475,389,0,0,0,389,A
5-NP,1476,0,386,0,1,387,T
5-NP,1477,0,0,387,0,387,G
5-NP,1478,0,0,0,384,384,C
5-NP,1479,375,0,0,0,375,A
5-NP,1480,0,0,375,0,375,G
5-NP,1481,372,0,0,0,372,A
5-NP,1482,348,0,0,0,348,A
5-NP,1483,0,1,346,0,347,G
5-NP,1484,215,0,0,0,215,A
5-NP,1485,0,0,215,0,215,G
5-NP,1486,0,195,0,0,195,T
5-NP,1487,195,0,0,0,195,A
5-NP,1488,0,0,0,195,195,C
5-NP,1489,0,1,180,0,181,G
5-NP,1490,177,0,0,0,177,A
5-NP,1491,0,0,0,173,173,C
5-NP,1492,127,0,0,0,127,A
5-NP,1493,127,0,0,0,127,A
5-NP,1494,0,108,0,0,108,T
5-NP,1495,0,104,0,0,104,T
5-NP,1496,103,0,0,0,103,A
5-NP,1497,101,0,0,0,101,A
6-NA,1,32,0,0,0,32,A
6-NA,2,0,32,0,0,32,T
6-NA,3,0,0,32,0,32,G
6-NA,4,31,0,1,0,32,A
6-NA,5,32,0,0,0,32,A
6-NA,6,0,32,0,0,32,T
6-NA,7,1,0,0,31,32,C
6-NA,8,0,0,0,32,32,C
6-NA,9,32,0,0,0,32,A
6-NA,10,35,0,0,0,35,A
6-NA,11,35,0,0,0,35,A
6-NA,12,0,34,0,0,34,T
6-NA,13,0,0,0,35,35,C
6-NA,14,35,0,0,0,35,A
6-NA,15,35,0,0,0,35,A
6-NA,16,35,0,0,0,35,A
6-NA,17,37,0,0,0,37,A
6-NA,18,0,0,41,0,41,G
6-NA,19,43,0,0,0,43,A
6-NA,20,0,44,0,0,44,T
6-NA,21,44,0,0,0,44,A
6-NA,22,44,0,0,0,44,A
6-NA,23,0,44,0,0,44,T
6-NA,24,46,0,0,0,46,A
6-NA,25,46,0,0,0,46,A
6-NA,26,1,0,0,46,47,C
6-NA,27,0,0,47,0,47,G
6-NA,28,46,0,0,0,46,A
6-NA,29,0,47,0,0,47,T
6-NA,30,0,47,0,0,47,T
6-NA,31,0,1,46,0,47,G
6-NA,32,0,0,53,0,53,G
6-NA,33,0,0,0,53,53,C
6-NA,34,0,53,0,0,53,T
6-NA,35,0,0,0,56,56,C
6-NA,36,1,55,0,0,56,T
6-NA,37,0,0,57,0,57,G
6-NA,38,0,58,0,0,58,T
6-NA,39,0,57,0,0,57,T
6-NA,40,0,59,0,0,59,T
6-NA,41,0,0,0,60,60,C
6-NA,42,0,61,0,0,61,T
6-NA,43,0,0,0,61,61,C
6-NA,44,0,61,0,0,61,T
6-NA,45,0,0,0,64,64,C
6-NA,46,64,0,0,0,64,A
6-NA,47,0,0,0,69,69,C
6-NA,48,0,0,0,69,69,C
6-NA,49,69,0,0,0,69,A
6-NA,50,0,70,0,0,70,T
6-NA,51,0,73,0,0,73,T
6-NA,52,0,73,0,0,73,T
6-NA,53,0,0,0,76,76,C
6-NA,54,0,1,0,75,76,C
6-NA,55,77,0,0,0,77,A
6-NA,56,0,0,0,83,83,C
6-NA,57,83,0,0,0,83,A
6-NA,58,91,0,0,0,91,A
6-NA,59,0,91,0,0,91,T
6-NA,60,95,0,0,0,95,A
6-NA,61,0,95,0,0,95,T
6-NA,62,0,0,96,0,96,G
6-NA,63,0,0,0,97,97,C
6-NA,64,0,96,0,1,97,T
6-NA,65,0,99,0,0,99,T
6-NA,66,0,0,0,99,99,C
6-NA,67,0,99,0,0,99,T
6-NA,68,0,98,0,0,98,T
6-NA,69,0,0,0,98,98,C
6-NA,70,97,0,1,0,98,A
6-NA,71,0,98,0,0,98,T
6-NA,72,0,0,97,0,97,G
6-NA,73,0,0,0,98,98,C
6-NA,74,98,0,0,0,98,A
6-NA,75,98,0,0,0,98,A
6-NA,76,98,0,0,0,98,A
6-NA,77,0,100,0,0,100,T
6-NA,78,0,100,0,0,100,T
6-NA,79,0,0,100,0,100,G
6-NA,80,0,0,0,99,99,C
6-NA,81,0,0,0,100,100,C
6-NA,82,100,0,0,0,100,A
6-NA,83,0,101,0,0,101,T
6-NA,84,0,0,0,111,111,C
6-NA,85,1,110,0,0,111,T
6-NA,86,0,111,0,0,111,T
6-NA,87,0,0,112,0,112,G
6-NA,88,113,0,0,0,113,A
6-NA,89,0,114,0,0,114,T
6-NA,90,115,0,0,0,115,A
6-NA,91,117,0,0,0,117,A
6-NA,92,0,0,0,129,129,C
6-NA,93,0,128,0,0,128,T
6-NA,94,130,0,0,0,130,A
6-NA,95,0,0,0,135,135,C
6-NA,96,0,134,0,0,134,T
6-NA,97,0,0,135,0,135,G
6-NA,98,0,135,0,0,135,T
6-NA,99,133,0,0,0,133,A
6-NA,100,134,0,0,0,134,A
6-NA,101,0,0,0,130,130,C
6-NA,102,133,0,0,0,133,A
6-NA,103,0,134,0,0,134,T
6-NA,104,0,134,0,0,134,T
6-NA,105,0,0,134,0,134,G
6-NA,106,0,0,0,135,135,C
6-NA,107,136,0,1,0,137,A
6-NA,108,0,138,0,0,138,T
6-NA,109,0,138,0,0,138,T
6-NA,110,0,138,0,0,138,T
6-NA,111,1,0,0,135,136,C
6-NA,112,137,0,0,0,137,A
6-NA,113,136,0,1,0,137,A
6-NA,114,0,0,135,0,135,G
6-NA,115,0,0,0,137,137,C
6-NA,116,138,0,0,0,138,A
6-NA,117,141,0,0,0,141,A
6-NA,118,0,140,0,0,140,T
6-NA,119,142,0,0,0,142,A
6-NA,120,0,142,0,0,142,T
6-NA,121,0,0,147,0,147,G
6-NA,122,148,0,0,0,148,A
6-NA,123,149,0,0,0,149,A
6-NA,124,0,150,0,0,150,T
6-NA,125,0,149,0,0,149,T
6-NA,126,0,0,0,151,151,C
6-NA,127,150,0,0,0,150,A
6-NA,128,152,0,0,0,152,A
6-NA,129,0,0,0,152,152,C
6-NA,130,0,151,0,0,151,T
6-NA,131,0,0,0,155,155,C
6-NA,132,0,1,0,154,155,C
6-NA,133,0,0,0,155,155,C
6-NA,134,0,0,0,156,156,C
6-NA,135,4,0,0,150,154,C
6-NA,136,1,0,0,160,161,C
6-NA,137,3,0,0,158,161,C
6-NA,138,160,0,0,0,160,A
6-NA,139,159,0,0,0,159,A
6-NA,140,159,0,0,1,160,A
6-NA,141,0,0,0,167,167,C
6-NA,142,166,0,0,0,166,A
6-NA,143,166,0,0,0,166,A
6-NA,144,0,0,0,167,167,C
6-NA,145,1,0,0,165,166,C
6-NA,146,168,0,0,0,168,A
6-NA,147,168,0,1,0,169,A
6-NA,148,0,0,174,0,174,G
6-NA,149,0,174,0,0,174,T
6-NA,150,0,0,170,0,170,G
6-NA,151,171,0,0,0,171,A
6-NA,152,0,170,0,0,170,T
6-NA,153,0,0,170,0,170,G
6-NA,154,0,0,0,171,171,C
6-NA,155,0,169,0,0,169,T
6-NA,156,0,0,184,0,184,G
6-NA,157,0,182,0,0,182,T
6-NA,158,0,0,185,0,185,G
6-NA,159,0,185,0,0,185,T
6-NA,160,0,1,181,0,182,G
6-NA,161,184,0,0,0,184,A
6-NA,162,183,0,0,0,183,A
6-NA,163,0,0,0,186,186,C
6-NA,164,0,0,0,185,185,C
6-NA,165,182,0,0,0,182,A
6-NA,166,184,0,0,0,184,A
6-NA,167,0,0,0,188,188,C
6-NA,168,188,0,0,0,188,A
6-NA,169,191,0,0,0,191,A
6-NA,170,0,191,0,0,191,T
6-NA,171,192,0,0,0,192,A
6-NA,172,193,0,0,0,193,A
6-NA,173,0,192,0,1,193,T
6-NA,174,192,1,0,0,193,A
6-NA,175,0,0,194,0,194,G
6-NA,176,188,0,0,0,188,A
6-NA,177,188,0,1,0,189,A
6-NA,178,189,0,0,0,189,A
6-NA,179,0,3,188,0,191,G
6-NA,180,195,0,1,0,196,A
6-NA,181,196,0,0,0,196,A
6-NA,182,204,0,0,0,204,A
6-NA,183,2,0,0,203,205,C
6-NA,184,208,0,0,1,209,A
6-NA,185,0,213,0,0,213,T
6-NA,186,213,0,0,0,213,A
6-NA,187,217,0,0,0,217,A
6-NA,188,0,0,0,221,221,C
6-NA,189,217,0,0,0,217,A
6-NA,190,0,0,228,0,228,G
6-NA,191,226,0,0,1,227,A
6-NA,192,0,0,225,0,225,G
6-NA,193,227,0,0,0,227,A
6-NA,194,0,243,0,0,243,T
6-NA,195,242,0,0,0,242,A
6-NA,196,0,0,249,0,249,G
6-NA,197,0,245,0,2,247,T
6-NA,198,0,0,251,0,251,G
6-NA,199,0,251,0,0,251,T
6-NA,200,252,0,0,0,252,A
6-NA,201,0,251,0,0,251,T
6-NA,202,0,0,0,253,253,C
6-NA,203,0,247,0,0,247,T
6-NA,204,0,1,253,0,254,G
6-NA,205,255,0,0,0,255,A
6-NA,206,1,0,0,254,255,C
6-NA,207,2,1,0,250,253,C
6-NA,208,250,0,0,0,250,A
6-NA,209,252,0,0,0,252,A
6-NA,210,1,0,0,255,256,C
6-NA,211,255,0,0,0,255,A
6-NA,212,1,0,0,267,268,C
6-NA,213,4,0,0,257,261,C
6-NA,214,271,0,0,0,271,A
6-NA,215,0,0,0,278,278,C
6-NA,216,2,0,0,276,278,C
6-NA,217,281,0,0,0,281,A
6-NA,218,0,280,1,0,281,T
6-NA,219,280,0,0,0,280,A
6-NA,220,0,1,277,0,278,G
6-NA,221,273,0,0,0,273,A
6-NA,222,0,0,279,1,280,G
6-NA,223,273,0,0,0,273,A
6-NA,224,268,0,0,0,268,A
6-NA,225,0,1,270,0,271,G
6-NA,226,0,0,271,0,271,G
6-NA,227,274,0,0,0,274,A
6-NA,228,275,0,0,0,275,A
6-NA,229,276,0,0,0,276,A
6-NA,230,0,276,0,0,276,T
6-NA,231,271,0,0,0,271,A
6-NA,232,0,272,0,0,272,T
6-NA,233,0,1,268,0,269,G
6-NA,234,1,0,0,273,274,C
6-NA,235,0,0,0,272,272,C
6-NA,236,0,1,0,269,270,C
6-NA,237,0,0,0,273,273,C
6-NA,238,273,0,0,0,273,A
6-NA,239,272,0,0,0,272,A
6-NA,240,274,0,0,0,274,A
6-NA,241,0,273,0,0,273,T
6-NA,242,0,285,0,0,285,T
6-NA,243,285,0,0,0,285,A
6-NA,244,0,0,285,0,285,G
6-NA,245,0,0,0,285,285,C
6-NA,246,284,1,0,0,285,A
6-NA,247,0,0,298,0,298,G
6-NA,248,297,0,0,0,297,A
6-NA,249,303,0,0,0,303,A
6-NA,250,0,303,0,0,303,T
6-NA,251,303,0,0,0,303,A
6-NA,252,0,1,0,303,304,C
6-NA,253,302,0,0,0,302,A
6-NA,254,0,1,299,0,300,G
6-NA,255,301,0,1,0,302,A
6-NA,256,297,0,0,0,297,A
6-NA,257,299,0,0,0,299,A
6-NA,258,1,291,0,0,292,T
6-NA,259,0,292,0,0,292,T
6-NA,260,0,1,297,0,298,G
6-NA,261,0,0,299,0,299,G
6-NA,262,0,298,0,0,298,T
6-NA,263,1,0,0,297,298,C
6-NA,264,299,0,0,0,299,A
6-NA,265,301,0,0,0,301,A
6-NA,266,300,0,0,0,300,A
6-NA,267,0,1,298,0,299,G
6-NA,268,0,0,0,300,300,C
6-NA,269,0,0,0,301,301,C
6-NA,270,0,0,299,0,299,G
6-NA,271,0,0,0,300,300,C
6-NA,272,302,0,0,0,302,A
6-NA,273,304,0,0,0,304,A
6-NA,274,0,304,0,0,304,T
6-NA,275,0,0,304,0,304,G
6-NA,276,0,8,0,292,300,C
6-NA,277,0,0,303,0,303,G
6-NA,278,308,0,0,0,308,A
6-NA,279,0,0,0,310,310,C
6-NA,280,313,0,0,0,313,A
6-NA,281,0,325,0,0,325,T
6-NA,282,0,326,0,0,326,T
6-NA,283,324,0,0,0,324,A
6-NA,284,0,0,0,324,324,C
6-NA,285,318,0,0,0,318,A
6-NA,286,0,2,321,0,323,G
6-NA,287,0,1,322,0,323,G
6-NA,288,323,0,0,0,323,A
6-NA,289,0,319,0,0,319,T
6-NA,290,0,318,0,0,318,T
6-NA,291,0,317,0,0,317,T
6-NA,292,0,0,320,0,320,G
6-NA,293,1,0,0,318,319,C
6-NA,294,319,1,0,0,320,A
6-NA,295,0,1,0,314,315,C
6-NA,296,3,0,0,314,317,C
6-NA,297,0,315,0,0,315,T
6-NA,298,0,314,0,0,314,T
6-NA,299,0,313,0,1,314,T
6-NA,300,0,314,0,0,314,T
6-NA,301,0,323,0,0,323,T
6-NA,302,0,0,0,323,323,C
6-NA,303,0,325,0,0,325,T
6-NA,304,320,0,2,0,322,A
6-NA,305,320,1,0,0,321,A
6-NA,306,0,2,320,0,322,G
6-NA,307,0,2,319,0,321,G
6-NA,308,319,0,2,0,321,A
6-NA,309,0,0,0,322,322,C
6-NA,310,315,0,1,0,316,A
6-NA,311,319,0,0,0,319,A
6-NA,312,0,318,0,0,318,T
6-NA,313,0,320,0,0,320,T
6-NA,314,1,0,0,323,324,C
6-NA,315,0,0,323,0,323,G
6-NA,316,322,0,0,0,322,A
6-NA,317,0,323,0,0,323,T
6-NA,318,0,319,0,0,319,T
6-NA,319,320,0,0,0,320,A
6-NA,320,1,1,318,0,320,G
6-NA,321,0,0,320,0,320,G
6-NA,322,0,0,0,321,321,C
6-NA,323,0,317,1,0,318,T
6-NA,324,0,321,0,1,322,T
6-NA,325,0,319,0,0,319,T
6-NA,326,0,0,0,321,321,C
6-NA,327,0,0,0,321,321,C
6-NA,328,0,0,324,0,324,G
6-NA,329,0,0,0,325,325,C
6-NA,330,0,320,0,1,321,T
6-NA,331,0,2,336,1,339,G
6-NA,332,1,0,338,0,339,G
6-NA,333,0,341,0,0,341,T
6-NA,334,0,2,340,0,342,G
6-NA,335,0,4,338,0,342,G
6-NA,336,0,1,341,1,343,G
6-NA,337,0,3,340,0,343,G
6-NA,338,336,0,1,0,337,A
6-NA,339,0,0,0,347,347,C
6-NA,340,342,0,0,0,342,A
6-NA,341,0,335,0,1,336,T
6-NA,342,0,0,0,341,341,C
6-NA,343,0,339,1,0,340,T
6-NA,344,0,0,344,0,344,G
6-NA,345,0,4,338,0,342,G
6-NA,346,0,0,343,0,343,G
6-NA,347,0,341,0,0,341,T
6-NA,348,0,1,331,0,332,G
6-NA,349,331,0,1,0,332,A
6-NA,350,0,0,0,337,337,C
6-NA,351,332,0,0,0,332,A
6-NA,352,354,0,0,0,354,A
6-NA,353,0,0,355,0,355,G
6-NA,354,350,0,0,0,350,A
6-NA,355,1,1,368,0,370,G
6-NA,356,373,0,0,0,373,A
6-NA,357,411,1,0,0,412,A
6-NA,358,0,0,0,494,494,C
6-NA,359,1,0,0,529,530,C
6-NA,360,0,527,0,0,527,T
6-NA,361,0,531,0,0,531,T
6-NA,362,533,0,0,0,533,A
6-NA,363,0,530,0,0,530,T
6-NA,364,0,0,555,0,555,G
6-NA,365,0,558,0,0,558,T
6-NA,366,1,0,572,0,573,G
6-NA,367,0,565,0,1,566,T
6-NA,368,2,0,0,557,559,C
6-NA,369,561,0,0,6,567,A
6-NA,370,0,567,0,0,567,T
6-NA,371,0,0,566,0,566,G
6-NA,372,0,0,0,566,566,C
6-NA,373,0,3,563,0,566,G
6-NA,374,650,0,0,0,650,A
6-NA,375,0,648,0,0,648,T
6-NA,376,1,0,0,665,666,C
6-NA,377,3,0,0,660,663,C
6-NA,378,0,675,0,3,678,T
6-NA,379,0,3,687,0,690,G
6-NA,380,687,0,1,0,688,A
6-NA,381,1,1,0,689,691,C
6-NA,382,693,0,1,0,694,A
6-NA,383,686,0,0,0,686,A
6-NA,384,0,0,725,0,725,G
6-NA,385,0,720,0,0,720,T
6-NA,386,0,0,733,0,733,G
6-NA,387,0,730,0,0,730,T
6-NA,388,0,730,0,0,730,T
6-NA,389,732,0,1,0,733,A
6-NA,390,0,730,0,2,732,T
6-NA,391,0,0,0,739,739,C
6-NA,392,740,0,0,0,740,A
6-NA,393,734,4,0,1,739,A
6-NA,394,0,727,0,1,728,T
6-NA,395,0,729,0,0,729,T
6-NA,396,0,730,0,0,730,T
6-NA,397,0,0,733,0,733,G
6-NA,398,0,0,0,779,779,C
6-NA,399,1,0,0,785,786,C
6-NA,400,3,0,0,780,783,C
6-NA,401,0,784,0,0,784,T
6-NA,402,0,790,0,0,790,T
6-NA,403,0,4,810,0,814,G
6-NA,404,0,5,813,0,818,G
6-NA,405,823,0,1,0,824,A
6-NA,406,0,0,0,824,824,C
6-NA,407,812,0,1,0,813,A
6-NA,408,0,0,834,0,834,G
6-NA,409,0,2,829,0,831,G
6-NA,410,2,2,868,0,872,G
6-NA,411,875,0,0,0,875,A
6-NA,412,872,0,0,0,872,A
6-NA,413,1,0,0,871,872,C
6-NA,414,865,0,1,0,866,A
6-NA,415,969,0,1,0,970,A
6-NA,416,0,0,0,977,977,C
6-NA,417,975,0,1,0,976,A
6-NA,418,1,0,0,988,989,C
6-NA,419,0,982,0,0,982,T
6-NA,420,995,0,0,0,995,A
6-NA,421,995,1,0,0,996,A
6-NA,422,998,1,0,0,999,A
6-NA,423,0,1,0,995,996,C
6-NA,424,955,0,1,0,956,A
6-NA,425,956,2,0,0,958,A
6-NA,426,0,0,0,962,962,C
6-NA,427,1,0,962,0,963,G
6-NA,428,0,964,0,0,964,T
6-NA,429,0,1,962,1,964,G
6-NA,430,0,1,0,964,965,C
6-NA,431,970,0,0,0,970,A
6-NA,432,0,968,0,0,968,T
6-NA,433,0,972,0,1,973,T
6-NA,434,3,1,0,980,984,C
6-NA,435,1004,0,0,0,1004,A
6-NA,436,1010,0,0,0,1010,A
6-NA,437,1009,0,0,0,1009,A
6-NA,438,0,1014,0,0,1014,T
6-NA,439,0,3,1009,1,1013,G
6-NA,440,1035,1,0,0,1036,A
6-NA,441,1,0,0,1036,1037,C
6-NA,442,1039,2,1,1,1043,A
6-NA,443,3,0,0,1054,1057,C
6-NA,444,1038,0,0,0,1038,A
6-NA,445,0,0,1286,0,1286,G
6-NA,446,1,1287,0,1,1289,T
6-NA,447,1306,0,2,0,1308,A
6-NA,448,1,2,1,1306,1310,C
6-NA,449,1,2,1300,0,1303,G
6-NA,450,1,1351,0,1,1353,T
6-NA,451,0,3,1353,0,1356,G
6-NA,452,1364,0,0,0,1364,A
6-NA,453,0,1370,0,0,1370,T
6-NA,454,1249,2,0,0,1251,A
6-NA,455,1,3,1244,0,1248,G
6-NA,456,0,5,1241,0,1246,G
6-NA,457,1251,0,3,0,1254,A
6-NA,458,1,0,0,1265,1266,C
6-NA,459,6,2,0,1251,1259,C
6-NA,460,4,0,0,1260,1264,C
6-NA,461,6,1,0,1265,1272,C
6-NA,462,0,1289,0,1,1290,T
6-NA,463,0,1318,0,0,1318,T
6-NA,464,1324,1,0,2,1327,A
6-NA,465,1,1326,0,0,1327,T
6-NA,466,2,0,0,1321,1323,C
6-NA,467,0,0,1316,0,1316,G
6-NA,468,0,8,1310,0,1318,G
6-NA,469,1317,0,0,0,1317,A
6-NA,470,2,0,0,1324,1326,C
6-NA,471,5,0,0,1320,1325,C
6-NA,472,1,0,0,1401,1402,C
6-NA,473,0,1400,0,3,1403,T
6-NA,474,1431,0,0,0,1431,A
6-NA,475,0,1430,0,0,1430,T
6-NA,476,0,1435,0,0,1435,T
6-NA,477,0,5,1429,0,1434,G
6-NA,478,1434,0,0,0,1434,A
6-NA,479,1,1432,0,1,1434,T
6-NA,480,0,6,1429,2,1437,G
6-NA,481,1397,0,0,0,1397,A
6-NA,482,1390,0,3,0,1393,A
6-NA,483,0,1408,0,0,1408,T
6-NA,484,0,5,1422,0,1427,G
6-NA,485,1455,0,1,0,1456,A
6-NA,486,2,1,1466,0,1469,G
6-NA,487,0,1464,0,1,1465,T
6-NA,488,0,1469,0,1,1470,T
6-NA,489,1476,3,0,0,1479,A
6-NA,490,0,5,1479,0,1484,G
6-NA,491,0,4,1483,0,1487,G
6-NA,492,0,1483,0,3,1486,T
6-NA,493,0,1,1483,0,1484,G
6-NA,494,0,1465,0,3,1468,T
6-NA,495,0,1459,1,4,1464,T
6-NA,496,4,0,1,1473,1478,C
6-NA,497,6,0,0,1475,1481,C
6-NA,498,0,1475,0,1,1476,T
6-NA,499,0,1474,0,0,1474,T
6-NA,500,0,1469,0,1,1470,T
6-NA,501,0,1468,0,3,1471,T
6-NA,502,6,0,0,1464,1470,C
6-NA,503,1464,0,1,0,1465,A
6-NA,504,0,1500,1,0,1501,T
6-NA,505,1,0,0,1495,1496,C
6-NA,506,0,1489,0,0,1489,T
6-NA,507,0,10,1474,0,1484,G
6-NA,508,3,9,1458,0,1470,G
6-NA,509,2,10,1463,0,1475,G
6-NA,510,0,5,1493,0,1498,G
6-NA,511,1494,0,2,0,1496,A
6-NA,512,0,0,0,1515,1515,C
6-NA,513,5,0,0,1488,1493,C
6-NA,514,1515,0,1,0,1516,A
6-NA,515,1515,0,1,0,1516,A
6-NA,516,0,1,1514,0,1515,G
6-NA,517,1,0,0,1517,1518,C
6-NA,518,1507,2,1,0,1510,A
6-NA,519,1526,0,1,0,1527,A
6-NA,520,0,0,1540,0,1540,G
6-NA,521,0,1530,1,0,1531,T
6-NA,522,0,0,1565,0,1565,G
6-NA,523,1,1547,0,1,1549,T
6-NA,524,1,2,1588,0,1591,G
6-NA,525,2,3,0,1583,1588,C
6-NA,526,1593,1,0,0,1594,A
6-NA,527,2,1605,0,0,1607,T
6-NA,528,1586,0,0,0,1586,A
6-NA,529,0,0,1631,0,1631,G
6-NA,530,1,1,0,1620,1622,C
6-NA,531,1584,0,0,0,1584,A
6-NA,532,0,1588,0,1,1589,T
6-NA,533,0,7,1554,0,1561,G
6-NA,534,2,0,1680,0,1682,G
6-NA,535,0,1692,0,2,1694,T
6-NA,536,2,2,0,1680,1684,C
6-NA,537,1,0,1,1694,1696,C
6-NA,538,1695,0,2,0,1697,A
6-NA,539,0,0,1763,1,1764,G
6-NA,540,0,1,0,1773,1774,C
6-NA,541,0,1770,0,2,1772,T
6-NA,542,4,0,0,1768,1772,C
6-NA,543,1738,0,1,0,1739,A
6-NA,544,1768,0,0,0,1768,A
6-NA,545,0,2,1774,0,1776,G
6-NA,546,0,1781,0,1,1782,T
6-NA,547,0,1779,0,0,1779,T
6-NA,548,1,1,1780,0,1782,G
6-NA,549,0,1781,0,2,1783,T
6-NA,550,8,0,0,1769,1777,C
6-NA,551,1781,0,1,0,1782,A
6-NA,552,0,0,0,1799,1799,C
6-NA,553,0,8,1790,2,1800,G
6-NA,554,1852,1,0,0,1853,A
6-NA,555,0,1862,0,1,1863,T
6-NA,556,1,3,1874,0,1878,G
6-NA,557,0,3,1897,1,1901,G
6-NA,558,1896,0,5,0,1901,A
6-NA,559,1904,1,1,0,1906,A
6-NA,560,1933,0,0,0,1933,A
6-NA,561,1931,0,3,0,1934,A
6-NA,562,0,2,1967,0,1969,G
6-NA,563,1,0,0,1950,1951,C
6-NA,564,1958,2,2,0,1962,A
6-NA,565,0,1963,0,2,1965,T
6-NA,566,0,8,1974,0,1982,G
6-NA,567,0,2,2003,0,2005,G
6-NA,568,1,0,0,2019,2020,C
6-NA,569,0,2009,0,0,2009,T
6-NA,570,2,2,2020,2,2026,G
6-NA,571,2,1,1,2009,2013,C
6-NA,572,2024,0,2,0,2026,A
6-NA,573,0,2118,0,1,2119,T
6-NA,574,0,2,2125,0,2127,G
6-NA,575,0,2168,0,0,2168,T
6-NA,576,0,2224,0,0,2224,T
6-NA,577,0,2222,0,3,2225,T
6-NA,578,2,1,2378,0,2381,G
6-NA,579,0,2376,0,0,2376,T
6-NA,580,2384,0,0,0,2384,A
6-NA,581,0,2389,0,0,2389,T
6-NA,582,2358,0,0,0,2358,A
6-NA,583,2373,0,0,1,2374,A
6-NA,584,2,2,1,2349,2354,C
6-NA,585,2,15,2325,1,2343,G
6-NA,586,0,7,2334,0,2341,G
6-NA,587,0,12,2289,0,2301,G
6-NA,588,0,9,2310,0,2319,G
6-NA,589,0,8,2320,0,2328,G
6-NA,590,2319,0,2,0,2321,A
6-NA,591,0,2322,1,0,2323,T
6-NA,592,2,8,2323,0,2333,G
6-NA,593,2352,0,2,0,2354,A
6-NA,594,0,2365,1,0,2366,T
6-NA,595,2361,0,0,0,2361,A
6-NA,596,2401,0,2,0,2403,A
6-NA,597,2422,1,0,1,2424,A
6-NA,598,2426,0,0,0,2426,A
6-NA,599,2434,0,0,0,2434,A
6-NA,600,0,2443,0,0,2443,T
6-NA,601,0,4,2440,0,2444,G
6-NA,602,3,1,0,2437,2441,C
6-NA,603,2430,0,1,1,2432,A
6-NA,604,2449,1,0,1,2451,A
6-NA,605,2,1,0,2467,2470,C
6-NA,606,1,2467,1,1,2470,T
6-NA,607,4,2,2486,1,2493,G
6-NA,608,1,0,0,2482,2483,C
6-NA,609,0,2489,0,0,2489,T
6-NA,610,2495,0,2,0,2497,A
6-NA,611,0,1,2503,0,2504,G
6-NA,612,2,0,0,2523,2525,C
6-NA,613,2,2534,0,2,2538,T
6-NA,614,0,2533,0,2,2535,T
6-NA,615,7,1,0,2561,2569,C
6-NA,616,2586,0,2,0,2588,A
6-NA,617,1,2597,0,2,2600,T
6-NA,618,0,2597,0,1,2598,T
6-NA,619,0,2611,0,0,2611,T
6-NA,620,2636,2,1,0,2639,A
6-NA,621,3,3,0,2660,2666,C
6-NA,622,2657,0,1,1,2659,A
6-NA,623,2689,0,1,0,2690,A
6-NA,624,0,2686,0,0,2686,T
6-NA,625,3,13,2668,0,2684,G
6-NA,626,1,6,2676,0,2683,G
6-NA,627,1,10,2666,0,2677,G
6-NA,628,2664,1,4,0,2669,A
6-NA,629,5,10,2733,0,2748,G
6-NA,630,1,2,2786,0,2789,G
6-NA,631,3,0,0,3027,3030,C
6-NA,632,2,3024,0,5,3031,T
6-NA,633,0,3061,0,1,3062,T
6-NA,634,4,3,3093,0,3100,G
6-NA,635,8,3097,0,0,3105,T
6-NA,636,3171,1,0,0,3172,A
6-NA,637,1,7,3171,0,3179,G
6-NA,638,3133,2,4,0,3139,A
6-NA,639,2,3152,0,0,3154,T
6-NA,640,2977,1,1,0,2979,A
6-NA,641,1,5,2980,0,2986,G
6-NA,642,0,2977,0,1,2978,T
6-NA,643,2,3,2915,0,2920,G
6-NA,644,0,3066,1,0,3067,T
6-NA,645,1,3068,0,0,3069,T
6-NA,646,0,3,3111,0,3114,G
6-NA,647,0,3095,0,4,3099,T
6-NA,648,0,3102,1,0,3103,T
6-NA,649,0,3107,1,0,3108,T
6-NA,650,6,1,0,3072,3079,C
6-NA,651,3071,0,1,0,3072,A
6-NA,652,0,3066,0,1,3067,T
6-NA,653,1,16,3045,1,3063,G
6-NA,654,2,3,3223,0,3228,G
6-NA,655,0,3194,0,5,3199,T
6-NA,656,7,1,0,3195,3203,C
6-NA,657,10,1,0,3183,3194,C
6-NA,658,3213,1,2,0,3216,A
6-NA,659,3226,0,2,0,3228,A
6-NA,660,3224,1,6,0,3231,A
6-NA,661,0,5,3248,0,3253,G
6-NA,662,3245,1,1,0,3247,A
6-NA,663,3175,0,1,0,3176,A
6-NA,664,3184,1,2,0,3187,A
6-NA,665,1,3177,0,0,3178,T
6-NA,666,6,6,0,3282,3294,C
6-NA,667,8,1,0,3272,3281,C
6-NA,668,0,3274,0,2,3276,T
6-NA,669,4,0,1,3276,3281,C
6-NA,670,3276,1,2,0,3279,A
6-NA,671,0,9,3311,0,3320,G
6-NA,672,0,11,3307,0,3318,G
6-NA,673,3396,0,3,0,3399,A
6-NA,674,4,0,0,3399,3403,C
6-NA,675,11,1,1,3336,3349,C
6-NA,676,12,1,1,3341,3355,C
6-NA,677,3363,1,1,0,3365,A
6-NA,678,1,15,3356,0,3372,G
6-NA,679,0,10,3368,1,3379,G
6-NA,680,3354,0,1,0,3355,A
6-NA,681,0,0,3397,0,3397,G
6-NA,682,1,3336,0,1,3338,T
6-NA,683,12,5,0,3329,3346,C
6-NA,684,3341,0,0,1,3342,A
6-NA,685,0,7,3367,0,3374,G
6-NA,686,3366,0,1,1,3368,A
6-NA,687,3371,0,2,1,3374,A
6-NA,688,1,3345,0,0,3346,T
6-NA,689,1,1,3361,0,3363,G
6-NA,690,3,1,1,3361,3366,C
6-NA,691,4,6,3374,0,3384,G
6-NA,692,1,3373,1,2,3377,T
6-NA,693,0,3371,0,2,3373,T
6-NA,694,0,3353,0,1,3354,T
6-NA,695,0,5,3386,0,3391,G
6-NA,696,2,3391,0,3,3396,T
6-NA,697,3393,0,3,0,3396,A
6-NA,698,1,3383,0,0,3384,T
6-NA,699,11,0,1,3362,3374,C
6-NA,700,3372,0,3,0,3375,A
6-NA,701,3372,1,1,0,3374,A
6-NA,702,0,3381,0,0,3381,T
6-NA,703,1,20,3346,1,3368,G
6-NA,704,1,5,3377,0,3383,G
6-NA,705,3454,0,1,0,3455,A
6-NA,706,3460,0,1,0,3461,A
6-NA,707,3,0,0,3498,3501,C
6-NA,708,0,3498,0,3,3501,T
6-NA,709,0,3509,0,1,3510,T
6-NA,710,3,5,3630,0,3638,G
6-NA,711,3,3635,0,3,3641,T
6-NA,712,3632,0,6,0,3638,A
6-NA,713,1,3,0,3682,3686,C
6-NA,714,3585,0,3,1,3589,A
6-NA,715,0,3,3831,0,3834,G
6-NA,716,2,3818,0,0,3820,T
6-NA,717,3963,0,2,0,3965,A
6-NA,718,1,3,3989,0,3993,G
6-NA,719,0,3912,0,2,3914,T
6-NA,720,3907,0,3,0,3910,A
6-NA,721,3908,0,1,0,3909,A
6-NA,722,0,3909,0,0,3909,T
6-NA,723,1,23,3905,0,3929,G
6-NA,724,3825,1,4,0,3830,A
6-NA,725,1,0,0,3859,3860,C
6-NA,726,0,3757,0,1,3758,T
6-NA,727,1,7,3769,1,3778,G
6-NA,728,3763,1,3,1,3768,A
6-NA,729,0,3785,0,2,3787,T
6-NA,730,0,13,3767,0,3780,G
6-NA,731,1,12,3755,0,3768,G
6-NA,732,8,13,3756,0,3777,G
6-NA,733,3719,0,0,0,3719,A
6-NA,734,0,4,3724,1,3729,G
6-NA,735,1,3712,0,2,3715,T
6-NA,736,2,4,3730,0,3736,G
6-NA,737,1,1,0,3729,3731,C
6-NA,738,0,3721,0,1,3722,T
6-NA,739,0,3726,0,1,3727,T
6-NA,740,12,0,0,3701,3713,C
6-NA,741,5,12,3688,0,3705,G
6-NA,742,2,9,3736,0,3747,G
6-NA,743,3,9,3736,0,3748,G
6-NA,744,3751,2,1,0,3754,A
6-NA,745,3729,1,4,0,3734,A
6-NA,746,3706,1,1,0,3708,A
6-NA,747,3722,0,6,1,3729,A
6-NA,748,1,0,3755,0,3756,G
6-NA,749,1,1,1,3749,3752,C
6-NA,750,1,3715,0,0,3716,T
6-NA,751,0,10,3708,1,3719,G
6-NA,752,3718,1,2,0,3721,A
6-NA,753,1,3756,0,0,3757,T
6-NA,754,3779,0,1,1,3781,A
6-NA,755,2,0,0,3941,3943,C
6-NA,756,1,3917,0,1,3919,T
6-NA,757,3917,0,1,0,3918,A
6-NA,758,3934,0,1,0,3935,A
6-NA,759,3923,1,2,0,3926,A
6-NA,760,4017,0,2,1,4020,A
6-NA,761,1,4017,0,3,4021,T
6-NA,762,4005,0,1,0,4006,A
6-NA,763,6,1,1,4016,4024,C
6-NA,764,0,3887,0,1,3888,T
6-NA,765,3951,1,1,0,3953,A
6-NA,766,1,3929,0,1,3931,T
6-NA,767,0,4232,1,3,4236,T
6-NA,768,15,1,0,4266,4282,C
6-NA,769,4235,0,2,0,4237,A
6-NA,770,0,4220,0,0,4220,T
6-NA,771,2,4224,0,4,4230,T
6-NA,772,4172,2,2,0,4176,A
6-NA,773,4190,0,4,0,4194,A
6-NA,774,0,11,4201,0,4212,G
6-NA,775,1,13,4198,0,4212,G
6-NA,776,3979,0,1,1,3981,A
6-NA,777,1,14,4013,0,4028,G
6-NA,778,0,27,4008,0,4035,G
6-NA,779,0,11,4034,0,4045,G
6-NA,780,1,7,4038,0,4046,G
6-NA,781,4036,1,3,0,4040,A
6-NA,782,4047,1,3,0,4051,A
6-NA,783,4043,0,4,1,4048,A
6-NA,784,4029,0,1,0,4030,A
6-NA,785,1,4030,0,0,4031,T
6-NA,786,8,1,0,3998,4007,C
6-NA,787,3,0,4055,0,4058,G
6-NA,788,1,4043,0,1,4045,T
6-NA,789,2,4030,1,7,4040,T
6-NA,790,10,1,0,4034,4045,C
6-NA,791,4037,0,0,1,4038,A
6-NA,792,1,4331,0,0,4332,T
6-NA,793,4329,1,1,1,4332,A
6-NA,794,6,0,0,4362,4368,C
6-NA,795,0,4357,0,2,4359,T
6-NA,796,4354,0,2,4,4360,A
6-NA,797,1,2,4355,1,4359,G
6-NA,798,0,3,1,4349,4353,C
6-NA,799,4363,0,0,0,4363,A
6-NA,800,1,0,0,4365,4366,C
6-NA,801,4205,0,1,0,4206,A
6-NA,802,1,4266,0,1,4268,T
6-NA,803,1,4236,1,1,4239,T
6-NA,804,2,2,4544,0,4548,G
6-NA,805,2,4526,0,3,4531,T
6-NA,806,21,4,1,4504,4530,C
6-NA,807,4513,3,11,1,4528,A
6-NA,808,1,9,4526,1,4537,G
6-NA,809,0,11,4530,0,4541,G
6-NA,810,4519,1,4,1,4525,A
6-NA,811,4459,0,5,1,4465,A
6-NA,812,2,2,4532,0,4536,G
6-NA,813,0,4311,0,2,4313,T
6-NA,814,1,4,4341,1,4347,G
6-NA,815,3,0,0,4342,4345,C
6-NA,816,0,4341,0,3,4344,T
6-NA,817,11,1,0,4339,4351,C
6-NA,818,4329,1,0,1,4331,A
6-NA,819,0,2,4367,0,4369,G
6-NA,820,3,1,3,4358,4365,C
6-NA,821,4357,0,3,2,4362,A
6-NA,822,1,4367,0,0,4368,T
6-NA,823,4,4,4491,1,4500,G
6-NA,824,0,4506,1,0,4507,T
6-NA,825,15,6,0,4482,4503,C
6-NA,826,2,10,4498,0,4510,G
6-NA,827,4499,0,1,0,4500,A
6-NA,828,1,15,4477,2,4495,G
6-NA,829,0,19,4479,0,4498,G
6-NA,830,4459,0,3,1,4463,A
6-NA,831,1,1,4537,0,4539,G
6-NA,832,2,4414,0,3,4419,T
6-NA,833,1,4,4438,0,4443,G
6-NA,834,2,0,0,4522,4524,C
6-NA,835,2,4516,0,6,4524,T
6-NA,836,13,1,2,4529,4545,C
6-NA,837,12,4,0,4550,4566,C
6-NA,838,2,4564,0,3,4569,T
6-NA,839,4,4,4599,0,4607,G
6-NA,840,3,1,0,4564,4568,C
6-NA,841,1,4534,0,5,4540,T
6-NA,842,4574,2,1,0,4577,A
6-NA,843,3,4506,0,5,4514,T
6-NA,844,8,0,2,4531,4541,C
6-NA,845,12,1,0,4516,4529,C
6-NA,846,1,4552,0,1,4554,T
6-NA,847,15,3,0,4559,4577,C
6-NA,848,1,12,4562,0,4575,G
6-NA,849,4610,1,1,0,4612,A
6-NA,850,2,4611,0,4,4617,T
6-NA,851,4633,2,1,0,4636,A
6-NA,852,0,4626,0,1,4627,T
6-NA,853,11,0,2,4618,4631,C
6-NA,854,11,2,1,4610,4624,C
6-NA,855,1,4588,0,10,4599,T
6-NA,856,3,22,4596,0,4621,G
6-NA,857,1,2,4626,0,4629,G
6-NA,858,0,4690,0,1,4691,T
6-NA,859,1,2,4693,0,4696,G
6-NA,860,1,4678,0,2,4681,T
6-NA,861,15,2,0,4653,4670,C
6-NA,862,4671,1,3,0,4675,A
6-NA,863,0,3,4674,0,4677,G
6-NA,864,4665,1,2,1,4669,A
6-NA,865,0,4638,0,0,4638,T
6-NA,866,3,6,4636,0,4645,G
6-NA,867,0,4611,0,2,4613,T
6-NA,868,1,1,4626,1,4629,G
6-NA,869,1,4614,0,5,4620,T
6-NA,870,5,0,1,4621,4627,C
6-NA,871,1,4612,0,10,4623,T
6-NA,872,0,2,4622,2,4626,G
6-NA,873,3,1,2,4627,4633,C
6-NA,874,4625,0,5,0,4630,A
6-NA,875,0,14,4626,0,4640,G
6-NA,876,4527,1,10,0,4538,A
6-NA,877,0,8,4548,3,4559,G
6-NA,878,4546,0,5,0,4551,A
6-NA,879,3,3,0,4574,4580,C
6-NA,880,4593,0,1,0,4594,A
6-NA,881,4607,2,2,0,4611,A
6-NA,882,4,1,0,4630,4635,C
6-NA,883,0,4632,0,2,4634,T
6-NA,884,2,12,4626,4,4644,G
6-NA,885,2,11,4621,0,4634,G
6-NA,886,4617,3,4,0,4624,A
6-NA,887,4614,0,5,0,4619,A
6-NA,888,4519,1,5,1,4526,A
6-NA,889,0,9,4599,0,4608,G
6-NA,890,0,5,4573,0,4578,G
6-NA,891,1,2,0,4574,4577,C
6-NA,892,1,4542,0,10,4553,T
6-NA,893,14,1,1,4626,4642,C
6-NA,894,24,2,1,4655,4682,C
6-NA,895,4699,1,1,1,4702,A
6-NA,896,4699,0,0,0,4699,A
6-NA,897,1,4702,0,1,4704,T
6-NA,898,4554,0,3,0,4557,A
6-NA,899,1,8,4526,0,4535,G
6-NA,900,2,3,4526,0,4531,G
6-NA,901,2,2,0,4524,4528,C
6-NA,902,8,0,0,4416,4424,C
6-NA,903,23,3,0,4363,4389,C
6-NA,904,4413,1,1,0,4415,A
6-NA,905,1,4448,0,2,4451,T
6-NA,906,18,1,1,4433,4453,C
6-NA,907,0,2,4471,0,4473,G
6-NA,908,0,4448,0,1,4449,T
6-NA,909,4369,0,2,0,4371,A
6-NA,910,0,3,4454,0,4457,G
6-NA,911,4466,1,2,0,4469,A
6-NA,912,0,4485,0,0,4485,T
6-NA,913,4410,0,0,0,4410,A
6-NA,914,1,4364,0,2,4367,T
6-NA,915,4362,0,0,0,4362,A
6-NA,916,4334,0,2,1,4337,A
6-NA,917,4428,0,2,0,4430,A
6-NA,918,1,0,0,4523,4524,C
6-NA,919,4422,0,1,0,4423,A
6-NA,920,1,4421,0,1,4423,T
6-NA,921,4390,0,0,0,4390,A
6-NA,922,4397,2,0,0,4399,A
6-NA,923,4396,0,2,0,4398,A
6-NA,924,1,18,4416,0,4435,G
6-NA,925,0,2,4482,0,4484,G
6-NA,926,4350,0,2,0,4352,A
6-NA,927,0,4329,0,2,4331,T
6-NA,928,13,0,1,4320,4334,C
6-NA,929,4365,1,5,1,4372,A
6-NA,930,0,4370,0,1,4371,T
6-NA,931,4366,0,2,0,4368,A
6-NA,932,9,2,4384,0,4395,G
6-NA,933,2,2,0,4331,4335,C
6-NA,934,4274,0,1,0,4275,A
6-NA,935,0,4154,0,1,4155,T
6-NA,936,0,4167,2,1,4170,T
6-NA,937,2,1,4258,0,4261,G
6-NA,938,1,4270,1,2,4274,T
6-NA,939,0,4320,0,1,4321,T
6-NA,940,2,4309,0,2,4313,T
6-NA,941,7,1,0,4282,4290,C
6-NA,942,13,2,0,4300,4315,C
6-NA,943,4358,1,1,0,4360,A
6-NA,944,0,8,4395,2,4405,G
6-NA,945,1,4383,0,4,4388,T
6-NA,946,0,4255,0,3,4258,T
6-NA,947,4264,2,1,0,4267,A
6-NA,948,3,4220,0,1,4224,T
6-NA,949,0,4,4222,1,4227,G
6-NA,950,1,4172,0,4,4177,T
6-NA,951,1,1,4205,0,4207,G
6-NA,952,2,4100,0,1,4103,T
6-NA,953,4,1,4194,0,4199,G
6-NA,954,1,4198,0,2,4201,T
6-NA,955,0,4189,0,2,4191,T
6-NA,956,15,4,0,4174,4193,C
6-NA,957,4151,2,6,0,4159,A
6-NA,958,0,9,4168,0,4177,G
6-NA,959,0,16,4142,0,4158,G
6-NA,960,4123,0,0,0,4123,A
6-NA,961,2,0,0,4136,4138,C
6-NA,962,0,4003,1,1,4005,T
6-NA,963,1,4001,0,1,4003,T
6-NA,964,0,5,4151,0,4156,G
6-NA,965,1,4149,2,2,4154,T
6-NA,966,1,4149,0,4,4154,T
6-NA,967,2,17,4103,1,4123,G
6-NA,968,0,18,4093,2,4113,G
6-NA,969,4112,1,3,1,4117,A
6-NA,970,0,8,4107,0,4115,G
6-NA,971,4100,1,6,0,4107,A
6-NA,972,5,1,0,4098,4104,C
6-NA,973,3952,0,2,1,3955,A
6-NA,974,4,0,0,3969,3973,C
6-NA,975,3980,1,2,1,3984,A
6-NA,976,8,1,0,3977,3986,C
6-NA,977,27,0,0,3934,3961,C
6-NA,978,18,3,0,3965,3986,C
6-NA,979,3972,3,3,0,3978,A
6-NA,980,2,10,3978,0,3990,G
6-NA,981,3982,0,1,0,3983,A
6-NA,982,4008,2,1,0,4011,A
6-NA,983,3988,1,3,1,3993,A
6-NA,984,3988,0,4,0,3992,A
6-NA,985,3954,0,5,1,3960,A
6-NA,986,3957,0,1,2,3960,A
6-NA,987,3,1,0,3966,3970,C
6-NA,988,0,15,3956,0,3971,G
6-NA,989,3953,0,2,0,3955,A
6-NA,990,2,4,0,3947,3953,C
6-NA,991,3940,0,3,0,3943,A
6-NA,992,1,2,3976,0,3979,G
6-NA,993,4,0,0,4070,4074,C
6-NA,994,1,4057,0,6,4064,T
6-NA,995,15,0,1,4051,4067,C
6-NA,996,14,2,0,4070,4086,C
6-NA,997,4090,1,5,1,4097,A
6-NA,998,0,3,4139,0,4142,G
6-NA,999,1,0,1,4135,4137,C
6-NA,1000,4121,0,6,0,4127,A
6-NA,1001,0,2,4118,2,4122,G
6-NA,1002,0,3946,0,2,3948,T
6-NA,1003,3955,0,5,0,3960,A
6-NA,1004,0,1,3959,0,3960,G
6-NA,1005,4,0,1,3953,3958,C
6-NA,1006,10,1,1,3950,3962,C
6-NA,1007,3911,1,1,0,3913,A
6-NA,1008,1,3906,0,2,3909,T
6-NA,1009,0,3909,0,3,3912,T
6-NA,1010,2,3,3985,0,3990,G
6-NA,1011,0,3965,2,2,3969,T
6-NA,1012,0,3954,0,5,3959,T
6-NA,1013,4,3946,0,3,3953,T
6-NA,1014,1,5,3912,2,3920,G
6-NA,1015,2,4,3968,0,3974,G
6-NA,1016,3955,2,0,0,3957,A
6-NA,1017,0,3985,0,2,3987,T
6-NA,1018,14,0,0,3966,3980,C
6-NA,1019,9,1,0,3909,3919,C
6-NA,1020,4,3911,0,1,3916,T
6-NA,1021,3918,1,3,0,3922,A
6-NA,1022,3922,1,4,0,3927,A
6-NA,1023,1,1,1,3973,3976,C
6-NA,1024,3893,0,5,1,3899,A
6-NA,1025,3923,0,1,0,3924,A
6-NA,1026,0,3915,0,1,3916,T
6-NA,1027,7,6,3942,0,3955,G
6-NA,1028,3926,0,8,0,3934,A
6-NA,1029,3910,1,3,1,3915,A
6-NA,1030,1,5,3928,0,3934,G
6-NA,1031,3910,1,1,0,3912,A
6-NA,1032,3798,0,4,0,3802,A
6-NA,1033,2,13,3796,0,3811,G
6-NA,1034,2,7,3815,0,3824,G
6-NA,1035,2,3762,0,2,3766,T
6-NA,1036,0,17,3730,0,3747,G
6-NA,1037,1,6,3853,0,3860,G
6-NA,1038,0,3832,0,8,3840,T
6-NA,1039,17,2,1,3807,3827,C
6-NA,1040,3827,1,1,1,3830,A
6-NA,1041,1,3808,0,4,3813,T
6-NA,1042,1,11,3794,0,3806,G
6-NA,1043,0,7,3810,0,3817,G
6-NA,1044,3796,0,2,0,3798,A
6-NA,1045,1,1,3912,0,3914,G
6-NA,1046,0,3766,0,2,3768,T
6-NA,1047,4,8,3758,2,3772,G
6-NA,1048,3762,0,4,0,3766,A
6-NA,1049,3756,1,2,1,3760,A
6-NA,1050,3762,1,7,1,3771,A
6-NA,1051,0,7,3796,0,3803,G
6-NA,1052,3,2,3768,0,3773,G
6-NA,1053,0,0,0,3747,3747,C
6-NA,1054,1,3657,0,1,3659,T
6-NA,1055,3,12,3654,0,3669,G
6-NA,1056,2,7,3657,0,3666,G
6-NA,1057,0,5,3697,1,3703,G
6-NA,1058,3,1,0,3698,3702,C
6-NA,1059,7,0,0,3708,3715,C
6-NA,1060,1,3665,1,6,3673,T
6-NA,1061,0,3677,0,2,3679,T
6-NA,1062,0,3686,1,1,3688,T
6-NA,1063,2,4,3699,0,3705,G
6-NA,1064,3694,0,4,0,3698,A
6-NA,1065,1,3667,0,2,3670,T
6-NA,1066,0,5,3614,0,3619,G
6-NA,1067,3571,0,4,0,3575,A
6-NA,1068,0,3585,0,2,3587,T
6-NA,1069,1,5,3585,0,3591,G
6-NA,1070,3,7,3624,0,3634,G
6-NA,1071,3624,0,5,0,3629,A
6-NA,1072,3626,2,1,0,3629,A
6-NA,1073,3629,0,3,1,3633,A
6-NA,1074,0,3622,0,3,3625,T
6-NA,1075,4,12,3618,0,3634,G
6-NA,1076,3631,0,4,0,3635,A
6-NA,1077,5,5,3,3608,3621,C
6-NA,1078,4,0,3634,0,3638,G
6-NA,1079,1,3543,1,2,3547,T
6-NA,1080,1,1,3571,0,3573,G
6-NA,1081,2,3568,0,4,3574,T
6-NA,1082,0,14,3564,0,3578,G
6-NA,1083,0,7,3587,0,3594,G
6-NA,1084,3572,1,9,0,3582,A
6-NA,1085,0,3569,1,3,3573,T
6-NA,1086,0,15,3548,0,3563,G
6-NA,1087,1,4,3553,0,3558,G
6-NA,1088,1,5,3562,0,3568,G
6-NA,1089,3541,1,1,0,3543,A
6-NA,1090,3532,0,4,0,3536,A
6-NA,1091,1,9,3527,0,3537,G
6-NA,1092,3490,1,2,1,3494,A
6-NA,1093,3492,2,1,0,3495,A
6-NA,1094,3,2,0,3465,3470,C
6-NA,1095,1,7,3453,0,3461,G
6-NA,1096,3448,1,1,0,3450,A
6-NA,1097,2,3379,0,3,3384,T
6-NA,1098,8,1,0,3381,3390,C
6-NA,1099,3384,0,3,0,3387,A
6-NA,1100,1,0,3396,0,3397,G
6-NA,1101,3,0,0,3382,3385,C
6-NA,1102,4,12,3373,0,3389,G
6-NA,1103,3376,1,1,0,3378,A
6-NA,1104,0,3,3381,0,3384,G
6-NA,1105,3379,1,0,0,3380,A
6-NA,1106,3379,0,1,0,3380,A
6-NA,1107,1,1,3401,0,3403,G
6-NA,1108,0,3375,1,3,3379,T
6-NA,1109,14,0,0,3327,3341,C
6-NA,1110,3338,2,5,0,3345,A
6-NA,1111,3,3,0,3442,3448,C
6-NA,1112,2,2,3441,1,3446,G
6-NA,1113,2,0,0,3441,3443,C
6-NA,1114,1,3423,0,2,3426,T
6-NA,1115,0,3438,1,2,3441,T
6-NA,1116,3389,0,2,0,3391,A
6-NA,1117,4,8,3467,0,3479,G
6-NA,1118,1,16,3460,1,3478,G
6-NA,1119,2,5,3542,1,3550,G
6-NA,1120,0,3328,1,4,3333,T
6-NA,1121,3318,1,0,0,3319,A
6-NA,1122,0,3301,0,0,3301,T
6-NA,1123,1,8,3290,1,3300,G
6-NA,1124,3288,0,2,0,3290,A
6-NA,1125,3284,0,0,0,3284,A
6-NA,1126,3141,0,4,0,3145,A
6-NA,1127,2,0,0,3144,3146,C
6-NA,1128,5,0,0,3088,3093,C
6-NA,1129,0,3058,1,1,3060,T
6-NA,1130,0,3056,0,2,3058,T
6-NA,1131,4,1,1,3061,3067,C
6-NA,1132,3065,2,0,1,3068,A
6-NA,1133,3065,0,3,0,3068,A
6-NA,1134,3070,1,0,0,3071,A
6-NA,1135,0,1,3098,0,3099,G
6-NA,1136,1,3040,0,0,3041,T
6-NA,1137,9,1,0,3047,3057,C
6-NA,1138,3111,3,3,1,3118,A
6-NA,1139,1,3128,0,1,3130,T
6-NA,1140,0,3126,0,3,3129,T
6-NA,1141,1,6,3121,1,3129,G
6-NA,1142,3125,0,1,0,3126,A
6-NA,1143,3127,3,3,0,3133,A
6-NA,1144,2,12,3107,0,3121,G
6-NA,1145,0,4,3109,0,3113,G
6-NA,1146,3,1,0,3087,3091,C
6-NA,1147,0,2997,0,0,2997,T
6-NA,1148,0,7,3013,0,3020,G
6-NA,1149,1,3,3094,0,3098,G
6-NA,1150,0,3088,0,7,3095,T
6-NA,1151,9,0,0,3077,3086,C
6-NA,1152,14,1,0,3060,3075,C
6-NA,1153,3066,1,3,0,3070,A
6-NA,1154,3094,0,1,0,3095,A
6-NA,1155,7,1,0,3098,3106,C
6-NA,1156,11,2,0,3086,3099,C
6-NA,1157,15,1,0,3086,3102,C
6-NA,1158,0,2975,0,1,2976,T
6-NA,1159,2971,0,0,0,2971,A
6-NA,1160,2966,0,1,0,2967,A
6-NA,1161,1,2,2987,0,2990,G
6-NA,1162,1,2962,1,5,2969,T
6-NA,1163,11,1,0,2942,2954,C
6-NA,1164,8,1,0,2912,2921,C
6-NA,1165,2921,0,2,0,2923,A
6-NA,1166,2912,1,0,0,2913,A
6-NA,1167,2914,2,1,0,2917,A
6-NA,1168,0,2925,1,0,2926,T
6-NA,1169,1,2910,3,0,2914,T
6-NA,1170,0,2,2899,0,2901,G
6-NA,1171,2,3,1,2880,2886,C
6-NA,1172,2889,1,1,0,2891,A
6-NA,1173,1,3,2898,0,2902,G
6-NA,1174,2898,0,1,0,2899,A
6-NA,1175,0,2948,0,0,2948,T
6-NA,1176,2952,0,3,0,2955,A
6-NA,1177,2946,0,0,0,2946,A
6-NA,1178,2953,0,4,0,2957,A
6-NA,1179,1,2935,0,0,2936,T
6-NA,1180,2916,1,1,0,2918,A
6-NA,1181,1,7,2918,0,2926,G
6-NA,1182,2,0,2905,0,2907,G
6-NA,1183,1,1,0,2894,2896,C
6-NA,1184,2798,1,2,0,2801,A
6-NA,1185,2810,1,2,0,2813,A
6-NA,1186,0,0,2839,0,2839,G
6-NA,1187,0,2821,1,3,2825,T
6-NA,1188,16,0,1,2817,2834,C
6-NA,1189,2833,2,2,0,2837,A
6-NA,1190,1,2833,1,1,2836,T
6-NA,1191,2855,0,2,1,2858,A
6-NA,1192,1,1,2860,1,2863,G
6-NA,1193,0,2853,2,0,2855,T
6-NA,1194,0,2758,0,1,2759,T
6-NA,1195,2,14,2699,1,2716,G
6-NA,1196,2691,2,5,1,2699,A
6-NA,1197,1,1,0,2688,2690,C
6-NA,1198,2651,0,0,0,2651,A
6-NA,1199,0,6,2682,0,2688,G
6-NA,1200,2651,0,1,0,2652,A
6-NA,1201,1,10,2741,0,2752,G
6-NA,1202,1,1,2752,1,2755,G
6-NA,1203,0,2730,0,0,2730,T
6-NA,1204,2728,0,0,0,2728,A
6-NA,1205,2710,1,3,0,2714,A
6-NA,1206,1,2712,1,3,2717,T
6-NA,1207,2707,0,1,0,2708,A
6-NA,1208,1,4,2624,0,2629,G
6-NA,1209,1,3,2572,1,2577,G
6-NA,1210,3,2365,0,1,2369,T
6-NA,1211,6,1,0,2332,2339,C
6-NA,1212,10,0,0,2330,2340,C
6-NA,1213,1,13,2328,0,2342,G
6-NA,1214,2,3,2336,0,2341,G
6-NA,1215,1,2330,0,4,2335,T
6-NA,1216,0,2328,0,2,2330,T
6-NA,1217,2306,0,0,0,2306,A
6-NA,1218,0,2280,0,1,2281,T
6-NA,1219,0,2275,0,0,2275,T
6-NA,1220,9,1,0,2266,2276,C
6-NA,1221,0,2208,0,2,2210,T
6-NA,1222,1,11,2210,0,2222,G
6-NA,1223,1,2,2226,0,2229,G
6-NA,1224,1,2223,0,1,2225,T
6-NA,1225,2231,0,0,0,2231,A
6-NA,1226,0,2201,0,1,2202,T
6-NA,1227,0,2192,0,5,2197,T
6-NA,1228,0,2192,1,7,2200,T
6-NA,1229,0,2208,1,1,2210,T
6-NA,1230,4,0,0,2205,2209,C
6-NA,1231,2,2180,0,4,2186,T
6-NA,1232,6,0,0,2190,2196,C
6-NA,1233,0,2177,0,1,2178,T
6-NA,1234,0,0,2229,0,2229,G
6-NA,1235,1,2220,0,4,2225,T
6-NA,1236,0,2210,0,1,2211,T
6-NA,1237,0,2,2217,0,2219,G
6-NA,1238,2195,1,1,1,2198,A
6-NA,1239,2194,2,1,0,2197,A
6-NA,1240,0,4,2208,0,2212,G
6-NA,1241,4,0,2201,0,2205,G
6-NA,1242,1,1,1,2211,2214,C
6-NA,1243,2187,0,1,0,2188,A
6-NA,1244,2194,0,0,0,2194,A
6-NA,1245,2188,1,2,0,2191,A
6-NA,1246,2200,1,2,0,2203,A
6-NA,1247,1,2,2195,1,2199,G
6-NA,1248,2,1,0,2190,2193,C
6-NA,1249,0,2179,0,2,2181,T
6-NA,1250,0,1,2201,0,2202,G
6-NA,1251,0,0,0,2207,2207,C
6-NA,1252,2213,0,1,0,2214,A
6-NA,1253,0,2201,0,1,2202,T
6-NA,1254,5,1,0,2185,2191,C
6-NA,1255,2188,0,2,0,2190,A
6-NA,1256,2193,0,1,0,2194,A
6-NA,1257,1,2190,0,0,2191,T
6-NA,1258,6,1,1,2185,2193,C
6-NA,1259,2,11,2138,1,2152,G
6-NA,1260,1,2,2175,0,2178,G
6-NA,1261,0,2174,0,2,2176,T
6-NA,1262,0,1,2179,0,2180,G
6-NA,1263,1,1,0,2188,2190,C
6-NA,1264,0,2168,0,3,2171,T
6-NA,1265,0,2183,0,1,2184,T
6-NA,1266,0,2181,0,0,2181,T
6-NA,1267,0,2196,1,0,2197,T
6-NA,1268,2201,0,0,0,2201,A
6-NA,1269,0,2096,0,6,2102,T
6-NA,1270,3,3,2095,0,2101,G
6-NA,1271,1,2061,0,2,2064,T
6-NA,1272,1,6,2035,1,2043,G
6-NA,1273,1,6,2059,0,2066,G
6-NA,1274,2032,0,0,0,2032,A
6-NA,1275,1,1,2055,0,2057,G
6-NA,1276,1,2039,0,1,2041,T
6-NA,1277,0,2021,0,1,2022,T
6-NA,1278,0,6,2039,0,2045,G
6-NA,1279,2038,0,6,0,2044,A
6-NA,1280,0,2041,0,2,2043,T
6-NA,1281,2030,0,2,0,2032,A
6-NA,1282,1974,0,3,0,1977,A
6-NA,1283,0,9,1973,0,1982,G
6-NA,1284,0,7,1925,0,1932,G
6-NA,1285,0,6,1911,0,1917,G
6-NA,1286,0,3,1918,0,1921,G
6-NA,1287,1907,0,0,0,1907,A
6-NA,1288,1897,0,1,1,1899,A
6-NA,1289,0,7,1901,0,1908,G
6-NA,1290,1903,0,1,0,1904,A
6-NA,1291,1906,0,0,0,1906,A
6-NA,1292,1893,0,0,0,1893,A
6-NA,1293,1859,0,1,0,1860,A
6-NA,1294,0,0,1881,0,1881,G
6-NA,1295,1873,1,2,0,1876,A
6-NA,1296,147,4,1720,0,1871,G
6-NA,1297,22,1,1842,0,1865,G
6-NA,1298,1839,2,0,0,1841,A
6-NA,1299,1690,0,150,0,1840,A
6-NA,1300,1847,0,1,0,1848,A
6-NA,1301,0,0,0,1855,1855,C
6-NA,1302,0,1808,1,0,1809,T
6-NA,1303,0,8,1800,0,1808,G
6-NA,1304,1744,1,2,0,1747,A
6-NA,1305,1742,0,1,0,1743,A
6-NA,1306,1,0,1748,0,1749,G
6-NA,1307,1,1726,0,1,1728,T
6-NA,1308,8,2,0,1732,1742,C
6-NA,1309,0,1727,0,5,1732,T
6-NA,1310,0,1719,0,0,1719,T
6-NA,1311,0,0,1715,1,1716,G
6-NA,1312,1,1713,0,0,1714,T
6-NA,1313,1,8,1702,0,1711,G
6-NA,1314,0,6,1699,0,1705,G
6-NA,1315,1660,0,5,0,1665,A
6-NA,1316,0,1,0,1658,1659,C
6-NA,1317,1593,1,0,0,1594,A
6-NA,1318,0,1589,0,1,1590,T
6-NA,1319,5,0,0,1586,1591,C
6-NA,1320,2,7,1582,0,1591,G
6-NA,1321,1636,1,0,0,1637,A
6-NA,1322,1635,0,0,0,1635,A
6-NA,1323,0,1,1,1640,1642,C
6-NA,1324,1611,0,1,0,1612,A
6-NA,1325,0,3,1661,0,1664,G
6-NA,1326,0,1653,0,0,1653,T
6-NA,1327,1644,0,3,0,1647,A
6-NA,1328,0,1651,0,0,1651,T
6-NA,1329,0,1588,0,0,1588,T
6-NA,1330,0,1,1603,0,1604,G
6-NA,1331,0,1597,0,2,1599,T
6-NA,1332,0,1553,0,5,1558,T
6-NA,1333,0,0,1562,0,1562,G
6-NA,1334,0,1388,0,0,1388,T
6-NA,1335,1,0,1392,0,1393,G
6-NA,1336,0,1385,0,1,1386,T
6-NA,1337,0,1362,0,0,1362,T
6-NA,1338,0,1365,0,0,1365,T
6-NA,1339,1,1334,0,0,1335,T
6-NA,1340,0,1,1334,0,1335,G
6-NA,1341,0,1336,0,2,1338,T
6-NA,1342,0,5,1329,0,1334,G
6-NA,1343,0,0,1330,0,1330,G
6-NA,1344,3,1,0,1306,1310,C
6-NA,1345,1304,0,1,4,1309,A
6-NA,1346,2,0,0,1328,1330,C
6-NA,1347,3,0,0,1314,1317,C
6-NA,1348,0,1320,0,1,1321,T
6-NA,1349,9,0,0,1317,1326,C
6-NA,1350,1315,0,2,0,1317,A
6-NA,1351,0,8,1314,0,1322,G
6-NA,1352,1,0,1325,0,1326,G
6-NA,1353,0,1318,0,0,1318,T
6-NA,1354,1306,0,0,0,1306,A
6-NA,1355,2,1,0,1247,1250,C
6-NA,1356,1215,1,1,1,1218,A
6-NA,1357,0,1217,0,0,1217,T
6-NA,1358,1190,0,0,0,1190,A
6-NA,1359,0,1183,0,3,1186,T
6-NA,1360,1,3,1111,0,1115,G
6-NA,1361,1,4,1110,0,1115,G
6-NA,1362,1111,0,0,0,1111,A
6-NA,1363,1103,1,2,0,1106,A
6-NA,1364,1,1,0,1094,1096,C
6-NA,1365,915,0,0,0,915,A
6-NA,1366,0,1,915,0,916,G
6-NA,1367,1,1,910,0,912,G
6-NA,1368,2,1,0,912,915,C
6-NA,1369,1,906,0,3,910,T
6-NA,1370,4,0,0,857,861,C
6-NA,1371,849,0,2,0,851,A
6-NA,1372,0,852,0,1,853,T
6-NA,1373,0,0,850,0,850,G
6-NA,1374,0,2,849,0,851,G
6-NA,1375,1,0,0,814,815,C
6-NA,1376,0,1,1,805,807,C
6-NA,1377,0,768,0,0,768,T
6-NA,1378,0,0,765,0,765,G
6-NA,1379,767,0,0,0,767,A
6-NA,1380,0,764,0,0,764,T
6-NA,1381,0,5,749,0,754,G
6-NA,1382,0,3,730,0,733,G
6-NA,1383,0,2,694,0,696,G
6-NA,1384,0,0,695,0,695,G
6-NA,1385,1,1,0,683,685,C
6-NA,1386,0,5,677,0,682,G
6-NA,1387,0,1,674,0,675,G
6-NA,1388,665,0,1,0,666,A
6-NA,1389,0,0,0,664,664,C
6-NA,1390,664,0,0,0,664,A
6-NA,1391,0,649,0,3,652,T
6-NA,1392,2,1,0,634,637,C
6-NA,1393,626,0,0,0,626,A
6-NA,1394,622,0,0,0,622,A
6-NA,1395,0,625,0,0,625,T
6-NA,1396,0,1,0,605,606,C
6-NA,1397,0,590,0,0,590,T
6-NA,1398,1,0,0,477,478,C
6-NA,1399,475,0,0,0,475,A
6-NA,1400,0,471,0,0,471,T
6-NA,1401,0,0,470,0,470,G
6-NA,1402,1,0,0,466,467,C
6-NA,1403,6,0,0,437,443,C
6-NA,1404,0,398,0,0,398,T
6-NA,1405,393,0,0,0,393,A
6-NA,1406,0,393,0,0,393,T
6-NA,1407,379,0,2,0,381,A
6-NA,1408,0,376,0,0,376,T
6-NA,1409,343,0,0,0,343,A
6-NA,1410,330,0,0,0,330,A
7-M,1,56,0,0,0,56,A
7-M,2,0,56,0,0,56,T
7-M,3,0,0,56,0,56,G
7-M,4,56,0,0,0,56,A
7-M,5,0,0,61,0,61,G
7-M,6,0,0,0,65,65,C
7-M,7,0,0,0,68,68,C
7-M,8,0,91,0,0,91,T
7-M,9,0,92,0,0,92,T
7-M,10,0,0,0,94,94,C
7-M,11,0,95,0,0,95,T
7-M,12,98,0,0,0,98,A
7-M,13,98,0,0,0,98,A
7-M,14,0,0,0,98,98,C
7-M,15,0,1,0,97,98,C
7-M,16,0,3,95,0,98,G
7-M,17,100,0,0,0,100,A
7-M,18,0,1,99,0,100,G
7-M,19,0,0,106,0,106,G
7-M,20,0,106,0,0,106,T
7-M,21,0,0,0,106,106,C
7-M,22,0,0,106,0,106,G
7-M,23,111,0,0,0,111,A
7-M,24,112,0,0,0,112,A
7-M,25,112,0,0,0,112,A
7-M,26,0,0,0,121,121,C
7-M,27,0,0,125,0,125,G
7-M,28,0,130,0,0,130,T
7-M,29,132,0,0,0,132,A
7-M,30,0,133,0,0,133,T
7-M,31,1,0,136,0,137,G
7-M,32,0,139,0,0,139,T
7-M,33,0,150,0,0,150,T
7-M,34,1,0,0,153,154,C
7-M,35,0,152,0,1,153,T
7-M,36,0,0,0,162,162,C
7-M,37,0,162,0,0,162,T
7-M,38,2,0,0,167,169,C
7-M,39,0,168,0,0,168,T
7-M,40,169,0,0,0,169,A
7-M,41,0,168,0,0,168,T
7-M,42,1,0,0,169,170,C
7-M,43,0,0,173,0,173,G
7-M,44,0,172,0,0,172,T
7-M,45,0,174,0,0,174,T
7-M,46,0,0,0,176,176,C
7-M,47,2,0,0,175,177,C
7-M,48,179,0,0,0,179,A
7-M,49,0,179,0,0,179,T
7-M,50,0,0,0,179,179,C
7-M,51,177,0,1,0,178,A
7-M,52,0,0,180,0,180,G
7-M,53,0,0,181,0,181,G
7-M,54,0,0,0,181,181,C
7-M,55,1,1,0,179,181,C
7-M,56,2,0,0,178,180,C
7-M,57,1,0,0,193,194,C
7-M,58,1,0,0,194,195,C
7-M,59,0,195,0,0,195,T
7-M,60,0,0,0,196,196,C
7-M,61,196,0,0,0,196,A
7-M,62,195,0,0,0,195,A
7-M,63,197,0,2,0,199,A
7-M,64,0,1,201,0,202,G
7-M,65,0,0,0,201,201,C
7-M,66,1,0,0,201,202,C
7-M,67,0,1,202,0,203,G
7-M,68,203,0,0,0,203,A
7-M,69,0,1,203,0,204,G
7-M,70,210,0,0,0,210,A
7-M,71,0,210,0,0,210,T
7-M,72,0,0,0,207,207,C
7-M,73,0,0,208,0,208,G
7-M,74,1,0,0,209,210,C
7-M,75,0,0,213,0,213,G
7-M,76,0,0,0,211,211,C
7-M,77,213,0,0,0,213,A
7-M,78,0,0,215,0,215,G
7-M,79,215,0,0,0,215,A
7-M,80,0,1,230,0,231,G
7-M,81,231,0,0,0,231,A
7-M,82,0,0,0,236,236,C
7-M,83,0,235,0,0,235,T
7-M,84,0,236,0,0,236,T
7-M,85,0,0,238,0,238,G
7-M,86,242,0,0,0,242,A
7-M,87,242,0,0,0,242,A
7-M,88,0,0,244,0,244,G
7-M,89,239,0,1,0,240,A
7-M,90,0,241,0,0,241,T
7-M,91,0,0,242,0,242,G
7-M,92,0,243,0,0,243,T
7-M,93,0,0,0,243,243,C
7-M,94,0,242,0,0,242,T
7-M,95,0,242,0,0,242,T
7-M,96,0,242,0,0,242,T
7-M,97,0,0,244,0,244,G
7-M,98,0,0,0,243,243,C
7-M,99,0,242,0,0,242,T
7-M,100,0,1,245,0,246,G
7-M,101,1,1,243,1,246,G
7-M,102,0,1,249,0,250,G
7-M,103,251,0,0,0,251,A
7-M,104,251,0,0,0,251,A
7-M,105,249,0,0,1,250,A
7-M,106,251,1,0,0,252,A
7-M,107,256,0,1,0,257,A
7-M,108,0,0,0,257,257,C
7-M,109,257,0,1,0,258,A
7-M,110,0,0,0,259,259,C
7-M,111,257,0,0,0,257,A
7-M,112,0,2,262,0,264,G
7-M,113,265,0,0,0,265,A
7-M,114,0,271,0,0,271,T
7-M,115,0,0,0,276,276,C
7-M,116,0,275,0,0,275,T
7-M,117,0,273,0,0,273,T
7-M,118,0,0,277,0,277,G
7-M,119,273,1,0,0,274,A
7-M,120,0,0,276,0,276,G
7-M,121,0,0,275,0,275,G
7-M,122,0,0,0,279,279,C
7-M,123,0,276,0,0,276,T
7-M,124,0,0,0,301,301,C
7-M,125,0,298,0,0,298,T
7-M,126,2,0,0,303,305,C
7-M,127,308,0,0,0,308,A
7-M,128,0,306,0,0,306,T
7-M,129,0,1,306,1,308,G
7-M,130,0,0,310,0,310,G
7-M,131,303,0,0,0,303,A
7-M,132,309,0,0,0,309,A
7-M,133,0,300,0,0,300,T
7-M,134,0,1,317,0,318,G
7-M,135,0,0,329,0,329,G
7-M,136,1,0,0,332,333,C
7-M,137,0,332,0,0,332,T
7-M,138,330,0,0,0,330,A
7-M,139,329,0,0,0,329,A
7-M,140,338,0,0,0,338,A
7-M,141,0,1,343,0,344,G
7-M,142,341,0,0,0,341,A
7-M,143,0,0,0,342,342,C
7-M,144,331,0,0,0,331,A
7-M,145,331,0,0,0,331,A
7-M,146,0,0,341,0,341,G
7-M,147,340,0,0,0,340,A
7-M,148,0,0,1,341,342,C
7-M,149,2,0,0,338,340,C
7-M,150,342,0,0,0,342,A
7-M,151,345,0,0,0,345,A
7-M,152,0,345,0,0,345,T
7-M,153,0,345,0,0,345,T
7-M,154,2,0,0,346,348,C
7-M,155,0,347,0,0,347,T
7-M,156,0,0,349,0,349,G
7-M,157,0,346,0,1,347,T
7-M,158,2,0,0,346,348,C
7-M,159,348,0,0,0,348,A
7-M,160,0,0,0,361,361,C
7-M,161,2,0,0,360,362,C
7-M,162,1,357,0,0,358,T
7-M,163,1,0,0,361,362,C
7-M,164,0,359,0,0,359,T
7-M,165,0,1,367,0,368,G
7-M,166,367,0,0,0,367,A
7-M,167,1,0,0,368,369,C
7-M,168,0,366,0,0,366,T
7-M,169,360,0,0,0,360,A
7-M,170,358,0,0,0,358,A
7-M,171,0,1,359,0,360,G
7-M,172,1,1,359,0,361,G
7-M,173,0,2,361,0,363,G
7-M,174,0,1,363,0,364,G
7-M,175,368,0,0,0,368,A
7-M,176,1,369,0,0,370,T
7-M,177,0,369,0,0,369,T
7-M,178,0,372,0,0,372,T
7-M,179,0,372,0,0,372,T
7-M,180,0,1,371,0,372,G
7-M,181,0,4,369,0,373,G
7-M,182,0,1,370,0,371,G
7-M,183,0,1,373,0,374,G
7-M,184,0,372,0,0,372,T
7-M,185,0,370,0,0,370,T
7-M,186,0,369,0,1,370,T
7-M,187,0,1,375,0,376,G
7-M,188,0,377,0,1,378,T
7-M,189,0,0,380,0,380,G
7-M,190,0,380,0,0,380,T
7-M,191,0,380,0,0,380,T
7-M,192,2,0,0,379,381,C
7-M,193,385,0,0,0,385,A
7-M,194,0,0,0,392,392,C
7-M,195,1,0,390,0,391,G
7-M,196,1,0,0,394,395,C
7-M,197,0,389,0,1,390,T
7-M,198,4,0,0,390,394,C
7-M,199,394,0,0,0,394,A
7-M,200,1,1,0,400,402,C
7-M,201,1,0,0,394,395,C
7-M,202,2,1,394,0,397,G
7-M,203,0,395,0,1,396,T
7-M,204,0,0,397,0,397,G
7-M,205,0,1,0,400,401,C
7-M,206,2,0,0,398,400,C
7-M,207,0,0,0,398,398,C
7-M,208,393,0,0,0,393,A
7-M,209,0,0,401,0,401,G
7-M,210,0,398,0,0,398,T
7-M,211,0,1,397,0,398,G
7-M,212,401,0,0,0,401,A
7-M,213,0,0,402,0,402,G
7-M,214,0,0,0,403,403,C
7-M,215,0,0,407,0,407,G
7-M,216,405,0,0,0,405,A
7-M,217,0,2,408,0,410,G
7-M,218,0,0,414,0,414,G
7-M,219,413,0,1,0,414,A
7-M,220,0,0,0,417,417,C
7-M,221,0,410,0,1,411,T
7-M,222,0,0,409,0,409,G
7-M,223,0,0,0,410,410,C
7-M,224,406,0,0,0,406,A
7-M,225,0,0,420,0,420,G
7-M,226,0,0,0,417,417,C
7-M,227,0,0,418,0,418,G
7-M,228,0,420,0,1,421,T
7-M,229,417,1,0,0,418,A
7-M,230,0,1,415,0,416,G
7-M,231,415,0,0,0,415,A
7-M,232,0,0,0,420,420,C
7-M,233,0,0,420,0,420,G
7-M,234,1,0,0,411,412,C
7-M,235,0,403,0,0,403,T
7-M,236,0,401,0,0,401,T
7-M,237,0,402,0,0,402,T
7-M,238,0,0,412,0,412,G
7-M,239,0,411,0,0,411,T
7-M,240,1,0,0,411,412,C
7-M,241,2,0,0,411,413,C
7-M,242,410,0,0,0,410,A
7-M,243,411,0,0,0,411,A
7-M,244,406,0,0,0,406,A
7-M,245,405,0,0,0,405,A
7-M,246,0,410,0,0,410,T
7-M,247,0,0,409,0,409,G
7-M,248,0,0,0,408,408,C
7-M,249,2,0,0,402,404,C
7-M,250,0,0,0,415,415,C
7-M,251,0,413,0,0,413,T
7-M,252,1,0,0,429,430,C
7-M,253,429,0,0,0,429,A
7-M,254,430,0,0,0,430,A
7-M,255,0,433,0,0,433,T
7-M,256,1,1,431,0,433,G
7-M,257,0,0,437,0,437,G
7-M,258,0,0,441,0,441,G
7-M,259,440,0,0,0,440,A
7-M,260,440,0,0,0,440,A
7-M,261,0,429,0,1,430,T
7-M,262,1,0,425,0,426,G
7-M,263,1,1,426,0,428,G
7-M,264,421,0,0,0,421,A
7-M,265,0,1,420,0,421,G
7-M,266,416,0,1,0,417,A
7-M,267,0,0,0,409,409,C
7-M,268,3,1,0,431,435,C
7-M,269,3,0,0,434,437,C
7-M,270,442,0,0,0,442,A
7-M,271,440,0,0,0,440,A
7-M,272,442,0,0,0,442,A
7-M,273,0,445,0,0,445,T
7-M,274,449,0,0,0,449,A
7-M,275,454,0,0,0,454,A
7-M,276,0,0,0,448,448,C
7-M,277,445,0,0,0,445,A
7-M,278,1,441,0,0,442,T
7-M,279,0,0,445,0,445,G
7-M,280,0,3,442,0,445,G
7-M,281,445,0,0,0,445,A
7-M,282,0,1,0,443,444,C
7-M,283,437,0,0,0,437,A
7-M,284,443,0,0,0,443,A
7-M,285,440,0,0,0,440,A
7-M,286,0,0,447,0,447,G
7-M,287,0,0,0,458,458,C
7-M,288,449,1,0,0,450,A
7-M,289,0,1,460,0,461,G
7-M,290,0,458,0,0,458,T
7-M,291,0,462,0,0,462,T
7-M,292,466,0,0,0,466,A
7-M,293,462,0,1,0,463,A
7-M,294,463,0,0,0,463,A
7-M,295,1,0,0,468,469,C
7-M,296,0,455,0,0,455,T
7-M,297,0,0,490,0,490,G
7-M,298,0,485,0,0,485,T
7-M,299,491,0,0,0,491,A
7-M,300,0,491,0,0,491,T
7-M,301,484,0,0,0,484,A
7-M,302,0,1,482,0,483,G
7-M,303,461,0,0,1,462,A
7-M,304,469,0,0,0,469,A
7-M,305,470,0,0,0,470,A
7-M,306,485,1,0,0,486,A
7-M,307,0,0,0,493,493,C
7-M,308,0,489,0,2,491,T
7-M,309,0,492,0,1,493,T
7-M,310,490,0,1,0,491,A
7-M,311,488,0,1,0,489,A
7-M,312,0,1,490,0,491,G
7-M,313,489,0,0,0,489,A
7-M,314,0,1,493,0,494,G
7-M,315,0,0,491,0,491,G
7-M,316,0,1,492,0,493,G
7-M,317,491,0,0,0,491,A
7-M,318,0,0,495,0,495,G
7-M,319,496,0,0,1,497,A
7-M,320,0,495,0,0,495,T
7-M,321,493,0,0,0,493,A
7-M,322,497,0,0,0,497,A
7-M,323,1,0,0,497,498,C
7-M,324,0,0,499,0,499,G
7-M,325,0,496,0,2,498,T
7-M,326,0,493,0,0,493,T
7-M,327,0,1,0,500,501,C
7-M,328,0,0,0,499,499,C
7-M,329,498,0,0,0,498,A
7-M,330,0,496,0,0,496,T
7-M,331,0,1,490,0,491,G
7-M,332,0,1,494,0,495,G
7-M,333,0,1,488,0,489,G
7-M,334,1,2,490,0,493,G
7-M,335,0,0,0,492,492,C
7-M,336,0,0,0,488,488,C
7-M,337,493,0,0,0,493,A
7-M,338,496,0,0,0,496,A
7-M,339,498,0,0,0,498,A
7-M,340,0,0,499,0,499,G
7-M,341,498,0,0,0,498,A
7-M,342,497,0,0,0,497,A
7-M,343,496,0,0,0,496,A
7-M,344,1,496,0,0,497,T
7-M,345,496,0,1,0,497,A
7-M,346,0,0,500,0,500,G
7-M,347,1,0,0,499,500,C
7-M,348,0,497,0,0,497,T
7-M,349,2,0,0,495,497,C
7-M,350,0,495,0,0,495,T
7-M,351,1,0,0,514,515,C
7-M,352,514,0,1,0,515,A
7-M,353,0,0,515,0,515,G
7-M,354,0,509,0,1,510,T
7-M,355,0,516,0,0,516,T
7-M,356,520,0,0,0,520,A
7-M,357,0,516,0,0,516,T
7-M,358,0,515,0,0,515,T
7-M,359,1,0,0,515,516,C
7-M,360,0,498,0,1,499,T
7-M,361,0,0,502,0,502,G
7-M,362,3,0,0,497,500,C
7-M,363,0,496,0,0,496,T
7-M,364,0,0,500,0,500,G
7-M,365,0,1,497,0,498,G
7-M,366,0,500,0,0,500,T
7-M,367,0,1,499,0,500,G
7-M,368,0,0,0,500,500,C
7-M,369,502,0,0,0,502,A
7-M,370,2,0,0,498,500,C
7-M,371,0,499,0,0,499,T
7-M,372,0,500,0,0,500,T
7-M,373,0,0,503,0,503,G
7-M,374,0,0,0,503,503,C
7-M,375,3,1,0,497,501,C
7-M,376,500,0,0,0,500,A
7-M,377,0,0,503,0,503,G
7-M,378,1,505,0,0,506,T
7-M,379,0,504,0,0,504,T
7-M,380,0,0,509,0,509,G
7-M,381,0,0,0,507,507,C
7-M,382,506,0,0,1,507,A
7-M,383,1,504,0,0,505,T
7-M,384,0,2,503,0,505,G
7-M,385,0,0,511,1,512,G
7-M,386,0,0,512,0,512,G
7-M,387,0,0,0,514,514,C
7-M,388,2,0,0,522,524,C
7-M,389,0,526,0,1,527,T
7-M,390,1,0,0,533,534,C
7-M,391,562,0,2,1,565,A
7-M,392,0,566,0,0,566,T
7-M,393,585,0,0,0,585,A
7-M,394,0,576,0,0,576,T
7-M,395,570,0,0,0,570,A
7-M,396,1,1,0,602,604,C
7-M,397,588,0,0,0,588,A
7-M,398,591,0,0,0,591,A
7-M,399,0,586,0,1,587,T
7-M,400,571,0,0,0,571,A
7-M,401,0,0,572,0,572,G
7-M,402,0,1,566,0,567,G
7-M,403,561,1,0,0,562,A
7-M,404,0,567,0,0,567,T
7-M,405,0,4,521,0,525,G
7-M,406,0,0,524,0,524,G
7-M,407,0,4,524,0,528,G
7-M,408,0,1,539,0,540,G
7-M,409,0,1,540,0,541,G
7-M,410,1,0,0,538,539,C
7-M,411,0,527,0,1,528,T
7-M,412,0,0,530,0,530,G
7-M,413,0,531,0,0,531,T
7-M,414,531,0,0,0,531,A
7-M,415,530,0,1,0,531,A
7-M,416,0,1,0,537,538,C
7-M,417,1,0,0,527,528,C
7-M,418,526,0,1,0,527,A
7-M,419,1,0,0,529,530,C
7-M,420,0,529,0,0,529,T
7-M,421,0,1,531,0,532,G
7-M,422,531,0,0,0,531,A
7-M,423,526,0,0,0,526,A
7-M,424,0,1,527,0,528,G
7-M,425,0,524,0,1,525,T
7-M,426,0,0,522,0,522,G
7-M,427,0,0,523,0,523,G
7-M,428,1,1,0,522,524,C
7-M,429,526,0,0,0,526,A
7-M,430,0,524,0,0,524,T
7-M,431,0,523,0,0,523,T
7-M,432,0,523,0,0,523,T
7-M,433,0,0,530,0,530,G
7-M,434,0,0,530,0,530,G
7-M,435,0,0,1,523,524,C
7-M,436,1,0,0,522,523,C
7-M,437,0,522,0,0,522,T
7-M,438,0,1,540,0,541,G
7-M,439,0,0,547,0,547,G
7-M,440,0,548,0,0,548,T
7-M,441,554,0,0,0,554,A
7-M,442,0,533,0,0,533,T
7-M,443,0,1,539,0,540,G
7-M,444,0,545,0,0,545,T
7-M,445,0,0,545,0,545,G
7-M,446,1,0,0,543,544,C
7-M,447,532,0,0,0,532,A
7-M,448,530,0,0,0,530,A
7-M,449,0,0,0,533,533,C
7-M,450,530,0,0,0,530,A
7-M,451,0,528,0,3,531,T
7-M,452,0,1,524,0,525,G
7-M,453,0,521,0,0,521,T
7-M,454,0,2,518,0,520,G
7-M,455,512,0,0,0,512,A
7-M,456,1,0,516,0,517,G
7-M,457,1,0,0,516,517,C
7-M,458,501,0,0,0,501,A
7-M,459,0,2,505,0,507,G
7-M,460,501,0,0,0,501,A
7-M,461,0,501,0,0,501,T
7-M,462,0,499,0,0,499,T
7-M,463,0,0,497,0,497,G
7-M,464,0,0,0,499,499,C
7-M,465,0,498,0,1,499,T
7-M,466,0,2,498,0,500,G
7-M,467,495,1,0,0,496,A
7-M,468,1,1,0,528,530,C
7-M,469,0,529,0,0,529,T
7-M,470,4,0,0,524,528,C
7-M,471,0,0,0,529,529,C
7-M,472,3,1,0,531,535,C
7-M,473,532,0,0,0,532,A
7-M,474,0,0,542,0,542,G
7-M,475,3,0,0,538,541,C
7-M,476,542,0,0,0,542,A
7-M,477,1,0,0,542,543,C
7-M,478,508,0,0,0,508,A
7-M,479,0,2,516,0,518,G
7-M,480,0,0,518,0,518,G
7-M,481,0,514,0,0,514,T
7-M,482,1,0,0,518,519,C
7-M,483,0,513,0,1,514,T
7-M,484,2,0,0,514,516,C
7-M,485,516,0,0,0,516,A
7-M,486,0,516,0,0,516,T
7-M,487,512,0,1,0,513,A
7-M,488,0,0,505,0,505,G
7-M,489,0,0,497,0,497,G
7-M,490,0,2,0,499,501,C
7-M,491,490,0,0,0,490,A
7-M,492,0,1,480,1,482,G
7-M,493,486,0,1,0,487,A
7-M,494,0,487,0,0,487,T
7-M,495,0,6,482,0,488,G
7-M,496,1,0,486,0,487,G
7-M,497,0,483,0,0,483,T
7-M,498,0,3,480,0,483,G
7-M,499,0,0,479,0,479,G
7-M,500,0,0,0,484,484,C
7-M,501,478,0,1,0,479,A
7-M,502,480,0,0,0,480,A
7-M,503,1,0,0,486,487,C
7-M,504,486,0,1,0,487,A
7-M,505,488,1,0,0,489,A
7-M,506,0,0,0,487,487,C
7-M,507,1,0,0,485,486,C
7-M,508,480,0,0,0,480,A
7-M,509,480,0,0,0,480,A
7-M,510,0,479,0,0,479,T
7-M,511,0,0,0,480,480,C
7-M,512,1,0,0,477,478,C
7-M,513,474,0,0,0,474,A
7-M,514,0,473,0,0,473,T
7-M,515,0,476,0,0,476,T
7-M,516,475,0,1,0,476,A
7-M,517,473,0,0,0,473,A
7-M,518,0,475,0,0,475,T
7-M,519,473,0,0,0,473,A
7-M,520,471,0,0,1,472,A
7-M,521,465,0,1,0,466,A
7-M,522,470,0,0,0,470,A
7-M,523,0,0,0,484,484,C
7-M,524,483,0,0,0,483,A
7-M,525,0,480,0,0,480,T
7-M,526,0,3,480,0,483,G
7-M,527,482,0,1,0,483,A
7-M,528,0,3,485,0,488,G
7-M,529,487,0,0,0,487,A
7-M,530,487,0,0,0,487,A
7-M,531,0,0,0,489,489,C
7-M,532,475,1,0,0,476,A
7-M,533,0,0,488,0,488,G
7-M,534,488,0,0,0,488,A
7-M,535,488,0,0,0,488,A
7-M,536,0,487,0,0,487,T
7-M,537,0,3,481,0,484,G
7-M,538,0,0,480,0,480,G
7-M,539,0,479,0,0,479,T
7-M,540,0,472,0,0,472,T
7-M,541,1,480,1,1,483,T
7-M,542,0,483,0,0,483,T
7-M,543,1,0,486,0,487,G
7-M,544,0,2,484,0,486,G
7-M,545,2,0,0,481,483,C
7-M,546,1,0,0,482,483,C
7-M,547,475,1,0,0,476,A
7-M,548,1,2,487,0,490,G
7-M,549,0,0,0,484,484,C
7-M,550,491,0,0,0,491,A
7-M,551,0,0,0,504,504,C
7-M,552,0,495,0,1,496,T
7-M,553,500,0,0,0,500,A
7-M,554,1,0,0,506,507,C
7-M,555,518,0,0,0,518,A
7-M,556,0,0,532,0,532,G
7-M,557,0,0,0,516,516,C
7-M,558,0,513,0,0,513,T
7-M,559,513,0,0,0,513,A
7-M,560,504,0,1,0,505,A
7-M,561,0,1,510,0,511,G
7-M,562,0,0,514,0,514,G
7-M,563,0,2,0,503,505,C
7-M,564,0,483,0,0,483,T
7-M,565,482,0,0,0,482,A
7-M,566,0,479,0,0,479,T
7-M,567,0,1,481,0,482,G
7-M,568,0,0,485,0,485,G
7-M,569,479,0,0,0,479,A
7-M,570,0,0,479,0,479,G
7-M,571,0,1,0,473,474,C
7-M,572,475,0,0,0,475,A
7-M,573,474,0,1,0,475,A
7-M,574,471,0,1,0,472,A
7-M,575,0,478,0,0,478,T
7-M,576,0,1,477,0,478,G
7-M,577,0,0,473,0,473,G
7-M,578,0,0,0,475,475,C
7-M,579,0,473,0,1,474,T
7-M,580,0,1,471,0,472,G
7-M,581,0,1,484,0,485,G
7-M,582,486,1,0,0,487,A
7-M,583,0,485,0,0,485,T
7-M,584,1,0,1,479,481,C
7-M,585,481,0,0,0,481,A
7-M,586,482,0,0,0,482,A
7-M,587,2,0,480,0,482,G
7-M,588,0,478,0,0,478,T
7-M,589,0,2,478,0,480,G
7-M,590,473,0,0,0,473,A
7-M,591,0,0,474,0,474,G
7-M,592,0,0,0,473,473,C
7-M,593,472,0,0,0,472,A
7-M,594,0,0,473,0,473,G
7-M,595,0,0,468,0,468,G
7-M,596,1,0,0,467,468,C
7-M,597,469,0,0,0,469,A
7-M,598,0,0,470,0,470,G
7-M,599,2,1,0,463,466,C
7-M,600,0,1,467,0,468,G
7-M,601,1,0,469,0,470,G
7-M,602,469,0,0,0,469,A
7-M,603,0,1,468,0,469,G
7-M,604,0,1,472,0,473,G
7-M,605,0,0,0,471,471,C
7-M,606,0,0,0,470,470,C
7-M,607,466,0,0,0,466,A
7-M,608,0,464,0,2,466,T
7-M,609,0,0,467,0,467,G
7-M,610,0,1,463,0,464,G
7-M,611,465,0,0,0,465,A
7-M,612,0,1,468,0,469,G
7-M,613,457,0,0,0,457,A
7-M,614,1,465,0,1,467,T
7-M,615,0,463,0,0,463,T
7-M,616,0,0,464,0,464,G
7-M,617,0,0,0,462,462,C
7-M,618,0,464,0,0,464,T
7-M,619,468,0,0,0,468,A
7-M,620,0,0,469,0,469,G
7-M,621,0,464,0,0,464,T
7-M,622,3,0,0,461,464,C
7-M,623,449,0,0,0,449,A
7-M,624,0,3,449,0,452,G
7-M,625,0,0,453,0,453,G
7-M,626,0,0,0,450,450,C
7-M,627,1,0,0,450,451,C
7-M,628,452,0,0,0,452,A
7-M,629,1,1,453,0,455,G
7-M,630,0,0,452,0,452,G
7-M,631,0,1,0,452,453,C
7-M,632,454,0,0,0,454,A
7-M,633,1,0,449,0,450,G
7-M,634,446,0,2,0,448,A
7-M,635,0,450,0,0,450,T
7-M,636,0,2,448,0,450,G
7-M,637,0,0,465,0,465,G
7-M,638,0,460,0,0,460,T
7-M,639,0,0,457,0,457,G
7-M,640,1,1,0,455,457,C
7-M,641,456,0,0,0,456,A
7-M,642,0,3,458,0,461,G
7-M,643,0,0,457,0,457,G
7-M,644,0,0,0,454,454,C
7-M,645,451,0,0,0,451,A
7-M,646,440,0,0,0,440,A
7-M,647,0,435,0,0,435,T
7-M,648,0,4,432,0,436,G
7-M,649,432,0,0,0,432,A
7-M,650,0,2,429,0,431,G
7-M,651,424,0,0,0,424,A
7-M,652,0,0,426,0,426,G
7-M,653,0,1,0,427,428,C
7-M,654,0,0,0,431,431,C
7-M,655,431,0,0,0,431,A
7-M,656,0,432,0,0,432,T
7-M,657,0,431,0,0,431,T
7-M,658,0,3,428,0,431,G
7-M,659,0,0,430,0,430,G
7-M,660,0,0,432,0,432,G
7-M,661,435,1,0,0,436,A
7-M,662,1,0,0,435,436,C
7-M,663,0,424,0,0,424,T
7-M,664,0,0,0,424,424,C
7-M,665,424,0,0,0,424,A
7-M,666,1,433,0,1,435,T
7-M,667,0,0,0,438,438,C
7-M,668,0,0,0,437,437,C
7-M,669,0,438,0,0,438,T
7-M,670,438,0,0,0,438,A
7-M,671,0,0,448,0,448,G
7-M,672,0,495,0,0,495,T
7-M,673,0,491,0,1,492,T
7-M,674,1,0,0,484,485,C
7-M,675,4,1,0,477,482,C
7-M,676,478,0,1,0,479,A
7-M,677,0,0,489,0,489,G
7-M,678,0,486,0,0,486,T
7-M,679,485,0,0,0,485,A
7-M,680,1,0,0,485,486,C
7-M,681,0,442,0,0,442,T
7-M,682,1,2,458,0,461,G
7-M,683,0,0,472,0,472,G
7-M,684,0,473,0,0,473,T
7-M,685,2,0,0,468,470,C
7-M,686,0,464,0,0,464,T
7-M,687,464,0,0,0,464,A
7-M,688,462,0,1,0,463,A
7-M,689,0,2,465,0,467,G
7-M,690,457,0,0,0,457,A
7-M,691,0,0,449,0,449,G
7-M,692,424,0,0,0,424,A
7-M,693,0,426,0,0,426,T
7-M,694,0,2,424,0,426,G
7-M,695,424,0,0,0,424,A
7-M,696,0,418,0,0,418,T
7-M,697,0,0,0,421,421,C
7-M,698,0,417,0,0,417,T
7-M,699,0,420,0,0,420,T
7-M,700,0,0,0,419,419,C
7-M,701,0,417,0,0,417,T
7-M,702,0,417,0,0,417,T
7-M,703,0,0,415,0,415,G
7-M,704,414,0,0,0,414,A
7-M,705,411,0,0,0,411,A
7-M,706,412,0,0,0,412,A
7-M,707,413,0,0,0,413,A
7-M,708,0,420,0,0,420,T
7-M,709,0,420,0,0,420,T
7-M,710,0,420,0,0,420,T
7-M,711,0,1,417,0,418,G
7-M,712,0,0,0,418,418,C
7-M,713,420,0,1,0,421,A
7-M,714,0,0,425,0,425,G
7-M,715,423,0,0,0,423,A
7-M,716,0,0,0,439,439,C
7-M,717,4,0,0,436,440,C
7-M,718,0,443,0,1,444,T
7-M,719,448,0,0,0,448,A
7-M,720,0,447,0,0,447,T
7-M,721,1,0,0,445,446,C
7-M,722,445,0,0,0,445,A
7-M,723,0,2,447,0,449,G
7-M,724,446,0,0,0,446,A
7-M,725,436,0,0,0,436,A
7-M,726,437,0,0,0,437,A
7-M,727,0,1,0,434,435,C
7-M,728,0,1,439,0,440,G
7-M,729,430,0,2,0,432,A
7-M,730,435,0,0,0,435,A
7-M,731,0,435,0,0,435,T
7-M,732,0,1,436,0,437,G
7-M,733,0,0,438,0,438,G
7-M,734,0,0,438,0,438,G
7-M,735,0,2,436,0,438,G
7-M,736,0,0,441,0,441,G
7-M,737,0,433,0,1,434,T
7-M,738,0,0,431,0,431,G
7-M,739,0,0,0,433,433,C
7-M,740,430,0,0,0,430,A
7-M,741,0,0,434,0,434,G
7-M,742,425,0,0,0,425,A
7-M,743,0,424,0,0,424,T
7-M,744,0,1,422,1,424,G
7-M,745,0,0,0,421,421,C
7-M,746,419,0,0,0,419,A
7-M,747,416,0,1,0,417,A
7-M,748,1,0,0,415,416,C
7-M,749,0,1,418,0,419,G
7-M,750,422,0,0,0,422,A
7-M,751,0,421,0,0,421,T
7-M,752,0,421,0,0,421,T
7-M,753,1,0,0,424,425,C
7-M,754,417,0,0,0,417,A
7-M,755,417,0,0,0,417,A
7-M,756,0,1,417,0,418,G
7-M,757,0,406,0,0,406,T
7-M,758,0,3,403,0,406,G
7-M,759,403,0,0,0,403,A
7-M,760,0,0,0,402,402,C
7-M,761,1,0,0,398,399,C
7-M,762,4,2,0,395,401,C
7-M,763,0,1,402,0,403,G
7-M,764,0,0,0,403,403,C
7-M,765,0,402,0,1,403,T
7-M,766,1,401,0,0,402,T
7-M,767,0,0,405,0,405,G
7-M,768,0,403,0,0,403,T
7-M,769,0,399,0,0,399,T
7-M,770,0,0,401,0,401,G
7-M,771,0,392,0,0,392,T
7-M,772,0,385,0,0,385,T
7-M,773,0,1,384,0,385,G
7-M,774,0,0,0,380,380,C
7-M,775,2,2,0,374,378,C
7-M,776,1,0,382,0,383,G
7-M,777,0,0,0,381,381,C
7-M,778,0,1,382,0,383,G
7-M,779,384,0,0,0,384,A
7-M,780,386,0,0,0,386,A
7-M,781,0,390,0,0,390,T
7-M,782,389,0,0,0,389,A
7-M,783,1,391,0,0,392,T
7-M,784,1,1,0,395,397,C
7-M,785,395,0,0,0,395,A
7-M,786,0,397,0,0,397,T
7-M,787,1,391,0,0,392,T
7-M,788,1,0,387,0,388,G
7-M,789,0,2,383,0,385,G
7-M,790,0,0,386,0,386,G
7-M,791,388,0,0,0,388,A
7-M,792,0,386,0,0,386,T
7-M,793,1,0,0,378,379,C
7-M,794,0,376,0,1,377,T
7-M,795,0,375,0,0,375,T
7-M,796,0,0,378,0,378,G
7-M,797,0,0,0,379,379,C
7-M,798,378,0,0,0,378,A
7-M,799,0,0,0,378,378,C
7-M,800,0,371,0,0,371,T
7-M,801,0,371,0,1,372,T
7-M,802,0,4,368,0,372,G
7-M,803,369,0,0,0,369,A
7-M,804,0,374,0,0,374,T
7-M,805,368,0,1,0,369,A
7-M,806,0,370,0,0,370,T
7-M,807,0,365,0,0,365,T
7-M,808,1,1,366,0,368,G
7-M,809,0,364,0,0,364,T
7-M,810,0,2,357,0,359,G
7-M,811,0,1,361,0,362,G
7-M,812,350,0,0,0,350,A
7-M,813,0,352,0,0,352,T
7-M,814,0,352,0,0,352,T
7-M,815,0,0,0,350,350,C
7-M,816,0,349,0,2,351,T
7-M,817,0,349,0,0,349,T
7-M,818,0,0,348,0,348,G
7-M,819,345,0,0,0,345,A
7-M,820,0,346,0,0,346,T
7-M,821,2,0,0,342,344,C
7-M,822,0,0,343,0,343,G
7-M,823,0,343,0,1,344,T
7-M,824,0,0,0,341,341,C
7-M,825,0,339,0,2,341,T
7-M,826,0,342,0,0,342,T
7-M,827,0,344,0,0,344,T
7-M,828,0,343,0,0,343,T
7-M,829,0,343,0,0,343,T
7-M,830,0,342,0,0,342,T
7-M,831,0,340,0,2,342,T
7-M,832,1,0,0,342,343,C
7-M,833,339,0,0,0,339,A
7-M,834,341,0,0,0,341,A
7-M,835,340,0,0,0,340,A
7-M,836,0,339,0,1,340,T
7-M,837,0,0,343,0,343,G
7-M,838,0,0,0,342,342,C
7-M,839,1,0,341,0,342,G
7-M,840,0,354,0,0,354,T
7-M,841,2,0,0,353,355,C
7-M,842,0,355,0,0,355,T
7-M,843,355,0,0,0,355,A
7-M,844,0,354,0,1,355,T
7-M,845,0,0,0,352,352,C
7-M,846,0,1,350,0,351,G
7-M,847,350,0,0,0,350,A
7-M,848,0,0,0,349,349,C
7-M,849,0,340,0,0,340,T
7-M,850,2,0,0,345,347,C
7-M,851,0,345,0,1,346,T
7-M,852,0,347,0,0,347,T
7-M,853,1,0,0,346,347,C
7-M,854,348,0,0,0,348,A
7-M,855,349,0,0,0,349,A
7-M,856,347,1,0,0,348,A
7-M,857,0,0,0,346,346,C
7-M,858,346,0,0,0,346,A
7-M,859,0,0,0,330,330,C
7-M,860,1,2,323,0,326,G
7-M,861,0,0,343,0,343,G
7-M,862,0,0,0,342,342,C
7-M,863,2,0,0,345,347,C
7-M,864,0,345,0,1,346,T
7-M,865,0,348,0,0,348,T
7-M,866,348,0,0,0,348,A
7-M,867,349,0,0,0,349,A
7-M,868,347,0,0,0,347,A
7-M,869,347,0,0,0,347,A
7-M,870,0,0,338,0,338,G
7-M,871,286,0,1,0,287,A
7-M,872,0,2,286,0,288,G
7-M,873,0,1,286,0,287,G
7-M,874,0,0,0,285,285,C
7-M,875,0,0,0,283,283,C
7-M,876,1,0,0,283,284,C
7-M,877,0,282,0,1,283,T
7-M,878,0,284,0,0,284,T
7-M,879,0,0,0,283,283,C
7-M,880,0,286,0,0,286,T
7-M,881,282,0,0,0,282,A
7-M,882,0,0,0,282,282,C
7-M,883,0,0,278,0,278,G
7-M,884,0,1,277,0,278,G
7-M,885,269,0,1,0,270,A
7-M,886,272,0,0,0,272,A
7-M,887,0,1,269,0,270,G
7-M,888,0,2,267,0,269,G
7-M,889,262,0,0,0,262,A
7-M,890,0,0,263,0,263,G
7-M,891,0,261,0,0,261,T
7-M,892,260,0,0,0,260,A
7-M,893,1,0,0,257,258,C
7-M,894,0,0,0,259,259,C
7-M,895,0,255,0,0,255,T
7-M,896,1,1,252,0,254,G
7-M,897,243,0,0,0,243,A
7-M,898,0,0,248,0,248,G
7-M,899,0,231,0,1,232,T
7-M,900,1,0,0,233,234,C
7-M,901,1,227,0,0,228,T
7-M,902,227,0,0,0,227,A
7-M,903,0,225,0,0,225,T
7-M,904,0,0,226,0,226,G
7-M,905,219,0,0,0,219,A
7-M,906,0,2,215,0,217,G
7-M,907,0,0,200,0,200,G
7-M,908,0,1,199,0,200,G
7-M,909,196,0,2,1,199,A
7-M,910,197,0,0,0,197,A
7-M,911,0,0,198,0,198,G
7-M,912,196,0,0,0,196,A
7-M,913,196,0,1,0,197,A
7-M,914,0,193,0,0,193,T
7-M,915,192,0,0,0,192,A
7-M,916,0,192,0,0,192,T
7-M,917,1,1,0,188,190,C
7-M,918,0,0,190,0,190,G
7-M,919,189,0,0,0,189,A
7-M,920,185,0,0,0,185,A
7-M,921,186,0,0,0,186,A
7-M,922,0,1,183,1,185,G
7-M,923,0,0,186,0,186,G
7-M,924,184,0,0,0,184,A
7-M,925,184,0,1,0,185,A
7-M,926,1,0,0,184,185,C
7-M,927,179,0,0,0,179,A
7-M,928,0,0,180,0,180,G
7-M,929,1,0,0,178,179,C
7-M,930,177,0,0,0,177,A
7-M,931,0,0,178,0,178,G
7-M,932,169,0,0,0,169,A
7-M,933,169,0,0,0,169,A
7-M,934,0,170,0,0,170,T
7-M,935,0,0,170,0,170,G
7-M,936,0,0,0,171,171,C
7-M,937,0,165,0,0,165,T
7-M,938,0,0,165,0,165,G
7-M,939,0,164,0,0,164,T
7-M,940,0,2,161,0,163,G
7-M,941,0,2,161,0,163,G
7-M,942,154,0,0,0,154,A
7-M,943,0,151,0,0,151,T
7-M,944,0,0,146,0,146,G
7-M,945,0,0,0,143,143,C
7-M,946,0,139,0,0,139,T
7-M,947,0,1,138,0,139,G
7-M,948,136,0,0,0,136,A
7-M,949,0,0,0,136,136,C
7-M,950,0,0,131,0,131,G
7-M,951,130,0,0,0,130,A
7-M,952,0,0,0,129,129,C
7-M,953,124,0,0,0,124,A
7-M,954,0,0,123,0,123,G
7-M,955,0,121,0,0,121,T
7-M,956,2,0,0,116,118,C
7-M,957,118,0,0,1,119,A
7-M,958,0,118,0,0,118,T
7-M,959,0,118,0,0,118,T
7-M,960,0,118,0,0,118,T
7-M,961,0,116,0,0,116,T
7-M,962,0,0,116,0,116,G
7-M,963,0,107,0,0,107,T
7-M,964,0,0,0,107,107,C
7-M,965,99,0,0,0,99,A
7-M,966,0,0,101,0,101,G
7-M,967,0,0,0,101,101,C
7-M,968,101,0,0,0,101,A
7-M,969,0,101,0,0,101,T
7-M,970,96,0,0,0,96,A
7-M,971,0,0,96,0,96,G
7-M,972,93,0,0,0,93,A
7-M,973,0,0,93,0,93,G
7-M,974,0,92,0,0,92,T
7-M,975,0,59,0,0,59,T
7-M,976,0,0,59,0,59,G
7-M,977,0,0,59,0,59,G
7-M,978,59,0,0,0,59,A
7-M,979,0,0,59,0,59,G
7-M,980,0,33,0,0,33,T
7-M,981,29,0,0,0,29,A
7-M,982,29,0,0,0,29,A
8-NS,1,185,0,0,0,185,A
8-NS,2,0,185,0,0,185,T
8-NS,3,0,0,191,0,191,G
8-NS,4,0,0,205,0,205,G
8-NS,5,220,0,0,0,220,A
8-NS,6,0,462,0,1,463,T
8-NS,7,0,462,0,0,462,T
8-NS,8,0,0,0,477,477,C
8-NS,9,0,0,0,478,478,C
8-NS,10,478,0,0,0,478,A
8-NS,11,480,0,0,0,480,A
8-NS,12,0,0,0,481,481,C
8-NS,13,482,0,0,0,482,A
8-NS,14,0,0,0,484,484,C
8-NS,15,0,484,0,0,484,T
8-NS,16,1,1,551,0,553,G
8-NS,17,0,554,0,0,554,T
8-NS,18,0,0,560,0,560,G
8-NS,19,0,558,0,2,560,T
8-NS,20,3,0,0,557,560,C
8-NS,21,561,0,1,0,562,A
8-NS,22,564,0,2,0,566,A
8-NS,23,0,0,578,0,578,G
8-NS,24,0,585,0,0,585,T
8-NS,25,0,588,0,0,588,T
8-NS,26,0,592,0,0,592,T
8-NS,27,0,1,0,593,594,C
8-NS,28,0,0,0,599,599,C
8-NS,29,595,0,1,0,596,A
8-NS,30,0,4,601,1,606,G
8-NS,31,0,0,610,0,610,G
8-NS,32,0,608,0,2,610,T
8-NS,33,610,0,0,0,610,A
8-NS,34,0,0,615,0,615,G
8-NS,35,615,0,1,0,616,A
8-NS,36,0,621,0,0,621,T
8-NS,37,0,621,0,0,621,T
8-NS,38,0,0,629,0,629,G
8-NS,39,0,1,0,630,631,C
8-NS,40,0,631,0,0,631,T
8-NS,41,0,636,0,0,636,T
8-NS,42,0,641,0,0,641,T
8-NS,43,0,0,0,649,649,C
8-NS,44,0,644,0,1,645,T
8-NS,45,0,647,0,0,647,T
8-NS,46,0,646,0,0,646,T
8-NS,47,0,3,648,0,651,G
8-NS,48,0,0,651,0,651,G
8-NS,49,1,1,0,651,653,C
8-NS,50,650,0,1,0,651,A
8-NS,51,0,656,0,0,656,T
8-NS,52,665,0,0,0,665,A
8-NS,53,0,675,0,0,675,T
8-NS,54,1,0,0,676,677,C
8-NS,55,14,1,0,662,677,C
8-NS,56,0,5,670,0,675,G
8-NS,57,1,1,678,0,680,G
8-NS,58,680,1,0,0,681,A
8-NS,59,683,0,1,0,684,A
8-NS,60,684,0,0,0,684,A
8-NS,61,1,0,0,693,694,C
8-NS,62,692,0,1,0,693,A
8-NS,63,695,0,0,0,695,A
8-NS,64,0,1,728,0,729,G
8-NS,65,0,729,0,0,729,T
8-NS,66,0,727,0,0,727,T
8-NS,67,1,3,728,0,732,G
8-NS,68,0,730,0,0,730,T
8-NS,69,733,0,1,0,734,A
8-NS,70,0,2,738,0,740,G
8-NS,71,784,0,1,0,785,A
8-NS,72,1,0,0,792,793,C
8-NS,73,3,0,0,784,787,C
8-NS,74,787,1,0,0,788,A
8-NS,75,795,1,0,0,796,A
8-NS,76,0,3,828,0,831,G
8-NS,77,835,0,0,0,835,A
8-NS,78,843,0,0,0,843,A
8-NS,79,1,0,0,843,844,C
8-NS,80,0,821,0,0,821,T
8-NS,81,0,4,832,0,836,G
8-NS,82,833,0,1,0,834,A
8-NS,83,0,1,843,0,844,G
8-NS,84,0,846,0,0,846,T
8-NS,85,0,0,834,0,834,G
8-NS,86,839,0,0,0,839,A
8-NS,87,0,837,0,0,837,T
8-NS,88,2,0,845,1,848,G
8-NS,89,3,0,0,868,871,C
8-NS,90,4,1,1,869,875,C
8-NS,91,4,2,0,874,880,C
8-NS,92,4,0,0,876,880,C
8-NS,93,881,0,0,0,881,A
8-NS,94,0,899,0,0,899,T
8-NS,95,0,902,0,2,904,T
8-NS,96,2,0,0,906,908,C
8-NS,97,2,0,0,898,900,C
8-NS,98,0,900,0,3,903,T
8-NS,99,0,902,0,0,902,T
8-NS,100,0,2,896,0,898,G
8-NS,101,895,0,0,0,895,A
8-NS,102,0,897,0,0,897,T
8-NS,103,1,0,0,889,890,C
8-NS,104,1,2,880,0,883,G
8-NS,105,0,0,894,0,894,G
8-NS,106,1,0,0,895,896,C
8-NS,107,0,890,0,0,890,T
8-NS,108,0,897,0,0,897,T
8-NS,109,4,3,0,888,895,C
8-NS,110,0,0,895,0,895,G
8-NS,111,1,0,0,896,897,C
8-NS,112,3,1,0,891,895,C
8-NS,113,0,1,896,0,897,G
8-NS,114,891,0,0,0,891,A
8-NS,115,0,1,931,0,932,G
8-NS,116,935,0,0,0,935,A
8-NS,117,0,935,0,0,935,T
8-NS,118,2,2,0,934,938,C
8-NS,119,935,0,1,0,936,A
8-NS,120,2,2,936,0,940,G
8-NS,121,935,0,0,0,935,A
8-NS,122,1,3,937,0,941,G
8-NS,123,0,0,965,0,965,G
8-NS,124,0,965,0,1,966,T
8-NS,125,2,0,1,1020,1023,C
8-NS,126,3,0,0,1021,1024,C
8-NS,127,2,0,0,1028,1030,C
8-NS,128,0,1031,0,0,1031,T
8-NS,129,1031,0,1,0,1032,A
8-NS,130,1033,0,0,0,1033,A
8-NS,131,0,2,1046,0,1048,G
8-NS,132,0,5,1042,1,1048,G
8-NS,133,0,7,1035,0,1042,G
8-NS,134,0,1,1025,0,1026,G
8-NS,135,1025,0,0,0,1025,A
8-NS,136,1022,0,0,0,1022,A
8-NS,137,1,3,1022,0,1026,G
8-NS,138,1033,1,3,0,1037,A
8-NS,139,0,2,1045,0,1047,G
8-NS,140,0,3,1043,0,1046,G
8-NS,141,1,0,0,1040,1041,C
8-NS,142,1035,0,0,1,1036,A
8-NS,143,1037,0,1,0,1038,A
8-NS,144,0,1039,0,0,1039,T
8-NS,145,1049,0,0,1,1050,A
8-NS,146,2,0,0,1063,1065,C
8-NS,147,0,1039,0,0,1039,T
8-NS,148,0,0,0,1044,1044,C
8-NS,149,0,1031,0,0,1031,T
8-NS,150,3,2,0,1033,1038,C
8-NS,151,0,12,1038,0,1050,G
8-NS,152,1,0,1110,0,1111,G
8-NS,153,0,1109,0,0,1109,T
8-NS,154,1,0,0,1108,1109,C
8-NS,155,0,1108,0,1,1109,T
8-NS,156,1112,0,0,0,1112,A
8-NS,157,0,3,1113,1,1117,G
8-NS,158,1113,0,1,0,1114,A
8-NS,159,0,0,0,1144,1144,C
8-NS,160,1124,1,0,0,1125,A
8-NS,161,0,1107,0,0,1107,T
8-NS,162,2,0,0,1101,1103,C
8-NS,163,1105,0,0,0,1105,A
8-NS,164,1107,0,0,0,1107,A
8-NS,165,1100,0,1,1,1102,A
8-NS,166,0,1,1101,0,1102,G
8-NS,167,0,1,0,1104,1105,C
8-NS,168,1082,0,1,0,1083,A
8-NS,169,0,1,1095,0,1096,G
8-NS,170,1,0,1,1094,1096,C
8-NS,171,0,0,0,1100,1100,C
8-NS,172,1103,2,1,0,1106,A
8-NS,173,2,2,0,1117,1121,C
8-NS,174,2,0,0,1117,1119,C
8-NS,175,2,0,1,1116,1119,C
8-NS,176,1137,3,0,0,1140,A
8-NS,177,0,1137,0,0,1137,T
8-NS,178,2,1,1135,0,1138,G
8-NS,179,0,1137,0,1,1138,T
8-NS,180,0,1131,0,1,1132,T
8-NS,181,1,3,1125,1,1130,G
8-NS,182,0,2,1123,0,1125,G
8-NS,183,1118,1,0,1,1120,A
8-NS,184,1118,1,0,0,1119,A
8-NS,185,1098,0,1,0,1099,A
8-NS,186,0,0,1110,0,1110,G
8-NS,187,0,0,0,1107,1107,C
8-NS,188,1107,0,0,0,1107,A
8-NS,189,1099,0,0,0,1099,A
8-NS,190,1099,0,1,0,1100,A
8-NS,191,0,1115,0,0,1115,T
8-NS,192,0,1112,0,0,1112,T
8-NS,193,1,2,1136,0,1139,G
8-NS,194,0,1132,0,0,1132,T
8-NS,195,1130,0,2,2,1134,A
8-NS,196,11,2,1119,0,1132,G
8-NS,197,1135,0,0,0,1135,A
8-NS,198,1124,1,3,1,1129,A
8-NS,199,1130,0,0,1,1131,A
8-NS,200,1123,0,3,0,1126,A
8-NS,201,0,1,1128,0,1129,G
8-NS,202,1115,0,0,0,1115,A
8-NS,203,1,1110,0,2,1113,T
8-NS,204,0,1111,0,0,1111,T
8-NS,205,2,0,0,1114,1116,C
8-NS,206,1,1110,0,1,1112,T
8-NS,207,0,1,1122,0,1123,G
8-NS,208,1121,0,0,0,1121,A
8-NS,209,1118,1,1,1,1121,A
8-NS,210,1118,0,0,0,1118,A
8-NS,211,0,4,1114,0,1118,G
8-NS,212,1113,0,0,0,1113,A
8-NS,213,1114,0,1,0,1115,A
8-NS,214,0,1,1123,0,1124,G
8-NS,215,1129,1,0,0,1130,A
8-NS,216,1133,0,1,0,1134,A
8-NS,217,0,1126,0,0,1126,T
8-NS,218,2,0,0,1145,1147,C
8-NS,219,0,1143,0,0,1143,T
8-NS,220,2,3,1136,0,1141,G
8-NS,221,1138,0,5,0,1143,A
8-NS,222,0,1145,0,0,1145,T
8-NS,223,1,0,1141,0,1142,G
8-NS,224,1133,1,0,0,1134,A
8-NS,225,0,3,1125,0,1128,G
8-NS,226,0,1,1134,0,1135,G
8-NS,227,0,0,0,1129,1129,C
8-NS,228,1135,1,1,0,1137,A
8-NS,229,0,0,0,1167,1167,C
8-NS,230,0,1163,0,0,1163,T
8-NS,231,0,1170,0,0,1170,T
8-NS,232,1177,0,0,0,1177,A
8-NS,233,1179,0,0,0,1179,A
8-NS,234,1176,0,0,0,1176,A
8-NS,235,1178,1,1,1,1181,A
8-NS,236,0,1180,0,1,1181,T
8-NS,237,0,9,1168,0,1177,G
8-NS,238,1177,0,0,0,1177,A
8-NS,239,1,0,0,1180,1181,C
8-NS,240,3,0,0,1164,1167,C
8-NS,241,1171,0,2,0,1173,A
8-NS,242,0,1173,0,0,1173,T
8-NS,243,0,3,1197,0,1200,G
8-NS,244,0,2,1217,0,1219,G
8-NS,245,0,1220,0,1,1221,T
8-NS,246,4,1,0,1289,1294,C
8-NS,247,0,1283,0,6,1289,T
8-NS,248,6,2,0,1316,1324,C
8-NS,249,3,0,0,1324,1327,C
8-NS,250,1333,0,1,0,1334,A
8-NS,251,3,1,0,1337,1341,C
8-NS,252,1315,6,0,0,1321,A
8-NS,253,2,1,0,1319,1322,C
8-NS,254,2,0,0,1309,1311,C
8-NS,255,0,1271,0,0,1271,T
8-NS,256,0,2,1276,0,1278,G
8-NS,257,0,0,0,1270,1270,C
8-NS,258,0,1261,0,0,1261,T
8-NS,259,0,1268,0,0,1268,T
8-NS,260,3,2,0,1255,1260,C
8-NS,261,1,1,1267,0,1269,G
8-NS,262,1,1,0,1266,1268,C
8-NS,263,2,4,1265,0,1271,G
8-NS,264,1326,0,1,0,1327,A
8-NS,265,0,1326,0,1,1327,T
8-NS,266,1364,0,1,1,1366,A
8-NS,267,0,1,1,1372,1374,C
8-NS,268,1369,1,0,0,1370,A
8-NS,269,0,1398,0,0,1398,T
8-NS,270,1394,0,0,0,1394,A
8-NS,271,1397,1,2,0,1400,A
8-NS,272,1,0,0,1398,1399,C
8-NS,273,0,1362,0,0,1362,T
8-NS,274,1,3,1376,0,1380,G
8-NS,275,1357,0,2,0,1359,A
8-NS,276,1,0,0,1367,1368,C
8-NS,277,1365,0,0,0,1365,A
8-NS,278,0,1344,0,1,1345,T
8-NS,279,0,4,1349,0,1353,G
8-NS,280,1351,0,1,0,1352,A
8-NS,281,1,0,0,1388,1389,C
8-NS,282,0,1392,0,0,1392,T
8-NS,283,1411,0,1,0,1412,A
8-NS,284,0,1410,0,0,1410,T
8-NS,285,1,1399,0,0,1400,T
8-NS,286,1,5,1398,0,1404,G
8-NS,287,1395,0,1,0,1396,A
8-NS,288,0,6,1382,0,1388,G
8-NS,289,0,3,1392,0,1395,G
8-NS,290,1357,0,0,0,1357,A
8-NS,291,1364,0,0,0,1364,A
8-NS,292,0,1347,0,0,1347,T
8-NS,293,0,1345,0,0,1345,T
8-NS,294,0,1,1370,0,1371,G
8-NS,295,1,1364,0,2,1367,T
8-NS,296,4,0,0,1363,1367,C
8-NS,297,1367,0,0,0,1367,A
8-NS,298,1365,0,1,0,1366,A
8-NS,299,0,1,1369,1,1371,G
8-NS,300,1384,0,0,0,1384,A
8-NS,301,1380,0,0,0,1380,A
8-NS,302,1379,2,2,1,1384,A
8-NS,303,2,0,0,1383,1385,C
8-NS,304,0,1357,0,3,1360,T
8-NS,305,0,7,1368,0,1375,G
8-NS,306,0,2,1393,0,1395,G
8-NS,307,0,1394,0,3,1397,T
8-NS,308,1,1388,0,1,1390,T
8-NS,309,7,0,0,1381,1388,C
8-NS,310,1391,0,1,0,1392,A
8-NS,311,0,1412,0,0,1412,T
8-NS,312,0,1,1420,0,1421,G
8-NS,313,0,0,0,1424,1424,C
8-NS,314,0,1405,0,1,1406,T
8-NS,315,1398,0,0,0,1398,A
8-NS,316,1409,0,0,0,1409,A
8-NS,317,0,1420,0,1,1421,T
8-NS,318,1,4,1414,0,1419,G
8-NS,319,1,0,0,1420,1421,C
8-NS,320,7,0,0,1396,1403,C
8-NS,321,4,2,0,1406,1412,C
8-NS,322,1411,0,0,0,1411,A
8-NS,323,1419,1,6,0,1426,A
8-NS,324,0,1,1424,0,1425,G
8-NS,325,1,1,0,1419,1421,C
8-NS,326,1415,0,1,0,1416,A
8-NS,327,3,3,1418,0,1424,G
8-NS,328,1415,0,2,0,1417,A
8-NS,329,1420,0,0,0,1420,A
8-NS,330,1423,0,0,0,1423,A
8-NS,331,0,0,1434,0,1434,G
8-NS,332,0,1419,0,0,1419,T
8-NS,333,0,3,1414,0,1417,G
8-NS,334,0,3,1415,0,1418,G
8-NS,335,1420,0,0,0,1420,A
8-NS,336,1406,0,2,0,1408,A
8-NS,337,0,4,1401,0,1405,G
8-NS,338,0,3,1418,0,1421,G
8-NS,339,1421,1,0,0,1422,A
8-NS,340,2,0,0,1412,1414,C
8-NS,341,2,0,0,1404,1406,C
8-NS,342,0,1402,0,1,1403,T
8-NS,343,2,0,0,1420,1422,C
8-NS,344,0,1416,0,0,1416,T
8-NS,345,0,1420,0,0,1420,T
8-NS,346,1,1411,0,0,1412,T
8-NS,347,1,5,1410,0,1416,G
8-NS,348,1,2,0,1426,1429,C
8-NS,349,1428,0,1,0,1429,A
8-NS,350,0,1428,0,1,1429,T
8-NS,351,2,2,1,1422,1427,C
8-NS,352,1444,1,1,0,1446,A
8-NS,353,0,4,1487,0,1491,G
8-NS,354,1489,0,0,2,1491,A
8-NS,355,1493,1,1,0,1495,A
8-NS,356,1,1495,0,0,1496,T
8-NS,357,1,4,1478,0,1483,G
8-NS,358,5,5,1484,0,1494,G
8-NS,359,1486,0,4,0,1490,A
8-NS,360,2,1,0,1480,1483,C
8-NS,361,12,1,0,1438,1451,C
8-NS,362,1422,0,0,0,1422,A
8-NS,363,0,8,1435,0,1443,G
8-NS,364,0,3,1438,0,1441,G
8-NS,365,1,1,0,1445,1447,C
8-NS,366,1441,0,0,0,1441,A
8-NS,367,1430,2,2,0,1434,A
8-NS,368,0,1430,0,0,1430,T
8-NS,369,2,0,0,1429,1431,C
8-NS,370,1431,0,1,0,1432,A
8-NS,371,0,1425,0,1,1426,T
8-NS,372,0,0,1413,0,1413,G
8-NS,373,0,5,1416,0,1421,G
8-NS,374,1417,1,0,0,1418,A
8-NS,375,0,0,1433,0,1433,G
8-NS,376,1423,0,4,0,1427,A
8-NS,377,1418,0,4,0,1422,A
8-NS,378,1421,0,3,0,1424,A
8-NS,379,1426,0,0,0,1426,A
8-NS,380,1430,0,2,1,1433,A
8-NS,381,0,1,1,1439,1441,C
8-NS,382,1429,2,0,0,1431,A
8-NS,383,0,1427,0,0,1427,T
8-NS,384,3,0,1,1412,1416,C
8-NS,385,1421,0,0,0,1421,A
8-NS,386,0,1429,0,0,1429,T
8-NS,387,0,0,1429,0,1429,G
8-NS,388,0,1430,1,1,1432,T
8-NS,389,0,1417,0,1,1418,T
8-NS,390,0,4,1413,0,1417,G
8-NS,391,1412,0,0,0,1412,A
8-NS,392,1410,0,1,0,1411,A
8-NS,393,1403,0,1,0,1404,A
8-NS,394,0,1,1407,0,1408,G
8-NS,395,1,0,0,1404,1405,C
8-NS,396,1,6,1393,0,1400,G
8-NS,397,1400,0,2,0,1402,A
8-NS,398,1402,0,0,0,1402,A
8-NS,399,0,1399,0,0,1399,T
8-NS,400,0,1404,0,0,1404,T
8-NS,401,0,1403,0,0,1403,T
8-NS,402,3,0,0,1403,1406,C
8-NS,403,1396,1,1,0,1398,A
8-NS,404,0,2,1400,0,1402,G
8-NS,405,0,1395,0,1,1396,T
8-NS,406,0,0,1400,0,1400,G
8-NS,407,0,1389,0,3,1392,T
8-NS,408,0,9,1395,0,1404,G
8-NS,409,1407,0,1,0,1408,A
8-NS,410,0,1404,0,0,1404,T
8-NS,411,0,1409,0,0,1409,T
8-NS,412,0,1404,0,0,1404,T
8-NS,413,0,1404,0,0,1404,T
8-NS,414,0,1403,0,0,1403,T
8-NS,415,0,10,1395,0,1405,G
8-NS,416,1407,0,2,0,1409,A
8-NS,417,0,1,0,1398,1399,C
8-NS,418,6,0,0,1381,1387,C
8-NS,419,1,6,1394,0,1401,G
8-NS,420,1482,0,0,2,1484,A
8-NS,421,0,1,0,1522,1523,C
8-NS,422,1,1520,0,1,1522,T
8-NS,423,1525,0,4,0,1529,A
8-NS,424,1,0,1528,0,1529,G
8-NS,425,1534,0,3,0,1537,A
8-NS,426,1,8,1547,0,1556,G
8-NS,427,1551,1,5,0,1557,A
8-NS,428,0,1,0,1588,1589,C
8-NS,429,10,1,0,1516,1527,C
8-NS,430,1477,0,3,0,1480,A
8-NS,431,0,1526,0,2,1528,T
8-NS,432,1518,0,2,0,1520,A
8-NS,433,0,0,1640,1,1641,G
8-NS,434,0,1626,0,0,1626,T
8-NS,435,1625,2,0,0,1627,A
8-NS,436,0,1617,0,0,1617,T
8-NS,437,0,1577,0,1,1578,T
8-NS,438,1635,1,0,0,1636,A
8-NS,439,1,0,0,1633,1634,C
8-NS,440,0,1565,0,0,1565,T
8-NS,441,1557,0,0,0,1557,A
8-NS,442,1422,1,0,0,1423,A
8-NS,443,0,5,1431,0,1436,G
8-NS,444,2,6,1423,0,1431,G
8-NS,445,2,1,1428,0,1431,G
8-NS,446,0,0,0,1422,1422,C
8-NS,447,1,1384,0,1,1386,T
8-NS,448,1,1389,0,0,1390,T
8-NS,449,0,1414,0,0,1414,T
8-NS,450,1,0,0,1414,1415,C
8-NS,451,1432,1,1,0,1434,A
8-NS,452,1,0,0,1426,1427,C
8-NS,453,6,4,0,1411,1421,C
8-NS,454,2,3,1423,0,1428,G
8-NS,455,1424,0,0,0,1424,A
8-NS,456,1433,1,0,0,1434,A
8-NS,457,0,2,1433,0,1435,G
8-NS,458,1414,0,1,0,1415,A
8-NS,459,0,5,1417,1,1423,G
8-NS,460,0,4,1400,0,1404,G
8-NS,461,1,12,1404,0,1417,G
8-NS,462,1413,0,3,0,1416,A
8-NS,463,0,0,1418,0,1418,G
8-NS,464,1,0,0,1407,1408,C
8-NS,465,1414,0,0,0,1414,A
8-NS,466,1415,0,1,1,1417,A
8-NS,467,0,1410,0,0,1410,T
8-NS,468,0,1399,0,0,1399,T
8-NS,469,0,0,1400,0,1400,G
8-NS,470,0,1389,0,0,1389,T
8-NS,471,0,1383,0,2,1385,T
8-NS,472,0,4,1378,1,1383,G
8-NS,473,0,1,1380,0,1381,G
8-NS,474,1,1,0,1385,1387,C
8-NS,475,0,2,1384,0,1386,G
8-NS,476,1393,0,0,0,1393,A
8-NS,477,1405,0,0,0,1405,A
8-NS,478,1404,0,0,0,1404,A
8-NS,479,0,1412,0,0,1412,T
8-NS,480,0,0,0,1415,1415,C
8-NS,481,0,1412,0,1,1413,T
8-NS,482,5,0,0,1410,1415,C
8-NS,483,1415,1,2,0,1418,A
8-NS,484,2,1,0,1421,1424,C
8-NS,485,1,0,0,1420,1421,C
8-NS,486,1423,0,0,0,1423,A
8-NS,487,0,1418,0,1,1419,T
8-NS,488,0,1416,0,0,1416,T
8-NS,489,1,1,1413,1,1416,G
8-NS,490,1,0,0,1413,1414,C
8-NS,491,5,2,0,1405,1412,C
8-NS,492,1,1408,0,7,1416,T
8-NS,493,0,1407,0,0,1407,T
8-NS,494,3,0,0,1423,1426,C
8-NS,495,0,1425,1,0,1426,T
8-NS,496,0,1420,1,0,1421,T
8-NS,497,0,1445,0,1,1446,T
8-NS,498,0,1444,1,1,1446,T
8-NS,499,1,1,0,1445,1447,C
8-NS,500,6,0,2,1443,1451,C
8-NS,501,1446,1,0,1,1448,A
8-NS,502,0,4,1453,0,1457,G
8-NS,503,0,6,1446,0,1452,G
8-NS,504,1483,1,2,0,1486,A
8-NS,505,2,1,0,1484,1487,C
8-NS,506,1502,1,0,0,1503,A
8-NS,507,0,1516,0,1,1517,T
8-NS,508,1517,0,3,0,1520,A
8-NS,509,4,0,0,1608,1612,C
8-NS,510,0,1594,0,1,1595,T
8-NS,511,1582,0,1,0,1583,A
8-NS,512,0,1579,0,0,1579,T
8-NS,513,0,1516,0,1,1517,T
8-NS,514,0,1,1516,0,1517,G
8-NS,515,1459,0,1,0,1460,A
8-NS,516,0,6,1448,0,1454,G
8-NS,517,0,5,1438,0,1443,G
8-NS,518,1301,0,0,0,1301,A
8-NS,519,0,1300,0,0,1300,T
8-NS,520,0,0,1286,0,1286,G
8-NS,521,0,1283,0,0,1283,T
8-NS,522,3,1,0,1284,1288,C
8-NS,523,1293,1,0,0,1294,A
8-NS,524,1292,0,0,1,1293,A
8-NS,525,1284,1,1,0,1286,A
8-NS,526,1276,0,0,0,1276,A
8-NS,527,1292,0,0,0,1292,A
8-NS,528,0,1293,0,0,1293,T
8-NS,529,0,1,1290,0,1291,G
8-NS,530,1,0,0,1304,1305,C
8-NS,531,1304,0,1,0,1305,A
8-NS,532,1309,0,0,0,1309,A
8-NS,533,0,1313,0,0,1313,T
8-NS,534,2,1309,0,0,1311,T
8-NS,535,0,8,1301,0,1309,G
8-NS,536,0,4,1294,0,1298,G
8-NS,537,0,3,1304,0,1307,G
8-NS,538,0,5,1312,1,1318,G
8-NS,539,0,1306,0,4,1310,T
8-NS,540,3,2,0,1310,1315,C
8-NS,541,6,0,0,1308,1314,C
8-NS,542,0,1301,0,4,1305,T
8-NS,543,1,1,0,1321,1323,C
8-NS,544,1320,0,0,0,1320,A
8-NS,545,0,1321,0,0,1321,T
8-NS,546,5,1,0,1321,1327,C
8-NS,547,1,4,1312,0,1317,G
8-NS,548,0,5,1312,0,1317,G
8-NS,549,1298,1,1,0,1300,A
8-NS,550,0,0,1304,0,1304,G
8-NS,551,0,3,1296,0,1299,G
8-NS,552,1287,0,0,1,1288,A
8-NS,553,0,1,0,1301,1302,C
8-NS,554,0,1295,0,0,1295,T
8-NS,555,0,1298,0,1,1299,T
8-NS,556,0,1,1303,0,1304,G
8-NS,557,1296,0,0,1,1297,A
8-NS,558,1291,0,1,0,1292,A
8-NS,559,0,1290,0,0,1290,T
8-NS,560,0,6,1258,0,1264,G
8-NS,561,0,2,1273,0,1275,G
8-NS,562,1266,0,3,0,1269,A
8-NS,563,1283,0,0,0,1283,A
8-NS,564,0,1329,1,0,1330,T
8-NS,565,0,1,1344,0,1345,G
8-NS,566,1346,0,3,0,1349,A
8-NS,567,0,1347,0,0,1347,T
8-NS,568,1348,0,1,0,1349,A
8-NS,569,1359,0,1,0,1360,A
8-NS,570,1,0,0,1346,1347,C
8-NS,571,1329,0,0,0,1329,A
8-NS,572,1,0,0,1335,1336,C
8-NS,573,1210,0,0,1,1211,A
8-NS,574,0,2,1237,0,1239,G
8-NS,575,0,1226,0,0,1226,T
8-NS,576,0,1225,0,0,1225,T
8-NS,577,1,0,0,1219,1220,C
8-NS,578,0,6,1208,1,1215,G
8-NS,579,1208,1,2,1,1212,A
8-NS,580,0,1,1216,0,1217,G
8-NS,581,0,1197,0,1,1198,T
8-NS,582,1,0,0,1198,1199,C
8-NS,583,0,1180,0,0,1180,T
8-NS,584,4,0,0,1184,1188,C
8-NS,585,0,1187,0,3,1190,T
8-NS,586,1191,0,0,0,1191,A
8-NS,587,1191,0,0,1,1192,A
8-NS,588,1186,0,1,1,1188,A
8-NS,589,1197,0,0,1,1198,A
8-NS,590,1199,0,0,1,1200,A
8-NS,591,0,1184,1,0,1185,T
8-NS,592,0,0,0,1195,1195,C
8-NS,593,0,1182,0,0,1182,T
8-NS,594,1186,0,0,0,1186,A
8-NS,595,0,1,0,1187,1188,C
8-NS,596,1183,0,1,0,1184,A
8-NS,597,0,5,1188,0,1193,G
8-NS,598,1164,0,0,0,1164,A
8-NS,599,0,2,1172,0,1174,G
8-NS,600,1169,0,0,0,1169,A
8-NS,601,0,1138,0,1,1139,T
8-NS,602,0,1146,0,1,1147,T
8-NS,603,14,1,0,1138,1153,C
8-NS,604,0,0,1152,0,1152,G
8-NS,605,1,0,0,1148,1149,C
8-NS,606,0,1147,0,1,1148,T
8-NS,607,0,1150,0,1,1151,T
8-NS,608,1,2,1145,0,1148,G
8-NS,609,0,3,1147,0,1150,G
8-NS,610,1145,0,0,1,1146,A
8-NS,611,0,1,1148,0,1149,G
8-NS,612,1144,2,0,0,1146,A
8-NS,613,1130,0,3,0,1133,A
8-NS,614,0,0,1149,0,1149,G
8-NS,615,0,1,0,1149,1150,C
8-NS,616,1148,0,0,1,1149,A
8-NS,617,0,0,1172,0,1172,G
8-NS,618,0,1154,0,0,1154,T
8-NS,619,1163,0,0,0,1163,A
8-NS,620,1163,0,0,1,1164,A
8-NS,621,1,1157,0,0,1158,T
8-NS,622,0,2,1169,0,1171,G
8-NS,623,1137,0,0,0,1137,A
8-NS,624,0,5,1155,1,1161,G
8-NS,625,1159,0,0,0,1159,A
8-NS,626,1131,0,1,0,1132,A
8-NS,627,0,1131,0,0,1131,T
8-NS,628,1,2,1114,0,1117,G
8-NS,629,0,4,1117,0,1121,G
8-NS,630,1,3,1105,0,1109,G
8-NS,631,0,1,1109,0,1110,G
8-NS,632,0,3,1095,0,1098,G
8-NS,633,1069,1,1,0,1071,A
8-NS,634,1,0,0,1074,1075,C
8-NS,635,1,1,0,1073,1075,C
8-NS,636,0,1048,0,1,1049,T
8-NS,637,6,0,0,1046,1052,C
8-NS,638,3,0,1,1053,1057,C
8-NS,639,1060,0,0,0,1060,A
8-NS,640,0,1016,1,0,1017,T
8-NS,641,0,1028,0,1,1029,T
8-NS,642,0,1032,1,0,1033,T
8-NS,643,1037,0,0,0,1037,A
8-NS,644,1,1,0,1037,1039,C
8-NS,645,0,1024,0,1,1025,T
8-NS,646,5,0,0,1016,1021,C
8-NS,647,4,0,1,992,997,C
8-NS,648,1004,0,0,0,1004,A
8-NS,649,1003,0,0,0,1003,A
8-NS,650,1001,0,0,0,1001,A
8-NS,651,1001,0,0,0,1001,A
8-NS,652,1,0,0,1002,1003,C
8-NS,653,988,0,1,0,989,A
8-NS,654,0,1,994,0,995,G
8-NS,655,991,0,0,1,992,A
8-NS,656,992,0,0,0,992,A
8-NS,657,991,0,1,0,992,A
8-NS,658,1,0,0,986,987,C
8-NS,659,0,6,980,0,986,G
8-NS,660,1,1,982,0,984,G
8-NS,661,1,1,985,0,987,G
8-NS,662,989,0,0,0,989,A
8-NS,663,979,1,0,0,980,A
8-NS,664,977,0,2,0,979,A
8-NS,665,0,977,0,0,977,T
8-NS,666,1,2,980,0,983,G
8-NS,667,0,1,980,0,981,G
8-NS,668,0,0,0,976,976,C
8-NS,669,0,5,970,0,975,G
8-NS,670,977,0,0,0,977,A
8-NS,671,0,3,977,0,980,G
8-NS,672,980,0,0,0,980,A
8-NS,673,979,0,0,0,979,A
8-NS,674,0,1,0,989,990,C
8-NS,675,960,0,1,0,961,A
8-NS,676,1,1,962,0,964,G
8-NS,677,0,0,0,956,956,C
8-NS,678,0,962,0,0,962,T
8-NS,679,957,0,0,0,957,A
8-NS,680,0,1,948,1,950,G
8-NS,681,0,0,947,0,947,G
8-NS,682,0,950,0,0,950,T
8-NS,683,1,1,0,927,929,C
8-NS,684,938,0,0,0,938,A
8-NS,685,933,0,0,2,935,A
8-NS,686,934,0,0,0,934,A
8-NS,687,938,0,0,0,938,A
8-NS,688,2,0,938,0,940,G
8-NS,689,0,922,0,0,922,T
8-NS,690,0,914,0,0,914,T
8-NS,691,0,917,0,0,917,T
8-NS,692,0,4,913,0,917,G
8-NS,693,917,0,0,0,917,A
8-NS,694,915,0,1,0,916,A
8-NS,695,0,4,914,0,918,G
8-NS,696,889,0,0,0,889,A
8-NS,697,0,1,893,0,894,G
8-NS,698,890,0,1,0,891,A
8-NS,699,0,888,0,0,888,T
8-NS,700,887,1,2,1,891,A
8-NS,701,891,0,0,0,891,A
8-NS,702,0,2,885,0,887,G
8-NS,703,835,0,1,0,836,A
8-NS,704,0,836,0,0,836,T
8-NS,705,0,3,833,0,836,G
8-NS,706,0,0,835,0,835,G
8-NS,707,0,0,0,834,834,C
8-NS,708,0,826,0,0,826,T
8-NS,709,828,0,0,0,828,A
8-NS,710,829,0,1,0,830,A
8-NS,711,0,826,0,0,826,T
8-NS,712,0,824,0,1,825,T
8-NS,713,0,0,830,0,830,G
8-NS,714,817,0,0,0,817,A
8-NS,715,819,0,0,0,819,A
8-NS,716,0,0,818,0,818,G
8-NS,717,814,0,1,0,815,A
8-NS,718,804,0,2,0,806,A
8-NS,719,0,3,814,0,817,G
8-NS,720,0,798,0,0,798,T
8-NS,721,0,1,792,0,793,G
8-NS,722,790,0,1,0,791,A
8-NS,723,0,4,787,0,791,G
8-NS,724,792,0,1,0,793,A
8-NS,725,0,0,0,788,788,C
8-NS,726,779,0,0,0,779,A
8-NS,727,0,0,0,776,776,C
8-NS,728,716,0,2,0,718,A
8-NS,729,0,0,729,0,729,G
8-NS,730,728,0,1,0,729,A
8-NS,731,0,721,0,0,721,T
8-NS,732,1,718,0,0,719,T
8-NS,733,718,0,0,0,718,A
8-NS,734,717,0,0,0,717,A
8-NS,735,720,0,0,0,720,A
8-NS,736,719,1,0,0,720,A
8-NS,737,720,0,0,0,720,A
8-NS,738,3,1,0,692,696,C
8-NS,739,665,0,1,0,666,A
8-NS,740,666,0,0,0,666,A
8-NS,741,0,0,0,664,664,C
8-NS,742,0,663,0,0,663,T
8-NS,743,1,1,666,0,668,G
8-NS,744,666,0,0,0,666,A
8-NS,745,669,0,0,0,669,A
8-NS,746,664,0,0,0,664,A
8-NS,747,654,0,0,0,654,A
8-NS,748,0,650,0,0,650,T
8-NS,749,642,0,0,0,642,A
8-NS,750,0,0,648,0,648,G
8-NS,751,0,1,0,646,647,C
8-NS,752,0,636,0,0,636,T
8-NS,753,0,635,0,0,635,T
8-NS,754,0,631,0,0,631,T
8-NS,755,0,8,622,0,630,G
8-NS,756,630,0,0,0,630,A
8-NS,757,629,0,2,0,631,A
8-NS,758,0,0,0,629,629,C
8-NS,759,610,0,0,0,610,A
8-NS,760,613,0,0,1,614,A
8-NS,761,613,0,0,0,613,A
8-NS,762,0,612,0,0,612,T
8-NS,763,613,0,0,0,613,A
8-NS,764,603,0,0,1,604,A
8-NS,765,0,0,0,605,605,C
8-NS,766,601,1,0,0,602,A
8-NS,767,0,585,0,0,585,T
8-NS,768,0,571,0,1,572,T
8-NS,769,1,0,0,554,555,C
8-NS,770,550,0,0,0,550,A
8-NS,771,0,547,1,0,548,T
8-NS,772,0,1,547,0,548,G
8-NS,773,0,0,0,537,537,C
8-NS,774,531,0,1,0,532,A
8-NS,775,528,0,0,0,528,A
8-NS,776,0,0,523,0,523,G
8-NS,777,0,0,0,529,529,C
8-NS,778,522,0,0,0,522,A
8-NS,779,1,521,0,0,522,T
8-NS,780,0,522,0,0,522,T
8-NS,781,522,0,0,0,522,A
8-NS,782,2,0,0,520,522,C
8-NS,783,505,0,0,0,505,A
8-NS,784,0,0,428,0,428,G
8-NS,785,0,0,0,431,431,C
8-NS,786,0,429,0,1,430,T
8-NS,787,0,1,428,0,429,G
8-NS,788,0,0,0,423,423,C
8-NS,789,0,418,0,0,418,T
8-NS,790,1,0,417,0,418,G
8-NS,791,0,410,0,0,410,T
8-NS,792,0,411,0,0,411,T
8-NS,793,0,410,0,0,410,T
8-NS,794,0,0,406,0,406,G
8-NS,795,408,0,1,0,409,A
8-NS,796,397,0,1,0,398,A
8-NS,797,0,0,398,0,398,G
8-NS,798,0,392,0,1,393,T
8-NS,799,0,3,363,0,366,G
8-NS,800,0,0,365,0,365,G
8-NS,801,367,1,0,0,368,A
8-NS,802,366,0,1,0,367,A
8-NS,803,0,0,0,367,367,C
8-NS,804,351,0,0,0,351,A
8-NS,805,0,0,351,0,351,G
8-NS,806,0,1,345,0,346,G
8-NS,807,332,1,1,0,334,A
8-NS,808,0,0,334,0,334,G
8-NS,809,276,0,0,0,276,A
8-NS,810,0,276,0,0,276,T
8-NS,811,275,0,0,0,275,A
8-NS,812,269,0,0,0,269,A
8-NS,813,1,1,266,0,268,G
8-NS,814,233,0,0,0,233,A
8-NS,815,232,0,0,0,232,A
8-NS,816,0,0,0,228,228,C
8-NS,817,0,188,0,0,188,T
8-NS,818,0,188,0,0,188,T
8-NS,819,0,189,0,0,189,T
8-NS,820,0,0,0,190,190,C
8-NS,821,0,189,0,0,189,T
8-NS,822,1,0,0,185,186,C
8-NS,823,181,0,0,0,181,A
8-NS,824,0,180,0,0,180,T
8-NS,825,0,177,0,0,177,T
8-NS,826,2,174,0,0,176,T
8-NS,827,1,0,0,173,174,C
8-NS,828,164,2,0,0,166,A
8-NS,829,0,1,165,0,166,G
8-NS,830,0,0,0,165,165,C
8-NS,831,0,156,0,1,157,T
8-NS,832,0,158,0,0,158,T
8-NS,833,151,0,0,0,151,A
8-NS,834,0,150,0,0,150,T
8-NS,835,0,150,0,0,150,T
8-NS,836,0,150,0,0,150,T
8-NS,837,144,0,0,0,144,A
8-NS,838,139,0,0,0,139,A
8-NS,839,0,135,0,0,135,T
8-NS,840,0,1,133,0,134,G
8-NS,841,130,0,0,0,130,A
8-NS,842,0,117,0,0,117,T
8-NS,843,116,0,0,0,116,A
8-NS,844,116,0,0,0,116,A
8-NS,845,116,0,0,0,116,A
8-NS,846,116,0,0,0,116,A
8-NS,847,115,0,0,0,115,A
8-NS,848,115,0,0,0,115,A
8-NS,849,0,0,0,114,114,C
8-NS,850,98,0,0,0,98,A
8-NS,851,0,0,0,97,97,C
8-NS,852,1,0,0,91,92,C
8-NS,853,0,0,0,89,89,C
8-NS,854,0,81,0,0,81,T
8-NS,855,1,79,0,0,80,T
8-NS,856,0,0,81,0,81,G
8-NS,857,0,75,0,0,75,T
8-NS,858,0,75,0,0,75,T
8-NS,859,0,71,0,0,71,T
8-NS,860,0,0,0,31,31,C
8-NS,861,0,20,0,0,20,T
8-NS,862,15,0,0,0,15,A
8-NS,863,0,0,0,15,15,C
