Gene,Position,A,T,G,C,Coverage,Consensus
1-PB2,1,68,0,0,0,68,A
1-PB2,2,0,68,0,0,68,T
1-PB2,3,0,0,71,0,71,G
1-PB2,4,0,0,71,0,71,G
1-PB2,5,70,0,0,0,70,A
1-PB2,6,70,0,0,0,70,A
1-PB2,7,71,0,0,0,71,A
1-PB2,8,0,0,82,0,82,G
1-PB2,9,81,0,1,0,82,A
1-PB2,10,81,0,0,0,81,A
1-PB2,11,0,85,0,0,85,T
1-PB2,12,85,0,0,0,85,A
1-PB2,13,84,2,0,0,86,A
1-PB2,14,86,0,0,0,86,A
1-PB2,15,85,0,0,0,85,A
1-PB2,16,0,0,90,0,90,G
1-PB2,17,90,0,0,0,90,A
1-PB2,18,90,0,0,0,90,A
1-PB2,19,0,0,0,90,90,C
1-PB2,20,0,90,0,0,90,T
1-PB2,21,93,0,0,0,93,A
1-PB2,22,0,0,0,93,93,C
1-PB2,23,0,0,93,0,93,G
1-PB2,24,0,0,93,0,93,G
1-PB2,25,93,0,0,0,93,A
1-PB2,26,94,0,1,0,95,A
1-PB2,27,0,95,0,0,95,T
1-PB2,28,0,1,0,93,94,C
1-PB2,29,0,95,0,0,95,T
1-PB2,30,0,0,97,0,97,G
1-PB2,31,97,0,0,0,97,A
1-PB2,32,0,97,0,0,97,T
1-PB2,33,0,0,98,0,98,G
1-PB2,34,0,99,0,0,99,T
1-PB2,35,0,1,0,97,98,C
1-PB2,36,0,0,96,0,96,G
1-PB2,37,0,0,0,98,98,C
1-PB2,38,97,0,0,0,97,A
1-PB2,39,0,0,103,0,103,G
1-PB2,40,0,104,0,0,104,T
1-PB2,41,0,0,0,103,103,C
1-PB2,42,0,102,0,0,102,T
1-PB2,43,0,0,0,102,102,C
1-PB2,44,0,0,104,0,104,G
1-PB2,45,0,0,0,103,103,C
1-PB2,46,102,0,0,0,102,A
1-PB2,47,0,0,0,105,105,C
1-PB2,48,0,105,0,0,105,T
1-PB2,49,0,0,0,106,106,C
1-PB2,50,0,0,106,0,106,G
1-PB2,51,0,0,0,107,107,C
1-PB2,52,0,0,105,0,105,G
1-PB2,53,106,0,0,0,106,A
1-PB2,54,0,0,108,0,108,G
1-PB2,55,109,0,0,0,109,A
1-PB2,56,0,108,0,0,108,T
1-PB2,57,108,0,0,0,108,A
1-PB2,58,0,0,0,107,107,C
1-PB2,59,0,106,1,0,107,T
1-PB2,60,0,0,108,0,108,G
1-PB2,61,109,0,0,0,109,A
1-PB2,62,0,0,0,108,108,C
1-PB2,63,108,0,0,0,108,A
1-PB2,64,109,0,0,0,109,A
1-PB2,65,111,0,0,0,111,A
1-PB2,66,113,0,0,0,113,A
1-PB2,67,113,0,0,0,113,A
1-PB2,68,0,0,0,113,113,C
1-PB2,69,0,0,0,113,113,C
1-PB2,70,118,0,0,0,118,A
1-PB2,71,0,0,0,119,119,C
1-PB2,72,119,0,0,0,119,A
1-PB2,73,0,0,123,0,123,G
1-PB2,74,0,124,0,0,124,T
1-PB2,75,0,0,127,0,127,G
1-PB2,76,0,0,127,0,127,G
1-PB2,77,128,0,0,0,128,A
1-PB2,78,0,0,0,134,134,C
1-PB2,79,0,0,0,133,133,C
1-PB2,80,133,0,0,0,133,A
1-PB2,81,0,135,0,0,135,T
1-PB2,82,135,0,0,0,135,A
1-PB2,83,0,133,0,0,133,T
1-PB2,84,0,0,136,0,136,G
1-PB2,85,0,0,136,0,136,G
1-PB2,86,0,0,0,138,138,C
1-PB2,87,0,0,0,139,139,C
1-PB2,88,138,0,0,0,138,A
1-PB2,89,0,146,0,0,146,T
1-PB2,90,150,0,0,0,150,A
1-PB2,91,160,0,0,0,160,A
1-PB2,92,0,160,0,0,160,T
1-PB2,93,0,158,0,0,158,T
1-PB2,94,162,0,0,0,162,A
1-PB2,95,163,0,0,0,163,A
1-PB2,96,0,0,171,0,171,G
1-PB2,97,170,0,0,0,170,A
1-PB2,98,170,0,0,0,170,A
1-PB2,99,0,0,174,0,174,G
1-PB2,100,0,173,0,0,173,T
1-PB2,101,175,0,0,0,175,A
1-PB2,102,0,0,0,174,174,C
1-PB2,103,175,0,0,1,176,A
1-PB2,104,0,0,0,181,181,C
1-PB2,105,181,0,0,0,181,A
1-PB2,106,0,180,0,0,180,T
1-PB2,107,0,0,0,183,183,C
1-PB2,108,0,0,180,0,180,G
1-PB2,109,0,0,179,0,179,G
1-PB2,110,0,0,178,0,178,G
1-PB2,111,0,1,179,0,180,G
1-PB2,112,180,0,0,0,180,A
1-PB2,113,0,0,180,0,180,G
1-PB2,114,181,0,0,0,181,A
1-PB2,115,0,0,0,179,179,C
1-PB2,116,182,0,0,0,182,A
1-PB2,117,0,0,181,0,181,G
1-PB2,118,0,0,183,0,183,G
1-PB2,119,184,0,0,0,184,A
1-PB2,120,182,0,0,0,182,A
1-PB2,121,184,0,0,0,184,A
1-PB2,122,183,0,1,0,184,A
1-PB2,123,1,0,184,0,185,G
1-PB2,124,184,0,0,0,184,A
1-PB2,125,186,0,0,0,186,A
1-PB2,126,0,0,0,185,185,C
1-PB2,127,1,0,0,182,183,C
1-PB2,128,0,0,0,183,183,C
1-PB2,129,1,0,183,0,184,G
1-PB2,130,0,185,0,0,185,T
1-PB2,131,0,0,0,185,185,C
1-PB2,132,188,0,0,0,188,A
1-PB2,133,0,0,0,189,189,C
1-PB2,134,0,188,0,0,188,T
1-PB2,135,0,187,0,0,187,T
1-PB2,136,187,0,0,0,187,A
1-PB2,137,0,0,194,0,194,G
1-PB2,138,0,0,194,0,194,G
1-PB2,139,194,0,0,0,194,A
1-PB2,140,0,194,0,0,194,T
1-PB2,141,0,0,195,0,195,G
1-PB2,142,199,0,0,0,199,A
1-PB2,143,200,0,0,0,200,A
1-PB2,144,202,0,0,0,202,A
1-PB2,145,0,201,0,0,201,T
1-PB2,146,0,0,202,0,202,G
1-PB2,147,0,0,203,0,203,G
1-PB2,148,202,0,0,0,202,A
1-PB2,149,0,202,0,0,202,T
1-PB2,150,0,0,202,0,202,G
1-PB2,151,198,0,1,0,199,A
1-PB2,152,0,201,0,0,201,T
1-PB2,153,0,0,202,0,202,G
1-PB2,154,0,0,201,0,201,G
1-PB2,155,0,0,0,202,202,C
1-PB2,156,203,0,0,0,203,A
1-PB2,157,205,0,0,0,205,A
1-PB2,158,0,206,0,0,206,T
1-PB2,159,0,0,212,0,212,G
1-PB2,160,212,0,0,0,212,A
1-PB2,161,211,0,0,0,211,A
1-PB2,162,210,0,0,0,210,A
1-PB2,163,0,212,0,0,212,T
1-PB2,164,215,0,0,0,215,A
1-PB2,165,0,0,0,217,217,C
1-PB2,166,0,0,0,212,212,C
1-PB2,167,0,0,0,213,213,C
1-PB2,168,212,0,0,0,212,A
1-PB2,169,213,0,0,0,213,A
1-PB2,170,0,211,0,0,211,T
1-PB2,171,0,0,0,213,213,C
1-PB2,172,212,0,0,0,212,A
1-PB2,173,0,0,0,213,213,C
1-PB2,174,0,208,0,0,208,T
1-PB2,175,0,0,209,0,209,G
1-PB2,176,0,2,0,209,211,C
1-PB2,177,0,209,0,1,210,T
1-PB2,178,0,0,212,0,212,G
1-PB2,179,210,0,0,0,210,A
1-PB2,180,0,0,0,212,212,C
1-PB2,181,212,0,0,0,212,A
1-PB2,182,207,0,1,0,208,A
1-PB2,183,214,0,0,0,214,A
1-PB2,184,213,0,0,0,213,A
1-PB2,185,0,0,216,0,216,G
1-PB2,186,0,0,216,0,216,G
1-PB2,187,214,0,1,0,215,A
1-PB2,188,0,216,0,0,216,T
1-PB2,189,213,0,0,0,213,A
1-PB2,190,215,0,0,0,215,A
1-PB2,191,0,0,0,218,218,C
1-PB2,192,218,0,0,0,218,A
1-PB2,193,0,0,218,0,218,G
1-PB2,194,214,0,0,0,214,A
1-PB2,195,214,0,0,0,214,A
1-PB2,196,214,0,0,0,214,A
1-PB2,197,0,212,0,0,212,T
1-PB2,198,0,1,212,0,213,G
1-PB2,199,0,0,215,0,215,G
1-PB2,200,0,212,0,1,213,T
1-PB2,201,0,212,0,0,212,T
1-PB2,202,0,0,0,211,211,C
1-PB2,203,0,0,0,211,211,C
1-PB2,204,0,0,212,0,212,G
1-PB2,205,0,0,210,0,210,G
1-PB2,206,210,0,2,0,212,A
1-PB2,207,0,0,212,0,212,G
1-PB2,208,210,0,0,0,210,A
1-PB2,209,0,0,214,0,214,G
1-PB2,210,215,0,0,0,215,A
1-PB2,211,214,0,0,0,214,A
1-PB2,212,215,0,0,0,215,A
1-PB2,213,0,213,0,0,213,T
1-PB2,214,0,0,217,0,217,G
1-PB2,215,217,0,1,0,218,A
1-PB2,216,217,0,0,0,217,A
1-PB2,217,0,0,0,217,217,C
1-PB2,218,214,0,0,0,214,A
1-PB2,219,214,0,0,0,214,A
1-PB2,220,0,0,219,0,219,G
1-PB2,221,0,0,223,0,223,G
1-PB2,222,224,0,0,0,224,A
1-PB2,223,0,0,0,223,223,C
1-PB2,224,223,0,0,0,223,A
1-PB2,225,225,0,0,0,225,A
1-PB2,226,224,0,0,0,224,A
1-PB2,227,0,0,0,223,223,C
1-PB2,228,0,0,0,215,215,C
1-PB2,229,0,0,0,236,236,C
1-PB2,230,0,236,0,0,236,T
1-PB2,231,236,0,0,0,236,A
1-PB2,232,0,235,0,1,236,T
1-PB2,233,0,0,238,0,238,G
1-PB2,234,0,1,245,0,246,G
1-PB2,235,239,0,0,0,239,A
1-PB2,236,0,0,242,0,242,G
1-PB2,237,0,241,0,0,241,T
1-PB2,238,243,0,0,0,243,A
1-PB2,239,242,0,0,0,242,A
1-PB2,240,241,0,0,0,241,A
1-PB2,241,241,0,0,0,241,A
1-PB2,242,0,240,0,0,240,T
1-PB2,243,0,0,235,0,235,G
1-PB2,244,228,0,0,0,228,A
1-PB2,245,0,0,230,0,230,G
1-PB2,246,0,229,0,0,229,T
1-PB2,247,0,0,228,0,228,G
1-PB2,248,232,0,0,0,232,A
1-PB2,249,0,234,0,0,234,T
1-PB2,250,0,0,234,0,234,G
1-PB2,251,0,0,0,233,233,C
1-PB2,252,0,232,0,0,232,T
1-PB2,253,0,0,239,0,239,G
1-PB2,254,0,0,238,0,238,G
1-PB2,255,243,0,0,0,243,A
1-PB2,256,0,243,0,0,243,T
1-PB2,257,1,0,0,246,247,C
1-PB2,258,252,0,0,0,252,A
1-PB2,259,0,0,262,0,262,G
1-PB2,260,263,0,0,0,263,A
1-PB2,261,0,263,0,0,263,T
1-PB2,262,256,0,0,0,256,A
1-PB2,263,0,0,264,0,264,G
1-PB2,264,259,0,1,0,260,A
1-PB2,265,0,0,266,0,266,G
1-PB2,266,0,261,0,0,261,T
1-PB2,267,0,0,259,0,259,G
1-PB2,268,258,0,0,0,258,A
1-PB2,269,0,261,0,0,261,T
1-PB2,270,0,0,266,0,266,G
1-PB2,271,0,0,266,0,266,G
1-PB2,272,0,264,0,0,264,T
1-PB2,273,265,0,0,0,265,A
1-PB2,274,0,263,0,1,264,T
1-PB2,275,0,0,0,265,265,C
1-PB2,276,273,0,1,0,274,A
1-PB2,277,0,0,0,281,281,C
1-PB2,278,0,0,0,279,279,C
1-PB2,279,0,276,0,1,277,T
1-PB2,280,0,274,0,1,275,T
1-PB2,281,0,275,0,0,275,T
1-PB2,282,0,0,279,0,279,G
1-PB2,283,0,0,281,0,281,G
1-PB2,284,0,1,0,282,283,C
1-PB2,285,0,279,0,1,280,T
1-PB2,286,0,0,281,0,281,G
1-PB2,287,0,280,0,0,280,T
1-PB2,288,281,0,0,0,281,A
1-PB2,289,282,0,0,0,282,A
1-PB2,290,0,0,0,283,283,C
1-PB2,291,282,0,0,0,282,A
1-PB2,292,0,281,0,0,281,T
1-PB2,293,0,0,275,0,275,G
1-PB2,294,0,0,281,0,281,G
1-PB2,295,0,280,0,0,280,T
1-PB2,296,0,0,279,0,279,G
1-PB2,297,0,0,281,0,281,G
1-PB2,298,278,0,0,0,278,A
1-PB2,299,279,0,0,0,279,A
1-PB2,300,0,279,0,0,279,T
1-PB2,301,279,0,0,0,279,A
1-PB2,302,0,0,282,0,282,G
1-PB2,303,274,0,0,0,274,A
1-PB2,304,274,0,0,0,274,A
1-PB2,305,274,0,0,0,274,A
1-PB2,306,0,269,0,0,269,T
1-PB2,307,0,0,269,0,269,G
1-PB2,308,0,0,268,0,268,G
1-PB2,309,271,0,0,0,271,A
1-PB2,310,0,0,0,271,271,C
1-PB2,311,0,0,0,268,268,C
1-PB2,312,0,0,0,266,266,C
1-PB2,313,0,0,268,0,268,G
1-PB2,314,0,271,0,0,271,T
1-PB2,315,0,0,276,0,276,G
1-PB2,316,278,0,0,0,278,A
1-PB2,317,1,0,0,280,281,C
1-PB2,318,281,0,0,0,281,A
1-PB2,319,279,0,0,0,279,A
1-PB2,320,0,0,289,0,289,G
1-PB2,321,0,289,0,0,289,T
1-PB2,322,289,0,0,0,289,A
1-PB2,323,0,0,0,287,287,C
1-PB2,324,0,0,287,0,287,G
1-PB2,325,0,0,291,0,291,G
1-PB2,326,0,288,0,1,289,T
1-PB2,327,0,0,0,292,292,C
1-PB2,328,0,0,0,293,293,C
1-PB2,329,286,0,0,0,286,A
1-PB2,330,0,283,0,1,284,T
1-PB2,331,0,288,0,0,288,T
1-PB2,332,299,0,0,0,299,A
1-PB2,333,0,2,0,296,298,C
1-PB2,334,0,0,0,293,293,C
1-PB2,335,0,0,0,292,292,C
1-PB2,336,291,0,0,0,291,A
1-PB2,337,292,0,0,0,292,A
1-PB2,338,292,0,0,0,292,A
1-PB2,339,293,0,0,0,293,A
1-PB2,340,0,0,297,0,297,G
1-PB2,341,0,287,0,0,287,T
1-PB2,342,0,0,293,0,293,G
1-PB2,343,0,291,1,0,292,T
1-PB2,344,291,0,0,0,291,A
1-PB2,345,0,0,0,291,291,C
1-PB2,346,291,0,0,0,291,A
1-PB2,347,289,0,0,0,289,A
1-PB2,348,0,0,291,0,291,G
1-PB2,349,292,0,0,0,292,A
1-PB2,350,0,0,0,292,292,C
1-PB2,351,0,286,1,0,287,T
1-PB2,352,0,289,0,0,289,T
1-PB2,353,286,0,0,0,286,A
1-PB2,354,0,289,0,0,289,T
1-PB2,355,0,288,0,0,288,T
1-PB2,356,0,287,0,0,287,T
1-PB2,357,0,0,0,286,286,C
1-PB2,358,0,1,284,0,285,G
1-PB2,359,285,0,0,0,285,A
1-PB2,360,0,1,0,282,283,C
1-PB2,361,280,0,0,0,280,A
1-PB2,362,280,0,0,0,280,A
1-PB2,363,280,0,0,0,280,A
1-PB2,364,0,0,287,0,287,G
1-PB2,365,0,285,0,0,285,T
1-PB2,366,0,0,0,289,289,C
1-PB2,367,0,0,289,0,289,G
1-PB2,368,287,0,0,0,287,A
1-PB2,369,286,0,1,0,287,A
1-PB2,370,287,0,0,0,287,A
1-PB2,371,0,0,293,0,293,G
1-PB2,372,0,0,293,0,293,G
1-PB2,373,0,289,0,0,289,T
1-PB2,374,0,288,0,0,288,T
1-PB2,375,289,0,0,0,289,A
1-PB2,376,288,0,0,0,288,A
1-PB2,377,287,0,0,0,287,A
1-PB2,378,290,0,0,0,290,A
1-PB2,379,0,0,0,293,293,C
1-PB2,380,285,0,0,0,285,A
1-PB2,381,0,285,0,0,285,T
1-PB2,382,0,0,284,0,284,G
1-PB2,383,0,0,284,0,284,G
1-PB2,384,283,0,0,0,283,A
1-PB2,385,285,0,0,0,285,A
1-PB2,386,0,0,0,292,292,C
1-PB2,387,0,0,0,293,293,C
1-PB2,388,0,291,0,0,291,T
1-PB2,389,0,291,0,1,292,T
1-PB2,390,0,292,0,0,292,T
1-PB2,391,0,0,289,0,289,G
1-PB2,392,0,1,293,0,294,G
1-PB2,393,0,0,0,293,293,C
1-PB2,394,0,0,0,289,289,C
1-PB2,395,0,1,0,286,287,C
1-PB2,396,0,285,0,0,285,T
1-PB2,397,0,0,288,0,288,G
1-PB2,398,0,286,0,1,287,T
1-PB2,399,0,286,0,0,286,T
1-PB2,400,0,0,0,288,288,C
1-PB2,401,288,0,0,0,288,A
1-PB2,402,0,289,0,0,289,T
1-PB2,403,0,289,0,0,289,T
1-PB2,404,0,290,0,0,290,T
1-PB2,405,0,290,0,0,290,T
1-PB2,406,283,0,0,0,283,A
1-PB2,407,0,0,284,0,284,G
1-PB2,408,282,0,0,0,282,A
1-PB2,409,284,0,0,0,284,A
1-PB2,410,285,0,0,0,285,A
1-PB2,411,0,284,0,0,284,T
1-PB2,412,0,0,0,283,283,C
1-PB2,413,284,0,0,0,284,A
1-PB2,414,285,0,1,0,286,A
1-PB2,415,0,0,287,0,287,G
1-PB2,416,0,287,0,0,287,T
1-PB2,417,0,0,0,288,288,C
1-PB2,418,291,0,0,0,291,A
1-PB2,419,289,1,1,0,291,A
1-PB2,420,0,0,293,0,293,G
1-PB2,421,291,0,0,0,291,A
1-PB2,422,0,293,0,0,293,T
1-PB2,423,292,0,0,0,292,A
1-PB2,424,0,0,0,290,290,C
1-PB2,425,1,0,292,0,293,G
1-PB2,426,0,0,0,305,305,C
1-PB2,427,299,0,1,0,300,A
1-PB2,428,0,0,301,0,301,G
1-PB2,429,303,0,0,0,303,A
1-PB2,430,301,0,0,0,301,A
1-PB2,431,0,0,307,0,307,G
1-PB2,432,301,0,0,0,301,A
1-PB2,433,0,0,301,0,301,G
1-PB2,434,0,298,0,0,298,T
1-PB2,435,297,0,0,0,297,A
1-PB2,436,0,0,299,0,299,G
1-PB2,437,288,0,0,0,288,A
1-PB2,438,0,0,0,294,294,C
1-PB2,439,292,0,0,0,292,A
1-PB2,440,0,285,0,0,285,T
1-PB2,441,285,0,0,0,285,A
1-PB2,442,284,0,0,0,284,A
1-PB2,443,285,0,0,0,285,A
1-PB2,444,0,0,0,287,287,C
1-PB2,445,0,0,0,276,276,C
1-PB2,446,0,0,0,275,275,C
1-PB2,447,0,253,0,0,253,T
1-PB2,448,0,0,256,0,256,G
1-PB2,449,0,0,255,0,255,G
1-PB2,450,0,257,0,0,257,T
1-PB2,451,0,1,0,254,255,C
1-PB2,452,260,0,0,0,260,A
1-PB2,453,0,259,0,0,259,T
1-PB2,454,0,0,260,0,260,G
1-PB2,455,3,0,0,258,261,C
1-PB2,456,259,0,0,0,259,A
1-PB2,457,0,0,263,0,263,G
1-PB2,458,259,0,0,0,259,A
1-PB2,459,0,0,0,266,266,C
1-PB2,460,0,0,0,266,266,C
1-PB2,461,0,262,0,0,262,T
1-PB2,462,0,1,0,260,261,C
1-PB2,463,263,0,0,0,263,A
1-PB2,464,0,0,268,0,268,G
1-PB2,465,0,269,0,0,269,T
1-PB2,466,1,0,273,0,274,G
1-PB2,467,1,0,0,270,271,C
1-PB2,468,0,0,0,271,271,C
1-PB2,469,271,0,0,0,271,A
1-PB2,470,274,0,0,0,274,A
1-PB2,471,273,0,0,0,273,A
1-PB2,472,0,0,272,0,272,G
1-PB2,473,265,0,1,0,266,A
1-PB2,474,0,1,266,0,267,G
1-PB2,475,0,0,269,0,269,G
1-PB2,476,0,0,0,265,265,C
1-PB2,477,265,0,1,0,266,A
1-PB2,478,0,0,0,268,268,C
1-PB2,479,266,0,0,0,266,A
1-PB2,480,275,0,0,0,275,A
1-PB2,481,0,0,279,0,279,G
1-PB2,482,283,0,0,0,283,A
1-PB2,483,0,279,0,0,279,T
1-PB2,484,0,0,279,0,279,G
1-PB2,485,0,279,0,0,279,T
1-PB2,486,278,0,0,0,278,A
1-PB2,487,279,0,0,0,279,A
1-PB2,488,0,280,0,0,280,T
1-PB2,489,1,0,0,257,258,C
1-PB2,490,260,0,0,0,260,A
1-PB2,491,0,258,1,0,259,T
1-PB2,492,0,0,260,0,260,G
1-PB2,493,0,0,259,0,259,G
1-PB2,494,257,0,1,0,258,A
1-PB2,495,257,0,0,0,257,A
1-PB2,496,0,0,258,0,258,G
1-PB2,497,0,257,0,0,257,T
1-PB2,498,0,254,0,0,254,T
1-PB2,499,0,0,255,0,255,G
1-PB2,500,0,255,0,0,255,T
1-PB2,501,0,254,0,0,254,T
1-PB2,502,0,254,0,0,254,T
1-PB2,503,0,251,0,0,251,T
1-PB2,504,0,254,0,0,254,T
1-PB2,505,0,0,0,256,256,C
1-PB2,506,0,0,0,255,255,C
1-PB2,507,0,1,0,254,255,C
1-PB2,508,257,0,0,0,257,A
1-PB2,509,256,0,0,0,256,A
1-PB2,510,0,255,0,0,255,T
1-PB2,511,0,0,258,1,259,G
1-PB2,512,259,0,0,0,259,A
1-PB2,513,255,0,0,0,255,A
1-PB2,514,0,0,260,0,260,G
1-PB2,515,0,259,0,0,259,T
1-PB2,516,0,2,254,0,256,G
1-PB2,517,0,1,254,0,255,G
1-PB2,518,0,1,256,0,257,G
1-PB2,519,263,0,0,0,263,A
1-PB2,520,0,0,265,0,265,G
1-PB2,521,0,0,0,262,262,C
1-PB2,522,0,0,0,263,263,C
1-PB2,523,264,0,0,0,264,A
1-PB2,524,0,0,271,0,271,G
1-PB2,525,0,0,272,0,272,G
1-PB2,526,270,0,0,0,270,A
1-PB2,527,0,269,0,0,269,T
1-PB2,528,266,0,0,0,266,A
1-PB2,529,0,0,0,266,266,C
1-PB2,530,0,264,0,0,264,T
1-PB2,531,262,0,0,0,262,A
1-PB2,532,260,0,0,0,260,A
1-PB2,533,0,0,0,266,266,C
1-PB2,534,254,0,0,0,254,A
1-PB2,535,0,247,0,0,247,T
1-PB2,536,0,0,0,250,250,C
1-PB2,537,249,0,0,0,249,A
1-PB2,538,0,0,251,0,251,G
1-PB2,539,253,0,0,0,253,A
1-PB2,540,249,0,0,0,249,A
1-PB2,541,0,249,0,0,249,T
1-PB2,542,0,0,0,242,242,C
1-PB2,543,243,0,0,0,243,A
1-PB2,544,0,0,0,246,246,C
1-PB2,545,244,0,0,0,244,A
1-PB2,546,248,0,0,0,248,A
1-PB2,547,0,246,0,0,246,T
1-PB2,548,0,248,0,0,248,T
1-PB2,549,249,0,0,0,249,A
1-PB2,550,251,0,0,0,251,A
1-PB2,551,0,0,0,253,253,C
1-PB2,552,251,0,0,0,251,A
1-PB2,553,247,1,0,0,248,A
1-PB2,554,0,249,0,0,249,T
1-PB2,555,248,0,0,0,248,A
1-PB2,556,248,0,0,0,248,A
1-PB2,557,0,0,0,248,248,C
1-PB2,558,0,245,0,1,246,T
1-PB2,559,247,0,0,0,247,A
1-PB2,560,247,0,0,0,247,A
1-PB2,561,243,0,0,1,244,A
1-PB2,562,0,0,243,0,243,G
1-PB2,563,240,0,0,0,240,A
1-PB2,564,0,0,240,0,240,G
1-PB2,565,240,0,0,0,240,A
1-PB2,566,238,0,0,0,238,A
1-PB2,567,239,0,0,0,239,A
1-PB2,568,237,1,0,0,238,A
1-PB2,569,240,0,0,0,240,A
1-PB2,570,238,1,0,0,239,A
1-PB2,571,0,0,240,0,240,G
1-PB2,572,241,0,0,0,241,A
1-PB2,573,240,0,0,0,240,A
1-PB2,574,0,0,240,0,240,G
1-PB2,575,241,0,0,0,241,A
1-PB2,576,243,0,0,0,243,A
1-PB2,577,0,0,0,243,243,C
1-PB2,578,0,237,0,0,237,T
1-PB2,579,1,0,0,239,240,C
1-PB2,580,0,0,0,242,242,C
1-PB2,581,0,0,241,0,241,G
1-PB2,582,242,0,0,0,242,A
1-PB2,583,0,0,240,0,240,G
1-PB2,584,242,0,0,0,242,A
1-PB2,585,0,241,0,0,241,T
1-PB2,586,0,239,0,0,239,T
1-PB2,587,0,0,243,0,243,G
1-PB2,588,0,0,0,243,243,C
1-PB2,589,242,0,1,0,243,A
1-PB2,590,243,0,0,0,243,A
1-PB2,591,243,0,0,0,243,A
1-PB2,592,245,0,0,0,245,A
1-PB2,593,0,244,0,0,244,T
1-PB2,594,0,245,0,0,245,T
1-PB2,595,0,244,0,0,244,T
1-PB2,596,1,0,0,242,243,C
1-PB2,597,0,245,0,0,245,T
1-PB2,598,0,0,0,301,301,C
1-PB2,599,0,0,0,304,304,C
1-PB2,600,1,0,0,381,382,C
1-PB2,601,0,384,0,0,384,T
1-PB2,602,0,393,0,0,393,T
1-PB2,603,0,1,400,0,401,G
1-PB2,604,400,0,1,0,401,A
1-PB2,605,0,413,0,0,413,T
1-PB2,606,0,0,424,0,424,G
1-PB2,607,0,0,544,0,544,G
1-PB2,608,0,558,0,0,558,T
1-PB2,609,0,556,0,3,559,T
1-PB2,610,0,0,640,0,640,G
1-PB2,611,0,0,0,646,646,C
1-PB2,612,677,0,1,0,678,A
1-PB2,613,0,679,0,1,680,T
1-PB2,614,688,0,0,3,691,A
1-PB2,615,0,0,0,735,735,C
1-PB2,616,878,0,0,12,890,A
1-PB2,617,0,916,0,0,916,T
1-PB2,618,0,0,999,0,999,G
1-PB2,619,0,997,0,0,997,T
1-PB2,620,0,999,0,0,999,T
1-PB2,621,1001,0,0,0,1001,A
1-PB2,622,0,0,1005,0,1005,G
1-PB2,623,1027,0,0,0,1027,A
1-PB2,624,0,2,1047,0,1049,G
1-PB2,625,1025,0,1,0,1026,A
1-PB2,626,0,0,1031,0,1031,G
1-PB2,627,1027,0,0,0,1027,A
1-PB2,628,0,0,1037,1,1038,G
1-PB2,629,1039,0,1,0,1040,A
1-PB2,630,1044,0,0,0,1044,A
1-PB2,631,0,0,0,1050,1050,C
1-PB2,632,0,1051,0,0,1051,T
1-PB2,633,0,1042,0,1,1043,T
1-PB2,634,1,0,1045,1,1047,G
1-PB2,635,1,1043,0,0,1044,T
1-PB2,636,1046,1,1,0,1048,A
1-PB2,637,1,1,0,1043,1045,C
1-PB2,638,1,0,1043,0,1044,G
1-PB2,639,1049,0,0,0,1049,A
1-PB2,640,1048,1,0,0,1049,A
1-PB2,641,1061,1,0,0,1062,A
1-PB2,642,1056,0,3,0,1059,A
1-PB2,643,1059,0,2,0,1061,A
1-PB2,644,0,0,0,1073,1073,C
1-PB2,645,1070,1,0,0,1071,A
1-PB2,646,1071,0,1,0,1072,A
1-PB2,647,0,1,1078,0,1079,G
1-PB2,648,1088,0,0,0,1088,A
1-PB2,649,0,1088,0,0,1088,T
1-PB2,650,0,1081,0,0,1081,T
1-PB2,651,0,1090,0,0,1090,T
1-PB2,652,0,0,0,1091,1091,C
1-PB2,653,0,1094,0,2,1096,T
1-PB2,654,1,0,0,1095,1096,C
1-PB2,655,0,0,0,1094,1094,C
1-PB2,656,0,0,0,1097,1097,C
1-PB2,657,1100,0,1,0,1101,A
1-PB2,658,0,1,1109,0,1110,G
1-PB2,659,0,1114,0,1,1115,T
1-PB2,660,0,1110,0,1,1111,T
1-PB2,661,0,1,1111,0,1112,G
1-PB2,662,1,0,0,1109,1110,C
1-PB2,663,0,1115,0,0,1115,T
1-PB2,664,12,0,1105,0,1117,G
1-PB2,665,0,0,1115,0,1115,G
1-PB2,666,0,1,0,1113,1114,C
1-PB2,667,0,0,1117,0,1117,G
1-PB2,668,0,0,1132,0,1132,G
1-PB2,669,1136,0,0,0,1136,A
1-PB2,670,1137,0,1,0,1138,A
1-PB2,671,0,0,0,1141,1141,C
1-PB2,672,1152,0,0,0,1152,A
1-PB2,673,1148,0,0,0,1148,A
1-PB2,674,1,0,1203,0,1204,G
1-PB2,675,0,0,0,1237,1237,C
1-PB2,676,1241,0,0,0,1241,A
1-PB2,677,4,0,1613,0,1617,G
1-PB2,678,0,1616,0,0,1616,T
1-PB2,679,1631,0,2,1,1634,A
1-PB2,680,0,1632,0,1,1633,T
1-PB2,681,1643,0,0,0,1643,A
1-PB2,682,0,1644,0,0,1644,T
1-PB2,683,1635,0,1,0,1636,A
1-PB2,684,0,0,0,1654,1654,C
1-PB2,685,1589,0,0,0,1589,A
1-PB2,686,0,1530,0,0,1530,T
1-PB2,687,0,1504,0,0,1504,T
1-PB2,688,0,0,1500,1,1501,G
1-PB2,689,1499,0,2,0,1501,A
1-PB2,690,1502,0,0,0,1502,A
1-PB2,691,0,1,1530,0,1531,G
1-PB2,692,0,1523,0,0,1523,T
1-PB2,693,0,1519,0,0,1519,T
1-PB2,694,0,1519,0,1,1520,T
1-PB2,695,0,1525,0,0,1525,T
1-PB2,696,1533,0,0,0,1533,A
1-PB2,697,0,0,0,1545,1545,C
1-PB2,698,1545,0,0,0,1545,A
1-PB2,699,0,1546,0,0,1546,T
1-PB2,700,0,1532,0,0,1532,T
1-PB2,701,0,1537,0,0,1537,T
1-PB2,702,0,1,1550,0,1551,G
1-PB2,703,1558,0,1,0,1559,A
1-PB2,704,0,0,0,1543,1543,C
1-PB2,705,0,1539,0,0,1539,T
1-PB2,706,0,0,0,1532,1532,C
1-PB2,707,1532,0,1,0,1533,A
1-PB2,708,0,2,1523,0,1525,G
1-PB2,709,2,1,1566,0,1569,G
1-PB2,710,0,2,1569,0,1571,G
1-PB2,711,1575,0,1,0,1576,A
1-PB2,712,1573,0,0,1,1574,A
1-PB2,713,0,2,0,1575,1577,C
1-PB2,714,0,0,1594,0,1594,G
1-PB2,715,0,1584,0,1,1585,T
1-PB2,716,0,0,1606,0,1606,G
1-PB2,717,1,1600,0,0,1601,T
1-PB2,718,0,1597,0,0,1597,T
1-PB2,719,0,1,1606,0,1607,G
1-PB2,720,0,1,1604,0,1605,G
1-PB2,721,1,1,1619,0,1621,G
1-PB2,722,1618,0,1,0,1619,A
1-PB2,723,1617,1,1,0,1619,A
1-PB2,724,0,0,0,1676,1676,C
1-PB2,725,1670,1,1,0,1672,A
1-PB2,726,1730,0,0,1,1731,A
1-PB2,727,1727,0,0,0,1727,A
1-PB2,728,0,1741,0,0,1741,T
1-PB2,729,0,0,1763,1,1764,G
1-PB2,730,0,1756,0,0,1756,T
1-PB2,731,1754,0,0,1,1755,A
1-PB2,732,0,0,0,1760,1760,C
1-PB2,733,1727,1,1,0,1729,A
1-PB2,734,0,0,0,1731,1731,C
1-PB2,735,0,1689,0,3,1692,T
1-PB2,736,1,0,0,1849,1850,C
1-PB2,737,0,1,0,1848,1849,C
1-PB2,738,1868,1,7,1,1877,A
1-PB2,739,0,0,1894,0,1894,G
1-PB2,740,1,1,1922,0,1924,G
1-PB2,741,1,1921,0,1,1923,T
1-PB2,742,0,0,1925,0,1925,G
1-PB2,743,0,0,1899,0,1899,G
1-PB2,744,1882,0,1,0,1883,A
1-PB2,745,0,0,1898,0,1898,G
1-PB2,746,1,3,1893,0,1897,G
1-PB2,747,1882,1,2,0,1885,A
1-PB2,748,0,0,1902,0,1902,G
1-PB2,749,0,1868,0,1,1869,T
1-PB2,750,0,2,1877,0,1879,G
1-PB2,751,1880,0,1,0,1881,A
1-PB2,752,1,0,1886,0,1887,G
1-PB2,753,0,0,1898,1,1899,G
1-PB2,754,1888,1,2,0,1891,A
1-PB2,755,1896,0,1,0,1897,A
1-PB2,756,0,1908,0,2,1910,T
1-PB2,757,0,3,1902,0,1905,G
1-PB2,758,1903,1,0,0,1904,A
1-PB2,759,0,0,0,1895,1895,C
1-PB2,760,0,0,1899,0,1899,G
1-PB2,761,1924,0,1,0,1925,A
1-PB2,762,0,1907,0,2,1909,T
1-PB2,763,0,0,1912,0,1912,G
1-PB2,764,0,1915,0,0,1915,T
1-PB2,765,1,1900,0,2,1903,T
1-PB2,766,1,1,1922,0,1924,G
1-PB2,767,1925,0,3,0,1928,A
1-PB2,768,0,0,0,1929,1929,C
1-PB2,769,2,0,0,1920,1922,C
1-PB2,770,1912,0,0,0,1912,A
1-PB2,771,1913,0,0,0,1913,A
1-PB2,772,1927,1,1,0,1929,A
1-PB2,773,1,0,1980,0,1981,G
1-PB2,774,1,0,0,1980,1981,C
1-PB2,775,0,0,0,1976,1976,C
1-PB2,776,1,1994,0,0,1995,T
1-PB2,777,2002,0,0,0,2002,A
1-PB2,778,2001,0,0,0,2001,A
1-PB2,779,0,2005,0,1,2006,T
1-PB2,780,1,2000,0,1,2002,T
1-PB2,781,1989,0,0,1,1990,A
1-PB2,782,2,1958,0,0,1960,T
1-PB2,783,0,1957,0,0,1957,T
1-PB2,784,1,0,1945,0,1946,G
1-PB2,785,0,1,0,1943,1944,C
1-PB2,786,0,2,1941,0,1943,G
1-PB2,787,0,0,1965,0,1965,G
1-PB2,788,2,0,0,1959,1961,C
1-PB2,789,0,0,0,1980,1980,C
1-PB2,790,1979,0,0,0,1979,A
1-PB2,791,0,0,2008,0,2008,G
1-PB2,792,0,0,2021,0,2021,G
1-PB2,793,2017,0,5,0,2022,A
1-PB2,794,2036,0,3,0,2039,A
1-PB2,795,0,2,0,2041,2043,C
1-PB2,796,2034,0,0,0,2034,A
1-PB2,797,0,2062,0,0,2062,T
1-PB2,798,2105,0,5,1,2111,A
1-PB2,799,0,0,2134,0,2134,G
1-PB2,800,0,2119,0,0,2119,T
1-PB2,801,2102,0,1,0,2103,A
1-PB2,802,2103,0,0,0,2103,A
1-PB2,803,0,0,2103,0,2103,G
1-PB2,804,2092,0,1,1,2094,A
1-PB2,805,2067,1,1,0,2069,A
1-PB2,806,0,0,2060,0,2060,G
1-PB2,807,2017,0,1,0,2018,A
1-PB2,808,0,0,2009,0,2009,G
1-PB2,809,1,1,0,2021,2023,C
1-PB2,810,1,1,0,2019,2021,C
1-PB2,811,2,0,2022,1,2025,G
1-PB2,812,0,0,0,2032,2032,C
1-PB2,813,2045,0,0,1,2046,A
1-PB2,814,1,0,2173,0,2174,G
1-PB2,815,0,2171,0,0,2171,T
1-PB2,816,2179,1,0,0,2180,A
1-PB2,817,0,2167,0,0,2167,T
1-PB2,818,0,0,0,2191,2191,C
1-PB2,819,2192,0,1,0,2193,A
1-PB2,820,0,0,2204,0,2204,G
1-PB2,821,0,0,1,2202,2203,C
1-PB2,822,2142,1,2,0,2145,A
1-PB2,823,0,0,2126,0,2126,G
1-PB2,824,2141,1,1,0,2143,A
1-PB2,825,0,2148,0,1,2149,T
1-PB2,826,0,0,0,2156,2156,C
1-PB2,827,1,0,1,2162,2164,C
1-PB2,828,2170,0,3,0,2173,A
1-PB2,829,1,0,0,2175,2176,C
1-PB2,830,0,2174,1,1,2176,T
1-PB2,831,2186,0,0,0,2186,A
1-PB2,832,1,0,2186,0,2187,G
1-PB2,833,1,1,0,2172,2174,C
1-PB2,834,2175,0,0,0,2175,A
1-PB2,835,0,2182,0,0,2182,T
1-PB2,836,0,1,0,2206,2207,C
1-PB2,837,0,2193,0,1,2194,T
1-PB2,838,0,2250,0,0,2250,T
1-PB2,839,0,2263,0,0,2263,T
1-PB2,840,2254,0,2,0,2256,A
1-PB2,841,1,2257,0,0,2258,T
1-PB2,842,0,2248,0,2,2250,T
1-PB2,843,0,4,2244,0,2248,G
1-PB2,844,0,3,2250,0,2253,G
1-PB2,845,2207,0,2,0,2209,A
1-PB2,846,0,1,2218,0,2219,G
1-PB2,847,2182,0,2,0,2184,A
1-PB2,848,0,2178,0,1,2179,T
1-PB2,849,0,0,2217,0,2217,G
1-PB2,850,1,2214,0,2,2217,T
1-PB2,851,0,0,2210,0,2210,G
1-PB2,852,4,1,0,2212,2217,C
1-PB2,853,1,0,0,2210,2211,C
1-PB2,854,2214,0,0,0,2214,A
1-PB2,855,0,0,0,2208,2208,C
1-PB2,856,2196,0,3,0,2199,A
1-PB2,857,0,0,2226,0,2226,G
1-PB2,858,1,0,0,2183,2184,C
1-PB2,859,2179,0,3,0,2182,A
1-PB2,860,1,1,0,2174,2176,C
1-PB2,861,2175,1,3,0,2179,A
1-PB2,862,0,1,0,2195,2196,C
1-PB2,863,2195,0,1,0,2196,A
1-PB2,864,2197,0,0,0,2197,A
1-PB2,865,2201,0,0,0,2201,A
1-PB2,866,1,2148,0,1,2150,T
1-PB2,867,0,2150,0,0,2150,T
1-PB2,868,1,0,2136,0,2137,G
1-PB2,869,2,0,2135,0,2137,G
1-PB2,870,0,1,0,2132,2133,C
1-PB2,871,1,0,2127,0,2128,G
1-PB2,872,0,0,2130,0,2130,G
1-PB2,873,2126,0,1,0,2127,A
1-PB2,874,2169,0,1,0,2170,A
1-PB2,875,0,1,0,2181,2182,C
1-PB2,876,2182,1,0,0,2183,A
1-PB2,877,2181,0,0,1,2182,A
1-PB2,878,0,1,2189,0,2190,G
1-PB2,879,0,0,2189,0,2189,G
1-PB2,880,2195,1,3,0,2199,A
1-PB2,881,0,2125,0,0,2125,T
1-PB2,882,0,1,2125,0,2126,G
1-PB2,883,0,0,2144,0,2144,G
1-PB2,884,0,2135,0,1,2136,T
1-PB2,885,2,1,2126,0,2129,G
1-PB2,886,0,0,2137,0,2137,G
1-PB2,887,2116,0,3,0,2119,A
1-PB2,888,0,0,0,2126,2126,C
1-PB2,889,2106,0,1,0,2107,A
1-PB2,890,0,2409,0,0,2409,T
1-PB2,891,0,2401,0,1,2402,T
1-PB2,892,1,0,0,2405,2406,C
1-PB2,893,1,2382,0,1,2384,T
1-PB2,894,0,2385,0,0,2385,T
1-PB2,895,2395,0,0,0,2395,A
1-PB2,896,0,1,2406,0,2407,G
1-PB2,897,2399,0,3,1,2403,A
1-PB2,898,0,3,0,2403,2406,C
1-PB2,899,2105,0,0,0,2105,A
1-PB2,900,2,1,2120,0,2123,G
1-PB2,901,2116,0,0,1,2117,A
1-PB2,902,2123,0,1,0,2124,A
1-PB2,903,0,0,0,2123,2123,C
1-PB2,904,2,1,0,2107,2110,C
1-PB2,905,1,0,0,2108,2109,C
1-PB2,906,1,1,2111,0,2113,G
1-PB2,907,2112,0,3,1,2116,A
1-PB2,908,0,0,0,2113,2113,C
1-PB2,909,1,2083,0,1,2085,T
1-PB2,910,0,0,2107,1,2108,G
1-PB2,911,2104,0,0,0,2104,A
1-PB2,912,2114,0,2,0,2116,A
1-PB2,913,0,2,2125,0,2127,G
1-PB2,914,2125,1,1,0,2127,A
1-PB2,915,2130,1,0,0,2131,A
1-PB2,916,0,0,0,2132,2132,C
1-PB2,917,2118,0,0,0,2118,A
1-PB2,918,2126,0,1,0,2127,A
1-PB2,919,1,0,2135,1,2137,G
1-PB2,920,0,0,0,2145,2145,C
1-PB2,921,0,2122,0,0,2122,T
1-PB2,922,0,0,2150,0,2150,G
1-PB2,923,1,2137,0,1,2139,T
1-PB2,924,0,0,2172,1,2173,G
1-PB2,925,0,1,2262,0,2263,G
1-PB2,926,2255,0,1,0,2256,A
1-PB2,927,0,2261,0,1,2262,T
1-PB2,928,2239,0,0,0,2239,A
1-PB2,929,0,2226,0,0,2226,T
1-PB2,930,2290,0,1,0,2291,A
1-PB2,931,0,2257,0,2,2259,T
1-PB2,932,1,0,2250,0,2251,G
1-PB2,933,0,1,0,2223,2224,C
1-PB2,934,2128,0,3,0,2131,A
1-PB2,935,2126,0,1,0,2127,A
1-PB2,936,1,1,2122,0,2124,G
1-PB2,937,3,0,2132,0,2135,G
1-PB2,938,1,0,0,2136,2137,C
1-PB2,939,1,2106,0,0,2107,T
1-PB2,940,0,0,2115,0,2115,G
1-PB2,941,1,1,0,2110,2112,C
1-PB2,942,2115,0,2,0,2117,A
1-PB2,943,2122,2,0,0,2124,A
1-PB2,944,0,2107,0,2,2109,T
1-PB2,945,1,2,2109,0,2112,G
1-PB2,946,0,0,2100,0,2100,G
1-PB2,947,1,1,2106,0,2108,G
1-PB2,948,2103,2,5,0,2110,A
1-PB2,949,0,2089,0,1,2090,T
1-PB2,950,0,2088,0,2,2090,T
1-PB2,951,1,1,2090,0,2092,G
1-PB2,952,2083,0,3,0,2086,A
1-PB2,953,1,0,2100,0,2101,G
1-PB2,954,2081,0,1,0,2082,A
1-PB2,955,2070,0,2,0,2072,A
1-PB2,956,0,2047,1,0,2048,T
1-PB2,957,0,0,0,2053,2053,C
1-PB2,958,2053,0,2,0,2055,A
1-PB2,959,0,0,2058,1,2059,G
1-PB2,960,0,1,0,2056,2057,C
1-PB2,961,1,2038,1,1,2041,T
1-PB2,962,1,0,0,2036,2037,C
1-PB2,963,2038,0,1,0,2039,A
1-PB2,964,0,2067,0,1,2068,T
1-PB2,965,1,0,0,2072,2073,C
1-PB2,966,0,0,0,2094,2094,C
1-PB2,967,0,2087,1,1,2089,T
1-PB2,968,0,2071,0,1,2072,T
1-PB2,969,1,0,0,2077,2078,C
1-PB2,970,2077,0,1,0,2078,A
1-PB2,971,0,0,2107,0,2107,G
1-PB2,972,0,1,0,2104,2105,C
1-PB2,973,1,2067,1,4,2073,T
1-PB2,974,0,2076,0,1,2077,T
1-PB2,975,0,2068,1,1,2070,T
1-PB2,976,34,2,2033,0,2069,G
1-PB2,977,2,0,2072,1,2075,G
1-PB2,978,1,2065,0,3,2069,T
1-PB2,979,1,3,2076,0,2080,G
1-PB2,980,1,0,2070,0,2071,G
1-PB2,981,0,0,2094,0,2094,G
1-PB2,982,0,2079,0,0,2079,T
1-PB2,983,0,2074,0,1,2075,T
1-PB2,984,0,2078,0,1,2079,T
1-PB2,985,2088,1,1,0,2090,A
1-PB2,986,0,0,0,2091,2091,C
1-PB2,987,2095,0,0,0,2095,A
1-PB2,988,0,2086,1,0,2087,T
1-PB2,989,0,2053,0,0,2053,T
1-PB2,990,0,2054,0,0,2054,T
1-PB2,991,2047,0,1,0,2048,A
1-PB2,992,2045,0,0,0,2045,A
1-PB2,993,2052,0,0,0,2052,A
1-PB2,994,2035,0,1,0,2036,A
1-PB2,995,0,1,2041,0,2042,G
1-PB2,996,2020,0,0,0,2020,A
1-PB2,997,2022,0,1,0,2023,A
1-PB2,998,0,1,0,2027,2028,C
1-PB2,999,2020,2,0,0,2022,A
1-PB2,1000,2021,0,2,0,2023,A
1-PB2,1001,0,0,2022,0,2022,G
1-PB2,1002,0,1,0,2023,2024,C
1-PB2,1003,1,2,2016,0,2019,G
1-PB2,1004,0,4,2021,0,2025,G
1-PB2,1005,0,0,2032,0,2032,G
1-PB2,1006,1,2018,0,7,2026,T
1-PB2,1007,3,0,0,2019,2022,C
1-PB2,1008,2024,0,0,1,2025,A
1-PB2,1009,0,2013,0,1,2014,T
1-PB2,1010,0,0,0,2024,2024,C
1-PB2,1011,2015,0,1,0,2016,A
1-PB2,1012,0,0,2052,0,2052,G
1-PB2,1013,0,2030,0,3,2033,T
1-PB2,1014,2,1,0,2029,2032,C
1-PB2,1015,2028,1,2,0,2031,A
1-PB2,1016,2035,0,0,0,2035,A
1-PB2,1017,2032,1,0,0,2033,A
1-PB2,1018,2027,0,0,0,2027,A
1-PB2,1019,2039,0,0,0,2039,A
1-PB2,1020,2039,1,1,0,2041,A
1-PB2,1021,0,0,2044,0,2044,G
1-PB2,1022,2031,1,2,0,2034,A
1-PB2,1023,2032,0,3,0,2035,A
1-PB2,1024,0,1,2036,0,2037,G
1-PB2,1025,2028,0,1,0,2029,A
1-PB2,1026,1974,1,1,0,1976,A
1-PB2,1027,0,0,1980,0,1980,G
1-PB2,1028,1970,0,3,0,1973,A
1-PB2,1029,0,0,1976,0,1976,G
1-PB2,1030,1,1,2007,0,2009,G
1-PB2,1031,1,1996,0,0,1997,T
1-PB2,1032,1,0,2041,0,2042,G
1-PB2,1033,1,0,0,2043,2044,C
1-PB2,1034,2,2042,0,0,2044,T
1-PB2,1035,0,2054,0,0,2054,T
1-PB2,1036,2049,0,0,0,2049,A
1-PB2,1037,0,0,0,2036,2036,C
1-PB2,1038,2025,0,3,0,2028,A
1-PB2,1039,1,0,2021,0,2022,G
1-PB2,1040,0,0,2020,0,2020,G
1-PB2,1041,0,1,0,1983,1984,C
1-PB2,1042,1965,0,0,0,1965,A
1-PB2,1043,1972,0,0,0,1972,A
1-PB2,1044,0,1989,0,1,1990,T
1-PB2,1045,2,0,0,2013,2015,C
1-PB2,1046,0,2013,0,0,2013,T
1-PB2,1047,2,1,1,2010,2014,C
1-PB2,1048,2,0,0,2012,2014,C
1-PB2,1049,2019,0,0,0,2019,A
1-PB2,1050,2020,0,0,0,2020,A
1-PB2,1051,2020,0,1,0,2021,A
1-PB2,1052,0,0,0,2037,2037,C
1-PB2,1053,1970,0,0,0,1970,A
1-PB2,1054,0,1939,0,2,1941,T
1-PB2,1055,0,1902,0,0,1902,T
1-PB2,1056,0,2,1900,1,1903,G
1-PB2,1057,1888,0,1,1,1890,A
1-PB2,1058,1,0,1876,0,1877,G
1-PB2,1059,1965,0,1,0,1966,A
1-PB2,1060,1965,0,1,0,1966,A
1-PB2,1061,0,1980,0,0,1980,T
1-PB2,1062,1979,0,0,0,1979,A
1-PB2,1063,1976,0,1,0,1977,A
1-PB2,1064,0,1,2023,0,2024,G
1-PB2,1065,1984,1,4,0,1989,A
1-PB2,1066,0,0,2033,0,2033,G
1-PB2,1067,0,1971,0,3,1974,T
1-PB2,1068,1995,0,0,0,1995,A
1-PB2,1069,0,0,0,2043,2043,C
1-PB2,1070,2026,0,0,0,2026,A
1-PB2,1071,0,2022,0,0,2022,T
1-PB2,1072,0,1,2017,0,2018,G
1-PB2,1073,1965,0,4,0,1969,A
1-PB2,1074,0,2,1968,0,1970,G
1-PB2,1075,1,4,1974,1,1980,G
1-PB2,1076,0,0,2058,0,2058,G
1-PB2,1077,2,1,2068,0,2071,G
1-PB2,1078,0,2039,0,1,2040,T
1-PB2,1079,2041,0,1,0,2042,A
1-PB2,1080,0,2028,0,3,2031,T
1-PB2,1081,0,2,2042,0,2044,G
1-PB2,1082,2040,2,0,0,2042,A
1-PB2,1083,0,0,2034,0,2034,G
1-PB2,1084,0,2,2015,0,2017,G
1-PB2,1085,1859,0,0,1,1860,A
1-PB2,1086,0,0,1901,0,1901,G
1-PB2,1087,0,1899,0,0,1899,T
1-PB2,1088,0,1948,0,2,1950,T
1-PB2,1089,2,0,0,1958,1960,C
1-PB2,1090,1955,1,0,1,1957,A
1-PB2,1091,1,1,0,1955,1957,C
1-PB2,1092,1952,0,1,0,1953,A
1-PB2,1093,1969,0,0,0,1969,A
1-PB2,1094,1,1955,0,1,1957,T
1-PB2,1095,0,1,1918,0,1919,G
1-PB2,1096,0,0,1937,0,1937,G
1-PB2,1097,0,1881,0,1,1882,T
1-PB2,1098,0,3,1860,0,1863,G
1-PB2,1099,0,0,1891,0,1891,G
1-PB2,1100,0,2,1887,0,1889,G
1-PB2,1101,0,3,1900,0,1903,G
1-PB2,1102,1888,0,2,0,1890,A
1-PB2,1103,1894,1,0,0,1895,A
1-PB2,1104,1885,1,1,0,1887,A
1-PB2,1105,1856,0,1,0,1857,A
1-PB2,1106,0,1,1881,0,1882,G
1-PB2,1107,1867,0,5,0,1872,A
1-PB2,1108,0,0,1879,0,1879,G
1-PB2,1109,0,1,0,1877,1878,C
1-PB2,1110,1872,0,1,0,1873,A
1-PB2,1111,1873,0,1,0,1874,A
1-PB2,1112,0,1,0,1931,1932,C
1-PB2,1113,1934,1,0,0,1935,A
1-PB2,1114,0,0,1967,0,1967,G
1-PB2,1115,1,0,0,1957,1958,C
1-PB2,1116,0,1955,0,0,1955,T
1-PB2,1117,1997,0,1,0,1998,A
1-PB2,1118,0,1998,0,0,1998,T
1-PB2,1119,2004,0,3,0,2007,A
1-PB2,1120,0,0,0,2009,2009,C
1-PB2,1121,1,1884,0,2,1887,T
1-PB2,1122,1901,0,0,0,1901,A
1-PB2,1123,1854,0,0,0,1854,A
1-PB2,1124,0,0,1862,0,1862,G
1-PB2,1125,1860,1,0,0,1861,A
1-PB2,1126,1805,0,0,0,1805,A
1-PB2,1127,1805,1,0,0,1806,A
1-PB2,1128,1802,0,2,0,1804,A
1-PB2,1129,1,0,1808,0,1809,G
1-PB2,1130,0,0,0,1799,1799,C
1-PB2,1131,1796,1,0,0,1797,A
1-PB2,1132,1801,0,0,0,1801,A
1-PB2,1133,0,1,0,1806,1807,C
1-PB2,1134,0,1,0,1806,1807,C
1-PB2,1135,1813,0,0,0,1813,A
1-PB2,1136,1,1,1827,0,1829,G
1-PB2,1137,1827,0,0,0,1827,A
1-PB2,1138,1819,1,2,0,1822,A
1-PB2,1139,0,1,1831,0,1832,G
1-PB2,1140,1829,0,0,0,1829,A
1-PB2,1141,0,1824,1,0,1825,T
1-PB2,1142,0,1806,0,1,1807,T
1-PB2,1143,0,1,1818,1,1820,G
1-PB2,1144,1,1,1846,0,1848,G
1-PB2,1145,0,1835,0,2,1837,T
1-PB2,1146,1,1834,1,1,1837,T
1-PB2,1147,1,0,0,1832,1833,C
1-PB2,1148,1827,0,0,0,1827,A
1-PB2,1149,1816,0,2,1,1819,A
1-PB2,1150,2,0,0,1942,1944,C
1-PB2,1151,0,1934,1,2,1937,T
1-PB2,1152,2,0,0,1959,1961,C
1-PB2,1153,1928,1,1,0,1930,A
1-PB2,1154,2,1929,1,0,1932,T
1-PB2,1155,1932,1,1,0,1934,A
1-PB2,1156,0,0,1941,0,1941,G
1-PB2,1157,0,1878,1,1,1880,T
1-PB2,1158,0,0,1903,0,1903,G
1-PB2,1159,1822,0,0,0,1822,A
1-PB2,1160,0,0,1852,0,1852,G
1-PB2,1161,0,1837,0,2,1839,T
1-PB2,1162,0,1,1835,0,1836,G
1-PB2,1163,1,0,1847,0,1848,G
1-PB2,1164,1848,1,3,0,1852,A
1-PB2,1165,1844,0,2,0,1846,A
1-PB2,1166,0,1,1850,0,1851,G
1-PB2,1167,1813,0,2,0,1815,A
1-PB2,1168,1,0,1823,0,1824,G
1-PB2,1169,1796,0,2,0,1798,A
1-PB2,1170,0,0,0,1797,1797,C
1-PB2,1171,1,2,1798,0,1801,G
1-PB2,1172,1789,0,0,0,1789,A
1-PB2,1173,1792,1,1,0,1794,A
1-PB2,1174,0,1,0,1794,1795,C
1-PB2,1175,1786,1,1,0,1788,A
1-PB2,1176,0,0,1898,0,1898,G
1-PB2,1177,0,1878,1,3,1882,T
1-PB2,1178,0,0,0,1881,1881,C
1-PB2,1179,1887,2,3,0,1892,A
1-PB2,1180,1881,0,3,0,1884,A
1-PB2,1181,0,1882,0,1,1883,T
1-PB2,1182,1869,1,0,0,1870,A
1-PB2,1183,0,0,1862,1,1863,G
1-PB2,1184,0,0,0,1859,1859,C
1-PB2,1185,0,1,0,1802,1803,C
1-PB2,1186,1,1,1793,0,1795,G
1-PB2,1187,1797,0,0,0,1797,A
1-PB2,1188,1797,0,0,0,1797,A
1-PB2,1189,0,1,1813,0,1814,G
1-PB2,1190,1,1,0,1857,1859,C
1-PB2,1191,1858,0,0,0,1858,A
1-PB2,1192,1860,0,0,0,1860,A
1-PB2,1193,0,1860,0,0,1860,T
1-PB2,1194,1870,0,0,0,1870,A
1-PB2,1195,1888,0,0,0,1888,A
1-PB2,1196,0,1890,0,0,1890,T
1-PB2,1197,0,1,0,1876,1877,C
1-PB2,1198,1,1,1868,0,1870,G
1-PB2,1199,1,1820,0,2,1823,T
1-PB2,1200,0,0,1823,1,1824,G
1-PB2,1201,1,0,1838,0,1839,G
1-PB2,1202,0,0,0,1842,1842,C
1-PB2,1203,2,0,0,1836,1838,C
1-PB2,1204,1826,0,0,0,1826,A
1-PB2,1205,1,1818,0,2,1821,T
1-PB2,1206,1,0,1829,0,1830,G
1-PB2,1207,0,0,1844,0,1844,G
1-PB2,1208,0,1816,1,2,1819,T
1-PB2,1209,0,0,1823,0,1823,G
1-PB2,1210,0,1764,0,1,1765,T
1-PB2,1211,0,1760,0,1,1761,T
1-PB2,1212,0,1768,0,0,1768,T
1-PB2,1213,0,1765,0,3,1768,T
1-PB2,1214,2,0,0,1782,1784,C
1-PB2,1215,1785,0,1,0,1786,A
1-PB2,1216,0,0,0,1838,1838,C
1-PB2,1217,1817,0,2,0,1819,A
1-PB2,1218,1821,0,1,1,1823,A
1-PB2,1219,1,0,1826,0,1827,G
1-PB2,1220,1815,0,1,0,1816,A
1-PB2,1221,1765,0,32,0,1797,A
1-PB2,1222,0,0,1830,1,1831,G
1-PB2,1223,1837,1,0,0,1838,A
1-PB2,1224,0,1835,1,1,1837,T
1-PB2,1225,0,1824,0,0,1824,T
1-PB2,1226,2,0,1824,0,1826,G
1-PB2,1227,0,0,0,1801,1801,C
1-PB2,1228,1816,0,1,0,1817,A
1-PB2,1229,0,1830,1,1,1832,T
1-PB2,1230,0,0,1883,0,1883,G
1-PB2,1231,1893,0,0,0,1893,A
1-PB2,1232,1,1897,0,0,1898,T
1-PB2,1233,1898,0,0,0,1898,A
1-PB2,1234,1893,1,1,0,1895,A
1-PB2,1235,1895,1,0,0,1896,A
1-PB2,1236,1899,0,1,0,1900,A
1-PB2,1237,0,0,1903,0,1903,G
1-PB2,1238,1,0,0,1932,1933,C
1-PB2,1239,1940,0,0,1,1941,A
1-PB2,1240,1,0,2002,0,2003,G
1-PB2,1241,1,1990,0,0,1991,T
1-PB2,1242,0,1989,1,0,1990,T
1-PB2,1243,1991,1,0,0,1992,A
1-PB2,1244,0,0,2002,0,2002,G
1-PB2,1245,1986,0,3,0,1989,A
1-PB2,1246,1,0,1990,0,1991,G
1-PB2,1247,16,0,1973,0,1989,G
1-PB2,1248,1,1892,0,2,1895,T
1-PB2,1249,0,3,1894,0,1897,G
1-PB2,1250,1903,0,0,0,1903,A
1-PB2,1251,0,1,0,1909,1910,C
1-PB2,1252,0,0,0,1914,1914,C
1-PB2,1253,0,1903,0,0,1903,T
1-PB2,1254,0,2,1910,0,1912,G
1-PB2,1255,1911,1,0,0,1912,A
1-PB2,1256,1907,0,1,0,1908,A
1-PB2,1257,1,1906,0,0,1907,T
1-PB2,1258,0,1928,2,3,1933,T
1-PB2,1259,0,1943,0,0,1943,T
1-PB2,1260,0,1,0,1944,1945,C
1-PB2,1261,0,0,1939,1,1940,G
1-PB2,1262,3,1940,0,1,1944,T
1-PB2,1263,1,0,2,1938,1941,C
1-PB2,1264,1938,0,1,0,1939,A
1-PB2,1265,1941,0,2,0,1943,A
1-PB2,1266,0,0,0,1941,1941,C
1-PB2,1267,1916,0,0,0,1916,A
1-PB2,1268,1,2,1940,0,1943,G
1-PB2,1269,1932,0,1,0,1933,A
1-PB2,1270,0,0,1945,0,1945,G
1-PB2,1271,0,1,1,1941,1943,C
1-PB2,1272,1937,0,0,0,1937,A
1-PB2,1273,1956,0,0,0,1956,A
1-PB2,1274,1960,0,2,0,1962,A
1-PB2,1275,1,1952,0,0,1953,T
1-PB2,1276,0,0,0,1958,1958,C
1-PB2,1277,1933,1,1,0,1935,A
1-PB2,1278,0,0,1936,0,1936,G
1-PB2,1279,0,0,0,1941,1941,C
1-PB2,1280,0,0,1950,0,1950,G
1-PB2,1281,0,0,2035,0,2035,G
1-PB2,1282,0,2026,0,1,2027,T
1-PB2,1283,0,2028,0,1,2029,T
1-PB2,1284,1,1,2027,1,2030,G
1-PB2,1285,2032,1,0,0,2033,A
1-PB2,1286,2049,0,1,0,2050,A
1-PB2,1287,1,0,0,2048,2049,C
1-PB2,1288,0,0,0,2035,2035,C
1-PB2,1289,3,1,0,2038,2042,C
1-PB2,1290,0,0,0,1981,1981,C
1-PB2,1291,1987,0,1,0,1988,A
1-PB2,1292,0,1998,0,0,1998,T
1-PB2,1293,2,0,2003,0,2005,G
1-PB2,1294,1,0,0,2007,2008,C
1-PB2,1295,2001,1,0,0,2002,A
1-PB2,1296,0,1982,0,4,1986,T
1-PB2,1297,0,1,0,1980,1981,C
1-PB2,1298,1975,0,0,1,1976,A
1-PB2,1299,1,0,2002,0,2003,G
1-PB2,1300,0,0,0,2003,2003,C
1-PB2,1301,0,2001,0,3,2004,T
1-PB2,1302,0,2004,0,0,2004,T
1-PB2,1303,0,1997,0,1,1998,T
1-PB2,1304,1,1999,1,1,2002,T
1-PB2,1305,2004,1,1,0,2006,A
1-PB2,1306,1996,1,1,0,1998,A
1-PB2,1307,0,0,2002,0,2002,G
1-PB2,1308,1,1,1984,0,1986,G
1-PB2,1309,0,0,0,1970,1970,C
1-PB2,1310,1964,1,1,0,1966,A
1-PB2,1311,0,1962,0,0,1962,T
1-PB2,1312,0,1966,2,0,1968,T
1-PB2,1313,1,1968,0,0,1969,T
1-PB2,1314,0,1736,0,240,1976,T
1-PB2,1315,2,0,0,1974,1976,C
1-PB2,1316,1977,0,0,0,1977,A
1-PB2,1317,0,0,1978,0,1978,G
1-PB2,1318,1967,0,0,0,1967,A
1-PB2,1319,1963,0,0,0,1963,A
1-PB2,1320,1961,0,1,0,1962,A
1-PB2,1321,0,0,1956,0,1956,G
1-PB2,1322,1970,0,1,0,1971,A
1-PB2,1323,0,1969,0,1,1970,T
1-PB2,1324,0,1,1969,0,1970,G
1-PB2,1325,0,1,1,1971,1973,C
1-PB2,1326,0,1,1971,0,1972,G
1-PB2,1327,1972,1,0,0,1973,A
1-PB2,1328,1966,0,0,1,1967,A
1-PB2,1329,1967,0,0,0,1967,A
1-PB2,1330,0,1,1974,0,1975,G
1-PB2,1331,0,1956,0,1,1957,T
1-PB2,1332,1,1,1964,0,1966,G
1-PB2,1333,0,0,0,1954,1954,C
1-PB2,1334,0,1950,0,3,1953,T
1-PB2,1335,0,1946,1,0,1947,T
1-PB2,1336,0,1956,0,0,1956,T
1-PB2,1337,0,1956,0,0,1956,T
1-PB2,1338,0,1958,1,1,1960,T
1-PB2,1339,2,0,0,1956,1958,C
1-PB2,1340,1963,0,1,0,1964,A
1-PB2,1341,1973,0,1,0,1974,A
1-PB2,1342,1969,0,0,1,1970,A
1-PB2,1343,1978,1,2,0,1981,A
1-PB2,1344,0,1971,0,2,1973,T
1-PB2,1345,0,1984,0,0,1984,T
1-PB2,1346,2,3,1975,0,1980,G
1-PB2,1347,0,3,1983,0,1986,G
1-PB2,1348,1,1,1979,1,1982,G
1-PB2,1349,0,2,2003,0,2005,G
1-PB2,1350,1988,1,4,0,1993,A
1-PB2,1351,0,0,2028,0,2028,G
1-PB2,1352,0,2021,0,0,2021,T
1-PB2,1353,0,2014,0,0,2014,T
1-PB2,1354,0,0,2022,0,2022,G
1-PB2,1355,2025,1,0,0,2026,A
1-PB2,1356,2029,1,2,0,2032,A
1-PB2,1357,1,0,0,2058,2059,C
1-PB2,1358,2036,2,0,0,2038,A
1-PB2,1359,0,0,0,2077,2077,C
1-PB2,1360,2044,0,0,1,2045,A
1-PB2,1361,0,2049,0,1,2050,T
1-PB2,1362,2,1,0,2048,2051,C
1-PB2,1363,0,1,2054,0,2055,G
1-PB2,1364,2058,1,0,0,2059,A
1-PB2,1365,0,0,0,2059,2059,C
1-PB2,1366,1990,2,2,0,1994,A
1-PB2,1367,0,1,2050,0,2051,G
1-PB2,1368,0,2007,0,0,2007,T
1-PB2,1369,0,0,2028,0,2028,G
1-PB2,1370,0,2021,0,2,2023,T
1-PB2,1371,0,0,2029,0,2029,G
1-PB2,1372,2028,0,0,0,2028,A
1-PB2,1373,1,2015,0,0,2016,T
1-PB2,1374,0,0,2018,0,2018,G
1-PB2,1375,3,0,2008,0,2011,G
1-PB2,1376,0,2,1979,0,1981,G
1-PB2,1377,1971,0,2,1,1974,A
1-PB2,1378,1955,0,0,0,1955,A
1-PB2,1379,0,1955,0,1,1956,T
1-PB2,1380,0,0,1975,0,1975,G
1-PB2,1381,1983,0,0,0,1983,A
1-PB2,1382,0,1977,0,0,1977,T
1-PB2,1383,0,1981,0,0,1981,T
1-PB2,1384,0,2,1965,0,1967,G
1-PB2,1385,0,1,2014,0,2015,G
1-PB2,1386,1999,1,0,0,2000,A
1-PB2,1387,0,0,2012,0,2012,G
1-PB2,1388,0,1990,0,0,1990,T
1-PB2,1389,1976,0,0,0,1976,A
1-PB2,1390,0,1969,0,0,1969,T
1-PB2,1391,1,1985,0,1,1987,T
1-PB2,1392,2002,0,0,0,2002,A
1-PB2,1393,0,0,0,2000,2000,C
1-PB2,1394,0,0,0,1969,1969,C
1-PB2,1395,1939,0,1,0,1940,A
1-PB2,1396,0,1,1943,0,1944,G
1-PB2,1397,1972,0,0,0,1972,A
1-PB2,1398,0,1953,0,0,1953,T
1-PB2,1399,1941,0,0,0,1941,A
1-PB2,1400,0,1922,0,1,1923,T
1-PB2,1401,0,2,1909,0,1911,G
1-PB2,1402,1913,1,1,0,1915,A
1-PB2,1403,1,0,0,1926,1927,C
1-PB2,1404,2,1910,0,3,1915,T
1-PB2,1405,1,1,0,1902,1904,C
1-PB2,1406,1,1,0,1875,1877,C
1-PB2,1407,1886,0,0,0,1886,A
1-PB2,1408,1889,0,2,0,1891,A
1-PB2,1409,0,0,1938,0,1938,G
1-PB2,1410,0,1,0,1923,1924,C
1-PB2,1411,1923,1,1,0,1925,A
1-PB2,1412,1,0,0,1912,1913,C
1-PB2,1413,1897,1,0,0,1898,A
1-PB2,1414,0,0,1906,0,1906,G
1-PB2,1415,1899,2,1,0,1902,A
1-PB2,1416,0,0,1954,1,1955,G
1-PB2,1417,1956,0,0,0,1956,A
1-PB2,1418,1,1881,0,2,1884,T
1-PB2,1419,1,0,1908,0,1909,G
1-PB2,1420,2,1896,0,0,1898,T
1-PB2,1421,3,0,0,1896,1899,C
1-PB2,1422,1906,0,1,0,1907,A
1-PB2,1423,1905,0,1,0,1906,A
1-PB2,1424,0,1897,0,0,1897,T
1-PB2,1425,0,2,1897,0,1899,G
1-PB2,1426,1869,1,1,0,1871,A
1-PB2,1427,0,0,1886,0,1886,G
1-PB2,1428,1833,1,4,0,1838,A
1-PB2,1429,0,1,1842,0,1843,G
1-PB2,1430,3,2,1910,0,1915,G
1-PB2,1431,1913,1,0,0,1914,A
1-PB2,1432,1922,1,0,0,1923,A
1-PB2,1433,0,1919,0,1,1920,T
1-PB2,1434,1918,0,2,0,1920,A
1-PB2,1435,1915,1,1,0,1917,A
1-PB2,1436,0,0,1908,0,1908,G
1-PB2,1437,1896,0,0,0,1896,A
1-PB2,1438,0,0,1899,0,1899,G
1-PB2,1439,0,1791,0,0,1791,T
1-PB2,1440,0,1,0,1796,1797,C
1-PB2,1441,1791,1,2,0,1794,A
1-PB2,1442,0,0,1797,0,1797,G
1-PB2,1443,0,0,0,1803,1803,C
1-PB2,1444,1800,0,0,0,1800,A
1-PB2,1445,1809,0,0,0,1809,A
1-PB2,1446,1792,1,0,0,1793,A
1-PB2,1447,1799,0,2,0,1801,A
1-PB2,1448,0,1803,0,0,1803,T
1-PB2,1449,0,3,1796,0,1799,G
1-PB2,1450,1,0,1801,1,1803,G
1-PB2,1451,0,0,1813,0,1813,G
1-PB2,1452,0,1788,0,2,1790,T
1-PB2,1453,0,0,1793,0,1793,G
1-PB2,1454,0,1787,0,1,1788,T
1-PB2,1455,0,1,1790,0,1791,G
1-PB2,1456,0,1,1807,0,1808,G
1-PB2,1457,1806,1,1,1,1809,A
1-PB2,1458,0,1805,0,0,1805,T
1-PB2,1459,0,1,1811,1,1813,G
1-PB2,1460,1801,1,0,0,1802,A
1-PB2,1461,1805,0,1,0,1806,A
1-PB2,1462,0,1803,0,0,1803,T
1-PB2,1463,1789,0,0,0,1789,A
1-PB2,1464,0,0,0,1879,1879,C
1-PB2,1465,1,1837,0,1,1839,T
1-PB2,1466,1,0,0,1851,1852,C
1-PB2,1467,0,0,0,1858,1858,C
1-PB2,1468,1833,1,2,0,1836,A
1-PB2,1469,0,0,1894,0,1894,G
1-PB2,1470,0,1883,0,0,1883,T
1-PB2,1471,1893,0,0,0,1893,A
1-PB2,1472,0,0,0,1891,1891,C
1-PB2,1473,1691,0,2,0,1693,A
1-PB2,1474,0,1,1697,0,1698,G
1-PB2,1475,1648,0,2,0,1650,A
1-PB2,1476,1,0,1658,0,1659,G
1-PB2,1477,1615,0,0,0,1615,A
1-PB2,1478,0,1,1536,0,1537,G
1-PB2,1479,0,1,1528,0,1529,G
1-PB2,1480,0,0,1531,0,1531,G
1-PB2,1481,0,1516,0,2,1518,T
1-PB2,1482,0,0,1519,0,1519,G
1-PB2,1483,0,0,1519,0,1519,G
1-PB2,1484,0,1509,0,0,1509,T
1-PB2,1485,0,2,1537,0,1539,G
1-PB2,1486,0,0,1541,0,1541,G
1-PB2,1487,1,1496,0,1,1498,T
1-PB2,1488,0,1494,0,3,1497,T
1-PB2,1489,1470,0,14,0,1484,A
1-PB2,1490,0,0,1489,0,1489,G
1-PB2,1491,0,18,1,1467,1486,C
1-PB2,1492,1474,0,0,0,1474,A
1-PB2,1493,0,1468,0,3,1471,T
1-PB2,1494,0,1392,0,0,1392,T
1-PB2,1495,0,1,1391,1,1393,G
1-PB2,1496,1390,0,0,0,1390,A
1-PB2,1497,1,1384,0,1,1386,T
1-PB2,1498,1,1,0,1386,1388,C
1-PB2,1499,0,0,1379,0,1379,G
1-PB2,1500,0,0,1403,0,1403,G
1-PB2,1501,0,1397,0,0,1397,T
1-PB2,1502,0,1393,0,0,1393,T
1-PB2,1503,0,1398,0,0,1398,T
1-PB2,1504,0,1397,0,0,1397,T
1-PB2,1505,0,1397,0,1,1398,T
1-PB2,1506,0,2,1398,0,1400,G
1-PB2,1507,1392,0,4,0,1396,A
1-PB2,1508,0,0,1395,0,1395,G
1-PB2,1509,1344,0,2,0,1346,A
1-PB2,1510,0,1,1353,0,1354,G
1-PB2,1511,0,1353,0,1,1354,T
1-PB2,1512,0,1351,0,0,1351,T
1-PB2,1513,1,0,0,1350,1351,C
1-PB2,1514,1,0,1352,0,1353,G
1-PB2,1515,1349,0,0,0,1349,A
1-PB2,1516,0,0,1355,0,1355,G
1-PB2,1517,1350,0,2,0,1352,A
1-PB2,1518,0,0,0,1352,1352,C
1-PB2,1519,0,0,0,1346,1346,C
1-PB2,1520,1330,0,1,0,1331,A
1-PB2,1521,1340,1,1,0,1342,A
1-PB2,1522,0,0,0,1344,1344,C
1-PB2,1523,0,0,1347,0,1347,G
1-PB2,1524,0,1332,0,7,1339,T
1-PB2,1525,0,0,1335,0,1335,G
1-PB2,1526,0,0,1340,0,1340,G
1-PB2,1527,1,1,1333,0,1335,G
1-PB2,1528,1326,0,0,1,1327,A
1-PB2,1529,1329,0,0,0,1329,A
1-PB2,1530,0,1283,0,2,1285,T
1-PB2,1531,0,0,1316,0,1316,G
1-PB2,1532,0,1315,0,0,1315,T
1-PB2,1533,1316,1,1,0,1318,A
1-PB2,1534,0,1316,0,0,1316,T
1-PB2,1535,0,1296,0,0,1296,T
1-PB2,1536,1310,0,0,0,1310,A
1-PB2,1537,0,1300,0,2,1302,T
1-PB2,1538,0,1282,0,0,1282,T
1-PB2,1539,1275,0,1,0,1276,A
1-PB2,1540,0,1112,0,0,1112,T
1-PB2,1541,0,0,0,1119,1119,C
1-PB2,1542,0,1099,1,1,1101,T
1-PB2,1543,0,0,0,1099,1099,C
1-PB2,1544,0,1,0,1101,1102,C
1-PB2,1545,1,1065,0,1,1067,T
1-PB2,1546,0,0,1068,0,1068,G
1-PB2,1547,1066,0,0,0,1066,A
1-PB2,1548,0,0,1064,0,1064,G
1-PB2,1549,0,0,1063,0,1063,G
1-PB2,1550,920,1,4,0,925,A
1-PB2,1551,0,0,932,0,932,G
1-PB2,1552,0,0,923,0,923,G
1-PB2,1553,0,865,0,0,865,T
1-PB2,1554,1,0,0,867,868,C
1-PB2,1555,858,0,0,0,858,A
1-PB2,1556,0,0,864,0,864,G
1-PB2,1557,0,861,0,1,862,T
1-PB2,1558,0,0,861,0,861,G
1-PB2,1559,862,0,0,0,862,A
1-PB2,1560,814,0,1,0,815,A
1-PB2,1561,816,0,1,0,817,A
1-PB2,1562,0,1,0,817,818,C
1-PB2,1563,812,0,0,0,812,A
1-PB2,1564,0,0,0,812,812,C
1-PB2,1565,764,0,0,0,764,A
1-PB2,1566,1,0,767,0,768,G
1-PB2,1567,0,1,763,0,764,G
1-PB2,1568,0,1,768,0,769,G
1-PB2,1569,767,0,1,0,768,A
1-PB2,1570,751,0,0,0,751,A
1-PB2,1571,0,0,0,759,759,C
1-PB2,1572,0,754,0,0,754,T
1-PB2,1573,0,0,755,0,755,G
1-PB2,1574,746,0,0,0,746,A
1-PB2,1575,0,0,747,0,747,G
1-PB2,1576,732,0,1,0,733,A
1-PB2,1577,0,1,686,0,687,G
1-PB2,1578,683,0,1,0,684,A
1-PB2,1579,0,0,0,680,680,C
1-PB2,1580,1,648,0,0,649,T
1-PB2,1581,1,0,652,0,653,G
1-PB2,1582,646,0,1,0,647,A
1-PB2,1583,0,1,0,646,647,C
1-PB2,1584,643,0,0,0,643,A
1-PB2,1585,642,0,0,0,642,A
1-PB2,1586,0,637,0,0,637,T
1-PB2,1587,630,0,0,0,630,A
1-PB2,1588,630,0,1,0,631,A
1-PB2,1589,1,0,0,632,633,C
1-PB2,1590,0,571,0,2,573,T
1-PB2,1591,0,564,0,0,564,T
1-PB2,1592,553,0,0,0,553,A
1-PB2,1593,0,551,0,2,553,T
1-PB2,1594,0,551,0,1,552,T
1-PB2,1595,1,0,0,549,550,C
1-PB2,1596,504,0,0,0,504,A
1-PB2,1597,0,503,0,0,503,T
1-PB2,1598,0,0,0,476,476,C
1-PB2,1599,0,0,475,0,475,G
1-PB2,1600,0,474,0,0,474,T
1-PB2,1601,1,0,0,468,469,C
1-PB2,1602,0,0,469,0,469,G
1-PB2,1603,468,1,0,0,469,A
1-PB2,1604,0,467,0,1,468,T
1-PB2,1605,0,0,464,0,464,G
1-PB2,1606,462,0,1,0,463,A
1-PB2,1607,0,463,0,0,463,T
1-PB2,1608,0,0,457,0,457,G
1-PB2,1609,1,429,0,0,430,T
1-PB2,1610,0,0,427,0,427,G
1-PB2,1611,0,0,428,0,428,G
1-PB2,1612,0,0,423,0,423,G
1-PB2,1613,404,0,1,0,405,A
1-PB2,1614,0,0,395,0,395,G
1-PB2,1615,337,0,0,0,337,A
1-PB2,1616,0,317,0,0,317,T
1-PB2,1617,0,304,0,0,304,T
1-PB2,1618,299,0,0,0,299,A
1-PB2,1619,296,0,1,0,297,A
1-PB2,1620,0,0,0,289,289,C
1-PB2,1621,0,1,246,0,247,G
1-PB2,1622,1,0,240,0,241,G
1-PB2,1623,0,167,0,0,167,T
1-PB2,1624,0,0,0,160,160,C
1-PB2,1625,0,0,0,161,161,C
1-PB2,1626,0,127,0,0,127,T
1-PB2,1627,0,0,127,0,127,G
1-PB2,1628,124,0,0,0,124,A
1-PB2,1629,0,0,127,0,127,G
1-PB2,1630,0,127,0,0,127,T
1-PB2,1631,0,0,0,122,122,C
1-PB2,1632,0,0,118,0,118,G
1-PB2,1633,0,0,124,0,124,G
1-PB2,1634,0,124,0,0,124,T
1-PB2,1635,0,124,0,0,124,T
1-PB2,1636,0,124,0,0,124,T
1-PB2,1637,0,125,0,0,125,T
1-PB2,1638,0,0,127,0,127,G
1-PB2,1639,0,0,127,0,127,G
1-PB2,1640,0,127,0,0,127,T
1-PB2,1641,0,0,0,128,128,C
1-PB2,1642,126,0,0,0,126,A
1-PB2,1643,131,0,0,0,131,A
1-PB2,1644,0,129,0,0,129,T
1-PB2,1645,130,0,0,0,130,A
1-PB2,1646,0,0,0,135,135,C
1-PB2,1647,0,0,0,135,135,C
1-PB2,1648,0,135,0,0,135,T
1-PB2,1649,135,0,0,0,135,A
1-PB2,1650,0,136,0,0,136,T
1-PB2,1651,1,0,0,134,135,C
1-PB2,1652,135,0,0,0,135,A
1-PB2,1653,135,0,0,0,135,A
1-PB2,1654,0,134,0,0,134,T
1-PB2,1655,0,0,131,0,131,G
1-PB2,1656,0,0,131,0,131,G
1-PB2,1657,129,0,0,0,129,A
1-PB2,1658,0,126,0,0,126,T
1-PB2,1659,0,0,0,129,129,C
1-PB2,1660,129,0,0,0,129,A
1-PB2,1661,0,129,0,0,129,T
1-PB2,1662,0,0,0,131,131,C
1-PB2,1663,131,0,0,0,131,A
1-PB2,1664,0,0,133,0,133,G
1-PB2,1665,132,0,0,0,132,A
1-PB2,1666,133,0,0,1,134,A
1-PB2,1667,133,0,0,0,133,A
1-PB2,1668,0,135,0,0,135,T
1-PB2,1669,0,134,0,1,135,T
1-PB2,1670,0,0,134,0,134,G
1-PB2,1671,0,1,133,0,134,G
1-PB2,1672,0,0,135,0,135,G
1-PB2,1673,135,0,0,0,135,A
1-PB2,1674,133,0,0,0,133,A
1-PB2,1675,0,0,133,0,133,G
1-PB2,1676,0,0,0,132,132,C
1-PB2,1677,0,132,0,0,132,T
1-PB2,1678,0,0,132,0,132,G
1-PB2,1679,0,132,0,0,132,T
1-PB2,1680,0,0,0,130,130,C
1-PB2,1681,132,0,0,0,132,A
1-PB2,1682,132,0,0,0,132,A
1-PB2,1683,131,0,0,0,131,A
1-PB2,1684,133,0,0,0,133,A
1-PB2,1685,0,131,0,0,131,T
1-PB2,1686,0,133,0,0,133,T
1-PB2,1687,0,0,0,132,132,C
1-PB2,1688,132,1,0,0,133,A
1-PB2,1689,133,0,0,0,133,A
1-PB2,1690,0,133,0,0,133,T
1-PB2,1691,1,0,132,0,133,G
1-PB2,1692,0,0,134,0,134,G
1-PB2,1693,0,136,0,0,136,T
1-PB2,1694,0,0,0,138,138,C
1-PB2,1695,0,138,0,0,138,T
1-PB2,1696,0,0,0,138,138,C
1-PB2,1697,138,0,0,0,138,A
1-PB2,1698,0,1,137,0,138,G
1-PB2,1699,136,0,0,0,136,A
1-PB2,1700,137,0,0,0,137,A
1-PB2,1701,0,138,0,0,138,T
1-PB2,1702,0,0,0,134,134,C
1-PB2,1703,0,0,0,134,134,C
1-PB2,1704,0,133,0,0,133,T
1-PB2,1705,0,0,133,0,133,G
1-PB2,1706,0,0,0,134,134,C
1-PB2,1707,131,0,0,0,131,A
1-PB2,1708,135,0,0,0,135,A
1-PB2,1709,0,134,0,0,134,T
1-PB2,1710,0,0,141,0,141,G
1-PB2,1711,0,140,1,0,141,T
1-PB2,1712,0,140,0,0,140,T
1-PB2,1713,0,0,142,0,142,G
1-PB2,1714,0,142,0,0,142,T
1-PB2,1715,142,0,0,0,142,A
1-PB2,1716,0,0,0,142,142,C
1-PB2,1717,138,0,0,0,138,A
1-PB2,1718,140,0,0,0,140,A
1-PB2,1719,0,0,0,136,136,C
1-PB2,1720,134,0,0,0,134,A
1-PB2,1721,134,0,0,0,134,A
1-PB2,1722,131,0,0,0,131,A
1-PB2,1723,130,0,0,0,130,A
1-PB2,1724,0,130,0,0,130,T
1-PB2,1725,0,0,130,0,130,G
1-PB2,1726,0,0,131,0,131,G
1-PB2,1727,131,0,0,0,131,A
1-PB2,1728,132,0,0,0,132,A
1-PB2,1729,0,132,0,0,132,T
1-PB2,1730,0,133,0,0,133,T
1-PB2,1731,0,133,0,0,133,T
1-PB2,1732,0,0,131,0,131,G
1-PB2,1733,132,0,0,0,132,A
1-PB2,1734,134,0,0,0,134,A
1-PB2,1735,0,0,0,134,134,C
1-PB2,1736,0,0,0,129,129,C
1-PB2,1737,130,0,0,0,130,A
1-PB2,1738,0,132,0,0,132,T
1-PB2,1739,0,131,0,0,131,T
1-PB2,1740,0,132,0,0,132,T
1-PB2,1741,1,0,0,131,132,C
1-PB2,1742,133,0,0,0,133,A
1-PB2,1743,132,0,0,0,132,A
1-PB2,1744,0,132,0,0,132,T
1-PB2,1745,0,0,0,132,132,C
1-PB2,1746,0,132,0,0,132,T
1-PB2,1747,0,132,0,0,132,T
1-PB2,1748,0,133,0,0,133,T
1-PB2,1749,133,0,0,0,133,A
1-PB2,1750,0,0,133,0,133,G
1-PB2,1751,0,133,0,0,133,T
1-PB2,1752,0,1,0,132,133,C
1-PB2,1753,0,0,0,133,133,C
1-PB2,1754,0,0,0,130,130,C
1-PB2,1755,0,0,0,131,131,C
1-PB2,1756,132,0,0,0,132,A
1-PB2,1757,131,0,1,0,132,A
1-PB2,1758,0,0,134,0,134,G
1-PB2,1759,0,0,133,0,133,G
1-PB2,1760,0,0,0,133,133,C
1-PB2,1761,1,0,0,131,132,C
1-PB2,1762,131,0,0,0,131,A
1-PB2,1763,0,134,0,0,134,T
1-PB2,1764,0,134,0,0,134,T
1-PB2,1765,134,0,0,0,134,A
1-PB2,1766,0,0,134,0,134,G
1-PB2,1767,126,0,0,0,126,A
1-PB2,1768,133,0,0,0,133,A
1-PB2,1769,0,0,134,0,134,G
1-PB2,1770,0,0,0,134,134,C
1-PB2,1771,0,0,0,134,134,C
1-PB2,1772,131,0,0,0,131,A
1-PB2,1773,131,0,0,0,131,A
1-PB2,1774,0,132,0,0,132,T
1-PB2,1775,131,0,0,0,131,A
1-PB2,1776,0,0,0,134,134,C
1-PB2,1777,127,0,0,0,127,A
1-PB2,1778,0,0,129,0,129,G
1-PB2,1779,0,127,0,0,127,T
1-PB2,1780,1,0,128,0,129,G
1-PB2,1781,0,0,129,0,129,G
1-PB2,1782,1,0,127,0,128,G
1-PB2,1783,0,129,0,0,129,T
1-PB2,1784,0,127,0,0,127,T
1-PB2,1785,0,128,0,0,128,T
1-PB2,1786,0,0,132,0,132,G
1-PB2,1787,0,131,0,0,131,T
1-PB2,1788,0,0,0,130,130,C
1-PB2,1789,132,0,0,0,132,A
1-PB2,1790,0,0,133,0,133,G
1-PB2,1791,132,0,0,0,132,A
1-PB2,1792,131,0,1,0,132,A
1-PB2,1793,0,0,0,133,133,C
1-PB2,1794,0,127,0,0,127,T
1-PB2,1795,0,0,0,133,133,C
1-PB2,1796,0,132,0,0,132,T
1-PB2,1797,134,0,0,0,134,A
1-PB2,1798,0,133,0,0,133,T
1-PB2,1799,0,129,0,0,129,T
1-PB2,1800,0,0,0,129,129,C
1-PB2,1801,0,0,0,128,128,C
1-PB2,1802,127,0,0,0,127,A
1-PB2,1803,128,0,0,0,128,A
1-PB2,1804,0,0,0,126,126,C
1-PB2,1805,124,0,0,0,124,A
1-PB2,1806,127,0,0,0,127,A
1-PB2,1807,126,0,0,0,126,A
1-PB2,1808,0,126,0,0,126,T
1-PB2,1809,0,0,126,0,126,G
1-PB2,1810,124,0,0,0,124,A
1-PB2,1811,0,0,127,0,127,G
1-PB2,1812,125,0,0,0,125,A
1-PB2,1813,0,0,125,0,125,G
1-PB2,1814,123,0,1,0,124,A
1-PB2,1815,0,0,0,122,122,C
1-PB2,1816,0,0,125,0,125,G
1-PB2,1817,0,125,0,0,125,T
1-PB2,1818,125,0,0,0,125,A
1-PB2,1819,0,0,0,126,126,C
1-PB2,1820,0,125,0,0,125,T
1-PB2,1821,0,125,0,0,125,T
1-PB2,1822,0,0,124,0,124,G
1-PB2,1823,0,0,124,0,124,G
1-PB2,1824,0,1,125,0,126,G
1-PB2,1825,126,0,0,0,126,A
1-PB2,1826,0,0,0,128,128,C
1-PB2,1827,128,0,0,0,128,A
1-PB2,1828,0,127,0,0,127,T
1-PB2,1829,0,126,0,1,127,T
1-PB2,1830,0,128,0,0,128,T
1-PB2,1831,0,0,125,0,125,G
1-PB2,1832,125,0,1,0,126,A
1-PB2,1833,0,0,0,128,128,C
1-PB2,1834,128,0,0,0,128,A
1-PB2,1835,0,0,0,130,130,C
1-PB2,1836,0,0,0,126,126,C
1-PB2,1837,126,0,0,0,126,A
1-PB2,1838,0,0,0,126,126,C
1-PB2,1839,0,0,0,126,126,C
1-PB2,1840,0,0,0,126,126,C
1-PB2,1841,124,0,0,0,124,A
1-PB2,1842,0,0,124,0,124,G
1-PB2,1843,125,0,0,0,125,A
1-PB2,1844,0,127,0,0,127,T
1-PB2,1845,126,0,0,0,126,A
1-PB2,1846,126,0,0,0,126,A
1-PB2,1847,0,127,0,0,127,T
1-PB2,1848,125,0,0,0,125,A
1-PB2,1849,124,0,0,0,124,A
1-PB2,1850,124,0,0,0,124,A
1-PB2,1851,0,0,124,0,124,G
1-PB2,1852,0,0,0,124,124,C
1-PB2,1853,0,121,0,0,121,T
1-PB2,1854,0,120,0,0,120,T
1-PB2,1855,0,0,0,120,120,C
1-PB2,1856,0,119,0,0,119,T
1-PB2,1857,0,0,0,124,124,C
1-PB2,1858,0,0,0,122,122,C
1-PB2,1859,0,0,0,121,121,C
1-PB2,1860,0,0,0,116,116,C
1-PB2,1861,0,120,0,0,120,T
1-PB2,1862,0,120,0,0,120,T
1-PB2,1863,0,119,0,0,119,T
1-PB2,1864,0,0,120,0,120,G
1-PB2,1865,0,0,0,120,120,C
1-PB2,1866,117,0,0,0,117,A
1-PB2,1867,0,0,117,0,117,G
1-PB2,1868,0,0,0,116,116,C
1-PB2,1869,0,114,0,0,114,T
1-PB2,1870,0,0,114,0,114,G
1-PB2,1871,0,0,0,114,114,C
1-PB2,1872,0,112,0,1,113,T
1-PB2,1873,0,0,0,112,112,C
1-PB2,1874,0,0,0,112,112,C
1-PB2,1875,112,0,0,0,112,A
1-PB2,1876,0,0,0,111,111,C
1-PB2,1877,0,0,0,111,111,C
1-PB2,1878,110,0,0,0,110,A
1-PB2,1879,108,0,0,1,109,A
1-PB2,1880,109,0,0,0,109,A
1-PB2,1881,0,0,112,0,112,G
1-PB2,1882,0,0,0,112,112,C
1-PB2,1883,111,0,0,0,111,A
1-PB2,1884,111,0,0,0,111,A
1-PB2,1885,111,0,0,0,111,A
1-PB2,1886,0,0,115,0,115,G
1-PB2,1887,0,0,0,115,115,C
1-PB2,1888,115,0,0,0,115,A
1-PB2,1889,0,0,115,0,115,G
1-PB2,1890,114,0,0,0,114,A
1-PB2,1891,116,0,0,0,116,A
1-PB2,1892,0,116,0,0,116,T
1-PB2,1893,0,0,116,0,116,G
1-PB2,1894,0,0,0,116,116,C
1-PB2,1895,114,0,0,0,114,A
1-PB2,1896,0,0,117,0,117,G
1-PB2,1897,0,117,0,0,117,T
1-PB2,1898,0,123,0,0,123,T
1-PB2,1899,0,0,0,123,123,C
1-PB2,1900,0,123,0,0,123,T
1-PB2,1901,0,0,0,126,126,C
1-PB2,1902,0,124,0,0,124,T
1-PB2,1903,0,124,0,0,124,T
1-PB2,1904,0,0,0,125,125,C
1-PB2,1905,124,0,0,0,124,A
1-PB2,1906,0,0,0,124,124,C
1-PB2,1907,0,120,0,0,120,T
1-PB2,1908,0,0,126,0,126,G
1-PB2,1909,126,0,0,0,126,A
1-PB2,1910,0,0,0,127,127,C
1-PB2,1911,0,124,0,0,124,T
1-PB2,1912,1,0,125,0,126,G
1-PB2,1913,0,126,0,0,126,T
1-PB2,1914,0,0,128,0,128,G
1-PB2,1915,129,0,0,0,129,A
1-PB2,1916,132,0,0,0,132,A
1-PB2,1917,0,128,0,0,128,T
1-PB2,1918,0,0,129,0,129,G
1-PB2,1919,0,127,0,0,127,T
1-PB2,1920,125,0,0,0,125,A
1-PB2,1921,125,0,0,0,125,A
1-PB2,1922,0,0,125,0,125,G
1-PB2,1923,0,0,128,0,128,G
1-PB2,1924,0,0,127,0,127,G
1-PB2,1925,0,0,127,0,127,G
1-PB2,1926,127,0,0,0,127,A
1-PB2,1927,0,128,0,0,128,T
1-PB2,1928,0,0,0,128,128,C
1-PB2,1929,128,0,0,0,128,A
1-PB2,1930,0,0,129,0,129,G
1-PB2,1931,0,0,126,0,126,G
1-PB2,1932,0,0,127,0,127,G
1-PB2,1933,126,0,0,0,126,A
1-PB2,1934,0,123,0,0,123,T
1-PB2,1935,0,0,123,0,123,G
1-PB2,1936,121,0,0,0,121,A
1-PB2,1937,0,0,128,0,128,G
1-PB2,1938,128,0,0,0,128,A
1-PB2,1939,127,0,0,0,127,A
1-PB2,1940,0,130,0,0,130,T
1-PB2,1941,130,0,0,0,130,A
1-PB2,1942,0,0,0,133,133,C
1-PB2,1943,0,133,0,0,133,T
1-PB2,1944,0,133,0,0,133,T
1-PB2,1945,0,0,132,0,132,G
1-PB2,1946,0,126,0,0,126,T
1-PB2,1947,128,0,0,0,128,A
1-PB2,1948,126,0,1,0,127,A
1-PB2,1949,0,0,125,0,125,G
1-PB2,1950,0,0,127,0,127,G
1-PB2,1951,0,0,124,0,124,G
1-PB2,1952,0,0,125,0,125,G
1-PB2,1953,0,0,0,125,125,C
1-PB2,1954,125,0,0,0,125,A
1-PB2,1955,125,0,0,0,125,A
1-PB2,1956,0,125,0,0,125,T
1-PB2,1957,0,124,0,0,124,T
1-PB2,1958,0,0,0,126,126,C
1-PB2,1959,0,122,0,1,123,T
1-PB2,1960,0,0,0,124,124,C
1-PB2,1961,0,0,0,124,124,C
1-PB2,1962,0,123,0,0,123,T
1-PB2,1963,0,0,125,0,125,G
1-PB2,1964,0,123,0,0,123,T
1-PB2,1965,123,0,0,0,123,A
1-PB2,1966,0,122,0,0,122,T
1-PB2,1967,0,120,0,0,120,T
1-PB2,1968,1,0,0,121,122,C
1-PB2,1969,120,0,0,0,120,A
1-PB2,1970,121,0,0,0,121,A
1-PB2,1971,0,0,0,121,121,C
1-PB2,1972,0,118,0,1,119,T
1-PB2,1973,122,0,0,0,122,A
1-PB2,1974,0,0,0,130,130,C
1-PB2,1975,129,0,0,0,129,A
1-PB2,1976,129,0,0,0,129,A
1-PB2,1977,0,0,0,129,129,C
1-PB2,1978,128,0,0,0,128,A
1-PB2,1979,127,0,0,0,127,A
1-PB2,1980,0,0,127,0,127,G
1-PB2,1981,128,0,0,0,128,A
1-PB2,1982,0,0,0,127,127,C
1-PB2,1983,0,0,0,124,124,C
1-PB2,1984,125,0,0,0,125,A
1-PB2,1985,0,0,0,126,126,C
1-PB2,1986,0,126,0,0,126,T
1-PB2,1987,126,0,0,0,126,A
1-PB2,1988,127,0,0,0,127,A
1-PB2,1989,126,0,0,0,126,A
1-PB2,1990,124,0,0,0,124,A
1-PB2,1991,0,0,127,0,127,G
1-PB2,1992,127,0,0,0,127,A
1-PB2,1993,0,0,0,127,127,C
1-PB2,1994,0,120,0,0,120,T
1-PB2,1995,121,0,0,0,121,A
1-PB2,1996,121,0,0,0,121,A
1-PB2,1997,0,0,0,121,121,C
1-PB2,1998,119,0,0,0,119,A
1-PB2,1999,120,0,0,0,120,A
1-PB2,2000,0,121,0,0,121,T
1-PB2,2001,0,119,0,0,119,T
1-PB2,2002,0,0,0,121,121,C
1-PB2,2003,0,120,0,0,120,T
1-PB2,2004,0,0,0,121,121,C
1-PB2,2005,0,0,121,0,121,G
1-PB2,2006,0,0,121,0,121,G
1-PB2,2007,121,0,0,0,121,A
1-PB2,2008,122,0,0,0,122,A
1-PB2,2009,122,0,0,0,122,A
1-PB2,2010,122,0,0,0,122,A
1-PB2,2011,0,0,122,0,122,G
1-PB2,2012,122,0,0,0,122,A
1-PB2,2013,0,121,0,0,121,T
1-PB2,2014,0,0,121,0,121,G
1-PB2,2015,0,0,0,120,120,C
1-PB2,2016,0,0,0,121,121,C
1-PB2,2017,0,0,119,0,119,G
1-PB2,2018,0,0,121,0,121,G
1-PB2,2019,0,0,0,121,121,C
1-PB2,2020,120,0,1,0,121,A
1-PB2,2021,0,0,0,121,121,C
1-PB2,2022,0,121,0,0,121,T
1-PB2,2023,0,121,0,0,121,T
1-PB2,2024,0,123,0,0,123,T
1-PB2,2025,123,0,0,0,123,A
1-PB2,2026,122,1,0,0,123,A
1-PB2,2027,0,123,0,0,123,T
1-PB2,2028,0,122,0,0,122,T
1-PB2,2029,0,0,122,0,122,G
1-PB2,2030,117,0,0,0,117,A
1-PB2,2031,117,0,0,0,117,A
1-PB2,2032,0,0,117,0,117,G
1-PB2,2033,118,0,0,0,118,A
1-PB2,2034,0,0,0,118,118,C
1-PB2,2035,1,0,0,115,116,C
1-PB2,2036,0,0,0,117,117,C
1-PB2,2037,116,0,0,0,116,A
1-PB2,2038,0,0,117,0,117,G
1-PB2,2039,116,0,0,1,117,A
1-PB2,2040,0,117,0,0,117,T
1-PB2,2041,0,0,116,0,116,G
1-PB2,2042,113,0,0,0,113,A
1-PB2,2043,113,0,0,0,113,A
1-PB2,2044,111,0,1,0,112,A
1-PB2,2045,0,0,113,0,113,G
1-PB2,2046,0,0,0,115,115,C
1-PB2,2047,113,0,0,0,113,A
1-PB2,2048,0,0,0,113,113,C
1-PB2,2049,112,0,1,0,113,A
1-PB2,2050,1,112,0,0,113,T
1-PB2,2051,0,0,0,113,113,C
1-PB2,2052,0,0,0,113,113,C
1-PB2,2053,0,0,113,0,113,G
1-PB2,2054,0,0,114,0,114,G
1-PB2,2055,114,0,0,0,114,A
1-PB2,2056,0,0,113,0,113,G
1-PB2,2057,0,110,0,0,110,T
1-PB2,2058,0,0,109,0,109,G
1-PB2,2059,0,2,108,0,110,G
1-PB2,2060,109,0,0,0,109,A
1-PB2,2061,0,0,109,0,109,G
1-PB2,2062,0,107,0,0,107,T
1-PB2,2063,0,0,0,105,105,C
1-PB2,2064,0,0,0,105,105,C
1-PB2,2065,0,0,105,0,105,G
1-PB2,2066,0,0,0,105,105,C
1-PB2,2067,0,0,0,105,105,C
1-PB2,2068,0,0,106,0,106,G
1-PB2,2069,0,106,0,0,106,T
1-PB2,2070,0,0,1,106,107,C
1-PB2,2071,0,107,0,0,107,T
1-PB2,2072,0,107,0,0,107,T
1-PB2,2073,0,0,107,0,107,G
1-PB2,2074,107,0,0,0,107,A
1-PB2,2075,0,0,106,0,106,G
1-PB2,2076,104,0,0,0,104,A
1-PB2,2077,0,1,99,0,100,G
1-PB2,2078,0,0,101,0,101,G
1-PB2,2079,0,0,99,0,99,G
1-PB2,2080,0,98,0,0,98,T
1-PB2,2081,0,97,0,0,97,T
1-PB2,2082,0,99,0,0,99,T
1-PB2,2083,1,0,0,97,98,C
1-PB2,2084,0,99,0,0,99,T
1-PB2,2085,0,0,0,100,100,C
1-PB2,2086,100,0,0,0,100,A
1-PB2,2087,0,99,0,0,99,T
1-PB2,2088,0,98,0,0,98,T
1-PB2,2089,98,0,0,0,98,A
1-PB2,2090,0,100,0,0,100,T
1-PB2,2091,101,0,0,0,101,A
1-PB2,2092,0,0,101,0,101,G
1-PB2,2093,0,0,101,0,101,G
1-PB2,2094,0,96,0,0,96,T
1-PB2,2095,96,0,0,0,96,A
1-PB2,2096,95,0,0,0,95,A
1-PB2,2097,0,0,98,0,98,G
1-PB2,2098,0,0,97,0,97,G
1-PB2,2099,98,0,0,0,98,A
1-PB2,2100,95,0,0,0,95,A
1-PB2,2101,0,0,97,0,97,G
1-PB2,2102,94,0,0,0,94,A
1-PB2,2103,0,0,0,94,94,C
1-PB2,2104,94,0,0,0,94,A
1-PB2,2105,0,0,94,0,94,G
1-PB2,2106,94,0,0,0,94,A
1-PB2,2107,93,0,0,0,93,A
1-PB2,2108,0,0,93,0,93,G
1-PB2,2109,0,0,93,0,93,G
1-PB2,2110,0,98,0,0,98,T
1-PB2,2111,98,0,0,0,98,A
1-PB2,2112,0,0,0,98,98,C
1-PB2,2113,0,0,97,0,97,G
1-PB2,2114,0,0,99,0,99,G
1-PB2,2115,99,0,0,0,99,A
1-PB2,2116,0,0,0,99,99,C
1-PB2,2117,0,0,0,98,98,C
1-PB2,2118,95,0,0,0,95,A
1-PB2,2119,0,0,102,0,102,G
1-PB2,2120,0,0,0,102,102,C
1-PB2,2121,102,0,0,0,102,A
1-PB2,2122,0,102,0,0,102,T
1-PB2,2123,0,99,0,0,99,T
1-PB2,2124,99,0,0,0,99,A
1-PB2,2125,98,0,0,0,98,A
1-PB2,2126,0,0,100,0,100,G
1-PB2,2127,0,0,0,100,100,C
1-PB2,2128,91,0,0,0,91,A
1-PB2,2129,0,90,0,0,90,T
1-PB2,2130,0,0,0,90,90,C
1-PB2,2131,90,0,0,0,90,A
1-PB2,2132,90,0,0,0,90,A
1-PB2,2133,0,89,0,0,89,T
1-PB2,2134,0,0,89,0,89,G
1-PB2,2135,88,0,0,0,88,A
1-PB2,2136,88,0,0,0,88,A
1-PB2,2137,0,0,0,88,88,C
1-PB2,2138,0,85,0,0,85,T
1-PB2,2139,0,0,86,0,86,G
1-PB2,2140,84,0,0,0,84,A
1-PB2,2141,0,0,84,0,84,G
1-PB2,2142,0,83,0,0,83,T
1-PB2,2143,83,0,0,0,83,A
1-PB2,2144,84,0,0,0,84,A
1-PB2,2145,0,0,0,85,85,C
1-PB2,2146,0,0,0,84,84,C
1-PB2,2147,0,84,0,0,84,T
1-PB2,2148,0,82,0,0,82,T
1-PB2,2149,0,0,81,0,81,G
1-PB2,2150,0,0,0,82,82,C
1-PB2,2151,81,0,0,0,81,A
1-PB2,2152,82,0,0,0,82,A
1-PB2,2153,81,0,0,0,81,A
1-PB2,2154,81,0,0,0,81,A
1-PB2,2155,0,0,81,0,81,G
1-PB2,2156,0,0,81,0,81,G
1-PB2,2157,0,0,82,0,82,G
1-PB2,2158,0,0,81,0,81,G
1-PB2,2159,81,0,0,0,81,A
1-PB2,2160,81,0,0,0,81,A
1-PB2,2161,81,0,0,0,81,A
1-PB2,2162,80,0,1,0,81,A
1-PB2,2163,0,0,81,0,81,G
1-PB2,2164,0,0,81,0,81,G
1-PB2,2165,0,0,0,80,80,C
1-PB2,2166,0,81,0,0,81,T
1-PB2,2167,81,0,0,0,81,A
1-PB2,2168,81,0,0,0,81,A
1-PB2,2169,0,81,0,0,81,T
1-PB2,2170,0,0,81,0,81,G
1-PB2,2171,0,76,0,1,77,T
1-PB2,2172,0,0,76,0,76,G
1-PB2,2173,0,0,0,76,76,C
1-PB2,2174,0,75,0,0,75,T
1-PB2,2175,75,0,0,0,75,A
1-PB2,2176,75,0,0,0,75,A
1-PB2,2177,0,73,0,1,74,T
1-PB2,2178,0,0,0,74,74,C
1-PB2,2179,0,0,70,0,70,G
1-PB2,2180,0,0,71,0,71,G
1-PB2,2181,1,0,69,0,70,G
1-PB2,2182,0,0,0,71,71,C
1-PB2,2183,71,0,0,0,71,A
1-PB2,2184,70,0,0,0,70,A
1-PB2,2185,0,0,70,0,70,G
1-PB2,2186,0,0,70,0,70,G
1-PB2,2187,69,0,0,0,69,A
1-PB2,2188,0,0,71,0,71,G
1-PB2,2189,70,0,0,0,70,A
1-PB2,2190,0,0,0,70,70,C
1-PB2,2191,0,0,71,0,71,G
1-PB2,2192,0,70,0,0,70,T
1-PB2,2193,0,0,70,0,70,G
1-PB2,2194,0,0,70,0,70,G
1-PB2,2195,0,68,0,0,68,T
1-PB2,2196,0,0,70,0,70,G
1-PB2,2197,0,70,0,0,70,T
1-PB2,2198,0,69,0,0,69,T
1-PB2,2199,0,0,68,0,68,G
1-PB2,2200,0,0,68,0,68,G
1-PB2,2201,0,68,0,0,68,T
1-PB2,2202,67,0,0,0,67,A
1-PB2,2203,62,0,0,0,62,A
1-PB2,2204,0,61,0,0,61,T
1-PB2,2205,0,0,60,0,60,G
1-PB2,2206,60,0,0,0,60,A
1-PB2,2207,59,0,0,0,59,A
1-PB2,2208,59,0,0,0,59,A
1-PB2,2209,0,0,0,57,57,C
1-PB2,2210,0,0,58,0,58,G
1-PB2,2211,57,0,0,0,57,A
1-PB2,2212,58,0,0,0,58,A
1-PB2,2213,58,0,0,0,58,A
1-PB2,2214,58,0,0,0,58,A
1-PB2,2215,0,0,0,58,58,C
1-PB2,2216,0,0,58,0,58,G
1-PB2,2217,0,0,59,0,59,G
1-PB2,2218,0,0,58,0,58,G
1-PB2,2219,58,0,1,0,59,A
1-PB2,2220,0,0,0,58,58,C
1-PB2,2221,0,59,0,0,59,T
1-PB2,2222,0,0,0,58,58,C
1-PB2,2223,0,59,0,0,59,T
1-PB2,2224,59,0,0,0,59,A
1-PB2,2225,0,0,59,0,59,G
1-PB2,2226,0,0,0,58,58,C
1-PB2,2227,58,0,0,0,58,A
1-PB2,2228,0,58,0,0,58,T
1-PB2,2229,52,0,0,0,52,A
1-PB2,2230,0,0,0,53,53,C
1-PB2,2231,0,42,0,0,42,T
1-PB2,2232,0,42,0,0,42,T
1-PB2,2233,41,0,0,0,41,A
1-PB2,2234,0,0,0,41,41,C
1-PB2,2235,0,40,0,0,40,T
1-PB2,2236,0,0,40,0,40,G
1-PB2,2237,38,0,0,0,38,A
1-PB2,2238,0,0,0,39,39,C
1-PB2,2239,38,0,0,0,38,A
1-PB2,2240,0,0,37,0,37,G
1-PB2,2241,0,0,0,38,38,C
1-PB2,2242,0,0,0,37,37,C
1-PB2,2243,37,0,0,0,37,A
1-PB2,2244,0,0,37,0,37,G
1-PB2,2245,37,0,0,0,37,A
1-PB2,2246,0,0,0,37,37,C
1-PB2,2247,34,0,0,0,34,A
1-PB2,2248,0,0,34,0,34,G
1-PB2,2249,0,0,0,31,31,C
1-PB2,2250,0,0,31,0,31,G
1-PB2,2251,31,0,0,0,31,A
1-PB2,2252,0,0,0,31,31,C
1-PB2,2253,0,0,0,31,31,C
1-PB2,2254,31,0,0,0,31,A
1-PB2,2255,31,0,0,0,31,A
1-PB2,2256,31,0,0,0,31,A
1-PB2,2257,31,0,0,0,31,A
1-PB2,2258,0,0,31,0,31,G
1-PB2,2259,31,0,0,0,31,A
1-PB2,2260,31,0,0,0,31,A
1-PB2,2261,0,31,0,0,31,T
1-PB2,2262,0,31,0,0,31,T
1-PB2,2263,0,0,0,31,31,C
1-PB2,2264,0,0,30,0,30,G
1-PB2,2265,0,0,31,0,31,G
1-PB2,2266,31,0,0,0,31,A
1-PB2,2267,0,30,0,0,30,T
1-PB2,2268,0,0,30,0,30,G
1-PB2,2269,0,0,30,0,30,G
1-PB2,2270,0,0,0,30,30,C
1-PB2,2271,0,0,0,30,30,C
1-PB2,2272,30,0,0,0,30,A
1-PB2,2273,0,30,0,0,30,T
1-PB2,2274,0,0,0,30,30,C
1-PB2,2275,30,0,0,0,30,A
1-PB2,2276,30,0,0,0,30,A
1-PB2,2277,0,30,0,0,30,T
1-PB2,2278,0,25,0,0,25,T
1-PB2,2279,24,0,0,0,24,A
1-PB2,2280,23,0,0,0,23,A
2-PB1,1,227,0,0,0,227,A
2-PB1,2,0,229,0,0,229,T
2-PB1,3,0,0,236,0,236,G
2-PB1,4,0,0,257,0,257,G
2-PB1,5,287,0,0,0,287,A
2-PB1,6,1,303,0,0,304,T
2-PB1,7,1,0,304,0,305,G
2-PB1,8,0,306,0,0,306,T
2-PB1,9,0,0,0,330,330,C
2-PB1,10,334,0,0,0,334,A
2-PB1,11,344,0,0,0,344,A
2-PB1,12,0,346,0,0,346,T
2-PB1,13,1,0,0,346,347,C
2-PB1,14,0,0,0,362,362,C
2-PB1,15,0,0,367,0,367,G
2-PB1,16,413,0,0,0,413,A
2-PB1,17,0,0,0,421,421,C
2-PB1,18,0,420,0,0,420,T
2-PB1,19,0,0,0,499,499,C
2-PB1,20,0,499,0,0,499,T
2-PB1,21,501,1,0,0,502,A
2-PB1,22,0,0,0,502,502,C
2-PB1,23,0,502,0,0,502,T
2-PB1,24,0,0,573,0,573,G
2-PB1,25,0,582,0,0,582,T
2-PB1,26,0,582,0,0,582,T
2-PB1,27,0,0,0,579,579,C
2-PB1,28,0,0,0,580,580,C
2-PB1,29,0,699,0,1,700,T
2-PB1,30,707,0,0,0,707,A
2-PB1,31,703,0,0,0,703,A
2-PB1,32,716,0,1,0,717,A
2-PB1,33,0,0,720,0,720,G
2-PB1,34,0,0,727,0,727,G
2-PB1,35,0,735,0,1,736,T
2-PB1,36,0,735,0,1,736,T
2-PB1,37,0,0,0,734,734,C
2-PB1,38,1,0,0,734,735,C
2-PB1,39,736,0,0,0,736,A
2-PB1,40,0,0,744,0,744,G
2-PB1,41,0,0,0,745,745,C
2-PB1,42,0,0,747,0,747,G
2-PB1,43,0,0,0,750,750,C
2-PB1,44,749,0,1,0,750,A
2-PB1,45,748,0,0,0,748,A
2-PB1,46,750,0,1,0,751,A
2-PB1,47,754,0,0,0,754,A
2-PB1,48,0,761,0,0,761,T
2-PB1,49,0,0,794,0,794,G
2-PB1,50,0,0,0,798,798,C
2-PB1,51,0,1,0,800,801,C
2-PB1,52,801,0,1,0,802,A
2-PB1,53,0,803,0,1,804,T
2-PB1,54,853,0,0,0,853,A
2-PB1,55,853,0,0,0,853,A
2-PB1,56,1,0,903,0,904,G
2-PB1,57,0,1,0,902,903,C
2-PB1,58,901,1,0,0,902,A
2-PB1,59,0,0,0,937,937,C
2-PB1,60,939,0,0,0,939,A
2-PB1,61,985,0,2,1,988,A
2-PB1,62,0,1,0,990,991,C
2-PB1,63,996,0,1,0,997,A
2-PB1,64,0,1009,0,0,1009,T
2-PB1,65,0,1007,2,0,1009,T
2-PB1,66,0,0,0,1264,1264,C
2-PB1,67,1,0,0,1266,1267,C
2-PB1,68,1,0,0,1267,1268,C
2-PB1,69,0,1268,0,0,1268,T
2-PB1,70,0,1262,0,0,1262,T
2-PB1,71,1397,0,0,0,1397,A
2-PB1,72,0,1403,0,0,1403,T
2-PB1,73,1413,0,0,0,1413,A
2-PB1,74,0,0,0,1423,1423,C
2-PB1,75,0,1390,0,0,1390,T
2-PB1,76,0,1,1402,0,1403,G
2-PB1,77,0,1,1405,0,1406,G
2-PB1,78,1375,0,28,0,1403,A
2-PB1,79,0,1,1412,0,1413,G
2-PB1,80,1417,0,0,0,1417,A
2-PB1,81,0,1426,1,1,1428,T
2-PB1,82,0,0,0,1512,1512,C
2-PB1,83,0,2,0,1509,1511,C
2-PB1,84,1,1523,0,1,1525,T
2-PB1,85,1,0,0,1632,1633,C
2-PB1,86,1,0,0,1634,1635,C
2-PB1,87,1647,1,1,0,1649,A
2-PB1,88,0,1651,0,0,1651,T
2-PB1,89,1644,1,1,0,1646,A
2-PB1,90,0,0,0,1657,1657,C
2-PB1,91,1632,1,2,0,1635,A
2-PB1,92,0,0,1697,0,1697,G
2-PB1,93,2,0,1,1709,1712,C
2-PB1,94,0,0,0,1707,1707,C
2-PB1,95,1704,0,1,0,1705,A
2-PB1,96,0,1703,0,2,1705,T
2-PB1,97,0,2,1704,0,1706,G
2-PB1,98,0,2,1798,0,1800,G
2-PB1,99,1814,1,0,0,1815,A
2-PB1,100,1818,0,1,0,1819,A
2-PB1,101,0,0,0,1819,1819,C
2-PB1,102,1813,0,0,0,1813,A
2-PB1,103,2,0,1848,0,1850,G
2-PB1,104,0,4,1875,0,1879,G
2-PB1,105,1882,1,1,0,1884,A
2-PB1,106,1889,2,2,0,1893,A
2-PB1,107,0,0,0,1897,1897,C
2-PB1,108,1898,1,2,0,1901,A
2-PB1,109,0,2,2154,0,2156,G
2-PB1,110,0,3,2160,0,2163,G
2-PB1,111,0,2,2192,0,2194,G
2-PB1,112,1,2190,0,0,2191,T
2-PB1,113,2187,0,0,0,2187,A
2-PB1,114,0,1,0,2207,2208,C
2-PB1,115,2267,0,3,1,2271,A
2-PB1,116,0,1,0,2342,2343,C
2-PB1,117,2,0,1,2326,2329,C
2-PB1,118,2284,0,1,0,2285,A
2-PB1,119,1,2282,0,0,2283,T
2-PB1,120,0,1,2287,0,2288,G
2-PB1,121,1,1,2294,0,2296,G
2-PB1,122,2288,0,3,0,2291,A
2-PB1,123,1,0,0,2293,2294,C
2-PB1,124,2263,1,0,0,2264,A
2-PB1,125,0,0,0,2295,2295,C
2-PB1,126,2290,0,1,0,2291,A
2-PB1,127,0,0,2320,0,2320,G
2-PB1,128,0,2315,0,0,2315,T
2-PB1,129,2,0,0,2388,2390,C
2-PB1,130,2385,0,3,1,2389,A
2-PB1,131,2416,0,1,0,2417,A
2-PB1,132,0,0,0,2419,2419,C
2-PB1,133,2407,1,1,0,2409,A
2-PB1,134,1,2,2440,0,2443,G
2-PB1,135,2421,0,1,0,2422,A
2-PB1,136,2422,0,0,0,2422,A
2-PB1,137,0,1,0,2428,2429,C
2-PB1,138,2392,1,1,0,2394,A
2-PB1,139,1,1,0,2389,2391,C
2-PB1,140,2370,0,5,0,2375,A
2-PB1,141,1,2356,0,2,2359,T
2-PB1,142,0,0,0,2536,2536,C
2-PB1,143,2552,0,0,0,2552,A
2-PB1,144,2590,0,1,0,2591,A
2-PB1,145,0,2644,0,0,2644,T
2-PB1,146,2715,0,0,0,2715,A
2-PB1,147,0,2725,0,1,2726,T
2-PB1,148,0,2692,0,0,2692,T
2-PB1,149,1,1,0,2702,2704,C
2-PB1,150,2667,0,0,0,2667,A
2-PB1,151,0,1,2667,0,2668,G
2-PB1,152,2651,0,1,0,2652,A
2-PB1,153,0,0,2653,1,2654,G
2-PB1,154,2620,0,2,0,2622,A
2-PB1,155,1,0,2577,0,2578,G
2-PB1,156,0,3,2577,0,2580,G
2-PB1,157,0,1,2656,0,2657,G
2-PB1,158,1,0,2661,0,2662,G
2-PB1,159,0,0,2674,0,2674,G
2-PB1,160,2674,0,0,0,2674,A
2-PB1,161,2672,0,0,1,2673,A
2-PB1,162,1,0,2696,0,2697,G
2-PB1,163,0,2684,0,1,2685,T
2-PB1,164,1,2,2675,0,2678,G
2-PB1,165,0,1,2676,0,2677,G
2-PB1,166,2665,2,5,0,2672,A
2-PB1,167,2,1,0,2678,2681,C
2-PB1,168,0,2,2697,1,2700,G
2-PB1,169,2721,0,1,0,2722,A
2-PB1,170,0,0,0,2742,2742,C
2-PB1,171,2728,0,0,0,2728,A
2-PB1,172,2730,0,2,0,2732,A
2-PB1,173,2741,0,2,0,2743,A
2-PB1,174,1,2793,0,0,2794,T
2-PB1,175,2799,1,3,0,2803,A
2-PB1,176,1,5,0,2800,2806,C
2-PB1,177,2784,0,0,0,2784,A
2-PB1,178,0,0,2792,0,2792,G
2-PB1,179,2778,0,0,0,2778,A
2-PB1,180,2809,1,0,0,2810,A
2-PB1,181,2810,0,1,0,2811,A
2-PB1,182,0,1,0,2814,2815,C
2-PB1,183,0,2797,0,2,2799,T
2-PB1,184,0,2,2789,0,2791,G
2-PB1,185,2,4,2781,0,2787,G
2-PB1,186,1,1,2787,1,2790,G
2-PB1,187,0,2,2787,1,2790,G
2-PB1,188,1,0,0,2793,2794,C
2-PB1,189,2794,0,0,1,2795,A
2-PB1,190,0,0,0,2916,2916,C
2-PB1,191,0,0,0,2905,2905,C
2-PB1,192,2,1,0,2907,2910,C
2-PB1,193,2,0,0,2913,2915,C
2-PB1,194,2921,1,2,0,2924,A
2-PB1,195,2958,1,0,0,2959,A
2-PB1,196,0,0,0,2955,2955,C
2-PB1,197,0,2939,0,2,2941,T
2-PB1,198,3,0,0,2955,2958,C
2-PB1,199,2887,0,1,0,2888,A
2-PB1,200,2937,0,5,1,2943,A
2-PB1,201,0,0,0,2939,2939,C
2-PB1,202,0,0,0,2933,2933,C
2-PB1,203,2,0,0,2939,2941,C
2-PB1,204,2936,0,0,0,2936,A
2-PB1,205,2945,0,1,0,2946,A
2-PB1,206,0,2949,0,0,2949,T
2-PB1,207,3,2949,0,1,2953,T
2-PB1,208,1,2,2958,0,2961,G
2-PB1,209,2928,0,2,0,2930,A
2-PB1,210,0,2935,0,1,2936,T
2-PB1,211,1,0,2928,0,2929,G
2-PB1,212,1,1,2966,1,2969,G
2-PB1,213,2930,0,75,0,3005,A
2-PB1,214,2,0,1,3027,3030,C
2-PB1,215,0,0,0,3022,3022,C
2-PB1,216,3017,0,2,0,3019,A
2-PB1,217,0,1,0,3065,3066,C
2-PB1,218,0,3066,0,2,3068,T
2-PB1,219,3103,0,1,0,3104,A
2-PB1,220,0,0,0,3138,3138,C
2-PB1,221,0,0,0,3112,3112,C
2-PB1,222,0,3080,0,1,3081,T
2-PB1,223,2,2,3100,0,3104,G
2-PB1,224,3104,0,0,0,3104,A
2-PB1,225,0,1,3114,0,3115,G
2-PB1,226,0,0,3113,0,3113,G
2-PB1,227,3107,1,3,0,3111,A
2-PB1,228,0,3085,0,1,3086,T
2-PB1,229,3046,0,2,0,3048,A
2-PB1,230,3050,0,1,0,3051,A
2-PB1,231,0,3057,0,0,3057,T
2-PB1,232,0,1,3053,0,3054,G
2-PB1,233,3051,1,1,1,3054,A
2-PB1,234,3039,0,2,0,3041,A
2-PB1,235,1,0,0,3036,3037,C
2-PB1,236,2,1,0,3000,3003,C
2-PB1,237,3000,2,1,0,3003,A
2-PB1,238,3010,0,1,0,3011,A
2-PB1,239,2,0,3017,1,3020,G
2-PB1,240,0,3017,0,0,3017,T
2-PB1,241,0,0,3015,0,3015,G
2-PB1,242,0,1,3054,0,3055,G
2-PB1,243,3049,1,2,0,3052,A
2-PB1,244,1,3039,0,1,3041,T
2-PB1,245,3047,0,1,0,3048,A
2-PB1,246,0,3126,0,1,3127,T
2-PB1,247,1,0,3137,0,3138,G
2-PB1,248,0,0,0,3153,3153,C
2-PB1,249,3150,0,0,0,3150,A
2-PB1,250,0,2,0,3231,3233,C
2-PB1,251,3175,1,1,0,3177,A
2-PB1,252,3232,0,1,1,3234,A
2-PB1,253,3234,0,0,0,3234,A
2-PB1,254,0,0,0,3236,3236,C
2-PB1,255,3150,0,0,0,3150,A
2-PB1,256,0,3,3193,1,3197,G
2-PB1,257,3196,0,0,0,3196,A
2-PB1,258,1,0,0,3195,3196,C
2-PB1,259,0,3119,0,0,3119,T
2-PB1,260,0,0,3170,0,3170,G
2-PB1,261,0,3127,0,4,3131,T
2-PB1,262,0,0,3257,0,3257,G
2-PB1,263,0,3244,0,0,3244,T
2-PB1,264,3,1,0,3251,3255,C
2-PB1,265,3,0,0,3251,3254,C
2-PB1,266,0,3233,0,2,3235,T
2-PB1,267,0,3,3219,1,3223,G
2-PB1,268,0,0,3222,0,3222,G
2-PB1,269,3164,3,1,0,3168,A
2-PB1,270,4,2,3205,1,3212,G
2-PB1,271,2,1,3133,0,3136,G
2-PB1,272,0,1,0,3137,3138,C
2-PB1,273,0,3111,0,2,3113,T
2-PB1,274,3119,0,1,0,3120,A
2-PB1,275,0,3119,1,1,3121,T
2-PB1,276,1,1,3116,0,3118,G
2-PB1,277,1,3,3114,0,3118,G
2-PB1,278,0,2,0,3108,3110,C
2-PB1,279,1,0,0,3073,3074,C
2-PB1,280,0,3036,0,2,3038,T
2-PB1,281,1,3198,0,1,3200,T
2-PB1,282,0,0,0,3204,3204,C
2-PB1,283,1,1,0,3198,3200,C
2-PB1,284,0,3202,0,1,3203,T
2-PB1,285,1,3197,0,2,3200,T
2-PB1,286,2,0,3207,0,3209,G
2-PB1,287,3208,2,1,1,3212,A
2-PB1,288,3209,1,2,0,3212,A
2-PB1,289,0,3,3211,0,3214,G
2-PB1,290,3074,0,1,0,3075,A
2-PB1,291,3099,0,0,0,3099,A
2-PB1,292,0,3084,0,0,3084,T
2-PB1,293,2,0,0,3090,3092,C
2-PB1,294,4,1,0,3088,3093,C
2-PB1,295,1,0,0,3080,3081,C
2-PB1,296,3087,2,0,0,3089,A
2-PB1,297,0,0,0,3097,3097,C
2-PB1,298,1,0,0,3089,3090,C
2-PB1,299,3,1,0,3090,3094,C
2-PB1,300,3061,0,0,0,3061,A
2-PB1,301,2,2,3081,0,3085,G
2-PB1,302,1,0,3101,0,3102,G
2-PB1,303,1,3100,0,0,3101,T
2-PB1,304,3126,0,1,0,3127,A
2-PB1,305,1,3111,0,2,3114,T
2-PB1,306,1,0,0,3119,3120,C
2-PB1,307,1,3116,1,1,3119,T
2-PB1,308,0,3108,0,1,3109,T
2-PB1,309,0,3106,0,0,3106,T
2-PB1,310,2,1,3091,0,3094,G
2-PB1,311,3049,1,17,0,3067,A
2-PB1,312,0,1,3066,0,3067,G
2-PB1,313,3027,1,0,0,3028,A
2-PB1,314,3044,0,0,0,3044,A
2-PB1,315,0,0,0,3076,3076,C
2-PB1,316,0,3042,0,3,3045,T
2-PB1,317,1,0,0,3047,3048,C
2-PB1,318,3044,0,2,0,3046,A
2-PB1,319,0,3037,0,1,3038,T
2-PB1,320,1,0,3046,0,3047,G
2-PB1,321,0,0,0,3093,3093,C
2-PB1,322,0,0,0,3093,3093,C
2-PB1,323,0,3086,0,1,3087,T
2-PB1,324,3,3050,0,0,3053,T
2-PB1,325,0,2,3062,1,3065,G
2-PB1,326,3088,0,0,0,3088,A
2-PB1,327,3091,0,1,1,3093,A
2-PB1,328,3084,0,4,0,3088,A
2-PB1,329,0,0,0,3103,3103,C
2-PB1,330,3015,0,0,0,3015,A
2-PB1,331,3030,1,1,0,3032,A
2-PB1,332,1,3028,0,2,3031,T
2-PB1,333,1,3,3025,0,3029,G
2-PB1,334,0,2,3028,0,3030,G
2-PB1,335,3001,0,0,1,3002,A
2-PB1,336,3001,0,2,1,3004,A
2-PB1,337,0,0,3000,0,3000,G
2-PB1,338,0,1,0,3008,3009,C
2-PB1,339,0,0,0,2990,2990,C
2-PB1,340,1,0,3013,0,3014,G
2-PB1,341,1,2994,1,3,2999,T
2-PB1,342,0,3008,0,1,3009,T
2-PB1,343,2,0,1,3033,3036,C
2-PB1,344,3039,0,1,0,3040,A
2-PB1,345,3078,1,2,0,3081,A
2-PB1,346,0,0,0,3085,3085,C
2-PB1,347,3096,0,1,0,3097,A
2-PB1,348,0,3,3129,0,3132,G
2-PB1,349,3079,1,3,0,3083,A
2-PB1,350,0,0,0,3082,3082,C
2-PB1,351,3077,0,3,0,3080,A
2-PB1,352,3087,0,0,0,3087,A
2-PB1,353,0,3,3119,0,3122,G
2-PB1,354,0,1,3080,0,3081,G
2-PB1,355,1,1,3092,0,3094,G
2-PB1,356,0,3025,1,4,3030,T
2-PB1,357,1,2,3033,0,3036,G
2-PB1,358,2,2,3034,0,3038,G
2-PB1,359,3025,0,4,0,3029,A
2-PB1,360,1,2,0,3029,3032,C
2-PB1,361,2987,0,0,0,2987,A
2-PB1,362,3004,0,1,1,3006,A
2-PB1,363,2994,0,2,1,2997,A
2-PB1,364,1,0,0,2992,2993,C
2-PB1,365,1,2982,1,1,2985,T
2-PB1,366,2978,2,1,1,2982,A
2-PB1,367,3000,1,2,1,3004,A
2-PB1,368,1,0,0,3003,3004,C
2-PB1,369,0,1,0,2990,2991,C
2-PB1,370,2,0,1,2993,2996,C
2-PB1,371,2921,0,1,0,2922,A
2-PB1,372,2921,1,0,2,2924,A
2-PB1,373,1,0,2925,1,2927,G
2-PB1,374,1,0,2932,0,2933,G
2-PB1,375,0,2940,0,0,2940,T
2-PB1,376,0,0,0,2910,2910,C
2-PB1,377,0,3,2915,0,2918,G
2-PB1,378,1,1,0,2908,2910,C
2-PB1,379,0,3,0,2914,2917,C
2-PB1,380,2926,0,1,0,2927,A
2-PB1,381,1,1,2965,0,2967,G
2-PB1,382,3015,0,1,0,3016,A
2-PB1,383,0,0,0,3006,3006,C
2-PB1,384,0,2975,0,18,2993,T
2-PB1,385,0,2989,0,2,2991,T
2-PB1,386,2991,1,2,0,2994,A
2-PB1,387,0,3006,0,1,3007,T
2-PB1,388,0,0,3007,1,3008,G
2-PB1,389,3000,0,0,0,3000,A
2-PB1,390,0,2917,1,0,2918,T
2-PB1,391,0,2839,0,2,2841,T
2-PB1,392,0,2,2809,0,2811,G
2-PB1,393,0,1,2813,0,2814,G
2-PB1,394,2839,0,6,1,2846,A
2-PB1,395,0,1,0,2844,2845,C
2-PB1,396,2811,0,0,0,2811,A
2-PB1,397,0,2795,0,0,2795,T
2-PB1,398,1,2814,0,0,2815,T
2-PB1,399,2827,2,1,0,2830,A
2-PB1,400,2828,0,2,0,2830,A
2-PB1,401,2828,0,0,1,2829,A
2-PB1,402,0,0,1,2828,2829,C
2-PB1,403,2778,1,1,0,2780,A
2-PB1,404,0,1,2796,0,2797,G
2-PB1,405,2784,1,1,0,2786,A
2-PB1,406,2791,0,0,0,2791,A
2-PB1,407,2790,0,0,1,2791,A
2-PB1,408,0,2763,0,0,2763,T
2-PB1,409,1,1,1,2763,2766,C
2-PB1,410,2772,0,1,0,2773,A
2-PB1,411,2772,0,0,0,2772,A
2-PB1,412,1,1,0,2761,2763,C
2-PB1,413,1,3,0,2757,2761,C
2-PB1,414,2,0,2759,0,2761,G
2-PB1,415,4,0,2760,0,2764,G
2-PB1,416,1,1,0,2761,2763,C
2-PB1,417,2765,1,2,0,2768,A
2-PB1,418,3,2,2754,1,2760,G
2-PB1,419,1,0,1,2778,2780,C
2-PB1,420,2776,0,1,0,2777,A
2-PB1,421,2786,0,2,0,2788,A
2-PB1,422,0,0,0,2788,2788,C
2-PB1,423,1,2777,0,2,2780,T
2-PB1,424,0,0,2889,0,2889,G
2-PB1,425,0,0,0,2885,2885,C
2-PB1,426,2892,1,0,0,2893,A
2-PB1,427,0,2891,1,0,2892,T
2-PB1,428,1,2860,0,0,2861,T
2-PB1,429,3003,0,3,0,3006,A
2-PB1,430,0,0,3005,0,3005,G
2-PB1,431,1,1,0,2992,2994,C
2-PB1,432,0,1,0,2992,2993,C
2-PB1,433,2886,1,2,0,2889,A
2-PB1,434,2908,0,1,0,2909,A
2-PB1,435,1,1,0,2913,2915,C
2-PB1,436,2923,1,2,0,2926,A
2-PB1,437,1,0,0,3015,3016,C
2-PB1,438,0,1,0,2839,2840,C
2-PB1,439,2829,2,1,0,2832,A
2-PB1,440,2,2821,0,0,2823,T
2-PB1,441,2829,0,2,0,2831,A
2-PB1,442,0,0,2822,0,2822,G
2-PB1,443,2818,1,0,0,2819,A
2-PB1,444,2782,1,1,1,2785,A
2-PB1,445,0,0,2810,0,2810,G
2-PB1,446,1,2714,0,1,2716,T
2-PB1,447,1,2712,0,0,2713,T
2-PB1,448,0,2712,1,0,2713,T
2-PB1,449,0,2718,0,2,2720,T
2-PB1,450,0,2726,0,0,2726,T
2-PB1,451,2728,0,1,0,2729,A
2-PB1,452,0,1,2726,0,2727,G
2-PB1,453,2710,0,3,0,2713,A
2-PB1,454,1,2701,0,1,2703,T
2-PB1,455,0,1,1,2667,2669,C
2-PB1,456,0,2,2669,0,2671,G
2-PB1,457,2671,0,1,0,2672,A
2-PB1,458,2670,0,2,0,2672,A
2-PB1,459,1,1,0,2679,2681,C
2-PB1,460,1,0,2675,0,2676,G
2-PB1,461,1,0,2803,0,2804,G
2-PB1,462,2804,1,1,0,2806,A
2-PB1,463,0,2795,0,0,2795,T
2-PB1,464,1,2800,0,0,2801,T
2-PB1,465,2793,0,5,0,2798,A
2-PB1,466,2790,0,3,0,2793,A
2-PB1,467,0,1,0,2794,2795,C
2-PB1,468,2778,0,2,0,2780,A
2-PB1,469,1,0,2805,0,2806,G
2-PB1,470,0,0,0,2711,2711,C
2-PB1,471,0,2712,0,0,2712,T
2-PB1,472,2715,0,0,0,2715,A
2-PB1,473,2715,1,1,0,2717,A
2-PB1,474,0,2713,1,0,2714,T
2-PB1,475,0,1,2750,0,2751,G
2-PB1,476,2735,0,0,0,2735,A
2-PB1,477,2739,1,0,0,2740,A
2-PB1,478,1,2684,0,0,2685,T
2-PB1,479,0,0,0,2703,2703,C
2-PB1,480,2702,1,0,0,2703,A
2-PB1,481,1,0,2701,0,2702,G
2-PB1,482,0,1,2702,0,2703,G
2-PB1,483,2692,0,1,0,2693,A
2-PB1,484,2663,0,1,0,2664,A
2-PB1,485,0,1,2797,0,2798,G
2-PB1,486,0,1,2804,0,2805,G
2-PB1,487,2,0,0,2801,2803,C
2-PB1,488,0,2802,0,2,2804,T
2-PB1,489,2811,0,1,0,2812,A
2-PB1,490,2811,0,0,1,2812,A
2-PB1,491,0,2811,0,0,2811,T
2-PB1,492,2818,0,0,0,2818,A
2-PB1,493,1,0,2823,1,2825,G
2-PB1,494,2659,0,0,1,2660,A
2-PB1,495,1,2621,0,1,2623,T
2-PB1,496,0,2606,0,0,2606,T
2-PB1,497,0,2611,0,1,2612,T
2-PB1,498,2,1,0,2673,2676,C
2-PB1,499,0,4,0,2679,2683,C
2-PB1,500,0,2680,0,0,2680,T
2-PB1,501,2,0,0,2680,2682,C
2-PB1,502,2678,3,2,0,2683,A
2-PB1,503,2690,0,0,1,2691,A
2-PB1,504,1,2,2689,1,2693,G
2-PB1,505,0,0,2726,0,2726,G
2-PB1,506,2724,0,2,0,2726,A
2-PB1,507,0,2623,0,1,2624,T
2-PB1,508,2,2,2646,0,2650,G
2-PB1,509,0,2636,0,3,2639,T
2-PB1,510,0,0,2674,0,2674,G
2-PB1,511,2675,0,2,0,2677,A
2-PB1,512,1,2664,0,0,2665,T
2-PB1,513,0,2,2653,0,2655,G
2-PB1,514,1,4,2634,0,2639,G
2-PB1,515,2645,0,1,0,2646,A
2-PB1,516,2647,0,0,0,2647,A
2-PB1,517,0,2616,0,0,2616,T
2-PB1,518,1,1,0,2631,2633,C
2-PB1,519,2606,0,1,0,2607,A
2-PB1,520,2613,0,1,0,2614,A
2-PB1,521,0,2611,0,0,2611,T
2-PB1,522,5,1,2628,0,2634,G
2-PB1,523,1,0,2644,1,2646,G
2-PB1,524,2643,0,2,0,2645,A
2-PB1,525,0,2645,0,1,2646,T
2-PB1,526,2640,0,1,0,2641,A
2-PB1,527,2631,1,0,0,2632,A
2-PB1,528,2627,0,2,0,2629,A
2-PB1,529,0,0,2654,0,2654,G
2-PB1,530,2636,1,1,0,2638,A
2-PB1,531,0,0,2612,1,2613,G
2-PB1,532,2,0,2599,0,2601,G
2-PB1,533,2579,0,1,0,2580,A
2-PB1,534,2584,0,1,0,2585,A
2-PB1,535,2585,0,0,0,2585,A
2-PB1,536,0,2588,0,0,2588,T
2-PB1,537,1,1,2621,0,2623,G
2-PB1,538,0,0,2617,0,2617,G
2-PB1,539,2572,0,4,0,2576,A
2-PB1,540,0,0,2602,0,2602,G
2-PB1,541,2575,1,2,0,2578,A
2-PB1,542,0,2639,1,1,2641,T
2-PB1,543,2633,0,1,0,2634,A
2-PB1,544,2656,0,1,0,2657,A
2-PB1,545,0,0,0,2669,2669,C
2-PB1,546,2632,0,3,0,2635,A
2-PB1,547,2638,1,2,1,2642,A
2-PB1,548,0,0,0,2632,2632,C
2-PB1,549,2618,1,1,0,2620,A
2-PB1,550,0,0,0,2615,2615,C
2-PB1,551,2582,1,0,0,2583,A
2-PB1,552,1,0,0,2606,2607,C
2-PB1,553,0,2570,0,1,2571,T
2-PB1,554,0,2572,0,1,2573,T
2-PB1,555,0,2579,0,0,2579,T
2-PB1,556,0,0,0,2575,2575,C
2-PB1,557,2584,1,0,0,2585,A
2-PB1,558,2586,1,1,0,2588,A
2-PB1,559,2593,0,2,0,2595,A
2-PB1,560,0,0,2627,0,2627,G
2-PB1,561,2587,1,0,0,2588,A
2-PB1,562,2597,0,0,2,2599,A
2-PB1,563,2600,0,0,0,2600,A
2-PB1,564,2604,1,0,0,2605,A
2-PB1,565,2593,1,5,2,2601,A
2-PB1,566,0,1,2617,0,2618,G
2-PB1,567,0,6,2610,0,2616,G
2-PB1,568,2581,0,6,0,2587,A
2-PB1,569,0,1,2627,0,2628,G
2-PB1,570,2598,0,2,0,2600,A
2-PB1,571,0,1,2686,0,2687,G
2-PB1,572,0,2682,1,1,2684,T
2-PB1,573,2687,0,2,0,2689,A
2-PB1,574,2690,0,3,0,2693,A
2-PB1,575,1,3,2687,1,2692,G
2-PB1,576,1,1,2694,0,2696,G
2-PB1,577,3,1,2692,0,2696,G
2-PB1,578,2659,2,1,1,2663,A
2-PB1,579,1,2,0,2670,2673,C
2-PB1,580,2616,0,2,0,2618,A
2-PB1,581,2627,0,2,0,2629,A
2-PB1,582,2,0,0,2620,2622,C
2-PB1,583,2618,0,1,0,2619,A
2-PB1,584,0,2586,0,1,2587,T
2-PB1,585,0,0,2565,0,2565,G
2-PB1,586,2569,1,2,0,2572,A
2-PB1,587,3,0,0,2566,2569,C
2-PB1,588,0,2,0,2535,2537,C
2-PB1,589,2540,0,1,0,2541,A
2-PB1,590,2559,1,1,0,2561,A
2-PB1,591,0,2,2571,0,2573,G
2-PB1,592,2570,0,1,0,2571,A
2-PB1,593,2579,1,0,0,2580,A
2-PB1,594,2564,1,0,0,2565,A
2-PB1,595,2562,0,2,0,2564,A
2-PB1,596,0,2566,0,1,2567,T
2-PB1,597,1,1,2571,2,2575,G
2-PB1,598,0,0,2565,0,2565,G
2-PB1,599,0,2519,0,3,2522,T
2-PB1,600,1,1,1,2499,2502,C
2-PB1,601,2516,1,1,0,2518,A
2-PB1,602,1,0,0,2704,2705,C
2-PB1,603,2770,0,0,0,2770,A
2-PB1,604,0,0,0,2795,2795,C
2-PB1,605,2778,0,0,0,2778,A
2-PB1,606,2935,0,1,1,2937,A
2-PB1,607,2922,1,0,0,2923,A
2-PB1,608,3,1,3048,0,3052,G
2-PB1,609,472,0,2455,0,2927,G
2-PB1,610,3048,1,3,0,3052,A
2-PB1,611,0,3,0,3151,3154,C
2-PB1,612,3161,0,0,0,3161,A
2-PB1,613,3168,1,0,0,3169,A
2-PB1,614,0,3164,0,0,3164,T
2-PB1,615,3106,0,1,0,3107,A
2-PB1,616,1,1,3101,0,3103,G
2-PB1,617,2,1,2981,1,2985,G
2-PB1,618,2,1,2992,0,2995,G
2-PB1,619,2989,0,2,0,2991,A
2-PB1,620,2944,0,2,0,2946,A
2-PB1,621,0,1,2967,0,2968,G
2-PB1,622,2969,0,0,0,2969,A
2-PB1,623,2971,0,0,0,2971,A
2-PB1,624,2990,0,0,0,2990,A
2-PB1,625,2987,2,2,2,2993,A
2-PB1,626,3070,1,2,0,3073,A
2-PB1,627,3068,1,1,0,3070,A
2-PB1,628,0,0,0,3077,3077,C
2-PB1,629,3073,0,2,0,3075,A
2-PB1,630,3075,0,0,1,3076,A
2-PB1,631,3059,0,0,1,3060,A
2-PB1,632,0,1,3126,0,3127,G
2-PB1,633,3121,1,1,0,3123,A
2-PB1,634,0,0,3251,0,3251,G
2-PB1,635,0,3209,1,4,3214,T
2-PB1,636,2,1,3764,1,3768,G
2-PB1,637,3769,0,7,0,3776,A
2-PB1,638,3782,0,1,0,3783,A
2-PB1,639,0,3840,1,2,3843,T
2-PB1,640,3862,0,0,0,3862,A
2-PB1,641,3855,0,1,0,3856,A
2-PB1,642,0,3,3859,1,3863,G
2-PB1,643,3774,1,1,0,3776,A
2-PB1,644,1,3,3799,0,3803,G
2-PB1,645,3656,1,2,1,3660,A
2-PB1,646,0,0,3678,0,3678,G
2-PB1,647,0,0,3684,0,3684,G
2-PB1,648,1,2,0,3671,3674,C
2-PB1,649,0,3656,1,3,3660,T
2-PB1,650,3795,0,1,0,3796,A
2-PB1,651,2,0,1,3974,3977,C
2-PB1,652,0,2,0,3976,3978,C
2-PB1,653,1,4020,1,4,4026,T
2-PB1,654,4192,0,0,0,4192,A
2-PB1,655,4180,1,2,2,4185,A
2-PB1,656,0,4190,0,1,4191,T
2-PB1,657,4188,0,1,0,4189,A
2-PB1,658,4178,1,0,1,4180,A
2-PB1,659,2,2,4178,0,4182,G
2-PB1,660,4064,1,6,0,4071,A
2-PB1,661,0,0,4084,0,4084,G
2-PB1,662,1,0,0,4099,4100,C
2-PB1,663,1,4045,1,3,4050,T
2-PB1,664,3,4064,0,0,4067,T
2-PB1,665,0,4079,0,0,4079,T
2-PB1,666,1,0,4080,0,4081,G
2-PB1,667,4143,2,1,0,4146,A
2-PB1,668,0,0,0,4159,4159,C
2-PB1,669,4144,1,1,0,4146,A
2-PB1,670,0,4133,0,2,4135,T
2-PB1,671,1,4122,0,1,4124,T
2-PB1,672,2,1,4196,0,4199,G
2-PB1,673,4199,0,1,1,4201,A
2-PB1,674,4205,0,1,0,4206,A
2-PB1,675,0,2,0,4201,4203,C
2-PB1,676,4191,1,0,0,4192,A
2-PB1,677,1,1,0,4188,4190,C
2-PB1,678,0,3,4191,0,4194,G
2-PB1,679,4208,0,5,1,4214,A
2-PB1,680,1,4207,0,1,4209,T
2-PB1,681,1,3,4290,0,4294,G
2-PB1,682,4305,3,2,2,4312,A
2-PB1,683,0,2,1,4307,4310,C
2-PB1,684,4,1,0,4307,4312,C
2-PB1,685,4322,0,2,0,4324,A
2-PB1,686,4371,2,1,3,4377,A
2-PB1,687,4372,1,7,2,4382,A
2-PB1,688,0,0,4477,0,4477,G
2-PB1,689,4517,2,2,0,4521,A
2-PB1,690,1,4476,0,1,4478,T
2-PB1,691,1,1,4478,0,4480,G
2-PB1,692,0,1,0,4463,4464,C
2-PB1,693,4464,2,4,0,4470,A
2-PB1,694,0,2,4500,0,4502,G
2-PB1,695,4458,0,3,0,4461,A
2-PB1,696,0,3,4465,1,4469,G
2-PB1,697,4374,0,2,0,4376,A
2-PB1,698,0,1,4361,0,4362,G
2-PB1,699,4321,2,5,0,4328,A
2-PB1,700,2,1,4327,1,4331,G
2-PB1,701,1,1,4324,1,4327,G
2-PB1,702,1,0,0,4328,4329,C
2-PB1,703,4294,1,2,1,4298,A
2-PB1,704,4306,0,0,1,4307,A
2-PB1,705,4320,0,0,3,4323,A
2-PB1,706,0,4325,0,1,4326,T
2-PB1,707,0,4310,0,3,4313,T
2-PB1,708,4331,2,0,2,4335,A
2-PB1,709,4313,1,0,1,4315,A
2-PB1,710,4325,0,0,0,4325,A
2-PB1,711,4348,0,0,0,4348,A
2-PB1,712,4358,0,0,0,4358,A
2-PB1,713,1,2,4366,0,4369,G
2-PB1,714,4339,0,0,0,4339,A
2-PB1,715,4269,2,56,0,4327,A
2-PB1,716,2,2,4391,0,4395,G
2-PB1,717,1,0,4471,0,4472,G
2-PB1,718,0,1,4477,1,4479,G
2-PB1,719,0,1,0,4512,4513,C
2-PB1,720,0,4498,0,4,4502,T
2-PB1,721,4520,0,1,0,4521,A
2-PB1,722,1,4571,0,2,4574,T
2-PB1,723,0,4572,0,3,4575,T
2-PB1,724,1,0,4589,0,4590,G
2-PB1,725,1,2,0,4571,4574,C
2-PB1,726,4484,0,3,0,4487,A
2-PB1,727,4482,2,2,0,4486,A
2-PB1,728,1,1,0,4476,4478,C
2-PB1,729,4464,4,1,0,4469,A
2-PB1,730,3,0,0,4465,4468,C
2-PB1,731,4,1,0,4391,4396,C
2-PB1,732,3,3,0,4402,4408,C
2-PB1,733,2,4,4386,0,4392,G
2-PB1,734,2,1,4396,1,4400,G
2-PB1,735,0,0,4408,0,4408,G
2-PB1,736,4429,3,4,1,4437,A
2-PB1,737,0,4388,0,3,4391,T
2-PB1,738,3,0,4396,0,4399,G
2-PB1,739,1,0,0,4377,4378,C
2-PB1,740,4443,1,2,0,4446,A
2-PB1,741,4511,1,1,1,4514,A
2-PB1,742,4555,0,0,1,4556,A
2-PB1,743,0,4547,0,1,4548,T
2-PB1,744,1,4542,1,3,4547,T
2-PB1,745,4523,1,1,0,4525,A
2-PB1,746,0,0,4526,2,4528,G
2-PB1,747,4495,1,4,1,4501,A
2-PB1,748,2,5,4520,0,4527,G
2-PB1,749,1,3,4483,0,4487,G
2-PB1,750,1,1,4603,0,4605,G
2-PB1,751,0,4612,0,1,4613,T
2-PB1,752,1,4604,0,1,4606,T
2-PB1,753,6,0,0,4615,4621,C
2-PB1,754,1,1,4677,1,4680,G
2-PB1,755,0,4658,0,8,4666,T
2-PB1,756,3,0,4668,1,4672,G
2-PB1,757,0,4665,0,2,4667,T
2-PB1,758,4637,1,2,0,4640,A
2-PB1,759,0,0,0,4631,4631,C
2-PB1,760,1,4444,0,1,4446,T
2-PB1,761,0,4451,0,4,4455,T
2-PB1,762,1,1,0,4446,4448,C
2-PB1,763,2,1,4432,0,4435,G
2-PB1,764,0,4416,0,2,4418,T
2-PB1,765,0,4412,0,10,4422,T
2-PB1,766,0,3,4423,0,4426,G
2-PB1,767,4416,3,2,0,4421,A
2-PB1,768,4419,1,6,0,4426,A
2-PB1,769,4449,0,1,0,4450,A
2-PB1,770,0,0,0,4459,4459,C
2-PB1,771,0,4419,0,2,4421,T
2-PB1,772,0,4408,1,1,4410,T
2-PB1,773,0,4421,1,0,4422,T
2-PB1,774,4497,0,2,0,4499,A
2-PB1,775,0,1,4512,0,4513,G
2-PB1,776,0,0,0,4525,4525,C
2-PB1,777,0,4518,0,0,4518,T
2-PB1,778,4483,0,1,0,4484,A
2-PB1,779,0,2,4476,0,4478,G
2-PB1,780,4472,0,2,0,4474,A
2-PB1,781,4471,1,4,0,4476,A
2-PB1,782,0,1,4488,0,4489,G
2-PB1,783,1,1,0,4443,4445,C
2-PB1,784,4439,0,2,0,4441,A
2-PB1,785,0,4431,0,0,4431,T
2-PB1,786,1,4425,0,1,4427,T
2-PB1,787,0,4429,0,3,4432,T
2-PB1,788,1,0,4439,0,4440,G
2-PB1,789,0,2,1,4427,4430,C
2-PB1,790,2,1,4435,0,4438,G
2-PB1,791,4424,0,1,0,4425,A
2-PB1,792,4414,0,0,0,4414,A
2-PB1,793,4401,0,4,2,4407,A
2-PB1,794,4503,0,3,1,4507,A
2-PB1,795,3,0,4552,0,4555,G
2-PB1,796,0,1,0,4552,4553,C
2-PB1,797,3,4552,0,5,4560,T
2-PB1,798,0,4545,0,2,4547,T
2-PB1,799,0,3,4560,0,4563,G
2-PB1,800,4559,1,1,1,4562,A
2-PB1,801,4553,2,2,1,4558,A
2-PB1,802,0,1,0,4578,4579,C
2-PB1,803,4448,1,0,0,4449,A
2-PB1,804,1,0,4808,0,4809,G
2-PB1,805,1,4757,0,2,4760,T
2-PB1,806,5,1,0,4758,4764,C
2-PB1,807,1,4767,0,4,4772,T
2-PB1,808,3,2,4773,0,4778,G
2-PB1,809,1,2,4781,0,4784,G
2-PB1,810,4791,0,1,0,4792,A
2-PB1,811,0,0,1,4790,4791,C
2-PB1,812,0,4648,0,3,4651,T
2-PB1,813,0,4405,0,1,4406,T
2-PB1,814,2,0,0,4382,4384,C
2-PB1,815,4,1,0,4388,4393,C
2-PB1,816,4,2,4403,0,4409,G
2-PB1,817,2,0,4425,0,4427,G
2-PB1,818,0,4392,1,0,4393,T
2-PB1,819,0,4378,0,1,4379,T
2-PB1,820,2,1,4374,0,4377,G
2-PB1,821,3,2,4390,0,4395,G
2-PB1,822,0,6,4418,0,4424,G
2-PB1,823,0,4,4419,0,4423,G
2-PB1,824,2,1,4445,0,4448,G
2-PB1,825,1,4413,0,1,4415,T
2-PB1,826,4419,0,2,0,4421,A
2-PB1,827,4440,1,1,1,4443,A
2-PB1,828,1,4444,0,3,4448,T
2-PB1,829,1,1,4454,0,4456,G
2-PB1,830,4412,0,1,0,4413,A
2-PB1,831,4366,0,4,0,4370,A
2-PB1,832,4374,0,2,2,4378,A
2-PB1,833,4357,0,1,1,4359,A
2-PB1,834,1,1,4359,0,4361,G
2-PB1,835,4313,0,5,2,4320,A
2-PB1,836,4275,0,2,1,4278,A
2-PB1,837,4,2,4299,0,4305,G
2-PB1,838,2,1,4291,0,4294,G
2-PB1,839,0,0,0,4267,4267,C
2-PB1,840,0,2,0,4271,4273,C
2-PB1,841,4290,2,1,0,4293,A
2-PB1,842,4293,0,1,0,4294,A
2-PB1,843,4291,0,1,0,4292,A
2-PB1,844,0,1,0,4286,4287,C
2-PB1,845,0,4279,1,6,4286,T
2-PB1,846,1,0,4317,0,4318,G
2-PB1,847,2,2,4304,0,4308,G
2-PB1,848,1,0,0,4311,4312,C
2-PB1,849,4321,0,2,0,4323,A
2-PB1,850,4324,0,0,1,4325,A
2-PB1,851,4330,0,1,1,4332,A
2-PB1,852,0,4329,0,3,4332,T
2-PB1,853,0,0,4338,1,4339,G
2-PB1,854,2,4314,1,1,4318,T
2-PB1,855,1,4228,0,1,4230,T
2-PB1,856,0,0,4236,0,4236,G
2-PB1,857,2,4222,0,2,4226,T
2-PB1,858,0,2,4230,0,4232,G
2-PB1,859,4231,0,4,0,4235,A
2-PB1,860,1,3,4241,0,4245,G
2-PB1,861,4242,0,2,1,4245,A
2-PB1,862,4226,0,1,0,4227,A
2-PB1,863,4221,0,2,0,4223,A
2-PB1,864,4228,0,3,0,4231,A
2-PB1,865,4246,0,1,0,4247,A
2-PB1,866,0,4235,0,0,4235,T
2-PB1,867,2,0,4227,1,4230,G
2-PB1,868,4220,0,2,2,4224,A
2-PB1,869,0,4187,0,1,4188,T
2-PB1,870,1,3,4216,0,4220,G
2-PB1,871,4218,1,6,0,4225,A
2-PB1,872,1,0,0,4249,4250,C
2-PB1,873,2,4234,1,0,4237,T
2-PB1,874,4237,0,1,0,4238,A
2-PB1,875,4275,0,1,0,4276,A
2-PB1,876,1,4250,0,2,4253,T
2-PB1,877,0,4292,0,2,4294,T
2-PB1,878,1,0,1,4303,4305,C
2-PB1,879,4290,0,1,1,4292,A
2-PB1,880,0,1,0,4288,4289,C
2-PB1,881,4240,1,3,0,4244,A
2-PB1,882,4246,0,3,0,4249,A
2-PB1,883,0,1,4241,0,4242,G
2-PB1,884,4287,0,1,0,4288,A
2-PB1,885,0,0,0,4282,4282,C
2-PB1,886,4238,1,3,1,4243,A
2-PB1,887,0,0,0,4236,4236,C
2-PB1,888,4195,1,1,0,4197,A
2-PB1,889,0,2,4203,0,4205,G
2-PB1,890,4191,1,4,0,4196,A
2-PB1,891,2,0,4215,0,4217,G
2-PB1,892,1,1,0,4190,4192,C
2-PB1,893,0,4106,0,7,4113,T
2-PB1,894,0,4148,0,1,4149,T
2-PB1,895,1,4153,0,1,4155,T
2-PB1,896,4,0,1,4167,4172,C
2-PB1,897,1,4156,0,7,4164,T
2-PB1,898,2,4124,0,1,4127,T
2-PB1,899,0,4116,1,4,4121,T
2-PB1,900,1,1,0,4122,4124,C
2-PB1,901,4115,1,2,0,4118,A
2-PB1,902,0,1,1,4122,4124,C
2-PB1,903,4060,1,2,1,4064,A
2-PB1,904,4085,1,3,0,4089,A
2-PB1,905,1,4126,1,2,4130,T
2-PB1,906,4,2,0,4176,4182,C
2-PB1,907,4200,2,0,0,4202,A
2-PB1,908,1,0,0,4214,4215,C
2-PB1,909,0,4177,0,2,4179,T
2-PB1,910,1,3,4190,0,4194,G
2-PB1,911,1,4,4162,0,4167,G
2-PB1,912,2,2,4257,0,4261,G
2-PB1,913,1,0,4267,0,4268,G
2-PB1,914,4188,1,9,0,4198,A
2-PB1,915,2,3,0,4045,4050,C
2-PB1,916,4108,0,2,0,4110,A
2-PB1,917,4351,1,2,0,4354,A
2-PB1,918,1,0,0,4385,4386,C
2-PB1,919,4356,1,3,0,4360,A
2-PB1,920,1,0,0,4350,4351,C
2-PB1,921,0,4166,0,1,4167,T
2-PB1,922,4176,0,0,0,4176,A
2-PB1,923,4158,1,3,1,4163,A
2-PB1,924,0,0,4190,0,4190,G
2-PB1,925,0,4171,1,0,4172,T
2-PB1,926,0,0,3870,0,3870,G
2-PB1,927,1,1,3831,0,3833,G
2-PB1,928,3821,1,1,0,3823,A
2-PB1,929,3817,0,3,0,3820,A
2-PB1,930,1,3821,0,0,3822,T
2-PB1,931,0,1,3819,1,3821,G
2-PB1,932,3811,1,1,0,3813,A
2-PB1,933,3770,0,2,0,3772,A
2-PB1,934,3796,2,0,0,3798,A
2-PB1,935,3817,0,1,0,3818,A
2-PB1,936,2,3806,0,1,3809,T
2-PB1,937,4,0,0,3809,3813,C
2-PB1,938,3807,0,0,0,3807,A
2-PB1,939,3807,0,1,1,3809,A
2-PB1,940,3792,2,4,1,3799,A
2-PB1,941,3798,0,5,0,3803,A
2-PB1,942,2,0,0,3808,3810,C
2-PB1,943,1,2,0,3774,3777,C
2-PB1,944,3,0,0,3766,3769,C
2-PB1,945,1,3760,1,2,3764,T
2-PB1,946,0,0,0,3777,3777,C
2-PB1,947,0,0,3779,0,3779,G
2-PB1,948,3781,1,0,0,3782,A
2-PB1,949,3775,2,1,2,3780,A
2-PB1,950,0,3775,0,0,3775,T
2-PB1,951,1,0,3782,0,3783,G
2-PB1,952,1,3746,2,5,3754,T
2-PB1,953,1,3740,2,2,3745,T
2-PB1,954,0,3751,0,1,3752,T
2-PB1,955,0,3753,0,1,3754,T
2-PB1,956,1,3747,0,2,3750,T
2-PB1,957,2,0,3751,0,3753,G
2-PB1,958,0,0,3744,0,3744,G
2-PB1,959,1,3,0,3734,3738,C
2-PB1,960,3,0,3674,0,3677,G
2-PB1,961,3670,1,1,0,3672,A
2-PB1,962,1,3757,0,2,3760,T
2-PB1,963,1,1,3886,0,3888,G
2-PB1,964,4075,0,3,1,4079,A
2-PB1,965,1,4083,0,1,4085,T
2-PB1,966,0,4085,0,2,4087,T
2-PB1,967,4116,0,4,0,4120,A
2-PB1,968,1,0,0,4117,4118,C
2-PB1,969,4131,0,2,0,4133,A
2-PB1,970,0,4120,0,1,4121,T
2-PB1,971,3882,1,5,0,3888,A
2-PB1,972,1,0,0,3911,3912,C
2-PB1,973,3513,0,0,0,3513,A
2-PB1,974,3,3513,0,3,3519,T
2-PB1,975,2,0,0,3505,3507,C
2-PB1,976,3487,0,1,0,3488,A
2-PB1,977,0,1,1,3506,3508,C
2-PB1,978,3493,1,0,1,3495,A
2-PB1,979,3490,1,1,1,3493,A
2-PB1,980,3485,0,2,1,3488,A
2-PB1,981,0,5,3372,1,3378,G
2-PB1,982,3516,0,4,0,3520,A
2-PB1,983,3517,2,2,1,3522,A
2-PB1,984,0,3521,1,2,3524,T
2-PB1,985,5,0,1,3502,3508,C
2-PB1,986,3505,0,1,0,3506,A
2-PB1,987,3511,0,12,0,3523,A
2-PB1,988,1,0,1,3523,3525,C
2-PB1,989,2,1,1,3511,3515,C
2-PB1,990,0,3348,0,2,3350,T
2-PB1,991,1,2,3384,1,3388,G
2-PB1,992,3374,0,2,1,3377,A
2-PB1,993,0,1,3381,0,3382,G
2-PB1,994,0,3360,1,3,3364,T
2-PB1,995,2,3,3288,0,3293,G
2-PB1,996,1,0,3460,0,3461,G
2-PB1,997,1,3431,0,1,3433,T
2-PB1,998,0,3428,0,4,3432,T
2-PB1,999,1,1,0,3436,3438,C
2-PB1,1000,3414,0,2,0,3416,A
2-PB1,1001,0,0,3481,0,3481,G
2-PB1,1002,3477,1,0,0,3478,A
2-PB1,1003,3473,0,1,1,3475,A
2-PB1,1004,3461,0,1,0,3462,A
2-PB1,1005,0,0,0,3179,3179,C
2-PB1,1006,3214,1,1,1,3217,A
2-PB1,1007,1,3204,0,1,3206,T
2-PB1,1008,1,1,0,3224,3226,C
2-PB1,1009,1,0,0,3234,3235,C
2-PB1,1010,1,3102,0,4,3107,T
2-PB1,1011,1,4,3108,1,3114,G
2-PB1,1012,3094,0,1,0,3095,A
2-PB1,1013,1,0,3114,1,3116,G
2-PB1,1014,1,0,0,3088,3089,C
2-PB1,1015,2968,0,3,0,2971,A
2-PB1,1016,0,2968,2,3,2973,T
2-PB1,1017,1,0,0,2948,2949,C
2-PB1,1018,2,0,2948,0,2950,G
2-PB1,1019,2,2,0,3027,3031,C
2-PB1,1020,3050,1,3,0,3054,A
2-PB1,1021,0,0,0,3173,3173,C
2-PB1,1022,0,2,0,3159,3161,C
2-PB1,1023,3174,0,1,0,3175,A
2-PB1,1024,3219,0,1,0,3220,A
2-PB1,1025,0,3218,0,0,3218,T
2-PB1,1026,3217,0,0,0,3217,A
2-PB1,1027,3218,0,0,0,3218,A
2-PB1,1028,0,3102,0,1,3103,T
2-PB1,1029,3,0,3111,0,3114,G
2-PB1,1030,0,3031,0,1,3032,T
2-PB1,1031,0,3000,2,3,3005,T
2-PB1,1032,3,0,0,3019,3022,C
2-PB1,1033,0,3005,0,1,3006,T
2-PB1,1034,0,0,1,3010,3011,C
2-PB1,1035,3019,0,0,0,3019,A
2-PB1,1036,3020,0,2,0,3022,A
2-PB1,1037,3021,0,1,0,3022,A
2-PB1,1038,0,1,0,3026,3027,C
2-PB1,1039,3016,1,1,0,3018,A
2-PB1,1040,3013,0,2,0,3015,A
2-PB1,1041,3008,0,1,0,3009,A
2-PB1,1042,3011,0,3,0,3014,A
2-PB1,1043,1,3013,0,0,3014,T
2-PB1,1044,1,0,3024,0,3025,G
2-PB1,1045,1,1,3018,0,3020,G
2-PB1,1046,1,2,1,3012,3016,C
2-PB1,1047,3012,0,3,0,3015,A
2-PB1,1048,3027,0,1,0,3028,A
2-PB1,1049,2,0,3023,0,3025,G
2-PB1,1050,3017,1,1,0,3019,A
2-PB1,1051,1,2988,0,0,2989,T
2-PB1,1052,1,3049,0,1,3051,T
2-PB1,1053,0,2,3073,1,3076,G
2-PB1,1054,0,2,3074,0,3076,G
2-PB1,1055,0,2,3087,0,3089,G
2-PB1,1056,3094,1,0,0,3095,A
2-PB1,1057,3087,1,0,0,3088,A
2-PB1,1058,3078,0,1,0,3079,A
2-PB1,1059,3067,1,1,0,3069,A
2-PB1,1060,0,1,3194,1,3196,G
2-PB1,1061,1,0,3197,0,3198,G
2-PB1,1062,3209,1,2,0,3212,A
2-PB1,1063,1,3192,0,0,3193,T
2-PB1,1064,3198,0,0,0,3198,A
2-PB1,1065,2,0,0,3203,3205,C
2-PB1,1066,3232,0,3,0,3235,A
2-PB1,1067,0,3219,1,1,3221,T
2-PB1,1068,1,0,3260,0,3261,G
2-PB1,1069,0,3194,0,1,3195,T
2-PB1,1070,0,3196,0,2,3198,T
2-PB1,1071,1,1,0,3186,3188,C
2-PB1,1072,1,3,3191,0,3195,G
2-PB1,1073,3202,0,2,0,3204,A
2-PB1,1074,0,2,3270,0,3272,G
2-PB1,1075,3237,0,3,1,3241,A
2-PB1,1076,1,1,3269,1,3272,G
2-PB1,1077,1,3251,0,2,3254,T
2-PB1,1078,3243,0,0,0,3243,A
2-PB1,1079,3254,1,1,0,3256,A
2-PB1,1080,0,1,3267,0,3268,G
2-PB1,1081,3272,0,1,1,3274,A
2-PB1,1082,2,1,3319,0,3322,G
2-PB1,1083,3237,1,1,0,3239,A
2-PB1,1084,3259,1,3,0,3263,A
2-PB1,1085,2,3231,0,2,3235,T
2-PB1,1086,2,2,3227,0,3231,G
2-PB1,1087,3230,0,1,0,3231,A
2-PB1,1088,3206,0,6,0,3212,A
2-PB1,1089,2,0,3215,1,3218,G
2-PB1,1090,0,0,0,3206,3206,C
2-PB1,1091,1,3148,0,2,3151,T
2-PB1,1092,1,0,1,3166,3168,C
2-PB1,1093,1,1,0,3171,3173,C
2-PB1,1094,4,1,3173,0,3178,G
2-PB1,1095,0,2,3182,0,3184,G
2-PB1,1096,3186,1,2,0,3189,A
2-PB1,1097,0,1,0,3229,3230,C
2-PB1,1098,3240,2,4,0,3246,A
2-PB1,1099,2,0,0,3270,3272,C
2-PB1,1100,3270,0,1,0,3271,A
2-PB1,1101,3269,0,3,0,3272,A
2-PB1,1102,3272,0,0,0,3272,A
2-PB1,1103,0,3281,0,2,3283,T
2-PB1,1104,3289,1,1,0,3291,A
2-PB1,1105,0,1,0,3276,3277,C
2-PB1,1106,0,0,0,3244,3244,C
2-PB1,1107,0,3211,0,3,3214,T
2-PB1,1108,3,2,3233,1,3239,G
2-PB1,1109,0,0,0,3243,3243,C
2-PB1,1110,3244,0,1,0,3245,A
2-PB1,1111,0,1,3245,0,3246,G
2-PB1,1112,3241,0,0,0,3241,A
2-PB1,1113,3236,1,0,0,3237,A
2-PB1,1114,3255,0,1,0,3256,A
2-PB1,1115,1,3249,0,1,3251,T
2-PB1,1116,0,1,3251,0,3252,G
2-PB1,1117,1,2,0,3237,3240,C
2-PB1,1118,0,3230,0,4,3234,T
2-PB1,1119,3273,1,1,0,3275,A
2-PB1,1120,1,0,3271,0,3272,G
2-PB1,1121,0,1,0,3264,3265,C
2-PB1,1122,3261,0,1,1,3263,A
2-PB1,1123,3255,1,3,0,3259,A
2-PB1,1124,0,0,3253,0,3253,G
2-PB1,1125,1,0,1,3245,3247,C
2-PB1,1126,3212,0,1,0,3213,A
2-PB1,1127,1,3272,0,1,3274,T
2-PB1,1128,0,3278,0,1,3279,T
2-PB1,1129,1,1,3360,0,3362,G
2-PB1,1130,3394,1,2,0,3397,A
2-PB1,1131,1,1,0,3378,3380,C
2-PB1,1132,1,0,0,3388,3389,C
2-PB1,1133,0,3325,0,4,3329,T
2-PB1,1134,0,0,3379,0,3379,G
2-PB1,1135,3387,0,1,0,3388,A
2-PB1,1136,3395,0,1,0,3396,A
2-PB1,1137,0,0,3427,0,3427,G
2-PB1,1138,0,3314,0,2,3316,T
2-PB1,1139,3345,0,0,0,3345,A
2-PB1,1140,0,3311,1,0,3312,T
2-PB1,1141,1,3310,0,1,3312,T
2-PB1,1142,0,3313,0,1,3314,T
2-PB1,1143,2,1,0,3265,3268,C
2-PB1,1144,3263,0,0,0,3263,A
2-PB1,1145,3270,1,0,0,3271,A
2-PB1,1146,0,3233,1,2,3236,T
2-PB1,1147,1,0,3254,1,3256,G
2-PB1,1148,3238,0,2,0,3240,A
2-PB1,1149,3252,1,2,0,3255,A
2-PB1,1150,0,3222,0,2,3224,T
2-PB1,1151,2,0,0,3252,3254,C
2-PB1,1152,3252,0,1,0,3253,A
2-PB1,1153,3254,0,1,0,3255,A
2-PB1,1154,0,0,0,3251,3251,C
2-PB1,1155,3248,1,2,0,3251,A
2-PB1,1156,3243,0,2,1,3246,A
2-PB1,1157,0,2,3245,0,3247,G
2-PB1,1158,0,2,3260,0,3262,G
2-PB1,1159,3256,0,6,0,3262,A
2-PB1,1160,3248,0,1,0,3249,A
2-PB1,1161,0,1,3251,1,3253,G
2-PB1,1162,3235,0,4,0,3239,A
2-PB1,1163,3245,0,0,0,3245,A
2-PB1,1164,3241,0,0,0,3241,A
2-PB1,1165,3235,1,1,2,3239,A
2-PB1,1166,1,3227,0,1,3229,T
2-PB1,1167,0,3207,1,2,3210,T
2-PB1,1168,1,1,3220,0,3222,G
2-PB1,1169,3212,3,4,0,3219,A
2-PB1,1170,0,0,3230,0,3230,G
2-PB1,1171,3230,1,0,0,3231,A
2-PB1,1172,3256,0,0,1,3257,A
2-PB1,1173,3279,0,1,2,3282,A
2-PB1,1174,3303,0,0,0,3303,A
2-PB1,1175,0,3293,1,0,3294,T
2-PB1,1176,3297,0,1,0,3298,A
2-PB1,1177,3288,0,7,0,3295,A
2-PB1,1178,0,6,3302,0,3308,G
2-PB1,1179,2,0,3296,0,3298,G
2-PB1,1180,3,1,0,3286,3290,C
2-PB1,1181,0,1,0,3276,3277,C
2-PB1,1182,3,3260,0,3,3266,T
2-PB1,1183,0,0,0,3673,3673,C
2-PB1,1184,0,3724,1,1,3726,T
2-PB1,1185,0,3728,1,1,3730,T
2-PB1,1186,1,0,0,3800,3801,C
2-PB1,1187,0,3791,0,3,3794,T
2-PB1,1188,3797,0,2,0,3799,A
2-PB1,1189,3795,1,1,0,3797,A
2-PB1,1190,0,3798,0,1,3799,T
2-PB1,1191,3809,0,1,0,3810,A
2-PB1,1192,0,2,3699,0,3701,G
2-PB1,1193,3362,0,0,0,3362,A
2-PB1,1194,0,3370,0,3,3373,T
2-PB1,1195,1,0,3318,0,3319,G
2-PB1,1196,1,1,3359,0,3361,G
2-PB1,1197,0,3,0,3340,3343,C
2-PB1,1198,3357,0,2,1,3360,A
2-PB1,1199,0,0,0,3365,3365,C
2-PB1,1200,3310,4,4,0,3318,A
2-PB1,1201,1,1,3431,0,3433,G
2-PB1,1202,0,1,0,3432,3433,C
2-PB1,1203,3429,0,2,0,3431,A
2-PB1,1204,0,3504,0,1,3505,T
2-PB1,1205,2,1,0,3485,3488,C
2-PB1,1206,3503,0,2,0,3505,A
2-PB1,1207,0,3508,0,1,3509,T
2-PB1,1208,0,3491,0,0,3491,T
2-PB1,1209,0,2,3483,0,3485,G
2-PB1,1210,3373,0,3,2,3378,A
2-PB1,1211,1,2,3457,0,3460,G
2-PB1,1212,0,3,0,3448,3451,C
2-PB1,1213,0,0,0,3399,3399,C
2-PB1,1214,2,0,0,3440,3442,C
2-PB1,1215,2,3408,0,1,3411,T
2-PB1,1216,1,1,3519,1,3522,G
2-PB1,1217,0,0,3560,1,3561,G
2-PB1,1218,3549,1,5,0,3555,A
2-PB1,1219,3597,1,0,0,3598,A
2-PB1,1220,0,3482,0,4,3486,T
2-PB1,1221,1,0,3550,0,3551,G
2-PB1,1222,3567,1,5,0,3573,A
2-PB1,1223,1,3541,0,0,3542,T
2-PB1,1224,0,0,3548,0,3548,G
2-PB1,1225,3503,0,0,1,3504,A
2-PB1,1226,0,3459,0,0,3459,T
2-PB1,1227,1,4,3441,1,3447,G
2-PB1,1228,1,1,3481,0,3483,G
2-PB1,1229,2,0,3484,1,3487,G
2-PB1,1230,1,1,1,3456,3459,C
2-PB1,1231,3457,1,1,0,3459,A
2-PB1,1232,0,3474,0,0,3474,T
2-PB1,1233,2,1,3553,0,3556,G
2-PB1,1234,1,3553,0,5,3559,T
2-PB1,1235,1,3568,0,1,3570,T
2-PB1,1236,2,2,0,3563,3567,C
2-PB1,1237,3551,0,0,0,3551,A
2-PB1,1238,3548,1,3,1,3553,A
2-PB1,1239,0,0,0,3554,3554,C
2-PB1,1240,3575,2,0,1,3578,A
2-PB1,1241,0,3591,0,1,3592,T
2-PB1,1242,3,1,3582,0,3586,G
2-PB1,1243,0,1,0,3583,3584,C
2-PB1,1244,1,3582,0,2,3585,T
2-PB1,1245,3508,1,82,1,3592,A
2-PB1,1246,3592,0,4,0,3596,A
2-PB1,1247,0,2,3661,0,3663,G
2-PB1,1248,0,3655,0,0,3655,T
2-PB1,1249,3638,0,1,0,3639,A
2-PB1,1250,0,2,0,3641,3643,C
2-PB1,1251,1,1,3624,0,3626,G
2-PB1,1252,2,0,3833,0,3835,G
2-PB1,1253,1,3819,2,3,3825,T
2-PB1,1254,0,3817,0,2,3819,T
2-PB1,1255,0,3814,1,1,3816,T
2-PB1,1256,0,3788,0,1,3789,T
2-PB1,1257,3782,1,7,0,3790,A
2-PB1,1258,1,1,3790,0,3792,G
2-PB1,1259,0,2,3783,0,3785,G
2-PB1,1260,3708,2,3,0,3713,A
2-PB1,1261,4,0,3671,0,3675,G
2-PB1,1262,0,3708,1,1,3710,T
2-PB1,1263,3,1,0,3715,3719,C
2-PB1,1264,0,3716,0,3,3719,T
2-PB1,1265,2,2,0,3714,3718,C
2-PB1,1266,0,0,3724,0,3724,G
2-PB1,1267,3821,1,0,0,3822,A
2-PB1,1268,0,3827,1,1,3829,T
2-PB1,1269,3834,1,0,1,3836,A
2-PB1,1270,2,0,0,3834,3836,C
2-PB1,1271,1,3776,0,4,3781,T
2-PB1,1272,1,1,3792,0,3794,G
2-PB1,1273,3788,0,1,0,3789,A
2-PB1,1274,3844,0,1,0,3845,A
2-PB1,1275,1,3851,0,1,3853,T
2-PB1,1276,1,0,0,3764,3765,C
2-PB1,1277,0,3752,0,1,3753,T
2-PB1,1278,1,3736,0,2,3739,T
2-PB1,1279,1,2,3743,1,3747,G
2-PB1,1280,1,2,3741,1,3745,G
2-PB1,1281,3740,0,6,0,3746,A
2-PB1,1282,0,5,0,3745,3750,C
2-PB1,1283,3696,0,1,0,3697,A
2-PB1,1284,3713,1,0,0,3714,A
2-PB1,1285,3727,0,1,0,3728,A
2-PB1,1286,3725,0,8,0,3733,A
2-PB1,1287,0,1,3802,0,3803,G
2-PB1,1288,3813,0,2,0,3815,A
2-PB1,1289,3804,0,0,1,3805,A
2-PB1,1290,3807,0,6,0,3813,A
2-PB1,1291,0,3807,0,0,3807,T
2-PB1,1292,3813,0,1,0,3814,A
2-PB1,1293,0,0,0,3907,3907,C
2-PB1,1294,3863,1,6,0,3870,A
2-PB1,1295,0,0,0,3870,3870,C
2-PB1,1296,2,0,0,3827,3829,C
2-PB1,1297,3814,3,0,0,3817,A
2-PB1,1298,3843,1,1,0,3845,A
2-PB1,1299,0,1,3961,0,3962,G
2-PB1,1300,3998,0,1,0,3999,A
2-PB1,1301,0,1,0,4033,4034,C
2-PB1,1302,3953,1,0,0,3954,A
2-PB1,1303,4057,0,3,0,4060,A
2-PB1,1304,0,0,0,4072,4072,C
2-PB1,1305,4127,0,3,0,4130,A
2-PB1,1306,1,4135,0,1,4137,T
2-PB1,1307,4103,2,1,0,4106,A
2-PB1,1308,1,0,0,4174,4175,C
2-PB1,1309,0,4040,0,4,4044,T
2-PB1,1310,1,1,4072,0,4074,G
2-PB1,1311,0,1,4068,0,4069,G
2-PB1,1312,0,3985,0,4,3989,T
2-PB1,1313,1,2,3974,0,3977,G
2-PB1,1314,0,4,3913,1,3918,G
2-PB1,1315,2,0,3929,0,3931,G
2-PB1,1316,3928,0,1,0,3929,A
2-PB1,1317,1,3857,0,1,3859,T
2-PB1,1318,1,3,3857,0,3861,G
2-PB1,1319,0,1,3841,1,3843,G
2-PB1,1320,1,2,3856,0,3859,G
2-PB1,1321,1,0,0,3904,3905,C
2-PB1,1322,1,3834,0,52,3887,T
2-PB1,1323,1,0,1,3907,3909,C
2-PB1,1324,0,1,0,3893,3894,C
2-PB1,1325,3903,0,0,1,3904,A
2-PB1,1326,3907,0,0,0,3907,A
2-PB1,1327,1,3885,0,1,3887,T
2-PB1,1328,1,0,0,3861,3862,C
2-PB1,1329,2,1,1,3823,3827,C
2-PB1,1330,1,3783,0,2,3786,T
2-PB1,1331,0,1,0,3794,3795,C
2-PB1,1332,4,2,0,3772,3778,C
2-PB1,1333,1,2,3783,0,3786,G
2-PB1,1334,3781,0,1,0,3782,A
2-PB1,1335,0,1,0,3786,3787,C
2-PB1,1336,1,1,3791,0,3793,G
2-PB1,1337,3809,2,0,0,3811,A
2-PB1,1338,0,3800,0,3,3803,T
2-PB1,1339,0,3801,1,1,3803,T
2-PB1,1340,1,3799,0,0,3800,T
2-PB1,1341,1,3808,0,0,3809,T
2-PB1,1342,2,0,3806,1,3809,G
2-PB1,1343,3,2,1,3825,3831,C
2-PB1,1344,3,0,0,3821,3824,C
2-PB1,1345,4,0,1,3915,3920,C
2-PB1,1346,0,3864,2,10,3876,T
2-PB1,1347,3,0,0,4013,4016,C
2-PB1,1348,4047,0,2,0,4049,A
2-PB1,1349,3,4060,0,0,4063,T
2-PB1,1350,4059,0,3,0,4062,A
2-PB1,1351,1,2,4089,0,4092,G
2-PB1,1352,0,4039,0,0,4039,T
2-PB1,1353,0,3,4046,1,4050,G
2-PB1,1354,3913,0,0,0,3913,A
2-PB1,1355,3920,0,0,0,3920,A
2-PB1,1356,0,3743,0,0,3743,T
2-PB1,1357,1,0,3734,0,3735,G
2-PB1,1358,2,2,0,3768,3772,C
2-PB1,1359,3764,0,6,1,3771,A
2-PB1,1360,0,0,0,3779,3779,C
2-PB1,1361,4,0,1,3744,3749,C
2-PB1,1362,3729,0,2,0,3731,A
2-PB1,1363,3732,0,0,0,3732,A
2-PB1,1364,3727,0,0,0,3727,A
2-PB1,1365,0,3622,0,1,3623,T
2-PB1,1366,3,0,0,3729,3732,C
2-PB1,1367,3731,0,2,1,3734,A
2-PB1,1368,0,3725,0,3,3728,T
2-PB1,1369,1,0,3733,0,3734,G
2-PB1,1370,3741,0,6,0,3747,A
2-PB1,1371,1,5,3762,0,3768,G
2-PB1,1372,2,1,3780,0,3783,G
2-PB1,1373,6,3,3783,0,3792,G
2-PB1,1374,3780,1,2,0,3783,A
2-PB1,1375,3825,0,3,1,3829,A
2-PB1,1376,0,3832,0,0,3832,T
2-PB1,1377,3840,0,1,0,3841,A
2-PB1,1378,0,0,0,3847,3847,C
2-PB1,1379,3857,0,1,0,3858,A
2-PB1,1380,3847,0,4,0,3851,A
2-PB1,1381,0,0,3840,0,3840,G
2-PB1,1382,1,0,0,3808,3809,C
2-PB1,1383,3796,1,2,0,3799,A
2-PB1,1384,0,1,3830,0,3831,G
2-PB1,1385,0,5,3825,1,3831,G
2-PB1,1386,3812,1,2,0,3815,A
2-PB1,1387,0,2,3827,0,3829,G
2-PB1,1388,0,3759,0,2,3761,T
2-PB1,1389,2,0,3795,1,3798,G
2-PB1,1390,1,1,3802,1,3805,G
2-PB1,1391,3805,1,4,0,3810,A
2-PB1,1392,1,3798,0,3,3802,T
2-PB1,1393,3740,0,0,1,3741,A
2-PB1,1394,2,1,3752,0,3755,G
2-PB1,1395,3783,0,0,0,3783,A
2-PB1,1396,0,3779,1,0,3780,T
2-PB1,1397,0,3761,0,2,3763,T
2-PB1,1398,2,0,0,3871,3873,C
2-PB1,1399,0,3848,0,2,3850,T
2-PB1,1400,3854,0,1,0,3855,A
2-PB1,1401,1,1,0,3854,3856,C
2-PB1,1402,3762,2,17,0,3781,A
2-PB1,1403,0,1,3783,0,3784,G
2-PB1,1404,0,0,3711,1,3712,G
2-PB1,1405,3731,0,2,0,3733,A
2-PB1,1406,2,2,0,3712,3716,C
2-PB1,1407,3,1,0,3599,3603,C
2-PB1,1408,0,3596,0,4,3600,T
2-PB1,1409,2,3,3608,0,3613,G
2-PB1,1410,1,0,1,3590,3592,C
2-PB1,1411,3607,0,1,0,3608,A
2-PB1,1412,3621,1,1,0,3623,A
2-PB1,1413,0,0,3641,0,3641,G
2-PB1,1414,2,3571,0,4,3577,T
2-PB1,1415,0,3573,0,1,3574,T
2-PB1,1416,3540,0,0,0,3540,A
2-PB1,1417,1,0,3548,0,3549,G
2-PB1,1418,1,3537,0,1,3539,T
2-PB1,1419,0,1,3529,0,3530,G
2-PB1,1420,2,1,3508,0,3511,G
2-PB1,1421,0,0,3532,0,3532,G
2-PB1,1422,3518,1,7,0,3526,A
2-PB1,1423,3536,0,1,0,3537,A
2-PB1,1424,0,3529,0,1,3530,T
2-PB1,1425,3,0,0,3528,3531,C
2-PB1,1426,3531,0,3,0,3534,A
2-PB1,1427,3539,0,0,0,3539,A
2-PB1,1428,1,1,0,3527,3529,C
2-PB1,1429,3527,0,0,0,3527,A
2-PB1,1430,0,3447,0,1,3448,T
2-PB1,1431,0,3,3449,0,3452,G
2-PB1,1432,3443,1,9,0,3453,A
2-PB1,1433,0,0,3470,0,3470,G
2-PB1,1434,1,2,0,3450,3453,C
2-PB1,1435,3448,1,0,0,3449,A
2-PB1,1436,3454,0,1,0,3455,A
2-PB1,1437,3453,1,0,1,3455,A
2-PB1,1438,3484,0,0,1,3485,A
2-PB1,1439,3478,0,3,0,3481,A
2-PB1,1440,1,0,3476,0,3477,G
2-PB1,1441,3437,1,1,0,3439,A
2-PB1,1442,3390,1,3,0,3394,A
2-PB1,1443,1,1,3497,1,3500,G
2-PB1,1444,2,3490,1,2,3495,T
2-PB1,1445,1,1,0,3488,3490,C
2-PB1,1446,1,5,0,3503,3509,C
2-PB1,1447,0,3486,0,5,3491,T
2-PB1,1448,3547,1,0,0,3548,A
2-PB1,1449,2,3540,0,0,3542,T
2-PB1,1450,3546,0,0,0,3546,A
2-PB1,1451,1,3540,0,0,3541,T
2-PB1,1452,3445,0,2,0,3447,A
2-PB1,1453,3441,0,0,0,3441,A
2-PB1,1454,3440,2,0,0,3442,A
2-PB1,1455,0,3433,0,1,3434,T
2-PB1,1456,3405,0,2,0,3407,A
2-PB1,1457,3350,0,0,0,3350,A
2-PB1,1458,3373,0,0,0,3373,A
2-PB1,1459,3368,2,5,1,3376,A
2-PB1,1460,0,0,0,3376,3376,C
2-PB1,1461,3219,0,0,0,3219,A
2-PB1,1462,1,5,3210,0,3216,G
2-PB1,1463,0,1,3193,1,3195,G
2-PB1,1464,1,4,3195,0,3200,G
2-PB1,1465,3204,2,3,0,3209,A
2-PB1,1466,0,0,0,3214,3214,C
2-PB1,1467,3184,1,1,0,3186,A
2-PB1,1468,0,3186,0,3,3189,T
2-PB1,1469,1,3194,0,1,3196,T
2-PB1,1470,0,3206,0,2,3208,T
2-PB1,1471,4,2,3200,0,3206,G
2-PB1,1472,3188,0,2,0,3190,A
2-PB1,1473,3189,1,0,0,3190,A
2-PB1,1474,1,3179,0,1,3181,T
2-PB1,1475,1,3120,0,1,3122,T
2-PB1,1476,3,2,0,3124,3129,C
2-PB1,1477,3098,0,2,0,3100,A
2-PB1,1478,1,0,0,3100,3101,C
2-PB1,1479,0,3096,0,0,3096,T
2-PB1,1480,3094,0,1,1,3096,A
2-PB1,1481,2,1,3091,0,3094,G
2-PB1,1482,0,0,0,3084,3084,C
2-PB1,1483,0,3059,0,8,3067,T
2-PB1,1484,1,3092,0,0,3093,T
2-PB1,1485,0,3076,0,2,3078,T
2-PB1,1486,1,3080,0,0,3081,T
2-PB1,1487,0,3080,0,0,3080,T
2-PB1,1488,0,3072,0,2,3074,T
2-PB1,1489,0,3074,0,0,3074,T
2-PB1,1490,3072,0,0,0,3072,A
2-PB1,1491,1,3056,0,1,3058,T
2-PB1,1492,2,0,0,3061,3063,C
2-PB1,1493,0,1,3083,0,3084,G
2-PB1,1494,3155,0,0,0,3155,A
2-PB1,1495,1,3162,0,0,3163,T
2-PB1,1496,3153,0,0,1,3154,A
2-PB1,1497,1,3179,0,1,3181,T
2-PB1,1498,1,0,3170,0,3171,G
2-PB1,1499,1,1,3187,1,3190,G
2-PB1,1500,3184,0,0,0,3184,A
2-PB1,1501,0,3157,0,2,3159,T
2-PB1,1502,2,3138,0,0,3140,T
2-PB1,1503,0,3035,0,1,3036,T
2-PB1,1504,1,1,3039,0,3041,G
2-PB1,1505,1,3020,0,1,3022,T
2-PB1,1506,1,2,3012,0,3015,G
2-PB1,1507,3,0,3014,0,3017,G
2-PB1,1508,0,0,1,2983,2984,C
2-PB1,1509,0,2982,0,2,2984,T
2-PB1,1510,2990,0,1,0,2991,A
2-PB1,1511,3004,0,1,0,3005,A
2-PB1,1512,1,2998,0,1,3000,T
2-PB1,1513,1,3002,1,0,3004,T
2-PB1,1514,0,3012,1,1,3014,T
2-PB1,1515,0,3008,0,0,3008,T
2-PB1,1516,3000,0,4,0,3004,A
2-PB1,1517,1,1,3018,0,3020,G
2-PB1,1518,0,1,0,3022,3023,C
2-PB1,1519,3005,1,1,1,3008,A
2-PB1,1520,0,2989,0,0,2989,T
2-PB1,1521,1,1,2941,0,2943,G
2-PB1,1522,1,0,2974,0,2975,G
2-PB1,1523,2966,0,5,0,2971,A
2-PB1,1524,0,0,2970,0,2970,G
2-PB1,1525,0,2,0,2960,2962,C
2-PB1,1526,0,2922,0,1,2923,T
2-PB1,1527,2,0,2929,0,2931,G
2-PB1,1528,2,3,0,2918,2923,C
2-PB1,1529,4,0,0,2910,2914,C
2-PB1,1530,3,0,0,2924,2927,C
2-PB1,1531,2832,0,2,1,2835,A
2-PB1,1532,0,0,2963,0,2963,G
2-PB1,1533,0,2956,0,1,2957,T
2-PB1,1534,1,2958,0,0,2959,T
2-PB1,1535,2,2959,0,2,2963,T
2-PB1,1536,0,2922,1,1,2924,T
2-PB1,1537,1,0,2909,1,2911,G
2-PB1,1538,1,2,2914,1,2918,G
2-PB1,1539,2904,0,4,0,2908,A
2-PB1,1540,0,0,2916,0,2916,G
2-PB1,1541,0,2604,0,1,2605,T
2-PB1,1542,2,1,2693,0,2696,G
2-PB1,1543,0,2682,0,2,2684,T
2-PB1,1544,0,1,0,2679,2680,C
2-PB1,1545,0,2689,0,1,2690,T
2-PB1,1546,1,0,2692,0,2693,G
2-PB1,1547,0,0,2704,0,2704,G
2-PB1,1548,2704,0,0,1,2705,A
2-PB1,1549,2703,0,1,0,2704,A
2-PB1,1550,0,2692,2,2,2696,T
2-PB1,1551,2410,0,0,0,2410,A
2-PB1,1552,2407,0,1,0,2408,A
2-PB1,1553,2404,1,1,0,2406,A
2-PB1,1554,1,20,0,2385,2406,C
2-PB1,1555,0,1,2373,0,2374,G
2-PB1,1556,2336,1,1,0,2338,A
2-PB1,1557,0,0,2334,0,2334,G
2-PB1,1558,1,2316,1,1,2319,T
2-PB1,1559,1,0,0,2316,2317,C
2-PB1,1560,2308,2,1,1,2312,A
2-PB1,1561,1,0,2334,0,2335,G
2-PB1,1562,1,0,0,2328,2329,C
2-PB1,1563,1,2323,0,0,2324,T
2-PB1,1564,0,0,2365,0,2365,G
2-PB1,1565,2351,0,1,0,2352,A
2-PB1,1566,0,2350,1,0,2351,T
2-PB1,1567,2353,1,0,0,2354,A
2-PB1,1568,0,2322,0,1,2323,T
2-PB1,1569,1,2,2323,0,2326,G
2-PB1,1570,2207,0,2,2,2211,A
2-PB1,1571,2,0,2228,0,2230,G
2-PB1,1572,0,1,0,2224,2225,C
2-PB1,1573,2087,0,0,1,2088,A
2-PB1,1574,2,2079,1,0,2082,T
2-PB1,1575,0,2071,0,0,2071,T
2-PB1,1576,1,0,2085,0,2086,G
2-PB1,1577,1,0,2134,0,2135,G
2-PB1,1578,2076,0,1,0,2077,A
2-PB1,1579,0,0,2084,0,2084,G
2-PB1,1580,0,1969,1,0,1970,T
2-PB1,1581,1961,1,1,0,1963,A
2-PB1,1582,1952,0,3,0,1955,A
2-PB1,1583,0,0,0,1973,1973,C
2-PB1,1584,1954,0,1,0,1955,A
2-PB1,1585,1,0,1974,0,1975,G
2-PB1,1586,0,1671,0,1,1672,T
2-PB1,1587,0,0,1682,0,1682,G
2-PB1,1588,1686,1,0,0,1687,A
2-PB1,1589,1,1686,0,0,1687,T
2-PB1,1590,1680,0,0,0,1680,A
2-PB1,1591,1673,0,0,0,1673,A
2-PB1,1592,1597,0,1,0,1598,A
2-PB1,1593,0,2,1607,0,1609,G
2-PB1,1594,1462,0,0,0,1462,A
2-PB1,1595,1460,1,0,0,1461,A
2-PB1,1596,0,3,0,1454,1457,C
2-PB1,1597,1373,0,2,0,1375,A
2-PB1,1598,1381,1,0,0,1382,A
2-PB1,1599,0,0,0,1388,1388,C
2-PB1,1600,1395,1,1,0,1397,A
2-PB1,1601,0,1393,2,0,1395,T
2-PB1,1602,1,0,1337,0,1338,G
2-PB1,1603,1338,0,2,0,1340,A
2-PB1,1604,0,1336,0,0,1336,T
2-PB1,1605,1294,0,0,0,1294,A
2-PB1,1606,1297,0,1,0,1298,A
2-PB1,1607,1239,1,0,1,1241,A
2-PB1,1608,0,0,0,1248,1248,C
2-PB1,1609,1160,0,0,0,1160,A
2-PB1,1610,1152,1,0,0,1153,A
2-PB1,1611,0,1104,0,2,1106,T
2-PB1,1612,0,0,1107,0,1107,G
2-PB1,1613,1133,0,1,0,1134,A
2-PB1,1614,0,0,0,1137,1137,C
2-PB1,1615,1,1,0,1084,1086,C
2-PB1,1616,0,1016,1,0,1017,T
2-PB1,1617,1,964,0,0,965,T
2-PB1,1618,0,0,966,0,966,G
2-PB1,1619,0,0,969,0,969,G
2-PB1,1620,982,0,0,0,982,A
2-PB1,1621,0,1,0,992,993,C
2-PB1,1622,1,0,0,985,986,C
2-PB1,1623,975,0,0,0,975,A
2-PB1,1624,0,0,1002,0,1002,G
2-PB1,1625,0,1,0,1003,1004,C
2-PB1,1626,1002,0,0,0,1002,A
2-PB1,1627,1002,0,1,0,1003,A
2-PB1,1628,0,0,0,1000,1000,C
2-PB1,1629,998,0,0,0,998,A
2-PB1,1630,2,0,1014,0,1016,G
2-PB1,1631,1,0,0,1015,1016,C
2-PB1,1632,0,0,0,1014,1014,C
2-PB1,1633,0,1,0,1011,1012,C
2-PB1,1634,1014,0,1,0,1015,A
2-PB1,1635,1013,0,0,0,1013,A
2-PB1,1636,1013,0,0,0,1013,A
2-PB1,1637,0,1016,0,0,1016,T
2-PB1,1638,0,2,1006,0,1008,G
2-PB1,1639,0,0,996,0,996,G
2-PB1,1640,0,0,0,991,991,C
2-PB1,1641,2,986,0,0,988,T
2-PB1,1642,0,0,0,1012,1012,C
2-PB1,1643,1,1010,0,1,1012,T
2-PB1,1644,2,0,0,1009,1011,C
2-PB1,1645,0,1,1,1016,1018,C
2-PB1,1646,1020,0,0,0,1020,A
2-PB1,1647,1028,1,0,0,1029,A
2-PB1,1648,0,1018,0,0,1018,T
2-PB1,1649,0,1014,0,2,1016,T
2-PB1,1650,0,0,1024,1,1025,G
2-PB1,1651,0,996,0,2,998,T
2-PB1,1652,0,999,0,0,999,T
2-PB1,1653,2,10,0,995,1007,C
2-PB1,1654,1007,0,0,0,1007,A
2-PB1,1655,0,1008,0,0,1008,T
2-PB1,1656,1,0,0,1007,1008,C
2-PB1,1657,1010,0,0,0,1010,A
2-PB1,1658,972,0,39,0,1011,A
2-PB1,1659,1006,0,1,0,1007,A
2-PB1,1660,0,0,1026,1,1027,G
2-PB1,1661,1025,0,0,0,1025,A
2-PB1,1662,2,1022,0,0,1024,T
2-PB1,1663,0,1019,0,0,1019,T
2-PB1,1664,1022,0,2,0,1024,A
2-PB1,1665,0,0,0,1040,1040,C
2-PB1,1666,1039,0,0,0,1039,A
2-PB1,1667,0,2,1049,0,1051,G
2-PB1,1668,1045,0,0,0,1045,A
2-PB1,1669,0,1055,0,0,1055,T
2-PB1,1670,1059,0,0,1,1060,A
2-PB1,1671,0,0,0,1128,1128,C
2-PB1,1672,1136,0,18,1,1155,A
2-PB1,1673,0,1,0,1222,1223,C
2-PB1,1674,1208,0,1,0,1209,A
2-PB1,1675,0,1218,0,0,1218,T
2-PB1,1676,1211,0,1,0,1212,A
2-PB1,1677,0,1208,0,1,1209,T
2-PB1,1678,1173,0,2,0,1175,A
2-PB1,1679,0,0,1174,0,1174,G
2-PB1,1680,3,0,1163,0,1166,G
2-PB1,1681,0,1115,0,1,1116,T
2-PB1,1682,0,0,1100,0,1100,G
2-PB1,1683,0,0,0,1135,1135,C
2-PB1,1684,0,1,0,1123,1124,C
2-PB1,1685,1139,0,0,0,1139,A
2-PB1,1686,0,1140,0,0,1140,T
2-PB1,1687,1140,0,0,1,1141,A
2-PB1,1688,0,1,1152,0,1153,G
2-PB1,1689,1121,0,0,0,1121,A
2-PB1,1690,0,0,1131,0,1131,G
2-PB1,1691,1,0,1126,0,1127,G
2-PB1,1692,1092,0,2,0,1094,A
2-PB1,1693,0,1,1096,0,1097,G
2-PB1,1694,1095,0,0,0,1095,A
2-PB1,1695,0,0,0,1097,1097,C
2-PB1,1696,1089,1,0,0,1090,A
2-PB1,1697,0,0,0,1107,1107,C
2-PB1,1698,1106,0,2,0,1108,A
2-PB1,1699,0,0,0,1114,1114,C
2-PB1,1700,1102,0,0,0,1102,A
2-PB1,1701,1102,0,0,0,1102,A
2-PB1,1702,1114,0,1,0,1115,A
2-PB1,1703,0,1104,0,0,1104,T
2-PB1,1704,0,2,0,1111,1113,C
2-PB1,1705,1,0,0,1113,1114,C
2-PB1,1706,1105,0,1,0,1106,A
2-PB1,1707,0,0,1105,1,1106,G
2-PB1,1708,1103,1,1,0,1105,A
2-PB1,1709,1,1,0,1105,1107,C
2-PB1,1710,1,0,1105,0,1106,G
2-PB1,1711,1102,0,1,0,1103,A
2-PB1,1712,0,0,1100,0,1100,G
2-PB1,1713,1095,0,0,0,1095,A
2-PB1,1714,1102,0,1,0,1103,A
2-PB1,1715,1,0,1106,0,1107,G
2-PB1,1716,1103,0,3,0,1106,A
2-PB1,1717,0,1096,0,1,1097,T
2-PB1,1718,0,0,0,1094,1094,C
2-PB1,1719,1095,1,0,0,1096,A
2-PB1,1720,1,1094,0,1,1096,T
2-PB1,1721,0,1093,0,0,1093,T
2-PB1,1722,0,0,0,1093,1093,C
2-PB1,1723,3,0,1088,0,1091,G
2-PB1,1724,1087,0,0,0,1087,A
2-PB1,1725,0,1,1090,0,1091,G
2-PB1,1726,1079,0,1,0,1080,A
2-PB1,1727,0,1123,0,1,1124,T
2-PB1,1728,1137,0,0,0,1137,A
2-PB1,1729,1135,0,1,0,1136,A
2-PB1,1730,1135,0,0,1,1136,A
2-PB1,1731,9,0,1128,0,1137,G
2-PB1,1732,1145,0,0,0,1145,A
2-PB1,1733,1117,0,0,0,1117,A
2-PB1,1734,1,0,1121,0,1122,G
2-PB1,1735,0,1,0,1116,1117,C
2-PB1,1736,0,1108,0,1,1109,T
2-PB1,1737,0,0,1118,0,1118,G
2-PB1,1738,0,1112,0,0,1112,T
2-PB1,1739,0,1,1097,0,1098,G
2-PB1,1740,0,0,1101,0,1101,G
2-PB1,1741,0,0,1107,3,1110,G
2-PB1,1742,1116,1,4,0,1121,A
2-PB1,1743,0,1109,0,0,1109,T
2-PB1,1744,1,0,0,1110,1111,C
2-PB1,1745,1111,0,0,0,1111,A
2-PB1,1746,1117,0,1,0,1118,A
2-PB1,1747,1124,0,0,0,1124,A
2-PB1,1748,0,1,1,1117,1119,C
2-PB1,1749,0,2,0,1114,1116,C
2-PB1,1750,2,0,0,1115,1117,C
2-PB1,1751,1111,0,0,0,1111,A
2-PB1,1752,1132,0,2,0,1134,A
2-PB1,1753,0,1136,0,1,1137,T
2-PB1,1754,1,0,0,1136,1137,C
2-PB1,1755,1129,0,0,0,1129,A
2-PB1,1756,1120,1,1,0,1122,A
2-PB1,1757,0,0,1132,0,1132,G
2-PB1,1758,0,0,1133,0,1133,G
2-PB1,1759,0,0,1138,0,1138,G
2-PB1,1760,0,1,0,1130,1131,C
2-PB1,1761,1112,0,2,0,1114,A
2-PB1,1762,1,0,1147,0,1148,G
2-PB1,1763,0,1,1155,1,1157,G
2-PB1,1764,1160,0,1,0,1161,A
2-PB1,1765,0,0,0,1177,1177,C
2-PB1,1766,0,1145,0,1,1146,T
2-PB1,1767,1183,1,1,0,1185,A
2-PB1,1768,0,1184,0,1,1185,T
2-PB1,1769,0,1184,0,1,1185,T
2-PB1,1770,0,0,1190,0,1190,G
2-PB1,1771,0,0,1193,0,1193,G
2-PB1,1772,0,1190,0,0,1190,T
2-PB1,1773,1188,0,0,0,1188,A
2-PB1,1774,0,1164,0,0,1164,T
2-PB1,1775,0,0,0,1170,1170,C
2-PB1,1776,1146,0,0,0,1146,A
2-PB1,1777,0,1,1170,0,1171,G
2-PB1,1778,1170,0,0,0,1170,A
2-PB1,1779,0,1163,0,1,1164,T
2-PB1,1780,0,0,1123,0,1123,G
2-PB1,1781,0,1,1115,0,1116,G
2-PB1,1782,1,1,1114,0,1116,G
2-PB1,1783,0,1,1119,0,1120,G
2-PB1,1784,0,2,1111,0,1113,G
2-PB1,1785,1106,1,1,0,1108,A
2-PB1,1786,0,0,0,1105,1105,C
2-PB1,1787,0,0,0,1104,1104,C
2-PB1,1788,1107,1,0,0,1108,A
2-PB1,1789,1204,1,1,0,1206,A
2-PB1,1790,1214,0,0,0,1214,A
2-PB1,1791,0,0,0,1238,1238,C
2-PB1,1792,0,1229,0,0,1229,T
2-PB1,1793,0,1226,0,0,1226,T
2-PB1,1794,1230,0,0,0,1230,A
2-PB1,1795,1,1226,0,0,1227,T
2-PB1,1796,1231,0,2,0,1233,A
2-PB1,1797,0,0,0,1232,1232,C
2-PB1,1798,1137,0,0,0,1137,A
2-PB1,1799,1139,0,0,1,1140,A
2-PB1,1800,0,1109,0,0,1109,T
2-PB1,1801,1118,0,0,0,1118,A
2-PB1,1802,0,1124,0,0,1124,T
2-PB1,1803,0,0,0,1122,1122,C
2-PB1,1804,0,0,0,1127,1127,C
2-PB1,1805,1,0,1124,0,1125,G
2-PB1,1806,1,0,1125,0,1126,G
2-PB1,1807,1127,0,1,0,1128,A
2-PB1,1808,1129,0,0,0,1129,A
2-PB1,1809,0,1133,0,0,1133,T
2-PB1,1810,0,0,0,1131,1131,C
2-PB1,1811,0,1131,0,0,1131,T
2-PB1,1812,0,1129,0,1,1130,T
2-PB1,1813,0,0,0,1129,1129,C
2-PB1,1814,1130,0,1,0,1131,A
2-PB1,1815,0,0,0,1135,1135,C
2-PB1,1816,1132,0,1,0,1133,A
2-PB1,1817,0,1196,0,4,1200,T
2-PB1,1818,1,0,0,1199,1200,C
2-PB1,1819,2,0,0,1212,1214,C
2-PB1,1820,2,0,0,1218,1220,C
2-PB1,1821,0,1217,0,2,1219,T
2-PB1,1822,0,1,1217,0,1218,G
2-PB1,1823,1221,0,0,0,1221,A
2-PB1,1824,1215,0,1,0,1216,A
2-PB1,1825,0,0,1218,0,1218,G
2-PB1,1826,0,1151,0,0,1151,T
2-PB1,1827,0,0,0,1152,1152,C
2-PB1,1828,0,1128,0,1,1129,T
2-PB1,1829,1,0,1158,0,1159,G
2-PB1,1830,1,0,1,1156,1158,C
2-PB1,1831,0,1159,0,2,1161,T
2-PB1,1832,0,1161,0,0,1161,T
2-PB1,1833,1163,0,0,0,1163,A
2-PB1,1834,1157,1,0,0,1158,A
2-PB1,1835,1158,0,0,0,1158,A
2-PB1,1836,1125,0,0,0,1125,A
2-PB1,1837,0,1135,0,0,1135,T
2-PB1,1838,0,1,1131,0,1132,G
2-PB1,1839,0,1,1131,1,1133,G
2-PB1,1840,2,0,1140,1,1143,G
2-PB1,1841,1127,0,6,0,1133,A
2-PB1,1842,0,0,1142,0,1142,G
2-PB1,1843,1,0,0,1137,1138,C
2-PB1,1844,0,1135,0,0,1135,T
2-PB1,1845,0,1,1136,0,1137,G
2-PB1,1846,1137,0,1,0,1138,A
2-PB1,1847,0,1141,0,0,1141,T
2-PB1,1848,0,1,1143,0,1144,G
2-PB1,1849,0,1,1144,0,1145,G
2-PB1,1850,1142,0,1,1,1144,A
2-PB1,1851,0,1141,0,0,1141,T
2-PB1,1852,0,0,1142,0,1142,G
2-PB1,1853,1140,1,2,0,1143,A
2-PB1,1854,0,0,1164,0,1164,G
2-PB1,1855,1159,0,0,0,1159,A
2-PB1,1856,1165,1,0,0,1166,A
2-PB1,1857,0,1161,0,0,1161,T
2-PB1,1858,0,1153,0,0,1153,T
2-PB1,1859,1157,0,0,0,1157,A
2-PB1,1860,1,1156,0,0,1157,T
2-PB1,1861,2,1,0,1157,1160,C
2-PB1,1862,1,3,1156,1,1161,G
2-PB1,1863,0,0,1149,0,1149,G
2-PB1,1864,0,0,1147,0,1147,G
2-PB1,1865,0,0,1147,0,1147,G
2-PB1,1866,1149,0,0,0,1149,A
2-PB1,1867,1149,0,0,0,1149,A
2-PB1,1868,0,0,1151,0,1151,G
2-PB1,1869,1168,0,0,0,1168,A
2-PB1,1870,0,0,0,1170,1170,C
2-PB1,1871,0,1153,0,0,1153,T
2-PB1,1872,0,1167,0,0,1167,T
2-PB1,1873,1,1172,0,1,1174,T
2-PB1,1874,0,0,1186,0,1186,G
2-PB1,1875,0,1182,0,0,1182,T
2-PB1,1876,1178,0,0,0,1178,A
2-PB1,1877,1169,0,1,0,1170,A
2-PB1,1878,0,1147,0,0,1147,T
2-PB1,1879,0,0,0,1160,1160,C
2-PB1,1880,1,0,0,1157,1158,C
2-PB1,1881,1,0,0,1156,1157,C
2-PB1,1882,0,1,0,1161,1162,C
2-PB1,1883,0,1151,0,2,1153,T
2-PB1,1884,1,0,1158,0,1159,G
2-PB1,1885,1154,0,0,0,1154,A
2-PB1,1886,1153,0,0,0,1153,A
2-PB1,1887,0,1159,0,0,1159,T
2-PB1,1888,0,0,0,1164,1164,C
2-PB1,1889,0,1,1,1157,1159,C
2-PB1,1890,0,0,0,1154,1154,C
2-PB1,1891,0,1152,0,3,1155,T
2-PB1,1892,0,1155,0,0,1155,T
2-PB1,1893,0,1151,0,0,1151,T
2-PB1,1894,0,0,1153,0,1153,G
2-PB1,1895,0,1146,0,2,1148,T
2-PB1,1896,0,0,0,1147,1147,C
2-PB1,1897,1132,1,0,0,1133,A
2-PB1,1898,0,0,1155,0,1155,G
2-PB1,1899,0,1,0,1152,1153,C
2-PB1,1900,0,1,0,1151,1152,C
2-PB1,1901,1155,0,0,0,1155,A
2-PB1,1902,0,1157,0,1,1158,T
2-PB1,1903,1160,0,0,0,1160,A
2-PB1,1904,1156,1,1,0,1158,A
2-PB1,1905,1158,0,2,0,1160,A
2-PB1,1906,0,0,1178,0,1178,G
2-PB1,1907,1148,1,0,0,1149,A
2-PB1,1908,1150,0,1,0,1151,A
2-PB1,1909,1151,0,1,0,1152,A
2-PB1,1910,0,1149,0,1,1150,T
2-PB1,1911,0,1147,0,0,1147,T
2-PB1,1912,0,1,1145,0,1146,G
2-PB1,1913,1137,0,0,0,1137,A
2-PB1,1914,0,0,1151,0,1151,G
2-PB1,1915,0,1155,0,0,1155,T
2-PB1,1916,0,0,1,1164,1165,C
2-PB1,1917,1,1158,0,1,1160,T
2-PB1,1918,0,0,1183,0,1183,G
2-PB1,1919,0,1181,0,1,1182,T
2-PB1,1920,1195,0,0,0,1195,A
2-PB1,1921,1193,1,0,0,1194,A
2-PB1,1922,1197,0,0,0,1197,A
2-PB1,1923,0,2,0,1196,1198,C
2-PB1,1924,1161,0,0,0,1161,A
2-PB1,1925,1179,1,0,0,1180,A
2-PB1,1926,0,1178,0,0,1178,T
2-PB1,1927,0,1,1165,0,1166,G
2-PB1,1928,0,0,0,1172,1172,C
2-PB1,1929,0,1149,2,1,1152,T
2-PB1,1930,0,0,1183,0,1183,G
2-PB1,1931,1,1182,0,1,1184,T
2-PB1,1932,1203,0,0,0,1203,A
2-PB1,1933,0,0,1209,0,1209,G
2-PB1,1934,0,1173,0,1,1174,T
2-PB1,1935,1165,0,0,0,1165,A
2-PB1,1936,1159,0,0,1,1160,A
2-PB1,1937,0,1153,0,0,1153,T
2-PB1,1938,0,0,1152,0,1152,G
2-PB1,1939,0,2,0,1136,1138,C
2-PB1,1940,0,2,0,1118,1120,C
2-PB1,1941,1102,0,0,0,1102,A
2-PB1,1942,0,0,1125,0,1125,G
2-PB1,1943,0,1,0,1145,1146,C
2-PB1,1944,0,2,0,1154,1156,C
2-PB1,1945,0,0,1,1154,1155,C
2-PB1,1946,1152,0,2,0,1154,A
2-PB1,1947,0,1153,0,0,1153,T
2-PB1,1948,0,1,1155,0,1156,G
2-PB1,1949,0,0,1171,0,1171,G
2-PB1,1950,1,1165,0,2,1168,T
2-PB1,1951,2,0,0,1138,1140,C
2-PB1,1952,0,0,0,1114,1114,C
2-PB1,1953,0,1108,0,0,1108,T
2-PB1,1954,1,0,1123,0,1124,G
2-PB1,1955,1,0,0,1118,1119,C
2-PB1,1956,1,0,1,1121,1123,C
2-PB1,1957,1123,0,0,0,1123,A
2-PB1,1958,1108,0,0,0,1108,A
2-PB1,1959,1105,0,0,0,1105,A
2-PB1,1960,1113,0,0,0,1113,A
2-PB1,1961,0,0,1128,0,1128,G
2-PB1,1962,0,1114,0,0,1114,T
2-PB1,1963,1110,0,0,0,1110,A
2-PB1,1964,0,1112,0,0,1112,T
2-PB1,1965,0,0,1111,0,1111,G
2-PB1,1966,0,1,1133,0,1134,G
2-PB1,1967,1132,0,1,0,1133,A
2-PB1,1968,1154,0,0,0,1154,A
2-PB1,1969,0,1152,0,0,1152,T
2-PB1,1970,1137,0,0,0,1137,A
2-PB1,1971,1,1135,0,0,1136,T
2-PB1,1972,0,0,1123,0,1123,G
2-PB1,1973,1122,0,0,0,1122,A
2-PB1,1974,0,1120,0,0,1120,T
2-PB1,1975,0,0,1072,0,1072,G
2-PB1,1976,0,0,0,1074,1074,C
2-PB1,1977,1,1,1,1063,1066,C
2-PB1,1978,0,1,1071,0,1072,G
2-PB1,1979,0,1071,0,0,1071,T
2-PB1,1980,1,1069,0,2,1072,T
2-PB1,1981,2,0,1075,0,1077,G
2-PB1,1982,0,0,0,1095,1095,C
2-PB1,1983,1096,1,0,0,1097,A
2-PB1,1984,1106,0,3,0,1109,A
2-PB1,1985,0,0,0,1117,1117,C
2-PB1,1986,0,1106,0,1,1107,T
2-PB1,1987,1111,1,1,0,1113,A
2-PB1,1988,0,0,0,1111,1111,C
2-PB1,1989,1106,1,5,0,1112,A
2-PB1,1990,1,0,0,1111,1112,C
2-PB1,1991,1076,0,1,0,1077,A
2-PB1,1992,0,0,0,1168,1168,C
2-PB1,1993,1,1147,0,1,1149,T
2-PB1,1994,0,0,0,1159,1159,C
2-PB1,1995,0,0,0,1155,1155,C
2-PB1,1996,0,1150,0,1,1151,T
2-PB1,1997,0,2,1145,0,1147,G
2-PB1,1998,0,0,1148,0,1148,G
2-PB1,1999,1142,0,1,0,1143,A
2-PB1,2000,0,1143,0,0,1143,T
2-PB1,2001,0,1033,0,2,1035,T
2-PB1,2002,0,0,0,1046,1046,C
2-PB1,2003,1,0,0,1037,1038,C
2-PB1,2004,0,1,0,1040,1041,C
2-PB1,2005,1044,0,1,0,1045,A
2-PB1,2006,1048,0,0,0,1048,A
2-PB1,2007,0,1,1048,0,1049,G
2-PB1,2008,1046,0,0,0,1046,A
2-PB1,2009,1,0,1048,0,1049,G
2-PB1,2010,0,0,1047,0,1047,G
2-PB1,2011,1032,0,0,0,1032,A
2-PB1,2012,1032,0,0,0,1032,A
2-PB1,2013,1,0,0,1033,1034,C
2-PB1,2014,0,0,0,1030,1030,C
2-PB1,2015,1,1,1037,0,1039,G
2-PB1,2016,1,1,0,1036,1038,C
2-PB1,2017,0,1038,0,1,1039,T
2-PB1,2018,2,0,0,1043,1045,C
2-PB1,2019,1,1035,0,0,1036,T
2-PB1,2020,1112,1,0,0,1113,A
2-PB1,2021,1,1112,0,1,1114,T
2-PB1,2022,0,1119,0,0,1119,T
2-PB1,2023,0,0,0,1117,1117,C
2-PB1,2024,0,1083,0,0,1083,T
2-PB1,2025,1088,0,0,0,1088,A
2-PB1,2026,1088,0,0,0,1088,A
2-PB1,2027,1093,0,0,0,1093,A
2-PB1,2028,0,0,0,1093,1093,C
2-PB1,2029,1026,0,0,0,1026,A
2-PB1,2030,0,0,0,1025,1025,C
2-PB1,2031,1010,0,3,0,1013,A
2-PB1,2032,1011,0,2,0,1013,A
2-PB1,2033,0,0,1019,0,1019,G
2-PB1,2034,0,0,0,1010,1010,C
2-PB1,2035,1,0,0,1016,1017,C
2-PB1,2036,1004,1,3,0,1008,A
2-PB1,2037,1007,0,1,0,1008,A
2-PB1,2038,1011,0,1,0,1012,A
2-PB1,2039,0,2,1018,0,1020,G
2-PB1,2040,0,0,1020,0,1020,G
2-PB1,2041,1,0,1006,0,1007,G
2-PB1,2042,1,1,1008,0,1010,G
2-PB1,2043,1004,0,2,0,1006,A
2-PB1,2044,1010,1,0,0,1011,A
2-PB1,2045,0,1014,1,0,1015,T
2-PB1,2046,0,1016,0,0,1016,T
2-PB1,2047,0,0,0,1021,1021,C
2-PB1,2048,1,1006,0,1,1008,T
2-PB1,2049,0,1009,0,0,1009,T
2-PB1,2050,0,0,1007,0,1007,G
2-PB1,2051,1002,0,1,0,1003,A
2-PB1,2052,0,0,1007,0,1007,G
2-PB1,2053,0,0,1001,0,1001,G
2-PB1,2054,999,0,0,0,999,A
2-PB1,2055,0,995,0,0,995,T
2-PB1,2056,0,1,1008,0,1009,G
2-PB1,2057,1007,0,0,0,1007,A
2-PB1,2058,1008,0,1,0,1009,A
2-PB1,2059,0,2,0,1006,1008,C
2-PB1,2060,998,0,0,1,999,A
2-PB1,2061,0,0,1008,0,1008,G
2-PB1,2062,1006,0,0,0,1006,A
2-PB1,2063,0,1006,0,0,1006,T
2-PB1,2064,0,0,1012,0,1012,G
2-PB1,2065,0,1030,0,1,1031,T
2-PB1,2066,1035,0,0,0,1035,A
2-PB1,2067,0,0,0,1034,1034,C
2-PB1,2068,0,0,0,1031,1031,C
2-PB1,2069,1016,1,0,1,1018,A
2-PB1,2070,0,0,1010,0,1010,G
2-PB1,2071,991,0,0,0,991,A
2-PB1,2072,992,0,0,0,992,A
2-PB1,2073,0,0,994,0,994,G
2-PB1,2074,0,939,1,0,940,T
2-PB1,2075,0,2,940,0,942,G
2-PB1,2076,0,0,0,941,941,C
2-PB1,2077,0,941,0,1,942,T
2-PB1,2078,1,0,939,1,941,G
2-PB1,2079,0,0,0,942,942,C
2-PB1,2080,940,1,0,0,941,A
2-PB1,2081,943,0,0,0,943,A
2-PB1,2082,0,0,0,936,936,C
2-PB1,2083,0,929,0,0,929,T
2-PB1,2084,0,920,0,0,920,T
2-PB1,2085,13,0,907,0,920,G
2-PB1,2086,1,916,0,0,917,T
2-PB1,2087,1,916,0,1,918,T
2-PB1,2088,0,1,0,915,916,C
2-PB1,2089,0,0,915,0,915,G
2-PB1,2090,915,0,0,0,915,A
2-PB1,2091,0,0,914,0,914,G
2-PB1,2092,914,0,0,0,914,A
2-PB1,2093,909,0,1,0,910,A
2-PB1,2094,909,1,1,0,911,A
2-PB1,2095,0,912,0,0,912,T
2-PB1,2096,0,912,0,0,912,T
2-PB1,2097,0,907,0,0,907,T
2-PB1,2098,0,911,0,0,911,T
2-PB1,2099,1,900,0,0,901,T
2-PB1,2100,0,0,0,916,916,C
2-PB1,2101,0,0,0,916,916,C
2-PB1,2102,2,0,0,910,912,C
2-PB1,2103,1,910,0,1,912,T
2-PB1,2104,914,0,0,0,914,A
2-PB1,2105,0,0,916,0,916,G
2-PB1,2106,0,914,0,0,914,T
2-PB1,2107,922,0,0,0,922,A
2-PB1,2108,0,0,926,0,926,G
2-PB1,2109,0,912,0,0,912,T
2-PB1,2110,0,937,0,1,938,T
2-PB1,2111,2,1,0,936,939,C
2-PB1,2112,957,0,0,0,957,A
2-PB1,2113,0,961,0,0,961,T
2-PB1,2114,958,0,1,0,959,A
2-PB1,2115,0,964,0,0,964,T
2-PB1,2116,936,0,0,0,936,A
2-PB1,2117,0,0,930,0,930,G
2-PB1,2118,0,0,925,0,925,G
2-PB1,2119,829,0,0,0,829,A
2-PB1,2120,0,0,830,0,830,G
2-PB1,2121,789,0,3,0,792,A
2-PB1,2122,0,0,0,792,792,C
2-PB1,2123,0,0,0,746,746,C
2-PB1,2124,0,0,746,0,746,G
2-PB1,2125,742,0,1,0,743,A
2-PB1,2126,0,744,0,0,744,T
2-PB1,2127,0,740,0,1,741,T
2-PB1,2128,1,0,742,0,743,G
2-PB1,2129,0,1,741,1,743,G
2-PB1,2130,742,0,0,0,742,A
2-PB1,2131,743,0,0,0,743,A
2-PB1,2132,0,739,1,0,740,T
2-PB1,2133,0,744,0,0,744,T
2-PB1,2134,0,742,0,1,743,T
2-PB1,2135,0,0,0,744,744,C
2-PB1,2136,0,745,0,0,745,T
2-PB1,2137,743,0,1,0,744,A
2-PB1,2138,0,0,745,0,745,G
2-PB1,2139,0,0,0,746,746,C
2-PB1,2140,743,0,0,0,743,A
2-PB1,2141,0,740,0,0,740,T
2-PB1,2142,0,0,723,0,723,G
2-PB1,2143,0,0,739,1,740,G
2-PB1,2144,0,740,0,0,740,T
2-PB1,2145,0,0,741,0,741,G
2-PB1,2146,1,0,737,0,738,G
2-PB1,2147,727,0,0,0,727,A
2-PB1,2148,1,0,725,0,726,G
2-PB1,2149,0,0,724,0,724,G
2-PB1,2150,0,0,0,721,721,C
2-PB1,2151,0,1,0,716,717,C
2-PB1,2152,666,0,2,0,668,A
2-PB1,2153,0,667,0,1,668,T
2-PB1,2154,0,0,667,0,667,G
2-PB1,2155,2,0,669,0,671,G
2-PB1,2156,0,655,0,1,656,T
2-PB1,2157,0,0,660,0,660,G
2-PB1,2158,0,650,0,0,650,T
2-PB1,2159,7,0,0,638,645,C
2-PB1,2160,1,646,0,0,647,T
2-PB1,2161,636,0,0,0,636,A
2-PB1,2162,0,1,634,0,635,G
2-PB1,2163,0,0,626,0,626,G
2-PB1,2164,0,0,617,0,617,G
2-PB1,2165,0,0,0,602,602,C
2-PB1,2166,0,0,0,575,575,C
2-PB1,2167,0,0,0,570,570,C
2-PB1,2168,0,0,563,0,563,G
2-PB1,2169,1,0,568,0,569,G
2-PB1,2170,570,0,0,0,570,A
2-PB1,2171,0,569,0,0,569,T
2-PB1,2172,0,547,0,0,547,T
2-PB1,2173,0,0,543,0,543,G
2-PB1,2174,544,0,0,0,544,A
2-PB1,2175,0,545,0,0,545,T
2-PB1,2176,0,0,543,0,543,G
2-PB1,2177,0,0,0,541,541,C
2-PB1,2178,0,0,0,540,540,C
2-PB1,2179,540,0,1,0,541,A
2-PB1,2180,0,0,546,0,546,G
2-PB1,2181,542,0,0,0,542,A
2-PB1,2182,545,0,0,0,545,A
2-PB1,2183,0,542,0,1,543,T
2-PB1,2184,0,529,0,0,529,T
2-PB1,2185,0,0,527,1,528,G
2-PB1,2186,530,0,0,0,530,A
2-PB1,2187,0,0,0,530,530,C
2-PB1,2188,1,525,0,0,526,T
2-PB1,2189,0,523,0,0,523,T
2-PB1,2190,1,0,0,516,517,C
2-PB1,2191,1,0,518,0,519,G
2-PB1,2192,520,0,0,0,520,A
2-PB1,2193,0,0,508,0,508,G
2-PB1,2194,0,513,0,0,513,T
2-PB1,2195,0,0,0,510,510,C
2-PB1,2196,0,511,0,1,512,T
2-PB1,2197,0,0,511,0,511,G
2-PB1,2198,0,0,510,0,510,G
2-PB1,2199,511,0,0,1,512,A
2-PB1,2200,474,0,0,0,474,A
2-PB1,2201,0,0,474,0,474,G
2-PB1,2202,0,0,476,0,476,G
2-PB1,2203,475,0,0,0,475,A
2-PB1,2204,0,474,0,0,474,T
2-PB1,2205,0,474,0,1,475,T
2-PB1,2206,469,0,4,0,473,A
2-PB1,2207,473,0,0,0,473,A
2-PB1,2208,0,0,472,0,472,G
2-PB1,2209,472,0,0,0,472,A
2-PB1,2210,442,0,0,0,442,A
2-PB1,2211,0,0,414,0,414,G
2-PB1,2212,0,0,411,0,411,G
2-PB1,2213,410,1,0,0,411,A
2-PB1,2214,409,0,1,0,410,A
2-PB1,2215,0,0,410,0,410,G
2-PB1,2216,361,0,1,0,362,A
2-PB1,2217,0,0,362,0,362,G
2-PB1,2218,0,331,0,0,331,T
2-PB1,2219,0,329,0,0,329,T
2-PB1,2220,0,0,0,330,330,C
2-PB1,2221,0,328,0,0,328,T
2-PB1,2222,0,0,0,328,328,C
2-PB1,2223,0,324,0,0,324,T
2-PB1,2224,0,0,323,0,323,G
2-PB1,2225,323,0,0,0,323,A
2-PB1,2226,0,0,319,0,319,G
2-PB1,2227,308,0,1,0,309,A
2-PB1,2228,0,300,0,0,300,T
2-PB1,2229,0,0,0,287,287,C
2-PB1,2230,287,0,0,0,287,A
2-PB1,2231,0,287,0,1,288,T
2-PB1,2232,0,0,288,0,288,G
2-PB1,2233,288,0,0,0,288,A
2-PB1,2234,286,0,0,0,286,A
2-PB1,2235,0,0,279,0,279,G
2-PB1,2236,271,0,0,0,271,A
2-PB1,2237,0,268,0,0,268,T
2-PB1,2238,1,0,0,262,263,C
2-PB1,2239,0,242,0,0,242,T
2-PB1,2240,0,1,243,0,244,G
2-PB1,2241,0,242,0,0,242,T
2-PB1,2242,0,240,0,1,241,T
2-PB1,2243,0,0,0,242,242,C
2-PB1,2244,0,0,0,231,231,C
2-PB1,2245,233,0,0,0,233,A
2-PB1,2246,0,0,0,232,232,C
2-PB1,2247,0,0,0,221,221,C
2-PB1,2248,215,0,0,0,215,A
2-PB1,2249,0,201,0,0,201,T
2-PB1,2250,0,196,0,1,197,T
2-PB1,2251,0,0,196,0,196,G
2-PB1,2252,198,0,0,0,198,A
2-PB1,2253,198,0,0,0,198,A
2-PB1,2254,0,0,196,0,196,G
2-PB1,2255,167,0,0,0,167,A
2-PB1,2256,167,0,0,0,167,A
2-PB1,2257,0,0,0,165,165,C
2-PB1,2258,0,161,0,0,161,T
2-PB1,2259,1,0,0,159,160,C
2-PB1,2260,156,0,0,0,156,A
2-PB1,2261,0,0,156,0,156,G
2-PB1,2262,156,0,0,0,156,A
2-PB1,2263,1,0,0,147,148,C
2-PB1,2264,0,0,142,0,142,G
2-PB1,2265,0,0,140,0,140,G
2-PB1,2266,0,0,0,139,139,C
2-PB1,2267,139,0,0,0,139,A
2-PB1,2268,138,0,0,0,138,A
2-PB1,2269,136,0,0,0,136,A
2-PB1,2270,136,0,0,0,136,A
2-PB1,2271,136,0,0,0,136,A
2-PB1,2272,0,134,0,0,134,T
2-PB1,2273,131,0,0,0,131,A
2-PB1,2274,131,0,0,0,131,A
3-PA,1,18,0,0,0,18,A
3-PA,2,0,18,0,0,18,T
3-PA,3,0,0,21,0,21,G
3-PA,4,0,0,21,0,21,G
3-PA,5,21,0,0,0,21,A
3-PA,6,21,0,0,0,21,A
3-PA,7,0,0,23,0,23,G
3-PA,8,24,0,0,0,24,A
3-PA,9,0,24,0,0,24,T
3-PA,10,0,24,0,0,24,T
3-PA,11,0,25,0,0,25,T
3-PA,12,0,25,0,0,25,T
3-PA,13,0,0,25,0,25,G
3-PA,14,0,25,0,0,25,T
3-PA,15,0,0,25,0,25,G
3-PA,16,0,0,0,28,28,C
3-PA,17,0,0,28,0,28,G
3-PA,18,31,0,0,0,31,A
3-PA,19,0,0,0,30,30,C
3-PA,20,31,0,0,0,31,A
3-PA,21,31,0,0,0,31,A
3-PA,22,0,32,0,0,32,T
3-PA,23,0,0,40,0,40,G
3-PA,24,0,0,0,41,41,C
3-PA,25,0,42,0,0,42,T
3-PA,26,0,42,0,0,42,T
3-PA,27,0,0,0,42,42,C
3-PA,28,45,0,0,0,45,A
3-PA,29,49,0,0,0,49,A
3-PA,30,0,0,0,52,52,C
3-PA,31,0,0,0,51,51,C
3-PA,32,1,0,0,51,52,C
3-PA,33,0,0,53,0,53,G
3-PA,34,54,0,0,0,54,A
3-PA,35,0,54,0,0,54,T
3-PA,36,0,0,54,0,54,G
3-PA,37,53,0,0,1,54,A
3-PA,38,0,55,0,0,55,T
3-PA,39,0,56,0,0,56,T
3-PA,40,0,0,58,0,58,G
3-PA,41,0,57,0,0,57,T
3-PA,42,0,0,0,58,58,C
3-PA,43,0,0,58,0,58,G
3-PA,44,58,0,0,0,58,A
3-PA,45,59,0,0,0,59,A
3-PA,46,0,0,0,59,59,C
3-PA,47,0,59,0,0,59,T
3-PA,48,0,59,0,0,59,T
3-PA,49,0,0,59,0,59,G
3-PA,50,0,0,0,57,57,C
3-PA,51,59,0,0,0,59,A
3-PA,52,0,0,58,0,58,G
3-PA,53,58,0,0,0,58,A
3-PA,54,58,0,0,0,58,A
3-PA,55,59,0,0,0,59,A
3-PA,56,59,0,0,0,59,A
3-PA,57,58,0,0,0,58,A
3-PA,58,0,0,63,0,63,G
3-PA,59,0,0,0,64,64,C
3-PA,60,65,0,0,0,65,A
3-PA,61,69,1,0,0,70,A
3-PA,62,0,68,0,0,68,T
3-PA,63,0,1,71,0,72,G
3-PA,64,75,0,0,0,75,A
3-PA,65,75,0,0,0,75,A
3-PA,66,74,0,0,0,74,A
3-PA,67,0,0,79,0,79,G
3-PA,68,78,1,2,0,81,A
3-PA,69,0,0,92,0,92,G
3-PA,70,0,92,0,0,92,T
3-PA,71,93,0,0,0,93,A
3-PA,72,0,93,0,0,93,T
3-PA,73,0,0,93,0,93,G
3-PA,74,0,0,94,0,94,G
3-PA,75,0,1,93,0,94,G
3-PA,76,0,0,92,0,92,G
3-PA,77,90,0,0,0,90,A
3-PA,78,0,0,91,0,91,G
3-PA,79,0,0,93,0,93,G
3-PA,80,93,0,0,0,93,A
3-PA,81,0,95,0,0,95,T
3-PA,82,0,0,0,95,95,C
3-PA,83,0,94,0,0,94,T
3-PA,84,0,0,94,0,94,G
3-PA,85,94,0,0,0,94,A
3-PA,86,94,0,0,0,94,A
3-PA,87,94,0,0,0,94,A
3-PA,88,93,0,1,0,94,A
3-PA,89,0,94,0,0,94,T
3-PA,90,0,94,0,0,94,T
3-PA,91,0,0,94,0,94,G
3-PA,92,93,0,1,0,94,A
3-PA,93,94,0,0,0,94,A
3-PA,94,93,1,0,0,94,A
3-PA,95,0,0,0,94,94,C
3-PA,96,94,0,0,0,94,A
3-PA,97,96,0,0,0,96,A
3-PA,98,96,0,0,0,96,A
3-PA,99,0,0,0,97,97,C
3-PA,100,97,0,0,0,97,A
3-PA,101,101,1,0,0,102,A
3-PA,102,104,0,0,0,104,A
3-PA,103,0,103,0,0,103,T
3-PA,104,0,104,0,0,104,T
3-PA,105,0,104,0,0,104,T
3-PA,106,0,0,104,0,104,G
3-PA,107,0,0,0,104,104,C
3-PA,108,104,0,0,0,104,A
3-PA,109,0,0,108,0,108,G
3-PA,110,0,0,0,108,108,C
3-PA,111,118,0,0,0,118,A
3-PA,112,120,0,0,0,120,A
3-PA,113,0,121,0,0,121,T
3-PA,114,124,0,0,0,124,A
3-PA,115,0,125,0,0,125,T
3-PA,116,0,0,127,0,127,G
3-PA,117,0,0,0,127,127,C
3-PA,118,127,0,0,0,127,A
3-PA,119,0,0,0,128,128,C
3-PA,120,0,125,0,0,125,T
3-PA,121,1,0,0,158,159,C
3-PA,122,164,0,0,0,164,A
3-PA,123,0,0,0,166,166,C
3-PA,124,0,165,0,0,165,T
3-PA,125,0,166,0,0,166,T
3-PA,126,0,0,166,0,166,G
3-PA,127,0,0,169,0,169,G
3-PA,128,168,0,0,0,168,A
3-PA,129,0,0,171,0,171,G
3-PA,130,0,0,168,0,168,G
3-PA,131,0,166,0,0,166,T
3-PA,132,0,0,174,0,174,G
3-PA,133,1,171,0,1,173,T
3-PA,134,0,0,176,0,176,G
3-PA,135,0,177,0,0,177,T
3-PA,136,0,174,0,1,175,T
3-PA,137,0,176,0,0,176,T
3-PA,138,0,0,1,175,176,C
3-PA,139,178,0,0,0,178,A
3-PA,140,0,179,0,0,179,T
3-PA,141,0,0,181,0,181,G
3-PA,142,0,174,0,0,174,T
3-PA,143,177,0,0,0,177,A
3-PA,144,0,177,0,0,177,T
3-PA,145,0,175,0,0,175,T
3-PA,146,0,0,0,176,176,C
3-PA,147,176,0,0,0,176,A
3-PA,148,0,0,176,0,176,G
3-PA,149,176,0,0,0,176,A
3-PA,150,0,176,0,0,176,T
3-PA,151,0,176,0,0,176,T
3-PA,152,0,175,0,0,175,T
3-PA,153,1,1,0,173,175,C
3-PA,154,0,0,0,184,184,C
3-PA,155,184,0,0,0,184,A
3-PA,156,0,184,0,0,184,T
3-PA,157,0,183,0,0,183,T
3-PA,158,0,184,0,0,184,T
3-PA,159,0,0,0,184,184,C
3-PA,160,184,0,0,0,184,A
3-PA,161,0,193,0,0,193,T
3-PA,162,0,0,0,193,193,C
3-PA,163,194,0,0,0,194,A
3-PA,164,194,0,0,0,194,A
3-PA,165,0,194,0,0,194,T
3-PA,166,0,0,201,0,201,G
3-PA,167,202,0,0,0,202,A
3-PA,168,202,0,0,0,202,A
3-PA,169,0,0,0,202,202,C
3-PA,170,197,1,0,0,198,A
3-PA,171,199,0,1,0,200,A
3-PA,172,0,0,200,0,200,G
3-PA,173,0,0,200,0,200,G
3-PA,174,0,0,0,201,201,C
3-PA,175,1,0,200,0,201,G
3-PA,176,217,0,0,0,217,A
3-PA,177,217,0,0,0,217,A
3-PA,178,0,217,0,0,217,T
3-PA,179,0,0,0,219,219,C
3-PA,180,218,0,1,0,219,A
3-PA,181,220,0,0,0,220,A
3-PA,182,0,221,0,0,221,T
3-PA,183,221,0,0,0,221,A
3-PA,184,0,0,229,0,229,G
3-PA,185,0,229,0,0,229,T
3-PA,186,0,0,233,0,233,G
3-PA,187,0,0,235,0,235,G
3-PA,188,0,233,0,1,234,T
3-PA,189,235,0,0,0,235,A
3-PA,190,0,0,234,0,234,G
3-PA,191,236,0,0,0,236,A
3-PA,192,238,0,0,0,238,A
3-PA,193,0,0,0,237,237,C
3-PA,194,0,234,0,0,234,T
3-PA,195,0,234,0,0,234,T
3-PA,196,0,0,234,0,234,G
3-PA,197,234,0,0,0,234,A
3-PA,198,0,0,0,234,234,C
3-PA,199,0,0,232,0,232,G
3-PA,200,242,0,0,0,242,A
3-PA,201,0,244,0,0,244,T
3-PA,202,0,0,0,245,245,C
3-PA,203,0,0,0,248,248,C
3-PA,204,247,0,0,0,247,A
3-PA,205,248,0,0,0,248,A
3-PA,206,248,0,0,0,248,A
3-PA,207,0,247,0,0,247,T
3-PA,208,0,0,248,0,248,G
3-PA,209,0,0,0,246,246,C
3-PA,210,243,0,0,0,243,A
3-PA,211,0,0,0,251,251,C
3-PA,212,0,250,0,0,250,T
3-PA,213,0,0,288,0,288,G
3-PA,214,0,288,0,0,288,T
3-PA,215,0,288,0,0,288,T
3-PA,216,288,0,0,0,288,A
3-PA,217,286,0,0,0,286,A
3-PA,218,288,0,0,0,288,A
3-PA,219,0,0,287,0,287,G
3-PA,220,0,0,0,287,287,C
3-PA,221,286,0,0,0,286,A
3-PA,222,0,0,0,284,284,C
3-PA,223,272,0,1,1,274,A
3-PA,224,0,0,286,0,286,G
3-PA,225,284,1,0,0,285,A
3-PA,226,0,285,0,0,285,T
3-PA,227,0,286,0,0,286,T
3-PA,228,0,285,0,0,285,T
3-PA,229,1,0,285,0,286,G
3-PA,230,287,0,0,0,287,A
3-PA,231,287,0,0,0,287,A
3-PA,232,288,0,0,0,288,A
3-PA,233,0,285,0,0,285,T
3-PA,234,282,0,0,0,282,A
3-PA,235,284,0,0,0,284,A
3-PA,236,0,285,0,0,285,T
3-PA,237,0,0,0,284,284,C
3-PA,238,0,0,284,0,284,G
3-PA,239,282,0,0,0,282,A
3-PA,240,0,0,283,0,283,G
3-PA,241,0,0,284,0,284,G
3-PA,242,0,0,283,0,283,G
3-PA,243,0,0,281,0,281,G
3-PA,244,284,0,0,0,284,A
3-PA,245,0,0,283,0,283,G
3-PA,246,292,0,0,0,292,A
3-PA,247,0,1,290,0,291,G
3-PA,248,291,0,0,0,291,A
3-PA,249,0,0,0,289,289,C
3-PA,250,287,0,0,0,287,A
3-PA,251,0,1,287,0,288,G
3-PA,252,287,0,0,0,287,A
3-PA,253,291,0,0,0,291,A
3-PA,254,0,0,0,291,291,C
3-PA,255,284,0,0,0,284,A
3-PA,256,285,0,0,0,285,A
3-PA,257,0,284,0,0,284,T
3-PA,258,0,0,301,0,301,G
3-PA,259,0,0,300,0,300,G
3-PA,260,0,0,0,298,298,C
3-PA,261,0,0,0,298,298,C
3-PA,262,0,296,1,0,297,T
3-PA,263,0,1,304,0,305,G
3-PA,264,0,0,304,0,304,G
3-PA,265,305,0,0,0,305,A
3-PA,266,0,0,0,306,306,C
3-PA,267,293,0,0,0,293,A
3-PA,268,0,0,327,0,327,G
3-PA,269,0,327,0,0,327,T
3-PA,270,332,0,0,0,332,A
3-PA,271,0,0,332,0,332,G
3-PA,272,0,326,0,1,327,T
3-PA,273,328,0,0,0,328,A
3-PA,274,326,1,0,0,327,A
3-PA,275,326,0,1,0,327,A
3-PA,276,0,0,0,331,331,C
3-PA,277,311,0,0,0,311,A
3-PA,278,0,0,321,0,321,G
3-PA,279,0,315,0,0,315,T
3-PA,280,324,0,0,0,324,A
3-PA,281,0,323,0,0,323,T
3-PA,282,0,0,0,331,331,C
3-PA,283,0,331,0,0,331,T
3-PA,284,0,0,331,0,331,G
3-PA,285,0,0,0,332,332,C
3-PA,286,332,0,0,0,332,A
3-PA,287,331,0,0,0,331,A
3-PA,288,0,0,0,331,331,C
3-PA,289,329,0,0,0,329,A
3-PA,290,1,0,0,345,346,C
3-PA,291,0,342,0,0,342,T
3-PA,292,344,0,0,0,344,A
3-PA,293,0,0,0,344,344,C
3-PA,294,0,340,0,1,341,T
3-PA,295,0,0,342,0,342,G
3-PA,296,1,0,344,0,345,G
3-PA,297,341,0,0,0,341,A
3-PA,298,0,0,342,0,342,G
3-PA,299,0,0,0,339,339,C
3-PA,300,0,336,0,1,337,T
3-PA,301,0,0,338,0,338,G
3-PA,302,0,1,336,0,337,G
3-PA,303,0,0,338,0,338,G
3-PA,304,339,0,0,0,339,A
3-PA,305,339,0,0,0,339,A
3-PA,306,339,0,1,0,340,A
3-PA,307,0,0,0,338,338,C
3-PA,308,0,0,0,341,341,C
3-PA,309,0,0,338,0,338,G
3-PA,310,339,0,0,0,339,A
3-PA,311,340,0,0,0,340,A
3-PA,312,0,0,345,0,345,G
3-PA,313,0,342,0,0,342,T
3-PA,314,0,343,0,0,343,T
3-PA,315,0,344,0,0,344,T
3-PA,316,0,0,0,345,345,C
3-PA,317,0,347,0,0,347,T
3-PA,318,347,0,0,0,347,A
3-PA,319,0,0,0,343,343,C
3-PA,320,0,0,0,345,345,C
3-PA,321,343,0,0,0,343,A
3-PA,322,0,0,346,0,346,G
3-PA,323,346,0,0,0,346,A
3-PA,324,0,346,0,0,346,T
3-PA,325,0,348,0,1,349,T
3-PA,326,0,348,0,0,348,T
3-PA,327,0,0,352,0,352,G
3-PA,328,0,352,0,0,352,T
3-PA,329,352,0,0,0,352,A
3-PA,330,0,351,0,0,351,T
3-PA,331,0,1,350,0,351,G
3-PA,332,373,0,0,0,373,A
3-PA,333,1,370,1,0,372,T
3-PA,334,0,369,0,2,371,T
3-PA,335,370,0,0,0,370,A
3-PA,336,0,0,0,371,371,C
3-PA,337,370,0,0,0,370,A
3-PA,338,370,0,0,0,370,A
3-PA,339,0,0,371,0,371,G
3-PA,340,0,1,376,0,377,G
3-PA,341,363,0,0,0,363,A
3-PA,342,0,0,363,0,363,G
3-PA,343,366,0,0,0,366,A
3-PA,344,365,0,0,0,365,A
3-PA,345,0,0,0,365,365,C
3-PA,346,364,0,0,0,364,A
3-PA,347,0,0,364,0,364,G
3-PA,348,359,0,0,0,359,A
3-PA,349,0,358,0,0,358,T
3-PA,350,0,358,0,0,358,T
3-PA,351,0,0,0,354,354,C
3-PA,352,354,0,0,0,354,A
3-PA,353,0,355,0,0,355,T
3-PA,354,1,0,0,352,353,C
3-PA,355,0,0,353,0,353,G
3-PA,356,349,0,0,0,349,A
3-PA,357,353,0,0,0,353,A
3-PA,358,353,0,0,0,353,A
3-PA,359,0,350,0,0,350,T
3-PA,360,0,347,0,0,347,T
3-PA,361,0,0,351,0,351,G
3-PA,362,0,0,349,0,349,G
3-PA,363,1,0,350,0,351,G
3-PA,364,0,0,353,0,353,G
3-PA,365,0,349,0,0,349,T
3-PA,366,0,0,353,0,353,G
3-PA,367,353,0,1,0,354,A
3-PA,368,0,0,0,355,355,C
3-PA,369,358,0,0,0,358,A
3-PA,370,356,0,0,0,356,A
3-PA,371,0,0,358,0,358,G
3-PA,372,0,0,358,0,358,G
3-PA,373,352,0,0,0,352,A
3-PA,374,0,1,355,0,356,G
3-PA,375,352,0,1,0,353,A
3-PA,376,0,0,352,0,352,G
3-PA,377,348,0,0,0,348,A
3-PA,378,350,0,0,0,350,A
3-PA,379,0,0,361,0,361,G
3-PA,380,0,355,0,0,355,T
3-PA,381,0,0,0,359,359,C
3-PA,382,0,0,0,362,362,C
3-PA,383,361,0,0,0,361,A
3-PA,384,0,0,0,368,368,C
3-PA,385,376,1,0,0,377,A
3-PA,386,0,384,0,0,384,T
3-PA,387,394,0,0,0,394,A
3-PA,388,0,391,0,0,391,T
3-PA,389,386,0,0,0,386,A
3-PA,390,0,382,0,1,383,T
3-PA,391,0,379,0,0,379,T
3-PA,392,390,0,0,0,390,A
3-PA,393,0,1,0,385,386,C
3-PA,394,0,0,0,378,378,C
3-PA,395,0,371,0,0,371,T
3-PA,396,0,362,0,0,362,T
3-PA,397,0,0,361,0,361,G
3-PA,398,362,0,0,0,362,A
3-PA,399,1,0,344,0,345,G
3-PA,400,345,0,1,0,346,A
3-PA,401,346,0,0,0,346,A
3-PA,402,0,0,345,0,345,G
3-PA,403,0,0,346,0,346,G
3-PA,404,0,0,0,349,349,C
3-PA,405,0,0,0,348,348,C
3-PA,406,352,0,0,0,352,A
3-PA,407,353,0,0,0,353,A
3-PA,408,0,352,0,0,352,T
3-PA,409,352,0,0,0,352,A
3-PA,410,354,0,0,0,354,A
3-PA,411,0,0,351,0,351,G
3-PA,412,352,1,0,0,353,A
3-PA,413,0,353,0,0,353,T
3-PA,414,0,350,0,0,350,T
3-PA,415,350,0,0,0,350,A
3-PA,416,350,0,0,0,350,A
3-PA,417,351,0,0,0,351,A
3-PA,418,0,353,0,0,353,T
3-PA,419,1,0,0,351,352,C
3-PA,420,0,344,0,0,344,T
3-PA,421,0,1,343,0,344,G
3-PA,422,344,0,0,0,344,A
3-PA,423,0,1,345,0,346,G
3-PA,424,348,0,0,0,348,A
3-PA,425,346,1,0,0,347,A
3-PA,426,0,0,0,350,350,C
3-PA,427,345,0,1,0,346,A
3-PA,428,0,1,0,342,343,C
3-PA,429,346,0,0,0,346,A
3-PA,430,0,0,0,346,346,C
3-PA,431,342,0,1,0,343,A
3-PA,432,0,0,0,355,355,C
3-PA,433,355,0,0,0,355,A
3-PA,434,0,351,0,0,351,T
3-PA,435,0,349,0,0,349,T
3-PA,436,0,0,0,352,352,C
3-PA,437,349,1,0,0,350,A
3-PA,438,0,0,0,350,350,C
3-PA,439,349,0,0,0,349,A
3-PA,440,0,351,0,1,352,T
3-PA,441,0,344,0,1,345,T
3-PA,442,0,349,0,0,349,T
3-PA,443,0,345,0,0,345,T
3-PA,444,1,0,0,350,351,C
3-PA,445,0,348,1,1,350,T
3-PA,446,0,0,0,352,352,C
3-PA,447,350,0,0,0,350,A
3-PA,448,1,349,0,0,350,T
3-PA,449,0,355,0,0,355,T
3-PA,450,0,0,0,357,357,C
3-PA,451,356,1,0,0,357,A
3-PA,452,0,0,0,364,364,C
3-PA,453,0,364,0,0,364,T
3-PA,454,0,0,364,0,364,G
3-PA,455,0,0,364,0,364,G
3-PA,456,357,0,0,0,357,A
3-PA,457,0,0,371,0,371,G
3-PA,458,371,0,0,0,371,A
3-PA,459,0,0,374,0,374,G
3-PA,460,0,0,372,0,372,G
3-PA,461,367,0,2,0,369,A
3-PA,462,366,0,2,0,368,A
3-PA,463,365,0,0,0,365,A
3-PA,464,1,361,0,1,363,T
3-PA,465,0,1,363,0,364,G
3-PA,466,0,0,365,0,365,G
3-PA,467,1,0,0,363,364,C
3-PA,468,0,0,0,363,363,C
3-PA,469,363,0,0,0,363,A
3-PA,470,0,0,0,360,360,C
3-PA,471,364,0,0,0,364,A
3-PA,472,365,0,0,0,365,A
3-PA,473,365,0,0,0,365,A
3-PA,474,0,0,367,0,367,G
3-PA,475,0,0,368,0,368,G
3-PA,476,0,0,0,368,368,C
3-PA,477,368,0,0,0,368,A
3-PA,478,0,0,372,0,372,G
3-PA,479,370,0,0,0,370,A
3-PA,480,0,4,0,367,371,C
3-PA,481,0,370,0,0,370,T
3-PA,482,372,0,0,0,372,A
3-PA,483,0,0,0,369,369,C
3-PA,484,364,0,2,0,366,A
3-PA,485,0,0,0,366,366,C
3-PA,486,0,357,0,0,357,T
3-PA,487,0,0,0,358,358,C
3-PA,488,0,354,0,0,354,T
3-PA,489,1,0,0,347,348,C
3-PA,490,0,0,347,0,347,G
3-PA,491,348,0,0,0,348,A
3-PA,492,0,0,0,346,346,C
3-PA,493,0,0,345,0,345,G
3-PA,494,345,0,0,0,345,A
3-PA,495,0,0,347,0,347,G
3-PA,496,0,0,349,0,349,G
3-PA,497,348,0,0,0,348,A
3-PA,498,348,0,0,0,348,A
3-PA,499,347,1,0,0,348,A
3-PA,500,0,0,350,0,350,G
3-PA,501,0,0,0,346,346,C
3-PA,502,340,1,0,0,341,A
3-PA,503,0,0,347,0,347,G
3-PA,504,0,0,346,0,346,G
3-PA,505,0,0,347,0,347,G
3-PA,506,0,0,0,348,348,C
3-PA,507,0,345,0,0,345,T
3-PA,508,342,0,2,0,344,A
3-PA,509,0,0,347,0,347,G
3-PA,510,0,0,365,0,365,G
3-PA,511,367,0,0,0,367,A
3-PA,512,0,356,0,0,356,T
3-PA,513,0,346,0,0,346,T
3-PA,514,343,0,0,0,343,A
3-PA,515,343,0,0,0,343,A
3-PA,516,0,0,343,0,343,G
3-PA,517,341,0,1,0,342,A
3-PA,518,2,1,0,337,340,C
3-PA,519,0,0,0,311,311,C
3-PA,520,309,0,0,0,309,A
3-PA,521,0,0,308,0,308,G
3-PA,522,0,0,310,0,310,G
3-PA,523,0,0,0,310,310,C
3-PA,524,0,308,0,0,308,T
3-PA,525,0,0,323,0,323,G
3-PA,526,0,321,1,0,322,T
3-PA,527,0,322,0,0,322,T
3-PA,528,0,322,0,0,322,T
3-PA,529,322,0,0,0,322,A
3-PA,530,0,0,0,324,324,C
3-PA,531,0,0,0,318,318,C
3-PA,532,310,0,1,0,311,A
3-PA,533,0,314,0,0,314,T
3-PA,534,300,0,0,0,300,A
3-PA,535,298,0,0,0,298,A
3-PA,536,0,0,303,0,303,G
3-PA,537,303,0,0,0,303,A
3-PA,538,0,0,0,305,305,C
3-PA,539,301,0,0,0,301,A
3-PA,540,301,0,0,0,301,A
3-PA,541,0,0,303,0,303,G
3-PA,542,300,1,0,0,301,A
3-PA,543,298,0,0,0,298,A
3-PA,544,298,2,0,0,300,A
3-PA,545,0,292,0,0,292,T
3-PA,546,0,0,300,0,300,G
3-PA,547,0,0,298,0,298,G
3-PA,548,0,0,0,300,300,C
3-PA,549,0,0,0,300,300,C
3-PA,550,298,0,1,0,299,A
3-PA,551,304,0,0,0,304,A
3-PA,552,0,0,0,304,304,C
3-PA,553,299,0,0,0,299,A
3-PA,554,0,0,298,0,298,G
3-PA,555,294,0,0,0,294,A
3-PA,556,0,0,295,0,295,G
3-PA,557,0,0,298,0,298,G
3-PA,558,0,0,0,294,294,C
3-PA,559,1,0,0,295,296,C
3-PA,560,0,281,0,0,281,T
3-PA,561,281,0,0,0,281,A
3-PA,562,0,285,0,0,285,T
3-PA,563,0,3,282,0,285,G
3-PA,564,0,0,286,0,286,G
3-PA,565,0,0,274,0,274,G
3-PA,566,264,0,0,0,264,A
3-PA,567,0,258,0,1,259,T
3-PA,568,0,255,0,0,255,T
3-PA,569,0,0,0,292,292,C
3-PA,570,0,0,0,286,286,C
3-PA,571,0,289,0,0,289,T
3-PA,572,0,289,0,0,289,T
3-PA,573,0,288,0,0,288,T
3-PA,574,0,0,0,290,290,C
3-PA,575,0,0,290,0,290,G
3-PA,576,0,286,0,1,287,T
3-PA,577,1,0,0,287,288,C
3-PA,578,277,0,0,0,277,A
3-PA,579,0,0,325,0,325,G
3-PA,580,0,325,0,0,325,T
3-PA,581,0,0,0,325,325,C
3-PA,582,0,0,0,324,324,C
3-PA,583,0,0,325,0,325,G
3-PA,584,324,0,0,0,324,A
3-PA,585,324,0,0,0,324,A
3-PA,586,324,0,1,0,325,A
3-PA,587,0,0,330,0,330,G
3-PA,588,328,0,0,0,328,A
3-PA,589,0,0,330,0,330,G
3-PA,590,0,0,331,0,331,G
3-PA,591,0,0,0,331,331,C
3-PA,592,0,0,331,0,331,G
3-PA,593,331,0,0,0,331,A
3-PA,594,330,0,1,0,331,A
3-PA,595,0,0,333,0,333,G
3-PA,596,332,0,0,0,332,A
3-PA,597,331,0,0,0,331,A
3-PA,598,333,0,0,0,333,A
3-PA,599,0,0,0,336,336,C
3-PA,600,334,0,0,0,334,A
3-PA,601,335,0,0,0,335,A
3-PA,602,0,335,0,0,335,T
3-PA,603,0,333,0,1,334,T
3-PA,604,0,0,333,0,333,G
3-PA,605,333,1,0,0,334,A
3-PA,606,334,0,1,0,335,A
3-PA,607,0,0,336,0,336,G
3-PA,608,332,0,0,0,332,A
3-PA,609,335,0,0,0,335,A
3-PA,610,332,0,0,0,332,A
3-PA,611,336,0,0,0,336,A
3-PA,612,336,0,0,0,336,A
3-PA,613,0,336,0,0,336,T
3-PA,614,0,334,0,0,334,T
3-PA,615,0,337,0,0,337,T
3-PA,616,0,0,336,0,336,G
3-PA,617,334,0,0,0,334,A
3-PA,618,333,0,0,0,333,A
3-PA,619,334,0,0,0,334,A
3-PA,620,0,338,0,0,338,T
3-PA,621,0,0,0,380,380,C
3-PA,622,382,0,0,0,382,A
3-PA,623,0,0,0,386,386,C
3-PA,624,384,0,1,0,385,A
3-PA,625,0,0,397,0,397,G
3-PA,626,0,0,411,0,411,G
3-PA,627,413,0,3,0,416,A
3-PA,628,423,0,1,0,424,A
3-PA,629,0,1,0,430,431,C
3-PA,630,0,413,0,0,413,T
3-PA,631,447,0,0,0,447,A
3-PA,632,0,455,0,0,455,T
3-PA,633,0,0,481,0,481,G
3-PA,634,0,0,0,479,479,C
3-PA,635,0,0,470,0,470,G
3-PA,636,0,470,0,1,471,T
3-PA,637,465,0,0,0,465,A
3-PA,638,0,0,469,0,469,G
3-PA,639,0,0,464,0,464,G
3-PA,640,0,0,0,467,467,C
3-PA,641,0,462,0,0,462,T
3-PA,642,0,460,0,0,460,T
3-PA,643,0,0,459,0,459,G
3-PA,644,0,0,1,459,460,C
3-PA,645,0,1,0,459,460,C
3-PA,646,0,0,467,0,467,G
3-PA,647,467,0,0,0,467,A
3-PA,648,0,0,0,470,470,C
3-PA,649,1,0,0,472,473,C
3-PA,650,474,0,0,0,474,A
3-PA,651,475,0,0,0,475,A
3-PA,652,474,1,0,0,475,A
3-PA,653,0,0,485,0,485,G
3-PA,654,1,484,0,1,486,T
3-PA,655,0,0,0,486,486,C
3-PA,656,0,488,0,0,488,T
3-PA,657,0,0,0,484,484,C
3-PA,658,1,0,0,485,486,C
3-PA,659,1,1,0,486,488,C
3-PA,660,489,0,0,0,489,A
3-PA,661,0,0,0,489,489,C
3-PA,662,0,1,0,485,486,C
3-PA,663,0,1,488,0,489,G
3-PA,664,495,0,0,0,495,A
3-PA,665,494,0,0,0,494,A
3-PA,666,0,0,0,497,497,C
3-PA,667,0,495,0,0,495,T
3-PA,668,0,505,0,1,506,T
3-PA,669,0,0,0,514,514,C
3-PA,670,0,516,0,0,516,T
3-PA,671,0,0,0,515,515,C
3-PA,672,0,0,0,512,512,C
3-PA,673,1,513,0,0,514,T
3-PA,674,0,0,523,0,523,G
3-PA,675,1,0,0,521,522,C
3-PA,676,0,1,0,520,521,C
3-PA,677,0,514,0,0,514,T
3-PA,678,0,513,0,0,513,T
3-PA,679,0,0,516,0,516,G
3-PA,680,517,0,1,0,518,A
3-PA,681,0,0,522,0,522,G
3-PA,682,521,0,1,0,522,A
3-PA,683,523,0,0,0,523,A
3-PA,684,0,529,0,0,529,T
3-PA,685,0,533,0,0,533,T
3-PA,686,0,528,0,0,528,T
3-PA,687,0,532,0,0,532,T
3-PA,688,529,0,0,0,529,A
3-PA,689,3,0,528,0,531,G
3-PA,690,523,0,0,0,523,A
3-PA,691,0,0,546,0,546,G
3-PA,692,0,0,0,548,548,C
3-PA,693,0,0,0,544,544,C
3-PA,694,0,554,0,1,555,T
3-PA,695,576,0,1,0,577,A
3-PA,696,0,575,0,1,576,T
3-PA,697,0,0,579,0,579,G
3-PA,698,0,580,0,1,581,T
3-PA,699,0,1,581,0,582,G
3-PA,700,0,0,577,0,577,G
3-PA,701,576,0,0,0,576,A
3-PA,702,0,571,0,0,571,T
3-PA,703,0,0,561,0,561,G
3-PA,704,0,0,577,1,578,G
3-PA,705,577,0,0,0,577,A
3-PA,706,0,577,0,0,577,T
3-PA,707,0,576,0,0,576,T
3-PA,708,0,1,0,576,577,C
3-PA,709,0,1,578,0,579,G
3-PA,710,580,0,0,0,580,A
3-PA,711,581,0,0,0,581,A
3-PA,712,0,0,0,581,581,C
3-PA,713,0,0,0,570,570,C
3-PA,714,0,0,574,0,574,G
3-PA,715,571,0,1,0,572,A
3-PA,716,573,0,1,0,574,A
3-PA,717,0,0,0,582,582,C
3-PA,718,0,0,578,0,578,G
3-PA,719,0,0,592,0,592,G
3-PA,720,0,0,0,597,597,C
3-PA,721,0,591,0,0,591,T
3-PA,722,1,0,605,0,606,G
3-PA,723,0,0,0,609,609,C
3-PA,724,613,0,0,0,613,A
3-PA,725,0,612,0,0,612,T
3-PA,726,0,605,0,0,605,T
3-PA,727,0,0,601,0,601,G
3-PA,728,588,0,2,0,590,A
3-PA,729,0,0,593,0,593,G
3-PA,730,0,0,592,0,592,G
3-PA,731,0,0,589,0,589,G
3-PA,732,0,0,0,587,587,C
3-PA,733,585,0,0,0,585,A
3-PA,734,584,0,0,0,584,A
3-PA,735,0,0,588,0,588,G
3-PA,736,0,0,0,588,588,C
3-PA,737,0,589,0,1,590,T
3-PA,738,0,593,0,0,593,T
3-PA,739,0,598,0,0,598,T
3-PA,740,0,0,0,599,599,C
3-PA,741,0,598,0,1,599,T
3-PA,742,0,0,0,604,604,C
3-PA,743,606,0,0,0,606,A
3-PA,744,605,0,0,0,605,A
3-PA,745,604,1,0,0,605,A
3-PA,746,0,602,0,1,603,T
3-PA,747,0,0,632,0,632,G
3-PA,748,0,628,0,1,629,T
3-PA,749,0,0,0,637,637,C
3-PA,750,1,0,0,635,636,C
3-PA,751,636,0,0,0,636,A
3-PA,752,636,0,0,0,636,A
3-PA,753,636,0,1,0,637,A
3-PA,754,1,0,645,0,646,G
3-PA,755,642,0,0,0,642,A
3-PA,756,628,0,1,0,629,A
3-PA,757,0,0,629,0,629,G
3-PA,758,0,622,0,0,622,T
3-PA,759,0,0,623,0,623,G
3-PA,760,620,0,1,0,621,A
3-PA,761,620,0,0,0,620,A
3-PA,762,0,621,0,0,621,T
3-PA,763,0,0,629,0,629,G
3-PA,764,2,0,0,627,629,C
3-PA,765,0,0,0,630,630,C
3-PA,766,0,0,0,633,633,C
3-PA,767,637,0,0,0,637,A
3-PA,768,647,0,0,0,647,A
3-PA,769,651,0,0,0,651,A
3-PA,770,0,649,0,0,649,T
3-PA,771,0,651,0,1,652,T
3-PA,772,0,0,651,0,651,G
3-PA,773,647,0,0,0,647,A
3-PA,774,648,0,0,0,648,A
3-PA,775,0,0,0,653,653,C
3-PA,776,0,0,0,647,647,C
3-PA,777,0,644,0,0,644,T
3-PA,778,0,658,0,0,658,T
3-PA,779,0,662,0,0,662,T
3-PA,780,0,673,0,0,673,T
3-PA,781,0,0,0,678,678,C
3-PA,782,0,676,0,0,676,T
3-PA,783,0,0,678,0,678,G
3-PA,784,677,0,0,0,677,A
3-PA,785,680,0,0,0,680,A
3-PA,786,0,0,681,0,681,G
3-PA,787,680,0,1,0,681,A
3-PA,788,0,0,0,682,682,C
3-PA,789,674,0,0,0,674,A
3-PA,790,678,0,0,0,678,A
3-PA,791,0,0,0,735,735,C
3-PA,792,744,0,0,0,744,A
3-PA,793,0,0,0,743,743,C
3-PA,794,0,0,0,734,734,C
3-PA,795,734,0,0,0,734,A
3-PA,796,735,0,0,0,735,A
3-PA,797,0,0,729,0,729,G
3-PA,798,730,0,3,0,733,A
3-PA,799,1,0,0,730,731,C
3-PA,800,0,0,0,671,671,C
3-PA,801,664,0,0,0,664,A
3-PA,802,666,0,0,0,666,A
3-PA,803,0,666,0,0,666,T
3-PA,804,2,1,0,662,665,C
3-PA,805,667,0,0,0,667,A
3-PA,806,664,0,0,0,664,A
3-PA,807,662,0,0,0,662,A
3-PA,808,0,0,0,669,669,C
3-PA,809,0,660,0,0,660,T
3-PA,810,0,665,0,0,665,T
3-PA,811,0,0,0,669,669,C
3-PA,812,1,0,0,670,671,C
3-PA,813,0,0,675,0,675,G
3-PA,814,673,0,2,0,675,A
3-PA,815,676,0,2,0,678,A
3-PA,816,0,676,0,0,676,T
3-PA,817,1,0,670,0,671,G
3-PA,818,0,1,672,0,673,G
3-PA,819,677,0,0,0,677,A
3-PA,820,0,0,0,677,677,C
3-PA,821,0,0,0,674,674,C
3-PA,822,0,691,0,0,691,T
3-PA,823,0,0,0,712,712,C
3-PA,824,0,0,0,717,717,C
3-PA,825,0,715,0,0,715,T
3-PA,826,0,717,0,0,717,T
3-PA,827,0,0,746,0,746,G
3-PA,828,1,738,0,1,740,T
3-PA,829,0,738,0,0,738,T
3-PA,830,738,0,0,1,739,A
3-PA,831,0,712,0,0,712,T
3-PA,832,1,0,0,705,706,C
3-PA,833,689,0,0,0,689,A
3-PA,834,0,1,688,0,689,G
3-PA,835,0,0,0,684,684,C
3-PA,836,0,1,655,0,656,G
3-PA,837,1,0,674,0,675,G
3-PA,838,0,675,0,0,675,T
3-PA,839,0,0,0,674,674,C
3-PA,840,0,0,0,676,676,C
3-PA,841,681,0,0,0,681,A
3-PA,842,682,0,0,1,683,A
3-PA,843,678,0,0,1,679,A
3-PA,844,0,682,0,1,683,T
3-PA,845,0,681,0,0,681,T
3-PA,846,1,0,0,671,672,C
3-PA,847,1,1,0,659,661,C
3-PA,848,0,662,0,0,662,T
3-PA,849,1,0,0,665,666,C
3-PA,850,0,1,0,665,666,C
3-PA,851,0,665,0,1,666,T
3-PA,852,0,1,670,0,671,G
3-PA,853,667,0,0,0,667,A
3-PA,854,0,671,0,0,671,T
3-PA,855,0,0,665,0,665,G
3-PA,856,1,0,656,0,657,G
3-PA,857,652,0,1,0,653,A
3-PA,858,0,654,0,0,654,T
3-PA,859,0,0,654,0,654,G
3-PA,860,0,0,0,695,695,C
3-PA,861,0,687,0,1,688,T
3-PA,862,0,690,0,0,690,T
3-PA,863,0,696,0,0,696,T
3-PA,864,693,0,0,0,693,A
3-PA,865,698,0,0,0,698,A
3-PA,866,697,0,0,0,697,A
3-PA,867,702,0,0,0,702,A
3-PA,868,0,697,0,1,698,T
3-PA,869,0,652,0,0,652,T
3-PA,870,0,1,654,0,655,G
3-PA,871,648,0,1,1,650,A
3-PA,872,0,0,655,1,656,G
3-PA,873,0,1,0,659,660,C
3-PA,874,657,0,0,1,658,A
3-PA,875,0,692,0,0,692,T
3-PA,876,0,692,1,0,693,T
3-PA,877,0,0,695,0,695,G
3-PA,878,692,0,1,0,693,A
3-PA,879,690,0,2,0,692,A
3-PA,880,0,0,696,0,696,G
3-PA,881,685,0,0,0,685,A
3-PA,882,0,0,0,687,687,C
3-PA,883,1,0,0,685,686,C
3-PA,884,0,0,1,673,674,C
3-PA,885,671,0,0,0,671,A
3-PA,886,668,0,1,1,670,A
3-PA,887,0,0,681,0,681,G
3-PA,888,0,682,0,0,682,T
3-PA,889,0,0,0,682,682,C
3-PA,890,685,0,0,0,685,A
3-PA,891,1,0,0,681,682,C
3-PA,892,0,0,679,0,679,G
3-PA,893,693,0,0,1,694,A
3-PA,894,689,0,2,0,691,A
3-PA,895,0,0,718,0,718,G
3-PA,896,0,0,713,0,713,G
3-PA,897,707,0,0,0,707,A
3-PA,898,0,0,712,0,712,G
3-PA,899,713,0,0,1,714,A
3-PA,900,714,0,2,1,717,A
3-PA,901,1,0,717,0,718,G
3-PA,902,0,1,713,0,714,G
3-PA,903,0,2,707,0,709,G
3-PA,904,702,0,0,1,703,A
3-PA,905,0,702,0,0,702,T
3-PA,906,1,0,0,705,706,C
3-PA,907,0,0,0,768,768,C
3-PA,908,1,1,0,775,777,C
3-PA,909,783,0,0,1,784,A
3-PA,910,0,785,0,0,785,T
3-PA,911,0,796,0,0,796,T
3-PA,912,810,0,0,0,810,A
3-PA,913,0,815,0,0,815,T
3-PA,914,811,0,1,0,812,A
3-PA,915,0,809,0,0,809,T
3-PA,916,1,1,732,0,734,G
3-PA,917,728,0,1,1,730,A
3-PA,918,0,724,0,0,724,T
3-PA,919,0,0,730,0,730,G
3-PA,920,1,0,0,725,726,C
3-PA,921,0,2,728,0,730,G
3-PA,922,734,1,1,0,736,A
3-PA,923,1,732,0,1,734,T
3-PA,924,0,0,0,734,734,C
3-PA,925,733,0,1,0,734,A
3-PA,926,739,0,0,0,739,A
3-PA,927,1,0,742,0,743,G
3-PA,928,0,740,0,0,740,T
3-PA,929,1,0,744,0,745,G
3-PA,930,0,0,0,737,737,C
3-PA,931,739,0,0,1,740,A
3-PA,932,0,742,0,0,742,T
3-PA,933,744,0,0,0,744,A
3-PA,934,752,0,0,1,753,A
3-PA,935,751,1,0,0,752,A
3-PA,936,748,1,2,0,751,A
3-PA,937,747,0,1,0,748,A
3-PA,938,0,0,0,751,751,C
3-PA,939,744,0,0,0,744,A
3-PA,940,0,744,0,0,744,T
3-PA,941,0,745,0,1,746,T
3-PA,942,2,0,0,744,746,C
3-PA,943,0,746,0,0,746,T
3-PA,944,1,740,0,0,741,T
3-PA,945,0,746,0,0,746,T
3-PA,946,0,0,743,0,743,G
3-PA,947,1,1,746,0,748,G
3-PA,948,743,0,0,0,743,A
3-PA,949,0,744,1,0,745,T
3-PA,950,0,0,751,0,751,G
3-PA,951,0,0,763,0,763,G
3-PA,952,763,0,0,0,763,A
3-PA,953,762,0,1,0,763,A
3-PA,954,760,0,1,0,761,A
3-PA,955,3,0,763,0,766,G
3-PA,956,761,0,1,0,762,A
3-PA,957,838,0,0,0,838,A
3-PA,958,0,0,0,858,858,C
3-PA,959,0,0,1,849,850,C
3-PA,960,0,851,0,0,851,T
3-PA,961,0,868,0,0,868,T
3-PA,962,871,0,0,0,871,A
3-PA,963,0,873,0,0,873,T
3-PA,964,866,0,0,0,866,A
3-PA,965,0,871,0,0,871,T
3-PA,966,805,0,1,0,806,A
3-PA,967,1,0,816,0,817,G
3-PA,968,0,812,1,1,814,T
3-PA,969,1,0,0,815,816,C
3-PA,970,803,0,0,1,804,A
3-PA,971,807,0,0,0,807,A
3-PA,972,803,0,1,0,804,A
3-PA,973,0,1,0,801,802,C
3-PA,974,1,0,0,794,795,C
3-PA,975,790,0,0,0,790,A
3-PA,976,0,0,0,794,794,C
3-PA,977,794,0,0,0,794,A
3-PA,978,0,0,0,797,797,C
3-PA,979,1,0,797,0,798,G
3-PA,980,793,1,0,1,795,A
3-PA,981,792,0,1,1,794,A
3-PA,982,794,1,1,0,796,A
3-PA,983,797,0,0,0,797,A
3-PA,984,0,0,804,0,804,G
3-PA,985,1,0,792,0,793,G
3-PA,986,0,0,807,0,807,G
3-PA,987,802,0,2,0,804,A
3-PA,988,803,0,0,0,803,A
3-PA,989,0,801,0,0,801,T
3-PA,990,799,0,1,0,800,A
3-PA,991,801,0,0,0,801,A
3-PA,992,802,0,0,0,802,A
3-PA,993,0,794,0,0,794,T
3-PA,994,0,797,0,0,797,T
3-PA,995,0,0,0,801,801,C
3-PA,996,800,0,1,0,801,A
3-PA,997,809,0,0,0,809,A
3-PA,998,809,0,0,0,809,A
3-PA,999,0,806,0,0,806,T
3-PA,1000,0,809,0,0,809,T
3-PA,1001,813,0,0,0,813,A
3-PA,1002,0,1,0,811,812,C
3-PA,1003,0,0,0,817,817,C
3-PA,1004,0,809,1,0,810,T
3-PA,1005,0,0,812,0,812,G
3-PA,1006,0,1,0,817,818,C
3-PA,1007,0,819,0,1,820,T
3-PA,1008,0,0,836,0,836,G
3-PA,1009,0,832,0,2,834,T
3-PA,1010,0,0,0,835,835,C
3-PA,1011,837,0,1,0,838,A
3-PA,1012,0,837,0,1,838,T
3-PA,1013,1,0,839,0,840,G
3-PA,1014,0,0,841,0,841,G
3-PA,1015,840,0,1,0,841,A
3-PA,1016,856,1,0,0,857,A
3-PA,1017,0,0,854,0,854,G
3-PA,1018,0,0,0,862,862,C
3-PA,1019,854,0,0,0,854,A
3-PA,1020,856,0,0,0,856,A
3-PA,1021,0,0,865,0,865,G
3-PA,1022,0,864,1,0,865,T
3-PA,1023,864,0,0,0,864,A
3-PA,1024,0,0,0,864,864,C
3-PA,1025,0,840,0,0,840,T
3-PA,1026,1,0,853,0,854,G
3-PA,1027,0,849,0,2,851,T
3-PA,1028,0,0,0,855,855,C
3-PA,1029,854,0,1,0,855,A
3-PA,1030,0,0,860,0,860,G
3-PA,1031,862,0,0,0,862,A
3-PA,1032,858,0,0,0,858,A
3-PA,1033,0,865,0,1,866,T
3-PA,1034,0,860,0,1,861,T
3-PA,1035,0,0,860,0,860,G
3-PA,1036,0,0,0,860,860,C
3-PA,1037,855,0,2,0,857,A
3-PA,1038,0,1,856,0,857,G
3-PA,1039,0,0,850,0,850,G
3-PA,1040,843,0,3,0,846,A
3-PA,1041,0,0,0,846,846,C
3-PA,1042,0,0,842,0,842,G
3-PA,1043,1,857,0,0,858,T
3-PA,1044,0,853,0,2,855,T
3-PA,1045,0,0,860,0,860,G
3-PA,1046,865,0,0,0,865,A
3-PA,1047,865,0,0,0,865,A
3-PA,1048,864,1,0,0,865,A
3-PA,1049,866,0,0,0,866,A
3-PA,1050,0,858,0,0,858,T
3-PA,1051,0,0,869,0,869,G
3-PA,1052,859,0,0,0,859,A
3-PA,1053,0,1,867,0,868,G
3-PA,1054,0,1,866,0,867,G
3-PA,1055,867,0,0,0,867,A
3-PA,1056,0,0,869,0,869,G
3-PA,1057,867,0,0,0,867,A
3-PA,1058,868,0,1,0,869,A
3-PA,1059,0,0,868,0,868,G
3-PA,1060,0,0,861,0,861,G
3-PA,1061,0,921,0,1,922,T
3-PA,1062,0,925,0,1,926,T
3-PA,1063,0,0,1,921,922,C
3-PA,1064,1,0,0,927,928,C
3-PA,1065,925,0,0,0,925,A
3-PA,1066,923,0,1,0,924,A
3-PA,1067,0,1,931,0,932,G
3-PA,1068,0,0,939,0,939,G
3-PA,1069,923,1,0,0,924,A
3-PA,1070,0,1,0,937,938,C
3-PA,1071,0,939,0,0,939,T
3-PA,1072,939,0,0,0,939,A
3-PA,1073,941,0,0,0,941,A
3-PA,1074,941,0,0,0,941,A
3-PA,1075,940,0,0,0,940,A
3-PA,1076,940,0,0,0,940,A
3-PA,1077,0,1,0,929,930,C
3-PA,1078,926,0,0,0,926,A
3-PA,1079,0,920,0,0,920,T
3-PA,1080,0,0,924,0,924,G
3-PA,1081,923,1,1,0,925,A
3-PA,1082,928,0,0,0,928,A
3-PA,1083,1,0,930,0,931,G
3-PA,1084,930,0,1,0,931,A
3-PA,1085,929,0,0,0,929,A
3-PA,1086,928,0,1,0,929,A
3-PA,1087,926,0,3,0,929,A
3-PA,1088,0,0,0,934,934,C
3-PA,1089,0,1,932,0,933,G
3-PA,1090,929,0,1,0,930,A
3-PA,1091,0,0,933,0,933,G
3-PA,1092,0,929,0,1,930,T
3-PA,1093,1,1,0,949,951,C
3-PA,1094,952,1,1,0,954,A
3-PA,1095,968,0,0,0,968,A
3-PA,1096,0,0,0,970,970,C
3-PA,1097,0,969,0,1,970,T
3-PA,1098,0,0,983,0,983,G
3-PA,1099,976,0,1,0,977,A
3-PA,1100,982,1,1,1,985,A
3-PA,1101,0,1,984,0,985,G
3-PA,1102,0,962,0,0,962,T
3-PA,1103,1,1,964,0,966,G
3-PA,1104,0,0,959,0,959,G
3-PA,1105,0,0,958,0,958,G
3-PA,1106,0,0,0,965,965,C
3-PA,1107,0,950,0,2,952,T
3-PA,1108,0,1,0,968,969,C
3-PA,1109,0,962,0,1,963,T
3-PA,1110,0,960,0,0,960,T
3-PA,1111,0,0,973,0,973,G
3-PA,1112,0,1,976,1,978,G
3-PA,1113,0,972,0,0,972,T
3-PA,1114,0,0,974,0,974,G
3-PA,1115,969,0,0,0,969,A
3-PA,1116,977,0,0,0,977,A
3-PA,1117,965,1,1,0,967,A
3-PA,1118,969,0,1,1,971,A
3-PA,1119,0,0,0,975,975,C
3-PA,1120,962,0,0,0,962,A
3-PA,1121,0,968,0,0,968,T
3-PA,1122,0,2,964,0,966,G
3-PA,1123,1,0,979,0,980,G
3-PA,1124,0,0,0,983,983,C
3-PA,1125,986,0,1,1,988,A
3-PA,1126,0,1,0,986,987,C
3-PA,1127,0,1,0,985,986,C
3-PA,1128,997,0,0,0,997,A
3-PA,1129,1,2,1006,1,1010,G
3-PA,1130,1009,0,0,0,1009,A
3-PA,1131,0,0,1020,0,1020,G
3-PA,1132,1022,0,0,0,1022,A
3-PA,1133,1027,0,0,0,1027,A
3-PA,1134,0,1,1035,0,1036,G
3-PA,1135,0,0,1034,0,1034,G
3-PA,1136,0,1034,0,1,1035,T
3-PA,1137,1025,0,0,0,1025,A
3-PA,1138,0,0,1025,0,1025,G
3-PA,1139,1025,0,2,0,1027,A
3-PA,1140,0,0,0,1035,1035,C
3-PA,1141,0,1027,0,0,1027,T
3-PA,1142,0,1026,0,0,1026,T
3-PA,1143,0,1032,0,0,1032,T
3-PA,1144,0,0,1030,0,1030,G
3-PA,1145,1029,0,1,0,1030,A
3-PA,1146,1027,1,1,1,1030,A
3-PA,1147,1028,0,0,0,1028,A
3-PA,1148,1019,0,0,0,1019,A
3-PA,1149,0,0,0,1035,1035,C
3-PA,1150,0,1033,0,0,1033,T
3-PA,1151,0,1,1040,0,1041,G
3-PA,1152,0,1,0,1037,1038,C
3-PA,1153,1041,0,2,0,1043,A
3-PA,1154,0,0,1040,0,1040,G
3-PA,1155,1036,0,0,1,1037,A
3-PA,1156,0,0,1079,0,1079,G
3-PA,1157,1077,0,1,0,1078,A
3-PA,1158,0,0,0,1073,1073,C
3-PA,1159,1068,1,1,0,1070,A
3-PA,1160,1,1064,0,0,1065,T
3-PA,1161,1065,0,0,0,1065,A
3-PA,1162,1065,0,1,0,1066,A
3-PA,1163,0,0,1065,0,1065,G
3-PA,1164,0,0,0,1056,1056,C
3-PA,1165,0,2,1038,0,1040,G
3-PA,1166,1070,0,0,0,1070,A
3-PA,1167,0,1062,0,0,1062,T
3-PA,1168,0,1053,0,0,1053,T
3-PA,1169,0,1060,0,0,1060,T
3-PA,1170,0,0,1062,0,1062,G
3-PA,1171,1064,0,0,0,1064,A
3-PA,1172,1052,0,15,0,1067,A
3-PA,1173,0,0,1071,0,1071,G
3-PA,1174,0,0,0,1086,1086,C
3-PA,1175,1068,0,1,0,1069,A
3-PA,1176,1134,0,1,0,1135,A
3-PA,1177,0,1137,0,0,1137,T
3-PA,1178,1137,0,0,0,1137,A
3-PA,1179,0,1143,1,0,1144,T
3-PA,1180,0,2,1144,0,1146,G
3-PA,1181,1149,0,1,0,1150,A
3-PA,1182,0,1148,0,0,1148,T
3-PA,1183,1122,0,0,0,1122,A
3-PA,1184,0,0,1120,0,1120,G
3-PA,1185,0,1077,0,0,1077,T
3-PA,1186,2,0,1076,0,1078,G
3-PA,1187,1076,0,0,0,1076,A
3-PA,1188,0,0,0,1068,1068,C
3-PA,1189,2,0,1064,0,1066,G
3-PA,1190,1061,0,0,1,1062,A
3-PA,1191,1063,0,0,0,1063,A
3-PA,1192,2,0,0,1070,1072,C
3-PA,1193,0,0,0,1068,1068,C
3-PA,1194,0,1073,0,2,1075,T
3-PA,1195,1,1,1097,0,1099,G
3-PA,1196,1093,0,0,0,1093,A
3-PA,1197,1098,0,0,0,1098,A
3-PA,1198,0,1087,0,0,1087,T
3-PA,1199,0,1084,0,0,1084,T
3-PA,1200,1085,1,0,0,1086,A
3-PA,1201,1077,0,2,1,1080,A
3-PA,1202,0,0,1080,0,1080,G
3-PA,1203,1,0,1077,0,1078,G
3-PA,1204,0,1067,0,0,1067,T
3-PA,1205,0,0,0,1064,1064,C
3-PA,1206,1064,1,1,0,1066,A
3-PA,1207,0,0,0,1093,1093,C
3-PA,1208,0,1097,1,2,1100,T
3-PA,1209,2,1099,0,0,1101,T
3-PA,1210,0,1096,0,1,1097,T
3-PA,1211,1,0,0,1093,1094,C
3-PA,1212,1101,0,0,0,1101,A
3-PA,1213,1099,0,0,0,1099,A
3-PA,1214,1,0,1111,0,1112,G
3-PA,1215,0,0,0,1113,1113,C
3-PA,1216,0,1096,0,1,1097,T
3-PA,1217,1,0,1114,0,1115,G
3-PA,1218,0,0,1122,0,1122,G
3-PA,1219,1130,1,2,0,1133,A
3-PA,1220,0,1141,0,0,1141,T
3-PA,1221,1140,0,0,0,1140,A
3-PA,1222,1,0,0,1150,1151,C
3-PA,1223,1125,1,1,0,1127,A
3-PA,1224,1,1,1136,0,1138,G
3-PA,1225,1137,0,1,0,1138,A
3-PA,1226,1120,0,0,0,1120,A
3-PA,1227,0,1109,1,0,1110,T
3-PA,1228,0,0,1117,0,1117,G
3-PA,1229,1101,1,2,0,1104,A
3-PA,1230,1,0,1117,0,1118,G
3-PA,1231,0,1108,0,2,1110,T
3-PA,1232,0,1110,0,1,1111,T
3-PA,1233,0,0,0,1127,1127,C
3-PA,1234,1134,0,0,0,1134,A
3-PA,1235,1133,1,0,0,1134,A
3-PA,1236,0,0,0,1135,1135,C
3-PA,1237,1114,0,2,0,1116,A
3-PA,1238,1115,0,0,0,1115,A
3-PA,1239,0,0,1108,0,1108,G
3-PA,1240,1,1,1113,0,1115,G
3-PA,1241,0,0,0,1117,1117,C
3-PA,1242,1,0,0,1114,1115,C
3-PA,1243,0,1103,0,1,1104,T
3-PA,1244,0,0,1122,0,1122,G
3-PA,1245,0,1120,0,1,1121,T
3-PA,1246,0,1,1124,0,1125,G
3-PA,1247,1127,0,0,1,1128,A
3-PA,1248,0,0,1123,0,1123,G
3-PA,1249,0,1,0,1118,1119,C
3-PA,1250,0,1113,0,0,1113,T
3-PA,1251,1137,0,1,1,1139,A
3-PA,1252,1138,0,1,1,1140,A
3-PA,1253,0,0,0,1143,1143,C
3-PA,1254,0,1132,0,0,1132,T
3-PA,1255,2,0,1132,1,1135,G
3-PA,1256,1134,0,0,0,1134,A
3-PA,1257,0,1135,0,0,1135,T
3-PA,1258,1,1137,0,0,1138,T
3-PA,1259,1,0,0,1140,1141,C
3-PA,1260,1150,0,0,1,1151,A
3-PA,1261,0,3,1174,0,1177,G
3-PA,1262,0,1177,0,0,1177,T
3-PA,1263,1,0,0,1176,1177,C
3-PA,1264,0,1172,0,1,1173,T
3-PA,1265,0,0,1211,0,1211,G
3-PA,1266,0,2,1209,0,1211,G
3-PA,1267,1210,0,1,0,1211,A
3-PA,1268,0,1209,0,0,1209,T
3-PA,1269,1151,0,1,0,1152,A
3-PA,1270,0,0,1149,0,1149,G
3-PA,1271,1135,0,1,1,1137,A
3-PA,1272,0,1,1139,0,1140,G
3-PA,1273,1,0,0,1136,1137,C
3-PA,1274,0,1112,0,0,1112,T
3-PA,1275,0,0,0,1114,1114,C
3-PA,1276,0,0,1118,0,1118,G
3-PA,1277,1114,0,2,0,1116,A
3-PA,1278,0,1121,0,0,1121,T
3-PA,1279,0,1,1115,1,1117,G
3-PA,1280,1128,0,1,0,1129,A
3-PA,1281,1126,0,0,0,1126,A
3-PA,1282,1130,0,0,0,1130,A
3-PA,1283,0,1130,0,0,1130,T
3-PA,1284,0,1122,0,1,1123,T
3-PA,1285,0,2,1129,0,1131,G
3-PA,1286,0,1,1126,0,1127,G
3-PA,1287,1129,0,0,0,1129,A
3-PA,1288,0,0,1129,0,1129,G
3-PA,1289,1115,0,1,0,1116,A
3-PA,1290,0,0,1125,0,1125,G
3-PA,1291,0,1,1131,0,1132,G
3-PA,1292,1142,0,1,0,1143,A
3-PA,1293,0,1,0,1141,1142,C
3-PA,1294,2,0,1131,0,1133,G
3-PA,1295,0,1135,0,1,1136,T
3-PA,1296,1144,0,0,1,1145,A
3-PA,1297,1,0,1154,0,1155,G
3-PA,1298,0,0,0,1160,1160,C
3-PA,1299,1,1,0,1149,1151,C
3-PA,1300,1,2,0,1143,1146,C
3-PA,1301,0,1,0,1136,1137,C
3-PA,1302,1143,1,0,0,1144,A
3-PA,1303,1172,0,0,0,1172,A
3-PA,1304,0,1166,0,0,1166,T
3-PA,1305,0,1163,0,1,1164,T
3-PA,1306,0,1,1161,0,1162,G
3-PA,1307,1140,0,1,0,1141,A
3-PA,1308,0,0,1143,1,1144,G
3-PA,1309,0,0,0,1140,1140,C
3-PA,1310,1134,0,0,0,1134,A
3-PA,1311,0,0,0,1158,1158,C
3-PA,1312,1122,0,1,0,1123,A
3-PA,1313,0,1155,0,0,1155,T
3-PA,1314,0,1153,0,1,1154,T
3-PA,1315,1,0,1154,0,1155,G
3-PA,1316,1,0,0,1154,1155,C
3-PA,1317,1148,0,1,0,1149,A
3-PA,1318,1147,0,1,0,1148,A
3-PA,1319,0,0,1151,0,1151,G
3-PA,1320,1,0,0,1140,1141,C
3-PA,1321,1140,0,0,0,1140,A
3-PA,1322,0,1115,0,0,1115,T
3-PA,1323,0,1,1115,0,1116,G
3-PA,1324,1113,0,1,0,1114,A
3-PA,1325,0,0,1112,1,1113,G
3-PA,1326,1114,0,0,0,1114,A
3-PA,1327,1110,1,0,0,1111,A
3-PA,1328,0,0,1108,0,1108,G
3-PA,1329,0,0,1105,0,1105,G
3-PA,1330,1109,0,0,0,1109,A
3-PA,1331,1105,0,2,0,1107,A
3-PA,1332,0,1109,1,0,1110,T
3-PA,1333,0,1109,0,3,1112,T
3-PA,1334,1105,0,0,0,1105,A
3-PA,1335,0,1114,0,0,1114,T
3-PA,1336,0,1108,0,2,1110,T
3-PA,1337,0,1112,0,0,1112,T
3-PA,1338,0,0,2,1108,1110,C
3-PA,1339,1109,0,0,0,1109,A
3-PA,1340,0,1,0,1126,1127,C
3-PA,1341,1120,0,1,0,1121,A
3-PA,1342,0,0,1130,0,1130,G
3-PA,1343,0,0,0,1127,1127,C
3-PA,1344,1119,0,0,0,1119,A
3-PA,1345,0,0,1124,0,1124,G
3-PA,1346,1120,0,0,0,1120,A
3-PA,1347,0,0,1125,0,1125,G
3-PA,1348,1,0,1129,1,1131,G
3-PA,1349,0,1110,0,1,1111,T
3-PA,1350,0,0,1129,0,1129,G
3-PA,1351,0,1119,0,0,1119,T
3-PA,1352,1,0,0,1111,1112,C
3-PA,1353,0,0,0,1126,1126,C
3-PA,1354,0,0,0,1125,1125,C
3-PA,1355,1131,0,0,1,1132,A
3-PA,1356,0,1140,0,0,1140,T
3-PA,1357,1,1139,0,0,1140,T
3-PA,1358,0,0,1143,0,1143,G
3-PA,1359,0,1127,0,0,1127,T
3-PA,1360,1108,1,2,1,1112,A
3-PA,1361,0,0,1116,0,1116,G
3-PA,1362,1087,0,0,0,1087,A
3-PA,1363,1,0,1085,0,1086,G
3-PA,1364,0,0,0,1073,1073,C
3-PA,1365,1,1,0,1058,1060,C
3-PA,1366,1073,0,0,0,1073,A
3-PA,1367,0,0,0,1079,1079,C
3-PA,1368,0,1068,0,8,1076,T
3-PA,1369,0,0,1076,0,1076,G
3-PA,1370,1075,0,1,0,1076,A
3-PA,1371,1056,0,0,0,1056,A
3-PA,1372,0,1078,0,0,1078,T
3-PA,1373,1086,1,0,0,1087,A
3-PA,1374,0,0,0,1101,1101,C
3-PA,1375,1081,0,0,0,1081,A
3-PA,1376,0,1087,0,0,1087,T
3-PA,1377,1082,0,0,0,1082,A
3-PA,1378,1082,0,0,0,1082,A
3-PA,1379,0,1082,0,0,1082,T
3-PA,1380,0,0,1071,0,1071,G
3-PA,1381,1066,1,0,1,1068,A
3-PA,1382,1049,0,0,0,1049,A
3-PA,1383,0,2,1049,0,1051,G
3-PA,1384,0,3,1040,0,1043,G
3-PA,1385,0,0,1063,0,1063,G
3-PA,1386,0,0,1059,0,1059,G
3-PA,1387,0,0,1073,0,1073,G
3-PA,1388,0,1058,0,0,1058,T
3-PA,1389,1064,0,0,0,1064,A
3-PA,1390,0,1070,0,0,1070,T
3-PA,1391,1081,0,0,0,1081,A
3-PA,1392,0,1,0,1167,1168,C
3-PA,1393,1130,1,0,0,1131,A
3-PA,1394,0,1100,0,2,1102,T
3-PA,1395,0,1083,0,1,1084,T
3-PA,1396,1079,0,0,0,1079,A
3-PA,1397,1107,0,0,0,1107,A
3-PA,1398,0,0,0,1109,1109,C
3-PA,1399,1093,0,0,0,1093,A
3-PA,1400,0,0,0,1093,1093,C
3-PA,1401,1,975,0,1,977,T
3-PA,1402,0,0,1009,0,1009,G
3-PA,1403,1,0,0,1010,1011,C
3-PA,1404,2,1,0,1008,1011,C
3-PA,1405,2,0,1,1009,1012,C
3-PA,1406,0,982,0,1,983,T
3-PA,1407,0,0,1004,0,1004,G
3-PA,1408,1,0,0,1005,1006,C
3-PA,1409,0,997,0,5,1002,T
3-PA,1410,1,0,0,1023,1024,C
3-PA,1411,985,0,0,0,985,A
3-PA,1412,990,0,1,0,991,A
3-PA,1413,0,992,0,0,992,T
3-PA,1414,0,0,995,0,995,G
3-PA,1415,0,0,0,996,996,C
3-PA,1416,972,0,0,0,972,A
3-PA,1417,0,971,0,1,972,T
3-PA,1418,1,0,0,967,968,C
3-PA,1419,0,0,0,980,980,C
3-PA,1420,0,945,0,1,946,T
3-PA,1421,1,0,971,0,972,G
3-PA,1422,0,965,0,1,966,T
3-PA,1423,0,0,966,0,966,G
3-PA,1424,0,0,0,968,968,C
3-PA,1425,957,0,0,0,957,A
3-PA,1426,0,0,966,0,966,G
3-PA,1427,0,1,0,966,967,C
3-PA,1428,953,0,0,0,953,A
3-PA,1429,956,0,0,0,956,A
3-PA,1430,1,909,0,0,910,T
3-PA,1431,0,0,907,0,907,G
3-PA,1432,0,1,908,0,909,G
3-PA,1433,909,0,0,0,909,A
3-PA,1434,1,0,0,909,910,C
3-PA,1435,0,3,895,0,898,G
3-PA,1436,904,0,0,0,904,A
3-PA,1437,0,900,0,0,900,T
3-PA,1438,0,901,0,1,902,T
3-PA,1439,0,901,0,0,901,T
3-PA,1440,1,901,0,0,902,T
3-PA,1441,0,0,0,900,900,C
3-PA,1442,902,0,1,0,903,A
3-PA,1443,906,0,0,0,906,A
3-PA,1444,0,0,0,905,905,C
3-PA,1445,0,889,0,0,889,T
3-PA,1446,891,0,0,0,891,A
3-PA,1447,892,0,0,0,892,A
3-PA,1448,0,892,0,1,893,T
3-PA,1449,0,896,0,0,896,T
3-PA,1450,0,0,0,893,893,C
3-PA,1451,0,0,0,890,890,C
3-PA,1452,0,0,0,882,882,C
3-PA,1453,882,0,0,0,882,A
3-PA,1454,0,897,0,0,897,T
3-PA,1455,0,0,895,1,896,G
3-PA,1456,896,0,1,0,897,A
3-PA,1457,0,894,0,0,894,T
3-PA,1458,891,0,0,0,891,A
3-PA,1459,893,0,2,0,895,A
3-PA,1460,0,0,896,0,896,G
3-PA,1461,0,0,0,894,894,C
3-PA,1462,889,0,0,0,889,A
3-PA,1463,863,0,0,0,863,A
3-PA,1464,0,0,874,0,874,G
3-PA,1465,0,868,0,1,869,T
3-PA,1466,0,0,867,0,867,G
3-PA,1467,1,0,0,863,864,C
3-PA,1468,859,0,0,0,859,A
3-PA,1469,0,0,872,0,872,G
3-PA,1470,868,0,0,0,868,A
3-PA,1471,882,0,0,0,882,A
3-PA,1472,0,0,0,885,885,C
3-PA,1473,1,863,0,0,864,T
3-PA,1474,868,0,0,0,868,A
3-PA,1475,866,0,0,0,866,A
3-PA,1476,864,0,1,0,865,A
3-PA,1477,0,0,867,0,867,G
3-PA,1478,825,0,1,0,826,A
3-PA,1479,1,0,824,0,825,G
3-PA,1480,0,1,808,0,809,G
3-PA,1481,0,1,808,0,809,G
3-PA,1482,800,0,3,0,803,A
3-PA,1483,786,0,1,0,787,A
3-PA,1484,0,0,787,0,787,G
3-PA,1485,0,0,788,0,788,G
3-PA,1486,0,0,0,786,786,C
3-PA,1487,1,0,787,0,788,G
3-PA,1488,785,0,0,0,785,A
3-PA,1489,786,0,0,0,786,A
3-PA,1490,785,0,0,0,785,A
3-PA,1491,784,0,2,0,786,A
3-PA,1492,785,0,2,0,787,A
3-PA,1493,0,0,0,784,784,C
3-PA,1494,1,0,0,774,775,C
3-PA,1495,778,0,0,0,778,A
3-PA,1496,782,1,0,0,783,A
3-PA,1497,0,781,0,0,781,T
3-PA,1498,0,779,0,0,779,T
3-PA,1499,0,785,0,0,785,T
3-PA,1500,790,0,0,0,790,A
3-PA,1501,0,790,0,0,790,T
3-PA,1502,790,0,2,0,792,A
3-PA,1503,0,789,0,1,790,T
3-PA,1504,1,0,782,0,783,G
3-PA,1505,0,1,773,0,774,G
3-PA,1506,774,0,0,0,774,A
3-PA,1507,1,768,0,1,770,T
3-PA,1508,1,762,0,0,763,T
3-PA,1509,2,0,0,762,764,C
3-PA,1510,760,0,6,0,766,A
3-PA,1511,0,767,0,1,768,T
3-PA,1512,0,1,0,772,773,C
3-PA,1513,767,0,0,0,767,A
3-PA,1514,0,756,0,0,756,T
3-PA,1515,752,0,0,0,752,A
3-PA,1516,752,0,0,0,752,A
3-PA,1517,753,0,0,0,753,A
3-PA,1518,0,0,748,0,748,G
3-PA,1519,0,1,735,0,736,G
3-PA,1520,0,0,725,0,725,G
3-PA,1521,715,0,2,0,717,A
3-PA,1522,709,0,1,0,710,A
3-PA,1523,0,0,708,0,708,G
3-PA,1524,708,0,0,0,708,A
3-PA,1525,0,706,0,0,706,T
3-PA,1526,0,0,0,704,704,C
3-PA,1527,0,697,0,0,697,T
3-PA,1528,0,0,0,704,704,C
3-PA,1529,699,0,0,0,699,A
3-PA,1530,0,697,0,0,697,T
3-PA,1531,0,697,0,1,698,T
3-PA,1532,0,689,0,0,689,T
3-PA,1533,683,0,0,0,683,A
3-PA,1534,683,0,0,0,683,A
3-PA,1535,0,0,685,0,685,G
3-PA,1536,0,0,689,0,689,G
3-PA,1537,654,0,0,0,654,A
3-PA,1538,656,0,0,0,656,A
3-PA,1539,0,644,9,0,653,T
3-PA,1540,0,1,652,0,653,G
3-PA,1541,656,0,1,1,658,A
3-PA,1542,0,0,0,656,656,C
3-PA,1543,657,0,0,0,657,A
3-PA,1544,0,0,0,656,656,C
3-PA,1545,634,0,2,0,636,A
3-PA,1546,0,0,636,0,636,G
3-PA,1547,622,0,0,0,622,A
3-PA,1548,0,0,0,614,614,C
3-PA,1549,0,0,602,0,602,G
3-PA,1550,0,561,0,0,561,T
3-PA,1551,0,0,564,0,564,G
3-PA,1552,0,0,564,0,564,G
3-PA,1553,0,564,0,0,564,T
3-PA,1554,562,0,1,0,563,A
3-PA,1555,555,0,0,0,555,A
3-PA,1556,556,0,0,0,556,A
3-PA,1557,0,549,0,0,549,T
3-PA,1558,0,542,0,0,542,T
3-PA,1559,0,540,0,0,540,T
3-PA,1560,0,526,0,0,526,T
3-PA,1561,0,0,526,0,526,G
3-PA,1562,0,519,0,2,521,T
3-PA,1563,0,1,518,0,519,G
3-PA,1564,509,0,0,0,509,A
3-PA,1565,0,0,511,0,511,G
3-PA,1566,0,0,0,508,508,C
3-PA,1567,506,0,0,0,506,A
3-PA,1568,0,506,0,0,506,T
3-PA,1569,0,0,506,0,506,G
3-PA,1570,0,0,509,0,509,G
3-PA,1571,509,0,0,0,509,A
3-PA,1572,0,0,510,0,510,G
3-PA,1573,0,504,0,0,504,T
3-PA,1574,0,496,0,0,496,T
3-PA,1575,0,495,0,1,496,T
3-PA,1576,1,493,0,1,495,T
3-PA,1577,0,0,0,498,498,C
3-PA,1578,0,494,0,0,494,T
3-PA,1579,0,0,0,494,494,C
3-PA,1580,0,479,0,0,479,T
3-PA,1581,0,0,0,478,478,C
3-PA,1582,477,0,0,0,477,A
3-PA,1583,0,0,0,476,476,C
3-PA,1584,0,468,0,0,468,T
3-PA,1585,0,0,469,0,469,G
3-PA,1586,468,0,0,0,468,A
3-PA,1587,0,0,0,466,466,C
3-PA,1588,1,0,0,466,467,C
3-PA,1589,1,0,0,461,462,C
3-PA,1590,0,0,457,0,457,G
3-PA,1591,453,1,1,0,455,A
3-PA,1592,0,0,456,0,456,G
3-PA,1593,454,1,0,0,455,A
3-PA,1594,0,0,0,442,442,C
3-PA,1595,0,431,1,0,432,T
3-PA,1596,0,401,0,1,402,T
3-PA,1597,0,0,401,0,401,G
3-PA,1598,395,0,0,0,395,A
3-PA,1599,0,0,400,0,400,G
3-PA,1600,0,0,0,400,400,C
3-PA,1601,1,1,1,377,380,C
3-PA,1602,376,0,0,0,376,A
3-PA,1603,0,0,0,369,369,C
3-PA,1604,372,0,0,0,372,A
3-PA,1605,0,371,0,0,371,T
3-PA,1606,369,0,0,0,369,A
3-PA,1607,366,0,0,0,366,A
3-PA,1608,365,0,0,0,365,A
3-PA,1609,0,359,0,0,359,T
3-PA,1610,0,0,356,0,356,G
3-PA,1611,1,1,315,0,317,G
3-PA,1612,0,1,309,0,310,G
3-PA,1613,300,0,0,0,300,A
3-PA,1614,0,1,302,0,303,G
3-PA,1615,298,0,0,0,298,A
3-PA,1616,293,0,0,0,293,A
3-PA,1617,293,0,0,0,293,A
3-PA,1618,0,289,0,0,289,T
3-PA,1619,284,0,0,0,284,A
3-PA,1620,0,0,0,283,283,C
3-PA,1621,0,156,0,0,156,T
3-PA,1622,0,0,153,0,153,G
3-PA,1623,0,99,0,0,99,T
3-PA,1624,0,0,101,0,101,G
3-PA,1625,0,91,1,0,92,T
3-PA,1626,0,0,0,45,45,C
3-PA,1627,0,0,0,43,43,C
3-PA,1628,0,38,0,0,38,T
3-PA,1629,0,36,0,0,36,T
3-PA,1630,0,0,36,0,36,G
3-PA,1631,36,0,0,0,36,A
3-PA,1632,0,0,36,0,36,G
3-PA,1633,36,0,0,0,36,A
3-PA,1634,0,36,0,0,36,T
3-PA,1635,36,0,0,0,36,A
3-PA,1636,0,0,37,0,37,G
3-PA,1637,0,0,37,0,37,G
3-PA,1638,37,0,0,0,37,A
3-PA,1639,0,0,37,0,37,G
3-PA,1640,37,0,0,0,37,A
3-PA,1641,0,36,0,0,36,T
3-PA,1642,36,0,0,0,36,A
3-PA,1643,0,35,0,0,35,T
3-PA,1644,0,0,36,0,36,G
3-PA,1645,0,37,0,0,37,T
3-PA,1646,0,36,0,0,36,T
3-PA,1647,38,0,0,0,38,A
3-PA,1648,0,0,0,38,38,C
3-PA,1649,0,38,0,0,38,T
3-PA,1650,38,0,0,0,38,A
3-PA,1651,38,0,0,0,38,A
3-PA,1652,0,0,39,0,39,G
3-PA,1653,39,0,0,0,39,A
3-PA,1654,36,0,0,0,36,A
3-PA,1655,0,0,37,0,37,G
3-PA,1656,0,38,0,0,38,T
3-PA,1657,0,0,37,0,37,G
3-PA,1658,0,0,0,38,38,C
3-PA,1659,0,0,0,38,38,C
3-PA,1660,38,0,0,0,38,A
3-PA,1661,0,37,0,0,37,T
3-PA,1662,37,0,0,0,37,A
3-PA,1663,0,0,37,0,37,G
3-PA,1664,0,0,37,0,37,G
3-PA,1665,0,0,0,37,37,C
3-PA,1666,0,0,0,36,36,C
3-PA,1667,37,0,0,0,37,A
3-PA,1668,37,0,0,0,37,A
3-PA,1669,37,0,0,0,37,A
3-PA,1670,0,37,0,0,37,T
3-PA,1671,0,37,0,0,37,T
3-PA,1672,0,36,0,0,36,T
3-PA,1673,0,0,0,37,37,C
3-PA,1674,33,0,0,0,33,A
3-PA,1675,33,0,0,0,33,A
3-PA,1676,0,0,35,0,35,G
3-PA,1677,0,0,36,0,36,G
3-PA,1678,0,0,0,36,36,C
3-PA,1679,0,0,0,36,36,C
3-PA,1680,36,0,0,0,36,A
3-PA,1681,45,0,0,0,45,A
3-PA,1682,0,45,0,0,45,T
3-PA,1683,0,0,49,0,49,G
3-PA,1684,0,49,0,0,49,T
3-PA,1685,0,50,0,0,50,T
3-PA,1686,0,0,0,50,50,C
3-PA,1687,0,49,0,0,49,T
3-PA,1688,0,49,0,0,49,T
3-PA,1689,46,0,0,0,46,A
3-PA,1690,0,46,0,0,46,T
3-PA,1691,46,0,0,0,46,A
3-PA,1692,0,46,0,0,46,T
3-PA,1693,0,0,46,0,46,G
3-PA,1694,0,44,0,0,44,T
3-PA,1695,0,0,43,0,43,G
3-PA,1696,43,0,0,0,43,A
3-PA,1697,0,0,44,0,44,G
3-PA,1698,0,0,44,0,44,G
3-PA,1699,44,0,0,0,44,A
3-PA,1700,0,0,0,44,44,C
3-PA,1701,44,0,0,0,44,A
3-PA,1702,44,0,0,0,44,A
3-PA,1703,44,0,0,0,44,A
3-PA,1704,0,0,0,44,44,C
3-PA,1705,0,0,44,0,44,G
3-PA,1706,0,0,44,0,44,G
3-PA,1707,44,0,0,0,44,A
3-PA,1708,43,0,1,0,44,A
3-PA,1709,0,0,0,44,44,C
3-PA,1710,44,0,0,0,44,A
3-PA,1711,0,44,0,0,44,T
3-PA,1712,0,0,0,43,43,C
3-PA,1713,43,0,0,0,43,A
3-PA,1714,43,0,0,0,43,A
3-PA,1715,43,0,0,0,43,A
3-PA,1716,0,0,44,0,44,G
3-PA,1717,0,0,44,0,44,G
3-PA,1718,0,44,0,0,44,T
3-PA,1719,0,0,0,44,44,C
3-PA,1720,44,0,0,0,44,A
3-PA,1721,44,0,0,0,44,A
3-PA,1722,44,0,0,0,44,A
3-PA,1723,45,0,0,0,45,A
3-PA,1724,0,45,0,0,45,T
3-PA,1725,0,0,44,0,44,G
3-PA,1726,44,0,0,0,44,A
3-PA,1727,44,0,0,0,44,A
3-PA,1728,45,0,0,0,45,A
3-PA,1729,0,45,0,0,45,T
3-PA,1730,0,0,44,0,44,G
3-PA,1731,0,0,44,0,44,G
3-PA,1732,0,0,44,0,44,G
3-PA,1733,0,0,45,0,45,G
3-PA,1734,45,0,0,0,45,A
3-PA,1735,44,0,1,0,45,A
3-PA,1736,0,45,0,0,45,T
3-PA,1737,0,0,45,0,45,G
3-PA,1738,0,0,45,0,45,G
3-PA,1739,42,0,1,0,43,A
3-PA,1740,0,0,44,0,44,G
3-PA,1741,44,0,0,0,44,A
3-PA,1742,0,44,0,0,44,T
3-PA,1743,0,0,44,0,44,G
3-PA,1744,44,0,0,0,44,A
3-PA,1745,0,0,44,0,44,G
3-PA,1746,43,0,0,0,43,A
3-PA,1747,0,0,0,43,43,C
3-PA,1748,0,0,42,0,42,G
3-PA,1749,0,42,0,0,42,T
3-PA,1750,0,43,0,0,43,T
3-PA,1751,0,0,43,0,43,G
3-PA,1752,0,0,0,43,43,C
3-PA,1753,0,0,0,43,43,C
3-PA,1754,0,43,0,0,43,T
3-PA,1755,0,0,0,46,46,C
3-PA,1756,0,0,0,47,47,C
3-PA,1757,0,47,0,0,47,T
3-PA,1758,0,47,0,0,47,T
3-PA,1759,0,0,0,47,47,C
3-PA,1760,46,0,0,0,46,A
3-PA,1761,0,0,46,0,46,G
3-PA,1762,0,46,0,0,46,T
3-PA,1763,0,0,0,47,47,C
3-PA,1764,46,0,0,0,46,A
3-PA,1765,0,0,0,47,47,C
3-PA,1766,0,47,0,0,47,T
3-PA,1767,0,0,0,46,46,C
3-PA,1768,0,0,0,45,45,C
3-PA,1769,47,0,0,0,47,A
3-PA,1770,0,0,48,0,48,G
3-PA,1771,0,0,0,48,48,C
3-PA,1772,48,0,0,0,48,A
3-PA,1773,0,0,48,0,48,G
3-PA,1774,48,0,0,0,48,A
3-PA,1775,0,48,0,0,48,T
3-PA,1776,0,0,0,48,48,C
3-PA,1777,0,0,48,0,48,G
3-PA,1778,48,0,0,0,48,A
3-PA,1779,0,0,48,0,48,G
3-PA,1780,47,0,0,0,47,A
3-PA,1781,0,0,48,0,48,G
3-PA,1782,0,0,0,48,48,C
3-PA,1783,48,0,0,0,48,A
3-PA,1784,0,48,0,0,48,T
3-PA,1785,0,0,48,0,48,G
3-PA,1786,47,0,0,0,47,A
3-PA,1787,0,48,0,0,48,T
3-PA,1788,0,48,0,0,48,T
3-PA,1789,0,0,48,0,48,G
3-PA,1790,47,0,0,0,47,A
3-PA,1791,47,0,0,0,47,A
3-PA,1792,0,0,47,0,47,G
3-PA,1793,0,0,0,46,46,C
3-PA,1794,0,0,0,46,46,C
3-PA,1795,0,0,46,0,46,G
3-PA,1796,46,0,0,0,46,A
3-PA,1797,0,0,46,0,46,G
3-PA,1798,0,46,0,0,46,T
3-PA,1799,0,0,0,45,45,C
3-PA,1800,0,0,0,46,46,C
3-PA,1801,0,46,0,0,46,T
3-PA,1802,0,0,0,46,46,C
3-PA,1803,0,0,46,0,46,G
3-PA,1804,0,0,49,0,49,G
3-PA,1805,0,49,0,0,49,T
3-PA,1806,0,49,0,0,49,T
3-PA,1807,49,0,0,0,49,A
3-PA,1808,49,0,0,0,49,A
3-PA,1809,49,0,0,0,49,A
3-PA,1810,0,0,49,0,49,G
3-PA,1811,48,0,0,0,48,A
3-PA,1812,0,0,48,0,48,G
3-PA,1813,47,0,0,0,47,A
3-PA,1814,48,0,0,0,48,A
3-PA,1815,49,0,0,0,49,A
3-PA,1816,0,0,49,0,49,G
3-PA,1817,49,0,0,0,49,A
3-PA,1818,0,0,0,49,49,C
3-PA,1819,49,0,0,0,49,A
3-PA,1820,0,49,0,0,49,T
3-PA,1821,0,0,49,0,49,G
3-PA,1822,52,0,0,0,52,A
3-PA,1823,0,0,0,52,52,C
3-PA,1824,0,0,0,51,51,C
3-PA,1825,51,0,0,0,51,A
3-PA,1826,51,0,0,0,51,A
3-PA,1827,51,0,0,0,51,A
3-PA,1828,0,0,52,0,52,G
3-PA,1829,52,0,0,0,52,A
3-PA,1830,0,0,52,0,52,G
3-PA,1831,0,52,0,0,52,T
3-PA,1832,0,51,0,0,51,T
3-PA,1833,0,52,0,0,52,T
3-PA,1834,0,49,0,0,49,T
3-PA,1835,0,52,0,0,52,T
3-PA,1836,0,52,0,0,52,T
3-PA,1837,0,0,52,0,52,G
3-PA,1838,51,1,0,0,52,A
3-PA,1839,0,0,52,0,52,G
3-PA,1840,52,0,0,0,52,A
3-PA,1841,52,0,0,0,52,A
3-PA,1842,0,51,0,0,51,T
3-PA,1843,52,0,0,0,52,A
3-PA,1844,53,0,0,0,53,A
3-PA,1845,53,0,0,0,53,A
3-PA,1846,0,53,0,0,53,T
3-PA,1847,0,0,0,53,53,C
3-PA,1848,53,0,0,0,53,A
3-PA,1849,0,0,53,0,53,G
3-PA,1850,53,0,0,0,53,A
3-PA,1851,52,0,0,0,52,A
3-PA,1852,0,0,53,0,53,G
3-PA,1853,1,0,0,52,53,C
3-PA,1854,53,0,0,0,53,A
3-PA,1855,0,52,0,0,52,T
3-PA,1856,0,0,53,0,53,G
3-PA,1857,0,0,53,0,53,G
3-PA,1858,0,0,0,53,53,C
3-PA,1859,0,0,0,54,54,C
3-PA,1860,0,0,0,54,54,C
3-PA,1861,55,0,1,0,56,A
3-PA,1862,0,55,0,0,55,T
3-PA,1863,0,56,0,0,56,T
3-PA,1864,0,0,56,0,56,G
3-PA,1865,0,0,56,0,56,G
3-PA,1866,0,0,54,0,54,G
3-PA,1867,0,0,54,0,54,G
3-PA,1868,53,0,0,0,53,A
3-PA,1869,0,0,53,0,53,G
3-PA,1870,0,52,0,1,53,T
3-PA,1871,0,0,0,54,54,C
3-PA,1872,0,0,0,55,55,C
3-PA,1873,0,0,0,56,56,C
3-PA,1874,0,0,0,56,56,C
3-PA,1875,0,0,0,55,55,C
3-PA,1876,56,0,0,0,56,A
3-PA,1877,56,0,0,0,56,A
3-PA,1878,0,1,55,0,56,G
3-PA,1879,0,0,54,0,54,G
3-PA,1880,0,0,54,0,54,G
3-PA,1881,53,0,0,0,53,A
3-PA,1882,0,0,53,0,53,G
3-PA,1883,0,52,0,0,52,T
3-PA,1884,0,0,53,0,53,G
3-PA,1885,0,0,53,0,53,G
3-PA,1886,53,0,0,0,53,A
3-PA,1887,53,0,0,0,53,A
3-PA,1888,0,0,52,0,52,G
3-PA,1889,53,0,0,0,53,A
3-PA,1890,53,0,0,0,53,A
3-PA,1891,0,0,53,0,53,G
3-PA,1892,0,0,53,0,53,G
3-PA,1893,0,53,0,0,53,T
3-PA,1894,0,52,0,0,52,T
3-PA,1895,0,0,0,52,52,C
3-PA,1896,0,0,0,52,52,C
3-PA,1897,52,0,0,0,52,A
3-PA,1898,0,52,0,0,52,T
3-PA,1899,0,51,0,0,51,T
3-PA,1900,0,0,51,0,51,G
3-PA,1901,0,0,50,0,50,G
3-PA,1902,0,0,51,0,51,G
3-PA,1903,51,0,0,0,51,A
3-PA,1904,50,0,0,0,50,A
3-PA,1905,51,0,0,0,51,A
3-PA,1906,0,0,51,0,51,G
3-PA,1907,0,50,0,0,50,T
3-PA,1908,0,0,0,52,52,C
3-PA,1909,0,52,0,0,52,T
3-PA,1910,0,0,52,0,52,G
3-PA,1911,0,51,0,0,51,T
3-PA,1912,51,0,0,0,51,A
3-PA,1913,0,0,51,0,51,G
3-PA,1914,0,0,51,0,51,G
3-PA,1915,50,0,0,0,50,A
3-PA,1916,0,0,0,50,50,C
3-PA,1917,0,46,0,0,46,T
3-PA,1918,0,0,0,48,48,C
3-PA,1919,0,48,0,0,48,T
3-PA,1920,48,0,0,0,48,A
3-PA,1921,0,48,0,0,48,T
3-PA,1922,0,48,0,0,48,T
3-PA,1923,0,0,48,0,48,G
3-PA,1924,0,0,47,0,47,G
3-PA,1925,0,0,1,47,48,C
3-PA,1926,0,46,0,0,46,T
3-PA,1927,42,0,0,0,42,A
3-PA,1928,42,0,0,0,42,A
3-PA,1929,0,0,42,0,42,G
3-PA,1930,1,41,0,0,42,T
3-PA,1931,0,0,0,42,42,C
3-PA,1932,39,0,0,0,39,A
3-PA,1933,0,0,40,0,40,G
3-PA,1934,0,40,0,0,40,T
3-PA,1935,40,0,0,0,40,A
3-PA,1936,0,40,0,0,40,T
3-PA,1937,0,37,0,0,37,T
3-PA,1938,0,0,0,38,38,C
3-PA,1939,37,0,0,0,37,A
3-PA,1940,37,0,0,0,37,A
3-PA,1941,0,37,0,0,37,T
3-PA,1942,32,0,0,0,32,A
3-PA,1943,0,0,31,0,31,G
3-PA,1944,0,0,0,33,33,C
3-PA,1945,0,0,0,33,33,C
3-PA,1946,0,33,0,0,33,T
3-PA,1947,0,0,34,0,34,G
3-PA,1948,0,34,0,0,34,T
3-PA,1949,35,0,0,0,35,A
3-PA,1950,0,35,0,0,35,T
3-PA,1951,0,0,34,0,34,G
3-PA,1952,0,0,0,33,33,C
3-PA,1953,32,0,0,0,32,A
3-PA,1954,0,32,0,0,32,T
3-PA,1955,0,0,0,32,32,C
3-PA,1956,31,0,0,0,31,A
3-PA,1957,0,0,0,31,31,C
3-PA,1958,0,0,0,31,31,C
3-PA,1959,31,0,0,0,31,A
3-PA,1960,0,0,0,31,31,C
3-PA,1961,30,0,0,0,30,A
3-PA,1962,30,0,0,0,30,A
3-PA,1963,0,30,0,0,30,T
3-PA,1964,0,30,0,0,30,T
3-PA,1965,0,0,30,0,30,G
3-PA,1966,0,0,30,0,30,G
3-PA,1967,30,0,0,0,30,A
3-PA,1968,30,0,0,0,30,A
3-PA,1969,0,0,30,0,30,G
3-PA,1970,0,0,30,0,30,G
3-PA,1971,30,0,0,0,30,A
3-PA,1972,0,30,0,0,30,T
3-PA,1973,0,29,0,0,29,T
3-PA,1974,0,29,0,0,29,T
3-PA,1975,0,29,0,0,29,T
3-PA,1976,0,0,0,29,29,C
3-PA,1977,29,0,0,0,29,A
3-PA,1978,0,0,29,0,29,G
3-PA,1979,0,0,0,29,29,C
3-PA,1980,0,0,29,0,29,G
3-PA,1981,0,0,29,0,29,G
3-PA,1982,29,0,0,0,29,A
3-PA,1983,0,0,29,0,29,G
3-PA,1984,0,29,0,0,29,T
3-PA,1985,0,0,0,31,31,C
3-PA,1986,31,0,0,0,31,A
3-PA,1987,30,1,0,0,31,A
3-PA,1988,0,0,31,0,31,G
3-PA,1989,31,0,0,0,31,A
3-PA,1990,31,0,0,0,31,A
3-PA,1991,32,0,0,0,32,A
3-PA,1992,30,0,0,0,30,A
3-PA,1993,0,0,0,30,30,C
3-PA,1994,0,30,0,0,30,T
3-PA,1995,0,0,30,0,30,G
3-PA,1996,0,0,0,30,30,C
3-PA,1997,0,30,0,0,30,T
3-PA,1998,0,0,0,30,30,C
3-PA,1999,0,0,0,30,30,C
3-PA,2000,0,30,0,0,30,T
3-PA,2001,0,30,0,0,30,T
3-PA,2002,0,0,30,0,30,G
3-PA,2003,0,30,0,0,30,T
3-PA,2004,0,29,0,0,29,T
3-PA,2005,0,0,30,0,30,G
3-PA,2006,0,30,0,0,30,T
3-PA,2007,0,30,0,0,30,T
3-PA,2008,0,0,0,30,30,C
3-PA,2009,28,0,0,0,28,A
3-PA,2010,0,0,29,0,29,G
3-PA,2011,0,0,29,0,29,G
3-PA,2012,0,0,0,29,29,C
3-PA,2013,0,29,0,0,29,T
3-PA,2014,0,0,0,29,29,C
3-PA,2015,0,29,0,0,29,T
3-PA,2016,0,29,0,0,29,T
3-PA,2017,29,0,0,0,29,A
3-PA,2018,0,0,29,0,29,G
3-PA,2019,0,0,28,0,28,G
3-PA,2020,0,0,28,0,28,G
3-PA,2021,28,0,0,0,28,A
3-PA,2022,0,0,0,28,28,C
3-PA,2023,26,0,0,0,26,A
3-PA,2024,27,0,0,0,27,A
3-PA,2025,0,0,0,27,27,C
3-PA,2026,0,0,0,27,27,C
3-PA,2027,0,27,0,0,27,T
3-PA,2028,0,0,0,27,27,C
3-PA,2029,0,0,27,0,27,G
3-PA,2030,27,0,0,0,27,A
3-PA,2031,27,0,0,0,27,A
3-PA,2032,0,0,0,27,27,C
3-PA,2033,0,0,0,26,26,C
3-PA,2034,0,25,0,0,25,T
3-PA,2035,0,0,25,0,25,G
3-PA,2036,0,0,25,0,25,G
3-PA,2037,0,0,25,0,25,G
3-PA,2038,25,0,0,0,25,A
3-PA,2039,0,0,0,25,25,C
3-PA,2040,0,0,0,25,25,C
3-PA,2041,0,22,0,0,22,T
3-PA,2042,0,22,0,0,22,T
3-PA,2043,0,22,0,0,22,T
3-PA,2044,0,0,22,0,22,G
3-PA,2045,21,0,0,0,21,A
3-PA,2046,0,22,0,0,22,T
3-PA,2047,0,0,0,22,22,C
3-PA,2048,0,22,0,0,22,T
3-PA,2049,0,22,0,0,22,T
3-PA,2050,0,0,22,0,22,G
3-PA,2051,0,0,22,0,22,G
3-PA,2052,0,0,22,0,22,G
3-PA,2053,0,0,22,0,22,G
3-PA,2054,0,0,22,0,22,G
3-PA,2055,0,0,21,0,21,G
3-PA,2056,0,0,0,21,21,C
3-PA,2057,1,19,0,0,20,T
3-PA,2058,20,0,0,0,20,A
3-PA,2059,0,20,0,0,20,T
3-PA,2060,20,0,0,0,20,A
3-PA,2061,0,20,0,0,20,T
3-PA,2062,0,0,19,0,19,G
3-PA,2063,18,0,0,0,18,A
3-PA,2064,18,0,0,0,18,A
3-PA,2065,0,0,18,0,18,G
3-PA,2066,0,0,0,18,18,C
3-PA,2067,14,0,0,0,14,A
3-PA,2068,14,0,0,0,14,A
3-PA,2069,0,14,0,0,14,T
3-PA,2070,0,14,0,0,14,T
3-PA,2071,0,0,14,0,14,G
3-PA,2072,14,0,0,0,14,A
3-PA,2073,0,0,14,0,14,G
3-PA,2074,0,0,14,0,14,G
3-PA,2075,14,0,0,0,14,A
3-PA,2076,0,0,14,0,14,G
3-PA,2077,0,13,0,0,13,T
3-PA,2078,0,0,13,0,13,G
3-PA,2079,0,0,0,13,13,C
3-PA,2080,0,0,0,13,13,C
3-PA,2081,0,13,0,0,13,T
3-PA,2082,0,0,13,0,13,G
3-PA,2083,13,0,0,0,13,A
3-PA,2084,0,13,0,0,13,T
3-PA,2085,0,13,0,0,13,T
3-PA,2086,13,0,0,0,13,A
3-PA,2087,13,0,0,0,13,A
3-PA,2088,0,11,0,0,11,T
3-PA,2089,0,1,10,0,11,G
3-PA,2090,11,0,0,0,11,A
3-PA,2091,0,8,0,0,8,T
3-PA,2092,0,0,0,8,8,C
3-PA,2093,0,0,0,8,8,C
3-PA,2094,0,0,0,8,8,C
3-PA,2095,0,8,0,0,8,T
3-PA,2096,0,0,8,0,8,G
3-PA,2097,0,0,8,0,8,G
3-PA,2098,0,0,8,0,8,G
3-PA,2099,0,8,0,0,8,T
3-PA,2100,0,8,0,0,8,T
3-PA,2101,0,8,0,0,8,T
3-PA,2102,0,8,0,0,8,T
3-PA,2103,0,0,8,0,8,G
3-PA,2104,0,0,0,8,8,C
3-PA,2105,0,8,0,0,8,T
3-PA,2106,0,0,0,8,8,C
3-PA,2107,7,0,0,0,7,A
3-PA,2108,7,0,0,0,7,A
3-PA,2109,0,7,0,0,7,T
3-PA,2110,0,0,7,0,7,G
3-PA,2111,0,0,0,7,7,C
3-PA,2112,0,0,7,0,7,G
3-PA,2113,0,7,0,0,7,T
3-PA,2114,0,0,0,7,7,C
3-PA,2115,0,7,0,0,7,T
3-PA,2116,0,7,0,0,7,T
3-PA,2117,0,0,7,0,7,G
3-PA,2118,0,0,7,0,7,G
3-PA,2119,0,7,0,0,7,T
3-PA,2120,0,7,0,0,7,T
3-PA,2121,0,0,0,7,7,C
3-PA,2122,7,0,0,0,7,A
3-PA,2123,7,0,0,0,7,A
3-PA,2124,0,0,0,7,7,C
3-PA,2125,0,7,0,0,7,T
3-PA,2126,0,0,0,7,7,C
3-PA,2127,0,0,0,7,7,C
3-PA,2128,0,7,0,0,7,T
3-PA,2129,0,7,0,0,7,T
3-PA,2130,0,0,0,7,7,C
3-PA,2131,0,0,0,7,7,C
3-PA,2132,0,7,0,0,7,T
3-PA,2133,0,0,7,0,7,G
3-PA,2134,7,0,0,0,7,A
3-PA,2135,0,0,0,7,7,C
3-PA,2136,7,0,0,0,7,A
3-PA,2137,0,0,0,6,6,C
3-PA,2138,6,0,0,0,6,A
3-PA,2139,0,6,0,0,6,T
3-PA,2140,0,0,6,0,6,G
3-PA,2141,0,0,0,6,6,C
3-PA,2142,6,0,0,0,6,A
3-PA,2143,0,6,0,0,6,T
3-PA,2144,0,6,0,0,6,T
3-PA,2145,6,0,0,0,6,A
3-PA,2146,6,0,0,0,6,A
3-PA,2147,6,0,0,0,6,A
3-PA,2148,6,0,0,0,6,A
3-PA,2149,0,6,0,0,6,T
3-PA,2150,5,0,0,0,5,A
3-PA,2151,0,0,5,0,5,G
4-HA,1,93,0,0,0,93,A
4-HA,2,0,93,0,0,93,T
4-HA,3,0,0,95,0,95,G
4-HA,4,98,0,0,0,98,A
4-HA,5,99,0,0,0,99,A
4-HA,6,0,0,103,0,103,G
4-HA,7,104,0,0,0,104,A
4-HA,8,1,0,0,109,110,C
4-HA,9,0,110,0,0,110,T
4-HA,10,114,0,0,0,114,A
4-HA,11,0,123,0,0,123,T
4-HA,12,0,0,0,125,125,C
4-HA,13,124,0,1,0,125,A
4-HA,14,0,125,0,0,125,T
4-HA,15,0,125,0,0,125,T
4-HA,16,0,0,137,0,137,G
4-HA,17,0,0,1,136,137,C
4-HA,18,0,137,0,0,137,T
4-HA,19,0,136,0,0,136,T
4-HA,20,0,137,0,0,137,T
4-HA,21,0,0,149,0,149,G
4-HA,22,147,0,1,0,148,A
4-HA,23,0,0,152,0,152,G
4-HA,24,0,0,0,152,152,C
4-HA,25,0,152,0,0,152,T
4-HA,26,167,0,0,0,167,A
4-HA,27,0,0,0,169,169,C
4-HA,28,172,0,0,0,172,A
4-HA,29,0,183,0,0,183,T
4-HA,30,0,183,0,0,183,T
4-HA,31,0,0,0,183,183,C
4-HA,32,0,182,0,0,182,T
4-HA,33,187,0,0,0,187,A
4-HA,34,0,187,0,0,187,T
4-HA,35,0,0,188,0,188,G
4-HA,36,0,187,0,0,187,T
4-HA,37,0,0,0,187,187,C
4-HA,38,0,185,0,1,186,T
4-HA,39,0,0,185,0,185,G
4-HA,40,0,0,186,0,186,G
4-HA,41,0,186,0,0,186,T
4-HA,42,0,188,0,0,188,T
4-HA,43,0,189,0,0,189,T
4-HA,44,0,189,0,0,189,T
4-HA,45,0,0,0,189,189,C
4-HA,46,0,0,189,0,189,G
4-HA,47,0,0,0,191,191,C
4-HA,48,0,190,0,0,190,T
4-HA,49,1,0,0,193,194,C
4-HA,50,194,0,0,0,194,A
4-HA,51,195,0,0,0,195,A
4-HA,52,195,0,0,0,195,A
4-HA,53,194,1,0,0,195,A
4-HA,54,195,0,0,0,195,A
4-HA,55,0,0,0,196,196,C
4-HA,56,0,195,0,0,195,T
4-HA,57,0,196,0,0,196,T
4-HA,58,0,0,0,196,196,C
4-HA,59,0,0,0,196,196,C
4-HA,60,0,195,0,0,195,T
4-HA,61,0,0,198,0,198,G
4-HA,62,0,0,199,0,199,G
4-HA,63,201,0,0,0,201,A
4-HA,64,207,0,0,0,207,A
4-HA,65,208,0,0,0,208,A
4-HA,66,0,211,0,0,211,T
4-HA,67,0,0,215,0,215,G
4-HA,68,215,0,0,0,215,A
4-HA,69,0,0,0,219,219,C
4-HA,70,217,0,0,0,217,A
4-HA,71,217,0,1,0,218,A
4-HA,72,0,0,0,221,221,C
4-HA,73,219,0,1,0,220,A
4-HA,74,0,0,221,0,221,G
4-HA,75,0,0,0,220,220,C
4-HA,76,221,0,0,0,221,A
4-HA,77,0,0,0,228,228,C
4-HA,78,0,0,228,0,228,G
4-HA,79,0,0,229,0,229,G
4-HA,80,0,0,0,230,230,C
4-HA,81,230,0,0,0,230,A
4-HA,82,232,0,0,0,232,A
4-HA,83,0,1,0,231,232,C
4-HA,84,0,0,237,0,237,G
4-HA,85,0,0,0,238,238,C
4-HA,86,0,231,0,0,231,T
4-HA,87,0,0,237,0,237,G
4-HA,88,0,237,0,0,237,T
4-HA,89,0,0,240,0,240,G
4-HA,90,0,0,0,238,238,C
4-HA,91,0,0,0,242,242,C
4-HA,92,0,241,0,0,241,T
4-HA,93,0,241,0,0,241,T
4-HA,94,0,0,240,0,240,G
4-HA,95,0,1,240,0,241,G
4-HA,96,0,238,0,0,238,T
4-HA,97,0,0,0,246,246,C
4-HA,98,247,0,0,0,247,A
4-HA,99,0,0,0,250,250,C
4-HA,100,0,0,0,250,250,C
4-HA,101,268,0,0,0,268,A
4-HA,102,0,267,0,1,268,T
4-HA,103,0,0,270,0,270,G
4-HA,104,0,0,0,269,269,C
4-HA,105,262,1,1,0,264,A
4-HA,106,0,0,286,0,286,G
4-HA,107,0,287,0,0,287,T
4-HA,108,289,0,0,0,289,A
4-HA,109,0,0,0,287,287,C
4-HA,110,0,0,0,288,288,C
4-HA,111,288,0,0,0,288,A
4-HA,112,286,0,0,0,286,A
4-HA,113,287,0,0,0,287,A
4-HA,114,0,0,0,287,287,C
4-HA,115,0,0,284,0,284,G
4-HA,116,0,0,286,0,286,G
4-HA,117,286,0,0,0,286,A
4-HA,118,288,0,0,0,288,A
4-HA,119,0,0,0,288,288,C
4-HA,120,0,0,287,0,287,G
4-HA,121,0,0,287,0,287,G
4-HA,122,0,296,0,1,297,T
4-HA,123,300,0,0,0,300,A
4-HA,124,0,0,300,0,300,G
4-HA,125,0,302,0,0,302,T
4-HA,126,0,0,302,0,302,G
4-HA,127,302,0,0,0,302,A
4-HA,128,302,0,0,0,302,A
4-HA,129,302,0,0,0,302,A
4-HA,130,300,0,0,0,300,A
4-HA,131,0,0,0,302,302,C
4-HA,132,302,0,0,0,302,A
4-HA,133,302,0,0,0,302,A
4-HA,134,0,303,0,0,303,T
4-HA,135,0,0,0,303,303,C
4-HA,136,302,0,0,0,302,A
4-HA,137,0,0,0,302,302,C
4-HA,138,0,0,302,0,302,G
4-HA,139,301,0,0,0,301,A
4-HA,140,301,0,0,0,301,A
4-HA,141,0,301,0,0,301,T
4-HA,142,0,0,300,0,300,G
4-HA,143,305,0,1,0,306,A
4-HA,144,0,0,0,307,307,C
4-HA,145,0,0,0,306,306,C
4-HA,146,310,0,0,0,310,A
4-HA,147,311,0,0,0,311,A
4-HA,148,311,0,0,0,311,A
4-HA,149,0,310,0,0,310,T
4-HA,150,0,310,0,0,310,T
4-HA,151,0,0,314,0,314,G
4-HA,152,314,0,0,0,314,A
4-HA,153,314,0,1,0,315,A
4-HA,154,0,0,315,0,315,G
4-HA,155,0,313,0,0,313,T
4-HA,156,0,320,0,0,320,T
4-HA,157,321,0,0,0,321,A
4-HA,158,0,0,0,324,324,C
4-HA,159,0,324,0,0,324,T
4-HA,160,320,0,1,0,321,A
4-HA,161,327,0,0,0,327,A
4-HA,162,0,327,0,0,327,T
4-HA,163,0,0,326,0,326,G
4-HA,164,0,0,0,335,335,C
4-HA,165,0,334,0,0,334,T
4-HA,166,335,0,0,0,335,A
4-HA,167,0,0,0,334,334,C
4-HA,168,1,332,0,0,333,T
4-HA,169,0,0,336,0,336,G
4-HA,170,328,1,1,0,330,A
4-HA,171,0,0,330,0,330,G
4-HA,172,0,0,0,329,329,C
4-HA,173,0,324,0,1,325,T
4-HA,174,0,1,331,0,332,G
4-HA,175,0,0,339,0,339,G
4-HA,176,0,338,0,0,338,T
4-HA,177,0,339,0,0,339,T
4-HA,178,0,0,0,339,339,C
4-HA,179,336,0,1,0,337,A
4-HA,180,0,0,337,0,337,G
4-HA,181,335,0,0,0,335,A
4-HA,182,0,0,342,0,342,G
4-HA,183,0,340,0,0,340,T
4-HA,184,1,330,0,2,333,T
4-HA,185,0,0,0,334,334,C
4-HA,186,0,0,0,334,334,C
4-HA,187,0,334,0,0,334,T
4-HA,188,1,0,0,336,337,C
4-HA,189,337,0,0,0,337,A
4-HA,190,336,1,0,0,337,A
4-HA,191,0,0,0,336,336,C
4-HA,192,325,0,0,0,325,A
4-HA,193,0,0,330,0,330,G
4-HA,194,0,0,329,0,329,G
4-HA,195,0,326,0,0,326,T
4-HA,196,0,0,325,0,325,G
4-HA,197,328,0,0,0,328,A
4-HA,198,328,0,0,0,328,A
4-HA,199,340,0,0,0,340,A
4-HA,200,0,340,0,1,341,T
4-HA,201,346,0,0,0,346,A
4-HA,202,0,341,0,0,341,T
4-HA,203,0,0,340,0,340,G
4-HA,204,0,0,0,342,342,C
4-HA,205,0,0,341,0,341,G
4-HA,206,340,0,1,0,341,A
4-HA,207,0,0,0,340,340,C
4-HA,208,336,0,0,0,336,A
4-HA,209,0,0,356,0,356,G
4-HA,210,0,354,0,1,355,T
4-HA,211,0,0,0,359,359,C
4-HA,212,0,1,0,359,360,C
4-HA,213,1,351,0,2,354,T
4-HA,214,0,0,0,364,364,C
4-HA,215,364,0,1,0,365,A
4-HA,216,0,364,0,0,364,T
4-HA,217,0,0,0,366,366,C
4-HA,218,352,0,0,0,352,A
4-HA,219,0,0,350,0,350,G
4-HA,220,348,1,0,0,349,A
4-HA,221,0,349,0,1,350,T
4-HA,222,0,0,0,349,349,C
4-HA,223,1,0,0,342,343,C
4-HA,224,0,342,0,0,342,T
4-HA,225,0,341,0,0,341,T
4-HA,226,0,0,342,0,342,G
4-HA,227,343,0,0,0,343,A
4-HA,228,0,342,0,0,342,T
4-HA,229,0,0,344,0,344,G
4-HA,230,0,0,344,0,344,G
4-HA,231,345,0,0,0,345,A
4-HA,232,344,0,0,0,344,A
4-HA,233,346,0,0,0,346,A
4-HA,234,345,0,0,0,345,A
4-HA,235,344,0,1,0,345,A
4-HA,236,345,0,0,0,345,A
4-HA,237,0,0,0,347,347,C
4-HA,238,0,346,0,0,346,T
4-HA,239,0,0,346,0,346,G
4-HA,240,0,0,0,344,344,C
4-HA,241,346,0,0,0,346,A
4-HA,242,0,0,0,358,358,C
4-HA,243,355,0,0,0,355,A
4-HA,244,2,0,0,407,409,C
4-HA,245,0,412,0,0,412,T
4-HA,246,412,0,0,0,412,A
4-HA,247,411,0,0,0,411,A
4-HA,248,0,409,0,0,409,T
4-HA,249,409,0,0,0,409,A
4-HA,250,0,0,413,0,413,G
4-HA,251,411,0,0,0,411,A
4-HA,252,0,406,0,0,406,T
4-HA,253,0,0,386,0,386,G
4-HA,254,0,0,0,387,387,C
4-HA,255,0,386,0,0,386,T
4-HA,256,0,0,0,409,409,C
4-HA,257,0,410,0,0,410,T
4-HA,258,425,0,0,0,425,A
4-HA,259,0,425,0,0,425,T
4-HA,260,0,422,0,0,422,T
4-HA,261,0,0,429,0,429,G
4-HA,262,0,0,429,0,429,G
4-HA,263,0,0,425,0,425,G
4-HA,264,424,0,0,0,424,A
4-HA,265,0,0,423,0,423,G
4-HA,266,410,0,2,0,412,A
4-HA,267,0,0,0,451,451,C
4-HA,268,1,1,0,459,461,C
4-HA,269,0,0,0,464,464,C
4-HA,270,0,465,0,0,465,T
4-HA,271,1,0,0,478,479,C
4-HA,272,479,0,0,0,479,A
4-HA,273,0,0,520,0,520,G
4-HA,274,0,520,0,1,521,T
4-HA,275,0,1,525,0,526,G
4-HA,276,1,505,0,1,507,T
4-HA,277,1,0,503,0,504,G
4-HA,278,503,2,0,0,505,A
4-HA,279,0,505,0,0,505,T
4-HA,280,0,0,501,0,501,G
4-HA,281,0,0,503,0,503,G
4-HA,282,0,0,0,499,499,C
4-HA,283,0,494,0,3,497,T
4-HA,284,0,494,0,1,495,T
4-HA,285,1,0,0,496,497,C
4-HA,286,1,0,0,496,497,C
4-HA,287,497,0,0,0,497,A
4-HA,288,499,0,1,0,500,A
4-HA,289,497,0,2,0,499,A
4-HA,290,499,0,0,0,499,A
4-HA,291,0,503,0,0,503,T
4-HA,292,501,0,0,0,501,A
4-HA,293,503,0,0,0,503,A
4-HA,294,0,0,507,0,507,G
4-HA,295,511,0,0,0,511,A
4-HA,296,512,0,0,0,512,A
4-HA,297,511,1,0,0,512,A
4-HA,298,0,513,0,0,513,T
4-HA,299,0,0,511,0,511,G
4-HA,300,1,0,510,0,511,G
4-HA,301,0,0,507,0,507,G
4-HA,302,512,0,0,0,512,A
4-HA,303,1,0,0,510,511,C
4-HA,304,0,0,0,511,511,C
4-HA,305,0,517,0,0,517,T
4-HA,306,0,519,1,0,520,T
4-HA,307,0,516,0,1,517,T
4-HA,308,0,520,0,0,520,T
4-HA,309,0,519,1,0,520,T
4-HA,310,0,0,523,0,523,G
4-HA,311,0,521,0,1,522,T
4-HA,312,0,520,0,0,520,T
4-HA,313,0,1,518,0,519,G
4-HA,314,517,0,0,0,517,A
4-HA,315,520,0,0,0,520,A
4-HA,316,0,0,0,520,520,C
4-HA,317,0,0,517,0,517,G
4-HA,318,0,0,0,521,521,C
4-HA,319,521,0,0,0,521,A
4-HA,320,0,0,521,0,521,G
4-HA,321,0,0,0,521,521,C
4-HA,322,520,0,0,0,520,A
4-HA,323,523,0,0,0,523,A
4-HA,324,523,0,0,0,523,A
4-HA,325,0,0,553,0,553,G
4-HA,326,0,0,0,556,556,C
4-HA,327,0,0,0,552,552,C
4-HA,328,0,554,0,0,554,T
4-HA,329,553,0,0,0,553,A
4-HA,330,0,0,0,558,558,C
4-HA,331,558,0,0,0,558,A
4-HA,332,0,0,562,0,562,G
4-HA,333,0,0,0,556,556,C
4-HA,334,550,0,0,0,550,A
4-HA,335,551,0,1,0,552,A
4-HA,336,0,0,0,579,579,C
4-HA,337,0,578,0,1,579,T
4-HA,338,0,0,583,0,583,G
4-HA,339,1,575,0,0,576,T
4-HA,340,0,577,0,1,578,T
4-HA,341,579,0,0,0,579,A
4-HA,342,1,0,0,633,634,C
4-HA,343,0,0,0,637,637,C
4-HA,344,2,0,0,659,661,C
4-HA,345,0,643,0,0,643,T
4-HA,346,0,642,0,0,642,T
4-HA,347,649,0,0,0,649,A
4-HA,348,0,646,0,0,646,T
4-HA,349,0,0,647,0,647,G
4-HA,350,644,0,0,0,644,A
4-HA,351,0,605,0,0,605,T
4-HA,352,0,1,611,0,612,G
4-HA,353,0,600,0,0,600,T
4-HA,354,0,0,592,0,592,G
4-HA,355,0,1,0,596,597,C
4-HA,356,0,0,0,598,598,C
4-HA,357,2,0,601,0,603,G
4-HA,358,0,0,616,1,617,G
4-HA,359,614,0,0,0,614,A
4-HA,360,0,616,0,0,616,T
4-HA,361,0,609,0,0,609,T
4-HA,362,610,0,0,0,610,A
4-HA,363,0,604,0,0,604,T
4-HA,364,0,0,613,0,613,G
4-HA,365,0,0,0,613,613,C
4-HA,366,0,0,0,612,612,C
4-HA,367,0,617,0,1,618,T
4-HA,368,0,0,0,642,642,C
4-HA,369,0,0,0,651,651,C
4-HA,370,2,0,0,649,651,C
4-HA,371,0,649,0,0,649,T
4-HA,372,0,647,0,0,647,T
4-HA,373,644,0,0,0,644,A
4-HA,374,0,0,655,0,655,G
4-HA,375,1,0,657,0,658,G
4-HA,376,0,646,0,2,648,T
4-HA,377,0,0,0,631,631,C
4-HA,378,623,0,0,0,623,A
4-HA,379,0,1,0,647,648,C
4-HA,380,0,650,0,0,650,T
4-HA,381,648,0,1,0,649,A
4-HA,382,0,0,647,0,647,G
4-HA,383,0,637,0,0,637,T
4-HA,384,0,634,0,0,634,T
4-HA,385,0,0,641,0,641,G
4-HA,386,0,1,0,641,642,C
4-HA,387,0,0,1,643,644,C
4-HA,388,0,634,1,0,635,T
4-HA,389,0,0,0,637,637,C
4-HA,390,660,0,0,0,660,A
4-HA,391,0,661,0,1,662,T
4-HA,392,0,0,0,666,666,C
4-HA,393,0,3,0,663,666,C
4-HA,394,0,1,660,0,661,G
4-HA,395,1,0,668,0,669,G
4-HA,396,0,0,0,671,671,C
4-HA,397,674,0,0,0,674,A
4-HA,398,0,1,0,683,684,C
4-HA,399,674,0,0,0,674,A
4-HA,400,0,0,0,677,677,C
4-HA,401,0,677,0,0,677,T
4-HA,402,0,0,685,0,685,G
4-HA,403,1,1,688,0,690,G
4-HA,404,685,0,0,0,685,A
4-HA,405,0,0,693,0,693,G
4-HA,406,0,689,0,1,690,T
4-HA,407,0,684,0,0,684,T
4-HA,408,0,683,0,2,685,T
4-HA,409,681,0,1,0,682,A
4-HA,410,684,0,1,1,686,A
4-HA,411,0,0,0,689,689,C
4-HA,412,677,0,0,0,677,A
4-HA,413,679,0,1,1,681,A
4-HA,414,0,671,0,0,671,T
4-HA,415,0,0,672,0,672,G
4-HA,416,672,0,0,0,672,A
4-HA,417,666,0,1,1,668,A
4-HA,418,671,0,0,1,672,A
4-HA,419,0,0,672,0,672,G
4-HA,420,0,0,0,683,683,C
4-HA,421,0,682,0,0,682,T
4-HA,422,0,683,0,0,683,T
4-HA,423,0,0,0,694,694,C
4-HA,424,690,0,0,0,690,A
4-HA,425,692,0,0,1,693,A
4-HA,426,0,695,0,0,695,T
4-HA,427,0,694,0,0,694,T
4-HA,428,0,1,710,0,711,G
4-HA,429,1,0,724,0,725,G
4-HA,430,727,0,1,0,728,A
4-HA,431,0,0,0,725,725,C
4-HA,432,0,723,0,0,723,T
4-HA,433,0,0,722,0,722,G
4-HA,434,1,0,723,0,724,G
4-HA,435,724,0,0,0,724,A
4-HA,436,0,0,726,0,726,G
4-HA,437,0,708,0,0,708,T
4-HA,438,0,1,0,694,695,C
4-HA,439,697,0,5,0,702,A
4-HA,440,0,0,0,706,706,C
4-HA,441,0,702,0,0,702,T
4-HA,442,0,1,0,700,701,C
4-HA,443,692,0,0,0,692,A
4-HA,444,701,0,0,0,701,A
4-HA,445,699,0,1,0,700,A
4-HA,446,702,0,0,0,702,A
4-HA,447,0,1,0,700,701,C
4-HA,448,0,1,692,0,693,G
4-HA,449,0,0,705,0,705,G
4-HA,450,705,0,0,0,705,A
4-HA,451,704,0,0,0,704,A
4-HA,452,0,0,0,705,705,C
4-HA,453,697,0,4,0,701,A
4-HA,454,704,0,0,0,704,A
4-HA,455,0,0,706,0,706,G
4-HA,456,0,0,0,705,705,C
4-HA,457,0,699,0,1,700,T
4-HA,458,1,0,0,699,700,C
4-HA,459,0,699,0,0,699,T
4-HA,460,0,0,701,0,701,G
4-HA,461,0,0,0,696,696,C
4-HA,462,0,699,0,0,699,T
4-HA,463,0,706,0,0,706,T
4-HA,464,1,1,714,0,716,G
4-HA,465,0,1,0,724,725,C
4-HA,466,727,0,0,0,727,A
4-HA,467,0,722,0,0,722,T
4-HA,468,716,1,0,0,717,A
4-HA,469,713,1,0,0,714,A
4-HA,470,0,0,712,0,712,G
4-HA,471,1,0,711,0,712,G
4-HA,472,688,0,2,0,690,A
4-HA,473,0,0,683,0,683,G
4-HA,474,677,0,1,0,678,A
4-HA,475,0,701,1,0,702,T
4-HA,476,0,0,0,706,706,C
4-HA,477,0,706,0,0,706,T
4-HA,478,707,0,0,0,707,A
4-HA,479,707,0,0,0,707,A
4-HA,480,699,0,1,0,700,A
4-HA,481,703,0,0,0,703,A
4-HA,482,702,0,0,1,703,A
4-HA,483,0,1,0,702,703,C
4-HA,484,686,0,0,0,686,A
4-HA,485,1,1,688,0,690,G
4-HA,486,0,688,0,0,688,T
4-HA,487,0,707,0,1,708,T
4-HA,488,0,709,0,1,710,T
4-HA,489,0,0,0,724,724,C
4-HA,490,0,718,0,2,720,T
4-HA,491,0,727,0,0,727,T
4-HA,492,0,725,0,1,726,T
4-HA,493,723,0,0,0,723,A
4-HA,494,0,0,723,0,723,G
4-HA,495,0,722,0,0,722,T
4-HA,496,710,0,1,0,711,A
4-HA,497,0,0,715,0,715,G
4-HA,498,703,0,0,0,703,A
4-HA,499,0,703,0,0,703,T
4-HA,500,0,705,0,0,705,T
4-HA,501,0,0,717,0,717,G
4-HA,502,715,0,0,0,715,A
4-HA,503,713,0,0,0,713,A
4-HA,504,1,712,0,1,714,T
4-HA,505,0,712,0,0,712,T
4-HA,506,0,0,712,0,712,G
4-HA,507,0,0,713,0,713,G
4-HA,508,0,715,0,0,715,T
4-HA,509,0,713,0,0,713,T
4-HA,510,0,1,708,0,709,G
4-HA,511,714,0,0,0,714,A
4-HA,512,0,0,1,705,706,C
4-HA,513,0,0,0,708,708,C
4-HA,514,2,0,0,713,715,C
4-HA,515,711,0,1,0,712,A
4-HA,516,0,1,0,716,717,C
4-HA,517,0,716,0,0,716,T
4-HA,518,0,719,0,0,719,T
4-HA,519,718,0,0,0,718,A
4-HA,520,714,0,0,0,714,A
4-HA,521,714,0,0,0,714,A
4-HA,522,0,0,0,701,701,C
4-HA,523,0,715,0,0,715,T
4-HA,524,0,719,0,0,719,T
4-HA,525,0,0,0,730,730,C
4-HA,526,730,0,0,0,730,A
4-HA,527,730,0,0,0,730,A
4-HA,528,731,0,0,0,731,A
4-HA,529,0,731,0,0,731,T
4-HA,530,743,0,1,0,744,A
4-HA,531,0,0,0,744,744,C
4-HA,532,1,0,0,721,722,C
4-HA,533,0,0,0,724,724,C
4-HA,534,722,0,0,0,722,A
4-HA,535,0,0,745,0,745,G
4-HA,536,0,0,0,749,749,C
4-HA,537,746,0,0,0,746,A
4-HA,538,0,747,0,0,747,T
4-HA,539,0,737,0,0,737,T
4-HA,540,0,0,765,0,765,G
4-HA,541,768,0,1,0,769,A
4-HA,542,771,0,0,0,771,A
4-HA,543,0,0,0,773,773,C
4-HA,544,0,0,755,0,755,G
4-HA,545,1,762,0,1,764,T
4-HA,546,0,1,766,0,767,G
4-HA,547,767,0,1,0,768,A
4-HA,548,0,0,0,768,768,C
4-HA,549,0,751,0,0,751,T
4-HA,550,767,0,0,0,767,A
4-HA,551,0,768,0,0,768,T
4-HA,552,0,0,779,0,779,G
4-HA,553,0,1,0,778,779,C
4-HA,554,0,1,0,763,764,C
4-HA,555,759,0,0,0,759,A
4-HA,556,761,0,0,0,761,A
4-HA,557,766,0,1,0,767,A
4-HA,558,0,0,0,767,767,C
4-HA,559,745,0,0,0,745,A
4-HA,560,743,0,0,0,743,A
4-HA,561,0,738,0,0,738,T
4-HA,562,0,1,743,0,744,G
4-HA,563,744,1,0,0,745,A
4-HA,564,741,0,0,0,741,A
4-HA,565,0,0,0,736,736,C
4-HA,566,738,0,6,0,744,A
4-HA,567,749,0,0,0,749,A
4-HA,568,0,747,0,0,747,T
4-HA,569,0,745,0,0,745,T
4-HA,570,0,745,0,0,745,T
4-HA,571,0,1,745,0,746,G
4-HA,572,747,0,1,0,748,A
4-HA,573,0,0,0,745,745,C
4-HA,574,747,0,0,0,747,A
4-HA,575,748,0,0,0,748,A
4-HA,576,761,0,0,0,761,A
4-HA,577,0,768,0,0,768,T
4-HA,578,0,762,0,0,762,T
4-HA,579,0,0,764,0,764,G
4-HA,580,0,761,0,1,762,T
4-HA,581,766,0,0,0,766,A
4-HA,582,0,1,0,776,777,C
4-HA,583,782,0,0,0,782,A
4-HA,584,0,791,0,0,791,T
4-HA,585,0,783,0,0,783,T
4-HA,586,1,786,0,0,787,T
4-HA,587,0,0,783,0,783,G
4-HA,588,0,1,783,0,784,G
4-HA,589,0,1,783,0,784,G
4-HA,590,1,0,780,0,781,G
4-HA,591,0,0,773,0,773,G
4-HA,592,1,0,791,0,792,G
4-HA,593,0,778,1,0,779,T
4-HA,594,0,783,0,3,786,T
4-HA,595,0,0,1,783,784,C
4-HA,596,786,0,0,2,788,A
4-HA,597,0,1,0,784,785,C
4-HA,598,0,0,0,789,789,C
4-HA,599,788,0,0,0,788,A
4-HA,600,0,0,0,788,788,C
4-HA,601,0,0,0,786,786,C
4-HA,602,1,1,0,785,787,C
4-HA,603,0,2,785,0,787,G
4-HA,604,0,1,798,0,799,G
4-HA,605,0,0,806,0,806,G
4-HA,606,1,802,0,0,803,T
4-HA,607,805,0,0,0,805,A
4-HA,608,0,0,0,797,797,C
4-HA,609,0,0,791,0,791,G
4-HA,610,0,0,802,0,802,G
4-HA,611,798,0,0,0,798,A
4-HA,612,0,1,0,796,797,C
4-HA,613,775,0,0,0,775,A
4-HA,614,773,0,0,0,773,A
4-HA,615,768,0,0,0,768,A
4-HA,616,0,0,790,0,790,G
4-HA,617,788,0,3,0,791,A
4-HA,618,1,0,0,786,787,C
4-HA,619,1,0,0,774,775,C
4-HA,620,779,1,0,0,780,A
4-HA,621,782,0,0,0,782,A
4-HA,622,796,0,0,0,796,A
4-HA,623,0,798,0,0,798,T
4-HA,624,0,0,0,805,805,C
4-HA,625,0,776,0,1,777,T
4-HA,626,0,781,0,0,781,T
4-HA,627,0,0,0,784,784,C
4-HA,628,0,0,0,789,789,C
4-HA,629,0,784,0,1,785,T
4-HA,630,0,0,787,0,787,G
4-HA,631,0,776,0,0,776,T
4-HA,632,784,0,0,0,784,A
4-HA,633,0,778,0,0,778,T
4-HA,634,1,0,780,0,781,G
4-HA,635,1,1,0,775,777,C
4-HA,636,0,775,0,0,775,T
4-HA,637,1,1,0,776,778,C
4-HA,638,778,0,2,0,780,A
4-HA,639,777,0,0,0,777,A
4-HA,640,0,0,779,0,779,G
4-HA,641,0,2,0,778,780,C
4-HA,642,780,0,0,0,780,A
4-HA,643,0,773,0,0,773,T
4-HA,644,0,0,0,774,774,C
4-HA,645,773,0,0,0,773,A
4-HA,646,1,1,777,0,779,G
4-HA,647,0,0,779,0,779,G
4-HA,648,777,0,0,0,777,A
4-HA,649,769,0,1,1,771,A
4-HA,650,0,0,782,0,782,G
4-HA,651,782,0,0,0,782,A
4-HA,652,785,1,2,0,788,A
4-HA,653,0,793,0,1,794,T
4-HA,654,0,0,0,795,795,C
4-HA,655,788,0,1,0,789,A
4-HA,656,0,0,0,791,791,C
4-HA,657,791,0,0,0,791,A
4-HA,658,1,0,806,0,807,G
4-HA,659,0,792,0,0,792,T
4-HA,660,1,0,0,800,801,C
4-HA,661,0,782,0,0,782,T
4-HA,662,1,0,0,797,798,C
4-HA,663,1,797,0,1,799,T
4-HA,664,798,0,0,0,798,A
4-HA,665,0,1,0,796,797,C
4-HA,666,0,2,0,794,796,C
4-HA,667,787,1,0,0,788,A
4-HA,668,787,0,0,0,787,A
4-HA,669,785,0,0,0,785,A
4-HA,670,786,0,1,0,787,A
4-HA,671,0,0,788,0,788,G
4-HA,672,766,0,0,0,766,A
4-HA,673,762,0,1,0,763,A
4-HA,674,1,0,761,0,762,G
4-HA,675,0,0,0,762,762,C
4-HA,676,0,1,0,765,766,C
4-HA,677,769,0,0,0,769,A
4-HA,678,765,3,0,1,769,A
4-HA,679,0,0,0,769,769,C
4-HA,680,766,0,0,0,766,A
4-HA,681,764,0,0,3,767,A
4-HA,682,767,0,0,0,767,A
4-HA,683,0,0,0,780,780,C
4-HA,684,0,779,0,1,780,T
4-HA,685,1,0,783,0,784,G
4-HA,686,0,782,0,0,782,T
4-HA,687,780,0,0,0,780,A
4-HA,688,782,0,1,0,783,A
4-HA,689,0,780,0,1,781,T
4-HA,690,0,0,1,788,789,C
4-HA,691,0,0,0,788,788,C
4-HA,692,0,1,0,762,763,C
4-HA,693,1,0,766,0,767,G
4-HA,694,760,0,0,0,760,A
4-HA,695,763,0,0,0,763,A
4-HA,696,0,762,0,0,762,T
4-HA,697,764,0,0,0,764,A
4-HA,698,0,760,0,0,760,T
4-HA,699,1,0,0,759,760,C
4-HA,700,0,0,756,0,756,G
4-HA,701,0,0,765,0,765,G
4-HA,702,767,0,0,1,768,A
4-HA,703,0,777,0,0,777,T
4-HA,704,0,0,0,777,777,C
4-HA,705,7,770,0,0,777,T
4-HA,706,774,0,3,0,777,A
4-HA,707,0,1,780,0,781,G
4-HA,708,789,0,1,0,790,A
4-HA,709,0,0,0,787,787,C
4-HA,710,1,0,0,764,765,C
4-HA,711,1,0,0,766,767,C
4-HA,712,758,0,0,0,758,A
4-HA,713,0,0,808,0,808,G
4-HA,714,808,0,1,0,809,A
4-HA,715,0,0,819,0,819,G
4-HA,716,0,807,0,0,807,T
4-HA,717,805,0,1,0,806,A
4-HA,718,806,0,1,0,807,A
4-HA,719,0,0,820,0,820,G
4-HA,720,1,0,826,0,827,G
4-HA,721,814,0,0,0,814,A
4-HA,722,737,1,0,0,738,A
4-HA,723,0,740,0,0,740,T
4-HA,724,736,0,0,0,736,A
4-HA,725,0,733,0,0,733,T
4-HA,726,1,1,1,736,739,C
4-HA,727,2,0,0,735,737,C
4-HA,728,0,0,0,723,723,C
4-HA,729,0,712,0,2,714,T
4-HA,730,716,0,0,0,716,A
4-HA,731,0,0,719,0,719,G
4-HA,732,0,0,0,722,722,C
4-HA,733,701,0,0,0,701,A
4-HA,734,0,1,721,0,722,G
4-HA,735,709,0,0,1,710,A
4-HA,736,706,0,0,0,706,A
4-HA,737,1,710,0,0,711,T
4-HA,738,707,0,0,0,707,A
4-HA,739,709,0,0,1,710,A
4-HA,740,0,0,709,0,709,G
4-HA,741,0,0,0,710,710,C
4-HA,742,712,0,0,0,712,A
4-HA,743,0,685,0,2,687,T
4-HA,744,0,1,0,720,721,C
4-HA,745,0,721,0,0,721,T
4-HA,746,721,1,0,0,722,A
4-HA,747,0,720,0,1,721,T
4-HA,748,0,714,0,1,715,T
4-HA,749,0,1,722,0,723,G
4-HA,750,1,0,716,0,717,G
4-HA,751,715,1,0,0,716,A
4-HA,752,0,0,1,716,717,C
4-HA,753,643,0,1,0,644,A
4-HA,754,667,0,0,0,667,A
4-HA,755,0,704,0,0,704,T
4-HA,756,711,1,0,0,712,A
4-HA,757,2,0,724,0,726,G
4-HA,758,0,722,0,0,722,T
4-HA,759,722,0,0,0,722,A
4-HA,760,723,0,0,0,723,A
4-HA,761,742,0,0,0,742,A
4-HA,762,748,0,2,0,750,A
4-HA,763,0,0,0,761,761,C
4-HA,764,0,2,0,720,722,C
4-HA,765,0,0,722,0,722,G
4-HA,766,0,0,722,0,722,G
4-HA,767,2,0,734,0,736,G
4-HA,768,741,0,0,0,741,A
4-HA,769,0,1,745,0,746,G
4-HA,770,761,0,1,0,762,A
4-HA,771,0,0,0,762,762,C
4-HA,772,757,0,2,0,759,A
4-HA,773,0,759,0,1,760,T
4-HA,774,760,0,0,0,760,A
4-HA,775,1,1,0,777,779,C
4-HA,776,0,769,0,1,770,T
4-HA,777,1,781,0,0,782,T
4-HA,778,0,785,0,0,785,T
4-HA,779,0,784,0,0,784,T
4-HA,780,0,2,790,0,792,G
4-HA,781,794,0,0,0,794,A
4-HA,782,0,795,0,0,795,T
4-HA,783,0,822,0,0,822,T
4-HA,784,820,0,0,0,820,A
4-HA,785,823,0,1,0,824,A
4-HA,786,0,1,0,829,830,C
4-HA,787,827,0,0,1,828,A
4-HA,788,0,0,868,0,868,G
4-HA,789,0,2,0,865,867,C
4-HA,790,866,0,0,0,866,A
4-HA,791,0,0,0,873,873,C
4-HA,792,865,0,1,0,866,A
4-HA,793,0,0,874,0,874,G
4-HA,794,1,0,871,0,872,G
4-HA,795,0,0,916,0,916,G
4-HA,796,905,0,0,0,905,A
4-HA,797,916,0,0,0,916,A
4-HA,798,0,916,0,1,917,T
4-HA,799,0,0,0,921,921,C
4-HA,800,0,932,0,0,932,T
4-HA,801,935,0,0,0,935,A
4-HA,802,931,0,0,0,931,A
4-HA,803,0,922,0,0,922,T
4-HA,804,0,890,0,0,890,T
4-HA,805,0,0,902,0,902,G
4-HA,806,0,0,0,934,934,C
4-HA,807,1,963,0,0,964,T
4-HA,808,0,0,0,1003,1003,C
4-HA,809,0,0,0,1001,1001,C
4-HA,810,0,1003,0,0,1003,T
4-HA,811,1004,0,0,0,1004,A
4-HA,812,0,1,1008,0,1009,G
4-HA,813,0,1,1026,0,1027,G
4-HA,814,0,0,1022,1,1023,G
4-HA,815,11,0,1007,0,1018,G
4-HA,816,0,987,1,0,988,T
4-HA,817,0,978,0,1,979,T
4-HA,818,983,0,0,0,983,A
4-HA,819,0,0,0,999,999,C
4-HA,820,0,995,0,0,995,T
4-HA,821,0,1003,0,1,1004,T
4-HA,822,0,0,0,1000,1000,C
4-HA,823,1001,0,0,0,1001,A
4-HA,824,1004,0,1,0,1005,A
4-HA,825,1007,1,0,0,1008,A
4-HA,826,1017,0,0,0,1017,A
4-HA,827,0,1017,0,0,1017,T
4-HA,828,1012,0,0,0,1012,A
4-HA,829,0,0,0,1011,1011,C
4-HA,830,0,0,1008,0,1008,G
4-HA,831,1013,0,0,0,1013,A
4-HA,832,1011,1,0,0,1012,A
4-HA,833,1,0,1028,0,1029,G
4-HA,834,0,1026,0,1,1027,T
4-HA,835,0,0,1047,0,1047,G
4-HA,836,0,0,1049,0,1049,G
4-HA,837,0,0,1049,0,1049,G
4-HA,838,1046,0,2,0,1048,A
4-HA,839,1051,0,1,0,1052,A
4-HA,840,1049,0,0,0,1049,A
4-HA,841,1043,1,1,0,1045,A
4-HA,842,0,0,1064,0,1064,G
4-HA,843,0,0,0,1063,1063,C
4-HA,844,0,1060,0,0,1060,T
4-HA,845,0,0,0,1076,1076,C
4-HA,846,1076,0,1,0,1077,A
4-HA,847,1084,1,0,0,1085,A
4-HA,848,0,1083,0,0,1083,T
4-HA,849,1110,0,0,0,1110,A
4-HA,850,1112,0,1,0,1113,A
4-HA,851,0,1099,0,1,1100,T
4-HA,852,0,0,1097,0,1097,G
4-HA,853,1090,0,1,0,1091,A
4-HA,854,0,0,1131,0,1131,G
4-HA,855,1130,0,2,0,1132,A
4-HA,856,0,1124,0,0,1124,T
4-HA,857,0,0,0,1143,1143,C
4-HA,858,1129,0,2,0,1131,A
4-HA,859,0,1,1143,0,1144,G
4-HA,860,1145,0,0,0,1145,A
4-HA,861,0,1145,0,0,1145,T
4-HA,862,1,0,1138,0,1139,G
4-HA,863,0,0,1,1124,1125,C
4-HA,864,1125,1,0,0,1126,A
4-HA,865,0,1,0,1151,1152,C
4-HA,866,2,1,0,1139,1142,C
4-HA,867,1,0,0,1146,1147,C
4-HA,868,1135,0,0,0,1135,A
4-HA,869,0,1135,0,0,1135,T
4-HA,870,0,1134,0,1,1135,T
4-HA,871,1,0,1146,0,1147,G
4-HA,872,1,0,1141,0,1142,G
4-HA,873,0,2,0,1142,1144,C
4-HA,874,1136,0,0,0,1136,A
4-HA,875,1131,0,0,0,1131,A
4-HA,876,1156,0,0,0,1156,A
4-HA,877,0,1159,0,1,1160,T
4-HA,878,0,0,1157,0,1157,G
4-HA,879,0,0,0,1153,1153,C
4-HA,880,1145,0,0,0,1145,A
4-HA,881,1179,0,3,0,1182,A
4-HA,882,0,1178,0,0,1178,T
4-HA,883,0,1196,0,0,1196,T
4-HA,884,0,1,1,1193,1195,C
4-HA,885,0,1178,0,0,1178,T
4-HA,886,0,2,1184,1,1187,G
4-HA,887,1184,0,0,0,1184,A
4-HA,888,1189,0,1,0,1190,A
4-HA,889,0,1189,0,0,1189,T
4-HA,890,0,0,1177,0,1177,G
4-HA,891,0,0,1,1174,1175,C
4-HA,892,1178,0,1,0,1179,A
4-HA,893,1,1176,0,0,1177,T
4-HA,894,1,0,0,1176,1177,C
4-HA,895,1175,0,2,0,1177,A
4-HA,896,0,0,0,1225,1225,C
4-HA,897,0,1219,0,1,1220,T
4-HA,898,0,1,0,1226,1227,C
4-HA,899,0,0,0,1219,1219,C
4-HA,900,1236,0,1,0,1237,A
4-HA,901,1236,0,0,0,1236,A
4-HA,902,1232,0,1,0,1233,A
4-HA,903,0,1190,0,0,1190,T
4-HA,904,0,1,1198,0,1199,G
4-HA,905,5,0,1198,0,1203,G
4-HA,906,1198,0,1,0,1199,A
4-HA,907,1194,0,5,0,1199,A
4-HA,908,0,1,1205,0,1206,G
4-HA,909,0,0,0,1196,1196,C
4-HA,910,1199,0,0,0,1199,A
4-HA,911,0,1205,0,0,1205,T
4-HA,912,0,1200,0,1,1201,T
4-HA,913,0,0,0,1229,1229,C
4-HA,914,2,1,0,1218,1221,C
4-HA,915,0,0,0,1231,1231,C
4-HA,916,1229,0,1,0,1230,A
4-HA,917,1255,0,0,0,1255,A
4-HA,918,0,1279,0,0,1279,T
4-HA,919,0,1,1277,0,1278,G
4-HA,920,1281,0,0,0,1281,A
4-HA,921,0,1,0,1279,1280,C
4-HA,922,1244,0,0,0,1244,A
4-HA,923,1247,1,1,0,1249,A
4-HA,924,1250,0,0,0,1250,A
4-HA,925,0,0,0,1266,1266,C
4-HA,926,0,1,0,1245,1246,C
4-HA,927,1228,0,0,0,1228,A
4-HA,928,0,1223,0,0,1223,T
4-HA,929,0,1226,0,1,1227,T
4-HA,930,0,0,0,1229,1229,C
4-HA,931,0,0,0,1231,1231,C
4-HA,932,1228,0,1,0,1229,A
4-HA,933,1229,0,0,1,1230,A
4-HA,934,1230,0,0,0,1230,A
4-HA,935,1260,0,0,0,1260,A
4-HA,936,0,1255,0,0,1255,T
4-HA,937,0,2,1258,0,1260,G
4-HA,938,0,1257,0,0,1257,T
4-HA,939,1257,0,0,0,1257,A
4-HA,940,1258,0,2,0,1260,A
4-HA,941,1257,0,1,1,1259,A
4-HA,942,0,0,0,1263,1263,C
4-HA,943,1246,0,0,0,1246,A
4-HA,944,1,1,1264,0,1266,G
4-HA,945,0,0,1270,0,1270,G
4-HA,946,1301,0,0,1,1302,A
4-HA,947,0,1297,0,0,1297,T
4-HA,948,0,0,0,1313,1313,C
4-HA,949,1319,0,2,0,1321,A
4-HA,950,0,1,1,1379,1381,C
4-HA,951,1382,0,0,1,1383,A
4-HA,952,0,1426,0,0,1426,T
4-HA,953,1391,1,0,0,1392,A
4-HA,954,0,0,0,1381,1381,C
4-HA,955,0,1,1346,0,1347,G
4-HA,956,1,1,1349,0,1351,G
4-HA,957,1,2,1340,0,1343,G
4-HA,958,0,0,1342,0,1342,G
4-HA,959,0,0,0,1326,1326,C
4-HA,960,0,2,0,1323,1325,C
4-HA,961,0,1302,0,1,1303,T
4-HA,962,0,1,1406,0,1407,G
4-HA,963,0,1408,0,1,1409,T
4-HA,964,3,1,0,1412,1416,C
4-HA,965,0,1,0,1407,1408,C
4-HA,966,1,0,0,1411,1412,C
4-HA,967,1410,0,1,1,1412,A
4-HA,968,1,1,1413,0,1415,G
4-HA,969,1413,0,1,1,1415,A
4-HA,970,0,1414,0,0,1414,T
4-HA,971,1333,0,0,0,1333,A
4-HA,972,0,1316,0,1,1317,T
4-HA,973,0,1,1312,7,1320,G
4-HA,974,0,1316,0,1,1317,T
4-HA,975,0,1308,0,0,1308,T
4-HA,976,1308,0,2,1,1311,A
4-HA,977,1309,0,1,1,1311,A
4-HA,978,0,1,1325,0,1326,G
4-HA,979,0,1,0,1328,1329,C
4-HA,980,1301,0,0,1,1302,A
4-HA,981,1304,0,0,1,1305,A
4-HA,982,1300,0,0,1,1301,A
4-HA,983,1306,1,0,0,1307,A
4-HA,984,0,1,0,1307,1308,C
4-HA,985,1292,0,0,0,1292,A
4-HA,986,0,0,0,1306,1306,C
4-HA,987,1,1279,0,0,1280,T
4-HA,988,1,0,0,1295,1296,C
4-HA,989,0,1290,0,2,1292,T
4-HA,990,1,0,1304,0,1305,G
4-HA,991,1303,0,0,0,1303,A
4-HA,992,1300,0,0,0,1300,A
4-HA,993,1300,1,0,1,1302,A
4-HA,994,0,1294,0,2,1296,T
4-HA,995,0,1288,0,1,1289,T
4-HA,996,1,1,1302,0,1304,G
4-HA,997,0,0,1296,0,1296,G
4-HA,998,0,0,0,1306,1306,C
4-HA,999,1306,1,0,0,1307,A
4-HA,1000,1309,1,0,0,1310,A
4-HA,1001,1,0,0,1312,1313,C
4-HA,1002,1310,0,1,0,1311,A
4-HA,1003,0,1,1320,0,1321,G
4-HA,1004,0,0,1312,0,1312,G
4-HA,1005,0,1,1308,0,1309,G
4-HA,1006,1306,0,2,0,1308,A
4-HA,1007,1,1307,0,0,1308,T
4-HA,1008,2,0,1308,0,1310,G
4-HA,1009,1,4,0,1303,1308,C
4-HA,1010,1,1,1312,0,1314,G
4-HA,1011,1329,0,0,0,1329,A
4-HA,1012,1314,0,1,0,1315,A
4-HA,1013,1331,0,1,0,1332,A
4-HA,1014,0,1323,0,1,1324,T
4-HA,1015,1,0,1340,0,1341,G
4-HA,1016,0,1340,0,2,1342,T
4-HA,1017,1341,0,2,0,1343,A
4-HA,1018,0,0,0,1341,1341,C
4-HA,1019,2,1,0,1330,1333,C
4-HA,1020,1323,0,1,0,1324,A
4-HA,1021,0,0,1328,1,1329,G
4-HA,1022,1289,0,1,0,1290,A
4-HA,1023,0,0,1298,0,1298,G
4-HA,1024,1289,0,0,0,1289,A
4-HA,1025,1284,0,5,0,1289,A
4-HA,1026,1292,0,0,0,1292,A
4-HA,1027,0,0,0,1287,1287,C
4-HA,1028,1282,0,1,0,1283,A
4-HA,1029,1305,0,0,0,1305,A
4-HA,1030,1299,0,1,0,1300,A
4-HA,1031,0,0,0,1316,1316,C
4-HA,1032,0,1308,0,0,1308,T
4-HA,1033,1302,0,0,0,1302,A
4-HA,1034,0,0,1297,0,1297,G
4-HA,1035,1292,0,3,0,1295,A
4-HA,1036,1,2,1315,0,1318,G
4-HA,1037,1,0,1319,0,1320,G
4-HA,1038,0,0,1,1291,1292,C
4-HA,1039,1296,0,0,0,1296,A
4-HA,1040,0,1299,0,0,1299,T
4-HA,1041,1306,0,1,0,1307,A
4-HA,1042,0,1301,0,0,1301,T
4-HA,1043,0,1304,0,0,1304,T
4-HA,1044,0,1304,0,0,1304,T
4-HA,1045,0,0,1264,0,1264,G
4-HA,1046,1,0,1265,0,1266,G
4-HA,1047,0,1,0,1264,1265,C
4-HA,1048,2,0,1264,0,1266,G
4-HA,1049,0,0,0,1249,1249,C
4-HA,1050,1253,1,0,0,1254,A
4-HA,1051,1266,0,0,0,1266,A
4-HA,1052,0,1266,0,0,1266,T
4-HA,1053,0,0,0,1268,1268,C
4-HA,1054,1,0,1266,0,1267,G
4-HA,1055,0,0,0,1262,1262,C
4-HA,1056,0,3,1261,0,1264,G
4-HA,1057,1,2,1259,1,1263,G
4-HA,1058,0,1,1268,0,1269,G
4-HA,1059,1,1263,0,1,1265,T
4-HA,1060,0,1246,1,1,1248,T
4-HA,1061,1,1248,0,0,1249,T
4-HA,1062,0,1,0,1256,1257,C
4-HA,1063,1260,0,0,0,1260,A
4-HA,1064,0,1259,0,0,1259,T
4-HA,1065,1254,0,0,0,1254,A
4-HA,1066,1,0,1260,0,1261,G
4-HA,1067,1224,0,0,0,1224,A
4-HA,1068,1223,1,0,0,1224,A
4-HA,1069,1222,0,0,1,1223,A
4-HA,1070,1226,0,1,1,1228,A
4-HA,1071,1,1230,1,1,1233,T
4-HA,1072,0,0,1247,0,1247,G
4-HA,1073,0,0,1247,0,1247,G
4-HA,1074,0,1238,0,0,1238,T
4-HA,1075,0,1223,0,1,1224,T
4-HA,1076,0,1,1224,0,1225,G
4-HA,1077,0,0,1235,0,1235,G
4-HA,1078,0,0,1239,0,1239,G
4-HA,1079,1229,1,2,0,1232,A
4-HA,1080,0,2,1240,0,1242,G
4-HA,1081,0,1,1235,0,1236,G
4-HA,1082,0,1,1272,0,1273,G
4-HA,1083,1267,0,1,1,1269,A
4-HA,1084,1277,1,0,1,1279,A
4-HA,1085,0,1280,0,0,1280,T
4-HA,1086,0,0,1281,0,1281,G
4-HA,1087,1,0,1298,0,1299,G
4-HA,1088,0,1287,0,1,1288,T
4-HA,1089,1,1,1291,0,1293,G
4-HA,1090,0,0,1285,0,1285,G
4-HA,1091,1252,0,1,0,1253,A
4-HA,1092,0,1257,0,0,1257,T
4-HA,1093,3,0,1285,0,1288,G
4-HA,1094,0,0,1302,0,1302,G
4-HA,1095,0,1292,0,0,1292,T
4-HA,1096,0,1264,0,1,1265,T
4-HA,1097,0,1,1267,0,1268,G
4-HA,1098,0,1,1284,0,1285,G
4-HA,1099,1,1284,0,0,1285,T
4-HA,1100,1285,0,2,1,1288,A
4-HA,1101,0,0,0,1233,1233,C
4-HA,1102,0,2,1241,0,1243,G
4-HA,1103,0,0,1281,0,1281,G
4-HA,1104,0,1279,0,1,1280,T
4-HA,1105,2,1275,2,1,1280,T
4-HA,1106,0,1278,1,0,1279,T
4-HA,1107,0,0,1,1260,1261,C
4-HA,1108,1257,0,3,1,1261,A
4-HA,1109,0,0,1258,0,1258,G
4-HA,1110,1,1,1259,0,1261,G
4-HA,1111,0,1,0,1256,1257,C
4-HA,1112,1223,0,1,0,1224,A
4-HA,1113,0,1239,0,0,1239,T
4-HA,1114,1,0,0,1237,1238,C
4-HA,1115,1245,0,0,0,1245,A
4-HA,1116,1242,0,0,0,1242,A
4-HA,1117,1241,1,0,0,1242,A
4-HA,1118,1247,0,0,0,1247,A
4-HA,1119,0,1243,0,0,1243,T
4-HA,1120,0,1237,0,0,1237,T
4-HA,1121,2,0,0,1242,1244,C
4-HA,1122,0,1231,0,0,1231,T
4-HA,1123,0,2,1234,0,1236,G
4-HA,1124,1231,1,2,0,1234,A
4-HA,1125,0,1,1234,0,1235,G
4-HA,1126,0,0,1242,0,1242,G
4-HA,1127,1,0,1249,0,1250,G
4-HA,1128,1239,3,1,0,1243,A
4-HA,1129,1243,0,1,0,1244,A
4-HA,1130,1,1,1242,0,1244,G
4-HA,1131,1257,0,2,1,1260,A
4-HA,1132,0,1,1261,0,1262,G
4-HA,1133,0,0,1270,0,1270,G
4-HA,1134,1271,0,2,0,1273,A
4-HA,1135,1,0,0,1270,1271,C
4-HA,1136,1257,0,0,0,1257,A
4-HA,1137,1260,0,2,0,1262,A
4-HA,1138,0,0,1256,0,1256,G
4-HA,1139,0,0,0,1261,1261,C
4-HA,1140,1243,0,0,0,1243,A
4-HA,1141,0,0,1249,0,1249,G
4-HA,1142,0,1,0,1242,1243,C
4-HA,1143,1244,0,0,0,1244,A
4-HA,1144,0,0,1250,0,1250,G
4-HA,1145,1238,0,0,0,1238,A
4-HA,1146,0,1265,0,1,1266,T
4-HA,1147,1,0,0,1272,1273,C
4-HA,1148,1,1261,0,3,1265,T
4-HA,1149,1,0,0,1275,1276,C
4-HA,1150,1272,0,0,0,1272,A
4-HA,1151,1275,0,0,0,1275,A
4-HA,1152,1274,0,1,0,1275,A
4-HA,1153,1256,0,1,0,1257,A
4-HA,1154,0,1,1259,0,1260,G
4-HA,1155,1,0,0,1241,1242,C
4-HA,1156,1231,0,1,0,1232,A
4-HA,1157,0,1,0,1258,1259,C
4-HA,1158,0,1246,0,0,1246,T
4-HA,1159,0,0,0,1248,1248,C
4-HA,1160,1252,0,0,0,1252,A
4-HA,1161,1268,0,1,0,1269,A
4-HA,1162,1,0,1268,0,1269,G
4-HA,1163,1,0,0,1264,1265,C
4-HA,1164,1250,0,2,0,1252,A
4-HA,1165,0,0,1256,0,1256,G
4-HA,1166,1,0,0,1239,1240,C
4-HA,1167,1239,0,0,0,1239,A
4-HA,1168,1239,0,0,0,1239,A
4-HA,1169,0,1235,0,1,1236,T
4-HA,1170,0,0,0,1215,1215,C
4-HA,1171,0,0,1223,0,1223,G
4-HA,1172,1227,0,0,0,1227,A
4-HA,1173,0,1217,0,0,1217,T
4-HA,1174,0,0,0,1220,1220,C
4-HA,1175,1220,0,1,0,1221,A
4-HA,1176,1245,0,1,0,1246,A
4-HA,1177,1190,0,0,54,1244,A
4-HA,1178,0,1240,0,0,1240,T
4-HA,1179,0,0,0,1247,1247,C
4-HA,1180,1217,0,1,0,1218,A
4-HA,1181,1229,0,1,0,1230,A
4-HA,1182,0,1229,0,0,1229,T
4-HA,1183,0,1,1224,0,1225,G
4-HA,1184,0,1,1220,1,1222,G
4-HA,1185,0,0,1212,1,1213,G
4-HA,1186,1210,0,0,0,1210,A
4-HA,1187,1210,0,3,0,1213,A
4-HA,1188,1,0,1231,0,1232,G
4-HA,1189,0,0,1,1230,1231,C
4-HA,1190,0,1222,0,0,1222,T
4-HA,1191,0,1,1268,0,1269,G
4-HA,1192,1269,0,0,0,1269,A
4-HA,1193,1266,0,0,0,1266,A
4-HA,1194,0,1267,1,1,1269,T
4-HA,1195,1244,0,0,0,1244,A
4-HA,1196,0,0,1240,0,1240,G
4-HA,1197,1149,1,1,0,1151,A
4-HA,1198,0,1155,0,1,1156,T
4-HA,1199,0,1159,0,0,1159,T
4-HA,1200,0,1,1170,0,1171,G
4-HA,1201,1166,0,0,0,1166,A
4-HA,1202,1,1161,0,0,1162,T
4-HA,1203,1,1,0,1167,1169,C
4-HA,1204,0,1,1163,0,1164,G
4-HA,1205,0,0,1163,0,1163,G
4-HA,1206,0,0,1170,0,1170,G
4-HA,1207,1166,0,0,0,1166,A
4-HA,1208,1165,0,0,0,1165,A
4-HA,1209,1158,0,0,0,1158,A
4-HA,1210,1161,0,0,0,1161,A
4-HA,1211,1,0,0,1159,1160,C
4-HA,1212,1,0,0,1159,1160,C
4-HA,1213,1157,0,0,0,1157,A
4-HA,1214,1155,1,0,0,1156,A
4-HA,1215,0,3,0,1155,1158,C
4-HA,1216,1,2,1158,0,1161,G
4-HA,1217,1159,1,0,0,1160,A
4-HA,1218,0,0,1157,0,1157,G
4-HA,1219,1153,1,0,0,1154,A
4-HA,1220,1159,2,0,0,1161,A
4-HA,1221,1160,0,0,0,1160,A
4-HA,1222,0,1163,0,0,1163,T
4-HA,1223,0,1163,0,0,1163,T
4-HA,1224,0,0,0,1169,1169,C
4-HA,1225,0,0,0,1166,1166,C
4-HA,1226,1169,0,0,0,1169,A
4-HA,1227,0,1162,0,0,1162,T
4-HA,1228,0,0,0,1168,1168,C
4-HA,1229,1165,0,0,0,1165,A
4-HA,1230,0,0,1176,0,1176,G
4-HA,1231,1174,0,0,0,1174,A
4-HA,1232,0,1174,0,1,1175,T
4-HA,1233,0,1166,0,1,1167,T
4-HA,1234,1,0,1173,0,1174,G
4-HA,1235,1170,0,1,0,1171,A
4-HA,1236,1172,1,0,0,1173,A
4-HA,1237,1175,0,1,0,1176,A
4-HA,1238,1175,0,0,0,1175,A
4-HA,1239,1161,0,2,0,1163,A
4-HA,1240,0,0,1163,0,1163,G
4-HA,1241,1155,0,1,0,1156,A
4-HA,1242,1161,0,0,0,1161,A
4-HA,1243,0,1144,0,0,1144,T
4-HA,1244,0,1144,0,0,1144,T
4-HA,1245,0,0,0,1151,1151,C
4-HA,1246,0,1148,0,1,1149,T
4-HA,1247,1,0,0,1147,1148,C
4-HA,1248,1148,0,0,1,1149,A
4-HA,1249,0,0,1149,0,1149,G
4-HA,1250,1145,0,0,0,1145,A
4-HA,1251,1140,0,1,0,1141,A
4-HA,1252,0,0,1153,0,1153,G
4-HA,1253,1,1146,0,0,1147,T
4-HA,1254,2,0,0,1146,1148,C
4-HA,1255,0,0,1145,0,1145,G
4-HA,1256,1144,0,1,0,1145,A
4-HA,1257,1142,0,3,0,1145,A
4-HA,1258,0,1,1147,0,1148,G
4-HA,1259,2,0,1154,0,1156,G
4-HA,1260,0,2,1155,0,1157,G
4-HA,1261,1120,0,4,0,1124,A
4-HA,1262,0,0,1125,0,1125,G
4-HA,1263,1122,0,0,0,1122,A
4-HA,1264,1196,0,0,0,1196,A
4-HA,1265,0,1201,0,0,1201,T
4-HA,1266,0,1197,0,0,1197,T
4-HA,1267,0,0,0,1197,1197,C
4-HA,1268,1179,0,1,0,1180,A
4-HA,1269,0,0,1180,0,1180,G
4-HA,1270,0,0,1174,0,1174,G
4-HA,1271,1171,0,0,0,1171,A
4-HA,1272,0,0,0,1169,1169,C
4-HA,1273,1,0,0,1081,1082,C
4-HA,1274,0,1073,0,1,1074,T
4-HA,1275,0,1042,0,35,1077,T
4-HA,1276,0,1,1084,0,1085,G
4-HA,1277,1084,1,0,0,1085,A
4-HA,1278,1,1,1101,0,1103,G
4-HA,1279,1089,0,2,0,1091,A
4-HA,1280,1029,0,1,0,1030,A
4-HA,1281,1023,0,2,0,1025,A
4-HA,1282,0,1017,0,0,1017,T
4-HA,1283,1045,0,0,0,1045,A
4-HA,1284,0,1039,0,0,1039,T
4-HA,1285,0,0,1048,0,1048,G
4-HA,1286,1,1044,0,2,1047,T
4-HA,1287,0,1022,0,1,1023,T
4-HA,1288,0,0,1029,0,1029,G
4-HA,1289,1018,0,0,0,1018,A
4-HA,1290,0,0,1070,0,1070,G
4-HA,1291,0,0,1066,0,1066,G
4-HA,1292,1049,1,0,0,1050,A
4-HA,1293,0,0,0,1075,1075,C
4-HA,1294,1060,0,0,0,1060,A
4-HA,1295,1,0,0,1050,1051,C
4-HA,1296,1,1043,0,2,1046,T
4-HA,1297,1109,2,0,0,1111,A
4-HA,1298,1125,0,0,0,1125,A
4-HA,1299,1127,1,0,0,1128,A
4-HA,1300,1132,0,1,0,1133,A
4-HA,1301,0,1130,0,0,1130,T
4-HA,1302,1083,0,1,0,1084,A
4-HA,1303,0,1,1086,0,1087,G
4-HA,1304,1061,1,0,0,1062,A
4-HA,1305,0,1066,0,2,1068,T
4-HA,1306,1,0,0,1061,1062,C
4-HA,1307,0,1047,0,0,1047,T
4-HA,1308,0,0,0,1063,1063,C
4-HA,1309,1,1065,0,2,1068,T
4-HA,1310,1,0,1082,0,1083,G
4-HA,1311,0,0,1096,0,1096,G
4-HA,1312,1,1089,0,0,1090,T
4-HA,1313,2,0,0,1089,1091,C
4-HA,1314,1098,0,0,0,1098,A
4-HA,1315,0,1096,0,2,1098,T
4-HA,1316,1098,0,0,0,1098,A
4-HA,1317,0,0,0,1097,1097,C
4-HA,1318,1070,0,0,0,1070,A
4-HA,1319,1074,0,0,0,1074,A
4-HA,1320,0,0,0,1054,1054,C
4-HA,1321,0,0,1051,0,1051,G
4-HA,1322,0,0,0,1050,1050,C
4-HA,1323,0,0,1044,0,1044,G
4-HA,1324,0,0,1049,0,1049,G
4-HA,1325,1046,0,0,0,1046,A
4-HA,1326,0,0,1061,0,1061,G
4-HA,1327,0,0,0,1061,1061,C
4-HA,1328,0,1053,0,1,1054,T
4-HA,1329,0,1056,0,1,1057,T
4-HA,1330,0,1,0,1061,1062,C
4-HA,1331,0,1070,0,1,1071,T
4-HA,1332,0,1068,0,0,1068,T
4-HA,1333,0,0,1063,0,1063,G
4-HA,1334,0,1057,1,1,1059,T
4-HA,1335,0,1041,0,2,1043,T
4-HA,1336,2,0,1062,0,1064,G
4-HA,1337,0,0,0,1058,1058,C
4-HA,1338,1,0,0,1059,1060,C
4-HA,1339,0,0,0,1059,1059,C
4-HA,1340,0,1059,0,2,1061,T
4-HA,1341,0,0,1076,0,1076,G
4-HA,1342,0,1,1071,0,1072,G
4-HA,1343,1073,0,0,0,1073,A
4-HA,1344,0,0,1077,0,1077,G
4-HA,1345,1059,0,1,0,1060,A
4-HA,1346,1058,1,1,0,1060,A
4-HA,1347,0,1,0,1071,1072,C
4-HA,1348,2,0,0,1063,1065,C
4-HA,1349,1069,0,0,0,1069,A
4-HA,1350,1103,1,1,0,1105,A
4-HA,1351,0,0,0,1113,1113,C
4-HA,1352,1115,0,0,0,1115,A
4-HA,1353,0,1110,0,0,1110,T
4-HA,1354,1109,0,0,0,1109,A
4-HA,1355,1,1,0,1119,1121,C
4-HA,1356,1098,0,0,0,1098,A
4-HA,1357,1098,0,0,0,1098,A
4-HA,1358,1,1092,0,1,1094,T
4-HA,1359,0,1065,0,0,1065,T
4-HA,1360,1,2,1069,0,1072,G
4-HA,1361,1078,0,1,0,1079,A
4-HA,1362,0,1080,0,2,1082,T
4-HA,1363,0,0,0,1086,1086,C
4-HA,1364,0,1062,1,1,1064,T
4-HA,1365,1068,0,0,0,1068,A
4-HA,1366,1069,1,0,0,1070,A
4-HA,1367,0,0,0,1070,1070,C
4-HA,1368,0,1059,0,0,1059,T
4-HA,1369,0,1,1058,0,1059,G
4-HA,1370,1074,0,1,0,1075,A
4-HA,1371,0,1,0,1075,1076,C
4-HA,1372,0,1074,0,2,1076,T
4-HA,1373,1,0,0,1078,1079,C
4-HA,1374,1071,0,0,0,1071,A
4-HA,1375,0,0,1090,0,1090,G
4-HA,1376,1087,0,0,0,1087,A
4-HA,1377,1084,0,0,0,1084,A
4-HA,1378,1089,0,0,0,1089,A
4-HA,1379,0,1083,0,0,1083,T
4-HA,1380,0,2,1090,0,1092,G
4-HA,1381,1093,0,0,0,1093,A
4-HA,1382,1096,0,0,0,1096,A
4-HA,1383,0,0,0,1094,1094,C
4-HA,1384,1085,0,0,0,1085,A
4-HA,1385,1081,0,0,0,1081,A
4-HA,1386,1084,0,0,0,1084,A
4-HA,1387,0,0,0,1087,1087,C
4-HA,1388,0,1076,0,0,1076,T
4-HA,1389,0,0,1080,0,1080,G
4-HA,1390,0,1073,0,1,1074,T
4-HA,1391,0,1074,0,0,1074,T
4-HA,1392,0,1074,0,1,1075,T
4-HA,1393,0,0,1078,0,1078,G
4-HA,1394,1077,0,0,0,1077,A
4-HA,1395,1075,0,1,0,1076,A
4-HA,1396,1073,0,0,0,1073,A
4-HA,1397,1077,0,1,0,1078,A
4-HA,1398,1067,0,0,0,1067,A
4-HA,1399,1066,0,0,0,1066,A
4-HA,1400,0,0,0,1069,1069,C
4-HA,1401,1068,0,0,0,1068,A
4-HA,1402,1066,0,1,0,1067,A
4-HA,1403,1067,0,0,0,1067,A
4-HA,1404,1,0,1073,0,1074,G
4-HA,1405,1072,0,1,0,1073,A
4-HA,1406,1065,0,1,0,1066,A
4-HA,1407,2,0,1064,0,1066,G
4-HA,1408,0,0,0,1064,1064,C
4-HA,1409,1062,0,0,0,1062,A
4-HA,1410,1069,0,0,0,1069,A
4-HA,1411,0,0,0,1070,1070,C
4-HA,1412,0,1064,0,0,1064,T
4-HA,1413,0,0,1068,0,1068,G
4-HA,1414,1057,0,2,1,1060,A
4-HA,1415,0,0,1062,0,1062,G
4-HA,1416,0,0,1069,0,1069,G
4-HA,1417,1,0,1066,0,1067,G
4-HA,1418,1067,1,0,0,1068,A
4-HA,1419,1058,0,1,0,1059,A
4-HA,1420,1053,0,1,0,1054,A
4-HA,1421,1062,0,4,0,1066,A
4-HA,1422,0,1062,0,1,1063,T
4-HA,1423,0,0,1070,0,1070,G
4-HA,1424,0,0,0,1069,1069,C
4-HA,1425,0,1055,0,0,1055,T
4-HA,1426,0,2,1057,0,1059,G
4-HA,1427,1060,0,0,0,1060,A
4-HA,1428,0,0,1102,1,1103,G
4-HA,1429,0,1,1117,0,1118,G
4-HA,1430,1110,0,1,0,1111,A
4-HA,1431,0,1112,0,0,1112,T
4-HA,1432,1105,0,0,0,1105,A
4-HA,1433,0,1102,1,0,1103,T
4-HA,1434,0,0,1113,0,1113,G
4-HA,1435,0,0,1124,1,1125,G
4-HA,1436,0,1,1118,0,1119,G
4-HA,1437,0,1,0,1066,1067,C
4-HA,1438,1039,0,1,0,1040,A
4-HA,1439,1043,0,0,0,1043,A
4-HA,1440,0,1039,0,0,1039,T
4-HA,1441,0,0,1046,0,1046,G
4-HA,1442,0,0,1048,0,1048,G
4-HA,1443,0,1032,0,1,1033,T
4-HA,1444,0,1016,0,0,1016,T
4-HA,1445,0,0,1019,0,1019,G
4-HA,1446,0,1020,0,1,1021,T
4-HA,1447,0,1020,0,1,1021,T
4-HA,1448,0,1021,0,0,1021,T
4-HA,1449,0,0,0,1029,1029,C
4-HA,1450,1025,0,0,0,1025,A
4-HA,1451,1026,0,0,0,1026,A
4-HA,1452,1026,0,0,0,1026,A
4-HA,1453,1038,0,0,0,1038,A
4-HA,1454,0,1033,0,0,1033,T
4-HA,1455,1028,0,0,0,1028,A
4-HA,1456,0,1030,0,0,1030,T
4-HA,1457,1029,0,0,0,1029,A
4-HA,1458,0,0,0,1038,1038,C
4-HA,1459,1,0,0,1034,1035,C
4-HA,1460,1035,0,0,0,1035,A
4-HA,1461,0,1,0,1033,1034,C
4-HA,1462,1029,0,0,0,1029,A
4-HA,1463,1032,0,0,0,1032,A
4-HA,1464,1033,0,0,0,1033,A
4-HA,1465,0,1036,0,0,1036,T
4-HA,1466,0,0,1035,0,1035,G
4-HA,1467,0,1023,0,0,1023,T
4-HA,1468,1,1,1032,0,1034,G
4-HA,1469,1033,0,0,0,1033,A
4-HA,1470,0,2,0,1028,1030,C
4-HA,1471,1016,0,1,0,1017,A
4-HA,1472,1019,0,0,0,1019,A
4-HA,1473,0,1028,0,0,1028,T
4-HA,1474,0,0,1035,0,1035,G
4-HA,1475,1,0,0,1027,1028,C
4-HA,1476,0,0,1,1032,1033,C
4-HA,1477,0,1026,0,1,1027,T
4-HA,1478,2,0,1064,0,1066,G
4-HA,1479,1,0,0,1068,1069,C
4-HA,1480,1069,0,0,0,1069,A
4-HA,1481,0,1070,0,0,1070,T
4-HA,1482,1035,0,1,0,1036,A
4-HA,1483,1,1,1037,0,1039,G
4-HA,1484,0,0,1034,0,1034,G
4-HA,1485,1032,0,0,0,1032,A
4-HA,1486,0,1027,0,0,1027,T
4-HA,1487,0,0,0,972,972,C
4-HA,1488,971,0,0,0,971,A
4-HA,1489,971,0,1,0,972,A
4-HA,1490,0,971,0,0,971,T
4-HA,1491,0,0,0,974,974,C
4-HA,1492,953,0,0,0,953,A
4-HA,1493,0,0,959,0,959,G
4-HA,1494,958,0,0,0,958,A
4-HA,1495,959,0,0,0,959,A
4-HA,1496,959,0,0,0,959,A
4-HA,1497,0,958,0,0,958,T
4-HA,1498,0,0,954,0,954,G
4-HA,1499,0,0,955,0,955,G
4-HA,1500,955,0,0,0,955,A
4-HA,1501,966,0,0,0,966,A
4-HA,1502,0,0,0,958,958,C
4-HA,1503,0,949,0,0,949,T
4-HA,1504,0,949,0,0,949,T
4-HA,1505,951,0,0,0,951,A
4-HA,1506,0,950,0,1,951,T
4-HA,1507,0,1,952,0,953,G
4-HA,1508,952,0,0,0,952,A
4-HA,1509,0,0,0,947,947,C
4-HA,1510,0,0,0,938,938,C
4-HA,1511,941,0,0,0,941,A
4-HA,1512,1,0,0,956,957,C
4-HA,1513,0,0,975,0,975,G
4-HA,1514,990,0,0,0,990,A
4-HA,1515,0,1000,0,1,1001,T
4-HA,1516,2,0,1030,0,1032,G
4-HA,1517,0,1026,0,0,1026,T
4-HA,1518,1053,0,1,0,1054,A
4-HA,1519,0,1055,0,0,1055,T
4-HA,1520,1047,1,0,0,1048,A
4-HA,1521,0,0,0,1047,1047,C
4-HA,1522,909,0,0,0,909,A
4-HA,1523,0,0,926,0,926,G
4-HA,1524,864,0,0,0,864,A
4-HA,1525,0,0,832,0,832,G
4-HA,1526,827,0,0,0,827,A
4-HA,1527,0,765,0,0,765,T
4-HA,1528,0,0,765,0,765,G
4-HA,1529,761,0,2,0,763,A
4-HA,1530,756,0,3,0,759,A
4-HA,1531,0,0,772,0,772,G
4-HA,1532,1,0,0,754,755,C
4-HA,1533,753,1,0,0,754,A
4-HA,1534,0,752,0,0,752,T
4-HA,1535,0,752,0,0,752,T
4-HA,1536,751,0,1,0,752,A
4-HA,1537,755,0,0,0,755,A
4-HA,1538,754,0,0,0,754,A
4-HA,1539,0,0,0,754,754,C
4-HA,1540,721,0,0,0,721,A
4-HA,1541,725,0,0,0,725,A
4-HA,1542,0,0,0,725,725,C
4-HA,1543,1,0,0,721,722,C
4-HA,1544,0,1,723,0,724,G
4-HA,1545,0,0,735,0,735,G
4-HA,1546,0,736,0,1,737,T
4-HA,1547,0,736,0,0,736,T
4-HA,1548,0,721,0,0,721,T
4-HA,1549,1,0,0,725,726,C
4-HA,1550,727,0,0,0,727,A
4-HA,1551,0,0,730,0,730,G
4-HA,1552,730,0,0,0,730,A
4-HA,1553,0,727,0,1,728,T
4-HA,1554,1,0,0,708,709,C
4-HA,1555,710,0,0,0,710,A
4-HA,1556,708,0,0,0,708,A
4-HA,1557,0,0,709,0,709,G
4-HA,1558,0,0,709,0,709,G
4-HA,1559,0,0,706,0,706,G
4-HA,1560,692,0,0,0,692,A
4-HA,1561,0,0,699,0,699,G
4-HA,1562,0,697,1,1,699,T
4-HA,1563,0,696,0,1,697,T
4-HA,1564,0,0,703,0,703,G
4-HA,1565,692,0,0,0,692,A
4-HA,1566,0,0,698,0,698,G
4-HA,1567,1,0,0,696,697,C
4-HA,1568,0,692,0,2,694,T
4-HA,1569,0,0,698,0,698,G
4-HA,1570,694,0,0,0,694,A
4-HA,1571,697,0,0,0,697,A
4-HA,1572,0,0,697,0,697,G
4-HA,1573,0,681,0,0,681,T
4-HA,1574,1,1,0,675,677,C
4-HA,1575,676,0,1,0,677,A
4-HA,1576,1,0,674,0,675,G
4-HA,1577,0,1,674,0,675,G
4-HA,1578,0,0,660,0,660,G
4-HA,1579,0,679,0,0,679,T
4-HA,1580,679,0,0,0,679,A
4-HA,1581,0,0,0,677,677,C
4-HA,1582,676,0,0,0,676,A
4-HA,1583,674,0,0,0,674,A
4-HA,1584,670,0,0,0,670,A
4-HA,1585,1,0,669,0,670,G
4-HA,1586,651,0,0,0,651,A
4-HA,1587,0,625,0,1,626,T
4-HA,1588,0,620,0,1,621,T
4-HA,1589,0,0,624,0,624,G
4-HA,1590,0,0,620,0,620,G
4-HA,1591,618,0,0,0,618,A
4-HA,1592,0,621,0,0,621,T
4-HA,1593,1,0,0,621,622,C
4-HA,1594,0,0,0,610,610,C
4-HA,1595,0,603,0,1,604,T
4-HA,1596,608,0,0,0,608,A
4-HA,1597,0,607,0,1,608,T
4-HA,1598,0,0,606,0,606,G
4-HA,1599,1,1,603,0,605,G
4-HA,1600,596,0,0,0,596,A
4-HA,1601,0,593,0,0,593,T
4-HA,1602,0,588,0,0,588,T
4-HA,1603,0,585,0,0,585,T
4-HA,1604,0,0,0,583,583,C
4-HA,1605,1,0,0,582,583,C
4-HA,1606,1,568,0,0,569,T
4-HA,1607,0,571,0,1,572,T
4-HA,1608,0,568,0,0,568,T
4-HA,1609,0,0,568,0,568,G
4-HA,1610,0,0,0,566,566,C
4-HA,1611,0,0,0,565,565,C
4-HA,1612,556,1,0,0,557,A
4-HA,1613,0,553,0,0,553,T
4-HA,1614,556,0,0,0,556,A
4-HA,1615,0,555,0,0,555,T
4-HA,1616,0,0,0,555,555,C
4-HA,1617,555,1,0,0,556,A
4-HA,1618,0,540,0,0,540,T
4-HA,1619,0,0,542,0,542,G
4-HA,1620,0,537,1,0,538,T
4-HA,1621,0,530,0,0,530,T
4-HA,1622,0,527,0,0,527,T
4-HA,1623,0,519,0,0,519,T
4-HA,1624,0,518,0,0,518,T
4-HA,1625,0,519,0,0,519,T
4-HA,1626,0,0,520,0,520,G
4-HA,1627,0,0,0,518,518,C
4-HA,1628,0,505,0,0,505,T
4-HA,1629,0,504,0,1,505,T
4-HA,1630,0,502,0,0,502,T
4-HA,1631,0,0,512,0,512,G
4-HA,1632,0,510,0,0,510,T
4-HA,1633,0,0,512,0,512,G
4-HA,1634,0,511,0,0,511,T
4-HA,1635,0,497,0,0,497,T
4-HA,1636,0,0,497,0,497,G
4-HA,1637,0,0,0,497,497,C
4-HA,1638,0,494,0,0,494,T
4-HA,1639,0,498,0,1,499,T
4-HA,1640,0,481,0,0,481,T
4-HA,1641,0,0,481,0,481,G
4-HA,1642,0,480,0,1,481,T
4-HA,1643,0,480,0,0,480,T
4-HA,1644,0,0,481,0,481,G
4-HA,1645,0,0,470,0,470,G
4-HA,1646,1,0,466,0,467,G
4-HA,1647,1,0,470,0,471,G
4-HA,1648,0,460,0,0,460,T
4-HA,1649,0,454,0,0,454,T
4-HA,1650,0,0,0,441,441,C
4-HA,1651,439,0,0,0,439,A
4-HA,1652,0,442,0,0,442,T
4-HA,1653,0,0,0,440,440,C
4-HA,1654,440,0,0,0,440,A
4-HA,1655,0,433,0,0,433,T
4-HA,1656,0,0,425,0,425,G
4-HA,1657,0,417,0,1,418,T
4-HA,1658,0,0,411,0,411,G
4-HA,1659,0,0,403,0,403,G
4-HA,1660,0,0,399,0,399,G
4-HA,1661,0,0,0,393,393,C
4-HA,1662,0,0,0,378,378,C
4-HA,1663,0,367,0,0,367,T
4-HA,1664,0,0,368,0,368,G
4-HA,1665,0,0,0,366,366,C
4-HA,1666,1,0,0,368,369,C
4-HA,1667,368,0,0,0,368,A
4-HA,1668,368,0,0,0,368,A
4-HA,1669,368,0,0,0,368,A
4-HA,1670,366,0,0,0,366,A
4-HA,1671,365,1,0,0,366,A
4-HA,1672,1,0,364,1,366,G
4-HA,1673,0,0,356,0,356,G
4-HA,1674,0,0,0,350,350,C
4-HA,1675,349,0,1,0,350,A
4-HA,1676,350,0,0,0,350,A
4-HA,1677,0,0,0,349,349,C
4-HA,1678,349,0,0,0,349,A
4-HA,1679,0,347,1,0,348,T
4-HA,1680,0,344,0,0,344,T
4-HA,1681,332,0,0,0,332,A
4-HA,1682,0,1,330,0,331,G
4-HA,1683,0,0,331,0,331,G
4-HA,1684,0,325,0,0,325,T
4-HA,1685,0,0,294,0,294,G
4-HA,1686,0,0,0,287,287,C
4-HA,1687,284,0,0,0,284,A
4-HA,1688,285,0,0,0,285,A
4-HA,1689,0,0,0,283,283,C
4-HA,1690,280,0,0,0,280,A
4-HA,1691,0,270,0,0,270,T
4-HA,1692,0,252,0,0,252,T
4-HA,1693,0,251,0,1,252,T
4-HA,1694,0,0,252,0,252,G
4-HA,1695,0,0,0,248,248,C
4-HA,1696,248,0,0,0,248,A
4-HA,1697,0,228,0,1,229,T
4-HA,1698,0,221,0,0,221,T
4-HA,1699,0,212,0,0,212,T
4-HA,1700,0,0,212,0,212,G
4-HA,1701,204,0,0,0,204,A
5-NP,1,135,0,0,0,135,A
5-NP,2,0,138,0,0,138,T
5-NP,3,0,0,138,0,138,G
5-NP,4,0,0,138,0,138,G
5-NP,5,0,0,0,139,139,C
5-NP,6,0,0,141,0,141,G
5-NP,7,0,154,0,0,154,T
5-NP,8,0,0,0,158,158,C
5-NP,9,0,0,0,159,159,C
5-NP,10,0,0,0,159,159,C
5-NP,11,159,0,0,0,159,A
5-NP,12,159,0,0,0,159,A
5-NP,13,0,0,161,0,161,G
5-NP,14,0,0,163,0,163,G
5-NP,15,0,0,0,163,163,C
5-NP,16,163,0,0,0,163,A
5-NP,17,0,0,0,164,164,C
5-NP,18,0,0,0,164,164,C
5-NP,19,165,0,0,0,165,A
5-NP,20,166,0,0,0,166,A
5-NP,21,164,0,1,0,165,A
5-NP,22,0,0,0,166,166,C
5-NP,23,0,0,165,0,165,G
5-NP,24,0,0,188,0,188,G
5-NP,25,0,188,0,0,188,T
5-NP,26,0,0,0,199,199,C
5-NP,27,0,198,0,0,198,T
5-NP,28,0,200,0,0,200,T
5-NP,29,201,0,0,0,201,A
5-NP,30,0,200,0,0,200,T
5-NP,31,0,0,202,0,202,G
5-NP,32,200,0,0,0,200,A
5-NP,33,196,0,0,0,196,A
5-NP,34,0,0,0,196,196,C
5-NP,35,193,0,0,0,193,A
5-NP,36,0,0,201,0,201,G
5-NP,37,198,0,2,0,200,A
5-NP,38,0,199,0,0,199,T
5-NP,39,0,0,202,0,202,G
5-NP,40,0,0,202,0,202,G
5-NP,41,203,0,0,0,203,A
5-NP,42,203,0,0,0,203,A
5-NP,43,204,0,0,0,204,A
5-NP,44,0,0,0,214,214,C
5-NP,45,0,213,0,0,213,T
5-NP,46,0,0,215,0,215,G
5-NP,47,215,0,0,0,215,A
5-NP,48,0,214,0,0,214,T
5-NP,49,0,0,213,0,213,G
5-NP,50,0,1,214,0,215,G
5-NP,51,0,0,216,0,216,G
5-NP,52,0,0,217,0,217,G
5-NP,53,217,0,0,0,217,A
5-NP,54,0,216,0,0,216,T
5-NP,55,0,0,0,215,215,C
5-NP,56,0,0,217,0,217,G
5-NP,57,0,0,0,218,218,C
5-NP,58,0,0,0,218,218,C
5-NP,59,219,0,0,0,219,A
5-NP,60,1,0,223,0,224,G
5-NP,61,223,0,0,0,223,A
5-NP,62,229,0,0,0,229,A
5-NP,63,0,228,0,0,228,T
5-NP,64,0,0,228,0,228,G
5-NP,65,0,0,0,229,229,C
5-NP,66,231,0,0,0,231,A
5-NP,67,234,0,0,0,234,A
5-NP,68,0,0,0,235,235,C
5-NP,69,0,234,0,0,234,T
5-NP,70,0,0,237,0,237,G
5-NP,71,237,0,0,0,237,A
5-NP,72,0,0,251,0,251,G
5-NP,73,251,0,0,0,251,A
5-NP,74,0,253,0,0,253,T
5-NP,75,1,251,0,0,252,T
5-NP,76,251,0,0,0,251,A
5-NP,77,0,0,249,0,249,G
5-NP,78,0,0,252,0,252,G
5-NP,79,0,0,252,0,252,G
5-NP,80,0,0,0,251,251,C
5-NP,81,247,0,0,0,247,A
5-NP,82,0,249,0,0,249,T
5-NP,83,0,0,0,247,247,C
5-NP,84,0,0,0,248,248,C
5-NP,85,0,0,254,0,254,G
5-NP,86,0,257,0,0,257,T
5-NP,87,0,0,0,256,256,C
5-NP,88,0,1,257,0,258,G
5-NP,89,0,0,260,0,260,G
5-NP,90,0,0,261,0,261,G
5-NP,91,260,0,1,1,262,A
5-NP,92,265,0,0,0,265,A
5-NP,93,0,0,268,0,268,G
5-NP,94,267,0,0,0,267,A
5-NP,95,0,271,0,0,271,T
5-NP,96,0,0,271,0,271,G
5-NP,97,269,0,1,0,270,A
5-NP,98,1,270,0,0,271,T
5-NP,99,1,266,0,0,267,T
5-NP,100,0,0,270,0,270,G
5-NP,101,270,0,0,0,270,A
5-NP,102,0,268,0,0,268,T
5-NP,103,0,0,268,0,268,G
5-NP,104,0,0,265,0,265,G
5-NP,105,0,0,264,0,264,G
5-NP,106,276,0,0,0,276,A
5-NP,107,0,276,0,0,276,T
5-NP,108,0,277,0,0,277,T
5-NP,109,0,0,279,0,279,G
5-NP,110,0,0,279,0,279,G
5-NP,111,0,0,281,0,281,G
5-NP,112,280,0,0,0,280,A
5-NP,113,0,0,278,0,278,G
5-NP,114,278,0,0,0,278,A
5-NP,115,0,279,0,0,279,T
5-NP,116,0,281,0,0,281,T
5-NP,117,0,0,0,280,280,C
5-NP,118,0,281,0,0,281,T
5-NP,119,282,0,1,0,283,A
5-NP,120,0,0,0,282,282,C
5-NP,121,285,0,0,0,285,A
5-NP,122,0,286,0,0,286,T
5-NP,123,0,0,0,284,284,C
5-NP,124,0,0,0,287,287,C
5-NP,125,287,0,0,0,287,A
5-NP,126,291,0,0,0,291,A
5-NP,127,292,0,0,0,292,A
5-NP,128,0,291,0,0,291,T
5-NP,129,0,1,290,0,291,G
5-NP,130,0,288,0,0,288,T
5-NP,131,0,0,288,0,288,G
5-NP,132,0,0,0,290,290,C
5-NP,133,290,0,0,0,290,A
5-NP,134,0,0,0,290,290,C
5-NP,135,0,287,0,0,287,T
5-NP,136,0,0,297,0,297,G
5-NP,137,299,0,0,0,299,A
5-NP,138,304,0,1,0,305,A
5-NP,139,0,0,0,306,306,C
5-NP,140,0,303,0,0,303,T
5-NP,141,0,302,0,0,302,T
5-NP,142,304,0,0,0,304,A
5-NP,143,303,0,0,0,303,A
5-NP,144,0,0,293,0,293,G
5-NP,145,0,0,0,295,295,C
5-NP,146,0,294,0,0,294,T
5-NP,147,0,0,0,296,296,C
5-NP,148,297,0,0,0,297,A
5-NP,149,0,0,305,0,305,G
5-NP,150,0,304,0,0,304,T
5-NP,151,0,1,305,0,306,G
5-NP,152,311,0,0,0,311,A
5-NP,153,0,307,0,0,307,T
5-NP,154,0,0,0,311,311,C
5-NP,155,311,0,0,0,311,A
5-NP,156,0,311,0,0,311,T
5-NP,157,0,0,311,0,311,G
5-NP,158,309,0,0,0,309,A
5-NP,159,307,0,1,0,308,A
5-NP,160,0,0,307,0,307,G
5-NP,161,0,0,306,0,306,G
5-NP,162,0,0,306,0,306,G
5-NP,163,0,0,0,300,300,C
5-NP,164,0,0,301,0,301,G
5-NP,165,0,0,302,0,302,G
5-NP,166,0,299,0,2,301,T
5-NP,167,0,300,0,1,301,T
5-NP,168,0,0,301,0,301,G
5-NP,169,336,0,0,0,336,A
5-NP,170,0,339,0,0,339,T
5-NP,171,0,0,0,339,339,C
5-NP,172,0,1,0,339,340,C
5-NP,173,338,0,0,0,338,A
5-NP,174,0,0,339,0,339,G
5-NP,175,338,0,1,0,339,A
5-NP,176,338,0,1,0,339,A
5-NP,177,0,0,0,341,341,C
5-NP,178,326,0,0,0,326,A
5-NP,179,0,0,332,0,332,G
5-NP,180,0,0,0,333,333,C
5-NP,181,0,333,0,0,333,T
5-NP,182,0,337,0,0,337,T
5-NP,183,0,0,338,0,338,G
5-NP,184,338,0,0,0,338,A
5-NP,185,0,0,0,339,339,C
5-NP,186,337,0,0,0,337,A
5-NP,187,337,0,0,0,337,A
5-NP,188,0,334,1,0,335,T
5-NP,189,332,0,0,0,332,A
5-NP,190,0,0,332,0,332,G
5-NP,191,330,0,0,0,330,A
5-NP,192,0,0,332,0,332,G
5-NP,193,327,0,1,0,328,A
5-NP,194,332,0,0,0,332,A
5-NP,195,331,0,0,0,331,A
5-NP,196,344,0,0,0,344,A
5-NP,197,0,346,0,0,346,T
5-NP,198,0,0,347,0,347,G
5-NP,199,0,0,345,0,345,G
5-NP,200,0,344,0,0,344,T
5-NP,201,341,0,0,0,341,A
5-NP,202,0,0,0,345,345,C
5-NP,203,0,346,0,0,346,T
5-NP,204,0,0,0,351,351,C
5-NP,205,0,342,0,0,342,T
5-NP,206,0,0,0,344,344,C
5-NP,207,0,344,0,0,344,T
5-NP,208,0,0,350,0,350,G
5-NP,209,0,0,0,350,350,C
5-NP,210,0,351,0,1,352,T
5-NP,211,0,355,0,0,355,T
5-NP,212,0,351,0,0,351,T
5-NP,213,0,347,0,0,347,T
5-NP,214,0,1,348,0,349,G
5-NP,215,348,0,0,0,348,A
5-NP,216,0,348,0,0,348,T
5-NP,217,0,0,347,0,347,G
5-NP,218,344,0,0,0,344,A
5-NP,219,346,0,0,0,346,A
5-NP,220,346,0,0,0,346,A
5-NP,221,0,0,345,0,345,G
5-NP,222,346,1,0,0,347,A
5-NP,223,347,0,0,0,347,A
5-NP,224,0,0,350,0,350,G
5-NP,225,0,0,354,1,355,G
5-NP,226,362,0,0,0,362,A
5-NP,227,363,0,0,0,363,A
5-NP,228,0,363,0,1,364,T
5-NP,229,363,0,0,0,363,A
5-NP,230,363,1,0,0,364,A
5-NP,231,365,0,0,0,365,A
5-NP,232,0,365,0,0,365,T
5-NP,233,362,0,0,0,362,A
5-NP,234,0,0,0,362,362,C
5-NP,235,1,0,0,355,356,C
5-NP,236,0,356,0,0,356,T
5-NP,237,0,0,355,0,355,G
5-NP,238,0,0,360,0,360,G
5-NP,239,359,0,0,0,359,A
5-NP,240,357,1,0,0,358,A
5-NP,241,1,0,365,0,366,G
5-NP,242,364,1,0,0,365,A
5-NP,243,361,1,0,0,362,A
5-NP,244,0,0,0,363,363,C
5-NP,245,362,0,0,0,362,A
5-NP,246,0,0,0,366,366,C
5-NP,247,0,0,0,362,362,C
5-NP,248,0,0,0,365,365,C
5-NP,249,0,0,0,365,365,C
5-NP,250,360,0,0,0,360,A
5-NP,251,0,1,358,0,359,G
5-NP,252,0,0,0,356,356,C
5-NP,253,0,0,357,0,357,G
5-NP,254,0,1,0,359,360,C
5-NP,255,0,0,358,0,358,G
5-NP,256,1,1,362,0,364,G
5-NP,257,0,1,361,0,362,G
5-NP,258,0,0,364,0,364,G
5-NP,259,363,0,0,0,363,A
5-NP,260,363,0,0,0,363,A
5-NP,261,363,0,0,0,363,A
5-NP,262,0,0,362,0,362,G
5-NP,263,361,0,0,0,361,A
5-NP,264,0,358,1,0,359,T
5-NP,265,0,0,0,359,359,C
5-NP,266,0,0,0,358,358,C
5-NP,267,0,0,0,361,361,C
5-NP,268,363,0,0,0,363,A
5-NP,269,362,0,0,0,362,A
5-NP,270,0,0,364,0,364,G
5-NP,271,362,0,0,0,362,A
5-NP,272,364,0,0,0,364,A
5-NP,273,365,0,0,0,365,A
5-NP,274,363,0,0,0,363,A
5-NP,275,0,0,1,363,364,C
5-NP,276,0,359,0,0,359,T
5-NP,277,0,0,358,0,358,G
5-NP,278,0,0,358,0,358,G
5-NP,279,0,0,357,0,357,G
5-NP,280,0,0,357,0,357,G
5-NP,281,1,0,359,0,360,G
5-NP,282,0,0,358,0,358,G
5-NP,283,0,0,0,384,384,C
5-NP,284,0,0,0,384,384,C
5-NP,285,0,0,0,389,389,C
5-NP,286,440,0,0,0,440,A
5-NP,287,0,440,0,0,440,T
5-NP,288,466,1,0,0,467,A
5-NP,289,0,469,0,0,469,T
5-NP,290,464,0,0,0,464,A
5-NP,291,0,0,0,464,464,C
5-NP,292,431,0,0,0,431,A
5-NP,293,1,0,433,0,434,G
5-NP,294,0,0,435,0,435,G
5-NP,295,396,0,0,0,396,A
5-NP,296,0,0,399,0,399,G
5-NP,297,375,0,0,0,375,A
5-NP,298,0,0,380,0,380,G
5-NP,299,0,381,0,0,381,T
5-NP,300,376,0,0,0,376,A
5-NP,301,0,0,377,0,377,G
5-NP,302,368,0,0,0,368,A
5-NP,303,0,370,0,0,370,T
5-NP,304,1,0,369,0,370,G
5-NP,305,0,0,373,0,373,G
5-NP,306,371,0,0,0,371,A
5-NP,307,370,0,0,0,370,A
5-NP,308,370,0,0,0,370,A
5-NP,309,370,0,0,0,370,A
5-NP,310,0,368,0,0,368,T
5-NP,311,0,0,369,0,369,G
5-NP,312,1,0,369,0,370,G
5-NP,313,371,0,0,0,371,A
5-NP,314,0,370,0,0,370,T
5-NP,315,0,0,373,0,373,G
5-NP,316,372,0,1,0,373,A
5-NP,317,0,1,373,0,374,G
5-NP,318,0,0,374,0,374,G
5-NP,319,0,0,379,0,379,G
5-NP,320,401,0,1,0,402,A
5-NP,321,408,0,0,0,408,A
5-NP,322,0,0,0,442,442,C
5-NP,323,0,440,0,0,440,T
5-NP,324,0,0,0,462,462,C
5-NP,325,1,0,486,0,487,G
5-NP,326,0,511,0,1,512,T
5-NP,327,0,1,0,528,529,C
5-NP,328,0,0,0,723,723,C
5-NP,329,0,722,0,0,722,T
5-NP,330,0,732,0,0,732,T
5-NP,331,0,730,0,1,731,T
5-NP,332,737,0,1,0,738,A
5-NP,333,0,741,0,0,741,T
5-NP,334,0,0,744,0,744,G
5-NP,335,760,0,1,0,761,A
5-NP,336,0,0,0,765,765,C
5-NP,337,765,0,0,0,765,A
5-NP,338,770,0,0,0,770,A
5-NP,339,779,0,0,0,779,A
5-NP,340,0,0,876,0,876,G
5-NP,341,874,0,0,0,874,A
5-NP,342,873,0,0,1,874,A
5-NP,343,0,0,981,0,981,G
5-NP,344,1001,0,0,0,1001,A
5-NP,345,1001,0,0,0,1001,A
5-NP,346,1004,0,0,0,1004,A
5-NP,347,0,1006,0,0,1006,T
5-NP,348,1010,0,0,0,1010,A
5-NP,349,1010,0,0,0,1010,A
5-NP,350,0,1,1036,0,1037,G
5-NP,351,0,0,1035,0,1035,G
5-NP,352,0,0,0,1035,1035,C
5-NP,353,0,2,1033,0,1035,G
5-NP,354,1044,1,0,0,1045,A
5-NP,355,1071,0,1,0,1072,A
5-NP,356,1,1077,0,0,1078,T
5-NP,357,0,1,0,1080,1081,C
5-NP,358,0,1081,0,1,1082,T
5-NP,359,0,0,1075,0,1075,G
5-NP,360,0,0,1081,0,1081,G
5-NP,361,0,0,1,1084,1085,C
5-NP,362,1,0,1086,0,1087,G
5-NP,363,0,2,0,1087,1089,C
5-NP,364,1,0,1,1086,1088,C
5-NP,365,1091,0,0,0,1091,A
5-NP,366,1112,0,0,0,1112,A
5-NP,367,1,0,1183,0,1184,G
5-NP,368,1,1,0,1192,1194,C
5-NP,369,1,0,0,1217,1218,C
5-NP,370,1225,0,0,0,1225,A
5-NP,371,1261,0,0,0,1261,A
5-NP,372,0,13,0,1286,1299,C
5-NP,373,1309,0,0,0,1309,A
5-NP,374,1370,0,0,0,1370,A
5-NP,375,1,1368,0,0,1369,T
5-NP,376,0,0,1439,0,1439,G
5-NP,377,1,1,1446,0,1448,G
5-NP,378,0,1441,0,0,1441,T
5-NP,379,0,1,1447,0,1448,G
5-NP,380,1441,1,1,1,1444,A
5-NP,381,0,1,1515,0,1516,G
5-NP,382,0,2,1521,0,1523,G
5-NP,383,1570,0,0,0,1570,A
5-NP,384,0,1779,0,0,1779,T
5-NP,385,0,0,1823,0,1823,G
5-NP,386,0,1,0,1858,1859,C
5-NP,387,0,1864,0,3,1867,T
5-NP,388,1901,0,2,0,1903,A
5-NP,389,0,1,0,1941,1942,C
5-NP,390,1953,1,0,0,1954,A
5-NP,391,0,1826,0,120,1946,T
5-NP,392,0,0,0,1940,1940,C
5-NP,393,0,1900,0,0,1900,T
5-NP,394,0,1,2029,0,2030,G
5-NP,395,0,0,2103,0,2103,G
5-NP,396,1,2101,0,2,2104,T
5-NP,397,2,0,0,2105,2107,C
5-NP,398,0,2102,0,2,2104,T
5-NP,399,2157,0,0,0,2157,A
5-NP,400,2155,0,0,2,2157,A
5-NP,401,0,0,0,2176,2176,C
5-NP,402,0,2172,0,6,2178,T
5-NP,403,0,0,0,2217,2217,C
5-NP,404,2222,1,0,0,2223,A
5-NP,405,0,2,0,2362,2364,C
5-NP,406,2363,0,0,0,2363,A
5-NP,407,0,2375,0,0,2375,T
5-NP,408,2362,0,0,0,2362,A
5-NP,409,2373,0,0,0,2373,A
5-NP,410,0,2391,0,0,2391,T
5-NP,411,0,1,2411,0,2412,G
5-NP,412,2414,1,0,0,2415,A
5-NP,413,0,2404,0,0,2404,T
5-NP,414,0,2381,0,1,2382,T
5-NP,415,0,2388,0,0,2388,T
5-NP,416,0,3,2372,0,2375,G
5-NP,417,0,0,2384,1,2385,G
5-NP,418,1,2,1,2388,2392,C
5-NP,419,2398,0,2,0,2400,A
5-NP,420,0,2404,0,4,2408,T
5-NP,421,1,2401,1,5,2408,T
5-NP,422,0,2,0,2405,2407,C
5-NP,423,0,0,0,2411,2411,C
5-NP,424,2475,0,0,0,2475,A
5-NP,425,2480,0,0,0,2480,A
5-NP,426,0,2486,0,0,2486,T
5-NP,427,0,2483,0,0,2483,T
5-NP,428,0,2480,0,1,2481,T
5-NP,429,0,0,2511,0,2511,G
5-NP,430,2505,0,1,0,2506,A
5-NP,431,2512,0,1,0,2513,A
5-NP,432,1,2538,0,1,2540,T
5-NP,433,0,1,2522,0,2523,G
5-NP,434,2666,0,1,0,2667,A
5-NP,435,0,2671,1,0,2672,T
5-NP,436,1,2,2683,0,2686,G
5-NP,437,0,0,0,2789,2789,C
5-NP,438,2773,0,8,1,2782,A
5-NP,439,2904,0,4,0,2908,A
5-NP,440,0,0,0,2916,2916,C
5-NP,441,2963,1,1,0,2965,A
5-NP,442,1,3032,0,0,3033,T
5-NP,443,2994,1,2,0,2997,A
5-NP,444,0,0,0,3069,3069,C
5-NP,445,0,1,0,3061,3062,C
5-NP,446,3022,1,1,0,3024,A
5-NP,447,0,3,3047,0,3050,G
5-NP,448,3016,0,2,0,3018,A
5-NP,449,0,1,3082,1,3084,G
5-NP,450,0,2,3092,0,3094,G
5-NP,451,3069,0,2,0,3071,A
5-NP,452,0,2,0,3104,3106,C
5-NP,453,3080,0,6,0,3086,A
5-NP,454,3075,3,4,0,3082,A
5-NP,455,0,2,3100,0,3102,G
5-NP,456,3080,0,4,0,3084,A
5-NP,457,0,0,3105,0,3105,G
5-NP,458,0,0,0,3104,3104,C
5-NP,459,0,3092,0,6,3098,T
5-NP,460,0,0,0,3108,3108,C
5-NP,461,0,3102,0,1,3103,T
5-NP,462,0,3113,1,1,3115,T
5-NP,463,0,1,3118,0,3119,G
5-NP,464,1,3120,0,0,3121,T
5-NP,465,0,3115,0,2,3117,T
5-NP,466,1,0,1,3108,3110,C
5-NP,467,0,3,3109,0,3112,G
5-NP,468,3179,0,0,2,3181,A
5-NP,469,3175,2,2,0,3179,A
5-NP,470,0,1,0,3218,3219,C
5-NP,471,1,3205,1,3,3210,T
5-NP,472,0,1,3276,0,3277,G
5-NP,473,0,1,3289,1,3291,G
5-NP,474,3297,2,0,0,3299,A
5-NP,475,3296,2,1,0,3299,A
5-NP,476,1,3297,0,1,3299,T
5-NP,477,2,2,3302,0,3306,G
5-NP,478,2,1,3313,0,3316,G
5-NP,479,3356,0,3,1,3360,A
5-NP,480,0,3390,0,1,3391,T
5-NP,481,3,0,1,3421,3425,C
5-NP,482,2,2,0,3422,3426,C
5-NP,483,2,0,0,3434,3436,C
5-NP,484,3452,0,3,0,3455,A
5-NP,485,0,1,3483,1,3485,G
5-NP,486,3479,0,0,0,3479,A
5-NP,487,3464,1,3,0,3468,A
5-NP,488,0,3446,0,5,3451,T
5-NP,489,1,0,3473,0,3474,G
5-NP,490,1,3458,0,0,3459,T
5-NP,491,0,0,3479,1,3480,G
5-NP,492,1,0,0,3477,3478,C
5-NP,493,0,3471,0,1,3472,T
5-NP,494,0,0,0,3650,3650,C
5-NP,495,0,3631,0,1,3632,T
5-NP,496,2,0,1,3771,3774,C
5-NP,497,0,3763,0,5,3768,T
5-NP,498,0,0,3776,0,3776,G
5-NP,499,3795,0,7,0,3802,A
5-NP,500,1,3789,0,3,3793,T
5-NP,501,0,1,3790,1,3792,G
5-NP,502,0,1,0,3789,3790,C
5-NP,503,3716,2,5,0,3723,A
5-NP,504,0,3,3838,0,3841,G
5-NP,505,0,2,3786,0,3788,G
5-NP,506,2,1,3822,0,3825,G
5-NP,507,0,1,0,3820,3821,C
5-NP,508,0,3805,0,4,3809,T
5-NP,509,2,1,0,3829,3832,C
5-NP,510,1,0,3837,0,3838,G
5-NP,511,3869,1,1,0,3871,A
5-NP,512,0,0,0,3863,3863,C
5-NP,513,0,3824,0,4,3828,T
5-NP,514,1,1,0,3999,4001,C
5-NP,515,1,3987,0,3,3991,T
5-NP,516,2,2,0,4536,4540,C
5-NP,517,0,0,0,4559,4559,C
5-NP,518,8,0,0,4556,4564,C
5-NP,519,0,4563,0,1,4564,T
5-NP,520,4552,0,0,0,4552,A
5-NP,521,0,2,4548,0,4550,G
5-NP,522,4541,1,0,0,4542,A
5-NP,523,4427,0,0,1,4428,A
5-NP,524,0,4,4430,1,4435,G
5-NP,525,0,0,4391,0,4391,G
5-NP,526,1,4338,0,1,4340,T
5-NP,527,1,1,0,4342,4344,C
5-NP,528,0,1,0,4337,4338,C
5-NP,529,1,2,4344,0,4347,G
5-NP,530,1,2,4383,0,4386,G
5-NP,531,4372,2,2,0,4376,A
5-NP,532,1,1,4417,0,4419,G
5-NP,533,0,0,0,4434,4434,C
5-NP,534,0,4397,1,5,4403,T
5-NP,535,2,4,4412,0,4418,G
5-NP,536,0,2,0,4433,4435,C
5-NP,537,4420,1,1,0,4422,A
5-NP,538,1,1,4430,0,4432,G
5-NP,539,0,1,4460,0,4461,G
5-NP,540,0,4457,0,2,4459,T
5-NP,541,0,3,4420,0,4423,G
5-NP,542,2,0,0,4449,4451,C
5-NP,543,1,4443,0,6,4450,T
5-NP,544,2,1,4445,0,4448,G
5-NP,545,0,0,0,4450,4450,C
5-NP,546,4496,0,4,0,4500,A
5-NP,547,0,1,4567,1,4569,G
5-NP,548,0,4550,0,2,4552,T
5-NP,549,4,0,1,4552,4557,C
5-NP,550,4558,1,0,0,4559,A
5-NP,551,4556,2,2,0,4560,A
5-NP,552,4535,0,6,0,4541,A
5-NP,553,0,1,4585,0,4586,G
5-NP,554,1,4,4584,1,4590,G
5-NP,555,4583,2,1,1,4587,A
5-NP,556,4577,0,2,0,4579,A
5-NP,557,0,4563,1,1,4565,T
5-NP,558,2,3,0,4562,4567,C
5-NP,559,2,1,4570,0,4573,G
5-NP,560,1,0,4716,0,4717,G
5-NP,561,1,2,4723,0,4726,G
5-NP,562,4703,1,4,0,4708,A
5-NP,563,1,0,0,4708,4709,C
5-NP,564,4684,0,2,0,4686,A
5-NP,565,4781,1,5,0,4787,A
5-NP,566,0,4792,0,4,4796,T
5-NP,567,0,1,4823,1,4825,G
5-NP,568,0,0,4871,0,4871,G
5-NP,569,0,4792,2,0,4794,T
5-NP,570,1,3,4811,0,4815,G
5-NP,571,4807,0,2,0,4809,A
5-NP,572,0,4789,0,2,4791,T
5-NP,573,2,1,4781,0,4784,G
5-NP,574,0,0,4880,0,4880,G
5-NP,575,4864,0,5,0,4869,A
5-NP,576,4876,0,2,0,4878,A
5-NP,577,1,0,0,4852,4853,C
5-NP,578,1,4799,0,2,4802,T
5-NP,579,4789,2,0,0,4791,A
5-NP,580,5011,0,2,0,5013,A
5-NP,581,0,5009,0,4,5013,T
5-NP,582,1,1,0,5024,5026,C
5-NP,583,4882,0,1,0,4883,A
5-NP,584,1,0,4935,0,4936,G
5-NP,585,4918,1,2,0,4921,A
5-NP,586,4917,1,1,0,4919,A
5-NP,587,1,4915,0,0,4916,T
5-NP,588,1,3,4927,0,4931,G
5-NP,589,1,3,4981,1,4986,G
5-NP,590,0,4973,0,8,4981,T
5-NP,591,3,0,0,4981,4984,C
5-NP,592,4992,0,1,0,4993,A
5-NP,593,4993,0,0,0,4993,A
5-NP,594,5005,1,4,1,5011,A
5-NP,595,0,1,0,5019,5020,C
5-NP,596,1,4,4999,1,5005,G
5-NP,597,0,1,5014,0,5015,G
5-NP,598,98,8,4865,1,4972,G
5-NP,599,1,3,4995,0,4999,G
5-NP,600,0,6,5002,0,5008,G
5-NP,601,5014,1,2,0,5017,A
5-NP,602,1,4984,1,3,4989,T
5-NP,603,3,0,0,4980,4983,C
5-NP,604,4936,0,61,0,4997,A
5-NP,605,4992,1,4,0,4997,A
5-NP,606,0,0,0,4941,4941,C
5-NP,607,0,1,4917,0,4918,G
5-NP,608,4916,0,2,0,4918,A
5-NP,609,0,4908,1,0,4909,T
5-NP,610,3,2,0,4902,4907,C
5-NP,611,0,1,4917,0,4918,G
5-NP,612,4922,0,0,0,4922,A
5-NP,613,4910,0,1,0,4911,A
5-NP,614,4909,0,1,0,4910,A
5-NP,615,0,4944,1,0,4945,T
5-NP,616,1,4939,0,3,4943,T
5-NP,617,0,4953,1,0,4954,T
5-NP,618,1,4967,2,2,4972,T
5-NP,619,0,4985,0,3,4988,T
5-NP,620,0,4,4991,0,4995,G
5-NP,621,1,1,4987,0,4989,G
5-NP,622,4960,2,6,0,4968,A
5-NP,623,1,3,4986,0,4990,G
5-NP,624,4921,2,1,0,4924,A
5-NP,625,2,2,5113,0,5117,G
5-NP,626,0,0,5135,0,5135,G
5-NP,627,0,5119,0,3,5122,T
5-NP,628,1,2,5141,1,5145,G
5-NP,629,5138,1,3,1,5143,A
5-NP,630,0,0,5176,1,5177,G
5-NP,631,5161,1,2,0,5164,A
5-NP,632,5155,1,4,0,5160,A
5-NP,633,2,5158,0,0,5160,T
5-NP,634,2,1,5003,0,5006,G
5-NP,635,0,5,4978,0,4983,G
5-NP,636,4951,0,2,0,4953,A
5-NP,637,2,1,0,4950,4953,C
5-NP,638,0,4,4962,0,4966,G
5-NP,639,0,2,5035,1,5038,G
5-NP,640,5031,0,2,1,5034,A
5-NP,641,5032,0,4,0,5036,A
5-NP,642,5098,1,3,2,5104,A
5-NP,643,5108,0,4,1,5113,A
5-NP,644,0,13,1,5130,5144,C
5-NP,645,5142,1,1,0,5144,A
5-NP,646,5139,1,2,1,5143,A
5-NP,647,0,3,5139,0,5142,G
5-NP,648,5014,1,1,1,5017,A
5-NP,649,5027,1,0,0,5028,A
5-NP,650,82,0,5045,0,5127,G
5-NP,651,1,5118,1,0,5120,T
5-NP,652,0,0,5345,0,5345,G
5-NP,653,1,1,0,5314,5316,C
5-NP,654,0,5314,1,7,5322,T
5-NP,655,0,5346,0,1,5347,T
5-NP,656,5378,0,0,0,5378,A
5-NP,657,2,5390,0,1,5393,T
5-NP,658,1,1,5412,1,5415,G
5-NP,659,5302,1,11,0,5314,A
5-NP,660,1,1,5334,0,5336,G
5-NP,661,5075,1,4,0,5080,A
5-NP,662,1,1,5090,0,5092,G
5-NP,663,5083,0,1,0,5084,A
5-NP,664,5104,1,1,0,5106,A
5-NP,665,0,5088,0,2,5090,T
5-NP,666,0,0,5153,0,5153,G
5-NP,667,1,5111,0,1,5113,T
5-NP,668,2,0,5136,0,5138,G
5-NP,669,0,3,0,5107,5110,C
5-NP,670,5106,1,2,0,5109,A
5-NP,671,5120,1,2,1,5124,A
5-NP,672,0,0,0,5119,5119,C
5-NP,673,5057,0,1,0,5058,A
5-NP,674,0,5068,1,2,5071,T
5-NP,675,2,5009,0,5,5016,T
5-NP,676,3,0,0,5020,5023,C
5-NP,677,2,5015,0,0,5017,T
5-NP,678,0,5018,0,2,5020,T
5-NP,679,5029,0,0,0,5029,A
5-NP,680,4992,2,1,1,4996,A
5-NP,681,4993,0,2,0,4995,A
5-NP,682,0,2,5002,1,5005,G
5-NP,683,2,2,4992,0,4996,G
5-NP,684,4967,0,2,1,4970,A
5-NP,685,4951,1,1,0,4953,A
5-NP,686,4948,1,2,1,4952,A
5-NP,687,5029,0,0,1,5030,A
5-NP,688,2,4993,3,4,5002,T
5-NP,689,0,5007,1,0,5008,T
5-NP,690,3,5025,0,3,5031,T
5-NP,691,0,0,0,5033,5033,C
5-NP,692,5034,1,4,0,5039,A
5-NP,693,5031,0,2,2,5035,A
5-NP,694,5022,3,8,1,5034,A
5-NP,695,0,0,0,5087,5087,C
5-NP,696,5001,1,2,0,5004,A
5-NP,697,0,1,5095,0,5096,G
5-NP,698,0,0,0,5085,5085,C
5-NP,699,2,5062,0,2,5066,T
5-NP,700,1,1,5149,1,5152,G
5-NP,701,1,1,0,5145,5147,C
5-NP,702,5187,2,1,0,5190,A
5-NP,703,1,1,0,5188,5190,C
5-NP,704,5153,1,1,1,5156,A
5-NP,705,5154,1,8,0,5163,A
5-NP,706,5034,0,5,0,5039,A
5-NP,707,2,3,5185,0,5190,G
5-NP,708,5180,0,6,0,5186,A
5-NP,709,2,1,5189,0,5192,G
5-NP,710,1,3,0,5157,5161,C
5-NP,711,5155,0,2,0,5157,A
5-NP,712,5274,1,5,0,5280,A
5-NP,713,1,5281,0,2,5284,T
5-NP,714,2,2,5296,0,5300,G
5-NP,715,1,0,5308,1,5310,G
5-NP,716,1,5166,1,3,5171,T
5-NP,717,3,3,5157,0,5163,G
5-NP,718,1,2,5179,0,5182,G
5-NP,719,5173,0,5,1,5179,A
5-NP,720,1,5169,0,1,5171,T
5-NP,721,3,1,0,5028,5032,C
5-NP,722,5057,0,2,0,5059,A
5-NP,723,5102,2,0,1,5105,A
5-NP,724,0,0,5115,0,5115,G
5-NP,725,1,5066,0,1,5068,T
5-NP,726,1,3,5074,0,5078,G
5-NP,727,5003,0,6,0,5009,A
5-NP,728,2,3,5010,0,5015,G
5-NP,729,5014,1,3,0,5018,A
5-NP,730,0,3,5019,3,5025,G
5-NP,731,4994,0,3,0,4997,A
5-NP,732,4874,0,1,2,4877,A
5-NP,733,4897,1,4,0,4902,A
5-NP,734,0,0,4921,0,4921,G
5-NP,735,0,4897,0,0,4897,T
5-NP,736,5,0,0,4894,4899,C
5-NP,737,2,3,4882,0,4887,G
5-NP,738,2,0,4891,1,4894,G
5-NP,739,4894,0,1,0,4895,A
5-NP,740,4911,1,2,0,4914,A
5-NP,741,0,1,0,4898,4899,C
5-NP,742,4,0,1,4859,4864,C
5-NP,743,5,0,0,4880,4885,C
5-NP,744,4805,1,3,0,4809,A
5-NP,745,1,0,4815,0,4816,G
5-NP,746,1,5,4811,1,4818,G
5-NP,747,4792,0,1,1,4794,A
5-NP,748,4788,2,0,1,4791,A
5-NP,749,4781,0,2,0,4783,A
5-NP,750,1,1,0,4799,4801,C
5-NP,751,1,0,4800,0,4801,G
5-NP,752,0,0,0,4790,4790,C
5-NP,753,0,4773,0,4,4777,T
5-NP,754,0,2,4772,0,4774,G
5-NP,755,4766,0,5,0,4771,A
5-NP,756,2,1,4839,0,4842,G
5-NP,757,4880,1,4,0,4885,A
5-NP,758,2,4874,0,1,4877,T
5-NP,759,1,2,0,4817,4820,C
5-NP,760,1,0,4829,1,4831,G
5-NP,761,4828,0,0,0,4828,A
5-NP,762,4825,1,1,0,4827,A
5-NP,763,1,1,4814,0,4816,G
5-NP,764,4808,0,3,1,4812,A
5-NP,765,3,1,1,4630,4635,C
5-NP,766,2,1,1,4784,4788,C
5-NP,767,1,4793,0,5,4799,T
5-NP,768,1,1,0,4811,4813,C
5-NP,769,4829,0,0,0,4829,A
5-NP,770,0,4833,1,0,4834,T
5-NP,771,4840,0,1,0,4841,A
5-NP,772,1,4841,0,4,4846,T
5-NP,773,2,4800,0,0,4802,T
5-NP,774,0,4694,4,1,4699,T
5-NP,775,2,4643,3,1,4649,T
5-NP,776,1,4650,1,2,4654,T
5-NP,777,4664,0,3,2,4669,A
5-NP,778,9,2,4656,0,4667,G
5-NP,779,0,1,1,4661,4663,C
5-NP,780,4625,3,2,2,4632,A
5-NP,781,4611,3,1,1,4616,A
5-NP,782,0,1,4762,0,4763,G
5-NP,783,4757,2,0,1,4760,A
5-NP,784,1,4752,1,1,4755,T
5-NP,785,1,0,1,4791,4793,C
5-NP,786,0,4759,0,5,4764,T
5-NP,787,1,0,4898,0,4899,G
5-NP,788,1,2,0,4911,4914,C
5-NP,789,4914,1,2,0,4917,A
5-NP,790,0,4966,1,0,4967,T
5-NP,791,0,4787,0,1,4788,T
5-NP,792,1,3,5071,0,5075,G
5-NP,793,5165,1,3,0,5169,A
5-NP,794,2,5157,0,1,5160,T
5-NP,795,5172,2,2,0,5176,A
5-NP,796,0,5055,1,1,5057,T
5-NP,797,1,5015,0,2,5018,T
5-NP,798,2,1,5046,0,5049,G
5-NP,799,4989,1,2,1,4993,A
5-NP,800,2,2,5027,1,5032,G
5-NP,801,4758,0,6,1,4765,A
5-NP,802,1,0,4683,0,4684,G
5-NP,803,0,1,4740,0,4741,G
5-NP,804,4730,1,2,0,4733,A
5-NP,805,3,4724,0,3,4730,T
5-NP,806,5,1,0,4727,4733,C
5-NP,807,4699,0,3,0,4702,A
5-NP,808,1,0,4728,0,4729,G
5-NP,809,0,4704,0,1,4705,T
5-NP,810,2,4676,0,0,4678,T
5-NP,811,4,0,4663,0,4667,G
5-NP,812,0,2,0,4627,4629,C
5-NP,813,1,4618,0,6,4625,T
5-NP,814,3,0,0,4653,4656,C
5-NP,815,4659,1,1,1,4662,A
5-NP,816,0,1,0,4670,4671,C
5-NP,817,4650,0,0,0,4650,A
5-NP,818,4670,0,0,0,4670,A
5-NP,819,4672,2,1,0,4675,A
5-NP,820,0,4661,1,0,4662,T
5-NP,821,1,0,1,4666,4668,C
5-NP,822,0,4662,1,4,4667,T
5-NP,823,0,4652,0,5,4657,T
5-NP,824,1,0,4662,2,4665,G
5-NP,825,2,2,1,4657,4662,C
5-NP,826,1,1,0,4710,4712,C
5-NP,827,1,4707,0,3,4711,T
5-NP,828,4721,1,1,0,4723,A
5-NP,829,0,0,1,4722,4723,C
5-NP,830,1,1,0,4723,4725,C
5-NP,831,0,4694,0,4,4698,T
5-NP,832,0,1,4783,0,4784,G
5-NP,833,0,0,0,4765,4765,C
5-NP,834,2,1,1,4765,4769,C
5-NP,835,0,4687,1,6,4694,T
5-NP,836,3,1,4748,0,4752,G
5-NP,837,5,4711,0,8,4724,T
5-NP,838,1,0,4773,0,4774,G
5-NP,839,0,1,1,4808,4810,C
5-NP,840,4,1,4881,0,4886,G
5-NP,841,0,4816,0,4,4820,T
5-NP,842,4809,0,4,0,4813,A
5-NP,843,0,4820,0,1,4821,T
5-NP,844,2,2,4810,0,4814,G
5-NP,845,1,1,4961,2,4965,G
5-NP,846,4955,0,7,0,4962,A
5-NP,847,0,1,1,4895,4897,C
5-NP,848,4,1,2,4877,4884,C
5-NP,849,0,4826,1,6,4833,T
5-NP,850,1,0,5065,0,5066,G
5-NP,851,1,2,0,5067,5070,C
5-NP,852,5066,0,5,0,5071,A
5-NP,853,1,0,5150,0,5151,G
5-NP,854,1,4937,0,0,4938,T
5-NP,855,5117,1,2,0,5120,A
5-NP,856,2,5104,0,3,5109,T
5-NP,857,2,1,0,5089,5092,C
5-NP,858,1,57,1,5035,5094,C
5-NP,859,4879,0,1,0,4880,A
5-NP,860,2,0,4895,0,4897,G
5-NP,861,0,4868,0,1,4869,T
5-NP,862,0,0,4931,0,4931,G
5-NP,863,3,0,4917,0,4920,G
5-NP,864,1,3,4846,1,4851,G
5-NP,865,0,4843,0,2,4845,T
5-NP,866,4835,1,1,0,4837,A
5-NP,867,0,1,0,4830,4831,C
5-NP,868,0,1,4813,0,4814,G
5-NP,869,4799,1,0,0,4800,A
5-NP,870,2,0,1,4796,4799,C
5-NP,871,0,4670,0,3,4673,T
5-NP,872,0,4678,1,9,4688,T
5-NP,873,2,2,0,4653,4657,C
5-NP,874,1,4,4660,0,4665,G
5-NP,875,4667,1,1,1,4670,A
5-NP,876,4662,1,0,1,4664,A
5-NP,877,4674,2,2,0,4678,A
5-NP,878,4676,0,0,0,4676,A
5-NP,879,4655,0,3,0,4658,A
5-NP,880,1,1,4684,1,4687,G
5-NP,881,4670,0,6,0,4676,A
5-NP,882,0,5,4708,0,4713,G
5-NP,883,1,2,4728,1,4732,G
5-NP,884,1,3,4742,0,4746,G
5-NP,885,4762,1,5,0,4768,A
5-NP,886,0,4758,0,3,4761,T
5-NP,887,4785,0,0,0,4785,A
5-NP,888,1,4784,1,3,4789,T
5-NP,889,1,4799,0,1,4801,T
5-NP,890,5,0,0,4825,4830,C
5-NP,891,1,0,0,4803,4804,C
5-NP,892,1,4742,0,2,4745,T
5-NP,893,1,4742,0,1,4744,T
5-NP,894,3,6,4784,1,4794,G
5-NP,895,0,0,4806,1,4807,G
5-NP,896,2,4791,0,1,4794,T
5-NP,897,7,2,4763,2,4774,G
5-NP,898,3,3,4744,0,4750,G
5-NP,899,1,1,4941,0,4943,G
5-NP,900,4956,0,0,0,4956,A
5-NP,901,4960,0,1,2,4963,A
5-NP,902,0,4967,0,0,4967,T
5-NP,903,4877,0,1,0,4878,A
5-NP,904,1,1,4873,0,4875,G
5-NP,905,4849,0,2,0,4851,A
5-NP,906,2,2,0,4834,4838,C
5-NP,907,4,0,1,4777,4782,C
5-NP,908,4,0,0,4637,4641,C
5-NP,909,0,4690,1,6,4697,T
5-NP,910,1,4695,0,1,4697,T
5-NP,911,2,4703,0,0,4705,T
5-NP,912,1,1,0,4703,4705,C
5-NP,913,4686,4,1,0,4691,A
5-NP,914,4691,1,0,0,4692,A
5-NP,915,4676,0,0,0,4676,A
5-NP,916,0,0,0,4684,4684,C
5-NP,917,1,4558,0,1,4560,T
5-NP,918,4532,0,1,1,4534,A
5-NP,919,0,0,0,4588,4588,C
5-NP,920,2,4569,0,3,4574,T
5-NP,921,2,4566,1,1,4570,T
5-NP,922,2,0,0,4585,4587,C
5-NP,923,4573,0,0,0,4573,A
5-NP,924,4570,0,1,0,4571,A
5-NP,925,4562,0,1,0,4563,A
5-NP,926,4553,1,2,0,4556,A
5-NP,927,0,4522,0,1,4523,T
5-NP,928,4431,1,2,0,4434,A
5-NP,929,2,0,4481,0,4483,G
5-NP,930,3,2,0,4511,4516,C
5-NP,931,2,1,0,4573,4576,C
5-NP,932,4573,2,0,0,4575,A
5-NP,933,4587,0,0,0,4587,A
5-NP,934,4729,3,3,0,4735,A
5-NP,935,0,4739,0,0,4739,T
5-NP,936,4761,1,0,0,4762,A
5-NP,937,0,4754,0,1,4755,T
5-NP,938,4672,1,3,0,4676,A
5-NP,939,0,1,0,4679,4680,C
5-NP,940,4557,0,2,0,4559,A
5-NP,941,1,2,4652,0,4655,G
5-NP,942,0,1,0,4645,4646,C
5-NP,943,1,4515,0,5,4521,T
5-NP,944,1,4549,1,0,4551,T
5-NP,945,4562,0,2,0,4564,A
5-NP,946,4573,1,3,0,4577,A
5-NP,947,0,4581,0,0,4581,T
5-NP,948,2,3,0,4570,4575,C
5-NP,949,4418,0,1,0,4419,A
5-NP,950,1,2,4441,0,4444,G
5-NP,951,4450,0,0,0,4450,A
5-NP,952,3,1,0,4458,4462,C
5-NP,953,1,0,1,4440,4442,C
5-NP,954,1,4374,1,4,4380,T
5-NP,955,4420,0,1,0,4421,A
5-NP,956,4418,1,2,0,4421,A
5-NP,957,0,0,0,4439,4439,C
5-NP,958,1,0,4444,0,4445,G
5-NP,959,4358,1,1,0,4360,A
5-NP,960,1,0,4363,0,4364,G
5-NP,961,4317,1,5,0,4323,A
5-NP,962,4360,0,1,0,4361,A
5-NP,963,0,4347,0,4,4351,T
5-NP,964,0,1,1,4313,4315,C
5-NP,965,2,1,1,4305,4309,C
5-NP,966,4225,1,2,0,4228,A
5-NP,967,92,0,4148,0,4240,G
5-NP,968,0,0,0,4232,4232,C
5-NP,969,4271,1,1,0,4273,A
5-NP,970,1,0,0,4287,4288,C
5-NP,971,4222,0,3,1,4226,A
5-NP,972,0,1,0,4240,4241,C
5-NP,973,4221,1,2,0,4224,A
5-NP,974,4230,0,3,0,4233,A
5-NP,975,0,1,4238,0,4239,G
5-NP,976,4188,1,4,0,4193,A
5-NP,977,1,0,4214,0,4215,G
5-NP,978,1,4121,0,1,4123,T
5-NP,979,1,1,0,4101,4103,C
5-NP,980,4096,0,5,0,4101,A
5-NP,981,2,0,4091,0,4093,G
5-NP,982,1,0,1,4092,4094,C
5-NP,983,1,4059,0,1,4061,T
5-NP,984,1,0,4110,0,4111,G
5-NP,985,0,1,4125,1,4127,G
5-NP,986,0,4096,0,0,4096,T
5-NP,987,0,0,4109,0,4109,G
5-NP,988,0,4071,0,2,4073,T
5-NP,989,0,4,4062,0,4066,G
5-NP,990,1,1,4064,0,4066,G
5-NP,991,4048,0,1,0,4049,A
5-NP,992,0,4056,0,2,4058,T
5-NP,993,2,3,3917,0,3922,G
5-NP,994,1,1,3904,1,3907,G
5-NP,995,2,1,0,3885,3888,C
5-NP,996,3868,0,1,0,3869,A
5-NP,997,0,3863,0,2,3865,T
5-NP,998,0,0,3860,0,3860,G
5-NP,999,3,0,1,3875,3879,C
5-NP,1000,0,0,0,3889,3889,C
5-NP,1001,3883,1,2,0,3886,A
5-NP,1002,0,3843,0,19,3862,T
5-NP,1003,0,3820,0,1,3821,T
5-NP,1004,2,1,0,3832,3835,C
5-NP,1005,0,3789,0,0,3789,T
5-NP,1006,0,0,3788,0,3788,G
5-NP,1007,0,0,1,3779,3780,C
5-NP,1008,0,3693,0,3,3696,T
5-NP,1009,1,0,3725,0,3726,G
5-NP,1010,0,3,0,3682,3685,C
5-NP,1011,3685,0,0,0,3685,A
5-NP,1012,0,3673,0,2,3675,T
5-NP,1013,1,3639,2,0,3642,T
5-NP,1014,0,3643,0,1,3644,T
5-NP,1015,0,0,3644,0,3644,G
5-NP,1016,3636,1,6,0,3643,A
5-NP,1017,3637,0,4,0,3641,A
5-NP,1018,76,1,3582,0,3659,G
5-NP,1019,3645,1,1,0,3647,A
5-NP,1020,0,3618,0,1,3619,T
5-NP,1021,0,3620,0,0,3620,T
5-NP,1022,0,3620,1,0,3621,T
5-NP,1023,3619,0,1,0,3620,A
5-NP,1024,3622,0,1,0,3623,A
5-NP,1025,1,0,3625,0,3626,G
5-NP,1026,3617,0,2,1,3620,A
5-NP,1027,1,3582,0,0,3583,T
5-NP,1028,0,3469,0,0,3469,T
5-NP,1029,0,0,3489,0,3489,G
5-NP,1030,1,3484,0,1,3486,T
5-NP,1031,0,3482,0,1,3483,T
5-NP,1032,3480,0,2,0,3482,A
5-NP,1033,3474,0,4,0,3478,A
5-NP,1034,0,0,3484,0,3484,G
5-NP,1035,1,1,0,3484,3486,C
5-NP,1036,0,3396,1,2,3399,T
5-NP,1037,1,3395,0,1,3397,T
5-NP,1038,2,1,0,3388,3391,C
5-NP,1039,3391,1,1,0,3393,A
5-NP,1040,0,3388,0,0,3388,T
5-NP,1041,0,0,0,3391,3391,C
5-NP,1042,3323,1,4,1,3329,A
5-NP,1043,0,0,3324,0,3324,G
5-NP,1044,3271,0,2,0,3273,A
5-NP,1045,0,2,3270,1,3273,G
5-NP,1046,1,1,3266,0,3268,G
5-NP,1047,1,0,3243,0,3244,G
5-NP,1048,3243,1,3,0,3247,A
5-NP,1049,0,1,0,3241,3242,C
5-NP,1050,3244,1,1,0,3246,A
5-NP,1051,3247,0,1,0,3248,A
5-NP,1052,3248,0,2,0,3250,A
5-NP,1053,3248,1,2,0,3251,A
5-NP,1054,0,0,3262,0,3262,G
5-NP,1055,0,3171,0,2,3173,T
5-NP,1056,3156,0,2,0,3158,A
5-NP,1057,2,3133,0,3,3138,T
5-NP,1058,1,0,1,3140,3142,C
5-NP,1059,1,3109,1,4,3115,T
5-NP,1060,1,0,1,3129,3131,C
5-NP,1061,3,0,0,3096,3099,C
5-NP,1062,0,3079,0,1,3080,T
5-NP,1063,1,0,1,3062,3064,C
5-NP,1064,0,1,3062,0,3063,G
5-NP,1065,1,1,3079,0,3081,G
5-NP,1066,2,1,3071,2,3076,G
5-NP,1067,0,1,3063,0,3064,G
5-NP,1068,2,2,3058,0,3062,G
5-NP,1069,2999,2,1,0,3002,A
5-NP,1070,3006,0,0,0,3006,A
5-NP,1071,3007,0,2,0,3009,A
5-NP,1072,0,0,0,3013,3013,C
5-NP,1073,1,2984,0,2,2987,T
5-NP,1074,2,0,3000,0,3002,G
5-NP,1075,0,2974,0,1,2975,T
5-NP,1076,2,2,0,2971,2975,C
5-NP,1077,3007,1,2,0,3010,A
5-NP,1078,3016,0,0,1,3017,A
5-NP,1079,0,1,0,3024,3025,C
5-NP,1080,0,3017,0,2,3019,T
5-NP,1081,2960,0,3,0,2963,A
5-NP,1082,1,1,2965,0,2967,G
5-NP,1083,2902,0,0,0,2902,A
5-NP,1084,1,0,2905,0,2906,G
5-NP,1085,0,0,2894,0,2894,G
5-NP,1086,2717,1,1,0,2719,A
5-NP,1087,0,0,2735,0,2735,G
5-NP,1088,0,2702,0,1,2703,T
5-NP,1089,2704,0,1,0,2705,A
5-NP,1090,0,2,0,2703,2705,C
5-NP,1091,2657,0,0,0,2657,A
5-NP,1092,2657,0,1,0,2658,A
5-NP,1093,2633,0,0,0,2633,A
5-NP,1094,1,2597,0,1,2599,T
5-NP,1095,0,2583,0,1,2584,T
5-NP,1096,2,0,2476,0,2478,G
5-NP,1097,2,1,0,2431,2434,C
5-NP,1098,1,2419,0,0,2420,T
5-NP,1099,2,2416,0,1,2419,T
5-NP,1100,2,1,0,2415,2418,C
5-NP,1101,2421,1,1,0,2423,A
5-NP,1102,2419,1,0,0,2420,A
5-NP,1103,2423,1,0,0,2424,A
5-NP,1104,0,2422,0,0,2422,T
5-NP,1105,0,0,2421,0,2421,G
5-NP,1106,2356,0,2,0,2358,A
5-NP,1107,0,0,2355,1,2356,G
5-NP,1108,2361,0,2,0,2363,A
5-NP,1109,2351,1,1,0,2353,A
5-NP,1110,0,0,0,2351,2351,C
5-NP,1111,2317,0,1,0,2318,A
5-NP,1112,2,2310,0,0,2312,T
5-NP,1113,1,0,2306,0,2307,G
5-NP,1114,0,1,2305,0,2306,G
5-NP,1115,2305,0,0,0,2305,A
5-NP,1116,0,2254,0,0,2254,T
5-NP,1117,2217,0,0,0,2217,A
5-NP,1118,2229,0,0,0,2229,A
5-NP,1119,0,2178,0,1,2179,T
5-NP,1120,2164,0,0,0,2164,A
5-NP,1121,0,2150,1,1,2152,T
5-NP,1122,0,4,1907,0,1911,G
5-NP,1123,0,0,1860,0,1860,G
5-NP,1124,0,1,1849,1,1851,G
5-NP,1125,1833,0,1,0,1834,A
5-NP,1126,0,1830,0,0,1830,T
5-NP,1127,1,0,0,1278,1279,C
5-NP,1128,1,0,1272,0,1273,G
5-NP,1129,1266,0,3,0,1269,A
5-NP,1130,0,0,1271,0,1271,G
5-NP,1131,1,1,1,1261,1264,C
5-NP,1132,1244,0,0,0,1244,A
5-NP,1133,0,0,0,1237,1237,C
5-NP,1134,1,1216,0,0,1217,T
5-NP,1135,1,0,0,1219,1220,C
5-NP,1136,0,1219,0,0,1219,T
5-NP,1137,0,1191,0,0,1191,T
5-NP,1138,1,0,1189,0,1190,G
5-NP,1139,1174,0,1,0,1175,A
5-NP,1140,1169,1,1,0,1171,A
5-NP,1141,0,0,1,1171,1172,C
5-NP,1142,0,715,0,1,716,T
5-NP,1143,0,0,714,0,714,G
5-NP,1144,661,0,0,0,661,A
5-NP,1145,0,0,663,0,663,G
5-NP,1146,662,0,0,0,662,A
5-NP,1147,633,0,0,0,633,A
5-NP,1148,0,0,634,0,634,G
5-NP,1149,0,0,0,590,590,C
5-NP,1150,1,0,583,0,584,G
5-NP,1151,0,0,582,0,582,G
5-NP,1152,0,0,527,0,527,G
5-NP,1153,0,510,0,0,510,T
5-NP,1154,471,0,0,0,471,A
5-NP,1155,0,0,1,467,468,C
5-NP,1156,0,145,0,0,145,T
5-NP,1157,0,0,121,0,121,G
5-NP,1158,0,0,102,0,102,G
5-NP,1159,0,0,74,0,74,G
5-NP,1160,0,0,0,56,56,C
5-NP,1161,0,0,0,1,1,C
6-NA,1,16,0,0,0,16,A
6-NA,2,0,16,0,0,16,T
6-NA,3,0,0,16,0,16,G
6-NA,4,17,0,0,0,17,A
6-NA,5,20,0,0,0,20,A
6-NA,6,0,19,0,0,19,T
6-NA,7,0,0,0,20,20,C
6-NA,8,0,0,0,20,20,C
6-NA,9,20,0,0,0,20,A
6-NA,10,21,0,0,0,21,A
6-NA,11,21,0,0,0,21,A
6-NA,12,0,20,0,0,20,T
6-NA,13,0,0,0,21,21,C
6-NA,14,21,0,0,0,21,A
6-NA,15,21,0,0,0,21,A
6-NA,16,21,0,0,0,21,A
6-NA,17,24,0,0,0,24,A
6-NA,18,0,0,30,0,30,G
6-NA,19,31,0,0,0,31,A
6-NA,20,0,31,0,0,31,T
6-NA,21,31,0,0,0,31,A
6-NA,22,31,0,0,0,31,A
6-NA,23,0,31,0,0,31,T
6-NA,24,31,0,0,0,31,A
6-NA,25,31,0,0,0,31,A
6-NA,26,0,0,0,32,32,C
6-NA,27,0,0,33,0,33,G
6-NA,28,33,0,0,0,33,A
6-NA,29,0,33,0,0,33,T
6-NA,30,0,33,0,0,33,T
6-NA,31,0,0,34,0,34,G
6-NA,32,0,0,35,0,35,G
6-NA,33,0,0,0,35,35,C
6-NA,34,0,33,0,2,35,T
6-NA,35,0,0,0,37,37,C
6-NA,36,0,37,0,0,37,T
6-NA,37,0,0,40,0,40,G
6-NA,38,0,40,0,0,40,T
6-NA,39,0,40,0,0,40,T
6-NA,40,0,41,0,0,41,T
6-NA,41,0,0,0,41,41,C
6-NA,42,0,41,0,0,41,T
6-NA,43,0,0,0,41,41,C
6-NA,44,0,41,0,0,41,T
6-NA,45,0,0,0,41,41,C
6-NA,46,41,0,0,0,41,A
6-NA,47,0,0,0,42,42,C
6-NA,48,0,0,0,42,42,C
6-NA,49,42,0,0,0,42,A
6-NA,50,0,42,0,0,42,T
6-NA,51,0,42,0,0,42,T
6-NA,52,0,42,0,0,42,T
6-NA,53,0,0,0,43,43,C
6-NA,54,0,0,0,43,43,C
6-NA,55,44,0,0,0,44,A
6-NA,56,0,0,0,43,43,C
6-NA,57,44,0,0,0,44,A
6-NA,58,48,0,0,0,48,A
6-NA,59,0,48,0,0,48,T
6-NA,60,51,0,0,0,51,A
6-NA,61,0,51,0,0,51,T
6-NA,62,0,0,50,0,50,G
6-NA,63,0,0,0,50,50,C
6-NA,64,0,51,0,0,51,T
6-NA,65,0,52,0,0,52,T
6-NA,66,0,0,0,52,52,C
6-NA,67,0,52,0,0,52,T
6-NA,68,0,52,0,0,52,T
6-NA,69,0,0,0,51,51,C
6-NA,70,50,0,1,0,51,A
6-NA,71,0,52,0,0,52,T
6-NA,72,2,1,50,0,53,G
6-NA,73,0,0,0,52,52,C
6-NA,74,53,0,0,0,53,A
6-NA,75,53,0,0,0,53,A
6-NA,76,53,0,0,0,53,A
6-NA,77,0,52,0,1,53,T
6-NA,78,0,53,0,0,53,T
6-NA,79,0,0,53,0,53,G
6-NA,80,0,0,0,53,53,C
6-NA,81,0,0,0,53,53,C
6-NA,82,53,0,0,0,53,A
6-NA,83,0,53,0,0,53,T
6-NA,84,0,0,0,56,56,C
6-NA,85,0,56,0,0,56,T
6-NA,86,0,56,0,0,56,T
6-NA,87,0,0,58,0,58,G
6-NA,88,57,0,0,0,57,A
6-NA,89,0,58,0,0,58,T
6-NA,90,59,0,0,0,59,A
6-NA,91,59,0,0,0,59,A
6-NA,92,0,0,0,70,70,C
6-NA,93,0,69,0,1,70,T
6-NA,94,69,0,0,0,69,A
6-NA,95,0,0,0,73,73,C
6-NA,96,0,70,0,0,70,T
6-NA,97,0,0,74,0,74,G
6-NA,98,0,74,0,0,74,T
6-NA,99,74,0,0,0,74,A
6-NA,100,74,0,0,0,74,A
6-NA,101,0,0,0,69,69,C
6-NA,102,67,0,0,0,67,A
6-NA,103,0,67,0,0,67,T
6-NA,104,0,67,0,0,67,T
6-NA,105,0,0,66,0,66,G
6-NA,106,0,0,0,68,68,C
6-NA,107,69,0,0,0,69,A
6-NA,108,0,69,0,0,69,T
6-NA,109,0,69,0,0,69,T
6-NA,110,0,69,0,0,69,T
6-NA,111,0,0,0,69,69,C
6-NA,112,68,0,0,0,68,A
6-NA,113,70,0,0,0,70,A
6-NA,114,0,0,72,0,72,G
6-NA,115,0,0,0,73,73,C
6-NA,116,73,0,0,0,73,A
6-NA,117,81,0,0,0,81,A
6-NA,118,0,81,0,0,81,T
6-NA,119,81,0,0,0,81,A
6-NA,120,0,81,0,0,81,T
6-NA,121,0,0,84,0,84,G
6-NA,122,84,0,0,0,84,A
6-NA,123,84,0,0,0,84,A
6-NA,124,0,85,0,0,85,T
6-NA,125,0,85,0,0,85,T
6-NA,126,0,0,0,85,85,C
6-NA,127,84,0,0,0,84,A
6-NA,128,84,0,0,0,84,A
6-NA,129,0,0,0,84,84,C
6-NA,130,0,84,0,0,84,T
6-NA,131,0,0,0,84,84,C
6-NA,132,0,0,0,83,83,C
6-NA,133,0,0,0,86,86,C
6-NA,134,0,0,0,86,86,C
6-NA,135,1,0,0,84,85,C
6-NA,136,0,0,0,84,84,C
6-NA,137,0,0,0,87,87,C
6-NA,138,85,0,0,0,85,A
6-NA,139,87,0,0,0,87,A
6-NA,140,87,0,0,0,87,A
6-NA,141,0,0,0,90,90,C
6-NA,142,87,0,0,0,87,A
6-NA,143,91,0,0,0,91,A
6-NA,144,0,0,0,91,91,C
6-NA,145,1,0,0,90,91,C
6-NA,146,96,0,0,0,96,A
6-NA,147,97,0,0,0,97,A
6-NA,148,0,0,98,0,98,G
6-NA,149,0,99,0,0,99,T
6-NA,150,0,0,98,0,98,G
6-NA,151,100,0,0,0,100,A
6-NA,152,0,99,0,0,99,T
6-NA,153,0,0,100,0,100,G
6-NA,154,0,0,0,100,100,C
6-NA,155,0,99,0,0,99,T
6-NA,156,0,0,106,0,106,G
6-NA,157,0,107,0,0,107,T
6-NA,158,0,0,108,0,108,G
6-NA,159,0,108,0,0,108,T
6-NA,160,0,0,108,0,108,G
6-NA,161,108,0,0,0,108,A
6-NA,162,109,0,0,0,109,A
6-NA,163,0,0,0,108,108,C
6-NA,164,1,0,0,108,109,C
6-NA,165,108,0,0,0,108,A
6-NA,166,108,0,0,0,108,A
6-NA,167,0,0,0,112,112,C
6-NA,168,112,0,0,0,112,A
6-NA,169,111,0,0,0,111,A
6-NA,170,0,112,0,0,112,T
6-NA,171,112,0,0,0,112,A
6-NA,172,112,0,1,0,113,A
6-NA,173,0,113,0,0,113,T
6-NA,174,112,0,0,0,112,A
6-NA,175,0,1,115,0,116,G
6-NA,176,110,0,0,0,110,A
6-NA,177,113,0,0,0,113,A
6-NA,178,112,0,0,0,112,A
6-NA,179,0,0,112,0,112,G
6-NA,180,113,0,0,0,113,A
6-NA,181,112,0,0,0,112,A
6-NA,182,114,0,0,0,114,A
6-NA,183,0,0,0,115,115,C
6-NA,184,116,0,0,0,116,A
6-NA,185,0,115,0,0,115,T
6-NA,186,116,0,0,0,116,A
6-NA,187,118,0,0,0,118,A
6-NA,188,0,0,0,118,118,C
6-NA,189,116,0,0,0,116,A
6-NA,190,0,0,118,0,118,G
6-NA,191,120,0,1,0,121,A
6-NA,192,0,0,120,0,120,G
6-NA,193,120,0,1,0,121,A
6-NA,194,0,128,0,0,128,T
6-NA,195,128,0,0,0,128,A
6-NA,196,0,0,135,0,135,G
6-NA,197,0,133,0,0,133,T
6-NA,198,0,0,139,0,139,G
6-NA,199,0,137,0,0,137,T
6-NA,200,137,0,0,0,137,A
6-NA,201,0,138,0,0,138,T
6-NA,202,0,0,0,137,137,C
6-NA,203,1,136,0,0,137,T
6-NA,204,0,1,143,0,144,G
6-NA,205,144,0,0,0,144,A
6-NA,206,0,0,0,144,144,C
6-NA,207,0,0,0,143,143,C
6-NA,208,143,0,0,0,143,A
6-NA,209,144,0,0,0,144,A
6-NA,210,1,0,0,146,147,C
6-NA,211,146,0,1,0,147,A
6-NA,212,0,0,0,157,157,C
6-NA,213,0,0,0,156,156,C
6-NA,214,161,0,0,0,161,A
6-NA,215,0,0,0,167,167,C
6-NA,216,0,0,0,167,167,C
6-NA,217,168,0,0,0,168,A
6-NA,218,0,167,0,0,167,T
6-NA,219,168,0,0,0,168,A
6-NA,220,0,0,168,0,168,G
6-NA,221,165,0,0,0,165,A
6-NA,222,0,1,164,0,165,G
6-NA,223,162,0,0,0,162,A
6-NA,224,162,0,0,0,162,A
6-NA,225,0,0,163,0,163,G
6-NA,226,0,1,165,0,166,G
6-NA,227,165,0,0,1,166,A
6-NA,228,165,0,0,0,165,A
6-NA,229,165,0,0,0,165,A
6-NA,230,0,165,0,0,165,T
6-NA,231,166,0,0,0,166,A
6-NA,232,0,167,0,0,167,T
6-NA,233,0,0,166,0,166,G
6-NA,234,0,0,0,164,164,C
6-NA,235,0,0,0,164,164,C
6-NA,236,0,0,0,164,164,C
6-NA,237,0,0,0,165,165,C
6-NA,238,165,0,0,0,165,A
6-NA,239,172,0,0,0,172,A
6-NA,240,170,0,0,0,170,A
6-NA,241,0,0,0,172,172,C
6-NA,242,0,172,0,0,172,T
6-NA,243,172,0,0,0,172,A
6-NA,244,0,0,170,0,170,G
6-NA,245,0,0,0,171,171,C
6-NA,246,170,0,1,0,171,A
6-NA,247,0,0,173,0,173,G
6-NA,248,172,0,0,0,172,A
6-NA,249,172,0,0,0,172,A
6-NA,250,0,172,0,0,172,T
6-NA,251,173,0,0,0,173,A
6-NA,252,0,0,0,174,174,C
6-NA,253,174,0,0,0,174,A
6-NA,254,0,0,175,0,175,G
6-NA,255,176,0,0,0,176,A
6-NA,256,174,0,0,0,174,A
6-NA,257,174,0,0,0,174,A
6-NA,258,0,173,0,0,173,T
6-NA,259,0,171,0,0,171,T
6-NA,260,0,0,171,0,171,G
6-NA,261,0,0,171,0,171,G
6-NA,262,0,172,0,0,172,T
6-NA,263,1,0,0,171,172,C
6-NA,264,172,0,0,0,172,A
6-NA,265,171,0,0,0,171,A
6-NA,266,171,0,0,0,171,A
6-NA,267,0,0,172,0,172,G
6-NA,268,0,0,0,171,171,C
6-NA,269,0,0,0,169,169,C
6-NA,270,0,0,171,0,171,G
6-NA,271,0,0,0,170,170,C
6-NA,272,172,0,0,0,172,A
6-NA,273,175,0,0,0,175,A
6-NA,274,0,174,0,0,174,T
6-NA,275,0,0,176,0,176,G
6-NA,276,0,175,0,0,175,T
6-NA,277,1,0,174,0,175,G
6-NA,278,176,0,0,0,176,A
6-NA,279,0,0,0,178,178,C
6-NA,280,183,0,0,0,183,A
6-NA,281,0,183,0,0,183,T
6-NA,282,0,182,0,0,182,T
6-NA,283,182,0,0,0,182,A
6-NA,284,0,0,0,182,182,C
6-NA,285,181,0,0,0,181,A
6-NA,286,0,0,181,0,181,G
6-NA,287,0,0,175,0,175,G
6-NA,288,0,0,173,0,173,G
6-NA,289,0,175,0,0,175,T
6-NA,290,0,174,0,0,174,T
6-NA,291,0,174,0,0,174,T
6-NA,292,0,0,175,0,175,G
6-NA,293,0,0,0,175,175,C
6-NA,294,177,0,0,0,177,A
6-NA,295,0,0,0,178,178,C
6-NA,296,1,0,0,175,176,C
6-NA,297,0,171,0,0,171,T
6-NA,298,0,172,0,0,172,T
6-NA,299,0,171,0,0,171,T
6-NA,300,0,172,0,0,172,T
6-NA,301,0,174,0,0,174,T
6-NA,302,0,0,0,171,171,C
6-NA,303,0,174,0,0,174,T
6-NA,304,173,0,0,0,173,A
6-NA,305,171,0,0,0,171,A
6-NA,306,0,0,173,0,173,G
6-NA,307,0,0,174,0,174,G
6-NA,308,173,0,0,0,173,A
6-NA,309,0,0,0,174,174,C
6-NA,310,169,0,0,0,169,A
6-NA,311,169,0,0,0,169,A
6-NA,312,0,170,0,0,170,T
6-NA,313,0,171,0,0,171,T
6-NA,314,0,0,0,173,173,C
6-NA,315,0,0,173,0,173,G
6-NA,316,174,0,0,0,174,A
6-NA,317,0,174,0,0,174,T
6-NA,318,0,173,0,0,173,T
6-NA,319,172,0,1,0,173,A
6-NA,320,0,0,174,0,174,G
6-NA,321,0,0,175,0,175,G
6-NA,322,0,0,0,174,174,C
6-NA,323,0,173,0,0,173,T
6-NA,324,0,172,0,0,172,T
6-NA,325,0,173,0,0,173,T
6-NA,326,0,0,0,174,174,C
6-NA,327,2,0,0,172,174,C
6-NA,328,0,0,172,0,172,G
6-NA,329,0,0,0,172,172,C
6-NA,330,0,170,0,0,170,T
6-NA,331,0,0,176,0,176,G
6-NA,332,0,0,176,0,176,G
6-NA,333,0,175,0,0,175,T
6-NA,334,0,0,175,0,175,G
6-NA,335,0,0,174,0,174,G
6-NA,336,0,0,177,0,177,G
6-NA,337,0,0,177,0,177,G
6-NA,338,174,0,0,0,174,A
6-NA,339,0,0,0,179,179,C
6-NA,340,176,0,0,0,176,A
6-NA,341,0,173,0,0,173,T
6-NA,342,0,0,0,175,175,C
6-NA,343,0,173,0,1,174,T
6-NA,344,0,0,175,0,175,G
6-NA,345,0,0,174,0,174,G
6-NA,346,0,0,175,0,175,G
6-NA,347,0,175,0,0,175,T
6-NA,348,0,0,172,0,172,G
6-NA,349,171,0,1,0,172,A
6-NA,350,0,0,0,173,173,C
6-NA,351,174,0,1,0,175,A
6-NA,352,179,0,0,0,179,A
6-NA,353,0,0,183,0,183,G
6-NA,354,179,0,0,0,179,A
6-NA,355,0,0,185,0,185,G
6-NA,356,191,0,0,0,191,A
6-NA,357,210,0,0,0,210,A
6-NA,358,0,0,0,265,265,C
6-NA,359,0,0,0,283,283,C
6-NA,360,0,282,0,0,282,T
6-NA,361,0,283,0,2,285,T
6-NA,362,284,0,0,0,284,A
6-NA,363,0,283,0,0,283,T
6-NA,364,0,0,300,0,300,G
6-NA,365,0,300,0,0,300,T
6-NA,366,0,0,304,0,304,G
6-NA,367,0,303,0,1,304,T
6-NA,368,0,0,0,301,301,C
6-NA,369,301,0,1,1,303,A
6-NA,370,0,302,0,0,302,T
6-NA,371,0,0,302,0,302,G
6-NA,372,0,0,0,304,304,C
6-NA,373,0,0,303,0,303,G
6-NA,374,344,0,0,0,344,A
6-NA,375,0,346,0,0,346,T
6-NA,376,0,0,0,362,362,C
6-NA,377,0,0,0,362,362,C
6-NA,378,0,368,0,3,371,T
6-NA,379,0,1,376,0,377,G
6-NA,380,377,0,0,0,377,A
6-NA,381,0,1,0,378,379,C
6-NA,382,378,0,0,0,378,A
6-NA,383,370,0,2,0,372,A
6-NA,384,0,0,386,0,386,G
6-NA,385,0,385,0,0,385,T
6-NA,386,0,0,395,0,395,G
6-NA,387,0,394,0,0,394,T
6-NA,388,0,394,0,0,394,T
6-NA,389,394,0,0,0,394,A
6-NA,390,0,393,0,0,393,T
6-NA,391,0,0,0,401,401,C
6-NA,392,402,0,0,0,402,A
6-NA,393,401,0,0,0,401,A
6-NA,394,0,401,0,0,401,T
6-NA,395,0,401,0,0,401,T
6-NA,396,0,401,0,0,401,T
6-NA,397,1,0,404,0,405,G
6-NA,398,0,0,0,419,419,C
6-NA,399,0,0,0,418,418,C
6-NA,400,0,0,1,417,418,C
6-NA,401,0,419,0,1,420,T
6-NA,402,0,419,0,0,419,T
6-NA,403,0,0,426,0,426,G
6-NA,404,0,0,426,0,426,G
6-NA,405,434,0,0,0,434,A
6-NA,406,0,1,0,431,432,C
6-NA,407,426,0,2,0,428,A
6-NA,408,0,0,442,0,442,G
6-NA,409,0,0,444,0,444,G
6-NA,410,0,1,465,0,466,G
6-NA,411,462,0,2,0,464,A
6-NA,412,464,0,0,0,464,A
6-NA,413,0,0,0,466,466,C
6-NA,414,466,0,0,0,466,A
6-NA,415,503,0,0,0,503,A
6-NA,416,0,0,0,505,505,C
6-NA,417,502,0,0,0,502,A
6-NA,418,0,0,0,506,506,C
6-NA,419,0,496,0,0,496,T
6-NA,420,502,0,0,0,502,A
6-NA,421,500,0,0,0,500,A
6-NA,422,504,0,0,0,504,A
6-NA,423,0,0,0,506,506,C
6-NA,424,486,0,0,0,486,A
6-NA,425,494,1,1,0,496,A
6-NA,426,0,0,0,499,499,C
6-NA,427,0,0,499,0,499,G
6-NA,428,0,498,0,1,499,T
6-NA,429,495,0,0,0,495,A
6-NA,430,0,0,0,506,506,C
6-NA,431,505,0,1,0,506,A
6-NA,432,0,507,0,2,509,T
6-NA,433,0,509,0,0,509,T
6-NA,434,1,0,0,528,529,C
6-NA,435,540,0,1,0,541,A
6-NA,436,545,0,0,0,545,A
6-NA,437,544,0,0,0,544,A
6-NA,438,0,546,0,0,546,T
6-NA,439,541,0,0,0,541,A
6-NA,440,561,0,0,0,561,A
6-NA,441,0,0,0,561,561,C
6-NA,442,561,0,0,0,561,A
6-NA,443,0,0,0,574,574,C
6-NA,444,558,0,0,0,558,A
6-NA,445,0,0,675,0,675,G
6-NA,446,0,677,0,0,677,T
6-NA,447,690,0,1,0,691,A
6-NA,448,1,0,0,696,697,C
6-NA,449,0,0,693,0,693,G
6-NA,450,0,724,0,0,724,T
6-NA,451,1,0,726,0,727,G
6-NA,452,725,0,0,0,725,A
6-NA,453,0,729,0,0,729,T
6-NA,454,681,0,0,0,681,A
6-NA,455,0,2,678,0,680,G
6-NA,456,0,0,679,0,679,G
6-NA,457,678,1,0,0,679,A
6-NA,458,0,0,0,690,690,C
6-NA,459,0,0,0,685,685,C
6-NA,460,1,1,0,697,699,C
6-NA,461,0,0,0,698,698,C
6-NA,462,0,702,1,1,704,T
6-NA,463,0,712,0,0,712,T
6-NA,464,716,0,0,0,716,A
6-NA,465,0,715,0,0,715,T
6-NA,466,0,0,0,717,717,C
6-NA,467,0,1,711,0,712,G
6-NA,468,0,0,709,0,709,G
6-NA,469,710,0,1,0,711,A
6-NA,470,1,0,0,723,724,C
6-NA,471,1,0,0,721,722,C
6-NA,472,2,0,0,747,749,C
6-NA,473,0,748,0,0,748,T
6-NA,474,769,0,0,0,769,A
6-NA,475,0,770,0,0,770,T
6-NA,476,0,773,0,0,773,T
6-NA,477,0,0,772,0,772,G
6-NA,478,770,1,2,0,773,A
6-NA,479,0,776,0,1,777,T
6-NA,480,0,2,775,0,777,G
6-NA,481,759,0,0,0,759,A
6-NA,482,757,0,0,0,757,A
6-NA,483,0,756,0,0,756,T
6-NA,484,1,1,768,0,770,G
6-NA,485,781,1,0,0,782,A
6-NA,486,0,0,788,0,788,G
6-NA,487,0,788,0,0,788,T
6-NA,488,0,790,0,0,790,T
6-NA,489,789,1,0,0,790,A
6-NA,490,0,0,791,0,791,G
6-NA,491,0,1,791,0,792,G
6-NA,492,0,793,0,0,793,T
6-NA,493,0,0,791,0,791,G
6-NA,494,0,785,0,0,785,T
6-NA,495,0,786,0,0,786,T
6-NA,496,0,0,0,794,794,C
6-NA,497,0,0,0,797,797,C
6-NA,498,0,788,0,1,789,T
6-NA,499,0,790,0,0,790,T
6-NA,500,0,789,0,0,789,T
6-NA,501,0,788,0,1,789,T
6-NA,502,0,0,0,794,794,C
6-NA,503,790,0,0,0,790,A
6-NA,504,0,810,0,0,810,T
6-NA,505,0,0,0,808,808,C
6-NA,506,0,804,0,1,805,T
6-NA,507,0,0,802,0,802,G
6-NA,508,0,2,795,0,797,G
6-NA,509,0,0,801,0,801,G
6-NA,510,0,0,807,0,807,G
6-NA,511,804,1,0,0,805,A
6-NA,512,0,1,0,808,809,C
6-NA,513,0,0,0,798,798,C
6-NA,514,810,0,0,0,810,A
6-NA,515,813,0,1,0,814,A
6-NA,516,0,0,814,0,814,G
6-NA,517,1,1,0,819,821,C
6-NA,518,809,1,2,0,812,A
6-NA,519,817,0,1,0,818,A
6-NA,520,0,0,821,0,821,G
6-NA,521,0,819,0,0,819,T
6-NA,522,0,0,831,0,831,G
6-NA,523,0,826,0,0,826,T
6-NA,524,1,0,845,0,846,G
6-NA,525,0,0,0,850,850,C
6-NA,526,852,0,0,0,852,A
6-NA,527,0,864,0,1,865,T
6-NA,528,857,0,0,0,857,A
6-NA,529,0,0,883,0,883,G
6-NA,530,0,0,0,883,883,C
6-NA,531,866,0,0,0,866,A
6-NA,532,0,865,0,0,865,T
6-NA,533,0,2,825,0,827,G
6-NA,534,1,1,902,0,904,G
6-NA,535,0,905,0,0,905,T
6-NA,536,0,0,0,900,900,C
6-NA,537,0,1,0,914,915,C
6-NA,538,907,0,1,0,908,A
6-NA,539,0,0,953,0,953,G
6-NA,540,0,0,0,961,961,C
6-NA,541,0,961,0,0,961,T
6-NA,542,1,0,0,961,962,C
6-NA,543,945,0,0,0,945,A
6-NA,544,961,0,0,0,961,A
6-NA,545,0,1,968,0,969,G
6-NA,546,0,973,0,0,973,T
6-NA,547,0,974,0,0,974,T
6-NA,548,0,0,979,0,979,G
6-NA,549,0,980,0,0,980,T
6-NA,550,1,0,0,980,981,C
6-NA,551,981,0,0,1,982,A
6-NA,552,0,0,1,995,996,C
6-NA,553,0,1,989,0,990,G
6-NA,554,1017,1,0,0,1018,A
6-NA,555,0,1018,0,1,1019,T
6-NA,556,1,0,1040,0,1041,G
6-NA,557,0,2,1050,0,1052,G
6-NA,558,1045,0,1,1,1047,A
6-NA,559,1049,0,0,0,1049,A
6-NA,560,1066,0,1,0,1067,A
6-NA,561,1066,0,5,0,1071,A
6-NA,562,0,0,1089,0,1089,G
6-NA,563,1,0,0,1084,1085,C
6-NA,564,1088,0,0,0,1088,A
6-NA,565,0,1085,0,0,1085,T
6-NA,566,1,1,1093,0,1095,G
6-NA,567,0,0,1107,0,1107,G
6-NA,568,0,0,0,1126,1126,C
6-NA,569,0,1125,0,1,1126,T
6-NA,570,0,0,1131,0,1131,G
6-NA,571,0,0,0,1131,1131,C
6-NA,572,1136,0,1,0,1137,A
6-NA,573,1,1169,0,0,1170,T
6-NA,574,1,0,1171,0,1172,G
6-NA,575,0,1176,1,1,1178,T
6-NA,576,0,1188,0,0,1188,T
6-NA,577,0,1183,0,1,1184,T
6-NA,578,0,0,1253,0,1253,G
6-NA,579,0,1257,0,0,1257,T
6-NA,580,1262,0,0,0,1262,A
6-NA,581,0,1268,0,1,1269,T
6-NA,582,1257,0,1,0,1258,A
6-NA,583,1253,1,0,1,1255,A
6-NA,584,0,0,0,1251,1251,C
6-NA,585,0,1,1248,0,1249,G
6-NA,586,0,0,1249,0,1249,G
6-NA,587,1,0,1232,0,1233,G
6-NA,588,1222,0,3,0,1225,A
6-NA,589,0,0,1238,0,1238,G
6-NA,590,1237,1,0,0,1238,A
6-NA,591,0,1253,0,0,1253,T
6-NA,592,0,1,1259,0,1260,G
6-NA,593,1265,0,0,0,1265,A
6-NA,594,1,1270,0,0,1271,T
6-NA,595,1264,0,1,0,1265,A
6-NA,596,1287,0,0,0,1287,A
6-NA,597,1291,0,0,1,1292,A
6-NA,598,1291,0,1,0,1292,A
6-NA,599,1302,0,0,0,1302,A
6-NA,600,0,1299,0,0,1299,T
6-NA,601,1,0,1299,0,1300,G
6-NA,602,0,0,0,1298,1298,C
6-NA,603,1303,1,1,0,1305,A
6-NA,604,1306,0,0,1,1307,A
6-NA,605,0,0,0,1322,1322,C
6-NA,606,0,1319,0,0,1319,T
6-NA,607,0,0,1325,0,1325,G
6-NA,608,0,1,1,1323,1325,C
6-NA,609,0,1322,1,1,1324,T
6-NA,610,1327,0,0,0,1327,A
6-NA,611,0,0,1338,0,1338,G
6-NA,612,0,0,0,1352,1352,C
6-NA,613,0,1355,0,0,1355,T
6-NA,614,0,1349,0,0,1349,T
6-NA,615,0,0,0,1368,1368,C
6-NA,616,1378,0,0,0,1378,A
6-NA,617,0,1382,0,0,1382,T
6-NA,618,0,1387,0,1,1388,T
6-NA,619,0,1388,1,2,1391,T
6-NA,620,1406,0,1,0,1407,A
6-NA,621,0,5,0,1421,1426,C
6-NA,622,1420,0,0,0,1420,A
6-NA,623,1434,1,0,0,1435,A
6-NA,624,0,1419,1,3,1423,T
6-NA,625,2,0,1427,0,1429,G
6-NA,626,0,1,1422,0,1423,G
6-NA,627,0,3,1419,0,1422,G
6-NA,628,1419,1,1,0,1421,A
6-NA,629,0,0,1452,0,1452,G
6-NA,630,0,0,1469,0,1469,G
6-NA,631,0,2,0,1596,1598,C
6-NA,632,0,1598,0,0,1598,T
6-NA,633,0,1620,0,1,1621,T
6-NA,634,0,0,1630,0,1630,G
6-NA,635,0,1639,0,0,1639,T
6-NA,636,1672,0,1,0,1673,A
6-NA,637,0,0,1693,0,1693,G
6-NA,638,1672,0,2,0,1674,A
6-NA,639,0,1675,0,0,1675,T
6-NA,640,1573,1,0,0,1574,A
6-NA,641,0,0,1577,0,1577,G
6-NA,642,0,1559,0,3,1562,T
6-NA,643,0,0,1530,0,1530,G
6-NA,644,0,1599,0,0,1599,T
6-NA,645,0,1595,0,0,1595,T
6-NA,646,1,0,1633,0,1634,G
6-NA,647,0,1633,0,1,1634,T
6-NA,648,1,1636,0,0,1637,T
6-NA,649,0,1640,0,0,1640,T
6-NA,650,0,1,0,1625,1626,C
6-NA,651,1621,0,1,0,1622,A
6-NA,652,0,1617,0,1,1618,T
6-NA,653,0,0,1612,0,1612,G
6-NA,654,1,0,1717,0,1718,G
6-NA,655,2,1709,0,1,1712,T
6-NA,656,0,0,0,1713,1713,C
6-NA,657,0,1,0,1709,1710,C
6-NA,658,1718,0,0,0,1718,A
6-NA,659,1736,0,0,0,1736,A
6-NA,660,1733,0,1,1,1735,A
6-NA,661,0,0,1743,0,1743,G
6-NA,662,1732,0,2,0,1734,A
6-NA,663,1698,0,1,0,1699,A
6-NA,664,1704,0,0,0,1704,A
6-NA,665,0,1690,0,0,1690,T
6-NA,666,0,1,0,1768,1769,C
6-NA,667,0,1,2,1767,1770,C
6-NA,668,0,1759,0,1,1760,T
6-NA,669,1,0,0,1767,1768,C
6-NA,670,1767,0,2,0,1769,A
6-NA,671,1,0,1786,0,1787,G
6-NA,672,1,1,1780,0,1782,G
6-NA,673,1838,2,1,0,1841,A
6-NA,674,0,0,0,1842,1842,C
6-NA,675,0,0,0,1823,1823,C
6-NA,676,0,0,1,1822,1823,C
6-NA,677,1828,0,0,0,1828,A
6-NA,678,0,1,1827,0,1828,G
6-NA,679,0,0,1834,0,1834,G
6-NA,680,1825,0,2,0,1827,A
6-NA,681,0,0,1855,0,1855,G
6-NA,682,0,1832,0,1,1833,T
6-NA,683,1,7,0,1834,1842,C
6-NA,684,1837,0,2,0,1839,A
6-NA,685,1,0,1847,0,1848,G
6-NA,686,1840,0,1,1,1842,A
6-NA,687,1845,0,0,0,1845,A
6-NA,688,0,1840,0,1,1841,T
6-NA,689,1,0,1859,0,1860,G
6-NA,690,0,1,0,1861,1862,C
6-NA,691,0,0,1870,0,1870,G
6-NA,692,0,1868,0,1,1869,T
6-NA,693,0,1869,0,0,1869,T
6-NA,694,1,1865,0,1,1867,T
6-NA,695,1,0,1885,0,1886,G
6-NA,696,0,1888,0,1,1889,T
6-NA,697,1890,0,1,0,1891,A
6-NA,698,2,1885,0,1,1888,T
6-NA,699,1,0,0,1892,1893,C
6-NA,700,1899,0,0,0,1899,A
6-NA,701,1897,0,0,0,1897,A
6-NA,702,0,1900,1,1,1902,T
6-NA,703,0,1,1898,0,1899,G
6-NA,704,0,1,1905,0,1906,G
6-NA,705,1939,1,3,0,1943,A
6-NA,706,1948,0,2,0,1950,A
6-NA,707,0,0,0,1962,1962,C
6-NA,708,0,1981,0,0,1981,T
6-NA,709,0,1981,0,1,1982,T
6-NA,710,1,1,2056,0,2058,G
6-NA,711,1,2055,0,0,2056,T
6-NA,712,2053,2,1,0,2056,A
6-NA,713,0,1,0,2078,2079,C
6-NA,714,2036,0,0,0,2036,A
6-NA,715,0,0,2226,0,2226,G
6-NA,716,0,2213,0,1,2214,T
6-NA,717,2330,0,1,0,2331,A
6-NA,718,0,0,2347,0,2347,G
6-NA,719,0,2304,0,0,2304,T
6-NA,720,2303,0,1,0,2304,A
6-NA,721,2301,0,1,0,2302,A
6-NA,722,0,2300,0,1,2301,T
6-NA,723,0,4,2313,0,2317,G
6-NA,724,2274,0,0,0,2274,A
6-NA,725,0,0,0,2288,2288,C
6-NA,726,0,2245,0,0,2245,T
6-NA,727,0,1,2253,0,2254,G
6-NA,728,2255,0,4,0,2259,A
6-NA,729,1,2256,0,2,2259,T
6-NA,730,1,2,2257,0,2260,G
6-NA,731,0,0,2245,0,2245,G
6-NA,732,1,1,2244,0,2246,G
6-NA,733,2225,0,2,0,2227,A
6-NA,734,2,1,2216,0,2219,G
6-NA,735,0,2215,0,0,2215,T
6-NA,736,0,0,2224,0,2224,G
6-NA,737,0,0,0,2243,2243,C
6-NA,738,0,2240,0,0,2240,T
6-NA,739,0,2244,0,0,2244,T
6-NA,740,0,0,1,2243,2244,C
6-NA,741,2243,0,1,0,2244,A
6-NA,742,1,0,2247,0,2248,G
6-NA,743,0,1,2253,0,2254,G
6-NA,744,2248,0,1,1,2250,A
6-NA,745,2228,1,1,0,2230,A
6-NA,746,2218,0,0,0,2218,A
6-NA,747,2230,0,4,0,2234,A
6-NA,748,0,0,2248,0,2248,G
6-NA,749,0,0,0,2247,2247,C
6-NA,750,0,2239,1,0,2240,T
6-NA,751,2,1,2238,1,2242,G
6-NA,752,2237,1,2,0,2240,A
6-NA,753,0,2259,0,1,2260,T
6-NA,754,2265,0,2,0,2267,A
6-NA,755,0,0,0,2391,2391,C
6-NA,756,0,2387,0,0,2387,T
6-NA,757,2393,0,1,0,2394,A
6-NA,758,2382,0,0,0,2382,A
6-NA,759,2386,1,0,0,2387,A
6-NA,760,2452,0,0,0,2452,A
6-NA,761,0,2460,0,0,2460,T
6-NA,762,2461,0,0,1,2462,A
6-NA,763,0,0,1,2478,2479,C
6-NA,764,0,2394,0,3,2397,T
6-NA,765,2435,0,0,0,2435,A
6-NA,766,1,2417,0,1,2419,T
6-NA,767,0,2548,0,1,2549,T
6-NA,768,0,2,1,2560,2563,C
6-NA,769,2526,0,1,0,2527,A
6-NA,770,0,2529,0,0,2529,T
6-NA,771,0,2515,0,1,2516,T
6-NA,772,0,1,2530,0,2531,G
6-NA,773,2521,0,1,0,2522,A
6-NA,774,0,1,2511,0,2512,G
6-NA,775,1,0,2507,0,2508,G
6-NA,776,2425,0,0,0,2425,A
6-NA,777,1,0,2460,0,2461,G
6-NA,778,0,2,2460,0,2462,G
6-NA,779,1,1,2461,0,2463,G
6-NA,780,0,1,2462,0,2463,G
6-NA,781,2457,0,2,0,2459,A
6-NA,782,2462,1,2,0,2465,A
6-NA,783,2457,0,2,0,2459,A
6-NA,784,2454,0,0,0,2454,A
6-NA,785,0,2460,0,0,2460,T
6-NA,786,3,0,0,2441,2444,C
6-NA,787,0,1,2468,0,2469,G
6-NA,788,0,2468,0,0,2468,T
6-NA,789,2,2457,1,2,2462,T
6-NA,790,0,1,0,2458,2459,C
6-NA,791,2459,2,1,0,2462,A
6-NA,792,0,2621,0,1,2622,T
6-NA,793,2622,0,0,0,2622,A
6-NA,794,2,3,0,2633,2638,C
6-NA,795,1,2629,1,0,2631,T
6-NA,796,2624,0,1,0,2625,A
6-NA,797,1,0,2617,0,2618,G
6-NA,798,1,0,0,2613,2614,C
6-NA,799,2615,0,2,0,2617,A
6-NA,800,1,0,0,2623,2624,C
6-NA,801,2538,1,1,0,2540,A
6-NA,802,0,2583,0,1,2584,T
6-NA,803,0,2571,0,1,2572,T
6-NA,804,1,1,2734,0,2736,G
6-NA,805,0,2737,0,3,2740,T
6-NA,806,1,0,0,2741,2742,C
6-NA,807,2732,0,6,0,2738,A
6-NA,808,1,0,2743,0,2744,G
6-NA,809,1,1,2745,0,2747,G
6-NA,810,2740,0,0,0,2740,A
6-NA,811,2698,0,1,0,2699,A
6-NA,812,1,0,2723,0,2724,G
6-NA,813,1,2612,0,0,2613,T
6-NA,814,2,0,2627,0,2629,G
6-NA,815,0,0,0,2619,2619,C
6-NA,816,1,2617,0,5,2623,T
6-NA,817,1,2,0,2633,2636,C
6-NA,818,2631,0,0,0,2631,A
6-NA,819,0,0,2651,0,2651,G
6-NA,820,0,0,2,2649,2651,C
6-NA,821,2639,0,4,0,2643,A
6-NA,822,0,2640,0,2,2642,T
6-NA,823,2,0,2738,1,2741,G
6-NA,824,0,2739,1,0,2740,T
6-NA,825,1,0,0,2740,2741,C
6-NA,826,0,0,2737,0,2737,G
6-NA,827,2733,0,2,0,2735,A
6-NA,828,0,1,2721,0,2722,G
6-NA,829,1,0,2720,0,2721,G
6-NA,830,2693,0,2,0,2695,A
6-NA,831,0,0,2742,0,2742,G
6-NA,832,0,2682,0,3,2685,T
6-NA,833,0,1,2690,0,2691,G
6-NA,834,0,2,0,2732,2734,C
6-NA,835,1,2722,0,2,2725,T
6-NA,836,1,2,0,2742,2745,C
6-NA,837,1,0,0,2743,2744,C
6-NA,838,0,2748,0,1,2749,T
6-NA,839,0,0,2749,0,2749,G
6-NA,840,1,0,0,2739,2740,C
6-NA,841,1,2726,0,0,2727,T
6-NA,842,2756,0,1,0,2757,A
6-NA,843,0,2705,0,0,2705,T
6-NA,844,1,0,0,2722,2723,C
6-NA,845,1,0,0,2714,2715,C
6-NA,846,1,2709,0,1,2711,T
6-NA,847,0,4,0,2725,2729,C
6-NA,848,1,0,2728,0,2729,G
6-NA,849,2751,1,0,0,2752,A
6-NA,850,0,2758,0,2,2760,T
6-NA,851,2757,0,3,0,2760,A
6-NA,852,0,2759,1,0,2760,T
6-NA,853,0,0,0,2755,2755,C
6-NA,854,0,0,0,2746,2746,C
6-NA,855,0,2736,0,4,2740,T
6-NA,856,0,1,2754,1,2756,G
6-NA,857,0,1,2757,0,2758,G
6-NA,858,0,2784,0,3,2787,T
6-NA,859,1,0,2800,0,2801,G
6-NA,860,0,2766,0,17,2783,T
6-NA,861,1,0,0,2782,2783,C
6-NA,862,2775,1,2,0,2778,A
6-NA,863,0,0,2783,0,2783,G
6-NA,864,2780,3,0,0,2783,A
6-NA,865,0,2757,0,1,2758,T
6-NA,866,1,0,2762,0,2763,G
6-NA,867,0,2733,0,0,2733,T
6-NA,868,0,0,2735,3,2738,G
6-NA,869,0,2727,0,2,2729,T
6-NA,870,4,1,0,2731,2736,C
6-NA,871,1,2721,1,4,2727,T
6-NA,872,1,0,2733,0,2734,G
6-NA,873,0,2,0,2728,2730,C
6-NA,874,2730,1,1,1,2733,A
6-NA,875,0,0,2729,0,2729,G
6-NA,876,2690,0,1,1,2692,A
6-NA,877,0,1,2692,2,2695,G
6-NA,878,2700,0,1,0,2701,A
6-NA,879,0,1,0,2707,2708,C
6-NA,880,2714,1,0,0,2715,A
6-NA,881,2726,3,1,0,2730,A
6-NA,882,0,0,0,2730,2730,C
6-NA,883,0,2733,0,1,2734,T
6-NA,884,0,0,2736,0,2736,G
6-NA,885,0,1,2731,0,2732,G
6-NA,886,2723,0,0,0,2723,A
6-NA,887,2720,2,4,0,2726,A
6-NA,888,2672,0,1,0,2673,A
6-NA,889,0,0,2666,0,2666,G
6-NA,890,0,0,2647,0,2647,G
6-NA,891,2619,1,2,0,2622,A
6-NA,892,0,2678,0,5,2683,T
6-NA,893,1,0,0,2701,2702,C
6-NA,894,0,1,0,2764,2765,C
6-NA,895,2766,0,3,0,2769,A
6-NA,896,2772,0,0,0,2772,A
6-NA,897,0,2767,0,0,2767,T
6-NA,898,2682,0,2,0,2684,A
6-NA,899,1,1,2666,0,2668,G
6-NA,900,0,0,2664,0,2664,G
6-NA,901,1,1,1,2654,2657,C
6-NA,902,1,0,0,2646,2647,C
6-NA,903,3,1,0,2601,2605,C
6-NA,904,2610,0,1,0,2611,A
6-NA,905,0,2622,0,5,2627,T
6-NA,906,1,0,0,2635,2636,C
6-NA,907,1,0,2640,0,2641,G
6-NA,908,0,2636,0,1,2637,T
6-NA,909,2601,0,1,0,2602,A
6-NA,910,0,1,2663,0,2664,G
6-NA,911,2664,0,3,0,2667,A
6-NA,912,1,2674,0,1,2676,T
6-NA,913,2618,0,0,0,2618,A
6-NA,914,1,2589,0,0,2590,T
6-NA,915,2585,0,1,1,2587,A
6-NA,916,2578,0,1,0,2579,A
6-NA,917,2635,0,0,0,2635,A
6-NA,918,0,0,0,2671,2671,C
6-NA,919,2580,0,0,0,2580,A
6-NA,920,0,2571,0,0,2571,T
6-NA,921,2546,1,0,0,2547,A
6-NA,922,2552,0,2,0,2554,A
6-NA,923,2551,0,0,0,2551,A
6-NA,924,1,3,2570,0,2574,G
6-NA,925,0,2,2601,0,2603,G
6-NA,926,2519,0,0,0,2519,A
6-NA,927,0,2519,0,2,2521,T
6-NA,928,0,0,0,2519,2519,C
6-NA,929,2530,2,1,0,2533,A
6-NA,930,1,2541,0,0,2542,T
6-NA,931,2529,0,2,0,2531,A
6-NA,932,0,0,2560,1,2561,G
6-NA,933,0,0,0,2533,2533,C
6-NA,934,2480,1,1,1,2483,A
6-NA,935,1,2383,0,5,2389,T
6-NA,936,0,2395,0,0,2395,T
6-NA,937,0,0,2389,1,2390,G
6-NA,938,0,2392,0,2,2394,T
6-NA,939,1,1,0,2369,2371,C
6-NA,940,0,2524,0,6,2530,T
6-NA,941,2,1,0,2558,2561,C
6-NA,942,0,0,0,2578,2578,C
6-NA,943,2613,0,0,0,2613,A
6-NA,944,1,0,2657,0,2658,G
6-NA,945,0,2658,0,1,2659,T
6-NA,946,0,2526,0,3,2529,T
6-NA,947,2531,0,1,0,2532,A
6-NA,948,1,2461,0,3,2465,T
6-NA,949,0,0,2470,0,2470,G
6-NA,950,0,2430,0,10,2440,T
6-NA,951,1,0,2445,0,2446,G
6-NA,952,1,2373,0,0,2374,T
6-NA,953,0,1,2423,0,2424,G
6-NA,954,3,2416,0,2,2421,T
6-NA,955,0,2419,0,0,2419,T
6-NA,956,2,0,1,2414,2417,C
6-NA,957,2395,2,3,0,2400,A
6-NA,958,0,1,2411,0,2412,G
6-NA,959,0,0,2413,0,2413,G
6-NA,960,2399,0,3,1,2403,A
6-NA,961,0,0,0,2409,2409,C
6-NA,962,0,2339,0,1,2340,T
6-NA,963,0,2351,0,0,2351,T
6-NA,964,0,0,2414,0,2414,G
6-NA,965,1,2417,0,0,2418,T
6-NA,966,0,2419,0,2,2421,T
6-NA,967,0,2,2397,0,2399,G
6-NA,968,0,0,2398,0,2398,G
6-NA,969,2392,1,4,0,2397,A
6-NA,970,0,2,2409,0,2411,G
6-NA,971,2413,0,5,0,2418,A
6-NA,972,1,2,0,2470,2473,C
6-NA,973,2401,0,3,1,2405,A
6-NA,974,0,0,0,2414,2414,C
6-NA,975,2419,0,3,0,2422,A
6-NA,976,0,1,0,2456,2457,C
6-NA,977,1,0,0,2443,2444,C
6-NA,978,5,0,0,2452,2457,C
6-NA,979,2448,0,2,0,2450,A
6-NA,980,0,0,2459,0,2459,G
6-NA,981,2456,0,2,0,2458,A
6-NA,982,2461,0,0,1,2462,A
6-NA,983,2442,0,1,0,2443,A
6-NA,984,2447,0,0,0,2447,A
6-NA,985,2421,0,1,0,2422,A
6-NA,986,2428,0,0,0,2428,A
6-NA,987,0,0,1,2432,2433,C
6-NA,988,1,4,2428,0,2433,G
6-NA,989,2421,1,1,0,2423,A
6-NA,990,1,0,0,2421,2422,C
6-NA,991,2421,0,0,0,2421,A
6-NA,992,0,0,2448,0,2448,G
6-NA,993,0,0,0,2577,2577,C
6-NA,994,0,2561,0,4,2565,T
6-NA,995,1,1,0,2567,2569,C
6-NA,996,2,3,0,2575,2580,C
6-NA,997,2583,0,1,1,2585,A
6-NA,998,0,0,2590,0,2590,G
6-NA,999,1,1,0,2581,2583,C
6-NA,1000,2572,0,1,0,2573,A
6-NA,1001,1,0,2569,0,2570,G
6-NA,1002,1,2405,0,2,2408,T
6-NA,1003,2,1,2383,1,2387,G
6-NA,1004,1,0,2416,1,2418,G
6-NA,1005,0,0,0,2428,2428,C
6-NA,1006,0,0,0,2427,2427,C
6-NA,1007,2410,0,0,0,2410,A
6-NA,1008,1,2412,0,2,2415,T
6-NA,1009,0,2414,0,1,2415,T
6-NA,1010,0,0,2466,0,2466,G
6-NA,1011,3,2447,0,1,2451,T
6-NA,1012,0,2432,0,0,2432,T
6-NA,1013,2,2432,0,0,2434,T
6-NA,1014,1,0,2423,0,2424,G
6-NA,1015,0,1,2446,0,2447,G
6-NA,1016,2439,0,0,1,2440,A
6-NA,1017,2,2461,0,0,2463,T
6-NA,1018,1,0,0,2453,2454,C
6-NA,1019,0,1,1,2448,2450,C
6-NA,1020,4,2445,1,0,2450,T
6-NA,1021,2454,0,1,0,2455,A
6-NA,1022,2446,0,3,0,2449,A
6-NA,1023,0,0,0,2491,2491,C
6-NA,1024,2457,0,0,0,2457,A
6-NA,1025,2514,0,2,0,2516,A
6-NA,1026,0,2504,0,0,2504,T
6-NA,1027,5,1,2498,0,2504,G
6-NA,1028,2482,1,3,0,2486,A
6-NA,1029,1,0,2397,0,2398,G
6-NA,1030,0,0,2459,0,2459,G
6-NA,1031,2446,0,0,0,2446,A
6-NA,1032,2457,0,1,0,2458,A
6-NA,1033,0,1,2463,0,2464,G
6-NA,1034,1,0,2479,0,2480,G
6-NA,1035,0,2459,0,3,2462,T
6-NA,1036,2,1,2454,0,2457,G
6-NA,1037,1,1,2505,0,2507,G
6-NA,1038,1,2485,0,1,2487,T
6-NA,1039,1,0,0,2480,2481,C
6-NA,1040,2480,0,1,0,2481,A
6-NA,1041,1,2473,0,0,2474,T
6-NA,1042,0,2,2465,0,2467,G
6-NA,1043,1,2,2447,0,2450,G
6-NA,1044,1,1,2368,0,2370,G
6-NA,1045,1,1,2463,0,2465,G
6-NA,1046,1,2462,0,1,2464,T
6-NA,1047,0,0,2471,0,2471,G
6-NA,1048,2465,0,1,0,2466,A
6-NA,1049,2458,0,1,0,2459,A
6-NA,1050,2464,0,2,0,2466,A
6-NA,1051,1,1,2484,0,2486,G
6-NA,1052,0,1,2474,0,2475,G
6-NA,1053,0,0,0,2468,2468,C
6-NA,1054,0,2406,0,0,2406,T
6-NA,1055,0,1,2406,0,2407,G
6-NA,1056,1,1,2406,0,2408,G
6-NA,1057,2,0,2431,0,2433,G
6-NA,1058,0,1,0,2432,2433,C
6-NA,1059,1,0,0,2426,2427,C
6-NA,1060,2,2391,0,6,2399,T
6-NA,1061,0,2407,0,0,2407,T
6-NA,1062,0,2404,0,1,2405,T
6-NA,1063,0,0,2414,0,2414,G
6-NA,1064,2408,0,0,0,2408,A
6-NA,1065,1,2391,0,0,2392,T
6-NA,1066,0,1,2361,0,2362,G
6-NA,1067,2336,0,0,0,2336,A
6-NA,1068,3,2339,0,0,2342,T
6-NA,1069,0,1,2352,0,2353,G
6-NA,1070,0,1,2370,1,2372,G
6-NA,1071,2372,1,1,0,2374,A
6-NA,1072,2373,0,0,0,2373,A
6-NA,1073,2376,0,0,0,2376,A
6-NA,1074,1,2380,0,0,2381,T
6-NA,1075,0,3,2385,0,2388,G
6-NA,1076,2382,0,2,0,2384,A
6-NA,1077,0,1,0,2376,2377,C
6-NA,1078,1,0,2384,0,2385,G
6-NA,1079,0,2340,0,5,2345,T
6-NA,1080,0,0,2358,0,2358,G
6-NA,1081,0,2349,0,0,2349,T
6-NA,1082,1,1,2353,0,2355,G
6-NA,1083,0,1,2364,0,2365,G
6-NA,1084,2349,1,1,0,2351,A
6-NA,1085,0,2350,0,1,2351,T
6-NA,1086,0,2,2354,0,2356,G
6-NA,1087,1,1,2354,0,2356,G
6-NA,1088,1,0,2363,0,2364,G
6-NA,1089,2352,0,2,0,2354,A
6-NA,1090,2349,0,0,1,2350,A
6-NA,1091,0,2,2348,0,2350,G
6-NA,1092,2320,1,1,0,2322,A
6-NA,1093,2330,0,0,0,2330,A
6-NA,1094,0,3,1,2321,2325,C
6-NA,1095,0,1,2321,0,2322,G
6-NA,1096,2316,2,1,0,2319,A
6-NA,1097,0,2306,0,1,2307,T
6-NA,1098,1,0,0,2304,2305,C
6-NA,1099,2303,0,1,0,2304,A
6-NA,1100,1,0,2315,0,2316,G
6-NA,1101,0,2,0,2312,2314,C
6-NA,1102,0,1,2310,0,2311,G
6-NA,1103,2308,1,0,0,2309,A
6-NA,1104,1,1,2307,0,2309,G
6-NA,1105,2303,1,0,1,2305,A
6-NA,1106,2305,0,1,1,2307,A
6-NA,1107,8,0,2310,0,2318,G
6-NA,1108,0,2292,0,2,2294,T
6-NA,1109,2,1,1,2282,2286,C
6-NA,1110,2282,0,1,0,2283,A
6-NA,1111,0,0,1,2352,2353,C
6-NA,1112,0,0,2356,0,2356,G
6-NA,1113,1,1,0,2347,2349,C
6-NA,1114,0,2348,0,2,2350,T
6-NA,1115,0,2347,0,2,2349,T
6-NA,1116,2325,0,0,0,2325,A
6-NA,1117,0,0,2514,0,2514,G
6-NA,1118,0,0,2509,0,2509,G
6-NA,1119,0,3,2542,0,2545,G
6-NA,1120,1,2415,0,2,2418,T
6-NA,1121,2406,0,0,1,2407,A
6-NA,1122,0,2401,0,3,2404,T
6-NA,1123,1,0,2401,0,2402,G
6-NA,1124,2397,0,3,0,2400,A
6-NA,1125,2394,0,0,0,2394,A
6-NA,1126,2283,1,2,0,2286,A
6-NA,1127,0,1,0,2279,2280,C
6-NA,1128,1,1,0,2235,2237,C
6-NA,1129,1,2214,1,1,2217,T
6-NA,1130,0,2212,0,6,2218,T
6-NA,1131,2,3,0,2216,2221,C
6-NA,1132,2221,0,0,0,2221,A
6-NA,1133,2215,1,0,2,2218,A
6-NA,1134,2218,1,1,0,2220,A
6-NA,1135,1,0,2224,0,2225,G
6-NA,1136,1,2191,0,3,2195,T
6-NA,1137,2,0,0,2211,2213,C
6-NA,1138,2254,1,0,1,2256,A
6-NA,1139,0,2250,0,2,2252,T
6-NA,1140,1,2254,0,1,2256,T
6-NA,1141,0,0,2263,0,2263,G
6-NA,1142,2257,1,2,0,2260,A
6-NA,1143,2274,1,4,0,2279,A
6-NA,1144,0,2,2452,0,2454,G
6-NA,1145,0,0,2467,0,2467,G
6-NA,1146,1,0,0,2460,2461,C
6-NA,1147,1,2396,0,1,2398,T
6-NA,1148,1,0,2406,0,2407,G
6-NA,1149,0,2,2443,0,2445,G
6-NA,1150,0,2445,0,0,2445,T
6-NA,1151,2,0,0,2444,2446,C
6-NA,1152,0,1,0,2431,2432,C
6-NA,1153,2431,0,2,0,2433,A
6-NA,1154,2440,1,1,0,2442,A
6-NA,1155,0,1,0,2448,2449,C
6-NA,1156,1,1,0,2443,2445,C
6-NA,1157,2,0,0,2445,2447,C
6-NA,1158,0,2356,0,1,2357,T
6-NA,1159,2363,0,2,0,2365,A
6-NA,1160,2357,0,0,0,2357,A
6-NA,1161,0,0,2374,0,2374,G
6-NA,1162,0,2365,0,0,2365,T
6-NA,1163,0,1,0,2349,2350,C
6-NA,1164,0,0,0,2337,2337,C
6-NA,1165,2330,0,2,0,2332,A
6-NA,1166,2323,0,0,1,2324,A
6-NA,1167,2334,0,0,0,2334,A
6-NA,1168,0,2341,0,0,2341,T
6-NA,1169,0,2340,0,0,2340,T
6-NA,1170,0,0,2322,0,2322,G
6-NA,1171,2,2,0,2309,2313,C
6-NA,1172,2307,0,2,0,2309,A
6-NA,1173,0,0,2323,0,2323,G
6-NA,1174,2317,0,0,1,2318,A
6-NA,1175,0,2358,0,1,2359,T
6-NA,1176,2365,0,0,0,2365,A
6-NA,1177,2365,0,2,0,2367,A
6-NA,1178,2360,0,1,0,2361,A
6-NA,1179,0,2361,0,0,2361,T
6-NA,1180,2338,1,0,0,2339,A
6-NA,1181,0,0,2344,1,2345,G
6-NA,1182,1,0,2327,0,2328,G
6-NA,1183,0,3,0,2319,2322,C
6-NA,1184,2266,1,1,0,2268,A
6-NA,1185,2277,0,1,0,2278,A
6-NA,1186,0,0,2291,0,2291,G
6-NA,1187,1,2283,0,3,2287,T
6-NA,1188,0,1,0,2284,2285,C
6-NA,1189,2282,1,5,0,2288,A
6-NA,1190,0,2296,0,0,2296,T
6-NA,1191,2333,0,2,0,2335,A
6-NA,1192,0,0,2349,0,2349,G
6-NA,1193,0,2339,1,0,2340,T
6-NA,1194,0,2258,0,2,2260,T
6-NA,1195,0,0,2229,0,2229,G
6-NA,1196,2218,0,5,0,2223,A
6-NA,1197,0,0,1,2217,2218,C
6-NA,1198,2193,0,1,0,2194,A
6-NA,1199,0,1,2212,0,2213,G
6-NA,1200,2200,0,1,0,2201,A
6-NA,1201,0,1,2299,1,2301,G
6-NA,1202,0,0,2307,0,2307,G
6-NA,1203,0,2302,1,0,2303,T
6-NA,1204,2300,0,2,0,2302,A
6-NA,1205,2290,2,3,1,2296,A
6-NA,1206,0,2301,0,0,2301,T
6-NA,1207,2299,0,0,0,2299,A
6-NA,1208,0,0,2254,0,2254,G
6-NA,1209,1,0,2210,0,2211,G
6-NA,1210,1,2016,0,37,2054,T
6-NA,1211,0,3,0,2039,2042,C
6-NA,1212,2,0,0,2041,2043,C
6-NA,1213,2,1,2048,0,2051,G
6-NA,1214,0,0,2062,0,2062,G
6-NA,1215,0,2050,0,4,2054,T
6-NA,1216,0,2050,0,1,2051,T
6-NA,1217,2028,0,0,0,2028,A
6-NA,1218,0,2002,0,1,2003,T
6-NA,1219,0,2005,0,2,2007,T
6-NA,1220,0,0,1,2011,2012,C
6-NA,1221,1,1944,0,1,1946,T
6-NA,1222,0,1,1954,0,1955,G
6-NA,1223,2,0,1955,1,1958,G
6-NA,1224,0,1960,0,0,1960,T
6-NA,1225,1961,0,1,0,1962,A
6-NA,1226,0,1939,0,0,1939,T
6-NA,1227,0,1941,0,1,1942,T
6-NA,1228,0,1934,0,3,1937,T
6-NA,1229,2,1952,0,0,1954,T
6-NA,1230,0,1,0,1953,1954,C
6-NA,1231,0,1930,0,2,1932,T
6-NA,1232,1,0,0,1948,1949,C
6-NA,1233,0,1942,0,0,1942,T
6-NA,1234,1,1,1970,0,1972,G
6-NA,1235,0,1973,0,0,1973,T
6-NA,1236,0,1957,0,0,1957,T
6-NA,1237,0,0,1961,0,1961,G
6-NA,1238,1932,0,2,0,1934,A
6-NA,1239,1929,0,4,0,1933,A
6-NA,1240,0,0,1952,0,1952,G
6-NA,1241,0,0,1947,0,1947,G
6-NA,1242,3,0,0,1940,1943,C
6-NA,1243,1921,1,0,0,1922,A
6-NA,1244,1920,0,1,0,1921,A
6-NA,1245,1925,0,0,1,1926,A
6-NA,1246,1933,0,2,0,1935,A
6-NA,1247,1,1,1934,0,1936,G
6-NA,1248,0,0,0,1933,1933,C
6-NA,1249,1,1913,0,1,1915,T
6-NA,1250,1,0,1930,0,1931,G
6-NA,1251,0,1,0,1930,1931,C
6-NA,1252,1934,0,0,0,1934,A
6-NA,1253,1,1928,0,1,1930,T
6-NA,1254,1,0,0,1923,1924,C
6-NA,1255,1922,0,0,0,1922,A
6-NA,1256,1922,1,1,0,1924,A
6-NA,1257,0,1916,0,0,1916,T
6-NA,1258,0,0,0,1917,1917,C
6-NA,1259,1,1,1900,0,1902,G
6-NA,1260,0,0,1926,0,1926,G
6-NA,1261,0,1920,0,1,1921,T
6-NA,1262,1,0,1934,0,1935,G
6-NA,1263,1,0,0,1943,1944,C
6-NA,1264,0,1915,0,9,1924,T
6-NA,1265,0,1932,1,2,1935,T
6-NA,1266,0,1942,0,0,1942,T
6-NA,1267,0,1951,0,0,1951,T
6-NA,1268,1963,0,0,0,1963,A
6-NA,1269,0,1879,0,1,1880,T
6-NA,1270,1,2,1878,0,1881,G
6-NA,1271,1,1855,0,1,1857,T
6-NA,1272,0,0,1834,0,1834,G
6-NA,1273,0,3,1860,0,1863,G
6-NA,1274,1821,0,0,0,1821,A
6-NA,1275,0,0,1835,0,1835,G
6-NA,1276,0,1826,0,2,1828,T
6-NA,1277,0,1824,0,1,1825,T
6-NA,1278,2,1,1836,0,1839,G
6-NA,1279,1822,0,13,1,1836,A
6-NA,1280,0,1841,0,0,1841,T
6-NA,1281,1833,0,0,0,1833,A
6-NA,1282,1772,0,1,0,1773,A
6-NA,1283,0,2,1778,0,1780,G
6-NA,1284,25,1,1712,0,1738,G
6-NA,1285,0,0,1730,0,1730,G
6-NA,1286,0,0,1722,0,1722,G
6-NA,1287,1693,3,1,0,1697,A
6-NA,1288,1691,1,2,1,1695,A
6-NA,1289,0,1,1697,0,1698,G
6-NA,1290,1699,0,0,0,1699,A
6-NA,1291,1694,0,1,0,1695,A
6-NA,1292,1682,0,1,0,1683,A
6-NA,1293,1651,0,1,0,1652,A
6-NA,1294,1,0,1655,0,1656,G
6-NA,1295,1630,0,1,0,1631,A
6-NA,1296,0,0,1635,0,1635,G
6-NA,1297,0,0,1634,0,1634,G
6-NA,1298,1621,1,0,0,1622,A
6-NA,1299,1621,0,0,0,1621,A
6-NA,1300,1622,1,1,3,1627,A
6-NA,1301,1,0,0,1633,1634,C
6-NA,1302,0,1623,0,2,1625,T
6-NA,1303,1,0,1630,0,1631,G
6-NA,1304,1625,0,0,0,1625,A
6-NA,1305,1618,1,1,0,1620,A
6-NA,1306,1,0,1628,0,1629,G
6-NA,1307,0,1607,0,3,1610,T
6-NA,1308,0,0,0,1628,1628,C
6-NA,1309,0,1618,0,5,1623,T
6-NA,1310,0,1611,0,2,1613,T
6-NA,1311,0,0,1612,0,1612,G
6-NA,1312,0,1602,0,6,1608,T
6-NA,1313,1,1,1601,0,1603,G
6-NA,1314,0,1,1600,2,1603,G
6-NA,1315,1586,0,3,0,1589,A
6-NA,1316,0,1,0,1594,1595,C
6-NA,1317,0,1,0,1573,1574,C
6-NA,1318,0,1560,0,9,1569,T
6-NA,1319,0,0,0,1571,1571,C
6-NA,1320,1576,0,0,1,1577,A
6-NA,1321,1575,0,0,0,1575,A
6-NA,1322,1574,0,1,0,1575,A
6-NA,1323,0,1,0,1596,1597,C
6-NA,1324,1538,1,1,1,1541,A
6-NA,1325,0,0,1558,0,1558,G
6-NA,1326,0,1542,0,3,1545,T
6-NA,1327,1543,1,0,0,1544,A
6-NA,1328,0,1546,0,0,1546,T
6-NA,1329,0,1519,0,2,1521,T
6-NA,1330,0,0,1543,0,1543,G
6-NA,1331,0,1531,0,2,1533,T
6-NA,1332,0,1448,0,11,1459,T
6-NA,1333,0,0,1464,0,1464,G
6-NA,1334,0,1351,0,1,1352,T
6-NA,1335,1,0,1355,0,1356,G
6-NA,1336,0,1347,2,1,1350,T
6-NA,1337,0,1337,0,1,1338,T
6-NA,1338,0,1336,1,2,1339,T
6-NA,1339,0,1305,0,0,1305,T
6-NA,1340,1,0,1306,0,1307,G
6-NA,1341,0,1304,0,3,1307,T
6-NA,1342,0,0,1298,0,1298,G
6-NA,1343,0,0,1289,0,1289,G
6-NA,1344,1,0,0,1267,1268,C
6-NA,1345,1268,0,0,0,1268,A
6-NA,1346,0,0,0,1274,1274,C
6-NA,1347,0,0,0,1267,1267,C
6-NA,1348,0,1269,0,2,1271,T
6-NA,1349,0,0,1,1268,1269,C
6-NA,1350,1260,1,3,0,1264,A
6-NA,1351,0,1,1269,0,1270,G
6-NA,1352,0,0,1271,0,1271,G
6-NA,1353,0,1266,0,1,1267,T
6-NA,1354,1258,0,0,0,1258,A
6-NA,1355,0,0,0,1197,1197,C
6-NA,1356,1187,0,0,0,1187,A
6-NA,1357,0,1183,0,0,1183,T
6-NA,1358,1143,0,1,0,1144,A
6-NA,1359,0,1145,0,1,1146,T
6-NA,1360,0,1,1067,0,1068,G
6-NA,1361,0,0,1069,0,1069,G
6-NA,1362,1062,0,0,0,1062,A
6-NA,1363,1054,0,0,0,1054,A
6-NA,1364,0,0,1,1044,1045,C
6-NA,1365,866,0,0,0,866,A
6-NA,1366,1,0,865,0,866,G
6-NA,1367,1,0,865,0,866,G
6-NA,1368,1,0,0,863,864,C
6-NA,1369,1,855,0,1,857,T
6-NA,1370,0,0,0,814,814,C
6-NA,1371,814,0,0,0,814,A
6-NA,1372,0,811,1,0,812,T
6-NA,1373,0,1,810,0,811,G
6-NA,1374,0,0,815,0,815,G
6-NA,1375,1,0,0,780,781,C
6-NA,1376,0,0,0,774,774,C
6-NA,1377,0,727,0,3,730,T
6-NA,1378,0,1,724,0,725,G
6-NA,1379,729,0,0,1,730,A
6-NA,1380,1,728,0,0,729,T
6-NA,1381,1,0,719,0,720,G
6-NA,1382,0,0,708,0,708,G
6-NA,1383,0,0,677,0,677,G
6-NA,1384,0,0,675,0,675,G
6-NA,1385,0,0,0,661,661,C
6-NA,1386,0,0,662,0,662,G
6-NA,1387,0,0,655,0,655,G
6-NA,1388,653,0,0,0,653,A
6-NA,1389,1,0,0,650,651,C
6-NA,1390,650,0,0,0,650,A
6-NA,1391,0,641,0,1,642,T
6-NA,1392,0,0,0,637,637,C
6-NA,1393,630,0,1,0,631,A
6-NA,1394,631,0,0,0,631,A
6-NA,1395,0,631,0,0,631,T
6-NA,1396,0,0,0,619,619,C
6-NA,1397,0,606,0,0,606,T
6-NA,1398,0,0,0,525,525,C
6-NA,1399,522,0,0,0,522,A
6-NA,1400,0,518,0,0,518,T
6-NA,1401,0,0,520,0,520,G
6-NA,1402,0,0,0,512,512,C
6-NA,1403,0,0,0,499,499,C
6-NA,1404,0,457,0,1,458,T
6-NA,1405,455,0,0,0,455,A
6-NA,1406,1,454,0,0,455,T
6-NA,1407,449,0,0,0,449,A
6-NA,1408,0,449,0,0,449,T
6-NA,1409,413,0,0,0,413,A
6-NA,1410,395,0,0,0,395,A
7-M,1,8,0,0,0,8,A
7-M,2,0,8,0,0,8,T
7-M,3,0,0,8,0,8,G
7-M,4,8,0,0,0,8,A
7-M,5,0,0,9,0,9,G
7-M,6,0,0,0,10,10,C
7-M,7,0,0,0,10,10,C
7-M,8,0,15,0,0,15,T
7-M,9,0,15,0,0,15,T
7-M,10,0,0,0,15,15,C
7-M,11,0,15,0,0,15,T
7-M,12,15,0,0,0,15,A
7-M,13,14,1,0,0,15,A
7-M,14,0,0,0,15,15,C
7-M,15,0,0,0,15,15,C
7-M,16,0,0,15,0,15,G
7-M,17,15,0,0,0,15,A
7-M,18,0,0,16,0,16,G
7-M,19,0,0,16,0,16,G
7-M,20,0,16,0,0,16,T
7-M,21,0,0,0,16,16,C
7-M,22,0,0,16,0,16,G
7-M,23,16,0,0,0,16,A
7-M,24,17,0,0,0,17,A
7-M,25,17,0,0,0,17,A
7-M,26,0,0,0,19,19,C
7-M,27,0,0,19,0,19,G
7-M,28,0,20,0,0,20,T
7-M,29,20,0,0,0,20,A
7-M,30,0,20,0,0,20,T
7-M,31,0,0,20,0,20,G
7-M,32,0,20,0,0,20,T
7-M,33,0,23,0,0,23,T
7-M,34,0,0,0,23,23,C
7-M,35,0,23,0,0,23,T
7-M,36,0,0,0,23,23,C
7-M,37,0,23,0,0,23,T
7-M,38,0,0,0,24,24,C
7-M,39,0,24,0,0,24,T
7-M,40,25,0,0,0,25,A
7-M,41,0,25,0,0,25,T
7-M,42,0,0,0,25,25,C
7-M,43,0,0,25,0,25,G
7-M,44,0,25,0,0,25,T
7-M,45,0,25,0,0,25,T
7-M,46,0,0,0,24,24,C
7-M,47,0,0,0,24,24,C
7-M,48,25,0,0,0,25,A
7-M,49,0,25,0,0,25,T
7-M,50,0,0,0,25,25,C
7-M,51,25,0,0,0,25,A
7-M,52,0,0,25,0,25,G
7-M,53,0,0,25,0,25,G
7-M,54,0,0,0,25,25,C
7-M,55,0,0,0,25,25,C
7-M,56,0,0,0,25,25,C
7-M,57,0,0,0,26,26,C
7-M,58,0,0,0,26,26,C
7-M,59,0,26,0,0,26,T
7-M,60,0,0,0,26,26,C
7-M,61,25,0,0,0,25,A
7-M,62,26,0,0,0,26,A
7-M,63,27,0,0,0,27,A
7-M,64,0,0,27,0,27,G
7-M,65,0,0,0,27,27,C
7-M,66,0,0,0,27,27,C
7-M,67,0,0,27,0,27,G
7-M,68,27,0,0,0,27,A
7-M,69,0,0,27,0,27,G
7-M,70,27,0,0,0,27,A
7-M,71,0,28,0,0,28,T
7-M,72,0,0,0,28,28,C
7-M,73,0,0,28,0,28,G
7-M,74,0,0,0,28,28,C
7-M,75,0,0,28,0,28,G
7-M,76,0,0,0,28,28,C
7-M,77,28,0,0,0,28,A
7-M,78,0,0,28,0,28,G
7-M,79,28,0,0,0,28,A
7-M,80,0,0,29,0,29,G
7-M,81,29,0,0,0,29,A
7-M,82,0,0,0,29,29,C
7-M,83,0,29,0,0,29,T
7-M,84,0,29,0,0,29,T
7-M,85,0,0,30,0,30,G
7-M,86,30,0,0,0,30,A
7-M,87,30,0,0,0,30,A
7-M,88,0,0,30,0,30,G
7-M,89,30,0,0,0,30,A
7-M,90,0,31,0,0,31,T
7-M,91,0,0,31,0,31,G
7-M,92,0,31,0,0,31,T
7-M,93,0,0,0,31,31,C
7-M,94,0,31,0,0,31,T
7-M,95,0,31,0,0,31,T
7-M,96,0,31,0,0,31,T
7-M,97,0,0,31,0,31,G
7-M,98,0,0,0,31,31,C
7-M,99,0,31,0,0,31,T
7-M,100,0,0,31,0,31,G
7-M,101,0,0,32,0,32,G
7-M,102,0,0,32,0,32,G
7-M,103,32,0,0,0,32,A
7-M,104,32,0,0,0,32,A
7-M,105,32,0,0,0,32,A
7-M,106,33,0,0,0,33,A
7-M,107,33,0,0,0,33,A
7-M,108,0,0,0,33,33,C
7-M,109,33,0,0,0,33,A
7-M,110,0,0,0,32,32,C
7-M,111,33,0,0,0,33,A
7-M,112,0,0,35,0,35,G
7-M,113,36,0,0,0,36,A
7-M,114,0,35,0,0,35,T
7-M,115,0,0,0,36,36,C
7-M,116,0,36,0,0,36,T
7-M,117,0,36,0,0,36,T
7-M,118,0,0,36,0,36,G
7-M,119,36,0,0,0,36,A
7-M,120,0,0,36,0,36,G
7-M,121,0,0,36,0,36,G
7-M,122,0,0,0,36,36,C
7-M,123,0,37,0,0,37,T
7-M,124,0,0,0,41,41,C
7-M,125,0,41,0,0,41,T
7-M,126,0,0,0,41,41,C
7-M,127,41,0,0,0,41,A
7-M,128,0,41,0,0,41,T
7-M,129,0,0,41,0,41,G
7-M,130,1,0,40,0,41,G
7-M,131,41,0,0,0,41,A
7-M,132,41,0,0,0,41,A
7-M,133,0,41,0,0,41,T
7-M,134,0,0,41,0,41,G
7-M,135,0,0,42,0,42,G
7-M,136,0,0,0,42,42,C
7-M,137,0,42,0,0,42,T
7-M,138,42,0,0,0,42,A
7-M,139,42,0,0,0,42,A
7-M,140,43,0,0,0,43,A
7-M,141,0,0,43,0,43,G
7-M,142,42,0,0,0,42,A
7-M,143,0,0,0,44,44,C
7-M,144,42,0,1,0,43,A
7-M,145,43,0,0,0,43,A
7-M,146,0,0,45,0,45,G
7-M,147,45,0,0,0,45,A
7-M,148,0,0,0,45,45,C
7-M,149,0,0,0,45,45,C
7-M,150,45,0,0,0,45,A
7-M,151,46,0,0,0,46,A
7-M,152,0,46,0,0,46,T
7-M,153,0,46,0,0,46,T
7-M,154,0,0,0,46,46,C
7-M,155,0,46,0,0,46,T
7-M,156,0,0,46,0,46,G
7-M,157,0,45,0,1,46,T
7-M,158,0,0,0,46,46,C
7-M,159,46,0,0,0,46,A
7-M,160,0,0,0,48,48,C
7-M,161,0,0,0,48,48,C
7-M,162,0,48,0,0,48,T
7-M,163,0,0,0,48,48,C
7-M,164,0,47,0,0,47,T
7-M,165,0,0,49,0,49,G
7-M,166,49,0,0,0,49,A
7-M,167,0,0,0,49,49,C
7-M,168,0,49,0,0,49,T
7-M,169,49,0,0,0,49,A
7-M,170,48,0,0,0,48,A
7-M,171,0,1,46,0,47,G
7-M,172,0,0,48,0,48,G
7-M,173,0,0,48,0,48,G
7-M,174,0,0,49,0,49,G
7-M,175,48,0,0,0,48,A
7-M,176,0,49,0,0,49,T
7-M,177,0,49,0,0,49,T
7-M,178,0,49,0,0,49,T
7-M,179,0,49,0,0,49,T
7-M,180,0,0,49,0,49,G
7-M,181,0,0,49,0,49,G
7-M,182,0,0,48,0,48,G
7-M,183,0,0,49,0,49,G
7-M,184,0,48,0,0,48,T
7-M,185,0,48,0,0,48,T
7-M,186,0,48,0,0,48,T
7-M,187,0,0,50,0,50,G
7-M,188,0,50,0,0,50,T
7-M,189,0,0,51,0,51,G
7-M,190,0,51,0,0,51,T
7-M,191,0,51,0,0,51,T
7-M,192,0,0,0,51,51,C
7-M,193,51,0,0,0,51,A
7-M,194,0,0,0,51,51,C
7-M,195,0,0,51,0,51,G
7-M,196,0,0,0,51,51,C
7-M,197,0,50,0,0,50,T
7-M,198,0,0,0,50,50,C
7-M,199,50,0,0,0,50,A
7-M,200,0,0,0,50,50,C
7-M,201,0,0,0,50,50,C
7-M,202,0,0,50,0,50,G
7-M,203,0,49,0,0,49,T
7-M,204,0,0,50,0,50,G
7-M,205,0,0,0,50,50,C
7-M,206,0,0,0,50,50,C
7-M,207,0,0,0,50,50,C
7-M,208,49,0,1,0,50,A
7-M,209,0,0,52,0,52,G
7-M,210,0,52,0,0,52,T
7-M,211,0,0,52,0,52,G
7-M,212,53,0,0,0,53,A
7-M,213,0,0,54,0,54,G
7-M,214,0,0,0,54,54,C
7-M,215,0,0,55,0,55,G
7-M,216,55,0,0,0,55,A
7-M,217,1,0,54,0,55,G
7-M,218,0,0,57,0,57,G
7-M,219,57,0,0,0,57,A
7-M,220,0,0,0,57,57,C
7-M,221,0,56,0,0,56,T
7-M,222,0,0,56,0,56,G
7-M,223,0,0,0,56,56,C
7-M,224,56,0,0,0,56,A
7-M,225,0,0,59,0,59,G
7-M,226,0,0,0,59,59,C
7-M,227,0,0,61,0,61,G
7-M,228,0,61,0,0,61,T
7-M,229,59,1,0,0,60,A
7-M,230,0,0,60,0,60,G
7-M,231,60,0,0,0,60,A
7-M,232,0,0,0,60,60,C
7-M,233,0,0,60,0,60,G
7-M,234,0,0,0,59,59,C
7-M,235,0,58,0,0,58,T
7-M,236,0,59,0,0,59,T
7-M,237,0,57,0,0,57,T
7-M,238,0,0,59,0,59,G
7-M,239,0,59,0,0,59,T
7-M,240,0,0,0,59,59,C
7-M,241,0,0,0,59,59,C
7-M,242,59,0,0,0,59,A
7-M,243,59,0,0,0,59,A
7-M,244,59,0,0,0,59,A
7-M,245,59,0,0,0,59,A
7-M,246,0,59,0,0,59,T
7-M,247,0,0,57,0,57,G
7-M,248,0,0,0,55,55,C
7-M,249,0,0,0,57,57,C
7-M,250,0,0,0,57,57,C
7-M,251,0,57,0,0,57,T
7-M,252,0,0,0,57,57,C
7-M,253,58,0,0,0,58,A
7-M,254,58,0,0,0,58,A
7-M,255,0,59,0,0,59,T
7-M,256,0,0,58,0,58,G
7-M,257,0,0,56,0,56,G
7-M,258,0,0,58,0,58,G
7-M,259,59,0,0,0,59,A
7-M,260,60,0,0,0,60,A
7-M,261,0,58,0,0,58,T
7-M,262,0,0,58,0,58,G
7-M,263,0,0,57,0,57,G
7-M,264,56,0,0,0,56,A
7-M,265,0,0,57,0,57,G
7-M,266,57,0,0,0,57,A
7-M,267,0,0,0,58,58,C
7-M,268,0,0,0,62,62,C
7-M,269,0,0,0,63,63,C
7-M,270,63,0,0,0,63,A
7-M,271,63,0,0,0,63,A
7-M,272,63,0,0,0,63,A
7-M,273,0,63,0,0,63,T
7-M,274,67,0,0,0,67,A
7-M,275,67,0,0,0,67,A
7-M,276,0,0,0,67,67,C
7-M,277,64,0,0,0,64,A
7-M,278,0,63,0,0,63,T
7-M,279,0,0,63,0,63,G
7-M,280,0,0,63,0,63,G
7-M,281,62,0,0,0,62,A
7-M,282,0,0,0,61,61,C
7-M,283,59,0,0,0,59,A
7-M,284,60,0,0,0,60,A
7-M,285,59,0,0,0,59,A
7-M,286,0,0,60,0,60,G
7-M,287,0,0,0,61,61,C
7-M,288,62,0,0,0,62,A
7-M,289,0,0,64,0,64,G
7-M,290,0,64,0,0,64,T
7-M,291,0,64,0,0,64,T
7-M,292,64,0,0,0,64,A
7-M,293,63,0,0,0,63,A
7-M,294,64,0,0,0,64,A
7-M,295,0,0,0,65,65,C
7-M,296,0,64,0,0,64,T
7-M,297,0,0,71,0,71,G
7-M,298,0,70,0,1,71,T
7-M,299,71,0,0,0,71,A
7-M,300,0,71,0,0,71,T
7-M,301,71,0,0,0,71,A
7-M,302,0,0,71,0,71,G
7-M,303,0,0,70,0,70,G
7-M,304,71,0,0,0,71,A
7-M,305,71,0,0,0,71,A
7-M,306,69,0,0,0,69,A
7-M,307,0,0,0,69,69,C
7-M,308,0,69,0,0,69,T
7-M,309,0,69,0,0,69,T
7-M,310,69,0,0,0,69,A
7-M,311,69,0,0,0,69,A
7-M,312,0,0,67,0,67,G
7-M,313,66,0,0,0,66,A
7-M,314,0,0,67,0,67,G
7-M,315,64,0,0,0,64,A
7-M,316,0,0,67,0,67,G
7-M,317,67,0,0,0,67,A
7-M,318,0,0,67,0,67,G
7-M,319,66,0,0,0,66,A
7-M,320,0,68,0,0,68,T
7-M,321,68,0,0,0,68,A
7-M,322,68,0,0,0,68,A
7-M,323,0,0,0,69,69,C
7-M,324,0,0,70,0,70,G
7-M,325,0,70,0,0,70,T
7-M,326,0,68,0,0,68,T
7-M,327,0,0,0,70,70,C
7-M,328,0,0,0,70,70,C
7-M,329,70,0,0,0,70,A
7-M,330,0,70,0,0,70,T
7-M,331,0,0,69,0,69,G
7-M,332,0,0,69,0,69,G
7-M,333,0,0,68,0,68,G
7-M,334,0,0,69,0,69,G
7-M,335,0,0,0,69,69,C
7-M,336,0,0,0,68,68,C
7-M,337,69,0,0,0,69,A
7-M,338,69,0,0,0,69,A
7-M,339,70,0,0,0,70,A
7-M,340,0,0,70,0,70,G
7-M,341,69,0,0,0,69,A
7-M,342,70,0,0,0,70,A
7-M,343,69,0,0,0,69,A
7-M,344,0,70,0,0,70,T
7-M,345,70,0,0,0,70,A
7-M,346,0,0,70,0,70,G
7-M,347,0,0,0,70,70,C
7-M,348,0,69,0,0,69,T
7-M,349,0,0,0,68,68,C
7-M,350,0,70,0,0,70,T
7-M,351,0,0,0,70,70,C
7-M,352,71,0,0,0,71,A
7-M,353,0,0,71,0,71,G
7-M,354,0,70,0,0,70,T
7-M,355,0,70,0,0,70,T
7-M,356,70,0,0,0,70,A
7-M,357,0,69,0,0,69,T
7-M,358,0,68,0,0,68,T
7-M,359,1,0,0,66,67,C
7-M,360,0,67,0,0,67,T
7-M,361,0,0,67,0,67,G
7-M,362,0,0,0,66,66,C
7-M,363,0,67,0,0,67,T
7-M,364,1,0,65,0,66,G
7-M,365,0,0,68,0,68,G
7-M,366,0,68,0,0,68,T
7-M,367,0,0,68,0,68,G
7-M,368,0,0,0,68,68,C
7-M,369,68,0,0,0,68,A
7-M,370,0,0,0,68,68,C
7-M,371,0,65,0,0,65,T
7-M,372,0,67,0,0,67,T
7-M,373,0,0,67,0,67,G
7-M,374,0,0,0,67,67,C
7-M,375,0,0,0,67,67,C
7-M,376,67,0,0,0,67,A
7-M,377,0,0,69,0,69,G
7-M,378,0,69,0,0,69,T
7-M,379,0,68,0,0,68,T
7-M,380,0,0,69,0,69,G
7-M,381,0,69,0,0,69,T
7-M,382,72,0,0,0,72,A
7-M,383,0,72,0,0,72,T
7-M,384,0,0,72,0,72,G
7-M,385,0,0,73,0,73,G
7-M,386,0,0,74,0,74,G
7-M,387,0,0,0,74,74,C
7-M,388,0,0,0,74,74,C
7-M,389,0,74,0,0,74,T
7-M,390,0,0,0,74,74,C
7-M,391,78,0,0,0,78,A
7-M,392,0,78,0,0,78,T
7-M,393,79,0,0,0,79,A
7-M,394,0,78,0,0,78,T
7-M,395,78,0,0,0,78,A
7-M,396,0,0,0,81,81,C
7-M,397,79,0,0,0,79,A
7-M,398,80,0,0,0,80,A
7-M,399,0,77,0,0,77,T
7-M,400,75,0,0,0,75,A
7-M,401,0,0,75,0,75,G
7-M,402,0,0,75,0,75,G
7-M,403,74,0,0,0,74,A
7-M,404,0,74,0,0,74,T
7-M,405,0,0,71,0,71,G
7-M,406,0,0,71,0,71,G
7-M,407,0,0,71,0,71,G
7-M,408,0,0,71,0,71,G
7-M,409,0,0,71,0,71,G
7-M,410,0,0,0,71,71,C
7-M,411,0,70,0,0,70,T
7-M,412,0,0,70,0,70,G
7-M,413,0,70,0,0,70,T
7-M,414,70,0,0,0,70,A
7-M,415,69,0,0,0,69,A
7-M,416,0,0,0,69,69,C
7-M,417,0,0,0,67,67,C
7-M,418,68,0,0,0,68,A
7-M,419,0,0,0,68,68,C
7-M,420,0,67,0,0,67,T
7-M,421,0,0,68,0,68,G
7-M,422,68,0,0,0,68,A
7-M,423,67,0,0,0,67,A
7-M,424,0,0,67,0,67,G
7-M,425,0,67,0,0,67,T
7-M,426,0,0,67,0,67,G
7-M,427,0,0,68,0,68,G
7-M,428,0,0,0,67,67,C
7-M,429,68,0,0,0,68,A
7-M,430,0,68,0,0,68,T
7-M,431,0,68,0,0,68,T
7-M,432,0,68,0,0,68,T
7-M,433,0,0,68,0,68,G
7-M,434,0,0,68,0,68,G
7-M,435,0,0,0,68,68,C
7-M,436,0,1,0,66,67,C
7-M,437,0,64,0,0,64,T
7-M,438,0,0,68,0,68,G
7-M,439,0,0,68,0,68,G
7-M,440,0,68,0,0,68,T
7-M,441,68,0,0,0,68,A
7-M,442,0,66,0,0,66,T
7-M,443,0,0,67,0,67,G
7-M,444,0,67,0,0,67,T
7-M,445,0,0,67,0,67,G
7-M,446,0,0,0,67,67,C
7-M,447,64,0,0,0,64,A
7-M,448,61,0,0,0,61,A
7-M,449,0,0,0,60,60,C
7-M,450,60,0,0,0,60,A
7-M,451,0,59,0,0,59,T
7-M,452,0,0,56,0,56,G
7-M,453,0,54,0,0,54,T
7-M,454,0,0,54,0,54,G
7-M,455,52,0,0,0,52,A
7-M,456,0,0,53,0,53,G
7-M,457,0,0,0,53,53,C
7-M,458,53,0,0,0,53,A
7-M,459,0,0,52,0,52,G
7-M,460,52,0,0,0,52,A
7-M,461,0,53,0,0,53,T
7-M,462,0,53,0,0,53,T
7-M,463,0,0,53,0,53,G
7-M,464,0,0,0,53,53,C
7-M,465,0,53,0,0,53,T
7-M,466,0,0,53,0,53,G
7-M,467,53,0,0,0,53,A
7-M,468,0,0,0,56,56,C
7-M,469,0,56,0,0,56,T
7-M,470,0,0,0,56,56,C
7-M,471,0,0,0,55,55,C
7-M,472,0,0,0,56,56,C
7-M,473,56,0,0,0,56,A
7-M,474,0,0,56,0,56,G
7-M,475,0,0,0,56,56,C
7-M,476,55,0,0,0,55,A
7-M,477,0,0,0,55,55,C
7-M,478,52,0,0,0,52,A
7-M,479,0,0,52,0,52,G
7-M,480,0,0,53,0,53,G
7-M,481,0,52,0,0,52,T
7-M,482,0,0,0,56,56,C
7-M,483,0,54,0,0,54,T
7-M,484,0,0,0,54,54,C
7-M,485,54,0,0,0,54,A
7-M,486,0,54,0,0,54,T
7-M,487,54,0,0,0,54,A
7-M,488,0,0,52,0,52,G
7-M,489,0,0,52,0,52,G
7-M,490,0,0,0,51,51,C
7-M,491,49,0,0,0,49,A
7-M,492,0,0,48,0,48,G
7-M,493,49,0,0,0,49,A
7-M,494,0,50,0,0,50,T
7-M,495,0,0,51,0,51,G
7-M,496,0,0,51,0,51,G
7-M,497,0,51,0,0,51,T
7-M,498,0,0,52,0,52,G
7-M,499,0,0,52,0,52,G
7-M,500,0,0,0,52,52,C
7-M,501,52,0,0,0,52,A
7-M,502,52,0,0,0,52,A
7-M,503,0,0,0,53,53,C
7-M,504,53,0,0,0,53,A
7-M,505,54,0,0,0,54,A
7-M,506,0,0,0,53,53,C
7-M,507,0,0,0,54,54,C
7-M,508,53,0,0,0,53,A
7-M,509,53,0,0,0,53,A
7-M,510,0,53,0,0,53,T
7-M,511,0,0,0,54,54,C
7-M,512,0,0,0,52,52,C
7-M,513,53,0,0,0,53,A
7-M,514,0,53,0,0,53,T
7-M,515,0,53,0,0,53,T
7-M,516,54,0,0,0,54,A
7-M,517,54,0,0,0,54,A
7-M,518,0,53,0,0,53,T
7-M,519,53,0,0,0,53,A
7-M,520,53,0,0,0,53,A
7-M,521,51,0,0,0,51,A
7-M,522,51,0,0,0,51,A
7-M,523,0,0,0,53,53,C
7-M,524,53,0,0,0,53,A
7-M,525,0,52,0,0,52,T
7-M,526,0,0,52,0,52,G
7-M,527,51,0,0,0,51,A
7-M,528,0,0,52,0,52,G
7-M,529,52,0,0,0,52,A
7-M,530,52,0,0,0,52,A
7-M,531,0,0,0,52,52,C
7-M,532,50,0,0,0,50,A
7-M,533,0,0,52,0,52,G
7-M,534,52,0,0,0,52,A
7-M,535,52,0,0,0,52,A
7-M,536,0,52,0,0,52,T
7-M,537,0,0,51,0,51,G
7-M,538,0,0,51,0,51,G
7-M,539,0,50,0,0,50,T
7-M,540,0,49,0,0,49,T
7-M,541,0,50,0,0,50,T
7-M,542,0,51,0,0,51,T
7-M,543,0,0,52,0,52,G
7-M,544,0,0,52,0,52,G
7-M,545,0,0,0,51,51,C
7-M,546,0,0,0,50,50,C
7-M,547,50,0,0,0,50,A
7-M,548,0,0,53,0,53,G
7-M,549,0,0,0,54,54,C
7-M,550,54,0,0,0,54,A
7-M,551,0,0,0,56,56,C
7-M,552,0,55,0,0,55,T
7-M,553,55,0,0,0,55,A
7-M,554,0,0,0,56,56,C
7-M,555,53,0,1,0,54,A
7-M,556,0,0,55,0,55,G
7-M,557,0,0,0,53,53,C
7-M,558,0,52,0,0,52,T
7-M,559,53,0,0,0,53,A
7-M,560,53,0,0,0,53,A
7-M,561,0,0,54,0,54,G
7-M,562,0,0,58,0,58,G
7-M,563,0,0,0,57,57,C
7-M,564,0,55,1,0,56,T
7-M,565,56,0,0,0,56,A
7-M,566,0,56,0,0,56,T
7-M,567,1,0,55,0,56,G
7-M,568,0,0,55,0,55,G
7-M,569,54,0,0,0,54,A
7-M,570,0,0,56,0,56,G
7-M,571,0,0,0,54,54,C
7-M,572,54,0,0,0,54,A
7-M,573,54,0,0,0,54,A
7-M,574,54,0,0,0,54,A
7-M,575,0,53,0,0,53,T
7-M,576,0,0,53,0,53,G
7-M,577,0,0,53,0,53,G
7-M,578,0,0,0,52,52,C
7-M,579,0,51,0,0,51,T
7-M,580,0,0,51,0,51,G
7-M,581,0,0,53,0,53,G
7-M,582,54,0,0,0,54,A
7-M,583,0,53,0,0,53,T
7-M,584,0,0,0,54,54,C
7-M,585,54,0,0,0,54,A
7-M,586,55,0,0,0,55,A
7-M,587,0,0,55,0,55,G
7-M,588,0,55,0,0,55,T
7-M,589,0,0,56,0,56,G
7-M,590,54,0,0,0,54,A
7-M,591,54,0,0,0,54,A
7-M,592,0,0,0,54,54,C
7-M,593,54,0,0,0,54,A
7-M,594,0,0,56,0,56,G
7-M,595,0,0,56,0,56,G
7-M,596,0,0,0,54,54,C
7-M,597,54,0,0,0,54,A
7-M,598,0,0,55,0,55,G
7-M,599,0,0,0,55,55,C
7-M,600,0,0,55,0,55,G
7-M,601,0,0,54,0,54,G
7-M,602,55,0,0,0,55,A
7-M,603,0,0,56,0,56,G
7-M,604,0,0,56,0,56,G
7-M,605,1,0,0,57,58,C
7-M,606,0,0,0,58,58,C
7-M,607,58,0,0,0,58,A
7-M,608,0,58,0,0,58,T
7-M,609,0,0,59,0,59,G
7-M,610,0,0,59,0,59,G
7-M,611,59,0,0,0,59,A
7-M,612,0,0,59,0,59,G
7-M,613,57,0,0,0,57,A
7-M,614,0,57,0,0,57,T
7-M,615,0,56,1,0,57,T
7-M,616,0,0,57,0,57,G
7-M,617,0,0,0,56,56,C
7-M,618,0,56,0,0,56,T
7-M,619,56,0,0,0,56,A
7-M,620,0,0,56,0,56,G
7-M,621,0,56,0,0,56,T
7-M,622,1,0,0,56,57,C
7-M,623,56,0,0,0,56,A
7-M,624,0,0,56,0,56,G
7-M,625,0,0,57,0,57,G
7-M,626,0,0,0,57,57,C
7-M,627,0,0,0,57,57,C
7-M,628,56,0,0,0,56,A
7-M,629,0,0,57,0,57,G
7-M,630,0,0,56,0,56,G
7-M,631,0,0,0,56,56,C
7-M,632,56,0,0,0,56,A
7-M,633,0,0,57,0,57,G
7-M,634,56,0,0,0,56,A
7-M,635,0,56,0,0,56,T
7-M,636,0,0,57,0,57,G
7-M,637,0,0,57,0,57,G
7-M,638,0,57,0,0,57,T
7-M,639,0,0,57,0,57,G
7-M,640,0,0,0,57,57,C
7-M,641,57,0,0,0,57,A
7-M,642,0,0,58,0,58,G
7-M,643,0,0,58,0,58,G
7-M,644,0,0,0,58,58,C
7-M,645,58,0,0,0,58,A
7-M,646,59,0,0,0,59,A
7-M,647,0,58,0,0,58,T
7-M,648,0,0,59,0,59,G
7-M,649,59,0,0,0,59,A
7-M,650,0,0,60,0,60,G
7-M,651,60,0,0,0,60,A
7-M,652,0,0,60,0,60,G
7-M,653,0,0,0,62,62,C
7-M,654,0,0,0,66,66,C
7-M,655,65,1,0,0,66,A
7-M,656,0,65,0,0,65,T
7-M,657,0,65,0,0,65,T
7-M,658,0,0,66,0,66,G
7-M,659,0,0,66,0,66,G
7-M,660,0,0,65,0,65,G
7-M,661,65,0,0,0,65,A
7-M,662,0,0,0,64,64,C
7-M,663,0,62,0,0,62,T
7-M,664,0,0,0,61,61,C
7-M,665,62,0,0,0,62,A
7-M,666,0,63,0,0,63,T
7-M,667,0,0,0,64,64,C
7-M,668,0,0,0,63,63,C
7-M,669,0,65,0,0,65,T
7-M,670,65,0,0,0,65,A
7-M,671,0,0,66,0,66,G
7-M,672,0,67,0,0,67,T
7-M,673,0,66,0,0,66,T
7-M,674,0,0,0,66,66,C
7-M,675,0,0,0,64,64,C
7-M,676,64,0,0,0,64,A
7-M,677,0,0,67,0,67,G
7-M,678,0,67,0,0,67,T
7-M,679,67,0,0,0,67,A
7-M,680,0,0,0,66,66,C
7-M,681,0,64,0,0,64,T
7-M,682,0,0,66,0,66,G
7-M,683,0,0,65,0,65,G
7-M,684,0,65,0,0,65,T
7-M,685,0,65,0,0,65,T
7-M,686,0,65,0,0,65,T
7-M,687,65,0,0,0,65,A
7-M,688,65,0,0,0,65,A
7-M,689,0,0,66,0,66,G
7-M,690,65,0,0,0,65,A
7-M,691,0,0,64,0,64,G
7-M,692,63,0,0,0,63,A
7-M,693,0,62,0,1,63,T
7-M,694,0,0,62,0,62,G
7-M,695,62,0,0,0,62,A
7-M,696,0,61,0,0,61,T
7-M,697,0,0,0,62,62,C
7-M,698,0,61,0,0,61,T
7-M,699,0,62,0,0,62,T
7-M,700,0,0,0,62,62,C
7-M,701,0,61,0,0,61,T
7-M,702,0,62,0,0,62,T
7-M,703,0,0,62,0,62,G
7-M,704,62,0,0,0,62,A
7-M,705,62,0,0,0,62,A
7-M,706,61,0,0,0,61,A
7-M,707,62,0,0,0,62,A
7-M,708,0,62,0,0,62,T
7-M,709,0,62,0,0,62,T
7-M,710,0,62,0,0,62,T
7-M,711,0,0,62,0,62,G
7-M,712,0,0,0,62,62,C
7-M,713,62,0,0,0,62,A
7-M,714,0,0,62,0,62,G
7-M,715,62,0,0,0,62,A
7-M,716,0,0,0,62,62,C
7-M,717,0,0,0,63,63,C
7-M,718,0,63,0,0,63,T
7-M,719,64,0,0,0,64,A
7-M,720,0,63,0,1,64,T
7-M,721,0,0,0,64,64,C
7-M,722,64,0,0,0,64,A
7-M,723,0,0,64,0,64,G
7-M,724,63,0,0,0,63,A
7-M,725,60,0,0,0,60,A
7-M,726,60,0,0,0,60,A
7-M,727,0,0,0,58,58,C
7-M,728,0,0,59,0,59,G
7-M,729,58,0,0,0,58,A
7-M,730,59,0,0,0,59,A
7-M,731,0,59,0,0,59,T
7-M,732,0,0,58,0,58,G
7-M,733,0,0,60,0,60,G
7-M,734,0,1,60,0,61,G
7-M,735,0,0,61,0,61,G
7-M,736,0,0,62,0,62,G
7-M,737,0,61,0,0,61,T
7-M,738,0,0,61,0,61,G
7-M,739,0,0,0,61,61,C
7-M,740,62,0,0,0,62,A
7-M,741,0,0,62,0,62,G
7-M,742,61,0,0,0,61,A
7-M,743,0,62,0,0,62,T
7-M,744,0,0,62,0,62,G
7-M,745,0,0,0,61,61,C
7-M,746,61,0,0,0,61,A
7-M,747,61,0,0,0,61,A
7-M,748,0,0,0,61,61,C
7-M,749,0,0,62,0,62,G
7-M,750,62,0,0,0,62,A
7-M,751,0,62,0,0,62,T
7-M,752,0,62,0,0,62,T
7-M,753,0,0,0,62,62,C
7-M,754,61,0,0,0,61,A
7-M,755,61,0,1,0,62,A
7-M,756,0,0,62,0,62,G
7-M,757,0,61,0,0,61,T
7-M,758,0,0,62,0,62,G
7-M,759,61,0,0,0,61,A
7-M,760,0,0,0,61,61,C
7-M,761,0,0,0,60,60,C
7-M,762,0,0,0,59,59,C
7-M,763,0,0,61,0,61,G
7-M,764,0,0,0,61,61,C
7-M,765,0,61,0,0,61,T
7-M,766,0,60,0,0,60,T
7-M,767,0,0,60,0,60,G
7-M,768,0,60,0,0,60,T
7-M,769,0,60,0,0,60,T
7-M,770,0,0,60,0,60,G
7-M,771,0,58,0,0,58,T
7-M,772,0,58,0,0,58,T
7-M,773,0,0,58,0,58,G
7-M,774,0,0,0,58,58,C
7-M,775,0,0,0,58,58,C
7-M,776,0,0,59,0,59,G
7-M,777,0,0,0,58,58,C
7-M,778,0,0,60,0,60,G
7-M,779,60,0,0,0,60,A
7-M,780,60,0,0,0,60,A
7-M,781,0,60,0,0,60,T
7-M,782,61,0,0,0,61,A
7-M,783,0,61,0,0,61,T
7-M,784,0,0,0,63,63,C
7-M,785,62,0,0,0,62,A
7-M,786,0,63,0,0,63,T
7-M,787,0,63,0,0,63,T
7-M,788,0,0,62,0,62,G
7-M,789,0,0,62,0,62,G
7-M,790,0,0,62,0,62,G
7-M,791,61,0,0,0,61,A
7-M,792,0,62,0,0,62,T
7-M,793,0,0,0,59,59,C
7-M,794,0,59,0,0,59,T
7-M,795,0,59,0,0,59,T
7-M,796,0,0,59,0,59,G
7-M,797,0,0,0,59,59,C
7-M,798,59,0,0,0,59,A
7-M,799,0,0,0,59,59,C
7-M,800,0,59,0,0,59,T
7-M,801,0,57,0,0,57,T
7-M,802,0,1,56,0,57,G
7-M,803,60,0,0,0,60,A
7-M,804,0,60,0,0,60,T
7-M,805,58,0,0,0,58,A
7-M,806,0,58,0,0,58,T
7-M,807,0,58,0,0,58,T
7-M,808,0,0,58,0,58,G
7-M,809,0,58,0,0,58,T
7-M,810,0,0,57,0,57,G
7-M,811,0,0,57,0,57,G
7-M,812,55,0,0,0,55,A
7-M,813,0,55,0,0,55,T
7-M,814,0,54,0,0,54,T
7-M,815,0,0,0,54,54,C
7-M,816,0,54,0,0,54,T
7-M,817,0,54,0,0,54,T
7-M,818,0,0,54,0,54,G
7-M,819,54,0,0,0,54,A
7-M,820,0,53,0,0,53,T
7-M,821,0,0,0,53,53,C
7-M,822,0,0,53,0,53,G
7-M,823,0,53,0,0,53,T
7-M,824,0,0,0,53,53,C
7-M,825,0,53,0,0,53,T
7-M,826,0,53,0,0,53,T
7-M,827,0,53,0,0,53,T
7-M,828,0,53,0,0,53,T
7-M,829,0,53,0,0,53,T
7-M,830,0,53,0,0,53,T
7-M,831,0,53,0,0,53,T
7-M,832,0,0,0,53,53,C
7-M,833,53,0,0,0,53,A
7-M,834,53,0,0,0,53,A
7-M,835,53,0,0,0,53,A
7-M,836,0,53,0,0,53,T
7-M,837,0,0,53,0,53,G
7-M,838,0,0,0,53,53,C
7-M,839,0,0,53,0,53,G
7-M,840,0,53,0,0,53,T
7-M,841,0,0,0,53,53,C
7-M,842,0,53,0,0,53,T
7-M,843,52,0,0,0,52,A
7-M,844,0,52,0,0,52,T
7-M,845,0,0,0,52,52,C
7-M,846,0,0,50,0,50,G
7-M,847,50,0,0,0,50,A
7-M,848,0,0,0,51,51,C
7-M,849,0,48,0,0,48,T
7-M,850,0,0,0,48,48,C
7-M,851,0,47,0,0,47,T
7-M,852,0,48,0,0,48,T
7-M,853,0,0,0,48,48,C
7-M,854,48,0,0,0,48,A
7-M,855,48,0,0,0,48,A
7-M,856,48,0,0,0,48,A
7-M,857,0,0,0,48,48,C
7-M,858,48,0,0,0,48,A
7-M,859,0,0,0,45,45,C
7-M,860,0,0,44,0,44,G
7-M,861,0,0,47,0,47,G
7-M,862,0,0,0,47,47,C
7-M,863,0,0,0,47,47,C
7-M,864,0,46,0,0,46,T
7-M,865,0,46,0,0,46,T
7-M,866,46,0,0,0,46,A
7-M,867,46,0,0,0,46,A
7-M,868,46,0,0,0,46,A
7-M,869,46,0,0,0,46,A
7-M,870,0,0,45,0,45,G
7-M,871,40,0,0,0,40,A
7-M,872,0,0,40,0,40,G
7-M,873,0,0,40,0,40,G
7-M,874,0,0,0,40,40,C
7-M,875,0,0,0,40,40,C
7-M,876,0,0,0,41,41,C
7-M,877,0,41,0,0,41,T
7-M,878,0,41,0,0,41,T
7-M,879,0,0,0,41,41,C
7-M,880,0,41,0,0,41,T
7-M,881,41,0,0,0,41,A
7-M,882,0,0,0,41,41,C
7-M,883,0,0,39,0,39,G
7-M,884,0,0,39,0,39,G
7-M,885,37,0,0,0,37,A
7-M,886,37,0,0,0,37,A
7-M,887,0,0,36,0,36,G
7-M,888,0,0,36,0,36,G
7-M,889,35,0,0,0,35,A
7-M,890,0,0,34,0,34,G
7-M,891,0,34,0,0,34,T
7-M,892,0,0,34,0,34,G
7-M,893,0,0,0,37,37,C
7-M,894,0,0,0,37,37,C
7-M,895,0,37,0,0,37,T
7-M,896,0,0,37,0,37,G
7-M,897,37,0,0,0,37,A
7-M,898,0,0,40,0,40,G
7-M,899,0,40,0,0,40,T
7-M,900,0,0,0,39,39,C
7-M,901,0,38,0,0,38,T
7-M,902,38,0,0,0,38,A
7-M,903,0,38,0,0,38,T
7-M,904,0,0,38,0,38,G
7-M,905,37,0,0,0,37,A
7-M,906,0,0,37,0,37,G
7-M,907,0,0,37,0,37,G
7-M,908,0,0,37,0,37,G
7-M,909,37,0,0,0,37,A
7-M,910,37,0,0,0,37,A
7-M,911,0,0,36,0,36,G
7-M,912,36,0,0,0,36,A
7-M,913,36,0,0,0,36,A
7-M,914,0,36,0,0,36,T
7-M,915,36,0,0,0,36,A
7-M,916,0,36,0,0,36,T
7-M,917,0,0,0,36,36,C
7-M,918,0,0,36,0,36,G
7-M,919,36,0,0,0,36,A
7-M,920,35,0,0,0,35,A
7-M,921,35,0,0,0,35,A
7-M,922,0,0,35,0,35,G
7-M,923,0,0,35,0,35,G
7-M,924,35,0,0,0,35,A
7-M,925,35,0,0,0,35,A
7-M,926,0,0,0,35,35,C
7-M,927,35,0,0,0,35,A
7-M,928,0,0,35,0,35,G
7-M,929,0,0,0,35,35,C
7-M,930,35,0,0,0,35,A
7-M,931,0,0,35,0,35,G
7-M,932,32,0,0,0,32,A
7-M,933,32,0,0,0,32,A
7-M,934,0,32,0,0,32,T
7-M,935,0,0,31,0,31,G
7-M,936,0,0,0,31,31,C
7-M,937,0,29,0,0,29,T
7-M,938,0,0,29,0,29,G
7-M,939,0,29,0,0,29,T
7-M,940,0,0,28,0,28,G
7-M,941,0,0,28,0,28,G
7-M,942,28,0,0,0,28,A
7-M,943,0,28,0,0,28,T
7-M,944,0,0,25,0,25,G
7-M,945,0,0,0,25,25,C
7-M,946,0,19,0,0,19,T
7-M,947,0,0,19,0,19,G
7-M,948,19,0,0,0,19,A
7-M,949,0,0,0,19,19,C
7-M,950,0,0,19,0,19,G
7-M,951,19,0,0,0,19,A
7-M,952,0,0,0,19,19,C
7-M,953,18,0,0,0,18,A
7-M,954,0,0,18,0,18,G
7-M,955,0,18,0,0,18,T
7-M,956,0,0,0,17,17,C
7-M,957,17,0,0,0,17,A
7-M,958,0,16,0,0,16,T
7-M,959,0,16,0,0,16,T
7-M,960,0,16,0,0,16,T
7-M,961,0,16,0,0,16,T
7-M,962,0,0,16,0,16,G
7-M,963,0,14,0,0,14,T
7-M,964,0,0,0,14,14,C
7-M,965,13,0,0,0,13,A
7-M,966,0,0,13,0,13,G
7-M,967,0,0,0,13,13,C
7-M,968,13,0,0,0,13,A
7-M,969,0,13,0,0,13,T
7-M,970,12,0,0,0,12,A
7-M,971,0,0,12,0,12,G
7-M,972,11,0,0,0,11,A
7-M,973,0,0,11,0,11,G
7-M,974,0,10,0,0,10,T
7-M,975,0,5,0,0,5,T
7-M,976,0,0,5,0,5,G
7-M,977,0,0,5,0,5,G
7-M,978,5,0,0,0,5,A
7-M,979,0,0,5,0,5,G
7-M,980,0,1,0,0,1,T
7-M,981,1,0,0,0,1,A
8-NS,1,228,0,0,0,228,A
8-NS,2,0,227,0,0,227,T
8-NS,3,0,0,245,0,245,G
8-NS,4,0,0,266,0,266,G
8-NS,5,287,0,0,0,287,A
8-NS,6,0,590,0,0,590,T
8-NS,7,0,593,0,0,593,T
8-NS,8,0,0,1,617,618,C
8-NS,9,0,0,0,618,618,C
8-NS,10,621,0,0,0,621,A
8-NS,11,623,1,0,0,624,A
8-NS,12,0,0,0,626,626,C
8-NS,13,626,0,0,0,626,A
8-NS,14,0,0,0,630,630,C
8-NS,15,0,632,0,0,632,T
8-NS,16,0,0,707,0,707,G
8-NS,17,0,709,0,0,709,T
8-NS,18,0,0,718,0,718,G
8-NS,19,0,720,0,0,720,T
8-NS,20,0,0,0,722,722,C
8-NS,21,720,0,1,0,721,A
8-NS,22,720,0,0,0,720,A
8-NS,23,0,0,732,0,732,G
8-NS,24,0,744,0,1,745,T
8-NS,25,0,737,1,1,739,T
8-NS,26,0,750,0,1,751,T
8-NS,27,0,0,0,750,750,C
8-NS,28,0,0,0,750,750,C
8-NS,29,753,1,0,0,754,A
8-NS,30,0,0,760,0,760,G
8-NS,31,0,0,764,0,764,G
8-NS,32,0,764,0,1,765,T
8-NS,33,767,0,0,0,767,A
8-NS,34,0,0,773,0,773,G
8-NS,35,769,0,0,0,769,A
8-NS,36,0,778,0,0,778,T
8-NS,37,0,777,0,0,777,T
8-NS,38,0,1,783,0,784,G
8-NS,39,0,0,1,784,785,C
8-NS,40,0,782,0,3,785,T
8-NS,41,0,794,0,0,794,T
8-NS,42,0,799,0,0,799,T
8-NS,43,0,0,0,809,809,C
8-NS,44,0,807,0,2,809,T
8-NS,45,0,809,0,0,809,T
8-NS,46,0,811,0,0,811,T
8-NS,47,0,0,816,0,816,G
8-NS,48,1,0,817,0,818,G
8-NS,49,0,1,0,819,820,C
8-NS,50,822,0,0,0,822,A
8-NS,51,0,822,0,0,822,T
8-NS,52,826,0,0,0,826,A
8-NS,53,0,882,0,5,887,T
8-NS,54,0,0,0,894,894,C
8-NS,55,0,2,0,893,895,C
8-NS,56,0,0,894,0,894,G
8-NS,57,0,894,0,0,894,T
8-NS,58,901,0,0,0,901,A
8-NS,59,902,0,0,0,902,A
8-NS,60,903,0,0,0,903,A
8-NS,61,0,0,0,908,908,C
8-NS,62,897,0,0,0,897,A
8-NS,63,899,0,0,0,899,A
8-NS,64,0,0,937,0,937,G
8-NS,65,0,937,0,1,938,T
8-NS,66,0,940,0,0,940,T
8-NS,67,0,0,943,0,943,G
8-NS,68,0,941,0,1,942,T
8-NS,69,937,0,2,0,939,A
8-NS,70,0,0,952,0,952,G
8-NS,71,992,0,1,0,993,A
8-NS,72,0,0,0,1002,1002,C
8-NS,73,0,0,0,984,984,C
8-NS,74,984,0,1,0,985,A
8-NS,75,986,0,1,0,987,A
8-NS,76,0,0,1048,0,1048,G
8-NS,77,1051,1,0,0,1052,A
8-NS,78,1056,0,0,0,1056,A
8-NS,79,0,0,0,1051,1051,C
8-NS,80,0,1043,0,0,1043,T
8-NS,81,0,0,1051,0,1051,G
8-NS,82,1048,0,1,0,1049,A
8-NS,83,0,1,1072,0,1073,G
8-NS,84,0,1073,0,0,1073,T
8-NS,85,0,1,1060,0,1061,G
8-NS,86,1063,0,0,0,1063,A
8-NS,87,0,1062,0,0,1062,T
8-NS,88,0,0,1077,0,1077,G
8-NS,89,0,0,0,1088,1088,C
8-NS,90,0,0,0,1090,1090,C
8-NS,91,1,0,0,1097,1098,C
8-NS,92,0,0,0,1093,1093,C
8-NS,93,1093,0,0,0,1093,A
8-NS,94,0,1108,0,1,1109,T
8-NS,95,0,1129,0,0,1129,T
8-NS,96,0,1,0,1131,1132,C
8-NS,97,1,0,0,1126,1127,C
8-NS,98,0,1125,0,1,1126,T
8-NS,99,0,1122,0,2,1124,T
8-NS,100,0,0,1126,0,1126,G
8-NS,101,1123,0,0,0,1123,A
8-NS,102,0,1122,0,0,1122,T
8-NS,103,0,0,0,1115,1115,C
8-NS,104,0,0,1107,0,1107,G
8-NS,105,0,0,1124,0,1124,G
8-NS,106,0,0,0,1126,1126,C
8-NS,107,0,1124,0,0,1124,T
8-NS,108,0,1131,0,0,1131,T
8-NS,109,0,0,0,1131,1131,C
8-NS,110,1,0,1133,0,1134,G
8-NS,111,0,1,0,1135,1136,C
8-NS,112,0,1,0,1128,1129,C
8-NS,113,0,0,1133,0,1133,G
8-NS,114,1126,0,0,1,1127,A
8-NS,115,0,0,1161,0,1161,G
8-NS,116,1159,1,0,0,1160,A
8-NS,117,0,1162,0,1,1163,T
8-NS,118,0,0,0,1168,1168,C
8-NS,119,1165,1,1,0,1167,A
8-NS,120,1,0,1169,0,1170,G
8-NS,121,1161,0,2,0,1163,A
8-NS,122,0,0,1168,0,1168,G
8-NS,123,0,0,1181,0,1181,G
8-NS,124,1,1190,0,0,1191,T
8-NS,125,0,1,0,1236,1237,C
8-NS,126,0,0,0,1246,1246,C
8-NS,127,0,0,1,1252,1253,C
8-NS,128,0,1254,0,0,1254,T
8-NS,129,1260,0,0,0,1260,A
8-NS,130,1255,0,0,0,1255,A
8-NS,131,0,1,1276,0,1277,G
8-NS,132,0,1,1275,0,1276,G
8-NS,133,0,2,1268,0,1270,G
8-NS,134,0,0,1231,0,1231,G
8-NS,135,1226,0,1,0,1227,A
8-NS,136,1223,0,0,0,1223,A
8-NS,137,0,0,1232,0,1232,G
8-NS,138,1264,0,1,0,1265,A
8-NS,139,0,0,1278,1,1279,G
8-NS,140,0,0,1268,0,1268,G
8-NS,141,0,0,0,1270,1270,C
8-NS,142,1271,0,0,0,1271,A
8-NS,143,1271,0,2,0,1273,A
8-NS,144,0,1274,0,0,1274,T
8-NS,145,1291,0,0,0,1291,A
8-NS,146,0,0,0,1328,1328,C
8-NS,147,0,1300,0,1,1301,T
8-NS,148,0,0,0,1299,1299,C
8-NS,149,0,1291,0,0,1291,T
8-NS,150,0,53,0,1248,1301,C
8-NS,151,1,1,1315,0,1317,G
8-NS,152,0,0,1381,0,1381,G
8-NS,153,2,1382,0,1,1385,T
8-NS,154,3,1,0,1382,1386,C
8-NS,155,0,1377,0,2,1379,T
8-NS,156,1392,0,0,0,1392,A
8-NS,157,0,0,1391,1,1392,G
8-NS,158,1390,1,0,0,1391,A
8-NS,159,1,0,0,1425,1426,C
8-NS,160,1407,0,0,0,1407,A
8-NS,161,0,1393,0,0,1393,T
8-NS,162,2,0,0,1386,1388,C
8-NS,163,1387,0,2,0,1389,A
8-NS,164,1389,0,0,0,1389,A
8-NS,165,1376,0,1,0,1377,A
8-NS,166,0,1,1385,0,1386,G
8-NS,167,0,0,0,1390,1390,C
8-NS,168,1379,0,0,0,1379,A
8-NS,169,0,0,1379,0,1379,G
8-NS,170,1,0,0,1374,1375,C
8-NS,171,0,1,0,1374,1375,C
8-NS,172,1384,0,2,0,1386,A
8-NS,173,0,0,0,1401,1401,C
8-NS,174,0,1,0,1400,1401,C
8-NS,175,1,1,0,1405,1407,C
8-NS,176,1391,29,0,0,1420,A
8-NS,177,0,1424,0,0,1424,T
8-NS,178,0,0,1427,0,1427,G
8-NS,179,0,1429,0,0,1429,T
8-NS,180,0,1424,1,2,1427,T
8-NS,181,0,0,1401,0,1401,G
8-NS,182,0,0,1388,1,1389,G
8-NS,183,1381,0,1,0,1382,A
8-NS,184,1388,1,0,0,1389,A
8-NS,185,1367,0,2,0,1369,A
8-NS,186,0,0,1380,0,1380,G
8-NS,187,0,0,0,1378,1378,C
8-NS,188,1375,1,0,0,1376,A
8-NS,189,1368,0,1,1,1370,A
8-NS,190,1371,0,0,0,1371,A
8-NS,191,0,1386,0,0,1386,T
8-NS,192,1,1385,0,0,1386,T
8-NS,193,0,1,1412,0,1413,G
8-NS,194,1,1413,0,0,1414,T
8-NS,195,1411,0,1,0,1412,A
8-NS,196,0,2,1411,0,1413,G
8-NS,197,1407,0,0,0,1407,A
8-NS,198,1405,0,2,0,1407,A
8-NS,199,1402,1,0,1,1404,A
8-NS,200,1398,0,3,0,1401,A
8-NS,201,1,0,1412,0,1413,G
8-NS,202,1387,0,1,0,1388,A
8-NS,203,0,1389,0,0,1389,T
8-NS,204,0,1392,0,0,1392,T
8-NS,205,0,0,0,1392,1392,C
8-NS,206,0,1395,0,0,1395,T
8-NS,207,0,0,1399,0,1399,G
8-NS,208,1395,0,1,0,1396,A
8-NS,209,1387,0,1,0,1388,A
8-NS,210,1396,0,0,0,1396,A
8-NS,211,0,0,1403,1,1404,G
8-NS,212,1401,0,0,0,1401,A
8-NS,213,1404,0,0,0,1404,A
8-NS,214,0,1,1407,0,1408,G
8-NS,215,1406,0,1,0,1407,A
8-NS,216,1417,0,0,0,1417,A
8-NS,217,0,1419,0,0,1419,T
8-NS,218,0,0,0,1429,1429,C
8-NS,219,1,1427,0,1,1429,T
8-NS,220,0,1,1439,0,1440,G
8-NS,221,1438,0,1,0,1439,A
8-NS,222,0,1438,0,0,1438,T
8-NS,223,0,2,1428,0,1430,G
8-NS,224,1412,1,1,0,1414,A
8-NS,225,0,0,1407,0,1407,G
8-NS,226,0,0,1409,0,1409,G
8-NS,227,0,0,0,1402,1402,C
8-NS,228,1411,0,1,0,1412,A
8-NS,229,0,0,0,1434,1434,C
8-NS,230,0,1433,0,0,1433,T
8-NS,231,0,1445,0,0,1445,T
8-NS,232,1456,0,0,0,1456,A
8-NS,233,1458,0,0,0,1458,A
8-NS,234,1454,0,0,0,1454,A
8-NS,235,1451,0,0,2,1453,A
8-NS,236,0,1460,0,0,1460,T
8-NS,237,0,1,1455,1,1457,G
8-NS,238,1450,0,6,0,1456,A
8-NS,239,1,0,0,1456,1457,C
8-NS,240,2,1,0,1446,1449,C
8-NS,241,1451,0,1,0,1452,A
8-NS,242,1,1446,1,0,1448,T
8-NS,243,1,1,1490,1,1493,G
8-NS,244,0,0,1502,0,1502,G
8-NS,245,0,1514,0,1,1515,T
8-NS,246,1,0,0,1558,1559,C
8-NS,247,0,1549,0,3,1552,T
8-NS,248,1,1,0,1568,1570,C
8-NS,249,1,0,0,1572,1573,C
8-NS,250,1573,0,0,0,1573,A
8-NS,251,0,0,0,1582,1582,C
8-NS,252,1555,0,0,0,1555,A
8-NS,253,0,0,0,1547,1547,C
8-NS,254,1,0,0,1541,1542,C
8-NS,255,0,1473,1,3,1477,T
8-NS,256,0,0,1498,0,1498,G
8-NS,257,1,0,0,1493,1494,C
8-NS,258,0,1485,0,1,1486,T
8-NS,259,0,1498,0,0,1498,T
8-NS,260,0,0,1,1481,1482,C
8-NS,261,0,0,1491,0,1491,G
8-NS,262,1,0,0,1488,1489,C
8-NS,263,2,0,1483,0,1485,G
8-NS,264,1533,0,3,0,1536,A
8-NS,265,0,1531,0,1,1532,T
8-NS,266,1576,1,2,0,1579,A
8-NS,267,0,0,0,1585,1585,C
8-NS,268,1578,1,0,0,1579,A
8-NS,269,0,1615,1,0,1616,T
8-NS,270,1606,0,0,0,1606,A
8-NS,271,1611,1,1,0,1613,A
8-NS,272,0,0,0,1613,1613,C
8-NS,273,2,1565,0,0,1567,T
8-NS,274,0,2,1578,0,1580,G
8-NS,275,1556,0,2,0,1558,A
8-NS,276,0,1,0,1566,1567,C
8-NS,277,1570,0,0,0,1570,A
8-NS,278,1,1560,0,0,1561,T
8-NS,279,1,1,1561,2,1565,G
8-NS,280,1567,0,2,0,1569,A
8-NS,281,1,0,0,1623,1624,C
8-NS,282,1,1614,0,0,1615,T
8-NS,283,1639,1,2,0,1642,A
8-NS,284,0,1639,0,1,1640,T
8-NS,285,0,1620,0,0,1620,T
8-NS,286,0,1,1623,0,1624,G
8-NS,287,1614,0,1,0,1615,A
8-NS,288,0,1,1609,0,1610,G
8-NS,289,0,1,1614,0,1615,G
8-NS,290,1574,0,0,0,1574,A
8-NS,291,1575,0,0,0,1575,A
8-NS,292,1,1551,0,0,1552,T
8-NS,293,0,1547,0,0,1547,T
8-NS,294,1,0,1576,0,1577,G
8-NS,295,0,1577,0,1,1578,T
8-NS,296,0,0,0,1577,1577,C
8-NS,297,1583,0,2,0,1585,A
8-NS,298,1589,0,1,0,1590,A
8-NS,299,0,0,1594,0,1594,G
8-NS,300,1594,0,0,0,1594,A
8-NS,301,1596,0,3,0,1599,A
8-NS,302,1597,0,0,0,1597,A
8-NS,303,0,0,0,1596,1596,C
8-NS,304,0,1578,0,1,1579,T
8-NS,305,1,0,1599,0,1600,G
8-NS,306,0,0,1620,0,1620,G
8-NS,307,0,1621,1,0,1622,T
8-NS,308,1,1620,0,1,1622,T
8-NS,309,0,0,0,1614,1614,C
8-NS,310,1615,0,0,0,1615,A
8-NS,311,0,1638,0,1,1639,T
8-NS,312,0,1,1658,0,1659,G
8-NS,313,0,0,0,1674,1674,C
8-NS,314,0,1658,0,1,1659,T
8-NS,315,1629,0,2,1,1632,A
8-NS,316,1698,0,0,0,1698,A
8-NS,317,0,1657,0,54,1711,T
8-NS,318,3,0,1705,0,1708,G
8-NS,319,1,1,0,1706,1708,C
8-NS,320,0,1,0,1679,1680,C
8-NS,321,6,2,0,1663,1671,C
8-NS,322,1657,1,0,0,1658,A
8-NS,323,1657,0,0,0,1657,A
8-NS,324,0,0,1669,0,1669,G
8-NS,325,0,0,0,1667,1667,C
8-NS,326,1658,0,0,0,1658,A
8-NS,327,0,1,1671,1,1673,G
8-NS,328,1668,1,0,0,1669,A
8-NS,329,1666,0,1,0,1667,A
8-NS,330,1665,0,0,0,1665,A
8-NS,331,1651,1,1,0,1653,A
8-NS,332,1,1672,0,1,1674,T
8-NS,333,1,0,1673,0,1674,G
8-NS,334,0,1,1677,0,1678,G
8-NS,335,1675,0,0,0,1675,A
8-NS,336,1662,0,2,0,1664,A
8-NS,337,0,0,1659,0,1659,G
8-NS,338,0,1,1662,0,1663,G
8-NS,339,1670,0,0,0,1670,A
8-NS,340,0,0,0,1670,1670,C
8-NS,341,2,0,0,1672,1674,C
8-NS,342,0,1669,0,0,1669,T
8-NS,343,0,0,0,1690,1690,C
8-NS,344,0,1682,0,1,1683,T
8-NS,345,0,1692,1,0,1693,T
8-NS,346,0,1694,0,0,1694,T
8-NS,347,0,0,1691,0,1691,G
8-NS,348,0,3,0,1702,1705,C
8-NS,349,1696,1,0,0,1697,A
8-NS,350,1,1691,2,0,1694,T
8-NS,351,0,1,1,1695,1697,C
8-NS,352,1710,0,11,0,1721,A
8-NS,353,0,1,1772,0,1773,G
8-NS,354,1766,0,0,1,1767,A
8-NS,355,1765,0,1,1,1767,A
8-NS,356,1,1764,1,2,1768,T
8-NS,357,0,0,1750,0,1750,G
8-NS,358,2,1,1757,0,1760,G
8-NS,359,1762,0,1,0,1763,A
8-NS,360,1,0,0,1760,1761,C
8-NS,361,1,0,0,1729,1730,C
8-NS,362,1689,0,0,0,1689,A
8-NS,363,0,0,1699,0,1699,G
8-NS,364,1,0,1702,0,1703,G
8-NS,365,0,0,0,1710,1710,C
8-NS,366,1695,0,1,0,1696,A
8-NS,367,1716,0,0,1,1717,A
8-NS,368,0,1716,0,1,1717,T
8-NS,369,1,0,0,1714,1715,C
8-NS,370,1712,1,1,0,1714,A
8-NS,371,0,1710,0,2,1712,T
8-NS,372,1,1,1699,0,1701,G
8-NS,373,2,0,1721,0,1723,G
8-NS,374,1712,0,3,0,1715,A
8-NS,375,0,0,1727,0,1727,G
8-NS,376,1681,0,0,1,1682,A
8-NS,377,1683,0,0,0,1683,A
8-NS,378,1679,0,1,0,1680,A
8-NS,379,0,0,1645,0,1645,G
8-NS,380,1659,1,1,0,1661,A
8-NS,381,0,0,0,1663,1663,C
8-NS,382,1671,1,1,0,1673,A
8-NS,383,0,1662,0,2,1664,T
8-NS,384,0,0,0,1663,1663,C
8-NS,385,1662,0,4,0,1666,A
8-NS,386,0,1677,1,0,1678,T
8-NS,387,0,0,1685,0,1685,G
8-NS,388,0,1675,1,3,1679,T
8-NS,389,0,1672,0,1,1673,T
8-NS,390,26,0,1640,3,1669,G
8-NS,391,1665,0,0,0,1665,A
8-NS,392,1660,2,0,0,1662,A
8-NS,393,1655,0,1,0,1656,A
8-NS,394,0,0,1657,0,1657,G
8-NS,395,0,1,0,1640,1641,C
8-NS,396,0,2,1636,0,1638,G
8-NS,397,1638,0,0,0,1638,A
8-NS,398,1637,2,0,0,1639,A
8-NS,399,0,1632,0,0,1632,T
8-NS,400,0,1634,1,1,1636,T
8-NS,401,0,1637,0,0,1637,T
8-NS,402,0,1,0,1642,1643,C
8-NS,403,1631,0,3,0,1634,A
8-NS,404,1,0,1634,0,1635,G
8-NS,405,0,1622,0,1,1623,T
8-NS,406,0,0,1628,0,1628,G
8-NS,407,0,1622,0,3,1625,T
8-NS,408,0,2,1628,0,1630,G
8-NS,409,1635,0,0,0,1635,A
8-NS,410,0,1619,0,0,1619,T
8-NS,411,0,1643,0,0,1643,T
8-NS,412,1,1642,0,1,1644,T
8-NS,413,0,1641,0,0,1641,T
8-NS,414,0,1636,0,0,1636,T
8-NS,415,1,1,1628,0,1630,G
8-NS,416,1636,1,1,0,1638,A
8-NS,417,1,3,0,1627,1631,C
8-NS,418,1,0,0,1616,1617,C
8-NS,419,1,0,1628,0,1629,G
8-NS,420,1715,0,0,0,1715,A
8-NS,421,0,0,0,1741,1741,C
8-NS,422,0,1739,0,1,1740,T
8-NS,423,1752,0,1,0,1753,A
8-NS,424,0,0,1750,0,1750,G
8-NS,425,1747,0,2,0,1749,A
8-NS,426,1,1,1752,0,1754,G
8-NS,427,1764,1,0,0,1765,A
8-NS,428,0,0,0,1815,1815,C
8-NS,429,1,0,0,1739,1740,C
8-NS,430,1693,0,0,0,1693,A
8-NS,431,0,1784,0,1,1785,T
8-NS,432,1772,1,0,0,1773,A
8-NS,433,0,0,1906,0,1906,G
8-NS,434,0,1903,0,0,1903,T
8-NS,435,1886,0,0,0,1886,A
8-NS,436,0,1882,0,1,1883,T
8-NS,437,0,1819,1,1,1821,T
8-NS,438,1875,0,0,0,1875,A
8-NS,439,0,0,0,1868,1868,C
8-NS,440,0,1800,0,3,1803,T
8-NS,441,1797,0,1,0,1798,A
8-NS,442,1635,0,0,0,1635,A
8-NS,443,0,0,1649,0,1649,G
8-NS,444,0,4,1643,0,1647,G
8-NS,445,0,0,1656,0,1656,G
8-NS,446,0,0,0,1625,1625,C
8-NS,447,0,1601,0,6,1607,T
8-NS,448,0,1606,0,0,1606,T
8-NS,449,0,1614,0,4,1618,T
8-NS,450,3,0,0,1625,1628,C
8-NS,451,1645,0,2,0,1647,A
8-NS,452,0,0,0,1648,1648,C
8-NS,453,0,0,0,1645,1645,C
8-NS,454,2,0,1644,0,1646,G
8-NS,455,1645,0,0,0,1645,A
8-NS,456,1642,0,2,0,1644,A
8-NS,457,0,0,1647,0,1647,G
8-NS,458,1631,0,1,0,1632,A
8-NS,459,0,1,1631,1,1633,G
8-NS,460,0,0,1597,0,1597,G
8-NS,461,0,1,1609,1,1611,G
8-NS,462,1602,1,1,0,1604,A
8-NS,463,0,0,1609,0,1609,G
8-NS,464,1,0,0,1599,1600,C
8-NS,465,1604,1,0,0,1605,A
8-NS,466,1606,1,1,0,1608,A
8-NS,467,0,1602,0,0,1602,T
8-NS,468,1,1594,0,0,1595,T
8-NS,469,0,0,1598,1,1599,G
8-NS,470,0,1577,0,0,1577,T
8-NS,471,1,1571,0,1,1573,T
8-NS,472,0,0,1569,0,1569,G
8-NS,473,1,0,1576,0,1577,G
8-NS,474,1,0,0,1572,1573,C
8-NS,475,0,0,1576,0,1576,G
8-NS,476,1575,0,0,0,1575,A
8-NS,477,1576,0,0,0,1576,A
8-NS,478,1584,0,0,0,1584,A
8-NS,479,1,1585,0,2,1588,T
8-NS,480,0,1,0,1586,1587,C
8-NS,481,0,1578,0,0,1578,T
8-NS,482,2,0,0,1577,1579,C
8-NS,483,1589,0,1,1,1591,A
8-NS,484,0,0,0,1617,1617,C
8-NS,485,0,0,0,1616,1616,C
8-NS,486,1611,1,0,0,1612,A
8-NS,487,0,1610,0,1,1611,T
8-NS,488,0,1597,0,0,1597,T
8-NS,489,1,0,1601,0,1602,G
8-NS,490,1,1,0,1590,1592,C
8-NS,491,1,0,0,1595,1596,C
8-NS,492,1,1590,0,2,1593,T
8-NS,493,0,1588,0,1,1589,T
8-NS,494,0,0,0,1600,1600,C
8-NS,495,0,1599,0,2,1601,T
8-NS,496,0,1595,0,2,1597,T
8-NS,497,0,1625,0,1,1626,T
8-NS,498,2,1619,0,2,1623,T
8-NS,499,0,1,0,1627,1628,C
8-NS,500,0,1,0,1621,1622,C
8-NS,501,1615,0,1,0,1616,A
8-NS,502,0,0,1640,0,1640,G
8-NS,503,0,0,1631,0,1631,G
8-NS,504,1659,0,0,0,1659,A
8-NS,505,0,0,0,1663,1663,C
8-NS,506,1670,0,1,0,1671,A
8-NS,507,0,1677,0,2,1679,T
8-NS,508,1683,0,0,0,1683,A
8-NS,509,0,0,0,1790,1790,C
8-NS,510,0,1780,0,0,1780,T
8-NS,511,1766,0,1,0,1767,A
8-NS,512,0,1760,0,1,1761,T
8-NS,513,0,1719,0,1,1720,T
8-NS,514,0,1,1718,0,1719,G
8-NS,515,1659,0,1,0,1660,A
8-NS,516,0,0,1663,1,1664,G
8-NS,517,0,1,1644,0,1645,G
8-NS,518,1517,0,0,0,1517,A
8-NS,519,0,1522,0,0,1522,T
8-NS,520,0,0,1537,0,1537,G
8-NS,521,1,1531,0,3,1535,T
8-NS,522,0,0,0,1539,1539,C
8-NS,523,1541,0,0,0,1541,A
8-NS,524,1544,0,0,0,1544,A
8-NS,525,1540,0,0,0,1540,A
8-NS,526,1535,0,0,0,1535,A
8-NS,527,1539,0,0,0,1539,A
8-NS,528,3,1527,0,0,1530,T
8-NS,529,1,1,1528,0,1530,G
8-NS,530,0,0,0,1536,1536,C
8-NS,531,1543,0,1,0,1544,A
8-NS,532,1542,0,0,0,1542,A
8-NS,533,0,1547,0,2,1549,T
8-NS,534,0,1545,0,0,1545,T
8-NS,535,0,0,1541,0,1541,G
8-NS,536,0,2,1533,0,1535,G
8-NS,537,1,0,1528,0,1529,G
8-NS,538,0,0,1540,0,1540,G
8-NS,539,0,1522,0,0,1522,T
8-NS,540,1,0,0,1540,1541,C
8-NS,541,2,0,0,1535,1537,C
8-NS,542,0,1542,0,0,1542,T
8-NS,543,0,0,0,1558,1558,C
8-NS,544,1557,0,0,0,1557,A
8-NS,545,0,1561,1,1,1563,T
8-NS,546,0,0,0,1563,1563,C
8-NS,547,0,0,1553,0,1553,G
8-NS,548,0,0,1555,0,1555,G
8-NS,549,1540,0,1,1,1542,A
8-NS,550,0,0,1544,0,1544,G
8-NS,551,0,0,1553,0,1553,G
8-NS,552,1535,0,0,0,1535,A
8-NS,553,0,0,0,1559,1559,C
8-NS,554,0,1550,0,0,1550,T
8-NS,555,0,1557,0,0,1557,T
8-NS,556,0,1,1562,0,1563,G
8-NS,557,1557,0,0,0,1557,A
8-NS,558,1556,1,2,0,1559,A
8-NS,559,0,1554,0,0,1554,T
8-NS,560,0,0,1527,1,1528,G
8-NS,561,0,0,1543,0,1543,G
8-NS,562,1531,0,0,0,1531,A
8-NS,563,1538,0,1,0,1539,A
8-NS,564,0,1613,0,2,1615,T
8-NS,565,0,0,1618,0,1618,G
8-NS,566,1624,0,1,0,1625,A
8-NS,567,0,1621,0,0,1621,T
8-NS,568,1623,0,1,0,1624,A
8-NS,569,1628,0,1,0,1629,A
8-NS,570,0,2,0,1612,1614,C
8-NS,571,1596,2,1,0,1599,A
8-NS,572,0,0,0,1605,1605,C
8-NS,573,1461,0,0,0,1461,A
8-NS,574,0,0,1482,0,1482,G
8-NS,575,1,1473,0,2,1476,T
8-NS,576,0,1472,0,0,1472,T
8-NS,577,0,0,0,1473,1473,C
8-NS,578,0,3,1464,0,1467,G
8-NS,579,1464,0,1,0,1465,A
8-NS,580,0,0,1469,0,1469,G
8-NS,581,0,1460,0,0,1460,T
8-NS,582,1,0,0,1470,1471,C
8-NS,583,0,1428,1,4,1433,T
8-NS,584,0,0,0,1440,1440,C
8-NS,585,0,1441,0,1,1442,T
8-NS,586,1442,0,0,0,1442,A
8-NS,587,1439,0,1,0,1440,A
8-NS,588,1437,0,0,0,1437,A
8-NS,589,1453,0,0,1,1454,A
8-NS,590,1454,0,0,0,1454,A
8-NS,591,0,1453,0,0,1453,T
8-NS,592,0,0,0,1465,1465,C
8-NS,593,0,1459,0,0,1459,T
8-NS,594,1463,0,1,0,1464,A
8-NS,595,0,0,0,1464,1464,C
8-NS,596,1459,0,1,0,1460,A
8-NS,597,0,1,1461,0,1462,G
8-NS,598,1425,0,0,0,1425,A
8-NS,599,0,2,1430,0,1432,G
8-NS,600,1425,0,0,0,1425,A
8-NS,601,0,1416,0,1,1417,T
8-NS,602,1,1416,0,0,1417,T
8-NS,603,1,1,0,1415,1417,C
8-NS,604,0,0,1421,0,1421,G
8-NS,605,0,1,0,1422,1423,C
8-NS,606,2,1418,0,2,1422,T
8-NS,607,0,1427,0,1,1428,T
8-NS,608,0,0,1411,0,1411,G
8-NS,609,0,1,1417,0,1418,G
8-NS,610,1416,0,0,0,1416,A
8-NS,611,0,0,1412,0,1412,G
8-NS,612,1407,0,0,0,1407,A
8-NS,613,1394,0,0,0,1394,A
8-NS,614,0,0,1420,0,1420,G
8-NS,615,1,0,0,1417,1418,C
8-NS,616,1421,0,1,0,1422,A
8-NS,617,0,0,1453,0,1453,G
8-NS,618,0,1443,0,0,1443,T
8-NS,619,1451,0,1,0,1452,A
8-NS,620,1448,0,0,0,1448,A
8-NS,621,0,1445,0,0,1445,T
8-NS,622,0,0,1448,0,1448,G
8-NS,623,1396,0,1,0,1397,A
8-NS,624,0,1,1419,0,1420,G
8-NS,625,1411,0,0,1,1412,A
8-NS,626,1351,0,0,0,1351,A
8-NS,627,1,1351,0,0,1352,T
8-NS,628,0,1,1332,0,1333,G
8-NS,629,0,1,1343,0,1344,G
8-NS,630,1,1,1336,0,1338,G
8-NS,631,0,0,1334,0,1334,G
8-NS,632,0,0,1328,0,1328,G
8-NS,633,1286,0,1,0,1287,A
8-NS,634,1,1265,0,0,1266,T
8-NS,635,0,0,0,1289,1289,C
8-NS,636,0,1290,0,2,1292,T
8-NS,637,2,0,0,1304,1306,C
8-NS,638,0,1,1,1312,1314,C
8-NS,639,1310,0,1,0,1311,A
8-NS,640,0,0,0,1311,1311,C
8-NS,641,0,1287,0,0,1287,T
8-NS,642,0,1285,0,0,1285,T
8-NS,643,1268,0,3,0,1271,A
8-NS,644,0,0,0,1283,1283,C
8-NS,645,0,1280,0,1,1281,T
8-NS,646,2,0,0,1277,1279,C
8-NS,647,0,0,0,1267,1267,C
8-NS,648,1265,1,0,0,1266,A
8-NS,649,1262,0,0,0,1262,A
8-NS,650,1260,0,0,0,1260,A
8-NS,651,1261,0,0,0,1261,A
8-NS,652,0,0,0,1261,1261,C
8-NS,653,1232,0,1,0,1233,A
8-NS,654,0,1,1236,0,1237,G
8-NS,655,1225,0,1,0,1226,A
8-NS,656,1228,1,0,0,1229,A
8-NS,657,1231,0,0,0,1231,A
8-NS,658,0,0,0,1230,1230,C
8-NS,659,1,0,1228,0,1229,G
8-NS,660,1,0,1228,0,1229,G
8-NS,661,0,1,1225,0,1226,G
8-NS,662,1229,0,0,0,1229,A
8-NS,663,1219,0,0,0,1219,A
8-NS,664,1219,0,0,0,1219,A
8-NS,665,0,1217,0,0,1217,T
8-NS,666,0,0,1229,0,1229,G
8-NS,667,0,1,1228,0,1229,G
8-NS,668,1,1,0,1218,1220,C
8-NS,669,1,1,1217,0,1219,G
8-NS,670,1215,2,0,0,1217,A
8-NS,671,0,0,1224,0,1224,G
8-NS,672,1221,0,0,0,1221,A
8-NS,673,1220,0,0,0,1220,A
8-NS,674,0,0,0,1221,1221,C
8-NS,675,1202,0,1,0,1203,A
8-NS,676,0,0,1202,0,1202,G
8-NS,677,0,0,0,1194,1194,C
8-NS,678,0,1199,0,0,1199,T
8-NS,679,1193,0,0,0,1193,A
8-NS,680,0,0,1180,1,1181,G
8-NS,681,0,0,1188,0,1188,G
8-NS,682,0,1187,0,2,1189,T
8-NS,683,0,0,0,1161,1161,C
8-NS,684,1167,0,0,0,1167,A
8-NS,685,1165,0,0,0,1165,A
8-NS,686,1167,0,1,0,1168,A
8-NS,687,1168,0,1,0,1169,A
8-NS,688,0,0,1174,0,1174,G
8-NS,689,0,1147,0,0,1147,T
8-NS,690,0,1143,0,0,1143,T
8-NS,691,0,1146,0,0,1146,T
8-NS,692,0,0,1147,0,1147,G
8-NS,693,1147,0,0,0,1147,A
8-NS,694,1146,1,1,0,1148,A
8-NS,695,1,1,1148,0,1150,G
8-NS,696,1125,0,0,0,1125,A
8-NS,697,0,0,1133,0,1133,G
8-NS,698,1126,0,2,0,1128,A
8-NS,699,1,1127,1,0,1129,T
8-NS,700,1127,0,1,0,1128,A
8-NS,701,1123,0,0,1,1124,A
8-NS,702,0,0,1127,0,1127,G
8-NS,703,1045,0,0,0,1045,A
8-NS,704,0,1046,0,0,1046,T
8-NS,705,0,0,1051,0,1051,G
8-NS,706,0,0,1052,0,1052,G
8-NS,707,0,0,0,1043,1043,C
8-NS,708,0,1042,0,0,1042,T
8-NS,709,1053,0,0,0,1053,A
8-NS,710,1049,0,0,0,1049,A
8-NS,711,0,1059,0,0,1059,T
8-NS,712,0,1057,0,1,1058,T
8-NS,713,0,1,1057,0,1058,G
8-NS,714,1031,0,0,0,1031,A
8-NS,715,1028,0,1,1,1030,A
8-NS,716,0,0,1029,0,1029,G
8-NS,717,1027,0,0,0,1027,A
8-NS,718,1015,0,0,0,1015,A
8-NS,719,0,0,1026,0,1026,G
8-NS,720,0,1007,0,1,1008,T
8-NS,721,0,2,1005,0,1007,G
8-NS,722,992,2,2,0,996,A
8-NS,723,0,2,994,0,996,G
8-NS,724,997,0,1,0,998,A
8-NS,725,0,0,0,991,991,C
8-NS,726,985,0,1,0,986,A
8-NS,727,0,2,0,978,980,C
8-NS,728,897,0,0,0,897,A
8-NS,729,0,0,908,0,908,G
8-NS,730,908,0,0,0,908,A
8-NS,731,0,898,0,0,898,T
8-NS,732,0,895,1,2,898,T
8-NS,733,896,0,1,0,897,A
8-NS,734,897,0,1,0,898,A
8-NS,735,894,0,0,0,894,A
8-NS,736,893,0,0,0,893,A
8-NS,737,890,0,1,0,891,A
8-NS,738,0,0,0,851,851,C
8-NS,739,796,0,0,0,796,A
8-NS,740,803,0,0,0,803,A
8-NS,741,0,0,0,801,801,C
8-NS,742,0,799,0,1,800,T
8-NS,743,0,0,803,1,804,G
8-NS,744,800,0,0,0,800,A
8-NS,745,802,0,1,0,803,A
8-NS,746,803,0,0,0,803,A
8-NS,747,791,1,0,0,792,A
8-NS,748,1,792,0,0,793,T
8-NS,749,777,0,0,1,778,A
8-NS,750,0,0,780,0,780,G
8-NS,751,0,0,0,776,776,C
8-NS,752,1,756,0,0,757,T
8-NS,753,0,761,0,0,761,T
8-NS,754,0,751,0,0,751,T
8-NS,755,0,0,755,1,756,G
8-NS,756,758,0,1,0,759,A
8-NS,757,755,0,2,0,757,A
8-NS,758,0,0,0,758,758,C
8-NS,759,734,0,2,0,736,A
8-NS,760,736,0,0,0,736,A
8-NS,761,737,0,0,0,737,A
8-NS,762,0,737,0,0,737,T
8-NS,763,737,0,1,0,738,A
8-NS,764,720,0,0,0,720,A
8-NS,765,0,0,0,719,719,C
8-NS,766,714,0,0,0,714,A
8-NS,767,0,708,0,0,708,T
8-NS,768,0,703,0,0,703,T
8-NS,769,0,0,0,685,685,C
8-NS,770,680,0,0,0,680,A
8-NS,771,0,676,0,0,676,T
8-NS,772,0,0,677,0,677,G
8-NS,773,0,1,0,663,664,C
8-NS,774,654,0,0,0,654,A
8-NS,775,650,0,0,0,650,A
8-NS,776,0,0,650,0,650,G
8-NS,777,0,0,0,654,654,C
8-NS,778,650,0,0,0,650,A
8-NS,779,0,650,0,1,651,T
8-NS,780,0,649,1,0,650,T
8-NS,781,647,0,1,0,648,A
8-NS,782,0,0,0,650,650,C
8-NS,783,640,0,0,0,640,A
8-NS,784,631,0,0,0,631,A
8-NS,785,0,0,0,624,624,C
8-NS,786,1,522,1,3,527,T
8-NS,787,0,0,526,0,526,G
8-NS,788,0,0,0,512,512,C
8-NS,789,0,505,0,0,505,T
8-NS,790,0,0,505,0,505,G
8-NS,791,0,492,1,0,493,T
8-NS,792,0,491,1,0,492,T
8-NS,793,0,491,0,0,491,T
8-NS,794,0,0,486,0,486,G
8-NS,795,483,1,0,0,484,A
8-NS,796,475,0,0,0,475,A
8-NS,797,0,0,472,0,472,G
8-NS,798,0,471,0,1,472,T
8-NS,799,0,0,451,0,451,G
8-NS,800,0,0,450,0,450,G
8-NS,801,448,0,0,0,448,A
8-NS,802,449,0,0,0,449,A
8-NS,803,0,0,0,449,449,C
8-NS,804,439,0,0,0,439,A
8-NS,805,0,0,441,0,441,G
8-NS,806,0,1,432,0,433,G
8-NS,807,424,0,0,0,424,A
8-NS,808,0,0,425,0,425,G
8-NS,809,353,0,0,0,353,A
8-NS,810,0,354,0,0,354,T
8-NS,811,353,0,0,0,353,A
8-NS,812,351,0,0,0,351,A
8-NS,813,0,0,351,0,351,G
8-NS,814,319,0,0,0,319,A
8-NS,815,317,0,0,0,317,A
8-NS,816,0,0,0,314,314,C
8-NS,817,0,271,0,0,271,T
8-NS,818,0,271,0,0,271,T
8-NS,819,0,269,0,0,269,T
8-NS,820,0,0,0,270,270,C
8-NS,821,0,266,0,1,267,T
8-NS,822,0,0,0,262,262,C
8-NS,823,258,0,1,0,259,A
8-NS,824,0,258,0,0,258,T
8-NS,825,0,256,0,0,256,T
8-NS,826,1,254,0,0,255,T
8-NS,827,0,0,0,252,252,C
8-NS,828,247,1,0,0,248,A
8-NS,829,0,0,246,0,246,G
8-NS,830,0,0,0,241,241,C
8-NS,831,0,228,0,0,228,T
8-NS,832,0,227,0,0,227,T
8-NS,833,219,0,0,0,219,A
8-NS,834,0,218,0,0,218,T
8-NS,835,0,217,0,0,217,T
8-NS,836,0,214,0,0,214,T
8-NS,837,199,0,0,0,199,A
8-NS,838,192,0,0,0,192,A
8-NS,839,0,190,0,0,190,T
8-NS,840,0,1,186,0,187,G
8-NS,841,181,0,0,0,181,A
8-NS,842,0,162,0,0,162,T
8-NS,843,161,0,0,0,161,A
8-NS,844,160,0,0,0,160,A
8-NS,845,161,0,0,0,161,A
8-NS,846,159,0,0,0,159,A
8-NS,847,160,0,0,0,160,A
8-NS,848,158,0,0,0,158,A
8-NS,849,0,0,0,157,157,C
8-NS,850,136,0,0,0,136,A
8-NS,851,0,0,0,136,136,C
8-NS,852,0,0,0,131,131,C
8-NS,853,0,0,0,127,127,C
8-NS,854,0,117,0,0,117,T
8-NS,855,0,111,0,0,111,T
8-NS,856,0,1,109,0,110,G
8-NS,857,0,106,0,0,106,T
8-NS,858,0,107,0,0,107,T
8-NS,859,0,102,0,0,102,T
8-NS,860,0,0,0,27,27,C
8-NS,861,0,19,0,0,19,T
8-NS,862,17,0,0,0,17,A
8-NS,863,0,0,0,17,17,C
