Gene,Position,A,T,G,C,Coverage,Consensus
1-PB2,1,257,0,0,0,257,A
1-PB2,2,0,258,0,0,258,T
1-PB2,3,0,0,264,0,264,G
1-PB2,4,0,0,265,0,265,G
1-PB2,5,264,0,0,0,264,A
1-PB2,6,263,0,0,0,263,A
1-PB2,7,266,0,1,0,267,A
1-PB2,8,0,0,297,0,297,G
1-PB2,9,297,0,0,0,297,A
1-PB2,10,301,0,0,0,301,A
1-PB2,11,0,306,0,0,306,T
1-PB2,12,305,0,1,0,306,A
1-PB2,13,307,0,0,0,307,A
1-PB2,14,308,0,1,0,309,A
1-PB2,15,308,0,1,0,309,A
1-PB2,16,1,0,316,0,317,G
1-PB2,17,316,0,0,0,316,A
1-PB2,18,319,0,0,0,319,A
1-PB2,19,0,0,0,324,324,C
1-PB2,20,0,324,0,0,324,T
1-PB2,21,331,0,0,0,331,A
1-PB2,22,0,0,0,331,331,C
1-PB2,23,0,0,331,0,331,G
1-PB2,24,0,0,342,0,342,G
1-PB2,25,344,0,0,0,344,A
1-PB2,26,353,0,0,0,353,A
1-PB2,27,1,353,0,0,354,T
1-PB2,28,0,0,0,355,355,C
1-PB2,29,0,356,0,0,356,T
1-PB2,30,0,0,357,0,357,G
1-PB2,31,359,0,0,0,359,A
1-PB2,32,1,359,0,0,360,T
1-PB2,33,0,0,359,0,359,G
1-PB2,34,0,366,0,0,366,T
1-PB2,35,0,0,0,366,366,C
1-PB2,36,0,0,366,0,366,G
1-PB2,37,0,0,0,367,367,C
1-PB2,38,365,0,0,1,366,A
1-PB2,39,0,0,386,0,386,G
1-PB2,40,0,388,0,0,388,T
1-PB2,41,0,0,0,389,389,C
1-PB2,42,0,387,0,0,387,T
1-PB2,43,0,0,0,387,387,C
1-PB2,44,2,0,387,0,389,G
1-PB2,45,0,0,0,390,390,C
1-PB2,46,391,0,1,0,392,A
1-PB2,47,0,0,0,404,404,C
1-PB2,48,0,401,0,0,401,T
1-PB2,49,0,0,0,413,413,C
1-PB2,50,0,0,414,0,414,G
1-PB2,51,0,0,0,413,413,C
1-PB2,52,0,0,414,0,414,G
1-PB2,53,414,0,0,0,414,A
1-PB2,54,0,0,414,0,414,G
1-PB2,55,428,0,5,0,433,A
1-PB2,56,0,433,0,1,434,T
1-PB2,57,435,0,0,0,435,A
1-PB2,58,0,1,0,432,433,C
1-PB2,59,0,432,0,0,432,T
1-PB2,60,0,0,439,0,439,G
1-PB2,61,437,0,2,0,439,A
1-PB2,62,0,1,0,443,444,C
1-PB2,63,441,1,1,0,443,A
1-PB2,64,442,0,0,0,442,A
1-PB2,65,446,0,0,0,446,A
1-PB2,66,456,0,0,0,456,A
1-PB2,67,457,0,0,0,457,A
1-PB2,68,0,0,0,462,462,C
1-PB2,69,0,0,0,461,461,C
1-PB2,70,469,0,0,0,469,A
1-PB2,71,0,0,0,479,479,C
1-PB2,72,479,0,0,0,479,A
1-PB2,73,0,0,494,0,494,G
1-PB2,74,0,494,0,0,494,T
1-PB2,75,1,0,504,0,505,G
1-PB2,76,0,0,505,0,505,G
1-PB2,77,504,0,0,0,504,A
1-PB2,78,0,0,1,519,520,C
1-PB2,79,0,0,0,522,522,C
1-PB2,80,537,0,0,0,537,A
1-PB2,81,0,539,0,0,539,T
1-PB2,82,535,0,0,0,535,A
1-PB2,83,0,535,0,0,535,T
1-PB2,84,0,0,543,0,543,G
1-PB2,85,0,1,546,0,547,G
1-PB2,86,1,0,0,545,546,C
1-PB2,87,0,0,0,540,540,C
1-PB2,88,539,0,0,0,539,A
1-PB2,89,0,588,0,0,588,T
1-PB2,90,588,0,0,0,588,A
1-PB2,91,613,0,0,0,613,A
1-PB2,92,0,612,0,0,612,T
1-PB2,93,0,612,0,0,612,T
1-PB2,94,622,0,0,0,622,A
1-PB2,95,622,0,0,0,622,A
1-PB2,96,0,0,633,0,633,G
1-PB2,97,629,0,1,0,630,A
1-PB2,98,622,0,0,0,622,A
1-PB2,99,2,0,649,0,651,G
1-PB2,100,0,650,0,0,650,T
1-PB2,101,655,0,0,0,655,A
1-PB2,102,0,0,0,656,656,C
1-PB2,103,661,0,2,0,663,A
1-PB2,104,0,1,0,687,688,C
1-PB2,105,688,0,0,0,688,A
1-PB2,106,0,688,0,0,688,T
1-PB2,107,0,0,0,692,692,C
1-PB2,108,0,0,684,0,684,G
1-PB2,109,0,0,684,0,684,G
1-PB2,110,1,1,681,0,683,G
1-PB2,111,0,1,682,0,683,G
1-PB2,112,685,0,1,0,686,A
1-PB2,113,0,0,688,0,688,G
1-PB2,114,687,0,0,0,687,A
1-PB2,115,0,0,0,694,694,C
1-PB2,116,689,1,4,0,694,A
1-PB2,117,0,0,694,0,694,G
1-PB2,118,0,0,708,0,708,G
1-PB2,119,711,0,0,0,711,A
1-PB2,120,711,0,0,0,711,A
1-PB2,121,712,0,0,0,712,A
1-PB2,122,711,0,1,0,712,A
1-PB2,123,0,0,712,0,712,G
1-PB2,124,708,0,0,0,708,A
1-PB2,125,709,0,0,0,709,A
1-PB2,126,0,0,0,705,705,C
1-PB2,127,1,0,0,705,706,C
1-PB2,128,1,1,0,701,703,C
1-PB2,129,0,1,706,0,707,G
1-PB2,130,0,705,0,1,706,T
1-PB2,131,0,0,0,710,710,C
1-PB2,132,715,0,0,0,715,A
1-PB2,133,0,0,0,723,723,C
1-PB2,134,0,723,0,0,723,T
1-PB2,135,0,722,0,0,722,T
1-PB2,136,721,0,1,0,722,A
1-PB2,137,0,1,726,0,727,G
1-PB2,138,0,0,729,0,729,G
1-PB2,139,728,0,2,0,730,A
1-PB2,140,1,726,0,0,727,T
1-PB2,141,0,1,734,0,735,G
1-PB2,142,748,0,1,0,749,A
1-PB2,143,750,0,0,0,750,A
1-PB2,144,750,0,0,0,750,A
1-PB2,145,0,748,0,1,749,T
1-PB2,146,0,0,752,0,752,G
1-PB2,147,0,0,756,0,756,G
1-PB2,148,757,0,1,1,759,A
1-PB2,149,0,757,0,1,758,T
1-PB2,150,0,0,750,0,750,G
1-PB2,151,747,0,1,0,748,A
1-PB2,152,1,751,0,0,752,T
1-PB2,153,0,0,756,0,756,G
1-PB2,154,0,0,759,0,759,G
1-PB2,155,0,0,0,762,762,C
1-PB2,156,756,0,2,0,758,A
1-PB2,157,773,0,1,0,774,A
1-PB2,158,0,774,0,0,774,T
1-PB2,159,0,0,802,0,802,G
1-PB2,160,801,0,0,0,801,A
1-PB2,161,800,0,0,0,800,A
1-PB2,162,800,0,0,0,800,A
1-PB2,163,0,807,0,0,807,T
1-PB2,164,812,0,0,0,812,A
1-PB2,165,0,0,0,815,815,C
1-PB2,166,1,0,0,815,816,C
1-PB2,167,1,0,0,818,819,C
1-PB2,168,818,0,0,0,818,A
1-PB2,169,821,1,0,0,822,A
1-PB2,170,0,815,0,4,819,T
1-PB2,171,0,1,0,816,817,C
1-PB2,172,813,0,0,1,814,A
1-PB2,173,0,0,0,831,831,C
1-PB2,174,0,829,0,1,830,T
1-PB2,175,0,0,837,0,837,G
1-PB2,176,0,0,0,834,834,C
1-PB2,177,0,829,0,1,830,T
1-PB2,178,0,1,831,0,832,G
1-PB2,179,835,0,1,0,836,A
1-PB2,180,0,0,0,840,840,C
1-PB2,181,837,0,0,0,837,A
1-PB2,182,829,0,0,0,829,A
1-PB2,183,828,0,0,0,828,A
1-PB2,184,826,0,2,0,828,A
1-PB2,185,0,0,837,0,837,G
1-PB2,186,0,0,838,0,838,G
1-PB2,187,831,2,1,0,834,A
1-PB2,188,0,835,0,0,835,T
1-PB2,189,834,0,0,0,834,A
1-PB2,190,838,0,2,0,840,A
1-PB2,191,0,4,0,835,839,C
1-PB2,192,834,0,0,0,834,A
1-PB2,193,0,0,836,0,836,G
1-PB2,194,835,0,0,0,835,A
1-PB2,195,841,0,0,0,841,A
1-PB2,196,838,0,0,0,838,A
1-PB2,197,0,837,0,0,837,T
1-PB2,198,0,1,837,0,838,G
1-PB2,199,828,0,0,0,828,A
1-PB2,200,0,846,0,0,846,T
1-PB2,201,1,845,0,0,846,T
1-PB2,202,1,0,0,842,843,C
1-PB2,203,0,0,0,847,847,C
1-PB2,204,848,0,0,0,848,A
1-PB2,205,0,1,846,0,847,G
1-PB2,206,844,0,1,0,845,A
1-PB2,207,0,0,852,0,852,G
1-PB2,208,841,0,2,0,843,A
1-PB2,209,0,0,855,0,855,G
1-PB2,210,853,0,0,0,853,A
1-PB2,211,856,1,0,0,857,A
1-PB2,212,854,1,2,0,857,A
1-PB2,213,0,859,0,0,859,T
1-PB2,214,0,1,870,0,871,G
1-PB2,215,871,0,1,0,872,A
1-PB2,216,867,1,3,0,871,A
1-PB2,217,0,0,0,872,872,C
1-PB2,218,858,0,1,0,859,A
1-PB2,219,877,1,0,0,878,A
1-PB2,220,0,0,890,0,890,G
1-PB2,221,1,0,898,0,899,G
1-PB2,222,897,2,0,0,899,A
1-PB2,223,0,0,0,892,892,C
1-PB2,224,889,0,0,0,889,A
1-PB2,225,891,0,0,0,891,A
1-PB2,226,926,1,0,0,927,A
1-PB2,227,0,1,0,938,939,C
1-PB2,228,1,924,0,0,925,T
1-PB2,229,0,0,0,943,943,C
1-PB2,230,0,926,0,0,926,T
1-PB2,231,936,0,0,0,936,A
1-PB2,232,0,933,0,0,933,T
1-PB2,233,0,0,941,0,941,G
1-PB2,234,0,0,957,0,957,G
1-PB2,235,921,2,1,0,924,A
1-PB2,236,0,0,929,0,929,G
1-PB2,237,1,929,0,1,931,T
1-PB2,238,923,0,1,0,924,A
1-PB2,239,927,0,0,0,927,A
1-PB2,240,923,0,0,0,923,A
1-PB2,241,920,2,0,0,922,A
1-PB2,242,0,920,0,0,920,T
1-PB2,243,0,1,917,0,918,G
1-PB2,244,906,0,0,0,906,A
1-PB2,245,0,0,910,0,910,G
1-PB2,246,0,897,0,0,897,T
1-PB2,247,1,0,897,0,898,G
1-PB2,248,919,0,0,0,919,A
1-PB2,249,1,923,0,0,924,T
1-PB2,250,0,0,925,0,925,G
1-PB2,251,0,0,0,923,923,C
1-PB2,252,0,920,0,1,921,T
1-PB2,253,1,0,954,0,955,G
1-PB2,254,0,1,956,0,957,G
1-PB2,255,976,0,0,0,976,A
1-PB2,256,0,974,0,0,974,T
1-PB2,257,0,0,0,966,966,C
1-PB2,258,972,0,0,0,972,A
1-PB2,259,0,0,1001,0,1001,G
1-PB2,260,1001,0,1,0,1002,A
1-PB2,261,0,999,0,1,1000,T
1-PB2,262,969,0,0,0,969,A
1-PB2,263,1,0,988,0,989,G
1-PB2,264,985,1,1,0,987,A
1-PB2,265,0,0,1005,0,1005,G
1-PB2,266,0,990,0,0,990,T
1-PB2,267,0,0,987,0,987,G
1-PB2,268,982,0,0,0,982,A
1-PB2,269,0,983,0,0,983,T
1-PB2,270,0,0,1006,0,1006,G
1-PB2,271,0,0,1026,0,1026,G
1-PB2,272,1,1019,0,0,1020,T
1-PB2,273,1018,0,0,0,1018,A
1-PB2,274,0,1006,0,0,1006,T
1-PB2,275,1,0,1,1006,1008,C
1-PB2,276,1020,0,0,0,1020,A
1-PB2,277,0,0,0,1031,1031,C
1-PB2,278,0,0,0,1023,1023,C
1-PB2,279,1,1003,0,2,1006,T
1-PB2,280,0,1003,0,1,1004,T
1-PB2,281,0,1003,0,0,1003,T
1-PB2,282,1,0,1011,0,1012,G
1-PB2,283,0,0,1017,0,1017,G
1-PB2,284,0,0,0,1024,1024,C
1-PB2,285,0,1004,0,2,1006,T
1-PB2,286,0,0,1012,0,1012,G
1-PB2,287,0,1015,0,0,1015,T
1-PB2,288,1015,0,0,0,1015,A
1-PB2,289,1015,0,1,0,1016,A
1-PB2,290,1,0,0,1016,1017,C
1-PB2,291,994,0,1,0,995,A
1-PB2,292,0,991,0,0,991,T
1-PB2,293,0,0,984,0,984,G
1-PB2,294,1,0,1000,0,1001,G
1-PB2,295,0,993,0,0,993,T
1-PB2,296,0,1,991,0,992,G
1-PB2,297,1,0,1009,0,1010,G
1-PB2,298,1012,0,0,0,1012,A
1-PB2,299,1016,0,0,0,1016,A
1-PB2,300,0,1016,0,0,1016,T
1-PB2,301,1011,0,1,0,1012,A
1-PB2,302,0,0,1025,0,1025,G
1-PB2,303,1013,0,0,0,1013,A
1-PB2,304,1013,1,0,0,1014,A
1-PB2,305,1009,0,0,0,1009,A
1-PB2,306,1,989,0,1,991,T
1-PB2,307,0,0,991,0,991,G
1-PB2,308,0,0,993,0,993,G
1-PB2,309,992,0,1,0,993,A
1-PB2,310,0,0,0,992,992,C
1-PB2,311,1,0,0,984,985,C
1-PB2,312,1,0,0,982,983,C
1-PB2,313,0,0,985,0,985,G
1-PB2,314,0,995,0,0,995,T
1-PB2,315,0,1,1013,0,1014,G
1-PB2,316,1015,0,0,0,1015,A
1-PB2,317,0,0,0,1021,1021,C
1-PB2,318,1029,0,1,0,1030,A
1-PB2,319,1028,0,0,0,1028,A
1-PB2,320,0,0,1060,0,1060,G
1-PB2,321,0,1054,0,1,1055,T
1-PB2,322,1054,0,0,0,1054,A
1-PB2,323,0,0,0,1048,1048,C
1-PB2,324,0,1,1027,0,1028,G
1-PB2,325,0,0,1056,0,1056,G
1-PB2,326,0,1052,0,0,1052,T
1-PB2,327,0,0,0,1061,1061,C
1-PB2,328,0,0,0,1061,1061,C
1-PB2,329,1051,0,1,0,1052,A
1-PB2,330,0,1054,0,1,1055,T
1-PB2,331,0,1056,0,0,1056,T
1-PB2,332,1125,0,0,0,1125,A
1-PB2,333,0,0,0,1125,1125,C
1-PB2,334,0,0,0,1099,1099,C
1-PB2,335,1,1,0,1098,1100,C
1-PB2,336,1090,0,0,0,1090,A
1-PB2,337,1104,0,0,0,1104,A
1-PB2,338,1101,0,0,0,1101,A
1-PB2,339,1100,0,0,0,1100,A
1-PB2,340,0,0,1114,0,1114,G
1-PB2,341,0,1078,0,0,1078,T
1-PB2,342,0,0,1098,0,1098,G
1-PB2,343,1,1098,0,0,1099,T
1-PB2,344,1098,0,1,0,1099,A
1-PB2,345,0,0,0,1100,1100,C
1-PB2,346,1092,0,0,0,1092,A
1-PB2,347,1093,0,0,0,1093,A
1-PB2,348,0,1,1094,0,1095,G
1-PB2,349,1087,0,1,0,1088,A
1-PB2,350,0,0,0,1090,1090,C
1-PB2,351,0,1070,0,1,1071,T
1-PB2,352,0,1072,0,1,1073,T
1-PB2,353,1071,0,1,0,1072,A
1-PB2,354,0,1074,0,0,1074,T
1-PB2,355,0,1073,0,0,1073,T
1-PB2,356,0,1068,0,0,1068,T
1-PB2,357,0,0,0,1062,1062,C
1-PB2,358,0,0,1060,1,1061,G
1-PB2,359,1059,0,0,0,1059,A
1-PB2,360,0,1,0,1060,1061,C
1-PB2,361,1059,0,0,0,1059,A
1-PB2,362,1055,0,0,0,1055,A
1-PB2,363,1056,0,0,0,1056,A
1-PB2,364,0,0,1064,0,1064,G
1-PB2,365,1,1061,0,0,1062,T
1-PB2,366,0,0,0,1064,1064,C
1-PB2,367,0,0,1065,0,1065,G
1-PB2,368,1063,0,0,0,1063,A
1-PB2,369,1061,0,3,0,1064,A
1-PB2,370,1063,0,1,0,1064,A
1-PB2,371,0,1,1094,0,1095,G
1-PB2,372,1,0,1098,0,1099,G
1-PB2,373,0,1088,0,1,1089,T
1-PB2,374,0,1088,0,0,1088,T
1-PB2,375,1087,0,1,0,1088,A
1-PB2,376,1088,0,0,0,1088,A
1-PB2,377,1087,0,1,0,1088,A
1-PB2,378,1096,0,1,0,1097,A
1-PB2,379,0,0,0,1101,1101,C
1-PB2,380,1083,0,0,0,1083,A
1-PB2,381,0,1078,0,0,1078,T
1-PB2,382,0,0,1074,0,1074,G
1-PB2,383,2,0,1071,1,1074,G
1-PB2,384,1072,2,0,0,1074,A
1-PB2,385,1085,0,1,0,1086,A
1-PB2,386,0,0,1,1104,1105,C
1-PB2,387,1,0,0,1109,1110,C
1-PB2,388,1,1104,0,1,1106,T
1-PB2,389,0,1104,0,0,1104,T
1-PB2,390,0,1107,0,0,1107,T
1-PB2,391,0,1,1100,0,1101,G
1-PB2,392,0,0,1108,0,1108,G
1-PB2,393,0,3,0,1102,1105,C
1-PB2,394,0,0,0,1097,1097,C
1-PB2,395,2,1,0,1094,1097,C
1-PB2,396,0,1063,0,0,1063,T
1-PB2,397,1,1,1074,0,1076,G
1-PB2,398,0,1077,0,0,1077,T
1-PB2,399,0,1072,0,1,1073,T
1-PB2,400,0,0,0,1074,1074,C
1-PB2,401,1065,0,0,0,1065,A
1-PB2,402,0,1065,0,0,1065,T
1-PB2,403,0,1066,0,0,1066,T
1-PB2,404,0,1076,1,0,1077,T
1-PB2,405,0,1076,0,0,1076,T
1-PB2,406,1071,0,0,0,1071,A
1-PB2,407,0,0,1066,0,1066,G
1-PB2,408,1068,0,0,0,1068,A
1-PB2,409,1068,0,0,0,1068,A
1-PB2,410,1066,0,0,0,1066,A
1-PB2,411,0,1061,0,2,1063,T
1-PB2,412,0,0,0,1067,1067,C
1-PB2,413,1063,0,0,0,1063,A
1-PB2,414,1067,0,4,0,1071,A
1-PB2,415,0,0,1075,0,1075,G
1-PB2,416,0,1076,0,0,1076,T
1-PB2,417,1,0,0,1074,1075,C
1-PB2,418,1085,0,0,0,1085,A
1-PB2,419,1086,1,0,0,1087,A
1-PB2,420,0,0,1086,0,1086,G
1-PB2,421,1086,0,0,0,1086,A
1-PB2,422,0,1084,0,0,1084,T
1-PB2,423,1103,0,0,0,1103,A
1-PB2,424,0,1,0,1097,1098,C
1-PB2,425,0,0,1105,0,1105,G
1-PB2,426,0,0,0,1114,1114,C
1-PB2,427,1106,0,1,0,1107,A
1-PB2,428,0,0,1121,1,1122,G
1-PB2,429,1118,0,0,0,1118,A
1-PB2,430,1118,0,0,0,1118,A
1-PB2,431,0,0,1138,0,1138,G
1-PB2,432,1115,0,0,0,1115,A
1-PB2,433,0,0,1119,0,1119,G
1-PB2,434,0,1119,0,0,1119,T
1-PB2,435,1107,0,0,0,1107,A
1-PB2,436,0,0,1123,0,1123,G
1-PB2,437,1114,0,1,1,1116,A
1-PB2,438,1,0,0,1152,1153,C
1-PB2,439,1148,0,0,0,1148,A
1-PB2,440,0,1124,0,1,1125,T
1-PB2,441,1124,0,0,0,1124,A
1-PB2,442,1133,0,0,0,1133,A
1-PB2,443,1145,0,0,1,1146,A
1-PB2,444,0,0,0,1146,1146,C
1-PB2,445,0,0,0,1134,1134,C
1-PB2,446,1,1,0,1130,1132,C
1-PB2,447,1,1084,0,1,1086,T
1-PB2,448,0,1,1091,0,1092,G
1-PB2,449,0,0,1110,0,1110,G
1-PB2,450,0,1113,0,1,1114,T
1-PB2,451,0,3,0,1106,1109,C
1-PB2,452,1116,0,0,0,1116,A
1-PB2,453,0,1108,0,1,1109,T
1-PB2,454,0,0,1118,0,1118,G
1-PB2,455,0,1,0,1117,1118,C
1-PB2,456,1121,0,0,0,1121,A
1-PB2,457,0,1,1130,0,1131,G
1-PB2,458,1117,0,0,0,1117,A
1-PB2,459,0,1,0,1121,1122,C
1-PB2,460,1,0,0,1124,1125,C
1-PB2,461,0,1107,1,1,1109,T
1-PB2,462,1,0,0,1108,1109,C
1-PB2,463,1102,0,1,0,1103,A
1-PB2,464,0,0,1126,0,1126,G
1-PB2,465,0,1127,0,0,1127,T
1-PB2,466,2,0,1125,0,1127,G
1-PB2,467,0,1,0,1126,1127,C
1-PB2,468,0,0,1,1112,1113,C
1-PB2,469,1112,1,0,0,1113,A
1-PB2,470,1116,0,0,0,1116,A
1-PB2,471,1113,0,0,0,1113,A
1-PB2,472,0,0,1115,0,1115,G
1-PB2,473,1069,0,1,0,1070,A
1-PB2,474,0,0,1074,0,1074,G
1-PB2,475,0,0,1076,0,1076,G
1-PB2,476,1,0,1,1070,1072,C
1-PB2,477,1076,0,1,0,1077,A
1-PB2,478,0,1,0,1073,1074,C
1-PB2,479,1075,0,0,0,1075,A
1-PB2,480,1093,0,2,0,1095,A
1-PB2,481,0,0,1101,0,1101,G
1-PB2,482,1122,0,1,0,1123,A
1-PB2,483,1,1114,0,0,1115,T
1-PB2,484,0,0,1118,0,1118,G
1-PB2,485,0,1123,0,1,1124,T
1-PB2,486,1124,0,0,0,1124,A
1-PB2,487,1125,0,0,0,1125,A
1-PB2,488,0,1127,0,0,1127,T
1-PB2,489,0,1087,0,1,1088,T
1-PB2,490,1082,0,0,0,1082,A
1-PB2,491,1,1062,0,0,1063,T
1-PB2,492,0,0,1059,0,1059,G
1-PB2,493,0,0,1058,1,1059,G
1-PB2,494,1054,2,0,0,1056,A
1-PB2,495,1053,1,1,1,1056,A
1-PB2,496,0,0,1056,0,1056,G
1-PB2,497,0,1059,0,0,1059,T
1-PB2,498,0,1063,0,0,1063,T
1-PB2,499,0,0,1068,0,1068,G
1-PB2,500,0,1065,0,1,1066,T
1-PB2,501,0,1059,1,0,1060,T
1-PB2,502,0,1062,0,0,1062,T
1-PB2,503,0,1060,0,0,1060,T
1-PB2,504,0,1,0,1056,1057,C
1-PB2,505,0,0,1,1074,1075,C
1-PB2,506,1,0,0,1088,1089,C
1-PB2,507,0,1,0,1088,1089,C
1-PB2,508,1088,0,0,0,1088,A
1-PB2,509,1092,1,0,0,1093,A
1-PB2,510,1,1091,0,1,1093,T
1-PB2,511,2,0,1098,0,1100,G
1-PB2,512,1099,0,0,0,1099,A
1-PB2,513,1083,0,0,0,1083,A
1-PB2,514,1,0,1089,0,1090,G
1-PB2,515,0,1076,0,1,1077,T
1-PB2,516,0,1,1076,0,1077,G
1-PB2,517,0,1,1073,0,1074,G
1-PB2,518,3,0,1068,0,1071,G
1-PB2,519,1074,0,4,0,1078,A
1-PB2,520,0,0,1076,0,1076,G
1-PB2,521,0,0,0,1077,1077,C
1-PB2,522,1,0,0,1085,1086,C
1-PB2,523,1084,0,0,0,1084,A
1-PB2,524,0,0,1113,0,1113,G
1-PB2,525,0,0,1122,0,1122,G
1-PB2,526,1124,0,0,0,1124,A
1-PB2,527,0,1122,0,1,1123,T
1-PB2,528,1124,0,1,0,1125,A
1-PB2,529,1,0,0,1119,1120,C
1-PB2,530,0,1116,0,1,1117,T
1-PB2,531,1119,0,0,0,1119,A
1-PB2,532,1114,0,0,0,1114,A
1-PB2,533,0,1,0,1118,1119,C
1-PB2,534,1103,0,0,0,1103,A
1-PB2,535,0,1085,0,0,1085,T
1-PB2,536,0,1,0,1087,1088,C
1-PB2,537,1075,1,0,0,1076,A
1-PB2,538,0,0,1084,0,1084,G
1-PB2,539,1082,0,0,0,1082,A
1-PB2,540,1082,0,1,0,1083,A
1-PB2,541,0,1076,0,4,1080,T
1-PB2,542,0,0,0,1057,1057,C
1-PB2,543,1060,0,0,0,1060,A
1-PB2,544,0,0,0,1066,1066,C
1-PB2,545,1069,0,0,0,1069,A
1-PB2,546,1076,2,0,0,1078,A
1-PB2,547,0,1062,0,0,1062,T
1-PB2,548,0,1064,0,0,1064,T
1-PB2,549,1069,0,1,0,1070,A
1-PB2,550,1081,0,0,0,1081,A
1-PB2,551,0,0,0,1080,1080,C
1-PB2,552,1073,0,0,0,1073,A
1-PB2,553,1062,0,1,0,1063,A
1-PB2,554,1,1063,0,0,1064,T
1-PB2,555,1058,1,1,0,1060,A
1-PB2,556,1061,0,0,0,1061,A
1-PB2,557,0,0,0,1061,1061,C
1-PB2,558,0,1058,0,1,1059,T
1-PB2,559,1057,0,0,0,1057,A
1-PB2,560,1055,0,0,0,1055,A
1-PB2,561,1053,0,3,0,1056,A
1-PB2,562,1,0,1055,0,1056,G
1-PB2,563,1039,0,1,0,1040,A
1-PB2,564,0,0,1050,0,1050,G
1-PB2,565,1040,0,0,0,1040,A
1-PB2,566,1042,1,0,0,1043,A
1-PB2,567,1043,0,1,0,1044,A
1-PB2,568,1044,0,1,0,1045,A
1-PB2,569,1046,0,1,0,1047,A
1-PB2,570,1048,0,1,0,1049,A
1-PB2,571,2,0,1052,0,1054,G
1-PB2,572,1052,0,0,0,1052,A
1-PB2,573,1044,0,0,0,1044,A
1-PB2,574,0,0,1048,1,1049,G
1-PB2,575,1048,0,1,0,1049,A
1-PB2,576,1054,1,0,0,1055,A
1-PB2,577,0,0,0,1062,1062,C
1-PB2,578,0,1047,1,0,1048,T
1-PB2,579,0,0,0,1052,1052,C
1-PB2,580,1,2,0,1050,1053,C
1-PB2,581,0,0,1057,0,1057,G
1-PB2,582,1054,0,0,0,1054,A
1-PB2,583,0,0,1055,0,1055,G
1-PB2,584,1043,0,0,0,1043,A
1-PB2,585,0,1043,0,1,1044,T
1-PB2,586,0,1035,0,0,1035,T
1-PB2,587,0,0,1036,0,1036,G
1-PB2,588,0,1,0,1038,1039,C
1-PB2,589,1037,1,0,0,1038,A
1-PB2,590,1039,0,0,0,1039,A
1-PB2,591,1037,1,0,0,1038,A
1-PB2,592,1040,0,0,0,1040,A
1-PB2,593,0,1038,0,0,1038,T
1-PB2,594,0,1032,0,0,1032,T
1-PB2,595,0,1032,0,0,1032,T
1-PB2,596,2,2,0,1026,1030,C
1-PB2,597,0,1016,0,3,1019,T
1-PB2,598,0,0,0,1164,1164,C
1-PB2,599,1,0,0,1165,1166,C
1-PB2,600,1,0,0,1382,1383,C
1-PB2,601,0,1359,0,2,1361,T
1-PB2,602,0,1394,0,0,1394,T
1-PB2,603,0,0,1407,1,1408,G
1-PB2,604,1416,0,1,0,1417,A
1-PB2,605,0,1472,0,0,1472,T
1-PB2,606,1,0,1531,0,1532,G
1-PB2,607,0,0,1829,0,1829,G
1-PB2,608,0,1898,0,1,1899,T
1-PB2,609,1,1904,0,2,1907,T
1-PB2,610,1,0,2155,0,2156,G
1-PB2,611,1,0,0,2180,2181,C
1-PB2,612,2276,1,1,0,2278,A
1-PB2,613,0,2280,0,2,2282,T
1-PB2,614,2319,1,0,3,2323,A
1-PB2,615,0,0,0,2483,2483,C
1-PB2,616,2953,0,0,5,2958,A
1-PB2,617,0,3048,0,1,3049,T
1-PB2,618,0,0,3260,1,3261,G
1-PB2,619,0,3252,0,0,3252,T
1-PB2,620,0,3257,1,0,3258,T
1-PB2,621,3255,1,2,0,3258,A
1-PB2,622,0,2,3267,0,3269,G
1-PB2,623,3321,1,3,0,3325,A
1-PB2,624,0,2,3377,0,3379,G
1-PB2,625,3315,1,1,0,3317,A
1-PB2,626,1,0,3328,0,3329,G
1-PB2,627,3306,1,4,0,3311,A
1-PB2,628,0,0,3338,0,3338,G
1-PB2,629,3350,1,5,1,3357,A
1-PB2,630,3367,0,0,0,3367,A
1-PB2,631,0,2,0,3392,3394,C
1-PB2,632,0,3380,0,3,3383,T
1-PB2,633,0,3385,0,2,3387,T
1-PB2,634,1,0,3388,0,3389,G
1-PB2,635,0,3380,0,2,3382,T
1-PB2,636,3391,1,2,0,3394,A
1-PB2,637,0,1,0,3385,3386,C
1-PB2,638,1,4,3381,0,3386,G
1-PB2,639,3381,1,1,1,3384,A
1-PB2,640,3384,0,0,0,3384,A
1-PB2,641,3427,0,0,0,3427,A
1-PB2,642,3430,0,0,0,3430,A
1-PB2,643,3428,0,1,0,3429,A
1-PB2,644,0,1,0,3440,3441,C
1-PB2,645,3444,0,0,0,3444,A
1-PB2,646,3454,0,0,0,3454,A
1-PB2,647,1,0,3477,0,3478,G
1-PB2,648,3496,0,1,0,3497,A
1-PB2,649,0,3497,0,3,3500,T
1-PB2,650,0,3496,0,0,3496,T
1-PB2,651,0,3515,1,0,3516,T
1-PB2,652,1,2,0,3519,3522,C
1-PB2,653,0,3528,0,7,3535,T
1-PB2,654,2,2,0,3542,3546,C
1-PB2,655,2,1,0,3529,3532,C
1-PB2,656,3,2,0,3538,3543,C
1-PB2,657,3545,0,2,0,3547,A
1-PB2,658,0,0,3592,0,3592,G
1-PB2,659,0,3596,0,1,3597,T
1-PB2,660,0,3593,0,0,3593,T
1-PB2,661,0,1,3590,0,3591,G
1-PB2,662,0,1,0,3585,3586,C
1-PB2,663,0,3588,0,0,3588,T
1-PB2,664,0,0,3591,1,3592,G
1-PB2,665,0,0,3582,1,3583,G
1-PB2,666,0,4,0,3584,3588,C
1-PB2,667,1,0,3603,0,3604,G
1-PB2,668,1,2,3633,0,3636,G
1-PB2,669,3662,2,3,0,3667,A
1-PB2,670,3664,0,4,0,3668,A
1-PB2,671,0,0,0,3675,3675,C
1-PB2,672,3699,0,1,0,3700,A
1-PB2,673,3699,0,5,0,3704,A
1-PB2,674,0,0,3916,0,3916,G
1-PB2,675,0,1,0,3986,3987,C
1-PB2,676,4001,1,0,0,4002,A
1-PB2,677,0,0,5162,0,5162,G
1-PB2,678,0,5157,1,2,5160,T
1-PB2,679,5197,0,3,0,5200,A
1-PB2,680,1,5199,0,1,5201,T
1-PB2,681,5226,1,1,0,5228,A
1-PB2,682,1,5226,0,1,5228,T
1-PB2,683,5189,1,1,0,5191,A
1-PB2,684,0,1,0,5254,5255,C
1-PB2,685,5106,0,1,0,5107,A
1-PB2,686,2,4952,0,1,4955,T
1-PB2,687,0,4863,0,3,4866,T
1-PB2,688,0,0,4864,0,4864,G
1-PB2,689,4847,0,0,0,4847,A
1-PB2,690,4849,0,2,0,4851,A
1-PB2,691,1,0,4918,0,4919,G
1-PB2,692,0,4897,0,2,4899,T
1-PB2,693,0,4873,0,0,4873,T
1-PB2,694,2,4869,0,1,4872,T
1-PB2,695,0,4882,0,2,4884,T
1-PB2,696,4925,1,3,2,4931,A
1-PB2,697,0,0,0,4960,4960,C
1-PB2,698,4967,0,0,0,4967,A
1-PB2,699,3,4958,0,1,4962,T
1-PB2,700,1,4939,0,2,4942,T
1-PB2,701,1,4945,0,3,4949,T
1-PB2,702,1,3,5013,1,5018,G
1-PB2,703,5039,1,3,1,5044,A
1-PB2,704,0,2,0,5065,5067,C
1-PB2,705,0,5061,0,3,5064,T
1-PB2,706,1,1,0,5050,5052,C
1-PB2,707,5048,1,3,0,5052,A
1-PB2,708,1,7,5029,0,5037,G
1-PB2,709,4,2,5135,0,5141,G
1-PB2,710,2,1,5147,0,5150,G
1-PB2,711,5148,2,4,0,5154,A
1-PB2,712,5164,0,4,2,5170,A
1-PB2,713,1,2,0,5175,5178,C
1-PB2,714,0,1,5217,1,5219,G
1-PB2,715,0,5235,0,1,5236,T
1-PB2,716,1,2,5255,0,5258,G
1-PB2,717,0,5225,0,1,5226,T
1-PB2,718,1,5235,1,0,5237,T
1-PB2,719,1,6,5251,0,5258,G
1-PB2,720,0,4,5251,1,5256,G
1-PB2,721,0,3,5290,0,5293,G
1-PB2,722,5277,0,3,0,5280,A
1-PB2,723,5258,1,4,0,5263,A
1-PB2,724,0,0,0,5415,5415,C
1-PB2,725,5396,0,2,0,5398,A
1-PB2,726,5591,2,0,0,5593,A
1-PB2,727,5607,0,3,0,5610,A
1-PB2,728,0,5650,0,0,5650,T
1-PB2,729,1,0,5730,0,5731,G
1-PB2,730,0,5712,1,2,5715,T
1-PB2,731,5705,1,4,0,5710,A
1-PB2,732,2,0,0,5729,5731,C
1-PB2,733,5665,0,0,0,5665,A
1-PB2,734,2,2,0,5654,5658,C
1-PB2,735,1,5563,0,8,5572,T
1-PB2,736,3,0,0,6109,6112,C
1-PB2,737,4,1,0,6109,6114,C
1-PB2,738,6188,1,6,1,6196,A
1-PB2,739,1,1,6238,0,6240,G
1-PB2,740,2,0,6366,0,6368,G
1-PB2,741,1,6353,0,6,6360,T
1-PB2,742,0,4,6359,1,6364,G
1-PB2,743,2,1,6231,0,6234,G
1-PB2,744,6201,1,8,0,6210,A
1-PB2,745,1,4,6254,1,6260,G
1-PB2,746,2,3,6263,0,6268,G
1-PB2,747,6212,2,8,0,6222,A
1-PB2,748,3,1,6271,0,6275,G
1-PB2,749,0,6193,1,3,6197,T
1-PB2,750,3,4,6227,0,6234,G
1-PB2,751,6224,1,5,0,6230,A
1-PB2,752,0,3,6255,0,6258,G
1-PB2,753,4,1,6277,1,6283,G
1-PB2,754,6250,0,2,0,6252,A
1-PB2,755,6255,0,3,0,6258,A
1-PB2,756,0,6266,0,1,6267,T
1-PB2,757,0,0,6263,0,6263,G
1-PB2,758,6258,0,9,0,6267,A
1-PB2,759,0,2,0,6238,6240,C
1-PB2,760,2,0,6247,0,6249,G
1-PB2,761,6313,0,1,0,6314,A
1-PB2,762,0,6287,0,0,6287,T
1-PB2,763,2,0,6323,0,6325,G
1-PB2,764,0,6315,1,2,6318,T
1-PB2,765,0,6288,0,2,6290,T
1-PB2,766,2,1,6333,0,6336,G
1-PB2,767,6337,1,4,0,6342,A
1-PB2,768,1,4,0,6337,6342,C
1-PB2,769,4,2,0,6333,6339,C
1-PB2,770,6296,0,0,0,6296,A
1-PB2,771,6305,0,2,1,6308,A
1-PB2,772,6313,0,11,1,6325,A
1-PB2,773,1,1,6477,0,6479,G
1-PB2,774,1,0,1,6482,6484,C
1-PB2,775,5,0,1,6466,6472,C
1-PB2,776,1,6524,0,2,6527,T
1-PB2,777,6547,0,1,2,6550,A
1-PB2,778,6546,2,3,0,6551,A
1-PB2,779,0,6558,1,2,6561,T
1-PB2,780,1,6548,0,2,6551,T
1-PB2,781,6503,0,2,0,6505,A
1-PB2,782,2,6392,1,1,6396,T
1-PB2,783,2,6365,0,0,6367,T
1-PB2,784,1,2,6344,0,6347,G
1-PB2,785,0,3,0,6336,6339,C
1-PB2,786,2,1,6342,0,6345,G
1-PB2,787,3,0,6462,0,6465,G
1-PB2,788,0,2,0,6453,6455,C
1-PB2,789,1,2,0,6489,6492,C
1-PB2,790,6494,0,1,0,6495,A
1-PB2,791,1,0,6579,0,6580,G
1-PB2,792,1,2,6630,1,6634,G
1-PB2,793,6641,1,7,1,6650,A
1-PB2,794,6666,1,7,0,6674,A
1-PB2,795,0,0,0,6701,6701,C
1-PB2,796,6650,1,4,0,6655,A
1-PB2,797,0,6755,1,0,6756,T
1-PB2,798,6879,0,7,0,6886,A
1-PB2,799,3,1,6960,0,6964,G
1-PB2,800,0,6908,0,2,6910,T
1-PB2,801,6892,0,1,0,6893,A
1-PB2,802,6862,2,2,0,6866,A
1-PB2,803,1,0,6892,0,6893,G
1-PB2,804,6854,0,2,0,6856,A
1-PB2,805,6763,2,3,0,6768,A
1-PB2,806,4,1,6761,0,6766,G
1-PB2,807,6639,2,7,0,6648,A
1-PB2,808,0,0,6639,0,6639,G
1-PB2,809,2,2,0,6646,6650,C
1-PB2,810,2,1,0,6619,6622,C
1-PB2,811,2,1,6645,0,6648,G
1-PB2,812,0,2,0,6691,6693,C
1-PB2,813,6709,2,4,0,6715,A
1-PB2,814,0,0,7153,0,7153,G
1-PB2,815,0,7141,0,5,7146,T
1-PB2,816,7161,0,0,0,7161,A
1-PB2,817,1,7122,1,4,7128,T
1-PB2,818,1,1,0,7163,7165,C
1-PB2,819,7158,0,8,0,7166,A
1-PB2,820,2,0,7179,0,7181,G
1-PB2,821,0,0,0,7182,7182,C
1-PB2,822,6959,1,5,0,6965,A
1-PB2,823,0,3,6914,0,6917,G
1-PB2,824,6954,0,3,0,6957,A
1-PB2,825,4,6937,3,2,6946,T
1-PB2,826,1,0,0,6978,6979,C
1-PB2,827,2,2,0,6995,6999,C
1-PB2,828,7025,3,3,0,7031,A
1-PB2,829,0,2,0,7043,7045,C
1-PB2,830,0,7035,2,0,7037,T
1-PB2,831,7054,2,4,0,7060,A
1-PB2,832,1,0,7046,0,7047,G
1-PB2,833,0,249,0,6762,7011,C
1-PB2,834,7020,1,0,1,7022,A
1-PB2,835,0,7032,1,2,7035,T
1-PB2,836,3,1,0,7135,7139,C
1-PB2,837,0,7118,1,3,7122,T
1-PB2,838,1,7292,1,0,7294,T
1-PB2,839,0,7318,1,1,7320,T
1-PB2,840,7324,1,2,0,7327,A
1-PB2,841,1,7333,1,0,7335,T
1-PB2,842,1,7305,0,2,7308,T
1-PB2,843,5,5,7279,1,7290,G
1-PB2,844,0,1,7296,0,7297,G
1-PB2,845,7238,1,6,0,7245,A
1-PB2,846,3,3,7256,0,7262,G
1-PB2,847,7226,1,3,0,7230,A
1-PB2,848,1,7198,1,4,7204,T
1-PB2,849,3,1,7329,0,7333,G
1-PB2,850,2,7334,0,5,7341,T
1-PB2,851,2,4,7322,0,7328,G
1-PB2,852,2,3,1,7319,7325,C
1-PB2,853,0,4,1,7305,7310,C
1-PB2,854,7293,0,5,0,7298,A
1-PB2,855,2,1,1,7295,7299,C
1-PB2,856,7224,0,5,0,7229,A
1-PB2,857,3,1,7318,0,7322,G
1-PB2,858,0,5,0,7186,7191,C
1-PB2,859,7191,0,5,0,7196,A
1-PB2,860,1,2,0,7202,7205,C
1-PB2,861,7184,1,4,0,7189,A
1-PB2,862,0,1,0,7238,7239,C
1-PB2,863,7218,1,1,0,7220,A
1-PB2,864,7220,1,1,0,7222,A
1-PB2,865,7219,0,2,0,7221,A
1-PB2,866,1,7071,1,1,7074,T
1-PB2,867,1,7071,0,1,7073,T
1-PB2,868,1,0,7071,1,7073,G
1-PB2,869,1,2,7060,0,7063,G
1-PB2,870,0,3,0,7060,7063,C
1-PB2,871,2,8,7012,0,7022,G
1-PB2,872,1,5,7115,1,7122,G
1-PB2,873,1,3,7148,1,7153,G
1-PB2,874,7151,2,6,0,7159,A
1-PB2,875,0,2,0,7168,7170,C
1-PB2,876,7158,2,7,1,7168,A
1-PB2,877,7184,1,4,0,7189,A
1-PB2,878,0,4,7232,1,7237,G
1-PB2,879,2,4,7253,1,7260,G
1-PB2,880,7272,4,4,0,7280,A
1-PB2,881,1,7063,0,1,7065,T
1-PB2,882,1,5,6998,0,7004,G
1-PB2,883,2,0,7040,0,7042,G
1-PB2,884,0,7004,0,8,7012,T
1-PB2,885,2,1,7012,0,7015,G
1-PB2,886,0,6,7002,0,7008,G
1-PB2,887,6946,0,6,0,6952,A
1-PB2,888,0,1,0,6952,6953,C
1-PB2,889,6877,0,4,0,6881,A
1-PB2,890,0,7807,0,0,7807,T
1-PB2,891,1,7784,0,0,7785,T
1-PB2,892,1,1,0,7804,7806,C
1-PB2,893,0,7770,1,1,7772,T
1-PB2,894,0,7771,0,1,7772,T
1-PB2,895,7772,1,6,0,7779,A
1-PB2,896,2,3,7815,0,7820,G
1-PB2,897,7807,0,2,0,7809,A
1-PB2,898,0,3,1,7805,7809,C
1-PB2,899,6837,2,4,0,6843,A
1-PB2,900,0,2,6887,0,6889,G
1-PB2,901,6848,2,10,1,6861,A
1-PB2,902,6878,0,4,0,6882,A
1-PB2,903,1,1,0,6860,6862,C
1-PB2,904,3,1,0,6846,6850,C
1-PB2,905,5,0,1,6841,6847,C
1-PB2,906,1,0,6873,0,6874,G
1-PB2,907,6873,0,5,0,6878,A
1-PB2,908,1,3,1,6880,6885,C
1-PB2,909,2,6801,3,1,6807,T
1-PB2,910,0,2,6850,0,6852,G
1-PB2,911,6829,0,6,2,6837,A
1-PB2,912,6860,0,10,1,6871,A
1-PB2,913,1,2,6890,0,6893,G
1-PB2,914,6866,6,6,1,6879,A
1-PB2,915,6889,0,4,0,6893,A
1-PB2,916,1,2,0,6875,6878,C
1-PB2,917,6855,0,2,0,6857,A
1-PB2,918,6881,0,6,2,6889,A
1-PB2,919,0,1,6950,0,6951,G
1-PB2,920,0,0,0,6999,6999,C
1-PB2,921,0,6935,3,8,6946,T
1-PB2,922,4,2,7047,1,7054,G
1-PB2,923,2,7021,2,2,7027,T
1-PB2,924,1,3,7140,1,7145,G
1-PB2,925,1,0,7344,0,7345,G
1-PB2,926,7343,2,2,4,7351,A
1-PB2,927,4,7337,0,0,7341,T
1-PB2,928,7294,0,3,0,7297,A
1-PB2,929,2,7215,1,0,7218,T
1-PB2,930,7398,1,2,1,7402,A
1-PB2,931,2,7287,1,3,7293,T
1-PB2,932,3,2,7287,0,7292,G
1-PB2,933,2,1,0,7199,7202,C
1-PB2,934,6958,2,2,2,6964,A
1-PB2,935,6965,0,1,0,6966,A
1-PB2,936,1,3,6949,1,6954,G
1-PB2,937,2,2,6968,0,6972,G
1-PB2,938,0,0,0,6959,6959,C
1-PB2,939,2,6826,0,7,6835,T
1-PB2,940,3,1,6870,0,6874,G
1-PB2,941,1,2,0,6876,6879,C
1-PB2,942,6891,0,2,0,6893,A
1-PB2,943,6903,1,3,1,6908,A
1-PB2,944,1,6859,1,1,6862,T
1-PB2,945,1,13,6874,0,6888,G
1-PB2,946,3,10,6839,0,6852,G
1-PB2,947,1,3,6870,1,6875,G
1-PB2,948,6853,4,11,1,6869,A
1-PB2,949,0,6834,0,2,6836,T
1-PB2,950,1,6814,0,3,6818,T
1-PB2,951,0,2,6836,0,6838,G
1-PB2,952,6820,2,7,1,6830,A
1-PB2,953,1,3,6881,0,6885,G
1-PB2,954,6820,1,3,1,6825,A
1-PB2,955,6776,3,2,0,6781,A
1-PB2,956,1,6734,2,1,6738,T
1-PB2,957,1,2,0,6757,6760,C
1-PB2,958,6748,1,5,1,6755,A
1-PB2,959,2,0,6799,0,6801,G
1-PB2,960,3,0,0,6788,6791,C
1-PB2,961,2,6751,0,5,6758,T
1-PB2,962,2,0,0,6743,6745,C
1-PB2,963,6724,1,4,3,6732,A
1-PB2,964,2,6839,0,2,6843,T
1-PB2,965,8,1,0,6842,6851,C
1-PB2,966,6,1,1,6881,6889,C
1-PB2,967,1,6858,2,5,6866,T
1-PB2,968,0,6844,0,5,6849,T
1-PB2,969,3,1,0,6840,6844,C
1-PB2,970,6838,0,7,0,6845,A
1-PB2,971,1,0,6920,0,6921,G
1-PB2,972,1,1,0,6903,6905,C
1-PB2,973,0,6815,0,4,6819,T
1-PB2,974,0,6814,0,2,6816,T
1-PB2,975,2,6797,0,3,6802,T
1-PB2,976,0,3,6794,0,6797,G
1-PB2,977,3,0,6805,0,6808,G
1-PB2,978,1,6801,0,4,6806,T
1-PB2,979,1,5,6827,1,6834,G
1-PB2,980,1,4,6828,0,6833,G
1-PB2,981,2,1,6881,0,6884,G
1-PB2,982,1,6852,0,7,6860,T
1-PB2,983,2,6850,0,2,6854,T
1-PB2,984,1,6852,0,0,6853,T
1-PB2,985,6882,0,5,1,6888,A
1-PB2,986,1,0,1,6912,6914,C
1-PB2,987,6932,0,0,0,6932,A
1-PB2,988,2,6892,1,5,6900,T
1-PB2,989,0,6772,0,0,6772,T
1-PB2,990,0,6749,1,1,6751,T
1-PB2,991,6757,0,3,3,6763,A
1-PB2,992,6472,3,273,3,6751,A
1-PB2,993,6752,2,5,1,6760,A
1-PB2,994,6720,1,8,0,6729,A
1-PB2,995,1,1,6773,0,6775,G
1-PB2,996,6728,1,3,0,6732,A
1-PB2,997,6729,4,2,0,6735,A
1-PB2,998,0,6,0,6740,6746,C
1-PB2,999,6718,0,2,1,6721,A
1-PB2,1000,6724,1,2,1,6728,A
1-PB2,1001,0,2,6719,0,6721,G
1-PB2,1002,1,0,1,6722,6724,C
1-PB2,1003,2,15,6707,0,6724,G
1-PB2,1004,1,2,6721,2,6726,G
1-PB2,1005,1,0,6734,1,6736,G
1-PB2,1006,2,6709,1,15,6727,T
1-PB2,1007,4,0,0,6696,6700,C
1-PB2,1008,6717,1,4,0,6722,A
1-PB2,1009,2,6661,0,31,6694,T
1-PB2,1010,1,2,0,6707,6710,C
1-PB2,1011,6693,0,3,0,6696,A
1-PB2,1012,3,0,6757,0,6760,G
1-PB2,1013,2,6664,0,4,6670,T
1-PB2,1014,4,3,0,6667,6674,C
1-PB2,1015,6683,0,3,1,6687,A
1-PB2,1016,6696,0,1,1,6698,A
1-PB2,1017,6691,0,3,0,6694,A
1-PB2,1018,6691,3,0,1,6695,A
1-PB2,1019,6714,0,3,0,6717,A
1-PB2,1020,6717,0,7,0,6724,A
1-PB2,1021,3,1,6722,0,6726,G
1-PB2,1022,6689,1,3,0,6693,A
1-PB2,1023,6688,1,5,0,6694,A
1-PB2,1024,2,3,6685,0,6690,G
1-PB2,1025,6654,1,11,1,6667,A
1-PB2,1026,6551,1,6,0,6558,A
1-PB2,1027,3,4,6550,0,6557,G
1-PB2,1028,6533,1,3,1,6538,A
1-PB2,1029,0,1,6550,0,6551,G
1-PB2,1030,1,0,6638,1,6640,G
1-PB2,1031,2,6631,0,7,6640,T
1-PB2,1032,0,0,6758,0,6758,G
1-PB2,1033,2,2,0,6786,6790,C
1-PB2,1034,0,6783,0,8,6791,T
1-PB2,1035,0,6806,0,1,6807,T
1-PB2,1036,6809,1,2,0,6812,A
1-PB2,1037,1,1,1,6808,6811,C
1-PB2,1038,6746,0,4,0,6750,A
1-PB2,1039,1,0,6761,1,6763,G
1-PB2,1040,4,3,6731,1,6739,G
1-PB2,1041,1,3,0,6607,6611,C
1-PB2,1042,6522,2,2,0,6526,A
1-PB2,1043,6539,1,2,0,6542,A
1-PB2,1044,1,6640,2,3,6646,T
1-PB2,1045,1,1,0,6700,6702,C
1-PB2,1046,0,6695,1,7,6703,T
1-PB2,1047,0,1,0,6699,6700,C
1-PB2,1048,2,2,0,6690,6694,C
1-PB2,1049,6697,1,2,0,6700,A
1-PB2,1050,6692,1,0,0,6693,A
1-PB2,1051,6699,3,3,1,6706,A
1-PB2,1052,0,1,0,6727,6728,C
1-PB2,1053,6536,0,1,1,6538,A
1-PB2,1054,0,6486,0,2,6488,T
1-PB2,1055,0,6471,0,2,6473,T
1-PB2,1056,1,2,6546,0,6549,G
1-PB2,1057,6540,3,3,1,6547,A
1-PB2,1058,6622,1,1,1,6625,A
1-PB2,1059,6630,1,4,0,6635,A
1-PB2,1060,6628,1,2,0,6631,A
1-PB2,1061,0,6638,1,0,6639,T
1-PB2,1062,6633,1,6,0,6640,A
1-PB2,1063,6648,1,4,1,6654,A
1-PB2,1064,0,1,6755,0,6756,G
1-PB2,1065,6653,2,4,3,6662,A
1-PB2,1066,1,1,6859,0,6861,G
1-PB2,1067,5,6770,0,2,6777,T
1-PB2,1068,6810,1,4,0,6815,A
1-PB2,1069,1,3,0,6962,6966,C
1-PB2,1070,6932,3,3,0,6938,A
1-PB2,1071,0,6940,0,1,6941,T
1-PB2,1072,1,1,6941,1,6944,G
1-PB2,1073,6839,1,2,0,6842,A
1-PB2,1074,0,7,6880,1,6888,G
1-PB2,1075,2,8,6917,0,6927,G
1-PB2,1076,0,4,7284,0,7288,G
1-PB2,1077,1,5,7339,0,7345,G
1-PB2,1078,1,7160,0,5,7166,T
1-PB2,1079,7184,3,4,0,7191,A
1-PB2,1080,0,7155,0,3,7158,T
1-PB2,1081,1,2,7197,0,7200,G
1-PB2,1082,7174,1,7,1,7183,A
1-PB2,1083,0,6,7155,2,7163,G
1-PB2,1084,0,1,7103,1,7105,G
1-PB2,1085,6557,3,3,0,6563,A
1-PB2,1086,2,0,6743,1,6746,G
1-PB2,1087,0,6724,1,9,6734,T
1-PB2,1088,2,6936,3,5,6946,T
1-PB2,1089,1,3,0,6985,6989,C
1-PB2,1090,6979,1,4,1,6985,A
1-PB2,1091,0,4,1,6988,6993,C
1-PB2,1092,6973,0,2,0,6975,A
1-PB2,1093,6979,1,4,1,6985,A
1-PB2,1094,3,6962,2,0,6967,T
1-PB2,1095,0,2,6853,1,6856,G
1-PB2,1096,0,1,6919,0,6920,G
1-PB2,1097,3,6734,3,5,6745,T
1-PB2,1098,1,3,6750,0,6754,G
1-PB2,1099,0,11,6738,0,6749,G
1-PB2,1100,1,1,6731,0,6733,G
1-PB2,1101,2,2,6773,0,6777,G
1-PB2,1102,6734,1,3,0,6738,A
1-PB2,1103,6744,1,3,0,6748,A
1-PB2,1104,6706,1,2,0,6709,A
1-PB2,1105,6606,2,10,0,6618,A
1-PB2,1106,0,1,6682,1,6684,G
1-PB2,1107,6650,0,5,0,6655,A
1-PB2,1108,2,1,6661,0,6664,G
1-PB2,1109,0,0,0,6645,6645,C
1-PB2,1110,6600,2,1,0,6603,A
1-PB2,1111,6604,1,5,0,6610,A
1-PB2,1112,1,5,0,6821,6827,C
1-PB2,1113,6817,0,1,0,6818,A
1-PB2,1114,0,0,6952,0,6952,G
1-PB2,1115,0,1,1,6888,6890,C
1-PB2,1116,0,6880,1,5,6886,T
1-PB2,1117,7084,2,3,0,7089,A
1-PB2,1118,0,7075,0,1,7076,T
1-PB2,1119,7114,1,2,0,7117,A
1-PB2,1120,0,1,0,7116,7117,C
1-PB2,1121,0,6745,0,0,6745,T
1-PB2,1122,6781,0,0,0,6781,A
1-PB2,1123,6650,0,1,0,6651,A
1-PB2,1124,1,2,6665,0,6668,G
1-PB2,1125,6652,2,0,0,6654,A
1-PB2,1126,6476,0,1,2,6479,A
1-PB2,1127,6468,0,5,0,6473,A
1-PB2,1128,6451,2,5,0,6458,A
1-PB2,1129,1,0,6461,1,6463,G
1-PB2,1130,0,1,0,6465,6466,C
1-PB2,1131,6438,1,8,0,6447,A
1-PB2,1132,6459,0,3,0,6462,A
1-PB2,1133,0,4,1,6490,6495,C
1-PB2,1134,1,3,0,6491,6495,C
1-PB2,1135,6503,3,0,0,6506,A
1-PB2,1136,0,0,6541,0,6541,G
1-PB2,1137,6518,2,4,1,6525,A
1-PB2,1138,6527,2,4,2,6535,A
1-PB2,1139,0,2,6600,0,6602,G
1-PB2,1140,6585,2,0,0,6587,A
1-PB2,1141,0,6564,0,0,6564,T
1-PB2,1142,2,6523,0,3,6528,T
1-PB2,1143,1,2,6547,0,6550,G
1-PB2,1144,1,2,6658,0,6661,G
1-PB2,1145,1,6641,0,7,6649,T
1-PB2,1146,0,6627,0,4,6631,T
1-PB2,1147,3,0,0,6620,6623,C
1-PB2,1148,6691,0,3,0,6694,A
1-PB2,1149,1,1,6974,0,6976,G
1-PB2,1150,0,0,0,7027,7027,C
1-PB2,1151,0,6994,0,12,7006,T
1-PB2,1152,2,1,0,7069,7072,C
1-PB2,1153,7008,0,3,0,7011,A
1-PB2,1154,1,7025,0,2,7028,T
1-PB2,1155,7042,0,3,1,7046,A
1-PB2,1156,1,1,7058,0,7060,G
1-PB2,1157,3,6713,0,10,6726,T
1-PB2,1158,3,4,6724,1,6732,G
1-PB2,1159,6536,0,1,1,6538,A
1-PB2,1160,0,1,6611,0,6612,G
1-PB2,1161,3,6563,0,6,6572,T
1-PB2,1162,2,1,6546,2,6551,G
1-PB2,1163,0,2,6616,0,6618,G
1-PB2,1164,6608,1,1,0,6610,A
1-PB2,1165,6570,0,5,0,6575,A
1-PB2,1166,0,2,6607,0,6609,G
1-PB2,1167,6507,1,5,1,6514,A
1-PB2,1168,3,0,6541,0,6544,G
1-PB2,1169,6480,1,15,0,6496,A
1-PB2,1170,0,4,0,6497,6501,C
1-PB2,1171,1,2,6508,0,6511,G
1-PB2,1172,6470,1,5,1,6477,A
1-PB2,1173,6493,1,8,0,6502,A
1-PB2,1174,0,1,0,6500,6501,C
1-PB2,1175,6466,1,3,2,6472,A
1-PB2,1176,0,0,6830,0,6830,G
1-PB2,1177,0,6802,0,4,6806,T
1-PB2,1178,1,0,0,6802,6803,C
1-PB2,1179,6813,1,1,0,6815,A
1-PB2,1180,6804,1,2,0,6807,A
1-PB2,1181,1,6803,0,0,6804,T
1-PB2,1182,6791,0,4,0,6795,A
1-PB2,1183,0,1,6792,0,6793,G
1-PB2,1184,5,1,0,6761,6767,C
1-PB2,1185,2,5,0,6575,6582,C
1-PB2,1186,2,0,6556,0,6558,G
1-PB2,1187,6557,0,1,0,6558,A
1-PB2,1188,6559,0,7,1,6567,A
1-PB2,1189,1,1,6638,3,6643,G
1-PB2,1190,1,3,0,6750,6754,C
1-PB2,1191,6761,1,1,0,6763,A
1-PB2,1192,6755,0,2,0,6757,A
1-PB2,1193,1,6763,2,1,6767,T
1-PB2,1194,6785,0,1,0,6786,A
1-PB2,1195,6875,1,1,1,6878,A
1-PB2,1196,3,6871,0,0,6874,T
1-PB2,1197,1,1,0,6816,6818,C
1-PB2,1198,2,0,6783,0,6785,G
1-PB2,1199,1,6661,0,8,6670,T
1-PB2,1200,0,1,6647,1,6649,G
1-PB2,1201,0,1,6713,0,6714,G
1-PB2,1202,2,4,0,6710,6716,C
1-PB2,1203,1,1,1,6710,6713,C
1-PB2,1204,6684,1,0,1,6686,A
1-PB2,1205,1,6682,0,2,6685,T
1-PB2,1206,1,2,6698,0,6701,G
1-PB2,1207,0,0,6793,0,6793,G
1-PB2,1208,1,6750,2,4,6757,T
1-PB2,1209,3,0,6784,1,6788,G
1-PB2,1210,1,6654,3,3,6661,T
1-PB2,1211,0,6701,1,8,6710,T
1-PB2,1212,1,6685,1,19,6706,T
1-PB2,1213,1,6713,1,5,6720,T
1-PB2,1214,1,1,0,6775,6777,C
1-PB2,1215,6781,1,0,0,6782,A
1-PB2,1216,1,1,0,6906,6908,C
1-PB2,1217,6787,3,2,3,6795,A
1-PB2,1218,6786,1,2,0,6789,A
1-PB2,1219,0,3,6809,0,6812,G
1-PB2,1220,6737,3,3,0,6743,A
1-PB2,1221,109,0,6708,0,6817,G
1-PB2,1222,1,2,6828,0,6831,G
1-PB2,1223,6770,3,3,0,6776,A
1-PB2,1224,1,6781,1,3,6786,T
1-PB2,1225,3,6672,0,4,6679,T
1-PB2,1226,1,2,6660,2,6665,G
1-PB2,1227,1,2,1,6555,6559,C
1-PB2,1228,6584,2,4,1,6591,A
1-PB2,1229,1,6630,0,13,6644,T
1-PB2,1230,1,0,6812,0,6813,G
1-PB2,1231,6831,2,7,1,6841,A
1-PB2,1232,0,6861,1,1,6863,T
1-PB2,1233,6835,0,0,0,6835,A
1-PB2,1234,6828,1,0,0,6829,A
1-PB2,1235,6801,1,1,0,6803,A
1-PB2,1236,6823,0,6,0,6829,A
1-PB2,1237,0,0,6835,1,6836,G
1-PB2,1238,0,2,0,6937,6939,C
1-PB2,1239,6971,2,2,0,6975,A
1-PB2,1240,0,0,7131,1,7132,G
1-PB2,1241,1,7108,0,3,7112,T
1-PB2,1242,0,7107,0,2,7109,T
1-PB2,1243,7118,0,2,0,7120,A
1-PB2,1244,1,3,7135,0,7139,G
1-PB2,1245,7102,1,5,1,7109,A
1-PB2,1246,0,6,7115,0,7121,G
1-PB2,1247,1,2,7103,1,7107,G
1-PB2,1248,1,6813,2,8,6824,T
1-PB2,1249,1,6,6822,0,6829,G
1-PB2,1250,6843,0,3,0,6846,A
1-PB2,1251,2,0,0,6843,6845,C
1-PB2,1252,5,2,0,6854,6861,C
1-PB2,1253,2,6834,0,11,6847,T
1-PB2,1254,2,0,6879,1,6882,G
1-PB2,1255,6871,2,3,1,6877,A
1-PB2,1256,6864,1,1,0,6866,A
1-PB2,1257,1,6842,3,3,6849,T
1-PB2,1258,0,6910,1,1,6912,T
1-PB2,1259,1,6925,3,4,6933,T
1-PB2,1260,2,1,0,6930,6933,C
1-PB2,1261,4,1,6936,0,6941,G
1-PB2,1262,3,6925,0,7,6935,T
1-PB2,1263,2,0,1,6928,6931,C
1-PB2,1264,6932,1,3,0,6936,A
1-PB2,1265,6945,2,3,0,6950,A
1-PB2,1266,0,0,0,6930,6930,C
1-PB2,1267,6862,0,0,0,6862,A
1-PB2,1268,2,2,6934,0,6938,G
1-PB2,1269,6892,2,9,0,6903,A
1-PB2,1270,4,1,6900,1,6906,G
1-PB2,1271,1,3,1,6907,6912,C
1-PB2,1272,6892,2,2,0,6896,A
1-PB2,1273,6943,0,3,0,6946,A
1-PB2,1274,6940,2,1,1,6944,A
1-PB2,1275,0,6935,0,3,6938,T
1-PB2,1276,1,4,1,6938,6944,C
1-PB2,1277,6895,0,2,0,6897,A
1-PB2,1278,3,0,6890,0,6893,G
1-PB2,1279,1,5,0,6900,6906,C
1-PB2,1280,4,0,6911,0,6915,G
1-PB2,1281,1,1,7191,0,7193,G
1-PB2,1282,2,7092,1,53,7148,T
1-PB2,1283,1,7144,1,2,7148,T
1-PB2,1284,2,1,7164,2,7169,G
1-PB2,1285,7157,0,14,0,7171,A
1-PB2,1286,7211,3,10,0,7224,A
1-PB2,1287,2,4,0,7219,7225,C
1-PB2,1288,1,1,1,7176,7179,C
1-PB2,1289,11,4,0,7169,7184,C
1-PB2,1290,11,2,0,6947,6960,C
1-PB2,1291,6979,1,2,0,6982,A
1-PB2,1292,2,6989,1,3,6995,T
1-PB2,1293,3,1,7010,0,7014,G
1-PB2,1294,2,0,0,7024,7026,C
1-PB2,1295,6990,3,5,0,6998,A
1-PB2,1296,2,6938,0,6,6946,T
1-PB2,1297,4,2,0,6926,6932,C
1-PB2,1298,6895,1,1,0,6897,A
1-PB2,1299,4,0,6952,0,6956,G
1-PB2,1300,1,0,1,6959,6961,C
1-PB2,1301,1,6917,0,15,6933,T
1-PB2,1302,1,6943,2,2,6948,T
1-PB2,1303,3,6941,0,3,6947,T
1-PB2,1304,0,6952,0,0,6952,T
1-PB2,1305,6957,1,1,0,6959,A
1-PB2,1306,6945,2,2,0,6949,A
1-PB2,1307,0,1,6950,0,6951,G
1-PB2,1308,2,1,6895,0,6898,G
1-PB2,1309,2,2,0,6855,6859,C
1-PB2,1310,6837,1,2,0,6840,A
1-PB2,1311,4,6826,0,0,6830,T
1-PB2,1312,1,6857,0,1,6859,T
1-PB2,1313,1,6866,0,2,6869,T
1-PB2,1314,2,6892,0,2,6896,T
1-PB2,1315,0,1,1,6899,6901,C
1-PB2,1316,6884,2,8,0,6894,A
1-PB2,1317,1,0,6882,0,6883,G
1-PB2,1318,6871,0,3,0,6874,A
1-PB2,1319,6868,0,0,1,6869,A
1-PB2,1320,6870,0,1,1,6872,A
1-PB2,1321,0,2,6873,0,6875,G
1-PB2,1322,6903,0,6,0,6909,A
1-PB2,1323,0,6906,0,3,6909,T
1-PB2,1324,1,0,6897,0,6898,G
1-PB2,1325,1,2,0,6906,6909,C
1-PB2,1326,1,0,6910,0,6911,G
1-PB2,1327,6915,0,1,0,6916,A
1-PB2,1328,6901,0,3,0,6904,A
1-PB2,1329,6894,0,3,1,6898,A
1-PB2,1330,1,0,6897,0,6898,G
1-PB2,1331,0,6834,0,6,6840,T
1-PB2,1332,0,0,6830,0,6830,G
1-PB2,1333,0,1,0,6818,6819,C
1-PB2,1334,2,6810,1,8,6821,T
1-PB2,1335,2,6823,0,3,6828,T
1-PB2,1336,0,6830,1,4,6835,T
1-PB2,1337,1,6829,0,1,6831,T
1-PB2,1338,0,6838,1,6,6845,T
1-PB2,1339,2,1,0,6835,6838,C
1-PB2,1340,6841,1,2,0,6844,A
1-PB2,1341,6845,1,2,0,6848,A
1-PB2,1342,6846,0,1,1,6848,A
1-PB2,1343,6856,0,2,1,6859,A
1-PB2,1344,1,6850,2,1,6854,T
1-PB2,1345,1,6851,0,1,6853,T
1-PB2,1346,3,5,6850,0,6858,G
1-PB2,1347,0,11,6849,0,6860,G
1-PB2,1348,1,5,6838,1,6845,G
1-PB2,1349,0,1,6891,1,6893,G
1-PB2,1350,6872,0,2,0,6874,A
1-PB2,1351,2,0,6954,0,6956,G
1-PB2,1352,1,6936,0,4,6941,T
1-PB2,1353,2,6928,0,2,6932,T
1-PB2,1354,5,0,6933,1,6939,G
1-PB2,1355,6926,2,11,0,6939,A
1-PB2,1356,6959,2,6,0,6967,A
1-PB2,1357,1,1,0,7086,7088,C
1-PB2,1358,7041,1,2,1,7045,A
1-PB2,1359,0,0,0,7185,7185,C
1-PB2,1360,7058,0,3,0,7061,A
1-PB2,1361,0,7045,1,1,7047,T
1-PB2,1362,3,7010,1,6,7020,T
1-PB2,1363,2,0,7077,0,7079,G
1-PB2,1364,7082,2,5,0,7089,A
1-PB2,1365,1,3,0,7075,7079,C
1-PB2,1366,6698,2,6,1,6707,A
1-PB2,1367,1,1,6817,0,6819,G
1-PB2,1368,4,6604,1,5,6614,T
1-PB2,1369,1,0,6682,0,6683,G
1-PB2,1370,1,6645,0,4,6650,T
1-PB2,1371,0,2,6656,0,6658,G
1-PB2,1372,6655,1,2,0,6658,A
1-PB2,1373,0,6636,1,1,6638,T
1-PB2,1374,2,8,6629,0,6639,G
1-PB2,1375,3,1,6620,1,6625,G
1-PB2,1376,0,3,6531,0,6534,G
1-PB2,1377,6465,2,12,0,6479,A
1-PB2,1378,6420,0,1,0,6421,A
1-PB2,1379,2,6403,0,2,6407,T
1-PB2,1380,5,2,6417,2,6426,G
1-PB2,1381,6422,0,1,0,6423,A
1-PB2,1382,0,6403,0,3,6406,T
1-PB2,1383,1,6402,0,2,6405,T
1-PB2,1384,5,2,6352,3,6362,G
1-PB2,1385,1,3,6456,1,6461,G
1-PB2,1386,6446,1,9,0,6456,A
1-PB2,1387,1,0,6486,0,6487,G
1-PB2,1388,2,6401,0,2,6405,T
1-PB2,1389,6359,0,2,0,6361,A
1-PB2,1390,1,6355,0,1,6357,T
1-PB2,1391,0,6398,0,2,6400,T
1-PB2,1392,6433,1,5,0,6439,A
1-PB2,1393,2,0,1,6424,6427,C
1-PB2,1394,3,2,0,6295,6300,C
1-PB2,1395,6231,0,3,1,6235,A
1-PB2,1396,0,0,6231,0,6231,G
1-PB2,1397,6320,0,0,0,6320,A
1-PB2,1398,1,6240,0,2,6243,T
1-PB2,1399,6197,0,2,0,6199,A
1-PB2,1400,1,6127,0,4,6132,T
1-PB2,1401,0,1,6088,0,6089,G
1-PB2,1402,6093,2,4,1,6100,A
1-PB2,1403,0,0,0,6112,6112,C
1-PB2,1404,0,6075,0,6,6081,T
1-PB2,1405,1,1,1,6054,6057,C
1-PB2,1406,4,0,1,5961,5966,C
1-PB2,1407,5966,0,4,0,5970,A
1-PB2,1408,5981,1,5,0,5987,A
1-PB2,1409,1,0,6068,0,6069,G
1-PB2,1410,5,0,0,6026,6031,C
1-PB2,1411,6006,2,0,0,6008,A
1-PB2,1412,0,2,0,5986,5988,C
1-PB2,1413,5944,1,6,0,5951,A
1-PB2,1414,1,1,5954,0,5956,G
1-PB2,1415,5930,0,5,0,5935,A
1-PB2,1416,0,1,5963,0,5964,G
1-PB2,1417,5969,0,4,0,5973,A
1-PB2,1418,1,5785,0,2,5788,T
1-PB2,1419,1,1,5840,0,5842,G
1-PB2,1420,1,5793,0,5,5799,T
1-PB2,1421,7,1,0,5785,5793,C
1-PB2,1422,5800,1,0,0,5801,A
1-PB2,1423,5801,1,1,0,5803,A
1-PB2,1424,0,5797,0,0,5797,T
1-PB2,1425,0,1,5774,0,5775,G
1-PB2,1426,5501,1,167,0,5669,A
1-PB2,1427,0,1,5697,1,5699,G
1-PB2,1428,5603,1,9,0,5613,A
1-PB2,1429,0,2,5626,1,5629,G
1-PB2,1430,1,1,5805,0,5807,G
1-PB2,1431,5794,0,3,0,5797,A
1-PB2,1432,5805,1,2,0,5808,A
1-PB2,1433,1,5807,1,0,5809,T
1-PB2,1434,5798,2,0,0,5800,A
1-PB2,1435,5792,0,3,0,5795,A
1-PB2,1436,0,0,5790,0,5790,G
1-PB2,1437,5760,0,5,3,5768,A
1-PB2,1438,1,0,5769,0,5770,G
1-PB2,1439,2,5404,0,2,5408,T
1-PB2,1440,6,0,1,5412,5419,C
1-PB2,1441,5418,0,1,2,5421,A
1-PB2,1442,0,0,5436,0,5436,G
1-PB2,1443,1,2,0,5432,5435,C
1-PB2,1444,5438,1,5,0,5444,A
1-PB2,1445,5452,1,2,0,5455,A
1-PB2,1446,5436,4,0,1,5441,A
1-PB2,1447,5438,1,1,0,5440,A
1-PB2,1448,0,5441,1,1,5443,T
1-PB2,1449,0,4,5433,1,5438,G
1-PB2,1450,1,3,5431,0,5435,G
1-PB2,1451,0,0,5443,0,5443,G
1-PB2,1452,1,5356,1,4,5362,T
1-PB2,1453,2,0,5354,4,5360,G
1-PB2,1454,1,5331,0,5,5337,T
1-PB2,1455,3,0,5350,0,5353,G
1-PB2,1456,0,1,5402,0,5403,G
1-PB2,1457,5394,2,3,0,5399,A
1-PB2,1458,0,5357,0,3,5360,T
1-PB2,1459,0,0,5370,0,5370,G
1-PB2,1460,5338,0,2,0,5340,A
1-PB2,1461,5347,0,4,2,5353,A
1-PB2,1462,1,5328,0,2,5331,T
1-PB2,1463,5311,0,2,0,5313,A
1-PB2,1464,0,2,0,5491,5493,C
1-PB2,1465,0,5343,0,4,5347,T
1-PB2,1466,3,2,1,5365,5371,C
1-PB2,1467,0,0,0,5365,5365,C
1-PB2,1468,5333,0,2,0,5335,A
1-PB2,1469,0,1,5429,0,5430,G
1-PB2,1470,0,5395,0,2,5397,T
1-PB2,1471,5413,0,1,0,5414,A
1-PB2,1472,1,2,0,5418,5421,C
1-PB2,1473,4849,0,1,1,4851,A
1-PB2,1474,0,1,4855,0,4856,G
1-PB2,1475,4754,0,2,0,4756,A
1-PB2,1476,1,0,4770,0,4771,G
1-PB2,1477,4548,0,2,0,4550,A
1-PB2,1478,0,3,4411,1,4415,G
1-PB2,1479,4226,0,2,0,4228,A
1-PB2,1480,1,0,4285,0,4286,G
1-PB2,1481,1,4280,1,4,4286,T
1-PB2,1482,0,0,4287,0,4287,G
1-PB2,1483,1,0,4296,0,4297,G
1-PB2,1484,2,4232,0,1,4235,T
1-PB2,1485,2,0,4286,1,4289,G
1-PB2,1486,2,0,4292,0,4294,G
1-PB2,1487,1,4194,1,1,4197,T
1-PB2,1488,0,4201,0,5,4206,T
1-PB2,1489,4136,0,1,2,4139,A
1-PB2,1490,2,0,4151,0,4153,G
1-PB2,1491,1,1,0,4149,4151,C
1-PB2,1492,4113,0,0,0,4113,A
1-PB2,1493,1,4102,0,2,4105,T
1-PB2,1494,0,3888,1,0,3889,T
1-PB2,1495,0,2,3877,1,3880,G
1-PB2,1496,3881,1,0,1,3883,A
1-PB2,1497,1,3880,0,1,3882,T
1-PB2,1498,0,1,0,3881,3882,C
1-PB2,1499,0,1,3835,0,3836,G
1-PB2,1500,0,0,3868,0,3868,G
1-PB2,1501,1,3854,1,3,3859,T
1-PB2,1502,0,3854,0,0,3854,T
1-PB2,1503,0,3854,0,1,3855,T
1-PB2,1504,0,3855,0,0,3855,T
1-PB2,1505,3,3855,0,1,3859,T
1-PB2,1506,2,1,3858,1,3862,G
1-PB2,1507,3834,0,9,0,3843,A
1-PB2,1508,0,1,3856,0,3857,G
1-PB2,1509,3695,0,2,0,3697,A
1-PB2,1510,1,0,3703,0,3704,G
1-PB2,1511,1,3698,0,4,3703,T
1-PB2,1512,0,3691,0,4,3695,T
1-PB2,1513,1,1,0,3695,3697,C
1-PB2,1514,0,1,3703,0,3704,G
1-PB2,1515,3700,0,8,0,3708,A
1-PB2,1516,2,1,3703,0,3706,G
1-PB2,1517,3702,0,2,0,3704,A
1-PB2,1518,0,0,0,3699,3699,C
1-PB2,1519,3,1,0,3652,3656,C
1-PB2,1520,3622,1,1,0,3624,A
1-PB2,1521,3641,0,4,0,3645,A
1-PB2,1522,0,1,1,3647,3649,C
1-PB2,1523,1,0,3649,0,3650,G
1-PB2,1524,0,3628,0,2,3630,T
1-PB2,1525,2,4,3622,0,3628,G
1-PB2,1526,0,2,3627,0,3629,G
1-PB2,1527,1,0,3630,0,3631,G
1-PB2,1528,3602,1,3,0,3606,A
1-PB2,1529,3605,0,3,0,3608,A
1-PB2,1530,1,3447,1,0,3449,T
1-PB2,1531,0,0,3505,0,3505,G
1-PB2,1532,4,3482,0,4,3490,T
1-PB2,1533,3479,1,0,0,3480,A
1-PB2,1534,1,3473,0,2,3476,T
1-PB2,1535,1,3423,0,0,3424,T
1-PB2,1536,3436,1,0,0,3437,A
1-PB2,1537,0,3417,0,2,3419,T
1-PB2,1538,0,3373,0,0,3373,T
1-PB2,1539,3367,0,1,0,3368,A
1-PB2,1540,0,2920,0,4,2924,T
1-PB2,1541,1,0,0,2972,2973,C
1-PB2,1542,0,2930,0,3,2933,T
1-PB2,1543,1,0,0,2923,2924,C
1-PB2,1544,4,0,0,2925,2929,C
1-PB2,1545,0,2817,0,2,2819,T
1-PB2,1546,0,0,2823,0,2823,G
1-PB2,1547,2802,1,3,0,2806,A
1-PB2,1548,1,2,2805,0,2808,G
1-PB2,1549,0,3,2797,0,2800,G
1-PB2,1550,2398,1,0,0,2399,A
1-PB2,1551,0,2,2412,0,2414,G
1-PB2,1552,2,0,2375,0,2377,G
1-PB2,1553,0,2302,0,1,2303,T
1-PB2,1554,0,1,0,2302,2303,C
1-PB2,1555,2262,1,2,0,2265,A
1-PB2,1556,0,1,2268,0,2269,G
1-PB2,1557,0,2254,0,2,2256,T
1-PB2,1558,0,0,2257,0,2257,G
1-PB2,1559,2252,0,0,0,2252,A
1-PB2,1560,2137,1,1,0,2139,A
1-PB2,1561,2135,0,0,0,2135,A
1-PB2,1562,0,0,0,2139,2139,C
1-PB2,1563,2112,2,0,0,2114,A
1-PB2,1564,1,0,1,2105,2107,C
1-PB2,1565,2032,0,0,0,2032,A
1-PB2,1566,2010,0,1,0,2011,A
1-PB2,1567,0,0,2012,0,2012,G
1-PB2,1568,0,1,2023,0,2024,G
1-PB2,1569,2025,0,1,0,2026,A
1-PB2,1570,1985,0,0,0,1985,A
1-PB2,1571,0,0,0,1987,1987,C
1-PB2,1572,1,1936,0,0,1937,T
1-PB2,1573,0,0,1937,0,1937,G
1-PB2,1574,1879,1,41,0,1921,A
1-PB2,1575,1,1,1920,0,1922,G
1-PB2,1576,1889,0,1,1,1891,A
1-PB2,1577,1,1,1742,0,1744,G
1-PB2,1578,1728,0,0,0,1728,A
1-PB2,1579,1,0,0,1722,1723,C
1-PB2,1580,1,1648,0,0,1649,T
1-PB2,1581,1,0,1657,0,1658,G
1-PB2,1582,1650,0,0,0,1650,A
1-PB2,1583,0,0,0,1648,1648,C
1-PB2,1584,1634,1,1,0,1636,A
1-PB2,1585,1633,0,2,0,1635,A
1-PB2,1586,1,1628,0,0,1629,T
1-PB2,1587,1610,0,0,0,1610,A
1-PB2,1588,1611,0,0,0,1611,A
1-PB2,1589,1,0,0,1606,1607,C
1-PB2,1590,0,1414,0,0,1414,T
1-PB2,1591,0,1395,0,0,1395,T
1-PB2,1592,1346,0,0,0,1346,A
1-PB2,1593,0,1347,0,0,1347,T
1-PB2,1594,0,1337,0,0,1337,T
1-PB2,1595,1,0,0,1331,1332,C
1-PB2,1596,1185,0,1,0,1186,A
1-PB2,1597,0,1177,0,1,1178,T
1-PB2,1598,0,0,0,1086,1086,C
1-PB2,1599,0,0,1080,0,1080,G
1-PB2,1600,0,1077,1,2,1080,T
1-PB2,1601,0,0,0,1056,1056,C
1-PB2,1602,0,0,1057,0,1057,G
1-PB2,1603,1054,0,0,0,1054,A
1-PB2,1604,0,1051,0,1,1052,T
1-PB2,1605,0,0,1041,0,1041,G
1-PB2,1606,1033,0,0,0,1033,A
1-PB2,1607,0,1025,0,0,1025,T
1-PB2,1608,0,0,1015,0,1015,G
1-PB2,1609,0,927,0,0,927,T
1-PB2,1610,2,1,926,0,929,G
1-PB2,1611,0,0,924,0,924,G
1-PB2,1612,0,1,917,0,918,G
1-PB2,1613,884,0,1,0,885,A
1-PB2,1614,0,0,844,0,844,G
1-PB2,1615,694,0,0,0,694,A
1-PB2,1616,0,637,0,0,637,T
1-PB2,1617,0,593,0,0,593,T
1-PB2,1618,587,0,0,0,587,A
1-PB2,1619,576,0,0,0,576,A
1-PB2,1620,0,0,0,561,561,C
1-PB2,1621,0,0,426,0,426,G
1-PB2,1622,0,0,395,0,395,G
1-PB2,1623,0,174,0,0,174,T
1-PB2,1624,1,0,0,158,159,C
1-PB2,1625,0,0,0,154,154,C
1-PB2,1626,0,95,0,0,95,T
1-PB2,1627,0,0,96,0,96,G
1-PB2,1628,96,0,0,0,96,A
1-PB2,1629,0,0,96,0,96,G
1-PB2,1630,0,94,0,0,94,T
1-PB2,1631,0,0,0,90,90,C
1-PB2,1632,0,0,89,0,89,G
1-PB2,1633,0,0,89,0,89,G
1-PB2,1634,0,89,0,0,89,T
1-PB2,1635,0,89,0,0,89,T
1-PB2,1636,0,89,0,0,89,T
1-PB2,1637,0,88,0,0,88,T
1-PB2,1638,0,0,95,0,95,G
1-PB2,1639,0,0,96,0,96,G
1-PB2,1640,0,96,0,0,96,T
1-PB2,1641,1,0,0,95,96,C
1-PB2,1642,95,0,0,0,95,A
1-PB2,1643,99,0,0,0,99,A
1-PB2,1644,0,99,0,0,99,T
1-PB2,1645,99,0,0,0,99,A
1-PB2,1646,0,0,0,101,101,C
1-PB2,1647,1,0,0,96,97,C
1-PB2,1648,0,98,0,0,98,T
1-PB2,1649,101,0,0,0,101,A
1-PB2,1650,0,101,0,0,101,T
1-PB2,1651,0,0,0,102,102,C
1-PB2,1652,101,0,0,0,101,A
1-PB2,1653,101,0,0,0,101,A
1-PB2,1654,0,100,0,1,101,T
1-PB2,1655,0,0,100,0,100,G
1-PB2,1656,0,0,101,0,101,G
1-PB2,1657,101,0,0,0,101,A
1-PB2,1658,0,100,0,0,100,T
1-PB2,1659,0,0,0,100,100,C
1-PB2,1660,101,0,0,0,101,A
1-PB2,1661,0,101,0,0,101,T
1-PB2,1662,0,0,0,101,101,C
1-PB2,1663,101,0,0,0,101,A
1-PB2,1664,0,0,102,0,102,G
1-PB2,1665,102,0,0,0,102,A
1-PB2,1666,102,0,0,0,102,A
1-PB2,1667,102,0,0,0,102,A
1-PB2,1668,0,100,0,2,102,T
1-PB2,1669,0,102,0,0,102,T
1-PB2,1670,0,0,101,0,101,G
1-PB2,1671,0,0,101,0,101,G
1-PB2,1672,0,0,100,0,100,G
1-PB2,1673,101,0,0,0,101,A
1-PB2,1674,101,0,0,0,101,A
1-PB2,1675,0,0,101,0,101,G
1-PB2,1676,0,0,0,101,101,C
1-PB2,1677,0,101,0,0,101,T
1-PB2,1678,0,0,101,0,101,G
1-PB2,1679,0,101,0,0,101,T
1-PB2,1680,0,0,0,101,101,C
1-PB2,1681,101,0,0,0,101,A
1-PB2,1682,101,0,0,0,101,A
1-PB2,1683,101,0,0,0,101,A
1-PB2,1684,101,0,0,0,101,A
1-PB2,1685,0,101,0,0,101,T
1-PB2,1686,0,101,0,0,101,T
1-PB2,1687,0,0,0,99,99,C
1-PB2,1688,99,0,0,0,99,A
1-PB2,1689,100,0,0,0,100,A
1-PB2,1690,0,100,0,0,100,T
1-PB2,1691,0,0,104,0,104,G
1-PB2,1692,0,0,104,0,104,G
1-PB2,1693,0,104,0,0,104,T
1-PB2,1694,0,0,0,102,102,C
1-PB2,1695,0,104,0,0,104,T
1-PB2,1696,0,0,0,104,104,C
1-PB2,1697,104,0,0,0,104,A
1-PB2,1698,0,0,105,0,105,G
1-PB2,1699,105,0,0,0,105,A
1-PB2,1700,107,0,0,0,107,A
1-PB2,1701,0,104,0,0,104,T
1-PB2,1702,0,0,0,104,104,C
1-PB2,1703,1,0,0,104,105,C
1-PB2,1704,0,104,0,0,104,T
1-PB2,1705,0,0,105,0,105,G
1-PB2,1706,0,0,0,105,105,C
1-PB2,1707,104,0,0,0,104,A
1-PB2,1708,105,0,0,0,105,A
1-PB2,1709,0,105,0,0,105,T
1-PB2,1710,0,0,109,0,109,G
1-PB2,1711,0,109,0,0,109,T
1-PB2,1712,0,107,0,0,107,T
1-PB2,1713,0,0,107,0,107,G
1-PB2,1714,0,107,0,0,107,T
1-PB2,1715,107,0,0,0,107,A
1-PB2,1716,0,0,0,107,107,C
1-PB2,1717,104,0,0,0,104,A
1-PB2,1718,104,0,0,0,104,A
1-PB2,1719,0,0,0,102,102,C
1-PB2,1720,102,0,0,0,102,A
1-PB2,1721,102,0,0,0,102,A
1-PB2,1722,101,0,0,0,101,A
1-PB2,1723,101,0,0,0,101,A
1-PB2,1724,0,101,0,0,101,T
1-PB2,1725,0,0,101,0,101,G
1-PB2,1726,0,0,99,0,99,G
1-PB2,1727,101,0,0,0,101,A
1-PB2,1728,102,0,0,0,102,A
1-PB2,1729,0,102,0,0,102,T
1-PB2,1730,0,102,0,0,102,T
1-PB2,1731,0,101,0,0,101,T
1-PB2,1732,0,0,102,0,102,G
1-PB2,1733,102,0,0,0,102,A
1-PB2,1734,102,0,0,0,102,A
1-PB2,1735,0,0,0,102,102,C
1-PB2,1736,0,0,0,101,101,C
1-PB2,1737,104,0,0,0,104,A
1-PB2,1738,0,106,0,0,106,T
1-PB2,1739,0,105,0,0,105,T
1-PB2,1740,0,106,0,0,106,T
1-PB2,1741,0,0,0,105,105,C
1-PB2,1742,106,0,0,0,106,A
1-PB2,1743,105,0,0,0,105,A
1-PB2,1744,0,107,0,0,107,T
1-PB2,1745,0,0,0,109,109,C
1-PB2,1746,0,107,0,0,107,T
1-PB2,1747,0,105,0,1,106,T
1-PB2,1748,0,106,0,0,106,T
1-PB2,1749,106,0,1,0,107,A
1-PB2,1750,0,0,108,0,108,G
1-PB2,1751,0,108,0,0,108,T
1-PB2,1752,0,0,0,111,111,C
1-PB2,1753,0,0,0,111,111,C
1-PB2,1754,0,0,0,111,111,C
1-PB2,1755,0,0,0,109,109,C
1-PB2,1756,109,0,0,0,109,A
1-PB2,1757,107,0,0,0,107,A
1-PB2,1758,0,0,108,0,108,G
1-PB2,1759,0,0,108,0,108,G
1-PB2,1760,0,0,0,107,107,C
1-PB2,1761,0,0,0,105,105,C
1-PB2,1762,105,0,0,0,105,A
1-PB2,1763,0,105,0,0,105,T
1-PB2,1764,0,106,0,0,106,T
1-PB2,1765,106,0,0,0,106,A
1-PB2,1766,0,0,106,0,106,G
1-PB2,1767,105,0,0,0,105,A
1-PB2,1768,107,0,0,0,107,A
1-PB2,1769,0,0,108,0,108,G
1-PB2,1770,0,0,0,107,107,C
1-PB2,1771,1,0,0,107,108,C
1-PB2,1772,103,0,0,0,103,A
1-PB2,1773,105,0,0,0,105,A
1-PB2,1774,0,105,0,0,105,T
1-PB2,1775,108,0,0,0,108,A
1-PB2,1776,0,0,0,109,109,C
1-PB2,1777,101,0,0,0,101,A
1-PB2,1778,0,0,102,0,102,G
1-PB2,1779,0,101,0,0,101,T
1-PB2,1780,0,0,101,0,101,G
1-PB2,1781,0,0,102,0,102,G
1-PB2,1782,1,0,100,0,101,G
1-PB2,1783,0,101,0,0,101,T
1-PB2,1784,0,101,0,0,101,T
1-PB2,1785,0,102,0,0,102,T
1-PB2,1786,0,0,102,0,102,G
1-PB2,1787,0,102,0,0,102,T
1-PB2,1788,0,0,0,101,101,C
1-PB2,1789,99,0,0,0,99,A
1-PB2,1790,0,0,99,0,99,G
1-PB2,1791,98,0,0,0,98,A
1-PB2,1792,98,0,0,0,98,A
1-PB2,1793,0,0,0,97,97,C
1-PB2,1794,0,93,0,0,93,T
1-PB2,1795,0,0,0,96,96,C
1-PB2,1796,0,96,0,0,96,T
1-PB2,1797,97,0,0,0,97,A
1-PB2,1798,0,96,0,0,96,T
1-PB2,1799,0,96,0,0,96,T
1-PB2,1800,0,0,0,96,96,C
1-PB2,1801,0,0,0,94,94,C
1-PB2,1802,91,0,0,0,91,A
1-PB2,1803,91,0,0,0,91,A
1-PB2,1804,0,0,0,91,91,C
1-PB2,1805,90,1,0,0,91,A
1-PB2,1806,91,0,0,0,91,A
1-PB2,1807,91,0,0,0,91,A
1-PB2,1808,0,91,0,0,91,T
1-PB2,1809,0,0,91,0,91,G
1-PB2,1810,91,0,0,0,91,A
1-PB2,1811,0,0,91,0,91,G
1-PB2,1812,91,0,0,0,91,A
1-PB2,1813,0,0,90,0,90,G
1-PB2,1814,89,0,0,0,89,A
1-PB2,1815,0,0,0,88,88,C
1-PB2,1816,0,0,89,0,89,G
1-PB2,1817,0,90,0,0,90,T
1-PB2,1818,91,0,0,0,91,A
1-PB2,1819,0,0,0,90,90,C
1-PB2,1820,0,91,0,0,91,T
1-PB2,1821,0,91,0,0,91,T
1-PB2,1822,0,0,89,0,89,G
1-PB2,1823,0,0,89,0,89,G
1-PB2,1824,0,0,90,0,90,G
1-PB2,1825,89,0,0,0,89,A
1-PB2,1826,0,0,0,90,90,C
1-PB2,1827,92,0,0,0,92,A
1-PB2,1828,0,92,0,0,92,T
1-PB2,1829,0,92,0,0,92,T
1-PB2,1830,0,93,0,0,93,T
1-PB2,1831,0,0,92,0,92,G
1-PB2,1832,93,0,0,0,93,A
1-PB2,1833,0,0,0,93,93,C
1-PB2,1834,93,0,0,0,93,A
1-PB2,1835,0,0,0,93,93,C
1-PB2,1836,0,0,0,93,93,C
1-PB2,1837,94,0,0,0,94,A
1-PB2,1838,0,0,0,95,95,C
1-PB2,1839,0,0,0,95,95,C
1-PB2,1840,0,0,0,97,97,C
1-PB2,1841,97,0,0,0,97,A
1-PB2,1842,0,0,98,0,98,G
1-PB2,1843,97,0,0,0,97,A
1-PB2,1844,0,103,0,0,103,T
1-PB2,1845,103,0,0,0,103,A
1-PB2,1846,102,0,0,0,102,A
1-PB2,1847,0,103,0,0,103,T
1-PB2,1848,104,0,0,0,104,A
1-PB2,1849,104,0,0,0,104,A
1-PB2,1850,104,0,0,0,104,A
1-PB2,1851,0,0,104,0,104,G
1-PB2,1852,0,0,0,103,103,C
1-PB2,1853,0,97,0,1,98,T
1-PB2,1854,0,97,0,0,97,T
1-PB2,1855,0,0,0,97,97,C
1-PB2,1856,0,96,0,0,96,T
1-PB2,1857,0,0,0,98,98,C
1-PB2,1858,0,0,0,98,98,C
1-PB2,1859,1,0,0,98,99,C
1-PB2,1860,0,94,0,0,94,T
1-PB2,1861,0,95,0,0,95,T
1-PB2,1862,0,96,0,0,96,T
1-PB2,1863,0,96,0,0,96,T
1-PB2,1864,0,0,96,0,96,G
1-PB2,1865,0,0,0,96,96,C
1-PB2,1866,94,0,0,0,94,A
1-PB2,1867,0,0,94,0,94,G
1-PB2,1868,0,0,0,95,95,C
1-PB2,1869,0,95,0,0,95,T
1-PB2,1870,0,0,95,0,95,G
1-PB2,1871,0,0,0,95,95,C
1-PB2,1872,0,93,0,0,93,T
1-PB2,1873,0,0,0,93,93,C
1-PB2,1874,2,0,0,90,92,C
1-PB2,1875,94,0,0,0,94,A
1-PB2,1876,0,0,0,93,93,C
1-PB2,1877,0,0,0,92,92,C
1-PB2,1878,91,0,0,0,91,A
1-PB2,1879,92,0,0,0,92,A
1-PB2,1880,92,0,0,0,92,A
1-PB2,1881,0,0,93,0,93,G
1-PB2,1882,0,0,0,94,94,C
1-PB2,1883,93,0,0,0,93,A
1-PB2,1884,93,0,0,0,93,A
1-PB2,1885,93,0,0,0,93,A
1-PB2,1886,0,0,93,0,93,G
1-PB2,1887,0,0,0,93,93,C
1-PB2,1888,93,0,0,0,93,A
1-PB2,1889,0,0,93,0,93,G
1-PB2,1890,93,0,0,0,93,A
1-PB2,1891,94,0,0,0,94,A
1-PB2,1892,0,94,0,0,94,T
1-PB2,1893,0,0,95,0,95,G
1-PB2,1894,0,0,0,95,95,C
1-PB2,1895,94,0,0,0,94,A
1-PB2,1896,0,0,95,0,95,G
1-PB2,1897,0,94,0,0,94,T
1-PB2,1898,0,98,0,0,98,T
1-PB2,1899,0,0,0,95,95,C
1-PB2,1900,0,97,0,0,97,T
1-PB2,1901,0,0,0,97,97,C
1-PB2,1902,0,96,0,1,97,T
1-PB2,1903,0,97,0,0,97,T
1-PB2,1904,0,1,0,96,97,C
1-PB2,1905,95,0,0,0,95,A
1-PB2,1906,0,0,0,95,95,C
1-PB2,1907,0,94,0,0,94,T
1-PB2,1908,0,0,95,0,95,G
1-PB2,1909,95,0,0,0,95,A
1-PB2,1910,0,0,0,95,95,C
1-PB2,1911,0,96,0,0,96,T
1-PB2,1912,0,0,97,0,97,G
1-PB2,1913,0,97,0,0,97,T
1-PB2,1914,0,0,97,0,97,G
1-PB2,1915,97,0,0,0,97,A
1-PB2,1916,97,0,0,0,97,A
1-PB2,1917,0,96,0,0,96,T
1-PB2,1918,0,0,96,0,96,G
1-PB2,1919,0,94,0,0,94,T
1-PB2,1920,0,0,94,0,94,G
1-PB2,1921,92,0,0,0,92,A
1-PB2,1922,0,0,93,0,93,G
1-PB2,1923,0,0,92,0,92,G
1-PB2,1924,0,0,92,0,92,G
1-PB2,1925,0,0,97,0,97,G
1-PB2,1926,97,0,0,0,97,A
1-PB2,1927,0,96,0,0,96,T
1-PB2,1928,0,0,0,97,97,C
1-PB2,1929,96,0,0,0,96,A
1-PB2,1930,0,0,97,0,97,G
1-PB2,1931,0,0,95,0,95,G
1-PB2,1932,0,0,97,0,97,G
1-PB2,1933,97,0,0,0,97,A
1-PB2,1934,0,92,0,0,92,T
1-PB2,1935,0,0,92,0,92,G
1-PB2,1936,92,0,0,0,92,A
1-PB2,1937,0,0,95,0,95,G
1-PB2,1938,95,0,0,0,95,A
1-PB2,1939,94,0,0,0,94,A
1-PB2,1940,0,95,0,0,95,T
1-PB2,1941,95,0,0,0,95,A
1-PB2,1942,0,0,0,95,95,C
1-PB2,1943,1,89,0,0,90,T
1-PB2,1944,0,89,0,0,89,T
1-PB2,1945,0,0,89,0,89,G
1-PB2,1946,0,85,0,0,85,T
1-PB2,1947,85,0,0,0,85,A
1-PB2,1948,84,0,0,0,84,A
1-PB2,1949,0,1,80,0,81,G
1-PB2,1950,0,0,83,0,83,G
1-PB2,1951,0,0,80,0,80,G
1-PB2,1952,0,0,80,0,80,G
1-PB2,1953,0,0,0,82,82,C
1-PB2,1954,82,0,0,0,82,A
1-PB2,1955,82,0,0,0,82,A
1-PB2,1956,0,82,0,0,82,T
1-PB2,1957,0,81,0,0,81,T
1-PB2,1958,0,0,0,82,82,C
1-PB2,1959,0,80,0,1,81,T
1-PB2,1960,0,0,0,81,81,C
1-PB2,1961,0,0,0,80,80,C
1-PB2,1962,0,81,0,0,81,T
1-PB2,1963,0,0,82,0,82,G
1-PB2,1964,0,81,0,0,81,T
1-PB2,1965,81,0,0,0,81,A
1-PB2,1966,0,81,0,0,81,T
1-PB2,1967,0,80,0,0,80,T
1-PB2,1968,0,0,0,81,81,C
1-PB2,1969,80,0,0,0,80,A
1-PB2,1970,80,0,0,0,80,A
1-PB2,1971,0,0,0,80,80,C
1-PB2,1972,0,77,0,0,77,T
1-PB2,1973,77,0,0,0,77,A
1-PB2,1974,0,0,0,81,81,C
1-PB2,1975,80,0,0,0,80,A
1-PB2,1976,80,0,0,0,80,A
1-PB2,1977,0,0,0,78,78,C
1-PB2,1978,78,0,0,0,78,A
1-PB2,1979,77,0,0,0,77,A
1-PB2,1980,0,0,77,0,77,G
1-PB2,1981,77,0,0,0,77,A
1-PB2,1982,0,0,0,76,76,C
1-PB2,1983,0,0,0,73,73,C
1-PB2,1984,73,0,0,0,73,A
1-PB2,1985,0,0,0,78,78,C
1-PB2,1986,0,78,0,0,78,T
1-PB2,1987,78,0,0,0,78,A
1-PB2,1988,78,0,0,0,78,A
1-PB2,1989,78,0,0,0,78,A
1-PB2,1990,77,0,0,0,77,A
1-PB2,1991,0,1,78,0,79,G
1-PB2,1992,77,0,0,0,77,A
1-PB2,1993,0,0,0,77,77,C
1-PB2,1994,0,76,0,0,76,T
1-PB2,1995,75,0,0,0,75,A
1-PB2,1996,76,0,0,0,76,A
1-PB2,1997,0,0,0,76,76,C
1-PB2,1998,76,0,0,0,76,A
1-PB2,1999,75,0,0,0,75,A
1-PB2,2000,0,74,0,0,74,T
1-PB2,2001,0,75,0,0,75,T
1-PB2,2002,0,0,0,75,75,C
1-PB2,2003,0,75,0,0,75,T
1-PB2,2004,0,0,0,76,76,C
1-PB2,2005,0,0,76,0,76,G
1-PB2,2006,0,0,76,0,76,G
1-PB2,2007,76,0,0,0,76,A
1-PB2,2008,76,0,0,0,76,A
1-PB2,2009,75,1,0,0,76,A
1-PB2,2010,76,0,0,0,76,A
1-PB2,2011,0,0,77,0,77,G
1-PB2,2012,76,0,0,0,76,A
1-PB2,2013,0,76,0,0,76,T
1-PB2,2014,0,0,77,0,77,G
1-PB2,2015,0,0,0,77,77,C
1-PB2,2016,0,0,0,77,77,C
1-PB2,2017,0,0,77,0,77,G
1-PB2,2018,0,0,77,0,77,G
1-PB2,2019,0,0,0,77,77,C
1-PB2,2020,77,0,0,0,77,A
1-PB2,2021,0,0,0,81,81,C
1-PB2,2022,0,80,0,0,80,T
1-PB2,2023,0,79,0,0,79,T
1-PB2,2024,0,81,0,0,81,T
1-PB2,2025,80,0,0,0,80,A
1-PB2,2026,80,0,0,0,80,A
1-PB2,2027,0,80,0,0,80,T
1-PB2,2028,79,0,0,0,79,A
1-PB2,2029,0,0,79,0,79,G
1-PB2,2030,78,0,0,0,78,A
1-PB2,2031,79,0,0,0,79,A
1-PB2,2032,0,0,80,0,80,G
1-PB2,2033,81,0,0,0,81,A
1-PB2,2034,0,0,0,80,80,C
1-PB2,2035,0,0,0,81,81,C
1-PB2,2036,0,0,0,81,81,C
1-PB2,2037,79,0,0,0,79,A
1-PB2,2038,0,0,81,0,81,G
1-PB2,2039,82,0,0,0,82,A
1-PB2,2040,0,82,0,0,82,T
1-PB2,2041,0,0,81,0,81,G
1-PB2,2042,82,0,0,0,82,A
1-PB2,2043,82,0,0,0,82,A
1-PB2,2044,82,0,0,0,82,A
1-PB2,2045,0,0,82,0,82,G
1-PB2,2046,0,0,0,82,82,C
1-PB2,2047,81,0,0,0,81,A
1-PB2,2048,0,0,0,83,83,C
1-PB2,2049,83,0,0,0,83,A
1-PB2,2050,0,83,0,0,83,T
1-PB2,2051,0,0,0,83,83,C
1-PB2,2052,0,0,0,83,83,C
1-PB2,2053,0,0,83,0,83,G
1-PB2,2054,0,0,83,0,83,G
1-PB2,2055,83,0,0,0,83,A
1-PB2,2056,0,0,82,0,82,G
1-PB2,2057,0,83,0,0,83,T
1-PB2,2058,0,0,82,0,82,G
1-PB2,2059,0,0,82,0,82,G
1-PB2,2060,81,0,0,0,81,A
1-PB2,2061,0,0,81,0,81,G
1-PB2,2062,0,79,0,0,79,T
1-PB2,2063,0,0,0,78,78,C
1-PB2,2064,0,0,0,78,78,C
1-PB2,2065,0,0,78,0,78,G
1-PB2,2066,0,0,0,78,78,C
1-PB2,2067,0,0,0,77,77,C
1-PB2,2068,0,0,79,0,79,G
1-PB2,2069,0,79,0,0,79,T
1-PB2,2070,0,0,0,80,80,C
1-PB2,2071,0,80,0,0,80,T
1-PB2,2072,0,79,0,0,79,T
1-PB2,2073,0,0,79,0,79,G
1-PB2,2074,79,0,0,0,79,A
1-PB2,2075,0,0,79,0,79,G
1-PB2,2076,79,0,0,0,79,A
1-PB2,2077,0,0,76,0,76,G
1-PB2,2078,0,0,76,0,76,G
1-PB2,2079,0,0,75,0,75,G
1-PB2,2080,0,74,0,0,74,T
1-PB2,2081,0,75,0,0,75,T
1-PB2,2082,0,75,0,0,75,T
1-PB2,2083,0,0,0,75,75,C
1-PB2,2084,0,75,0,0,75,T
1-PB2,2085,0,0,0,77,77,C
1-PB2,2086,75,0,0,0,75,A
1-PB2,2087,0,74,0,0,74,T
1-PB2,2088,0,74,0,0,74,T
1-PB2,2089,74,0,0,0,74,A
1-PB2,2090,0,74,0,0,74,T
1-PB2,2091,74,0,0,0,74,A
1-PB2,2092,0,0,74,0,74,G
1-PB2,2093,0,0,75,0,75,G
1-PB2,2094,0,70,0,0,70,T
1-PB2,2095,65,0,0,0,65,A
1-PB2,2096,67,0,0,0,67,A
1-PB2,2097,0,0,67,0,67,G
1-PB2,2098,1,0,66,0,67,G
1-PB2,2099,66,0,0,0,66,A
1-PB2,2100,64,0,0,0,64,A
1-PB2,2101,0,0,63,0,63,G
1-PB2,2102,63,0,0,0,63,A
1-PB2,2103,0,0,0,62,62,C
1-PB2,2104,63,0,0,0,63,A
1-PB2,2105,1,0,62,0,63,G
1-PB2,2106,63,0,0,0,63,A
1-PB2,2107,63,0,0,0,63,A
1-PB2,2108,0,0,63,0,63,G
1-PB2,2109,63,0,0,0,63,A
1-PB2,2110,0,63,0,0,63,T
1-PB2,2111,63,0,0,0,63,A
1-PB2,2112,0,0,0,63,63,C
1-PB2,2113,0,0,62,0,62,G
1-PB2,2114,0,0,62,0,62,G
1-PB2,2115,62,0,0,0,62,A
1-PB2,2116,0,0,0,60,60,C
1-PB2,2117,0,0,0,59,59,C
1-PB2,2118,59,0,0,0,59,A
1-PB2,2119,0,0,62,0,62,G
1-PB2,2120,0,0,0,62,62,C
1-PB2,2121,62,0,0,0,62,A
1-PB2,2122,0,61,0,0,61,T
1-PB2,2123,0,61,0,0,61,T
1-PB2,2124,61,0,0,0,61,A
1-PB2,2125,60,0,1,0,61,A
1-PB2,2126,0,0,61,0,61,G
1-PB2,2127,0,0,0,62,62,C
1-PB2,2128,62,0,0,0,62,A
1-PB2,2129,0,62,0,0,62,T
1-PB2,2130,0,0,0,62,62,C
1-PB2,2131,62,0,0,0,62,A
1-PB2,2132,62,0,0,0,62,A
1-PB2,2133,0,61,0,0,61,T
1-PB2,2134,0,0,61,0,61,G
1-PB2,2135,61,0,0,0,61,A
1-PB2,2136,61,0,0,0,61,A
1-PB2,2137,0,0,0,61,61,C
1-PB2,2138,0,56,0,0,56,T
1-PB2,2139,0,0,56,0,56,G
1-PB2,2140,55,0,0,0,55,A
1-PB2,2141,0,0,56,0,56,G
1-PB2,2142,0,56,0,0,56,T
1-PB2,2143,55,0,0,0,55,A
1-PB2,2144,56,0,0,0,56,A
1-PB2,2145,0,0,0,56,56,C
1-PB2,2146,0,0,0,55,55,C
1-PB2,2147,0,55,0,0,55,T
1-PB2,2148,0,52,0,0,52,T
1-PB2,2149,0,0,52,0,52,G
1-PB2,2150,0,0,0,52,52,C
1-PB2,2151,51,0,0,0,51,A
1-PB2,2152,52,0,0,0,52,A
1-PB2,2153,52,0,0,0,52,A
1-PB2,2154,51,0,0,0,51,A
1-PB2,2155,0,1,51,0,52,G
1-PB2,2156,0,0,53,0,53,G
1-PB2,2157,0,0,53,0,53,G
1-PB2,2158,0,0,53,0,53,G
1-PB2,2159,53,0,0,0,53,A
1-PB2,2160,53,0,0,0,53,A
1-PB2,2161,53,0,0,0,53,A
1-PB2,2162,53,0,0,0,53,A
1-PB2,2163,0,0,53,0,53,G
1-PB2,2164,0,0,54,0,54,G
1-PB2,2165,0,0,0,55,55,C
1-PB2,2166,0,53,0,0,53,T
1-PB2,2167,52,0,0,0,52,A
1-PB2,2168,52,0,0,0,52,A
1-PB2,2169,0,52,0,0,52,T
1-PB2,2170,0,0,53,0,53,G
1-PB2,2171,0,51,0,0,51,T
1-PB2,2172,0,0,51,0,51,G
1-PB2,2173,0,0,0,50,50,C
1-PB2,2174,0,50,0,0,50,T
1-PB2,2175,50,0,0,0,50,A
1-PB2,2176,50,0,0,0,50,A
1-PB2,2177,0,50,0,0,50,T
1-PB2,2178,0,0,0,51,51,C
1-PB2,2179,0,0,47,0,47,G
1-PB2,2180,0,0,47,0,47,G
1-PB2,2181,0,0,47,0,47,G
1-PB2,2182,0,0,0,47,47,C
1-PB2,2183,47,0,0,0,47,A
1-PB2,2184,46,0,0,0,46,A
1-PB2,2185,0,0,46,0,46,G
1-PB2,2186,0,0,46,0,46,G
1-PB2,2187,46,0,0,0,46,A
1-PB2,2188,0,0,46,0,46,G
1-PB2,2189,42,0,0,0,42,A
1-PB2,2190,0,0,0,42,42,C
1-PB2,2191,0,0,42,0,42,G
1-PB2,2192,0,42,0,0,42,T
1-PB2,2193,0,0,42,0,42,G
1-PB2,2194,0,0,42,0,42,G
1-PB2,2195,0,42,0,0,42,T
1-PB2,2196,0,0,43,0,43,G
1-PB2,2197,0,43,0,0,43,T
1-PB2,2198,0,43,0,0,43,T
1-PB2,2199,0,0,43,0,43,G
1-PB2,2200,0,0,43,0,43,G
1-PB2,2201,0,43,0,0,43,T
1-PB2,2202,43,0,0,0,43,A
1-PB2,2203,43,0,0,0,43,A
1-PB2,2204,0,43,0,0,43,T
1-PB2,2205,0,0,43,0,43,G
1-PB2,2206,43,0,0,0,43,A
1-PB2,2207,44,0,0,0,44,A
1-PB2,2208,44,0,0,0,44,A
1-PB2,2209,0,0,0,43,43,C
1-PB2,2210,0,0,44,0,44,G
1-PB2,2211,44,0,0,0,44,A
1-PB2,2212,44,0,0,0,44,A
1-PB2,2213,44,0,0,0,44,A
1-PB2,2214,44,0,0,0,44,A
1-PB2,2215,0,0,0,44,44,C
1-PB2,2216,0,0,44,0,44,G
1-PB2,2217,0,0,44,0,44,G
1-PB2,2218,0,0,44,0,44,G
1-PB2,2219,44,0,0,0,44,A
1-PB2,2220,0,0,0,44,44,C
1-PB2,2221,0,44,0,0,44,T
1-PB2,2222,0,0,0,44,44,C
1-PB2,2223,0,44,0,0,44,T
1-PB2,2224,43,0,0,0,43,A
1-PB2,2225,0,0,44,0,44,G
1-PB2,2226,0,0,0,44,44,C
1-PB2,2227,44,0,0,0,44,A
1-PB2,2228,0,44,0,0,44,T
1-PB2,2229,44,0,0,0,44,A
1-PB2,2230,0,0,0,44,44,C
1-PB2,2231,0,37,0,0,37,T
1-PB2,2232,0,37,0,0,37,T
1-PB2,2233,36,0,0,0,36,A
1-PB2,2234,0,0,0,36,36,C
1-PB2,2235,0,36,0,0,36,T
1-PB2,2236,0,0,36,0,36,G
1-PB2,2237,34,0,0,0,34,A
1-PB2,2238,0,0,0,34,34,C
1-PB2,2239,31,0,0,0,31,A
1-PB2,2240,0,0,31,0,31,G
1-PB2,2241,0,0,0,30,30,C
1-PB2,2242,0,0,0,30,30,C
1-PB2,2243,30,0,0,0,30,A
1-PB2,2244,0,0,30,0,30,G
1-PB2,2245,30,0,0,0,30,A
1-PB2,2246,0,0,0,30,30,C
1-PB2,2247,28,0,0,0,28,A
1-PB2,2248,0,0,28,0,28,G
1-PB2,2249,0,0,0,28,28,C
1-PB2,2250,0,0,28,0,28,G
1-PB2,2251,28,0,0,0,28,A
1-PB2,2252,0,0,0,28,28,C
1-PB2,2253,0,0,0,28,28,C
1-PB2,2254,28,0,0,0,28,A
1-PB2,2255,28,0,0,0,28,A
1-PB2,2256,28,0,0,0,28,A
1-PB2,2257,28,0,0,0,28,A
1-PB2,2258,0,0,28,0,28,G
1-PB2,2259,28,0,0,0,28,A
1-PB2,2260,28,0,0,0,28,A
1-PB2,2261,0,28,0,0,28,T
1-PB2,2262,0,28,0,0,28,T
1-PB2,2263,0,1,0,27,28,C
1-PB2,2264,0,0,28,0,28,G
1-PB2,2265,0,0,28,0,28,G
1-PB2,2266,28,0,0,0,28,A
1-PB2,2267,0,27,0,0,27,T
1-PB2,2268,0,0,27,0,27,G
1-PB2,2269,0,0,27,0,27,G
1-PB2,2270,0,0,0,27,27,C
1-PB2,2271,0,0,0,27,27,C
1-PB2,2272,27,0,0,0,27,A
1-PB2,2273,0,27,0,0,27,T
1-PB2,2274,0,0,0,27,27,C
1-PB2,2275,27,0,0,0,27,A
1-PB2,2276,27,0,0,0,27,A
1-PB2,2277,0,27,0,0,27,T
1-PB2,2278,0,25,0,0,25,T
1-PB2,2279,24,0,0,0,24,A
1-PB2,2280,24,0,0,0,24,A
2-PB1,1,117,0,0,0,117,A
2-PB1,2,0,117,0,0,117,T
2-PB1,3,0,0,120,0,120,G
2-PB1,4,0,0,129,0,129,G
2-PB1,5,148,0,0,0,148,A
2-PB1,6,0,157,0,0,157,T
2-PB1,7,0,0,158,0,158,G
2-PB1,8,1,158,0,0,159,T
2-PB1,9,0,0,0,171,171,C
2-PB1,10,171,0,0,0,171,A
2-PB1,11,181,0,0,0,181,A
2-PB1,12,0,183,0,0,183,T
2-PB1,13,0,0,0,186,186,C
2-PB1,14,0,0,0,199,199,C
2-PB1,15,0,0,204,0,204,G
2-PB1,16,231,1,0,0,232,A
2-PB1,17,0,0,0,233,233,C
2-PB1,18,0,233,0,0,233,T
2-PB1,19,1,0,0,260,261,C
2-PB1,20,0,261,0,0,261,T
2-PB1,21,269,0,0,0,269,A
2-PB1,22,0,0,0,271,271,C
2-PB1,23,0,271,0,0,271,T
2-PB1,24,0,0,297,0,297,G
2-PB1,25,0,295,0,1,296,T
2-PB1,26,0,298,0,0,298,T
2-PB1,27,0,0,0,297,297,C
2-PB1,28,0,1,0,296,297,C
2-PB1,29,0,354,0,0,354,T
2-PB1,30,358,0,1,0,359,A
2-PB1,31,358,0,0,0,358,A
2-PB1,32,360,0,0,0,360,A
2-PB1,33,0,0,361,0,361,G
2-PB1,34,1,0,363,0,364,G
2-PB1,35,0,367,0,0,367,T
2-PB1,36,0,367,0,0,367,T
2-PB1,37,0,0,0,368,368,C
2-PB1,38,0,0,0,367,367,C
2-PB1,39,367,0,1,0,368,A
2-PB1,40,0,0,377,0,377,G
2-PB1,41,0,0,0,377,377,C
2-PB1,42,0,0,376,0,376,G
2-PB1,43,0,0,0,376,376,C
2-PB1,44,378,0,0,0,378,A
2-PB1,45,377,1,0,0,378,A
2-PB1,46,377,0,0,0,377,A
2-PB1,47,378,0,0,0,378,A
2-PB1,48,0,383,0,0,383,T
2-PB1,49,0,0,394,0,394,G
2-PB1,50,0,0,0,394,394,C
2-PB1,51,0,0,0,398,398,C
2-PB1,52,400,0,0,0,400,A
2-PB1,53,0,401,0,0,401,T
2-PB1,54,423,0,0,0,423,A
2-PB1,55,421,0,0,0,421,A
2-PB1,56,0,0,446,0,446,G
2-PB1,57,0,0,0,446,446,C
2-PB1,58,445,2,0,0,447,A
2-PB1,59,0,0,0,459,459,C
2-PB1,60,460,0,0,0,460,A
2-PB1,61,489,0,0,0,489,A
2-PB1,62,0,0,0,489,489,C
2-PB1,63,491,0,0,0,491,A
2-PB1,64,0,500,0,0,500,T
2-PB1,65,0,498,0,0,498,T
2-PB1,66,0,0,0,623,623,C
2-PB1,67,0,0,0,627,627,C
2-PB1,68,0,0,0,632,632,C
2-PB1,69,0,639,0,0,639,T
2-PB1,70,0,638,0,1,639,T
2-PB1,71,700,0,0,0,700,A
2-PB1,72,0,708,0,0,708,T
2-PB1,73,710,1,0,1,712,A
2-PB1,74,0,0,0,720,720,C
2-PB1,75,1,701,0,0,702,T
2-PB1,76,0,0,706,0,706,G
2-PB1,77,0,0,709,0,709,G
2-PB1,78,705,0,0,0,705,A
2-PB1,79,0,0,706,0,706,G
2-PB1,80,704,1,0,0,705,A
2-PB1,81,0,710,0,0,710,T
2-PB1,82,0,0,0,755,755,C
2-PB1,83,0,0,0,756,756,C
2-PB1,84,1,760,0,1,762,T
2-PB1,85,0,0,0,811,811,C
2-PB1,86,0,0,0,812,812,C
2-PB1,87,825,0,0,0,825,A
2-PB1,88,0,825,0,0,825,T
2-PB1,89,822,1,0,0,823,A
2-PB1,90,0,0,0,827,827,C
2-PB1,91,820,0,0,0,820,A
2-PB1,92,0,0,861,0,861,G
2-PB1,93,0,0,0,874,874,C
2-PB1,94,0,0,1,873,874,C
2-PB1,95,878,0,0,0,878,A
2-PB1,96,0,875,0,0,875,T
2-PB1,97,0,1,877,0,878,G
2-PB1,98,1,0,916,0,917,G
2-PB1,99,925,0,0,0,925,A
2-PB1,100,926,0,0,0,926,A
2-PB1,101,0,0,0,935,935,C
2-PB1,102,932,0,0,0,932,A
2-PB1,103,0,1,954,0,955,G
2-PB1,104,0,0,966,0,966,G
2-PB1,105,965,0,0,0,965,A
2-PB1,106,970,0,0,0,970,A
2-PB1,107,0,0,0,971,971,C
2-PB1,108,971,0,0,0,971,A
2-PB1,109,1,2,1096,0,1099,G
2-PB1,110,1,0,1102,0,1103,G
2-PB1,111,0,1,1116,0,1117,G
2-PB1,112,0,1120,0,0,1120,T
2-PB1,113,1119,0,0,0,1119,A
2-PB1,114,0,0,0,1127,1127,C
2-PB1,115,1162,2,1,0,1165,A
2-PB1,116,0,0,0,1207,1207,C
2-PB1,117,0,0,0,1205,1205,C
2-PB1,118,1183,0,0,0,1183,A
2-PB1,119,0,1184,0,0,1184,T
2-PB1,120,0,2,1194,0,1196,G
2-PB1,121,0,0,1198,0,1198,G
2-PB1,122,1199,0,1,0,1200,A
2-PB1,123,0,0,1,1200,1201,C
2-PB1,124,1191,1,0,0,1192,A
2-PB1,125,0,0,0,1215,1215,C
2-PB1,126,1222,0,2,0,1224,A
2-PB1,127,0,0,1250,0,1250,G
2-PB1,128,0,1248,0,0,1248,T
2-PB1,129,0,0,0,1282,1282,C
2-PB1,130,1279,0,0,0,1279,A
2-PB1,131,1283,0,0,0,1283,A
2-PB1,132,0,0,0,1283,1283,C
2-PB1,133,1280,0,2,0,1282,A
2-PB1,134,0,1,1304,0,1305,G
2-PB1,135,1293,1,2,0,1296,A
2-PB1,136,1296,0,0,0,1296,A
2-PB1,137,0,0,0,1295,1295,C
2-PB1,138,1283,0,0,0,1283,A
2-PB1,139,0,0,0,1325,1325,C
2-PB1,140,1318,1,0,0,1319,A
2-PB1,141,0,1,0,1360,1361,C
2-PB1,142,2,1,0,1359,1362,C
2-PB1,143,1365,0,0,0,1365,A
2-PB1,144,1379,0,0,0,1379,A
2-PB1,145,0,1416,0,0,1416,T
2-PB1,146,1452,0,0,0,1452,A
2-PB1,147,0,1451,0,0,1451,T
2-PB1,148,0,1443,0,0,1443,T
2-PB1,149,1,0,0,1447,1448,C
2-PB1,150,1425,1,1,0,1427,A
2-PB1,151,0,0,1429,0,1429,G
2-PB1,152,1422,0,0,0,1422,A
2-PB1,153,0,0,1419,0,1419,G
2-PB1,154,1399,0,0,0,1399,A
2-PB1,155,1,0,1387,0,1388,G
2-PB1,156,0,2,1385,0,1387,G
2-PB1,157,0,0,1444,0,1444,G
2-PB1,158,0,0,1450,0,1450,G
2-PB1,159,0,0,1453,0,1453,G
2-PB1,160,1452,1,0,0,1453,A
2-PB1,161,1457,0,0,0,1457,A
2-PB1,162,1,0,1459,0,1460,G
2-PB1,163,0,1453,0,0,1453,T
2-PB1,164,0,0,1446,0,1446,G
2-PB1,165,0,0,1436,0,1436,G
2-PB1,166,1435,0,1,0,1436,A
2-PB1,167,0,0,0,1438,1438,C
2-PB1,168,0,1,1441,0,1442,G
2-PB1,169,1442,2,0,0,1444,A
2-PB1,170,0,0,0,1453,1453,C
2-PB1,171,1446,0,0,0,1446,A
2-PB1,172,1446,0,0,0,1446,A
2-PB1,173,1459,0,0,0,1459,A
2-PB1,174,2,1473,0,1,1476,T
2-PB1,175,1479,0,0,0,1479,A
2-PB1,176,0,0,0,1482,1482,C
2-PB1,177,1471,0,1,0,1472,A
2-PB1,178,0,0,1471,0,1471,G
2-PB1,179,1467,0,0,0,1467,A
2-PB1,180,1493,0,0,0,1493,A
2-PB1,181,1489,0,1,0,1490,A
2-PB1,182,0,0,1,1486,1487,C
2-PB1,183,0,1471,0,0,1471,T
2-PB1,184,0,0,1463,0,1463,G
2-PB1,185,0,0,1457,0,1457,G
2-PB1,186,2,3,1450,0,1455,G
2-PB1,187,0,0,1454,0,1454,G
2-PB1,188,0,1,0,1466,1467,C
2-PB1,189,1459,1,1,0,1461,A
2-PB1,190,0,0,0,1514,1514,C
2-PB1,191,0,0,0,1515,1515,C
2-PB1,192,4,0,0,1508,1512,C
2-PB1,193,0,1,0,1515,1516,C
2-PB1,194,1513,3,0,0,1516,A
2-PB1,195,1536,1,0,0,1537,A
2-PB1,196,0,0,0,1534,1534,C
2-PB1,197,0,1529,0,1,1530,T
2-PB1,198,1,0,0,1534,1535,C
2-PB1,199,1501,0,0,0,1501,A
2-PB1,200,1521,0,0,0,1521,A
2-PB1,201,0,0,0,1521,1521,C
2-PB1,202,1,0,0,1516,1517,C
2-PB1,203,1,0,1,1521,1523,C
2-PB1,204,1517,0,0,1,1518,A
2-PB1,205,1519,0,0,1,1520,A
2-PB1,206,0,1521,0,0,1521,T
2-PB1,207,1,1515,1,0,1517,T
2-PB1,208,0,0,1515,0,1515,G
2-PB1,209,1493,0,1,0,1494,A
2-PB1,210,1,1499,0,2,1502,T
2-PB1,211,2,1,1500,0,1503,G
2-PB1,212,0,3,1508,0,1511,G
2-PB1,213,1537,1,2,0,1540,A
2-PB1,214,1,0,0,1544,1545,C
2-PB1,215,0,1,0,1541,1542,C
2-PB1,216,1540,0,0,1,1541,A
2-PB1,217,2,0,0,1570,1572,C
2-PB1,218,0,1576,0,0,1576,T
2-PB1,219,1597,0,2,1,1600,A
2-PB1,220,0,0,0,1616,1616,C
2-PB1,221,1,0,0,1608,1609,C
2-PB1,222,0,1588,0,1,1589,T
2-PB1,223,0,0,1594,0,1594,G
2-PB1,224,1589,0,0,0,1589,A
2-PB1,225,0,0,1603,0,1603,G
2-PB1,226,0,0,1586,0,1586,G
2-PB1,227,1578,0,0,0,1578,A
2-PB1,228,0,1571,0,0,1571,T
2-PB1,229,1545,0,0,0,1545,A
2-PB1,230,1545,0,0,0,1545,A
2-PB1,231,0,1545,0,0,1545,T
2-PB1,232,0,0,1540,0,1540,G
2-PB1,233,1544,1,0,0,1545,A
2-PB1,234,1530,0,1,0,1531,A
2-PB1,235,0,0,0,1527,1527,C
2-PB1,236,0,0,0,1508,1508,C
2-PB1,237,1508,0,3,0,1511,A
2-PB1,238,1515,0,0,0,1515,A
2-PB1,239,0,0,1526,0,1526,G
2-PB1,240,0,1525,0,0,1525,T
2-PB1,241,0,4,1521,0,1525,G
2-PB1,242,0,0,1543,0,1543,G
2-PB1,243,1542,0,1,0,1543,A
2-PB1,244,0,1540,0,0,1540,T
2-PB1,245,1542,0,0,0,1542,A
2-PB1,246,1,1573,0,1,1575,T
2-PB1,247,1,0,1574,0,1575,G
2-PB1,248,0,1,0,1575,1576,C
2-PB1,249,1571,2,1,0,1574,A
2-PB1,250,0,1,0,1608,1609,C
2-PB1,251,1586,0,0,0,1586,A
2-PB1,252,1614,3,0,0,1617,A
2-PB1,253,1614,0,0,0,1614,A
2-PB1,254,0,0,0,1617,1617,C
2-PB1,255,1580,0,1,0,1581,A
2-PB1,256,0,0,1600,0,1600,G
2-PB1,257,1592,0,0,0,1592,A
2-PB1,258,0,0,0,1597,1597,C
2-PB1,259,0,1552,0,1,1553,T
2-PB1,260,0,0,1575,0,1575,G
2-PB1,261,0,1557,0,1,1558,T
2-PB1,262,1,0,1616,0,1617,G
2-PB1,263,0,1616,0,1,1617,T
2-PB1,264,0,0,0,1629,1629,C
2-PB1,265,0,0,0,1622,1622,C
2-PB1,266,0,1622,1,2,1625,T
2-PB1,267,0,0,1618,0,1618,G
2-PB1,268,0,0,1623,0,1623,G
2-PB1,269,1597,0,0,0,1597,A
2-PB1,270,0,0,1632,0,1632,G
2-PB1,271,0,0,1597,0,1597,G
2-PB1,272,0,0,0,1602,1602,C
2-PB1,273,1,1593,0,0,1594,T
2-PB1,274,1591,0,1,0,1592,A
2-PB1,275,0,1589,0,1,1590,T
2-PB1,276,0,1,1593,0,1594,G
2-PB1,277,2,0,1596,0,1598,G
2-PB1,278,1,1,0,1590,1592,C
2-PB1,279,1,0,0,1579,1580,C
2-PB1,280,1,1574,0,0,1575,T
2-PB1,281,1,1656,0,0,1657,T
2-PB1,282,0,0,0,1662,1662,C
2-PB1,283,1,0,0,1668,1669,C
2-PB1,284,0,1668,0,0,1668,T
2-PB1,285,0,1668,0,0,1668,T
2-PB1,286,1,1,1676,0,1678,G
2-PB1,287,1675,0,0,0,1675,A
2-PB1,288,1680,0,0,0,1680,A
2-PB1,289,0,1,1682,0,1683,G
2-PB1,290,1613,0,0,1,1614,A
2-PB1,291,1624,1,0,0,1625,A
2-PB1,292,0,1620,0,0,1620,T
2-PB1,293,1,0,0,1624,1625,C
2-PB1,294,0,0,0,1620,1620,C
2-PB1,295,3,0,0,1619,1622,C
2-PB1,296,1631,1,1,0,1633,A
2-PB1,297,0,0,0,1633,1633,C
2-PB1,298,1,0,0,1634,1635,C
2-PB1,299,0,1,1,1638,1640,C
2-PB1,300,1618,0,1,0,1619,A
2-PB1,301,0,0,1634,0,1634,G
2-PB1,302,1,1,1638,0,1640,G
2-PB1,303,0,1637,0,1,1638,T
2-PB1,304,1654,0,0,0,1654,A
2-PB1,305,1,1646,0,0,1647,T
2-PB1,306,0,0,0,1652,1652,C
2-PB1,307,0,1658,0,1,1659,T
2-PB1,308,0,1662,0,0,1662,T
2-PB1,309,0,1660,0,0,1660,T
2-PB1,310,1,0,1653,0,1654,G
2-PB1,311,1641,1,1,0,1643,A
2-PB1,312,0,1,1646,0,1647,G
2-PB1,313,1636,0,0,0,1636,A
2-PB1,314,1643,0,2,0,1645,A
2-PB1,315,0,0,0,1654,1654,C
2-PB1,316,0,1645,0,0,1645,T
2-PB1,317,1,0,0,1646,1647,C
2-PB1,318,1646,0,0,0,1646,A
2-PB1,319,0,1646,0,1,1647,T
2-PB1,320,2,0,1648,0,1650,G
2-PB1,321,0,1,0,1684,1685,C
2-PB1,322,1,0,0,1691,1692,C
2-PB1,323,0,1688,1,1,1690,T
2-PB1,324,0,1677,0,0,1677,T
2-PB1,325,0,0,1685,0,1685,G
2-PB1,326,1701,0,0,0,1701,A
2-PB1,327,1699,0,1,0,1700,A
2-PB1,328,1704,0,0,0,1704,A
2-PB1,329,0,2,0,1705,1707,C
2-PB1,330,1672,0,0,0,1672,A
2-PB1,331,1674,1,0,0,1675,A
2-PB1,332,0,1679,0,1,1680,T
2-PB1,333,0,1,1677,0,1678,G
2-PB1,334,0,0,1677,0,1677,G
2-PB1,335,1659,0,0,0,1659,A
2-PB1,336,1659,0,0,0,1659,A
2-PB1,337,1,0,1657,0,1658,G
2-PB1,338,0,0,0,1656,1656,C
2-PB1,339,1,0,0,1651,1652,C
2-PB1,340,0,0,1668,0,1668,G
2-PB1,341,0,1667,0,1,1668,T
2-PB1,342,0,1667,0,0,1667,T
2-PB1,343,1,0,0,1681,1682,C
2-PB1,344,1683,0,0,0,1683,A
2-PB1,345,1696,0,2,0,1698,A
2-PB1,346,0,0,0,1700,1700,C
2-PB1,347,1711,0,1,0,1712,A
2-PB1,348,2,2,1723,0,1727,G
2-PB1,349,1707,0,0,0,1707,A
2-PB1,350,0,0,0,1710,1710,C
2-PB1,351,1708,0,0,0,1708,A
2-PB1,352,1706,0,6,0,1712,A
2-PB1,353,0,2,1728,0,1730,G
2-PB1,354,0,1,1722,0,1723,G
2-PB1,355,0,0,1725,0,1725,G
2-PB1,356,0,1693,0,0,1693,T
2-PB1,357,1,1,1699,0,1701,G
2-PB1,358,1,2,1695,0,1698,G
2-PB1,359,1697,1,3,0,1701,A
2-PB1,360,0,1,0,1700,1701,C
2-PB1,361,1675,0,1,0,1676,A
2-PB1,362,1691,0,0,0,1691,A
2-PB1,363,1688,0,0,1,1689,A
2-PB1,364,0,0,0,1687,1687,C
2-PB1,365,0,1677,0,1,1678,T
2-PB1,366,1676,0,0,0,1676,A
2-PB1,367,1690,0,1,0,1691,A
2-PB1,368,1,1,0,1690,1692,C
2-PB1,369,1,0,0,1688,1689,C
2-PB1,370,2,0,0,1687,1689,C
2-PB1,371,1641,0,0,0,1641,A
2-PB1,372,1645,0,0,0,1645,A
2-PB1,373,0,0,1648,0,1648,G
2-PB1,374,0,0,1650,0,1650,G
2-PB1,375,0,1643,0,1,1644,T
2-PB1,376,1,1,0,1641,1643,C
2-PB1,377,1,0,1640,0,1641,G
2-PB1,378,1,1,0,1625,1627,C
2-PB1,379,0,1,0,1645,1646,C
2-PB1,380,1645,0,0,0,1645,A
2-PB1,381,0,0,1662,1,1663,G
2-PB1,382,1683,0,1,0,1684,A
2-PB1,383,0,0,0,1685,1685,C
2-PB1,384,0,1678,0,0,1678,T
2-PB1,385,0,1677,1,0,1678,T
2-PB1,386,1679,0,0,1,1680,A
2-PB1,387,0,1682,0,0,1682,T
2-PB1,388,1,1,1682,0,1684,G
2-PB1,389,1686,0,0,0,1686,A
2-PB1,390,0,1653,0,0,1653,T
2-PB1,391,0,1614,0,1,1615,T
2-PB1,392,0,0,1612,0,1612,G
2-PB1,393,0,1,1607,0,1608,G
2-PB1,394,1626,2,1,0,1629,A
2-PB1,395,0,0,0,1627,1627,C
2-PB1,396,1614,0,0,0,1614,A
2-PB1,397,0,1598,0,0,1598,T
2-PB1,398,0,1608,0,0,1608,T
2-PB1,399,1613,1,1,1,1616,A
2-PB1,400,1612,1,1,0,1614,A
2-PB1,401,1618,0,0,0,1618,A
2-PB1,402,0,1,0,1616,1617,C
2-PB1,403,1593,1,1,0,1595,A
2-PB1,404,0,0,1601,0,1601,G
2-PB1,405,1591,0,1,0,1592,A
2-PB1,406,1594,0,2,0,1596,A
2-PB1,407,1592,1,0,0,1593,A
2-PB1,408,0,1584,1,0,1585,T
2-PB1,409,0,0,0,1584,1584,C
2-PB1,410,1581,0,0,0,1581,A
2-PB1,411,1585,0,1,0,1586,A
2-PB1,412,0,1,0,1577,1578,C
2-PB1,413,0,0,0,1577,1577,C
2-PB1,414,0,0,1575,0,1575,G
2-PB1,415,0,0,1579,0,1579,G
2-PB1,416,1,1,0,1575,1577,C
2-PB1,417,1574,0,0,1,1575,A
2-PB1,418,1,0,1570,0,1571,G
2-PB1,419,1,0,0,1586,1587,C
2-PB1,420,1589,0,0,0,1589,A
2-PB1,421,1589,0,0,0,1589,A
2-PB1,422,0,0,0,1590,1590,C
2-PB1,423,0,1592,0,0,1592,T
2-PB1,424,0,0,1637,0,1637,G
2-PB1,425,0,0,0,1637,1637,C
2-PB1,426,1634,4,0,0,1638,A
2-PB1,427,0,1632,0,2,1634,T
2-PB1,428,0,1612,0,0,1612,T
2-PB1,429,1689,1,0,3,1693,A
2-PB1,430,1,0,1687,0,1688,G
2-PB1,431,0,1,0,1675,1676,C
2-PB1,432,0,0,0,1680,1680,C
2-PB1,433,1621,0,0,0,1621,A
2-PB1,434,1624,0,0,0,1624,A
2-PB1,435,0,0,0,1630,1630,C
2-PB1,436,1633,1,0,0,1634,A
2-PB1,437,1,0,0,1670,1671,C
2-PB1,438,1,0,0,1560,1561,C
2-PB1,439,1559,0,0,0,1559,A
2-PB1,440,0,1555,0,1,1556,T
2-PB1,441,1559,0,2,0,1561,A
2-PB1,442,1,1,1561,0,1563,G
2-PB1,443,1548,0,0,0,1548,A
2-PB1,444,1542,0,1,0,1543,A
2-PB1,445,0,0,1546,0,1546,G
2-PB1,446,0,1499,0,0,1499,T
2-PB1,447,0,1501,1,0,1502,T
2-PB1,448,0,1500,0,0,1500,T
2-PB1,449,0,1499,0,0,1499,T
2-PB1,450,1,1506,1,0,1508,T
2-PB1,451,1506,0,0,0,1506,A
2-PB1,452,0,0,1506,0,1506,G
2-PB1,453,1504,0,1,0,1505,A
2-PB1,454,1,1494,0,0,1495,T
2-PB1,455,0,0,0,1473,1473,C
2-PB1,456,0,1,1477,0,1478,G
2-PB1,457,1478,0,0,0,1478,A
2-PB1,458,1480,1,1,0,1482,A
2-PB1,459,0,0,0,1483,1483,C
2-PB1,460,0,0,1487,0,1487,G
2-PB1,461,0,1,1535,0,1536,G
2-PB1,462,1540,0,0,0,1540,A
2-PB1,463,1,1533,0,2,1536,T
2-PB1,464,0,1535,0,0,1535,T
2-PB1,465,1536,0,4,0,1540,A
2-PB1,466,1535,0,1,0,1536,A
2-PB1,467,0,0,0,1541,1541,C
2-PB1,468,1529,0,1,0,1530,A
2-PB1,469,1,0,1554,0,1555,G
2-PB1,470,0,0,0,1496,1496,C
2-PB1,471,1,1487,0,0,1488,T
2-PB1,472,1488,0,0,0,1488,A
2-PB1,473,1490,0,0,0,1490,A
2-PB1,474,0,1487,0,0,1487,T
2-PB1,475,0,0,1500,0,1500,G
2-PB1,476,1494,0,0,0,1494,A
2-PB1,477,1497,0,0,0,1497,A
2-PB1,478,1,1470,0,0,1471,T
2-PB1,479,0,0,0,1484,1484,C
2-PB1,480,1476,0,0,0,1476,A
2-PB1,481,0,0,1473,1,1474,G
2-PB1,482,0,0,1477,0,1477,G
2-PB1,483,1469,0,1,0,1470,A
2-PB1,484,1452,1,0,0,1453,A
2-PB1,485,0,0,1497,0,1497,G
2-PB1,486,0,0,1497,0,1497,G
2-PB1,487,0,0,0,1497,1497,C
2-PB1,488,1,1496,0,0,1497,T
2-PB1,489,1497,0,0,1,1498,A
2-PB1,490,1492,1,0,0,1493,A
2-PB1,491,0,1493,0,0,1493,T
2-PB1,492,1495,1,0,0,1496,A
2-PB1,493,0,0,1500,0,1500,G
2-PB1,494,1404,0,0,0,1404,A
2-PB1,495,0,1396,0,0,1396,T
2-PB1,496,0,1400,0,0,1400,T
2-PB1,497,0,1392,0,0,1392,T
2-PB1,498,1,0,0,1428,1429,C
2-PB1,499,2,0,0,1433,1435,C
2-PB1,500,2,1426,0,3,1431,T
2-PB1,501,1,0,0,1433,1434,C
2-PB1,502,1428,0,1,0,1429,A
2-PB1,503,1429,0,1,0,1430,A
2-PB1,504,0,0,1434,0,1434,G
2-PB1,505,0,0,1442,0,1442,G
2-PB1,506,1441,0,1,0,1442,A
2-PB1,507,0,1387,0,0,1387,T
2-PB1,508,1,0,1397,0,1398,G
2-PB1,509,0,1394,0,0,1394,T
2-PB1,510,0,0,1403,0,1403,G
2-PB1,511,1405,0,0,0,1405,A
2-PB1,512,0,1402,0,1,1403,T
2-PB1,513,0,0,1388,0,1388,G
2-PB1,514,0,2,1377,0,1379,G
2-PB1,515,1378,1,2,0,1381,A
2-PB1,516,1385,0,0,0,1385,A
2-PB1,517,1,1368,0,1,1370,T
2-PB1,518,0,1,0,1367,1368,C
2-PB1,519,1353,3,0,0,1356,A
2-PB1,520,1359,0,0,1,1360,A
2-PB1,521,0,1359,0,0,1359,T
2-PB1,522,0,1,1361,0,1362,G
2-PB1,523,0,0,1369,0,1369,G
2-PB1,524,1363,0,0,0,1363,A
2-PB1,525,0,1364,0,0,1364,T
2-PB1,526,1361,1,0,0,1362,A
2-PB1,527,1361,1,0,0,1362,A
2-PB1,528,1360,0,1,0,1361,A
2-PB1,529,0,0,1367,0,1367,G
2-PB1,530,1356,2,0,0,1358,A
2-PB1,531,0,2,1347,0,1349,G
2-PB1,532,1,1,1347,0,1349,G
2-PB1,533,1341,0,2,0,1343,A
2-PB1,534,1344,0,0,0,1344,A
2-PB1,535,1344,0,1,0,1345,A
2-PB1,536,0,1340,0,0,1340,T
2-PB1,537,0,1,1368,0,1369,G
2-PB1,538,0,0,1368,0,1368,G
2-PB1,539,1350,0,5,0,1355,A
2-PB1,540,0,0,1365,0,1365,G
2-PB1,541,1350,0,1,0,1351,A
2-PB1,542,0,1374,0,1,1375,T
2-PB1,543,1377,0,1,0,1378,A
2-PB1,544,1387,0,0,0,1387,A
2-PB1,545,1,0,0,1387,1388,C
2-PB1,546,1359,0,0,0,1359,A
2-PB1,547,1360,1,1,0,1362,A
2-PB1,548,0,0,0,1360,1360,C
2-PB1,549,1343,1,0,0,1344,A
2-PB1,550,0,0,0,1343,1343,C
2-PB1,551,1307,1,0,0,1308,A
2-PB1,552,0,1,0,1313,1314,C
2-PB1,553,0,1291,0,1,1292,T
2-PB1,554,0,1294,0,0,1294,T
2-PB1,555,1,1303,0,0,1304,T
2-PB1,556,0,1,0,1301,1302,C
2-PB1,557,1300,0,0,0,1300,A
2-PB1,558,1295,0,1,0,1296,A
2-PB1,559,1301,1,1,0,1303,A
2-PB1,560,0,0,1310,0,1310,G
2-PB1,561,1294,2,1,1,1298,A
2-PB1,562,1299,0,0,0,1299,A
2-PB1,563,1301,0,0,0,1301,A
2-PB1,564,1302,0,0,0,1302,A
2-PB1,565,1301,0,1,0,1302,A
2-PB1,566,0,0,1305,0,1305,G
2-PB1,567,0,1,1299,0,1300,G
2-PB1,568,1281,0,1,0,1282,A
2-PB1,569,0,0,1309,1,1310,G
2-PB1,570,1306,0,0,0,1306,A
2-PB1,571,1,0,1354,0,1355,G
2-PB1,572,1,1350,0,0,1351,T
2-PB1,573,1351,0,0,0,1351,A
2-PB1,574,1350,1,1,1,1353,A
2-PB1,575,0,0,1361,1,1362,G
2-PB1,576,1,1,1374,0,1376,G
2-PB1,577,0,0,1379,0,1379,G
2-PB1,578,1353,1,3,0,1357,A
2-PB1,579,0,0,0,1367,1367,C
2-PB1,580,1317,0,0,0,1317,A
2-PB1,581,1318,0,0,0,1318,A
2-PB1,582,0,0,0,1317,1317,C
2-PB1,583,1309,0,1,0,1310,A
2-PB1,584,0,1300,0,0,1300,T
2-PB1,585,0,2,1290,1,1293,G
2-PB1,586,1295,0,1,0,1296,A
2-PB1,587,0,0,0,1290,1290,C
2-PB1,588,1,1,0,1273,1275,C
2-PB1,589,1275,0,0,0,1275,A
2-PB1,590,1271,0,0,0,1271,A
2-PB1,591,0,0,1283,0,1283,G
2-PB1,592,1284,0,1,0,1285,A
2-PB1,593,1286,0,0,1,1287,A
2-PB1,594,1284,0,0,0,1284,A
2-PB1,595,1282,0,0,0,1282,A
2-PB1,596,0,1280,0,0,1280,T
2-PB1,597,1,1,1277,0,1279,G
2-PB1,598,0,0,1288,0,1288,G
2-PB1,599,0,1277,0,1,1278,T
2-PB1,600,1,0,0,1274,1275,C
2-PB1,601,1288,0,0,0,1288,A
2-PB1,602,0,0,0,1431,1431,C
2-PB1,603,1480,0,1,0,1481,A
2-PB1,604,0,1,0,1500,1501,C
2-PB1,605,1502,0,0,0,1502,A
2-PB1,606,1599,0,0,0,1599,A
2-PB1,607,1591,0,2,0,1593,A
2-PB1,608,0,0,1770,0,1770,G
2-PB1,609,1767,0,1,0,1768,A
2-PB1,610,1787,0,0,0,1787,A
2-PB1,611,0,0,0,1878,1878,C
2-PB1,612,1835,0,0,0,1835,A
2-PB1,613,1860,0,0,0,1860,A
2-PB1,614,0,1854,0,2,1856,T
2-PB1,615,1839,0,1,0,1840,A
2-PB1,616,1,2,1846,0,1849,G
2-PB1,617,0,0,1803,0,1803,G
2-PB1,618,1,1,1799,0,1801,G
2-PB1,619,1799,0,0,0,1799,A
2-PB1,620,1793,1,1,0,1795,A
2-PB1,621,0,1,1831,0,1832,G
2-PB1,622,1832,0,0,0,1832,A
2-PB1,623,1835,0,0,0,1835,A
2-PB1,624,1844,0,0,0,1844,A
2-PB1,625,1844,0,0,2,1846,A
2-PB1,626,1919,0,0,0,1919,A
2-PB1,627,1918,0,0,1,1919,A
2-PB1,628,0,0,0,1925,1925,C
2-PB1,629,1918,0,0,0,1918,A
2-PB1,630,1915,1,1,0,1917,A
2-PB1,631,1907,0,0,0,1907,A
2-PB1,632,1,0,1964,0,1965,G
2-PB1,633,1967,0,0,0,1967,A
2-PB1,634,0,0,2024,0,2024,G
2-PB1,635,0,2008,0,0,2008,T
2-PB1,636,0,1,2161,0,2162,G
2-PB1,637,2164,0,4,0,2168,A
2-PB1,638,2179,0,0,0,2179,A
2-PB1,639,1,2232,0,1,2234,T
2-PB1,640,2277,0,0,1,2278,A
2-PB1,641,2283,0,1,0,2284,A
2-PB1,642,0,0,2284,0,2284,G
2-PB1,643,2265,0,0,0,2265,A
2-PB1,644,2199,0,1,0,2200,A
2-PB1,645,2235,1,2,1,2239,A
2-PB1,646,1,0,2267,0,2268,G
2-PB1,647,1,1,2270,0,2272,G
2-PB1,648,0,0,0,2260,2260,C
2-PB1,649,1,2244,0,1,2246,T
2-PB1,650,2339,0,1,1,2341,A
2-PB1,651,0,1,1,2523,2525,C
2-PB1,652,3,0,0,2531,2534,C
2-PB1,653,0,2566,0,3,2569,T
2-PB1,654,2713,0,0,0,2713,A
2-PB1,655,2707,0,0,1,2708,A
2-PB1,656,0,2711,0,1,2712,T
2-PB1,657,2707,0,0,0,2707,A
2-PB1,658,2705,0,0,1,2706,A
2-PB1,659,0,2,2722,0,2724,G
2-PB1,660,2688,0,2,0,2690,A
2-PB1,661,1,0,2708,0,2709,G
2-PB1,662,0,0,0,2727,2727,C
2-PB1,663,0,2689,0,2,2691,T
2-PB1,664,0,2709,0,1,2710,T
2-PB1,665,0,2711,0,0,2711,T
2-PB1,666,1,1,2714,0,2716,G
2-PB1,667,2773,0,2,0,2775,A
2-PB1,668,0,0,0,2788,2788,C
2-PB1,669,2795,1,0,0,2796,A
2-PB1,670,1,2780,0,2,2783,T
2-PB1,671,1,2762,0,1,2764,T
2-PB1,672,1,0,2834,1,2836,G
2-PB1,673,2830,2,3,0,2835,A
2-PB1,674,2839,0,3,0,2842,A
2-PB1,675,2,1,0,2847,2850,C
2-PB1,676,2843,2,2,0,2847,A
2-PB1,677,0,0,0,2849,2849,C
2-PB1,678,2,2,2841,0,2845,G
2-PB1,679,2857,0,0,0,2857,A
2-PB1,680,0,2858,0,1,2859,T
2-PB1,681,1,5,2945,1,2952,G
2-PB1,682,2955,0,1,1,2957,A
2-PB1,683,1,0,0,2964,2965,C
2-PB1,684,1,1,0,2958,2960,C
2-PB1,685,2970,2,0,0,2972,A
2-PB1,686,3013,0,1,0,3014,A
2-PB1,687,3013,0,3,0,3016,A
2-PB1,688,1,0,3103,0,3104,G
2-PB1,689,3151,0,4,0,3155,A
2-PB1,690,0,3139,1,2,3142,T
2-PB1,691,0,0,3152,0,3152,G
2-PB1,692,1,3,0,3139,3143,C
2-PB1,693,3145,0,3,0,3148,A
2-PB1,694,0,0,3194,0,3194,G
2-PB1,695,3162,1,2,0,3165,A
2-PB1,696,0,1,3177,0,3178,G
2-PB1,697,3124,0,0,0,3124,A
2-PB1,698,0,0,3114,1,3115,G
2-PB1,699,3102,1,2,0,3105,A
2-PB1,700,1,0,3098,0,3099,G
2-PB1,701,0,1,3099,0,3100,G
2-PB1,702,0,0,0,3090,3090,C
2-PB1,703,3094,1,0,0,3095,A
2-PB1,704,3100,2,0,0,3102,A
2-PB1,705,3127,1,2,0,3130,A
2-PB1,706,1,3137,2,0,3140,T
2-PB1,707,1,3140,0,1,3142,T
2-PB1,708,3148,2,1,0,3151,A
2-PB1,709,3141,0,0,1,3142,A
2-PB1,710,3150,0,2,0,3152,A
2-PB1,711,3161,0,1,0,3162,A
2-PB1,712,3171,1,0,0,3172,A
2-PB1,713,1,0,3175,1,3177,G
2-PB1,714,3156,1,1,0,3158,A
2-PB1,715,3155,1,2,0,3158,A
2-PB1,716,0,5,3204,0,3209,G
2-PB1,717,0,0,3293,0,3293,G
2-PB1,718,0,1,3299,0,3300,G
2-PB1,719,0,0,0,3318,3318,C
2-PB1,720,0,3323,0,1,3324,T
2-PB1,721,3342,0,2,1,3345,A
2-PB1,722,0,3410,0,0,3410,T
2-PB1,723,1,3413,0,1,3415,T
2-PB1,724,2,0,3423,1,3426,G
2-PB1,725,2,1,0,3423,3426,C
2-PB1,726,3381,0,3,0,3384,A
2-PB1,727,3384,0,0,0,3384,A
2-PB1,728,0,0,0,3392,3392,C
2-PB1,729,3398,0,0,0,3398,A
2-PB1,730,1,1,1,3391,3394,C
2-PB1,731,2,2,0,3328,3332,C
2-PB1,732,3,0,0,3333,3336,C
2-PB1,733,2,5,3335,0,3342,G
2-PB1,734,2,2,3347,0,3351,G
2-PB1,735,0,0,3349,0,3349,G
2-PB1,736,3373,2,1,0,3376,A
2-PB1,737,0,3361,0,2,3363,T
2-PB1,738,1,0,3370,0,3371,G
2-PB1,739,1,2,0,3352,3355,C
2-PB1,740,3410,0,0,0,3410,A
2-PB1,741,3473,1,3,1,3478,A
2-PB1,742,3525,1,0,0,3526,A
2-PB1,743,0,3531,0,0,3531,T
2-PB1,744,0,3532,0,1,3533,T
2-PB1,745,3518,0,4,0,3522,A
2-PB1,746,0,1,3515,0,3516,G
2-PB1,747,3508,1,1,0,3510,A
2-PB1,748,0,2,3526,1,3529,G
2-PB1,749,0,3,3489,0,3492,G
2-PB1,750,1,1,3610,0,3612,G
2-PB1,751,0,3644,0,5,3649,T
2-PB1,752,0,3649,0,0,3649,T
2-PB1,753,0,2,0,3656,3658,C
2-PB1,754,0,0,3691,0,3691,G
2-PB1,755,0,3688,0,3,3691,T
2-PB1,756,1,0,3702,0,3703,G
2-PB1,757,0,3695,0,1,3696,T
2-PB1,758,3683,0,0,0,3683,A
2-PB1,759,1,0,0,3680,3681,C
2-PB1,760,1,3545,1,2,3549,T
2-PB1,761,0,3565,0,2,3567,T
2-PB1,762,0,3,0,3548,3551,C
2-PB1,763,1,1,3546,0,3548,G
2-PB1,764,0,3544,0,0,3544,T
2-PB1,765,0,3538,0,4,3542,T
2-PB1,766,0,0,3543,0,3543,G
2-PB1,767,3530,0,3,2,3535,A
2-PB1,768,3532,0,0,1,3533,A
2-PB1,769,3561,0,1,0,3562,A
2-PB1,770,1,0,0,3573,3574,C
2-PB1,771,0,3555,0,3,3558,T
2-PB1,772,0,3547,0,2,3549,T
2-PB1,773,0,3559,0,1,3560,T
2-PB1,774,3634,0,2,1,3637,A
2-PB1,775,0,0,3647,0,3647,G
2-PB1,776,0,2,0,3654,3656,C
2-PB1,777,0,3654,0,2,3656,T
2-PB1,778,3617,1,1,1,3620,A
2-PB1,779,0,0,3621,0,3621,G
2-PB1,780,3621,0,0,1,3622,A
2-PB1,781,3626,2,0,0,3628,A
2-PB1,782,1,1,3626,0,3628,G
2-PB1,783,2,2,0,3585,3589,C
2-PB1,784,3585,0,1,0,3586,A
2-PB1,785,2,3577,0,0,3579,T
2-PB1,786,0,3571,0,1,3572,T
2-PB1,787,0,3578,1,2,3581,T
2-PB1,788,1,0,3589,1,3591,G
2-PB1,789,0,2,1,3583,3586,C
2-PB1,790,0,0,3590,0,3590,G
2-PB1,791,3578,0,3,1,3582,A
2-PB1,792,3576,0,0,0,3576,A
2-PB1,793,3577,1,0,0,3578,A
2-PB1,794,3684,0,0,0,3684,A
2-PB1,795,0,1,3726,0,3727,G
2-PB1,796,0,0,0,3733,3733,C
2-PB1,797,1,3728,0,0,3729,T
2-PB1,798,0,3735,0,1,3736,T
2-PB1,799,0,1,3735,0,3736,G
2-PB1,800,3724,1,7,1,3733,A
2-PB1,801,3726,0,4,0,3730,A
2-PB1,802,0,1,0,3744,3745,C
2-PB1,803,3692,0,2,0,3694,A
2-PB1,804,1,0,4067,0,4068,G
2-PB1,805,0,4055,0,3,4058,T
2-PB1,806,1,2,0,4065,4068,C
2-PB1,807,0,4071,0,2,4073,T
2-PB1,808,1,1,4066,2,4070,G
2-PB1,809,1,3,4072,2,4078,G
2-PB1,810,4084,1,1,1,4087,A
2-PB1,811,0,0,0,4100,4100,C
2-PB1,812,0,4000,0,4,4004,T
2-PB1,813,1,3822,1,1,3825,T
2-PB1,814,0,0,0,3824,3824,C
2-PB1,815,4,2,0,3822,3828,C
2-PB1,816,0,2,3843,0,3845,G
2-PB1,817,0,0,3857,0,3857,G
2-PB1,818,1,3839,0,1,3841,T
2-PB1,819,0,3841,0,1,3842,T
2-PB1,820,1,6,3819,0,3826,G
2-PB1,821,3,4,3830,0,3837,G
2-PB1,822,4,8,3847,0,3859,G
2-PB1,823,1,1,3859,0,3861,G
2-PB1,824,2,0,3880,0,3882,G
2-PB1,825,0,3866,1,2,3869,T
2-PB1,826,3885,0,0,0,3885,A
2-PB1,827,3890,0,2,0,3892,A
2-PB1,828,1,3899,1,2,3903,T
2-PB1,829,0,3,3919,0,3922,G
2-PB1,830,3894,1,1,0,3896,A
2-PB1,831,3856,0,1,1,3858,A
2-PB1,832,3855,0,0,0,3855,A
2-PB1,833,3842,0,1,0,3843,A
2-PB1,834,0,1,3838,0,3839,G
2-PB1,835,3812,2,3,0,3817,A
2-PB1,836,3803,0,3,0,3806,A
2-PB1,837,1,0,3828,0,3829,G
2-PB1,838,0,1,3822,0,3823,G
2-PB1,839,1,0,0,3805,3806,C
2-PB1,840,2,2,1,3806,3811,C
2-PB1,841,3817,0,1,1,3819,A
2-PB1,842,3819,1,1,0,3821,A
2-PB1,843,3824,0,3,0,3827,A
2-PB1,844,1,1,1,3826,3829,C
2-PB1,845,0,3822,0,3,3825,T
2-PB1,846,0,2,3881,0,3883,G
2-PB1,847,4,2,3863,0,3869,G
2-PB1,848,1,1,0,3875,3877,C
2-PB1,849,3887,2,0,0,3889,A
2-PB1,850,3876,2,2,0,3880,A
2-PB1,851,3877,0,3,1,3881,A
2-PB1,852,0,3892,0,1,3893,T
2-PB1,853,1,0,3899,0,3900,G
2-PB1,854,0,3890,0,1,3891,T
2-PB1,855,0,3828,0,1,3829,T
2-PB1,856,1,0,3837,1,3839,G
2-PB1,857,0,3831,0,1,3832,T
2-PB1,858,2,1,3838,1,3842,G
2-PB1,859,3846,0,0,0,3846,A
2-PB1,860,0,1,3868,0,3869,G
2-PB1,861,3856,1,2,0,3859,A
2-PB1,862,3839,0,1,0,3840,A
2-PB1,863,3838,2,1,0,3841,A
2-PB1,864,3846,2,2,0,3850,A
2-PB1,865,3859,0,2,3,3864,A
2-PB1,866,0,3857,0,0,3857,T
2-PB1,867,0,0,3858,0,3858,G
2-PB1,868,3845,2,2,0,3849,A
2-PB1,869,0,3826,0,0,3826,T
2-PB1,870,2,0,3852,0,3854,G
2-PB1,871,3857,1,5,0,3863,A
2-PB1,872,0,1,0,3903,3904,C
2-PB1,873,1,3899,1,2,3903,T
2-PB1,874,3903,1,2,0,3906,A
2-PB1,875,3948,0,2,0,3950,A
2-PB1,876,0,3949,0,1,3950,T
2-PB1,877,1,3996,1,0,3998,T
2-PB1,878,1,1,0,4019,4021,C
2-PB1,879,4014,2,2,0,4018,A
2-PB1,880,1,1,0,4022,4024,C
2-PB1,881,3991,0,1,0,3992,A
2-PB1,882,4005,0,2,0,4007,A
2-PB1,883,0,0,4007,0,4007,G
2-PB1,884,4051,2,5,2,4060,A
2-PB1,885,0,2,0,4053,4055,C
2-PB1,886,4015,0,3,1,4019,A
2-PB1,887,0,0,0,4024,4024,C
2-PB1,888,3984,0,3,0,3987,A
2-PB1,889,0,0,4012,0,4012,G
2-PB1,890,3990,0,6,0,3996,A
2-PB1,891,0,1,4008,0,4009,G
2-PB1,892,2,0,0,3996,3998,C
2-PB1,893,0,3939,1,4,3944,T
2-PB1,894,0,3992,0,0,3992,T
2-PB1,895,0,3981,1,1,3983,T
2-PB1,896,3,0,0,3998,4001,C
2-PB1,897,4,3994,0,0,3998,T
2-PB1,898,0,3983,0,1,3984,T
2-PB1,899,0,3979,0,2,3981,T
2-PB1,900,1,2,1,3978,3982,C
2-PB1,901,3971,1,2,0,3974,A
2-PB1,902,0,0,0,4004,4004,C
2-PB1,903,3959,0,1,0,3960,A
2-PB1,904,3974,0,2,0,3976,A
2-PB1,905,0,4008,0,1,4009,T
2-PB1,906,2,0,0,4056,4058,C
2-PB1,907,4094,0,0,0,4094,A
2-PB1,908,0,0,0,4118,4118,C
2-PB1,909,1,4054,1,49,4105,T
2-PB1,910,1,1,4130,0,4132,G
2-PB1,911,1,3,4110,0,4114,G
2-PB1,912,1,1,4219,0,4221,G
2-PB1,913,1,2,4224,0,4227,G
2-PB1,914,4160,0,5,0,4165,A
2-PB1,915,0,2,0,4056,4058,C
2-PB1,916,4098,1,2,1,4102,A
2-PB1,917,4340,0,2,0,4342,A
2-PB1,918,1,0,0,4371,4372,C
2-PB1,919,4365,1,1,0,4367,A
2-PB1,920,0,0,1,4361,4362,C
2-PB1,921,0,4213,0,1,4214,T
2-PB1,922,4226,0,1,0,4227,A
2-PB1,923,4221,0,1,0,4222,A
2-PB1,924,1,1,4242,0,4244,G
2-PB1,925,0,4240,0,0,4240,T
2-PB1,926,0,2,3987,1,3990,G
2-PB1,927,0,2,3968,0,3970,G
2-PB1,928,3953,1,1,0,3955,A
2-PB1,929,3967,1,1,0,3969,A
2-PB1,930,0,3971,0,0,3971,T
2-PB1,931,0,0,3961,0,3961,G
2-PB1,932,3951,1,2,2,3956,A
2-PB1,933,3909,0,3,0,3912,A
2-PB1,934,3937,1,1,0,3939,A
2-PB1,935,3945,2,0,0,3947,A
2-PB1,936,0,3931,0,1,3932,T
2-PB1,937,0,1,0,3931,3932,C
2-PB1,938,3929,0,2,0,3931,A
2-PB1,939,3927,0,0,0,3927,A
2-PB1,940,3928,0,0,0,3928,A
2-PB1,941,3921,3,3,0,3927,A
2-PB1,942,1,0,0,3932,3933,C
2-PB1,943,2,2,0,3896,3900,C
2-PB1,944,5,1,0,3891,3897,C
2-PB1,945,0,3876,0,5,3881,T
2-PB1,946,0,0,1,3891,3892,C
2-PB1,947,0,0,3883,2,3885,G
2-PB1,948,3898,0,2,0,3900,A
2-PB1,949,3888,0,2,0,3890,A
2-PB1,950,1,3893,1,2,3897,T
2-PB1,951,1,0,3923,0,3924,G
2-PB1,952,1,3895,1,1,3898,T
2-PB1,953,2,3889,0,1,3892,T
2-PB1,954,0,3888,0,0,3888,T
2-PB1,955,0,3890,0,2,3892,T
2-PB1,956,1,3891,2,0,3894,T
2-PB1,957,2,1,3891,0,3894,G
2-PB1,958,0,0,3884,1,3885,G
2-PB1,959,1,1,0,3879,3881,C
2-PB1,960,3,0,3875,0,3878,G
2-PB1,961,3876,1,3,0,3880,A
2-PB1,962,2,3982,0,1,3985,T
2-PB1,963,0,0,4130,0,4130,G
2-PB1,964,4356,0,1,0,4357,A
2-PB1,965,1,4372,0,1,4374,T
2-PB1,966,0,4380,0,0,4380,T
2-PB1,967,4391,2,3,0,4396,A
2-PB1,968,0,1,1,4403,4405,C
2-PB1,969,4423,1,5,0,4429,A
2-PB1,970,0,4417,1,1,4419,T
2-PB1,971,4224,2,2,0,4228,A
2-PB1,972,2,0,0,4255,4257,C
2-PB1,973,3948,0,1,0,3949,A
2-PB1,974,1,3951,0,0,3952,T
2-PB1,975,0,0,1,3949,3950,C
2-PB1,976,3934,2,0,0,3936,A
2-PB1,977,1,0,1,3940,3942,C
2-PB1,978,3922,0,2,0,3924,A
2-PB1,979,3922,0,2,0,3924,A
2-PB1,980,3917,2,0,0,3919,A
2-PB1,981,2,1,3819,0,3822,G
2-PB1,982,3968,0,1,0,3969,A
2-PB1,983,3979,0,0,0,3979,A
2-PB1,984,2,3974,1,1,3978,T
2-PB1,985,1,0,0,3974,3975,C
2-PB1,986,4019,0,3,0,4022,A
2-PB1,987,4051,0,1,0,4052,A
2-PB1,988,2,1,0,4060,4063,C
2-PB1,989,0,0,0,4055,4055,C
2-PB1,990,0,3907,0,1,3908,T
2-PB1,991,0,1,3939,1,3941,G
2-PB1,992,3931,2,2,0,3935,A
2-PB1,993,1,0,3942,0,3943,G
2-PB1,994,1,3919,1,0,3921,T
2-PB1,995,0,3,3858,0,3861,G
2-PB1,996,0,0,4108,0,4108,G
2-PB1,997,1,4086,0,0,4087,T
2-PB1,998,1,4089,0,2,4092,T
2-PB1,999,1,2,0,4095,4098,C
2-PB1,1000,4072,0,3,1,4076,A
2-PB1,1001,0,1,4168,0,4169,G
2-PB1,1002,4162,0,0,0,4162,A
2-PB1,1003,4154,0,3,0,4157,A
2-PB1,1004,4146,1,1,0,4148,A
2-PB1,1005,0,1,0,3889,3890,C
2-PB1,1006,3948,0,1,0,3949,A
2-PB1,1007,0,3931,1,3,3935,T
2-PB1,1008,0,0,0,3990,3990,C
2-PB1,1009,0,1,0,3992,3993,C
2-PB1,1010,1,3893,0,1,3895,T
2-PB1,1011,0,1,3906,0,3907,G
2-PB1,1012,3892,0,2,0,3894,A
2-PB1,1013,1,0,3941,0,3942,G
2-PB1,1014,0,0,0,3923,3923,C
2-PB1,1015,3830,0,0,0,3830,A
2-PB1,1016,1,3835,0,1,3837,T
2-PB1,1017,1,0,1,3804,3806,C
2-PB1,1018,1,1,3791,0,3793,G
2-PB1,1019,2,1,0,3881,3884,C
2-PB1,1020,3906,1,0,0,3907,A
2-PB1,1021,1,2,0,4071,4074,C
2-PB1,1022,0,2,0,4059,4061,C
2-PB1,1023,4051,1,4,0,4056,A
2-PB1,1024,4119,1,1,1,4122,A
2-PB1,1025,1,4117,0,0,4118,T
2-PB1,1026,4122,0,1,0,4123,A
2-PB1,1027,4124,1,0,0,4125,A
2-PB1,1028,0,4014,1,0,4015,T
2-PB1,1029,2,0,4026,0,4028,G
2-PB1,1030,0,3939,0,1,3940,T
2-PB1,1031,0,3914,0,5,3919,T
2-PB1,1032,1,1,0,3932,3934,C
2-PB1,1033,1,3915,0,2,3918,T
2-PB1,1034,0,1,0,3926,3927,C
2-PB1,1035,3928,1,2,0,3931,A
2-PB1,1036,3924,1,5,0,3930,A
2-PB1,1037,3930,0,2,0,3932,A
2-PB1,1038,1,2,0,3947,3950,C
2-PB1,1039,3935,0,1,0,3936,A
2-PB1,1040,3935,0,3,0,3938,A
2-PB1,1041,3934,1,2,1,3938,A
2-PB1,1042,3928,0,17,0,3945,A
2-PB1,1043,0,3990,1,0,3991,T
2-PB1,1044,1,1,3996,1,3999,G
2-PB1,1045,0,4,3986,0,3990,G
2-PB1,1046,1,0,0,3987,3988,C
2-PB1,1047,3975,2,2,0,3979,A
2-PB1,1048,3992,0,3,1,3996,A
2-PB1,1049,1,1,4008,0,4010,G
2-PB1,1050,4024,1,2,0,4027,A
2-PB1,1051,1,0,0,4022,4023,C
2-PB1,1052,2,3965,0,1,3968,T
2-PB1,1053,0,1,4034,0,4035,G
2-PB1,1054,1,1,4044,0,4046,G
2-PB1,1055,1,1,4056,2,4060,G
2-PB1,1056,4061,0,1,0,4062,A
2-PB1,1057,4056,0,2,0,4058,A
2-PB1,1058,4031,0,0,0,4031,A
2-PB1,1059,4021,2,6,0,4029,A
2-PB1,1060,0,2,4131,0,4133,G
2-PB1,1061,0,2,4132,0,4134,G
2-PB1,1062,4106,2,1,0,4109,A
2-PB1,1063,0,4105,0,1,4106,T
2-PB1,1064,4090,2,3,1,4096,A
2-PB1,1065,1,1,0,4096,4098,C
2-PB1,1066,4128,1,2,0,4131,A
2-PB1,1067,0,4120,0,0,4120,T
2-PB1,1068,1,0,4151,0,4152,G
2-PB1,1069,0,4078,1,4,4083,T
2-PB1,1070,0,4083,0,1,4084,T
2-PB1,1071,3,1,0,4071,4075,C
2-PB1,1072,1,1,4085,0,4087,G
2-PB1,1073,4084,0,1,1,4086,A
2-PB1,1074,0,3,4155,0,4158,G
2-PB1,1075,4124,1,2,1,4128,A
2-PB1,1076,0,0,4167,0,4167,G
2-PB1,1077,1,4144,0,2,4147,T
2-PB1,1078,4120,1,2,1,4124,A
2-PB1,1079,4145,1,1,2,4149,A
2-PB1,1080,0,1,4165,0,4166,G
2-PB1,1081,4168,1,2,0,4171,A
2-PB1,1082,0,0,4213,0,4213,G
2-PB1,1083,4124,1,0,1,4126,A
2-PB1,1084,4153,0,0,0,4153,A
2-PB1,1085,0,4116,0,0,4116,T
2-PB1,1086,1,0,4110,0,4111,G
2-PB1,1087,4103,0,2,0,4105,A
2-PB1,1088,4085,1,4,0,4090,A
2-PB1,1089,1,0,4116,0,4117,G
2-PB1,1090,0,0,0,4093,4093,C
2-PB1,1091,0,4051,0,4,4055,T
2-PB1,1092,3,0,0,4061,4064,C
2-PB1,1093,2,1,0,4063,4066,C
2-PB1,1094,2,0,4085,0,4087,G
2-PB1,1095,1,0,4088,0,4089,G
2-PB1,1096,4099,1,2,0,4102,A
2-PB1,1097,0,0,0,4134,4134,C
2-PB1,1098,4142,0,1,0,4143,A
2-PB1,1099,2,0,0,4177,4179,C
2-PB1,1100,4171,0,2,0,4173,A
2-PB1,1101,4168,1,2,0,4171,A
2-PB1,1102,4160,2,1,0,4163,A
2-PB1,1103,0,4171,0,1,4172,T
2-PB1,1104,4159,0,2,0,4161,A
2-PB1,1105,2,1,0,4154,4157,C
2-PB1,1106,1,0,0,4132,4133,C
2-PB1,1107,1,4082,0,3,4086,T
2-PB1,1108,4,1,4094,0,4099,G
2-PB1,1109,3,3,0,4098,4104,C
2-PB1,1110,4099,0,2,0,4101,A
2-PB1,1111,1,0,4100,0,4101,G
2-PB1,1112,4098,1,0,0,4099,A
2-PB1,1113,4086,0,2,0,4088,A
2-PB1,1114,4100,1,0,0,4101,A
2-PB1,1115,0,4103,0,0,4103,T
2-PB1,1116,3,0,4107,0,4110,G
2-PB1,1117,0,3,1,4086,4090,C
2-PB1,1118,1,4088,0,2,4091,T
2-PB1,1119,4149,1,2,0,4152,A
2-PB1,1120,2,1,4149,0,4152,G
2-PB1,1121,0,0,0,4142,4142,C
2-PB1,1122,4147,1,0,0,4148,A
2-PB1,1123,4138,2,4,0,4144,A
2-PB1,1124,0,1,4120,0,4121,G
2-PB1,1125,1,0,0,4112,4113,C
2-PB1,1126,4068,0,1,0,4069,A
2-PB1,1127,0,4119,0,2,4121,T
2-PB1,1128,0,4125,1,2,4128,T
2-PB1,1129,0,3,4233,0,4236,G
2-PB1,1130,4261,1,7,0,4269,A
2-PB1,1131,4,1,0,4259,4264,C
2-PB1,1132,2,0,0,4271,4273,C
2-PB1,1133,0,4183,0,6,4189,T
2-PB1,1134,1,0,4251,0,4252,G
2-PB1,1135,4253,0,1,0,4254,A
2-PB1,1136,4255,0,1,0,4256,A
2-PB1,1137,2,0,4303,0,4305,G
2-PB1,1138,0,4194,0,3,4197,T
2-PB1,1139,4192,0,2,1,4195,A
2-PB1,1140,1,4177,1,0,4179,T
2-PB1,1141,1,4169,0,1,4171,T
2-PB1,1142,0,4169,0,1,4170,T
2-PB1,1143,1,0,0,4131,4132,C
2-PB1,1144,4130,0,1,0,4131,A
2-PB1,1145,4136,0,0,1,4137,A
2-PB1,1146,2,4082,0,3,4087,T
2-PB1,1147,2,1,4091,0,4094,G
2-PB1,1148,4082,0,0,0,4082,A
2-PB1,1149,4078,0,2,1,4081,A
2-PB1,1150,0,4066,0,1,4067,T
2-PB1,1151,2,1,0,4095,4098,C
2-PB1,1152,4095,0,3,0,4098,A
2-PB1,1153,4099,1,0,1,4101,A
2-PB1,1154,1,0,0,4096,4097,C
2-PB1,1155,4084,1,8,0,4093,A
2-PB1,1156,4075,0,2,1,4078,A
2-PB1,1157,0,1,4079,0,4080,G
2-PB1,1158,1,1,4092,0,4094,G
2-PB1,1159,4087,1,2,0,4090,A
2-PB1,1160,4082,0,5,0,4087,A
2-PB1,1161,1,1,4085,1,4088,G
2-PB1,1162,4074,1,1,0,4076,A
2-PB1,1163,4078,2,2,0,4082,A
2-PB1,1164,4082,0,1,1,4084,A
2-PB1,1165,4078,2,2,1,4083,A
2-PB1,1166,0,4054,1,1,4056,T
2-PB1,1167,2,4030,0,3,4035,T
2-PB1,1168,0,1,4043,0,4044,G
2-PB1,1169,4028,0,10,0,4038,A
2-PB1,1170,0,1,4043,0,4044,G
2-PB1,1171,4037,0,0,2,4039,A
2-PB1,1172,4064,1,1,0,4066,A
2-PB1,1173,4111,0,0,1,4112,A
2-PB1,1174,4124,0,0,0,4124,A
2-PB1,1175,1,4121,0,0,4122,T
2-PB1,1176,4127,0,0,0,4127,A
2-PB1,1177,4119,0,4,0,4123,A
2-PB1,1178,0,1,4127,0,4128,G
2-PB1,1179,2,0,4118,1,4121,G
2-PB1,1180,0,0,0,4098,4098,C
2-PB1,1181,2,1,0,4082,4085,C
2-PB1,1182,0,4064,0,2,4066,T
2-PB1,1183,2,0,1,4526,4529,C
2-PB1,1184,0,4575,1,0,4576,T
2-PB1,1185,0,4594,1,0,4595,T
2-PB1,1186,0,2,0,4667,4669,C
2-PB1,1187,0,4663,1,1,4665,T
2-PB1,1188,4668,2,0,2,4672,A
2-PB1,1189,4671,0,0,0,4671,A
2-PB1,1190,2,4678,0,0,4680,T
2-PB1,1191,4718,1,2,0,4721,A
2-PB1,1192,0,2,4613,0,4615,G
2-PB1,1193,4218,2,1,0,4221,A
2-PB1,1194,1,4215,0,5,4221,T
2-PB1,1195,1,1,4162,0,4164,G
2-PB1,1196,1,2,4204,0,4207,G
2-PB1,1197,1,0,0,4199,4200,C
2-PB1,1198,4208,0,3,0,4211,A
2-PB1,1199,2,1,0,4213,4216,C
2-PB1,1200,4149,0,1,0,4150,A
2-PB1,1201,1,2,4268,1,4272,G
2-PB1,1202,1,0,0,4261,4262,C
2-PB1,1203,4269,1,2,0,4272,A
2-PB1,1204,1,4355,0,1,4357,T
2-PB1,1205,1,0,0,4318,4319,C
2-PB1,1206,4363,0,2,0,4365,A
2-PB1,1207,0,4358,0,3,4361,T
2-PB1,1208,0,4337,0,2,4339,T
2-PB1,1209,1,1,4331,1,4334,G
2-PB1,1210,4175,0,37,0,4212,A
2-PB1,1211,1,2,4310,0,4313,G
2-PB1,1212,2,2,0,4306,4310,C
2-PB1,1213,2,2,0,4244,4248,C
2-PB1,1214,7,0,0,4291,4298,C
2-PB1,1215,0,4261,0,5,4266,T
2-PB1,1216,0,1,4361,0,4362,G
2-PB1,1217,0,0,4415,0,4415,G
2-PB1,1218,4400,1,10,0,4411,A
2-PB1,1219,4462,0,0,0,4462,A
2-PB1,1220,2,4349,0,1,4352,T
2-PB1,1221,0,0,4415,0,4415,G
2-PB1,1222,4434,0,15,0,4449,A
2-PB1,1223,0,4433,0,2,4435,T
2-PB1,1224,0,0,4441,3,4444,G
2-PB1,1225,4404,0,3,0,4407,A
2-PB1,1226,0,4347,0,0,4347,T
2-PB1,1227,1,5,4344,0,4350,G
2-PB1,1228,3,3,4365,0,4371,G
2-PB1,1229,1,1,4376,0,4378,G
2-PB1,1230,0,1,0,4348,4349,C
2-PB1,1231,4331,1,3,0,4335,A
2-PB1,1232,0,4338,0,2,4340,T
2-PB1,1233,0,0,4436,0,4436,G
2-PB1,1234,1,4436,0,9,4446,T
2-PB1,1235,3,4450,0,1,4454,T
2-PB1,1236,2,1,0,4443,4446,C
2-PB1,1237,4408,1,1,0,4410,A
2-PB1,1238,4418,2,1,0,4421,A
2-PB1,1239,2,0,0,4420,4422,C
2-PB1,1240,4440,2,2,0,4444,A
2-PB1,1241,0,4450,0,1,4451,T
2-PB1,1242,2,0,4450,0,4452,G
2-PB1,1243,2,2,0,4444,4448,C
2-PB1,1244,0,4432,1,4,4437,T
2-PB1,1245,4453,0,1,0,4454,A
2-PB1,1246,4446,1,0,1,4448,A
2-PB1,1247,1,0,4510,0,4511,G
2-PB1,1248,0,4504,0,0,4504,T
2-PB1,1249,4476,1,0,0,4477,A
2-PB1,1250,1,1,0,4483,4485,C
2-PB1,1251,2,2,4440,0,4444,G
2-PB1,1252,3,0,4665,0,4668,G
2-PB1,1253,1,4661,0,1,4663,T
2-PB1,1254,0,4634,1,0,4635,T
2-PB1,1255,0,4636,2,0,4638,T
2-PB1,1256,1,4612,0,0,4613,T
2-PB1,1257,4613,0,2,0,4615,A
2-PB1,1258,0,0,4612,1,4613,G
2-PB1,1259,0,4,4603,1,4608,G
2-PB1,1260,4502,1,2,0,4505,A
2-PB1,1261,1,0,4458,0,4459,G
2-PB1,1262,1,4489,0,3,4493,T
2-PB1,1263,1,0,0,4493,4494,C
2-PB1,1264,0,4498,0,0,4498,T
2-PB1,1265,0,0,0,4496,4496,C
2-PB1,1266,1,1,4508,0,4510,G
2-PB1,1267,4633,1,1,0,4635,A
2-PB1,1268,0,4640,0,0,4640,T
2-PB1,1269,4650,0,1,0,4651,A
2-PB1,1270,1,1,0,4649,4651,C
2-PB1,1271,0,4555,0,6,4561,T
2-PB1,1272,2,2,4566,0,4570,G
2-PB1,1273,4568,0,0,0,4568,A
2-PB1,1274,4614,2,2,0,4618,A
2-PB1,1275,0,4621,0,2,4623,T
2-PB1,1276,1,1,0,4516,4518,C
2-PB1,1277,0,4505,1,2,4508,T
2-PB1,1278,0,4495,0,2,4497,T
2-PB1,1279,1,0,4501,0,4502,G
2-PB1,1280,1,1,4499,0,4501,G
2-PB1,1281,4480,1,16,0,4497,A
2-PB1,1282,0,0,0,4501,4501,C
2-PB1,1283,4446,0,1,0,4447,A
2-PB1,1284,4468,0,2,0,4470,A
2-PB1,1285,4476,1,2,0,4479,A
2-PB1,1286,4482,1,5,0,4488,A
2-PB1,1287,1,0,4560,0,4561,G
2-PB1,1288,4545,0,2,0,4547,A
2-PB1,1289,4537,0,2,0,4539,A
2-PB1,1290,4545,1,2,2,4550,A
2-PB1,1291,0,4542,0,0,4542,T
2-PB1,1292,4547,1,1,0,4549,A
2-PB1,1293,1,1,0,4654,4656,C
2-PB1,1294,4618,0,3,0,4621,A
2-PB1,1295,0,1,0,4633,4634,C
2-PB1,1296,3,1,0,4581,4585,C
2-PB1,1297,4577,0,3,0,4580,A
2-PB1,1298,4627,0,0,1,4628,A
2-PB1,1299,0,0,4726,0,4726,G
2-PB1,1300,4776,1,3,0,4780,A
2-PB1,1301,1,3,0,4808,4812,C
2-PB1,1302,4702,0,1,0,4703,A
2-PB1,1303,4791,0,7,1,4799,A
2-PB1,1304,1,1,0,4810,4812,C
2-PB1,1305,4880,0,1,0,4881,A
2-PB1,1306,2,4898,0,1,4901,T
2-PB1,1307,4845,0,2,0,4847,A
2-PB1,1308,0,0,0,4909,4909,C
2-PB1,1309,1,4774,1,0,4776,T
2-PB1,1310,0,0,4814,0,4814,G
2-PB1,1311,1,0,4811,1,4813,G
2-PB1,1312,3,4708,0,9,4720,T
2-PB1,1313,1,10,4683,0,4694,G
2-PB1,1314,0,2,4647,1,4650,G
2-PB1,1315,1,2,4661,0,4664,G
2-PB1,1316,4658,1,7,0,4666,A
2-PB1,1317,1,4561,0,4,4566,T
2-PB1,1318,0,1,4563,0,4564,G
2-PB1,1319,2,1,4532,0,4535,G
2-PB1,1320,1,2,4557,0,4560,G
2-PB1,1321,1,1,0,4601,4603,C
2-PB1,1322,2,4580,0,6,4588,T
2-PB1,1323,3,1,0,4596,4600,C
2-PB1,1324,3,2,0,4587,4592,C
2-PB1,1325,4590,2,2,0,4594,A
2-PB1,1326,4593,0,1,2,4596,A
2-PB1,1327,0,4564,0,18,4582,T
2-PB1,1328,1,0,0,4555,4556,C
2-PB1,1329,2,0,0,4522,4524,C
2-PB1,1330,0,4480,0,4,4484,T
2-PB1,1331,5,3,0,4475,4483,C
2-PB1,1332,1,5,0,4451,4457,C
2-PB1,1333,1,1,4459,0,4461,G
2-PB1,1334,4462,0,2,0,4464,A
2-PB1,1335,0,2,0,4463,4465,C
2-PB1,1336,0,2,4467,0,4469,G
2-PB1,1337,4494,0,2,0,4496,A
2-PB1,1338,1,4486,0,1,4488,T
2-PB1,1339,2,4472,0,0,4474,T
2-PB1,1340,1,4479,0,1,4481,T
2-PB1,1341,0,4483,0,3,4486,T
2-PB1,1342,1,1,4490,0,4492,G
2-PB1,1343,1,9,0,4492,4502,C
2-PB1,1344,2,2,0,4498,4502,C
2-PB1,1345,5,0,0,4607,4612,C
2-PB1,1346,2,4518,1,9,4530,T
2-PB1,1347,3,0,0,4673,4676,C
2-PB1,1348,4698,0,1,1,4700,A
2-PB1,1349,0,4714,0,4,4718,T
2-PB1,1350,4708,0,2,0,4710,A
2-PB1,1351,0,0,4756,0,4756,G
2-PB1,1352,0,4703,0,2,4705,T
2-PB1,1353,0,2,4718,1,4721,G
2-PB1,1354,4572,0,0,0,4572,A
2-PB1,1355,4570,1,0,0,4571,A
2-PB1,1356,1,4381,0,6,4388,T
2-PB1,1357,1,0,4370,0,4371,G
2-PB1,1358,1,2,0,4405,4408,C
2-PB1,1359,4411,0,2,0,4413,A
2-PB1,1360,0,1,0,4401,4402,C
2-PB1,1361,1,0,0,4372,4373,C
2-PB1,1362,4353,0,0,1,4354,A
2-PB1,1363,4356,1,1,0,4358,A
2-PB1,1364,4341,0,1,2,4344,A
2-PB1,1365,1,4256,0,0,4257,T
2-PB1,1366,3,0,0,4373,4376,C
2-PB1,1367,4386,0,1,1,4388,A
2-PB1,1368,1,4381,0,0,4382,T
2-PB1,1369,1,2,4384,0,4387,G
2-PB1,1370,4335,0,40,1,4376,A
2-PB1,1371,0,0,4402,0,4402,G
2-PB1,1372,1,3,4385,0,4389,G
2-PB1,1373,4,4,4382,0,4390,G
2-PB1,1374,4356,2,0,1,4359,A
2-PB1,1375,4405,1,0,0,4406,A
2-PB1,1376,0,4409,1,1,4411,T
2-PB1,1377,4420,1,1,2,4424,A
2-PB1,1378,0,1,0,4426,4427,C
2-PB1,1379,4422,0,4,0,4426,A
2-PB1,1380,4433,0,3,0,4436,A
2-PB1,1381,0,0,4422,1,4423,G
2-PB1,1382,0,1,4,4378,4383,C
2-PB1,1383,4359,0,0,0,4359,A
2-PB1,1384,0,2,4383,1,4386,G
2-PB1,1385,0,2,4387,0,4389,G
2-PB1,1386,4374,0,3,0,4377,A
2-PB1,1387,2,10,4386,0,4398,G
2-PB1,1388,3,4322,2,1,4328,T
2-PB1,1389,0,2,4377,0,4379,G
2-PB1,1390,0,1,4391,0,4392,G
2-PB1,1391,4379,1,5,0,4385,A
2-PB1,1392,2,4386,1,0,4389,T
2-PB1,1393,4299,0,2,0,4301,A
2-PB1,1394,1,1,4315,0,4317,G
2-PB1,1395,4370,1,0,0,4371,A
2-PB1,1396,1,4362,0,1,4364,T
2-PB1,1397,0,4340,0,1,4341,T
2-PB1,1398,0,0,0,4431,4431,C
2-PB1,1399,0,4413,0,0,4413,T
2-PB1,1400,4414,0,0,0,4414,A
2-PB1,1401,0,0,0,4414,4414,C
2-PB1,1402,4334,1,1,0,4336,A
2-PB1,1403,2,1,4331,1,4335,G
2-PB1,1404,2,1,4268,1,4272,G
2-PB1,1405,4292,2,4,1,4299,A
2-PB1,1406,1,1,0,4275,4277,C
2-PB1,1407,2,0,0,4146,4148,C
2-PB1,1408,0,4125,0,8,4133,T
2-PB1,1409,1,2,4142,0,4145,G
2-PB1,1410,0,0,0,4136,4136,C
2-PB1,1411,4136,1,2,0,4139,A
2-PB1,1412,4152,2,8,1,4163,A
2-PB1,1413,1,1,4180,0,4182,G
2-PB1,1414,0,4111,0,1,4112,T
2-PB1,1415,0,4108,1,0,4109,T
2-PB1,1416,4053,0,2,0,4055,A
2-PB1,1417,0,0,4068,0,4068,G
2-PB1,1418,0,4050,0,3,4053,T
2-PB1,1419,2,1,4045,0,4048,G
2-PB1,1420,0,0,4040,0,4040,G
2-PB1,1421,1,3,4046,0,4050,G
2-PB1,1422,4043,0,2,0,4045,A
2-PB1,1423,4060,0,0,0,4060,A
2-PB1,1424,2,4046,0,0,4048,T
2-PB1,1425,1,1,0,4051,4053,C
2-PB1,1426,4045,0,1,0,4046,A
2-PB1,1427,4050,0,4,0,4054,A
2-PB1,1428,0,0,0,4047,4047,C
2-PB1,1429,4047,0,1,1,4049,A
2-PB1,1430,0,3970,1,0,3971,T
2-PB1,1431,1,0,3975,1,3977,G
2-PB1,1432,3955,0,6,0,3961,A
2-PB1,1433,0,1,3994,0,3995,G
2-PB1,1434,3,3,1,3968,3975,C
2-PB1,1435,3960,0,0,1,3961,A
2-PB1,1436,3962,1,0,0,3963,A
2-PB1,1437,3962,0,0,0,3962,A
2-PB1,1438,3977,1,1,0,3979,A
2-PB1,1439,3975,0,3,0,3978,A
2-PB1,1440,0,0,3980,0,3980,G
2-PB1,1441,3931,2,3,0,3936,A
2-PB1,1442,3888,0,5,2,3895,A
2-PB1,1443,0,0,3977,0,3977,G
2-PB1,1444,0,3972,0,0,3972,T
2-PB1,1445,6,2,0,3959,3967,C
2-PB1,1446,1,0,0,3974,3975,C
2-PB1,1447,1,3946,0,18,3965,T
2-PB1,1448,4012,0,1,1,4014,A
2-PB1,1449,0,4005,0,0,4005,T
2-PB1,1450,4004,1,0,0,4005,A
2-PB1,1451,1,4004,0,0,4005,T
2-PB1,1452,3879,0,1,0,3880,A
2-PB1,1453,3874,1,1,0,3876,A
2-PB1,1454,3868,1,1,0,3870,A
2-PB1,1455,0,3858,0,1,3859,T
2-PB1,1456,3815,0,4,0,3819,A
2-PB1,1457,3767,0,3,0,3770,A
2-PB1,1458,3789,2,1,0,3792,A
2-PB1,1459,3798,1,0,1,3800,A
2-PB1,1460,2,0,0,3800,3802,C
2-PB1,1461,3625,0,2,0,3627,A
2-PB1,1462,2,2,3617,0,3621,G
2-PB1,1463,2,1,3600,0,3603,G
2-PB1,1464,0,1,3614,0,3615,G
2-PB1,1465,3632,0,5,0,3637,A
2-PB1,1466,0,0,0,3634,3634,C
2-PB1,1467,3619,0,2,0,3621,A
2-PB1,1468,0,3622,0,0,3622,T
2-PB1,1469,0,3622,0,3,3625,T
2-PB1,1470,0,3626,0,1,3627,T
2-PB1,1471,0,0,3623,1,3624,G
2-PB1,1472,3611,1,1,0,3613,A
2-PB1,1473,3606,1,0,1,3608,A
2-PB1,1474,0,3601,0,1,3602,T
2-PB1,1475,0,3526,1,1,3528,T
2-PB1,1476,4,2,0,3533,3539,C
2-PB1,1477,3510,1,3,0,3514,A
2-PB1,1478,0,0,0,3514,3514,C
2-PB1,1479,0,3513,1,1,3515,T
2-PB1,1480,3507,2,0,1,3510,A
2-PB1,1481,1,0,3506,0,3507,G
2-PB1,1482,2,0,0,3496,3498,C
2-PB1,1483,0,3479,0,6,3485,T
2-PB1,1484,0,3499,0,1,3500,T
2-PB1,1485,1,3485,0,0,3486,T
2-PB1,1486,2,3480,1,1,3484,T
2-PB1,1487,1,3482,0,2,3485,T
2-PB1,1488,0,3486,0,0,3486,T
2-PB1,1489,0,3474,0,0,3474,T
2-PB1,1490,3473,0,0,0,3473,A
2-PB1,1491,0,3467,1,0,3468,T
2-PB1,1492,1,0,0,3469,3470,C
2-PB1,1493,0,0,3484,1,3485,G
2-PB1,1494,3563,0,0,0,3563,A
2-PB1,1495,2,3557,0,1,3560,T
2-PB1,1496,3551,1,2,0,3554,A
2-PB1,1497,1,3573,0,2,3576,T
2-PB1,1498,1,4,3573,0,3578,G
2-PB1,1499,0,2,3577,0,3579,G
2-PB1,1500,3587,2,2,0,3591,A
2-PB1,1501,0,3555,0,0,3555,T
2-PB1,1502,1,3514,0,1,3516,T
2-PB1,1503,0,3412,0,0,3412,T
2-PB1,1504,0,0,3413,0,3413,G
2-PB1,1505,0,3411,0,1,3412,T
2-PB1,1506,3,1,3398,0,3402,G
2-PB1,1507,4,0,3402,0,3406,G
2-PB1,1508,1,3,0,3363,3367,C
2-PB1,1509,0,3368,0,3,3371,T
2-PB1,1510,3377,0,0,0,3377,A
2-PB1,1511,3386,1,0,0,3387,A
2-PB1,1512,0,3391,1,0,3392,T
2-PB1,1513,0,3394,0,0,3394,T
2-PB1,1514,1,3394,0,1,3396,T
2-PB1,1515,0,3393,0,2,3395,T
2-PB1,1516,3392,0,1,0,3393,A
2-PB1,1517,1,3,3401,0,3405,G
2-PB1,1518,0,1,0,3401,3402,C
2-PB1,1519,3387,0,0,1,3388,A
2-PB1,1520,0,3361,0,0,3361,T
2-PB1,1521,1,2,3302,0,3305,G
2-PB1,1522,0,3,3336,0,3339,G
2-PB1,1523,3328,0,3,0,3331,A
2-PB1,1524,0,0,3339,0,3339,G
2-PB1,1525,0,2,0,3321,3323,C
2-PB1,1526,0,3270,0,0,3270,T
2-PB1,1527,0,2,3283,0,3285,G
2-PB1,1528,0,0,0,3261,3261,C
2-PB1,1529,1,0,0,3266,3267,C
2-PB1,1530,4,0,0,3277,3281,C
2-PB1,1531,3182,0,0,2,3184,A
2-PB1,1532,0,0,3262,0,3262,G
2-PB1,1533,0,3261,0,2,3263,T
2-PB1,1534,1,3261,0,0,3262,T
2-PB1,1535,1,3258,2,0,3261,T
2-PB1,1536,0,3228,0,1,3229,T
2-PB1,1537,0,1,3228,0,3229,G
2-PB1,1538,0,0,3222,1,3223,G
2-PB1,1539,3210,0,3,0,3213,A
2-PB1,1540,1,1,3217,0,3219,G
2-PB1,1541,0,2970,0,2,2972,T
2-PB1,1542,2967,0,1,0,2968,A
2-PB1,1543,0,3007,0,1,3008,T
2-PB1,1544,1,1,0,3015,3017,C
2-PB1,1545,2,3016,0,0,3018,T
2-PB1,1546,1,0,3024,1,3026,G
2-PB1,1547,1,1,3036,0,3038,G
2-PB1,1548,3035,1,1,0,3037,A
2-PB1,1549,3032,0,2,0,3034,A
2-PB1,1550,0,3024,0,0,3024,T
2-PB1,1551,2890,0,1,1,2892,A
2-PB1,1552,2885,0,0,0,2885,A
2-PB1,1553,2882,0,2,2,2886,A
2-PB1,1554,0,2,0,2884,2886,C
2-PB1,1555,0,0,2846,0,2846,G
2-PB1,1556,2813,0,1,0,2814,A
2-PB1,1557,0,0,2812,0,2812,G
2-PB1,1558,1,2790,1,0,2792,T
2-PB1,1559,1,0,1,2809,2811,C
2-PB1,1560,2788,0,1,1,2790,A
2-PB1,1561,0,0,2825,0,2825,G
2-PB1,1562,0,0,0,2824,2824,C
2-PB1,1563,0,2812,1,2,2815,T
2-PB1,1564,0,0,2870,0,2870,G
2-PB1,1565,2838,0,0,0,2838,A
2-PB1,1566,0,2831,0,1,2832,T
2-PB1,1567,2837,0,2,0,2839,A
2-PB1,1568,0,2780,0,1,2781,T
2-PB1,1569,0,3,2782,0,2785,G
2-PB1,1570,2645,0,2,0,2647,A
2-PB1,1571,1,1,2672,0,2674,G
2-PB1,1572,1,1,2,2661,2665,C
2-PB1,1573,2451,0,0,0,2451,A
2-PB1,1574,3,2437,0,2,2442,T
2-PB1,1575,0,2435,0,0,2435,T
2-PB1,1576,0,1,2448,1,2450,G
2-PB1,1577,0,1,2492,0,2493,G
2-PB1,1578,2444,0,0,0,2444,A
2-PB1,1579,0,1,2458,0,2459,G
2-PB1,1580,0,2328,0,1,2329,T
2-PB1,1581,2322,0,2,0,2324,A
2-PB1,1582,2321,0,2,0,2323,A
2-PB1,1583,0,0,0,2321,2321,C
2-PB1,1584,2291,1,0,0,2292,A
2-PB1,1585,0,0,2330,0,2330,G
2-PB1,1586,0,1919,0,0,1919,T
2-PB1,1587,0,0,1925,1,1926,G
2-PB1,1588,1937,1,0,0,1938,A
2-PB1,1589,0,1931,0,0,1931,T
2-PB1,1590,1930,0,1,0,1931,A
2-PB1,1591,1921,0,0,0,1921,A
2-PB1,1592,1852,0,2,0,1854,A
2-PB1,1593,0,0,1870,0,1870,G
2-PB1,1594,1708,0,1,0,1709,A
2-PB1,1595,1703,0,0,0,1703,A
2-PB1,1596,1,0,0,1696,1697,C
2-PB1,1597,1594,1,0,0,1595,A
2-PB1,1598,1609,0,1,0,1610,A
2-PB1,1599,0,0,0,1610,1610,C
2-PB1,1600,1608,1,0,0,1609,A
2-PB1,1601,2,1598,2,0,1602,T
2-PB1,1602,0,0,1541,0,1541,G
2-PB1,1603,1540,0,3,0,1543,A
2-PB1,1604,0,1542,0,0,1542,T
2-PB1,1605,1502,0,0,0,1502,A
2-PB1,1606,1510,0,0,0,1510,A
2-PB1,1607,1467,0,1,0,1468,A
2-PB1,1608,0,1,0,1477,1478,C
2-PB1,1609,1335,0,0,0,1335,A
2-PB1,1610,1324,1,0,0,1325,A
2-PB1,1611,0,1272,0,0,1272,T
2-PB1,1612,1,1,1269,0,1271,G
2-PB1,1613,1294,0,0,0,1294,A
2-PB1,1614,0,0,0,1309,1309,C
2-PB1,1615,0,0,0,1257,1257,C
2-PB1,1616,0,1145,1,0,1146,T
2-PB1,1617,0,1090,0,1,1091,T
2-PB1,1618,0,2,1091,1,1094,G
2-PB1,1619,0,1,1113,0,1114,G
2-PB1,1620,1133,0,1,0,1134,A
2-PB1,1621,0,0,0,1171,1171,C
2-PB1,1622,1,0,0,1149,1150,C
2-PB1,1623,1141,0,1,0,1142,A
2-PB1,1624,0,1,1164,0,1165,G
2-PB1,1625,2,0,0,1167,1169,C
2-PB1,1626,1171,1,0,0,1172,A
2-PB1,1627,1170,0,0,0,1170,A
2-PB1,1628,0,0,0,1164,1164,C
2-PB1,1629,1153,0,1,0,1154,A
2-PB1,1630,0,0,1171,0,1171,G
2-PB1,1631,1,0,0,1163,1164,C
2-PB1,1632,1,0,0,1171,1172,C
2-PB1,1633,4,0,0,1161,1165,C
2-PB1,1634,1166,0,0,0,1166,A
2-PB1,1635,1162,1,0,1,1164,A
2-PB1,1636,1163,0,1,0,1164,A
2-PB1,1637,0,1165,0,0,1165,T
2-PB1,1638,0,0,1160,0,1160,G
2-PB1,1639,1,0,1147,0,1148,G
2-PB1,1640,1,0,0,1145,1146,C
2-PB1,1641,0,1135,1,2,1138,T
2-PB1,1642,1,0,1,1159,1161,C
2-PB1,1643,0,1154,0,4,1158,T
2-PB1,1644,0,0,0,1162,1162,C
2-PB1,1645,1,0,0,1168,1169,C
2-PB1,1646,1168,0,0,0,1168,A
2-PB1,1647,1169,0,0,0,1169,A
2-PB1,1648,0,1161,0,0,1161,T
2-PB1,1649,0,1157,0,0,1157,T
2-PB1,1650,0,0,1158,0,1158,G
2-PB1,1651,0,1142,0,0,1142,T
2-PB1,1652,0,1145,0,0,1145,T
2-PB1,1653,1,2,0,1140,1143,C
2-PB1,1654,1137,1,0,0,1138,A
2-PB1,1655,1,1138,0,0,1139,T
2-PB1,1656,0,0,0,1139,1139,C
2-PB1,1657,1140,0,1,0,1141,A
2-PB1,1658,1142,0,0,0,1142,A
2-PB1,1659,1140,0,3,0,1143,A
2-PB1,1660,0,0,1161,0,1161,G
2-PB1,1661,1165,1,0,0,1166,A
2-PB1,1662,0,1161,0,0,1161,T
2-PB1,1663,0,1165,0,0,1165,T
2-PB1,1664,1160,0,10,2,1172,A
2-PB1,1665,0,1,0,1183,1184,C
2-PB1,1666,1177,1,2,0,1180,A
2-PB1,1667,0,0,1193,0,1193,G
2-PB1,1668,1188,1,1,0,1190,A
2-PB1,1669,0,1212,0,0,1212,T
2-PB1,1670,1217,0,0,0,1217,A
2-PB1,1671,0,0,0,1282,1282,C
2-PB1,1672,1317,0,1,0,1318,A
2-PB1,1673,0,0,0,1417,1417,C
2-PB1,1674,1396,0,1,0,1397,A
2-PB1,1675,0,1403,1,0,1404,T
2-PB1,1676,1385,0,0,0,1385,A
2-PB1,1677,0,1380,0,2,1382,T
2-PB1,1678,1355,0,1,0,1356,A
2-PB1,1679,0,0,1357,0,1357,G
2-PB1,1680,0,1,1339,0,1340,G
2-PB1,1681,0,1280,0,0,1280,T
2-PB1,1682,0,0,1265,0,1265,G
2-PB1,1683,0,0,0,1305,1305,C
2-PB1,1684,0,0,0,1300,1300,C
2-PB1,1685,1318,0,0,0,1318,A
2-PB1,1686,0,1316,0,0,1316,T
2-PB1,1687,1324,0,0,0,1324,A
2-PB1,1688,0,0,1328,0,1328,G
2-PB1,1689,1300,0,0,0,1300,A
2-PB1,1690,1,0,1307,0,1308,G
2-PB1,1691,0,0,1310,0,1310,G
2-PB1,1692,1258,0,3,0,1261,A
2-PB1,1693,0,0,1264,0,1264,G
2-PB1,1694,1257,0,1,0,1258,A
2-PB1,1695,0,1,0,1263,1264,C
2-PB1,1696,1264,1,0,0,1265,A
2-PB1,1697,0,1,0,1283,1284,C
2-PB1,1698,1287,0,2,0,1289,A
2-PB1,1699,0,0,0,1291,1291,C
2-PB1,1700,1286,0,0,0,1286,A
2-PB1,1701,1286,1,0,0,1287,A
2-PB1,1702,1290,0,0,0,1290,A
2-PB1,1703,0,1287,0,0,1287,T
2-PB1,1704,0,1,0,1292,1293,C
2-PB1,1705,2,1,0,1294,1297,C
2-PB1,1706,1288,0,2,0,1290,A
2-PB1,1707,0,0,1294,0,1294,G
2-PB1,1708,1291,0,3,0,1294,A
2-PB1,1709,0,0,0,1308,1308,C
2-PB1,1710,0,0,1298,0,1298,G
2-PB1,1711,1291,0,2,0,1293,A
2-PB1,1712,0,1,1299,0,1300,G
2-PB1,1713,1298,0,3,0,1301,A
2-PB1,1714,1301,0,1,0,1302,A
2-PB1,1715,0,0,1308,0,1308,G
2-PB1,1716,1302,0,0,0,1302,A
2-PB1,1717,0,1300,0,0,1300,T
2-PB1,1718,0,1,0,1294,1295,C
2-PB1,1719,1298,0,0,0,1298,A
2-PB1,1720,0,1298,0,1,1299,T
2-PB1,1721,0,1298,0,0,1298,T
2-PB1,1722,0,0,1,1297,1298,C
2-PB1,1723,1,0,1300,1,1302,G
2-PB1,1724,1287,0,2,0,1289,A
2-PB1,1725,0,0,1291,0,1291,G
2-PB1,1726,1282,0,0,1,1283,A
2-PB1,1727,0,1335,0,0,1335,T
2-PB1,1728,1346,0,0,0,1346,A
2-PB1,1729,1348,0,0,0,1348,A
2-PB1,1730,1349,0,2,0,1351,A
2-PB1,1731,7,0,1339,0,1346,G
2-PB1,1732,1346,0,0,0,1346,A
2-PB1,1733,1328,0,0,0,1328,A
2-PB1,1734,0,0,1326,1,1327,G
2-PB1,1735,0,0,0,1325,1325,C
2-PB1,1736,0,1320,0,0,1320,T
2-PB1,1737,1,0,1321,0,1322,G
2-PB1,1738,0,1321,0,0,1321,T
2-PB1,1739,0,1,1312,0,1313,G
2-PB1,1740,0,0,1319,0,1319,G
2-PB1,1741,1,0,1330,0,1331,G
2-PB1,1742,1331,1,1,0,1333,A
2-PB1,1743,1,1330,0,0,1331,T
2-PB1,1744,0,0,0,1330,1330,C
2-PB1,1745,1335,1,0,0,1336,A
2-PB1,1746,1340,1,1,0,1342,A
2-PB1,1747,1348,0,1,0,1349,A
2-PB1,1748,0,1,1,1344,1346,C
2-PB1,1749,1,0,0,1332,1333,C
2-PB1,1750,2,0,0,1334,1336,C
2-PB1,1751,1334,0,1,1,1336,A
2-PB1,1752,1357,0,0,0,1357,A
2-PB1,1753,1,1351,0,2,1354,T
2-PB1,1754,0,1,0,1353,1354,C
2-PB1,1755,1336,0,0,0,1336,A
2-PB1,1756,1333,0,0,1,1334,A
2-PB1,1757,0,2,1341,0,1343,G
2-PB1,1758,0,3,1330,0,1333,G
2-PB1,1759,0,0,1334,0,1334,G
2-PB1,1760,1,0,0,1335,1336,C
2-PB1,1761,1327,1,0,0,1328,A
2-PB1,1762,0,0,1348,0,1348,G
2-PB1,1763,0,0,1357,1,1358,G
2-PB1,1764,1363,0,0,0,1363,A
2-PB1,1765,0,1,0,1373,1374,C
2-PB1,1766,0,1354,0,0,1354,T
2-PB1,1767,1381,0,1,0,1382,A
2-PB1,1768,0,1380,0,0,1380,T
2-PB1,1769,0,1380,0,0,1380,T
2-PB1,1770,0,2,1378,0,1380,G
2-PB1,1771,0,0,1393,0,1393,G
2-PB1,1772,0,1376,0,1,1377,T
2-PB1,1773,1380,0,1,0,1381,A
2-PB1,1774,0,1364,0,0,1364,T
2-PB1,1775,1,1,0,1363,1365,C
2-PB1,1776,1354,0,0,0,1354,A
2-PB1,1777,0,0,1387,0,1387,G
2-PB1,1778,1390,0,0,0,1390,A
2-PB1,1779,0,1383,0,0,1383,T
2-PB1,1780,0,2,1336,0,1338,G
2-PB1,1781,0,2,1331,0,1333,G
2-PB1,1782,2,3,1326,0,1331,G
2-PB1,1783,0,0,1332,0,1332,G
2-PB1,1784,1,0,1326,0,1327,G
2-PB1,1785,1330,0,2,0,1332,A
2-PB1,1786,0,0,0,1326,1326,C
2-PB1,1787,0,0,0,1320,1320,C
2-PB1,1788,1323,2,0,0,1325,A
2-PB1,1789,1405,0,2,0,1407,A
2-PB1,1790,1413,0,0,0,1413,A
2-PB1,1791,0,0,0,1434,1434,C
2-PB1,1792,0,1419,0,0,1419,T
2-PB1,1793,0,1421,0,0,1421,T
2-PB1,1794,1420,1,0,0,1421,A
2-PB1,1795,0,1420,1,0,1421,T
2-PB1,1796,1424,0,0,0,1424,A
2-PB1,1797,0,0,0,1423,1423,C
2-PB1,1798,1332,0,0,0,1332,A
2-PB1,1799,1328,0,1,0,1329,A
2-PB1,1800,1,1310,1,0,1312,T
2-PB1,1801,1331,0,0,0,1331,A
2-PB1,1802,0,1336,1,0,1337,T
2-PB1,1803,2,1,0,1327,1330,C
2-PB1,1804,1,1,0,1330,1332,C
2-PB1,1805,0,1,1333,0,1334,G
2-PB1,1806,0,0,1334,0,1334,G
2-PB1,1807,1332,0,0,0,1332,A
2-PB1,1808,1343,0,0,0,1343,A
2-PB1,1809,0,1341,0,1,1342,T
2-PB1,1810,0,0,0,1340,1340,C
2-PB1,1811,0,1339,0,2,1341,T
2-PB1,1812,0,1345,0,1,1346,T
2-PB1,1813,1,1,1,1348,1351,C
2-PB1,1814,1349,0,0,0,1349,A
2-PB1,1815,0,1,0,1352,1353,C
2-PB1,1816,1350,0,1,0,1351,A
2-PB1,1817,1,1342,0,2,1345,T
2-PB1,1818,0,1332,0,0,1332,T
2-PB1,1819,0,0,0,1452,1452,C
2-PB1,1820,0,0,0,1453,1453,C
2-PB1,1821,1,1453,0,1,1455,T
2-PB1,1822,0,0,1455,0,1455,G
2-PB1,1823,1451,1,1,0,1453,A
2-PB1,1824,1452,0,1,0,1453,A
2-PB1,1825,0,0,1457,0,1457,G
2-PB1,1826,0,1392,0,0,1392,T
2-PB1,1827,0,1,0,1389,1390,C
2-PB1,1828,0,1368,1,1,1370,T
2-PB1,1829,1,0,1411,0,1412,G
2-PB1,1830,0,0,0,1411,1411,C
2-PB1,1831,0,1406,0,1,1407,T
2-PB1,1832,0,1410,0,0,1410,T
2-PB1,1833,1410,1,0,0,1411,A
2-PB1,1834,1415,0,0,0,1415,A
2-PB1,1835,1419,0,2,1,1422,A
2-PB1,1836,0,0,1434,0,1434,G
2-PB1,1837,0,1414,0,1,1415,T
2-PB1,1838,0,1,1394,0,1395,G
2-PB1,1839,1,0,1391,1,1393,G
2-PB1,1840,0,0,1390,1,1391,G
2-PB1,1841,1395,0,1,0,1396,A
2-PB1,1842,0,0,1402,0,1402,G
2-PB1,1843,0,1,0,1400,1401,C
2-PB1,1844,0,1397,0,1,1398,T
2-PB1,1845,0,0,1402,0,1402,G
2-PB1,1846,1401,0,0,0,1401,A
2-PB1,1847,0,1403,0,0,1403,T
2-PB1,1848,0,0,1411,0,1411,G
2-PB1,1849,0,0,1405,0,1405,G
2-PB1,1850,1403,0,1,0,1404,A
2-PB1,1851,0,1401,0,2,1403,T
2-PB1,1852,0,3,1399,0,1402,G
2-PB1,1853,1394,0,0,0,1394,A
2-PB1,1854,0,1,1406,1,1408,G
2-PB1,1855,1407,0,0,0,1407,A
2-PB1,1856,1408,0,0,0,1408,A
2-PB1,1857,0,1392,0,1,1393,T
2-PB1,1858,0,1396,0,0,1396,T
2-PB1,1859,1401,0,0,0,1401,A
2-PB1,1860,1,1399,0,0,1400,T
2-PB1,1861,0,0,0,1401,1401,C
2-PB1,1862,0,2,1397,0,1399,G
2-PB1,1863,1,1,1396,0,1398,G
2-PB1,1864,1,0,1392,0,1393,G
2-PB1,1865,0,0,1394,0,1394,G
2-PB1,1866,1389,2,1,0,1392,A
2-PB1,1867,1393,0,1,0,1394,A
2-PB1,1868,1,0,1399,1,1401,G
2-PB1,1869,1411,0,2,0,1413,A
2-PB1,1870,0,0,0,1428,1428,C
2-PB1,1871,0,1403,0,2,1405,T
2-PB1,1872,0,1434,0,0,1434,T
2-PB1,1873,0,1434,0,1,1435,T
2-PB1,1874,0,0,1438,0,1438,G
2-PB1,1875,1,1441,1,1,1444,T
2-PB1,1876,1440,0,0,0,1440,A
2-PB1,1877,1436,0,0,0,1436,A
2-PB1,1878,0,1423,0,0,1423,T
2-PB1,1879,0,0,0,1436,1436,C
2-PB1,1880,0,0,0,1433,1433,C
2-PB1,1881,2,0,0,1413,1415,C
2-PB1,1882,2,8,0,1420,1430,C
2-PB1,1883,0,1424,0,3,1427,T
2-PB1,1884,0,0,1428,0,1428,G
2-PB1,1885,1429,0,1,0,1430,A
2-PB1,1886,1431,0,0,0,1431,A
2-PB1,1887,1,1428,0,1,1430,T
2-PB1,1888,0,2,0,1414,1416,C
2-PB1,1889,2,0,0,1410,1412,C
2-PB1,1890,2,1,0,1410,1413,C
2-PB1,1891,0,1405,0,2,1407,T
2-PB1,1892,1,1409,0,0,1410,T
2-PB1,1893,0,1410,0,0,1410,T
2-PB1,1894,0,0,1412,0,1412,G
2-PB1,1895,0,1405,0,2,1407,T
2-PB1,1896,2,0,0,1406,1408,C
2-PB1,1897,1398,0,1,0,1399,A
2-PB1,1898,0,2,1418,1,1421,G
2-PB1,1899,0,0,1,1415,1416,C
2-PB1,1900,0,1,0,1419,1420,C
2-PB1,1901,1426,0,0,0,1426,A
2-PB1,1902,0,1426,0,0,1426,T
2-PB1,1903,1426,0,0,0,1426,A
2-PB1,1904,1421,0,0,0,1421,A
2-PB1,1905,1423,0,0,0,1423,A
2-PB1,1906,0,0,1434,0,1434,G
2-PB1,1907,1394,0,0,0,1394,A
2-PB1,1908,1399,0,0,0,1399,A
2-PB1,1909,1400,0,0,0,1400,A
2-PB1,1910,0,1395,0,0,1395,T
2-PB1,1911,0,1394,0,0,1394,T
2-PB1,1912,1,1,1393,0,1395,G
2-PB1,1913,1394,2,1,0,1397,A
2-PB1,1914,1374,0,0,1,1375,A
2-PB1,1915,1,1409,0,0,1410,T
2-PB1,1916,0,0,0,1420,1420,C
2-PB1,1917,0,1415,0,3,1418,T
2-PB1,1918,0,0,1438,0,1438,G
2-PB1,1919,0,1436,0,0,1436,T
2-PB1,1920,1450,0,0,0,1450,A
2-PB1,1921,1451,1,1,0,1453,A
2-PB1,1922,1443,3,0,0,1446,A
2-PB1,1923,0,0,0,1452,1452,C
2-PB1,1924,1416,0,0,0,1416,A
2-PB1,1925,1449,1,1,0,1451,A
2-PB1,1926,0,1456,0,0,1456,T
2-PB1,1927,0,1,1444,0,1445,G
2-PB1,1928,2,0,0,1448,1450,C
2-PB1,1929,0,1437,1,1,1439,T
2-PB1,1930,1,1,1483,0,1485,G
2-PB1,1931,0,1481,1,0,1482,T
2-PB1,1932,1503,0,0,0,1503,A
2-PB1,1933,0,0,1506,0,1506,G
2-PB1,1934,0,1468,0,0,1468,T
2-PB1,1935,1453,0,1,0,1454,A
2-PB1,1936,1437,0,0,0,1437,A
2-PB1,1937,0,1421,0,0,1421,T
2-PB1,1938,0,0,1420,0,1420,G
2-PB1,1939,2,0,0,1397,1399,C
2-PB1,1940,0,0,0,1388,1388,C
2-PB1,1941,1367,0,0,0,1367,A
2-PB1,1942,1,1,1364,0,1366,G
2-PB1,1943,1,0,0,1400,1401,C
2-PB1,1944,2,0,0,1399,1401,C
2-PB1,1945,1,1,1,1386,1389,C
2-PB1,1946,1387,0,0,0,1387,A
2-PB1,1947,0,1384,0,1,1385,T
2-PB1,1948,0,3,1386,0,1389,G
2-PB1,1949,0,0,1388,0,1388,G
2-PB1,1950,1,1385,0,2,1388,T
2-PB1,1951,2,1,0,1369,1372,C
2-PB1,1952,0,0,0,1322,1322,C
2-PB1,1953,1,1,1335,0,1337,G
2-PB1,1954,2,0,1332,0,1334,G
2-PB1,1955,0,0,0,1330,1330,C
2-PB1,1956,1,0,0,1335,1336,C
2-PB1,1957,1334,1,1,1,1337,A
2-PB1,1958,1343,0,0,0,1343,A
2-PB1,1959,1339,0,0,0,1339,A
2-PB1,1960,1342,0,1,0,1343,A
2-PB1,1961,0,0,1356,0,1356,G
2-PB1,1962,0,1323,0,0,1323,T
2-PB1,1963,1324,0,1,0,1325,A
2-PB1,1964,0,1328,0,0,1328,T
2-PB1,1965,1,0,1325,0,1326,G
2-PB1,1966,0,1,1348,1,1350,G
2-PB1,1967,1344,0,1,0,1345,A
2-PB1,1968,1356,0,0,0,1356,A
2-PB1,1969,0,1344,0,2,1346,T
2-PB1,1970,1335,0,0,0,1335,A
2-PB1,1971,0,1337,0,1,1338,T
2-PB1,1972,1,0,1332,0,1333,G
2-PB1,1973,1338,0,1,0,1339,A
2-PB1,1974,0,1334,0,0,1334,T
2-PB1,1975,0,0,1301,0,1301,G
2-PB1,1976,0,1,0,1291,1292,C
2-PB1,1977,0,0,0,1293,1293,C
2-PB1,1978,1,0,1292,0,1293,G
2-PB1,1979,1,1292,0,1,1294,T
2-PB1,1980,0,1293,1,2,1296,T
2-PB1,1981,1,0,1299,0,1300,G
2-PB1,1982,0,1,0,1313,1314,C
2-PB1,1983,1313,0,0,0,1313,A
2-PB1,1984,1317,0,0,0,1317,A
2-PB1,1985,0,0,0,1320,1320,C
2-PB1,1986,0,1307,0,0,1307,T
2-PB1,1987,1305,0,0,0,1305,A
2-PB1,1988,0,0,0,1301,1301,C
2-PB1,1989,1303,0,0,0,1303,A
2-PB1,1990,0,0,0,1303,1303,C
2-PB1,1991,1254,0,0,0,1254,A
2-PB1,1992,0,0,0,1333,1333,C
2-PB1,1993,0,1305,0,3,1308,T
2-PB1,1994,1,0,1,1311,1313,C
2-PB1,1995,1,0,0,1315,1316,C
2-PB1,1996,0,1305,0,1,1306,T
2-PB1,1997,1,0,1307,0,1308,G
2-PB1,1998,0,0,1307,0,1307,G
2-PB1,1999,1305,0,0,0,1305,A
2-PB1,2000,0,1304,0,0,1304,T
2-PB1,2001,0,1182,0,2,1184,T
2-PB1,2002,0,0,0,1198,1198,C
2-PB1,2003,0,0,0,1196,1196,C
2-PB1,2004,3,0,0,1199,1202,C
2-PB1,2005,1202,0,0,0,1202,A
2-PB1,2006,1199,0,0,0,1199,A
2-PB1,2007,0,0,1201,0,1201,G
2-PB1,2008,1191,0,1,0,1192,A
2-PB1,2009,0,2,1190,0,1192,G
2-PB1,2010,0,0,1194,0,1194,G
2-PB1,2011,1169,2,0,0,1171,A
2-PB1,2012,1147,0,24,0,1171,A
2-PB1,2013,0,1,0,1171,1172,C
2-PB1,2014,0,0,0,1162,1162,C
2-PB1,2015,0,0,1176,0,1176,G
2-PB1,2016,0,0,0,1172,1172,C
2-PB1,2017,1,1170,0,0,1171,T
2-PB1,2018,1,0,0,1176,1177,C
2-PB1,2019,0,1159,0,2,1161,T
2-PB1,2020,1219,0,0,0,1219,A
2-PB1,2021,0,1214,0,1,1215,T
2-PB1,2022,1,1219,0,0,1220,T
2-PB1,2023,0,0,0,1217,1217,C
2-PB1,2024,0,1182,0,0,1182,T
2-PB1,2025,1181,0,0,0,1181,A
2-PB1,2026,1179,0,1,0,1180,A
2-PB1,2027,1179,0,0,0,1179,A
2-PB1,2028,0,0,0,1179,1179,C
2-PB1,2029,1117,1,0,0,1118,A
2-PB1,2030,0,0,0,1120,1120,C
2-PB1,2031,1101,0,0,0,1101,A
2-PB1,2032,1109,1,0,1,1111,A
2-PB1,2033,1,0,1113,0,1114,G
2-PB1,2034,1,0,0,1113,1114,C
2-PB1,2035,0,0,0,1109,1109,C
2-PB1,2036,1099,0,0,0,1099,A
2-PB1,2037,1097,0,2,0,1099,A
2-PB1,2038,1101,0,0,1,1102,A
2-PB1,2039,0,2,1105,0,1107,G
2-PB1,2040,1,0,1104,0,1105,G
2-PB1,2041,0,0,1090,0,1090,G
2-PB1,2042,0,0,1092,0,1092,G
2-PB1,2043,1085,1,1,0,1087,A
2-PB1,2044,1093,0,0,0,1093,A
2-PB1,2045,0,1091,0,0,1091,T
2-PB1,2046,0,1086,0,1,1087,T
2-PB1,2047,1,0,0,1100,1101,C
2-PB1,2048,0,1089,0,0,1089,T
2-PB1,2049,0,1084,0,1,1085,T
2-PB1,2050,0,0,1082,0,1082,G
2-PB1,2051,1081,0,1,0,1082,A
2-PB1,2052,0,0,1084,0,1084,G
2-PB1,2053,0,0,1078,0,1078,G
2-PB1,2054,1073,0,0,0,1073,A
2-PB1,2055,1,1062,0,1,1064,T
2-PB1,2056,0,1,1067,0,1068,G
2-PB1,2057,1063,0,3,0,1066,A
2-PB1,2058,1063,0,1,0,1064,A
2-PB1,2059,0,0,0,1065,1065,C
2-PB1,2060,1053,0,0,0,1053,A
2-PB1,2061,0,0,1065,0,1065,G
2-PB1,2062,1056,0,1,0,1057,A
2-PB1,2063,0,1060,0,0,1060,T
2-PB1,2064,1,0,1061,0,1062,G
2-PB1,2065,0,1074,0,0,1074,T
2-PB1,2066,1072,0,0,0,1072,A
2-PB1,2067,0,0,0,1065,1065,C
2-PB1,2068,1,0,0,1060,1061,C
2-PB1,2069,1050,0,0,0,1050,A
2-PB1,2070,0,0,1047,0,1047,G
2-PB1,2071,1034,0,1,0,1035,A
2-PB1,2072,1033,0,0,0,1033,A
2-PB1,2073,0,0,1030,0,1030,G
2-PB1,2074,0,962,0,0,962,T
2-PB1,2075,0,1,964,0,965,G
2-PB1,2076,0,0,0,964,964,C
2-PB1,2077,0,961,1,1,963,T
2-PB1,2078,2,0,960,0,962,G
2-PB1,2079,0,0,0,958,958,C
2-PB1,2080,960,1,0,0,961,A
2-PB1,2081,961,1,0,0,962,A
2-PB1,2082,0,0,0,946,946,C
2-PB1,2083,0,944,0,1,945,T
2-PB1,2084,0,932,0,0,932,T
2-PB1,2085,0,0,932,0,932,G
2-PB1,2086,1,932,0,0,933,T
2-PB1,2087,0,932,0,0,932,T
2-PB1,2088,1,0,0,932,933,C
2-PB1,2089,0,1,930,0,931,G
2-PB1,2090,931,0,0,0,931,A
2-PB1,2091,0,1,929,0,930,G
2-PB1,2092,932,0,0,0,932,A
2-PB1,2093,929,1,1,0,931,A
2-PB1,2094,932,0,0,0,932,A
2-PB1,2095,1,930,0,0,931,T
2-PB1,2096,0,926,0,0,926,T
2-PB1,2097,0,926,0,0,926,T
2-PB1,2098,0,931,0,0,931,T
2-PB1,2099,0,928,0,1,929,T
2-PB1,2100,0,1,0,926,927,C
2-PB1,2101,1,1,0,929,931,C
2-PB1,2102,3,0,0,922,925,C
2-PB1,2103,0,920,0,1,921,T
2-PB1,2104,924,0,0,0,924,A
2-PB1,2105,0,0,930,0,930,G
2-PB1,2106,0,928,0,0,928,T
2-PB1,2107,927,0,1,0,928,A
2-PB1,2108,0,0,932,0,932,G
2-PB1,2109,0,926,0,0,926,T
2-PB1,2110,0,948,0,0,948,T
2-PB1,2111,1,0,0,952,953,C
2-PB1,2112,966,0,0,0,966,A
2-PB1,2113,0,966,0,0,966,T
2-PB1,2114,966,0,1,0,967,A
2-PB1,2115,0,966,0,0,966,T
2-PB1,2116,940,0,0,0,940,A
2-PB1,2117,1,0,929,0,930,G
2-PB1,2118,0,0,927,0,927,G
2-PB1,2119,837,0,1,0,838,A
2-PB1,2120,0,0,837,0,837,G
2-PB1,2121,795,0,0,0,795,A
2-PB1,2122,0,0,0,793,793,C
2-PB1,2123,0,1,0,767,768,C
2-PB1,2124,1,0,765,0,766,G
2-PB1,2125,761,0,0,0,761,A
2-PB1,2126,0,759,0,1,760,T
2-PB1,2127,0,760,0,1,761,T
2-PB1,2128,0,0,759,0,759,G
2-PB1,2129,1,0,757,0,758,G
2-PB1,2130,758,0,0,0,758,A
2-PB1,2131,753,0,0,0,753,A
2-PB1,2132,1,746,0,0,747,T
2-PB1,2133,0,748,0,0,748,T
2-PB1,2134,0,751,0,0,751,T
2-PB1,2135,1,0,0,751,752,C
2-PB1,2136,0,744,0,6,750,T
2-PB1,2137,743,0,2,0,745,A
2-PB1,2138,0,0,744,0,744,G
2-PB1,2139,0,0,1,744,745,C
2-PB1,2140,743,0,0,0,743,A
2-PB1,2141,0,740,0,0,740,T
2-PB1,2142,0,0,728,1,729,G
2-PB1,2143,0,0,740,0,740,G
2-PB1,2144,0,738,0,0,738,T
2-PB1,2145,0,0,739,0,739,G
2-PB1,2146,0,0,731,0,731,G
2-PB1,2147,726,0,2,0,728,A
2-PB1,2148,0,0,723,0,723,G
2-PB1,2149,0,0,724,0,724,G
2-PB1,2150,0,0,0,716,716,C
2-PB1,2151,0,0,0,708,708,C
2-PB1,2152,665,0,0,0,665,A
2-PB1,2153,0,662,0,0,662,T
2-PB1,2154,0,0,671,0,671,G
2-PB1,2155,0,0,676,0,676,G
2-PB1,2156,1,656,0,0,657,T
2-PB1,2157,0,0,655,0,655,G
2-PB1,2158,0,643,0,1,644,T
2-PB1,2159,0,0,0,640,640,C
2-PB1,2160,0,641,0,0,641,T
2-PB1,2161,640,0,0,0,640,A
2-PB1,2162,1,0,640,0,641,G
2-PB1,2163,0,0,628,0,628,G
2-PB1,2164,0,0,626,0,626,G
2-PB1,2165,0,0,0,610,610,C
2-PB1,2166,0,0,0,582,582,C
2-PB1,2167,0,0,0,565,565,C
2-PB1,2168,0,0,565,0,565,G
2-PB1,2169,0,0,564,0,564,G
2-PB1,2170,563,0,0,0,563,A
2-PB1,2171,2,562,0,0,564,T
2-PB1,2172,0,542,0,0,542,T
2-PB1,2173,1,0,534,0,535,G
2-PB1,2174,531,0,0,0,531,A
2-PB1,2175,0,534,0,0,534,T
2-PB1,2176,0,0,532,0,532,G
2-PB1,2177,0,1,0,529,530,C
2-PB1,2178,0,0,0,529,529,C
2-PB1,2179,523,1,0,0,524,A
2-PB1,2180,0,1,525,0,526,G
2-PB1,2181,527,0,0,0,527,A
2-PB1,2182,525,0,0,0,525,A
2-PB1,2183,0,523,0,0,523,T
2-PB1,2184,0,510,0,0,510,T
2-PB1,2185,0,0,512,0,512,G
2-PB1,2186,511,0,0,0,511,A
2-PB1,2187,0,505,0,0,505,T
2-PB1,2188,0,504,0,1,505,T
2-PB1,2189,0,504,0,0,504,T
2-PB1,2190,0,0,0,507,507,C
2-PB1,2191,0,2,503,0,505,G
2-PB1,2192,504,0,0,0,504,A
2-PB1,2193,0,0,497,0,497,G
2-PB1,2194,0,502,0,0,502,T
2-PB1,2195,0,0,0,501,501,C
2-PB1,2196,0,501,0,0,501,T
2-PB1,2197,0,0,502,0,502,G
2-PB1,2198,0,0,501,0,501,G
2-PB1,2199,502,0,0,0,502,A
2-PB1,2200,472,0,0,0,472,A
2-PB1,2201,0,0,470,0,470,G
2-PB1,2202,0,1,472,0,473,G
2-PB1,2203,474,0,0,0,474,A
2-PB1,2204,0,468,1,0,469,T
2-PB1,2205,0,470,1,0,471,T
2-PB1,2206,468,0,0,0,468,A
2-PB1,2207,470,0,0,0,470,A
2-PB1,2208,0,0,469,0,469,G
2-PB1,2209,468,0,0,0,468,A
2-PB1,2210,444,0,0,0,444,A
2-PB1,2211,0,0,408,0,408,G
2-PB1,2212,0,0,407,0,407,G
2-PB1,2213,407,0,0,0,407,A
2-PB1,2214,406,1,0,0,407,A
2-PB1,2215,0,0,407,0,407,G
2-PB1,2216,374,0,0,0,374,A
2-PB1,2217,0,0,374,0,374,G
2-PB1,2218,0,357,0,0,357,T
2-PB1,2219,0,352,0,0,352,T
2-PB1,2220,0,0,0,354,354,C
2-PB1,2221,0,348,0,0,348,T
2-PB1,2222,0,0,0,349,349,C
2-PB1,2223,0,345,0,0,345,T
2-PB1,2224,0,0,345,0,345,G
2-PB1,2225,341,0,0,0,341,A
2-PB1,2226,0,0,336,0,336,G
2-PB1,2227,330,0,0,0,330,A
2-PB1,2228,0,318,0,0,318,T
2-PB1,2229,0,0,0,296,296,C
2-PB1,2230,299,0,0,0,299,A
2-PB1,2231,0,298,0,0,298,T
2-PB1,2232,0,0,298,0,298,G
2-PB1,2233,296,0,2,0,298,A
2-PB1,2234,295,0,2,0,297,A
2-PB1,2235,0,1,289,0,290,G
2-PB1,2236,287,1,0,0,288,A
2-PB1,2237,0,285,0,0,285,T
2-PB1,2238,0,0,0,279,279,C
2-PB1,2239,0,255,0,0,255,T
2-PB1,2240,0,0,255,0,255,G
2-PB1,2241,0,255,0,0,255,T
2-PB1,2242,0,254,0,0,254,T
2-PB1,2243,0,0,0,253,253,C
2-PB1,2244,0,0,0,243,243,C
2-PB1,2245,241,0,0,1,242,A
2-PB1,2246,0,0,0,243,243,C
2-PB1,2247,0,0,0,235,235,C
2-PB1,2248,224,0,0,1,225,A
2-PB1,2249,0,206,0,0,206,T
2-PB1,2250,0,202,0,0,202,T
2-PB1,2251,0,0,202,0,202,G
2-PB1,2252,199,0,0,0,199,A
2-PB1,2253,198,0,0,0,198,A
2-PB1,2254,0,0,197,0,197,G
2-PB1,2255,178,0,0,0,178,A
2-PB1,2256,179,0,0,0,179,A
2-PB1,2257,0,0,0,178,178,C
2-PB1,2258,0,170,0,0,170,T
2-PB1,2259,0,0,0,169,169,C
2-PB1,2260,164,0,0,0,164,A
2-PB1,2261,0,0,164,0,164,G
2-PB1,2262,164,0,0,0,164,A
2-PB1,2263,0,0,0,155,155,C
2-PB1,2264,0,0,153,0,153,G
2-PB1,2265,0,0,151,0,151,G
2-PB1,2266,0,0,0,149,149,C
2-PB1,2267,149,0,0,0,149,A
2-PB1,2268,147,0,0,0,147,A
2-PB1,2269,147,0,0,0,147,A
2-PB1,2270,147,0,0,0,147,A
2-PB1,2271,146,0,0,0,146,A
2-PB1,2272,0,144,0,0,144,T
2-PB1,2273,139,0,0,0,139,A
2-PB1,2274,139,0,0,0,139,A
3-PA,1,27,0,0,0,27,A
3-PA,2,0,27,0,0,27,T
3-PA,3,0,0,29,0,29,G
3-PA,4,0,0,29,0,29,G
3-PA,5,29,0,0,0,29,A
3-PA,6,29,0,0,0,29,A
3-PA,7,0,0,30,0,30,G
3-PA,8,31,0,0,0,31,A
3-PA,9,0,31,0,0,31,T
3-PA,10,0,32,0,0,32,T
3-PA,11,0,34,0,0,34,T
3-PA,12,0,34,0,0,34,T
3-PA,13,0,0,35,0,35,G
3-PA,14,0,35,0,0,35,T
3-PA,15,0,0,35,0,35,G
3-PA,16,0,0,0,35,35,C
3-PA,17,0,0,35,0,35,G
3-PA,18,36,0,0,0,36,A
3-PA,19,0,0,0,36,36,C
3-PA,20,36,0,0,0,36,A
3-PA,21,36,0,0,0,36,A
3-PA,22,0,38,0,0,38,T
3-PA,23,0,0,42,0,42,G
3-PA,24,0,0,0,42,42,C
3-PA,25,0,42,0,0,42,T
3-PA,26,0,42,0,0,42,T
3-PA,27,0,0,0,42,42,C
3-PA,28,42,0,0,0,42,A
3-PA,29,42,0,0,0,42,A
3-PA,30,0,0,0,44,44,C
3-PA,31,0,0,0,44,44,C
3-PA,32,0,0,0,44,44,C
3-PA,33,0,0,44,0,44,G
3-PA,34,44,0,0,0,44,A
3-PA,35,0,45,0,0,45,T
3-PA,36,0,0,45,0,45,G
3-PA,37,45,0,0,0,45,A
3-PA,38,0,44,0,0,44,T
3-PA,39,0,44,0,0,44,T
3-PA,40,0,0,44,0,44,G
3-PA,41,0,44,0,0,44,T
3-PA,42,0,0,0,44,44,C
3-PA,43,0,0,44,0,44,G
3-PA,44,44,0,0,0,44,A
3-PA,45,44,0,0,0,44,A
3-PA,46,0,0,0,45,45,C
3-PA,47,0,45,0,0,45,T
3-PA,48,0,45,0,0,45,T
3-PA,49,0,0,46,0,46,G
3-PA,50,0,0,0,46,46,C
3-PA,51,46,0,0,0,46,A
3-PA,52,0,0,46,0,46,G
3-PA,53,46,0,0,0,46,A
3-PA,54,46,0,0,0,46,A
3-PA,55,46,0,0,0,46,A
3-PA,56,46,0,0,0,46,A
3-PA,57,47,0,0,0,47,A
3-PA,58,0,0,47,0,47,G
3-PA,59,0,0,0,49,49,C
3-PA,60,49,0,0,0,49,A
3-PA,61,50,0,0,0,50,A
3-PA,62,0,51,0,0,51,T
3-PA,63,0,0,52,0,52,G
3-PA,64,51,0,0,0,51,A
3-PA,65,51,0,0,0,51,A
3-PA,66,51,0,0,0,51,A
3-PA,67,0,0,51,0,51,G
3-PA,68,55,0,0,0,55,A
3-PA,69,0,0,71,0,71,G
3-PA,70,0,71,0,0,71,T
3-PA,71,72,0,0,0,72,A
3-PA,72,0,72,0,0,72,T
3-PA,73,0,0,71,0,71,G
3-PA,74,0,0,70,0,70,G
3-PA,75,0,0,71,0,71,G
3-PA,76,0,0,71,0,71,G
3-PA,77,70,0,0,0,70,A
3-PA,78,0,0,70,0,70,G
3-PA,79,0,0,70,0,70,G
3-PA,80,70,0,0,0,70,A
3-PA,81,0,70,0,0,70,T
3-PA,82,0,0,0,70,70,C
3-PA,83,0,69,0,0,69,T
3-PA,84,0,0,68,0,68,G
3-PA,85,68,0,0,0,68,A
3-PA,86,68,0,0,0,68,A
3-PA,87,68,0,0,0,68,A
3-PA,88,68,0,0,0,68,A
3-PA,89,0,68,0,0,68,T
3-PA,90,0,68,0,0,68,T
3-PA,91,0,0,68,0,68,G
3-PA,92,68,0,0,0,68,A
3-PA,93,68,0,0,0,68,A
3-PA,94,67,0,1,0,68,A
3-PA,95,0,0,0,68,68,C
3-PA,96,67,0,0,0,67,A
3-PA,97,68,0,0,0,68,A
3-PA,98,68,0,0,0,68,A
3-PA,99,0,0,0,69,69,C
3-PA,100,69,0,0,0,69,A
3-PA,101,69,0,0,0,69,A
3-PA,102,70,0,0,0,70,A
3-PA,103,0,70,0,0,70,T
3-PA,104,0,71,0,0,71,T
3-PA,105,0,71,0,0,71,T
3-PA,106,0,0,70,0,70,G
3-PA,107,0,0,0,71,71,C
3-PA,108,71,0,0,0,71,A
3-PA,109,0,0,74,0,74,G
3-PA,110,0,0,0,75,75,C
3-PA,111,80,0,0,0,80,A
3-PA,112,80,0,0,0,80,A
3-PA,113,0,80,0,0,80,T
3-PA,114,80,0,0,0,80,A
3-PA,115,0,81,0,0,81,T
3-PA,116,0,0,81,0,81,G
3-PA,117,0,0,0,80,80,C
3-PA,118,79,0,0,0,79,A
3-PA,119,0,0,0,81,81,C
3-PA,120,0,80,0,0,80,T
3-PA,121,0,0,0,98,98,C
3-PA,122,104,0,0,0,104,A
3-PA,123,0,0,0,106,106,C
3-PA,124,0,105,0,1,106,T
3-PA,125,0,106,0,0,106,T
3-PA,126,1,0,105,0,106,G
3-PA,127,0,0,108,0,108,G
3-PA,128,107,0,0,0,107,A
3-PA,129,0,1,107,0,108,G
3-PA,130,0,0,110,0,110,G
3-PA,131,0,108,0,0,108,T
3-PA,132,0,0,116,0,116,G
3-PA,133,1,115,0,0,116,T
3-PA,134,0,0,118,0,118,G
3-PA,135,1,116,0,1,118,T
3-PA,136,0,118,0,0,118,T
3-PA,137,0,118,0,0,118,T
3-PA,138,0,0,0,118,118,C
3-PA,139,116,0,0,0,116,A
3-PA,140,0,118,0,0,118,T
3-PA,141,0,0,120,0,120,G
3-PA,142,0,120,0,0,120,T
3-PA,143,123,0,0,0,123,A
3-PA,144,0,123,0,0,123,T
3-PA,145,0,123,0,0,123,T
3-PA,146,0,0,0,123,123,C
3-PA,147,122,0,0,0,122,A
3-PA,148,0,0,124,0,124,G
3-PA,149,124,0,0,0,124,A
3-PA,150,0,124,0,0,124,T
3-PA,151,0,124,0,0,124,T
3-PA,152,1,122,0,1,124,T
3-PA,153,0,0,0,123,123,C
3-PA,154,0,0,0,127,127,C
3-PA,155,127,0,0,0,127,A
3-PA,156,0,126,0,1,127,T
3-PA,157,0,125,0,0,125,T
3-PA,158,0,126,0,0,126,T
3-PA,159,0,0,0,126,126,C
3-PA,160,125,1,0,0,126,A
3-PA,161,0,129,0,0,129,T
3-PA,162,0,0,0,129,129,C
3-PA,163,129,0,0,0,129,A
3-PA,164,129,0,0,0,129,A
3-PA,165,0,129,0,0,129,T
3-PA,166,0,0,134,0,134,G
3-PA,167,134,0,0,0,134,A
3-PA,168,133,0,0,0,133,A
3-PA,169,0,0,0,133,133,C
3-PA,170,131,0,0,0,131,A
3-PA,171,134,0,0,0,134,A
3-PA,172,0,0,135,0,135,G
3-PA,173,0,0,135,0,135,G
3-PA,174,0,2,0,133,135,C
3-PA,175,1,0,131,0,132,G
3-PA,176,134,0,0,0,134,A
3-PA,177,135,0,0,0,135,A
3-PA,178,0,135,0,0,135,T
3-PA,179,1,0,0,137,138,C
3-PA,180,139,0,0,0,139,A
3-PA,181,140,0,0,0,140,A
3-PA,182,0,142,0,0,142,T
3-PA,183,142,0,0,0,142,A
3-PA,184,0,0,146,0,146,G
3-PA,185,0,148,0,1,149,T
3-PA,186,0,0,149,0,149,G
3-PA,187,0,0,149,0,149,G
3-PA,188,0,146,0,0,146,T
3-PA,189,146,0,0,0,146,A
3-PA,190,0,0,146,0,146,G
3-PA,191,147,0,0,0,147,A
3-PA,192,147,0,0,0,147,A
3-PA,193,0,0,0,144,144,C
3-PA,194,0,144,1,0,145,T
3-PA,195,0,145,0,0,145,T
3-PA,196,0,0,146,0,146,G
3-PA,197,146,0,0,0,146,A
3-PA,198,0,1,0,145,146,C
3-PA,199,0,0,145,0,145,G
3-PA,200,149,0,0,0,149,A
3-PA,201,0,153,0,0,153,T
3-PA,202,0,0,0,154,154,C
3-PA,203,0,0,0,155,155,C
3-PA,204,154,0,0,1,155,A
3-PA,205,155,0,0,0,155,A
3-PA,206,156,0,0,0,156,A
3-PA,207,0,156,0,0,156,T
3-PA,208,0,0,156,0,156,G
3-PA,209,0,0,0,154,154,C
3-PA,210,155,0,0,0,155,A
3-PA,211,0,0,0,160,160,C
3-PA,212,0,159,0,0,159,T
3-PA,213,0,0,186,0,186,G
3-PA,214,0,187,0,0,187,T
3-PA,215,0,187,0,0,187,T
3-PA,216,187,0,0,0,187,A
3-PA,217,187,0,0,0,187,A
3-PA,218,186,0,0,0,186,A
3-PA,219,0,0,187,0,187,G
3-PA,220,0,0,0,188,188,C
3-PA,221,186,0,1,0,187,A
3-PA,222,0,0,0,185,185,C
3-PA,223,177,1,0,0,178,A
3-PA,224,0,0,182,0,182,G
3-PA,225,181,0,1,0,182,A
3-PA,226,0,182,0,0,182,T
3-PA,227,0,179,0,0,179,T
3-PA,228,0,182,0,0,182,T
3-PA,229,0,0,182,0,182,G
3-PA,230,181,0,0,0,181,A
3-PA,231,182,0,0,0,182,A
3-PA,232,181,0,0,0,181,A
3-PA,233,0,177,0,0,177,T
3-PA,234,179,0,0,0,179,A
3-PA,235,183,0,0,0,183,A
3-PA,236,0,183,0,0,183,T
3-PA,237,1,0,0,182,183,C
3-PA,238,0,0,183,0,183,G
3-PA,239,184,0,0,0,184,A
3-PA,240,0,0,183,0,183,G
3-PA,241,0,0,188,0,188,G
3-PA,242,0,0,187,0,187,G
3-PA,243,0,0,186,0,186,G
3-PA,244,185,0,0,0,185,A
3-PA,245,0,0,184,0,184,G
3-PA,246,189,0,0,0,189,A
3-PA,247,0,0,188,0,188,G
3-PA,248,189,0,0,0,189,A
3-PA,249,0,0,0,189,189,C
3-PA,250,188,0,0,0,188,A
3-PA,251,0,0,191,0,191,G
3-PA,252,191,0,0,0,191,A
3-PA,253,200,0,0,0,200,A
3-PA,254,0,0,0,200,200,C
3-PA,255,194,0,0,0,194,A
3-PA,256,193,0,1,0,194,A
3-PA,257,0,194,0,0,194,T
3-PA,258,0,0,208,0,208,G
3-PA,259,0,0,210,0,210,G
3-PA,260,0,0,0,210,210,C
3-PA,261,0,0,0,210,210,C
3-PA,262,0,210,0,0,210,T
3-PA,263,0,0,217,0,217,G
3-PA,264,0,0,216,0,216,G
3-PA,265,215,1,1,0,217,A
3-PA,266,0,0,0,216,216,C
3-PA,267,215,0,0,0,215,A
3-PA,268,0,0,255,0,255,G
3-PA,269,0,255,0,0,255,T
3-PA,270,257,0,0,0,257,A
3-PA,271,0,1,257,0,258,G
3-PA,272,0,254,0,0,254,T
3-PA,273,255,0,0,0,255,A
3-PA,274,254,0,0,0,254,A
3-PA,275,255,0,0,0,255,A
3-PA,276,0,0,0,256,256,C
3-PA,277,245,0,0,0,245,A
3-PA,278,0,0,248,0,248,G
3-PA,279,0,248,0,0,248,T
3-PA,280,251,0,0,0,251,A
3-PA,281,0,249,0,0,249,T
3-PA,282,0,0,0,256,256,C
3-PA,283,0,257,0,0,257,T
3-PA,284,0,0,255,0,255,G
3-PA,285,0,0,0,254,254,C
3-PA,286,253,0,0,0,253,A
3-PA,287,253,0,0,0,253,A
3-PA,288,0,0,0,256,256,C
3-PA,289,253,0,0,0,253,A
3-PA,290,0,0,0,262,262,C
3-PA,291,0,259,0,0,259,T
3-PA,292,263,0,0,0,263,A
3-PA,293,0,0,0,263,263,C
3-PA,294,0,261,0,0,261,T
3-PA,295,0,0,262,0,262,G
3-PA,296,0,0,259,0,259,G
3-PA,297,255,0,2,0,257,A
3-PA,298,0,0,258,0,258,G
3-PA,299,0,0,0,253,253,C
3-PA,300,0,253,0,2,255,T
3-PA,301,0,0,250,0,250,G
3-PA,302,0,0,252,0,252,G
3-PA,303,253,0,0,0,253,A
3-PA,304,253,0,0,0,253,A
3-PA,305,251,0,0,0,251,A
3-PA,306,255,0,0,0,255,A
3-PA,307,0,0,0,252,252,C
3-PA,308,1,0,0,252,253,C
3-PA,309,1,0,253,0,254,G
3-PA,310,254,0,0,0,254,A
3-PA,311,250,0,0,0,250,A
3-PA,312,0,0,256,0,256,G
3-PA,313,0,256,0,0,256,T
3-PA,314,0,257,0,0,257,T
3-PA,315,0,257,0,0,257,T
3-PA,316,0,0,0,258,258,C
3-PA,317,0,256,0,0,256,T
3-PA,318,257,0,0,0,257,A
3-PA,319,0,0,0,256,256,C
3-PA,320,0,0,0,259,259,C
3-PA,321,259,0,0,0,259,A
3-PA,322,0,0,259,0,259,G
3-PA,323,257,1,0,0,258,A
3-PA,324,0,0,0,255,255,C
3-PA,325,0,264,0,0,264,T
3-PA,326,0,266,0,0,266,T
3-PA,327,0,0,265,0,265,G
3-PA,328,0,267,0,0,267,T
3-PA,329,267,0,0,0,267,A
3-PA,330,0,267,0,0,267,T
3-PA,331,0,0,266,0,266,G
3-PA,332,282,0,0,0,282,A
3-PA,333,0,280,0,0,280,T
3-PA,334,0,281,0,0,281,T
3-PA,335,282,0,0,0,282,A
3-PA,336,0,0,0,282,282,C
3-PA,337,283,0,0,0,283,A
3-PA,338,284,0,0,0,284,A
3-PA,339,0,0,284,0,284,G
3-PA,340,0,0,282,0,282,G
3-PA,341,276,0,0,0,276,A
3-PA,342,0,1,277,0,278,G
3-PA,343,278,0,0,0,278,A
3-PA,344,279,0,0,0,279,A
3-PA,345,0,0,0,279,279,C
3-PA,346,276,0,0,0,276,A
3-PA,347,0,0,275,0,275,G
3-PA,348,275,0,0,0,275,A
3-PA,349,1,269,0,0,270,T
3-PA,350,0,270,0,1,271,T
3-PA,351,0,0,0,268,268,C
3-PA,352,1,0,267,0,268,G
3-PA,353,0,264,0,0,264,T
3-PA,354,0,0,0,264,264,C
3-PA,355,0,0,267,0,267,G
3-PA,356,269,0,0,0,269,A
3-PA,357,269,0,0,0,269,A
3-PA,358,266,0,1,0,267,A
3-PA,359,0,270,0,0,270,T
3-PA,360,0,269,0,0,269,T
3-PA,361,0,0,269,0,269,G
3-PA,362,0,2,266,0,268,G
3-PA,363,0,0,268,0,268,G
3-PA,364,0,0,269,0,269,G
3-PA,365,0,265,0,0,265,T
3-PA,366,0,0,269,0,269,G
3-PA,367,270,0,0,0,270,A
3-PA,368,0,0,0,271,271,C
3-PA,369,272,0,0,0,272,A
3-PA,370,271,0,0,0,271,A
3-PA,371,0,0,274,0,274,G
3-PA,372,0,0,275,0,275,G
3-PA,373,275,0,0,0,275,A
3-PA,374,0,1,274,0,275,G
3-PA,375,271,0,0,0,271,A
3-PA,376,0,0,271,0,271,G
3-PA,377,269,0,0,0,269,A
3-PA,378,268,0,1,0,269,A
3-PA,379,0,0,272,0,272,G
3-PA,380,0,271,0,0,271,T
3-PA,381,0,0,0,266,266,C
3-PA,382,0,0,1,268,269,C
3-PA,383,270,0,1,0,271,A
3-PA,384,0,0,0,278,278,C
3-PA,385,289,0,0,0,289,A
3-PA,386,0,294,0,0,294,T
3-PA,387,297,0,0,0,297,A
3-PA,388,0,291,0,0,291,T
3-PA,389,292,0,0,0,292,A
3-PA,390,0,283,0,1,284,T
3-PA,391,0,284,0,0,284,T
3-PA,392,291,0,0,0,291,A
3-PA,393,0,0,0,290,290,C
3-PA,394,0,0,0,270,270,C
3-PA,395,0,262,0,0,262,T
3-PA,396,0,261,0,0,261,T
3-PA,397,0,0,264,0,264,G
3-PA,398,261,0,0,0,261,A
3-PA,399,264,0,0,0,264,A
3-PA,400,263,0,1,0,264,A
3-PA,401,249,0,1,0,250,A
3-PA,402,0,0,251,0,251,G
3-PA,403,0,0,249,0,249,G
3-PA,404,0,1,0,251,252,C
3-PA,405,0,0,0,252,252,C
3-PA,406,252,0,0,0,252,A
3-PA,407,251,0,0,0,251,A
3-PA,408,0,252,0,0,252,T
3-PA,409,252,0,0,0,252,A
3-PA,410,251,0,0,0,251,A
3-PA,411,0,0,256,0,256,G
3-PA,412,255,0,0,0,255,A
3-PA,413,0,254,0,0,254,T
3-PA,414,0,255,0,0,255,T
3-PA,415,255,0,0,0,255,A
3-PA,416,254,0,0,0,254,A
3-PA,417,255,0,0,0,255,A
3-PA,418,0,253,0,0,253,T
3-PA,419,1,0,0,254,255,C
3-PA,420,0,254,0,0,254,T
3-PA,421,0,0,258,0,258,G
3-PA,422,256,0,0,0,256,A
3-PA,423,0,0,257,0,257,G
3-PA,424,258,0,0,0,258,A
3-PA,425,260,0,0,0,260,A
3-PA,426,0,0,0,262,262,C
3-PA,427,261,0,0,0,261,A
3-PA,428,0,0,0,263,263,C
3-PA,429,260,0,1,0,261,A
3-PA,430,0,1,0,264,265,C
3-PA,431,258,0,0,0,258,A
3-PA,432,0,0,0,260,260,C
3-PA,433,260,0,0,0,260,A
3-PA,434,0,260,0,0,260,T
3-PA,435,0,261,0,0,261,T
3-PA,436,0,1,0,263,264,C
3-PA,437,264,0,0,0,264,A
3-PA,438,1,0,0,263,264,C
3-PA,439,259,0,0,0,259,A
3-PA,440,0,258,0,0,258,T
3-PA,441,0,256,0,0,256,T
3-PA,442,0,257,0,0,257,T
3-PA,443,0,256,0,0,256,T
3-PA,444,0,0,0,261,261,C
3-PA,445,0,259,0,1,260,T
3-PA,446,0,0,0,261,261,C
3-PA,447,260,0,0,0,260,A
3-PA,448,0,259,0,0,259,T
3-PA,449,0,258,0,0,258,T
3-PA,450,0,0,0,262,262,C
3-PA,451,261,1,0,0,262,A
3-PA,452,0,0,0,265,265,C
3-PA,453,0,263,0,0,263,T
3-PA,454,0,1,264,0,265,G
3-PA,455,0,0,263,0,263,G
3-PA,456,0,0,267,0,267,G
3-PA,457,0,0,267,0,267,G
3-PA,458,265,0,0,0,265,A
3-PA,459,0,0,265,0,265,G
3-PA,460,0,0,264,0,264,G
3-PA,461,261,0,1,0,262,A
3-PA,462,263,0,0,0,263,A
3-PA,463,255,0,2,0,257,A
3-PA,464,0,255,0,0,255,T
3-PA,465,0,1,258,1,260,G
3-PA,466,0,0,259,0,259,G
3-PA,467,0,0,0,257,257,C
3-PA,468,1,0,0,255,256,C
3-PA,469,258,0,0,0,258,A
3-PA,470,0,0,0,259,259,C
3-PA,471,256,1,0,0,257,A
3-PA,472,258,0,0,0,258,A
3-PA,473,258,0,1,0,259,A
3-PA,474,0,0,255,0,255,G
3-PA,475,0,0,255,0,255,G
3-PA,476,0,0,0,255,255,C
3-PA,477,259,0,0,0,259,A
3-PA,478,0,0,264,0,264,G
3-PA,479,267,0,0,0,267,A
3-PA,480,0,0,0,272,272,C
3-PA,481,0,270,0,0,270,T
3-PA,482,271,0,1,0,272,A
3-PA,483,0,0,0,270,270,C
3-PA,484,268,0,0,0,268,A
3-PA,485,0,0,0,270,270,C
3-PA,486,0,262,0,0,262,T
3-PA,487,0,0,0,264,264,C
3-PA,488,0,263,0,0,263,T
3-PA,489,0,0,0,259,259,C
3-PA,490,0,0,260,0,260,G
3-PA,491,259,0,0,0,259,A
3-PA,492,0,0,0,259,259,C
3-PA,493,0,0,261,0,261,G
3-PA,494,256,0,0,1,257,A
3-PA,495,0,0,258,0,258,G
3-PA,496,0,0,256,0,256,G
3-PA,497,256,0,0,0,256,A
3-PA,498,258,0,0,0,258,A
3-PA,499,259,0,0,0,259,A
3-PA,500,0,0,258,0,258,G
3-PA,501,0,0,0,258,258,C
3-PA,502,257,0,0,0,257,A
3-PA,503,0,0,261,0,261,G
3-PA,504,0,0,259,0,259,G
3-PA,505,0,0,261,0,261,G
3-PA,506,0,0,0,261,261,C
3-PA,507,0,257,0,1,258,T
3-PA,508,259,0,0,0,259,A
3-PA,509,0,0,260,0,260,G
3-PA,510,0,1,271,0,272,G
3-PA,511,271,0,0,0,271,A
3-PA,512,0,261,0,0,261,T
3-PA,513,0,257,0,0,257,T
3-PA,514,258,0,0,0,258,A
3-PA,515,260,1,0,0,261,A
3-PA,516,0,0,262,0,262,G
3-PA,517,261,0,1,0,262,A
3-PA,518,0,0,0,260,260,C
3-PA,519,0,0,0,241,241,C
3-PA,520,240,0,1,0,241,A
3-PA,521,0,0,244,0,244,G
3-PA,522,0,0,244,0,244,G
3-PA,523,0,0,0,243,243,C
3-PA,524,0,242,0,0,242,T
3-PA,525,1,0,245,0,246,G
3-PA,526,0,246,0,0,246,T
3-PA,527,0,246,0,1,247,T
3-PA,528,0,249,0,0,249,T
3-PA,529,249,0,0,0,249,A
3-PA,530,0,0,0,251,251,C
3-PA,531,0,0,0,250,250,C
3-PA,532,246,0,0,0,246,A
3-PA,533,0,246,0,0,246,T
3-PA,534,231,0,0,0,231,A
3-PA,535,231,0,0,1,232,A
3-PA,536,0,0,233,0,233,G
3-PA,537,233,1,0,0,234,A
3-PA,538,0,0,0,233,233,C
3-PA,539,228,0,0,0,228,A
3-PA,540,229,0,0,0,229,A
3-PA,541,0,0,232,0,232,G
3-PA,542,230,0,0,0,230,A
3-PA,543,231,0,0,0,231,A
3-PA,544,226,0,0,0,226,A
3-PA,545,0,223,0,0,223,T
3-PA,546,0,0,231,0,231,G
3-PA,547,0,0,231,0,231,G
3-PA,548,0,0,0,231,231,C
3-PA,549,0,0,0,233,233,C
3-PA,550,231,0,0,0,231,A
3-PA,551,231,0,0,0,231,A
3-PA,552,0,220,0,0,220,T
3-PA,553,224,0,0,0,224,A
3-PA,554,0,0,221,0,221,G
3-PA,555,223,0,0,0,223,A
3-PA,556,1,0,223,0,224,G
3-PA,557,0,0,221,0,221,G
3-PA,558,0,0,0,221,221,C
3-PA,559,0,0,0,224,224,C
3-PA,560,0,215,0,0,215,T
3-PA,561,0,0,0,221,221,C
3-PA,562,0,222,0,0,222,T
3-PA,563,0,0,221,0,221,G
3-PA,564,0,0,217,0,217,G
3-PA,565,0,0,219,0,219,G
3-PA,566,215,0,1,0,216,A
3-PA,567,0,214,0,0,214,T
3-PA,568,0,211,0,0,211,T
3-PA,569,0,0,0,293,293,C
3-PA,570,0,0,0,291,291,C
3-PA,571,0,285,0,1,286,T
3-PA,572,0,291,0,0,291,T
3-PA,573,0,291,0,0,291,T
3-PA,574,0,0,0,303,303,C
3-PA,575,0,0,304,0,304,G
3-PA,576,0,305,0,0,305,T
3-PA,577,0,0,0,309,309,C
3-PA,578,301,0,1,0,302,A
3-PA,579,0,0,459,0,459,G
3-PA,580,0,462,0,0,462,T
3-PA,581,0,0,0,462,462,C
3-PA,582,0,0,0,470,470,C
3-PA,583,0,0,477,0,477,G
3-PA,584,478,0,0,0,478,A
3-PA,585,480,0,0,0,480,A
3-PA,586,480,0,1,0,481,A
3-PA,587,0,0,504,0,504,G
3-PA,588,490,0,0,0,490,A
3-PA,589,0,1,501,0,502,G
3-PA,590,0,1,505,0,506,G
3-PA,591,0,0,0,509,509,C
3-PA,592,0,0,510,0,510,G
3-PA,593,508,0,0,0,508,A
3-PA,594,515,0,1,0,516,A
3-PA,595,0,0,524,0,524,G
3-PA,596,530,0,0,0,530,A
3-PA,597,530,0,1,0,531,A
3-PA,598,529,0,2,0,531,A
3-PA,599,0,0,0,540,540,C
3-PA,600,540,0,0,0,540,A
3-PA,601,540,0,0,0,540,A
3-PA,602,0,538,0,0,538,T
3-PA,603,0,537,0,0,537,T
3-PA,604,0,0,540,0,540,G
3-PA,605,537,0,0,0,537,A
3-PA,606,533,1,2,0,536,A
3-PA,607,0,1,539,0,540,G
3-PA,608,539,0,0,0,539,A
3-PA,609,537,0,1,0,538,A
3-PA,610,538,0,1,0,539,A
3-PA,611,540,0,0,0,540,A
3-PA,612,540,0,1,0,541,A
3-PA,613,0,546,0,0,546,T
3-PA,614,0,543,0,0,543,T
3-PA,615,0,546,0,0,546,T
3-PA,616,0,1,543,0,544,G
3-PA,617,542,0,1,0,543,A
3-PA,618,546,0,0,0,546,A
3-PA,619,546,0,0,0,546,A
3-PA,620,0,568,0,0,568,T
3-PA,621,0,0,0,703,703,C
3-PA,622,707,0,0,0,707,A
3-PA,623,0,0,0,733,733,C
3-PA,624,731,0,1,0,732,A
3-PA,625,0,0,749,0,749,G
3-PA,626,0,0,783,0,783,G
3-PA,627,812,0,0,0,812,A
3-PA,628,840,0,0,0,840,A
3-PA,629,0,0,0,854,854,C
3-PA,630,0,846,0,0,846,T
3-PA,631,953,0,0,0,953,A
3-PA,632,0,978,0,0,978,T
3-PA,633,0,0,1053,0,1053,G
3-PA,634,0,0,0,1048,1048,C
3-PA,635,0,0,1044,0,1044,G
3-PA,636,0,1045,0,0,1045,T
3-PA,637,1041,0,0,0,1041,A
3-PA,638,1,0,1057,1,1059,G
3-PA,639,0,0,1055,0,1055,G
3-PA,640,0,0,0,1057,1057,C
3-PA,641,0,1054,0,0,1054,T
3-PA,642,1,1046,0,0,1047,T
3-PA,643,0,0,1045,0,1045,G
3-PA,644,0,0,0,1044,1044,C
3-PA,645,1,0,0,1045,1046,C
3-PA,646,1,0,1070,0,1071,G
3-PA,647,1074,1,0,0,1075,A
3-PA,648,0,0,0,1076,1076,C
3-PA,649,0,0,0,1080,1080,C
3-PA,650,1073,1,0,1,1075,A
3-PA,651,1077,0,1,0,1078,A
3-PA,652,1078,0,0,1,1079,A
3-PA,653,0,0,1119,0,1119,G
3-PA,654,0,1119,0,1,1120,T
3-PA,655,2,0,0,1123,1125,C
3-PA,656,0,1123,0,0,1123,T
3-PA,657,0,1,2,1125,1128,C
3-PA,658,0,0,1,1137,1138,C
3-PA,659,0,0,0,1139,1139,C
3-PA,660,1140,0,3,0,1143,A
3-PA,661,0,0,0,1157,1157,C
3-PA,662,0,0,0,1152,1152,C
3-PA,663,0,0,1157,0,1157,G
3-PA,664,1176,0,0,0,1176,A
3-PA,665,1177,0,0,0,1177,A
3-PA,666,0,0,0,1189,1189,C
3-PA,667,0,1185,0,1,1186,T
3-PA,668,1,1218,0,0,1219,T
3-PA,669,0,0,0,1237,1237,C
3-PA,670,0,1233,0,1,1234,T
3-PA,671,2,0,0,1235,1237,C
3-PA,672,0,0,1,1239,1240,C
3-PA,673,0,1243,0,0,1243,T
3-PA,674,0,0,1261,0,1261,G
3-PA,675,0,0,0,1258,1258,C
3-PA,676,0,0,0,1269,1269,C
3-PA,677,1,1259,0,1,1261,T
3-PA,678,0,1259,0,1,1260,T
3-PA,679,2,0,1260,0,1262,G
3-PA,680,1259,0,1,2,1262,A
3-PA,681,1,1,1282,0,1284,G
3-PA,682,1280,0,1,0,1281,A
3-PA,683,1293,0,1,0,1294,A
3-PA,684,0,1337,0,0,1337,T
3-PA,685,0,1339,0,0,1339,T
3-PA,686,0,1336,1,0,1337,T
3-PA,687,0,1343,0,0,1343,T
3-PA,688,1343,0,0,0,1343,A
3-PA,689,2,0,1340,0,1342,G
3-PA,690,1332,0,2,1,1335,A
3-PA,691,0,0,1390,0,1390,G
3-PA,692,0,0,0,1397,1397,C
3-PA,693,0,0,0,1418,1418,C
3-PA,694,0,1457,0,0,1457,T
3-PA,695,1542,0,0,0,1542,A
3-PA,696,0,1544,0,0,1544,T
3-PA,697,1,0,1560,0,1561,G
3-PA,698,0,1559,0,0,1559,T
3-PA,699,0,1,1570,0,1571,G
3-PA,700,0,1,1564,0,1565,G
3-PA,701,1557,1,0,0,1558,A
3-PA,702,0,1550,0,0,1550,T
3-PA,703,0,2,1550,0,1552,G
3-PA,704,0,0,1609,0,1609,G
3-PA,705,1620,0,0,0,1620,A
3-PA,706,0,1620,1,0,1621,T
3-PA,707,3,1613,0,1,1617,T
3-PA,708,0,0,0,1618,1618,C
3-PA,709,1,0,1626,0,1627,G
3-PA,710,1634,0,3,0,1637,A
3-PA,711,1636,0,0,0,1636,A
3-PA,712,0,0,0,1641,1641,C
3-PA,713,0,0,1,1619,1620,C
3-PA,714,1,0,1625,0,1626,G
3-PA,715,1619,0,0,0,1619,A
3-PA,716,1625,0,1,0,1626,A
3-PA,717,0,1,0,1643,1644,C
3-PA,718,2,0,1641,0,1643,G
3-PA,719,0,0,1679,1,1680,G
3-PA,720,0,0,0,1689,1689,C
3-PA,721,0,1688,0,2,1690,T
3-PA,722,1,0,1750,0,1751,G
3-PA,723,0,0,0,1764,1764,C
3-PA,724,1771,0,1,0,1772,A
3-PA,725,0,1776,0,1,1777,T
3-PA,726,0,1767,0,0,1767,T
3-PA,727,1,0,1760,0,1761,G
3-PA,728,1741,0,3,0,1744,A
3-PA,729,0,0,1762,0,1762,G
3-PA,730,2,1,1755,0,1758,G
3-PA,731,2,0,1748,0,1750,G
3-PA,732,1,0,0,1748,1749,C
3-PA,733,1748,1,0,0,1749,A
3-PA,734,1751,0,1,0,1752,A
3-PA,735,0,0,1762,1,1763,G
3-PA,736,0,0,0,1774,1774,C
3-PA,737,0,1779,0,1,1780,T
3-PA,738,0,1781,0,1,1782,T
3-PA,739,0,1796,0,1,1797,T
3-PA,740,0,0,0,1804,1804,C
3-PA,741,0,1798,0,0,1798,T
3-PA,742,1,0,1,1805,1807,C
3-PA,743,1806,0,2,0,1808,A
3-PA,744,1800,1,1,0,1802,A
3-PA,745,1805,0,0,0,1805,A
3-PA,746,0,1807,0,1,1808,T
3-PA,747,1,0,1884,0,1885,G
3-PA,748,0,1873,0,2,1875,T
3-PA,749,0,0,0,1893,1893,C
3-PA,750,1,0,0,1904,1905,C
3-PA,751,1915,0,0,0,1915,A
3-PA,752,1914,0,1,0,1915,A
3-PA,753,1914,0,1,0,1915,A
3-PA,754,0,0,1943,0,1943,G
3-PA,755,1935,0,0,0,1935,A
3-PA,756,1906,0,2,0,1908,A
3-PA,757,0,0,1918,0,1918,G
3-PA,758,0,1915,0,0,1915,T
3-PA,759,0,0,1916,0,1916,G
3-PA,760,1910,1,1,0,1912,A
3-PA,761,1910,0,1,2,1913,A
3-PA,762,1,1921,0,0,1922,T
3-PA,763,0,0,1921,0,1921,G
3-PA,764,0,3,0,1927,1930,C
3-PA,765,2,1,1,1923,1927,C
3-PA,766,0,1,0,1925,1926,C
3-PA,767,1939,0,1,0,1940,A
3-PA,768,1963,0,1,0,1964,A
3-PA,769,1969,0,0,0,1969,A
3-PA,770,0,1965,0,1,1966,T
3-PA,771,0,1966,0,1,1967,T
3-PA,772,1,1,1961,0,1963,G
3-PA,773,1961,0,1,0,1962,A
3-PA,774,1958,2,3,0,1963,A
3-PA,775,0,1,0,1967,1968,C
3-PA,776,1,0,0,1963,1964,C
3-PA,777,0,1951,0,0,1951,T
3-PA,778,1,2006,0,1,2008,T
3-PA,779,0,2010,0,0,2010,T
3-PA,780,0,2073,0,0,2073,T
3-PA,781,1,0,1,2075,2077,C
3-PA,782,1,2075,0,0,2076,T
3-PA,783,0,1,2072,0,2073,G
3-PA,784,2072,0,0,1,2073,A
3-PA,785,2093,0,2,0,2095,A
3-PA,786,0,0,2114,0,2114,G
3-PA,787,2090,0,1,0,2091,A
3-PA,788,0,0,0,2097,2097,C
3-PA,789,2070,0,0,0,2070,A
3-PA,790,2090,0,2,0,2092,A
3-PA,791,0,0,0,2329,2329,C
3-PA,792,2339,0,4,0,2343,A
3-PA,793,0,0,0,2336,2336,C
3-PA,794,0,0,0,2329,2329,C
3-PA,795,2324,0,1,0,2325,A
3-PA,796,2319,0,2,0,2321,A
3-PA,797,0,1,2331,0,2332,G
3-PA,798,2329,0,2,0,2331,A
3-PA,799,0,0,0,2333,2333,C
3-PA,800,0,1,0,2226,2227,C
3-PA,801,2221,1,2,0,2224,A
3-PA,802,2227,0,0,0,2227,A
3-PA,803,0,2233,0,0,2233,T
3-PA,804,0,1,1,2227,2229,C
3-PA,805,2227,0,3,0,2230,A
3-PA,806,2224,0,1,0,2225,A
3-PA,807,2222,1,1,0,2224,A
3-PA,808,0,0,0,2246,2246,C
3-PA,809,0,2231,0,1,2232,T
3-PA,810,0,2239,0,0,2239,T
3-PA,811,0,1,0,2251,2252,C
3-PA,812,2,2,0,2245,2249,C
3-PA,813,1,1,2263,1,2266,G
3-PA,814,2267,0,0,0,2267,A
3-PA,815,2272,0,0,0,2272,A
3-PA,816,0,2275,0,0,2275,T
3-PA,817,0,0,2262,0,2262,G
3-PA,818,0,0,2278,0,2278,G
3-PA,819,2294,0,0,0,2294,A
3-PA,820,0,3,0,2294,2297,C
3-PA,821,1,0,0,2290,2291,C
3-PA,822,2,2374,0,1,2377,T
3-PA,823,1,0,1,2440,2442,C
3-PA,824,0,2,0,2447,2449,C
3-PA,825,0,2446,0,0,2446,T
3-PA,826,2,2448,0,0,2450,T
3-PA,827,0,0,2572,0,2572,G
3-PA,828,1,2557,0,1,2559,T
3-PA,829,0,2552,0,0,2552,T
3-PA,830,2560,0,1,0,2561,A
3-PA,831,0,2518,0,1,2519,T
3-PA,832,0,0,0,2500,2500,C
3-PA,833,2474,0,0,0,2474,A
3-PA,834,0,1,2468,0,2469,G
3-PA,835,2,3,0,2467,2472,C
3-PA,836,1,1,2432,0,2434,G
3-PA,837,1,0,2495,0,2496,G
3-PA,838,0,2505,0,1,2506,T
3-PA,839,0,1,1,2509,2511,C
3-PA,840,0,1,0,2508,2509,C
3-PA,841,2522,1,0,0,2523,A
3-PA,842,2515,0,3,1,2519,A
3-PA,843,2530,0,0,0,2530,A
3-PA,844,2,2527,0,2,2531,T
3-PA,845,0,2521,0,2,2523,T
3-PA,846,2,1,0,2506,2509,C
3-PA,847,1,0,0,2507,2508,C
3-PA,848,0,2505,0,2,2507,T
3-PA,849,1,0,1,2514,2516,C
3-PA,850,1,1,0,2528,2530,C
3-PA,851,0,2525,0,1,2526,T
3-PA,852,0,0,2542,0,2542,G
3-PA,853,2533,0,1,0,2534,A
3-PA,854,1,2534,0,0,2535,T
3-PA,855,0,0,2517,0,2517,G
3-PA,856,0,1,2501,0,2502,G
3-PA,857,2498,0,1,0,2499,A
3-PA,858,0,2492,0,0,2492,T
3-PA,859,0,0,2495,0,2495,G
3-PA,860,0,0,0,2625,2625,C
3-PA,861,0,2617,0,0,2617,T
3-PA,862,0,2618,0,4,2622,T
3-PA,863,0,2622,0,0,2622,T
3-PA,864,2622,0,0,0,2622,A
3-PA,865,2633,0,0,0,2633,A
3-PA,866,2624,1,1,0,2626,A
3-PA,867,2636,0,2,1,2639,A
3-PA,868,0,2638,0,0,2638,T
3-PA,869,0,2511,0,0,2511,T
3-PA,870,0,4,2512,0,2516,G
3-PA,871,2504,0,4,0,2508,A
3-PA,872,3,1,2527,0,2531,G
3-PA,873,0,1,0,2536,2537,C
3-PA,874,2543,1,0,0,2544,A
3-PA,875,0,2587,0,2,2589,T
3-PA,876,0,2589,0,0,2589,T
3-PA,877,1,1,2577,0,2579,G
3-PA,878,2554,0,1,38,2593,A
3-PA,879,2577,1,2,1,2581,A
3-PA,880,0,3,2598,0,2601,G
3-PA,881,2581,1,0,0,2582,A
3-PA,882,0,1,0,2597,2598,C
3-PA,883,1,1,0,2584,2586,C
3-PA,884,3,2,0,2555,2560,C
3-PA,885,2556,0,1,0,2557,A
3-PA,886,2597,0,3,0,2600,A
3-PA,887,0,0,2640,0,2640,G
3-PA,888,0,2647,3,0,2650,T
3-PA,889,0,1,0,2654,2655,C
3-PA,890,2657,0,3,0,2660,A
3-PA,891,0,1,0,2662,2663,C
3-PA,892,1,1,2656,0,2658,G
3-PA,893,2697,3,1,0,2701,A
3-PA,894,2692,1,2,0,2695,A
3-PA,895,0,0,2800,0,2800,G
3-PA,896,1,3,2782,1,2787,G
3-PA,897,2777,0,6,0,2783,A
3-PA,898,0,1,2800,1,2802,G
3-PA,899,2797,0,3,0,2800,A
3-PA,900,2797,0,4,0,2801,A
3-PA,901,0,6,2800,0,2806,G
3-PA,902,1,0,2788,0,2789,G
3-PA,903,0,0,2792,0,2792,G
3-PA,904,2753,0,2,0,2755,A
3-PA,905,1,2748,1,2,2752,T
3-PA,906,0,0,0,2765,2765,C
3-PA,907,0,1,2,2961,2964,C
3-PA,908,1,1,0,3001,3003,C
3-PA,909,3031,0,2,0,3033,A
3-PA,910,0,3037,0,1,3038,T
3-PA,911,0,3067,0,1,3068,T
3-PA,912,3131,0,0,1,3132,A
3-PA,913,0,3129,0,0,3129,T
3-PA,914,3128,0,0,0,3128,A
3-PA,915,0,3112,0,0,3112,T
3-PA,916,2,2,2824,0,2828,G
3-PA,917,2841,0,1,0,2842,A
3-PA,918,0,2814,0,0,2814,T
3-PA,919,1,0,2825,1,2827,G
3-PA,920,0,0,1,2801,2802,C
3-PA,921,1,2,2798,0,2801,G
3-PA,922,2825,0,0,0,2825,A
3-PA,923,1,2814,0,2,2817,T
3-PA,924,1,0,0,2833,2834,C
3-PA,925,2820,0,0,0,2820,A
3-PA,926,2800,0,3,0,2803,A
3-PA,927,0,0,2823,0,2823,G
3-PA,928,1,2788,0,1,2790,T
3-PA,929,3,0,2819,0,2822,G
3-PA,930,0,4,0,2816,2820,C
3-PA,931,2811,0,3,0,2814,A
3-PA,932,1,2828,2,0,2831,T
3-PA,933,2823,0,0,0,2823,A
3-PA,934,2850,0,0,0,2850,A
3-PA,935,2849,0,0,0,2849,A
3-PA,936,2839,0,0,1,2840,A
3-PA,937,2838,1,1,1,2841,A
3-PA,938,0,0,0,2843,2843,C
3-PA,939,2823,1,1,0,2825,A
3-PA,940,0,2832,0,1,2833,T
3-PA,941,0,2834,0,3,2837,T
3-PA,942,0,2,0,2844,2846,C
3-PA,943,0,2806,0,0,2806,T
3-PA,944,0,2805,0,0,2805,T
3-PA,945,0,2814,0,0,2814,T
3-PA,946,1,3,2811,0,2815,G
3-PA,947,0,0,2827,0,2827,G
3-PA,948,2817,3,2,0,2822,A
3-PA,949,0,2817,0,0,2817,T
3-PA,950,1,2,2843,0,2846,G
3-PA,951,0,1,2886,2,2889,G
3-PA,952,2893,0,0,0,2893,A
3-PA,953,2891,0,2,0,2893,A
3-PA,954,2893,0,5,0,2898,A
3-PA,955,0,0,2929,0,2929,G
3-PA,956,2922,0,1,0,2923,A
3-PA,957,3184,1,0,0,3185,A
3-PA,958,0,1,0,3225,3226,C
3-PA,959,1,2,0,3241,3244,C
3-PA,960,0,3228,2,0,3230,T
3-PA,961,0,3298,0,1,3299,T
3-PA,962,3302,0,0,0,3302,A
3-PA,963,1,3302,0,1,3304,T
3-PA,964,3289,0,1,0,3290,A
3-PA,965,0,3351,0,0,3351,T
3-PA,966,3150,0,0,0,3150,A
3-PA,967,3,1,3163,0,3167,G
3-PA,968,1,3137,0,5,3143,T
3-PA,969,0,0,0,3135,3135,C
3-PA,970,3095,1,2,0,3098,A
3-PA,971,3101,1,2,1,3105,A
3-PA,972,3093,1,2,1,3097,A
3-PA,973,0,1,1,3103,3105,C
3-PA,974,2,0,0,3062,3064,C
3-PA,975,3029,2,4,1,3036,A
3-PA,976,0,0,0,3047,3047,C
3-PA,977,3050,1,3,1,3055,A
3-PA,978,0,1,0,3064,3065,C
3-PA,979,0,1,3068,0,3069,G
3-PA,980,3057,0,0,1,3058,A
3-PA,981,3055,0,1,0,3056,A
3-PA,982,3058,0,1,0,3059,A
3-PA,983,3059,0,3,0,3062,A
3-PA,984,1,3,3063,0,3067,G
3-PA,985,2,3,3046,0,3051,G
3-PA,986,0,2,3077,0,3079,G
3-PA,987,3068,0,7,0,3075,A
3-PA,988,3079,0,4,0,3083,A
3-PA,989,0,3076,1,0,3077,T
3-PA,990,3080,0,0,0,3080,A
3-PA,991,3074,0,1,0,3075,A
3-PA,992,3086,0,0,0,3086,A
3-PA,993,0,3084,0,0,3084,T
3-PA,994,0,3064,0,0,3064,T
3-PA,995,1,0,0,3089,3090,C
3-PA,996,3081,1,1,0,3083,A
3-PA,997,3091,0,0,0,3091,A
3-PA,998,3088,1,1,0,3090,A
3-PA,999,0,3090,0,2,3092,T
3-PA,1000,0,3104,1,2,3107,T
3-PA,1001,3117,0,2,0,3119,A
3-PA,1002,0,0,0,3108,3108,C
3-PA,1003,3,0,0,3106,3109,C
3-PA,1004,2,3097,0,4,3103,T
3-PA,1005,1,0,3130,0,3131,G
3-PA,1006,0,1,0,3129,3130,C
3-PA,1007,0,3123,0,2,3125,T
3-PA,1008,1,0,3196,0,3197,G
3-PA,1009,1,3183,0,1,3185,T
3-PA,1010,1,1,0,3201,3203,C
3-PA,1011,3204,1,0,0,3205,A
3-PA,1012,0,3202,0,1,3203,T
3-PA,1013,0,1,3196,0,3197,G
3-PA,1014,1,1,3198,1,3201,G
3-PA,1015,3200,0,1,0,3201,A
3-PA,1016,3288,0,5,0,3293,A
3-PA,1017,0,0,3276,1,3277,G
3-PA,1018,1,4,0,3275,3280,C
3-PA,1019,3269,1,1,0,3271,A
3-PA,1020,3275,0,1,0,3276,A
3-PA,1021,0,0,3300,0,3300,G
3-PA,1022,0,3306,0,0,3306,T
3-PA,1023,3301,0,0,0,3301,A
3-PA,1024,0,1,0,3306,3307,C
3-PA,1025,0,3260,0,1,3261,T
3-PA,1026,0,0,3280,0,3280,G
3-PA,1027,0,3263,0,3,3266,T
3-PA,1028,2,1,2,3265,3270,C
3-PA,1029,3259,0,4,0,3263,A
3-PA,1030,1,1,3296,0,3298,G
3-PA,1031,3294,0,0,0,3294,A
3-PA,1032,3292,1,1,0,3294,A
3-PA,1033,1,3347,1,1,3350,T
3-PA,1034,0,3331,0,1,3332,T
3-PA,1035,1,2,3315,0,3318,G
3-PA,1036,0,0,0,3324,3324,C
3-PA,1037,3314,0,3,0,3317,A
3-PA,1038,0,4,3327,0,3331,G
3-PA,1039,0,2,3298,0,3300,G
3-PA,1040,3330,1,2,0,3333,A
3-PA,1041,0,0,0,3363,3363,C
3-PA,1042,3315,0,2,0,3317,A
3-PA,1043,2,3334,1,3,3340,T
3-PA,1044,0,3344,0,1,3345,T
3-PA,1045,1,1,3365,0,3367,G
3-PA,1046,3362,0,4,0,3366,A
3-PA,1047,3353,0,2,0,3355,A
3-PA,1048,3341,0,2,0,3343,A
3-PA,1049,3331,0,0,2,3333,A
3-PA,1050,1,3317,0,3,3321,T
3-PA,1051,1,0,3352,0,3353,G
3-PA,1052,3335,0,2,0,3337,A
3-PA,1053,0,1,3364,0,3365,G
3-PA,1054,0,2,3354,1,3357,G
3-PA,1055,3337,0,0,1,3338,A
3-PA,1056,0,0,3347,0,3347,G
3-PA,1057,3349,1,2,0,3352,A
3-PA,1058,3348,0,4,0,3352,A
3-PA,1059,1,0,3341,0,3342,G
3-PA,1060,0,1,3322,0,3323,G
3-PA,1061,0,3451,0,2,3453,T
3-PA,1062,0,3459,0,3,3462,T
3-PA,1063,4,0,2,3449,3455,C
3-PA,1064,1,0,0,3463,3464,C
3-PA,1065,3468,0,1,0,3469,A
3-PA,1066,3464,0,2,0,3466,A
3-PA,1067,0,4,3480,0,3484,G
3-PA,1068,1,2,3540,0,3543,G
3-PA,1069,3470,1,0,0,3471,A
3-PA,1070,0,1,0,3471,3472,C
3-PA,1071,0,3475,0,0,3475,T
3-PA,1072,3482,0,1,0,3483,A
3-PA,1073,3482,0,0,0,3482,A
3-PA,1074,3478,0,0,0,3478,A
3-PA,1075,3480,0,1,1,3482,A
3-PA,1076,3467,1,3,2,3473,A
3-PA,1077,0,1,0,3435,3436,C
3-PA,1078,3425,0,3,0,3428,A
3-PA,1079,0,3403,0,2,3405,T
3-PA,1080,0,0,3437,0,3437,G
3-PA,1081,3425,1,3,2,3431,A
3-PA,1082,3435,1,0,0,3436,A
3-PA,1083,1,0,3459,0,3460,G
3-PA,1084,3454,0,2,0,3456,A
3-PA,1085,3460,0,0,0,3460,A
3-PA,1086,3446,1,0,0,3447,A
3-PA,1087,3441,0,1,3,3445,A
3-PA,1088,0,0,0,3457,3457,C
3-PA,1089,1,1,3447,0,3449,G
3-PA,1090,3459,1,2,1,3463,A
3-PA,1091,1,0,3464,0,3465,G
3-PA,1092,0,3445,0,1,3446,T
3-PA,1093,2,0,0,3510,3512,C
3-PA,1094,3519,1,1,1,3522,A
3-PA,1095,3568,0,3,0,3571,A
3-PA,1096,0,1,0,3559,3560,C
3-PA,1097,0,3561,0,0,3561,T
3-PA,1098,0,1,3604,0,3605,G
3-PA,1099,3593,1,0,0,3594,A
3-PA,1100,3613,0,1,1,3615,A
3-PA,1101,0,0,3617,0,3617,G
3-PA,1102,0,3554,0,0,3554,T
3-PA,1103,0,3,3556,0,3559,G
3-PA,1104,1,1,3534,0,3536,G
3-PA,1105,1,0,3552,0,3553,G
3-PA,1106,0,0,0,3545,3545,C
3-PA,1107,0,3520,0,2,3522,T
3-PA,1108,0,0,0,3533,3533,C
3-PA,1109,0,3518,0,0,3518,T
3-PA,1110,1,3537,0,1,3539,T
3-PA,1111,1,1,3597,0,3599,G
3-PA,1112,2,2,3606,0,3610,G
3-PA,1113,1,3599,0,4,3604,T
3-PA,1114,1,3,3597,0,3601,G
3-PA,1115,3583,1,0,1,3585,A
3-PA,1116,3598,0,1,0,3599,A
3-PA,1117,3579,0,2,0,3581,A
3-PA,1118,3596,0,1,4,3601,A
3-PA,1119,0,0,0,3612,3612,C
3-PA,1120,3566,1,0,0,3567,A
3-PA,1121,0,3566,0,0,3566,T
3-PA,1122,3,1,3554,0,3558,G
3-PA,1123,0,0,3600,1,3601,G
3-PA,1124,2,0,0,3590,3592,C
3-PA,1125,3602,1,1,1,3605,A
3-PA,1126,1,0,0,3612,3613,C
3-PA,1127,0,1,0,3624,3625,C
3-PA,1128,3669,0,1,0,3670,A
3-PA,1129,0,1,3679,0,3680,G
3-PA,1130,3673,2,1,0,3676,A
3-PA,1131,0,1,3707,0,3708,G
3-PA,1132,3684,2,2,0,3688,A
3-PA,1133,3683,0,5,0,3688,A
3-PA,1134,0,3,3692,0,3695,G
3-PA,1135,0,0,3684,1,3685,G
3-PA,1136,0,3670,0,1,3671,T
3-PA,1137,3637,0,2,0,3639,A
3-PA,1138,0,1,3641,0,3642,G
3-PA,1139,3636,0,2,0,3638,A
3-PA,1140,0,0,0,3646,3646,C
3-PA,1141,0,3619,2,1,3622,T
3-PA,1142,1,3600,2,3,3606,T
3-PA,1143,1,3618,0,2,3621,T
3-PA,1144,1,1,3617,0,3619,G
3-PA,1145,3613,0,2,0,3615,A
3-PA,1146,3620,0,0,0,3620,A
3-PA,1147,3617,0,2,0,3619,A
3-PA,1148,3586,0,0,0,3586,A
3-PA,1149,0,0,0,3648,3648,C
3-PA,1150,0,3633,1,0,3634,T
3-PA,1151,2,0,3676,0,3678,G
3-PA,1152,0,0,0,3670,3670,C
3-PA,1153,3675,1,4,0,3680,A
3-PA,1154,0,2,3671,0,3673,G
3-PA,1155,3663,1,1,0,3665,A
3-PA,1156,0,1,3796,0,3797,G
3-PA,1157,3801,0,3,0,3804,A
3-PA,1158,1,0,0,3775,3776,C
3-PA,1159,3772,0,3,0,3775,A
3-PA,1160,0,3745,0,1,3746,T
3-PA,1161,3750,0,3,0,3753,A
3-PA,1162,3748,1,5,1,3755,A
3-PA,1163,1,1,3752,0,3754,G
3-PA,1164,0,0,0,3748,3748,C
3-PA,1165,1,4,3678,0,3683,G
3-PA,1166,3739,0,0,0,3739,A
3-PA,1167,1,3710,0,0,3711,T
3-PA,1168,2,3712,1,2,3717,T
3-PA,1169,1,3719,0,0,3720,T
3-PA,1170,4,1,3727,1,3733,G
3-PA,1171,3740,0,1,0,3741,A
3-PA,1172,3735,1,5,0,3741,A
3-PA,1173,0,0,3750,0,3750,G
3-PA,1174,0,0,0,3803,3803,C
3-PA,1175,3759,1,1,1,3762,A
3-PA,1176,3956,3,0,0,3959,A
3-PA,1177,1,3959,0,2,3962,T
3-PA,1178,3965,0,1,0,3966,A
3-PA,1179,0,3968,1,0,3969,T
3-PA,1180,0,2,3983,0,3985,G
3-PA,1181,4016,1,3,0,4020,A
3-PA,1182,1,4011,0,3,4015,T
3-PA,1183,3898,1,2,0,3901,A
3-PA,1184,0,0,3903,0,3903,G
3-PA,1185,0,3789,0,0,3789,T
3-PA,1186,2,1,3769,0,3772,G
3-PA,1187,3775,0,3,0,3778,A
3-PA,1188,0,0,0,3738,3738,C
3-PA,1189,0,1,3734,0,3735,G
3-PA,1190,3737,2,1,1,3741,A
3-PA,1191,3746,0,2,0,3748,A
3-PA,1192,0,0,0,3762,3762,C
3-PA,1193,1,1,1,3759,3762,C
3-PA,1194,0,3749,1,2,3752,T
3-PA,1195,1,2,3828,1,3832,G
3-PA,1196,3825,1,2,0,3828,A
3-PA,1197,3840,0,0,0,3840,A
3-PA,1198,1,3831,0,2,3834,T
3-PA,1199,0,3805,0,2,3807,T
3-PA,1200,3802,0,0,0,3802,A
3-PA,1201,3754,0,4,0,3758,A
3-PA,1202,1,0,3766,0,3767,G
3-PA,1203,0,0,3770,0,3770,G
3-PA,1204,0,3709,0,0,3709,T
3-PA,1205,4,1,1,3692,3698,C
3-PA,1206,3717,0,0,0,3717,A
3-PA,1207,1,1,0,3805,3807,C
3-PA,1208,0,3799,1,7,3807,T
3-PA,1209,0,3797,1,4,3802,T
3-PA,1210,0,3810,1,4,3815,T
3-PA,1211,0,0,0,3804,3804,C
3-PA,1212,3808,0,1,0,3809,A
3-PA,1213,3801,0,6,0,3807,A
3-PA,1214,0,0,3864,0,3864,G
3-PA,1215,0,1,0,3857,3858,C
3-PA,1216,0,3805,0,1,3806,T
3-PA,1217,0,0,3891,0,3891,G
3-PA,1218,0,3,3898,0,3901,G
3-PA,1219,3937,0,2,0,3939,A
3-PA,1220,2,3959,0,1,3962,T
3-PA,1221,3960,0,3,0,3963,A
3-PA,1222,1,3,1,3977,3982,C
3-PA,1223,3919,2,1,0,3922,A
3-PA,1224,0,1,3953,0,3954,G
3-PA,1225,3944,1,0,0,3945,A
3-PA,1226,3860,0,2,0,3862,A
3-PA,1227,0,3825,0,0,3825,T
3-PA,1228,0,2,3839,1,3842,G
3-PA,1229,3815,0,1,2,3818,A
3-PA,1230,1,0,3854,0,3855,G
3-PA,1231,0,3828,0,2,3830,T
3-PA,1232,1,3831,0,0,3832,T
3-PA,1233,2,1,0,3862,3865,C
3-PA,1234,3882,0,2,0,3884,A
3-PA,1235,3883,0,1,1,3885,A
3-PA,1236,0,0,0,3887,3887,C
3-PA,1237,3845,0,1,0,3846,A
3-PA,1238,3843,0,2,0,3845,A
3-PA,1239,1,1,3827,0,3829,G
3-PA,1240,0,2,3849,0,3851,G
3-PA,1241,2,4,0,3878,3884,C
3-PA,1242,1,0,0,3851,3852,C
3-PA,1243,0,3831,1,0,3832,T
3-PA,1244,1,0,3861,0,3862,G
3-PA,1245,1,3854,0,2,3857,T
3-PA,1246,2,1,3870,1,3874,G
3-PA,1247,3866,3,13,0,3882,A
3-PA,1248,4,0,3879,0,3883,G
3-PA,1249,1,0,0,3856,3857,C
3-PA,1250,0,3822,0,2,3824,T
3-PA,1251,3892,0,3,0,3895,A
3-PA,1252,3892,1,1,0,3894,A
3-PA,1253,0,2,0,3906,3908,C
3-PA,1254,2,3884,0,0,3886,T
3-PA,1255,1,1,3861,0,3863,G
3-PA,1256,3846,0,1,0,3847,A
3-PA,1257,0,3851,0,0,3851,T
3-PA,1258,0,3845,0,1,3846,T
3-PA,1259,1,0,1,3860,3862,C
3-PA,1260,3905,1,7,0,3913,A
3-PA,1261,0,1,3956,0,3957,G
3-PA,1262,0,3947,0,1,3948,T
3-PA,1263,4,1,1,3948,3954,C
3-PA,1264,0,3928,0,5,3933,T
3-PA,1265,1,1,4107,0,4109,G
3-PA,1266,0,2,4107,0,4109,G
3-PA,1267,4105,2,2,0,4109,A
3-PA,1268,0,4109,0,0,4109,T
3-PA,1269,3941,0,1,0,3942,A
3-PA,1270,1,1,3938,0,3940,G
3-PA,1271,3923,0,3,0,3926,A
3-PA,1272,1,1,3935,0,3937,G
3-PA,1273,1,0,0,3936,3937,C
3-PA,1274,1,3808,1,1,3811,T
3-PA,1275,0,3807,0,2,3809,T
3-PA,1276,1,1,3822,0,3824,G
3-PA,1277,3825,0,2,0,3827,A
3-PA,1278,1,3820,1,3,3825,T
3-PA,1279,0,2,3804,0,3806,G
3-PA,1280,3821,0,3,0,3824,A
3-PA,1281,3816,1,0,0,3817,A
3-PA,1282,3834,0,2,0,3836,A
3-PA,1283,1,3831,0,1,3833,T
3-PA,1284,1,3834,0,3,3838,T
3-PA,1285,3,0,3861,0,3864,G
3-PA,1286,0,1,3861,1,3863,G
3-PA,1287,3854,2,3,0,3859,A
3-PA,1288,1,0,3856,1,3858,G
3-PA,1289,3806,0,4,0,3810,A
3-PA,1290,1,1,3837,0,3839,G
3-PA,1291,0,1,3855,0,3856,G
3-PA,1292,3878,2,3,0,3883,A
3-PA,1293,1,0,0,3877,3878,C
3-PA,1294,0,0,3855,0,3855,G
3-PA,1295,0,3854,0,2,3856,T
3-PA,1296,3873,0,3,0,3876,A
3-PA,1297,1,0,3901,0,3902,G
3-PA,1298,1,3,0,3904,3908,C
3-PA,1299,2,0,0,3866,3868,C
3-PA,1300,3,1,0,3839,3843,C
3-PA,1301,4,5,0,3823,3832,C
3-PA,1302,3837,0,0,0,3837,A
3-PA,1303,3950,0,0,0,3950,A
3-PA,1304,1,3944,1,1,3947,T
3-PA,1305,0,3913,0,1,3914,T
3-PA,1306,2,2,3909,0,3913,G
3-PA,1307,3858,2,0,0,3860,A
3-PA,1308,2,1,3863,0,3866,G
3-PA,1309,1,1,0,3847,3849,C
3-PA,1310,3834,0,2,0,3836,A
3-PA,1311,1,2,1,3903,3907,C
3-PA,1312,3798,0,2,0,3800,A
3-PA,1313,1,3893,0,4,3898,T
3-PA,1314,3,3897,0,2,3902,T
3-PA,1315,1,1,3908,1,3911,G
3-PA,1316,0,1,0,3905,3906,C
3-PA,1317,3890,0,3,0,3893,A
3-PA,1318,3894,0,3,0,3897,A
3-PA,1319,1,1,3892,0,3894,G
3-PA,1320,1,1,0,3829,3831,C
3-PA,1321,3820,1,0,0,3821,A
3-PA,1322,0,3721,0,1,3722,T
3-PA,1323,0,1,3728,0,3729,G
3-PA,1324,3717,0,4,0,3721,A
3-PA,1325,2,2,3725,0,3729,G
3-PA,1326,3727,1,1,0,3729,A
3-PA,1327,3725,0,0,0,3725,A
3-PA,1328,1,2,3705,1,3709,G
3-PA,1329,0,0,3698,0,3698,G
3-PA,1330,3703,1,0,0,3704,A
3-PA,1331,3708,1,0,0,3709,A
3-PA,1332,0,3701,0,0,3701,T
3-PA,1333,0,3712,0,2,3714,T
3-PA,1334,3714,0,0,0,3714,A
3-PA,1335,1,3727,1,0,3729,T
3-PA,1336,1,3729,0,0,3730,T
3-PA,1337,0,3724,0,3,3727,T
3-PA,1338,0,0,0,3706,3706,C
3-PA,1339,3683,1,2,0,3686,A
3-PA,1340,2,1,0,3755,3758,C
3-PA,1341,3741,0,2,0,3743,A
3-PA,1342,0,0,3773,0,3773,G
3-PA,1343,0,0,0,3765,3765,C
3-PA,1344,3731,1,3,1,3736,A
3-PA,1345,0,0,3751,0,3751,G
3-PA,1346,3724,0,9,0,3733,A
3-PA,1347,0,4,3744,0,3748,G
3-PA,1348,0,1,3755,0,3756,G
3-PA,1349,0,3661,1,0,3662,T
3-PA,1350,2,1,3711,0,3714,G
3-PA,1351,1,3689,0,4,3694,T
3-PA,1352,2,0,1,3684,3687,C
3-PA,1353,4,3,0,3694,3701,C
3-PA,1354,7,0,0,3680,3687,C
3-PA,1355,3711,0,0,0,3711,A
3-PA,1356,0,3737,0,2,3739,T
3-PA,1357,0,3687,1,4,3692,T
3-PA,1358,1,0,3706,0,3707,G
3-PA,1359,0,3644,0,1,3645,T
3-PA,1360,3608,0,1,0,3609,A
3-PA,1361,1,0,3595,0,3596,G
3-PA,1362,3510,0,4,0,3514,A
3-PA,1363,2,0,3516,0,3518,G
3-PA,1364,0,1,0,3460,3461,C
3-PA,1365,1,1,0,3407,3409,C
3-PA,1366,3428,2,3,0,3433,A
3-PA,1367,1,0,0,3446,3447,C
3-PA,1368,0,3423,0,2,3425,T
3-PA,1369,2,0,3423,1,3426,G
3-PA,1370,3423,0,0,0,3423,A
3-PA,1371,3347,1,3,0,3351,A
3-PA,1372,0,3428,0,0,3428,T
3-PA,1373,3454,1,0,1,3456,A
3-PA,1374,0,0,0,3473,3473,C
3-PA,1375,3385,0,17,1,3403,A
3-PA,1376,0,3431,0,1,3432,T
3-PA,1377,3408,0,1,1,3410,A
3-PA,1378,3423,0,1,0,3424,A
3-PA,1379,1,3405,0,1,3407,T
3-PA,1380,0,0,3371,0,3371,G
3-PA,1381,3350,0,1,1,3352,A
3-PA,1382,3289,0,1,0,3290,A
3-PA,1383,0,4,3277,1,3282,G
3-PA,1384,0,3,3241,0,3244,G
3-PA,1385,1,3,3287,0,3291,G
3-PA,1386,0,1,3301,0,3302,G
3-PA,1387,1,1,3325,0,3327,G
3-PA,1388,1,3289,0,2,3292,T
3-PA,1389,3308,0,1,0,3309,A
3-PA,1390,1,3329,1,0,3331,T
3-PA,1391,3351,0,1,0,3352,A
3-PA,1392,0,1,0,3588,3589,C
3-PA,1393,3481,0,1,1,3483,A
3-PA,1394,0,3408,0,1,3409,T
3-PA,1395,1,3360,0,0,3361,T
3-PA,1396,3311,0,0,0,3311,A
3-PA,1397,3363,2,3,0,3368,A
3-PA,1398,0,63,0,3294,3357,C
3-PA,1399,3295,0,2,0,3297,A
3-PA,1400,1,2,0,3291,3294,C
3-PA,1401,0,2926,0,1,2927,T
3-PA,1402,0,0,3021,0,3021,G
3-PA,1403,1,1,0,3010,3012,C
3-PA,1404,0,1,0,3001,3002,C
3-PA,1405,2,0,0,3017,3019,C
3-PA,1406,0,2928,0,1,2929,T
3-PA,1407,0,0,3006,0,3006,G
3-PA,1408,0,0,0,3005,3005,C
3-PA,1409,0,3002,0,1,3003,T
3-PA,1410,3,1,0,3065,3069,C
3-PA,1411,2963,0,0,0,2963,A
3-PA,1412,2990,0,1,0,2991,A
3-PA,1413,0,2996,0,0,2996,T
3-PA,1414,0,0,2992,0,2992,G
3-PA,1415,1,0,0,2986,2987,C
3-PA,1416,2899,0,0,0,2899,A
3-PA,1417,0,2895,0,3,2898,T
3-PA,1418,0,0,0,2893,2893,C
3-PA,1419,0,0,0,2918,2918,C
3-PA,1420,2,2800,0,1,2803,T
3-PA,1421,0,1,2868,0,2869,G
3-PA,1422,0,2860,0,1,2861,T
3-PA,1423,1,1,2859,0,2861,G
3-PA,1424,0,1,0,2861,2862,C
3-PA,1425,2812,1,2,1,2816,A
3-PA,1426,0,0,2836,0,2836,G
3-PA,1427,1,1,0,2827,2829,C
3-PA,1428,2789,1,0,1,2791,A
3-PA,1429,2790,2,0,1,2793,A
3-PA,1430,0,2674,0,0,2674,T
3-PA,1431,0,1,2679,0,2680,G
3-PA,1432,0,0,2681,1,2682,G
3-PA,1433,2676,0,2,1,2679,A
3-PA,1434,0,1,0,2678,2679,C
3-PA,1435,1,0,2652,0,2653,G
3-PA,1436,2680,0,0,0,2680,A
3-PA,1437,1,2671,0,2,2674,T
3-PA,1438,0,2673,0,2,2675,T
3-PA,1439,0,2668,0,0,2668,T
3-PA,1440,0,2667,0,1,2668,T
3-PA,1441,1,1,0,2668,2670,C
3-PA,1442,2669,0,1,0,2670,A
3-PA,1443,2679,0,1,0,2680,A
3-PA,1444,0,1,0,2670,2671,C
3-PA,1445,1,2630,0,1,2632,T
3-PA,1446,2633,0,0,0,2633,A
3-PA,1447,2631,0,0,0,2631,A
3-PA,1448,1,2631,0,1,2633,T
3-PA,1449,2,2628,0,1,2631,T
3-PA,1450,0,2,0,2625,2627,C
3-PA,1451,2,0,0,2623,2625,C
3-PA,1452,3,0,0,2618,2621,C
3-PA,1453,2615,0,0,0,2615,A
3-PA,1454,0,2642,0,3,2645,T
3-PA,1455,0,0,2651,0,2651,G
3-PA,1456,2649,0,0,0,2649,A
3-PA,1457,0,2634,0,1,2635,T
3-PA,1458,2631,0,1,0,2632,A
3-PA,1459,2632,1,3,0,2636,A
3-PA,1460,0,0,2635,0,2635,G
3-PA,1461,0,0,0,2628,2628,C
3-PA,1462,2623,0,0,0,2623,A
3-PA,1463,2543,0,3,0,2546,A
3-PA,1464,0,0,2570,0,2570,G
3-PA,1465,1,2562,0,2,2565,T
3-PA,1466,0,0,2558,0,2558,G
3-PA,1467,0,0,0,2553,2553,C
3-PA,1468,2541,0,0,0,2541,A
3-PA,1469,1,3,2575,0,2579,G
3-PA,1470,2562,0,0,0,2562,A
3-PA,1471,2582,0,2,0,2584,A
3-PA,1472,0,0,0,2593,2593,C
3-PA,1473,0,2506,0,1,2507,T
3-PA,1474,2512,0,2,0,2514,A
3-PA,1475,2518,1,0,0,2519,A
3-PA,1476,2512,0,2,0,2514,A
3-PA,1477,0,0,2523,0,2523,G
3-PA,1478,2423,0,2,0,2425,A
3-PA,1479,1,5,2418,0,2424,G
3-PA,1480,0,2,2367,0,2369,G
3-PA,1481,0,0,2367,0,2367,G
3-PA,1482,2347,0,3,0,2350,A
3-PA,1483,2289,0,2,0,2291,A
3-PA,1484,1,0,2293,0,2294,G
3-PA,1485,1,1,2284,0,2286,G
3-PA,1486,1,2,0,2276,2279,C
3-PA,1487,1,0,2282,0,2283,G
3-PA,1488,2273,0,1,1,2275,A
3-PA,1489,2276,0,0,0,2276,A
3-PA,1490,2275,0,1,0,2276,A
3-PA,1491,2277,0,0,1,2278,A
3-PA,1492,2273,1,3,0,2277,A
3-PA,1493,1,0,0,2281,2282,C
3-PA,1494,0,0,0,2263,2263,C
3-PA,1495,2270,0,0,1,2271,A
3-PA,1496,2283,0,0,0,2283,A
3-PA,1497,0,2283,0,1,2284,T
3-PA,1498,2,2274,0,0,2276,T
3-PA,1499,0,2281,0,1,2282,T
3-PA,1500,2287,1,0,0,2288,A
3-PA,1501,1,2281,1,0,2283,T
3-PA,1502,2280,0,1,0,2281,A
3-PA,1503,4,2273,0,1,2278,T
3-PA,1504,0,0,2246,0,2246,G
3-PA,1505,0,0,2231,0,2231,G
3-PA,1506,2223,0,0,0,2223,A
3-PA,1507,1,2210,0,2,2213,T
3-PA,1508,0,2191,0,0,2191,T
3-PA,1509,0,0,1,2176,2177,C
3-PA,1510,2185,0,1,0,2186,A
3-PA,1511,0,2195,0,4,2199,T
3-PA,1512,3,0,0,2192,2195,C
3-PA,1513,2189,0,0,0,2189,A
3-PA,1514,0,2171,0,0,2171,T
3-PA,1515,2146,0,0,0,2146,A
3-PA,1516,2147,0,0,0,2147,A
3-PA,1517,2141,1,0,0,2142,A
3-PA,1518,0,2,2128,0,2130,G
3-PA,1519,0,0,2097,0,2097,G
3-PA,1520,0,1,2079,0,2080,G
3-PA,1521,2059,1,1,1,2062,A
3-PA,1522,2032,0,1,1,2034,A
3-PA,1523,0,0,2036,0,2036,G
3-PA,1524,2028,0,0,0,2028,A
3-PA,1525,0,2023,0,0,2023,T
3-PA,1526,1,0,1,2014,2016,C
3-PA,1527,0,1987,0,2,1989,T
3-PA,1528,2,0,0,2016,2018,C
3-PA,1529,2017,0,0,0,2017,A
3-PA,1530,0,2011,0,0,2011,T
3-PA,1531,0,2015,0,0,2015,T
3-PA,1532,0,1986,0,2,1988,T
3-PA,1533,1969,2,0,0,1971,A
3-PA,1534,1966,0,1,1,1968,A
3-PA,1535,0,1,1968,0,1969,G
3-PA,1536,0,1,1980,0,1981,G
3-PA,1537,1858,0,0,0,1858,A
3-PA,1538,1857,0,0,1,1858,A
3-PA,1539,0,1844,13,0,1857,T
3-PA,1540,1,0,1866,0,1867,G
3-PA,1541,1897,0,0,0,1897,A
3-PA,1542,0,0,0,1898,1898,C
3-PA,1543,1880,0,1,0,1881,A
3-PA,1544,0,1,0,1882,1883,C
3-PA,1545,1823,0,1,0,1824,A
3-PA,1546,0,0,1830,0,1830,G
3-PA,1547,1798,0,0,0,1798,A
3-PA,1548,0,0,0,1772,1772,C
3-PA,1549,0,0,1732,0,1732,G
3-PA,1550,0,1587,0,2,1589,T
3-PA,1551,0,0,1592,0,1592,G
3-PA,1552,0,0,1592,0,1592,G
3-PA,1553,1,1597,0,0,1598,T
3-PA,1554,1593,0,0,0,1593,A
3-PA,1555,1551,0,2,0,1553,A
3-PA,1556,1559,0,0,0,1559,A
3-PA,1557,0,1553,0,0,1553,T
3-PA,1558,0,1532,0,0,1532,T
3-PA,1559,0,1525,0,0,1525,T
3-PA,1560,1,1501,0,0,1502,T
3-PA,1561,0,0,1507,0,1507,G
3-PA,1562,0,1486,0,1,1487,T
3-PA,1563,0,1,1494,0,1495,G
3-PA,1564,1481,0,1,0,1482,A
3-PA,1565,0,0,1485,0,1485,G
3-PA,1566,0,1,0,1474,1475,C
3-PA,1567,1473,1,0,0,1474,A
3-PA,1568,0,1470,0,4,1474,T
3-PA,1569,0,0,1473,0,1473,G
3-PA,1570,0,0,1477,0,1477,G
3-PA,1571,1472,0,1,0,1473,A
3-PA,1572,1,0,1475,0,1476,G
3-PA,1573,1,1439,0,2,1442,T
3-PA,1574,0,1420,0,2,1422,T
3-PA,1575,0,1425,1,1,1427,T
3-PA,1576,1,1420,0,1,1422,T
3-PA,1577,1,0,0,1426,1427,C
3-PA,1578,0,1420,0,1,1421,T
3-PA,1579,1,0,0,1417,1418,C
3-PA,1580,2,1369,0,2,1373,T
3-PA,1581,0,2,0,1359,1361,C
3-PA,1582,1361,0,1,0,1362,A
3-PA,1583,0,0,0,1359,1359,C
3-PA,1584,0,1314,0,1,1315,T
3-PA,1585,1,0,1311,0,1312,G
3-PA,1586,1307,0,1,0,1308,A
3-PA,1587,0,0,0,1304,1304,C
3-PA,1588,2,0,0,1305,1307,C
3-PA,1589,2,2,0,1281,1285,C
3-PA,1590,0,0,1276,0,1276,G
3-PA,1591,1272,1,0,0,1273,A
3-PA,1592,1,0,1270,0,1271,G
3-PA,1593,1264,1,0,0,1265,A
3-PA,1594,0,0,0,1232,1232,C
3-PA,1595,0,1200,0,2,1202,T
3-PA,1596,0,1127,0,0,1127,T
3-PA,1597,1,0,1124,1,1126,G
3-PA,1598,1118,0,3,0,1121,A
3-PA,1599,0,0,1128,0,1128,G
3-PA,1600,0,0,1,1122,1123,C
3-PA,1601,0,0,0,1069,1069,C
3-PA,1602,1072,0,0,0,1072,A
3-PA,1603,0,0,0,1065,1065,C
3-PA,1604,1066,0,1,0,1067,A
3-PA,1605,0,1066,0,0,1066,T
3-PA,1606,1052,0,1,0,1053,A
3-PA,1607,1050,0,0,0,1050,A
3-PA,1608,1050,0,0,0,1050,A
3-PA,1609,0,1043,0,0,1043,T
3-PA,1610,2,0,1038,0,1040,G
3-PA,1611,0,0,881,0,881,G
3-PA,1612,0,0,860,0,860,G
3-PA,1613,833,0,1,0,834,A
3-PA,1614,1,0,822,0,823,G
3-PA,1615,807,0,0,0,807,A
3-PA,1616,791,0,0,0,791,A
3-PA,1617,789,0,0,0,789,A
3-PA,1618,0,784,0,1,785,T
3-PA,1619,764,0,1,0,765,A
3-PA,1620,1,0,0,760,761,C
3-PA,1621,0,401,0,0,401,T
3-PA,1622,0,0,406,0,406,G
3-PA,1623,0,235,0,0,235,T
3-PA,1624,0,0,242,0,242,G
3-PA,1625,0,225,0,0,225,T
3-PA,1626,0,0,0,140,140,C
3-PA,1627,0,0,0,131,131,C
3-PA,1628,0,121,0,0,121,T
3-PA,1629,0,120,0,0,120,T
3-PA,1630,0,0,120,0,120,G
3-PA,1631,123,0,0,0,123,A
3-PA,1632,0,0,125,0,125,G
3-PA,1633,120,0,1,0,121,A
3-PA,1634,0,122,0,0,122,T
3-PA,1635,120,0,0,0,120,A
3-PA,1636,0,0,123,0,123,G
3-PA,1637,0,0,123,0,123,G
3-PA,1638,122,0,0,0,122,A
3-PA,1639,0,0,121,0,121,G
3-PA,1640,119,0,0,0,119,A
3-PA,1641,0,118,0,0,118,T
3-PA,1642,118,0,0,0,118,A
3-PA,1643,0,117,0,0,117,T
3-PA,1644,0,0,117,0,117,G
3-PA,1645,0,117,0,0,117,T
3-PA,1646,0,116,0,0,116,T
3-PA,1647,117,0,0,0,117,A
3-PA,1648,0,0,0,118,118,C
3-PA,1649,0,117,0,0,117,T
3-PA,1650,118,0,0,0,118,A
3-PA,1651,115,0,0,0,115,A
3-PA,1652,0,0,116,0,116,G
3-PA,1653,115,0,0,0,115,A
3-PA,1654,113,0,0,0,113,A
3-PA,1655,0,0,112,0,112,G
3-PA,1656,0,114,0,0,114,T
3-PA,1657,0,0,115,0,115,G
3-PA,1658,0,0,0,115,115,C
3-PA,1659,0,0,0,116,116,C
3-PA,1660,116,0,0,0,116,A
3-PA,1661,0,115,0,0,115,T
3-PA,1662,114,0,0,0,114,A
3-PA,1663,0,0,116,0,116,G
3-PA,1664,0,0,116,0,116,G
3-PA,1665,0,0,0,115,115,C
3-PA,1666,0,0,0,116,116,C
3-PA,1667,114,0,0,0,114,A
3-PA,1668,114,0,0,0,114,A
3-PA,1669,114,0,0,0,114,A
3-PA,1670,0,114,0,0,114,T
3-PA,1671,0,115,0,0,115,T
3-PA,1672,0,115,0,0,115,T
3-PA,1673,0,0,0,115,115,C
3-PA,1674,114,0,0,0,114,A
3-PA,1675,114,0,0,0,114,A
3-PA,1676,8,0,105,0,113,G
3-PA,1677,0,0,113,0,113,G
3-PA,1678,0,0,0,115,115,C
3-PA,1679,0,0,0,113,113,C
3-PA,1680,0,0,110,0,110,G
3-PA,1681,112,0,0,0,112,A
3-PA,1682,0,112,0,0,112,T
3-PA,1683,0,0,112,0,112,G
3-PA,1684,0,112,0,0,112,T
3-PA,1685,0,114,0,0,114,T
3-PA,1686,0,0,0,116,116,C
3-PA,1687,0,116,0,0,116,T
3-PA,1688,0,116,0,0,116,T
3-PA,1689,0,0,117,0,117,G
3-PA,1690,0,115,0,0,115,T
3-PA,1691,116,0,0,0,116,A
3-PA,1692,0,112,0,0,112,T
3-PA,1693,0,0,112,0,112,G
3-PA,1694,0,109,0,0,109,T
3-PA,1695,0,0,109,0,109,G
3-PA,1696,108,0,1,0,109,A
3-PA,1697,0,0,109,0,109,G
3-PA,1698,0,0,107,0,107,G
3-PA,1699,107,0,0,0,107,A
3-PA,1700,0,0,0,109,109,C
3-PA,1701,108,0,0,0,108,A
3-PA,1702,108,0,0,0,108,A
3-PA,1703,108,0,0,0,108,A
3-PA,1704,0,0,0,108,108,C
3-PA,1705,0,0,108,0,108,G
3-PA,1706,0,0,109,0,109,G
3-PA,1707,109,0,0,0,109,A
3-PA,1708,109,0,0,0,109,A
3-PA,1709,0,0,0,109,109,C
3-PA,1710,108,0,0,0,108,A
3-PA,1711,0,109,0,0,109,T
3-PA,1712,0,0,0,108,108,C
3-PA,1713,109,0,0,0,109,A
3-PA,1714,109,0,0,0,109,A
3-PA,1715,107,0,0,0,107,A
3-PA,1716,0,0,107,0,107,G
3-PA,1717,17,0,91,0,108,G
3-PA,1718,0,106,0,0,106,T
3-PA,1719,0,0,0,107,107,C
3-PA,1720,107,0,0,0,107,A
3-PA,1721,108,0,0,0,108,A
3-PA,1722,108,0,0,0,108,A
3-PA,1723,108,0,0,0,108,A
3-PA,1724,1,107,0,0,108,T
3-PA,1725,0,0,109,0,109,G
3-PA,1726,108,0,0,0,108,A
3-PA,1727,109,0,0,0,109,A
3-PA,1728,109,0,0,0,109,A
3-PA,1729,0,109,0,0,109,T
3-PA,1730,0,1,108,0,109,G
3-PA,1731,0,0,108,0,108,G
3-PA,1732,0,0,109,0,109,G
3-PA,1733,0,0,110,0,110,G
3-PA,1734,110,0,0,0,110,A
3-PA,1735,109,0,0,0,109,A
3-PA,1736,0,110,0,0,110,T
3-PA,1737,0,0,110,0,110,G
3-PA,1738,0,0,110,0,110,G
3-PA,1739,110,0,0,0,110,A
3-PA,1740,0,0,110,0,110,G
3-PA,1741,109,0,0,0,109,A
3-PA,1742,0,109,0,0,109,T
3-PA,1743,0,0,109,0,109,G
3-PA,1744,109,0,0,0,109,A
3-PA,1745,0,0,110,0,110,G
3-PA,1746,110,0,0,0,110,A
3-PA,1747,0,0,0,107,107,C
3-PA,1748,0,0,108,0,108,G
3-PA,1749,0,107,0,0,107,T
3-PA,1750,0,108,0,0,108,T
3-PA,1751,0,0,106,0,106,G
3-PA,1752,0,0,0,107,107,C
3-PA,1753,0,0,0,109,109,C
3-PA,1754,0,108,0,0,108,T
3-PA,1755,0,0,0,109,109,C
3-PA,1756,0,0,0,109,109,C
3-PA,1757,0,109,0,0,109,T
3-PA,1758,0,109,0,0,109,T
3-PA,1759,0,0,0,108,108,C
3-PA,1760,107,0,0,0,107,A
3-PA,1761,0,0,107,0,107,G
3-PA,1762,0,106,0,0,106,T
3-PA,1763,0,0,0,108,108,C
3-PA,1764,105,0,0,0,105,A
3-PA,1765,0,0,0,109,109,C
3-PA,1766,0,110,0,0,110,T
3-PA,1767,0,0,0,112,112,C
3-PA,1768,0,0,0,112,112,C
3-PA,1769,111,0,0,0,111,A
3-PA,1770,0,0,110,0,110,G
3-PA,1771,0,0,0,111,111,C
3-PA,1772,110,0,0,0,110,A
3-PA,1773,0,0,111,0,111,G
3-PA,1774,107,0,0,0,107,A
3-PA,1775,0,107,0,0,107,T
3-PA,1776,0,0,0,107,107,C
3-PA,1777,0,0,107,0,107,G
3-PA,1778,106,0,0,0,106,A
3-PA,1779,0,0,106,0,106,G
3-PA,1780,105,0,0,0,105,A
3-PA,1781,0,0,106,0,106,G
3-PA,1782,0,0,0,104,104,C
3-PA,1783,104,0,0,0,104,A
3-PA,1784,0,105,0,0,105,T
3-PA,1785,0,0,107,0,107,G
3-PA,1786,109,0,0,0,109,A
3-PA,1787,0,109,0,0,109,T
3-PA,1788,0,107,0,0,107,T
3-PA,1789,0,0,108,0,108,G
3-PA,1790,107,0,0,0,107,A
3-PA,1791,107,0,0,0,107,A
3-PA,1792,0,0,108,0,108,G
3-PA,1793,0,0,0,108,108,C
3-PA,1794,0,0,0,105,105,C
3-PA,1795,0,0,105,0,105,G
3-PA,1796,105,0,0,0,105,A
3-PA,1797,0,0,105,0,105,G
3-PA,1798,0,104,0,0,104,T
3-PA,1799,0,0,0,104,104,C
3-PA,1800,0,0,0,104,104,C
3-PA,1801,0,104,0,0,104,T
3-PA,1802,0,0,0,104,104,C
3-PA,1803,1,0,102,0,103,G
3-PA,1804,1,0,102,0,103,G
3-PA,1805,0,102,0,0,102,T
3-PA,1806,0,0,0,101,101,C
3-PA,1807,108,0,0,0,108,A
3-PA,1808,108,1,0,0,109,A
3-PA,1809,109,0,0,0,109,A
3-PA,1810,0,0,109,0,109,G
3-PA,1811,109,0,0,0,109,A
3-PA,1812,0,0,109,0,109,G
3-PA,1813,106,0,0,0,106,A
3-PA,1814,107,0,0,0,107,A
3-PA,1815,106,0,1,0,107,A
3-PA,1816,0,0,108,0,108,G
3-PA,1817,105,0,0,0,105,A
3-PA,1818,0,0,0,105,105,C
3-PA,1819,102,0,0,0,102,A
3-PA,1820,0,102,0,0,102,T
3-PA,1821,0,0,102,0,102,G
3-PA,1822,102,0,0,0,102,A
3-PA,1823,0,1,0,100,101,C
3-PA,1824,1,0,0,100,101,C
3-PA,1825,102,0,0,0,102,A
3-PA,1826,102,0,0,0,102,A
3-PA,1827,102,0,0,0,102,A
3-PA,1828,0,0,103,0,103,G
3-PA,1829,101,0,0,0,101,A
3-PA,1830,0,0,101,0,101,G
3-PA,1831,0,100,0,0,100,T
3-PA,1832,0,98,0,0,98,T
3-PA,1833,0,100,0,0,100,T
3-PA,1834,0,99,1,0,100,T
3-PA,1835,0,100,0,0,100,T
3-PA,1836,0,100,0,0,100,T
3-PA,1837,0,0,100,0,100,G
3-PA,1838,100,0,0,0,100,A
3-PA,1839,0,0,100,0,100,G
3-PA,1840,99,0,0,0,99,A
3-PA,1841,99,0,0,0,99,A
3-PA,1842,0,99,0,0,99,T
3-PA,1843,99,0,0,0,99,A
3-PA,1844,99,0,0,0,99,A
3-PA,1845,0,0,99,0,99,G
3-PA,1846,0,103,0,0,103,T
3-PA,1847,0,0,0,104,104,C
3-PA,1848,103,0,0,0,103,A
3-PA,1849,0,0,103,0,103,G
3-PA,1850,104,0,0,0,104,A
3-PA,1851,103,0,0,0,103,A
3-PA,1852,0,0,102,0,102,G
3-PA,1853,0,0,0,99,99,C
3-PA,1854,98,0,0,0,98,A
3-PA,1855,0,97,0,0,97,T
3-PA,1856,0,0,97,0,97,G
3-PA,1857,0,0,96,0,96,G
3-PA,1858,0,0,0,96,96,C
3-PA,1859,0,0,0,96,96,C
3-PA,1860,0,0,0,98,98,C
3-PA,1861,98,0,0,0,98,A
3-PA,1862,0,98,0,0,98,T
3-PA,1863,0,98,0,0,98,T
3-PA,1864,0,0,99,0,99,G
3-PA,1865,0,1,98,0,99,G
3-PA,1866,0,0,98,0,98,G
3-PA,1867,0,0,99,0,99,G
3-PA,1868,93,0,1,0,94,A
3-PA,1869,0,0,98,0,98,G
3-PA,1870,0,96,0,0,96,T
3-PA,1871,0,0,0,94,94,C
3-PA,1872,0,0,0,102,102,C
3-PA,1873,0,0,0,102,102,C
3-PA,1874,0,0,0,102,102,C
3-PA,1875,1,0,0,100,101,C
3-PA,1876,101,0,0,0,101,A
3-PA,1877,101,0,0,0,101,A
3-PA,1878,0,0,100,0,100,G
3-PA,1879,0,0,99,0,99,G
3-PA,1880,0,0,99,0,99,G
3-PA,1881,91,0,0,0,91,A
3-PA,1882,0,0,91,0,91,G
3-PA,1883,0,91,0,0,91,T
3-PA,1884,0,0,91,0,91,G
3-PA,1885,0,0,93,0,93,G
3-PA,1886,93,0,0,0,93,A
3-PA,1887,93,0,0,0,93,A
3-PA,1888,0,0,92,0,92,G
3-PA,1889,90,0,0,0,90,A
3-PA,1890,92,0,0,0,92,A
3-PA,1891,0,0,89,0,89,G
3-PA,1892,0,0,90,0,90,G
3-PA,1893,0,88,0,0,88,T
3-PA,1894,0,83,0,0,83,T
3-PA,1895,0,0,0,86,86,C
3-PA,1896,0,0,0,86,86,C
3-PA,1897,86,0,0,0,86,A
3-PA,1898,0,86,0,0,86,T
3-PA,1899,0,86,0,0,86,T
3-PA,1900,0,0,87,0,87,G
3-PA,1901,0,0,86,0,86,G
3-PA,1902,0,0,86,0,86,G
3-PA,1903,86,0,0,0,86,A
3-PA,1904,86,0,0,0,86,A
3-PA,1905,85,0,0,0,85,A
3-PA,1906,0,0,86,0,86,G
3-PA,1907,0,86,0,0,86,T
3-PA,1908,0,0,0,89,89,C
3-PA,1909,0,89,0,0,89,T
3-PA,1910,0,0,89,0,89,G
3-PA,1911,0,89,0,0,89,T
3-PA,1912,89,0,0,0,89,A
3-PA,1913,0,0,90,0,90,G
3-PA,1914,0,0,87,0,87,G
3-PA,1915,86,0,1,0,87,A
3-PA,1916,0,0,0,87,87,C
3-PA,1917,0,85,0,0,85,T
3-PA,1918,0,0,0,89,89,C
3-PA,1919,1,87,0,0,88,T
3-PA,1920,88,0,0,0,88,A
3-PA,1921,0,88,0,0,88,T
3-PA,1922,0,87,0,0,87,T
3-PA,1923,0,0,89,0,89,G
3-PA,1924,0,0,87,0,87,G
3-PA,1925,0,0,0,87,87,C
3-PA,1926,0,86,0,0,86,T
3-PA,1927,83,0,0,0,83,A
3-PA,1928,83,0,0,0,83,A
3-PA,1929,0,0,84,0,84,G
3-PA,1930,0,85,0,0,85,T
3-PA,1931,0,0,0,85,85,C
3-PA,1932,84,0,0,0,84,A
3-PA,1933,0,0,85,0,85,G
3-PA,1934,0,86,0,0,86,T
3-PA,1935,88,0,0,0,88,A
3-PA,1936,0,88,0,0,88,T
3-PA,1937,0,85,0,0,85,T
3-PA,1938,0,0,0,86,86,C
3-PA,1939,85,0,0,0,85,A
3-PA,1940,85,0,0,0,85,A
3-PA,1941,0,84,0,0,84,T
3-PA,1942,82,0,0,0,82,A
3-PA,1943,0,0,81,0,81,G
3-PA,1944,0,0,0,80,80,C
3-PA,1945,0,0,0,81,81,C
3-PA,1946,0,81,0,0,81,T
3-PA,1947,0,0,82,0,82,G
3-PA,1948,0,81,0,0,81,T
3-PA,1949,81,0,0,0,81,A
3-PA,1950,0,81,0,0,81,T
3-PA,1951,0,0,78,0,78,G
3-PA,1952,0,0,0,75,75,C
3-PA,1953,71,0,0,0,71,A
3-PA,1954,0,71,0,0,71,T
3-PA,1955,0,0,0,71,71,C
3-PA,1956,70,0,0,0,70,A
3-PA,1957,0,0,0,71,71,C
3-PA,1958,0,0,0,71,71,C
3-PA,1959,71,0,0,0,71,A
3-PA,1960,0,0,0,70,70,C
3-PA,1961,69,0,1,0,70,A
3-PA,1962,70,0,0,0,70,A
3-PA,1963,0,70,0,0,70,T
3-PA,1964,0,70,0,0,70,T
3-PA,1965,0,0,70,0,70,G
3-PA,1966,0,0,69,0,69,G
3-PA,1967,69,0,0,0,69,A
3-PA,1968,70,0,0,0,70,A
3-PA,1969,0,0,68,0,68,G
3-PA,1970,0,0,67,0,67,G
3-PA,1971,67,0,0,0,67,A
3-PA,1972,0,66,0,0,66,T
3-PA,1973,0,65,0,0,65,T
3-PA,1974,0,66,0,0,66,T
3-PA,1975,0,67,0,0,67,T
3-PA,1976,0,0,0,67,67,C
3-PA,1977,67,0,0,0,67,A
3-PA,1978,0,0,67,0,67,G
3-PA,1979,0,0,0,67,67,C
3-PA,1980,0,1,66,0,67,G
3-PA,1981,0,0,67,0,67,G
3-PA,1982,67,0,0,0,67,A
3-PA,1983,0,0,70,0,70,G
3-PA,1984,0,70,0,0,70,T
3-PA,1985,0,0,0,70,70,C
3-PA,1986,70,0,0,0,70,A
3-PA,1987,70,0,0,0,70,A
3-PA,1988,0,0,70,0,70,G
3-PA,1989,70,0,0,0,70,A
3-PA,1990,70,0,0,0,70,A
3-PA,1991,71,0,0,0,71,A
3-PA,1992,71,0,0,0,71,A
3-PA,1993,0,0,0,71,71,C
3-PA,1994,0,66,0,0,66,T
3-PA,1995,0,0,67,0,67,G
3-PA,1996,0,0,0,67,67,C
3-PA,1997,0,67,0,0,67,T
3-PA,1998,0,0,0,67,67,C
3-PA,1999,0,0,0,67,67,C
3-PA,2000,0,66,0,0,66,T
3-PA,2001,0,66,0,0,66,T
3-PA,2002,0,0,66,0,66,G
3-PA,2003,0,66,0,0,66,T
3-PA,2004,0,64,0,1,65,T
3-PA,2005,0,0,67,0,67,G
3-PA,2006,0,67,0,0,67,T
3-PA,2007,0,67,0,0,67,T
3-PA,2008,0,0,0,66,66,C
3-PA,2009,64,0,0,0,64,A
3-PA,2010,0,0,66,0,66,G
3-PA,2011,0,0,66,0,66,G
3-PA,2012,0,0,0,65,65,C
3-PA,2013,0,65,0,0,65,T
3-PA,2014,0,0,0,65,65,C
3-PA,2015,0,63,0,0,63,T
3-PA,2016,0,63,0,0,63,T
3-PA,2017,63,0,0,0,63,A
3-PA,2018,0,0,62,0,62,G
3-PA,2019,1,0,61,0,62,G
3-PA,2020,0,0,61,0,61,G
3-PA,2021,61,0,0,0,61,A
3-PA,2022,0,0,0,61,61,C
3-PA,2023,57,0,0,0,57,A
3-PA,2024,57,0,0,0,57,A
3-PA,2025,0,0,0,58,58,C
3-PA,2026,0,0,0,58,58,C
3-PA,2027,0,58,0,0,58,T
3-PA,2028,0,0,0,58,58,C
3-PA,2029,0,0,58,0,58,G
3-PA,2030,58,0,0,0,58,A
3-PA,2031,58,0,0,0,58,A
3-PA,2032,0,0,0,58,58,C
3-PA,2033,0,0,0,57,57,C
3-PA,2034,0,54,0,0,54,T
3-PA,2035,0,0,55,0,55,G
3-PA,2036,0,0,55,0,55,G
3-PA,2037,0,0,54,0,54,G
3-PA,2038,55,0,0,0,55,A
3-PA,2039,0,0,0,54,54,C
3-PA,2040,0,0,0,52,52,C
3-PA,2041,0,45,0,0,45,T
3-PA,2042,0,45,0,0,45,T
3-PA,2043,0,45,0,0,45,T
3-PA,2044,0,0,45,0,45,G
3-PA,2045,46,0,0,0,46,A
3-PA,2046,0,46,0,0,46,T
3-PA,2047,0,0,0,47,47,C
3-PA,2048,0,46,0,0,46,T
3-PA,2049,0,46,0,0,46,T
3-PA,2050,0,0,46,0,46,G
3-PA,2051,0,0,45,0,45,G
3-PA,2052,0,0,46,0,46,G
3-PA,2053,0,0,46,0,46,G
3-PA,2054,0,0,45,0,45,G
3-PA,2055,0,0,45,0,45,G
3-PA,2056,0,0,0,44,44,C
3-PA,2057,0,44,0,0,44,T
3-PA,2058,44,0,0,0,44,A
3-PA,2059,0,44,0,0,44,T
3-PA,2060,44,0,0,0,44,A
3-PA,2061,0,44,0,0,44,T
3-PA,2062,0,0,44,0,44,G
3-PA,2063,44,0,0,0,44,A
3-PA,2064,44,0,0,0,44,A
3-PA,2065,0,0,44,0,44,G
3-PA,2066,0,0,0,45,45,C
3-PA,2067,42,0,0,0,42,A
3-PA,2068,42,0,0,0,42,A
3-PA,2069,0,42,0,0,42,T
3-PA,2070,0,42,0,0,42,T
3-PA,2071,0,0,42,0,42,G
3-PA,2072,41,0,0,0,41,A
3-PA,2073,0,0,41,0,41,G
3-PA,2074,0,0,41,0,41,G
3-PA,2075,40,0,0,0,40,A
3-PA,2076,0,0,40,0,40,G
3-PA,2077,0,36,0,0,36,T
3-PA,2078,0,0,36,0,36,G
3-PA,2079,0,0,0,36,36,C
3-PA,2080,0,0,0,36,36,C
3-PA,2081,0,36,0,0,36,T
3-PA,2082,0,0,36,0,36,G
3-PA,2083,36,0,0,0,36,A
3-PA,2084,0,36,0,0,36,T
3-PA,2085,0,36,0,0,36,T
3-PA,2086,36,0,0,0,36,A
3-PA,2087,36,0,0,0,36,A
3-PA,2088,0,35,0,0,35,T
3-PA,2089,0,0,35,0,35,G
3-PA,2090,35,0,0,0,35,A
3-PA,2091,0,32,0,0,32,T
3-PA,2092,0,0,0,32,32,C
3-PA,2093,0,0,0,32,32,C
3-PA,2094,0,0,0,32,32,C
3-PA,2095,0,32,0,0,32,T
3-PA,2096,0,0,32,0,32,G
3-PA,2097,0,0,32,0,32,G
3-PA,2098,0,0,32,0,32,G
3-PA,2099,0,32,0,0,32,T
3-PA,2100,0,30,0,0,30,T
3-PA,2101,0,30,0,0,30,T
3-PA,2102,0,30,0,0,30,T
3-PA,2103,0,0,30,0,30,G
3-PA,2104,0,0,0,30,30,C
3-PA,2105,0,30,0,0,30,T
3-PA,2106,0,0,0,30,30,C
3-PA,2107,29,0,0,0,29,A
3-PA,2108,29,0,0,0,29,A
3-PA,2109,0,29,0,0,29,T
3-PA,2110,0,0,29,0,29,G
3-PA,2111,0,0,0,29,29,C
3-PA,2112,0,0,28,0,28,G
3-PA,2113,0,28,0,0,28,T
3-PA,2114,0,0,0,28,28,C
3-PA,2115,0,28,0,0,28,T
3-PA,2116,0,29,0,0,29,T
3-PA,2117,0,0,29,0,29,G
3-PA,2118,0,0,29,0,29,G
3-PA,2119,0,28,0,0,28,T
3-PA,2120,0,27,0,0,27,T
3-PA,2121,0,0,0,27,27,C
3-PA,2122,26,0,0,0,26,A
3-PA,2123,26,0,0,0,26,A
3-PA,2124,0,0,0,26,26,C
3-PA,2125,0,26,0,0,26,T
3-PA,2126,0,0,0,26,26,C
3-PA,2127,0,0,0,24,24,C
3-PA,2128,0,24,0,0,24,T
3-PA,2129,0,24,0,0,24,T
3-PA,2130,0,0,0,22,22,C
3-PA,2131,0,0,0,22,22,C
3-PA,2132,0,22,0,0,22,T
3-PA,2133,0,0,22,0,22,G
3-PA,2134,22,0,0,0,22,A
3-PA,2135,0,0,0,22,22,C
3-PA,2136,21,0,0,0,21,A
3-PA,2137,0,0,0,21,21,C
3-PA,2138,19,0,0,0,19,A
3-PA,2139,0,19,0,0,19,T
3-PA,2140,0,0,19,0,19,G
3-PA,2141,0,0,0,19,19,C
3-PA,2142,18,0,0,0,18,A
3-PA,2143,0,18,0,0,18,T
3-PA,2144,0,17,0,0,17,T
3-PA,2145,17,0,0,0,17,A
3-PA,2146,16,0,0,0,16,A
3-PA,2147,16,0,0,0,16,A
3-PA,2148,16,0,0,0,16,A
3-PA,2149,0,16,0,0,16,T
3-PA,2150,10,0,0,0,10,A
3-PA,2151,0,0,10,0,10,G
4-HA,1,138,0,0,0,138,A
4-HA,2,0,138,0,0,138,T
4-HA,3,0,0,141,0,141,G
4-HA,4,141,0,0,0,141,A
4-HA,5,144,0,0,0,144,A
4-HA,6,0,0,160,0,160,G
4-HA,7,160,0,1,0,161,A
4-HA,8,1,0,0,170,171,C
4-HA,9,0,174,0,0,174,T
4-HA,10,181,0,0,0,181,A
4-HA,11,0,191,0,0,191,T
4-HA,12,0,0,0,191,191,C
4-HA,13,192,0,0,0,192,A
4-HA,14,0,193,0,0,193,T
4-HA,15,0,193,0,0,193,T
4-HA,16,0,0,210,0,210,G
4-HA,17,0,0,0,213,213,C
4-HA,18,0,213,0,0,213,T
4-HA,19,0,213,0,0,213,T
4-HA,20,0,213,0,0,213,T
4-HA,21,0,0,226,0,226,G
4-HA,22,227,0,0,0,227,A
4-HA,23,0,0,229,0,229,G
4-HA,24,0,0,0,231,231,C
4-HA,25,0,231,0,0,231,T
4-HA,26,251,0,0,0,251,A
4-HA,27,0,0,0,253,253,C
4-HA,28,256,0,0,0,256,A
4-HA,29,0,278,0,0,278,T
4-HA,30,0,278,0,0,278,T
4-HA,31,0,0,0,278,278,C
4-HA,32,0,277,0,0,277,T
4-HA,33,282,0,0,0,282,A
4-HA,34,0,282,0,0,282,T
4-HA,35,0,0,284,0,284,G
4-HA,36,0,284,0,1,285,T
4-HA,37,0,0,0,284,284,C
4-HA,38,0,285,0,0,285,T
4-HA,39,0,0,285,0,285,G
4-HA,40,0,0,287,0,287,G
4-HA,41,0,286,0,0,286,T
4-HA,42,0,293,0,0,293,T
4-HA,43,0,293,0,0,293,T
4-HA,44,0,293,0,0,293,T
4-HA,45,0,0,0,292,292,C
4-HA,46,0,0,293,0,293,G
4-HA,47,0,0,0,298,298,C
4-HA,48,0,299,0,0,299,T
4-HA,49,0,0,0,298,298,C
4-HA,50,298,0,0,0,298,A
4-HA,51,301,0,0,0,301,A
4-HA,52,302,0,0,0,302,A
4-HA,53,302,0,0,0,302,A
4-HA,54,303,0,0,0,303,A
4-HA,55,0,0,0,305,305,C
4-HA,56,0,305,0,0,305,T
4-HA,57,0,306,0,0,306,T
4-HA,58,0,0,0,305,305,C
4-HA,59,0,0,0,306,306,C
4-HA,60,0,305,0,0,305,T
4-HA,61,0,0,308,0,308,G
4-HA,62,0,0,311,0,311,G
4-HA,63,309,0,0,0,309,A
4-HA,64,320,0,0,0,320,A
4-HA,65,320,0,0,0,320,A
4-HA,66,0,322,0,0,322,T
4-HA,67,0,0,328,0,328,G
4-HA,68,328,0,0,0,328,A
4-HA,69,0,0,0,333,333,C
4-HA,70,333,0,0,0,333,A
4-HA,71,332,0,0,0,332,A
4-HA,72,0,0,0,346,346,C
4-HA,73,344,0,0,0,344,A
4-HA,74,0,0,349,0,349,G
4-HA,75,0,0,0,349,349,C
4-HA,76,349,0,0,0,349,A
4-HA,77,0,2,0,354,356,C
4-HA,78,0,0,354,0,354,G
4-HA,79,0,0,356,0,356,G
4-HA,80,0,0,0,357,357,C
4-HA,81,359,0,0,0,359,A
4-HA,82,362,0,0,0,362,A
4-HA,83,0,0,0,364,364,C
4-HA,84,0,0,369,0,369,G
4-HA,85,0,0,0,371,371,C
4-HA,86,0,365,0,0,365,T
4-HA,87,0,0,368,0,368,G
4-HA,88,0,368,0,0,368,T
4-HA,89,0,0,376,0,376,G
4-HA,90,0,0,0,380,380,C
4-HA,91,0,0,0,392,392,C
4-HA,92,0,392,0,0,392,T
4-HA,93,1,390,0,0,391,T
4-HA,94,0,1,391,0,392,G
4-HA,95,0,0,393,1,394,G
4-HA,96,0,0,403,0,403,G
4-HA,97,0,0,0,403,403,C
4-HA,98,401,0,0,0,401,A
4-HA,99,0,0,0,406,406,C
4-HA,100,0,0,0,399,399,C
4-HA,101,433,0,0,0,433,A
4-HA,102,0,432,0,0,432,T
4-HA,103,0,0,435,0,435,G
4-HA,104,0,1,0,433,434,C
4-HA,105,428,1,0,0,429,A
4-HA,106,0,0,460,0,460,G
4-HA,107,0,461,0,0,461,T
4-HA,108,461,0,0,0,461,A
4-HA,109,0,1,0,461,462,C
4-HA,110,0,0,0,448,448,C
4-HA,111,453,0,0,0,453,A
4-HA,112,453,0,0,0,453,A
4-HA,113,452,0,1,0,453,A
4-HA,114,0,0,0,457,457,C
4-HA,115,0,0,451,0,451,G
4-HA,116,0,0,464,1,465,G
4-HA,117,463,0,1,0,464,A
4-HA,118,464,0,0,0,464,A
4-HA,119,0,0,0,463,463,C
4-HA,120,458,0,0,0,458,A
4-HA,121,472,0,0,0,472,A
4-HA,122,0,471,0,1,472,T
4-HA,123,478,0,0,1,479,A
4-HA,124,0,0,481,0,481,G
4-HA,125,0,474,0,1,475,T
4-HA,126,0,0,476,0,476,G
4-HA,127,476,0,0,0,476,A
4-HA,128,477,0,0,0,477,A
4-HA,129,476,0,1,0,477,A
4-HA,130,475,0,0,0,475,A
4-HA,131,0,0,0,481,481,C
4-HA,132,477,0,0,0,477,A
4-HA,133,479,0,0,0,479,A
4-HA,134,0,478,0,0,478,T
4-HA,135,0,0,0,479,479,C
4-HA,136,479,0,0,0,479,A
4-HA,137,0,1,0,477,478,C
4-HA,138,0,0,479,0,479,G
4-HA,139,479,0,0,0,479,A
4-HA,140,478,1,0,0,479,A
4-HA,141,0,478,0,0,478,T
4-HA,142,0,0,479,0,479,G
4-HA,143,482,0,0,0,482,A
4-HA,144,0,1,0,483,484,C
4-HA,145,0,0,0,484,484,C
4-HA,146,486,0,0,0,486,A
4-HA,147,484,0,0,0,484,A
4-HA,148,486,0,0,0,486,A
4-HA,149,0,485,0,0,485,T
4-HA,150,0,485,0,0,485,T
4-HA,151,0,0,486,0,486,G
4-HA,152,487,0,0,0,487,A
4-HA,153,484,2,1,0,487,A
4-HA,154,0,0,488,0,488,G
4-HA,155,0,488,0,0,488,T
4-HA,156,0,502,0,0,502,T
4-HA,157,504,0,0,0,504,A
4-HA,158,0,0,0,511,511,C
4-HA,159,0,514,0,0,514,T
4-HA,160,511,1,0,1,513,A
4-HA,161,517,0,0,0,517,A
4-HA,162,0,519,0,0,519,T
4-HA,163,127,0,387,0,514,G
4-HA,164,0,0,0,554,554,C
4-HA,165,0,548,0,0,548,T
4-HA,166,547,0,0,0,547,A
4-HA,167,0,0,0,546,546,C
4-HA,168,0,543,0,1,544,T
4-HA,169,0,0,547,0,547,G
4-HA,170,545,0,0,0,545,A
4-HA,171,0,0,544,0,544,G
4-HA,172,0,0,0,542,542,C
4-HA,173,0,528,0,0,528,T
4-HA,174,0,2,540,0,542,G
4-HA,175,1,1,548,0,550,G
4-HA,176,0,551,0,0,551,T
4-HA,177,0,552,0,0,552,T
4-HA,178,0,0,1,547,548,C
4-HA,179,548,0,0,0,548,A
4-HA,180,0,0,550,0,550,G
4-HA,181,551,0,0,0,551,A
4-HA,182,0,0,564,0,564,G
4-HA,183,0,562,0,0,562,T
4-HA,184,0,563,0,0,563,T
4-HA,185,1,0,1,565,567,C
4-HA,186,1,0,0,568,569,C
4-HA,187,0,568,0,0,568,T
4-HA,188,0,0,0,569,569,C
4-HA,189,570,0,0,0,570,A
4-HA,190,569,0,0,0,569,A
4-HA,191,0,0,0,571,571,C
4-HA,192,555,0,0,0,555,A
4-HA,193,0,0,572,0,572,G
4-HA,194,1,0,571,0,572,G
4-HA,195,0,571,0,0,571,T
4-HA,196,0,0,570,0,570,G
4-HA,197,571,1,1,0,573,A
4-HA,198,575,0,0,0,575,A
4-HA,199,584,0,1,0,585,A
4-HA,200,0,583,0,0,583,T
4-HA,201,587,0,0,0,587,A
4-HA,202,0,583,0,0,583,T
4-HA,203,0,1,579,0,580,G
4-HA,204,0,0,0,583,583,C
4-HA,205,0,0,585,0,585,G
4-HA,206,590,0,0,0,590,A
4-HA,207,0,0,0,588,588,C
4-HA,208,580,0,0,0,580,A
4-HA,209,0,0,619,0,619,G
4-HA,210,0,614,0,0,614,T
4-HA,211,0,0,0,616,616,C
4-HA,212,0,0,0,617,617,C
4-HA,213,0,612,0,1,613,T
4-HA,214,0,0,0,632,632,C
4-HA,215,632,0,0,0,632,A
4-HA,216,0,631,0,1,632,T
4-HA,217,0,2,0,631,633,C
4-HA,218,607,0,0,0,607,A
4-HA,219,0,0,613,0,613,G
4-HA,220,609,0,0,0,609,A
4-HA,221,0,613,0,0,613,T
4-HA,222,2,1,0,616,619,C
4-HA,223,0,0,0,615,615,C
4-HA,224,0,625,0,0,625,T
4-HA,225,1,623,0,0,624,T
4-HA,226,0,0,626,0,626,G
4-HA,227,627,1,0,0,628,A
4-HA,228,0,627,0,0,627,T
4-HA,229,0,0,630,0,630,G
4-HA,230,0,0,634,0,634,G
4-HA,231,634,0,1,0,635,A
4-HA,232,0,0,635,0,635,G
4-HA,233,629,0,1,0,630,A
4-HA,234,0,1,623,0,624,G
4-HA,235,636,0,1,0,637,A
4-HA,236,640,0,1,0,641,A
4-HA,237,0,0,1,645,646,C
4-HA,238,0,639,0,0,639,T
4-HA,239,0,0,641,0,641,G
4-HA,240,0,1,0,638,639,C
4-HA,241,639,0,0,0,639,A
4-HA,242,0,0,0,650,650,C
4-HA,243,644,0,0,0,644,A
4-HA,244,0,0,0,708,708,C
4-HA,245,0,700,0,4,704,T
4-HA,246,709,0,0,0,709,A
4-HA,247,709,0,1,0,710,A
4-HA,248,0,700,0,0,700,T
4-HA,249,703,0,0,0,703,A
4-HA,250,0,0,704,0,704,G
4-HA,251,695,0,1,0,696,A
4-HA,252,0,690,0,0,690,T
4-HA,253,0,0,668,0,668,G
4-HA,254,0,0,0,673,673,C
4-HA,255,1,671,0,1,673,T
4-HA,256,0,0,0,709,709,C
4-HA,257,0,703,0,0,703,T
4-HA,258,721,0,0,0,721,A
4-HA,259,0,723,0,0,723,T
4-HA,260,0,720,1,0,721,T
4-HA,261,0,0,721,0,721,G
4-HA,262,0,0,717,0,717,G
4-HA,263,0,0,719,0,719,G
4-HA,264,711,0,0,0,711,A
4-HA,265,0,0,701,0,701,G
4-HA,266,695,0,0,0,695,A
4-HA,267,0,0,0,728,728,C
4-HA,268,0,0,0,734,734,C
4-HA,269,1,0,0,738,739,C
4-HA,270,0,741,0,1,742,T
4-HA,271,0,0,0,747,747,C
4-HA,272,751,0,0,0,751,A
4-HA,273,673,0,74,0,747,A
4-HA,274,0,768,0,0,768,T
4-HA,275,0,0,771,0,771,G
4-HA,276,0,770,0,0,770,T
4-HA,277,0,1,774,0,775,G
4-HA,278,772,0,0,0,772,A
4-HA,279,0,768,0,0,768,T
4-HA,280,0,1,769,0,770,G
4-HA,281,0,0,769,0,769,G
4-HA,282,0,0,0,769,769,C
4-HA,283,0,765,0,0,765,T
4-HA,284,0,765,0,0,765,T
4-HA,285,0,0,0,770,770,C
4-HA,286,0,1,0,769,770,C
4-HA,287,768,0,1,0,769,A
4-HA,288,772,0,0,0,772,A
4-HA,289,770,0,0,0,770,A
4-HA,290,772,0,0,0,772,A
4-HA,291,0,775,0,0,775,T
4-HA,292,774,0,0,0,774,A
4-HA,293,773,0,0,0,773,A
4-HA,294,0,0,776,0,776,G
4-HA,295,775,0,0,0,775,A
4-HA,296,776,1,0,0,777,A
4-HA,297,779,0,0,0,779,A
4-HA,298,0,778,0,0,778,T
4-HA,299,0,0,778,0,778,G
4-HA,300,0,1,777,0,778,G
4-HA,301,0,1,777,0,778,G
4-HA,302,776,0,2,0,778,A
4-HA,303,0,0,0,784,784,C
4-HA,304,1,0,0,779,780,C
4-HA,305,0,791,1,0,792,T
4-HA,306,0,791,0,0,791,T
4-HA,307,0,787,0,0,787,T
4-HA,308,1,792,0,1,794,T
4-HA,309,0,795,0,1,796,T
4-HA,310,0,0,799,0,799,G
4-HA,311,1,798,0,0,799,T
4-HA,312,0,793,0,1,794,T
4-HA,313,1,1,788,0,790,G
4-HA,314,791,0,0,0,791,A
4-HA,315,789,0,1,0,790,A
4-HA,316,0,0,0,791,791,C
4-HA,317,1,0,787,0,788,G
4-HA,318,0,0,0,795,795,C
4-HA,319,795,0,0,0,795,A
4-HA,320,0,0,792,0,792,G
4-HA,321,0,0,0,796,796,C
4-HA,322,787,0,10,0,797,A
4-HA,323,798,1,0,0,799,A
4-HA,324,802,0,0,0,802,A
4-HA,325,0,0,822,0,822,G
4-HA,326,0,0,0,823,823,C
4-HA,327,0,0,0,823,823,C
4-HA,328,0,819,0,0,819,T
4-HA,329,817,0,0,0,817,A
4-HA,330,0,0,0,829,829,C
4-HA,331,824,0,0,0,824,A
4-HA,332,0,0,830,0,830,G
4-HA,333,0,0,0,825,825,C
4-HA,334,810,0,0,0,810,A
4-HA,335,813,0,1,0,814,A
4-HA,336,0,0,0,851,851,C
4-HA,337,0,849,0,1,850,T
4-HA,338,0,1,852,0,853,G
4-HA,339,0,850,0,0,850,T
4-HA,340,0,848,0,0,848,T
4-HA,341,850,0,0,0,850,A
4-HA,342,0,1,0,899,900,C
4-HA,343,0,0,0,903,903,C
4-HA,344,3,0,0,910,913,C
4-HA,345,0,888,0,0,888,T
4-HA,346,0,889,0,0,889,T
4-HA,347,888,0,0,0,888,A
4-HA,348,1,889,0,0,890,T
4-HA,349,1,0,886,0,887,G
4-HA,350,882,1,0,0,883,A
4-HA,351,0,824,0,0,824,T
4-HA,352,1,0,831,0,832,G
4-HA,353,0,818,0,1,819,T
4-HA,354,0,0,816,0,816,G
4-HA,355,1,1,0,814,816,C
4-HA,356,1,1,0,814,816,C
4-HA,357,0,0,828,0,828,G
4-HA,358,1,0,832,0,833,G
4-HA,359,838,0,0,0,838,A
4-HA,360,1,837,0,1,839,T
4-HA,361,0,828,0,0,828,T
4-HA,362,831,1,0,0,832,A
4-HA,363,1,831,0,0,832,T
4-HA,364,0,0,834,0,834,G
4-HA,365,0,0,0,830,830,C
4-HA,366,0,1,0,826,827,C
4-HA,367,0,831,0,2,833,T
4-HA,368,1,0,0,878,879,C
4-HA,369,2,0,0,880,882,C
4-HA,370,1,0,0,883,884,C
4-HA,371,0,883,0,0,883,T
4-HA,372,0,883,0,0,883,T
4-HA,373,873,0,1,1,875,A
4-HA,374,0,0,889,0,889,G
4-HA,375,0,0,895,0,895,G
4-HA,376,0,880,0,0,880,T
4-HA,377,0,0,0,863,863,C
4-HA,378,853,0,0,0,853,A
4-HA,379,0,0,0,870,870,C
4-HA,380,0,872,0,0,872,T
4-HA,381,873,0,0,0,873,A
4-HA,382,0,0,870,0,870,G
4-HA,383,0,858,0,0,858,T
4-HA,384,0,850,0,0,850,T
4-HA,385,0,0,856,0,856,G
4-HA,386,0,0,1,856,857,C
4-HA,387,0,0,0,856,856,C
4-HA,388,0,842,0,2,844,T
4-HA,389,0,0,0,849,849,C
4-HA,390,876,0,0,0,876,A
4-HA,391,0,877,0,0,877,T
4-HA,392,0,0,0,878,878,C
4-HA,393,0,2,0,873,875,C
4-HA,394,0,0,874,0,874,G
4-HA,395,0,0,875,0,875,G
4-HA,396,0,0,0,878,878,C
4-HA,397,884,0,0,0,884,A
4-HA,398,1,1,0,887,889,C
4-HA,399,863,0,2,0,865,A
4-HA,400,0,0,0,867,867,C
4-HA,401,0,867,0,0,867,T
4-HA,402,0,0,870,0,870,G
4-HA,403,0,1,876,0,877,G
4-HA,404,865,1,3,1,870,A
4-HA,405,0,0,882,0,882,G
4-HA,406,0,870,0,0,870,T
4-HA,407,0,867,0,0,867,T
4-HA,408,1,868,0,4,873,T
4-HA,409,867,0,0,0,867,A
4-HA,410,868,1,1,0,870,A
4-HA,411,0,0,0,878,878,C
4-HA,412,860,0,0,0,860,A
4-HA,413,859,0,2,0,861,A
4-HA,414,0,859,0,0,859,T
4-HA,415,1,0,854,0,855,G
4-HA,416,854,0,0,0,854,A
4-HA,417,853,1,0,0,854,A
4-HA,418,854,0,2,0,856,A
4-HA,419,0,0,862,0,862,G
4-HA,420,0,0,0,865,865,C
4-HA,421,0,860,0,1,861,T
4-HA,422,0,864,0,0,864,T
4-HA,423,0,0,0,872,872,C
4-HA,424,873,0,1,0,874,A
4-HA,425,875,0,0,0,875,A
4-HA,426,0,877,0,0,877,T
4-HA,427,0,879,0,0,879,T
4-HA,428,1,0,886,0,887,G
4-HA,429,7,0,894,0,901,G
4-HA,430,902,0,0,0,902,A
4-HA,431,0,0,0,904,904,C
4-HA,432,0,899,0,0,899,T
4-HA,433,0,0,899,0,899,G
4-HA,434,0,0,901,0,901,G
4-HA,435,900,0,1,0,901,A
4-HA,436,0,0,898,0,898,G
4-HA,437,0,886,0,0,886,T
4-HA,438,1,0,0,883,884,C
4-HA,439,887,2,0,0,889,A
4-HA,440,0,0,0,897,897,C
4-HA,441,0,893,0,0,893,T
4-HA,442,0,0,0,891,891,C
4-HA,443,891,0,2,0,893,A
4-HA,444,899,0,0,0,899,A
4-HA,445,896,0,2,0,898,A
4-HA,446,899,0,0,1,900,A
4-HA,447,0,0,0,903,903,C
4-HA,448,1,0,894,0,895,G
4-HA,449,0,1,909,0,910,G
4-HA,450,908,0,1,0,909,A
4-HA,451,906,0,1,0,907,A
4-HA,452,0,0,0,911,911,C
4-HA,453,904,0,0,0,904,A
4-HA,454,912,0,1,0,913,A
4-HA,455,0,0,919,0,919,G
4-HA,456,0,0,0,919,919,C
4-HA,457,0,911,0,0,911,T
4-HA,458,0,0,0,917,917,C
4-HA,459,1,908,0,0,909,T
4-HA,460,0,0,909,0,909,G
4-HA,461,0,0,0,915,915,C
4-HA,462,0,911,0,0,911,T
4-HA,463,1,928,0,0,929,T
4-HA,464,0,0,938,0,938,G
4-HA,465,0,0,0,948,948,C
4-HA,466,951,0,0,0,951,A
4-HA,467,0,940,0,0,940,T
4-HA,468,938,0,0,0,938,A
4-HA,469,933,0,1,0,934,A
4-HA,470,1,0,935,0,936,G
4-HA,471,0,1,933,0,934,G
4-HA,472,869,0,31,0,900,A
4-HA,473,0,0,894,0,894,G
4-HA,474,891,1,0,0,892,A
4-HA,475,0,911,0,0,911,T
4-HA,476,0,0,0,914,914,C
4-HA,477,0,916,0,0,916,T
4-HA,478,918,0,0,0,918,A
4-HA,479,912,1,0,0,913,A
4-HA,480,0,917,0,0,917,T
4-HA,481,914,1,0,0,915,A
4-HA,482,907,0,0,0,907,A
4-HA,483,0,0,0,910,910,C
4-HA,484,885,0,0,0,885,A
4-HA,485,0,0,890,0,890,G
4-HA,486,0,884,0,1,885,T
4-HA,487,0,898,0,1,899,T
4-HA,488,1,899,0,0,900,T
4-HA,489,0,0,0,923,923,C
4-HA,490,0,923,0,0,923,T
4-HA,491,0,925,0,1,926,T
4-HA,492,0,925,0,0,925,T
4-HA,493,925,0,1,0,926,A
4-HA,494,0,0,925,0,925,G
4-HA,495,0,922,0,0,922,T
4-HA,496,922,1,0,1,924,A
4-HA,497,0,0,927,0,927,G
4-HA,498,916,0,0,0,916,A
4-HA,499,0,916,0,1,917,T
4-HA,500,0,913,0,0,913,T
4-HA,501,0,1,923,1,925,G
4-HA,502,924,0,0,0,924,A
4-HA,503,926,0,0,0,926,A
4-HA,504,0,928,0,0,928,T
4-HA,505,0,915,0,0,915,T
4-HA,506,0,0,919,0,919,G
4-HA,507,0,0,922,0,922,G
4-HA,508,0,923,0,0,923,T
4-HA,509,0,921,0,0,921,T
4-HA,510,0,0,914,0,914,G
4-HA,511,914,0,0,0,914,A
4-HA,512,0,0,0,907,907,C
4-HA,513,2,0,0,908,910,C
4-HA,514,1,0,0,902,903,C
4-HA,515,907,0,0,0,907,A
4-HA,516,0,0,0,910,910,C
4-HA,517,0,911,0,0,911,T
4-HA,518,0,913,0,0,913,T
4-HA,519,912,0,0,0,912,A
4-HA,520,908,0,0,0,908,A
4-HA,521,906,1,0,0,907,A
4-HA,522,908,0,0,0,908,A
4-HA,523,0,923,0,0,923,T
4-HA,524,0,911,0,1,912,T
4-HA,525,0,0,0,913,913,C
4-HA,526,912,0,0,0,912,A
4-HA,527,912,0,0,0,912,A
4-HA,528,912,0,0,0,912,A
4-HA,529,1,912,1,0,914,T
4-HA,530,929,0,0,0,929,A
4-HA,531,0,0,0,925,925,C
4-HA,532,0,0,0,908,908,C
4-HA,533,2,0,0,909,911,C
4-HA,534,905,0,1,1,907,A
4-HA,535,0,0,929,0,929,G
4-HA,536,0,0,0,930,930,C
4-HA,537,928,0,0,0,928,A
4-HA,538,0,926,0,0,926,T
4-HA,539,0,910,0,0,910,T
4-HA,540,0,0,937,0,937,G
4-HA,541,937,0,2,0,939,A
4-HA,542,939,0,1,0,940,A
4-HA,543,0,0,0,940,940,C
4-HA,544,0,0,912,0,912,G
4-HA,545,0,914,1,1,916,T
4-HA,546,1,0,918,0,919,G
4-HA,547,914,0,6,0,920,A
4-HA,548,0,0,0,918,918,C
4-HA,549,0,892,0,2,894,T
4-HA,550,915,0,0,0,915,A
4-HA,551,0,915,0,0,915,T
4-HA,552,0,0,922,0,922,G
4-HA,553,0,1,0,921,922,C
4-HA,554,0,2,0,913,915,C
4-HA,555,914,1,0,0,915,A
4-HA,556,916,0,0,0,916,A
4-HA,557,925,0,1,0,926,A
4-HA,558,0,0,0,926,926,C
4-HA,559,899,1,1,0,901,A
4-HA,560,901,0,0,0,901,A
4-HA,561,0,895,0,0,895,T
4-HA,562,0,0,896,0,896,G
4-HA,563,893,0,1,0,894,A
4-HA,564,895,0,0,1,896,A
4-HA,565,0,0,0,879,879,C
4-HA,566,886,0,1,0,887,A
4-HA,567,897,0,0,0,897,A
4-HA,568,1,894,0,0,895,T
4-HA,569,1,893,0,0,894,T
4-HA,570,0,893,0,0,893,T
4-HA,571,1,1,894,0,896,G
4-HA,572,897,0,0,0,897,A
4-HA,573,0,0,0,897,897,C
4-HA,574,896,0,0,0,896,A
4-HA,575,897,1,0,0,898,A
4-HA,576,914,0,1,0,915,A
4-HA,577,0,921,0,0,921,T
4-HA,578,0,923,0,0,923,T
4-HA,579,0,0,927,0,927,G
4-HA,580,0,926,0,0,926,T
4-HA,581,928,0,0,0,928,A
4-HA,582,1,0,0,938,939,C
4-HA,583,947,0,0,0,947,A
4-HA,584,0,963,0,0,963,T
4-HA,585,0,956,0,0,956,T
4-HA,586,0,958,0,0,958,T
4-HA,587,0,0,948,0,948,G
4-HA,588,1,2,949,0,952,G
4-HA,589,0,0,950,0,950,G
4-HA,590,1,3,946,0,950,G
4-HA,591,0,1,941,1,943,G
4-HA,592,0,1,955,0,956,G
4-HA,593,0,939,0,0,939,T
4-HA,594,0,940,0,0,940,T
4-HA,595,1,0,0,934,935,C
4-HA,596,936,1,5,0,942,A
4-HA,597,0,0,0,941,941,C
4-HA,598,1,0,0,942,943,C
4-HA,599,946,0,0,0,946,A
4-HA,600,0,0,0,947,947,C
4-HA,601,2,0,0,931,933,C
4-HA,602,0,0,0,937,937,C
4-HA,603,0,1,935,1,937,G
4-HA,604,0,0,992,0,992,G
4-HA,605,0,0,991,0,991,G
4-HA,606,0,989,0,0,989,T
4-HA,607,989,0,0,0,989,A
4-HA,608,0,0,0,986,986,C
4-HA,609,1,1,977,0,979,G
4-HA,610,0,1,995,0,996,G
4-HA,611,994,0,2,0,996,A
4-HA,612,1,0,0,994,995,C
4-HA,613,945,0,0,0,945,A
4-HA,614,948,0,0,0,948,A
4-HA,615,0,946,0,0,946,T
4-HA,616,0,0,957,0,957,G
4-HA,617,955,1,1,0,957,A
4-HA,618,1,0,0,949,950,C
4-HA,619,1,0,0,942,943,C
4-HA,620,946,0,1,1,948,A
4-HA,621,949,0,0,0,949,A
4-HA,622,958,0,0,0,958,A
4-HA,623,0,958,0,0,958,T
4-HA,624,0,0,0,972,972,C
4-HA,625,2,947,0,0,949,T
4-HA,626,0,951,0,0,951,T
4-HA,627,1,0,0,960,961,C
4-HA,628,0,0,0,962,962,C
4-HA,629,0,958,0,0,958,T
4-HA,630,0,0,967,0,967,G
4-HA,631,0,947,0,0,947,T
4-HA,632,954,0,0,0,954,A
4-HA,633,0,948,0,0,948,T
4-HA,634,0,0,954,0,954,G
4-HA,635,0,1,0,956,957,C
4-HA,636,0,953,0,0,953,T
4-HA,637,0,1,0,955,956,C
4-HA,638,954,0,1,0,955,A
4-HA,639,951,0,2,0,953,A
4-HA,640,0,0,957,0,957,G
4-HA,641,0,0,0,953,953,C
4-HA,642,955,0,0,0,955,A
4-HA,643,0,951,0,2,953,T
4-HA,644,0,0,0,947,947,C
4-HA,645,946,0,1,0,947,A
4-HA,646,0,0,949,0,949,G
4-HA,647,0,0,951,0,951,G
4-HA,648,945,0,0,0,945,A
4-HA,649,936,0,0,0,936,A
4-HA,650,0,1,966,0,967,G
4-HA,651,964,0,0,1,965,A
4-HA,652,973,0,0,0,973,A
4-HA,653,0,980,0,0,980,T
4-HA,654,0,0,0,981,981,C
4-HA,655,974,0,0,0,974,A
4-HA,656,2,1,0,972,975,C
4-HA,657,970,0,2,0,972,A
4-HA,658,0,0,986,0,986,G
4-HA,659,0,972,0,0,972,T
4-HA,660,0,0,0,979,979,C
4-HA,661,0,957,0,1,958,T
4-HA,662,0,0,0,972,972,C
4-HA,663,0,971,0,2,973,T
4-HA,664,982,0,0,0,982,A
4-HA,665,0,0,0,979,979,C
4-HA,666,0,0,0,980,980,C
4-HA,667,967,0,0,0,967,A
4-HA,668,965,1,0,0,966,A
4-HA,669,963,0,0,0,963,A
4-HA,670,964,0,0,0,964,A
4-HA,671,0,0,962,0,962,G
4-HA,672,941,0,2,0,943,A
4-HA,673,936,1,0,1,938,A
4-HA,674,0,0,940,0,940,G
4-HA,675,1,0,0,941,942,C
4-HA,676,0,0,0,943,943,C
4-HA,677,939,0,0,0,939,A
4-HA,678,942,0,0,0,942,A
4-HA,679,0,0,0,942,942,C
4-HA,680,942,0,0,0,942,A
4-HA,681,938,0,0,1,939,A
4-HA,682,951,0,1,0,952,A
4-HA,683,0,1,0,980,981,C
4-HA,684,0,977,0,1,978,T
4-HA,685,0,0,984,0,984,G
4-HA,686,0,986,0,1,987,T
4-HA,687,987,1,0,0,988,A
4-HA,688,987,0,0,0,987,A
4-HA,689,0,984,0,0,984,T
4-HA,690,0,0,0,986,986,C
4-HA,691,0,1,0,986,987,C
4-HA,692,1,0,0,977,978,C
4-HA,693,0,0,979,0,979,G
4-HA,694,974,0,0,0,974,A
4-HA,695,973,1,0,1,975,A
4-HA,696,0,974,0,0,974,T
4-HA,697,974,1,0,0,975,A
4-HA,698,0,969,1,1,971,T
4-HA,699,0,0,0,963,963,C
4-HA,700,0,0,963,0,963,G
4-HA,701,0,0,979,0,979,G
4-HA,702,980,0,0,0,980,A
4-HA,703,0,989,0,0,989,T
4-HA,704,0,0,1,990,991,C
4-HA,705,1,985,0,0,986,T
4-HA,706,985,0,1,0,986,A
4-HA,707,1,0,985,0,986,G
4-HA,708,988,1,0,0,989,A
4-HA,709,1,0,0,989,990,C
4-HA,710,0,1,0,964,965,C
4-HA,711,1,0,0,968,969,C
4-HA,712,964,0,0,0,964,A
4-HA,713,0,0,1000,0,1000,G
4-HA,714,999,0,1,0,1000,A
4-HA,715,0,0,1006,0,1006,G
4-HA,716,1,998,0,0,999,T
4-HA,717,994,0,0,0,994,A
4-HA,718,994,0,0,0,994,A
4-HA,719,1,0,1006,0,1007,G
4-HA,720,0,2,1013,0,1015,G
4-HA,721,1000,1,0,0,1001,A
4-HA,722,932,0,0,0,932,A
4-HA,723,1,934,0,0,935,T
4-HA,724,932,0,0,0,932,A
4-HA,725,0,931,0,0,931,T
4-HA,726,0,0,0,938,938,C
4-HA,727,0,1,0,930,931,C
4-HA,728,1,0,1,923,925,C
4-HA,729,0,919,0,3,922,T
4-HA,730,922,0,0,0,922,A
4-HA,731,0,0,923,0,923,G
4-HA,732,0,1,0,927,928,C
4-HA,733,910,1,0,0,911,A
4-HA,734,0,1,931,0,932,G
4-HA,735,916,0,0,0,916,A
4-HA,736,918,0,0,0,918,A
4-HA,737,0,919,1,0,920,T
4-HA,738,914,0,0,0,914,A
4-HA,739,920,0,0,0,920,A
4-HA,740,0,0,912,0,912,G
4-HA,741,0,0,0,920,920,C
4-HA,742,919,0,1,0,920,A
4-HA,743,0,896,1,0,897,T
4-HA,744,1,0,0,935,936,C
4-HA,745,0,933,1,0,934,T
4-HA,746,941,1,0,0,942,A
4-HA,747,0,941,0,0,941,T
4-HA,748,0,935,0,0,935,T
4-HA,749,0,2,942,0,944,G
4-HA,750,0,0,937,1,938,G
4-HA,751,941,0,0,0,941,A
4-HA,752,0,0,0,941,941,C
4-HA,753,856,0,0,0,856,A
4-HA,754,870,1,0,0,871,A
4-HA,755,0,906,0,1,907,T
4-HA,756,913,0,0,0,913,A
4-HA,757,1,0,926,0,927,G
4-HA,758,0,908,1,0,909,T
4-HA,759,910,0,0,0,910,A
4-HA,760,917,0,0,0,917,A
4-HA,761,939,0,0,0,939,A
4-HA,762,945,0,1,0,946,A
4-HA,763,0,0,0,953,953,C
4-HA,764,1,0,0,881,882,C
4-HA,765,0,0,884,1,885,G
4-HA,766,0,0,896,0,896,G
4-HA,767,0,0,907,0,907,G
4-HA,768,909,1,1,0,911,A
4-HA,769,0,0,918,0,918,G
4-HA,770,932,0,1,1,934,A
4-HA,771,0,0,0,931,931,C
4-HA,772,932,0,1,0,933,A
4-HA,773,0,936,0,0,936,T
4-HA,774,938,0,0,0,938,A
4-HA,775,0,0,0,955,955,C
4-HA,776,0,947,0,5,952,T
4-HA,777,0,956,1,2,959,T
4-HA,778,0,968,0,0,968,T
4-HA,779,0,966,0,0,966,T
4-HA,780,0,0,979,0,979,G
4-HA,781,983,0,0,0,983,A
4-HA,782,0,983,1,2,986,T
4-HA,783,1,1024,0,0,1025,T
4-HA,784,1017,0,0,0,1017,A
4-HA,785,1028,0,0,0,1028,A
4-HA,786,1,1,0,1036,1038,C
4-HA,787,1038,0,1,0,1039,A
4-HA,788,0,0,1084,0,1084,G
4-HA,789,0,0,0,1078,1078,C
4-HA,790,1082,0,0,0,1082,A
4-HA,791,0,0,0,1084,1084,C
4-HA,792,1075,0,3,0,1078,A
4-HA,793,0,0,1099,0,1099,G
4-HA,794,0,0,1097,0,1097,G
4-HA,795,1,1,1135,0,1137,G
4-HA,796,1129,0,1,0,1130,A
4-HA,797,1148,0,0,0,1148,A
4-HA,798,0,1150,0,0,1150,T
4-HA,799,0,0,0,1155,1155,C
4-HA,800,0,1160,0,1,1161,T
4-HA,801,1173,0,0,0,1173,A
4-HA,802,1165,0,0,0,1165,A
4-HA,803,0,1160,0,1,1161,T
4-HA,804,0,1137,0,1,1138,T
4-HA,805,0,1,1159,0,1160,G
4-HA,806,0,0,0,1201,1201,C
4-HA,807,0,1267,0,0,1267,T
4-HA,808,0,0,0,1298,1298,C
4-HA,809,1,0,0,1304,1305,C
4-HA,810,1,1303,0,0,1304,T
4-HA,811,1306,0,0,0,1306,A
4-HA,812,0,4,1305,0,1309,G
4-HA,813,0,3,1315,0,1318,G
4-HA,814,1,0,1324,0,1325,G
4-HA,815,0,0,1315,0,1315,G
4-HA,816,0,1284,0,1,1285,T
4-HA,817,0,1278,0,0,1278,T
4-HA,818,1275,2,0,0,1277,A
4-HA,819,0,0,0,1300,1300,C
4-HA,820,0,1295,0,0,1295,T
4-HA,821,0,1308,0,0,1308,T
4-HA,822,0,0,0,1301,1301,C
4-HA,823,1297,0,1,0,1298,A
4-HA,824,1298,0,0,0,1298,A
4-HA,825,1297,0,0,0,1297,A
4-HA,826,1303,1,0,0,1304,A
4-HA,827,1,1301,0,0,1302,T
4-HA,828,1296,0,0,0,1296,A
4-HA,829,0,1,0,1297,1298,C
4-HA,830,0,0,1297,0,1297,G
4-HA,831,1302,0,1,0,1303,A
4-HA,832,1301,0,0,1,1302,A
4-HA,833,0,0,1320,0,1320,G
4-HA,834,0,1319,0,0,1319,T
4-HA,835,0,1,1328,0,1329,G
4-HA,836,0,0,1332,0,1332,G
4-HA,837,1,0,1334,0,1335,G
4-HA,838,1332,0,0,0,1332,A
4-HA,839,1330,1,0,0,1331,A
4-HA,840,1340,0,0,0,1340,A
4-HA,841,1332,0,2,0,1334,A
4-HA,842,1,0,1356,0,1357,G
4-HA,843,0,0,0,1358,1358,C
4-HA,844,0,1352,0,0,1352,T
4-HA,845,0,0,0,1361,1361,C
4-HA,846,1367,0,0,0,1367,A
4-HA,847,1381,0,0,0,1381,A
4-HA,848,0,1379,0,1,1380,T
4-HA,849,1393,0,2,0,1395,A
4-HA,850,1398,0,0,0,1398,A
4-HA,851,0,1372,0,2,1374,T
4-HA,852,1,4,1373,0,1378,G
4-HA,853,1373,0,1,0,1374,A
4-HA,854,0,2,1413,1,1416,G
4-HA,855,1418,0,0,0,1418,A
4-HA,856,0,1414,0,0,1414,T
4-HA,857,0,0,0,1437,1437,C
4-HA,858,1438,0,0,0,1438,A
4-HA,859,0,0,1465,0,1465,G
4-HA,860,1469,0,0,0,1469,A
4-HA,861,0,1469,0,0,1469,T
4-HA,862,0,0,1469,0,1469,G
4-HA,863,0,1,0,1452,1453,C
4-HA,864,1455,0,0,0,1455,A
4-HA,865,0,0,0,1475,1475,C
4-HA,866,0,0,0,1467,1467,C
4-HA,867,1,0,0,1467,1468,C
4-HA,868,1447,1,1,0,1449,A
4-HA,869,0,1446,0,1,1447,T
4-HA,870,0,1447,0,0,1447,T
4-HA,871,0,0,1470,0,1470,G
4-HA,872,0,0,1468,0,1468,G
4-HA,873,0,1,0,1468,1469,C
4-HA,874,1449,0,2,0,1451,A
4-HA,875,1449,0,0,0,1449,A
4-HA,876,1481,0,1,0,1482,A
4-HA,877,0,1475,0,2,1477,T
4-HA,878,0,0,1479,0,1479,G
4-HA,879,0,0,0,1481,1481,C
4-HA,880,1469,0,0,0,1469,A
4-HA,881,1500,0,0,0,1500,A
4-HA,882,0,1501,0,0,1501,T
4-HA,883,0,1514,0,0,1514,T
4-HA,884,0,0,0,1514,1514,C
4-HA,885,0,1503,0,0,1503,T
4-HA,886,0,2,1516,0,1518,G
4-HA,887,1516,0,0,1,1517,A
4-HA,888,1519,0,0,0,1519,A
4-HA,889,0,1517,0,0,1517,T
4-HA,890,1,1,1506,0,1508,G
4-HA,891,0,0,0,1504,1504,C
4-HA,892,1506,0,0,0,1506,A
4-HA,893,0,1504,0,0,1504,T
4-HA,894,0,0,0,1509,1509,C
4-HA,895,1500,0,1,0,1501,A
4-HA,896,0,0,0,1564,1564,C
4-HA,897,0,1555,0,2,1557,T
4-HA,898,0,0,0,1561,1561,C
4-HA,899,33,0,0,1520,1553,C
4-HA,900,1568,0,0,0,1568,A
4-HA,901,1564,0,2,0,1566,A
4-HA,902,1562,0,0,1,1563,A
4-HA,903,0,1514,0,1,1515,T
4-HA,904,0,1,1521,0,1522,G
4-HA,905,0,1,1525,0,1526,G
4-HA,906,1529,0,0,0,1529,A
4-HA,907,1525,0,1,1,1527,A
4-HA,908,0,2,1528,0,1530,G
4-HA,909,0,0,0,1515,1515,C
4-HA,910,1512,0,0,0,1512,A
4-HA,911,0,1512,0,0,1512,T
4-HA,912,0,1510,0,0,1510,T
4-HA,913,0,0,0,1548,1548,C
4-HA,914,1,0,0,1545,1546,C
4-HA,915,0,1,0,1547,1548,C
4-HA,916,1543,0,1,0,1544,A
4-HA,917,1576,0,2,0,1578,A
4-HA,918,0,1602,0,2,1604,T
4-HA,919,0,0,1607,0,1607,G
4-HA,920,1601,1,2,0,1604,A
4-HA,921,0,0,0,1601,1601,C
4-HA,922,1564,0,0,0,1564,A
4-HA,923,1565,0,1,0,1566,A
4-HA,924,1569,0,0,0,1569,A
4-HA,925,0,0,0,1578,1578,C
4-HA,926,1,0,0,1562,1563,C
4-HA,927,1532,0,2,0,1534,A
4-HA,928,0,1536,0,0,1536,T
4-HA,929,1,1538,0,1,1540,T
4-HA,930,0,1,0,1538,1539,C
4-HA,931,0,1,0,1541,1542,C
4-HA,932,1543,0,0,0,1543,A
4-HA,933,1542,0,0,0,1542,A
4-HA,934,1528,0,0,0,1528,A
4-HA,935,1547,0,0,1,1548,A
4-HA,936,0,1542,0,1,1543,T
4-HA,937,1,0,1540,0,1541,G
4-HA,938,0,1530,0,1,1531,T
4-HA,939,0,1527,0,1,1528,T
4-HA,940,1548,0,0,0,1548,A
4-HA,941,1546,0,0,0,1546,A
4-HA,942,0,0,0,1550,1550,C
4-HA,943,1536,0,1,0,1537,A
4-HA,944,0,1,1551,0,1552,G
4-HA,945,1,0,1560,0,1561,G
4-HA,946,1605,0,2,0,1607,A
4-HA,947,1,1610,0,0,1611,T
4-HA,948,0,0,0,1628,1628,C
4-HA,949,1637,0,3,0,1640,A
4-HA,950,0,2,0,1704,1706,C
4-HA,951,1703,0,1,1,1705,A
4-HA,952,0,1771,0,0,1771,T
4-HA,953,1739,1,0,1,1741,A
4-HA,954,0,0,0,1732,1732,C
4-HA,955,0,1,1688,0,1689,G
4-HA,956,0,0,1692,0,1692,G
4-HA,957,0,0,1677,0,1677,G
4-HA,958,0,2,1684,0,1686,G
4-HA,959,1,2,0,1655,1658,C
4-HA,960,0,0,0,1649,1649,C
4-HA,961,1,1623,0,0,1624,T
4-HA,962,0,0,1789,0,1789,G
4-HA,963,0,1797,0,3,1800,T
4-HA,964,1,0,0,1806,1807,C
4-HA,965,1,1,0,1802,1804,C
4-HA,966,2,0,0,1804,1806,C
4-HA,967,1794,1,3,0,1798,A
4-HA,968,0,0,1813,0,1813,G
4-HA,969,1812,0,0,0,1812,A
4-HA,970,0,1812,0,0,1812,T
4-HA,971,1684,0,0,1,1685,A
4-HA,972,0,1670,0,1,1671,T
4-HA,973,0,0,1683,0,1683,G
4-HA,974,0,1681,0,1,1682,T
4-HA,975,0,1662,0,0,1662,T
4-HA,976,1688,0,1,0,1689,A
4-HA,977,1673,0,2,0,1675,A
4-HA,978,1,1,1679,0,1681,G
4-HA,979,0,1,0,1679,1680,C
4-HA,980,1652,0,0,0,1652,A
4-HA,981,1651,0,2,0,1653,A
4-HA,982,1642,0,0,0,1642,A
4-HA,983,1636,0,3,3,1642,A
4-HA,984,0,0,0,1644,1644,C
4-HA,985,1636,0,0,0,1636,A
4-HA,986,0,0,0,1649,1649,C
4-HA,987,0,1628,0,2,1630,T
4-HA,988,2,0,0,1638,1640,C
4-HA,989,1,1637,0,3,1641,T
4-HA,990,1,0,1649,0,1650,G
4-HA,991,1648,0,0,1,1649,A
4-HA,992,1645,0,0,0,1645,A
4-HA,993,1644,0,0,0,1644,A
4-HA,994,0,1640,0,0,1640,T
4-HA,995,0,1633,0,1,1634,T
4-HA,996,0,0,1654,0,1654,G
4-HA,997,1,0,1652,0,1653,G
4-HA,998,1,0,0,1655,1656,C
4-HA,999,1641,0,2,0,1643,A
4-HA,1000,1646,1,0,0,1647,A
4-HA,1001,0,1,0,1649,1650,C
4-HA,1002,1649,0,0,2,1651,A
4-HA,1003,0,1,1658,0,1659,G
4-HA,1004,0,0,1650,0,1650,G
4-HA,1005,1,1,1640,0,1642,G
4-HA,1006,1643,0,1,0,1644,A
4-HA,1007,0,1635,0,2,1637,T
4-HA,1008,1,0,1641,1,1643,G
4-HA,1009,0,2,0,1641,1643,C
4-HA,1010,0,0,1642,0,1642,G
4-HA,1011,1658,0,0,0,1658,A
4-HA,1012,1632,0,0,1,1633,A
4-HA,1013,1643,1,0,0,1644,A
4-HA,1014,0,1621,0,0,1621,T
4-HA,1015,0,0,1648,0,1648,G
4-HA,1016,0,1648,0,2,1650,T
4-HA,1017,1645,0,0,0,1645,A
4-HA,1018,0,1,0,1637,1638,C
4-HA,1019,1,0,0,1629,1630,C
4-HA,1020,1606,1,0,0,1607,A
4-HA,1021,0,0,1607,0,1607,G
4-HA,1022,1571,0,1,0,1572,A
4-HA,1023,1,0,1595,0,1596,G
4-HA,1024,1570,0,2,0,1572,A
4-HA,1025,1573,0,0,0,1573,A
4-HA,1026,1572,0,3,0,1575,A
4-HA,1027,1,0,0,1572,1573,C
4-HA,1028,1533,0,0,0,1533,A
4-HA,1029,1572,0,0,0,1572,A
4-HA,1030,1570,0,0,0,1570,A
4-HA,1031,1,0,0,1585,1586,C
4-HA,1032,0,1570,0,0,1570,T
4-HA,1033,1532,0,0,0,1532,A
4-HA,1034,1,0,1531,0,1532,G
4-HA,1035,1524,0,0,0,1524,A
4-HA,1036,0,1,1574,1,1576,G
4-HA,1037,4,2,1566,0,1572,G
4-HA,1038,1,0,1,1540,1542,C
4-HA,1039,1547,0,0,0,1547,A
4-HA,1040,0,1536,0,0,1536,T
4-HA,1041,1553,0,0,0,1553,A
4-HA,1042,0,1550,1,0,1551,T
4-HA,1043,0,1548,0,1,1549,T
4-HA,1044,0,1548,0,0,1548,T
4-HA,1045,0,1,1501,0,1502,G
4-HA,1046,1,0,1499,0,1500,G
4-HA,1047,0,0,0,1498,1498,C
4-HA,1048,0,1,1490,0,1491,G
4-HA,1049,0,1,0,1480,1481,C
4-HA,1050,1483,0,0,0,1483,A
4-HA,1051,1497,0,1,1,1499,A
4-HA,1052,0,1493,0,0,1493,T
4-HA,1053,0,0,0,1495,1495,C
4-HA,1054,0,1,1498,0,1499,G
4-HA,1055,0,0,0,1493,1493,C
4-HA,1056,0,0,1491,0,1491,G
4-HA,1057,0,0,1500,0,1500,G
4-HA,1058,1,0,1507,0,1508,G
4-HA,1059,1,1501,0,0,1502,T
4-HA,1060,0,1498,0,2,1500,T
4-HA,1061,0,1499,0,1,1500,T
4-HA,1062,2,0,0,1500,1502,C
4-HA,1063,1504,1,0,0,1505,A
4-HA,1064,0,1507,0,0,1507,T
4-HA,1065,1503,0,0,0,1503,A
4-HA,1066,0,0,1523,0,1523,G
4-HA,1067,1485,0,1,0,1486,A
4-HA,1068,1488,0,1,0,1489,A
4-HA,1069,1490,0,1,0,1491,A
4-HA,1070,1500,1,0,0,1501,A
4-HA,1071,0,1499,0,0,1499,T
4-HA,1072,0,0,1526,0,1526,G
4-HA,1073,0,1,1534,0,1535,G
4-HA,1074,1,1529,0,0,1530,T
4-HA,1075,0,1511,0,0,1511,T
4-HA,1076,0,2,1512,0,1514,G
4-HA,1077,1,0,1541,0,1542,G
4-HA,1078,0,0,1558,0,1558,G
4-HA,1079,1559,0,2,0,1561,A
4-HA,1080,0,0,1581,0,1581,G
4-HA,1081,1,0,1575,0,1576,G
4-HA,1082,0,0,1663,0,1663,G
4-HA,1083,1656,0,1,0,1657,A
4-HA,1084,1684,0,0,0,1684,A
4-HA,1085,0,1682,0,2,1684,T
4-HA,1086,0,0,1680,0,1680,G
4-HA,1087,0,0,1712,0,1712,G
4-HA,1088,0,1701,0,0,1701,T
4-HA,1089,0,2,1691,0,1693,G
4-HA,1090,1,0,1693,0,1694,G
4-HA,1091,1663,1,3,0,1667,A
4-HA,1092,0,1675,0,0,1675,T
4-HA,1093,1,1,1691,0,1693,G
4-HA,1094,0,0,1715,0,1715,G
4-HA,1095,1,1694,0,0,1695,T
4-HA,1096,0,1665,0,1,1666,T
4-HA,1097,0,1,1666,0,1667,G
4-HA,1098,0,0,1692,0,1692,G
4-HA,1099,0,1695,0,0,1695,T
4-HA,1100,1686,1,0,0,1687,A
4-HA,1101,0,1,0,1627,1628,C
4-HA,1102,1,0,1633,0,1634,G
4-HA,1103,1,0,1701,0,1702,G
4-HA,1104,0,1699,0,1,1700,T
4-HA,1105,0,1698,0,0,1698,T
4-HA,1106,0,1697,1,1,1699,T
4-HA,1107,1,0,0,1683,1684,C
4-HA,1108,1686,0,1,0,1687,A
4-HA,1109,1,3,1684,0,1688,G
4-HA,1110,0,0,1689,0,1689,G
4-HA,1111,0,0,0,1684,1684,C
4-HA,1112,1639,0,0,0,1639,A
4-HA,1113,1,1649,0,1,1651,T
4-HA,1114,0,0,0,1655,1655,C
4-HA,1115,1655,0,1,0,1656,A
4-HA,1116,1656,0,0,0,1656,A
4-HA,1117,1658,0,0,0,1658,A
4-HA,1118,1666,0,0,0,1666,A
4-HA,1119,0,1663,0,1,1664,T
4-HA,1120,0,1663,0,0,1663,T
4-HA,1121,2,0,0,1670,1672,C
4-HA,1122,1,1659,0,1,1661,T
4-HA,1123,1,0,1663,0,1664,G
4-HA,1124,1662,1,1,1,1665,A
4-HA,1125,1650,0,2,0,1652,A
4-HA,1126,0,0,1669,0,1669,G
4-HA,1127,0,0,1681,0,1681,G
4-HA,1128,1682,0,0,0,1682,A
4-HA,1129,1681,0,2,0,1683,A
4-HA,1130,0,1,1675,0,1676,G
4-HA,1131,1690,0,2,0,1692,A
4-HA,1132,0,1,1708,0,1709,G
4-HA,1133,0,1,1708,0,1709,G
4-HA,1134,1712,0,1,1,1714,A
4-HA,1135,1,0,0,1711,1712,C
4-HA,1136,1708,0,0,0,1708,A
4-HA,1137,1708,0,1,0,1709,A
4-HA,1138,0,0,1711,0,1711,G
4-HA,1139,0,0,1,1713,1714,C
4-HA,1140,1700,0,1,0,1701,A
4-HA,1141,0,0,1719,0,1719,G
4-HA,1142,1,0,0,1716,1717,C
4-HA,1143,1715,0,0,0,1715,A
4-HA,1144,0,0,1747,0,1747,G
4-HA,1145,1729,0,3,0,1732,A
4-HA,1146,0,1775,0,3,1778,T
4-HA,1147,0,0,0,1804,1804,C
4-HA,1148,0,1782,0,7,1789,T
4-HA,1149,0,0,0,1813,1813,C
4-HA,1150,1806,0,1,0,1807,A
4-HA,1151,1803,0,1,0,1804,A
4-HA,1152,1807,1,0,1,1809,A
4-HA,1153,1784,1,2,0,1787,A
4-HA,1154,0,0,1791,0,1791,G
4-HA,1155,0,0,0,1769,1769,C
4-HA,1156,1763,0,0,0,1763,A
4-HA,1157,0,0,0,1803,1803,C
4-HA,1158,0,1789,0,3,1792,T
4-HA,1159,1,0,0,1790,1791,C
4-HA,1160,1785,0,3,0,1788,A
4-HA,1161,1810,1,2,0,1813,A
4-HA,1162,0,0,1811,1,1812,G
4-HA,1163,0,0,0,1810,1810,C
4-HA,1164,1806,0,0,0,1806,A
4-HA,1165,1,0,1814,0,1815,G
4-HA,1166,0,1,0,1786,1787,C
4-HA,1167,1785,0,0,0,1785,A
4-HA,1168,1782,0,1,0,1783,A
4-HA,1169,0,1772,0,0,1772,T
4-HA,1170,0,0,0,1754,1754,C
4-HA,1171,1,1,1763,0,1765,G
4-HA,1172,1760,0,0,0,1760,A
4-HA,1173,0,1756,0,3,1759,T
4-HA,1174,2,1,0,1749,1752,C
4-HA,1175,1748,0,1,0,1749,A
4-HA,1176,1789,0,0,0,1789,A
4-HA,1177,1798,0,0,0,1798,A
4-HA,1178,1,1798,0,1,1800,T
4-HA,1179,0,1,0,1801,1802,C
4-HA,1180,1784,0,1,0,1785,A
4-HA,1181,1789,1,2,0,1792,A
4-HA,1182,1,1787,0,0,1788,T
4-HA,1183,1,1,1797,0,1799,G
4-HA,1184,0,1,1796,0,1797,G
4-HA,1185,0,2,1777,0,1779,G
4-HA,1186,1790,0,1,0,1791,A
4-HA,1187,1790,0,0,0,1790,A
4-HA,1188,0,0,1813,0,1813,G
4-HA,1189,0,5,0,1804,1809,C
4-HA,1190,0,1797,0,2,1799,T
4-HA,1191,19,1,1859,0,1879,G
4-HA,1192,1877,0,0,0,1877,A
4-HA,1193,1877,1,0,0,1878,A
4-HA,1194,0,1885,0,0,1885,T
4-HA,1195,1840,0,1,0,1841,A
4-HA,1196,0,1,1839,0,1840,G
4-HA,1197,1728,2,0,1,1731,A
4-HA,1198,0,1728,0,0,1728,T
4-HA,1199,0,1734,0,1,1735,T
4-HA,1200,0,0,1748,1,1749,G
4-HA,1201,1746,0,0,0,1746,A
4-HA,1202,0,1747,0,0,1747,T
4-HA,1203,0,0,0,1754,1754,C
4-HA,1204,2,1,1744,0,1747,G
4-HA,1205,2,0,1744,1,1747,G
4-HA,1206,0,2,1753,0,1755,G
4-HA,1207,1754,0,1,0,1755,A
4-HA,1208,1754,0,0,0,1754,A
4-HA,1209,1743,0,0,0,1743,A
4-HA,1210,1751,1,1,1,1754,A
4-HA,1211,1,0,0,1758,1759,C
4-HA,1212,0,1,1,1746,1748,C
4-HA,1213,1740,1,1,0,1742,A
4-HA,1214,1741,0,0,0,1741,A
4-HA,1215,0,1,0,1742,1743,C
4-HA,1216,1,0,1742,0,1743,G
4-HA,1217,1750,0,0,0,1750,A
4-HA,1218,0,0,1748,0,1748,G
4-HA,1219,1744,1,0,0,1745,A
4-HA,1220,1744,0,0,0,1744,A
4-HA,1221,1746,0,0,0,1746,A
4-HA,1222,0,1751,0,0,1751,T
4-HA,1223,1,1748,0,0,1749,T
4-HA,1224,2,0,0,1754,1756,C
4-HA,1225,0,0,0,1756,1756,C
4-HA,1226,1758,1,0,0,1759,A
4-HA,1227,1,1750,0,2,1753,T
4-HA,1228,0,0,0,1754,1754,C
4-HA,1229,1747,0,0,0,1747,A
4-HA,1230,0,1,1751,0,1752,G
4-HA,1231,1741,2,0,0,1743,A
4-HA,1232,0,1739,0,0,1739,T
4-HA,1233,0,1731,0,1,1732,T
4-HA,1234,0,0,1742,0,1742,G
4-HA,1235,1741,1,0,0,1742,A
4-HA,1236,1742,1,0,0,1743,A
4-HA,1237,1746,0,0,0,1746,A
4-HA,1238,1745,0,0,0,1745,A
4-HA,1239,1731,0,1,0,1732,A
4-HA,1240,0,1,1733,0,1734,G
4-HA,1241,1733,1,1,0,1735,A
4-HA,1242,1738,0,0,0,1738,A
4-HA,1243,1,1718,0,0,1719,T
4-HA,1244,0,1724,0,0,1724,T
4-HA,1245,0,1,0,1731,1732,C
4-HA,1246,0,1731,0,1,1732,T
4-HA,1247,1,0,0,1730,1731,C
4-HA,1248,1730,0,2,0,1732,A
4-HA,1249,1,0,1731,0,1732,G
4-HA,1250,1728,0,0,0,1728,A
4-HA,1251,1725,0,2,0,1727,A
4-HA,1252,0,0,1739,0,1739,G
4-HA,1253,1,1731,0,1,1733,T
4-HA,1254,0,1,0,1729,1730,C
4-HA,1255,2,0,1729,0,1731,G
4-HA,1256,1727,0,1,1,1729,A
4-HA,1257,1721,1,3,0,1725,A
4-HA,1258,0,1,1728,0,1729,G
4-HA,1259,0,0,1744,0,1744,G
4-HA,1260,0,1,1739,0,1740,G
4-HA,1261,1702,0,10,0,1712,A
4-HA,1262,0,3,1714,0,1717,G
4-HA,1263,1715,2,1,1,1719,A
4-HA,1264,1829,0,2,0,1831,A
4-HA,1265,0,1835,0,0,1835,T
4-HA,1266,1,1833,0,0,1834,T
4-HA,1267,1,0,0,1834,1835,C
4-HA,1268,1808,0,4,0,1812,A
4-HA,1269,0,0,1810,0,1810,G
4-HA,1270,1,0,1806,0,1807,G
4-HA,1271,1806,1,0,0,1807,A
4-HA,1272,3,0,0,1815,1818,C
4-HA,1273,2,0,0,1688,1690,C
4-HA,1274,0,1685,0,2,1687,T
4-HA,1275,0,1681,1,13,1695,T
4-HA,1276,1,0,1703,0,1704,G
4-HA,1277,1706,0,0,0,1706,A
4-HA,1278,0,0,1752,0,1752,G
4-HA,1279,1753,0,0,0,1753,A
4-HA,1280,1716,0,0,0,1716,A
4-HA,1281,1712,0,3,0,1715,A
4-HA,1282,0,1702,0,1,1703,T
4-HA,1283,1780,0,1,0,1781,A
4-HA,1284,0,1776,0,0,1776,T
4-HA,1285,0,2,1812,0,1814,G
4-HA,1286,0,1811,0,0,1811,T
4-HA,1287,1,1769,0,2,1772,T
4-HA,1288,0,0,1782,0,1782,G
4-HA,1289,1774,1,0,0,1775,A
4-HA,1290,1,1,1790,0,1792,G
4-HA,1291,0,2,1786,0,1788,G
4-HA,1292,1768,1,1,0,1770,A
4-HA,1293,0,1,0,1792,1793,C
4-HA,1294,1777,0,0,0,1777,A
4-HA,1295,0,0,0,1799,1799,C
4-HA,1296,1,1,0,1801,1803,C
4-HA,1297,1811,0,0,0,1811,A
4-HA,1298,1848,0,0,1,1849,A
4-HA,1299,1840,0,0,0,1840,A
4-HA,1300,1856,0,1,0,1857,A
4-HA,1301,0,1862,0,0,1862,T
4-HA,1302,1810,1,0,0,1811,A
4-HA,1303,0,0,1819,0,1819,G
4-HA,1304,1791,0,0,0,1791,A
4-HA,1305,0,1795,0,0,1795,T
4-HA,1306,1,0,0,1813,1814,C
4-HA,1307,0,1784,0,2,1786,T
4-HA,1308,0,0,1,1818,1819,C
4-HA,1309,0,1824,0,0,1824,T
4-HA,1310,1,0,1859,0,1860,G
4-HA,1311,0,0,1912,0,1912,G
4-HA,1312,0,1895,0,4,1899,T
4-HA,1313,2,1,0,1890,1893,C
4-HA,1314,1901,0,0,0,1901,A
4-HA,1315,0,1906,0,0,1906,T
4-HA,1316,1909,0,1,0,1910,A
4-HA,1317,0,0,0,1905,1905,C
4-HA,1318,1857,0,1,0,1858,A
4-HA,1319,1865,0,0,0,1865,A
4-HA,1320,1,0,0,1812,1813,C
4-HA,1321,0,0,1813,0,1813,G
4-HA,1322,0,0,0,1811,1811,C
4-HA,1323,1,1,1798,0,1800,G
4-HA,1324,0,1,1797,0,1798,G
4-HA,1325,1765,0,33,0,1798,A
4-HA,1326,1,0,1829,0,1830,G
4-HA,1327,0,3,0,1822,1825,C
4-HA,1328,0,1818,0,0,1818,T
4-HA,1329,0,1822,0,2,1824,T
4-HA,1330,0,0,0,1821,1821,C
4-HA,1331,0,1826,0,1,1827,T
4-HA,1332,0,1826,0,1,1827,T
4-HA,1333,0,0,1823,0,1823,G
4-HA,1334,2,1808,0,2,1812,T
4-HA,1335,2,1794,0,0,1796,T
4-HA,1336,1,0,1819,0,1820,G
4-HA,1337,0,0,0,1814,1814,C
4-HA,1338,1,0,0,1814,1815,C
4-HA,1339,2,0,0,1819,1821,C
4-HA,1340,0,1820,0,4,1824,T
4-HA,1341,1,0,1839,0,1840,G
4-HA,1342,0,0,1843,0,1843,G
4-HA,1343,1841,0,2,0,1843,A
4-HA,1344,0,0,1849,0,1849,G
4-HA,1345,1806,2,0,0,1808,A
4-HA,1346,1815,0,1,0,1816,A
4-HA,1347,0,0,0,1836,1836,C
4-HA,1348,1,0,0,1832,1833,C
4-HA,1349,1830,0,0,0,1830,A
4-HA,1350,1904,0,0,0,1904,A
4-HA,1351,0,1,0,1909,1910,C
4-HA,1352,1924,0,0,0,1924,A
4-HA,1353,0,1917,0,2,1919,T
4-HA,1354,1915,0,0,0,1915,A
4-HA,1355,1,0,0,1946,1947,C
4-HA,1356,1919,1,0,0,1920,A
4-HA,1357,1921,0,0,0,1921,A
4-HA,1358,0,1912,0,1,1913,T
4-HA,1359,0,1859,0,0,1859,T
4-HA,1360,1,0,1884,0,1885,G
4-HA,1361,1882,0,0,0,1882,A
4-HA,1362,0,1875,0,1,1876,T
4-HA,1363,0,0,0,1883,1883,C
4-HA,1364,0,1848,0,1,1849,T
4-HA,1365,1858,0,0,0,1858,A
4-HA,1366,1861,0,0,0,1861,A
4-HA,1367,0,0,0,1858,1858,C
4-HA,1368,0,1855,0,1,1856,T
4-HA,1369,1,1,1841,0,1843,G
4-HA,1370,1846,0,0,0,1846,A
4-HA,1371,0,0,1,1839,1840,C
4-HA,1372,1,1842,0,0,1843,T
4-HA,1373,0,0,0,1847,1847,C
4-HA,1374,1843,0,1,0,1844,A
4-HA,1375,0,0,1866,0,1866,G
4-HA,1376,1861,1,1,0,1863,A
4-HA,1377,1865,0,1,0,1866,A
4-HA,1378,1865,0,0,0,1865,A
4-HA,1379,0,1836,0,1,1837,T
4-HA,1380,0,1,1850,0,1851,G
4-HA,1381,1852,0,1,0,1853,A
4-HA,1382,1851,0,3,0,1854,A
4-HA,1383,0,0,0,1852,1852,C
4-HA,1384,1829,0,0,0,1829,A
4-HA,1385,1828,1,1,0,1830,A
4-HA,1386,1825,1,0,5,1831,A
4-HA,1387,0,0,0,1832,1832,C
4-HA,1388,0,1820,0,0,1820,T
4-HA,1389,0,0,1827,0,1827,G
4-HA,1390,0,1813,0,0,1813,T
4-HA,1391,0,1813,0,0,1813,T
4-HA,1392,1,1808,0,4,1813,T
4-HA,1393,0,0,1814,0,1814,G
4-HA,1394,1816,0,0,1,1817,A
4-HA,1395,1814,1,0,0,1815,A
4-HA,1396,1808,0,1,0,1809,A
4-HA,1397,1807,0,1,0,1808,A
4-HA,1398,1799,0,0,0,1799,A
4-HA,1399,1799,0,1,0,1800,A
4-HA,1400,0,0,0,1802,1802,C
4-HA,1401,1805,0,1,0,1806,A
4-HA,1402,1808,0,1,0,1809,A
4-HA,1403,1804,0,0,0,1804,A
4-HA,1404,0,0,1812,0,1812,G
4-HA,1405,1816,0,0,0,1816,A
4-HA,1406,1798,0,2,0,1800,A
4-HA,1407,0,0,1794,0,1794,G
4-HA,1408,1,1,0,1790,1792,C
4-HA,1409,1791,0,1,0,1792,A
4-HA,1410,1804,1,0,0,1805,A
4-HA,1411,0,0,0,1805,1805,C
4-HA,1412,0,1795,1,1,1797,T
4-HA,1413,2,0,1799,0,1801,G
4-HA,1414,1778,1,1,0,1780,A
4-HA,1415,0,3,1790,1,1794,G
4-HA,1416,0,1,1791,0,1792,G
4-HA,1417,2,1,1792,0,1795,G
4-HA,1418,1795,0,1,0,1796,A
4-HA,1419,1791,0,1,0,1792,A
4-HA,1420,1784,0,2,0,1786,A
4-HA,1421,1803,2,0,0,1805,A
4-HA,1422,0,1793,0,0,1793,T
4-HA,1423,0,1,1794,0,1795,G
4-HA,1424,0,0,0,1793,1793,C
4-HA,1425,0,1772,0,1,1773,T
4-HA,1426,0,1,1776,0,1777,G
4-HA,1427,1775,0,0,0,1775,A
4-HA,1428,0,0,1847,0,1847,G
4-HA,1429,0,0,1859,0,1859,G
4-HA,1430,1837,0,1,0,1838,A
4-HA,1431,0,1832,0,0,1832,T
4-HA,1432,1825,0,1,0,1826,A
4-HA,1433,0,1820,0,1,1821,T
4-HA,1434,0,1,1832,0,1833,G
4-HA,1435,0,1,1844,0,1845,G
4-HA,1436,4,0,1829,0,1833,G
4-HA,1437,1,1,0,1738,1740,C
4-HA,1438,1699,0,0,0,1699,A
4-HA,1439,1700,1,0,0,1701,A
4-HA,1440,2,1694,1,1,1698,T
4-HA,1441,0,0,1705,0,1705,G
4-HA,1442,0,0,1700,0,1700,G
4-HA,1443,1,1677,0,0,1678,T
4-HA,1444,0,1646,0,1,1647,T
4-HA,1445,0,0,1648,0,1648,G
4-HA,1446,1,1653,0,0,1654,T
4-HA,1447,1,1648,0,1,1650,T
4-HA,1448,0,1653,0,1,1654,T
4-HA,1449,0,0,0,1661,1661,C
4-HA,1450,1658,0,0,0,1658,A
4-HA,1451,1660,0,0,0,1660,A
4-HA,1452,1663,0,0,0,1663,A
4-HA,1453,1682,0,0,0,1682,A
4-HA,1454,0,1681,0,1,1682,T
4-HA,1455,1677,0,0,0,1677,A
4-HA,1456,0,1678,0,0,1678,T
4-HA,1457,1677,0,0,1,1678,A
4-HA,1458,1,0,0,1688,1689,C
4-HA,1459,0,0,0,1673,1673,C
4-HA,1460,1671,0,1,0,1672,A
4-HA,1461,0,0,0,1671,1671,C
4-HA,1462,1667,0,0,0,1667,A
4-HA,1463,1671,0,0,0,1671,A
4-HA,1464,1675,0,0,0,1675,A
4-HA,1465,0,1664,0,0,1664,T
4-HA,1466,1,0,1667,0,1668,G
4-HA,1467,0,1638,1,1,1640,T
4-HA,1468,1,1,1645,0,1647,G
4-HA,1469,1625,1,24,0,1650,A
4-HA,1470,0,0,0,1647,1647,C
4-HA,1471,1623,1,0,0,1624,A
4-HA,1472,1621,0,0,0,1621,A
4-HA,1473,0,1634,0,0,1634,T
4-HA,1474,1,0,1653,1,1655,G
4-HA,1475,2,0,0,1643,1645,C
4-HA,1476,0,0,0,1645,1645,C
4-HA,1477,0,1638,0,3,1641,T
4-HA,1478,0,0,1678,0,1678,G
4-HA,1479,0,0,1,1677,1678,C
4-HA,1480,1682,0,1,0,1683,A
4-HA,1481,0,1677,0,1,1678,T
4-HA,1482,1624,0,0,0,1624,A
4-HA,1483,0,1,1628,0,1629,G
4-HA,1484,0,3,1617,0,1620,G
4-HA,1485,1615,0,0,0,1615,A
4-HA,1486,0,1612,0,1,1613,T
4-HA,1487,1,1,0,1524,1526,C
4-HA,1488,1524,0,0,0,1524,A
4-HA,1489,1524,0,0,0,1524,A
4-HA,1490,0,1524,0,0,1524,T
4-HA,1491,1,0,0,1524,1525,C
4-HA,1492,1491,0,1,0,1492,A
4-HA,1493,0,1,1502,0,1503,G
4-HA,1494,1501,1,0,0,1502,A
4-HA,1495,1502,0,1,1,1504,A
4-HA,1496,1501,0,0,0,1501,A
4-HA,1497,0,1490,0,1,1491,T
4-HA,1498,1,2,1482,0,1485,G
4-HA,1499,0,0,1487,0,1487,G
4-HA,1500,1490,0,2,0,1492,A
4-HA,1501,1499,0,0,0,1499,A
4-HA,1502,0,0,0,1488,1488,C
4-HA,1503,0,1473,1,0,1474,T
4-HA,1504,1,1486,2,0,1489,T
4-HA,1505,1491,0,0,0,1491,A
4-HA,1506,0,1486,0,1,1487,T
4-HA,1507,1,2,1481,0,1484,G
4-HA,1508,1474,0,2,0,1476,A
4-HA,1509,1,2,0,1467,1470,C
4-HA,1510,2,0,0,1455,1457,C
4-HA,1511,1453,0,0,0,1453,A
4-HA,1512,0,0,0,1482,1482,C
4-HA,1513,0,0,1528,0,1528,G
4-HA,1514,1551,0,0,0,1551,A
4-HA,1515,1,1568,0,0,1569,T
4-HA,1516,0,0,1618,0,1618,G
4-HA,1517,0,1605,0,2,1607,T
4-HA,1518,1638,0,1,0,1639,A
4-HA,1519,0,1637,0,0,1637,T
4-HA,1520,1632,2,1,0,1635,A
4-HA,1521,0,0,0,1629,1629,C
4-HA,1522,1457,0,0,0,1457,A
4-HA,1523,1,0,1474,0,1475,G
4-HA,1524,1387,0,0,0,1387,A
4-HA,1525,1,0,1335,0,1336,G
4-HA,1526,1330,0,0,0,1330,A
4-HA,1527,0,1238,0,0,1238,T
4-HA,1528,0,0,1237,0,1237,G
4-HA,1529,1237,0,0,0,1237,A
4-HA,1530,1229,0,0,0,1229,A
4-HA,1531,1,0,1244,0,1245,G
4-HA,1532,0,0,0,1212,1212,C
4-HA,1533,1206,0,0,0,1206,A
4-HA,1534,0,1199,0,0,1199,T
4-HA,1535,0,1205,0,0,1205,T
4-HA,1536,1211,0,0,0,1211,A
4-HA,1537,1211,0,0,0,1211,A
4-HA,1538,1209,0,1,0,1210,A
4-HA,1539,0,0,0,1212,1212,C
4-HA,1540,1150,0,0,0,1150,A
4-HA,1541,1153,0,0,0,1153,A
4-HA,1542,1,1,0,1151,1153,C
4-HA,1543,0,0,0,1144,1144,C
4-HA,1544,0,1,1147,0,1148,G
4-HA,1545,0,0,1159,0,1159,G
4-HA,1546,1,1161,0,0,1162,T
4-HA,1547,0,1150,0,2,1152,T
4-HA,1548,1,0,0,1152,1153,C
4-HA,1549,0,2,1,1156,1159,C
4-HA,1550,1153,0,2,0,1155,A
4-HA,1551,1,0,1167,0,1168,G
4-HA,1552,1165,0,0,0,1165,A
4-HA,1553,1,1158,0,1,1160,T
4-HA,1554,0,1,0,1117,1118,C
4-HA,1555,1110,0,0,0,1110,A
4-HA,1556,1111,0,0,0,1111,A
4-HA,1557,0,3,1107,0,1110,G
4-HA,1558,0,0,1105,0,1105,G
4-HA,1559,0,0,1107,0,1107,G
4-HA,1560,1051,1,0,0,1052,A
4-HA,1561,0,0,1065,0,1065,G
4-HA,1562,0,1064,0,0,1064,T
4-HA,1563,0,1063,0,0,1063,T
4-HA,1564,0,0,1069,0,1069,G
4-HA,1565,1062,0,2,0,1064,A
4-HA,1566,0,0,1066,0,1066,G
4-HA,1567,0,0,0,1066,1066,C
4-HA,1568,0,1052,0,1,1053,T
4-HA,1569,1,0,1058,0,1059,G
4-HA,1570,1049,0,0,0,1049,A
4-HA,1571,1053,0,0,0,1053,A
4-HA,1572,0,0,1054,0,1054,G
4-HA,1573,0,1035,0,0,1035,T
4-HA,1574,1,0,0,1032,1033,C
4-HA,1575,1017,0,0,0,1017,A
4-HA,1576,0,1,1018,0,1019,G
4-HA,1577,0,0,1015,0,1015,G
4-HA,1578,0,2,1001,0,1003,G
4-HA,1579,0,1024,0,1,1025,T
4-HA,1580,1024,0,0,0,1024,A
4-HA,1581,0,0,0,1020,1020,C
4-HA,1582,1019,0,0,0,1019,A
4-HA,1583,1021,0,0,0,1021,A
4-HA,1584,1016,0,0,0,1016,A
4-HA,1585,1,0,1014,0,1015,G
4-HA,1586,989,0,0,0,989,A
4-HA,1587,1,945,0,0,946,T
4-HA,1588,0,930,0,0,930,T
4-HA,1589,0,0,930,0,930,G
4-HA,1590,1,0,921,0,922,G
4-HA,1591,927,0,0,0,927,A
4-HA,1592,0,923,0,0,923,T
4-HA,1593,1,0,0,911,912,C
4-HA,1594,1,1,0,890,892,C
4-HA,1595,1,881,0,1,883,T
4-HA,1596,887,0,0,0,887,A
4-HA,1597,0,887,0,1,888,T
4-HA,1598,0,0,891,0,891,G
4-HA,1599,0,0,890,0,890,G
4-HA,1600,865,0,0,0,865,A
4-HA,1601,1,861,0,0,862,T
4-HA,1602,1,852,0,1,854,T
4-HA,1603,0,855,0,0,855,T
4-HA,1604,0,0,0,854,854,C
4-HA,1605,0,0,0,853,853,C
4-HA,1606,0,845,0,0,845,T
4-HA,1607,0,844,0,0,844,T
4-HA,1608,0,834,0,0,834,T
4-HA,1609,0,0,838,0,838,G
4-HA,1610,0,0,0,837,837,C
4-HA,1611,0,0,0,832,832,C
4-HA,1612,810,0,0,0,810,A
4-HA,1613,0,801,0,1,802,T
4-HA,1614,809,0,1,0,810,A
4-HA,1615,0,805,1,2,808,T
4-HA,1616,0,0,0,801,801,C
4-HA,1617,802,0,0,0,802,A
4-HA,1618,0,788,0,1,789,T
4-HA,1619,1,0,791,0,792,G
4-HA,1620,0,737,0,1,738,T
4-HA,1621,0,785,0,0,785,T
4-HA,1622,0,784,0,0,784,T
4-HA,1623,0,769,0,0,769,T
4-HA,1624,0,769,0,0,769,T
4-HA,1625,0,764,0,0,764,T
4-HA,1626,0,0,763,0,763,G
4-HA,1627,0,0,0,762,762,C
4-HA,1628,0,742,1,2,745,T
4-HA,1629,0,744,0,0,744,T
4-HA,1630,0,744,0,0,744,T
4-HA,1631,0,1,746,0,747,G
4-HA,1632,0,743,0,2,745,T
4-HA,1633,0,1,746,0,747,G
4-HA,1634,0,748,0,0,748,T
4-HA,1635,0,730,1,0,731,T
4-HA,1636,0,0,730,0,730,G
4-HA,1637,0,0,0,731,731,C
4-HA,1638,0,727,0,3,730,T
4-HA,1639,0,734,0,0,734,T
4-HA,1640,0,695,0,1,696,T
4-HA,1641,0,0,696,0,696,G
4-HA,1642,0,694,0,0,694,T
4-HA,1643,0,691,0,0,691,T
4-HA,1644,0,0,693,0,693,G
4-HA,1645,0,0,671,1,672,G
4-HA,1646,0,1,672,0,673,G
4-HA,1647,0,0,674,0,674,G
4-HA,1648,0,658,0,0,658,T
4-HA,1649,0,659,0,0,659,T
4-HA,1650,0,1,0,644,645,C
4-HA,1651,627,1,1,0,629,A
4-HA,1652,0,630,0,1,631,T
4-HA,1653,0,0,0,632,632,C
4-HA,1654,624,0,0,0,624,A
4-HA,1655,0,607,0,0,607,T
4-HA,1656,0,0,603,0,603,G
4-HA,1657,0,595,0,0,595,T
4-HA,1658,3,0,584,0,587,G
4-HA,1659,0,0,567,0,567,G
4-HA,1660,0,0,560,0,560,G
4-HA,1661,0,0,0,550,550,C
4-HA,1662,0,0,0,535,535,C
4-HA,1663,0,502,0,3,505,T
4-HA,1664,1,0,505,0,506,G
4-HA,1665,1,0,0,503,504,C
4-HA,1666,0,0,0,504,504,C
4-HA,1667,505,0,0,0,505,A
4-HA,1668,504,0,0,0,504,A
4-HA,1669,503,0,0,0,503,A
4-HA,1670,503,0,0,0,503,A
4-HA,1671,503,0,0,0,503,A
4-HA,1672,0,0,501,0,501,G
4-HA,1673,0,0,484,0,484,G
4-HA,1674,0,0,0,479,479,C
4-HA,1675,473,0,0,0,473,A
4-HA,1676,471,0,2,0,473,A
4-HA,1677,0,0,0,473,473,C
4-HA,1678,473,0,0,0,473,A
4-HA,1679,0,472,0,0,472,T
4-HA,1680,0,469,0,0,469,T
4-HA,1681,448,0,0,0,448,A
4-HA,1682,0,0,444,0,444,G
4-HA,1683,0,0,444,0,444,G
4-HA,1684,0,429,0,0,429,T
4-HA,1685,0,0,394,0,394,G
4-HA,1686,0,0,0,378,378,C
4-HA,1687,371,0,0,0,371,A
4-HA,1688,371,0,0,0,371,A
4-HA,1689,0,0,0,371,371,C
4-HA,1690,364,0,0,0,364,A
4-HA,1691,0,358,0,1,359,T
4-HA,1692,0,327,0,0,327,T
4-HA,1693,0,326,0,0,326,T
4-HA,1694,0,0,325,0,325,G
4-HA,1695,1,0,0,323,324,C
4-HA,1696,324,0,0,0,324,A
4-HA,1697,0,300,0,0,300,T
4-HA,1698,0,295,0,0,295,T
4-HA,1699,0,285,0,0,285,T
4-HA,1700,0,0,285,0,285,G
4-HA,1701,274,0,0,0,274,A
5-NP,1,34,0,0,0,34,A
5-NP,2,0,34,0,0,34,T
5-NP,3,0,0,34,0,34,G
5-NP,4,0,0,34,0,34,G
5-NP,5,0,0,0,34,34,C
5-NP,6,0,0,37,0,37,G
5-NP,7,0,39,0,0,39,T
5-NP,8,0,0,0,40,40,C
5-NP,9,0,0,0,40,40,C
5-NP,10,0,0,0,40,40,C
5-NP,11,40,0,0,0,40,A
5-NP,12,40,0,0,0,40,A
5-NP,13,0,0,40,0,40,G
5-NP,14,0,0,40,0,40,G
5-NP,15,0,0,0,40,40,C
5-NP,16,40,0,0,0,40,A
5-NP,17,0,0,0,40,40,C
5-NP,18,0,0,0,40,40,C
5-NP,19,40,0,0,0,40,A
5-NP,20,40,0,0,0,40,A
5-NP,21,40,0,0,0,40,A
5-NP,22,0,0,0,40,40,C
5-NP,23,0,0,41,0,41,G
5-NP,24,0,0,47,0,47,G
5-NP,25,0,47,0,0,47,T
5-NP,26,0,0,0,52,52,C
5-NP,27,0,52,0,0,52,T
5-NP,28,0,52,0,0,52,T
5-NP,29,52,0,0,0,52,A
5-NP,30,0,52,0,0,52,T
5-NP,31,0,0,53,0,53,G
5-NP,32,53,0,0,0,53,A
5-NP,33,52,0,1,0,53,A
5-NP,34,0,0,0,54,54,C
5-NP,35,53,0,0,0,53,A
5-NP,36,0,0,57,0,57,G
5-NP,37,58,0,0,0,58,A
5-NP,38,0,57,0,0,57,T
5-NP,39,0,0,58,0,58,G
5-NP,40,0,0,58,0,58,G
5-NP,41,59,0,0,0,59,A
5-NP,42,59,0,0,0,59,A
5-NP,43,60,0,0,0,60,A
5-NP,44,0,0,0,61,61,C
5-NP,45,0,61,0,0,61,T
5-NP,46,0,0,63,0,63,G
5-NP,47,63,0,0,0,63,A
5-NP,48,0,63,0,0,63,T
5-NP,49,0,0,63,0,63,G
5-NP,50,0,0,62,0,62,G
5-NP,51,0,0,63,0,63,G
5-NP,52,0,0,63,0,63,G
5-NP,53,63,0,0,0,63,A
5-NP,54,0,63,0,0,63,T
5-NP,55,0,0,0,63,63,C
5-NP,56,0,0,63,0,63,G
5-NP,57,0,0,0,64,64,C
5-NP,58,0,0,0,64,64,C
5-NP,59,65,0,0,0,65,A
5-NP,60,0,0,66,0,66,G
5-NP,61,65,0,0,0,65,A
5-NP,62,67,0,0,0,67,A
5-NP,63,0,67,0,0,67,T
5-NP,64,0,0,67,0,67,G
5-NP,65,0,0,0,67,67,C
5-NP,66,66,0,0,0,66,A
5-NP,67,67,0,0,0,67,A
5-NP,68,0,0,0,67,67,C
5-NP,69,0,66,0,0,66,T
5-NP,70,0,0,67,0,67,G
5-NP,71,70,0,0,0,70,A
5-NP,72,0,0,74,0,74,G
5-NP,73,75,0,0,0,75,A
5-NP,74,0,74,0,0,74,T
5-NP,75,0,74,0,0,74,T
5-NP,76,74,0,0,0,74,A
5-NP,77,0,0,73,0,73,G
5-NP,78,0,1,73,0,74,G
5-NP,79,0,0,74,0,74,G
5-NP,80,0,0,0,73,73,C
5-NP,81,73,0,0,0,73,A
5-NP,82,0,73,0,0,73,T
5-NP,83,0,0,0,73,73,C
5-NP,84,0,0,0,73,73,C
5-NP,85,0,0,75,0,75,G
5-NP,86,0,75,0,0,75,T
5-NP,87,0,0,0,75,75,C
5-NP,88,0,0,75,0,75,G
5-NP,89,0,0,75,0,75,G
5-NP,90,0,0,76,0,76,G
5-NP,91,75,0,0,0,75,A
5-NP,92,75,0,0,0,75,A
5-NP,93,0,0,75,0,75,G
5-NP,94,75,0,0,0,75,A
5-NP,95,0,77,0,0,77,T
5-NP,96,0,0,77,0,77,G
5-NP,97,77,0,0,0,77,A
5-NP,98,0,77,0,0,77,T
5-NP,99,0,77,0,0,77,T
5-NP,100,0,0,76,0,76,G
5-NP,101,77,0,0,0,77,A
5-NP,102,0,77,0,0,77,T
5-NP,103,0,0,77,0,77,G
5-NP,104,0,0,77,0,77,G
5-NP,105,0,0,76,0,76,G
5-NP,106,83,0,0,0,83,A
5-NP,107,0,83,0,0,83,T
5-NP,108,0,83,0,0,83,T
5-NP,109,0,0,84,0,84,G
5-NP,110,0,0,83,0,83,G
5-NP,111,0,0,84,0,84,G
5-NP,112,83,0,0,0,83,A
5-NP,113,0,0,84,0,84,G
5-NP,114,83,0,0,0,83,A
5-NP,115,0,82,0,0,82,T
5-NP,116,0,81,0,1,82,T
5-NP,117,0,0,0,82,82,C
5-NP,118,0,81,0,0,81,T
5-NP,119,83,0,0,0,83,A
5-NP,120,0,0,0,83,83,C
5-NP,121,84,0,0,0,84,A
5-NP,122,0,86,0,0,86,T
5-NP,123,0,0,0,86,86,C
5-NP,124,0,0,0,85,85,C
5-NP,125,86,0,0,0,86,A
5-NP,126,92,0,0,0,92,A
5-NP,127,92,0,0,0,92,A
5-NP,128,0,90,0,0,90,T
5-NP,129,0,0,91,0,91,G
5-NP,130,0,90,0,0,90,T
5-NP,131,0,0,91,0,91,G
5-NP,132,0,0,0,91,91,C
5-NP,133,89,0,0,0,89,A
5-NP,134,0,0,0,90,90,C
5-NP,135,0,90,0,0,90,T
5-NP,136,0,0,95,0,95,G
5-NP,137,96,0,0,0,96,A
5-NP,138,99,0,0,0,99,A
5-NP,139,0,0,0,99,99,C
5-NP,140,0,99,0,0,99,T
5-NP,141,0,99,0,0,99,T
5-NP,142,100,0,0,0,100,A
5-NP,143,99,0,0,0,99,A
5-NP,144,100,0,0,0,100,A
5-NP,145,0,1,0,99,100,C
5-NP,146,0,98,0,0,98,T
5-NP,147,0,0,0,98,98,C
5-NP,148,96,0,0,0,96,A
5-NP,149,0,0,97,0,97,G
5-NP,150,0,97,0,0,97,T
5-NP,151,0,0,100,0,100,G
5-NP,152,100,0,0,0,100,A
5-NP,153,0,99,0,0,99,T
5-NP,154,0,0,0,101,101,C
5-NP,155,101,0,0,0,101,A
5-NP,156,0,100,0,0,100,T
5-NP,157,0,0,100,0,100,G
5-NP,158,100,0,0,0,100,A
5-NP,159,100,0,0,0,100,A
5-NP,160,0,0,100,0,100,G
5-NP,161,0,0,100,0,100,G
5-NP,162,0,0,98,0,98,G
5-NP,163,0,0,0,100,100,C
5-NP,164,0,0,101,0,101,G
5-NP,165,0,0,102,0,102,G
5-NP,166,0,102,0,0,102,T
5-NP,167,0,102,0,0,102,T
5-NP,168,0,0,102,0,102,G
5-NP,169,108,0,0,0,108,A
5-NP,170,0,107,0,0,107,T
5-NP,171,0,0,0,108,108,C
5-NP,172,0,0,0,108,108,C
5-NP,173,107,0,0,0,107,A
5-NP,174,0,0,107,0,107,G
5-NP,175,108,0,0,0,108,A
5-NP,176,107,0,0,0,107,A
5-NP,177,0,0,0,109,109,C
5-NP,178,102,0,0,0,102,A
5-NP,179,0,0,105,0,105,G
5-NP,180,0,0,0,105,105,C
5-NP,181,0,105,0,0,105,T
5-NP,182,0,107,0,0,107,T
5-NP,183,0,0,108,0,108,G
5-NP,184,108,0,0,0,108,A
5-NP,185,0,0,0,108,108,C
5-NP,186,107,0,1,0,108,A
5-NP,187,108,0,0,0,108,A
5-NP,188,0,104,1,0,105,T
5-NP,189,107,0,0,0,107,A
5-NP,190,0,0,110,0,110,G
5-NP,191,109,0,0,0,109,A
5-NP,192,0,0,111,0,111,G
5-NP,193,110,0,0,0,110,A
5-NP,194,111,0,0,0,111,A
5-NP,195,112,0,0,0,112,A
5-NP,196,113,0,0,0,113,A
5-NP,197,0,114,0,0,114,T
5-NP,198,0,0,113,0,113,G
5-NP,199,0,0,112,0,112,G
5-NP,200,0,113,0,0,113,T
5-NP,201,112,0,0,0,112,A
5-NP,202,0,0,0,113,113,C
5-NP,203,0,114,0,0,114,T
5-NP,204,0,0,0,114,114,C
5-NP,205,0,115,0,0,115,T
5-NP,206,0,0,0,117,117,C
5-NP,207,0,118,0,0,118,T
5-NP,208,0,0,120,0,120,G
5-NP,209,0,0,0,119,119,C
5-NP,210,0,120,0,0,120,T
5-NP,211,0,118,0,0,118,T
5-NP,212,0,120,0,0,120,T
5-NP,213,0,119,0,0,119,T
5-NP,214,0,0,121,0,121,G
5-NP,215,120,0,0,0,120,A
5-NP,216,0,121,0,0,121,T
5-NP,217,0,0,120,0,120,G
5-NP,218,120,0,0,0,120,A
5-NP,219,120,0,0,0,120,A
5-NP,220,120,0,0,0,120,A
5-NP,221,0,0,120,0,120,G
5-NP,222,120,0,0,0,120,A
5-NP,223,120,0,0,0,120,A
5-NP,224,0,0,120,0,120,G
5-NP,225,0,0,123,0,123,G
5-NP,226,123,0,0,0,123,A
5-NP,227,123,0,0,0,123,A
5-NP,228,0,124,0,0,124,T
5-NP,229,124,0,0,0,124,A
5-NP,230,121,0,0,0,121,A
5-NP,231,122,0,1,0,123,A
5-NP,232,0,121,0,0,121,T
5-NP,233,123,0,0,0,123,A
5-NP,234,0,0,0,120,120,C
5-NP,235,0,0,0,119,119,C
5-NP,236,0,118,0,0,118,T
5-NP,237,0,0,119,0,119,G
5-NP,238,0,0,121,0,121,G
5-NP,239,121,0,0,0,121,A
5-NP,240,121,0,0,0,121,A
5-NP,241,0,0,124,0,124,G
5-NP,242,124,0,0,0,124,A
5-NP,243,124,0,0,0,124,A
5-NP,244,0,0,0,124,124,C
5-NP,245,122,0,0,0,122,A
5-NP,246,0,0,0,125,125,C
5-NP,247,0,0,0,124,124,C
5-NP,248,0,0,0,124,124,C
5-NP,249,0,0,0,125,125,C
5-NP,250,126,0,0,0,126,A
5-NP,251,0,0,126,0,126,G
5-NP,252,0,0,0,125,125,C
5-NP,253,0,0,125,0,125,G
5-NP,254,0,0,0,124,124,C
5-NP,255,0,0,121,0,121,G
5-NP,256,0,0,124,0,124,G
5-NP,257,0,0,123,0,123,G
5-NP,258,0,0,122,0,122,G
5-NP,259,123,0,0,0,123,A
5-NP,260,123,0,0,0,123,A
5-NP,261,123,0,0,0,123,A
5-NP,262,0,0,123,0,123,G
5-NP,263,122,0,0,0,122,A
5-NP,264,0,121,0,0,121,T
5-NP,265,0,0,0,119,119,C
5-NP,266,0,0,0,120,120,C
5-NP,267,1,0,0,120,121,C
5-NP,268,120,0,0,0,120,A
5-NP,269,122,0,0,0,122,A
5-NP,270,0,0,122,0,122,G
5-NP,271,120,0,1,0,121,A
5-NP,272,122,0,0,0,122,A
5-NP,273,123,0,0,0,123,A
5-NP,274,122,0,0,0,122,A
5-NP,275,0,0,0,123,123,C
5-NP,276,0,123,0,0,123,T
5-NP,277,0,0,122,0,122,G
5-NP,278,0,0,123,0,123,G
5-NP,279,0,0,123,0,123,G
5-NP,280,0,0,124,0,124,G
5-NP,281,0,0,121,0,121,G
5-NP,282,0,0,123,0,123,G
5-NP,283,0,0,0,130,130,C
5-NP,284,0,0,0,131,131,C
5-NP,285,0,0,0,133,133,C
5-NP,286,151,0,0,0,151,A
5-NP,287,0,151,1,0,152,T
5-NP,288,158,0,0,0,158,A
5-NP,289,0,158,0,0,158,T
5-NP,290,156,0,0,0,156,A
5-NP,291,0,0,0,157,157,C
5-NP,292,143,0,0,0,143,A
5-NP,293,0,0,143,0,143,G
5-NP,294,0,0,142,0,142,G
5-NP,295,130,0,0,0,130,A
5-NP,296,0,0,134,0,134,G
5-NP,297,129,0,0,0,129,A
5-NP,298,0,0,130,0,130,G
5-NP,299,0,128,0,0,128,T
5-NP,300,130,0,0,0,130,A
5-NP,301,0,0,129,0,129,G
5-NP,302,126,1,0,0,127,A
5-NP,303,0,126,0,0,126,T
5-NP,304,0,0,129,0,129,G
5-NP,305,0,0,132,0,132,G
5-NP,306,130,0,1,0,131,A
5-NP,307,130,0,0,0,130,A
5-NP,308,129,0,0,0,129,A
5-NP,309,129,1,0,0,130,A
5-NP,310,0,128,0,0,128,T
5-NP,311,0,1,129,0,130,G
5-NP,312,0,0,130,0,130,G
5-NP,313,131,0,0,0,131,A
5-NP,314,0,130,0,0,130,T
5-NP,315,0,0,131,0,131,G
5-NP,316,132,0,0,0,132,A
5-NP,317,0,0,132,0,132,G
5-NP,318,0,0,132,0,132,G
5-NP,319,0,0,135,0,135,G
5-NP,320,175,0,0,0,175,A
5-NP,321,187,0,0,0,187,A
5-NP,322,0,0,0,230,230,C
5-NP,323,0,231,0,0,231,T
5-NP,324,0,0,0,266,266,C
5-NP,325,0,0,280,0,280,G
5-NP,326,0,307,0,0,307,T
5-NP,327,0,0,0,333,333,C
5-NP,328,0,0,0,621,621,C
5-NP,329,0,620,0,0,620,T
5-NP,330,0,643,1,0,644,T
5-NP,331,0,642,0,1,643,T
5-NP,332,653,0,1,0,654,A
5-NP,333,0,654,0,1,655,T
5-NP,334,0,3,656,0,659,G
5-NP,335,677,0,1,0,678,A
5-NP,336,0,0,0,684,684,C
5-NP,337,682,0,0,0,682,A
5-NP,338,688,0,0,0,688,A
5-NP,339,703,0,1,0,704,A
5-NP,340,0,0,798,0,798,G
5-NP,341,798,0,0,0,798,A
5-NP,342,801,2,0,0,803,A
5-NP,343,0,0,923,0,923,G
5-NP,344,949,1,0,0,950,A
5-NP,345,951,0,0,0,951,A
5-NP,346,953,0,0,0,953,A
5-NP,347,0,952,0,0,952,T
5-NP,348,957,0,0,0,957,A
5-NP,349,961,0,2,0,963,A
5-NP,350,0,0,998,0,998,G
5-NP,351,0,1,994,0,995,G
5-NP,352,0,0,0,998,998,C
5-NP,353,0,0,997,1,998,G
5-NP,354,1014,1,0,0,1015,A
5-NP,355,1048,0,0,0,1048,A
5-NP,356,0,1056,0,0,1056,T
5-NP,357,0,0,0,1060,1060,C
5-NP,358,0,1058,0,0,1058,T
5-NP,359,1,0,1060,0,1061,G
5-NP,360,0,0,1063,0,1063,G
5-NP,361,0,0,0,1068,1068,C
5-NP,362,1,0,1067,0,1068,G
5-NP,363,0,0,0,1072,1072,C
5-NP,364,0,1,0,1074,1075,C
5-NP,365,1082,0,0,0,1082,A
5-NP,366,1120,0,1,0,1121,A
5-NP,367,0,1,1203,0,1204,G
5-NP,368,0,1,0,1204,1205,C
5-NP,369,0,2,0,1229,1231,C
5-NP,370,1234,2,0,0,1236,A
5-NP,371,1290,1,0,0,1291,A
5-NP,372,0,0,1,1326,1327,C
5-NP,373,1328,0,1,0,1329,A
5-NP,374,1393,0,2,0,1395,A
5-NP,375,0,1402,0,0,1402,T
5-NP,376,0,1,1490,0,1491,G
5-NP,377,0,0,1494,0,1494,G
5-NP,378,1,1493,0,0,1494,T
5-NP,379,0,0,1499,0,1499,G
5-NP,380,1498,0,2,0,1500,A
5-NP,381,0,0,1595,0,1595,G
5-NP,382,1,0,1603,0,1604,G
5-NP,383,1649,1,5,0,1655,A
5-NP,384,0,1955,0,0,1955,T
5-NP,385,1,1,2018,0,2020,G
5-NP,386,1,0,0,2028,2029,C
5-NP,387,1,2034,0,0,2035,T
5-NP,388,2064,1,2,0,2067,A
5-NP,389,0,0,0,2137,2137,C
5-NP,390,2162,1,0,0,2163,A
5-NP,391,0,2163,0,0,2163,T
5-NP,392,0,0,1,2152,2153,C
5-NP,393,0,2115,0,1,2116,T
5-NP,394,2,1,2276,0,2279,G
5-NP,395,0,0,2357,0,2357,G
5-NP,396,0,2361,1,3,2365,T
5-NP,397,2,0,0,2361,2363,C
5-NP,398,1,2358,1,1,2361,T
5-NP,399,2422,0,0,1,2423,A
5-NP,400,2423,0,0,1,2424,A
5-NP,401,1,0,0,2469,2470,C
5-NP,402,0,2466,0,3,2469,T
5-NP,403,0,0,0,2507,2507,C
5-NP,404,2513,0,4,1,2518,A
5-NP,405,0,1,0,2670,2671,C
5-NP,406,2667,3,2,1,2673,A
5-NP,407,1,2689,0,0,2690,T
5-NP,408,2669,0,0,0,2669,A
5-NP,409,2691,0,2,0,2693,A
5-NP,410,0,2731,0,1,2732,T
5-NP,411,1,0,2788,0,2789,G
5-NP,412,2785,0,0,0,2785,A
5-NP,413,0,2783,0,0,2783,T
5-NP,414,0,2767,0,0,2767,T
5-NP,415,0,2774,1,1,2776,T
5-NP,416,1,1,2766,0,2768,G
5-NP,417,2,0,2774,0,2776,G
5-NP,418,0,2,0,2785,2787,C
5-NP,419,2784,0,2,0,2786,A
5-NP,420,1,2791,0,1,2793,T
5-NP,421,0,2789,0,5,2794,T
5-NP,422,1,1,0,2790,2792,C
5-NP,423,0,2,0,2802,2804,C
5-NP,424,2849,1,1,0,2851,A
5-NP,425,2855,0,1,0,2856,A
5-NP,426,0,2856,0,0,2856,T
5-NP,427,0,2860,0,0,2860,T
5-NP,428,1,2855,2,0,2858,T
5-NP,429,0,2,2894,1,2897,G
5-NP,430,2891,1,3,0,2895,A
5-NP,431,2896,0,0,1,2897,A
5-NP,432,2,2915,1,0,2918,T
5-NP,433,0,0,2912,0,2912,G
5-NP,434,3082,1,4,1,3088,A
5-NP,435,1,3087,1,2,3091,T
5-NP,436,0,0,3102,1,3103,G
5-NP,437,0,1,0,3214,3215,C
5-NP,438,3209,0,2,0,3211,A
5-NP,439,3370,2,2,0,3374,A
5-NP,440,0,0,0,3383,3383,C
5-NP,441,3446,0,2,0,3448,A
5-NP,442,0,3552,0,0,3552,T
5-NP,443,3520,1,1,0,3522,A
5-NP,444,0,0,0,3585,3585,C
5-NP,445,1,0,0,3586,3587,C
5-NP,446,3554,1,0,1,3556,A
5-NP,447,0,3,3596,0,3599,G
5-NP,448,3555,0,1,0,3556,A
5-NP,449,2,2,3637,0,3641,G
5-NP,450,0,1,3642,0,3643,G
5-NP,451,3621,3,5,0,3629,A
5-NP,452,0,0,0,3663,3663,C
5-NP,453,3640,0,1,0,3641,A
5-NP,454,3636,2,2,0,3640,A
5-NP,455,0,3,3658,0,3661,G
5-NP,456,3632,0,1,0,3633,A
5-NP,457,0,2,3661,0,3663,G
5-NP,458,1,0,0,3670,3671,C
5-NP,459,0,3658,0,4,3662,T
5-NP,460,1,0,0,3687,3688,C
5-NP,461,0,3680,0,2,3682,T
5-NP,462,0,3688,1,1,3690,T
5-NP,463,2,0,3708,0,3710,G
5-NP,464,0,3704,0,1,3705,T
5-NP,465,0,3698,0,1,3699,T
5-NP,466,1,1,0,3695,3697,C
5-NP,467,1,3,3694,0,3698,G
5-NP,468,3798,0,1,0,3799,A
5-NP,469,3794,0,1,0,3795,A
5-NP,470,0,1,0,3826,3827,C
5-NP,471,1,3820,0,2,3823,T
5-NP,472,1,2,3894,0,3897,G
5-NP,473,0,3,3917,0,3920,G
5-NP,474,3917,1,1,1,3920,A
5-NP,475,3915,1,1,2,3919,A
5-NP,476,1,3932,0,0,3933,T
5-NP,477,1,1,3948,0,3950,G
5-NP,478,0,1,3969,0,3970,G
5-NP,479,4007,1,4,1,4013,A
5-NP,480,1,4050,0,3,4054,T
5-NP,481,3,1,0,4082,4086,C
5-NP,482,1,1,0,4074,4076,C
5-NP,483,2,1,0,4094,4097,C
5-NP,484,4119,0,0,0,4119,A
5-NP,485,0,1,4181,0,4182,G
5-NP,486,4184,0,1,1,4186,A
5-NP,487,4188,0,3,0,4191,A
5-NP,488,2,4164,0,0,4166,T
5-NP,489,0,0,4211,0,4211,G
5-NP,490,0,4189,0,1,4190,T
5-NP,491,0,0,4209,0,4209,G
5-NP,492,0,0,0,4219,4219,C
5-NP,493,0,4196,1,2,4199,T
5-NP,494,0,2,0,4433,4435,C
5-NP,495,1,4416,0,0,4417,T
5-NP,496,2,1,0,4616,4619,C
5-NP,497,0,4616,0,1,4617,T
5-NP,498,0,0,4632,0,4632,G
5-NP,499,4659,1,0,1,4661,A
5-NP,500,2,4656,0,0,4658,T
5-NP,501,1,0,4663,0,4664,G
5-NP,502,0,1,0,4658,4659,C
5-NP,503,4575,3,5,0,4583,A
5-NP,504,1,5,4695,0,4701,G
5-NP,505,0,1,4643,1,4645,G
5-NP,506,1,3,4691,0,4695,G
5-NP,507,0,0,0,4695,4695,C
5-NP,508,0,4685,0,2,4687,T
5-NP,509,1,1,0,4700,4702,C
5-NP,510,0,1,4709,0,4710,G
5-NP,511,4773,1,3,0,4777,A
5-NP,512,1,0,0,4781,4782,C
5-NP,513,2,4719,1,9,4731,T
5-NP,514,0,0,0,4972,4972,C
5-NP,515,0,4953,0,5,4958,T
5-NP,516,1,2,0,5746,5749,C
5-NP,517,3,0,0,5749,5752,C
5-NP,518,10,1,0,5762,5773,C
5-NP,519,1,5780,0,1,5782,T
5-NP,520,5734,0,7,1,5742,A
5-NP,521,0,0,5755,0,5755,G
5-NP,522,5731,1,2,0,5734,A
5-NP,523,5598,0,1,0,5599,A
5-NP,524,0,0,5625,0,5625,G
5-NP,525,1,1,5576,0,5578,G
5-NP,526,2,5519,0,0,5521,T
5-NP,527,1,0,0,5511,5512,C
5-NP,528,5,3,0,5511,5519,C
5-NP,529,0,3,5514,0,5517,G
5-NP,530,1,7,5533,1,5542,G
5-NP,531,5542,0,4,1,5547,A
5-NP,532,0,0,5603,0,5603,G
5-NP,533,1,2,0,5630,5633,C
5-NP,534,0,5611,0,1,5612,T
5-NP,535,2,1,5626,3,5632,G
5-NP,536,0,1,0,5645,5646,C
5-NP,537,5624,2,12,0,5638,A
5-NP,538,0,2,5652,0,5654,G
5-NP,539,44,2,5632,0,5678,G
5-NP,540,0,5686,1,2,5689,T
5-NP,541,1,1,5638,0,5640,G
5-NP,542,2,1,0,5658,5661,C
5-NP,543,0,5656,0,3,5659,T
5-NP,544,1,0,5671,0,5672,G
5-NP,545,2,0,0,5678,5680,C
5-NP,546,5720,0,0,0,5720,A
5-NP,547,0,0,5800,1,5801,G
5-NP,548,0,5768,0,0,5768,T
5-NP,549,2,1,0,5788,5791,C
5-NP,550,5781,1,1,0,5783,A
5-NP,551,5791,0,0,1,5792,A
5-NP,552,5777,2,3,1,5783,A
5-NP,553,1,0,5809,1,5811,G
5-NP,554,0,2,5815,1,5818,G
5-NP,555,5830,1,0,0,5831,A
5-NP,556,5800,0,4,0,5804,A
5-NP,557,0,5804,0,0,5804,T
5-NP,558,1,2,0,5803,5806,C
5-NP,559,2,4,5800,0,5806,G
5-NP,560,1,1,5951,1,5954,G
5-NP,561,0,5,5957,0,5962,G
5-NP,562,5947,6,2,0,5955,A
5-NP,563,0,0,0,5961,5961,C
5-NP,564,5928,2,3,0,5933,A
5-NP,565,6052,1,2,0,6055,A
5-NP,566,2,6077,1,0,6080,T
5-NP,567,0,2,6111,0,6113,G
5-NP,568,1,0,6233,0,6234,G
5-NP,569,1,6277,2,5,6285,T
5-NP,570,1,0,6304,0,6305,G
5-NP,571,6295,0,2,0,6297,A
5-NP,572,1,6277,1,3,6282,T
5-NP,573,1,2,6275,2,6280,G
5-NP,574,1,6,6327,0,6334,G
5-NP,575,6322,1,3,1,6327,A
5-NP,576,6330,1,3,0,6334,A
5-NP,577,1,2,0,6311,6314,C
5-NP,578,1,6181,2,0,6184,T
5-NP,579,0,2,6477,1,6480,G
5-NP,580,6466,1,1,0,6468,A
5-NP,581,1,6469,0,1,6471,T
5-NP,582,1,1,0,6484,6486,C
5-NP,583,6416,3,1,0,6420,A
5-NP,584,2,0,6558,0,6560,G
5-NP,585,6529,0,1,0,6530,A
5-NP,586,6535,2,2,0,6539,A
5-NP,587,0,6548,0,1,6549,T
5-NP,588,4,3,6433,0,6440,G
5-NP,589,4,2,6496,4,6506,G
5-NP,590,2,6494,0,12,6508,T
5-NP,591,3,0,0,6518,6521,C
5-NP,592,6520,0,1,0,6521,A
5-NP,593,6508,1,0,1,6510,A
5-NP,594,6521,1,2,1,6525,A
5-NP,595,0,4,0,6522,6526,C
5-NP,596,1,4,6518,1,6524,G
5-NP,597,3,5,6544,1,6553,G
5-NP,598,2,4,6511,0,6517,G
5-NP,599,4,1,6522,1,6528,G
5-NP,600,6493,2,3,0,6498,A
5-NP,601,6548,0,5,0,6553,A
5-NP,602,0,6538,0,0,6538,T
5-NP,603,2,0,0,6544,6546,C
5-NP,604,6537,2,2,0,6541,A
5-NP,605,6542,4,3,0,6549,A
5-NP,606,0,1,0,6514,6515,C
5-NP,607,3,1,6484,1,6489,G
5-NP,608,6483,0,1,0,6484,A
5-NP,609,1,6468,0,2,6471,T
5-NP,610,3,0,1,6470,6474,C
5-NP,611,4,0,6474,1,6479,G
5-NP,612,6462,2,0,0,6464,A
5-NP,613,6458,0,4,2,6464,A
5-NP,614,6469,0,2,1,6472,A
5-NP,615,0,6544,0,2,6546,T
5-NP,616,1,6513,0,0,6514,T
5-NP,617,3,6513,0,1,6517,T
5-NP,618,1,6546,1,2,6550,T
5-NP,619,1,6571,1,0,6573,T
5-NP,620,2,5,6579,2,6588,G
5-NP,621,1,1,6584,2,6588,G
5-NP,622,6536,0,6,0,6542,A
5-NP,623,1,1,6593,0,6595,G
5-NP,624,6515,1,4,0,6520,A
5-NP,625,3,5,6790,1,6799,G
5-NP,626,1,0,6833,0,6834,G
5-NP,627,4,6807,0,8,6819,T
5-NP,628,0,4,6837,0,6841,G
5-NP,629,6829,0,10,1,6840,A
5-NP,630,1,2,6867,0,6870,G
5-NP,631,6865,0,2,0,6867,A
5-NP,632,6851,2,0,0,6853,A
5-NP,633,0,6830,1,3,6834,T
5-NP,634,3,11,6665,0,6679,G
5-NP,635,2,3,6622,0,6627,G
5-NP,636,2,0,6635,0,6637,G
5-NP,637,1,1,0,6606,6608,C
5-NP,638,5,4,6609,0,6618,G
5-NP,639,2,2,6633,2,6639,G
5-NP,640,6630,0,3,0,6633,A
5-NP,641,6645,2,3,0,6650,A
5-NP,642,6729,2,4,0,6735,A
5-NP,643,6767,1,3,1,6772,A
5-NP,644,0,2,1,6790,6793,C
5-NP,645,6787,1,0,0,6788,A
5-NP,646,6786,0,5,0,6791,A
5-NP,647,1,0,6787,0,6788,G
5-NP,648,6629,3,1,1,6634,A
5-NP,649,6658,2,2,0,6662,A
5-NP,650,1,0,6809,0,6810,G
5-NP,651,2,6794,0,1,6797,T
5-NP,652,2,2,7051,1,7056,G
5-NP,653,0,0,0,7022,7022,C
5-NP,654,2,7038,2,1,7043,T
5-NP,655,0,7079,0,1,7080,T
5-NP,656,7151,0,2,1,7154,A
5-NP,657,3,7160,0,0,7163,T
5-NP,658,1,3,7192,1,7197,G
5-NP,659,7082,1,10,0,7093,A
5-NP,660,0,4,7112,0,7116,G
5-NP,661,6870,1,5,0,6876,A
5-NP,662,1,2,6914,0,6917,G
5-NP,663,6890,0,0,1,6891,A
5-NP,664,6950,0,0,0,6950,A
5-NP,665,0,6900,0,2,6902,T
5-NP,666,1,0,6973,1,6975,G
5-NP,667,2,6947,0,4,6953,T
5-NP,668,1,0,6968,0,6969,G
5-NP,669,2,1,1,6947,6951,C
5-NP,670,6942,2,2,0,6946,A
5-NP,671,6942,1,5,0,6948,A
5-NP,672,1,2,1,6937,6941,C
5-NP,673,6900,1,0,0,6901,A
5-NP,674,0,6901,0,4,6905,T
5-NP,675,0,6830,0,3,6833,T
5-NP,676,1,1,0,6866,6868,C
5-NP,677,1,6838,0,4,6843,T
5-NP,678,0,6842,0,1,6843,T
5-NP,679,6844,1,3,0,6848,A
5-NP,680,6814,1,2,0,6817,A
5-NP,681,6831,0,2,0,6833,A
5-NP,682,1,3,6827,0,6831,G
5-NP,683,2,4,6801,0,6807,G
5-NP,684,6787,2,1,0,6790,A
5-NP,685,6785,1,1,0,6787,A
5-NP,686,6777,3,0,0,6780,A
5-NP,687,6863,0,1,0,6864,A
5-NP,688,0,6848,0,2,6850,T
5-NP,689,1,6838,0,3,6842,T
5-NP,690,3,6859,0,1,6863,T
5-NP,691,1,2,0,6883,6886,C
5-NP,692,6891,0,3,0,6894,A
5-NP,693,6878,1,3,2,6884,A
5-NP,694,6873,3,2,0,6878,A
5-NP,695,0,2,0,6962,6964,C
5-NP,696,6898,0,2,1,6901,A
5-NP,697,1,0,7015,0,7016,G
5-NP,698,1,0,0,7011,7012,C
5-NP,699,3,6997,0,5,7005,T
5-NP,700,6,0,7109,0,7115,G
5-NP,701,0,1,0,7085,7086,C
5-NP,702,7134,1,10,0,7145,A
5-NP,703,2,1,1,7136,7140,C
5-NP,704,7098,0,1,0,7099,A
5-NP,705,7110,1,3,1,7115,A
5-NP,706,6979,0,4,0,6983,A
5-NP,707,1,5,7192,0,7198,G
5-NP,708,7178,2,13,0,7193,A
5-NP,709,2,2,7243,0,7247,G
5-NP,710,3,3,0,7207,7213,C
5-NP,711,7219,0,2,0,7221,A
5-NP,712,7304,2,2,1,7309,A
5-NP,713,0,7317,0,1,7318,T
5-NP,714,3,3,7304,0,7310,G
5-NP,715,1,1,7320,0,7322,G
5-NP,716,1,7159,0,2,7162,T
5-NP,717,5,1,7161,1,7168,G
5-NP,718,1,0,7181,0,7182,G
5-NP,719,7183,2,4,0,7189,A
5-NP,720,1,7170,0,1,7172,T
5-NP,721,2,1,0,7085,7088,C
5-NP,722,7150,1,2,0,7153,A
5-NP,723,7338,2,1,1,7342,A
5-NP,724,1,2,7347,1,7351,G
5-NP,725,1,7307,0,2,7310,T
5-NP,726,0,7261,1,0,7262,T
5-NP,727,7306,1,3,0,7310,A
5-NP,728,0,1,7323,1,7325,G
5-NP,729,7307,2,6,0,7315,A
5-NP,730,1,3,7316,0,7320,G
5-NP,731,7240,0,2,1,7243,A
5-NP,732,7009,1,3,0,7013,A
5-NP,733,7015,0,0,0,7015,A
5-NP,734,4,2,7052,0,7058,G
5-NP,735,0,7029,1,0,7030,T
5-NP,736,8,3,1,7034,7046,C
5-NP,737,3,1,7019,0,7023,G
5-NP,738,4,2,7030,0,7036,G
5-NP,739,7037,1,4,0,7042,A
5-NP,740,7083,1,0,0,7084,A
5-NP,741,2,1,0,7091,7094,C
5-NP,742,5,3,0,7043,7051,C
5-NP,743,6,2,0,7081,7089,C
5-NP,744,7087,0,8,1,7096,A
5-NP,745,0,3,7100,0,7103,G
5-NP,746,0,2,7107,0,7109,G
5-NP,747,7078,0,3,0,7081,A
5-NP,748,7078,1,3,1,7083,A
5-NP,749,7058,1,4,2,7065,A
5-NP,750,0,1,0,7093,7094,C
5-NP,751,0,0,7076,0,7076,G
5-NP,752,1,1,0,7073,7075,C
5-NP,753,0,7064,1,10,7075,T
5-NP,754,1,5,7061,2,7069,G
5-NP,755,7039,1,2,0,7042,A
5-NP,756,1,0,7132,0,7133,G
5-NP,757,7135,1,7,0,7143,A
5-NP,758,1,7129,0,1,7131,T
5-NP,759,1,0,0,7068,7069,C
5-NP,760,0,1,7079,1,7081,G
5-NP,761,7079,1,2,0,7082,A
5-NP,762,7068,1,3,0,7072,A
5-NP,763,1,1,7087,0,7089,G
5-NP,764,7084,0,0,1,7085,A
5-NP,765,2,7016,0,3,7021,T
5-NP,766,0,1,0,7087,7088,C
5-NP,767,1,7070,0,4,7075,T
5-NP,768,2,3,0,7095,7100,C
5-NP,769,7115,2,0,0,7117,A
5-NP,770,0,7121,1,0,7122,T
5-NP,771,7136,0,2,2,7140,A
5-NP,772,2,7108,0,3,7113,T
5-NP,773,2,7056,0,12,7070,T
5-NP,774,4,7047,1,1,7053,T
5-NP,775,1,6992,2,2,6997,T
5-NP,776,0,7012,0,2,7014,T
5-NP,777,7027,0,4,0,7031,A
5-NP,778,0,3,7021,0,7024,G
5-NP,779,0,1,0,7022,7023,C
5-NP,780,7000,2,2,0,7004,A
5-NP,781,6975,1,1,0,6977,A
5-NP,782,1,2,7166,0,7169,G
5-NP,783,7170,0,4,1,7175,A
5-NP,784,0,7168,1,1,7170,T
5-NP,785,1,2,1,7197,7201,C
5-NP,786,2,7167,0,7,7176,T
5-NP,787,6,0,7359,0,7365,G
5-NP,788,2,4,0,7365,7371,C
5-NP,789,7377,0,6,1,7384,A
5-NP,790,1,7435,1,2,7439,T
5-NP,791,1,7195,0,3,7199,T
5-NP,792,1,0,7567,2,7570,G
5-NP,793,7673,3,3,0,7679,A
5-NP,794,1,7662,0,1,7664,T
5-NP,795,7688,0,2,0,7690,A
5-NP,796,2,7572,1,1,7576,T
5-NP,797,2,7523,0,3,7528,T
5-NP,798,2,3,7561,1,7567,G
5-NP,799,7485,0,8,0,7493,A
5-NP,800,0,2,7547,0,7549,G
5-NP,801,7199,3,4,4,7210,A
5-NP,802,0,4,7057,1,7062,G
5-NP,803,1,4,7141,0,7146,G
5-NP,804,7128,1,1,0,7130,A
5-NP,805,2,7120,0,3,7125,T
5-NP,806,3,2,1,7143,7149,C
5-NP,807,7100,0,5,2,7107,A
5-NP,808,1,0,7128,1,7130,G
5-NP,809,3,7097,1,1,7102,T
5-NP,810,2,7054,0,0,7056,T
5-NP,811,2,1,7054,1,7058,G
5-NP,812,2,1,0,6985,6988,C
5-NP,813,0,6986,1,5,6992,T
5-NP,814,4,1,0,7014,7019,C
5-NP,815,7033,4,0,1,7038,A
5-NP,816,1,0,0,7042,7043,C
5-NP,817,7030,1,1,1,7033,A
5-NP,818,7065,1,0,1,7067,A
5-NP,819,7077,1,1,1,7080,A
5-NP,820,0,7063,1,1,7065,T
5-NP,821,1,0,0,7075,7076,C
5-NP,822,0,7046,0,5,7051,T
5-NP,823,2,7031,0,1,7034,T
5-NP,824,1,1,7035,2,7039,G
5-NP,825,3,8,1,7028,7040,C
5-NP,826,0,2,2,7117,7121,C
5-NP,827,0,7106,1,2,7109,T
5-NP,828,7137,0,2,1,7140,A
5-NP,829,2,1,0,7126,7129,C
5-NP,830,1,0,0,7130,7131,C
5-NP,831,0,7117,3,3,7123,T
5-NP,832,3,4,7191,0,7198,G
5-NP,833,3,0,0,7172,7175,C
5-NP,834,0,0,1,7180,7181,C
5-NP,835,1,7074,1,4,7080,T
5-NP,836,2,1,7146,0,7149,G
5-NP,837,1,7111,1,1,7114,T
5-NP,838,2,2,7161,0,7165,G
5-NP,839,1,9,0,7196,7206,C
5-NP,840,2,1,7282,0,7285,G
5-NP,841,0,7177,0,2,7179,T
5-NP,842,7161,2,1,0,7164,A
5-NP,843,1,7164,0,4,7169,T
5-NP,844,2,6,7156,0,7164,G
5-NP,845,0,5,7436,0,7441,G
5-NP,846,7421,1,2,0,7424,A
5-NP,847,1,0,0,7294,7295,C
5-NP,848,0,1,0,7279,7280,C
5-NP,849,2,7163,1,8,7174,T
5-NP,850,1,2,7485,0,7488,G
5-NP,851,0,2,0,7486,7488,C
5-NP,852,7496,0,9,0,7505,A
5-NP,853,3,0,7633,0,7636,G
5-NP,854,1,7243,0,2,7246,T
5-NP,855,7514,1,6,1,7522,A
5-NP,856,0,7491,0,2,7493,T
5-NP,857,4,2,0,7470,7476,C
5-NP,858,0,2,2,7471,7475,C
5-NP,859,7146,1,1,0,7148,A
5-NP,860,2,0,7173,0,7175,G
5-NP,861,2,7138,1,0,7141,T
5-NP,862,2,8,7181,1,7192,G
5-NP,863,0,3,7167,0,7170,G
5-NP,864,4,2,7067,0,7073,G
5-NP,865,1,7062,0,4,7067,T
5-NP,866,7057,1,1,0,7059,A
5-NP,867,0,0,0,7039,7039,C
5-NP,868,1,3,7013,0,7017,G
5-NP,869,6985,1,0,0,6986,A
5-NP,870,0,2,0,6979,6981,C
5-NP,871,1,6788,1,1,6791,T
5-NP,872,0,6805,0,1,6806,T
5-NP,873,1,2,0,6793,6796,C
5-NP,874,2,4,6795,0,6801,G
5-NP,875,6800,0,0,0,6800,A
5-NP,876,6795,1,1,0,6797,A
5-NP,877,6800,0,5,0,6805,A
5-NP,878,6802,0,0,1,6803,A
5-NP,879,6775,1,3,1,6780,A
5-NP,880,0,0,6814,0,6814,G
5-NP,881,6780,2,18,1,6801,A
5-NP,882,0,9,6834,0,6843,G
5-NP,883,0,4,6868,0,6872,G
5-NP,884,5,0,6879,0,6884,G
5-NP,885,6884,2,3,0,6889,A
5-NP,886,0,6890,2,0,6892,T
5-NP,887,6932,1,2,0,6935,A
5-NP,888,1,6922,0,0,6923,T
5-NP,889,0,6944,3,3,6950,T
5-NP,890,1,0,0,6983,6984,C
5-NP,891,2,0,0,6964,6966,C
5-NP,892,0,6879,0,2,6881,T
5-NP,893,1,6879,1,0,6881,T
5-NP,894,1,2,6941,0,6944,G
5-NP,895,2,0,6973,1,6976,G
5-NP,896,3,6936,0,2,6941,T
5-NP,897,4,5,6912,0,6921,G
5-NP,898,2,2,6864,0,6868,G
5-NP,899,5,3,7121,0,7129,G
5-NP,900,7131,0,3,1,7135,A
5-NP,901,7139,0,2,1,7142,A
5-NP,902,3,7134,0,3,7140,T
5-NP,903,7016,2,2,1,7021,A
5-NP,904,0,1,7019,0,7020,G
5-NP,905,6964,1,8,0,6973,A
5-NP,906,1,1,0,6953,6955,C
5-NP,907,5,3,0,6875,6883,C
5-NP,908,9,1,0,6634,6644,C
5-NP,909,0,6686,1,24,6711,T
5-NP,910,1,6700,0,3,6704,T
5-NP,911,2,6719,0,3,6724,T
5-NP,912,1,2,0,6723,6726,C
5-NP,913,6706,0,2,0,6708,A
5-NP,914,6705,1,0,0,6706,A
5-NP,915,6701,0,2,0,6703,A
5-NP,916,0,0,0,6704,6704,C
5-NP,917,0,6537,1,2,6540,T
5-NP,918,6479,0,0,0,6479,A
5-NP,919,1,0,0,6549,6550,C
5-NP,920,4,6524,0,2,6530,T
5-NP,921,2,6523,0,1,6526,T
5-NP,922,2,0,0,6550,6552,C
5-NP,923,6519,0,1,0,6520,A
5-NP,924,6523,1,3,0,6527,A
5-NP,925,6496,1,2,3,6502,A
5-NP,926,6504,1,2,1,6508,A
5-NP,927,0,6456,2,1,6459,T
5-NP,928,6366,1,3,1,6371,A
5-NP,929,0,0,6431,1,6432,G
5-NP,930,1,1,0,6451,6453,C
5-NP,931,3,3,0,6490,6496,C
5-NP,932,6509,1,1,0,6511,A
5-NP,933,6519,0,0,0,6519,A
5-NP,934,6698,0,3,0,6701,A
5-NP,935,0,6708,1,1,6710,T
5-NP,936,6732,4,3,0,6739,A
5-NP,937,0,6735,0,0,6735,T
5-NP,938,6633,1,1,0,6635,A
5-NP,939,0,3,0,6645,6648,C
5-NP,940,6515,0,3,0,6518,A
5-NP,941,0,0,6654,0,6654,G
5-NP,942,1,1,0,6630,6632,C
5-NP,943,0,6445,2,4,6451,T
5-NP,944,0,6503,1,2,6506,T
5-NP,945,6529,0,0,1,6530,A
5-NP,946,6529,2,2,0,6533,A
5-NP,947,0,6532,1,1,6534,T
5-NP,948,3,1,0,6524,6528,C
5-NP,949,6299,1,3,0,6303,A
5-NP,950,0,3,6337,0,6340,G
5-NP,951,6323,1,3,1,6328,A
5-NP,952,1,0,0,6350,6351,C
5-NP,953,4,1,0,6295,6300,C
5-NP,954,0,6217,1,4,6222,T
5-NP,955,6262,0,3,0,6265,A
5-NP,956,6263,4,3,0,6270,A
5-NP,957,1,1,1,6287,6290,C
5-NP,958,1,3,6282,0,6286,G
5-NP,959,6181,1,2,0,6184,A
5-NP,960,0,1,6187,0,6188,G
5-NP,961,6122,1,1,0,6124,A
5-NP,962,6177,1,1,0,6179,A
5-NP,963,1,6160,0,2,6163,T
5-NP,964,1,1,0,6117,6119,C
5-NP,965,2,0,0,6132,6134,C
5-NP,966,6078,0,5,1,6084,A
5-NP,967,2,0,6130,0,6132,G
5-NP,968,2,2,1,6122,6127,C
5-NP,969,6168,0,6,0,6174,A
5-NP,970,1,1,0,6181,6183,C
5-NP,971,6097,0,6,1,6104,A
5-NP,972,0,0,0,6109,6109,C
5-NP,973,6110,1,3,1,6115,A
5-NP,974,6124,1,6,1,6132,A
5-NP,975,1,2,6160,0,6163,G
5-NP,976,6082,2,2,0,6086,A
5-NP,977,1,0,6118,0,6119,G
5-NP,978,0,6014,1,2,6017,T
5-NP,979,1,0,0,6003,6004,C
5-NP,980,5993,0,6,0,5999,A
5-NP,981,1,1,5986,0,5988,G
5-NP,982,0,1,0,5971,5972,C
5-NP,983,0,5910,0,1,5911,T
5-NP,984,1,4,5986,1,5992,G
5-NP,985,2,0,6013,0,6015,G
5-NP,986,1,5974,2,2,5979,T
5-NP,987,0,0,6015,0,6015,G
5-NP,988,0,5953,0,1,5954,T
5-NP,989,3,3,5947,1,5954,G
5-NP,990,1,1,5934,1,5937,G
5-NP,991,5915,0,5,1,5921,A
5-NP,992,1,5922,0,2,5925,T
5-NP,993,2,2,5718,1,5723,G
5-NP,994,0,1,5721,0,5722,G
5-NP,995,1,2,0,5697,5700,C
5-NP,996,5667,2,0,1,5670,A
5-NP,997,1,5656,0,4,5661,T
5-NP,998,3,0,5622,0,5625,G
5-NP,999,2,2,0,5654,5658,C
5-NP,1000,4,0,0,5669,5673,C
5-NP,1001,5676,0,1,1,5678,A
5-NP,1002,0,5659,0,1,5660,T
5-NP,1003,2,5602,0,2,5606,T
5-NP,1004,1,1,1,5603,5606,C
5-NP,1005,1,5550,0,2,5553,T
5-NP,1006,0,1,5549,0,5550,G
5-NP,1007,2,1,0,5540,5543,C
5-NP,1008,0,5437,1,7,5445,T
5-NP,1009,0,1,5465,0,5466,G
5-NP,1010,1,0,0,5412,5413,C
5-NP,1011,5414,0,3,0,5417,A
5-NP,1012,0,5411,0,0,5411,T
5-NP,1013,1,5350,1,1,5353,T
5-NP,1014,1,5357,0,3,5361,T
5-NP,1015,0,0,5356,1,5357,G
5-NP,1016,5356,0,1,0,5357,A
5-NP,1017,5352,2,2,1,5357,A
5-NP,1018,1,2,5376,0,5379,G
5-NP,1019,5356,0,0,0,5356,A
5-NP,1020,0,5331,1,0,5332,T
5-NP,1021,1,5324,0,1,5326,T
5-NP,1022,1,5326,0,2,5329,T
5-NP,1023,5325,1,1,0,5327,A
5-NP,1024,5331,0,2,0,5333,A
5-NP,1025,0,0,5335,0,5335,G
5-NP,1026,5315,0,1,0,5316,A
5-NP,1027,1,5276,0,0,5277,T
5-NP,1028,0,5157,0,3,5160,T
5-NP,1029,1,0,5181,0,5182,G
5-NP,1030,2,5171,0,4,5177,T
5-NP,1031,0,5177,0,1,5178,T
5-NP,1032,5172,0,0,1,5173,A
5-NP,1033,5189,0,1,0,5190,A
5-NP,1034,1,0,5195,0,5196,G
5-NP,1035,1,0,0,5192,5193,C
5-NP,1036,2,5105,0,7,5114,T
5-NP,1037,0,5099,1,3,5103,T
5-NP,1038,1,1,0,5102,5104,C
5-NP,1039,5101,0,5,0,5106,A
5-NP,1040,0,5088,1,2,5091,T
5-NP,1041,0,1,0,5101,5102,C
5-NP,1042,5020,2,2,0,5024,A
5-NP,1043,1,0,5021,1,5023,G
5-NP,1044,4960,1,2,0,4963,A
5-NP,1045,2,7,4956,0,4965,G
5-NP,1046,2,1,4924,0,4927,G
5-NP,1047,3,4,4878,1,4886,G
5-NP,1048,4884,1,6,0,4891,A
5-NP,1049,2,2,0,4875,4879,C
5-NP,1050,4889,1,0,0,4890,A
5-NP,1051,4887,0,1,0,4888,A
5-NP,1052,4884,2,1,0,4887,A
5-NP,1053,4894,1,1,1,4897,A
5-NP,1054,0,0,4913,0,4913,G
5-NP,1055,0,4787,0,0,4787,T
5-NP,1056,4752,0,0,0,4752,A
5-NP,1057,1,4703,1,18,4723,T
5-NP,1058,1,0,2,4712,4715,C
5-NP,1059,1,4678,1,5,4685,T
5-NP,1060,0,0,1,4702,4703,C
5-NP,1061,3,0,0,4665,4668,C
5-NP,1062,1,4639,0,0,4640,T
5-NP,1063,3,0,0,4626,4629,C
5-NP,1064,2,4,4619,0,4625,G
5-NP,1065,0,3,4631,0,4634,G
5-NP,1066,1,4,4626,0,4631,G
5-NP,1067,0,1,4613,0,4614,G
5-NP,1068,2,1,4603,2,4608,G
5-NP,1069,4534,1,1,1,4537,A
5-NP,1070,4533,2,0,1,4536,A
5-NP,1071,4537,2,4,0,4543,A
5-NP,1072,0,1,0,4549,4550,C
5-NP,1073,0,4522,0,0,4522,T
5-NP,1074,1,0,4536,0,4537,G
5-NP,1075,0,4491,0,5,4496,T
5-NP,1076,5,0,0,4484,4489,C
5-NP,1077,4538,1,0,0,4539,A
5-NP,1078,4556,0,0,0,4556,A
5-NP,1079,0,0,0,4561,4561,C
5-NP,1080,0,4551,0,1,4552,T
5-NP,1081,4450,2,0,0,4452,A
5-NP,1082,0,2,4460,0,4462,G
5-NP,1083,4373,0,4,0,4377,A
5-NP,1084,0,4,4375,0,4379,G
5-NP,1085,0,1,4363,1,4365,G
5-NP,1086,4138,0,4,1,4143,A
5-NP,1087,0,1,4170,0,4171,G
5-NP,1088,1,4115,0,4,4120,T
5-NP,1089,4120,0,1,0,4121,A
5-NP,1090,0,1,0,4114,4115,C
5-NP,1091,4076,0,3,0,4079,A
5-NP,1092,4075,2,0,0,4077,A
5-NP,1093,4036,0,1,0,4037,A
5-NP,1094,0,4005,0,1,4006,T
5-NP,1095,0,3971,0,1,3972,T
5-NP,1096,2,0,3823,0,3825,G
5-NP,1097,0,0,1,3755,3756,C
5-NP,1098,0,3745,1,2,3748,T
5-NP,1099,3,3733,0,1,3737,T
5-NP,1100,0,0,0,3746,3746,C
5-NP,1101,3743,1,1,0,3745,A
5-NP,1102,3746,2,0,0,3748,A
5-NP,1103,3747,1,1,2,3751,A
5-NP,1104,0,3749,0,1,3750,T
5-NP,1105,1,2,3742,0,3745,G
5-NP,1106,3666,1,7,1,3675,A
5-NP,1107,2,1,3675,0,3678,G
5-NP,1108,3682,0,3,1,3686,A
5-NP,1109,3678,1,1,1,3681,A
5-NP,1110,0,1,0,3676,3677,C
5-NP,1111,3642,0,1,1,3644,A
5-NP,1112,0,3638,0,1,3639,T
5-NP,1113,0,0,3641,2,3643,G
5-NP,1114,0,3,3638,0,3641,G
5-NP,1115,3634,1,2,1,3638,A
5-NP,1116,1,3544,1,1,3547,T
5-NP,1117,3503,0,2,0,3505,A
5-NP,1118,3571,1,0,1,3573,A
5-NP,1119,0,3474,0,0,3474,T
5-NP,1120,3455,0,0,0,3455,A
5-NP,1121,1,3434,1,0,3436,T
5-NP,1122,1,5,3150,1,3157,G
5-NP,1123,1,0,3060,0,3061,G
5-NP,1124,2,1,3042,0,3045,G
5-NP,1125,3025,0,0,0,3025,A
5-NP,1126,1,3022,0,0,3023,T
5-NP,1127,1,0,0,2152,2153,C
5-NP,1128,1,2,2146,0,2149,G
5-NP,1129,2141,0,3,0,2144,A
5-NP,1130,0,0,2146,0,2146,G
5-NP,1131,0,0,0,2139,2139,C
5-NP,1132,2084,0,0,0,2084,A
5-NP,1133,0,0,0,2111,2111,C
5-NP,1134,0,2059,0,1,2060,T
5-NP,1135,2,0,0,2069,2071,C
5-NP,1136,0,2066,0,1,2067,T
5-NP,1137,0,2036,0,1,2037,T
5-NP,1138,1,0,2036,0,2037,G
5-NP,1139,2024,0,1,0,2025,A
5-NP,1140,2024,0,0,0,2024,A
5-NP,1141,0,1346,0,0,1346,T
5-NP,1142,0,1356,0,0,1356,T
5-NP,1143,0,0,1357,0,1357,G
5-NP,1144,1351,0,1,0,1352,A
5-NP,1145,0,0,1355,0,1355,G
5-NP,1146,1352,0,1,0,1353,A
5-NP,1147,1304,0,0,0,1304,A
5-NP,1148,0,0,1307,0,1307,G
5-NP,1149,2,0,0,1242,1244,C
5-NP,1150,0,2,1244,0,1246,G
5-NP,1151,0,0,1248,0,1248,G
5-NP,1152,1,0,1230,1,1232,G
5-NP,1153,0,1216,0,0,1216,T
5-NP,1154,1184,0,0,0,1184,A
5-NP,1155,0,0,0,1180,1180,C
5-NP,1156,0,725,0,0,725,T
5-NP,1157,0,1,688,0,689,G
5-NP,1158,0,0,646,0,646,G
5-NP,1159,0,0,617,1,618,G
5-NP,1160,0,0,0,586,586,C
5-NP,1161,0,1,0,497,498,C
5-NP,1162,502,0,0,0,502,A
5-NP,1163,0,502,0,0,502,T
5-NP,1164,500,0,0,0,500,A
5-NP,1165,499,0,0,0,499,A
5-NP,1166,0,0,495,0,495,G
5-NP,1167,0,0,507,0,507,G
5-NP,1168,499,0,0,0,499,A
5-NP,1169,0,0,0,498,498,C
5-NP,1170,0,0,0,495,495,C
5-NP,1171,493,1,0,0,494,A
5-NP,1172,0,1,502,0,503,G
5-NP,1173,0,0,502,0,502,G
5-NP,1174,500,0,0,0,500,A
5-NP,1175,0,0,505,0,505,G
5-NP,1176,0,485,0,0,485,T
5-NP,1177,0,1,482,0,483,G
5-NP,1178,0,0,490,0,490,G
5-NP,1179,488,0,1,0,489,A
5-NP,1180,0,0,494,0,494,G
5-NP,1181,0,1,490,0,491,G
5-NP,1182,491,0,1,0,492,A
5-NP,1183,490,0,0,0,490,A
5-NP,1184,489,0,0,0,489,A
5-NP,1185,0,0,0,489,489,C
5-NP,1186,486,0,0,0,486,A
5-NP,1187,0,0,0,494,494,C
5-NP,1188,0,495,0,1,496,T
5-NP,1189,507,0,0,0,507,A
5-NP,1190,506,0,0,0,506,A
5-NP,1191,1,501,0,1,503,T
5-NP,1192,0,0,0,510,510,C
5-NP,1193,506,0,0,0,506,A
5-NP,1194,509,0,0,0,509,A
5-NP,1195,0,0,0,511,511,C
5-NP,1196,500,0,1,0,501,A
5-NP,1197,1,0,502,0,503,G
5-NP,1198,487,0,2,0,489,A
5-NP,1199,0,0,492,0,492,G
5-NP,1200,0,0,493,0,493,G
5-NP,1201,0,0,490,0,490,G
5-NP,1202,0,0,0,488,488,C
5-NP,1203,0,0,0,490,490,C
5-NP,1204,0,484,0,0,484,T
5-NP,1205,1,0,0,489,490,C
5-NP,1206,0,0,0,492,492,C
5-NP,1207,0,0,493,0,493,G
5-NP,1208,0,0,0,493,493,C
5-NP,1209,485,0,1,0,486,A
5-NP,1210,0,1,501,0,502,G
5-NP,1211,0,0,497,0,497,G
5-NP,1212,0,0,0,499,499,C
5-NP,1213,0,0,0,498,498,C
5-NP,1214,497,0,0,0,497,A
5-NP,1215,497,0,0,0,497,A
5-NP,1216,499,0,0,0,499,A
5-NP,1217,0,3,0,500,503,C
5-NP,1218,0,0,0,502,502,C
5-NP,1219,474,0,1,0,475,A
5-NP,1220,0,0,483,0,483,G
5-NP,1221,0,478,0,0,478,T
5-NP,1222,0,0,481,0,481,G
5-NP,1223,0,478,0,0,478,T
5-NP,1224,1,0,476,0,477,G
5-NP,1225,0,0,0,477,477,C
5-NP,1226,470,0,0,1,471,A
5-NP,1227,477,0,0,0,477,A
5-NP,1228,0,0,0,476,476,C
5-NP,1229,0,1,0,474,475,C
5-NP,1230,0,474,0,0,474,T
5-NP,1231,471,0,0,1,472,A
5-NP,1232,0,0,0,473,473,C
5-NP,1233,0,0,471,0,471,G
5-NP,1234,0,469,1,1,471,T
5-NP,1235,0,475,0,1,476,T
5-NP,1236,0,470,0,0,470,T
5-NP,1237,0,470,0,0,470,T
5-NP,1238,0,0,0,469,469,C
5-NP,1239,0,464,0,0,464,T
5-NP,1240,0,1,478,0,479,G
5-NP,1241,0,476,0,1,477,T
5-NP,1242,480,0,0,0,480,A
5-NP,1243,0,0,0,485,485,C
5-NP,1244,478,0,0,0,478,A
5-NP,1245,479,0,0,0,479,A
5-NP,1246,478,0,0,0,478,A
5-NP,1247,0,0,479,0,479,G
5-NP,1248,479,0,0,0,479,A
5-NP,1249,470,0,1,0,471,A
5-NP,1250,472,0,0,0,472,A
5-NP,1251,0,0,0,473,473,C
5-NP,1252,0,0,0,467,467,C
5-NP,1253,0,466,0,0,466,T
5-NP,1254,0,0,0,466,466,C
5-NP,1255,0,0,0,465,465,C
5-NP,1256,0,0,0,464,464,C
5-NP,1257,463,0,0,0,463,A
5-NP,1258,0,460,0,0,460,T
5-NP,1259,0,462,0,1,463,T
5-NP,1260,0,463,0,0,463,T
5-NP,1261,0,0,464,0,464,G
5-NP,1262,465,0,0,0,465,A
5-NP,1263,463,0,0,0,463,A
5-NP,1264,465,0,0,0,465,A
5-NP,1265,461,0,1,0,462,A
5-NP,1266,0,0,465,0,465,G
5-NP,1267,0,466,0,0,466,T
5-NP,1268,0,0,0,466,466,C
5-NP,1269,467,0,0,0,467,A
5-NP,1270,466,2,0,0,468,A
5-NP,1271,0,0,0,470,470,C
5-NP,1272,0,0,0,471,471,C
5-NP,1273,472,0,0,0,472,A
5-NP,1274,0,476,0,0,476,T
5-NP,1275,0,0,0,474,474,C
5-NP,1276,472,0,0,0,472,A
5-NP,1277,0,476,0,0,476,T
5-NP,1278,0,0,477,0,477,G
5-NP,1279,0,0,475,0,475,G
5-NP,1280,0,0,0,474,474,C
5-NP,1281,465,0,0,0,465,A
5-NP,1282,0,0,465,0,465,G
5-NP,1283,0,0,0,462,462,C
5-NP,1284,462,1,0,0,463,A
5-NP,1285,0,461,0,0,461,T
5-NP,1286,1,458,0,0,459,T
5-NP,1287,0,1,0,457,458,C
5-NP,1288,451,0,0,0,451,A
5-NP,1289,0,0,0,451,451,C
5-NP,1290,0,451,0,0,451,T
5-NP,1291,1,0,453,0,454,G
5-NP,1292,0,1,455,0,456,G
5-NP,1293,452,0,0,1,453,A
5-NP,1294,453,0,0,0,453,A
5-NP,1295,451,1,0,0,452,A
5-NP,1296,0,454,0,0,454,T
5-NP,1297,454,0,0,0,454,A
5-NP,1298,0,1,0,451,452,C
5-NP,1299,0,0,447,0,447,G
5-NP,1300,0,0,446,0,446,G
5-NP,1301,429,0,0,0,429,A
5-NP,1302,1,0,433,0,434,G
5-NP,1303,0,0,432,1,433,G
5-NP,1304,1,1,432,0,434,G
5-NP,1305,431,0,1,0,432,A
5-NP,1306,432,0,0,0,432,A
5-NP,1307,0,0,430,0,430,G
5-NP,1308,431,0,0,0,431,A
5-NP,1309,431,0,0,0,431,A
5-NP,1310,0,0,0,432,432,C
5-NP,1311,0,426,0,1,427,T
5-NP,1312,0,429,0,0,429,T
5-NP,1313,0,0,0,427,427,C
5-NP,1314,426,0,2,0,428,A
5-NP,1315,0,0,432,0,432,G
5-NP,1316,428,0,0,0,428,A
5-NP,1317,0,0,0,427,427,C
5-NP,1318,423,1,0,0,424,A
5-NP,1319,0,419,0,0,419,T
5-NP,1320,0,0,420,0,420,G
5-NP,1321,415,0,2,0,417,A
5-NP,1322,0,0,419,0,419,G
5-NP,1323,0,0,415,0,415,G
5-NP,1324,0,0,414,0,414,G
5-NP,1325,0,0,0,413,413,C
5-NP,1326,411,0,0,0,411,A
5-NP,1327,0,1,412,0,413,G
5-NP,1328,411,1,0,0,412,A
5-NP,1329,412,0,1,0,413,A
5-NP,1330,411,0,0,0,411,A
5-NP,1331,0,407,0,0,407,T
5-NP,1332,0,0,0,406,406,C
5-NP,1333,406,0,0,0,406,A
5-NP,1334,0,404,1,1,406,T
5-NP,1335,406,0,0,0,406,A
5-NP,1336,403,1,0,0,404,A
5-NP,1337,0,0,407,0,407,G
5-NP,1338,403,0,0,0,403,A
5-NP,1339,407,1,0,0,408,A
5-NP,1340,0,401,0,0,401,T
5-NP,1341,0,0,405,0,405,G
5-NP,1342,404,0,1,0,405,A
5-NP,1343,0,403,0,0,403,T
5-NP,1344,0,0,405,0,405,G
5-NP,1345,0,0,403,0,403,G
5-NP,1346,391,0,1,0,392,A
5-NP,1347,391,0,0,0,391,A
5-NP,1348,1,0,377,0,378,G
5-NP,1349,0,0,384,0,384,G
5-NP,1350,0,376,0,0,376,T
5-NP,1351,0,0,377,0,377,G
5-NP,1352,0,0,0,375,375,C
5-NP,1353,376,1,0,0,377,A
5-NP,1354,377,0,0,0,377,A
5-NP,1355,375,0,0,0,375,A
5-NP,1356,382,0,0,0,382,A
5-NP,1357,0,0,0,385,385,C
5-NP,1358,0,0,0,378,378,C
5-NP,1359,372,0,0,0,372,A
5-NP,1360,0,0,375,0,375,G
5-NP,1361,375,0,0,0,375,A
5-NP,1362,373,0,0,0,373,A
5-NP,1363,0,0,375,0,375,G
5-NP,1364,372,0,1,0,373,A
5-NP,1365,368,0,1,0,369,A
5-NP,1366,0,0,371,0,371,G
5-NP,1367,0,368,0,1,369,T
5-NP,1368,0,0,370,0,370,G
5-NP,1369,0,362,0,0,362,T
5-NP,1370,0,0,0,361,361,C
5-NP,1371,363,0,0,0,363,A
5-NP,1372,1,366,0,0,367,T
5-NP,1373,0,369,0,0,369,T
5-NP,1374,0,0,0,370,370,C
5-NP,1375,0,0,0,364,364,C
5-NP,1376,0,0,362,0,362,G
5-NP,1377,1,1,360,0,362,G
5-NP,1378,0,0,363,0,363,G
5-NP,1379,0,0,361,0,361,G
5-NP,1380,0,0,365,0,365,G
5-NP,1381,345,0,0,0,345,A
5-NP,1382,0,0,346,0,346,G
5-NP,1383,0,0,347,0,347,G
5-NP,1384,0,0,344,0,344,G
5-NP,1385,0,0,344,0,344,G
5-NP,1386,344,0,0,0,344,A
5-NP,1387,0,0,344,0,344,G
5-NP,1388,0,340,0,0,340,T
5-NP,1389,0,339,0,2,341,T
5-NP,1390,0,342,0,0,342,T
5-NP,1391,1,339,0,0,340,T
5-NP,1392,0,1,0,341,342,C
5-NP,1393,0,0,342,0,342,G
5-NP,1394,337,0,2,0,339,A
5-NP,1395,0,0,343,0,343,G
5-NP,1396,1,0,0,342,343,C
5-NP,1397,0,341,0,1,342,T
5-NP,1398,0,0,0,345,345,C
5-NP,1399,0,344,0,0,344,T
5-NP,1400,0,1,0,343,344,C
5-NP,1401,344,0,0,0,344,A
5-NP,1402,0,0,345,0,345,G
5-NP,1403,345,0,0,0,345,A
5-NP,1404,0,0,0,344,344,C
5-NP,1405,0,0,341,0,341,G
5-NP,1406,334,0,0,0,334,A
5-NP,1407,0,0,336,0,336,G
5-NP,1408,332,0,0,0,332,A
5-NP,1409,331,0,0,0,331,A
5-NP,1410,0,0,330,0,330,G
5-NP,1411,0,0,328,0,328,G
5-NP,1412,0,0,0,328,328,C
5-NP,1413,326,0,0,0,326,A
5-NP,1414,326,0,0,0,326,A
5-NP,1415,0,0,0,326,326,C
5-NP,1416,0,0,325,0,325,G
5-NP,1417,324,0,0,0,324,A
5-NP,1418,323,0,0,0,323,A
5-NP,1419,0,0,0,320,320,C
5-NP,1420,1,0,0,319,320,C
5-NP,1421,1,0,0,317,318,C
5-NP,1422,0,0,318,0,318,G
5-NP,1423,317,0,0,0,317,A
5-NP,1424,0,317,0,1,318,T
5-NP,1425,0,0,0,313,313,C
5-NP,1426,0,0,311,0,311,G
5-NP,1427,0,311,0,0,311,T
5-NP,1428,0,0,312,0,312,G
5-NP,1429,0,0,0,311,311,C
5-NP,1430,1,0,0,309,310,C
5-NP,1431,0,0,0,311,311,C
5-NP,1432,0,310,0,0,310,T
5-NP,1433,0,0,0,317,317,C
5-NP,1434,0,314,0,0,314,T
5-NP,1435,0,314,0,0,314,T
5-NP,1436,0,315,0,0,315,T
5-NP,1437,0,311,0,0,311,T
5-NP,1438,0,0,312,0,312,G
5-NP,1439,311,0,0,0,311,A
5-NP,1440,0,308,0,0,308,T
5-NP,1441,305,0,0,0,305,A
5-NP,1442,0,257,0,0,257,T
5-NP,1443,0,0,260,0,260,G
5-NP,1444,257,0,0,0,257,A
5-NP,1445,1,0,258,0,259,G
5-NP,1446,0,259,0,0,259,T
5-NP,1447,253,0,0,0,253,A
5-NP,1448,254,0,0,0,254,A
5-NP,1449,0,253,0,0,253,T
5-NP,1450,0,0,253,0,253,G
5-NP,1451,253,0,0,0,253,A
5-NP,1452,221,0,0,0,221,A
5-NP,1453,0,0,219,0,219,G
5-NP,1454,0,0,208,0,208,G
5-NP,1455,206,0,0,0,206,A
5-NP,1456,0,202,0,0,202,T
5-NP,1457,0,0,0,202,202,C
5-NP,1458,0,200,0,0,200,T
5-NP,1459,0,198,0,0,198,T
5-NP,1460,200,0,0,0,200,A
5-NP,1461,0,200,0,0,200,T
5-NP,1462,0,198,0,0,198,T
5-NP,1463,0,196,0,0,196,T
5-NP,1464,0,0,0,194,194,C
5-NP,1465,0,186,0,0,186,T
5-NP,1466,0,186,0,0,186,T
5-NP,1467,0,0,0,187,187,C
5-NP,1468,0,0,183,0,183,G
5-NP,1469,0,0,184,0,184,G
5-NP,1470,183,0,0,0,183,A
5-NP,1471,0,0,183,0,183,G
5-NP,1472,182,0,0,0,182,A
5-NP,1473,0,0,0,180,180,C
5-NP,1474,170,0,0,0,170,A
5-NP,1475,170,0,0,0,170,A
5-NP,1476,0,170,0,0,170,T
5-NP,1477,0,0,169,0,169,G
5-NP,1478,0,0,0,168,168,C
5-NP,1479,161,0,0,0,161,A
5-NP,1480,0,0,160,0,160,G
5-NP,1481,160,0,0,0,160,A
5-NP,1482,150,0,0,0,150,A
5-NP,1483,0,0,150,0,150,G
5-NP,1484,96,0,0,0,96,A
5-NP,1485,0,0,96,0,96,G
5-NP,1486,0,84,0,0,84,T
5-NP,1487,83,0,0,0,83,A
5-NP,1488,0,1,0,82,83,C
5-NP,1489,0,0,77,0,77,G
5-NP,1490,77,0,0,0,77,A
5-NP,1491,0,0,0,76,76,C
5-NP,1492,54,0,0,0,54,A
5-NP,1493,54,0,0,0,54,A
5-NP,1494,0,46,0,0,46,T
5-NP,1495,0,46,0,0,46,T
5-NP,1496,46,0,0,0,46,A
5-NP,1497,44,0,0,0,44,A
6-NA,1,21,0,0,0,21,A
6-NA,2,0,21,0,0,21,T
6-NA,3,0,0,21,0,21,G
6-NA,4,22,0,0,0,22,A
6-NA,5,22,0,0,0,22,A
6-NA,6,0,22,0,0,22,T
6-NA,7,0,0,0,22,22,C
6-NA,8,0,0,0,22,22,C
6-NA,9,22,0,0,0,22,A
6-NA,10,23,0,0,0,23,A
6-NA,11,23,0,0,0,23,A
6-NA,12,0,23,0,0,23,T
6-NA,13,0,0,0,23,23,C
6-NA,14,23,0,0,0,23,A
6-NA,15,23,0,0,0,23,A
6-NA,16,23,0,0,0,23,A
6-NA,17,24,0,0,0,24,A
6-NA,18,0,0,25,0,25,G
6-NA,19,24,0,0,0,24,A
6-NA,20,0,25,0,0,25,T
6-NA,21,27,0,0,0,27,A
6-NA,22,27,0,0,0,27,A
6-NA,23,0,27,0,0,27,T
6-NA,24,27,0,0,0,27,A
6-NA,25,27,0,0,0,27,A
6-NA,26,0,0,0,27,27,C
6-NA,27,0,0,28,0,28,G
6-NA,28,28,0,0,0,28,A
6-NA,29,0,27,0,0,27,T
6-NA,30,0,28,0,0,28,T
6-NA,31,0,0,29,0,29,G
6-NA,32,0,0,31,0,31,G
6-NA,33,0,0,0,31,31,C
6-NA,34,0,31,0,0,31,T
6-NA,35,0,0,0,32,32,C
6-NA,36,0,32,0,0,32,T
6-NA,37,0,0,34,0,34,G
6-NA,38,0,34,0,0,34,T
6-NA,39,0,35,0,0,35,T
6-NA,40,0,36,0,0,36,T
6-NA,41,0,0,0,38,38,C
6-NA,42,0,37,0,0,37,T
6-NA,43,0,0,0,39,39,C
6-NA,44,0,40,0,0,40,T
6-NA,45,0,0,0,41,41,C
6-NA,46,41,0,0,0,41,A
6-NA,47,0,0,0,46,46,C
6-NA,48,0,0,0,47,47,C
6-NA,49,47,0,0,0,47,A
6-NA,50,0,47,0,0,47,T
6-NA,51,0,49,0,0,49,T
6-NA,52,0,50,0,0,50,T
6-NA,53,0,0,0,50,50,C
6-NA,54,0,0,0,50,50,C
6-NA,55,49,0,0,0,49,A
6-NA,56,0,0,0,51,51,C
6-NA,57,50,0,0,0,50,A
6-NA,58,53,0,0,0,53,A
6-NA,59,0,53,0,0,53,T
6-NA,60,54,0,0,0,54,A
6-NA,61,0,55,0,0,55,T
6-NA,62,0,0,55,0,55,G
6-NA,63,0,0,0,55,55,C
6-NA,64,0,55,0,0,55,T
6-NA,65,0,56,0,0,56,T
6-NA,66,0,0,0,56,56,C
6-NA,67,0,55,0,0,55,T
6-NA,68,0,55,0,0,55,T
6-NA,69,0,0,0,56,56,C
6-NA,70,57,0,0,0,57,A
6-NA,71,0,57,0,0,57,T
6-NA,72,0,0,57,0,57,G
6-NA,73,0,0,0,57,57,C
6-NA,74,57,0,0,0,57,A
6-NA,75,57,0,0,0,57,A
6-NA,76,57,0,0,0,57,A
6-NA,77,0,60,0,0,60,T
6-NA,78,0,59,0,0,59,T
6-NA,79,0,0,59,0,59,G
6-NA,80,0,0,0,60,60,C
6-NA,81,0,0,0,59,59,C
6-NA,82,57,0,0,2,59,A
6-NA,83,0,59,0,0,59,T
6-NA,84,0,0,0,66,66,C
6-NA,85,0,66,0,0,66,T
6-NA,86,0,66,0,0,66,T
6-NA,87,0,0,68,0,68,G
6-NA,88,68,0,0,0,68,A
6-NA,89,0,67,0,0,67,T
6-NA,90,68,0,0,0,68,A
6-NA,91,68,0,0,0,68,A
6-NA,92,0,0,0,81,81,C
6-NA,93,0,81,0,0,81,T
6-NA,94,82,0,0,0,82,A
6-NA,95,0,0,0,86,86,C
6-NA,96,0,86,0,0,86,T
6-NA,97,0,0,88,0,88,G
6-NA,98,0,88,0,0,88,T
6-NA,99,87,0,0,0,87,A
6-NA,100,88,0,0,0,88,A
6-NA,101,0,0,0,86,86,C
6-NA,102,85,0,0,0,85,A
6-NA,103,0,86,0,0,86,T
6-NA,104,0,86,0,0,86,T
6-NA,105,0,0,87,0,87,G
6-NA,106,0,0,0,87,87,C
6-NA,107,87,0,0,0,87,A
6-NA,108,0,87,0,0,87,T
6-NA,109,0,87,0,0,87,T
6-NA,110,0,86,0,0,86,T
6-NA,111,0,0,0,87,87,C
6-NA,112,86,0,0,0,86,A
6-NA,113,86,0,0,0,86,A
6-NA,114,0,0,87,0,87,G
6-NA,115,0,0,0,88,88,C
6-NA,116,89,0,0,0,89,A
6-NA,117,97,0,0,0,97,A
6-NA,118,0,97,0,0,97,T
6-NA,119,96,0,0,0,96,A
6-NA,120,0,97,0,0,97,T
6-NA,121,0,0,104,0,104,G
6-NA,122,104,0,0,0,104,A
6-NA,123,105,0,0,0,105,A
6-NA,124,0,104,0,0,104,T
6-NA,125,0,105,0,0,105,T
6-NA,126,0,0,0,105,105,C
6-NA,127,105,0,0,0,105,A
6-NA,128,105,0,0,0,105,A
6-NA,129,0,0,0,106,106,C
6-NA,130,0,106,0,0,106,T
6-NA,131,0,0,0,107,107,C
6-NA,132,0,0,0,105,105,C
6-NA,133,0,0,0,106,106,C
6-NA,134,0,0,0,104,104,C
6-NA,135,0,0,0,107,107,C
6-NA,136,0,0,0,109,109,C
6-NA,137,0,0,0,108,108,C
6-NA,138,110,0,0,0,110,A
6-NA,139,110,0,0,0,110,A
6-NA,140,109,0,0,0,109,A
6-NA,141,0,0,0,115,115,C
6-NA,142,113,0,0,0,113,A
6-NA,143,119,0,0,0,119,A
6-NA,144,0,0,0,119,119,C
6-NA,145,0,0,0,120,120,C
6-NA,146,120,0,0,0,120,A
6-NA,147,117,0,0,0,117,A
6-NA,148,0,0,122,0,122,G
6-NA,149,0,122,0,0,122,T
6-NA,150,0,0,123,0,123,G
6-NA,151,125,0,0,0,125,A
6-NA,152,0,124,0,0,124,T
6-NA,153,0,0,124,0,124,G
6-NA,154,0,0,0,125,125,C
6-NA,155,0,126,0,0,126,T
6-NA,156,0,0,142,0,142,G
6-NA,157,0,142,0,0,142,T
6-NA,158,0,0,142,0,142,G
6-NA,159,0,142,0,0,142,T
6-NA,160,0,0,141,0,141,G
6-NA,161,140,0,0,0,140,A
6-NA,162,142,0,0,0,142,A
6-NA,163,0,0,0,141,141,C
6-NA,164,0,0,0,141,141,C
6-NA,165,140,0,0,0,140,A
6-NA,166,140,0,0,0,140,A
6-NA,167,0,0,0,147,147,C
6-NA,168,145,0,0,0,145,A
6-NA,169,148,0,0,0,148,A
6-NA,170,0,149,0,0,149,T
6-NA,171,149,0,0,0,149,A
6-NA,172,149,0,1,0,150,A
6-NA,173,0,149,0,0,149,T
6-NA,174,150,0,0,0,150,A
6-NA,175,0,0,151,0,151,G
6-NA,176,152,0,0,0,152,A
6-NA,177,152,0,0,0,152,A
6-NA,178,149,0,0,1,150,A
6-NA,179,1,0,149,0,150,G
6-NA,180,152,0,0,0,152,A
6-NA,181,154,0,0,0,154,A
6-NA,182,157,0,0,0,157,A
6-NA,183,0,0,0,159,159,C
6-NA,184,158,0,0,0,158,A
6-NA,185,0,161,0,0,161,T
6-NA,186,164,0,0,0,164,A
6-NA,187,164,0,0,0,164,A
6-NA,188,0,1,0,167,168,C
6-NA,189,165,0,0,0,165,A
6-NA,190,0,0,171,0,171,G
6-NA,191,168,0,1,0,169,A
6-NA,192,0,0,169,0,169,G
6-NA,193,169,0,0,0,169,A
6-NA,194,0,178,0,0,178,T
6-NA,195,178,0,0,0,178,A
6-NA,196,0,0,182,0,182,G
6-NA,197,0,182,0,0,182,T
6-NA,198,1,0,184,0,185,G
6-NA,199,0,182,0,0,182,T
6-NA,200,182,0,0,0,182,A
6-NA,201,0,183,0,0,183,T
6-NA,202,0,0,0,183,183,C
6-NA,203,1,176,0,1,178,T
6-NA,204,0,0,179,0,179,G
6-NA,205,177,0,0,0,177,A
6-NA,206,0,0,0,177,177,C
6-NA,207,0,1,0,177,178,C
6-NA,208,178,0,0,0,178,A
6-NA,209,181,0,0,0,181,A
6-NA,210,0,0,0,183,183,C
6-NA,211,183,0,0,0,183,A
6-NA,212,0,0,0,186,186,C
6-NA,213,0,0,0,183,183,C
6-NA,214,187,0,0,0,187,A
6-NA,215,0,0,0,195,195,C
6-NA,216,0,0,0,195,195,C
6-NA,217,197,0,0,0,197,A
6-NA,218,0,195,0,0,195,T
6-NA,219,196,0,0,0,196,A
6-NA,220,0,0,196,0,196,G
6-NA,221,195,0,0,0,195,A
6-NA,222,0,0,197,0,197,G
6-NA,223,199,0,0,0,199,A
6-NA,224,195,0,0,0,195,A
6-NA,225,0,0,198,0,198,G
6-NA,226,0,0,198,0,198,G
6-NA,227,198,0,1,0,199,A
6-NA,228,198,0,0,0,198,A
6-NA,229,197,0,0,0,197,A
6-NA,230,0,197,0,0,197,T
6-NA,231,196,0,0,0,196,A
6-NA,232,0,197,0,0,197,T
6-NA,233,0,0,196,0,196,G
6-NA,234,0,1,0,193,194,C
6-NA,235,0,0,0,194,194,C
6-NA,236,0,0,0,194,194,C
6-NA,237,1,0,0,194,195,C
6-NA,238,194,0,0,0,194,A
6-NA,239,195,0,0,0,195,A
6-NA,240,195,0,0,0,195,A
6-NA,241,0,193,0,0,193,T
6-NA,242,0,194,0,0,194,T
6-NA,243,197,0,0,0,197,A
6-NA,244,0,0,198,0,198,G
6-NA,245,0,0,0,198,198,C
6-NA,246,198,0,0,0,198,A
6-NA,247,0,0,201,0,201,G
6-NA,248,199,0,0,0,199,A
6-NA,249,209,0,0,0,209,A
6-NA,250,0,210,0,0,210,T
6-NA,251,210,0,1,0,211,A
6-NA,252,0,0,0,211,211,C
6-NA,253,211,0,0,0,211,A
6-NA,254,0,0,209,0,209,G
6-NA,255,211,0,0,0,211,A
6-NA,256,208,0,0,0,208,A
6-NA,257,208,0,0,0,208,A
6-NA,258,0,207,0,0,207,T
6-NA,259,0,206,0,0,206,T
6-NA,260,0,0,207,0,207,G
6-NA,261,0,0,206,0,206,G
6-NA,262,0,206,0,1,207,T
6-NA,263,0,0,0,205,205,C
6-NA,264,206,0,0,0,206,A
6-NA,265,204,0,0,0,204,A
6-NA,266,205,0,0,1,206,A
6-NA,267,205,0,0,0,205,A
6-NA,268,0,0,0,206,206,C
6-NA,269,1,0,0,204,205,C
6-NA,270,0,0,205,0,205,G
6-NA,271,0,0,0,204,204,C
6-NA,272,206,0,0,0,206,A
6-NA,273,206,0,0,0,206,A
6-NA,274,0,206,0,0,206,T
6-NA,275,0,0,206,0,206,G
6-NA,276,0,0,0,203,203,C
6-NA,277,0,0,203,0,203,G
6-NA,278,207,1,1,0,209,A
6-NA,279,0,0,0,211,211,C
6-NA,280,209,0,1,0,210,A
6-NA,281,0,214,0,0,214,T
6-NA,282,0,215,0,0,215,T
6-NA,283,215,0,0,0,215,A
6-NA,284,0,0,0,214,214,C
6-NA,285,214,0,0,0,214,A
6-NA,286,0,0,217,0,217,G
6-NA,287,0,0,214,0,214,G
6-NA,288,216,0,0,0,216,A
6-NA,289,0,212,0,1,213,T
6-NA,290,0,211,0,0,211,T
6-NA,291,0,210,0,0,210,T
6-NA,292,0,0,211,0,211,G
6-NA,293,0,0,0,209,209,C
6-NA,294,211,0,0,0,211,A
6-NA,295,0,0,0,209,209,C
6-NA,296,0,0,0,210,210,C
6-NA,297,0,208,0,1,209,T
6-NA,298,0,209,0,0,209,T
6-NA,299,0,212,0,0,212,T
6-NA,300,0,211,0,1,212,T
6-NA,301,0,215,0,0,215,T
6-NA,302,0,0,0,217,217,C
6-NA,303,0,216,0,0,216,T
6-NA,304,215,0,0,0,215,A
6-NA,305,213,0,0,0,213,A
6-NA,306,1,0,215,0,216,G
6-NA,307,0,0,216,0,216,G
6-NA,308,215,0,0,0,215,A
6-NA,309,0,0,0,216,216,C
6-NA,310,212,0,0,0,212,A
6-NA,311,213,0,0,0,213,A
6-NA,312,0,212,0,0,212,T
6-NA,313,1,211,0,0,212,T
6-NA,314,0,0,0,214,214,C
6-NA,315,0,0,212,0,212,G
6-NA,316,212,0,0,0,212,A
6-NA,317,0,211,0,0,211,T
6-NA,318,0,212,0,0,212,T
6-NA,319,212,0,0,0,212,A
6-NA,320,0,0,211,0,211,G
6-NA,321,0,0,213,0,213,G
6-NA,322,0,0,0,213,213,C
6-NA,323,0,212,0,1,213,T
6-NA,324,0,213,0,0,213,T
6-NA,325,0,213,0,0,213,T
6-NA,326,0,0,0,214,214,C
6-NA,327,1,0,0,214,215,C
6-NA,328,0,0,215,0,215,G
6-NA,329,0,0,0,216,216,C
6-NA,330,0,213,0,0,213,T
6-NA,331,0,0,218,0,218,G
6-NA,332,0,0,218,0,218,G
6-NA,333,0,217,0,0,217,T
6-NA,334,1,0,216,0,217,G
6-NA,335,0,0,215,0,215,G
6-NA,336,0,0,218,0,218,G
6-NA,337,0,0,218,0,218,G
6-NA,338,217,0,0,0,217,A
6-NA,339,0,0,0,221,221,C
6-NA,340,214,0,1,0,215,A
6-NA,341,0,214,0,0,214,T
6-NA,342,0,0,0,214,214,C
6-NA,343,0,213,0,0,213,T
6-NA,344,0,0,214,0,214,G
6-NA,345,0,1,212,0,213,G
6-NA,346,0,0,218,0,218,G
6-NA,347,0,218,0,0,218,T
6-NA,348,0,0,211,0,211,G
6-NA,349,212,0,0,0,212,A
6-NA,350,0,0,0,213,213,C
6-NA,351,215,0,0,0,215,A
6-NA,352,214,0,0,0,214,A
6-NA,353,0,0,216,0,216,G
6-NA,354,212,0,0,0,212,A
6-NA,355,0,0,213,0,213,G
6-NA,356,215,0,0,0,215,A
6-NA,357,225,0,0,0,225,A
6-NA,358,0,0,0,249,249,C
6-NA,359,0,0,0,252,252,C
6-NA,360,0,252,0,0,252,T
6-NA,361,0,252,0,0,252,T
6-NA,362,251,0,0,0,251,A
6-NA,363,0,253,0,0,253,T
6-NA,364,0,0,259,0,259,G
6-NA,365,0,255,0,0,255,T
6-NA,366,0,0,259,0,259,G
6-NA,367,0,253,0,0,253,T
6-NA,368,0,0,0,249,249,C
6-NA,369,249,0,0,0,249,A
6-NA,370,0,248,0,0,248,T
6-NA,371,0,0,249,0,249,G
6-NA,372,0,0,0,247,247,C
6-NA,373,0,1,244,0,245,G
6-NA,374,264,0,1,0,265,A
6-NA,375,0,266,0,0,266,T
6-NA,376,0,0,0,266,266,C
6-NA,377,0,0,0,265,265,C
6-NA,378,0,266,0,0,266,T
6-NA,379,0,1,266,0,267,G
6-NA,380,267,0,0,0,267,A
6-NA,381,0,0,0,269,269,C
6-NA,382,268,0,0,0,268,A
6-NA,383,259,0,1,0,260,A
6-NA,384,0,0,266,0,266,G
6-NA,385,0,263,0,0,263,T
6-NA,386,0,0,266,0,266,G
6-NA,387,0,265,0,0,265,T
6-NA,388,0,267,0,0,267,T
6-NA,389,266,0,0,0,266,A
6-NA,390,1,264,0,1,266,T
6-NA,391,0,0,0,271,271,C
6-NA,392,271,0,0,0,271,A
6-NA,393,267,0,0,0,267,A
6-NA,394,0,264,0,0,264,T
6-NA,395,0,263,0,0,263,T
6-NA,396,0,264,0,0,264,T
6-NA,397,0,0,264,0,264,G
6-NA,398,0,0,0,275,275,C
6-NA,399,0,0,0,274,274,C
6-NA,400,0,1,0,274,275,C
6-NA,401,0,272,0,0,272,T
6-NA,402,0,273,0,0,273,T
6-NA,403,0,0,277,0,277,G
6-NA,404,0,0,276,0,276,G
6-NA,405,279,0,0,0,279,A
6-NA,406,0,0,0,280,280,C
6-NA,407,270,0,0,0,270,A
6-NA,408,0,0,272,0,272,G
6-NA,409,0,0,271,0,271,G
6-NA,410,0,0,282,0,282,G
6-NA,411,283,0,0,0,283,A
6-NA,412,280,0,1,0,281,A
6-NA,413,0,0,0,280,280,C
6-NA,414,280,0,0,0,280,A
6-NA,415,304,0,0,0,304,A
6-NA,416,0,0,0,307,307,C
6-NA,417,306,0,0,0,306,A
6-NA,418,0,0,0,309,309,C
6-NA,419,0,304,0,0,304,T
6-NA,420,308,0,0,0,308,A
6-NA,421,308,0,0,0,308,A
6-NA,422,307,0,0,0,307,A
6-NA,423,0,0,0,307,307,C
6-NA,424,284,0,0,0,284,A
6-NA,425,283,0,0,0,283,A
6-NA,426,0,0,0,283,283,C
6-NA,427,0,0,284,0,284,G
6-NA,428,0,284,0,0,284,T
6-NA,429,1,0,282,0,283,G
6-NA,430,0,0,0,282,282,C
6-NA,431,283,0,0,0,283,A
6-NA,432,0,283,0,0,283,T
6-NA,433,0,283,0,1,284,T
6-NA,434,0,0,0,288,288,C
6-NA,435,291,0,0,0,291,A
6-NA,436,294,0,0,0,294,A
6-NA,437,298,0,0,0,298,A
6-NA,438,0,294,0,0,294,T
6-NA,439,0,0,296,0,296,G
6-NA,440,303,0,0,0,303,A
6-NA,441,12,0,0,292,304,C
6-NA,442,304,0,0,0,304,A
6-NA,443,0,1,0,307,308,C
6-NA,444,301,0,0,0,301,A
6-NA,445,0,0,363,0,363,G
6-NA,446,0,360,0,0,360,T
6-NA,447,366,0,1,0,367,A
6-NA,448,0,0,0,366,366,C
6-NA,449,2,0,363,0,365,G
6-NA,450,0,378,0,1,379,T
6-NA,451,0,1,377,0,378,G
6-NA,452,378,0,0,0,378,A
6-NA,453,0,378,0,0,378,T
6-NA,454,342,0,1,0,343,A
6-NA,455,0,0,343,0,343,G
6-NA,456,0,0,342,0,342,G
6-NA,457,342,0,0,0,342,A
6-NA,458,0,0,0,342,342,C
6-NA,459,1,0,0,331,332,C
6-NA,460,1,0,0,333,334,C
6-NA,461,2,0,0,340,342,C
6-NA,462,0,342,0,0,342,T
6-NA,463,0,342,0,0,342,T
6-NA,464,348,0,0,0,348,A
6-NA,465,1,348,0,0,349,T
6-NA,466,0,0,0,350,350,C
6-NA,467,0,0,349,0,349,G
6-NA,468,0,0,347,0,347,G
6-NA,469,348,0,0,0,348,A
6-NA,470,0,0,0,348,348,C
6-NA,471,0,0,0,351,351,C
6-NA,472,0,0,0,366,366,C
6-NA,473,0,365,0,3,368,T
6-NA,474,378,0,0,0,378,A
6-NA,475,0,379,0,0,379,T
6-NA,476,0,381,0,0,381,T
6-NA,477,0,0,380,0,380,G
6-NA,478,378,0,0,0,378,A
6-NA,479,0,377,0,0,377,T
6-NA,480,0,0,376,0,376,G
6-NA,481,369,0,0,0,369,A
6-NA,482,371,0,0,0,371,A
6-NA,483,0,371,0,0,371,T
6-NA,484,0,0,378,0,378,G
6-NA,485,380,0,0,0,380,A
6-NA,486,0,0,385,0,385,G
6-NA,487,0,384,0,0,384,T
6-NA,488,0,383,0,0,383,T
6-NA,489,383,0,0,0,383,A
6-NA,490,0,0,386,0,386,G
6-NA,491,0,0,386,0,386,G
6-NA,492,0,385,0,0,385,T
6-NA,493,0,0,386,0,386,G
6-NA,494,0,387,0,0,387,T
6-NA,495,0,383,0,1,384,T
6-NA,496,0,0,0,386,386,C
6-NA,497,0,0,0,390,390,C
6-NA,498,0,390,0,0,390,T
6-NA,499,1,388,0,0,389,T
6-NA,500,0,387,0,0,387,T
6-NA,501,0,387,0,0,387,T
6-NA,502,0,0,0,388,388,C
6-NA,503,386,0,0,0,386,A
6-NA,504,0,400,0,0,400,T
6-NA,505,0,0,0,401,401,C
6-NA,506,0,399,0,0,399,T
6-NA,507,1,0,396,0,397,G
6-NA,508,1,1,393,0,395,G
6-NA,509,0,1,395,0,396,G
6-NA,510,0,0,396,0,396,G
6-NA,511,399,0,0,0,399,A
6-NA,512,0,1,0,402,403,C
6-NA,513,0,0,0,396,396,C
6-NA,514,399,1,0,0,400,A
6-NA,515,397,0,0,0,397,A
6-NA,516,0,0,396,0,396,G
6-NA,517,0,0,0,402,402,C
6-NA,518,403,0,0,0,403,A
6-NA,519,403,0,1,0,404,A
6-NA,520,0,0,409,0,409,G
6-NA,521,0,404,0,0,404,T
6-NA,522,0,0,426,0,426,G
6-NA,523,0,421,0,0,421,T
6-NA,524,0,0,431,0,431,G
6-NA,525,0,0,0,432,432,C
6-NA,526,428,0,0,0,428,A
6-NA,527,0,434,0,0,434,T
6-NA,528,425,0,0,0,425,A
6-NA,529,0,0,437,0,437,G
6-NA,530,0,0,0,438,438,C
6-NA,531,429,0,0,0,429,A
6-NA,532,0,429,0,0,429,T
6-NA,533,0,0,424,0,424,G
6-NA,534,0,0,526,0,526,G
6-NA,535,0,526,0,1,527,T
6-NA,536,0,0,0,525,525,C
6-NA,537,0,0,0,554,554,C
6-NA,538,578,0,0,0,578,A
6-NA,539,0,0,661,0,661,G
6-NA,540,0,0,0,677,677,C
6-NA,541,0,673,0,0,673,T
6-NA,542,2,2,0,672,676,C
6-NA,543,673,0,0,0,673,A
6-NA,544,698,0,0,0,698,A
6-NA,545,0,0,703,0,703,G
6-NA,546,1,715,0,0,716,T
6-NA,547,0,711,0,1,712,T
6-NA,548,0,0,721,1,722,G
6-NA,549,0,722,0,0,722,T
6-NA,550,0,0,0,723,723,C
6-NA,551,723,0,0,0,723,A
6-NA,552,0,1,0,742,743,C
6-NA,553,0,0,738,0,738,G
6-NA,554,780,0,0,0,780,A
6-NA,555,0,789,0,0,789,T
6-NA,556,2,0,814,0,816,G
6-NA,557,2,0,832,0,834,G
6-NA,558,829,0,0,0,829,A
6-NA,559,834,0,0,0,834,A
6-NA,560,850,1,1,0,852,A
6-NA,561,860,0,0,0,860,A
6-NA,562,0,0,885,0,885,G
6-NA,563,0,0,0,882,882,C
6-NA,564,882,0,1,0,883,A
6-NA,565,1,888,0,0,889,T
6-NA,566,1,0,912,0,913,G
6-NA,567,0,1,922,0,923,G
6-NA,568,1,0,0,942,943,C
6-NA,569,0,937,0,1,938,T
6-NA,570,1,0,953,0,954,G
6-NA,571,1,0,0,951,952,C
6-NA,572,958,0,0,0,958,A
6-NA,573,0,1034,0,0,1034,T
6-NA,574,0,0,1037,0,1037,G
6-NA,575,0,1065,0,0,1065,T
6-NA,576,1,1120,0,1,1122,T
6-NA,577,0,1122,0,0,1122,T
6-NA,578,1,0,1267,0,1268,G
6-NA,579,0,1271,0,1,1272,T
6-NA,580,1275,0,0,0,1275,A
6-NA,581,0,1284,0,1,1285,T
6-NA,582,1281,0,1,0,1282,A
6-NA,583,1296,0,0,0,1296,A
6-NA,584,0,0,0,1288,1288,C
6-NA,585,0,1,1288,0,1289,G
6-NA,586,0,1,1295,0,1296,G
6-NA,587,0,3,1276,0,1279,G
6-NA,588,0,0,1289,0,1289,G
6-NA,589,0,0,1291,0,1291,G
6-NA,590,1289,0,2,0,1291,A
6-NA,591,0,1299,0,0,1299,T
6-NA,592,1,0,1314,0,1315,G
6-NA,593,1322,0,0,0,1322,A
6-NA,594,0,1324,1,0,1325,T
6-NA,595,1329,0,0,0,1329,A
6-NA,596,1346,0,0,0,1346,A
6-NA,597,1352,0,0,0,1352,A
6-NA,598,1356,0,1,0,1357,A
6-NA,599,1368,0,0,0,1368,A
6-NA,600,0,1376,0,0,1376,T
6-NA,601,0,0,1387,0,1387,G
6-NA,602,0,1,0,1387,1388,C
6-NA,603,1386,0,0,0,1386,A
6-NA,604,1392,1,1,0,1394,A
6-NA,605,0,22,0,1397,1419,C
6-NA,606,0,1429,0,2,1431,T
6-NA,607,1,1,1441,0,1443,G
6-NA,608,0,0,0,1447,1447,C
6-NA,609,0,1445,0,1,1446,T
6-NA,610,1452,0,1,0,1453,A
6-NA,611,0,1,1456,0,1457,G
6-NA,612,2,0,0,1487,1489,C
6-NA,613,0,1492,0,0,1492,T
6-NA,614,0,1491,0,0,1491,T
6-NA,615,2,0,0,1514,1516,C
6-NA,616,1532,0,2,0,1534,A
6-NA,617,0,1541,0,1,1542,T
6-NA,618,0,1543,0,1,1544,T
6-NA,619,0,1562,0,0,1562,T
6-NA,620,1578,1,0,0,1579,A
6-NA,621,0,3,0,1601,1604,C
6-NA,622,1604,1,0,0,1605,A
6-NA,623,1627,0,1,0,1628,A
6-NA,624,0,1628,0,1,1629,T
6-NA,625,1,7,1623,0,1631,G
6-NA,626,0,1,1632,1,1634,G
6-NA,627,0,0,1631,0,1631,G
6-NA,628,1623,1,1,0,1625,A
6-NA,629,1,1,1685,0,1687,G
6-NA,630,1,0,1717,0,1718,G
6-NA,631,0,0,0,1907,1907,C
6-NA,632,0,1901,0,2,1903,T
6-NA,633,0,1938,0,1,1939,T
6-NA,634,1,0,1965,0,1966,G
6-NA,635,1,1968,0,0,1969,T
6-NA,636,2028,0,0,0,2028,A
6-NA,637,0,1,2058,0,2059,G
6-NA,638,2046,0,0,0,2046,A
6-NA,639,0,2051,0,0,2051,T
6-NA,640,1983,0,0,0,1983,A
6-NA,641,0,0,1991,0,1991,G
6-NA,642,0,1985,0,1,1986,T
6-NA,643,0,0,1962,0,1962,G
6-NA,644,0,2069,0,1,2070,T
6-NA,645,1,2068,0,1,2070,T
6-NA,646,0,0,2117,0,2117,G
6-NA,647,0,2115,0,2,2117,T
6-NA,648,1,2117,0,1,2119,T
6-NA,649,1,2124,0,0,2125,T
6-NA,650,0,1,0,2109,2110,C
6-NA,651,2111,1,1,0,2113,A
6-NA,652,0,2105,0,0,2105,T
6-NA,653,0,0,2106,0,2106,G
6-NA,654,0,2,2270,0,2272,G
6-NA,655,1,2266,0,2,2269,T
6-NA,656,0,2,0,2266,2268,C
6-NA,657,3,0,0,2263,2266,C
6-NA,658,2280,0,2,0,2282,A
6-NA,659,2294,0,0,0,2294,A
6-NA,660,2297,0,1,0,2298,A
6-NA,661,0,0,2308,0,2308,G
6-NA,662,2298,0,1,0,2299,A
6-NA,663,2258,0,1,0,2259,A
6-NA,664,2262,0,3,0,2265,A
6-NA,665,0,2262,0,1,2263,T
6-NA,666,0,0,0,2357,2357,C
6-NA,667,0,0,0,2359,2359,C
6-NA,668,2,2349,0,1,2352,T
6-NA,669,0,1,0,2357,2358,C
6-NA,670,2354,1,1,0,2356,A
6-NA,671,0,2,2374,1,2377,G
6-NA,672,0,2,2379,0,2381,G
6-NA,673,2472,1,3,0,2476,A
6-NA,674,2,1,0,2477,2480,C
6-NA,675,1,1,0,2459,2461,C
6-NA,676,4,0,0,2457,2461,C
6-NA,677,2465,0,0,0,2465,A
6-NA,678,0,2,2466,0,2468,G
6-NA,679,1,1,2482,0,2484,G
6-NA,680,2476,0,3,0,2479,A
6-NA,681,0,0,2504,0,2504,G
6-NA,682,0,2494,0,1,2495,T
6-NA,683,1,0,0,2503,2504,C
6-NA,684,2495,0,4,0,2499,A
6-NA,685,0,0,2518,0,2518,G
6-NA,686,2512,0,2,1,2515,A
6-NA,687,2520,2,1,0,2523,A
6-NA,688,0,2516,0,4,2520,T
6-NA,689,0,0,2525,0,2525,G
6-NA,690,0,1,0,2536,2537,C
6-NA,691,4,0,2560,0,2564,G
6-NA,692,1,2560,0,2,2563,T
6-NA,693,0,2564,0,1,2565,T
6-NA,694,1,2560,0,0,2561,T
6-NA,695,2,3,2575,0,2580,G
6-NA,696,0,2583,0,0,2583,T
6-NA,697,2585,0,1,0,2586,A
6-NA,698,0,2582,0,1,2583,T
6-NA,699,0,0,0,2595,2595,C
6-NA,700,2598,0,2,0,2600,A
6-NA,701,2600,0,0,1,2601,A
6-NA,702,0,2603,0,0,2603,T
6-NA,703,0,1,2603,0,2604,G
6-NA,704,1,1,2613,0,2615,G
6-NA,705,2667,0,2,0,2669,A
6-NA,706,2676,0,2,0,2678,A
6-NA,707,0,0,0,2704,2704,C
6-NA,708,0,2722,1,2,2725,T
6-NA,709,1,2723,0,0,2724,T
6-NA,710,0,1,2834,0,2835,G
6-NA,711,0,2837,0,1,2838,T
6-NA,712,2835,0,1,0,2836,A
6-NA,713,1,0,0,2889,2890,C
6-NA,714,2852,0,2,0,2854,A
6-NA,715,1,0,3084,0,3085,G
6-NA,716,0,3069,0,1,3070,T
6-NA,717,3224,1,3,0,3228,A
6-NA,718,0,1,3247,1,3249,G
6-NA,719,1,3199,1,0,3201,T
6-NA,720,3208,0,1,0,3209,A
6-NA,721,3199,1,2,0,3202,A
6-NA,722,2,3206,0,0,3208,T
6-NA,723,0,2,3218,0,3220,G
6-NA,724,3181,0,1,0,3182,A
6-NA,725,2,0,0,3206,3208,C
6-NA,726,0,3159,1,1,3161,T
6-NA,727,1,2,3172,0,3175,G
6-NA,728,3178,2,0,1,3181,A
6-NA,729,1,3187,0,4,3192,T
6-NA,730,0,1,3189,0,3190,G
6-NA,731,0,2,3195,0,3197,G
6-NA,732,2,2,3189,0,3193,G
6-NA,733,3151,0,1,0,3152,A
6-NA,734,0,0,3150,0,3150,G
6-NA,735,0,3146,0,2,3148,T
6-NA,736,2,0,3155,0,3157,G
6-NA,737,1,1,0,3156,3158,C
6-NA,738,0,3158,0,0,3158,T
6-NA,739,1,3157,0,0,3158,T
6-NA,740,1,3,0,3153,3157,C
6-NA,741,0,5,3142,0,3147,G
6-NA,742,3,0,3168,1,3172,G
6-NA,743,1,0,3176,0,3177,G
6-NA,744,3167,1,3,0,3171,A
6-NA,745,3160,1,0,0,3161,A
6-NA,746,3159,0,1,0,3160,A
6-NA,747,3165,3,3,0,3171,A
6-NA,748,1,0,3196,0,3197,G
6-NA,749,0,0,0,3196,3196,C
6-NA,750,0,3182,0,0,3182,T
6-NA,751,0,3,3183,0,3186,G
6-NA,752,3185,0,3,0,3188,A
6-NA,753,1,3224,0,1,3226,T
6-NA,754,3239,0,2,0,3241,A
6-NA,755,1,0,0,3372,3373,C
6-NA,756,1,3350,0,3,3354,T
6-NA,757,3356,0,0,0,3356,A
6-NA,758,3358,0,0,0,3358,A
6-NA,759,3354,0,1,0,3355,A
6-NA,760,3420,0,1,1,3422,A
6-NA,761,0,3424,0,1,3425,T
6-NA,762,3414,0,1,0,3415,A
6-NA,763,1,0,0,3433,3434,C
6-NA,764,0,3330,0,1,3331,T
6-NA,765,3370,0,0,0,3370,A
6-NA,766,0,3361,0,2,3363,T
6-NA,767,0,3683,0,3,3686,T
6-NA,768,1,1,2,3712,3716,C
6-NA,769,3692,0,0,0,3692,A
6-NA,770,0,3689,0,2,3691,T
6-NA,771,0,3690,0,3,3693,T
6-NA,772,3658,0,0,0,3658,A
6-NA,773,3670,1,1,0,3672,A
6-NA,774,2,5,3681,0,3688,G
6-NA,775,0,3,3685,0,3688,G
6-NA,776,3505,1,2,0,3508,A
6-NA,777,1,5,3534,0,3540,G
6-NA,778,0,2,3536,0,3538,G
6-NA,779,3,1,3544,1,3549,G
6-NA,780,0,0,3545,1,3546,G
6-NA,781,3536,0,2,0,3538,A
6-NA,782,3548,0,1,0,3549,A
6-NA,783,3532,0,1,0,3533,A
6-NA,784,3531,0,2,1,3534,A
6-NA,785,1,3538,0,0,3539,T
6-NA,786,0,1,0,3544,3545,C
6-NA,787,2,1,3565,1,3569,G
6-NA,788,0,3561,0,0,3561,T
6-NA,789,0,3558,0,2,3560,T
6-NA,790,1,1,0,3561,3563,C
6-NA,791,3565,0,1,0,3566,A
6-NA,792,1,3834,0,0,3835,T
6-NA,793,3825,2,2,0,3829,A
6-NA,794,1,1,1,3853,3856,C
6-NA,795,0,3845,0,4,3849,T
6-NA,796,3861,0,3,0,3864,A
6-NA,797,0,0,3863,0,3863,G
6-NA,798,0,0,0,3872,3872,C
6-NA,799,3870,0,3,1,3874,A
6-NA,800,0,1,0,3885,3886,C
6-NA,801,3751,0,1,0,3752,A
6-NA,802,0,3811,0,0,3811,T
6-NA,803,0,3786,0,3,3789,T
6-NA,804,1,0,4064,0,4065,G
6-NA,805,0,4051,0,1,4052,T
6-NA,806,0,4,0,4049,4053,C
6-NA,807,4050,1,2,0,4053,A
6-NA,808,2,1,4056,0,4059,G
6-NA,809,0,1,4066,0,4067,G
6-NA,810,4061,0,0,0,4061,A
6-NA,811,4013,0,2,0,4015,A
6-NA,812,0,2,4065,0,4067,G
6-NA,813,0,3908,0,3,3911,T
6-NA,814,0,0,3938,0,3938,G
6-NA,815,1,2,0,3929,3932,C
6-NA,816,0,3920,0,4,3924,T
6-NA,817,1,1,0,3935,3937,C
6-NA,818,3929,0,0,0,3929,A
6-NA,819,1,0,3956,0,3957,G
6-NA,820,0,1,0,3954,3955,C
6-NA,821,3967,0,0,0,3967,A
6-NA,822,0,3964,0,1,3965,T
6-NA,823,1,0,4116,0,4117,G
6-NA,824,1,4122,0,2,4125,T
6-NA,825,11,4,1,4107,4123,C
6-NA,826,0,1,4123,0,4124,G
6-NA,827,4114,3,0,0,4117,A
6-NA,828,0,5,4107,0,4112,G
6-NA,829,1,1,4101,0,4103,G
6-NA,830,4073,0,7,0,4080,A
6-NA,831,1,0,4131,1,4133,G
6-NA,832,0,4044,0,0,4044,T
6-NA,833,1,1,4046,0,4048,G
6-NA,834,1,4,0,4118,4123,C
6-NA,835,1,4107,0,0,4108,T
6-NA,836,1,0,1,4132,4134,C
6-NA,837,4,0,0,4142,4146,C
6-NA,838,0,4146,0,0,4146,T
6-NA,839,1,0,4165,0,4166,G
6-NA,840,1,0,1,4151,4153,C
6-NA,841,0,4121,0,3,4124,T
6-NA,842,4151,1,2,0,4154,A
6-NA,843,0,4080,0,0,4080,T
6-NA,844,1,0,0,4105,4106,C
6-NA,845,3,1,1,4098,4103,C
6-NA,846,0,4103,1,4,4108,T
6-NA,847,0,0,0,4139,4139,C
6-NA,848,4,0,4128,0,4132,G
6-NA,849,4163,1,1,0,4165,A
6-NA,850,1,4171,0,2,4174,T
6-NA,851,4176,1,0,0,4177,A
6-NA,852,1,4172,0,0,4173,T
6-NA,853,2,0,1,4170,4173,C
6-NA,854,2,0,0,4167,4169,C
6-NA,855,1,4152,0,2,4155,T
6-NA,856,1,2,4178,0,4181,G
6-NA,857,1,0,4190,0,4191,G
6-NA,858,1,4242,0,2,4245,T
6-NA,859,2,0,4253,0,4255,G
6-NA,860,0,4232,0,4,4236,T
6-NA,861,1,3,0,4234,4238,C
6-NA,862,4236,0,2,0,4238,A
6-NA,863,0,1,4246,0,4247,G
6-NA,864,4232,4,1,0,4237,A
6-NA,865,0,4195,0,0,4195,T
6-NA,866,2,0,4203,0,4205,G
6-NA,867,0,4165,0,1,4166,T
6-NA,868,2,1,4173,4,4180,G
6-NA,869,0,4179,0,0,4179,T
6-NA,870,3,0,0,4188,4191,C
6-NA,871,0,4175,0,3,4178,T
6-NA,872,2,0,4185,0,4187,G
6-NA,873,0,2,0,4184,4186,C
6-NA,874,4184,0,1,0,4185,A
6-NA,875,0,1,4181,0,4182,G
6-NA,876,4109,0,4,0,4113,A
6-NA,877,0,1,4115,4,4120,G
6-NA,878,4118,1,2,0,4121,A
6-NA,879,1,2,0,4150,4153,C
6-NA,880,4157,1,3,0,4161,A
6-NA,881,4191,6,3,0,4200,A
6-NA,882,0,1,0,4223,4224,C
6-NA,883,0,4216,0,1,4217,T
6-NA,884,1,0,4219,0,4220,G
6-NA,885,0,1,4199,0,4200,G
6-NA,886,4189,1,4,0,4194,A
6-NA,887,4190,0,2,0,4192,A
6-NA,888,4113,2,5,0,4120,A
6-NA,889,0,2,4167,0,4169,G
6-NA,890,0,2,4164,0,4166,G
6-NA,891,1,2,0,4161,4164,C
6-NA,892,1,4144,0,5,4150,T
6-NA,893,1,1,0,4260,4262,C
6-NA,894,2,2,1,4303,4308,C
6-NA,895,4320,1,5,0,4326,A
6-NA,896,4321,0,0,1,4322,A
6-NA,897,0,4328,0,2,4330,T
6-NA,898,4232,0,0,1,4233,A
6-NA,899,0,1,4231,0,4232,G
6-NA,900,1,0,4239,0,4240,G
6-NA,901,0,1,0,4254,4255,C
6-NA,902,0,0,0,4188,4188,C
6-NA,903,3,1,0,4137,4141,C
6-NA,904,4180,0,1,1,4182,A
6-NA,905,0,4214,0,1,4215,T
6-NA,906,2,1,0,4223,4226,C
6-NA,907,1,0,4235,0,4236,G
6-NA,908,1,4228,0,2,4231,T
6-NA,909,4183,0,4,0,4187,A
6-NA,910,0,2,4277,0,4279,G
6-NA,911,4299,2,1,0,4302,A
6-NA,912,2,4314,0,2,4318,T
6-NA,913,4224,1,1,0,4226,A
6-NA,914,0,4183,0,0,4183,T
6-NA,915,4173,0,8,0,4181,A
6-NA,916,4167,1,0,0,4168,A
6-NA,917,4262,1,4,2,4269,A
6-NA,918,0,1,0,4378,4379,C
6-NA,919,4283,2,0,0,4285,A
6-NA,920,0,4279,0,0,4279,T
6-NA,921,4242,1,0,0,4243,A
6-NA,922,4254,2,0,0,4256,A
6-NA,923,4245,2,5,1,4253,A
6-NA,924,1,4,4297,0,4302,G
6-NA,925,0,0,4350,1,4351,G
6-NA,926,4219,3,0,0,4222,A
6-NA,927,0,4230,0,4,4234,T
6-NA,928,0,0,0,4252,4252,C
6-NA,929,4284,0,3,0,4287,A
6-NA,930,2,4290,0,0,4292,T
6-NA,931,4280,0,2,0,4282,A
6-NA,932,0,0,4315,0,4315,G
6-NA,933,1,0,0,4270,4271,C
6-NA,934,4208,0,0,0,4208,A
6-NA,935,0,4127,0,1,4128,T
6-NA,936,1,4136,0,0,4137,T
6-NA,937,1,0,4286,0,4287,G
6-NA,938,0,4281,0,5,4286,T
6-NA,939,1,4349,0,3,4353,T
6-NA,940,0,4350,0,2,4352,T
6-NA,941,1,1,0,4337,4339,C
6-NA,942,0,6,1,4357,4364,C
6-NA,943,4396,3,2,1,4402,A
6-NA,944,0,0,4454,0,4454,G
6-NA,945,1,4451,0,4,4456,T
6-NA,946,0,4330,0,1,4331,T
6-NA,947,4332,1,1,0,4334,A
6-NA,948,0,4317,0,1,4318,T
6-NA,949,1,0,4323,0,4324,G
6-NA,950,0,4309,1,0,4310,T
6-NA,951,2,1,4330,0,4333,G
6-NA,952,1,4250,0,6,4257,T
6-NA,953,21,1,4358,0,4380,G
6-NA,954,1,4379,0,0,4380,T
6-NA,955,1,4375,0,2,4378,T
6-NA,956,3,0,0,4361,4364,C
6-NA,957,4329,0,18,1,4348,A
6-NA,958,3,1,4380,0,4384,G
6-NA,959,1,1,4380,0,4382,G
6-NA,960,4365,1,3,2,4371,A
6-NA,961,0,0,0,4377,4377,C
6-NA,962,1,4258,0,0,4259,T
6-NA,963,0,4279,0,1,4280,T
6-NA,964,0,0,4453,1,4454,G
6-NA,965,1,4456,1,5,4463,T
6-NA,966,1,4457,0,0,4458,T
6-NA,967,1,0,4444,0,4445,G
6-NA,968,2,3,4442,0,4447,G
6-NA,969,4444,1,7,0,4452,A
6-NA,970,0,1,4454,0,4455,G
6-NA,971,4454,0,3,0,4457,A
6-NA,972,0,2,0,4438,4440,C
6-NA,973,4332,1,5,0,4338,A
6-NA,974,0,4,0,4352,4356,C
6-NA,975,4352,1,3,0,4356,A
6-NA,976,1,1,0,4372,4374,C
6-NA,977,3,1,0,4342,4346,C
6-NA,978,3,1,0,4361,4365,C
6-NA,979,4358,3,0,0,4361,A
6-NA,980,0,0,4370,0,4370,G
6-NA,981,4364,0,0,1,4365,A
6-NA,982,4378,1,1,0,4380,A
6-NA,983,4362,2,1,2,4367,A
6-NA,984,4367,0,1,0,4368,A
6-NA,985,4350,1,3,0,4354,A
6-NA,986,4353,0,4,2,4359,A
6-NA,987,0,1,0,4363,4364,C
6-NA,988,3,2,4352,0,4357,G
6-NA,989,4353,0,1,0,4354,A
6-NA,990,0,1,0,4347,4348,C
6-NA,991,4337,3,5,0,4345,A
6-NA,992,3,0,4374,0,4377,G
6-NA,993,1,1,0,4513,4515,C
6-NA,994,2,4493,0,5,4500,T
6-NA,995,2,0,0,4521,4523,C
6-NA,996,2,28,0,4503,4533,C
6-NA,997,4535,0,1,0,4536,A
6-NA,998,1,1,4575,0,4577,G
6-NA,999,0,0,0,4576,4576,C
6-NA,1000,4562,0,1,0,4563,A
6-NA,1001,1,0,4553,1,4555,G
6-NA,1002,1,4391,0,2,4394,T
6-NA,1003,4391,0,4,0,4395,A
6-NA,1004,0,0,4398,1,4399,G
6-NA,1005,2,1,0,4407,4410,C
6-NA,1006,2,2,0,4418,4422,C
6-NA,1007,4370,1,1,0,4372,A
6-NA,1008,0,4374,0,2,4376,T
6-NA,1009,0,4383,0,1,4384,T
6-NA,1010,2,0,4455,0,4457,G
6-NA,1011,2,4429,2,5,4438,T
6-NA,1012,0,4430,1,3,4434,T
6-NA,1013,3,4421,0,0,4424,T
6-NA,1014,0,3,4400,0,4403,G
6-NA,1015,0,1,4443,0,4444,G
6-NA,1016,4436,0,1,0,4437,A
6-NA,1017,1,4453,1,1,4456,T
6-NA,1018,4,1,2,4447,4454,C
6-NA,1019,1,1,0,4393,4395,C
6-NA,1020,3,4395,0,7,4405,T
6-NA,1021,4391,0,13,1,4405,A
6-NA,1022,4407,1,12,0,4420,A
6-NA,1023,0,3,0,4480,4483,C
6-NA,1024,4394,0,0,0,4394,A
6-NA,1025,4448,0,0,0,4448,A
6-NA,1026,0,4450,0,0,4450,T
6-NA,1027,0,1,4493,0,4494,G
6-NA,1028,4472,3,1,0,4476,A
6-NA,1029,4441,0,4,0,4445,A
6-NA,1030,0,1,4461,1,4463,G
6-NA,1031,4443,0,1,1,4445,A
6-NA,1032,4351,1,4,1,4357,A
6-NA,1033,0,2,4353,0,4355,G
6-NA,1034,2,1,4355,0,4358,G
6-NA,1035,0,4322,0,3,4325,T
6-NA,1036,3,2,4321,0,4326,G
6-NA,1037,1,2,4455,0,4458,G
6-NA,1038,3,4433,0,5,4441,T
6-NA,1039,7,1,0,4415,4423,C
6-NA,1040,4441,0,3,0,4444,A
6-NA,1041,0,4428,0,4,4432,T
6-NA,1042,1,0,4429,1,4431,G
6-NA,1043,0,0,4468,0,4468,G
6-NA,1044,4432,0,7,0,4439,A
6-NA,1045,0,0,4548,0,4548,G
6-NA,1046,2,4389,0,2,4393,T
6-NA,1047,1,2,4387,0,4390,G
6-NA,1048,4384,1,5,0,4390,A
6-NA,1049,4384,2,1,0,4387,A
6-NA,1050,4384,0,14,0,4398,A
6-NA,1051,2,0,4420,0,4422,G
6-NA,1052,0,1,4395,0,4396,G
6-NA,1053,0,3,0,4383,4386,C
6-NA,1054,1,4260,0,4,4265,T
6-NA,1055,3,2,4269,0,4274,G
6-NA,1056,3,4,4263,0,4270,G
6-NA,1057,1,0,4313,0,4314,G
6-NA,1058,0,1,0,4311,4312,C
6-NA,1059,1,0,0,4321,4322,C
6-NA,1060,1,4273,0,3,4277,T
6-NA,1061,0,4292,0,1,4293,T
6-NA,1062,0,4290,0,0,4290,T
6-NA,1063,0,2,4307,0,4309,G
6-NA,1064,4301,0,3,0,4304,A
6-NA,1065,1,4268,0,1,4270,T
6-NA,1066,2,0,4214,0,4216,G
6-NA,1067,4169,0,2,1,4172,A
6-NA,1068,1,4171,1,1,4174,T
6-NA,1069,7,0,4179,0,4186,G
6-NA,1070,0,0,4205,1,4206,G
6-NA,1071,4206,0,0,0,4206,A
6-NA,1072,4199,0,3,0,4202,A
6-NA,1073,4204,0,3,0,4207,A
6-NA,1074,1,4196,0,2,4199,T
6-NA,1075,1,3,4232,0,4236,G
6-NA,1076,4261,1,5,0,4267,A
6-NA,1077,1,0,0,4262,4263,C
6-NA,1078,2,0,4265,0,4267,G
6-NA,1079,0,4216,1,1,4218,T
6-NA,1080,4206,0,3,0,4209,A
6-NA,1081,0,4249,0,1,4250,T
6-NA,1082,0,0,4263,1,4264,G
6-NA,1083,0,2,4302,0,4304,G
6-NA,1084,4247,0,2,0,4249,A
6-NA,1085,0,4176,0,2,4178,T
6-NA,1086,0,4,4157,0,4161,G
6-NA,1087,2,1,4145,0,4148,G
6-NA,1088,2,1,4162,0,4165,G
6-NA,1089,4157,1,0,1,4159,A
6-NA,1090,4147,0,1,0,4148,A
6-NA,1091,2,2,4141,0,4145,G
6-NA,1092,4074,0,1,0,4075,A
6-NA,1093,4067,0,9,0,4076,A
6-NA,1094,0,4,0,4060,4064,C
6-NA,1095,2,1,4052,0,4055,G
6-NA,1096,4053,0,3,0,4056,A
6-NA,1097,1,4003,0,3,4007,T
6-NA,1098,2,1,1,4013,4017,C
6-NA,1099,4011,1,5,0,4017,A
6-NA,1100,1,2,4024,0,4027,G
6-NA,1101,0,0,0,4026,4026,C
6-NA,1102,2,0,4025,0,4027,G
6-NA,1103,4016,1,5,0,4022,A
6-NA,1104,0,1,4027,0,4028,G
6-NA,1105,4016,0,3,0,4019,A
6-NA,1106,4019,2,2,0,4023,A
6-NA,1107,1,0,4045,0,4046,G
6-NA,1108,1,4022,0,5,4028,T
6-NA,1109,1,0,0,4006,4007,C
6-NA,1110,4007,0,2,0,4009,A
6-NA,1111,2,2,0,4105,4109,C
6-NA,1112,0,0,4124,0,4124,G
6-NA,1113,0,1,0,4120,4121,C
6-NA,1114,1,4102,0,0,4103,T
6-NA,1115,0,4111,0,1,4112,T
6-NA,1116,4075,0,6,0,4081,A
6-NA,1117,0,14,4138,0,4152,G
6-NA,1118,0,0,4155,0,4155,G
6-NA,1119,1,4,4239,0,4244,G
6-NA,1120,0,3991,0,2,3993,T
6-NA,1121,3989,0,1,0,3990,A
6-NA,1122,0,3982,0,1,3983,T
6-NA,1123,0,0,3979,1,3980,G
6-NA,1124,3976,2,1,0,3979,A
6-NA,1125,3963,0,3,0,3966,A
6-NA,1126,3782,0,2,0,3784,A
6-NA,1127,0,0,0,3787,3787,C
6-NA,1128,3,1,0,3723,3727,C
6-NA,1129,2,3692,1,2,3697,T
6-NA,1130,0,3686,0,7,3693,T
6-NA,1131,0,1,0,3699,3700,C
6-NA,1132,3696,0,2,0,3698,A
6-NA,1133,3703,0,0,0,3703,A
6-NA,1134,3694,1,1,0,3696,A
6-NA,1135,0,0,3732,0,3732,G
6-NA,1136,4,3667,0,2,3673,T
6-NA,1137,1,0,0,3703,3704,C
6-NA,1138,3751,1,1,0,3753,A
6-NA,1139,0,3758,0,3,3761,T
6-NA,1140,0,3752,0,1,3753,T
6-NA,1141,0,1,3758,0,3759,G
6-NA,1142,3747,1,1,1,3750,A
6-NA,1143,3764,0,4,1,3769,A
6-NA,1144,0,2,3750,0,3752,G
6-NA,1145,2,1,3735,0,3738,G
6-NA,1146,1,0,0,3724,3725,C
6-NA,1147,2,3613,1,3,3619,T
6-NA,1148,0,0,3631,0,3631,G
6-NA,1149,1,1,3686,0,3688,G
6-NA,1150,1,3683,0,10,3694,T
6-NA,1151,2,0,0,3678,3680,C
6-NA,1152,0,4,0,3695,3699,C
6-NA,1153,3694,1,0,0,3695,A
6-NA,1154,3688,0,12,0,3700,A
6-NA,1155,1,1,0,3692,3694,C
6-NA,1156,1,11,0,3665,3677,C
6-NA,1157,7,1,0,3665,3673,C
6-NA,1158,5,6,0,3542,3553,C
6-NA,1159,3583,0,3,0,3586,A
6-NA,1160,3588,0,1,0,3589,A
6-NA,1161,1,0,3599,4,3604,G
6-NA,1162,1,3585,0,3,3589,T
6-NA,1163,0,24,0,3571,3595,C
6-NA,1164,0,0,1,3585,3586,C
6-NA,1165,3574,1,0,1,3576,A
6-NA,1166,3565,0,1,1,3567,A
6-NA,1167,3573,1,2,0,3576,A
6-NA,1168,0,3577,0,0,3577,T
6-NA,1169,1,3553,0,3,3557,T
6-NA,1170,0,1,3546,0,3547,G
6-NA,1171,0,0,1,3534,3535,C
6-NA,1172,3529,0,6,1,3536,A
6-NA,1173,0,1,3528,0,3529,G
6-NA,1174,3526,0,3,0,3529,A
6-NA,1175,1,0,0,3491,3492,C
6-NA,1176,3606,1,0,4,3611,A
6-NA,1177,3614,0,0,2,3616,A
6-NA,1178,3621,1,0,0,3622,A
6-NA,1179,1,3600,0,2,3603,T
6-NA,1180,3609,0,1,0,3610,A
6-NA,1181,0,1,3620,0,3621,G
6-NA,1182,2,2,3605,0,3609,G
6-NA,1183,2,0,0,3582,3584,C
6-NA,1184,3446,1,0,0,3447,A
6-NA,1185,3468,2,2,0,3472,A
6-NA,1186,0,0,3500,0,3500,G
6-NA,1187,4,3480,0,5,3489,T
6-NA,1188,6,2,0,3492,3500,C
6-NA,1189,3501,2,2,0,3505,A
6-NA,1190,1,3507,0,0,3508,T
6-NA,1191,3527,2,0,1,3530,A
6-NA,1192,3,0,3541,0,3544,G
6-NA,1193,0,3543,0,0,3543,T
6-NA,1194,0,3437,0,1,3438,T
6-NA,1195,2,2,3396,0,3400,G
6-NA,1196,3394,0,3,0,3397,A
6-NA,1197,0,0,0,3389,3389,C
6-NA,1198,3359,0,2,0,3361,A
6-NA,1199,0,1,3402,0,3403,G
6-NA,1200,3347,0,1,0,3348,A
6-NA,1201,1,0,3344,1,3346,G
6-NA,1202,3311,1,3,1,3316,A
6-NA,1203,0,3501,0,4,3505,T
6-NA,1204,3498,0,1,1,3500,A
6-NA,1205,3487,0,2,1,3490,A
6-NA,1206,1,3505,0,0,3506,T
6-NA,1207,3478,1,3,1,3483,A
6-NA,1208,0,1,3434,0,3435,G
6-NA,1209,0,0,3383,0,3383,G
6-NA,1210,1,3259,0,6,3266,T
6-NA,1211,2,0,0,3250,3252,C
6-NA,1212,1,1,0,3226,3228,C
6-NA,1213,1,1,3225,1,3228,G
6-NA,1214,0,0,3231,0,3231,G
6-NA,1215,1,3223,0,2,3226,T
6-NA,1216,0,3216,0,0,3216,T
6-NA,1217,3198,0,0,0,3198,A
6-NA,1218,0,3188,0,0,3188,T
6-NA,1219,1,3190,1,0,3192,T
6-NA,1220,0,1,0,3195,3196,C
6-NA,1221,1,3128,0,1,3130,T
6-NA,1222,0,1,3135,0,3136,G
6-NA,1223,1,0,3142,0,3143,G
6-NA,1224,0,3140,0,1,3141,T
6-NA,1225,3145,0,0,0,3145,A
6-NA,1226,1,3112,0,1,3114,T
6-NA,1227,0,3114,0,0,3114,T
6-NA,1228,2,3105,0,4,3111,T
6-NA,1229,0,3119,0,3,3122,T
6-NA,1230,0,1,0,3117,3118,C
6-NA,1231,0,3084,0,2,3086,T
6-NA,1232,0,0,0,3111,3111,C
6-NA,1233,0,3100,1,1,3102,T
6-NA,1234,0,0,3140,1,3141,G
6-NA,1235,0,3142,0,0,3142,T
6-NA,1236,1,3118,4,0,3123,T
6-NA,1237,1,0,3118,1,3120,G
6-NA,1238,3099,1,1,0,3101,A
6-NA,1239,3092,1,3,0,3096,A
6-NA,1240,0,0,3121,0,3121,G
6-NA,1241,3,0,3102,0,3105,G
6-NA,1242,1,1,0,3112,3114,C
6-NA,1243,3062,0,0,0,3062,A
6-NA,1244,3060,1,2,0,3063,A
6-NA,1245,3067,0,2,1,3070,A
6-NA,1246,3073,0,4,0,3077,A
6-NA,1247,1,0,3079,0,3080,G
6-NA,1248,0,3,0,3069,3072,C
6-NA,1249,0,3024,1,4,3029,T
6-NA,1250,0,0,3050,0,3050,G
6-NA,1251,0,1,0,3046,3047,C
6-NA,1252,3049,0,1,0,3050,A
6-NA,1253,2,3041,1,5,3049,T
6-NA,1254,0,0,0,3018,3018,C
6-NA,1255,3012,0,1,0,3013,A
6-NA,1256,3017,0,0,0,3017,A
6-NA,1257,0,3012,1,1,3014,T
6-NA,1258,1,0,1,3008,3010,C
6-NA,1259,1,1,2968,1,2971,G
6-NA,1260,0,1,3009,0,3010,G
6-NA,1261,1,2995,1,2,2999,T
6-NA,1262,0,2,3008,0,3010,G
6-NA,1263,0,0,0,3019,3019,C
6-NA,1264,0,2992,1,2,2995,T
6-NA,1265,0,3017,1,0,3018,T
6-NA,1266,1,3019,1,1,3022,T
6-NA,1267,0,3025,1,0,3026,T
6-NA,1268,3044,0,1,0,3045,A
6-NA,1269,1,2905,1,1,2908,T
6-NA,1270,0,0,2912,0,2912,G
6-NA,1271,0,2880,0,2,2882,T
6-NA,1272,1,0,2845,0,2846,G
6-NA,1273,1,0,2868,0,2869,G
6-NA,1274,2813,1,3,0,2817,A
6-NA,1275,0,0,2838,0,2838,G
6-NA,1276,0,2818,0,2,2820,T
6-NA,1277,0,2802,0,2,2804,T
6-NA,1278,1,0,2817,1,2819,G
6-NA,1279,2811,0,4,0,2815,A
6-NA,1280,1,2809,0,1,2811,T
6-NA,1281,2805,1,2,0,2808,A
6-NA,1282,2708,1,2,0,2711,A
6-NA,1283,1,2,2724,0,2727,G
6-NA,1284,0,3,2677,0,2680,G
6-NA,1285,0,0,2665,0,2665,G
6-NA,1286,0,0,2657,0,2657,G
6-NA,1287,2619,0,1,0,2620,A
6-NA,1288,2613,0,0,0,2613,A
6-NA,1289,0,1,2630,0,2631,G
6-NA,1290,2629,0,0,0,2629,A
6-NA,1291,2617,1,1,1,2620,A
6-NA,1292,2586,0,1,0,2587,A
6-NA,1293,2549,0,3,0,2552,A
6-NA,1294,2,0,2555,0,2557,G
6-NA,1295,2526,1,4,0,2531,A
6-NA,1296,2,1,2530,0,2533,G
6-NA,1297,0,2,2529,0,2531,G
6-NA,1298,2499,1,1,0,2501,A
6-NA,1299,2505,0,2,0,2507,A
6-NA,1300,2514,0,1,0,2515,A
6-NA,1301,0,1,0,2520,2521,C
6-NA,1302,1,2509,0,2,2512,T
6-NA,1303,1,0,2512,0,2513,G
6-NA,1304,2500,1,3,0,2504,A
6-NA,1305,2497,0,4,1,2502,A
6-NA,1306,0,0,2513,0,2513,G
6-NA,1307,1,2481,0,5,2487,T
6-NA,1308,0,2,0,2503,2505,C
6-NA,1309,1,2481,2,2,2486,T
6-NA,1310,1,2474,0,1,2476,T
6-NA,1311,0,0,2481,0,2481,G
6-NA,1312,1,2474,0,1,2476,T
6-NA,1313,0,1,2471,0,2472,G
6-NA,1314,0,2,2468,1,2471,G
6-NA,1315,2419,0,5,0,2424,A
6-NA,1316,0,0,0,2423,2423,C
6-NA,1317,2329,0,0,1,2330,A
6-NA,1318,2,2327,1,1,2331,T
6-NA,1319,1,0,0,2328,2329,C
6-NA,1320,2,0,2322,0,2324,G
6-NA,1321,2349,0,0,0,2349,A
6-NA,1322,2343,1,2,0,2346,A
6-NA,1323,0,2,0,2357,2359,C
6-NA,1324,2327,1,1,0,2329,A
6-NA,1325,0,0,2395,0,2395,G
6-NA,1326,1,2374,0,2,2377,T
6-NA,1327,2371,1,2,0,2374,A
6-NA,1328,0,2370,1,0,2371,T
6-NA,1329,2,2256,0,1,2259,T
6-NA,1330,0,1,2260,0,2261,G
6-NA,1331,3,2254,0,3,2260,T
6-NA,1332,1,2186,0,2,2189,T
6-NA,1333,1,0,2188,0,2189,G
6-NA,1334,0,1936,0,3,1939,T
6-NA,1335,0,0,1941,0,1941,G
6-NA,1336,0,1929,0,3,1932,T
6-NA,1337,0,1907,1,1,1909,T
6-NA,1338,0,1905,0,1,1906,T
6-NA,1339,0,1858,0,0,1858,T
6-NA,1340,0,0,1852,0,1852,G
6-NA,1341,2,1853,0,1,1856,T
6-NA,1342,0,0,1847,0,1847,G
6-NA,1343,0,0,1850,0,1850,G
6-NA,1344,0,1,0,1827,1828,C
6-NA,1345,1821,1,1,0,1823,A
6-NA,1346,1,0,0,1829,1830,C
6-NA,1347,0,7,0,1808,1815,C
6-NA,1348,0,1815,0,4,1819,T
6-NA,1349,1,1,1,1821,1824,C
6-NA,1350,1819,0,3,0,1822,A
6-NA,1351,0,0,1831,0,1831,G
6-NA,1352,1,1,1829,0,1831,G
6-NA,1353,1,1821,1,0,1823,T
6-NA,1354,1811,0,0,0,1811,A
6-NA,1355,1,0,0,1703,1704,C
6-NA,1356,1679,1,1,0,1681,A
6-NA,1357,0,1679,0,0,1679,T
6-NA,1358,1635,0,1,0,1636,A
6-NA,1359,0,1635,1,0,1636,T
6-NA,1360,0,0,1507,0,1507,G
6-NA,1361,2,0,1508,0,1510,G
6-NA,1362,1497,0,0,0,1497,A
6-NA,1363,1476,0,2,0,1478,A
6-NA,1364,0,1,0,1454,1455,C
6-NA,1365,1192,0,1,0,1193,A
6-NA,1366,0,0,1192,0,1192,G
6-NA,1367,1,0,1192,0,1193,G
6-NA,1368,0,0,0,1201,1201,C
6-NA,1369,0,1198,0,1,1199,T
6-NA,1370,0,0,0,1128,1128,C
6-NA,1371,1116,0,0,0,1116,A
6-NA,1372,0,1116,0,2,1118,T
6-NA,1373,0,0,1114,0,1114,G
6-NA,1374,0,0,1115,0,1115,G
6-NA,1375,0,0,1,1071,1072,C
6-NA,1376,0,0,0,1062,1062,C
6-NA,1377,0,1012,0,0,1012,T
6-NA,1378,0,1,1007,0,1008,G
6-NA,1379,1008,0,1,0,1009,A
6-NA,1380,0,1008,0,0,1008,T
6-NA,1381,0,0,998,0,998,G
6-NA,1382,1,1,968,0,970,G
6-NA,1383,0,0,909,0,909,G
6-NA,1384,0,0,911,0,911,G
6-NA,1385,1,0,0,883,884,C
6-NA,1386,0,0,883,0,883,G
6-NA,1387,0,0,875,0,875,G
6-NA,1388,859,0,0,0,859,A
6-NA,1389,0,1,0,859,860,C
6-NA,1390,854,0,1,1,856,A
6-NA,1391,0,839,0,1,840,T
6-NA,1392,2,0,0,829,831,C
6-NA,1393,818,0,0,0,818,A
6-NA,1394,818,0,0,0,818,A
6-NA,1395,0,820,0,0,820,T
6-NA,1396,0,1,0,791,792,C
6-NA,1397,0,768,0,1,769,T
6-NA,1398,0,0,0,633,633,C
6-NA,1399,630,0,0,0,630,A
6-NA,1400,1,623,0,0,624,T
6-NA,1401,0,0,622,0,622,G
6-NA,1402,0,0,0,621,621,C
6-NA,1403,0,0,0,586,586,C
6-NA,1404,0,521,0,0,521,T
6-NA,1405,513,0,0,0,513,A
6-NA,1406,0,512,0,0,512,T
6-NA,1407,492,0,0,0,492,A
6-NA,1408,0,491,0,0,491,T
6-NA,1409,450,0,0,0,450,A
6-NA,1410,433,0,0,0,433,A
7-M,1,10,0,0,0,10,A
7-M,2,0,10,0,0,10,T
7-M,3,0,0,10,0,10,G
7-M,4,10,0,0,0,10,A
7-M,5,0,0,10,0,10,G
7-M,6,0,0,0,12,12,C
7-M,7,0,0,0,13,13,C
7-M,8,0,22,0,0,22,T
7-M,9,0,22,0,0,22,T
7-M,10,0,0,0,22,22,C
7-M,11,0,22,0,0,22,T
7-M,12,22,0,0,0,22,A
7-M,13,22,0,0,0,22,A
7-M,14,0,0,0,22,22,C
7-M,15,0,0,0,22,22,C
7-M,16,0,0,22,0,22,G
7-M,17,22,0,0,0,22,A
7-M,18,0,0,22,0,22,G
7-M,19,0,0,23,0,23,G
7-M,20,0,23,0,0,23,T
7-M,21,0,0,0,23,23,C
7-M,22,0,0,23,0,23,G
7-M,23,24,0,0,0,24,A
7-M,24,24,0,0,0,24,A
7-M,25,24,0,0,0,24,A
7-M,26,0,0,0,28,28,C
7-M,27,0,0,28,0,28,G
7-M,28,0,28,0,0,28,T
7-M,29,29,0,0,0,29,A
7-M,30,0,29,0,0,29,T
7-M,31,0,0,29,0,29,G
7-M,32,0,29,0,0,29,T
7-M,33,0,33,0,0,33,T
7-M,34,0,0,0,34,34,C
7-M,35,0,34,0,0,34,T
7-M,36,0,0,0,41,41,C
7-M,37,0,41,0,0,41,T
7-M,38,0,0,0,44,44,C
7-M,39,0,44,0,0,44,T
7-M,40,45,0,0,0,45,A
7-M,41,0,45,0,0,45,T
7-M,42,0,0,0,45,45,C
7-M,43,0,0,44,0,44,G
7-M,44,0,45,0,0,45,T
7-M,45,0,45,0,0,45,T
7-M,46,0,0,0,46,46,C
7-M,47,0,0,0,48,48,C
7-M,48,48,0,0,0,48,A
7-M,49,0,48,0,0,48,T
7-M,50,0,0,0,48,48,C
7-M,51,48,0,0,0,48,A
7-M,52,0,0,47,0,47,G
7-M,53,0,0,47,0,47,G
7-M,54,0,0,0,48,48,C
7-M,55,0,0,0,47,47,C
7-M,56,0,0,0,47,47,C
7-M,57,0,0,0,51,51,C
7-M,58,0,0,0,51,51,C
7-M,59,0,51,0,0,51,T
7-M,60,0,0,0,51,51,C
7-M,61,50,0,0,0,50,A
7-M,62,50,0,0,0,50,A
7-M,63,50,0,0,0,50,A
7-M,64,0,0,52,0,52,G
7-M,65,0,0,0,52,52,C
7-M,66,0,0,0,51,51,C
7-M,67,0,0,51,0,51,G
7-M,68,51,0,0,0,51,A
7-M,69,0,0,51,0,51,G
7-M,70,51,0,0,0,51,A
7-M,71,0,51,0,0,51,T
7-M,72,0,0,0,51,51,C
7-M,73,0,0,51,0,51,G
7-M,74,0,0,0,52,52,C
7-M,75,0,0,52,0,52,G
7-M,76,0,0,0,52,52,C
7-M,77,52,0,0,0,52,A
7-M,78,0,0,53,0,53,G
7-M,79,55,0,0,0,55,A
7-M,80,0,0,57,0,57,G
7-M,81,58,0,0,0,58,A
7-M,82,0,0,0,57,57,C
7-M,83,0,58,0,0,58,T
7-M,84,0,58,0,0,58,T
7-M,85,0,0,58,0,58,G
7-M,86,57,0,0,0,57,A
7-M,87,58,0,0,0,58,A
7-M,88,0,0,58,0,58,G
7-M,89,58,0,0,0,58,A
7-M,90,0,58,0,0,58,T
7-M,91,0,0,58,0,58,G
7-M,92,0,57,0,1,58,T
7-M,93,0,0,0,58,58,C
7-M,94,0,58,0,0,58,T
7-M,95,0,58,0,0,58,T
7-M,96,0,58,0,0,58,T
7-M,97,0,0,58,0,58,G
7-M,98,0,0,0,58,58,C
7-M,99,0,57,0,0,57,T
7-M,100,0,0,58,0,58,G
7-M,101,0,0,58,0,58,G
7-M,102,0,0,59,0,59,G
7-M,103,58,0,0,0,58,A
7-M,104,59,0,0,0,59,A
7-M,105,59,0,0,0,59,A
7-M,106,60,0,0,0,60,A
7-M,107,61,0,0,0,61,A
7-M,108,0,0,0,61,61,C
7-M,109,60,1,0,0,61,A
7-M,110,0,0,0,62,62,C
7-M,111,62,0,0,0,62,A
7-M,112,0,0,65,0,65,G
7-M,113,66,0,0,0,66,A
7-M,114,0,66,0,0,66,T
7-M,115,0,0,0,66,66,C
7-M,116,0,66,0,0,66,T
7-M,117,0,66,0,0,66,T
7-M,118,0,0,66,0,66,G
7-M,119,66,0,0,0,66,A
7-M,120,0,0,66,0,66,G
7-M,121,0,0,67,0,67,G
7-M,122,0,0,0,67,67,C
7-M,123,0,67,0,0,67,T
7-M,124,0,0,0,71,71,C
7-M,125,0,71,0,0,71,T
7-M,126,0,0,0,71,71,C
7-M,127,71,0,0,0,71,A
7-M,128,0,71,0,0,71,T
7-M,129,0,1,70,0,71,G
7-M,130,0,0,73,0,73,G
7-M,131,73,0,0,0,73,A
7-M,132,73,0,0,0,73,A
7-M,133,0,72,0,0,72,T
7-M,134,0,0,75,0,75,G
7-M,135,0,0,76,0,76,G
7-M,136,0,0,0,76,76,C
7-M,137,1,75,0,0,76,T
7-M,138,76,0,0,0,76,A
7-M,139,76,0,0,0,76,A
7-M,140,77,0,1,0,78,A
7-M,141,0,0,79,0,79,G
7-M,142,80,0,0,0,80,A
7-M,143,0,0,0,80,80,C
7-M,144,79,0,0,0,79,A
7-M,145,79,0,0,0,79,A
7-M,146,0,0,81,0,81,G
7-M,147,81,0,0,0,81,A
7-M,148,0,0,0,81,81,C
7-M,149,0,0,0,81,81,C
7-M,150,80,0,0,0,80,A
7-M,151,80,0,0,0,80,A
7-M,152,0,80,0,0,80,T
7-M,153,0,81,0,0,81,T
7-M,154,0,0,0,84,84,C
7-M,155,0,81,0,0,81,T
7-M,156,0,0,82,0,82,G
7-M,157,0,81,0,0,81,T
7-M,158,0,0,0,81,81,C
7-M,159,81,0,0,0,81,A
7-M,160,0,0,0,85,85,C
7-M,161,0,0,0,84,84,C
7-M,162,0,72,0,10,82,T
7-M,163,0,0,0,84,84,C
7-M,164,0,85,0,0,85,T
7-M,165,0,0,85,0,85,G
7-M,166,86,0,0,0,86,A
7-M,167,0,0,0,85,85,C
7-M,168,0,86,0,0,86,T
7-M,169,86,0,0,0,86,A
7-M,170,85,0,0,0,85,A
7-M,171,0,0,85,0,85,G
7-M,172,0,0,85,0,85,G
7-M,173,0,0,84,0,84,G
7-M,174,0,0,83,0,83,G
7-M,175,82,0,0,0,82,A
7-M,176,0,83,0,0,83,T
7-M,177,0,82,0,0,82,T
7-M,178,0,83,0,0,83,T
7-M,179,0,80,0,3,83,T
7-M,180,0,0,83,0,83,G
7-M,181,0,0,83,0,83,G
7-M,182,0,0,82,0,82,G
7-M,183,0,0,83,0,83,G
7-M,184,0,82,0,0,82,T
7-M,185,0,83,0,0,83,T
7-M,186,0,84,0,0,84,T
7-M,187,0,0,86,0,86,G
7-M,188,0,86,0,0,86,T
7-M,189,0,0,87,0,87,G
7-M,190,0,86,0,0,86,T
7-M,191,0,86,0,0,86,T
7-M,192,0,0,0,88,88,C
7-M,193,88,0,0,0,88,A
7-M,194,0,0,0,89,89,C
7-M,195,0,0,89,0,89,G
7-M,196,0,0,0,89,89,C
7-M,197,0,88,0,0,88,T
7-M,198,0,0,0,91,91,C
7-M,199,89,1,0,0,90,A
7-M,200,0,0,0,90,90,C
7-M,201,1,0,0,89,90,C
7-M,202,0,0,90,0,90,G
7-M,203,0,91,0,0,91,T
7-M,204,0,0,92,0,92,G
7-M,205,0,0,0,92,92,C
7-M,206,0,0,0,92,92,C
7-M,207,0,0,0,92,92,C
7-M,208,91,0,0,0,91,A
7-M,209,0,0,91,0,91,G
7-M,210,0,90,0,1,91,T
7-M,211,0,0,92,0,92,G
7-M,212,92,0,0,0,92,A
7-M,213,0,0,92,0,92,G
7-M,214,0,0,0,91,91,C
7-M,215,0,0,90,0,90,G
7-M,216,90,0,0,0,90,A
7-M,217,0,0,91,0,91,G
7-M,218,0,0,91,0,91,G
7-M,219,91,0,1,0,92,A
7-M,220,0,0,0,94,94,C
7-M,221,0,92,0,0,92,T
7-M,222,0,0,92,0,92,G
7-M,223,0,0,0,92,92,C
7-M,224,92,0,0,0,92,A
7-M,225,0,0,94,0,94,G
7-M,226,0,0,0,93,93,C
7-M,227,0,0,94,0,94,G
7-M,228,0,94,0,0,94,T
7-M,229,93,0,0,0,93,A
7-M,230,0,0,93,0,93,G
7-M,231,92,0,0,0,92,A
7-M,232,0,0,0,92,92,C
7-M,233,0,0,92,0,92,G
7-M,234,0,0,0,91,91,C
7-M,235,0,90,0,0,90,T
7-M,236,0,90,0,0,90,T
7-M,237,0,90,0,0,90,T
7-M,238,0,0,93,0,93,G
7-M,239,0,93,0,0,93,T
7-M,240,0,0,0,93,93,C
7-M,241,0,0,0,93,93,C
7-M,242,93,0,0,0,93,A
7-M,243,93,0,0,0,93,A
7-M,244,93,0,0,0,93,A
7-M,245,90,0,1,0,91,A
7-M,246,0,92,0,0,92,T
7-M,247,0,0,92,0,92,G
7-M,248,0,0,0,92,92,C
7-M,249,0,0,0,91,91,C
7-M,250,0,0,0,93,93,C
7-M,251,0,93,0,0,93,T
7-M,252,0,0,0,96,96,C
7-M,253,96,0,0,0,96,A
7-M,254,96,0,0,0,96,A
7-M,255,0,96,0,0,96,T
7-M,256,0,0,97,0,97,G
7-M,257,0,0,98,0,98,G
7-M,258,0,0,98,0,98,G
7-M,259,98,0,0,0,98,A
7-M,260,97,0,0,0,97,A
7-M,261,0,91,0,4,95,T
7-M,262,0,0,93,0,93,G
7-M,263,0,0,95,0,95,G
7-M,264,95,0,0,0,95,A
7-M,265,0,0,95,0,95,G
7-M,266,95,0,0,0,95,A
7-M,267,0,0,0,95,95,C
7-M,268,0,0,0,97,97,C
7-M,269,0,0,0,100,100,C
7-M,270,100,0,0,0,100,A
7-M,271,100,0,0,0,100,A
7-M,272,100,0,0,0,100,A
7-M,273,0,100,0,0,100,T
7-M,274,102,0,0,0,102,A
7-M,275,101,0,0,0,101,A
7-M,276,0,0,0,99,99,C
7-M,277,99,0,0,0,99,A
7-M,278,0,99,0,0,99,T
7-M,279,0,0,101,0,101,G
7-M,280,0,0,101,0,101,G
7-M,281,101,0,0,0,101,A
7-M,282,0,0,0,101,101,C
7-M,283,98,0,0,0,98,A
7-M,284,99,0,0,0,99,A
7-M,285,99,0,0,0,99,A
7-M,286,0,0,98,1,99,G
7-M,287,0,0,0,102,102,C
7-M,288,98,0,0,0,98,A
7-M,289,0,0,99,0,99,G
7-M,290,0,98,0,0,98,T
7-M,291,0,99,0,0,99,T
7-M,292,99,0,0,0,99,A
7-M,293,97,0,0,0,97,A
7-M,294,99,0,0,0,99,A
7-M,295,0,0,0,100,100,C
7-M,296,0,97,0,0,97,T
7-M,297,0,0,105,0,105,G
7-M,298,0,105,0,0,105,T
7-M,299,106,0,0,0,106,A
7-M,300,0,105,0,0,105,T
7-M,301,103,0,0,0,103,A
7-M,302,0,0,103,0,103,G
7-M,303,99,0,0,0,99,A
7-M,304,99,0,0,0,99,A
7-M,305,99,0,0,0,99,A
7-M,306,101,0,0,0,101,A
7-M,307,0,0,0,101,101,C
7-M,308,0,101,0,0,101,T
7-M,309,0,101,0,0,101,T
7-M,310,101,0,0,0,101,A
7-M,311,100,0,0,0,100,A
7-M,312,0,0,101,0,101,G
7-M,313,98,0,0,0,98,A
7-M,314,0,1,97,0,98,G
7-M,315,0,0,96,0,96,G
7-M,316,0,0,95,0,95,G
7-M,317,96,0,0,0,96,A
7-M,318,0,0,97,0,97,G
7-M,319,97,0,0,0,97,A
7-M,320,0,97,0,0,97,T
7-M,321,96,0,0,0,96,A
7-M,322,98,0,0,0,98,A
7-M,323,0,0,0,98,98,C
7-M,324,0,0,99,0,99,G
7-M,325,0,100,0,0,100,T
7-M,326,0,100,0,0,100,T
7-M,327,0,0,0,99,99,C
7-M,328,0,0,0,100,100,C
7-M,329,100,0,0,0,100,A
7-M,330,0,100,0,0,100,T
7-M,331,0,0,100,0,100,G
7-M,332,0,0,101,0,101,G
7-M,333,0,0,103,0,103,G
7-M,334,0,0,102,0,102,G
7-M,335,0,0,0,101,101,C
7-M,336,0,0,0,104,104,C
7-M,337,104,0,0,0,104,A
7-M,338,105,0,0,0,105,A
7-M,339,106,0,0,0,106,A
7-M,340,0,0,108,0,108,G
7-M,341,108,0,0,0,108,A
7-M,342,106,0,0,0,106,A
7-M,343,104,0,0,0,104,A
7-M,344,0,105,0,0,105,T
7-M,345,104,0,1,0,105,A
7-M,346,0,0,106,0,106,G
7-M,347,0,0,0,106,106,C
7-M,348,0,106,0,0,106,T
7-M,349,0,0,0,106,106,C
7-M,350,0,106,0,0,106,T
7-M,351,0,0,0,107,107,C
7-M,352,107,0,0,0,107,A
7-M,353,0,0,107,0,107,G
7-M,354,0,106,0,0,106,T
7-M,355,0,108,0,0,108,T
7-M,356,109,0,0,0,109,A
7-M,357,0,109,0,0,109,T
7-M,358,0,109,0,0,109,T
7-M,359,0,0,0,109,109,C
7-M,360,0,106,0,0,106,T
7-M,361,0,0,107,0,107,G
7-M,362,0,0,0,107,107,C
7-M,363,0,107,0,0,107,T
7-M,364,0,0,107,0,107,G
7-M,365,0,0,107,0,107,G
7-M,366,0,108,0,0,108,T
7-M,367,0,0,108,0,108,G
7-M,368,0,0,0,107,107,C
7-M,369,108,0,0,0,108,A
7-M,370,0,0,0,109,109,C
7-M,371,0,107,0,0,107,T
7-M,372,0,109,0,0,109,T
7-M,373,0,0,109,0,109,G
7-M,374,0,0,0,109,109,C
7-M,375,0,1,0,109,110,C
7-M,376,110,0,0,0,110,A
7-M,377,0,0,109,0,109,G
7-M,378,0,111,0,0,111,T
7-M,379,0,111,0,0,111,T
7-M,380,0,0,112,0,112,G
7-M,381,0,0,0,112,112,C
7-M,382,112,0,0,0,112,A
7-M,383,0,112,0,0,112,T
7-M,384,0,0,113,0,113,G
7-M,385,0,0,113,0,113,G
7-M,386,0,0,115,0,115,G
7-M,387,0,0,0,116,116,C
7-M,388,0,0,0,122,122,C
7-M,389,0,122,0,0,122,T
7-M,390,0,0,0,125,125,C
7-M,391,131,0,0,0,131,A
7-M,392,0,130,0,0,130,T
7-M,393,136,0,0,0,136,A
7-M,394,0,133,0,0,133,T
7-M,395,128,0,0,0,128,A
7-M,396,0,0,0,141,141,C
7-M,397,139,0,0,0,139,A
7-M,398,140,0,0,0,140,A
7-M,399,0,139,0,0,139,T
7-M,400,131,0,0,0,131,A
7-M,401,0,0,137,0,137,G
7-M,402,0,0,137,0,137,G
7-M,403,139,0,0,0,139,A
7-M,404,0,139,0,0,139,T
7-M,405,0,0,135,0,135,G
7-M,406,0,0,135,0,135,G
7-M,407,0,1,133,0,134,G
7-M,408,0,0,137,0,137,G
7-M,409,1,0,138,0,139,G
7-M,410,0,0,0,139,139,C
7-M,411,0,136,0,0,136,T
7-M,412,0,0,137,0,137,G
7-M,413,0,137,0,0,137,T
7-M,414,138,0,0,0,138,A
7-M,415,138,0,0,0,138,A
7-M,416,0,0,0,138,138,C
7-M,417,0,0,0,136,136,C
7-M,418,138,0,0,0,138,A
7-M,419,0,0,0,139,139,C
7-M,420,0,138,0,0,138,T
7-M,421,0,0,139,0,139,G
7-M,422,138,0,0,0,138,A
7-M,423,138,0,0,0,138,A
7-M,424,0,0,139,0,139,G
7-M,425,0,136,0,0,136,T
7-M,426,0,0,136,0,136,G
7-M,427,0,0,137,0,137,G
7-M,428,0,0,0,138,138,C
7-M,429,137,0,0,0,137,A
7-M,430,0,137,0,0,137,T
7-M,431,0,138,0,0,138,T
7-M,432,0,137,0,0,137,T
7-M,433,0,0,138,0,138,G
7-M,434,0,0,138,0,138,G
7-M,435,0,0,0,137,137,C
7-M,436,0,0,0,137,137,C
7-M,437,0,137,0,0,137,T
7-M,438,0,0,140,0,140,G
7-M,439,0,0,141,0,141,G
7-M,440,0,142,0,0,142,T
7-M,441,142,0,0,0,142,A
7-M,442,0,138,0,0,138,T
7-M,443,0,0,139,0,139,G
7-M,444,0,141,0,0,141,T
7-M,445,0,0,141,0,141,G
7-M,446,0,0,0,141,141,C
7-M,447,137,0,0,0,137,A
7-M,448,137,0,0,0,137,A
7-M,449,0,0,0,138,138,C
7-M,450,137,0,0,0,137,A
7-M,451,0,137,1,0,138,T
7-M,452,0,0,133,0,133,G
7-M,453,0,129,0,0,129,T
7-M,454,0,0,129,0,129,G
7-M,455,129,0,0,0,129,A
7-M,456,0,0,130,0,130,G
7-M,457,0,0,0,130,130,C
7-M,458,126,0,1,0,127,A
7-M,459,0,0,130,0,130,G
7-M,460,129,0,0,0,129,A
7-M,461,0,130,0,0,130,T
7-M,462,0,130,0,0,130,T
7-M,463,0,0,130,0,130,G
7-M,464,0,0,0,130,130,C
7-M,465,0,130,0,0,130,T
7-M,466,0,0,130,0,130,G
7-M,467,130,0,0,0,130,A
7-M,468,0,0,0,137,137,C
7-M,469,0,137,0,0,137,T
7-M,470,0,0,0,137,137,C
7-M,471,0,0,0,137,137,C
7-M,472,0,0,0,138,138,C
7-M,473,136,0,0,0,136,A
7-M,474,0,0,137,0,137,G
7-M,475,0,0,0,137,137,C
7-M,476,137,0,0,0,137,A
7-M,477,0,0,0,137,137,C
7-M,478,131,0,0,0,131,A
7-M,479,0,0,134,0,134,G
7-M,480,0,0,134,0,134,G
7-M,481,0,134,0,0,134,T
7-M,482,0,0,0,136,136,C
7-M,483,0,136,0,0,136,T
7-M,484,0,0,0,136,136,C
7-M,485,136,0,0,0,136,A
7-M,486,0,136,0,0,136,T
7-M,487,136,0,0,0,136,A
7-M,488,0,0,137,0,137,G
7-M,489,0,0,137,0,137,G
7-M,490,0,0,0,137,137,C
7-M,491,131,0,0,0,131,A
7-M,492,0,0,130,0,130,G
7-M,493,131,0,0,0,131,A
7-M,494,0,131,0,0,131,T
7-M,495,0,0,132,0,132,G
7-M,496,0,0,132,0,132,G
7-M,497,0,131,0,0,131,T
7-M,498,0,0,131,0,131,G
7-M,499,0,0,131,0,131,G
7-M,500,0,0,0,130,130,C
7-M,501,131,0,0,0,131,A
7-M,502,131,0,0,0,131,A
7-M,503,0,0,0,133,133,C
7-M,504,133,0,0,0,133,A
7-M,505,133,0,0,0,133,A
7-M,506,0,0,0,133,133,C
7-M,507,0,0,0,133,133,C
7-M,508,131,0,0,0,131,A
7-M,509,132,0,0,0,132,A
7-M,510,0,132,0,0,132,T
7-M,511,0,0,0,132,132,C
7-M,512,0,1,0,128,129,C
7-M,513,129,0,0,0,129,A
7-M,514,0,129,0,0,129,T
7-M,515,0,129,0,0,129,T
7-M,516,129,0,0,0,129,A
7-M,517,129,0,0,0,129,A
7-M,518,0,129,0,0,129,T
7-M,519,129,0,0,0,129,A
7-M,520,129,0,0,0,129,A
7-M,521,128,0,0,0,128,A
7-M,522,128,0,0,0,128,A
7-M,523,0,0,0,128,128,C
7-M,524,128,0,0,0,128,A
7-M,525,0,129,0,0,129,T
7-M,526,0,0,128,0,128,G
7-M,527,128,0,0,0,128,A
7-M,528,0,0,130,0,130,G
7-M,529,129,0,0,0,129,A
7-M,530,129,0,0,0,129,A
7-M,531,0,0,0,131,131,C
7-M,532,124,0,0,0,124,A
7-M,533,0,0,125,0,125,G
7-M,534,126,0,0,0,126,A
7-M,535,126,0,0,0,126,A
7-M,536,0,126,0,0,126,T
7-M,537,0,0,125,0,125,G
7-M,538,0,0,125,0,125,G
7-M,539,0,124,0,0,124,T
7-M,540,0,121,0,0,121,T
7-M,541,0,123,0,0,123,T
7-M,542,0,122,0,0,122,T
7-M,543,1,0,122,0,123,G
7-M,544,0,0,122,0,122,G
7-M,545,0,1,0,123,124,C
7-M,546,0,0,0,124,124,C
7-M,547,121,0,0,0,121,A
7-M,548,0,0,127,0,127,G
7-M,549,0,0,0,127,127,C
7-M,550,129,0,0,0,129,A
7-M,551,0,1,0,131,132,C
7-M,552,0,130,0,0,130,T
7-M,553,130,0,1,0,131,A
7-M,554,0,0,0,131,131,C
7-M,555,131,0,0,0,131,A
7-M,556,0,0,132,0,132,G
7-M,557,0,0,0,129,129,C
7-M,558,0,124,0,0,124,T
7-M,559,124,0,0,0,124,A
7-M,560,123,0,0,0,123,A
7-M,561,0,0,124,0,124,G
7-M,562,0,0,124,0,124,G
7-M,563,0,0,0,123,123,C
7-M,564,0,116,0,0,116,T
7-M,565,116,0,0,0,116,A
7-M,566,0,116,0,0,116,T
7-M,567,0,0,115,0,115,G
7-M,568,0,0,117,0,117,G
7-M,569,114,0,0,0,114,A
7-M,570,0,0,116,0,116,G
7-M,571,0,0,0,114,114,C
7-M,572,114,0,0,0,114,A
7-M,573,115,0,0,0,115,A
7-M,574,115,0,0,0,115,A
7-M,575,0,115,0,0,115,T
7-M,576,0,0,115,0,115,G
7-M,577,0,0,115,0,115,G
7-M,578,0,0,0,115,115,C
7-M,579,0,114,0,0,114,T
7-M,580,0,0,115,0,115,G
7-M,581,0,0,118,0,118,G
7-M,582,117,0,0,0,117,A
7-M,583,0,117,0,0,117,T
7-M,584,0,0,0,115,115,C
7-M,585,117,0,0,0,117,A
7-M,586,118,0,0,0,118,A
7-M,587,0,0,119,0,119,G
7-M,588,0,119,0,0,119,T
7-M,589,0,0,117,0,117,G
7-M,590,110,0,0,0,110,A
7-M,591,0,0,111,0,111,G
7-M,592,0,0,0,111,111,C
7-M,593,110,0,0,0,110,A
7-M,594,0,0,111,0,111,G
7-M,595,0,0,106,0,106,G
7-M,596,0,0,0,106,106,C
7-M,597,104,0,0,0,104,A
7-M,598,0,0,105,0,105,G
7-M,599,0,0,0,104,104,C
7-M,600,0,0,104,0,104,G
7-M,601,0,0,105,0,105,G
7-M,602,105,0,0,0,105,A
7-M,603,0,0,104,0,104,G
7-M,604,0,0,105,0,105,G
7-M,605,0,0,0,105,105,C
7-M,606,0,0,0,104,104,C
7-M,607,105,0,0,0,105,A
7-M,608,0,105,0,0,105,T
7-M,609,0,0,105,0,105,G
7-M,610,0,0,105,0,105,G
7-M,611,105,0,0,0,105,A
7-M,612,0,0,106,0,106,G
7-M,613,105,0,0,0,105,A
7-M,614,0,107,0,0,107,T
7-M,615,0,107,0,0,107,T
7-M,616,0,0,107,0,107,G
7-M,617,0,0,0,107,107,C
7-M,618,0,107,0,0,107,T
7-M,619,107,0,0,0,107,A
7-M,620,0,0,107,0,107,G
7-M,621,1,107,0,0,108,T
7-M,622,0,0,0,108,108,C
7-M,623,104,0,1,0,105,A
7-M,624,0,0,108,0,108,G
7-M,625,0,0,108,0,108,G
7-M,626,0,0,0,109,109,C
7-M,627,0,0,0,110,110,C
7-M,628,109,0,0,0,109,A
7-M,629,0,0,112,0,112,G
7-M,630,0,0,111,0,111,G
7-M,631,0,0,0,111,111,C
7-M,632,112,0,0,0,112,A
7-M,633,0,0,112,0,112,G
7-M,634,111,0,0,0,111,A
7-M,635,0,111,0,0,111,T
7-M,636,0,0,111,0,111,G
7-M,637,0,0,113,0,113,G
7-M,638,0,114,0,0,114,T
7-M,639,0,0,114,0,114,G
7-M,640,0,0,0,114,114,C
7-M,641,111,0,0,0,111,A
7-M,642,0,0,113,0,113,G
7-M,643,0,0,112,0,112,G
7-M,644,0,0,0,115,115,C
7-M,645,113,0,0,0,113,A
7-M,646,113,0,0,0,113,A
7-M,647,0,112,0,0,112,T
7-M,648,0,0,111,1,112,G
7-M,649,110,0,0,0,110,A
7-M,650,0,0,112,0,112,G
7-M,651,108,0,0,0,108,A
7-M,652,0,0,109,0,109,G
7-M,653,0,0,0,109,109,C
7-M,654,0,0,0,111,111,C
7-M,655,111,0,0,0,111,A
7-M,656,0,109,0,0,109,T
7-M,657,0,111,0,0,111,T
7-M,658,0,0,110,0,110,G
7-M,659,0,0,109,0,109,G
7-M,660,0,0,110,0,110,G
7-M,661,112,0,0,0,112,A
7-M,662,0,0,0,111,111,C
7-M,663,0,107,0,0,107,T
7-M,664,0,0,0,110,110,C
7-M,665,110,1,0,0,111,A
7-M,666,0,114,0,0,114,T
7-M,667,0,0,0,115,115,C
7-M,668,0,0,0,114,114,C
7-M,669,0,114,0,0,114,T
7-M,670,112,0,0,0,112,A
7-M,671,0,0,114,0,114,G
7-M,672,0,122,0,1,123,T
7-M,673,0,124,0,0,124,T
7-M,674,0,0,0,123,123,C
7-M,675,0,0,0,121,121,C
7-M,676,123,0,0,0,123,A
7-M,677,0,0,125,0,125,G
7-M,678,0,125,0,0,125,T
7-M,679,124,0,0,0,124,A
7-M,680,0,0,0,123,123,C
7-M,681,0,107,0,0,107,T
7-M,682,0,0,114,0,114,G
7-M,683,0,0,116,0,116,G
7-M,684,0,117,0,0,117,T
7-M,685,0,0,0,117,117,C
7-M,686,1,115,0,0,116,T
7-M,687,116,0,0,0,116,A
7-M,688,115,0,0,0,115,A
7-M,689,0,0,117,0,117,G
7-M,690,117,0,0,0,117,A
7-M,691,0,0,115,0,115,G
7-M,692,108,0,0,0,108,A
7-M,693,0,107,0,0,107,T
7-M,694,0,0,107,0,107,G
7-M,695,107,0,0,0,107,A
7-M,696,0,107,0,0,107,T
7-M,697,0,0,0,106,106,C
7-M,698,0,106,0,0,106,T
7-M,699,0,105,0,0,105,T
7-M,700,1,0,0,105,106,C
7-M,701,0,105,0,0,105,T
7-M,702,0,105,0,1,106,T
7-M,703,0,0,106,0,106,G
7-M,704,106,0,0,0,106,A
7-M,705,106,0,0,0,106,A
7-M,706,105,0,1,0,106,A
7-M,707,105,0,0,0,105,A
7-M,708,0,107,0,0,107,T
7-M,709,0,109,0,0,109,T
7-M,710,0,109,0,0,109,T
7-M,711,0,0,109,0,109,G
7-M,712,0,0,0,109,109,C
7-M,713,109,0,0,0,109,A
7-M,714,0,0,109,0,109,G
7-M,715,108,0,0,0,108,A
7-M,716,0,0,0,111,111,C
7-M,717,1,0,0,109,110,C
7-M,718,0,109,0,0,109,T
7-M,719,110,0,0,0,110,A
7-M,720,0,110,0,0,110,T
7-M,721,0,0,0,109,109,C
7-M,722,110,0,0,0,110,A
7-M,723,0,0,109,0,109,G
7-M,724,109,0,0,0,109,A
7-M,725,105,0,0,0,105,A
7-M,726,105,0,0,0,105,A
7-M,727,0,0,0,105,105,C
7-M,728,0,0,104,0,104,G
7-M,729,104,0,0,0,104,A
7-M,730,104,0,0,0,104,A
7-M,731,0,103,1,0,104,T
7-M,732,0,0,104,0,104,G
7-M,733,0,0,104,0,104,G
7-M,734,0,0,102,0,102,G
7-M,735,0,0,103,0,103,G
7-M,736,0,0,103,0,103,G
7-M,737,0,102,0,0,102,T
7-M,738,0,0,103,0,103,G
7-M,739,0,0,0,102,102,C
7-M,740,103,0,0,0,103,A
7-M,741,0,0,103,0,103,G
7-M,742,101,0,0,0,101,A
7-M,743,0,101,0,0,101,T
7-M,744,0,0,100,0,100,G
7-M,745,0,0,0,100,100,C
7-M,746,100,0,0,0,100,A
7-M,747,100,0,0,0,100,A
7-M,748,0,0,0,101,101,C
7-M,749,0,0,101,0,101,G
7-M,750,101,0,0,0,101,A
7-M,751,0,98,0,0,98,T
7-M,752,0,100,0,0,100,T
7-M,753,0,0,0,98,98,C
7-M,754,100,0,0,0,100,A
7-M,755,100,0,0,0,100,A
7-M,756,0,0,100,0,100,G
7-M,757,0,99,0,0,99,T
7-M,758,0,0,98,0,98,G
7-M,759,99,0,0,0,99,A
7-M,760,0,0,0,98,98,C
7-M,761,0,0,0,98,98,C
7-M,762,0,0,0,99,99,C
7-M,763,0,0,100,0,100,G
7-M,764,0,0,0,100,100,C
7-M,765,0,98,0,0,98,T
7-M,766,0,98,0,0,98,T
7-M,767,0,0,100,0,100,G
7-M,768,0,99,0,0,99,T
7-M,769,0,101,0,0,101,T
7-M,770,0,0,101,0,101,G
7-M,771,0,101,0,0,101,T
7-M,772,0,100,0,0,100,T
7-M,773,0,0,101,0,101,G
7-M,774,0,0,0,100,100,C
7-M,775,0,1,0,100,101,C
7-M,776,0,0,101,0,101,G
7-M,777,0,0,0,99,99,C
7-M,778,0,0,100,0,100,G
7-M,779,101,0,0,0,101,A
7-M,780,101,0,0,0,101,A
7-M,781,0,103,0,0,103,T
7-M,782,104,0,0,0,104,A
7-M,783,0,104,0,0,104,T
7-M,784,0,0,0,107,107,C
7-M,785,107,0,0,0,107,A
7-M,786,0,107,0,0,107,T
7-M,787,0,106,0,0,106,T
7-M,788,0,0,106,0,106,G
7-M,789,0,0,104,0,104,G
7-M,790,0,0,106,0,106,G
7-M,791,104,0,0,0,104,A
7-M,792,0,105,0,0,105,T
7-M,793,0,0,0,102,102,C
7-M,794,0,102,0,0,102,T
7-M,795,0,102,0,0,102,T
7-M,796,0,0,104,0,104,G
7-M,797,0,0,0,104,104,C
7-M,798,103,0,0,0,103,A
7-M,799,0,0,0,104,104,C
7-M,800,0,100,0,0,100,T
7-M,801,0,99,0,0,99,T
7-M,802,0,0,101,0,101,G
7-M,803,101,0,0,0,101,A
7-M,804,0,101,0,0,101,T
7-M,805,103,0,0,0,103,A
7-M,806,0,103,0,0,103,T
7-M,807,0,103,0,0,103,T
7-M,808,0,0,103,0,103,G
7-M,809,0,102,0,0,102,T
7-M,810,1,0,100,0,101,G
7-M,811,0,0,101,0,101,G
7-M,812,97,0,0,0,97,A
7-M,813,0,99,0,0,99,T
7-M,814,0,97,0,0,97,T
7-M,815,0,0,0,96,96,C
7-M,816,0,97,0,0,97,T
7-M,817,0,95,0,0,95,T
7-M,818,0,0,94,0,94,G
7-M,819,95,0,0,0,95,A
7-M,820,0,95,0,0,95,T
7-M,821,0,0,0,93,93,C
7-M,822,0,0,92,0,92,G
7-M,823,0,92,0,0,92,T
7-M,824,0,0,0,92,92,C
7-M,825,0,92,0,0,92,T
7-M,826,0,92,0,0,92,T
7-M,827,0,92,0,0,92,T
7-M,828,0,92,0,0,92,T
7-M,829,0,91,0,0,91,T
7-M,830,0,90,0,0,90,T
7-M,831,0,91,0,0,91,T
7-M,832,0,0,0,91,91,C
7-M,833,91,0,0,0,91,A
7-M,834,91,0,0,0,91,A
7-M,835,91,0,0,0,91,A
7-M,836,0,91,0,0,91,T
7-M,837,0,0,92,0,92,G
7-M,838,0,0,0,92,92,C
7-M,839,0,0,92,0,92,G
7-M,840,0,93,0,0,93,T
7-M,841,0,0,0,93,93,C
7-M,842,0,92,0,0,92,T
7-M,843,93,0,0,0,93,A
7-M,844,0,92,0,0,92,T
7-M,845,0,0,0,93,93,C
7-M,846,0,0,93,0,93,G
7-M,847,92,0,0,0,92,A
7-M,848,0,0,0,92,92,C
7-M,849,0,89,0,0,89,T
7-M,850,0,0,0,90,90,C
7-M,851,0,88,0,1,89,T
7-M,852,0,90,0,0,90,T
7-M,853,0,0,0,90,90,C
7-M,854,90,0,0,0,90,A
7-M,855,89,0,0,0,89,A
7-M,856,90,0,0,0,90,A
7-M,857,0,0,0,89,89,C
7-M,858,89,0,0,0,89,A
7-M,859,0,0,0,84,84,C
7-M,860,0,0,83,0,83,G
7-M,861,0,0,84,0,84,G
7-M,862,0,0,0,84,84,C
7-M,863,0,0,0,84,84,C
7-M,864,0,84,0,0,84,T
7-M,865,0,84,0,0,84,T
7-M,866,84,0,0,0,84,A
7-M,867,84,0,0,0,84,A
7-M,868,84,0,0,0,84,A
7-M,869,82,0,0,0,82,A
7-M,870,0,0,82,0,82,G
7-M,871,71,0,0,0,71,A
7-M,872,0,0,71,0,71,G
7-M,873,0,0,71,0,71,G
7-M,874,0,0,0,71,71,C
7-M,875,0,0,0,70,70,C
7-M,876,1,0,0,72,73,C
7-M,877,0,72,0,0,72,T
7-M,878,0,72,0,0,72,T
7-M,879,0,0,0,72,72,C
7-M,880,0,72,0,0,72,T
7-M,881,73,0,0,0,73,A
7-M,882,0,0,0,72,72,C
7-M,883,0,0,70,0,70,G
7-M,884,0,0,70,0,70,G
7-M,885,68,0,0,0,68,A
7-M,886,68,0,0,0,68,A
7-M,887,0,0,68,0,68,G
7-M,888,0,0,67,0,67,G
7-M,889,68,0,0,0,68,A
7-M,890,0,0,68,0,68,G
7-M,891,0,68,0,0,68,T
7-M,892,69,0,0,0,69,A
7-M,893,0,0,0,69,69,C
7-M,894,0,0,0,68,68,C
7-M,895,0,68,0,0,68,T
7-M,896,0,0,68,0,68,G
7-M,897,64,0,0,0,64,A
7-M,898,0,0,65,0,65,G
7-M,899,0,61,0,0,61,T
7-M,900,0,0,0,61,61,C
7-M,901,0,59,0,0,59,T
7-M,902,60,0,0,0,60,A
7-M,903,0,60,0,0,60,T
7-M,904,0,0,61,0,61,G
7-M,905,60,0,0,0,60,A
7-M,906,0,0,60,0,60,G
7-M,907,0,0,57,0,57,G
7-M,908,0,0,57,0,57,G
7-M,909,57,0,0,0,57,A
7-M,910,57,0,0,0,57,A
7-M,911,0,0,58,0,58,G
7-M,912,58,0,0,0,58,A
7-M,913,60,0,0,0,60,A
7-M,914,0,60,0,0,60,T
7-M,915,59,0,0,0,59,A
7-M,916,0,59,0,0,59,T
7-M,917,0,2,1,56,59,C
7-M,918,0,0,59,0,59,G
7-M,919,58,0,0,0,58,A
7-M,920,58,0,0,0,58,A
7-M,921,58,0,0,0,58,A
7-M,922,0,0,57,0,57,G
7-M,923,0,0,57,0,57,G
7-M,924,57,0,0,0,57,A
7-M,925,57,0,0,0,57,A
7-M,926,0,0,0,57,57,C
7-M,927,57,0,0,0,57,A
7-M,928,0,0,58,0,58,G
7-M,929,0,0,0,58,58,C
7-M,930,58,0,0,0,58,A
7-M,931,0,0,58,0,58,G
7-M,932,57,0,0,0,57,A
7-M,933,57,0,0,0,57,A
7-M,934,0,57,0,0,57,T
7-M,935,0,0,56,0,56,G
7-M,936,0,0,0,56,56,C
7-M,937,0,55,0,0,55,T
7-M,938,0,0,55,0,55,G
7-M,939,0,54,0,0,54,T
7-M,940,0,0,54,0,54,G
7-M,941,0,0,54,0,54,G
7-M,942,53,0,0,0,53,A
7-M,943,0,53,0,0,53,T
7-M,944,0,0,49,0,49,G
7-M,945,0,0,0,48,48,C
7-M,946,0,42,0,0,42,T
7-M,947,0,0,42,0,42,G
7-M,948,42,0,0,0,42,A
7-M,949,0,0,0,39,39,C
7-M,950,0,0,39,0,39,G
7-M,951,36,0,0,0,36,A
7-M,952,0,0,0,36,36,C
7-M,953,36,0,0,0,36,A
7-M,954,0,0,36,0,36,G
7-M,955,0,35,0,0,35,T
7-M,956,0,0,0,36,36,C
7-M,957,36,0,0,0,36,A
7-M,958,0,36,0,0,36,T
7-M,959,0,36,0,0,36,T
7-M,960,0,36,0,0,36,T
7-M,961,0,36,0,0,36,T
7-M,962,0,0,36,0,36,G
7-M,963,0,36,0,0,36,T
7-M,964,0,0,0,36,36,C
7-M,965,35,0,0,0,35,A
7-M,966,0,0,35,0,35,G
7-M,967,0,0,0,35,35,C
7-M,968,35,0,0,0,35,A
7-M,969,0,35,0,0,35,T
7-M,970,35,0,0,0,35,A
7-M,971,0,0,35,0,35,G
7-M,972,35,0,0,0,35,A
7-M,973,0,0,35,0,35,G
7-M,974,0,35,0,0,35,T
7-M,975,0,25,0,0,25,T
7-M,976,0,0,25,0,25,G
7-M,977,0,0,25,0,25,G
7-M,978,25,0,0,0,25,A
7-M,979,0,0,25,0,25,G
7-M,980,0,18,0,0,18,T
7-M,981,16,0,0,0,16,A
7-M,982,16,0,0,0,16,A
8-NS,1,217,0,0,0,217,A
8-NS,2,0,218,0,0,218,T
8-NS,3,0,0,229,0,229,G
8-NS,4,0,0,250,0,250,G
8-NS,5,279,0,0,0,279,A
8-NS,6,0,620,0,0,620,T
8-NS,7,0,619,0,1,620,T
8-NS,8,0,0,0,646,646,C
8-NS,9,0,0,0,647,647,C
8-NS,10,647,0,0,0,647,A
8-NS,11,652,0,0,0,652,A
8-NS,12,0,1,0,652,653,C
8-NS,13,654,1,1,0,656,A
8-NS,14,0,0,0,660,660,C
8-NS,15,0,661,0,0,661,T
8-NS,16,0,0,736,0,736,G
8-NS,17,0,738,0,0,738,T
8-NS,18,0,0,743,0,743,G
8-NS,19,0,741,0,3,744,T
8-NS,20,1,0,0,746,747,C
8-NS,21,745,0,0,0,745,A
8-NS,22,743,0,1,0,744,A
8-NS,23,0,0,757,0,757,G
8-NS,24,0,775,0,0,775,T
8-NS,25,0,764,0,2,766,T
8-NS,26,0,782,0,0,782,T
8-NS,27,0,1,0,781,782,C
8-NS,28,0,0,0,786,786,C
8-NS,29,784,0,0,0,784,A
8-NS,30,0,0,788,0,788,G
8-NS,31,0,0,793,0,793,G
8-NS,32,0,794,0,0,794,T
8-NS,33,793,1,0,1,795,A
8-NS,34,0,0,803,0,803,G
8-NS,35,801,1,0,0,802,A
8-NS,36,0,806,0,0,806,T
8-NS,37,0,805,0,0,805,T
8-NS,38,2,0,816,0,818,G
8-NS,39,0,0,0,819,819,C
8-NS,40,0,817,0,0,817,T
8-NS,41,0,829,0,0,829,T
8-NS,42,0,830,0,1,831,T
8-NS,43,0,0,0,847,847,C
8-NS,44,0,844,0,2,846,T
8-NS,45,0,845,0,1,846,T
8-NS,46,1,845,0,0,846,T
8-NS,47,0,0,858,0,858,G
8-NS,48,2,0,853,0,855,G
8-NS,49,0,0,1,857,858,C
8-NS,50,856,0,0,0,856,A
8-NS,51,1,858,0,0,859,T
8-NS,52,866,2,0,0,868,A
8-NS,53,0,891,0,0,891,T
8-NS,54,0,0,0,895,895,C
8-NS,55,1,1,0,891,893,C
8-NS,56,2,0,890,0,892,G
8-NS,57,0,0,896,0,896,G
8-NS,58,893,1,0,0,894,A
8-NS,59,896,0,0,0,896,A
8-NS,60,898,0,0,0,898,A
8-NS,61,0,1,0,910,911,C
8-NS,62,918,1,0,0,919,A
8-NS,63,924,0,0,0,924,A
8-NS,64,0,0,960,0,960,G
8-NS,65,0,965,0,1,966,T
8-NS,66,0,965,0,0,965,T
8-NS,67,0,0,964,0,964,G
8-NS,68,0,964,0,0,964,T
8-NS,69,961,0,1,0,962,A
8-NS,70,0,0,972,0,972,G
8-NS,71,1028,0,0,0,1028,A
8-NS,72,0,0,0,1045,1045,C
8-NS,73,2,0,0,1040,1042,C
8-NS,74,1043,0,0,0,1043,A
8-NS,75,1046,0,1,0,1047,A
8-NS,76,0,0,1102,0,1102,G
8-NS,77,1102,0,0,0,1102,A
8-NS,78,1112,0,0,0,1112,A
8-NS,79,0,1,0,1112,1113,C
8-NS,80,0,1104,0,0,1104,T
8-NS,81,0,0,1114,0,1114,G
8-NS,82,1111,0,4,0,1115,A
8-NS,83,0,0,1135,0,1135,G
8-NS,84,0,1135,0,1,1136,T
8-NS,85,0,0,1127,0,1127,G
8-NS,86,1130,1,1,0,1132,A
8-NS,87,0,1127,0,0,1127,T
8-NS,88,0,0,1138,0,1138,G
8-NS,89,1,1,0,1142,1144,C
8-NS,90,0,0,0,1140,1140,C
8-NS,91,3,0,0,1147,1150,C
8-NS,92,0,0,0,1147,1147,C
8-NS,93,1150,0,0,0,1150,A
8-NS,94,0,1163,0,0,1163,T
8-NS,95,0,1173,0,0,1173,T
8-NS,96,0,0,0,1185,1185,C
8-NS,97,0,0,1,1175,1176,C
8-NS,98,1,1181,0,0,1182,T
8-NS,99,0,1179,0,1,1180,T
8-NS,100,0,2,1178,0,1180,G
8-NS,101,1179,0,0,0,1179,A
8-NS,102,0,1176,0,0,1176,T
8-NS,103,0,2,0,1173,1175,C
8-NS,104,0,1,1175,0,1176,G
8-NS,105,0,2,1179,0,1181,G
8-NS,106,0,0,0,1177,1177,C
8-NS,107,0,1175,1,2,1178,T
8-NS,108,0,1181,0,0,1181,T
8-NS,109,2,1,0,1178,1181,C
8-NS,110,0,0,1195,0,1195,G
8-NS,111,0,0,0,1197,1197,C
8-NS,112,0,1,0,1190,1191,C
8-NS,113,1,0,1198,0,1199,G
8-NS,114,1191,0,0,0,1191,A
8-NS,115,0,1,1246,0,1247,G
8-NS,116,1243,0,1,0,1244,A
8-NS,117,0,1246,0,1,1247,T
8-NS,118,0,0,0,1245,1245,C
8-NS,119,1243,0,3,0,1246,A
8-NS,120,0,0,1255,0,1255,G
8-NS,121,1250,0,5,0,1255,A
8-NS,122,0,0,1254,0,1254,G
8-NS,123,0,0,1268,0,1268,G
8-NS,124,0,1279,0,3,1282,T
8-NS,125,0,1,1,1370,1372,C
8-NS,126,0,1,0,1376,1377,C
8-NS,127,0,0,0,1382,1382,C
8-NS,128,0,1385,0,1,1386,T
8-NS,129,1391,0,0,0,1391,A
8-NS,130,1390,1,0,0,1391,A
8-NS,131,0,2,1405,0,1407,G
8-NS,132,1,3,1405,0,1409,G
8-NS,133,3,0,1398,0,1401,G
8-NS,134,0,2,1372,1,1375,G
8-NS,135,1378,0,1,0,1379,A
8-NS,136,1376,0,0,0,1376,A
8-NS,137,0,1,1385,0,1386,G
8-NS,138,1419,0,0,0,1419,A
8-NS,139,0,0,1435,0,1435,G
8-NS,140,1,1,1431,0,1433,G
8-NS,141,0,0,0,1433,1433,C
8-NS,142,1433,0,0,1,1434,A
8-NS,143,1433,1,0,0,1434,A
8-NS,144,0,1437,0,0,1437,T
8-NS,145,1445,0,0,0,1445,A
8-NS,146,0,0,0,1468,1468,C
8-NS,147,0,1450,0,1,1451,T
8-NS,148,0,0,0,1451,1451,C
8-NS,149,0,1433,2,5,1440,T
8-NS,150,1,2,0,1448,1451,C
8-NS,151,1,0,1462,0,1463,G
8-NS,152,0,0,1545,0,1545,G
8-NS,153,1,1544,0,0,1545,T
8-NS,154,1,0,0,1552,1553,C
8-NS,155,0,1546,0,0,1546,T
8-NS,156,1576,0,0,0,1576,A
8-NS,157,2,1,1574,0,1577,G
8-NS,158,1578,1,0,0,1579,A
8-NS,159,0,1,1,1606,1608,C
8-NS,160,1588,0,1,0,1589,A
8-NS,161,0,1569,1,0,1570,T
8-NS,162,0,0,0,1573,1573,C
8-NS,163,1577,1,0,0,1578,A
8-NS,164,1582,0,0,0,1582,A
8-NS,165,1570,0,0,0,1570,A
8-NS,166,0,0,1580,0,1580,G
8-NS,167,0,1,0,1582,1583,C
8-NS,168,1572,0,0,0,1572,A
8-NS,169,0,0,1571,0,1571,G
8-NS,170,0,0,0,1572,1572,C
8-NS,171,2,2,0,1576,1580,C
8-NS,172,1586,1,0,0,1587,A
8-NS,173,0,0,0,1598,1598,C
8-NS,174,2,0,0,1598,1600,C
8-NS,175,1,0,1,1600,1602,C
8-NS,176,1624,0,0,0,1624,A
8-NS,177,1,1626,1,1,1629,T
8-NS,178,0,0,1634,0,1634,G
8-NS,179,2,1604,0,28,1634,T
8-NS,180,0,1625,0,3,1628,T
8-NS,181,0,0,1628,0,1628,G
8-NS,182,0,2,1629,0,1631,G
8-NS,183,1631,1,0,0,1632,A
8-NS,184,1632,0,0,0,1632,A
8-NS,185,1608,4,3,0,1615,A
8-NS,186,0,0,1628,0,1628,G
8-NS,187,0,1,0,1630,1631,C
8-NS,188,1626,0,0,0,1626,A
8-NS,189,1624,0,0,0,1624,A
8-NS,190,1625,0,0,0,1625,A
8-NS,191,0,1632,0,0,1632,T
8-NS,192,1,1634,0,0,1635,T
8-NS,193,0,0,1662,0,1662,G
8-NS,194,0,1658,0,3,1661,T
8-NS,195,1654,0,2,0,1656,A
8-NS,196,0,0,1659,1,1660,G
8-NS,197,1657,0,1,0,1658,A
8-NS,198,1650,1,0,0,1651,A
8-NS,199,1655,0,0,1,1656,A
8-NS,200,1648,0,0,0,1648,A
8-NS,201,0,0,1659,0,1659,G
8-NS,202,1645,1,0,0,1646,A
8-NS,203,0,1646,0,0,1646,T
8-NS,204,0,1648,0,0,1648,T
8-NS,205,0,0,0,1650,1650,C
8-NS,206,0,1649,0,1,1650,T
8-NS,207,0,0,1648,0,1648,G
8-NS,208,1643,1,1,1,1646,A
8-NS,209,1641,0,1,0,1642,A
8-NS,210,1643,0,0,0,1643,A
8-NS,211,0,0,1646,0,1646,G
8-NS,212,1648,0,1,0,1649,A
8-NS,213,1649,0,0,0,1649,A
8-NS,214,0,0,1650,0,1650,G
8-NS,215,1657,0,1,0,1658,A
8-NS,216,1666,1,1,0,1668,A
8-NS,217,0,1672,0,0,1672,T
8-NS,218,0,0,0,1686,1686,C
8-NS,219,0,1684,0,0,1684,T
8-NS,220,0,0,1693,0,1693,G
8-NS,221,1689,1,1,0,1691,A
8-NS,222,0,1690,0,1,1691,T
8-NS,223,0,0,1685,0,1685,G
8-NS,224,1673,0,2,0,1675,A
8-NS,225,0,0,1674,0,1674,G
8-NS,226,1,0,1676,1,1678,G
8-NS,227,0,1,0,1674,1675,C
8-NS,228,1675,0,0,0,1675,A
8-NS,229,0,0,0,1712,1712,C
8-NS,230,0,1705,0,0,1705,T
8-NS,231,1,1711,0,2,1714,T
8-NS,232,1718,0,0,0,1718,A
8-NS,233,1724,0,0,0,1724,A
8-NS,234,1715,0,0,0,1715,A
8-NS,235,1717,0,0,0,1717,A
8-NS,236,0,1717,0,1,1718,T
8-NS,237,0,2,1712,0,1714,G
8-NS,238,1715,0,0,0,1715,A
8-NS,239,0,0,0,1717,1717,C
8-NS,240,0,0,0,1712,1712,C
8-NS,241,1713,0,0,0,1713,A
8-NS,242,1,1708,1,0,1710,T
8-NS,243,0,0,1742,0,1742,G
8-NS,244,0,0,1767,0,1767,G
8-NS,245,1,1774,0,2,1777,T
8-NS,246,2,0,0,1827,1829,C
8-NS,247,0,1815,1,3,1819,T
8-NS,248,2,0,0,1838,1840,C
8-NS,249,0,0,1,1843,1844,C
8-NS,250,1849,0,0,0,1849,A
8-NS,251,1,0,0,1864,1865,C
8-NS,252,1842,1,1,0,1844,A
8-NS,253,0,0,2,1835,1837,C
8-NS,254,0,0,0,1824,1824,C
8-NS,255,0,1773,0,2,1775,T
8-NS,256,0,1,1781,0,1782,G
8-NS,257,0,0,0,1772,1772,C
8-NS,258,0,1771,0,1,1772,T
8-NS,259,1,1781,0,0,1782,T
8-NS,260,0,0,0,1770,1770,C
8-NS,261,0,0,1778,0,1778,G
8-NS,262,0,0,0,1779,1779,C
8-NS,263,0,0,1774,1,1775,G
8-NS,264,1840,0,0,0,1840,A
8-NS,265,1,1829,0,0,1830,T
8-NS,266,1868,0,1,0,1869,A
8-NS,267,0,0,0,1875,1875,C
8-NS,268,1867,1,1,0,1869,A
8-NS,269,0,1919,0,1,1920,T
8-NS,270,1905,0,0,0,1905,A
8-NS,271,1914,0,0,0,1914,A
8-NS,272,0,0,0,1916,1916,C
8-NS,273,0,1853,0,1,1854,T
8-NS,274,0,0,1875,0,1875,G
8-NS,275,1853,0,2,0,1855,A
8-NS,276,0,0,1,1861,1862,C
8-NS,277,1859,0,1,0,1860,A
8-NS,278,0,1845,0,3,1848,T
8-NS,279,0,0,1856,0,1856,G
8-NS,280,1854,0,0,0,1854,A
8-NS,281,0,0,0,1894,1894,C
8-NS,282,0,1889,0,2,1891,T
8-NS,283,1901,0,0,0,1901,A
8-NS,284,0,1898,1,0,1899,T
8-NS,285,1,1893,0,0,1894,T
8-NS,286,1,0,1896,0,1897,G
8-NS,287,1888,0,0,0,1888,A
8-NS,288,1,0,1888,0,1889,G
8-NS,289,0,0,1887,0,1887,G
8-NS,290,1849,0,0,0,1849,A
8-NS,291,1861,1,1,0,1863,A
8-NS,292,0,1823,0,0,1823,T
8-NS,293,3,1818,0,1,1822,T
8-NS,294,1,0,1863,0,1864,G
8-NS,295,0,1857,0,2,1859,T
8-NS,296,0,0,0,1860,1860,C
8-NS,297,1856,1,0,0,1857,A
8-NS,298,1862,0,0,0,1862,A
8-NS,299,0,1,1866,0,1867,G
8-NS,300,1868,1,0,0,1869,A
8-NS,301,1871,0,1,0,1872,A
8-NS,302,1869,1,0,0,1870,A
8-NS,303,0,1,0,1871,1872,C
8-NS,304,0,1845,0,0,1845,T
8-NS,305,0,0,1868,0,1868,G
8-NS,306,1,0,1895,0,1896,G
8-NS,307,1,1896,0,1,1898,T
8-NS,308,0,1893,1,0,1894,T
8-NS,309,1,2,0,1884,1887,C
8-NS,310,1888,0,3,0,1891,A
8-NS,311,0,1920,1,0,1921,T
8-NS,312,1,3,1927,0,1931,G
8-NS,313,0,0,0,1947,1947,C
8-NS,314,0,1926,0,0,1926,T
8-NS,315,1909,0,5,0,1914,A
8-NS,316,1960,0,0,0,1960,A
8-NS,317,0,1970,0,0,1970,T
8-NS,318,1,0,1973,0,1974,G
8-NS,319,0,0,0,1972,1972,C
8-NS,320,1,0,0,1954,1955,C
8-NS,321,2,0,0,1952,1954,C
8-NS,322,1944,0,0,0,1944,A
8-NS,323,1958,0,3,0,1961,A
8-NS,324,1,0,1966,0,1967,G
8-NS,325,1,0,0,1967,1968,C
8-NS,326,1959,0,2,0,1961,A
8-NS,327,0,0,1965,0,1965,G
8-NS,328,1954,0,3,0,1957,A
8-NS,329,1965,0,1,0,1966,A
8-NS,330,1971,0,1,0,1972,A
8-NS,331,0,0,1991,0,1991,G
8-NS,332,0,1982,1,2,1985,T
8-NS,333,0,2,1977,1,1980,G
8-NS,334,0,0,1981,0,1981,G
8-NS,335,1980,0,0,1,1981,A
8-NS,336,1961,1,4,0,1966,A
8-NS,337,0,2,1964,0,1966,G
8-NS,338,0,0,1978,0,1978,G
8-NS,339,1979,1,1,0,1981,A
8-NS,340,2,0,0,1964,1966,C
8-NS,341,1,0,0,1954,1955,C
8-NS,342,0,1951,0,1,1952,T
8-NS,343,1,0,0,1981,1982,C
8-NS,344,0,1980,1,0,1981,T
8-NS,345,0,1989,1,1,1991,T
8-NS,346,0,1991,0,0,1991,T
8-NS,347,0,1,1988,0,1989,G
8-NS,348,0,1,0,2000,2001,C
8-NS,349,1994,0,1,0,1995,A
8-NS,350,0,1994,1,0,1995,T
8-NS,351,1,2,0,1990,1993,C
8-NS,352,2002,0,0,0,2002,A
8-NS,353,1,0,2061,0,2062,G
8-NS,354,2052,1,0,1,2054,A
8-NS,355,2063,0,0,0,2063,A
8-NS,356,0,2054,0,1,2055,T
8-NS,357,0,0,2027,0,2027,G
8-NS,358,6,3,2031,0,2040,G
8-NS,359,2042,0,2,0,2044,A
8-NS,360,1,0,0,2031,2032,C
8-NS,361,2,0,0,1996,1998,C
8-NS,362,1956,0,4,1,1961,A
8-NS,363,0,0,1980,0,1980,G
8-NS,364,0,0,1985,0,1985,G
8-NS,365,1,0,0,1984,1985,C
8-NS,366,1968,0,1,0,1969,A
8-NS,367,1976,0,0,0,1976,A
8-NS,368,0,1968,2,3,1973,T
8-NS,369,1,1,0,1972,1974,C
8-NS,370,1971,0,0,0,1971,A
8-NS,371,0,1962,0,4,1966,T
8-NS,372,1,2,1944,0,1947,G
8-NS,373,0,0,1957,0,1957,G
8-NS,374,1951,1,1,0,1953,A
8-NS,375,1,0,1969,0,1970,G
8-NS,376,1948,1,0,0,1949,A
8-NS,377,1945,1,0,0,1946,A
8-NS,378,1948,0,0,2,1950,A
8-NS,379,1949,0,0,0,1949,A
8-NS,380,1950,0,1,0,1951,A
8-NS,381,0,0,0,1956,1956,C
8-NS,382,1944,0,1,0,1945,A
8-NS,383,0,1945,0,1,1946,T
8-NS,384,0,0,0,1934,1934,C
8-NS,385,1935,0,2,0,1937,A
8-NS,386,1,1939,0,0,1940,T
8-NS,387,0,1,1945,0,1946,G
8-NS,388,0,1944,0,1,1945,T
8-NS,389,0,1930,0,2,1932,T
8-NS,390,0,0,1929,0,1929,G
8-NS,391,1921,0,0,0,1921,A
8-NS,392,1920,0,0,0,1920,A
8-NS,393,1920,0,1,0,1921,A
8-NS,394,1,1,1921,0,1923,G
8-NS,395,0,1,0,1914,1915,C
8-NS,396,0,1,1917,0,1918,G
8-NS,397,1917,0,1,0,1918,A
8-NS,398,1912,0,2,0,1914,A
8-NS,399,0,1916,0,0,1916,T
8-NS,400,1,1908,0,4,1913,T
8-NS,401,2,1914,0,0,1916,T
8-NS,402,1,0,0,1924,1925,C
8-NS,403,1916,0,0,0,1916,A
8-NS,404,0,1,1915,1,1917,G
8-NS,405,0,1918,0,0,1918,T
8-NS,406,0,0,1916,0,1916,G
8-NS,407,0,1910,0,3,1913,T
8-NS,408,0,2,1912,0,1914,G
8-NS,409,1909,1,0,0,1910,A
8-NS,410,0,1914,0,1,1915,T
8-NS,411,0,1909,0,0,1909,T
8-NS,412,0,1912,0,1,1913,T
8-NS,413,0,1912,0,0,1912,T
8-NS,414,0,1910,0,0,1910,T
8-NS,415,0,1,1910,0,1911,G
8-NS,416,1908,0,3,0,1911,A
8-NS,417,4,1892,0,1,1897,T
8-NS,418,1,0,0,1903,1904,C
8-NS,419,0,2,1904,0,1906,G
8-NS,420,2038,1,0,0,2039,A
8-NS,421,0,1,0,2050,2051,C
8-NS,422,0,2053,0,0,2053,T
8-NS,423,2061,0,0,0,2061,A
8-NS,424,1,0,2057,0,2058,G
8-NS,425,2058,0,3,0,2061,A
8-NS,426,0,0,2078,1,2079,G
8-NS,427,2078,1,2,0,2081,A
8-NS,428,1,0,0,2132,2133,C
8-NS,429,0,0,1,2018,2019,C
8-NS,430,1983,0,0,0,1983,A
8-NS,431,0,2071,0,0,2071,T
8-NS,432,2071,0,1,0,2072,A
8-NS,433,0,0,2196,0,2196,G
8-NS,434,0,2181,0,0,2181,T
8-NS,435,2162,1,0,0,2163,A
8-NS,436,0,2165,0,0,2165,T
8-NS,437,0,2110,0,0,2110,T
8-NS,438,2169,0,0,0,2169,A
8-NS,439,1,0,0,2163,2164,C
8-NS,440,0,2061,0,1,2062,T
8-NS,441,2058,0,0,1,2059,A
8-NS,442,1889,0,2,0,1891,A
8-NS,443,0,2,1904,0,1906,G
8-NS,444,0,0,1907,0,1907,G
8-NS,445,1,0,1906,0,1907,G
8-NS,446,0,0,0,1889,1889,C
8-NS,447,0,1855,0,1,1856,T
8-NS,448,0,1846,0,0,1846,T
8-NS,449,0,1874,0,0,1874,T
8-NS,450,0,0,1,1881,1882,C
8-NS,451,1904,0,0,0,1904,A
8-NS,452,0,2,0,1899,1901,C
8-NS,453,0,0,0,1892,1892,C
8-NS,454,1,0,1892,0,1893,G
8-NS,455,1891,0,1,0,1892,A
8-NS,456,1889,1,2,1,1893,A
8-NS,457,1,0,1893,0,1894,G
8-NS,458,1879,0,1,0,1880,A
8-NS,459,0,3,1870,1,1874,G
8-NS,460,1,2,1838,0,1841,G
8-NS,461,0,0,1856,0,1856,G
8-NS,462,1850,1,1,0,1852,A
8-NS,463,0,0,1852,0,1852,G
8-NS,464,2,3,0,1846,1851,C
8-NS,465,1841,0,2,0,1843,A
8-NS,466,1843,0,1,2,1846,A
8-NS,467,0,1848,0,0,1848,T
8-NS,468,0,1843,0,0,1843,T
8-NS,469,0,0,1849,0,1849,G
8-NS,470,0,1826,0,0,1826,T
8-NS,471,0,1828,0,0,1828,T
8-NS,472,1,1,1828,0,1830,G
8-NS,473,0,0,1823,0,1823,G
8-NS,474,0,1,0,1828,1829,C
8-NS,475,0,0,1825,1,1826,G
8-NS,476,1831,0,0,0,1831,A
8-NS,477,1840,0,1,0,1841,A
8-NS,478,1848,0,0,0,1848,A
8-NS,479,0,1853,1,1,1855,T
8-NS,480,0,0,0,1852,1852,C
8-NS,481,0,1847,0,1,1848,T
8-NS,482,0,0,0,1852,1852,C
8-NS,483,1856,0,3,0,1859,A
8-NS,484,0,0,0,1861,1861,C
8-NS,485,0,0,0,1858,1858,C
8-NS,486,1845,0,1,0,1846,A
8-NS,487,0,1845,0,1,1846,T
8-NS,488,0,1831,0,0,1831,T
8-NS,489,2,0,1825,0,1827,G
8-NS,490,0,1,0,1829,1830,C
8-NS,491,0,0,1,1821,1822,C
8-NS,492,0,1823,0,4,1827,T
8-NS,493,2,1814,0,0,1816,T
8-NS,494,0,0,0,1828,1828,C
8-NS,495,0,1823,1,0,1824,T
8-NS,496,0,1823,0,0,1823,T
8-NS,497,0,1850,0,0,1850,T
8-NS,498,0,1837,1,0,1838,T
8-NS,499,1,0,0,1834,1835,C
8-NS,500,0,0,0,1841,1841,C
8-NS,501,1839,0,4,0,1843,A
8-NS,502,0,1,1859,0,1860,G
8-NS,503,0,1,1846,0,1847,G
8-NS,504,1876,0,0,0,1876,A
8-NS,505,0,1,0,1878,1879,C
8-NS,506,1884,0,0,0,1884,A
8-NS,507,1,1888,0,0,1889,T
8-NS,508,1892,0,1,0,1893,A
8-NS,509,1,0,0,2003,2004,C
8-NS,510,0,1997,0,1,1998,T
8-NS,511,1976,0,1,0,1977,A
8-NS,512,0,1973,0,0,1973,T
8-NS,513,0,1912,0,1,1913,T
8-NS,514,0,1,1904,0,1905,G
8-NS,515,1853,0,2,0,1855,A
8-NS,516,0,2,1851,0,1853,G
8-NS,517,0,2,1840,0,1842,G
8-NS,518,1694,0,1,0,1695,A
8-NS,519,0,1693,0,0,1693,T
8-NS,520,0,1,1682,0,1683,G
8-NS,521,1,1667,0,9,1677,T
8-NS,522,2,0,1,1682,1685,C
8-NS,523,1687,0,0,0,1687,A
8-NS,524,1682,0,1,1,1684,A
8-NS,525,1680,0,1,0,1681,A
8-NS,526,1678,0,0,0,1678,A
8-NS,527,1681,0,0,0,1681,A
8-NS,528,0,1676,0,0,1676,T
8-NS,529,0,0,1672,0,1672,G
8-NS,530,0,1,0,1679,1680,C
8-NS,531,1676,0,0,0,1676,A
8-NS,532,1678,0,1,0,1679,A
8-NS,533,1,1681,0,0,1682,T
8-NS,534,0,1679,0,1,1680,T
8-NS,535,0,3,1677,0,1680,G
8-NS,536,0,5,1667,0,1672,G
8-NS,537,0,0,1683,0,1683,G
8-NS,538,0,1,1694,0,1695,G
8-NS,539,0,1672,0,2,1674,T
8-NS,540,0,0,0,1680,1680,C
8-NS,541,3,0,0,1685,1688,C
8-NS,542,0,1679,0,0,1679,T
8-NS,543,0,0,0,1689,1689,C
8-NS,544,1686,0,0,0,1686,A
8-NS,545,1,1689,0,1,1691,T
8-NS,546,0,0,0,1686,1686,C
8-NS,547,0,1,1674,0,1675,G
8-NS,548,0,0,1673,0,1673,G
8-NS,549,1644,0,3,0,1647,A
8-NS,550,0,0,1650,0,1650,G
8-NS,551,0,0,1660,0,1660,G
8-NS,552,1640,1,2,0,1643,A
8-NS,553,0,0,0,1649,1649,C
8-NS,554,0,1644,1,0,1645,T
8-NS,555,0,1639,0,1,1640,T
8-NS,556,0,1,1646,0,1647,G
8-NS,557,1642,0,0,0,1642,A
8-NS,558,1640,0,2,0,1642,A
8-NS,559,1,1637,0,0,1638,T
8-NS,560,1,0,1608,0,1609,G
8-NS,561,0,1,1624,0,1625,G
8-NS,562,1606,0,1,0,1607,A
8-NS,563,1614,0,1,0,1615,A
8-NS,564,1,1672,0,0,1673,T
8-NS,565,0,0,1683,0,1683,G
8-NS,566,1677,0,0,0,1677,A
8-NS,567,1,1679,0,0,1680,T
8-NS,568,1678,0,0,0,1678,A
8-NS,569,1685,1,0,0,1686,A
8-NS,570,0,0,0,1670,1670,C
8-NS,571,1648,1,2,0,1651,A
8-NS,572,0,0,0,1652,1652,C
8-NS,573,1517,0,1,0,1518,A
8-NS,574,0,0,1533,0,1533,G
8-NS,575,0,1527,0,0,1527,T
8-NS,576,1,1520,0,0,1521,T
8-NS,577,1,0,0,1519,1520,C
8-NS,578,0,1,1512,0,1513,G
8-NS,579,1511,0,0,0,1511,A
8-NS,580,0,0,1512,0,1512,G
8-NS,581,0,1492,0,1,1493,T
8-NS,582,0,1,0,1507,1508,C
8-NS,583,1,1478,0,0,1479,T
8-NS,584,0,0,0,1484,1484,C
8-NS,585,1,1481,0,2,1484,T
8-NS,586,1486,0,0,0,1486,A
8-NS,587,1489,1,0,0,1490,A
8-NS,588,1479,0,2,0,1481,A
8-NS,589,1488,0,0,0,1488,A
8-NS,590,1489,0,0,0,1489,A
8-NS,591,0,1470,0,0,1470,T
8-NS,592,2,0,0,1473,1475,C
8-NS,593,1,1466,0,0,1467,T
8-NS,594,1468,0,0,0,1468,A
8-NS,595,0,1,0,1467,1468,C
8-NS,596,1464,1,2,0,1467,A
8-NS,597,0,2,1467,0,1469,G
8-NS,598,1444,0,0,0,1444,A
8-NS,599,0,2,1447,0,1449,G
8-NS,600,1446,1,1,0,1448,A
8-NS,601,1,1427,0,2,1430,T
8-NS,602,0,1433,0,1,1434,T
8-NS,603,0,3,0,1429,1432,C
8-NS,604,0,0,1429,0,1429,G
8-NS,605,1,0,0,1436,1437,C
8-NS,606,0,1430,1,1,1432,T
8-NS,607,1,1429,0,1,1431,T
8-NS,608,0,0,1433,0,1433,G
8-NS,609,0,1,1441,0,1442,G
8-NS,610,1441,0,1,0,1442,A
8-NS,611,0,0,1444,0,1444,G
8-NS,612,1433,0,0,0,1433,A
8-NS,613,1415,0,1,0,1416,A
8-NS,614,0,0,1435,1,1436,G
8-NS,615,0,0,0,1437,1437,C
8-NS,616,1438,1,0,0,1439,A
8-NS,617,0,0,1456,0,1456,G
8-NS,618,1,1446,0,0,1447,T
8-NS,619,1453,1,0,0,1454,A
8-NS,620,1452,1,0,0,1453,A
8-NS,621,0,1446,0,0,1446,T
8-NS,622,0,0,1450,0,1450,G
8-NS,623,1393,0,0,1,1394,A
8-NS,624,0,1,1408,0,1409,G
8-NS,625,1402,0,1,0,1403,A
8-NS,626,1353,0,1,0,1354,A
8-NS,627,0,1358,0,0,1358,T
8-NS,628,1,0,1328,0,1329,G
8-NS,629,0,0,1336,0,1336,G
8-NS,630,0,3,1321,0,1324,G
8-NS,631,0,0,1318,0,1318,G
8-NS,632,1,0,1325,0,1326,G
8-NS,633,1293,1,2,0,1296,A
8-NS,634,0,0,0,1301,1301,C
8-NS,635,1,0,0,1299,1300,C
8-NS,636,0,1250,0,0,1250,T
8-NS,637,1,0,1,1264,1266,C
8-NS,638,0,0,0,1273,1273,C
8-NS,639,1273,1,0,0,1274,A
8-NS,640,0,0,0,1267,1267,C
8-NS,641,1,1250,0,1,1252,T
8-NS,642,0,1249,0,0,1249,T
8-NS,643,1214,0,0,0,1214,A
8-NS,644,0,0,0,1217,1217,C
8-NS,645,0,1213,0,1,1214,T
8-NS,646,0,0,0,1204,1204,C
8-NS,647,0,0,0,1190,1190,C
8-NS,648,1191,0,1,0,1192,A
8-NS,649,1194,0,0,0,1194,A
8-NS,650,1192,0,0,0,1192,A
8-NS,651,1192,0,0,0,1192,A
8-NS,652,0,0,1,1191,1192,C
8-NS,653,1169,0,0,0,1169,A
8-NS,654,0,0,1170,0,1170,G
8-NS,655,1164,0,0,0,1164,A
8-NS,656,1164,0,0,0,1164,A
8-NS,657,1161,1,0,0,1162,A
8-NS,658,0,2,0,1161,1163,C
8-NS,659,0,0,1164,0,1164,G
8-NS,660,0,1,1159,0,1160,G
8-NS,661,0,0,1163,0,1163,G
8-NS,662,1158,0,0,0,1158,A
8-NS,663,1156,0,0,0,1156,A
8-NS,664,1151,0,2,0,1153,A
8-NS,665,0,1149,0,0,1149,T
8-NS,666,0,0,1156,0,1156,G
8-NS,667,1,0,1155,0,1156,G
8-NS,668,0,1,0,1148,1149,C
8-NS,669,1,1,1149,0,1151,G
8-NS,670,1151,0,0,0,1151,A
8-NS,671,0,2,1153,0,1155,G
8-NS,672,1155,0,0,0,1155,A
8-NS,673,1151,0,2,0,1153,A
8-NS,674,0,0,0,1162,1162,C
8-NS,675,1135,1,0,0,1136,A
8-NS,676,0,0,1134,0,1134,G
8-NS,677,1,0,0,1132,1133,C
8-NS,678,1,1135,0,0,1136,T
8-NS,679,1129,0,1,0,1130,A
8-NS,680,1,0,1119,0,1120,G
8-NS,681,0,0,1119,0,1119,G
8-NS,682,0,1118,0,0,1118,T
8-NS,683,0,0,0,1088,1088,C
8-NS,684,1086,0,0,0,1086,A
8-NS,685,1084,0,0,0,1084,A
8-NS,686,1082,0,0,0,1082,A
8-NS,687,1081,0,0,0,1081,A
8-NS,688,0,0,1085,0,1085,G
8-NS,689,0,1057,0,0,1057,T
8-NS,690,0,1048,0,0,1048,T
8-NS,691,1,1053,0,1,1055,T
8-NS,692,0,0,1058,0,1058,G
8-NS,693,1058,1,0,0,1059,A
8-NS,694,1058,0,0,0,1058,A
8-NS,695,0,0,1060,0,1060,G
8-NS,696,1052,0,0,0,1052,A
8-NS,697,1038,0,0,0,1038,A
8-NS,698,1053,0,0,0,1053,A
8-NS,699,0,1057,0,0,1057,T
8-NS,700,1053,0,0,0,1053,A
8-NS,701,1054,0,0,0,1054,A
8-NS,702,0,1,1050,0,1051,G
8-NS,703,1004,0,0,0,1004,A
8-NS,704,0,1005,0,0,1005,T
8-NS,705,0,1,997,0,998,G
8-NS,706,0,0,1002,0,1002,G
8-NS,707,0,0,0,1000,1000,C
8-NS,708,0,995,0,0,995,T
8-NS,709,1000,0,0,0,1000,A
8-NS,710,1001,0,1,0,1002,A
8-NS,711,1,1001,1,0,1003,T
8-NS,712,0,1001,0,1,1002,T
8-NS,713,0,0,1003,0,1003,G
8-NS,714,981,1,2,0,984,A
8-NS,715,979,1,3,0,983,A
8-NS,716,0,0,983,0,983,G
8-NS,717,978,0,0,0,978,A
8-NS,718,962,0,0,0,962,A
8-NS,719,0,0,974,0,974,G
8-NS,720,0,952,0,0,952,T
8-NS,721,0,1,956,0,957,G
8-NS,722,949,0,1,0,950,A
8-NS,723,1,1,950,0,952,G
8-NS,724,952,0,2,0,954,A
8-NS,725,0,0,0,946,946,C
8-NS,726,940,0,0,0,940,A
8-NS,727,0,0,0,942,942,C
8-NS,728,865,0,0,0,865,A
8-NS,729,0,0,886,0,886,G
8-NS,730,878,0,1,1,880,A
8-NS,731,0,875,0,0,875,T
8-NS,732,0,873,0,0,873,T
8-NS,733,871,1,0,0,872,A
8-NS,734,871,0,1,0,872,A
8-NS,735,871,0,0,0,871,A
8-NS,736,868,0,0,0,868,A
8-NS,737,868,0,0,0,868,A
8-NS,738,0,0,0,828,828,C
8-NS,739,777,0,0,0,777,A
8-NS,740,779,0,1,0,780,A
8-NS,741,0,0,0,781,781,C
8-NS,742,1,771,0,0,772,T
8-NS,743,0,0,777,0,777,G
8-NS,744,774,0,0,0,774,A
8-NS,745,770,0,0,0,770,A
8-NS,746,771,0,0,0,771,A
8-NS,747,764,0,0,0,764,A
8-NS,748,0,761,0,0,761,T
8-NS,749,741,0,0,0,741,A
8-NS,750,0,0,747,0,747,G
8-NS,751,0,0,0,746,746,C
8-NS,752,0,726,0,0,726,T
8-NS,753,0,726,0,0,726,T
8-NS,754,0,722,0,0,722,T
8-NS,755,0,0,721,0,721,G
8-NS,756,722,0,0,0,722,A
8-NS,757,723,0,1,0,724,A
8-NS,758,0,0,0,724,724,C
8-NS,759,703,0,0,0,703,A
8-NS,760,707,0,0,0,707,A
8-NS,761,707,0,0,0,707,A
8-NS,762,0,705,0,0,705,T
8-NS,763,701,0,0,1,702,A
8-NS,764,693,0,0,0,693,A
8-NS,765,0,0,0,693,693,C
8-NS,766,694,0,0,0,694,A
8-NS,767,0,676,0,0,676,T
8-NS,768,0,668,0,1,669,T
8-NS,769,0,0,0,659,659,C
8-NS,770,653,0,0,0,653,A
8-NS,771,0,648,0,1,649,T
8-NS,772,0,0,652,0,652,G
8-NS,773,0,0,0,642,642,C
8-NS,774,633,0,0,0,633,A
8-NS,775,626,0,0,0,626,A
8-NS,776,0,0,627,0,627,G
8-NS,777,0,0,0,627,627,C
8-NS,778,623,0,0,0,623,A
8-NS,779,0,620,0,0,620,T
8-NS,780,0,615,0,0,615,T
8-NS,781,616,0,0,0,616,A
8-NS,782,0,0,0,614,614,C
8-NS,783,596,0,0,0,596,A
8-NS,784,0,0,506,0,506,G
8-NS,785,0,0,0,509,509,C
8-NS,786,0,502,0,0,502,T
8-NS,787,0,0,510,0,510,G
8-NS,788,1,0,0,501,502,C
8-NS,789,0,494,0,1,495,T
8-NS,790,0,0,499,0,499,G
8-NS,791,0,487,0,0,487,T
8-NS,792,0,486,0,1,487,T
8-NS,793,0,488,0,0,488,T
8-NS,794,0,0,486,0,486,G
8-NS,795,487,0,0,0,487,A
8-NS,796,478,0,0,0,478,A
8-NS,797,0,0,478,0,478,G
8-NS,798,0,469,0,0,469,T
8-NS,799,0,0,445,0,445,G
8-NS,800,0,0,452,0,452,G
8-NS,801,450,0,0,0,450,A
8-NS,802,451,0,0,0,451,A
8-NS,803,0,0,0,450,450,C
8-NS,804,435,0,1,0,436,A
8-NS,805,0,1,435,0,436,G
8-NS,806,0,0,431,0,431,G
8-NS,807,420,0,1,0,421,A
8-NS,808,0,0,426,0,426,G
8-NS,809,339,0,0,0,339,A
8-NS,810,0,337,0,0,337,T
8-NS,811,335,0,0,0,335,A
8-NS,812,330,0,0,0,330,A
8-NS,813,0,0,331,0,331,G
8-NS,814,288,0,0,0,288,A
8-NS,815,287,0,0,0,287,A
8-NS,816,0,0,0,282,282,C
8-NS,817,0,241,0,0,241,T
8-NS,818,0,237,0,1,238,T
8-NS,819,0,238,0,0,238,T
8-NS,820,1,0,1,236,238,C
8-NS,821,0,228,0,1,229,T
8-NS,822,0,0,0,224,224,C
8-NS,823,217,0,0,0,217,A
8-NS,824,0,217,0,0,217,T
8-NS,825,0,215,0,0,215,T
8-NS,826,0,215,0,0,215,T
8-NS,827,0,0,0,214,214,C
8-NS,828,207,0,0,0,207,A
8-NS,829,0,0,207,0,207,G
8-NS,830,0,0,0,206,206,C
8-NS,831,0,193,0,0,193,T
8-NS,832,0,193,0,0,193,T
8-NS,833,186,0,0,0,186,A
8-NS,834,0,184,0,0,184,T
8-NS,835,0,184,0,0,184,T
8-NS,836,0,185,0,0,185,T
8-NS,837,177,0,0,0,177,A
8-NS,838,172,0,0,0,172,A
8-NS,839,0,163,0,0,163,T
8-NS,840,1,0,163,0,164,G
8-NS,841,158,0,0,0,158,A
8-NS,842,0,145,0,0,145,T
8-NS,843,144,0,0,0,144,A
8-NS,844,143,0,1,0,144,A
8-NS,845,143,0,0,0,143,A
8-NS,846,142,0,0,0,142,A
8-NS,847,144,0,0,0,144,A
8-NS,848,141,0,0,0,141,A
8-NS,849,0,0,0,141,141,C
8-NS,850,121,0,0,0,121,A
8-NS,851,0,0,0,121,121,C
8-NS,852,0,0,0,113,113,C
8-NS,853,0,0,0,110,110,C
8-NS,854,0,108,0,0,108,T
8-NS,855,0,104,0,0,104,T
8-NS,856,0,0,104,0,104,G
8-NS,857,0,100,0,0,100,T
8-NS,858,0,97,0,0,97,T
8-NS,859,0,93,0,0,93,T
8-NS,860,0,0,0,30,30,C
8-NS,861,0,24,0,0,24,T
8-NS,862,18,0,0,0,18,A
8-NS,863,0,0,0,17,17,C
