Gene,Position,A,T,G,C,Coverage,Consensus
1-PB2,1,427,0,0,0,427,A
1-PB2,2,0,425,0,0,425,T
1-PB2,3,0,0,436,0,436,G
1-PB2,4,0,2,438,0,440,G
1-PB2,5,438,0,0,0,438,A
1-PB2,6,438,0,0,0,438,A
1-PB2,7,438,1,0,0,439,A
1-PB2,8,0,2,496,0,498,G
1-PB2,9,500,0,2,0,502,A
1-PB2,10,507,0,0,0,507,A
1-PB2,11,0,517,0,0,517,T
1-PB2,12,518,0,0,0,518,A
1-PB2,13,517,0,2,0,519,A
1-PB2,14,519,0,2,0,521,A
1-PB2,15,521,0,1,0,522,A
1-PB2,16,0,3,540,0,543,G
1-PB2,17,543,0,0,0,543,A
1-PB2,18,549,0,0,0,549,A
1-PB2,19,0,0,0,562,562,C
1-PB2,20,0,561,0,0,561,T
1-PB2,21,570,0,0,0,570,A
1-PB2,22,0,3,0,567,570,C
1-PB2,23,0,2,570,0,572,G
1-PB2,24,0,6,582,0,588,G
1-PB2,25,588,0,0,0,588,A
1-PB2,26,601,0,0,0,601,A
1-PB2,27,0,600,0,0,600,T
1-PB2,28,3,1,0,601,605,C
1-PB2,29,0,602,0,0,602,T
1-PB2,30,0,2,606,0,608,G
1-PB2,31,615,0,1,0,616,A
1-PB2,32,0,618,0,0,618,T
1-PB2,33,0,0,619,0,619,G
1-PB2,34,0,627,0,1,628,T
1-PB2,35,5,1,0,618,624,C
1-PB2,36,0,0,626,0,626,G
1-PB2,37,0,0,0,628,628,C
1-PB2,38,626,0,1,0,627,A
1-PB2,39,1,1,660,0,662,G
1-PB2,40,0,662,0,0,662,T
1-PB2,41,4,0,0,658,662,C
1-PB2,42,1,659,1,0,661,T
1-PB2,43,4,1,0,654,659,C
1-PB2,44,0,1,662,0,663,G
1-PB2,45,0,0,0,665,665,C
1-PB2,46,665,0,0,0,665,A
1-PB2,47,0,0,0,671,671,C
1-PB2,48,0,666,0,0,666,T
1-PB2,49,4,0,0,683,687,C
1-PB2,50,0,1,684,0,685,G
1-PB2,51,0,1,0,689,690,C
1-PB2,52,0,7,681,0,688,G
1-PB2,53,688,0,1,0,689,A
1-PB2,54,1,2,690,0,693,G
1-PB2,55,705,0,1,0,706,A
1-PB2,56,0,705,0,0,705,T
1-PB2,57,706,0,0,0,706,A
1-PB2,58,0,1,0,706,707,C
1-PB2,59,1,700,0,0,701,T
1-PB2,60,0,3,713,0,716,G
1-PB2,61,712,1,2,0,715,A
1-PB2,62,1,0,0,717,718,C
1-PB2,63,717,0,2,0,719,A
1-PB2,64,720,0,0,0,720,A
1-PB2,65,730,0,2,0,732,A
1-PB2,66,748,0,1,0,749,A
1-PB2,67,750,0,1,0,751,A
1-PB2,68,1,0,0,762,763,C
1-PB2,69,3,1,0,754,758,C
1-PB2,70,770,0,0,0,770,A
1-PB2,71,0,0,1,779,780,C
1-PB2,72,779,0,0,0,779,A
1-PB2,73,0,0,799,0,799,G
1-PB2,74,0,794,0,1,795,T
1-PB2,75,0,4,829,0,833,G
1-PB2,76,0,7,833,0,840,G
1-PB2,77,837,0,2,0,839,A
1-PB2,78,1,1,0,879,881,C
1-PB2,79,4,0,0,869,873,C
1-PB2,80,882,0,1,0,883,A
1-PB2,81,0,884,0,0,884,T
1-PB2,82,871,0,0,0,871,A
1-PB2,83,1,869,0,0,870,T
1-PB2,84,1,4,870,0,875,G
1-PB2,85,1,1,872,0,874,G
1-PB2,86,0,1,0,877,878,C
1-PB2,87,6,0,0,855,861,C
1-PB2,88,863,0,0,0,863,A
1-PB2,89,0,916,0,1,917,T
1-PB2,90,921,0,0,0,921,A
1-PB2,91,960,0,1,0,961,A
1-PB2,92,0,960,0,0,960,T
1-PB2,93,0,957,0,0,957,T
1-PB2,94,965,2,0,1,968,A
1-PB2,95,962,0,0,0,962,A
1-PB2,96,0,1,979,0,980,G
1-PB2,97,976,0,1,0,977,A
1-PB2,98,957,0,2,0,959,A
1-PB2,99,0,2,992,0,994,G
1-PB2,100,0,983,0,0,983,T
1-PB2,101,981,0,0,0,981,A
1-PB2,102,0,2,0,982,984,C
1-PB2,103,986,0,2,0,988,A
1-PB2,104,0,0,0,1012,1012,C
1-PB2,105,1004,0,0,0,1004,A
1-PB2,106,0,1003,0,0,1003,T
1-PB2,107,3,2,0,997,1002,C
1-PB2,108,1,5,981,0,987,G
1-PB2,109,0,5,982,0,987,G
1-PB2,110,1,1,978,0,980,G
1-PB2,111,0,6,978,0,984,G
1-PB2,112,976,0,1,0,977,A
1-PB2,113,0,7,971,0,978,G
1-PB2,114,964,0,2,1,967,A
1-PB2,115,1,1,0,981,983,C
1-PB2,116,983,0,0,0,983,A
1-PB2,117,1,5,997,0,1003,G
1-PB2,118,0,9,1020,0,1029,G
1-PB2,119,1032,0,1,0,1033,A
1-PB2,120,1033,0,0,0,1033,A
1-PB2,121,1035,0,0,0,1035,A
1-PB2,122,1028,1,1,0,1030,A
1-PB2,123,0,7,1028,0,1035,G
1-PB2,124,1027,0,1,1,1029,A
1-PB2,125,1030,0,1,0,1031,A
1-PB2,126,0,0,0,1031,1031,C
1-PB2,127,2,0,0,1020,1022,C
1-PB2,128,5,2,0,1023,1030,C
1-PB2,129,1,0,1038,0,1039,G
1-PB2,130,0,1040,0,0,1040,T
1-PB2,131,7,0,0,1035,1042,C
1-PB2,132,1047,0,1,0,1048,A
1-PB2,133,0,0,0,1062,1062,C
1-PB2,134,0,1058,0,1,1059,T
1-PB2,135,0,1059,0,0,1059,T
1-PB2,136,1053,0,3,0,1056,A
1-PB2,137,0,5,1075,0,1080,G
1-PB2,138,1,7,1073,0,1081,G
1-PB2,139,1079,1,1,0,1081,A
1-PB2,140,0,1079,0,0,1079,T
1-PB2,141,2,3,1080,0,1085,G
1-PB2,142,1100,0,0,0,1100,A
1-PB2,143,1102,0,1,0,1103,A
1-PB2,144,1102,0,3,0,1105,A
1-PB2,145,0,1106,0,1,1107,T
1-PB2,146,0,6,1102,0,1108,G
1-PB2,147,0,1,1124,0,1125,G
1-PB2,148,1121,0,4,0,1125,A
1-PB2,149,0,1126,0,2,1128,T
1-PB2,150,0,7,1111,0,1118,G
1-PB2,151,1106,0,2,0,1108,A
1-PB2,152,0,1111,0,0,1111,T
1-PB2,153,0,6,1110,0,1116,G
1-PB2,154,0,0,1119,0,1119,G
1-PB2,155,0,0,0,1118,1118,C
1-PB2,156,1097,0,0,0,1097,A
1-PB2,157,1108,0,1,1,1110,A
1-PB2,158,0,1114,0,1,1115,T
1-PB2,159,0,8,1136,0,1144,G
1-PB2,160,1143,0,0,2,1145,A
1-PB2,161,1144,0,0,0,1144,A
1-PB2,162,1141,0,2,0,1143,A
1-PB2,163,0,1147,0,1,1148,T
1-PB2,164,1161,1,3,0,1165,A
1-PB2,165,2,2,0,1191,1195,C
1-PB2,166,6,0,0,1184,1190,C
1-PB2,167,7,2,0,1184,1193,C
1-PB2,168,1177,1,0,0,1178,A
1-PB2,169,1183,0,0,0,1183,A
1-PB2,170,0,1181,0,1,1182,T
1-PB2,171,10,1,0,1176,1187,C
1-PB2,172,1186,0,1,0,1187,A
1-PB2,173,0,1,0,1217,1218,C
1-PB2,174,0,1206,0,0,1206,T
1-PB2,175,1,0,1210,0,1211,G
1-PB2,176,0,0,0,1211,1211,C
1-PB2,177,0,1203,0,2,1205,T
1-PB2,178,1,8,1210,1,1220,G
1-PB2,179,1218,0,0,1,1219,A
1-PB2,180,0,2,0,1224,1226,C
1-PB2,181,1227,0,0,0,1227,A
1-PB2,182,1209,0,2,0,1211,A
1-PB2,183,1216,0,0,0,1216,A
1-PB2,184,1211,0,1,0,1212,A
1-PB2,185,1,5,1236,0,1242,G
1-PB2,186,0,3,1241,0,1244,G
1-PB2,187,1236,0,1,0,1237,A
1-PB2,188,0,1241,0,0,1241,T
1-PB2,189,1228,0,0,0,1228,A
1-PB2,190,1240,0,1,0,1241,A
1-PB2,191,0,1,0,1254,1255,C
1-PB2,192,1249,0,1,0,1250,A
1-PB2,193,2,6,1245,0,1253,G
1-PB2,194,1225,0,2,0,1227,A
1-PB2,195,1228,1,0,0,1229,A
1-PB2,196,1229,1,0,0,1230,A
1-PB2,197,0,1225,0,0,1225,T
1-PB2,198,1,11,1216,0,1228,G
1-PB2,199,2,0,1244,0,1246,G
1-PB2,200,1,1229,0,1,1231,T
1-PB2,201,0,1230,0,0,1230,T
1-PB2,202,6,1,0,1216,1223,C
1-PB2,203,4,0,0,1222,1226,C
1-PB2,204,1225,0,0,0,1225,A
1-PB2,205,2,7,1226,0,1235,G
1-PB2,206,1236,0,0,0,1236,A
1-PB2,207,0,9,1228,0,1237,G
1-PB2,208,1219,0,3,0,1222,A
1-PB2,209,0,3,1235,0,1238,G
1-PB2,210,1241,0,0,0,1241,A
1-PB2,211,1239,0,1,0,1240,A
1-PB2,212,1242,1,1,0,1244,A
1-PB2,213,0,1237,0,0,1237,T
1-PB2,214,0,8,1244,0,1252,G
1-PB2,215,1254,0,0,0,1254,A
1-PB2,216,1250,0,2,0,1252,A
1-PB2,217,1,0,0,1252,1253,C
1-PB2,218,1233,0,2,0,1235,A
1-PB2,219,1237,0,3,0,1240,A
1-PB2,220,0,4,1254,0,1258,G
1-PB2,221,0,13,1256,0,1269,G
1-PB2,222,1264,0,4,2,1270,A
1-PB2,223,0,1,0,1265,1266,C
1-PB2,224,1259,3,2,0,1264,A
1-PB2,225,1259,0,4,0,1263,A
1-PB2,226,1315,0,1,0,1316,A
1-PB2,227,1,0,0,1334,1335,C
1-PB2,228,0,1314,0,1,1315,T
1-PB2,229,7,0,0,1335,1342,C
1-PB2,230,0,1318,0,0,1318,T
1-PB2,231,1326,0,0,1,1327,A
1-PB2,232,0,1328,0,0,1328,T
1-PB2,233,1,5,1327,0,1333,G
1-PB2,234,0,5,1368,0,1373,G
1-PB2,235,1315,1,2,0,1318,A
1-PB2,236,0,0,1335,0,1335,G
1-PB2,237,0,1330,0,1,1331,T
1-PB2,238,1312,0,3,0,1315,A
1-PB2,239,1314,1,1,0,1316,A
1-PB2,240,1312,0,1,0,1313,A
1-PB2,241,1316,1,1,0,1318,A
1-PB2,242,0,1302,0,0,1302,T
1-PB2,243,1,13,1294,0,1308,G
1-PB2,244,1280,0,2,0,1282,A
1-PB2,245,0,1,1288,0,1289,G
1-PB2,246,0,1271,1,3,1275,T
1-PB2,247,0,8,1263,0,1271,G
1-PB2,248,1289,0,4,0,1293,A
1-PB2,249,0,1298,0,2,1300,T
1-PB2,250,0,0,1303,0,1303,G
1-PB2,251,2,0,1,1298,1301,C
1-PB2,252,1,1289,0,2,1292,T
1-PB2,253,2,5,1333,0,1340,G
1-PB2,254,0,10,1325,1,1336,G
1-PB2,255,1351,1,1,0,1353,A
1-PB2,256,0,1351,0,0,1351,T
1-PB2,257,7,1,0,1354,1362,C
1-PB2,258,1364,0,0,0,1364,A
1-PB2,259,0,3,1384,0,1387,G
1-PB2,260,1385,0,2,0,1387,A
1-PB2,261,0,1383,0,1,1384,T
1-PB2,262,1350,0,0,1,1351,A
1-PB2,263,0,6,1394,0,1400,G
1-PB2,264,1380,0,4,1,1385,A
1-PB2,265,0,0,1401,0,1401,G
1-PB2,266,0,1376,0,1,1377,T
1-PB2,267,2,7,1361,0,1370,G
1-PB2,268,1338,0,1,0,1339,A
1-PB2,269,0,1347,0,1,1348,T
1-PB2,270,0,8,1366,0,1374,G
1-PB2,271,0,2,1393,0,1395,G
1-PB2,272,0,1368,0,1,1369,T
1-PB2,273,1367,0,0,0,1367,A
1-PB2,274,0,1342,0,3,1345,T
1-PB2,275,9,2,0,1335,1346,C
1-PB2,276,1369,0,1,0,1370,A
1-PB2,277,0,0,0,1406,1406,C
1-PB2,278,3,1,0,1396,1400,C
1-PB2,279,0,1373,1,3,1377,T
1-PB2,280,0,1363,0,1,1364,T
1-PB2,281,0,1361,0,0,1361,T
1-PB2,282,0,9,1363,0,1372,G
1-PB2,283,0,0,1377,0,1377,G
1-PB2,284,1,0,1,1387,1389,C
1-PB2,285,0,1363,1,1,1365,T
1-PB2,286,1,0,1369,0,1370,G
1-PB2,287,0,1373,0,0,1373,T
1-PB2,288,1376,0,0,0,1376,A
1-PB2,289,1382,1,1,0,1384,A
1-PB2,290,2,0,0,1382,1384,C
1-PB2,291,1359,0,2,1,1362,A
1-PB2,292,0,1359,0,1,1360,T
1-PB2,293,3,7,1326,0,1336,G
1-PB2,294,0,0,1360,0,1360,G
1-PB2,295,2,1348,0,1,1351,T
1-PB2,296,0,7,1342,0,1349,G
1-PB2,297,0,12,1351,1,1364,G
1-PB2,298,1360,0,0,1,1361,A
1-PB2,299,1362,0,2,0,1364,A
1-PB2,300,0,1362,0,0,1362,T
1-PB2,301,1357,0,0,0,1357,A
1-PB2,302,1,6,1377,0,1384,G
1-PB2,303,1360,1,0,0,1361,A
1-PB2,304,1361,0,2,0,1363,A
1-PB2,305,1361,0,1,0,1362,A
1-PB2,306,1,1336,0,0,1337,T
1-PB2,307,0,5,1323,0,1328,G
1-PB2,308,0,6,1328,0,1334,G
1-PB2,309,1336,0,2,0,1338,A
1-PB2,310,3,0,0,1339,1342,C
1-PB2,311,3,0,0,1323,1326,C
1-PB2,312,4,2,1,1319,1326,C
1-PB2,313,1,1,1326,0,1328,G
1-PB2,314,2,1336,0,0,1338,T
1-PB2,315,0,4,1367,0,1371,G
1-PB2,316,1371,0,0,0,1371,A
1-PB2,317,1,0,0,1379,1380,C
1-PB2,318,1378,0,1,0,1379,A
1-PB2,319,1375,0,1,0,1376,A
1-PB2,320,1,0,1402,0,1403,G
1-PB2,321,0,1389,0,0,1389,T
1-PB2,322,1388,0,0,0,1388,A
1-PB2,323,0,4,0,1379,1383,C
1-PB2,324,1,12,1347,0,1360,G
1-PB2,325,1,1,1402,0,1404,G
1-PB2,326,0,1392,0,2,1394,T
1-PB2,327,7,1,0,1403,1411,C
1-PB2,328,8,1,0,1406,1415,C
1-PB2,329,1395,0,2,0,1397,A
1-PB2,330,0,1405,0,0,1405,T
1-PB2,331,0,1403,0,1,1404,T
1-PB2,332,1475,0,0,0,1475,A
1-PB2,333,1,0,0,1476,1477,C
1-PB2,334,6,0,0,1435,1441,C
1-PB2,335,12,0,0,1428,1440,C
1-PB2,336,1427,0,1,0,1428,A
1-PB2,337,1447,0,0,0,1447,A
1-PB2,338,1452,0,2,0,1454,A
1-PB2,339,1446,0,4,0,1450,A
1-PB2,340,1,0,1475,0,1476,G
1-PB2,341,0,1425,1,1,1427,T
1-PB2,342,0,2,1459,0,1461,G
1-PB2,343,0,1459,0,1,1460,T
1-PB2,344,1458,0,0,0,1458,A
1-PB2,345,0,0,0,1462,1462,C
1-PB2,346,1451,0,1,0,1452,A
1-PB2,347,1458,2,3,0,1463,A
1-PB2,348,0,10,1463,0,1473,G
1-PB2,349,1452,1,2,0,1455,A
1-PB2,350,1,1,0,1454,1456,C
1-PB2,351,0,1426,0,1,1427,T
1-PB2,352,0,1442,0,2,1444,T
1-PB2,353,1445,0,1,0,1446,A
1-PB2,354,0,1443,1,0,1444,T
1-PB2,355,0,1447,0,0,1447,T
1-PB2,356,1,1439,1,0,1441,T
1-PB2,357,6,0,0,1422,1428,C
1-PB2,358,2,21,1404,0,1427,G
1-PB2,359,1423,0,2,0,1425,A
1-PB2,360,1,0,0,1424,1425,C
1-PB2,361,1417,0,0,0,1417,A
1-PB2,362,1410,0,1,0,1411,A
1-PB2,363,1413,0,1,0,1414,A
1-PB2,364,0,2,1446,1,1449,G
1-PB2,365,1,1444,0,2,1447,T
1-PB2,366,10,2,0,1431,1443,C
1-PB2,367,2,4,1439,0,1445,G
1-PB2,368,1441,0,1,0,1442,A
1-PB2,369,1439,0,1,0,1440,A
1-PB2,370,1443,0,2,1,1446,A
1-PB2,371,0,9,1490,0,1499,G
1-PB2,372,0,1,1502,0,1503,G
1-PB2,373,0,1491,0,1,1492,T
1-PB2,374,1,1491,1,0,1493,T
1-PB2,375,1490,0,0,0,1490,A
1-PB2,376,1487,0,0,0,1487,A
1-PB2,377,1492,0,1,0,1493,A
1-PB2,378,1504,0,1,0,1505,A
1-PB2,379,2,2,0,1519,1523,C
1-PB2,380,1484,1,2,0,1487,A
1-PB2,381,1,1475,0,0,1476,T
1-PB2,382,0,4,1469,0,1473,G
1-PB2,383,0,12,1463,0,1475,G
1-PB2,384,1476,0,1,0,1477,A
1-PB2,385,1490,0,0,0,1490,A
1-PB2,386,1,1,0,1538,1540,C
1-PB2,387,12,0,0,1530,1542,C
1-PB2,388,0,1527,1,4,1532,T
1-PB2,389,0,1528,1,2,1531,T
1-PB2,390,0,1529,1,1,1531,T
1-PB2,391,1,5,1522,0,1528,G
1-PB2,392,2,3,1536,0,1541,G
1-PB2,393,0,1,1,1531,1533,C
1-PB2,394,6,0,0,1520,1526,C
1-PB2,395,6,3,0,1518,1527,C
1-PB2,396,0,1463,0,5,1468,T
1-PB2,397,0,0,1497,1,1498,G
1-PB2,398,0,1493,0,2,1495,T
1-PB2,399,0,1491,0,2,1493,T
1-PB2,400,18,0,0,1478,1496,C
1-PB2,401,1483,0,1,0,1484,A
1-PB2,402,1,1480,0,1,1482,T
1-PB2,403,1,1483,0,0,1484,T
1-PB2,404,0,1486,0,1,1487,T
1-PB2,405,0,1487,0,0,1487,T
1-PB2,406,1451,0,2,0,1453,A
1-PB2,407,0,3,1453,0,1456,G
1-PB2,408,1453,0,0,0,1453,A
1-PB2,409,1453,0,0,0,1453,A
1-PB2,410,1454,0,0,1,1455,A
1-PB2,411,0,1454,0,0,1454,T
1-PB2,412,17,0,0,1440,1457,C
1-PB2,413,1455,0,0,0,1455,A
1-PB2,414,1460,1,4,0,1465,A
1-PB2,415,0,3,1465,0,1468,G
1-PB2,416,0,1464,0,1,1465,T
1-PB2,417,14,0,0,1454,1468,C
1-PB2,418,1471,0,1,1,1473,A
1-PB2,419,1474,0,1,1,1476,A
1-PB2,420,0,2,1482,0,1484,G
1-PB2,421,1481,0,4,0,1485,A
1-PB2,422,0,1485,0,1,1486,T
1-PB2,423,1486,0,0,0,1486,A
1-PB2,424,0,0,0,1479,1479,C
1-PB2,425,0,1,1476,0,1477,G
1-PB2,426,0,0,0,1492,1492,C
1-PB2,427,1479,1,0,0,1480,A
1-PB2,428,0,1,1499,0,1500,G
1-PB2,429,1498,0,0,0,1498,A
1-PB2,430,1508,0,2,0,1510,A
1-PB2,431,0,3,1532,0,1535,G
1-PB2,432,1498,0,5,0,1503,A
1-PB2,433,1,1,1509,0,1511,G
1-PB2,434,0,1505,0,0,1505,T
1-PB2,435,1496,0,2,0,1498,A
1-PB2,436,0,5,1510,0,1515,G
1-PB2,437,1513,0,2,0,1515,A
1-PB2,438,1,3,0,1561,1565,C
1-PB2,439,1537,0,0,0,1537,A
1-PB2,440,0,1509,0,2,1511,T
1-PB2,441,1501,0,0,0,1501,A
1-PB2,442,1497,0,4,0,1501,A
1-PB2,443,1516,1,1,0,1518,A
1-PB2,444,1,0,0,1529,1530,C
1-PB2,445,7,0,0,1505,1512,C
1-PB2,446,12,0,0,1488,1500,C
1-PB2,447,0,1416,0,2,1418,T
1-PB2,448,3,8,1414,1,1426,G
1-PB2,449,0,1,1453,0,1454,G
1-PB2,450,0,1449,0,1,1450,T
1-PB2,451,26,0,0,1418,1444,C
1-PB2,452,1459,0,4,0,1463,A
1-PB2,453,0,1468,0,0,1468,T
1-PB2,454,1,1,1477,0,1479,G
1-PB2,455,2,0,0,1474,1476,C
1-PB2,456,1466,0,1,1,1468,A
1-PB2,457,1,7,1466,0,1474,G
1-PB2,458,1440,1,2,0,1443,A
1-PB2,459,2,0,0,1466,1468,C
1-PB2,460,5,0,0,1459,1464,C
1-PB2,461,0,1441,0,2,1443,T
1-PB2,462,5,0,0,1439,1444,C
1-PB2,463,1427,0,1,0,1428,A
1-PB2,464,0,1,1469,0,1470,G
1-PB2,465,0,1464,0,1,1465,T
1-PB2,466,2,1,1461,0,1464,G
1-PB2,467,3,0,0,1464,1467,C
1-PB2,468,12,1,0,1436,1449,C
1-PB2,469,1439,0,4,0,1443,A
1-PB2,470,1444,0,0,1,1445,A
1-PB2,471,1440,1,1,0,1442,A
1-PB2,472,0,4,1451,0,1455,G
1-PB2,473,1406,0,0,0,1406,A
1-PB2,474,0,1,1412,0,1413,G
1-PB2,475,1,3,1413,1,1418,G
1-PB2,476,0,1,0,1416,1417,C
1-PB2,477,1422,0,0,1,1423,A
1-PB2,478,1,0,0,1422,1423,C
1-PB2,479,1425,0,0,0,1425,A
1-PB2,480,1451,0,1,0,1452,A
1-PB2,481,0,4,1452,0,1456,G
1-PB2,482,1495,2,1,0,1498,A
1-PB2,483,0,1484,0,0,1484,T
1-PB2,484,1,0,1483,0,1484,G
1-PB2,485,2,1488,0,0,1490,T
1-PB2,486,1486,0,0,0,1486,A
1-PB2,487,1484,1,1,0,1486,A
1-PB2,488,0,1488,0,1,1489,T
1-PB2,489,0,1426,0,0,1426,T
1-PB2,490,1406,2,0,0,1408,A
1-PB2,491,0,1359,0,1,1360,T
1-PB2,492,3,9,1351,0,1363,G
1-PB2,493,1,3,1361,1,1366,G
1-PB2,494,1354,0,2,0,1356,A
1-PB2,495,1350,0,2,0,1352,A
1-PB2,496,0,0,1347,0,1347,G
1-PB2,497,0,1342,0,1,1343,T
1-PB2,498,0,1339,0,0,1339,T
1-PB2,499,0,0,1360,0,1360,G
1-PB2,500,0,1355,0,3,1358,T
1-PB2,501,0,1353,0,0,1353,T
1-PB2,502,0,1351,0,2,1353,T
1-PB2,503,0,1349,0,0,1349,T
1-PB2,504,0,1357,0,2,1359,T
1-PB2,505,6,0,0,1353,1359,C
1-PB2,506,8,1,0,1364,1373,C
1-PB2,507,3,0,0,1370,1373,C
1-PB2,508,1372,0,2,0,1374,A
1-PB2,509,1378,0,0,0,1378,A
1-PB2,510,0,1382,0,0,1382,T
1-PB2,511,0,4,1386,0,1390,G
1-PB2,512,1389,0,1,0,1390,A
1-PB2,513,1383,0,1,0,1384,A
1-PB2,514,2,0,1399,0,1401,G
1-PB2,515,1,1396,0,1,1398,T
1-PB2,516,2,7,1380,0,1389,G
1-PB2,517,2,2,1381,0,1385,G
1-PB2,518,2,7,1377,1,1387,G
1-PB2,519,1385,0,2,0,1387,A
1-PB2,520,0,0,1380,0,1380,G
1-PB2,521,0,2,0,1384,1386,C
1-PB2,522,5,3,0,1380,1388,C
1-PB2,523,1367,0,2,1,1370,A
1-PB2,524,0,6,1404,0,1410,G
1-PB2,525,2,5,1411,0,1418,G
1-PB2,526,1423,0,0,0,1423,A
1-PB2,527,0,1425,0,0,1425,T
1-PB2,528,1414,1,2,0,1417,A
1-PB2,529,0,0,0,1419,1419,C
1-PB2,530,0,1404,0,0,1404,T
1-PB2,531,1401,0,0,0,1401,A
1-PB2,532,1399,0,0,0,1399,A
1-PB2,533,0,0,0,1407,1407,C
1-PB2,534,1373,2,0,0,1375,A
1-PB2,535,0,1361,0,0,1361,T
1-PB2,536,4,1,0,1358,1363,C
1-PB2,537,1345,0,3,0,1348,A
1-PB2,538,0,4,1361,0,1365,G
1-PB2,539,1360,0,0,0,1360,A
1-PB2,540,1354,0,1,0,1355,A
1-PB2,541,1,1356,0,1,1358,T
1-PB2,542,12,0,0,1326,1338,C
1-PB2,543,1344,0,0,0,1344,A
1-PB2,544,0,0,0,1376,1376,C
1-PB2,545,1370,0,2,0,1372,A
1-PB2,546,1388,0,0,0,1388,A
1-PB2,547,0,1363,0,1,1364,T
1-PB2,548,0,1365,0,2,1367,T
1-PB2,549,1374,1,1,0,1376,A
1-PB2,550,1376,0,6,0,1382,A
1-PB2,551,2,1,0,1386,1389,C
1-PB2,552,1361,2,2,0,1365,A
1-PB2,553,1353,0,1,0,1354,A
1-PB2,554,0,1369,0,0,1369,T
1-PB2,555,1358,0,1,0,1359,A
1-PB2,556,1362,0,0,0,1362,A
1-PB2,557,0,0,0,1368,1368,C
1-PB2,558,0,1356,0,2,1358,T
1-PB2,559,1347,0,0,0,1347,A
1-PB2,560,1334,0,0,0,1334,A
1-PB2,561,1340,0,1,0,1341,A
1-PB2,562,0,13,1333,0,1346,G
1-PB2,563,1313,0,0,0,1313,A
1-PB2,564,0,8,1316,0,1324,G
1-PB2,565,1321,0,2,0,1323,A
1-PB2,566,1323,1,0,0,1324,A
1-PB2,567,1321,1,1,0,1323,A
1-PB2,568,1324,0,0,0,1324,A
1-PB2,569,1330,0,0,0,1330,A
1-PB2,570,1327,0,1,0,1328,A
1-PB2,571,0,2,1336,0,1338,G
1-PB2,572,1331,1,0,0,1332,A
1-PB2,573,1319,0,3,0,1322,A
1-PB2,574,0,9,1318,0,1327,G
1-PB2,575,1328,0,1,0,1329,A
1-PB2,576,1329,1,2,0,1332,A
1-PB2,577,0,0,0,1343,1343,C
1-PB2,578,0,1330,0,0,1330,T
1-PB2,579,6,0,0,1327,1333,C
1-PB2,580,2,0,0,1325,1327,C
1-PB2,581,4,13,1307,0,1324,G
1-PB2,582,1330,0,1,0,1331,A
1-PB2,583,0,2,1330,0,1332,G
1-PB2,584,1323,0,1,0,1324,A
1-PB2,585,0,1307,0,20,1327,T
1-PB2,586,0,1302,0,1,1303,T
1-PB2,587,1,0,1303,0,1304,G
1-PB2,588,4,0,0,1299,1303,C
1-PB2,589,1302,0,1,0,1303,A
1-PB2,590,1301,1,0,0,1302,A
1-PB2,591,1305,0,0,0,1305,A
1-PB2,592,1321,2,0,0,1323,A
1-PB2,593,0,1319,1,0,1320,T
1-PB2,594,0,1320,0,0,1320,T
1-PB2,595,0,1316,0,5,1321,T
1-PB2,596,2,0,0,1315,1317,C
1-PB2,597,0,1319,0,0,1319,T
1-PB2,598,8,0,0,1367,1375,C
1-PB2,599,3,0,0,1374,1377,C
1-PB2,600,10,0,1,1403,1414,C
1-PB2,601,0,1407,0,1,1408,T
1-PB2,602,0,1409,0,2,1411,T
1-PB2,603,0,8,1407,1,1416,G
1-PB2,604,1415,0,2,0,1417,A
1-PB2,605,1,1443,0,0,1444,T
1-PB2,606,0,10,1442,0,1452,G
1-PB2,607,0,0,1527,0,1527,G
1-PB2,608,2,1548,0,1,1551,T
1-PB2,609,0,1536,0,3,1539,T
1-PB2,610,2,1,1597,0,1600,G
1-PB2,611,1,4,0,1596,1601,C
1-PB2,612,1624,0,1,0,1625,A
1-PB2,613,0,1623,0,1,1624,T
1-PB2,614,1637,0,0,0,1637,A
1-PB2,615,0,0,0,1688,1688,C
1-PB2,616,1777,1,0,2,1780,A
1-PB2,617,0,1800,0,1,1801,T
1-PB2,618,0,1,1859,0,1860,G
1-PB2,619,0,1835,0,1,1836,T
1-PB2,620,0,1836,0,0,1836,T
1-PB2,621,1826,1,3,0,1830,A
1-PB2,622,0,6,1826,0,1832,G
1-PB2,623,1840,1,2,0,1843,A
1-PB2,624,0,16,1846,0,1862,G
1-PB2,625,1753,0,1,0,1754,A
1-PB2,626,2,13,1739,0,1754,G
1-PB2,627,1710,0,2,0,1712,A
1-PB2,628,2,16,1709,0,1727,G
1-PB2,629,1725,0,2,0,1727,A
1-PB2,630,1734,0,1,0,1735,A
1-PB2,631,1,0,0,1751,1752,C
1-PB2,632,0,1740,1,0,1741,T
1-PB2,633,0,1736,0,0,1736,T
1-PB2,634,0,0,1738,0,1738,G
1-PB2,635,0,1734,0,0,1734,T
1-PB2,636,1732,0,2,1,1735,A
1-PB2,637,1,1,0,1727,1729,C
1-PB2,638,0,11,1710,0,1721,G
1-PB2,639,1730,0,0,0,1730,A
1-PB2,640,1721,0,0,0,1721,A
1-PB2,641,1737,0,1,0,1738,A
1-PB2,642,1740,0,0,0,1740,A
1-PB2,643,1740,1,0,1,1742,A
1-PB2,644,1,1,0,1738,1740,C
1-PB2,645,1740,0,0,0,1740,A
1-PB2,646,1746,1,2,0,1749,A
1-PB2,647,0,16,1742,0,1758,G
1-PB2,648,1760,0,0,0,1760,A
1-PB2,649,0,1759,0,2,1761,T
1-PB2,650,0,1759,0,2,1761,T
1-PB2,651,0,1766,0,1,1767,T
1-PB2,652,9,2,0,1763,1774,C
1-PB2,653,4,1763,0,4,1771,T
1-PB2,654,6,0,0,1778,1784,C
1-PB2,655,9,0,0,1771,1780,C
1-PB2,656,9,0,1,1773,1783,C
1-PB2,657,1777,1,1,0,1779,A
1-PB2,658,0,0,1794,0,1794,G
1-PB2,659,0,1789,0,2,1791,T
1-PB2,660,0,1788,0,1,1789,T
1-PB2,661,0,1,1788,0,1789,G
1-PB2,662,0,2,1,1778,1781,C
1-PB2,663,0,1779,0,0,1779,T
1-PB2,664,2,4,1776,1,1783,G
1-PB2,665,2,1,1776,0,1779,G
1-PB2,666,0,3,0,1773,1776,C
1-PB2,667,1,5,1771,0,1777,G
1-PB2,668,0,9,1785,0,1794,G
1-PB2,669,1795,0,1,0,1796,A
1-PB2,670,1797,0,0,0,1797,A
1-PB2,671,2,1,0,1793,1796,C
1-PB2,672,1806,0,0,0,1806,A
1-PB2,673,1808,0,1,1,1810,A
1-PB2,674,0,0,1871,0,1871,G
1-PB2,675,4,0,1,1907,1912,C
1-PB2,676,1920,0,1,0,1921,A
1-PB2,677,1,0,2235,0,2236,G
1-PB2,678,0,2237,0,0,2237,T
1-PB2,679,2245,0,1,0,2246,A
1-PB2,680,3,2237,0,2,2242,T
1-PB2,681,2236,1,1,1,2239,A
1-PB2,682,0,2233,0,1,2234,T
1-PB2,683,2200,0,1,0,2201,A
1-PB2,684,0,0,0,2228,2228,C
1-PB2,685,2118,0,0,1,2119,A
1-PB2,686,0,1990,0,1,1991,T
1-PB2,687,1,1908,0,0,1909,T
1-PB2,688,1,9,1900,0,1910,G
1-PB2,689,1911,1,1,0,1913,A
1-PB2,690,1907,0,0,0,1907,A
1-PB2,691,1,2,1928,0,1931,G
1-PB2,692,0,1900,0,2,1902,T
1-PB2,693,0,1889,0,1,1890,T
1-PB2,694,0,1894,0,1,1895,T
1-PB2,695,0,1895,0,0,1895,T
1-PB2,696,1915,1,1,0,1917,A
1-PB2,697,1,2,0,1923,1926,C
1-PB2,698,1929,0,0,0,1929,A
1-PB2,699,0,1919,0,1,1920,T
1-PB2,700,0,1904,0,0,1904,T
1-PB2,701,0,1902,0,1,1903,T
1-PB2,702,0,37,1893,0,1930,G
1-PB2,703,1949,0,0,0,1949,A
1-PB2,704,1,0,0,1950,1951,C
1-PB2,705,0,1934,0,2,1936,T
1-PB2,706,6,1,0,1924,1931,C
1-PB2,707,1927,0,1,0,1928,A
1-PB2,708,0,12,1894,0,1906,G
1-PB2,709,2,9,1944,0,1955,G
1-PB2,710,1,18,1948,0,1967,G
1-PB2,711,1967,0,3,0,1970,A
1-PB2,712,1966,0,1,1,1968,A
1-PB2,713,1,1,0,1961,1963,C
1-PB2,714,2,4,1974,0,1980,G
1-PB2,715,0,1975,0,3,1978,T
1-PB2,716,1,1,1989,0,1991,G
1-PB2,717,0,1973,0,2,1975,T
1-PB2,718,0,1973,0,1,1974,T
1-PB2,719,1,12,1963,1,1977,G
1-PB2,720,1,9,1970,0,1980,G
1-PB2,721,0,13,1986,0,1999,G
1-PB2,722,1986,0,1,0,1987,A
1-PB2,723,1976,0,5,0,1981,A
1-PB2,724,0,1,0,2032,2033,C
1-PB2,725,2024,0,0,0,2024,A
1-PB2,726,2071,0,2,0,2073,A
1-PB2,727,2077,0,1,0,2078,A
1-PB2,728,1,2095,0,0,2096,T
1-PB2,729,0,1,2128,0,2129,G
1-PB2,730,0,2112,0,2,2114,T
1-PB2,731,2111,0,0,0,2111,A
1-PB2,732,3,1,0,2111,2115,C
1-PB2,733,2055,0,2,0,2057,A
1-PB2,734,0,0,0,2060,2060,C
1-PB2,735,0,1993,1,2,1996,T
1-PB2,736,17,1,0,2129,2147,C
1-PB2,737,5,0,0,2146,2151,C
1-PB2,738,2174,0,1,0,2175,A
1-PB2,739,1,6,2180,0,2187,G
1-PB2,740,1,3,2213,0,2217,G
1-PB2,741,0,2213,0,2,2215,T
1-PB2,742,0,6,2206,0,2212,G
1-PB2,743,0,7,2144,0,2151,G
1-PB2,744,2118,0,4,0,2122,A
1-PB2,745,0,9,2120,0,2129,G
1-PB2,746,0,12,2112,0,2124,G
1-PB2,747,2071,0,1,0,2072,A
1-PB2,748,1,0,2090,0,2091,G
1-PB2,749,0,2031,0,3,2034,T
1-PB2,750,0,8,2028,1,2037,G
1-PB2,751,2036,0,4,0,2040,A
1-PB2,752,3,5,2040,0,2048,G
1-PB2,753,5,13,2042,0,2060,G
1-PB2,754,2047,1,1,0,2049,A
1-PB2,755,2054,0,2,0,2056,A
1-PB2,756,1,2046,0,0,2047,T
1-PB2,757,0,9,2033,0,2042,G
1-PB2,758,2034,0,3,0,2037,A
1-PB2,759,0,2,0,2029,2031,C
1-PB2,760,1,7,2019,0,2027,G
1-PB2,761,2045,1,1,0,2047,A
1-PB2,762,0,2042,0,1,2043,T
1-PB2,763,1,1,2062,1,2065,G
1-PB2,764,0,2053,0,5,2058,T
1-PB2,765,1,2029,0,0,2030,T
1-PB2,766,1,16,2027,0,2044,G
1-PB2,767,2055,1,3,0,2059,A
1-PB2,768,4,0,1,2052,2057,C
1-PB2,769,16,3,2,2029,2050,C
1-PB2,770,2017,0,1,0,2018,A
1-PB2,771,2019,0,0,0,2019,A
1-PB2,772,2014,0,1,0,2015,A
1-PB2,773,0,1,2091,0,2092,G
1-PB2,774,1,0,0,2091,2092,C
1-PB2,775,5,1,0,2070,2076,C
1-PB2,776,0,2086,0,2,2088,T
1-PB2,777,2097,0,0,0,2097,A
1-PB2,778,2092,0,0,0,2092,A
1-PB2,779,1,2097,0,0,2098,T
1-PB2,780,0,2089,0,1,2090,T
1-PB2,781,2075,0,1,0,2076,A
1-PB2,782,1,2016,0,3,2020,T
1-PB2,783,1,1996,0,1,1998,T
1-PB2,784,4,1,1994,0,1999,G
1-PB2,785,2,0,0,1975,1977,C
1-PB2,786,7,7,1968,0,1982,G
1-PB2,787,1,1,2004,0,2006,G
1-PB2,788,0,2,0,2002,2004,C
1-PB2,789,4,0,0,2007,2011,C
1-PB2,790,2005,0,1,1,2007,A
1-PB2,791,1,5,2023,0,2029,G
1-PB2,792,0,13,2032,0,2045,G
1-PB2,793,2049,1,1,1,2052,A
1-PB2,794,2051,0,5,0,2056,A
1-PB2,795,1,1,0,2074,2076,C
1-PB2,796,2039,0,0,0,2039,A
1-PB2,797,0,2060,0,1,2061,T
1-PB2,798,2078,1,2,1,2082,A
1-PB2,799,0,1,2103,0,2104,G
1-PB2,800,0,2079,0,1,2080,T
1-PB2,801,2060,0,1,0,2061,A
1-PB2,802,2053,0,2,0,2055,A
1-PB2,803,1,9,2047,0,2057,G
1-PB2,804,2045,0,1,0,2046,A
1-PB2,805,1998,0,4,0,2002,A
1-PB2,806,0,8,1988,0,1996,G
1-PB2,807,1917,1,1,0,1919,A
1-PB2,808,0,0,1925,0,1925,G
1-PB2,809,2,1,0,1914,1917,C
1-PB2,810,8,3,0,1901,1912,C
1-PB2,811,6,1,1910,0,1917,G
1-PB2,812,0,2,0,1927,1929,C
1-PB2,813,1926,1,0,1,1928,A
1-PB2,814,2,0,2084,0,2086,G
1-PB2,815,0,2082,1,2,2085,T
1-PB2,816,2086,1,0,0,2087,A
1-PB2,817,0,2069,0,3,2072,T
1-PB2,818,10,2,0,2071,2083,C
1-PB2,819,2069,1,2,1,2073,A
1-PB2,820,0,1,2081,0,2082,G
1-PB2,821,3,1,0,2071,2075,C
1-PB2,822,1979,1,2,0,1982,A
1-PB2,823,0,9,1943,0,1952,G
1-PB2,824,1952,1,4,0,1957,A
1-PB2,825,1,1939,0,0,1940,T
1-PB2,826,12,0,0,1938,1950,C
1-PB2,827,6,1,0,1943,1950,C
1-PB2,828,1951,2,1,0,1954,A
1-PB2,829,1,0,0,1958,1959,C
1-PB2,830,0,1954,0,2,1956,T
1-PB2,831,1955,0,1,1,1957,A
1-PB2,832,0,1,1944,0,1945,G
1-PB2,833,1,4,0,1921,1926,C
1-PB2,834,1923,1,0,0,1924,A
1-PB2,835,0,1920,0,0,1920,T
1-PB2,836,1,0,0,1936,1937,C
1-PB2,837,1,1924,0,1,1926,T
1-PB2,838,0,1962,0,1,1963,T
1-PB2,839,1,1971,0,0,1972,T
1-PB2,840,1963,1,3,0,1967,A
1-PB2,841,0,1968,0,1,1969,T
1-PB2,842,0,1956,0,4,1960,T
1-PB2,843,1,2,1948,0,1951,G
1-PB2,844,1,7,1950,0,1958,G
1-PB2,845,1903,0,3,0,1906,A
1-PB2,846,1,5,1903,0,1909,G
1-PB2,847,1865,0,1,0,1866,A
1-PB2,848,0,1840,0,0,1840,T
1-PB2,849,0,0,1868,0,1868,G
1-PB2,850,0,1867,0,2,1869,T
1-PB2,851,2,0,1860,0,1862,G
1-PB2,852,1,1,0,1869,1871,C
1-PB2,853,16,1,0,1847,1864,C
1-PB2,854,1851,0,1,0,1852,A
1-PB2,855,1,1,1,1848,1851,C
1-PB2,856,1822,0,1,0,1823,A
1-PB2,857,0,0,1866,0,1866,G
1-PB2,858,2,1,0,1800,1803,C
1-PB2,859,1798,0,3,0,1801,A
1-PB2,860,2,1,0,1799,1802,C
1-PB2,861,1789,0,1,0,1790,A
1-PB2,862,1,0,0,1798,1799,C
1-PB2,863,1790,0,1,0,1791,A
1-PB2,864,1785,0,2,1,1788,A
1-PB2,865,1784,0,2,0,1786,A
1-PB2,866,0,1731,0,0,1731,T
1-PB2,867,0,1717,0,0,1717,T
1-PB2,868,1,7,1706,0,1714,G
1-PB2,869,0,1,1716,0,1717,G
1-PB2,870,1,3,1,1708,1713,C
1-PB2,871,1,10,1683,0,1694,G
1-PB2,872,0,6,1708,0,1714,G
1-PB2,873,1,5,1709,0,1715,G
1-PB2,874,1714,1,1,0,1716,A
1-PB2,875,0,1,0,1718,1719,C
1-PB2,876,1714,2,0,0,1716,A
1-PB2,877,1711,0,1,0,1712,A
1-PB2,878,2,7,1708,0,1717,G
1-PB2,879,0,1,1713,1,1715,G
1-PB2,880,1716,0,3,0,1719,A
1-PB2,881,0,1631,0,0,1631,T
1-PB2,882,1,7,1582,0,1590,G
1-PB2,883,2,1,1595,0,1598,G
1-PB2,884,0,1571,0,3,1574,T
1-PB2,885,3,7,1560,0,1570,G
1-PB2,886,1,7,1549,0,1557,G
1-PB2,887,1520,0,0,1,1521,A
1-PB2,888,2,0,0,1520,1522,C
1-PB2,889,1467,1,0,0,1468,A
1-PB2,890,0,1587,0,0,1587,T
1-PB2,891,0,1563,0,0,1563,T
1-PB2,892,13,0,1,1541,1555,C
1-PB2,893,1,1504,0,0,1505,T
1-PB2,894,0,1500,0,0,1500,T
1-PB2,895,1492,0,0,0,1492,A
1-PB2,896,1,4,1489,0,1494,G
1-PB2,897,1486,0,0,0,1486,A
1-PB2,898,1,1,0,1481,1483,C
1-PB2,899,1063,0,0,0,1063,A
1-PB2,900,0,4,1074,0,1078,G
1-PB2,901,1070,0,0,0,1070,A
1-PB2,902,1077,0,4,0,1081,A
1-PB2,903,0,1,0,1077,1078,C
1-PB2,904,6,0,0,1066,1072,C
1-PB2,905,1,3,0,1067,1071,C
1-PB2,906,34,4,1031,0,1069,G
1-PB2,907,1072,0,2,0,1074,A
1-PB2,908,0,0,0,1081,1081,C
1-PB2,909,0,1044,0,0,1044,T
1-PB2,910,0,1,1049,0,1050,G
1-PB2,911,1036,0,1,0,1037,A
1-PB2,912,1047,0,0,0,1047,A
1-PB2,913,0,7,1047,0,1054,G
1-PB2,914,1048,0,1,0,1049,A
1-PB2,915,1048,1,2,0,1051,A
1-PB2,916,0,0,0,1049,1049,C
1-PB2,917,1045,0,1,0,1046,A
1-PB2,918,1047,0,1,0,1048,A
1-PB2,919,0,0,1057,0,1057,G
1-PB2,920,1,0,0,1060,1061,C
1-PB2,921,0,1041,0,1,1042,T
1-PB2,922,0,1,1057,0,1058,G
1-PB2,923,0,1053,0,1,1054,T
1-PB2,924,4,8,1071,0,1083,G
1-PB2,925,1,0,1122,0,1123,G
1-PB2,926,1119,0,2,1,1122,A
1-PB2,927,0,1120,0,2,1122,T
1-PB2,928,1116,0,0,0,1116,A
1-PB2,929,0,1105,0,0,1105,T
1-PB2,930,1126,0,0,0,1126,A
1-PB2,931,0,1104,0,1,1105,T
1-PB2,932,0,0,1100,1,1101,G
1-PB2,933,1,1,0,1088,1090,C
1-PB2,934,1050,0,1,0,1051,A
1-PB2,935,1050,0,0,0,1050,A
1-PB2,936,0,2,1048,0,1050,G
1-PB2,937,0,0,1047,1,1048,G
1-PB2,938,1,0,0,1049,1050,C
1-PB2,939,0,1017,0,1,1018,T
1-PB2,940,1,0,1026,0,1027,G
1-PB2,941,1,0,0,1025,1026,C
1-PB2,942,1029,0,0,0,1029,A
1-PB2,943,1031,1,0,1,1033,A
1-PB2,944,0,1020,0,2,1022,T
1-PB2,945,2,5,1022,0,1029,G
1-PB2,946,0,3,1026,0,1029,G
1-PB2,947,0,3,1027,0,1030,G
1-PB2,948,1026,0,2,0,1028,A
1-PB2,949,0,1029,0,0,1029,T
1-PB2,950,0,1021,0,0,1021,T
1-PB2,951,2,9,1018,0,1029,G
1-PB2,952,1023,1,0,0,1024,A
1-PB2,953,0,3,1030,0,1033,G
1-PB2,954,1019,0,2,1,1022,A
1-PB2,955,1014,0,0,1,1015,A
1-PB2,956,0,1006,0,0,1006,T
1-PB2,957,3,0,0,1023,1026,C
1-PB2,958,1004,0,0,0,1004,A
1-PB2,959,0,2,1012,0,1014,G
1-PB2,960,0,0,0,1012,1012,C
1-PB2,961,0,1002,0,1,1003,T
1-PB2,962,7,0,0,991,998,C
1-PB2,963,998,0,1,0,999,A
1-PB2,964,1,1018,1,0,1020,T
1-PB2,965,2,0,0,1027,1029,C
1-PB2,966,1,0,0,1049,1050,C
1-PB2,967,1,1039,0,2,1042,T
1-PB2,968,0,1033,0,1,1034,T
1-PB2,969,5,0,0,1030,1035,C
1-PB2,970,1036,0,0,0,1036,A
1-PB2,971,0,0,1060,0,1060,G
1-PB2,972,1,0,0,1055,1056,C
1-PB2,973,0,1044,0,2,1046,T
1-PB2,974,0,1040,0,0,1040,T
1-PB2,975,0,1040,0,1,1041,T
1-PB2,976,0,1,1043,0,1044,G
1-PB2,977,0,0,1043,0,1043,G
1-PB2,978,1,1041,0,0,1042,T
1-PB2,979,0,6,1039,0,1045,G
1-PB2,980,0,8,1022,0,1030,G
1-PB2,981,0,0,1036,0,1036,G
1-PB2,982,0,1030,0,1,1031,T
1-PB2,983,1,1026,0,1,1028,T
1-PB2,984,0,1029,0,0,1029,T
1-PB2,985,1033,0,0,0,1033,A
1-PB2,986,0,0,0,1038,1038,C
1-PB2,987,1041,0,1,0,1042,A
1-PB2,988,0,1035,0,0,1035,T
1-PB2,989,0,1015,0,1,1016,T
1-PB2,990,0,1009,0,0,1009,T
1-PB2,991,1007,0,1,0,1008,A
1-PB2,992,1008,0,0,0,1008,A
1-PB2,993,1005,0,0,0,1005,A
1-PB2,994,999,0,3,0,1002,A
1-PB2,995,1,2,1010,0,1013,G
1-PB2,996,1007,0,2,1,1010,A
1-PB2,997,1011,0,0,0,1011,A
1-PB2,998,0,0,0,1015,1015,C
1-PB2,999,1012,0,1,0,1013,A
1-PB2,1000,1014,0,1,0,1015,A
1-PB2,1001,0,1,1016,0,1017,G
1-PB2,1002,1,1,0,1016,1018,C
1-PB2,1003,2,3,1006,0,1011,G
1-PB2,1004,0,5,1003,0,1008,G
1-PB2,1005,1,1,1011,0,1013,G
1-PB2,1006,0,1008,0,1,1009,T
1-PB2,1007,15,0,0,988,1003,C
1-PB2,1008,1007,0,0,0,1007,A
1-PB2,1009,1,1006,0,0,1007,T
1-PB2,1010,2,3,0,1003,1008,C
1-PB2,1011,998,0,2,0,1000,A
1-PB2,1012,2,0,1023,0,1025,G
1-PB2,1013,0,1015,0,1,1016,T
1-PB2,1014,7,0,0,1016,1023,C
1-PB2,1015,1017,3,0,0,1020,A
1-PB2,1016,1024,1,2,0,1027,A
1-PB2,1017,1027,0,0,0,1027,A
1-PB2,1018,1024,0,0,0,1024,A
1-PB2,1019,1029,0,0,0,1029,A
1-PB2,1020,1022,1,3,0,1026,A
1-PB2,1021,0,0,1038,0,1038,G
1-PB2,1022,1033,0,1,0,1034,A
1-PB2,1023,1033,0,1,0,1034,A
1-PB2,1024,0,4,1031,0,1035,G
1-PB2,1025,1029,0,1,0,1030,A
1-PB2,1026,956,0,1,1,958,A
1-PB2,1027,0,3,958,0,961,G
1-PB2,1028,955,0,2,0,957,A
1-PB2,1029,1,3,955,0,959,G
1-PB2,1030,0,0,981,0,981,G
1-PB2,1031,0,982,0,0,982,T
1-PB2,1032,0,0,1003,0,1003,G
1-PB2,1033,1,1,0,1008,1010,C
1-PB2,1034,0,1007,0,2,1009,T
1-PB2,1035,0,1009,0,1,1010,T
1-PB2,1036,1011,0,0,0,1011,A
1-PB2,1037,0,0,0,1010,1010,C
1-PB2,1038,983,0,6,0,989,A
1-PB2,1039,1,2,1001,0,1004,G
1-PB2,1040,1,1,996,1,999,G
1-PB2,1041,3,0,0,987,990,C
1-PB2,1042,970,0,0,0,970,A
1-PB2,1043,994,1,0,0,995,A
1-PB2,1044,0,1011,0,1,1012,T
1-PB2,1045,1,0,0,1026,1027,C
1-PB2,1046,0,1027,0,2,1029,T
1-PB2,1047,3,0,0,1021,1024,C
1-PB2,1048,5,0,0,1024,1029,C
1-PB2,1049,1030,0,1,0,1031,A
1-PB2,1050,1028,1,2,0,1031,A
1-PB2,1051,1030,2,2,0,1034,A
1-PB2,1052,1,0,0,1040,1041,C
1-PB2,1053,1019,0,0,0,1019,A
1-PB2,1054,0,1009,1,1,1011,T
1-PB2,1055,0,1003,0,1,1004,T
1-PB2,1056,1,1,1016,0,1018,G
1-PB2,1057,1014,0,2,0,1016,A
1-PB2,1058,1028,0,1,0,1029,A
1-PB2,1059,1030,0,0,0,1030,A
1-PB2,1060,1031,1,1,0,1033,A
1-PB2,1061,0,1044,0,0,1044,T
1-PB2,1062,1034,0,4,1,1039,A
1-PB2,1063,1038,0,0,0,1038,A
1-PB2,1064,0,5,1046,0,1051,G
1-PB2,1065,1034,0,2,0,1036,A
1-PB2,1066,2,0,1070,0,1072,G
1-PB2,1067,0,1071,0,0,1071,T
1-PB2,1068,1093,0,1,0,1094,A
1-PB2,1069,0,0,0,1133,1133,C
1-PB2,1070,1127,0,0,0,1127,A
1-PB2,1071,0,1124,0,2,1126,T
1-PB2,1072,40,4,1076,0,1120,G
1-PB2,1073,1097,0,4,0,1101,A
1-PB2,1074,1,5,1099,0,1105,G
1-PB2,1075,1,4,1092,0,1097,G
1-PB2,1076,0,4,1138,0,1142,G
1-PB2,1077,2,3,1139,0,1144,G
1-PB2,1078,1,1116,0,1,1118,T
1-PB2,1079,1122,1,0,0,1123,A
1-PB2,1080,0,1117,0,0,1117,T
1-PB2,1081,0,3,1124,0,1127,G
1-PB2,1082,1124,0,2,0,1126,A
1-PB2,1083,0,2,1121,0,1123,G
1-PB2,1084,0,5,1118,1,1124,G
1-PB2,1085,1051,1,1,0,1053,A
1-PB2,1086,0,0,1075,0,1075,G
1-PB2,1087,0,1069,0,1,1070,T
1-PB2,1088,0,1101,0,4,1105,T
1-PB2,1089,14,3,0,1094,1111,C
1-PB2,1090,1112,0,0,0,1112,A
1-PB2,1091,0,0,0,1113,1113,C
1-PB2,1092,1111,0,0,0,1111,A
1-PB2,1093,1120,0,2,0,1122,A
1-PB2,1094,1,1121,0,0,1122,T
1-PB2,1095,0,3,1096,0,1099,G
1-PB2,1096,0,3,1098,0,1101,G
1-PB2,1097,0,1077,0,0,1077,T
1-PB2,1098,1,2,1079,0,1082,G
1-PB2,1099,0,3,1081,0,1084,G
1-PB2,1100,1,5,1082,0,1088,G
1-PB2,1101,2,4,1090,0,1096,G
1-PB2,1102,1090,0,0,0,1090,A
1-PB2,1103,1089,0,1,0,1090,A
1-PB2,1104,1088,0,0,1,1089,A
1-PB2,1105,1073,0,1,0,1074,A
1-PB2,1106,3,9,1075,0,1087,G
1-PB2,1107,1073,2,1,0,1076,A
1-PB2,1108,0,2,1079,0,1081,G
1-PB2,1109,1,2,2,1077,1082,C
1-PB2,1110,1073,0,0,0,1073,A
1-PB2,1111,1073,0,1,0,1074,A
1-PB2,1112,1,0,0,1100,1101,C
1-PB2,1113,1094,0,0,0,1094,A
1-PB2,1114,0,2,1109,0,1111,G
1-PB2,1115,0,0,0,1104,1104,C
1-PB2,1116,1,1102,0,0,1103,T
1-PB2,1117,1136,0,0,0,1136,A
1-PB2,1118,0,1136,0,0,1136,T
1-PB2,1119,1136,0,0,0,1136,A
1-PB2,1120,0,0,0,1137,1137,C
1-PB2,1121,0,1063,0,0,1063,T
1-PB2,1122,1067,0,0,0,1067,A
1-PB2,1123,1049,0,0,0,1049,A
1-PB2,1124,0,3,1049,0,1052,G
1-PB2,1125,1048,0,1,0,1049,A
1-PB2,1126,1014,0,0,0,1014,A
1-PB2,1127,1011,0,1,0,1012,A
1-PB2,1128,1006,0,3,0,1009,A
1-PB2,1129,0,0,1018,0,1018,G
1-PB2,1130,0,0,0,1015,1015,C
1-PB2,1131,1009,0,1,0,1010,A
1-PB2,1132,1011,1,0,0,1012,A
1-PB2,1133,0,1,0,1012,1013,C
1-PB2,1134,3,0,0,1011,1014,C
1-PB2,1135,1015,0,0,0,1015,A
1-PB2,1136,0,3,1023,0,1026,G
1-PB2,1137,1023,0,1,1,1025,A
1-PB2,1138,1025,0,1,0,1026,A
1-PB2,1139,0,5,1032,0,1037,G
1-PB2,1140,1035,0,0,0,1035,A
1-PB2,1141,0,1034,0,1,1035,T
1-PB2,1142,0,1025,0,0,1025,T
1-PB2,1143,0,9,1016,0,1025,G
1-PB2,1144,0,1,1041,0,1042,G
1-PB2,1145,0,1035,0,2,1037,T
1-PB2,1146,0,1032,0,0,1032,T
1-PB2,1147,10,1,0,1028,1039,C
1-PB2,1148,1049,0,0,0,1049,A
1-PB2,1149,1,0,1081,0,1082,G
1-PB2,1150,1,1,1,1085,1088,C
1-PB2,1151,1,1086,0,3,1090,T
1-PB2,1152,9,0,0,1092,1101,C
1-PB2,1153,1088,0,0,0,1088,A
1-PB2,1154,0,1096,0,0,1096,T
1-PB2,1155,1098,0,0,0,1098,A
1-PB2,1156,1,0,1098,1,1100,G
1-PB2,1157,0,1062,0,1,1063,T
1-PB2,1158,0,10,1065,0,1075,G
1-PB2,1159,1042,0,1,0,1043,A
1-PB2,1160,1,0,1054,0,1055,G
1-PB2,1161,0,1038,0,1,1039,T
1-PB2,1162,0,5,1039,0,1044,G
1-PB2,1163,0,4,1046,0,1050,G
1-PB2,1164,1044,0,2,0,1046,A
1-PB2,1165,1037,1,0,0,1038,A
1-PB2,1166,0,6,1036,0,1042,G
1-PB2,1167,1020,0,2,0,1022,A
1-PB2,1168,0,8,1027,0,1035,G
1-PB2,1169,1016,0,4,0,1020,A
1-PB2,1170,1,2,0,1019,1022,C
1-PB2,1171,1,12,1011,0,1024,G
1-PB2,1172,1023,0,0,0,1023,A
1-PB2,1173,1028,1,0,0,1029,A
1-PB2,1174,0,0,0,1033,1033,C
1-PB2,1175,1027,0,1,0,1028,A
1-PB2,1176,0,1,1080,0,1081,G
1-PB2,1177,1,1072,0,2,1075,T
1-PB2,1178,3,0,0,1075,1078,C
1-PB2,1179,1078,0,0,0,1078,A
1-PB2,1180,1081,0,0,0,1081,A
1-PB2,1181,1,1081,0,0,1082,T
1-PB2,1182,1081,0,0,0,1081,A
1-PB2,1183,0,0,1078,0,1078,G
1-PB2,1184,2,1,0,1071,1074,C
1-PB2,1185,7,1,0,1037,1045,C
1-PB2,1186,1,2,1039,0,1042,G
1-PB2,1187,1039,1,0,0,1040,A
1-PB2,1188,1038,1,1,0,1040,A
1-PB2,1189,1,0,1050,2,1053,G
1-PB2,1190,0,1,0,1072,1073,C
1-PB2,1191,1072,0,0,0,1072,A
1-PB2,1192,1083,0,3,0,1086,A
1-PB2,1193,0,1087,0,0,1087,T
1-PB2,1194,1090,0,1,0,1091,A
1-PB2,1195,1103,0,0,0,1103,A
1-PB2,1196,0,1094,0,0,1094,T
1-PB2,1197,4,0,0,1085,1089,C
1-PB2,1198,0,0,1091,0,1091,G
1-PB2,1199,0,1059,0,0,1059,T
1-PB2,1200,0,6,1048,1,1055,G
1-PB2,1201,0,1,1065,0,1066,G
1-PB2,1202,2,0,1,1063,1066,C
1-PB2,1203,4,1,0,1062,1067,C
1-PB2,1204,1063,0,1,0,1064,A
1-PB2,1205,0,1064,1,1,1066,T
1-PB2,1206,0,4,1060,0,1064,G
1-PB2,1207,0,0,1080,0,1080,G
1-PB2,1208,0,1075,0,1,1076,T
1-PB2,1209,1,0,1084,0,1085,G
1-PB2,1210,0,1069,0,1,1070,T
1-PB2,1211,0,1079,0,1,1080,T
1-PB2,1212,0,1081,0,1,1082,T
1-PB2,1213,0,1085,0,2,1087,T
1-PB2,1214,4,0,0,1105,1109,C
1-PB2,1215,1107,1,1,0,1109,A
1-PB2,1216,1,0,0,1182,1183,C
1-PB2,1217,1170,0,0,0,1170,A
1-PB2,1218,1176,0,2,0,1178,A
1-PB2,1219,0,2,1182,0,1184,G
1-PB2,1220,1175,0,1,0,1176,A
1-PB2,1221,72,4,1121,0,1197,G
1-PB2,1222,0,5,1198,0,1203,G
1-PB2,1223,1198,0,1,0,1199,A
1-PB2,1224,0,1205,0,2,1207,T
1-PB2,1225,0,1196,0,0,1196,T
1-PB2,1226,0,0,1189,1,1190,G
1-PB2,1227,3,0,0,1163,1166,C
1-PB2,1228,1173,0,1,0,1174,A
1-PB2,1229,0,1179,0,1,1180,T
1-PB2,1230,0,7,1227,0,1234,G
1-PB2,1231,1247,0,0,0,1247,A
1-PB2,1232,1,1251,0,1,1253,T
1-PB2,1233,1249,0,1,0,1250,A
1-PB2,1234,1248,0,1,0,1249,A
1-PB2,1235,1247,1,1,0,1249,A
1-PB2,1236,1250,0,2,0,1252,A
1-PB2,1237,0,1,1260,0,1261,G
1-PB2,1238,2,0,0,1276,1278,C
1-PB2,1239,1303,0,2,0,1305,A
1-PB2,1240,0,0,1363,0,1363,G
1-PB2,1241,0,1360,0,0,1360,T
1-PB2,1242,0,1355,0,1,1356,T
1-PB2,1243,1360,0,0,0,1360,A
1-PB2,1244,0,4,1387,0,1391,G
1-PB2,1245,1385,0,0,0,1385,A
1-PB2,1246,0,5,1376,0,1381,G
1-PB2,1247,0,1,1381,0,1382,G
1-PB2,1248,0,1332,0,4,1336,T
1-PB2,1249,1,14,1328,0,1343,G
1-PB2,1250,1342,0,2,0,1344,A
1-PB2,1251,0,1,0,1356,1357,C
1-PB2,1252,1,0,1,1358,1360,C
1-PB2,1253,0,1286,1,2,1289,T
1-PB2,1254,0,3,1294,0,1297,G
1-PB2,1255,1296,0,0,0,1296,A
1-PB2,1256,1291,0,1,0,1292,A
1-PB2,1257,0,1291,0,1,1292,T
1-PB2,1258,0,1323,0,0,1323,T
1-PB2,1259,1,1322,0,0,1323,T
1-PB2,1260,7,2,0,1314,1323,C
1-PB2,1261,0,0,1321,0,1321,G
1-PB2,1262,1,1319,1,2,1323,T
1-PB2,1263,5,0,0,1317,1322,C
1-PB2,1264,1313,2,2,0,1317,A
1-PB2,1265,1318,0,1,0,1319,A
1-PB2,1266,1,0,0,1314,1315,C
1-PB2,1267,1310,0,0,0,1310,A
1-PB2,1268,1,3,1332,0,1336,G
1-PB2,1269,1325,1,2,0,1328,A
1-PB2,1270,0,1,1331,0,1332,G
1-PB2,1271,1,1,0,1332,1334,C
1-PB2,1272,1334,0,0,0,1334,A
1-PB2,1273,1352,0,2,0,1354,A
1-PB2,1274,1351,0,1,0,1352,A
1-PB2,1275,0,1350,0,0,1350,T
1-PB2,1276,10,0,0,1343,1353,C
1-PB2,1277,1343,0,3,0,1346,A
1-PB2,1278,0,0,1351,0,1351,G
1-PB2,1279,1,3,0,1344,1348,C
1-PB2,1280,2,3,1347,0,1352,G
1-PB2,1281,1,2,1424,0,1427,G
1-PB2,1282,0,1419,0,0,1419,T
1-PB2,1283,0,1415,0,1,1416,T
1-PB2,1284,0,11,1409,1,1421,G
1-PB2,1285,1410,0,5,0,1415,A
1-PB2,1286,1430,0,1,0,1431,A
1-PB2,1287,0,0,0,1444,1444,C
1-PB2,1288,8,0,0,1436,1444,C
1-PB2,1289,5,1,0,1446,1452,C
1-PB2,1290,2,0,0,1409,1411,C
1-PB2,1291,1414,0,0,0,1414,A
1-PB2,1292,0,1416,0,2,1418,T
1-PB2,1293,0,3,1423,0,1426,G
1-PB2,1294,1,0,0,1436,1437,C
1-PB2,1295,1426,0,2,0,1428,A
1-PB2,1296,0,1414,0,2,1416,T
1-PB2,1297,6,0,0,1408,1414,C
1-PB2,1298,1401,0,2,0,1403,A
1-PB2,1299,0,1,1437,0,1438,G
1-PB2,1300,0,0,0,1451,1451,C
1-PB2,1301,0,1418,0,2,1420,T
1-PB2,1302,0,1421,0,0,1421,T
1-PB2,1303,0,1407,0,2,1409,T
1-PB2,1304,0,1415,0,0,1415,T
1-PB2,1305,1412,0,0,0,1412,A
1-PB2,1306,1408,0,1,0,1409,A
1-PB2,1307,0,10,1405,0,1415,G
1-PB2,1308,2,0,1404,0,1406,G
1-PB2,1309,1,0,1,1388,1390,C
1-PB2,1310,1387,0,0,0,1387,A
1-PB2,1311,1,1388,0,0,1389,T
1-PB2,1312,0,1389,0,0,1389,T
1-PB2,1313,1,1393,0,0,1394,T
1-PB2,1314,0,1395,0,2,1397,T
1-PB2,1315,6,1,0,1389,1396,C
1-PB2,1316,1390,0,2,0,1392,A
1-PB2,1317,1,7,1385,0,1393,G
1-PB2,1318,1390,0,0,0,1390,A
1-PB2,1319,1389,0,0,1,1390,A
1-PB2,1320,1393,0,1,0,1394,A
1-PB2,1321,0,4,1394,0,1398,G
1-PB2,1322,1405,0,2,0,1407,A
1-PB2,1323,0,1407,0,1,1408,T
1-PB2,1324,1,1,1411,0,1413,G
1-PB2,1325,0,5,0,1406,1411,C
1-PB2,1326,2,11,1402,0,1415,G
1-PB2,1327,1416,0,1,0,1417,A
1-PB2,1328,1414,1,0,0,1415,A
1-PB2,1329,1412,0,1,0,1413,A
1-PB2,1330,1,0,1419,0,1420,G
1-PB2,1331,0,1406,0,1,1407,T
1-PB2,1332,0,1,1406,0,1407,G
1-PB2,1333,1,1,0,1401,1403,C
1-PB2,1334,0,1397,0,3,1400,T
1-PB2,1335,0,1401,0,1,1402,T
1-PB2,1336,0,1396,0,1,1397,T
1-PB2,1337,1,1401,0,0,1402,T
1-PB2,1338,0,1400,0,0,1400,T
1-PB2,1339,8,0,0,1394,1402,C
1-PB2,1340,1402,0,0,0,1402,A
1-PB2,1341,1402,0,2,0,1404,A
1-PB2,1342,1399,0,0,1,1400,A
1-PB2,1343,1407,0,0,0,1407,A
1-PB2,1344,0,1412,1,0,1413,T
1-PB2,1345,0,1409,0,2,1411,T
1-PB2,1346,0,8,1405,0,1413,G
1-PB2,1347,0,7,1403,0,1410,G
1-PB2,1348,1,3,1406,1,1411,G
1-PB2,1349,0,11,1415,2,1428,G
1-PB2,1350,1424,0,2,0,1426,A
1-PB2,1351,0,0,1458,0,1458,G
1-PB2,1352,0,1453,0,2,1455,T
1-PB2,1353,0,1452,0,2,1454,T
1-PB2,1354,0,10,1448,0,1458,G
1-PB2,1355,1455,0,1,0,1456,A
1-PB2,1356,1455,0,2,0,1457,A
1-PB2,1357,0,1,0,1492,1493,C
1-PB2,1358,1471,1,1,1,1474,A
1-PB2,1359,1,0,1,1522,1524,C
1-PB2,1360,1486,0,0,1,1487,A
1-PB2,1361,0,1502,1,0,1503,T
1-PB2,1362,5,0,0,1497,1502,C
1-PB2,1363,3,13,1484,0,1500,G
1-PB2,1364,1504,0,1,0,1505,A
1-PB2,1365,1,1,0,1502,1504,C
1-PB2,1366,1463,0,0,0,1463,A
1-PB2,1367,0,0,1510,0,1510,G
1-PB2,1368,1,1483,0,0,1484,T
1-PB2,1369,1,0,1509,0,1510,G
1-PB2,1370,0,1501,0,0,1501,T
1-PB2,1371,1,5,1499,1,1506,G
1-PB2,1372,1503,0,0,1,1504,A
1-PB2,1373,0,1489,0,0,1489,T
1-PB2,1374,0,7,1489,0,1496,G
1-PB2,1375,1,7,1491,0,1499,G
1-PB2,1376,0,9,1469,0,1478,G
1-PB2,1377,1469,0,2,1,1472,A
1-PB2,1378,1459,0,1,0,1460,A
1-PB2,1379,0,1461,1,0,1462,T
1-PB2,1380,2,12,1463,0,1477,G
1-PB2,1381,1479,1,1,0,1481,A
1-PB2,1382,0,1482,0,0,1482,T
1-PB2,1383,0,1473,0,3,1476,T
1-PB2,1384,0,4,1458,0,1462,G
1-PB2,1385,1,7,1494,0,1502,G
1-PB2,1386,1485,2,3,0,1490,A
1-PB2,1387,0,2,1526,0,1528,G
1-PB2,1388,0,1512,0,2,1514,T
1-PB2,1389,1510,0,1,0,1511,A
1-PB2,1390,0,1515,1,1,1517,T
1-PB2,1391,0,1534,0,0,1534,T
1-PB2,1392,1549,0,1,0,1550,A
1-PB2,1393,2,0,0,1548,1550,C
1-PB2,1394,4,0,2,1513,1519,C
1-PB2,1395,1505,0,3,0,1508,A
1-PB2,1396,0,2,1515,0,1517,G
1-PB2,1397,1547,0,0,0,1547,A
1-PB2,1398,0,1538,0,0,1538,T
1-PB2,1399,1531,0,1,0,1532,A
1-PB2,1400,0,1512,0,0,1512,T
1-PB2,1401,2,14,1494,0,1510,G
1-PB2,1402,1517,0,3,0,1520,A
1-PB2,1403,1,1,0,1530,1532,C
1-PB2,1404,0,1521,0,2,1523,T
1-PB2,1405,9,0,1,1516,1526,C
1-PB2,1406,3,0,1,1502,1506,C
1-PB2,1407,1508,0,0,0,1508,A
1-PB2,1408,1518,1,2,0,1521,A
1-PB2,1409,0,2,1551,0,1553,G
1-PB2,1410,0,2,0,1548,1550,C
1-PB2,1411,1551,0,1,1,1553,A
1-PB2,1412,0,2,0,1555,1557,C
1-PB2,1413,1546,0,3,0,1549,A
1-PB2,1414,0,7,1546,0,1553,G
1-PB2,1415,1540,0,2,0,1542,A
1-PB2,1416,1,4,1557,0,1562,G
1-PB2,1417,1563,0,2,0,1565,A
1-PB2,1418,0,1540,0,0,1540,T
1-PB2,1419,1,1,1577,0,1579,G
1-PB2,1420,0,1575,0,2,1577,T
1-PB2,1421,12,1,0,1557,1570,C
1-PB2,1422,1572,0,5,0,1577,A
1-PB2,1423,1572,0,1,0,1573,A
1-PB2,1424,0,1573,0,1,1574,T
1-PB2,1425,0,10,1564,0,1574,G
1-PB2,1426,1535,0,6,0,1541,A
1-PB2,1427,0,3,1557,0,1560,G
1-PB2,1428,1534,0,2,0,1536,A
1-PB2,1429,0,7,1543,0,1550,G
1-PB2,1430,1,10,1638,0,1649,G
1-PB2,1431,1641,0,2,0,1643,A
1-PB2,1432,1649,0,0,0,1649,A
1-PB2,1433,0,1645,0,0,1645,T
1-PB2,1434,1643,0,2,0,1645,A
1-PB2,1435,1641,1,1,0,1643,A
1-PB2,1436,0,8,1631,0,1639,G
1-PB2,1437,1628,1,3,0,1632,A
1-PB2,1438,1,0,1641,0,1642,G
1-PB2,1439,0,1553,0,0,1553,T
1-PB2,1440,16,1,0,1540,1557,C
1-PB2,1441,1557,0,1,0,1558,A
1-PB2,1442,1,0,1579,0,1580,G
1-PB2,1443,2,0,0,1616,1618,C
1-PB2,1444,1615,1,0,0,1616,A
1-PB2,1445,1618,1,1,0,1620,A
1-PB2,1446,1615,1,0,2,1618,A
1-PB2,1447,1618,1,2,0,1621,A
1-PB2,1448,0,1619,0,0,1619,T
1-PB2,1449,1,14,1603,0,1618,G
1-PB2,1450,0,5,1616,0,1621,G
1-PB2,1451,2,1,1624,0,1627,G
1-PB2,1452,0,1603,0,1,1604,T
1-PB2,1453,1,2,1609,0,1612,G
1-PB2,1454,0,1609,0,0,1609,T
1-PB2,1455,0,6,1616,0,1622,G
1-PB2,1456,0,6,1647,0,1653,G
1-PB2,1457,1651,0,0,0,1651,A
1-PB2,1458,1,1635,0,0,1636,T
1-PB2,1459,1,13,1642,1,1657,G
1-PB2,1460,1650,0,0,0,1650,A
1-PB2,1461,1653,0,3,0,1656,A
1-PB2,1462,1,1654,0,1,1656,T
1-PB2,1463,1628,0,0,0,1628,A
1-PB2,1464,1,1,0,1769,1771,C
1-PB2,1465,1,1728,0,2,1731,T
1-PB2,1466,9,3,0,1753,1765,C
1-PB2,1467,3,1,0,1765,1769,C
1-PB2,1468,1765,0,2,0,1767,A
1-PB2,1469,1,1,1832,0,1834,G
1-PB2,1470,0,1820,0,0,1820,T
1-PB2,1471,1838,0,1,0,1839,A
1-PB2,1472,0,0,0,1849,1849,C
1-PB2,1473,1723,0,1,0,1724,A
1-PB2,1474,0,8,1718,0,1726,G
1-PB2,1475,1690,0,1,0,1691,A
1-PB2,1476,0,5,1699,0,1704,G
1-PB2,1477,1671,0,4,0,1675,A
1-PB2,1478,0,7,1628,0,1635,G
1-PB2,1479,0,4,1630,0,1634,G
1-PB2,1480,0,1,1636,0,1637,G
1-PB2,1481,0,1613,0,0,1613,T
1-PB2,1482,0,0,1611,1,1612,G
1-PB2,1483,0,0,1614,1,1615,G
1-PB2,1484,0,1609,0,0,1609,T
1-PB2,1485,0,13,1649,0,1662,G
1-PB2,1486,0,2,1657,0,1659,G
1-PB2,1487,0,1627,1,0,1628,T
1-PB2,1488,0,1625,0,5,1630,T
1-PB2,1489,1596,0,1,1,1598,A
1-PB2,1490,2,1,1614,0,1617,G
1-PB2,1491,1,2,0,1612,1615,C
1-PB2,1492,1615,0,0,0,1615,A
1-PB2,1493,0,1609,0,1,1610,T
1-PB2,1494,0,1537,0,0,1537,T
1-PB2,1495,0,4,1537,0,1541,G
1-PB2,1496,1536,1,0,0,1537,A
1-PB2,1497,0,1537,0,1,1538,T
1-PB2,1498,8,0,0,1531,1539,C
1-PB2,1499,2,3,1518,0,1523,G
1-PB2,1500,0,0,1560,0,1560,G
1-PB2,1501,0,1555,0,1,1556,T
1-PB2,1502,0,1554,0,2,1556,T
1-PB2,1503,0,1553,0,1,1554,T
1-PB2,1504,1,1553,0,2,1556,T
1-PB2,1505,1,1556,0,1,1558,T
1-PB2,1506,1,9,1547,0,1557,G
1-PB2,1507,1549,1,2,0,1552,A
1-PB2,1508,0,6,1551,1,1558,G
1-PB2,1509,1513,0,1,0,1514,A
1-PB2,1510,0,1,1526,0,1527,G
1-PB2,1511,0,1532,0,2,1534,T
1-PB2,1512,1,1528,0,1,1530,T
1-PB2,1513,8,0,0,1523,1531,C
1-PB2,1514,2,11,1522,0,1535,G
1-PB2,1515,1538,1,3,0,1542,A
1-PB2,1516,1,4,1535,0,1540,G
1-PB2,1517,1538,0,1,0,1539,A
1-PB2,1518,1,1,0,1539,1541,C
1-PB2,1519,11,1,0,1517,1529,C
1-PB2,1520,1518,1,3,0,1522,A
1-PB2,1521,1539,1,2,0,1542,A
1-PB2,1522,1,0,0,1544,1545,C
1-PB2,1523,0,0,1548,0,1548,G
1-PB2,1524,1,1528,0,1,1530,T
1-PB2,1525,0,5,1524,0,1529,G
1-PB2,1526,0,1,1530,0,1531,G
1-PB2,1527,2,4,1529,0,1535,G
1-PB2,1528,1525,0,0,0,1525,A
1-PB2,1529,1529,1,0,0,1530,A
1-PB2,1530,0,1496,0,0,1496,T
1-PB2,1531,0,0,1615,0,1615,G
1-PB2,1532,1,1601,0,0,1602,T
1-PB2,1533,1607,0,0,0,1607,A
1-PB2,1534,0,1610,0,3,1613,T
1-PB2,1535,0,1602,0,1,1603,T
1-PB2,1536,1626,0,0,0,1626,A
1-PB2,1537,1,1621,0,0,1622,T
1-PB2,1538,0,1614,0,0,1614,T
1-PB2,1539,1612,0,0,0,1612,A
1-PB2,1540,0,1470,0,3,1473,T
1-PB2,1541,2,0,0,1529,1531,C
1-PB2,1542,0,1515,0,0,1515,T
1-PB2,1543,11,0,0,1508,1519,C
1-PB2,1544,0,0,1,1522,1523,C
1-PB2,1545,1,1484,0,2,1487,T
1-PB2,1546,0,7,1483,0,1490,G
1-PB2,1547,1482,0,1,0,1483,A
1-PB2,1548,0,0,1485,0,1485,G
1-PB2,1549,0,6,1483,0,1489,G
1-PB2,1550,1384,0,0,0,1384,A
1-PB2,1551,0,5,1408,0,1413,G
1-PB2,1552,0,0,1410,0,1410,G
1-PB2,1553,1,1346,0,2,1349,T
1-PB2,1554,11,0,0,1337,1348,C
1-PB2,1555,1335,0,0,0,1335,A
1-PB2,1556,0,0,1365,0,1365,G
1-PB2,1557,0,1363,0,1,1364,T
1-PB2,1558,2,5,1352,0,1359,G
1-PB2,1559,1362,0,1,0,1363,A
1-PB2,1560,1339,0,1,0,1340,A
1-PB2,1561,1340,1,1,1,1343,A
1-PB2,1562,0,0,0,1344,1344,C
1-PB2,1563,1327,1,1,0,1329,A
1-PB2,1564,2,0,0,1330,1332,C
1-PB2,1565,1282,0,1,0,1283,A
1-PB2,1566,0,1,1293,0,1294,G
1-PB2,1567,0,6,1284,1,1291,G
1-PB2,1568,0,8,1302,0,1310,G
1-PB2,1569,1308,0,2,0,1310,A
1-PB2,1570,1301,0,0,0,1301,A
1-PB2,1571,1,0,0,1311,1312,C
1-PB2,1572,0,1282,0,1,1283,T
1-PB2,1573,0,11,1270,0,1281,G
1-PB2,1574,1273,0,0,0,1273,A
1-PB2,1575,1,3,1268,0,1272,G
1-PB2,1576,1251,0,2,0,1253,A
1-PB2,1577,0,7,1208,0,1215,G
1-PB2,1578,1212,0,1,1,1214,A
1-PB2,1579,1,0,0,1215,1216,C
1-PB2,1580,1,1180,0,0,1181,T
1-PB2,1581,2,4,1200,0,1206,G
1-PB2,1582,1204,0,2,0,1206,A
1-PB2,1583,0,0,1,1213,1214,C
1-PB2,1584,1212,0,0,0,1212,A
1-PB2,1585,1212,0,0,0,1212,A
1-PB2,1586,0,1208,1,0,1209,T
1-PB2,1587,1225,0,1,0,1226,A
1-PB2,1588,1227,0,1,0,1228,A
1-PB2,1589,3,0,0,1231,1234,C
1-PB2,1590,0,1169,0,3,1172,T
1-PB2,1591,0,1163,0,1,1164,T
1-PB2,1592,1158,0,0,0,1158,A
1-PB2,1593,0,1157,0,0,1157,T
1-PB2,1594,0,1153,0,1,1154,T
1-PB2,1595,11,0,0,1144,1155,C
1-PB2,1596,1096,0,0,0,1096,A
1-PB2,1597,0,1097,0,0,1097,T
1-PB2,1598,5,1,0,1058,1064,C
1-PB2,1599,1,0,1068,0,1069,G
1-PB2,1600,0,1071,0,2,1073,T
1-PB2,1601,5,0,0,1051,1056,C
1-PB2,1602,0,3,1050,0,1053,G
1-PB2,1603,1057,0,1,0,1058,A
1-PB2,1604,0,1055,0,0,1055,T
1-PB2,1605,1,1,1053,0,1055,G
1-PB2,1606,1043,0,2,0,1045,A
1-PB2,1607,0,1046,0,0,1046,T
1-PB2,1608,0,0,1040,0,1040,G
1-PB2,1609,0,1019,0,0,1019,T
1-PB2,1610,0,3,1015,0,1018,G
1-PB2,1611,1,2,1019,0,1022,G
1-PB2,1612,0,6,1010,0,1016,G
1-PB2,1613,1000,1,1,0,1002,A
1-PB2,1614,0,2,997,0,999,G
1-PB2,1615,958,1,0,0,959,A
1-PB2,1616,0,943,0,0,943,T
1-PB2,1617,0,930,0,1,931,T
1-PB2,1618,925,1,0,0,926,A
1-PB2,1619,922,0,2,0,924,A
1-PB2,1620,0,0,0,920,920,C
1-PB2,1621,0,7,879,0,886,G
1-PB2,1622,0,0,892,0,892,G
1-PB2,1623,0,842,0,0,842,T
1-PB2,1624,8,0,0,827,835,C
1-PB2,1625,3,0,0,837,840,C
1-PB2,1626,0,770,0,2,772,T
1-PB2,1627,0,5,767,0,772,G
1-PB2,1628,765,1,1,0,767,A
1-PB2,1629,0,0,773,0,773,G
1-PB2,1630,1,770,0,1,772,T
1-PB2,1631,8,0,0,734,742,C
1-PB2,1632,1,1,742,0,744,G
1-PB2,1633,0,8,740,0,748,G
1-PB2,1634,0,745,0,4,749,T
1-PB2,1635,0,747,0,0,747,T
1-PB2,1636,0,739,0,1,740,T
1-PB2,1637,0,741,0,0,741,T
1-PB2,1638,1,3,752,0,756,G
1-PB2,1639,1,0,760,0,761,G
1-PB2,1640,0,758,0,0,758,T
1-PB2,1641,11,0,0,746,757,C
1-PB2,1642,746,0,0,1,747,A
1-PB2,1643,768,0,0,0,768,A
1-PB2,1644,0,770,0,0,770,T
1-PB2,1645,774,0,0,0,774,A
1-PB2,1646,1,0,1,788,790,C
1-PB2,1647,0,0,1,754,755,C
1-PB2,1648,0,748,1,1,750,T
1-PB2,1649,764,0,1,0,765,A
1-PB2,1650,0,763,0,1,764,T
1-PB2,1651,3,1,0,765,769,C
1-PB2,1652,749,0,0,0,749,A
1-PB2,1653,752,0,0,0,752,A
1-PB2,1654,0,749,0,1,750,T
1-PB2,1655,0,3,722,0,725,G
1-PB2,1656,0,3,726,0,729,G
1-PB2,1657,719,0,0,0,719,A
1-PB2,1658,0,709,0,0,709,T
1-PB2,1659,5,0,1,701,707,C
1-PB2,1660,709,0,1,0,710,A
1-PB2,1661,1,710,0,0,711,T
1-PB2,1662,2,2,0,709,713,C
1-PB2,1663,712,0,0,0,712,A
1-PB2,1664,0,2,716,0,718,G
1-PB2,1665,714,0,0,0,714,A
1-PB2,1666,712,0,1,0,713,A
1-PB2,1667,719,0,1,0,720,A
1-PB2,1668,0,716,0,0,716,T
1-PB2,1669,0,718,0,0,718,T
1-PB2,1670,0,4,711,0,715,G
1-PB2,1671,0,0,713,0,713,G
1-PB2,1672,0,0,712,0,712,G
1-PB2,1673,709,0,0,0,709,A
1-PB2,1674,704,0,0,0,704,A
1-PB2,1675,0,0,705,0,705,G
1-PB2,1676,1,0,0,702,703,C
1-PB2,1677,0,701,0,0,701,T
1-PB2,1678,0,0,711,0,711,G
1-PB2,1679,0,710,0,0,710,T
1-PB2,1680,3,0,0,704,707,C
1-PB2,1681,710,0,0,0,710,A
1-PB2,1682,717,0,0,0,717,A
1-PB2,1683,712,0,1,0,713,A
1-PB2,1684,715,1,1,0,717,A
1-PB2,1685,0,720,0,0,720,T
1-PB2,1686,0,712,0,0,712,T
1-PB2,1687,2,0,0,706,708,C
1-PB2,1688,701,0,0,0,701,A
1-PB2,1689,697,0,1,1,699,A
1-PB2,1690,0,700,0,1,701,T
1-PB2,1691,0,5,697,0,702,G
1-PB2,1692,0,0,709,0,709,G
1-PB2,1693,0,706,1,1,708,T
1-PB2,1694,5,0,0,707,712,C
1-PB2,1695,0,712,0,0,712,T
1-PB2,1696,3,0,0,707,710,C
1-PB2,1697,707,1,0,0,708,A
1-PB2,1698,0,4,713,0,717,G
1-PB2,1699,717,0,0,0,717,A
1-PB2,1700,713,0,0,0,713,A
1-PB2,1701,1,702,0,0,703,T
1-PB2,1702,2,0,0,694,696,C
1-PB2,1703,1,1,0,678,680,C
1-PB2,1704,0,678,0,0,678,T
1-PB2,1705,0,0,682,0,682,G
1-PB2,1706,0,0,0,682,682,C
1-PB2,1707,670,1,0,0,671,A
1-PB2,1708,687,0,0,0,687,A
1-PB2,1709,0,680,0,0,680,T
1-PB2,1710,1,0,698,0,699,G
1-PB2,1711,1,698,0,0,699,T
1-PB2,1712,0,677,0,1,678,T
1-PB2,1713,1,0,685,0,686,G
1-PB2,1714,0,682,0,2,684,T
1-PB2,1715,683,0,1,0,684,A
1-PB2,1716,0,1,0,683,684,C
1-PB2,1717,667,0,0,0,667,A
1-PB2,1718,672,0,0,0,672,A
1-PB2,1719,1,0,0,663,664,C
1-PB2,1720,652,0,0,0,652,A
1-PB2,1721,651,0,1,0,652,A
1-PB2,1722,638,0,0,0,638,A
1-PB2,1723,638,0,1,0,639,A
1-PB2,1724,0,639,0,1,640,T
1-PB2,1725,0,1,632,0,633,G
1-PB2,1726,0,4,628,0,632,G
1-PB2,1727,629,0,0,0,629,A
1-PB2,1728,630,0,1,0,631,A
1-PB2,1729,0,626,0,0,626,T
1-PB2,1730,0,628,0,0,628,T
1-PB2,1731,0,625,0,1,626,T
1-PB2,1732,0,7,618,0,625,G
1-PB2,1733,629,0,0,0,629,A
1-PB2,1734,633,0,0,0,633,A
1-PB2,1735,1,0,0,633,634,C
1-PB2,1736,4,1,0,603,608,C
1-PB2,1737,613,0,0,0,613,A
1-PB2,1738,0,621,0,2,623,T
1-PB2,1739,0,623,0,0,623,T
1-PB2,1740,0,625,0,0,625,T
1-PB2,1741,2,0,0,623,625,C
1-PB2,1742,628,0,0,0,628,A
1-PB2,1743,630,0,0,0,630,A
1-PB2,1744,0,632,0,0,632,T
1-PB2,1745,1,0,0,644,645,C
1-PB2,1746,0,637,0,0,637,T
1-PB2,1747,0,633,0,0,633,T
1-PB2,1748,0,633,0,0,633,T
1-PB2,1749,633,0,0,0,633,A
1-PB2,1750,1,0,631,0,632,G
1-PB2,1751,0,628,0,0,628,T
1-PB2,1752,2,1,0,638,641,C
1-PB2,1753,6,0,0,636,642,C
1-PB2,1754,2,0,0,638,640,C
1-PB2,1755,5,0,0,635,640,C
1-PB2,1756,635,0,1,0,636,A
1-PB2,1757,634,0,1,0,635,A
1-PB2,1758,0,3,650,0,653,G
1-PB2,1759,0,0,655,0,655,G
1-PB2,1760,0,0,0,653,653,C
1-PB2,1761,5,0,0,643,648,C
1-PB2,1762,647,0,0,0,647,A
1-PB2,1763,0,657,0,0,657,T
1-PB2,1764,0,658,0,0,658,T
1-PB2,1765,658,0,0,0,658,A
1-PB2,1766,0,0,658,0,658,G
1-PB2,1767,630,0,0,0,630,A
1-PB2,1768,653,0,0,0,653,A
1-PB2,1769,0,0,659,0,659,G
1-PB2,1770,0,0,0,664,664,C
1-PB2,1771,1,0,0,665,666,C
1-PB2,1772,656,1,0,0,657,A
1-PB2,1773,668,0,1,0,669,A
1-PB2,1774,0,671,0,0,671,T
1-PB2,1775,673,0,1,0,674,A
1-PB2,1776,0,0,1,674,675,C
1-PB2,1777,619,1,0,0,620,A
1-PB2,1778,0,0,621,0,621,G
1-PB2,1779,0,610,0,2,612,T
1-PB2,1780,0,4,610,1,615,G
1-PB2,1781,0,3,613,0,616,G
1-PB2,1782,0,2,616,0,618,G
1-PB2,1783,0,610,0,1,611,T
1-PB2,1784,0,608,0,0,608,T
1-PB2,1785,0,618,0,1,619,T
1-PB2,1786,1,0,628,0,629,G
1-PB2,1787,0,628,0,2,630,T
1-PB2,1788,5,0,0,626,631,C
1-PB2,1789,626,0,0,0,626,A
1-PB2,1790,0,0,626,0,626,G
1-PB2,1791,624,0,0,0,624,A
1-PB2,1792,623,0,0,0,623,A
1-PB2,1793,0,0,0,623,623,C
1-PB2,1794,0,599,0,0,599,T
1-PB2,1795,5,0,0,611,616,C
1-PB2,1796,0,618,0,0,618,T
1-PB2,1797,625,0,0,0,625,A
1-PB2,1798,0,623,0,0,623,T
1-PB2,1799,0,623,0,0,623,T
1-PB2,1800,8,0,0,616,624,C
1-PB2,1801,1,2,0,618,621,C
1-PB2,1802,619,0,0,0,619,A
1-PB2,1803,620,0,0,0,620,A
1-PB2,1804,1,0,0,620,621,C
1-PB2,1805,615,0,0,0,615,A
1-PB2,1806,613,0,0,0,613,A
1-PB2,1807,608,1,1,0,610,A
1-PB2,1808,0,611,0,2,613,T
1-PB2,1809,1,2,613,0,616,G
1-PB2,1810,608,0,0,1,609,A
1-PB2,1811,0,2,613,0,615,G
1-PB2,1812,612,0,1,0,613,A
1-PB2,1813,0,3,610,0,613,G
1-PB2,1814,608,0,1,0,609,A
1-PB2,1815,0,0,0,605,605,C
1-PB2,1816,0,0,610,0,610,G
1-PB2,1817,0,612,0,0,612,T
1-PB2,1818,612,1,1,0,614,A
1-PB2,1819,0,0,0,615,615,C
1-PB2,1820,0,608,0,0,608,T
1-PB2,1821,0,606,0,0,606,T
1-PB2,1822,0,2,603,0,605,G
1-PB2,1823,2,3,604,0,609,G
1-PB2,1824,0,3,605,0,608,G
1-PB2,1825,599,1,0,0,600,A
1-PB2,1826,0,1,0,601,602,C
1-PB2,1827,610,0,0,0,610,A
1-PB2,1828,0,610,0,0,610,T
1-PB2,1829,0,609,0,0,609,T
1-PB2,1830,0,612,0,0,612,T
1-PB2,1831,0,7,605,0,612,G
1-PB2,1832,607,0,2,0,609,A
1-PB2,1833,0,0,0,607,607,C
1-PB2,1834,601,0,1,0,602,A
1-PB2,1835,0,0,1,600,601,C
1-PB2,1836,1,0,0,592,593,C
1-PB2,1837,602,0,0,0,602,A
1-PB2,1838,0,0,0,612,612,C
1-PB2,1839,2,0,0,611,613,C
1-PB2,1840,5,1,0,607,613,C
1-PB2,1841,615,0,0,0,615,A
1-PB2,1842,0,1,625,0,626,G
1-PB2,1843,630,0,0,0,630,A
1-PB2,1844,0,658,0,0,658,T
1-PB2,1845,649,0,0,0,649,A
1-PB2,1846,642,1,1,0,644,A
1-PB2,1847,0,642,0,0,642,T
1-PB2,1848,636,0,0,0,636,A
1-PB2,1849,637,0,0,0,637,A
1-PB2,1850,634,0,0,0,634,A
1-PB2,1851,0,0,636,0,636,G
1-PB2,1852,1,0,0,629,630,C
1-PB2,1853,0,601,0,3,604,T
1-PB2,1854,0,604,0,0,604,T
1-PB2,1855,3,0,0,601,604,C
1-PB2,1856,0,600,0,1,601,T
1-PB2,1857,4,0,0,623,627,C
1-PB2,1858,1,1,0,622,624,C
1-PB2,1859,2,0,0,631,633,C
1-PB2,1860,0,625,1,0,626,T
1-PB2,1861,0,629,0,0,629,T
1-PB2,1862,0,631,0,0,631,T
1-PB2,1863,0,627,0,1,628,T
1-PB2,1864,1,0,625,0,626,G
1-PB2,1865,0,0,0,627,627,C
1-PB2,1866,619,0,0,0,619,A
1-PB2,1867,0,0,617,0,617,G
1-PB2,1868,0,0,0,616,616,C
1-PB2,1869,0,611,0,1,612,T
1-PB2,1870,0,1,614,0,615,G
1-PB2,1871,0,0,1,619,620,C
1-PB2,1872,0,617,0,0,617,T
1-PB2,1873,10,0,1,613,624,C
1-PB2,1874,1,0,0,626,627,C
1-PB2,1875,627,0,0,0,627,A
1-PB2,1876,1,0,0,627,628,C
1-PB2,1877,0,0,1,626,627,C
1-PB2,1878,620,0,0,0,620,A
1-PB2,1879,619,0,1,0,620,A
1-PB2,1880,619,0,1,0,620,A
1-PB2,1881,0,0,625,0,625,G
1-PB2,1882,0,0,0,625,625,C
1-PB2,1883,611,0,0,0,611,A
1-PB2,1884,610,0,0,0,610,A
1-PB2,1885,610,0,0,0,610,A
1-PB2,1886,0,1,618,0,619,G
1-PB2,1887,0,1,0,620,621,C
1-PB2,1888,610,0,1,0,611,A
1-PB2,1889,0,1,613,0,614,G
1-PB2,1890,603,0,0,0,603,A
1-PB2,1891,604,0,0,0,604,A
1-PB2,1892,1,605,0,0,606,T
1-PB2,1893,0,1,606,0,607,G
1-PB2,1894,0,0,0,606,606,C
1-PB2,1895,587,0,2,0,589,A
1-PB2,1896,0,0,602,0,602,G
1-PB2,1897,0,604,0,0,604,T
1-PB2,1898,0,619,0,1,620,T
1-PB2,1899,6,0,0,617,623,C
1-PB2,1900,0,620,0,1,621,T
1-PB2,1901,4,0,0,633,637,C
1-PB2,1902,0,639,0,0,639,T
1-PB2,1903,0,637,0,1,638,T
1-PB2,1904,1,1,0,639,641,C
1-PB2,1905,628,0,1,0,629,A
1-PB2,1906,0,0,0,634,634,C
1-PB2,1907,0,612,0,2,614,T
1-PB2,1908,1,7,615,0,623,G
1-PB2,1909,618,0,1,0,619,A
1-PB2,1910,1,0,0,625,626,C
1-PB2,1911,0,615,0,1,616,T
1-PB2,1912,0,0,624,0,624,G
1-PB2,1913,0,623,0,1,624,T
1-PB2,1914,0,5,622,0,627,G
1-PB2,1915,624,0,0,0,624,A
1-PB2,1916,625,0,0,0,625,A
1-PB2,1917,0,605,0,0,605,T
1-PB2,1918,1,0,605,0,606,G
1-PB2,1919,0,587,1,0,588,T
1-PB2,1920,0,2,582,0,584,G
1-PB2,1921,571,0,2,0,573,A
1-PB2,1922,0,4,574,0,578,G
1-PB2,1923,0,1,575,0,576,G
1-PB2,1924,0,1,568,0,569,G
1-PB2,1925,0,3,590,0,593,G
1-PB2,1926,589,2,0,0,591,A
1-PB2,1927,0,591,0,0,591,T
1-PB2,1928,3,0,0,588,591,C
1-PB2,1929,586,0,0,0,586,A
1-PB2,1930,0,4,595,0,599,G
1-PB2,1931,0,1,599,0,600,G
1-PB2,1932,1,0,606,0,607,G
1-PB2,1933,603,2,0,0,605,A
1-PB2,1934,0,582,0,0,582,T
1-PB2,1935,0,6,578,1,585,G
1-PB2,1936,578,0,0,0,578,A
1-PB2,1937,0,2,592,0,594,G
1-PB2,1938,593,0,0,0,593,A
1-PB2,1939,581,0,0,0,581,A
1-PB2,1940,0,592,0,0,592,T
1-PB2,1941,590,1,0,0,591,A
1-PB2,1942,0,0,0,602,602,C
1-PB2,1943,0,595,0,0,595,T
1-PB2,1944,0,591,0,0,591,T
1-PB2,1945,0,0,597,0,597,G
1-PB2,1946,1,578,0,0,579,T
1-PB2,1947,580,0,0,0,580,A
1-PB2,1948,579,0,0,0,579,A
1-PB2,1949,0,4,566,0,570,G
1-PB2,1950,0,3,573,0,576,G
1-PB2,1951,0,5,558,1,564,G
1-PB2,1952,1,0,566,0,567,G
1-PB2,1953,0,0,0,570,570,C
1-PB2,1954,570,0,0,0,570,A
1-PB2,1955,582,0,0,0,582,A
1-PB2,1956,0,578,0,2,580,T
1-PB2,1957,0,582,0,2,584,T
1-PB2,1958,3,0,0,585,588,C
1-PB2,1959,0,584,0,1,585,T
1-PB2,1960,2,4,0,585,591,C
1-PB2,1961,0,1,0,591,592,C
1-PB2,1962,0,590,0,0,590,T
1-PB2,1963,0,0,605,0,605,G
1-PB2,1964,0,593,0,0,593,T
1-PB2,1965,594,0,2,3,599,A
1-PB2,1966,0,597,0,1,598,T
1-PB2,1967,0,579,0,0,579,T
1-PB2,1968,0,0,0,583,583,C
1-PB2,1969,575,1,0,0,576,A
1-PB2,1970,587,0,0,0,587,A
1-PB2,1971,0,0,0,592,592,C
1-PB2,1972,0,582,0,0,582,T
1-PB2,1973,584,0,0,0,584,A
1-PB2,1974,0,0,0,597,597,C
1-PB2,1975,592,0,1,0,593,A
1-PB2,1976,592,0,1,0,593,A
1-PB2,1977,1,0,0,590,591,C
1-PB2,1978,579,0,1,0,580,A
1-PB2,1979,574,0,0,0,574,A
1-PB2,1980,0,4,570,0,574,G
1-PB2,1981,572,1,1,0,574,A
1-PB2,1982,0,0,0,578,578,C
1-PB2,1983,2,0,0,569,571,C
1-PB2,1984,569,0,0,0,569,A
1-PB2,1985,1,0,0,584,585,C
1-PB2,1986,0,583,0,0,583,T
1-PB2,1987,584,0,0,0,584,A
1-PB2,1988,583,0,0,0,583,A
1-PB2,1989,586,0,0,0,586,A
1-PB2,1990,583,0,1,0,584,A
1-PB2,1991,0,4,591,0,595,G
1-PB2,1992,587,0,0,0,587,A
1-PB2,1993,0,0,0,590,590,C
1-PB2,1994,0,571,0,0,571,T
1-PB2,1995,571,0,0,0,571,A
1-PB2,1996,571,0,1,0,572,A
1-PB2,1997,0,0,0,570,570,C
1-PB2,1998,570,0,0,0,570,A
1-PB2,1999,570,0,0,0,570,A
1-PB2,2000,0,560,0,0,560,T
1-PB2,2001,0,561,0,0,561,T
1-PB2,2002,1,0,0,560,561,C
1-PB2,2003,0,559,0,0,559,T
1-PB2,2004,3,0,0,558,561,C
1-PB2,2005,0,2,561,0,563,G
1-PB2,2006,0,2,561,0,563,G
1-PB2,2007,563,0,1,0,564,A
1-PB2,2008,568,0,0,0,568,A
1-PB2,2009,567,0,0,0,567,A
1-PB2,2010,566,0,2,0,568,A
1-PB2,2011,0,0,566,0,566,G
1-PB2,2012,566,0,0,0,566,A
1-PB2,2013,0,569,0,0,569,T
1-PB2,2014,1,0,567,0,568,G
1-PB2,2015,0,0,0,567,567,C
1-PB2,2016,4,1,0,561,566,C
1-PB2,2017,1,1,565,0,567,G
1-PB2,2018,0,0,567,0,567,G
1-PB2,2019,0,0,0,566,566,C
1-PB2,2020,566,0,0,0,566,A
1-PB2,2021,0,0,0,576,576,C
1-PB2,2022,0,573,0,0,573,T
1-PB2,2023,0,575,0,0,575,T
1-PB2,2024,0,577,0,0,577,T
1-PB2,2025,580,0,1,0,581,A
1-PB2,2026,585,0,0,0,585,A
1-PB2,2027,0,584,0,0,584,T
1-PB2,2028,1,578,0,0,579,T
1-PB2,2029,0,1,577,0,578,G
1-PB2,2030,558,0,0,0,558,A
1-PB2,2031,556,0,2,0,558,A
1-PB2,2032,0,3,560,0,563,G
1-PB2,2033,573,0,1,0,574,A
1-PB2,2034,1,0,0,570,571,C
1-PB2,2035,3,0,0,565,568,C
1-PB2,2036,1,0,0,562,563,C
1-PB2,2037,563,0,0,0,563,A
1-PB2,2038,0,0,584,0,584,G
1-PB2,2039,586,0,0,0,586,A
1-PB2,2040,0,584,0,1,585,T
1-PB2,2041,1,4,581,0,586,G
1-PB2,2042,569,0,0,0,569,A
1-PB2,2043,570,0,0,1,571,A
1-PB2,2044,573,0,0,0,573,A
1-PB2,2045,0,2,573,0,575,G
1-PB2,2046,0,1,0,573,574,C
1-PB2,2047,562,1,1,0,564,A
1-PB2,2048,1,0,0,569,570,C
1-PB2,2049,572,0,0,0,572,A
1-PB2,2050,0,570,0,0,570,T
1-PB2,2051,3,1,0,569,573,C
1-PB2,2052,1,1,0,569,571,C
1-PB2,2053,0,4,572,0,576,G
1-PB2,2054,0,5,570,0,575,G
1-PB2,2055,571,0,1,0,572,A
1-PB2,2056,0,0,578,0,578,G
1-PB2,2057,0,569,0,0,569,T
1-PB2,2058,0,0,571,0,571,G
1-PB2,2059,0,3,569,0,572,G
1-PB2,2060,564,0,0,0,564,A
1-PB2,2061,0,0,564,0,564,G
1-PB2,2062,0,557,0,1,558,T
1-PB2,2063,4,0,0,555,559,C
1-PB2,2064,0,0,0,559,559,C
1-PB2,2065,0,1,558,0,559,G
1-PB2,2066,1,0,0,559,560,C
1-PB2,2067,4,1,0,556,561,C
1-PB2,2068,0,1,563,1,565,G
1-PB2,2069,0,567,0,1,568,T
1-PB2,2070,3,0,0,568,571,C
1-PB2,2071,0,572,0,0,572,T
1-PB2,2072,0,574,0,0,574,T
1-PB2,2073,1,1,574,0,576,G
1-PB2,2074,569,0,1,0,570,A
1-PB2,2075,0,1,566,0,567,G
1-PB2,2076,569,0,1,0,570,A
1-PB2,2077,1,4,546,0,551,G
1-PB2,2078,0,4,545,0,549,G
1-PB2,2079,0,1,549,0,550,G
1-PB2,2080,0,542,0,2,544,T
1-PB2,2081,0,541,0,0,541,T
1-PB2,2082,0,547,0,2,549,T
1-PB2,2083,2,0,0,547,549,C
1-PB2,2084,0,550,0,0,550,T
1-PB2,2085,6,0,0,554,560,C
1-PB2,2086,558,0,0,0,558,A
1-PB2,2087,0,555,0,0,555,T
1-PB2,2088,0,552,0,0,552,T
1-PB2,2089,555,0,0,0,555,A
1-PB2,2090,0,557,0,0,557,T
1-PB2,2091,553,0,1,0,554,A
1-PB2,2092,0,1,553,0,554,G
1-PB2,2093,0,1,552,0,553,G
1-PB2,2094,0,517,0,1,518,T
1-PB2,2095,515,0,0,0,515,A
1-PB2,2096,509,0,0,0,509,A
1-PB2,2097,0,1,511,0,512,G
1-PB2,2098,0,2,516,0,518,G
1-PB2,2099,513,0,0,0,513,A
1-PB2,2100,504,1,0,0,505,A
1-PB2,2101,0,4,501,0,505,G
1-PB2,2102,495,1,1,0,497,A
1-PB2,2103,0,0,0,500,500,C
1-PB2,2104,499,0,0,0,499,A
1-PB2,2105,0,0,501,0,501,G
1-PB2,2106,499,0,0,0,499,A
1-PB2,2107,501,0,0,0,501,A
1-PB2,2108,0,0,506,0,506,G
1-PB2,2109,508,0,0,0,508,A
1-PB2,2110,0,505,0,0,505,T
1-PB2,2111,501,0,0,0,501,A
1-PB2,2112,1,2,0,496,499,C
1-PB2,2113,0,1,491,0,492,G
1-PB2,2114,0,3,491,0,494,G
1-PB2,2115,495,0,1,0,496,A
1-PB2,2116,0,0,0,487,487,C
1-PB2,2117,3,1,0,480,484,C
1-PB2,2118,472,1,1,0,474,A
1-PB2,2119,0,1,505,0,506,G
1-PB2,2120,1,0,0,504,505,C
1-PB2,2121,504,0,0,0,504,A
1-PB2,2122,0,505,0,0,505,T
1-PB2,2123,0,476,0,0,476,T
1-PB2,2124,475,0,0,2,477,A
1-PB2,2125,475,0,0,0,475,A
1-PB2,2126,0,1,475,0,476,G
1-PB2,2127,0,0,0,474,474,C
1-PB2,2128,436,0,0,0,436,A
1-PB2,2129,0,452,0,0,452,T
1-PB2,2130,0,0,0,452,452,C
1-PB2,2131,451,0,0,0,451,A
1-PB2,2132,451,0,0,0,451,A
1-PB2,2133,0,450,0,0,450,T
1-PB2,2134,0,2,450,0,452,G
1-PB2,2135,449,0,0,0,449,A
1-PB2,2136,449,0,0,0,449,A
1-PB2,2137,0,0,0,452,452,C
1-PB2,2138,1,419,0,0,420,T
1-PB2,2139,0,4,430,0,434,G
1-PB2,2140,430,0,0,0,430,A
1-PB2,2141,0,0,430,0,430,G
1-PB2,2142,0,431,0,0,431,T
1-PB2,2143,425,0,0,0,425,A
1-PB2,2144,427,0,1,0,428,A
1-PB2,2145,0,1,0,433,434,C
1-PB2,2146,4,0,0,419,423,C
1-PB2,2147,0,416,0,2,418,T
1-PB2,2148,0,404,0,1,405,T
1-PB2,2149,0,0,405,0,405,G
1-PB2,2150,0,0,0,405,405,C
1-PB2,2151,405,0,0,0,405,A
1-PB2,2152,405,0,1,0,406,A
1-PB2,2153,399,0,0,0,399,A
1-PB2,2154,393,0,0,0,393,A
1-PB2,2155,0,0,401,1,402,G
1-PB2,2156,0,1,405,0,406,G
1-PB2,2157,0,4,401,0,405,G
1-PB2,2158,1,2,402,0,405,G
1-PB2,2159,402,1,0,0,403,A
1-PB2,2160,405,0,0,0,405,A
1-PB2,2161,404,0,0,0,404,A
1-PB2,2162,402,0,2,0,404,A
1-PB2,2163,0,0,412,0,412,G
1-PB2,2164,0,0,409,0,409,G
1-PB2,2165,0,0,0,405,405,C
1-PB2,2166,0,404,0,0,404,T
1-PB2,2167,404,0,0,0,404,A
1-PB2,2168,404,0,0,0,404,A
1-PB2,2169,0,404,0,0,404,T
1-PB2,2170,0,0,416,0,416,G
1-PB2,2171,0,407,0,0,407,T
1-PB2,2172,1,0,403,0,404,G
1-PB2,2173,0,0,0,404,404,C
1-PB2,2174,0,401,0,0,401,T
1-PB2,2175,404,0,0,0,404,A
1-PB2,2176,400,0,0,0,400,A
1-PB2,2177,0,400,0,0,400,T
1-PB2,2178,1,0,1,396,398,C
1-PB2,2179,1,2,382,0,385,G
1-PB2,2180,0,1,385,0,386,G
1-PB2,2181,0,0,388,0,388,G
1-PB2,2182,0,0,0,388,388,C
1-PB2,2183,385,0,0,0,385,A
1-PB2,2184,384,0,0,0,384,A
1-PB2,2185,0,0,383,0,383,G
1-PB2,2186,0,1,382,0,383,G
1-PB2,2187,382,0,1,0,383,A
1-PB2,2188,0,1,380,0,381,G
1-PB2,2189,374,0,0,0,374,A
1-PB2,2190,0,0,0,370,370,C
1-PB2,2191,0,0,371,0,371,G
1-PB2,2192,0,370,0,0,370,T
1-PB2,2193,0,2,367,0,369,G
1-PB2,2194,0,0,377,0,377,G
1-PB2,2195,0,366,0,1,367,T
1-PB2,2196,0,0,368,0,368,G
1-PB2,2197,0,358,0,3,361,T
1-PB2,2198,0,357,0,1,358,T
1-PB2,2199,0,2,359,0,361,G
1-PB2,2200,0,0,358,0,358,G
1-PB2,2201,0,358,0,0,358,T
1-PB2,2202,347,0,0,0,347,A
1-PB2,2203,338,0,1,0,339,A
1-PB2,2204,0,334,0,0,334,T
1-PB2,2205,0,0,333,0,333,G
1-PB2,2206,331,0,0,0,331,A
1-PB2,2207,329,0,1,0,330,A
1-PB2,2208,327,0,2,0,329,A
1-PB2,2209,0,0,0,326,326,C
1-PB2,2210,0,2,322,0,324,G
1-PB2,2211,325,0,0,0,325,A
1-PB2,2212,323,0,1,0,324,A
1-PB2,2213,324,0,0,0,324,A
1-PB2,2214,325,0,0,0,325,A
1-PB2,2215,0,0,0,325,325,C
1-PB2,2216,0,1,323,0,324,G
1-PB2,2217,0,0,324,0,324,G
1-PB2,2218,0,2,322,0,324,G
1-PB2,2219,325,0,0,0,325,A
1-PB2,2220,0,0,0,324,324,C
1-PB2,2221,0,320,0,3,323,T
1-PB2,2222,1,0,0,330,331,C
1-PB2,2223,0,331,0,0,331,T
1-PB2,2224,330,0,0,0,330,A
1-PB2,2225,0,0,331,0,331,G
1-PB2,2226,1,0,0,325,326,C
1-PB2,2227,324,0,1,0,325,A
1-PB2,2228,0,322,0,0,322,T
1-PB2,2229,312,0,0,0,312,A
1-PB2,2230,0,0,0,315,315,C
1-PB2,2231,0,273,0,0,273,T
1-PB2,2232,0,274,0,0,274,T
1-PB2,2233,264,0,0,0,264,A
1-PB2,2234,0,0,0,264,264,C
1-PB2,2235,0,262,0,0,262,T
1-PB2,2236,0,3,260,0,263,G
1-PB2,2237,256,0,0,0,256,A
1-PB2,2238,0,0,0,257,257,C
1-PB2,2239,236,0,0,0,236,A
1-PB2,2240,0,0,239,0,239,G
1-PB2,2241,1,0,0,238,239,C
1-PB2,2242,3,0,0,236,239,C
1-PB2,2243,238,0,1,0,239,A
1-PB2,2244,0,1,238,0,239,G
1-PB2,2245,237,0,0,0,237,A
1-PB2,2246,0,0,0,236,236,C
1-PB2,2247,225,0,0,0,225,A
1-PB2,2248,0,1,224,0,225,G
1-PB2,2249,0,0,0,218,218,C
1-PB2,2250,1,1,216,0,218,G
1-PB2,2251,215,0,1,0,216,A
1-PB2,2252,0,0,0,217,217,C
1-PB2,2253,7,0,0,206,213,C
1-PB2,2254,211,0,0,0,211,A
1-PB2,2255,209,0,0,0,209,A
1-PB2,2256,208,0,0,0,208,A
1-PB2,2257,209,0,1,0,210,A
1-PB2,2258,0,0,210,0,210,G
1-PB2,2259,206,0,0,0,206,A
1-PB2,2260,205,0,1,0,206,A
1-PB2,2261,0,204,0,0,204,T
1-PB2,2262,0,204,0,0,204,T
1-PB2,2263,1,0,0,203,204,C
1-PB2,2264,0,1,200,0,201,G
1-PB2,2265,0,2,198,0,200,G
1-PB2,2266,199,0,0,0,199,A
1-PB2,2267,0,192,0,0,192,T
1-PB2,2268,0,1,191,0,192,G
1-PB2,2269,0,1,188,0,189,G
1-PB2,2270,1,0,0,187,188,C
1-PB2,2271,1,0,0,189,190,C
1-PB2,2272,190,0,0,0,190,A
1-PB2,2273,1,186,0,0,187,T
1-PB2,2274,0,0,0,188,188,C
1-PB2,2275,188,0,0,0,188,A
1-PB2,2276,188,0,0,0,188,A
1-PB2,2277,0,186,0,0,186,T
1-PB2,2278,0,170,0,0,170,T
1-PB2,2279,165,0,0,0,165,A
1-PB2,2280,163,0,0,0,163,A
2-PB1,1,473,0,0,0,473,A
2-PB1,2,0,473,0,0,473,T
2-PB1,3,0,0,483,0,483,G
2-PB1,4,0,1,518,0,519,G
2-PB1,5,577,0,0,0,577,A
2-PB1,6,0,613,0,1,614,T
2-PB1,7,1,0,625,0,626,G
2-PB1,8,0,625,0,4,629,T
2-PB1,9,3,1,0,692,696,C
2-PB1,10,698,0,0,0,698,A
2-PB1,11,729,0,0,0,729,A
2-PB1,12,1,731,0,0,732,T
2-PB1,13,0,0,0,745,745,C
2-PB1,14,5,3,0,788,796,C
2-PB1,15,0,12,796,0,808,G
2-PB1,16,896,0,2,0,898,A
2-PB1,17,0,0,0,919,919,C
2-PB1,18,1,916,0,2,919,T
2-PB1,19,2,1,0,1055,1058,C
2-PB1,20,0,1058,0,0,1058,T
2-PB1,21,1070,0,0,0,1070,A
2-PB1,22,0,0,0,1073,1073,C
2-PB1,23,0,1072,0,1,1073,T
2-PB1,24,0,0,1207,0,1207,G
2-PB1,25,0,1216,0,2,1218,T
2-PB1,26,0,1214,0,3,1217,T
2-PB1,27,5,0,0,1210,1215,C
2-PB1,28,0,2,0,1213,1215,C
2-PB1,29,0,1413,0,1,1414,T
2-PB1,30,1432,0,0,0,1432,A
2-PB1,31,1432,0,0,0,1432,A
2-PB1,32,1445,0,1,0,1446,A
2-PB1,33,0,8,1443,0,1451,G
2-PB1,34,0,1,1457,0,1458,G
2-PB1,35,0,1471,0,3,1474,T
2-PB1,36,1,1471,1,1,1474,T
2-PB1,37,8,4,0,1456,1468,C
2-PB1,38,3,1,0,1466,1470,C
2-PB1,39,1471,1,0,0,1472,A
2-PB1,40,1,2,1490,0,1493,G
2-PB1,41,0,1,0,1493,1494,C
2-PB1,42,1,4,1492,0,1497,G
2-PB1,43,1,0,0,1504,1505,C
2-PB1,44,1505,0,0,0,1505,A
2-PB1,45,1507,0,0,0,1507,A
2-PB1,46,1503,1,0,0,1504,A
2-PB1,47,1516,0,1,0,1517,A
2-PB1,48,0,1526,0,0,1526,T
2-PB1,49,1,0,1591,0,1592,G
2-PB1,50,0,0,0,1602,1602,C
2-PB1,51,11,0,0,1599,1610,C
2-PB1,52,1608,0,2,1,1611,A
2-PB1,53,1,1610,0,0,1611,T
2-PB1,54,1708,0,0,0,1708,A
2-PB1,55,1712,0,0,0,1712,A
2-PB1,56,0,2,1779,0,1781,G
2-PB1,57,0,0,0,1788,1788,C
2-PB1,58,1780,0,0,0,1780,A
2-PB1,59,0,1,0,1848,1849,C
2-PB1,60,1846,1,2,0,1849,A
2-PB1,61,1949,0,1,0,1950,A
2-PB1,62,1,1,0,1960,1962,C
2-PB1,63,1962,1,0,1,1964,A
2-PB1,64,0,1983,0,2,1985,T
2-PB1,65,1,1971,0,3,1975,T
2-PB1,66,12,0,0,2436,2448,C
2-PB1,67,8,1,1,2447,2457,C
2-PB1,68,4,0,0,2475,2479,C
2-PB1,69,0,2491,0,5,2496,T
2-PB1,70,0,2486,0,2,2488,T
2-PB1,71,2708,0,2,0,2710,A
2-PB1,72,0,2724,0,0,2724,T
2-PB1,73,2734,0,0,0,2734,A
2-PB1,74,1,0,0,2766,2767,C
2-PB1,75,1,2662,0,1,2664,T
2-PB1,76,1,10,2681,0,2692,G
2-PB1,77,0,16,2690,0,2706,G
2-PB1,78,2693,2,3,0,2698,A
2-PB1,79,1,10,2700,0,2711,G
2-PB1,80,2691,1,4,0,2696,A
2-PB1,81,0,2707,0,1,2708,T
2-PB1,82,10,0,0,2853,2863,C
2-PB1,83,6,1,0,2867,2874,C
2-PB1,84,0,2883,0,1,2884,T
2-PB1,85,7,0,0,3065,3072,C
2-PB1,86,9,1,0,3061,3071,C
2-PB1,87,3090,2,0,0,3092,A
2-PB1,88,1,3092,0,0,3093,T
2-PB1,89,3087,1,1,0,3089,A
2-PB1,90,1,2,0,3100,3103,C
2-PB1,91,3062,0,1,0,3063,A
2-PB1,92,2,3,3199,0,3204,G
2-PB1,93,1,0,0,3231,3232,C
2-PB1,94,6,5,0,3197,3208,C
2-PB1,95,3209,0,2,0,3211,A
2-PB1,96,2,3206,1,4,3213,T
2-PB1,97,0,19,3198,0,3217,G
2-PB1,98,0,28,3353,0,3381,G
2-PB1,99,3404,0,0,0,3404,A
2-PB1,100,3402,1,7,1,3411,A
2-PB1,101,1,1,0,3415,3417,C
2-PB1,102,3384,0,6,0,3390,A
2-PB1,103,0,9,3477,0,3486,G
2-PB1,104,2,34,3517,0,3553,G
2-PB1,105,3547,0,6,0,3553,A
2-PB1,106,3564,0,2,0,3566,A
2-PB1,107,0,0,1,3592,3593,C
2-PB1,108,3559,0,1,0,3560,A
2-PB1,109,1,22,3861,1,3885,G
2-PB1,110,0,25,3852,0,3877,G
2-PB1,111,1,4,3942,0,3947,G
2-PB1,112,1,3936,0,2,3939,T
2-PB1,113,3926,0,1,0,3927,A
2-PB1,114,3,1,0,3962,3966,C
2-PB1,115,4091,0,5,0,4096,A
2-PB1,116,2,0,0,4233,4235,C
2-PB1,117,15,0,0,4192,4207,C
2-PB1,118,4101,1,4,0,4106,A
2-PB1,119,0,4105,0,2,4107,T
2-PB1,120,1,29,4092,1,4123,G
2-PB1,121,1,45,4090,0,4136,G
2-PB1,122,4125,0,7,0,4132,A
2-PB1,123,2,0,0,4145,4147,C
2-PB1,124,4074,1,5,0,4080,A
2-PB1,125,0,2,0,4138,4140,C
2-PB1,126,4114,2,5,0,4121,A
2-PB1,127,1,1,4204,0,4206,G
2-PB1,128,0,4196,0,4,4200,T
2-PB1,129,34,1,0,4275,4310,C
2-PB1,130,4299,2,2,0,4303,A
2-PB1,131,4339,2,3,0,4344,A
2-PB1,132,0,5,0,4346,4351,C
2-PB1,133,4330,1,3,0,4334,A
2-PB1,134,1,25,4373,0,4399,G
2-PB1,135,4346,0,7,1,4354,A
2-PB1,136,4349,0,3,0,4352,A
2-PB1,137,1,4,0,4345,4350,C
2-PB1,138,4283,1,4,1,4289,A
2-PB1,139,2,4,1,4410,4417,C
2-PB1,140,4390,0,4,0,4394,A
2-PB1,141,0,2,1,4603,4606,C
2-PB1,142,23,0,0,4582,4605,C
2-PB1,143,4598,0,1,0,4599,A
2-PB1,144,4633,1,0,1,4635,A
2-PB1,145,0,4749,0,1,4750,T
2-PB1,146,4848,1,1,0,4850,A
2-PB1,147,0,4846,0,1,4847,T
2-PB1,148,2,4793,0,1,4796,T
2-PB1,149,30,0,0,4776,4806,C
2-PB1,150,4699,0,3,0,4702,A
2-PB1,151,1,26,4677,0,4704,G
2-PB1,152,4672,2,5,0,4679,A
2-PB1,153,0,19,4662,0,4681,G
2-PB1,154,4601,1,3,0,4605,A
2-PB1,155,7,25,4475,1,4508,G
2-PB1,156,1,21,4471,1,4494,G
2-PB1,157,1,26,4616,0,4643,G
2-PB1,158,1,22,4629,0,4652,G
2-PB1,159,4,13,4675,0,4692,G
2-PB1,160,4684,1,5,0,4690,A
2-PB1,161,4691,0,3,0,4694,A
2-PB1,162,0,0,4737,1,4738,G
2-PB1,163,0,4693,0,9,4702,T
2-PB1,164,1,36,4648,0,4685,G
2-PB1,165,1,23,4646,0,4670,G
2-PB1,166,4655,0,7,3,4665,A
2-PB1,167,4,8,0,4671,4683,C
2-PB1,168,2,41,4647,0,4690,G
2-PB1,169,4729,0,1,1,4731,A
2-PB1,170,0,2,0,4773,4775,C
2-PB1,171,4746,1,2,1,4750,A
2-PB1,172,4752,0,0,1,4753,A
2-PB1,173,4793,0,0,1,4794,A
2-PB1,174,0,4890,0,1,4891,T
2-PB1,175,4901,2,1,3,4907,A
2-PB1,176,4,1,0,4905,4910,C
2-PB1,177,4850,3,2,2,4857,A
2-PB1,178,1,21,4859,0,4881,G
2-PB1,179,4852,0,1,1,4854,A
2-PB1,180,4898,2,1,1,4902,A
2-PB1,181,4891,0,9,1,4901,A
2-PB1,182,1,1,0,4903,4905,C
2-PB1,183,0,4821,0,1,4822,T
2-PB1,184,2,18,4797,0,4817,G
2-PB1,185,4,34,4778,0,4816,G
2-PB1,186,1,32,4773,1,4807,G
2-PB1,187,3,1,4800,0,4804,G
2-PB1,188,4,1,0,4797,4802,C
2-PB1,189,4781,0,4,0,4785,A
2-PB1,190,3,2,0,4933,4938,C
2-PB1,191,19,1,0,4908,4928,C
2-PB1,192,25,3,0,4893,4921,C
2-PB1,193,26,4,1,4911,4942,C
2-PB1,194,4962,0,2,1,4965,A
2-PB1,195,5010,1,4,1,5016,A
2-PB1,196,1,0,1,5014,5016,C
2-PB1,197,3,4997,0,3,5003,T
2-PB1,198,39,1,0,4978,5018,C
2-PB1,199,4862,1,4,1,4868,A
2-PB1,200,4954,0,4,1,4959,A
2-PB1,201,3,3,0,4954,4960,C
2-PB1,202,18,0,0,4927,4945,C
2-PB1,203,34,2,1,4930,4967,C
2-PB1,204,4938,0,1,0,4939,A
2-PB1,205,4961,1,2,1,4965,A
2-PB1,206,0,4992,0,1,4993,T
2-PB1,207,0,4990,0,0,4990,T
2-PB1,208,1,20,4971,1,4993,G
2-PB1,209,4941,0,4,0,4945,A
2-PB1,210,0,4944,0,3,4947,T
2-PB1,211,2,31,4899,4,4936,G
2-PB1,212,1,37,4957,0,4995,G
2-PB1,213,5024,2,7,1,5034,A
2-PB1,214,4,1,0,5055,5060,C
2-PB1,215,34,4,0,5000,5038,C
2-PB1,216,5020,2,9,1,5032,A
2-PB1,217,2,0,0,5143,5145,C
2-PB1,218,0,5124,0,3,5127,T
2-PB1,219,5195,3,2,0,5200,A
2-PB1,220,5,0,0,5252,5257,C
2-PB1,221,9,2,0,5190,5201,C
2-PB1,222,0,5110,1,4,5115,T
2-PB1,223,1,20,5117,1,5139,G
2-PB1,224,5105,1,7,0,5113,A
2-PB1,225,2,22,5134,1,5159,G
2-PB1,226,3,15,5125,0,5143,G
2-PB1,227,5150,0,2,0,5152,A
2-PB1,228,0,5117,0,0,5117,T
2-PB1,229,5033,1,0,0,5034,A
2-PB1,230,5044,1,2,0,5047,A
2-PB1,231,2,5043,0,2,5047,T
2-PB1,232,0,60,4984,0,5044,G
2-PB1,233,5043,0,2,0,5045,A
2-PB1,234,5023,0,5,1,5029,A
2-PB1,235,3,1,1,5043,5048,C
2-PB1,236,34,1,1,4920,4956,C
2-PB1,237,4969,0,1,0,4970,A
2-PB1,238,4975,0,3,0,4978,A
2-PB1,239,4,6,5003,1,5014,G
2-PB1,240,1,5008,0,3,5012,T
2-PB1,241,0,21,4970,1,4992,G
2-PB1,242,1,13,5040,0,5054,G
2-PB1,243,5025,1,9,0,5035,A
2-PB1,244,1,5020,0,4,5025,T
2-PB1,245,5022,2,2,1,5027,A
2-PB1,246,1,5113,0,2,5116,T
2-PB1,247,1,4,5152,0,5157,G
2-PB1,248,3,2,0,5147,5152,C
2-PB1,249,5153,1,6,0,5160,A
2-PB1,250,1,2,0,5292,5295,C
2-PB1,251,5211,1,1,0,5213,A
2-PB1,252,5306,1,2,0,5309,A
2-PB1,253,5298,1,7,0,5306,A
2-PB1,254,5,1,1,5330,5337,C
2-PB1,255,5178,1,7,0,5186,A
2-PB1,256,0,33,5233,0,5266,G
2-PB1,257,5234,0,5,0,5239,A
2-PB1,258,6,0,0,5250,5256,C
2-PB1,259,1,5064,0,5,5070,T
2-PB1,260,7,0,5182,0,5189,G
2-PB1,261,4,5098,0,5,5107,T
2-PB1,262,5,2,5319,1,5327,G
2-PB1,263,2,5310,0,7,5319,T
2-PB1,264,32,1,0,5313,5346,C
2-PB1,265,22,2,1,5295,5320,C
2-PB1,266,0,5269,1,1,5271,T
2-PB1,267,0,4,5268,1,5273,G
2-PB1,268,1,19,5252,0,5272,G
2-PB1,269,5186,0,3,0,5189,A
2-PB1,270,0,16,5253,0,5269,G
2-PB1,271,2,0,5130,0,5132,G
2-PB1,272,5,2,0,5144,5151,C
2-PB1,273,1,5091,1,5,5098,T
2-PB1,274,5117,0,2,0,5119,A
2-PB1,275,2,5112,0,3,5117,T
2-PB1,276,4,20,5071,0,5095,G
2-PB1,277,3,2,5097,0,5102,G
2-PB1,278,4,3,0,5088,5095,C
2-PB1,279,15,1,0,5003,5019,C
2-PB1,280,1,4948,0,6,4955,T
2-PB1,281,1,5212,1,3,5217,T
2-PB1,282,11,1,0,5207,5219,C
2-PB1,283,18,0,0,5212,5230,C
2-PB1,284,0,5225,0,2,5227,T
2-PB1,285,0,5209,0,9,5218,T
2-PB1,286,1,25,5205,0,5231,G
2-PB1,287,5221,1,3,0,5225,A
2-PB1,288,5221,2,7,0,5230,A
2-PB1,289,0,31,5214,0,5245,G
2-PB1,290,5055,1,0,0,5056,A
2-PB1,291,5113,0,5,0,5118,A
2-PB1,292,0,5105,0,1,5106,T
2-PB1,293,25,0,0,5093,5118,C
2-PB1,294,16,1,1,5099,5117,C
2-PB1,295,33,3,1,5077,5114,C
2-PB1,296,5132,1,3,0,5136,A
2-PB1,297,4,0,0,5157,5161,C
2-PB1,298,15,0,2,5135,5152,C
2-PB1,299,39,3,0,5126,5168,C
2-PB1,300,5106,0,2,0,5108,A
2-PB1,301,2,24,5131,0,5157,G
2-PB1,302,1,3,5183,0,5187,G
2-PB1,303,0,5160,0,7,5167,T
2-PB1,304,5216,0,0,0,5216,A
2-PB1,305,3,5192,0,7,5202,T
2-PB1,306,10,0,0,5192,5202,C
2-PB1,307,1,5167,0,8,5176,T
2-PB1,308,1,5173,0,0,5174,T
2-PB1,309,2,5151,0,1,5154,T
2-PB1,310,3,32,5109,1,5145,G
2-PB1,311,5066,1,8,0,5075,A
2-PB1,312,0,47,5040,1,5088,G
2-PB1,313,5017,1,4,0,5022,A
2-PB1,314,5043,0,1,0,5044,A
2-PB1,315,1,0,0,5076,5077,C
2-PB1,316,0,5023,0,2,5025,T
2-PB1,317,44,2,0,4992,5038,C
2-PB1,318,5025,0,2,0,5027,A
2-PB1,319,1,5029,0,3,5033,T
2-PB1,320,1,5,5031,0,5037,G
2-PB1,321,7,1,0,5116,5124,C
2-PB1,322,21,0,0,5107,5128,C
2-PB1,323,0,5100,0,2,5102,T
2-PB1,324,1,5054,0,2,5057,T
2-PB1,325,0,29,5049,2,5080,G
2-PB1,326,5111,1,5,0,5117,A
2-PB1,327,5114,0,2,1,5117,A
2-PB1,328,5112,1,4,0,5117,A
2-PB1,329,2,0,0,5163,5165,C
2-PB1,330,5030,2,1,0,5033,A
2-PB1,331,5069,0,1,0,5070,A
2-PB1,332,2,5066,0,0,5068,T
2-PB1,333,0,34,5032,0,5066,G
2-PB1,334,0,8,5049,0,5057,G
2-PB1,335,4975,0,6,0,4981,A
2-PB1,336,4980,0,6,0,4986,A
2-PB1,337,3,2,4977,0,4982,G
2-PB1,338,3,3,0,4982,4988,C
2-PB1,339,24,5,0,4924,4953,C
2-PB1,340,2,0,5024,0,5026,G
2-PB1,341,0,5001,0,5,5006,T
2-PB1,342,3,5016,0,1,5020,T
2-PB1,343,66,0,1,5004,5071,C
2-PB1,344,5071,0,1,0,5072,A
2-PB1,345,5135,1,6,0,5142,A
2-PB1,346,2,1,0,5147,5150,C
2-PB1,347,5140,1,9,0,5150,A
2-PB1,348,0,29,5168,0,5197,G
2-PB1,349,5092,0,6,0,5098,A
2-PB1,350,2,1,1,5095,5099,C
2-PB1,351,5089,2,0,0,5091,A
2-PB1,352,5110,1,7,0,5118,A
2-PB1,353,2,30,5103,0,5135,G
2-PB1,354,2,20,5063,1,5086,G
2-PB1,355,1,3,5106,0,5110,G
2-PB1,356,0,5016,0,4,5020,T
2-PB1,357,5,30,4982,0,5017,G
2-PB1,358,0,19,4997,0,5016,G
2-PB1,359,5006,1,10,1,5018,A
2-PB1,360,6,0,0,5013,5019,C
2-PB1,361,4922,0,0,0,4922,A
2-PB1,362,4992,1,0,0,4993,A
2-PB1,363,4973,2,4,0,4979,A
2-PB1,364,3,1,0,4980,4984,C
2-PB1,365,1,4953,0,2,4956,T
2-PB1,366,4953,0,1,0,4954,A
2-PB1,367,4987,2,3,0,4992,A
2-PB1,368,2,2,0,4997,5001,C
2-PB1,369,30,0,1,4968,4999,C
2-PB1,370,41,0,0,4944,4985,C
2-PB1,371,4875,0,2,0,4877,A
2-PB1,372,4869,0,1,1,4871,A
2-PB1,373,1,29,4845,0,4875,G
2-PB1,374,0,3,4876,0,4879,G
2-PB1,375,1,4868,1,6,4876,T
2-PB1,376,43,2,0,4801,4846,C
2-PB1,377,3,1,4848,0,4852,G
2-PB1,378,6,0,0,4831,4837,C
2-PB1,379,15,0,0,4844,4859,C
2-PB1,380,4860,1,0,0,4861,A
2-PB1,381,1,27,4928,0,4956,G
2-PB1,382,5036,0,9,0,5045,A
2-PB1,383,3,0,0,5050,5053,C
2-PB1,384,0,5024,0,4,5028,T
2-PB1,385,0,5018,0,0,5018,T
2-PB1,386,5019,1,7,1,5028,A
2-PB1,387,1,5053,0,3,5057,T
2-PB1,388,2,24,5038,1,5065,G
2-PB1,389,5056,0,3,0,5059,A
2-PB1,390,1,4973,0,2,4976,T
2-PB1,391,0,4826,1,3,4830,T
2-PB1,392,5,33,4765,0,4803,G
2-PB1,393,3,19,4782,0,4804,G
2-PB1,394,4879,1,2,0,4882,A
2-PB1,395,2,1,0,4878,4881,C
2-PB1,396,4818,1,0,0,4819,A
2-PB1,397,3,4781,0,3,4787,T
2-PB1,398,1,4816,0,0,4817,T
2-PB1,399,4842,0,0,0,4842,A
2-PB1,400,4841,2,0,0,4843,A
2-PB1,401,4852,0,2,0,4854,A
2-PB1,402,2,3,0,4849,4854,C
2-PB1,403,4758,1,4,0,4763,A
2-PB1,404,1,16,4783,0,4800,G
2-PB1,405,4777,0,5,0,4782,A
2-PB1,406,4784,0,1,1,4786,A
2-PB1,407,4781,0,2,0,4783,A
2-PB1,408,0,4737,1,0,4738,T
2-PB1,409,36,2,0,4720,4758,C
2-PB1,410,4734,2,3,0,4739,A
2-PB1,411,4756,0,0,0,4756,A
2-PB1,412,4,0,0,4747,4751,C
2-PB1,413,17,6,0,4686,4709,C
2-PB1,414,6,13,4710,1,4730,G
2-PB1,415,2,3,4728,1,4734,G
2-PB1,416,3,4,0,4738,4745,C
2-PB1,417,4733,0,1,0,4734,A
2-PB1,418,3,4,4738,0,4745,G
2-PB1,419,2,2,0,4777,4781,C
2-PB1,420,4772,1,3,0,4776,A
2-PB1,421,4782,0,2,0,4784,A
2-PB1,422,3,0,0,4800,4803,C
2-PB1,423,0,4778,0,6,4784,T
2-PB1,424,3,0,5000,0,5003,G
2-PB1,425,3,2,1,4984,4990,C
2-PB1,426,4986,4,2,0,4992,A
2-PB1,427,2,4986,0,1,4989,T
2-PB1,428,1,4919,0,1,4921,T
2-PB1,429,5156,2,6,2,5166,A
2-PB1,430,2,1,5176,0,5179,G
2-PB1,431,9,2,0,5140,5151,C
2-PB1,432,25,0,0,5130,5155,C
2-PB1,433,4957,1,3,0,4961,A
2-PB1,434,4977,2,6,1,4986,A
2-PB1,435,2,2,0,5024,5028,C
2-PB1,436,5030,2,2,1,5035,A
2-PB1,437,6,3,0,5172,5181,C
2-PB1,438,33,1,1,4844,4879,C
2-PB1,439,4859,0,0,0,4859,A
2-PB1,440,1,4858,0,0,4859,T
2-PB1,441,4862,0,4,1,4867,A
2-PB1,442,2,10,4856,1,4869,G
2-PB1,443,4844,0,0,1,4845,A
2-PB1,444,4778,0,6,0,4784,A
2-PB1,445,2,3,4821,0,4826,G
2-PB1,446,0,4668,0,2,4670,T
2-PB1,447,0,4665,0,3,4668,T
2-PB1,448,1,4652,1,3,4657,T
2-PB1,449,0,4665,1,2,4668,T
2-PB1,450,1,4676,0,2,4679,T
2-PB1,451,4658,0,3,0,4661,A
2-PB1,452,0,12,4660,0,4672,G
2-PB1,453,4643,0,1,0,4644,A
2-PB1,454,0,4618,0,1,4619,T
2-PB1,455,31,2,0,4505,4538,C
2-PB1,456,5,37,4522,0,4564,G
2-PB1,457,4573,1,1,0,4575,A
2-PB1,458,4572,0,3,0,4575,A
2-PB1,459,3,6,0,4589,4598,C
2-PB1,460,4,18,4577,2,4601,G
2-PB1,461,1,15,4781,0,4797,G
2-PB1,462,4794,0,3,0,4797,A
2-PB1,463,1,4781,2,3,4787,T
2-PB1,464,1,4791,1,0,4793,T
2-PB1,465,4773,0,12,0,4785,A
2-PB1,466,4778,0,8,1,4787,A
2-PB1,467,8,2,0,4801,4811,C
2-PB1,468,4765,0,10,0,4775,A
2-PB1,469,1,4,4823,0,4828,G
2-PB1,470,2,1,0,4622,4625,C
2-PB1,471,1,4600,0,4,4605,T
2-PB1,472,4603,0,2,0,4605,A
2-PB1,473,4606,0,0,0,4606,A
2-PB1,474,1,4600,0,1,4602,T
2-PB1,475,0,37,4630,0,4667,G
2-PB1,476,4646,2,2,1,4651,A
2-PB1,477,4662,0,2,0,4664,A
2-PB1,478,1,4581,0,2,4584,T
2-PB1,479,30,0,0,4561,4591,C
2-PB1,480,4572,1,6,0,4579,A
2-PB1,481,2,11,4564,0,4577,G
2-PB1,482,2,7,4562,0,4571,G
2-PB1,483,4561,0,2,1,4564,A
2-PB1,484,4500,1,2,0,4503,A
2-PB1,485,1,17,4728,0,4746,G
2-PB1,486,4,5,4747,0,4756,G
2-PB1,487,5,5,1,4756,4767,C
2-PB1,488,0,4751,0,4,4755,T
2-PB1,489,4759,0,1,0,4760,A
2-PB1,490,4761,0,2,0,4763,A
2-PB1,491,1,4757,0,1,4759,T
2-PB1,492,4763,1,1,0,4765,A
2-PB1,493,1,24,4766,0,4791,G
2-PB1,494,4468,0,1,0,4469,A
2-PB1,495,0,4421,0,4,4425,T
2-PB1,496,1,4399,0,0,4400,T
2-PB1,497,1,4401,1,3,4406,T
2-PB1,498,29,0,0,4500,4529,C
2-PB1,499,17,2,1,4525,4545,C
2-PB1,500,4,4528,0,6,4538,T
2-PB1,501,17,0,1,4533,4551,C
2-PB1,502,4532,2,1,3,4538,A
2-PB1,503,4548,0,2,1,4551,A
2-PB1,504,5,16,4547,0,4568,G
2-PB1,505,0,17,4607,0,4624,G
2-PB1,506,4627,0,1,0,4628,A
2-PB1,507,1,4481,0,0,4482,T
2-PB1,508,1,3,4528,0,4532,G
2-PB1,509,1,4497,0,8,4506,T
2-PB1,510,0,12,4535,0,4547,G
2-PB1,511,4540,1,7,0,4548,A
2-PB1,512,3,4532,1,2,4538,T
2-PB1,513,1,18,4495,0,4514,G
2-PB1,514,2,30,4477,1,4510,G
2-PB1,515,4486,2,4,0,4492,A
2-PB1,516,4499,0,3,0,4502,A
2-PB1,517,0,4456,0,1,4457,T
2-PB1,518,32,1,0,4429,4462,C
2-PB1,519,4408,1,1,0,4410,A
2-PB1,520,4419,0,3,0,4422,A
2-PB1,521,0,4424,0,0,4424,T
2-PB1,522,2,21,4446,2,4471,G
2-PB1,523,0,17,4460,1,4478,G
2-PB1,524,4456,0,5,1,4462,A
2-PB1,525,1,4457,0,1,4459,T
2-PB1,526,4443,0,2,0,4445,A
2-PB1,527,4446,0,0,1,4447,A
2-PB1,528,4439,0,1,2,4442,A
2-PB1,529,1,15,4477,0,4493,G
2-PB1,530,4445,1,2,0,4448,A
2-PB1,531,2,13,4398,0,4413,G
2-PB1,532,2,14,4396,0,4412,G
2-PB1,533,4397,0,3,1,4401,A
2-PB1,534,4410,0,2,1,4413,A
2-PB1,535,4410,2,5,0,4417,A
2-PB1,536,1,4406,1,1,4409,T
2-PB1,537,0,10,4470,0,4480,G
2-PB1,538,0,25,4443,0,4468,G
2-PB1,539,4418,1,5,1,4425,A
2-PB1,540,1,13,4447,0,4461,G
2-PB1,541,4396,1,3,0,4400,A
2-PB1,542,0,4499,2,1,4502,T
2-PB1,543,4490,0,1,0,4491,A
2-PB1,544,4545,0,4,0,4549,A
2-PB1,545,3,3,0,4564,4570,C
2-PB1,546,4490,1,0,0,4491,A
2-PB1,547,4504,1,1,3,4509,A
2-PB1,548,6,1,0,4496,4503,C
2-PB1,549,4463,0,2,0,4465,A
2-PB1,550,3,4,0,4460,4467,C
2-PB1,551,4375,1,1,0,4377,A
2-PB1,552,1,1,0,4428,4430,C
2-PB1,553,0,4365,1,5,4371,T
2-PB1,554,0,4368,0,2,4370,T
2-PB1,555,0,4362,0,6,4368,T
2-PB1,556,26,0,0,4332,4358,C
2-PB1,557,4361,0,0,1,4362,A
2-PB1,558,4358,1,4,0,4363,A
2-PB1,559,4370,0,0,1,4371,A
2-PB1,560,0,24,4413,0,4437,G
2-PB1,561,4375,0,1,0,4376,A
2-PB1,562,4378,0,2,0,4380,A
2-PB1,563,4384,0,0,0,4384,A
2-PB1,564,4377,0,16,1,4394,A
2-PB1,565,4379,1,11,0,4391,A
2-PB1,566,1,16,4396,1,4414,G
2-PB1,567,1,21,4387,0,4409,G
2-PB1,568,4329,1,9,0,4339,A
2-PB1,569,0,17,4417,0,4434,G
2-PB1,570,4369,2,9,0,4380,A
2-PB1,571,1,2,4551,0,4554,G
2-PB1,572,0,4527,0,2,4529,T
2-PB1,573,4513,0,2,0,4515,A
2-PB1,574,4506,1,14,1,4522,A
2-PB1,575,0,28,4505,0,4533,G
2-PB1,576,2,24,4553,1,4580,G
2-PB1,577,1,34,4536,2,4573,G
2-PB1,578,4485,0,8,0,4493,A
2-PB1,579,5,3,0,4519,4527,C
2-PB1,580,4356,0,7,0,4363,A
2-PB1,581,4376,1,3,0,4380,A
2-PB1,582,5,0,0,4374,4379,C
2-PB1,583,4360,0,3,1,4364,A
2-PB1,584,1,4328,0,2,4331,T
2-PB1,585,0,62,4222,2,4286,G
2-PB1,586,4286,2,5,0,4293,A
2-PB1,587,6,0,0,4288,4294,C
2-PB1,588,37,1,1,4204,4243,C
2-PB1,589,4233,0,3,0,4236,A
2-PB1,590,4243,0,2,0,4245,A
2-PB1,591,0,12,4273,0,4285,G
2-PB1,592,4284,0,2,1,4287,A
2-PB1,593,4280,0,3,0,4283,A
2-PB1,594,4263,0,2,1,4266,A
2-PB1,595,4249,0,2,2,4253,A
2-PB1,596,2,4256,0,0,4258,T
2-PB1,597,3,29,4219,0,4251,G
2-PB1,598,1,3,4278,0,4282,G
2-PB1,599,2,4236,0,8,4246,T
2-PB1,600,58,4,0,4150,4212,C
2-PB1,601,4215,0,3,0,4218,A
2-PB1,602,1,2,0,4413,4416,C
2-PB1,603,4458,1,0,0,4459,A
2-PB1,604,0,1,1,4478,4480,C
2-PB1,605,4465,1,1,0,4467,A
2-PB1,606,4577,1,4,1,4583,A
2-PB1,607,4548,0,4,0,4552,A
2-PB1,608,0,52,4740,0,4792,G
2-PB1,609,4783,1,5,0,4789,A
2-PB1,610,4803,2,6,1,4812,A
2-PB1,611,2,2,0,4886,4890,C
2-PB1,612,4767,0,0,0,4767,A
2-PB1,613,4788,0,2,0,4790,A
2-PB1,614,0,4774,0,0,4774,T
2-PB1,615,4697,0,5,0,4702,A
2-PB1,616,1,27,4676,0,4704,G
2-PB1,617,3,19,4495,0,4517,G
2-PB1,618,1,19,4495,0,4515,G
2-PB1,619,4500,0,3,1,4504,A
2-PB1,620,4438,0,1,0,4439,A
2-PB1,621,1,17,4456,0,4474,G
2-PB1,622,4462,0,0,0,4462,A
2-PB1,623,4477,0,3,0,4480,A
2-PB1,624,4488,2,1,0,4491,A
2-PB1,625,4500,2,2,1,4505,A
2-PB1,626,4605,0,1,0,4606,A
2-PB1,627,4602,2,1,1,4606,A
2-PB1,628,1,2,0,4616,4619,C
2-PB1,629,4610,0,0,0,4610,A
2-PB1,630,4598,1,3,0,4602,A
2-PB1,631,4568,0,4,1,4573,A
2-PB1,632,0,24,4638,0,4662,G
2-PB1,633,4655,2,1,0,4658,A
2-PB1,634,1,1,4774,0,4776,G
2-PB1,635,1,4691,0,1,4693,T
2-PB1,636,1,46,4831,0,4878,G
2-PB1,637,4873,1,6,2,4882,A
2-PB1,638,4903,0,1,1,4905,A
2-PB1,639,1,4963,0,0,4964,T
2-PB1,640,4990,0,0,0,4990,A
2-PB1,641,4944,0,3,0,4947,A
2-PB1,642,0,21,4928,0,4949,G
2-PB1,643,4861,0,1,0,4862,A
2-PB1,644,4688,0,3,0,4691,A
2-PB1,645,4757,0,5,0,4762,A
2-PB1,646,1,13,4773,0,4787,G
2-PB1,647,2,3,4786,0,4791,G
2-PB1,648,3,4,0,4766,4773,C
2-PB1,649,0,4752,3,1,4756,T
2-PB1,650,4889,1,1,0,4891,A
2-PB1,651,2,2,0,5094,5098,C
2-PB1,652,23,0,0,5084,5107,C
2-PB1,653,1,5126,3,5,5135,T
2-PB1,654,5319,0,2,0,5321,A
2-PB1,655,5306,3,3,1,5313,A
2-PB1,656,0,5304,0,2,5306,T
2-PB1,657,5297,0,1,1,5299,A
2-PB1,658,5292,0,4,0,5296,A
2-PB1,659,1,37,5270,0,5308,G
2-PB1,660,5068,0,8,0,5076,A
2-PB1,661,2,2,5128,0,5132,G
2-PB1,662,2,0,0,5137,5139,C
2-PB1,663,0,5038,2,7,5047,T
2-PB1,664,0,5060,1,3,5064,T
2-PB1,665,0,5057,0,6,5063,T
2-PB1,666,5,42,5026,1,5074,G
2-PB1,667,5158,0,5,0,5163,A
2-PB1,668,3,2,0,5177,5182,C
2-PB1,669,5126,0,4,0,5130,A
2-PB1,670,0,5102,0,2,5104,T
2-PB1,671,0,5069,0,1,5070,T
2-PB1,672,3,54,5114,0,5171,G
2-PB1,673,5166,1,2,0,5169,A
2-PB1,674,5160,1,6,3,5170,A
2-PB1,675,1,5,0,5178,5184,C
2-PB1,676,5136,0,3,0,5139,A
2-PB1,677,5,2,0,5145,5152,C
2-PB1,678,1,26,5109,0,5136,G
2-PB1,679,5151,0,5,0,5156,A
2-PB1,680,1,5180,0,2,5183,T
2-PB1,681,2,76,5188,0,5266,G
2-PB1,682,5269,2,4,0,5275,A
2-PB1,683,5,1,0,5292,5298,C
2-PB1,684,45,1,0,5254,5300,C
2-PB1,685,5291,1,3,0,5295,A
2-PB1,686,5344,5,2,1,5352,A
2-PB1,687,5334,0,13,2,5349,A
2-PB1,688,3,22,5444,0,5469,G
2-PB1,689,5522,0,8,0,5530,A
2-PB1,690,0,5440,1,1,5442,T
2-PB1,691,2,5,5454,0,5461,G
2-PB1,692,3,3,0,5444,5450,C
2-PB1,693,5420,2,8,0,5430,A
2-PB1,694,0,18,5475,0,5493,G
2-PB1,695,5414,1,9,1,5425,A
2-PB1,696,2,30,5411,0,5443,G
2-PB1,697,5301,0,4,0,5305,A
2-PB1,698,0,13,5285,0,5298,G
2-PB1,699,5239,2,9,0,5250,A
2-PB1,700,0,17,5236,1,5254,G
2-PB1,701,3,2,5247,0,5252,G
2-PB1,702,8,1,1,5242,5252,C
2-PB1,703,5221,2,1,0,5224,A
2-PB1,704,5230,0,2,0,5232,A
2-PB1,705,5277,1,3,0,5281,A
2-PB1,706,0,5297,2,1,5300,T
2-PB1,707,1,5288,0,1,5290,T
2-PB1,708,5304,3,1,0,5308,A
2-PB1,709,5293,0,1,0,5294,A
2-PB1,710,5298,2,3,1,5304,A
2-PB1,711,5333,0,1,1,5335,A
2-PB1,712,5323,1,3,2,5329,A
2-PB1,713,1,11,5331,0,5343,G
2-PB1,714,5292,0,3,0,5295,A
2-PB1,715,5263,0,4,1,5268,A
2-PB1,716,1,26,5300,0,5327,G
2-PB1,717,0,16,5422,1,5439,G
2-PB1,718,2,4,5440,1,5447,G
2-PB1,719,4,3,0,5451,5458,C
2-PB1,720,0,5444,1,2,5447,T
2-PB1,721,5492,0,2,0,5494,A
2-PB1,722,0,5555,0,2,5557,T
2-PB1,723,1,5559,0,0,5560,T
2-PB1,724,3,7,5589,2,5601,G
2-PB1,725,3,5,1,5552,5561,C
2-PB1,726,5410,0,11,1,5422,A
2-PB1,727,5424,0,4,0,5428,A
2-PB1,728,1,3,0,5419,5423,C
2-PB1,729,5420,0,2,1,5423,A
2-PB1,730,6,1,0,5428,5435,C
2-PB1,731,26,1,0,5282,5309,C
2-PB1,732,27,5,0,5289,5321,C
2-PB1,733,4,29,5270,1,5304,G
2-PB1,734,1,22,5291,2,5316,G
2-PB1,735,3,20,5298,0,5321,G
2-PB1,736,5354,2,4,0,5360,A
2-PB1,737,1,5319,0,2,5322,T
2-PB1,738,1,6,5338,0,5345,G
2-PB1,739,6,4,0,5308,5318,C
2-PB1,740,5375,0,6,0,5381,A
2-PB1,741,5470,1,3,0,5474,A
2-PB1,742,5540,0,1,0,5541,A
2-PB1,743,0,5533,0,0,5533,T
2-PB1,744,0,5545,0,0,5545,T
2-PB1,745,5499,1,3,0,5503,A
2-PB1,746,0,15,5493,0,5508,G
2-PB1,747,5450,1,11,0,5462,A
2-PB1,748,1,28,5453,0,5482,G
2-PB1,749,0,33,5349,0,5382,G
2-PB1,750,3,2,5493,0,5498,G
2-PB1,751,2,5473,0,2,5477,T
2-PB1,752,3,5444,2,8,5457,T
2-PB1,753,54,1,0,5393,5448,C
2-PB1,754,2,0,5501,0,5503,G
2-PB1,755,0,5488,0,5,5493,T
2-PB1,756,4,0,5500,0,5504,G
2-PB1,757,1,5478,0,6,5485,T
2-PB1,758,5454,0,1,0,5455,A
2-PB1,759,2,3,0,5442,5447,C
2-PB1,760,0,5165,0,3,5168,T
2-PB1,761,0,5178,0,2,5180,T
2-PB1,762,22,2,0,5132,5156,C
2-PB1,763,7,3,5091,0,5101,G
2-PB1,764,1,5097,1,1,5100,T
2-PB1,765,1,5081,0,8,5090,T
2-PB1,766,0,36,5054,0,5090,G
2-PB1,767,5078,2,1,1,5082,A
2-PB1,768,5068,3,0,2,5073,A
2-PB1,769,5103,0,5,0,5108,A
2-PB1,770,1,2,0,5120,5123,C
2-PB1,771,0,5060,1,5,5066,T
2-PB1,772,0,5028,0,2,5030,T
2-PB1,773,1,5043,0,1,5045,T
2-PB1,774,5126,2,2,0,5130,A
2-PB1,775,1,2,5138,0,5141,G
2-PB1,776,1,2,0,5137,5140,C
2-PB1,777,1,5140,0,2,5143,T
2-PB1,778,5098,0,1,1,5100,A
2-PB1,779,0,11,5079,1,5091,G
2-PB1,780,5089,1,6,0,5096,A
2-PB1,781,5084,0,8,0,5092,A
2-PB1,782,1,3,5095,1,5100,G
2-PB1,783,2,5,0,5009,5016,C
2-PB1,784,5010,0,2,0,5012,A
2-PB1,785,1,4975,0,0,4976,T
2-PB1,786,0,4970,0,1,4971,T
2-PB1,787,2,4977,0,2,4981,T
2-PB1,788,1,5,4982,0,4988,G
2-PB1,789,4,2,0,4984,4990,C
2-PB1,790,3,25,4967,0,4995,G
2-PB1,791,4977,1,5,0,4983,A
2-PB1,792,4950,1,0,0,4951,A
2-PB1,793,4954,2,1,0,4957,A
2-PB1,794,5057,1,7,0,5065,A
2-PB1,795,0,4,5111,0,5115,G
2-PB1,796,3,1,0,5120,5124,C
2-PB1,797,1,5104,0,5,5110,T
2-PB1,798,0,5103,0,0,5103,T
2-PB1,799,0,47,5073,0,5120,G
2-PB1,800,5113,1,6,0,5120,A
2-PB1,801,5122,0,3,0,5125,A
2-PB1,802,4,6,0,5130,5140,C
2-PB1,803,4935,2,7,0,4944,A
2-PB1,804,3,1,5295,0,5299,G
2-PB1,805,0,5246,1,1,5248,T
2-PB1,806,39,0,1,5217,5257,C
2-PB1,807,1,5245,1,6,5253,T
2-PB1,808,0,19,5245,1,5265,G
2-PB1,809,2,30,5243,0,5275,G
2-PB1,810,5275,0,1,0,5276,A
2-PB1,811,2,1,0,5292,5295,C
2-PB1,812,0,5105,1,6,5112,T
2-PB1,813,0,4813,1,4,4818,T
2-PB1,814,16,0,1,4794,4811,C
2-PB1,815,14,10,2,4779,4805,C
2-PB1,816,7,10,4810,0,4827,G
2-PB1,817,2,3,4840,0,4845,G
2-PB1,818,0,4814,0,5,4819,T
2-PB1,819,0,4813,0,4,4817,T
2-PB1,820,2,23,4757,0,4782,G
2-PB1,821,1,23,4770,0,4794,G
2-PB1,822,4,25,4794,1,4824,G
2-PB1,823,2,28,4783,0,4813,G
2-PB1,824,1,5,4827,1,4834,G
2-PB1,825,1,4782,0,2,4785,T
2-PB1,826,4761,0,3,0,4764,A
2-PB1,827,4796,0,1,0,4797,A
2-PB1,828,1,4797,0,2,4800,T
2-PB1,829,5,24,4788,1,4818,G
2-PB1,830,4736,0,2,0,4738,A
2-PB1,831,4694,0,1,0,4695,A
2-PB1,832,4697,1,3,0,4701,A
2-PB1,833,4666,0,4,0,4670,A
2-PB1,834,0,11,4662,0,4673,G
2-PB1,835,4621,0,4,1,4626,A
2-PB1,836,4587,2,5,0,4594,A
2-PB1,837,1,19,4610,0,4630,G
2-PB1,838,1,6,4621,0,4628,G
2-PB1,839,2,2,0,4597,4601,C
2-PB1,840,22,2,0,4585,4609,C
2-PB1,841,4610,0,2,3,4615,A
2-PB1,842,4610,0,2,2,4614,A
2-PB1,843,4610,0,3,0,4613,A
2-PB1,844,3,0,0,4624,4627,C
2-PB1,845,1,4602,0,1,4604,T
2-PB1,846,1,22,4607,1,4631,G
2-PB1,847,1,3,4611,0,4615,G
2-PB1,848,1,1,0,4622,4624,C
2-PB1,849,4629,0,2,0,4631,A
2-PB1,850,4614,1,1,0,4616,A
2-PB1,851,4622,2,1,1,4626,A
2-PB1,852,1,4624,1,1,4627,T
2-PB1,853,0,3,4624,0,4627,G
2-PB1,854,1,4601,1,1,4604,T
2-PB1,855,0,4448,0,2,4450,T
2-PB1,856,0,2,4456,0,4458,G
2-PB1,857,1,4442,0,4,4447,T
2-PB1,858,3,26,4426,0,4455,G
2-PB1,859,4443,0,2,0,4445,A
2-PB1,860,1,21,4438,0,4460,G
2-PB1,861,4438,0,2,2,4442,A
2-PB1,862,4403,2,1,0,4406,A
2-PB1,863,4401,1,3,0,4405,A
2-PB1,864,4415,0,1,0,4416,A
2-PB1,865,4443,1,3,0,4447,A
2-PB1,866,0,4422,1,0,4423,T
2-PB1,867,0,21,4401,0,4422,G
2-PB1,868,4405,2,5,0,4412,A
2-PB1,869,0,4361,0,2,4363,T
2-PB1,870,3,47,4344,1,4395,G
2-PB1,871,4389,0,6,0,4395,A
2-PB1,872,3,2,1,4437,4443,C
2-PB1,873,1,4403,0,5,4409,T
2-PB1,874,4379,0,2,1,4382,A
2-PB1,875,4421,1,3,0,4425,A
2-PB1,876,0,4404,0,2,4406,T
2-PB1,877,0,4427,0,7,4434,T
2-PB1,878,46,0,1,4425,4472,C
2-PB1,879,4436,0,3,0,4439,A
2-PB1,880,2,2,1,4436,4441,C
2-PB1,881,4363,0,3,0,4366,A
2-PB1,882,4365,1,10,2,4378,A
2-PB1,883,0,20,4369,0,4389,G
2-PB1,884,4414,0,4,1,4419,A
2-PB1,885,2,0,2,4412,4416,C
2-PB1,886,4354,1,2,0,4357,A
2-PB1,887,0,2,0,4347,4349,C
2-PB1,888,4265,0,2,0,4267,A
2-PB1,889,1,19,4291,0,4311,G
2-PB1,890,4282,0,4,0,4286,A
2-PB1,891,2,0,4306,0,4308,G
2-PB1,892,5,0,1,4274,4280,C
2-PB1,893,0,4146,0,11,4157,T
2-PB1,894,0,4201,2,1,4204,T
2-PB1,895,0,4196,0,5,4201,T
2-PB1,896,15,0,1,4204,4220,C
2-PB1,897,0,4204,0,5,4209,T
2-PB1,898,1,4155,1,2,4159,T
2-PB1,899,0,4150,1,9,4160,T
2-PB1,900,15,1,0,4132,4148,C
2-PB1,901,4123,1,3,1,4128,A
2-PB1,902,3,1,0,4147,4151,C
2-PB1,903,4073,1,2,0,4076,A
2-PB1,904,4097,0,0,0,4097,A
2-PB1,905,1,4123,1,4,4129,T
2-PB1,906,28,1,0,4135,4164,C
2-PB1,907,4177,1,1,0,4179,A
2-PB1,908,2,0,1,4196,4199,C
2-PB1,909,2,4145,0,4,4151,T
2-PB1,910,3,13,4157,0,4173,G
2-PB1,911,2,19,4123,0,4144,G
2-PB1,912,2,18,4216,0,4236,G
2-PB1,913,3,18,4211,0,4232,G
2-PB1,914,4156,0,10,0,4166,A
2-PB1,915,3,1,0,3982,3986,C
2-PB1,916,4020,2,4,0,4026,A
2-PB1,917,4227,2,4,0,4233,A
2-PB1,918,1,1,0,4262,4264,C
2-PB1,919,4246,0,1,0,4247,A
2-PB1,920,3,0,0,4240,4243,C
2-PB1,921,0,3989,0,2,3991,T
2-PB1,922,3993,0,2,0,3995,A
2-PB1,923,3984,0,6,0,3990,A
2-PB1,924,1,0,4024,0,4025,G
2-PB1,925,0,3990,0,1,3991,T
2-PB1,926,3,16,3633,0,3652,G
2-PB1,927,0,13,3598,1,3612,G
2-PB1,928,3576,0,6,0,3582,A
2-PB1,929,3582,1,2,0,3585,A
2-PB1,930,0,3580,1,2,3583,T
2-PB1,931,0,25,3537,1,3563,G
2-PB1,932,3557,0,1,0,3558,A
2-PB1,933,3489,0,2,0,3491,A
2-PB1,934,3520,0,6,0,3526,A
2-PB1,935,3544,0,1,0,3545,A
2-PB1,936,0,3532,0,1,3533,T
2-PB1,937,35,0,0,3492,3527,C
2-PB1,938,3528,1,1,0,3530,A
2-PB1,939,3528,0,1,0,3529,A
2-PB1,940,3519,0,2,1,3522,A
2-PB1,941,3525,0,2,1,3528,A
2-PB1,942,5,0,0,3529,3534,C
2-PB1,943,18,2,0,3470,3490,C
2-PB1,944,26,0,1,3457,3484,C
2-PB1,945,0,3462,1,7,3470,T
2-PB1,946,14,3,0,3461,3478,C
2-PB1,947,0,21,3458,0,3479,G
2-PB1,948,3480,0,0,0,3480,A
2-PB1,949,3479,1,0,0,3480,A
2-PB1,950,0,3470,1,1,3472,T
2-PB1,951,2,1,3479,0,3482,G
2-PB1,952,0,3450,2,2,3454,T
2-PB1,953,1,3436,0,4,3441,T
2-PB1,954,0,3450,0,0,3450,T
2-PB1,955,0,3447,0,2,3449,T
2-PB1,956,2,3446,0,0,3448,T
2-PB1,957,2,16,3425,0,3443,G
2-PB1,958,4,1,3437,0,3442,G
2-PB1,959,5,5,0,3412,3422,C
2-PB1,960,1,13,3352,0,3366,G
2-PB1,961,3362,1,1,0,3364,A
2-PB1,962,1,3419,0,2,3422,T
2-PB1,963,1,19,3473,0,3493,G
2-PB1,964,3630,0,1,0,3631,A
2-PB1,965,0,3634,1,3,3638,T
2-PB1,966,1,3643,0,0,3644,T
2-PB1,967,3653,0,3,0,3656,A
2-PB1,968,1,3,1,3653,3658,C
2-PB1,969,3670,0,1,0,3671,A
2-PB1,970,1,3663,0,1,3665,T
2-PB1,971,3412,0,1,1,3414,A
2-PB1,972,1,1,0,3430,3432,C
2-PB1,973,2994,0,2,0,2996,A
2-PB1,974,0,2982,0,4,2986,T
2-PB1,975,12,1,0,2970,2983,C
2-PB1,976,2956,2,2,0,2960,A
2-PB1,977,0,2,0,2963,2965,C
2-PB1,978,2914,0,1,0,2915,A
2-PB1,979,2914,0,0,0,2914,A
2-PB1,980,2894,0,4,0,2898,A
2-PB1,981,0,17,2752,0,2769,G
2-PB1,982,2859,0,0,0,2859,A
2-PB1,983,2862,0,3,0,2865,A
2-PB1,984,0,2866,0,1,2867,T
2-PB1,985,25,1,1,2831,2858,C
2-PB1,986,2845,0,0,0,2845,A
2-PB1,987,2860,0,0,0,2860,A
2-PB1,988,4,0,0,2863,2867,C
2-PB1,989,8,0,0,2854,2862,C
2-PB1,990,0,2605,0,4,2609,T
2-PB1,991,0,22,2591,1,2614,G
2-PB1,992,2596,0,1,0,2597,A
2-PB1,993,0,0,2605,0,2605,G
2-PB1,994,0,2571,0,1,2572,T
2-PB1,995,1,18,2470,0,2489,G
2-PB1,996,2,0,2576,0,2578,G
2-PB1,997,1,2539,0,1,2541,T
2-PB1,998,1,2538,0,3,2542,T
2-PB1,999,38,2,0,2503,2543,C
2-PB1,1000,2489,0,1,1,2491,A
2-PB1,1001,1,7,2519,2,2529,G
2-PB1,1002,2518,0,2,0,2520,A
2-PB1,1003,2520,1,1,0,2522,A
2-PB1,1004,2494,1,1,1,2497,A
2-PB1,1005,1,1,0,2121,2123,C
2-PB1,1006,2091,0,2,0,2093,A
2-PB1,1007,0,2088,0,5,2093,T
2-PB1,1008,7,1,1,2095,2104,C
2-PB1,1009,5,0,2,2096,2103,C
2-PB1,1010,0,1937,0,2,1939,T
2-PB1,1011,0,14,1925,0,1939,G
2-PB1,1012,1922,0,0,0,1922,A
2-PB1,1013,0,1,1947,1,1949,G
2-PB1,1014,6,0,0,1904,1910,C
2-PB1,1015,1832,0,1,0,1833,A
2-PB1,1016,2,1833,0,0,1835,T
2-PB1,1017,6,1,0,1811,1818,C
2-PB1,1018,0,0,1821,2,1823,G
2-PB1,1019,1,1,0,1873,1875,C
2-PB1,1020,1885,0,1,0,1886,A
2-PB1,1021,1,0,1,1958,1960,C
2-PB1,1022,17,0,0,1932,1949,C
2-PB1,1023,1954,0,1,0,1955,A
2-PB1,1024,1985,0,1,0,1986,A
2-PB1,1025,0,1984,0,0,1984,T
2-PB1,1026,1981,0,1,0,1982,A
2-PB1,1027,1980,0,2,0,1982,A
2-PB1,1028,0,1893,1,2,1896,T
2-PB1,1029,3,1,1901,0,1905,G
2-PB1,1030,1,1842,0,3,1846,T
2-PB1,1031,0,1834,0,1,1835,T
2-PB1,1032,17,0,0,1817,1834,C
2-PB1,1033,0,1826,0,0,1826,T
2-PB1,1034,12,0,0,1817,1829,C
2-PB1,1035,1823,0,2,0,1825,A
2-PB1,1036,1822,0,1,0,1823,A
2-PB1,1037,1828,0,1,0,1829,A
2-PB1,1038,1,0,0,1839,1840,C
2-PB1,1039,1830,0,1,0,1831,A
2-PB1,1040,1831,0,2,0,1833,A
2-PB1,1041,1828,0,1,0,1829,A
2-PB1,1042,1829,1,3,0,1833,A
2-PB1,1043,2,1849,0,1,1852,T
2-PB1,1044,1,15,1848,0,1864,G
2-PB1,1045,2,1,1854,0,1857,G
2-PB1,1046,0,1,0,1856,1857,C
2-PB1,1047,1852,0,2,0,1854,A
2-PB1,1048,1857,0,4,1,1862,A
2-PB1,1049,2,19,1854,0,1875,G
2-PB1,1050,1874,1,3,0,1878,A
2-PB1,1051,0,0,0,1885,1885,C
2-PB1,1052,1,1848,0,2,1851,T
2-PB1,1053,1,13,1876,0,1890,G
2-PB1,1054,1,5,1883,0,1889,G
2-PB1,1055,0,13,1878,1,1892,G
2-PB1,1056,1895,0,3,0,1898,A
2-PB1,1057,1894,1,0,0,1895,A
2-PB1,1058,1891,0,0,0,1891,A
2-PB1,1059,1880,1,2,0,1883,A
2-PB1,1060,0,6,1951,0,1957,G
2-PB1,1061,0,8,1946,0,1954,G
2-PB1,1062,1949,0,3,0,1952,A
2-PB1,1063,0,1941,0,0,1941,T
2-PB1,1064,1929,0,2,0,1931,A
2-PB1,1065,0,1,0,1930,1931,C
2-PB1,1066,1953,0,1,0,1954,A
2-PB1,1067,0,1946,0,1,1947,T
2-PB1,1068,1,1,1957,1,1960,G
2-PB1,1069,0,1912,0,3,1915,T
2-PB1,1070,0,1909,0,2,1911,T
2-PB1,1071,19,3,0,1885,1907,C
2-PB1,1072,1,11,1899,0,1911,G
2-PB1,1073,1914,0,2,0,1916,A
2-PB1,1074,0,17,1937,0,1954,G
2-PB1,1075,1933,0,4,0,1937,A
2-PB1,1076,0,1,1955,0,1956,G
2-PB1,1077,0,1940,0,1,1941,T
2-PB1,1078,1938,0,1,0,1939,A
2-PB1,1079,1938,2,1,0,1941,A
2-PB1,1080,2,8,1940,0,1950,G
2-PB1,1081,1938,0,3,0,1941,A
2-PB1,1082,0,10,1963,0,1973,G
2-PB1,1083,1915,0,1,0,1916,A
2-PB1,1084,1924,0,2,0,1926,A
2-PB1,1085,0,1904,0,0,1904,T
2-PB1,1086,0,10,1892,0,1902,G
2-PB1,1087,1899,2,3,0,1904,A
2-PB1,1088,1891,0,4,0,1895,A
2-PB1,1089,0,1,1894,0,1895,G
2-PB1,1090,0,0,0,1890,1890,C
2-PB1,1091,0,1860,0,4,1864,T
2-PB1,1092,8,0,0,1858,1866,C
2-PB1,1093,5,1,0,1858,1864,C
2-PB1,1094,2,10,1866,0,1878,G
2-PB1,1095,1,12,1871,1,1885,G
2-PB1,1096,1883,0,3,1,1887,A
2-PB1,1097,1,2,0,1926,1929,C
2-PB1,1098,1926,0,0,0,1926,A
2-PB1,1099,1,0,0,1953,1954,C
2-PB1,1100,1953,1,0,0,1954,A
2-PB1,1101,1954,0,2,0,1956,A
2-PB1,1102,1952,0,2,0,1954,A
2-PB1,1103,0,1963,0,1,1964,T
2-PB1,1104,1960,0,0,0,1960,A
2-PB1,1105,1,0,0,1964,1965,C
2-PB1,1106,5,0,0,1940,1945,C
2-PB1,1107,0,1916,0,3,1919,T
2-PB1,1108,0,1,1927,0,1928,G
2-PB1,1109,1,0,1,1934,1936,C
2-PB1,1110,1926,0,2,0,1928,A
2-PB1,1111,0,6,1926,0,1932,G
2-PB1,1112,1925,0,0,0,1925,A
2-PB1,1113,1918,1,1,0,1920,A
2-PB1,1114,1922,1,0,0,1923,A
2-PB1,1115,0,1914,0,2,1916,T
2-PB1,1116,0,4,1915,0,1919,G
2-PB1,1117,0,0,0,1916,1916,C
2-PB1,1118,1,1905,0,2,1908,T
2-PB1,1119,1938,0,2,0,1940,A
2-PB1,1120,2,1,1935,0,1938,G
2-PB1,1121,2,0,0,1933,1935,C
2-PB1,1122,1931,1,0,0,1932,A
2-PB1,1123,1919,0,2,0,1921,A
2-PB1,1124,0,2,1914,0,1916,G
2-PB1,1125,2,1,0,1911,1914,C
2-PB1,1126,1891,0,2,0,1893,A
2-PB1,1127,0,1939,0,0,1939,T
2-PB1,1128,0,1940,0,1,1941,T
2-PB1,1129,1,22,1991,0,2014,G
2-PB1,1130,2032,1,4,1,2038,A
2-PB1,1131,2,0,1,2029,2032,C
2-PB1,1132,9,1,0,2025,2035,C
2-PB1,1133,0,1969,0,4,1973,T
2-PB1,1134,1,5,2008,0,2014,G
2-PB1,1135,2017,1,0,0,2018,A
2-PB1,1136,2021,0,2,0,2023,A
2-PB1,1137,1,2,2055,0,2058,G
2-PB1,1138,0,1988,0,2,1990,T
2-PB1,1139,1984,0,0,0,1984,A
2-PB1,1140,0,1971,0,2,1973,T
2-PB1,1141,0,1973,0,2,1975,T
2-PB1,1142,1,1969,1,2,1973,T
2-PB1,1143,8,0,0,1928,1936,C
2-PB1,1144,1932,0,0,0,1932,A
2-PB1,1145,1935,0,3,0,1938,A
2-PB1,1146,0,1904,0,1,1905,T
2-PB1,1147,1,19,1892,0,1912,G
2-PB1,1148,1901,0,0,0,1901,A
2-PB1,1149,1908,0,0,0,1908,A
2-PB1,1150,0,1905,1,3,1909,T
2-PB1,1151,12,1,0,1907,1920,C
2-PB1,1152,1912,0,2,0,1914,A
2-PB1,1153,1918,0,2,0,1920,A
2-PB1,1154,1,0,0,1917,1918,C
2-PB1,1155,1919,0,0,0,1919,A
2-PB1,1156,1910,0,4,0,1914,A
2-PB1,1157,2,12,1904,0,1918,G
2-PB1,1158,0,7,1920,0,1927,G
2-PB1,1159,1920,0,0,0,1920,A
2-PB1,1160,1920,0,0,0,1920,A
2-PB1,1161,1,5,1917,0,1923,G
2-PB1,1162,1915,1,2,0,1918,A
2-PB1,1163,1916,0,3,0,1919,A
2-PB1,1164,1918,0,2,0,1920,A
2-PB1,1165,1916,0,3,0,1919,A
2-PB1,1166,0,1918,0,0,1918,T
2-PB1,1167,0,1902,0,0,1902,T
2-PB1,1168,1,14,1889,0,1904,G
2-PB1,1169,1893,0,5,1,1899,A
2-PB1,1170,0,10,1899,0,1909,G
2-PB1,1171,1908,0,0,0,1908,A
2-PB1,1172,1917,0,0,1,1918,A
2-PB1,1173,1939,1,2,0,1942,A
2-PB1,1174,1949,1,0,0,1950,A
2-PB1,1175,0,1951,0,0,1951,T
2-PB1,1176,1948,0,2,1,1951,A
2-PB1,1177,1949,0,3,0,1952,A
2-PB1,1178,3,8,1957,0,1968,G
2-PB1,1179,0,2,1962,0,1964,G
2-PB1,1180,0,0,0,1959,1959,C
2-PB1,1181,12,0,0,1947,1959,C
2-PB1,1182,0,1934,0,5,1939,T
2-PB1,1183,8,1,0,2175,2184,C
2-PB1,1184,0,2218,0,4,2222,T
2-PB1,1185,0,2221,0,5,2226,T
2-PB1,1186,3,0,1,2275,2279,C
2-PB1,1187,1,2270,0,2,2273,T
2-PB1,1188,2271,0,0,0,2271,A
2-PB1,1189,2269,2,1,1,2273,A
2-PB1,1190,1,2274,0,1,2276,T
2-PB1,1191,2278,0,2,0,2280,A
2-PB1,1192,2,8,2233,0,2243,G
2-PB1,1193,2056,0,3,0,2059,A
2-PB1,1194,0,2056,0,1,2057,T
2-PB1,1195,1,12,2013,0,2026,G
2-PB1,1196,0,2,2044,0,2046,G
2-PB1,1197,2,1,0,2035,2038,C
2-PB1,1198,2035,1,2,0,2038,A
2-PB1,1199,1,1,0,2049,2051,C
2-PB1,1200,2009,1,1,0,2011,A
2-PB1,1201,3,0,2085,0,2088,G
2-PB1,1202,0,1,0,2083,2084,C
2-PB1,1203,2088,0,0,0,2088,A
2-PB1,1204,0,2151,1,2,2154,T
2-PB1,1205,9,0,1,2129,2139,C
2-PB1,1206,2158,2,1,0,2161,A
2-PB1,1207,0,2160,0,1,2161,T
2-PB1,1208,1,2149,1,1,2152,T
2-PB1,1209,1,9,2138,0,2148,G
2-PB1,1210,2081,0,8,0,2089,A
2-PB1,1211,0,4,2139,0,2143,G
2-PB1,1212,1,1,0,2147,2149,C
2-PB1,1213,11,1,0,2116,2128,C
2-PB1,1214,10,1,0,2154,2165,C
2-PB1,1215,0,2155,0,2,2157,T
2-PB1,1216,2,5,2420,0,2427,G
2-PB1,1217,1,10,2473,0,2484,G
2-PB1,1218,2472,0,10,0,2482,A
2-PB1,1219,2620,0,0,0,2620,A
2-PB1,1220,0,2566,0,1,2567,T
2-PB1,1221,2,15,2665,0,2682,G
2-PB1,1222,2756,0,0,0,2756,A
2-PB1,1223,1,2795,0,1,2797,T
2-PB1,1224,0,15,2794,1,2810,G
2-PB1,1225,2771,0,2,0,2773,A
2-PB1,1226,2,2743,0,0,2745,T
2-PB1,1227,2,19,2735,0,2756,G
2-PB1,1228,1,17,2804,0,2822,G
2-PB1,1229,2,1,2827,0,2830,G
2-PB1,1230,2,2,0,2816,2820,C
2-PB1,1231,2803,0,2,0,2805,A
2-PB1,1232,0,2839,0,1,2840,T
2-PB1,1233,0,1,2978,0,2979,G
2-PB1,1234,1,2975,0,3,2979,T
2-PB1,1235,2,2998,0,1,3001,T
2-PB1,1236,32,0,0,2990,3022,C
2-PB1,1237,3003,0,3,0,3006,A
2-PB1,1238,3010,0,8,0,3018,A
2-PB1,1239,0,1,0,3032,3033,C
2-PB1,1240,3053,0,0,0,3053,A
2-PB1,1241,0,3055,0,4,3059,T
2-PB1,1242,1,2,3108,2,3113,G
2-PB1,1243,1,0,0,3121,3122,C
2-PB1,1244,0,3124,1,0,3125,T
2-PB1,1245,3173,0,2,0,3175,A
2-PB1,1246,3178,1,0,0,3179,A
2-PB1,1247,1,2,3267,0,3270,G
2-PB1,1248,0,3268,1,0,3269,T
2-PB1,1249,3256,2,1,0,3259,A
2-PB1,1250,1,6,0,3276,3283,C
2-PB1,1251,2,14,3301,0,3317,G
2-PB1,1252,1,1,3588,0,3590,G
2-PB1,1253,0,3584,0,3,3587,T
2-PB1,1254,0,3577,0,1,3578,T
2-PB1,1255,0,3574,1,0,3575,T
2-PB1,1256,0,3554,0,1,3555,T
2-PB1,1257,3546,2,2,1,3551,A
2-PB1,1258,1,16,3532,1,3550,G
2-PB1,1259,1,26,3531,1,3559,G
2-PB1,1260,3497,2,5,0,3504,A
2-PB1,1261,0,2,3492,0,3494,G
2-PB1,1262,1,3540,1,2,3544,T
2-PB1,1263,31,1,0,3521,3553,C
2-PB1,1264,1,3558,0,4,3563,T
2-PB1,1265,15,5,1,3550,3571,C
2-PB1,1266,1,22,3548,1,3572,G
2-PB1,1267,3732,1,2,0,3735,A
2-PB1,1268,0,3740,0,1,3741,T
2-PB1,1269,3772,0,2,0,3774,A
2-PB1,1270,0,2,0,3770,3772,C
2-PB1,1271,1,3705,2,5,3713,T
2-PB1,1272,2,30,3702,0,3734,G
2-PB1,1273,3721,3,4,0,3728,A
2-PB1,1274,3821,1,3,1,3826,A
2-PB1,1275,0,3831,0,1,3832,T
2-PB1,1276,14,0,0,3738,3752,C
2-PB1,1277,1,3736,1,3,3741,T
2-PB1,1278,0,3716,1,4,3721,T
2-PB1,1279,2,20,3721,0,3743,G
2-PB1,1280,0,24,3719,0,3743,G
2-PB1,1281,3733,1,2,0,3736,A
2-PB1,1282,0,1,0,3752,3753,C
2-PB1,1283,3691,1,1,0,3693,A
2-PB1,1284,3726,0,2,0,3728,A
2-PB1,1285,3755,2,0,0,3757,A
2-PB1,1286,3749,1,13,1,3764,A
2-PB1,1287,2,25,3848,0,3875,G
2-PB1,1288,3886,1,3,1,3891,A
2-PB1,1289,3872,0,5,0,3877,A
2-PB1,1290,3887,0,3,3,3893,A
2-PB1,1291,1,3888,0,3,3892,T
2-PB1,1292,3892,0,2,0,3894,A
2-PB1,1293,2,3,0,4028,4033,C
2-PB1,1294,4003,0,6,0,4009,A
2-PB1,1295,2,1,0,4033,4036,C
2-PB1,1296,17,1,0,3972,3990,C
2-PB1,1297,3974,0,1,0,3975,A
2-PB1,1298,4035,0,4,0,4039,A
2-PB1,1299,0,28,4150,1,4179,G
2-PB1,1300,4224,0,5,0,4229,A
2-PB1,1301,1,3,0,4273,4277,C
2-PB1,1302,4181,0,1,0,4182,A
2-PB1,1303,4341,1,3,1,4346,A
2-PB1,1304,4,1,0,4369,4374,C
2-PB1,1305,4469,2,4,0,4475,A
2-PB1,1306,1,4509,0,0,4510,T
2-PB1,1307,4466,0,2,0,4468,A
2-PB1,1308,4,1,0,4573,4578,C
2-PB1,1309,0,4446,0,2,4448,T
2-PB1,1310,2,14,4508,0,4524,G
2-PB1,1311,2,5,4521,0,4528,G
2-PB1,1312,1,4416,0,3,4420,T
2-PB1,1313,2,26,4389,1,4418,G
2-PB1,1314,0,22,4375,0,4397,G
2-PB1,1315,0,17,4387,1,4405,G
2-PB1,1316,4389,0,7,1,4397,A
2-PB1,1317,0,4333,1,4,4338,T
2-PB1,1318,4,27,4316,3,4350,G
2-PB1,1319,0,16,4340,1,4357,G
2-PB1,1320,3,3,4380,0,4386,G
2-PB1,1321,5,1,0,4448,4454,C
2-PB1,1322,1,4432,0,8,4441,T
2-PB1,1323,19,4,0,4463,4486,C
2-PB1,1324,20,2,0,4445,4467,C
2-PB1,1325,4473,1,0,0,4474,A
2-PB1,1326,4472,1,5,3,4481,A
2-PB1,1327,0,4471,1,3,4475,T
2-PB1,1328,26,1,5,4436,4468,C
2-PB1,1329,14,0,1,4430,4445,C
2-PB1,1330,1,4416,0,3,4420,T
2-PB1,1331,16,2,0,4403,4421,C
2-PB1,1332,21,2,0,4381,4404,C
2-PB1,1333,2,17,4384,1,4404,G
2-PB1,1334,4404,0,3,0,4407,A
2-PB1,1335,2,7,1,4393,4403,C
2-PB1,1336,0,35,4374,0,4409,G
2-PB1,1337,4463,1,0,0,4464,A
2-PB1,1338,0,4457,0,5,4462,T
2-PB1,1339,2,4455,0,3,4460,T
2-PB1,1340,0,4457,0,1,4458,T
2-PB1,1341,1,4458,0,2,4461,T
2-PB1,1342,2,1,4477,0,4480,G
2-PB1,1343,5,1,3,4494,4503,C
2-PB1,1344,34,3,0,4460,4497,C
2-PB1,1345,24,4,1,4622,4651,C
2-PB1,1346,1,4573,0,7,4581,T
2-PB1,1347,18,2,0,4726,4746,C
2-PB1,1348,4772,1,0,0,4773,A
2-PB1,1349,1,4788,1,3,4793,T
2-PB1,1350,4791,1,8,0,4800,A
2-PB1,1351,3,3,4836,1,4843,G
2-PB1,1352,1,4786,0,5,4792,T
2-PB1,1353,1,36,4779,0,4816,G
2-PB1,1354,4673,0,2,0,4675,A
2-PB1,1355,4676,0,2,0,4678,A
2-PB1,1356,0,4521,1,4,4526,T
2-PB1,1357,4,1,4533,0,4538,G
2-PB1,1358,3,0,0,4583,4586,C
2-PB1,1359,4591,0,4,0,4595,A
2-PB1,1360,2,4,0,4601,4607,C
2-PB1,1361,34,3,0,4543,4580,C
2-PB1,1362,4550,0,2,0,4552,A
2-PB1,1363,4553,1,2,0,4556,A
2-PB1,1364,4541,0,3,1,4545,A
2-PB1,1365,2,4437,0,0,4439,T
2-PB1,1366,24,0,0,4583,4607,C
2-PB1,1367,4611,1,2,0,4614,A
2-PB1,1368,1,4615,0,2,4618,T
2-PB1,1369,1,23,4598,0,4622,G
2-PB1,1370,4633,0,12,1,4646,A
2-PB1,1371,6,28,4639,0,4673,G
2-PB1,1372,0,16,4686,0,4702,G
2-PB1,1373,5,33,4690,0,4728,G
2-PB1,1374,4723,0,4,1,4728,A
2-PB1,1375,4788,1,4,0,4793,A
2-PB1,1376,0,4805,0,1,4806,T
2-PB1,1377,4822,1,2,0,4825,A
2-PB1,1378,3,3,0,4823,4829,C
2-PB1,1379,4824,0,0,0,4824,A
2-PB1,1380,4807,1,12,1,4821,A
2-PB1,1381,1,0,4817,0,4818,G
2-PB1,1382,3,2,0,4781,4786,C
2-PB1,1383,4742,1,2,0,4745,A
2-PB1,1384,3,12,4811,0,4826,G
2-PB1,1385,0,32,4791,1,4824,G
2-PB1,1386,4799,1,5,0,4805,A
2-PB1,1387,2,3,4832,0,4837,G
2-PB1,1388,0,4760,0,1,4761,T
2-PB1,1389,3,23,4789,2,4817,G
2-PB1,1390,5,17,4808,2,4832,G
2-PB1,1391,4833,1,2,0,4836,A
2-PB1,1392,1,4840,0,0,4841,T
2-PB1,1393,4771,0,1,0,4772,A
2-PB1,1394,0,23,4812,0,4835,G
2-PB1,1395,4875,0,3,1,4879,A
2-PB1,1396,1,4889,0,4,4894,T
2-PB1,1397,1,4865,0,1,4867,T
2-PB1,1398,28,0,0,5002,5030,C
2-PB1,1399,0,5005,0,6,5011,T
2-PB1,1400,5011,1,0,0,5012,A
2-PB1,1401,2,1,0,5009,5012,C
2-PB1,1402,4914,0,7,0,4921,A
2-PB1,1403,0,15,4925,1,4941,G
2-PB1,1404,0,38,4803,1,4842,G
2-PB1,1405,4872,1,5,0,4878,A
2-PB1,1406,5,0,0,4865,4870,C
2-PB1,1407,18,4,0,4747,4769,C
2-PB1,1408,3,4713,0,5,4721,T
2-PB1,1409,1,4,4745,0,4750,G
2-PB1,1410,1,3,0,4740,4744,C
2-PB1,1411,4752,1,3,1,4757,A
2-PB1,1412,4788,0,5,1,4794,A
2-PB1,1413,1,4,4811,0,4816,G
2-PB1,1414,0,4733,0,1,4734,T
2-PB1,1415,0,4727,0,3,4730,T
2-PB1,1416,4657,1,4,0,4662,A
2-PB1,1417,0,2,4677,0,4679,G
2-PB1,1418,2,4641,0,2,4645,T
2-PB1,1419,2,29,4612,1,4644,G
2-PB1,1420,1,13,4623,0,4637,G
2-PB1,1421,4,28,4651,0,4683,G
2-PB1,1422,4654,0,4,1,4659,A
2-PB1,1423,4678,1,0,0,4679,A
2-PB1,1424,1,4671,0,3,4675,T
2-PB1,1425,28,1,1,4667,4697,C
2-PB1,1426,4683,0,4,0,4687,A
2-PB1,1427,4704,1,3,0,4708,A
2-PB1,1428,3,0,0,4702,4705,C
2-PB1,1429,4691,1,3,1,4696,A
2-PB1,1430,0,4612,1,3,4616,T
2-PB1,1431,2,54,4575,1,4632,G
2-PB1,1432,4631,2,5,0,4638,A
2-PB1,1433,1,4,4666,0,4671,G
2-PB1,1434,3,2,0,4647,4652,C
2-PB1,1435,4630,1,3,0,4634,A
2-PB1,1436,4636,1,6,0,4643,A
2-PB1,1437,4647,3,3,0,4653,A
2-PB1,1438,4684,0,3,1,4688,A
2-PB1,1439,4683,0,5,0,4688,A
2-PB1,1440,0,9,4677,0,4686,G
2-PB1,1441,4629,0,8,0,4637,A
2-PB1,1442,4586,0,6,0,4592,A
2-PB1,1443,0,0,4803,0,4803,G
2-PB1,1444,0,4800,0,6,4806,T
2-PB1,1445,28,2,0,4784,4814,C
2-PB1,1446,30,1,0,4805,4836,C
2-PB1,1447,1,4794,0,6,4801,T
2-PB1,1448,4876,2,2,0,4880,A
2-PB1,1449,0,4861,0,3,4864,T
2-PB1,1450,4870,1,2,0,4873,A
2-PB1,1451,0,4876,0,1,4877,T
2-PB1,1452,4798,0,3,0,4801,A
2-PB1,1453,4806,2,4,0,4812,A
2-PB1,1454,4802,0,1,0,4803,A
2-PB1,1455,1,4800,0,0,4801,T
2-PB1,1456,4750,0,0,0,4750,A
2-PB1,1457,4732,0,2,1,4735,A
2-PB1,1458,4751,0,4,1,4756,A
2-PB1,1459,4761,0,1,2,4764,A
2-PB1,1460,3,4,0,4755,4762,C
2-PB1,1461,4513,1,5,1,4520,A
2-PB1,1462,2,25,4491,1,4519,G
2-PB1,1463,3,24,4482,1,4510,G
2-PB1,1464,3,32,4488,0,4523,G
2-PB1,1465,4513,1,5,0,4519,A
2-PB1,1466,1,1,0,4583,4585,C
2-PB1,1467,4542,0,2,1,4545,A
2-PB1,1468,0,4590,1,1,4592,T
2-PB1,1469,2,4568,3,5,4578,T
2-PB1,1470,0,4587,0,2,4589,T
2-PB1,1471,0,34,4552,0,4586,G
2-PB1,1472,4549,0,1,0,4550,A
2-PB1,1473,4564,0,2,0,4566,A
2-PB1,1474,0,4569,0,2,4571,T
2-PB1,1475,1,4466,2,1,4470,T
2-PB1,1476,36,0,0,4459,4495,C
2-PB1,1477,4467,0,0,0,4467,A
2-PB1,1478,2,2,1,4457,4462,C
2-PB1,1479,0,4465,0,3,4468,T
2-PB1,1480,4474,0,2,0,4476,A
2-PB1,1481,2,1,4473,0,4476,G
2-PB1,1482,1,0,1,4483,4485,C
2-PB1,1483,0,4421,1,4,4426,T
2-PB1,1484,1,4493,0,1,4495,T
2-PB1,1485,0,4466,0,3,4469,T
2-PB1,1486,0,4468,0,2,4470,T
2-PB1,1487,0,4465,0,0,4465,T
2-PB1,1488,0,4458,1,3,4462,T
2-PB1,1489,0,4454,1,0,4455,T
2-PB1,1490,4454,0,3,0,4457,A
2-PB1,1491,0,4435,1,2,4438,T
2-PB1,1492,16,3,0,4428,4447,C
2-PB1,1493,2,19,4466,0,4487,G
2-PB1,1494,4643,1,0,0,4644,A
2-PB1,1495,0,4655,1,2,4658,T
2-PB1,1496,4658,1,2,1,4662,A
2-PB1,1497,1,4693,2,2,4698,T
2-PB1,1498,2,35,4659,0,4696,G
2-PB1,1499,0,26,4684,0,4710,G
2-PB1,1500,4717,0,4,0,4721,A
2-PB1,1501,0,4683,1,3,4687,T
2-PB1,1502,2,4643,0,0,4645,T
2-PB1,1503,1,4495,0,1,4497,T
2-PB1,1504,1,4,4498,0,4503,G
2-PB1,1505,2,4482,0,3,4487,T
2-PB1,1506,1,19,4454,0,4474,G
2-PB1,1507,1,5,4469,0,4475,G
2-PB1,1508,2,1,0,4438,4441,C
2-PB1,1509,1,4432,0,3,4436,T
2-PB1,1510,4450,0,0,0,4450,A
2-PB1,1511,4486,0,0,0,4486,A
2-PB1,1512,0,4527,0,0,4527,T
2-PB1,1513,1,4519,2,2,4524,T
2-PB1,1514,1,4531,1,1,4534,T
2-PB1,1515,0,4527,0,2,4529,T
2-PB1,1516,4519,0,4,0,4523,A
2-PB1,1517,2,3,4556,1,4562,G
2-PB1,1518,1,5,0,4554,4560,C
2-PB1,1519,4541,1,5,1,4548,A
2-PB1,1520,1,4481,1,3,4486,T
2-PB1,1521,1,19,4423,0,4443,G
2-PB1,1522,0,27,4487,2,4516,G
2-PB1,1523,4505,0,3,0,4508,A
2-PB1,1524,0,2,4506,0,4508,G
2-PB1,1525,2,2,1,4484,4489,C
2-PB1,1526,0,4424,2,1,4427,T
2-PB1,1527,1,6,4463,1,4471,G
2-PB1,1528,2,1,0,4448,4451,C
2-PB1,1529,16,1,0,4434,4451,C
2-PB1,1530,21,2,0,4456,4479,C
2-PB1,1531,4375,0,0,0,4375,A
2-PB1,1532,0,1,4595,0,4596,G
2-PB1,1533,0,4587,1,0,4588,T
2-PB1,1534,0,4578,2,3,4583,T
2-PB1,1535,0,4585,1,3,4589,T
2-PB1,1536,0,4526,0,1,4527,T
2-PB1,1537,0,18,4497,0,4515,G
2-PB1,1538,0,36,4487,0,4523,G
2-PB1,1539,4506,0,5,0,4511,A
2-PB1,1540,1,0,4520,0,4521,G
2-PB1,1541,1,4226,1,2,4230,T
2-PB1,1542,4217,0,2,0,4219,A
2-PB1,1543,0,4332,1,2,4335,T
2-PB1,1544,6,0,1,4340,4347,C
2-PB1,1545,0,4347,3,2,4352,T
2-PB1,1546,3,11,4366,0,4380,G
2-PB1,1547,2,29,4395,0,4426,G
2-PB1,1548,4419,1,5,0,4425,A
2-PB1,1549,4429,1,4,0,4434,A
2-PB1,1550,1,4417,0,0,4418,T
2-PB1,1551,4281,0,0,0,4281,A
2-PB1,1552,4277,0,5,1,4283,A
2-PB1,1553,4278,0,4,0,4282,A
2-PB1,1554,4,3,0,4288,4295,C
2-PB1,1555,5,43,4192,0,4240,G
2-PB1,1556,4213,0,1,0,4214,A
2-PB1,1557,2,0,4217,0,4219,G
2-PB1,1558,1,4203,0,6,4210,T
2-PB1,1559,51,1,0,4177,4229,C
2-PB1,1560,4202,0,11,1,4214,A
2-PB1,1561,1,1,4299,1,4302,G
2-PB1,1562,3,0,0,4298,4301,C
2-PB1,1563,0,4278,0,3,4281,T
2-PB1,1564,1,18,4445,0,4464,G
2-PB1,1565,4435,1,8,0,4444,A
2-PB1,1566,0,4446,0,0,4446,T
2-PB1,1567,4444,1,4,0,4449,A
2-PB1,1568,0,4387,0,1,4388,T
2-PB1,1569,0,45,4363,1,4409,G
2-PB1,1570,4245,0,7,0,4252,A
2-PB1,1571,1,3,4316,0,4320,G
2-PB1,1572,4,2,3,4323,4332,C
2-PB1,1573,4138,0,1,0,4139,A
2-PB1,1574,1,4141,0,0,4142,T
2-PB1,1575,1,4132,0,0,4133,T
2-PB1,1576,1,10,4171,0,4182,G
2-PB1,1577,0,26,4334,0,4360,G
2-PB1,1578,4296,0,8,0,4304,A
2-PB1,1579,2,2,4309,1,4314,G
2-PB1,1580,0,4167,0,4,4171,T
2-PB1,1581,4162,0,2,0,4164,A
2-PB1,1582,4167,0,4,0,4171,A
2-PB1,1583,3,2,1,4181,4187,C
2-PB1,1584,4159,1,2,0,4162,A
2-PB1,1585,1,3,4228,0,4232,G
2-PB1,1586,2,3885,0,2,3889,T
2-PB1,1587,2,23,3897,2,3924,G
2-PB1,1588,3967,0,5,0,3972,A
2-PB1,1589,1,3964,0,3,3968,T
2-PB1,1590,3957,0,8,0,3965,A
2-PB1,1591,3960,0,4,0,3964,A
2-PB1,1592,3861,0,8,2,3871,A
2-PB1,1593,0,29,3881,0,3910,G
2-PB1,1594,3771,0,2,0,3773,A
2-PB1,1595,3766,0,4,1,3771,A
2-PB1,1596,2,1,0,3773,3776,C
2-PB1,1597,3657,0,1,0,3658,A
2-PB1,1598,3701,2,3,1,3707,A
2-PB1,1599,0,1,1,3730,3732,C
2-PB1,1600,3766,0,0,0,3766,A
2-PB1,1601,0,3765,4,1,3770,T
2-PB1,1602,0,26,3713,2,3741,G
2-PB1,1603,3742,0,5,1,3748,A
2-PB1,1604,1,3748,0,0,3749,T
2-PB1,1605,3705,0,3,0,3708,A
2-PB1,1606,3738,0,2,0,3740,A
2-PB1,1607,3723,0,5,0,3728,A
2-PB1,1608,1,0,0,3749,3750,C
2-PB1,1609,3626,0,2,0,3628,A
2-PB1,1610,3622,0,1,0,3623,A
2-PB1,1611,0,3573,0,5,3578,T
2-PB1,1612,2,34,3551,0,3587,G
2-PB1,1613,3654,0,4,0,3658,A
2-PB1,1614,1,0,0,3702,3703,C
2-PB1,1615,16,1,1,3634,3652,C
2-PB1,1616,0,3535,1,3,3539,T
2-PB1,1617,0,3454,0,3,3457,T
2-PB1,1618,1,33,3429,0,3463,G
2-PB1,1619,1,27,3460,1,3489,G
2-PB1,1620,3517,0,7,0,3524,A
2-PB1,1621,1,0,0,3511,3512,C
2-PB1,1622,10,4,0,3447,3461,C
2-PB1,1623,3420,0,3,0,3423,A
2-PB1,1624,0,3,3452,0,3455,G
2-PB1,1625,3,2,0,3454,3459,C
2-PB1,1626,3456,1,3,0,3460,A
2-PB1,1627,3448,0,4,0,3452,A
2-PB1,1628,1,1,0,3435,3437,C
2-PB1,1629,3406,0,3,0,3409,A
2-PB1,1630,2,0,3491,0,3493,G
2-PB1,1631,3,2,0,3482,3487,C
2-PB1,1632,9,0,0,3505,3514,C
2-PB1,1633,20,2,0,3465,3487,C
2-PB1,1634,3493,0,1,0,3494,A
2-PB1,1635,3487,2,2,1,3492,A
2-PB1,1636,3495,0,0,0,3495,A
2-PB1,1637,1,3498,0,1,3500,T
2-PB1,1638,2,11,3475,1,3489,G
2-PB1,1639,0,1,3449,0,3450,G
2-PB1,1640,1,0,1,3445,3447,C
2-PB1,1641,1,3429,1,4,3435,T
2-PB1,1642,18,4,0,3518,3540,C
2-PB1,1643,1,3522,0,5,3528,T
2-PB1,1644,28,0,0,3527,3555,C
2-PB1,1645,10,1,0,3554,3565,C
2-PB1,1646,3566,2,2,1,3571,A
2-PB1,1647,3570,1,1,1,3573,A
2-PB1,1648,1,3552,0,2,3555,T
2-PB1,1649,0,3523,0,0,3523,T
2-PB1,1650,4,3,3527,1,3535,G
2-PB1,1651,1,3438,0,5,3444,T
2-PB1,1652,0,3445,0,1,3446,T
2-PB1,1653,49,3,0,3389,3441,C
2-PB1,1654,3431,0,0,0,3431,A
2-PB1,1655,1,3426,0,4,3431,T
2-PB1,1656,13,1,0,3417,3431,C
2-PB1,1657,3435,0,4,0,3439,A
2-PB1,1658,3439,2,1,0,3442,A
2-PB1,1659,3445,1,4,0,3450,A
2-PB1,1660,4,13,3489,0,3506,G
2-PB1,1661,3504,0,2,0,3506,A
2-PB1,1662,0,3505,0,2,3507,T
2-PB1,1663,0,3514,0,0,3514,T
2-PB1,1664,3519,0,5,1,3525,A
2-PB1,1665,0,2,0,3578,3580,C
2-PB1,1666,3562,2,3,0,3567,A
2-PB1,1667,0,7,3609,0,3616,G
2-PB1,1668,3589,0,3,0,3592,A
2-PB1,1669,0,3676,0,1,3677,T
2-PB1,1670,3690,0,3,0,3693,A
2-PB1,1671,0,3,0,3922,3925,C
2-PB1,1672,3987,0,2,1,3990,A
2-PB1,1673,2,3,0,4229,4234,C
2-PB1,1674,4167,0,9,0,4176,A
2-PB1,1675,0,4208,0,3,4211,T
2-PB1,1676,4138,0,5,0,4143,A
2-PB1,1677,0,4137,0,2,4139,T
2-PB1,1678,4043,0,0,0,4043,A
2-PB1,1679,0,14,4037,0,4051,G
2-PB1,1680,2,3,4003,0,4008,G
2-PB1,1681,0,3801,0,6,3807,T
2-PB1,1682,1,3,3730,0,3734,G
2-PB1,1683,4,3,0,3857,3864,C
2-PB1,1684,30,0,1,3833,3864,C
2-PB1,1685,3891,0,2,0,3893,A
2-PB1,1686,1,3885,1,4,3891,T
2-PB1,1687,3898,0,1,2,3901,A
2-PB1,1688,1,17,3897,1,3916,G
2-PB1,1689,3823,0,7,0,3830,A
2-PB1,1690,2,12,3835,0,3849,G
2-PB1,1691,3,28,3810,1,3842,G
2-PB1,1692,3697,1,0,1,3699,A
2-PB1,1693,0,31,3683,1,3715,G
2-PB1,1694,3666,0,8,0,3674,A
2-PB1,1695,0,4,0,3674,3678,C
2-PB1,1696,3675,0,2,0,3677,A
2-PB1,1697,2,4,0,3732,3738,C
2-PB1,1698,3736,0,1,0,3737,A
2-PB1,1699,1,2,0,3745,3748,C
2-PB1,1700,3703,0,6,0,3709,A
2-PB1,1701,3731,1,2,0,3734,A
2-PB1,1702,3780,1,1,0,3782,A
2-PB1,1703,1,3764,0,1,3766,T
2-PB1,1704,17,0,0,3751,3768,C
2-PB1,1705,15,1,0,3747,3763,C
2-PB1,1706,3708,0,3,2,3713,A
2-PB1,1707,1,16,3712,0,3729,G
2-PB1,1708,3723,1,4,0,3728,A
2-PB1,1709,1,1,0,3743,3745,C
2-PB1,1710,3,36,3699,0,3738,G
2-PB1,1711,3711,2,4,0,3717,A
2-PB1,1712,1,12,3701,1,3715,G
2-PB1,1713,3715,0,2,0,3717,A
2-PB1,1714,3721,2,2,1,3726,A
2-PB1,1715,3,19,3715,0,3737,G
2-PB1,1716,3726,1,5,0,3732,A
2-PB1,1717,1,3715,0,4,3720,T
2-PB1,1718,25,0,1,3674,3700,C
2-PB1,1719,3713,0,1,0,3714,A
2-PB1,1720,1,3697,1,1,3700,T
2-PB1,1721,0,3694,0,3,3697,T
2-PB1,1722,26,3,0,3666,3695,C
2-PB1,1723,4,19,3677,0,3700,G
2-PB1,1724,3677,1,5,0,3683,A
2-PB1,1725,0,15,3672,0,3687,G
2-PB1,1726,3658,0,3,0,3661,A
2-PB1,1727,2,3807,0,0,3809,T
2-PB1,1728,3816,0,4,0,3820,A
2-PB1,1729,3837,0,0,0,3837,A
2-PB1,1730,3822,2,5,1,3830,A
2-PB1,1731,2,12,3837,1,3852,G
2-PB1,1732,3841,1,2,0,3844,A
2-PB1,1733,3753,0,0,0,3753,A
2-PB1,1734,0,3,3775,0,3778,G
2-PB1,1735,2,3,0,3791,3796,C
2-PB1,1736,1,3728,0,5,3734,T
2-PB1,1737,7,1,3753,0,3761,G
2-PB1,1738,1,3740,0,4,3745,T
2-PB1,1739,1,24,3714,0,3739,G
2-PB1,1740,1,15,3731,1,3748,G
2-PB1,1741,0,27,3760,0,3787,G
2-PB1,1742,3786,0,1,0,3787,A
2-PB1,1743,0,3764,1,2,3767,T
2-PB1,1744,17,3,0,3725,3745,C
2-PB1,1745,3745,0,3,1,3749,A
2-PB1,1746,3763,0,8,0,3771,A
2-PB1,1747,3795,0,2,0,3797,A
2-PB1,1748,2,1,0,3787,3790,C
2-PB1,1749,14,1,0,3766,3781,C
2-PB1,1750,27,3,0,3734,3764,C
2-PB1,1751,3759,0,2,0,3761,A
2-PB1,1752,3820,0,2,1,3823,A
2-PB1,1753,1,3816,1,4,3822,T
2-PB1,1754,22,0,0,3806,3828,C
2-PB1,1755,3778,1,0,0,3779,A
2-PB1,1756,3745,0,5,0,3750,A
2-PB1,1757,1,27,3774,0,3802,G
2-PB1,1758,4,13,3773,1,3791,G
2-PB1,1759,4,5,3772,0,3781,G
2-PB1,1760,4,2,0,3770,3776,C
2-PB1,1761,3701,1,6,0,3708,A
2-PB1,1762,0,11,3817,0,3828,G
2-PB1,1763,2,21,3831,1,3855,G
2-PB1,1764,3856,1,7,0,3864,A
2-PB1,1765,4,0,0,3896,3900,C
2-PB1,1766,0,3838,0,1,3839,T
2-PB1,1767,3916,2,0,0,3918,A
2-PB1,1768,2,3903,0,4,3909,T
2-PB1,1769,1,3903,0,2,3906,T
2-PB1,1770,3,13,3906,0,3922,G
2-PB1,1771,0,4,3938,0,3942,G
2-PB1,1772,0,3866,0,3,3869,T
2-PB1,1773,3853,1,4,0,3858,A
2-PB1,1774,0,3799,0,2,3801,T
2-PB1,1775,8,4,2,3788,3802,C
2-PB1,1776,3724,2,0,1,3727,A
2-PB1,1777,1,6,3752,0,3759,G
2-PB1,1778,3743,0,5,0,3748,A
2-PB1,1779,1,3721,0,1,3723,T
2-PB1,1780,5,18,3562,0,3585,G
2-PB1,1781,0,24,3565,0,3589,G
2-PB1,1782,0,15,3567,0,3582,G
2-PB1,1783,1,19,3573,0,3593,G
2-PB1,1784,3,35,3543,0,3581,G
2-PB1,1785,3551,0,6,1,3558,A
2-PB1,1786,1,1,0,3551,3553,C
2-PB1,1787,22,1,0,3501,3524,C
2-PB1,1788,3522,2,1,0,3525,A
2-PB1,1789,3778,0,2,0,3780,A
2-PB1,1790,3793,0,0,0,3793,A
2-PB1,1791,2,0,0,3901,3903,C
2-PB1,1792,1,3872,0,1,3874,T
2-PB1,1793,0,3852,0,2,3854,T
2-PB1,1794,3872,1,2,0,3875,A
2-PB1,1795,0,3868,0,3,3871,T
2-PB1,1796,3879,0,3,0,3882,A
2-PB1,1797,0,1,0,3884,3885,C
2-PB1,1798,3549,1,2,0,3552,A
2-PB1,1799,3568,0,1,1,3570,A
2-PB1,1800,1,3483,0,1,3485,T
2-PB1,1801,3533,1,1,0,3535,A
2-PB1,1802,0,3540,0,0,3540,T
2-PB1,1803,16,0,1,3506,3523,C
2-PB1,1804,9,3,0,3505,3517,C
2-PB1,1805,6,13,3503,1,3523,G
2-PB1,1806,0,19,3505,0,3524,G
2-PB1,1807,3526,0,2,1,3529,A
2-PB1,1808,3529,1,2,1,3533,A
2-PB1,1809,0,3525,0,0,3525,T
2-PB1,1810,15,3,0,3538,3556,C
2-PB1,1811,0,3520,0,6,3526,T
2-PB1,1812,1,3544,0,5,3550,T
2-PB1,1813,12,1,0,3532,3545,C
2-PB1,1814,3539,1,7,1,3548,A
2-PB1,1815,1,0,0,3553,3554,C
2-PB1,1816,3540,0,5,0,3545,A
2-PB1,1817,0,3832,0,1,3833,T
2-PB1,1818,10,1,0,3826,3837,C
2-PB1,1819,19,1,1,3826,3847,C
2-PB1,1820,16,2,0,3842,3860,C
2-PB1,1821,0,3849,1,5,3855,T
2-PB1,1822,1,14,3847,0,3862,G
2-PB1,1823,3856,0,1,1,3858,A
2-PB1,1824,3849,1,3,1,3854,A
2-PB1,1825,1,2,3856,0,3859,G
2-PB1,1826,0,3636,0,3,3639,T
2-PB1,1827,14,5,0,3625,3644,C
2-PB1,1828,2,3594,1,3,3600,T
2-PB1,1829,5,2,3711,0,3718,G
2-PB1,1830,2,0,0,3723,3725,C
2-PB1,1831,2,3714,1,5,3722,T
2-PB1,1832,1,3716,1,5,3723,T
2-PB1,1833,3713,1,1,0,3715,A
2-PB1,1834,3716,1,4,0,3721,A
2-PB1,1835,3726,1,0,0,3727,A
2-PB1,1836,2,2,3742,0,3746,G
2-PB1,1837,1,3712,0,0,3713,T
2-PB1,1838,0,20,3607,1,3628,G
2-PB1,1839,0,11,3608,0,3619,G
2-PB1,1840,3,32,3602,0,3637,G
2-PB1,1841,3630,1,6,0,3637,A
2-PB1,1842,1,0,3653,0,3654,G
2-PB1,1843,2,0,0,3647,3649,C
2-PB1,1844,0,3624,0,2,3626,T
2-PB1,1845,0,13,3627,0,3640,G
2-PB1,1846,3628,0,6,0,3634,A
2-PB1,1847,1,3637,0,2,3640,T
2-PB1,1848,4,23,3615,1,3643,G
2-PB1,1849,0,15,3645,0,3660,G
2-PB1,1850,3646,2,6,1,3655,A
2-PB1,1851,0,3628,0,4,3632,T
2-PB1,1852,2,33,3594,0,3629,G
2-PB1,1853,3613,0,1,0,3614,A
2-PB1,1854,0,28,3632,0,3660,G
2-PB1,1855,3652,1,3,0,3656,A
2-PB1,1856,3660,0,1,0,3661,A
2-PB1,1857,0,3648,0,2,3650,T
2-PB1,1858,0,3617,0,0,3617,T
2-PB1,1859,3623,0,1,0,3624,A
2-PB1,1860,2,3617,0,3,3622,T
2-PB1,1861,18,8,0,3600,3626,C
2-PB1,1862,4,12,3628,0,3644,G
2-PB1,1863,4,10,3590,0,3604,G
2-PB1,1864,3,13,3577,0,3593,G
2-PB1,1865,0,9,3582,0,3591,G
2-PB1,1866,3577,1,1,0,3579,A
2-PB1,1867,3586,0,6,0,3592,A
2-PB1,1868,0,21,3595,0,3616,G
2-PB1,1869,3642,1,4,0,3647,A
2-PB1,1870,2,2,0,3657,3661,C
2-PB1,1871,0,3610,0,2,3612,T
2-PB1,1872,0,3683,0,1,3684,T
2-PB1,1873,0,3678,0,5,3683,T
2-PB1,1874,4,2,3736,0,3742,G
2-PB1,1875,0,3734,0,2,3736,T
2-PB1,1876,3728,0,1,0,3729,A
2-PB1,1877,3724,0,1,0,3725,A
2-PB1,1878,0,3638,0,3,3641,T
2-PB1,1879,23,1,0,3659,3683,C
2-PB1,1880,7,4,0,3675,3686,C
2-PB1,1881,21,2,0,3643,3666,C
2-PB1,1882,7,1,0,3690,3698,C
2-PB1,1883,2,3661,0,2,3665,T
2-PB1,1884,0,20,3652,0,3672,G
2-PB1,1885,3672,1,2,0,3675,A
2-PB1,1886,3689,0,2,0,3691,A
2-PB1,1887,0,3683,0,7,3690,T
2-PB1,1888,33,3,0,3652,3688,C
2-PB1,1889,17,1,1,3636,3655,C
2-PB1,1890,24,0,0,3620,3644,C
2-PB1,1891,2,3606,0,6,3614,T
2-PB1,1892,2,3620,0,1,3623,T
2-PB1,1893,0,3606,0,3,3609,T
2-PB1,1894,3,3,3608,0,3614,G
2-PB1,1895,3,3581,1,2,3587,T
2-PB1,1896,30,4,0,3555,3589,C
2-PB1,1897,3557,0,6,0,3563,A
2-PB1,1898,1,5,3635,1,3642,G
2-PB1,1899,4,2,0,3634,3640,C
2-PB1,1900,9,0,0,3644,3653,C
2-PB1,1901,3648,2,3,1,3654,A
2-PB1,1902,0,3657,0,2,3659,T
2-PB1,1903,3656,0,1,1,3658,A
2-PB1,1904,3660,0,0,0,3660,A
2-PB1,1905,3666,0,2,0,3668,A
2-PB1,1906,0,8,3682,0,3690,G
2-PB1,1907,3602,0,0,0,3602,A
2-PB1,1908,3605,1,1,0,3607,A
2-PB1,1909,3598,0,5,0,3603,A
2-PB1,1910,1,3598,1,1,3601,T
2-PB1,1911,0,3605,0,0,3605,T
2-PB1,1912,2,24,3575,1,3602,G
2-PB1,1913,3592,0,1,0,3593,A
2-PB1,1914,3508,0,2,0,3510,A
2-PB1,1915,1,3646,0,2,3649,T
2-PB1,1916,19,0,0,3653,3672,C
2-PB1,1917,1,3672,2,3,3678,T
2-PB1,1918,4,2,3739,0,3745,G
2-PB1,1919,0,3738,1,4,3743,T
2-PB1,1920,3806,0,2,0,3808,A
2-PB1,1921,3802,0,4,0,3806,A
2-PB1,1922,3798,2,7,0,3807,A
2-PB1,1923,0,1,0,3829,3830,C
2-PB1,1924,3701,1,2,0,3704,A
2-PB1,1925,3803,1,1,0,3805,A
2-PB1,1926,1,3804,0,1,3806,T
2-PB1,1927,0,7,3785,0,3792,G
2-PB1,1928,2,4,0,3819,3825,C
2-PB1,1929,0,3771,1,6,3778,T
2-PB1,1930,3,2,3912,0,3917,G
2-PB1,1931,0,3913,0,2,3915,T
2-PB1,1932,3998,0,1,0,3999,A
2-PB1,1933,0,1,4008,0,4009,G
2-PB1,1934,0,3875,0,4,3879,T
2-PB1,1935,3864,0,0,0,3864,A
2-PB1,1936,3838,1,0,0,3839,A
2-PB1,1937,3,3827,0,0,3830,T
2-PB1,1938,3,2,3820,0,3825,G
2-PB1,1939,2,1,0,3762,3765,C
2-PB1,1940,8,1,0,3708,3717,C
2-PB1,1941,3650,0,2,0,3652,A
2-PB1,1942,0,3,3669,1,3673,G
2-PB1,1943,0,1,0,3757,3758,C
2-PB1,1944,18,0,0,3734,3752,C
2-PB1,1945,20,0,0,3735,3755,C
2-PB1,1946,3734,0,1,1,3736,A
2-PB1,1947,5,3726,0,6,3737,T
2-PB1,1948,3,15,3717,0,3735,G
2-PB1,1949,1,1,3743,0,3745,G
2-PB1,1950,1,3706,5,3,3715,T
2-PB1,1951,27,0,0,3670,3697,C
2-PB1,1952,10,2,1,3590,3603,C
2-PB1,1953,3,21,3635,0,3659,G
2-PB1,1954,2,3,3659,0,3664,G
2-PB1,1955,3,3,0,3647,3653,C
2-PB1,1956,26,2,0,3638,3666,C
2-PB1,1957,3662,1,1,1,3665,A
2-PB1,1958,3686,0,0,0,3686,A
2-PB1,1959,3681,1,2,0,3684,A
2-PB1,1960,3696,0,5,0,3701,A
2-PB1,1961,1,1,3766,0,3768,G
2-PB1,1962,0,3662,0,1,3663,T
2-PB1,1963,3687,0,1,1,3689,A
2-PB1,1964,0,3689,0,1,3690,T
2-PB1,1965,4,11,3678,0,3693,G
2-PB1,1966,1,18,3740,0,3759,G
2-PB1,1967,3715,0,2,0,3717,A
2-PB1,1968,3753,0,2,1,3756,A
2-PB1,1969,0,3741,0,1,3742,T
2-PB1,1970,3699,0,0,0,3699,A
2-PB1,1971,0,3688,1,1,3690,T
2-PB1,1972,1,22,3642,1,3666,G
2-PB1,1973,3679,1,1,0,3681,A
2-PB1,1974,0,3662,0,3,3665,T
2-PB1,1975,0,3,3567,0,3570,G
2-PB1,1976,1,0,1,3572,3574,C
2-PB1,1977,11,0,1,3525,3537,C
2-PB1,1978,2,2,3542,0,3546,G
2-PB1,1979,0,3543,0,2,3545,T
2-PB1,1980,1,3540,0,0,3541,T
2-PB1,1981,1,3,3550,0,3554,G
2-PB1,1982,3,3,0,3602,3608,C
2-PB1,1983,3603,0,5,0,3608,A
2-PB1,1984,3656,0,1,0,3657,A
2-PB1,1985,2,3,0,3666,3671,C
2-PB1,1986,0,3637,1,3,3641,T
2-PB1,1987,3670,0,0,1,3671,A
2-PB1,1988,2,3,0,3663,3668,C
2-PB1,1989,3657,0,3,0,3660,A
2-PB1,1990,3,1,2,3659,3665,C
2-PB1,1991,3529,0,5,0,3534,A
2-PB1,1992,2,2,0,3770,3774,C
2-PB1,1993,0,3698,0,5,3703,T
2-PB1,1994,28,1,0,3676,3705,C
2-PB1,1995,11,0,0,3695,3706,C
2-PB1,1996,2,3671,0,6,3679,T
2-PB1,1997,2,13,3664,0,3679,G
2-PB1,1998,1,15,3659,0,3675,G
2-PB1,1999,3671,1,4,0,3676,A
2-PB1,2000,0,3671,0,2,3673,T
2-PB1,2001,0,3382,0,5,3387,T
2-PB1,2002,24,2,0,3413,3439,C
2-PB1,2003,12,0,0,3400,3412,C
2-PB1,2004,24,1,1,3409,3435,C
2-PB1,2005,3447,0,2,0,3449,A
2-PB1,2006,3437,0,2,0,3439,A
2-PB1,2007,1,5,3445,0,3451,G
2-PB1,2008,3432,0,3,0,3435,A
2-PB1,2009,1,11,3423,0,3435,G
2-PB1,2010,0,25,3422,1,3448,G
2-PB1,2011,3367,0,6,0,3373,A
2-PB1,2012,3363,2,4,0,3369,A
2-PB1,2013,1,0,1,3362,3364,C
2-PB1,2014,15,5,0,3325,3345,C
2-PB1,2015,5,7,3389,0,3401,G
2-PB1,2016,1,0,0,3397,3398,C
2-PB1,2017,0,3383,0,2,3385,T
2-PB1,2018,26,0,1,3375,3402,C
2-PB1,2019,0,3377,0,0,3377,T
2-PB1,2020,3611,0,1,0,3612,A
2-PB1,2021,0,3618,0,3,3621,T
2-PB1,2022,2,3624,0,2,3628,T
2-PB1,2023,17,1,1,3620,3639,C
2-PB1,2024,0,3495,0,4,3499,T
2-PB1,2025,3499,0,4,1,3504,A
2-PB1,2026,3491,0,1,1,3493,A
2-PB1,2027,3526,0,1,0,3527,A
2-PB1,2028,2,3,0,3522,3527,C
2-PB1,2029,3295,0,1,1,3297,A
2-PB1,2030,2,1,0,3292,3295,C
2-PB1,2031,3248,0,2,0,3250,A
2-PB1,2032,3291,1,6,0,3298,A
2-PB1,2033,3,2,3302,0,3307,G
2-PB1,2034,0,2,0,3303,3305,C
2-PB1,2035,15,4,0,3288,3307,C
2-PB1,2036,3289,0,1,1,3291,A
2-PB1,2037,3289,1,3,0,3293,A
2-PB1,2038,3282,0,3,1,3286,A
2-PB1,2039,1,8,3310,1,3320,G
2-PB1,2040,2,17,3303,1,3323,G
2-PB1,2041,0,8,3250,0,3258,G
2-PB1,2042,0,23,3229,1,3253,G
2-PB1,2043,3226,0,3,0,3229,A
2-PB1,2044,3251,0,0,0,3251,A
2-PB1,2045,0,3237,0,1,3238,T
2-PB1,2046,0,3236,0,3,3239,T
2-PB1,2047,21,2,0,3229,3252,C
2-PB1,2048,1,3222,0,1,3224,T
2-PB1,2049,1,3207,0,0,3208,T
2-PB1,2050,1,12,3203,0,3216,G
2-PB1,2051,3209,0,4,0,3213,A
2-PB1,2052,1,13,3217,0,3231,G
2-PB1,2053,0,13,3197,0,3210,G
2-PB1,2054,3206,0,1,0,3207,A
2-PB1,2055,0,3186,0,6,3192,T
2-PB1,2056,1,41,3165,0,3207,G
2-PB1,2057,3202,1,2,0,3205,A
2-PB1,2058,3200,1,8,0,3209,A
2-PB1,2059,2,5,0,3220,3227,C
2-PB1,2060,3174,0,2,0,3176,A
2-PB1,2061,0,11,3217,0,3228,G
2-PB1,2062,3192,1,5,0,3198,A
2-PB1,2063,0,3190,1,1,3192,T
2-PB1,2064,0,0,3214,0,3214,G
2-PB1,2065,0,3253,0,1,3254,T
2-PB1,2066,3262,3,2,0,3267,A
2-PB1,2067,4,1,1,3255,3261,C
2-PB1,2068,14,1,1,3221,3237,C
2-PB1,2069,3213,1,5,0,3219,A
2-PB1,2070,1,6,3175,0,3182,G
2-PB1,2071,3128,0,1,0,3129,A
2-PB1,2072,3116,0,4,0,3120,A
2-PB1,2073,0,2,3137,0,3139,G
2-PB1,2074,0,2962,0,2,2964,T
2-PB1,2075,3,1,2963,0,2967,G
2-PB1,2076,4,0,0,2965,2969,C
2-PB1,2077,1,2962,0,2,2965,T
2-PB1,2078,1,1,2962,0,2964,G
2-PB1,2079,1,3,0,2952,2956,C
2-PB1,2080,2946,0,3,0,2949,A
2-PB1,2081,2959,0,1,0,2960,A
2-PB1,2082,0,0,0,2911,2911,C
2-PB1,2083,0,2895,0,5,2900,T
2-PB1,2084,0,2856,0,0,2856,T
2-PB1,2085,5,1,2849,0,2855,G
2-PB1,2086,1,2856,0,0,2857,T
2-PB1,2087,2,2853,0,0,2855,T
2-PB1,2088,30,1,0,2820,2851,C
2-PB1,2089,0,14,2835,0,2849,G
2-PB1,2090,2842,1,5,1,2849,A
2-PB1,2091,0,17,2830,0,2847,G
2-PB1,2092,2842,0,0,0,2842,A
2-PB1,2093,2848,0,0,0,2848,A
2-PB1,2094,2846,1,0,1,2848,A
2-PB1,2095,2,2835,1,1,2839,T
2-PB1,2096,1,2839,1,2,2843,T
2-PB1,2097,1,2846,0,1,2848,T
2-PB1,2098,2,2852,0,1,2855,T
2-PB1,2099,0,2844,1,1,2846,T
2-PB1,2100,18,0,0,2847,2865,C
2-PB1,2101,13,0,0,2858,2871,C
2-PB1,2102,22,3,0,2842,2867,C
2-PB1,2103,1,2846,0,6,2853,T
2-PB1,2104,2864,0,0,0,2864,A
2-PB1,2105,0,0,2880,0,2880,G
2-PB1,2106,0,2877,1,1,2879,T
2-PB1,2107,2893,0,0,0,2893,A
2-PB1,2108,3,2,2914,0,2919,G
2-PB1,2109,2,2892,0,1,2895,T
2-PB1,2110,2,2980,0,3,2985,T
2-PB1,2111,35,0,0,2967,3002,C
2-PB1,2112,3045,0,3,0,3048,A
2-PB1,2113,1,3045,0,1,3047,T
2-PB1,2114,3049,1,2,0,3052,A
2-PB1,2115,2,3045,2,3,3052,T
2-PB1,2116,2955,0,2,0,2957,A
2-PB1,2117,1,8,2947,0,2956,G
2-PB1,2118,0,11,2927,0,2938,G
2-PB1,2119,2639,1,7,0,2647,A
2-PB1,2120,0,15,2622,1,2638,G
2-PB1,2121,2465,0,1,0,2466,A
2-PB1,2122,2,2,0,2456,2460,C
2-PB1,2123,15,0,0,2357,2372,C
2-PB1,2124,6,11,2353,0,2370,G
2-PB1,2125,2371,0,0,0,2371,A
2-PB1,2126,0,2352,1,1,2354,T
2-PB1,2127,0,2354,1,1,2356,T
2-PB1,2128,2,10,2354,0,2366,G
2-PB1,2129,0,11,2354,0,2365,G
2-PB1,2130,2365,0,4,0,2369,A
2-PB1,2131,2364,0,4,0,2368,A
2-PB1,2132,0,2350,1,0,2351,T
2-PB1,2133,0,2354,0,1,2355,T
2-PB1,2134,0,2348,0,2,2350,T
2-PB1,2135,19,0,0,2338,2357,C
2-PB1,2136,0,2352,0,2,2354,T
2-PB1,2137,2333,2,5,0,2340,A
2-PB1,2138,1,1,2347,1,2350,G
2-PB1,2139,0,0,0,2345,2345,C
2-PB1,2140,2347,1,3,0,2351,A
2-PB1,2141,0,2339,0,1,2340,T
2-PB1,2142,1,8,2305,0,2314,G
2-PB1,2143,0,1,2370,1,2372,G
2-PB1,2144,0,2361,1,3,2365,T
2-PB1,2145,3,8,2349,0,2360,G
2-PB1,2146,1,6,2347,0,2354,G
2-PB1,2147,2320,0,6,0,2326,A
2-PB1,2148,0,5,2337,0,2342,G
2-PB1,2149,1,2,2344,0,2347,G
2-PB1,2150,3,1,0,2334,2338,C
2-PB1,2151,10,2,0,2300,2312,C
2-PB1,2152,2194,0,3,0,2197,A
2-PB1,2153,0,2188,0,1,2189,T
2-PB1,2154,0,13,2183,0,2196,G
2-PB1,2155,1,0,2211,0,2212,G
2-PB1,2156,1,2161,0,0,2162,T
2-PB1,2157,0,0,2180,0,2180,G
2-PB1,2158,0,2129,1,2,2132,T
2-PB1,2159,25,2,0,2100,2127,C
2-PB1,2160,0,2118,2,3,2123,T
2-PB1,2161,2097,0,0,0,2097,A
2-PB1,2162,0,6,2092,0,2098,G
2-PB1,2163,1,10,2041,0,2052,G
2-PB1,2164,0,1,2029,0,2030,G
2-PB1,2165,1,0,0,1979,1980,C
2-PB1,2166,11,2,0,1887,1900,C
2-PB1,2167,10,1,0,1864,1875,C
2-PB1,2168,5,5,1858,0,1868,G
2-PB1,2169,0,4,1867,0,1871,G
2-PB1,2170,1871,0,1,0,1872,A
2-PB1,2171,1,1867,1,0,1869,T
2-PB1,2172,0,1805,0,0,1805,T
2-PB1,2173,0,2,1788,0,1790,G
2-PB1,2174,1784,0,0,0,1784,A
2-PB1,2175,0,1792,0,0,1792,T
2-PB1,2176,1,0,1791,0,1792,G
2-PB1,2177,5,1,1,1762,1769,C
2-PB1,2178,9,0,0,1757,1766,C
2-PB1,2179,1749,0,1,0,1750,A
2-PB1,2180,0,10,1745,0,1755,G
2-PB1,2181,1751,0,2,0,1753,A
2-PB1,2182,1753,0,0,0,1753,A
2-PB1,2183,1,1743,1,3,1748,T
2-PB1,2184,0,1714,1,4,1719,T
2-PB1,2185,0,14,1706,0,1720,G
2-PB1,2186,1711,0,0,2,1713,A
2-PB1,2187,2,1,0,1712,1715,C
2-PB1,2188,0,1689,1,5,1695,T
2-PB1,2189,0,1676,1,0,1677,T
2-PB1,2190,3,0,0,1664,1667,C
2-PB1,2191,2,9,1663,0,1674,G
2-PB1,2192,1666,0,2,1,1669,A
2-PB1,2193,1,0,1634,0,1635,G
2-PB1,2194,3,1656,0,0,1659,T
2-PB1,2195,16,2,0,1643,1661,C
2-PB1,2196,1,1658,1,2,1662,T
2-PB1,2197,0,2,1664,0,1666,G
2-PB1,2198,0,3,1658,0,1661,G
2-PB1,2199,1660,0,0,1,1661,A
2-PB1,2200,1554,0,2,1,1557,A
2-PB1,2201,0,9,1558,0,1567,G
2-PB1,2202,0,5,1581,0,1586,G
2-PB1,2203,1582,1,1,1,1585,A
2-PB1,2204,0,1579,0,0,1579,T
2-PB1,2205,0,1576,0,0,1576,T
2-PB1,2206,1571,1,2,1,1575,A
2-PB1,2207,1567,0,2,1,1570,A
2-PB1,2208,1,7,1569,0,1577,G
2-PB1,2209,1569,0,1,1,1571,A
2-PB1,2210,1482,0,3,0,1485,A
2-PB1,2211,0,4,1371,0,1375,G
2-PB1,2212,0,2,1370,0,1372,G
2-PB1,2213,1369,0,1,0,1370,A
2-PB1,2214,1361,0,3,1,1365,A
2-PB1,2215,0,2,1365,0,1367,G
2-PB1,2216,1297,0,2,1,1300,A
2-PB1,2217,1,0,1302,0,1303,G
2-PB1,2218,0,1246,1,1,1248,T
2-PB1,2219,0,1233,1,1,1235,T
2-PB1,2220,17,0,2,1226,1245,C
2-PB1,2221,0,1204,0,2,1206,T
2-PB1,2222,5,0,0,1200,1205,C
2-PB1,2223,0,1196,0,1,1197,T
2-PB1,2224,0,7,1179,0,1186,G
2-PB1,2225,1163,0,0,0,1163,A
2-PB1,2226,0,5,1141,1,1147,G
2-PB1,2227,1133,0,0,0,1133,A
2-PB1,2228,0,1109,0,1,1110,T
2-PB1,2229,8,1,0,1040,1049,C
2-PB1,2230,1055,0,1,0,1056,A
2-PB1,2231,0,1049,0,0,1049,T
2-PB1,2232,0,7,1041,0,1048,G
2-PB1,2233,1044,0,1,0,1045,A
2-PB1,2234,1039,0,0,0,1039,A
2-PB1,2235,0,3,1014,0,1017,G
2-PB1,2236,992,0,0,1,993,A
2-PB1,2237,2,980,0,4,986,T
2-PB1,2238,4,0,0,967,971,C
2-PB1,2239,0,910,0,1,911,T
2-PB1,2240,1,0,918,0,919,G
2-PB1,2241,0,911,0,3,914,T
2-PB1,2242,0,911,0,2,913,T
2-PB1,2243,11,0,0,897,908,C
2-PB1,2244,5,2,0,863,870,C
2-PB1,2245,866,0,1,0,867,A
2-PB1,2246,2,1,0,867,870,C
2-PB1,2247,8,0,0,831,839,C
2-PB1,2248,825,0,0,0,825,A
2-PB1,2249,0,767,0,0,767,T
2-PB1,2250,1,739,0,0,740,T
2-PB1,2251,4,2,733,0,739,G
2-PB1,2252,730,0,2,0,732,A
2-PB1,2253,730,0,3,0,733,A
2-PB1,2254,8,3,723,0,734,G
2-PB1,2255,632,0,0,0,632,A
2-PB1,2256,631,0,0,0,631,A
2-PB1,2257,0,1,0,623,624,C
2-PB1,2258,0,599,0,1,600,T
2-PB1,2259,2,0,0,595,597,C
2-PB1,2260,556,1,0,0,557,A
2-PB1,2261,0,0,556,0,556,G
2-PB1,2262,556,0,1,0,557,A
2-PB1,2263,0,1,0,536,537,C
2-PB1,2264,1,2,513,0,516,G
2-PB1,2265,2,2,507,0,511,G
2-PB1,2266,0,0,0,507,507,C
2-PB1,2267,504,0,0,0,504,A
2-PB1,2268,505,0,0,0,505,A
2-PB1,2269,504,0,0,0,504,A
2-PB1,2270,502,0,0,0,502,A
2-PB1,2271,502,0,0,0,502,A
2-PB1,2272,0,493,0,0,493,T
2-PB1,2273,472,0,0,0,472,A
2-PB1,2274,471,0,0,0,471,A
3-PA,1,139,0,0,0,139,A
3-PA,2,0,139,0,0,139,T
3-PA,3,0,0,152,0,152,G
3-PA,4,0,1,152,0,153,G
3-PA,5,153,0,0,0,153,A
3-PA,6,153,0,0,0,153,A
3-PA,7,0,2,156,0,158,G
3-PA,8,170,0,0,0,170,A
3-PA,9,0,171,0,0,171,T
3-PA,10,0,170,0,0,170,T
3-PA,11,0,178,0,0,178,T
3-PA,12,1,177,0,1,179,T
3-PA,13,0,0,185,0,185,G
3-PA,14,0,185,0,0,185,T
3-PA,15,0,0,185,0,185,G
3-PA,16,0,0,0,192,192,C
3-PA,17,0,4,189,0,193,G
3-PA,18,219,0,0,0,219,A
3-PA,19,1,0,0,220,221,C
3-PA,20,221,0,0,0,221,A
3-PA,21,228,0,0,0,228,A
3-PA,22,0,234,0,0,234,T
3-PA,23,0,0,268,1,269,G
3-PA,24,0,0,0,271,271,C
3-PA,25,0,270,1,0,271,T
3-PA,26,0,272,0,0,272,T
3-PA,27,2,0,0,272,274,C
3-PA,28,283,0,1,0,284,A
3-PA,29,296,0,0,0,296,A
3-PA,30,0,0,0,311,311,C
3-PA,31,0,0,0,312,312,C
3-PA,32,1,1,0,311,313,C
3-PA,33,0,0,316,0,316,G
3-PA,34,315,0,1,0,316,A
3-PA,35,0,316,0,0,316,T
3-PA,36,0,2,315,0,317,G
3-PA,37,317,0,0,0,317,A
3-PA,38,1,331,0,0,332,T
3-PA,39,0,331,0,0,331,T
3-PA,40,0,0,331,0,331,G
3-PA,41,0,332,0,0,332,T
3-PA,42,2,0,0,330,332,C
3-PA,43,0,7,325,0,332,G
3-PA,44,338,0,0,0,338,A
3-PA,45,339,0,0,0,339,A
3-PA,46,1,0,0,341,342,C
3-PA,47,0,342,0,0,342,T
3-PA,48,0,342,0,0,342,T
3-PA,49,0,1,342,0,343,G
3-PA,50,0,1,0,343,344,C
3-PA,51,345,0,0,0,345,A
3-PA,52,0,0,349,0,349,G
3-PA,53,347,0,0,0,347,A
3-PA,54,349,0,0,0,349,A
3-PA,55,350,0,0,0,350,A
3-PA,56,351,0,0,0,351,A
3-PA,57,351,0,2,0,353,A
3-PA,58,0,0,359,0,359,G
3-PA,59,0,0,0,382,382,C
3-PA,60,382,0,2,0,384,A
3-PA,61,409,0,0,0,409,A
3-PA,62,0,409,0,0,409,T
3-PA,63,0,1,413,0,414,G
3-PA,64,418,0,0,0,418,A
3-PA,65,417,0,1,0,418,A
3-PA,66,414,1,1,0,416,A
3-PA,67,0,2,440,0,442,G
3-PA,68,460,0,1,0,461,A
3-PA,69,0,0,524,0,524,G
3-PA,70,0,522,0,0,522,T
3-PA,71,528,0,0,0,528,A
3-PA,72,0,528,0,0,528,T
3-PA,73,0,5,528,0,533,G
3-PA,74,0,4,537,0,541,G
3-PA,75,0,4,535,1,540,G
3-PA,76,0,2,541,0,543,G
3-PA,77,533,0,0,1,534,A
3-PA,78,0,4,529,0,533,G
3-PA,79,0,6,530,0,536,G
3-PA,80,537,0,1,0,538,A
3-PA,81,0,541,0,0,541,T
3-PA,82,0,0,0,545,545,C
3-PA,83,0,538,0,1,539,T
3-PA,84,1,3,537,0,541,G
3-PA,85,541,0,0,0,541,A
3-PA,86,539,1,0,0,540,A
3-PA,87,541,0,0,0,541,A
3-PA,88,540,0,0,0,540,A
3-PA,89,0,540,0,0,540,T
3-PA,90,0,538,0,0,538,T
3-PA,91,0,3,537,0,540,G
3-PA,92,539,0,0,0,539,A
3-PA,93,540,0,2,0,542,A
3-PA,94,542,0,1,0,543,A
3-PA,95,0,0,0,546,546,C
3-PA,96,548,0,0,0,548,A
3-PA,97,548,0,0,1,549,A
3-PA,98,549,0,0,0,549,A
3-PA,99,1,0,0,551,552,C
3-PA,100,548,0,2,0,550,A
3-PA,101,557,0,0,0,557,A
3-PA,102,556,0,0,0,556,A
3-PA,103,0,557,0,0,557,T
3-PA,104,0,558,0,1,559,T
3-PA,105,0,559,0,0,559,T
3-PA,106,1,1,557,0,559,G
3-PA,107,0,0,0,560,560,C
3-PA,108,555,0,0,0,555,A
3-PA,109,3,1,582,0,586,G
3-PA,110,0,1,0,591,592,C
3-PA,111,622,0,0,0,622,A
3-PA,112,634,0,0,0,634,A
3-PA,113,0,640,0,0,640,T
3-PA,114,651,0,0,0,651,A
3-PA,115,0,652,0,0,652,T
3-PA,116,0,1,665,0,666,G
3-PA,117,0,0,0,666,666,C
3-PA,118,664,0,0,0,664,A
3-PA,119,0,0,0,675,675,C
3-PA,120,0,663,0,1,664,T
3-PA,121,5,0,0,780,785,C
3-PA,122,797,0,1,1,799,A
3-PA,123,0,0,0,814,814,C
3-PA,124,0,813,0,0,813,T
3-PA,125,0,813,0,0,813,T
3-PA,126,0,1,816,0,817,G
3-PA,127,0,3,819,0,822,G
3-PA,128,816,0,1,0,817,A
3-PA,129,0,5,831,0,836,G
3-PA,130,0,1,828,0,829,G
3-PA,131,0,798,0,0,798,T
3-PA,132,0,0,832,0,832,G
3-PA,133,0,832,0,1,833,T
3-PA,134,0,3,847,0,850,G
3-PA,135,0,851,0,1,852,T
3-PA,136,0,852,0,0,852,T
3-PA,137,0,849,0,3,852,T
3-PA,138,9,0,0,855,864,C
3-PA,139,868,0,0,0,868,A
3-PA,140,0,871,0,0,871,T
3-PA,141,1,0,887,0,888,G
3-PA,142,0,873,0,0,873,T
3-PA,143,884,0,0,0,884,A
3-PA,144,1,881,0,0,882,T
3-PA,145,0,879,0,1,880,T
3-PA,146,7,1,0,878,886,C
3-PA,147,878,1,1,0,880,A
3-PA,148,0,4,889,0,893,G
3-PA,149,894,0,0,0,894,A
3-PA,150,0,894,0,1,895,T
3-PA,151,0,890,0,3,893,T
3-PA,152,0,895,0,0,895,T
3-PA,153,4,0,0,889,893,C
3-PA,154,5,0,0,920,925,C
3-PA,155,925,0,0,0,925,A
3-PA,156,0,928,0,0,928,T
3-PA,157,0,926,0,0,926,T
3-PA,158,0,930,0,0,930,T
3-PA,159,4,0,0,926,930,C
3-PA,160,926,0,9,0,935,A
3-PA,161,0,969,0,0,969,T
3-PA,162,3,0,0,966,969,C
3-PA,163,967,0,0,0,967,A
3-PA,164,972,0,0,0,972,A
3-PA,165,0,971,0,0,971,T
3-PA,166,0,13,993,1,1007,G
3-PA,167,1008,0,0,0,1008,A
3-PA,168,1008,0,1,0,1009,A
3-PA,169,1,0,0,1007,1008,C
3-PA,170,1001,0,0,0,1001,A
3-PA,171,1005,0,0,0,1005,A
3-PA,172,1,3,1008,0,1012,G
3-PA,173,0,2,1006,0,1008,G
3-PA,174,1,2,0,1006,1009,C
3-PA,175,1,15,982,0,998,G
3-PA,176,1052,0,0,0,1052,A
3-PA,177,1058,0,2,0,1060,A
3-PA,178,0,1058,0,1,1059,T
3-PA,179,5,0,0,1070,1075,C
3-PA,180,1066,0,1,0,1067,A
3-PA,181,1070,0,1,0,1071,A
3-PA,182,1,1080,0,0,1081,T
3-PA,183,1078,0,1,0,1079,A
3-PA,184,0,0,1100,0,1100,G
3-PA,185,1,1090,0,0,1091,T
3-PA,186,0,7,1087,0,1094,G
3-PA,187,0,3,1093,0,1096,G
3-PA,188,0,1087,0,3,1090,T
3-PA,189,1084,0,1,0,1085,A
3-PA,190,1,11,1087,0,1099,G
3-PA,191,1091,0,2,0,1093,A
3-PA,192,1091,0,2,0,1093,A
3-PA,193,0,0,0,1096,1096,C
3-PA,194,0,1079,0,0,1079,T
3-PA,195,0,1080,0,0,1080,T
3-PA,196,0,8,1071,1,1080,G
3-PA,197,1079,0,2,0,1081,A
3-PA,198,0,0,0,1083,1083,C
3-PA,199,0,8,1061,0,1069,G
3-PA,200,1100,0,1,0,1101,A
3-PA,201,1,1106,0,1,1108,T
3-PA,202,5,0,0,1123,1128,C
3-PA,203,4,0,0,1133,1137,C
3-PA,204,1141,0,0,0,1141,A
3-PA,205,1140,0,0,0,1140,A
3-PA,206,1146,0,0,0,1146,A
3-PA,207,1,1145,0,0,1146,T
3-PA,208,0,1,1151,0,1152,G
3-PA,209,0,0,0,1143,1143,C
3-PA,210,1131,1,2,0,1134,A
3-PA,211,1,0,0,1163,1164,C
3-PA,212,0,1148,0,2,1150,T
3-PA,213,0,2,1292,0,1294,G
3-PA,214,0,1296,0,1,1297,T
3-PA,215,0,1295,0,2,1297,T
3-PA,216,1295,1,0,0,1296,A
3-PA,217,1299,0,0,1,1300,A
3-PA,218,1298,0,1,0,1299,A
3-PA,219,2,0,1302,1,1305,G
3-PA,220,1,1,0,1287,1289,C
3-PA,221,1271,0,2,1,1274,A
3-PA,222,0,0,0,1272,1272,C
3-PA,223,1185,0,2,0,1187,A
3-PA,224,0,5,1225,0,1230,G
3-PA,225,1231,0,0,0,1231,A
3-PA,226,0,1228,0,0,1228,T
3-PA,227,0,1226,0,0,1226,T
3-PA,228,0,1222,0,2,1224,T
3-PA,229,0,4,1225,1,1230,G
3-PA,230,1235,0,2,0,1237,A
3-PA,231,1238,0,2,0,1240,A
3-PA,232,1241,0,0,0,1241,A
3-PA,233,0,1220,0,0,1220,T
3-PA,234,1215,0,0,0,1215,A
3-PA,235,1229,0,0,0,1229,A
3-PA,236,0,1229,1,0,1230,T
3-PA,237,5,0,0,1223,1228,C
3-PA,238,2,6,1224,0,1232,G
3-PA,239,1220,0,0,0,1220,A
3-PA,240,0,10,1212,0,1222,G
3-PA,241,0,10,1232,0,1242,G
3-PA,242,0,7,1236,0,1243,G
3-PA,243,0,11,1230,0,1241,G
3-PA,244,1227,0,0,0,1227,A
3-PA,245,0,3,1227,0,1230,G
3-PA,246,1249,0,2,0,1251,A
3-PA,247,1,8,1253,0,1262,G
3-PA,248,1259,0,2,0,1261,A
3-PA,249,0,1,0,1260,1261,C
3-PA,250,1242,0,1,1,1244,A
3-PA,251,0,10,1259,0,1269,G
3-PA,252,1263,1,3,0,1267,A
3-PA,253,1290,0,0,0,1290,A
3-PA,254,0,2,0,1285,1287,C
3-PA,255,1245,0,3,0,1248,A
3-PA,256,1244,0,0,0,1244,A
3-PA,257,0,1243,0,0,1243,T
3-PA,258,1,9,1269,0,1279,G
3-PA,259,0,3,1272,0,1275,G
3-PA,260,1,0,0,1265,1266,C
3-PA,261,5,0,0,1266,1271,C
3-PA,262,0,1263,0,1,1264,T
3-PA,263,1,7,1292,0,1300,G
3-PA,264,1,8,1292,0,1301,G
3-PA,265,1299,0,1,0,1300,A
3-PA,266,0,2,1,1299,1302,C
3-PA,267,1248,0,0,0,1248,A
3-PA,268,0,1,1385,0,1386,G
3-PA,269,0,1376,0,0,1376,T
3-PA,270,1397,0,0,1,1398,A
3-PA,271,0,0,1399,0,1399,G
3-PA,272,0,1353,0,1,1354,T
3-PA,273,1363,0,0,0,1363,A
3-PA,274,1366,0,0,0,1366,A
3-PA,275,1361,0,2,0,1363,A
3-PA,276,1,0,0,1374,1375,C
3-PA,277,1284,0,1,0,1285,A
3-PA,278,0,2,1310,0,1312,G
3-PA,279,0,1287,0,1,1288,T
3-PA,280,1313,0,1,0,1314,A
3-PA,281,0,1307,0,2,1309,T
3-PA,282,5,1,0,1329,1335,C
3-PA,283,0,1334,0,2,1336,T
3-PA,284,0,0,1328,0,1328,G
3-PA,285,0,1,0,1327,1328,C
3-PA,286,1309,2,0,0,1311,A
3-PA,287,1309,0,3,0,1312,A
3-PA,288,0,2,0,1321,1323,C
3-PA,289,1320,0,0,0,1320,A
3-PA,290,0,0,0,1369,1369,C
3-PA,291,1,1336,0,2,1339,T
3-PA,292,1344,1,0,0,1345,A
3-PA,293,0,0,0,1345,1345,C
3-PA,294,0,1336,0,1,1337,T
3-PA,295,0,5,1330,0,1335,G
3-PA,296,1,5,1328,0,1334,G
3-PA,297,1333,0,1,0,1334,A
3-PA,298,0,0,1334,0,1334,G
3-PA,299,0,1,0,1295,1296,C
3-PA,300,0,1290,0,3,1293,T
3-PA,301,0,3,1288,0,1291,G
3-PA,302,0,4,1289,0,1293,G
3-PA,303,1290,0,1,0,1291,A
3-PA,304,1295,0,0,0,1295,A
3-PA,305,1291,0,0,0,1291,A
3-PA,306,1293,0,0,0,1293,A
3-PA,307,2,0,0,1296,1298,C
3-PA,308,7,1,2,1285,1295,C
3-PA,309,2,1,1292,0,1295,G
3-PA,310,1293,0,0,0,1293,A
3-PA,311,1298,0,0,0,1298,A
3-PA,312,0,0,1316,0,1316,G
3-PA,313,0,1308,1,1,1310,T
3-PA,314,0,1308,0,2,1310,T
3-PA,315,0,1313,0,1,1314,T
3-PA,316,6,0,0,1325,1331,C
3-PA,317,0,1339,0,1,1340,T
3-PA,318,1341,1,0,0,1342,A
3-PA,319,0,0,0,1341,1341,C
3-PA,320,4,0,1,1334,1339,C
3-PA,321,1324,0,0,0,1324,A
3-PA,322,0,10,1311,0,1321,G
3-PA,323,1318,1,0,0,1319,A
3-PA,324,1,0,0,1301,1302,C
3-PA,325,1,1344,0,1,1346,T
3-PA,326,0,1347,0,1,1348,T
3-PA,327,1,2,1367,0,1370,G
3-PA,328,0,1366,0,0,1366,T
3-PA,329,1370,0,1,0,1371,A
3-PA,330,0,1379,0,0,1379,T
3-PA,331,0,11,1349,0,1360,G
3-PA,332,1408,0,0,0,1408,A
3-PA,333,0,1394,0,2,1396,T
3-PA,334,9,1384,0,1,1394,T
3-PA,335,1391,0,0,0,1391,A
3-PA,336,0,1,0,1378,1379,C
3-PA,337,1382,0,0,0,1382,A
3-PA,338,1382,0,1,0,1383,A
3-PA,339,0,5,1379,0,1384,G
3-PA,340,1,8,1392,0,1401,G
3-PA,341,1336,1,2,0,1339,A
3-PA,342,0,5,1343,0,1348,G
3-PA,343,1344,0,0,0,1344,A
3-PA,344,1345,0,0,0,1345,A
3-PA,345,1,1,0,1344,1346,C
3-PA,346,1328,0,1,0,1329,A
3-PA,347,0,7,1323,0,1330,G
3-PA,348,1322,1,0,0,1323,A
3-PA,349,0,1298,0,1,1299,T
3-PA,350,1,1297,1,0,1299,T
3-PA,351,13,0,0,1276,1289,C
3-PA,352,3,0,1284,0,1287,G
3-PA,353,1,1293,0,1,1295,T
3-PA,354,5,2,1,1284,1292,C
3-PA,355,1,8,1290,0,1299,G
3-PA,356,1306,0,0,0,1306,A
3-PA,357,1304,0,2,0,1306,A
3-PA,358,1310,0,0,0,1310,A
3-PA,359,0,1309,0,0,1309,T
3-PA,360,0,1308,0,0,1308,T
3-PA,361,0,8,1303,0,1311,G
3-PA,362,1,10,1300,0,1311,G
3-PA,363,0,5,1309,0,1314,G
3-PA,364,0,1,1318,0,1319,G
3-PA,365,0,1300,0,1,1301,T
3-PA,366,0,13,1300,0,1313,G
3-PA,367,1312,0,2,0,1314,A
3-PA,368,1,2,0,1322,1325,C
3-PA,369,1326,1,1,0,1328,A
3-PA,370,1327,0,1,0,1328,A
3-PA,371,0,6,1336,0,1342,G
3-PA,372,2,6,1340,0,1348,G
3-PA,373,1335,0,0,0,1335,A
3-PA,374,1,9,1327,0,1337,G
3-PA,375,1314,0,3,0,1317,A
3-PA,376,0,4,1320,0,1324,G
3-PA,377,1303,1,3,0,1307,A
3-PA,378,1293,0,2,0,1295,A
3-PA,379,1,1,1344,0,1346,G
3-PA,380,0,1321,0,1,1322,T
3-PA,381,10,0,1,1323,1334,C
3-PA,382,9,0,0,1329,1338,C
3-PA,383,1342,0,1,0,1343,A
3-PA,384,0,0,0,1374,1374,C
3-PA,385,1402,1,1,0,1404,A
3-PA,386,0,1431,0,1,1432,T
3-PA,387,1444,0,0,0,1444,A
3-PA,388,0,1370,0,2,1372,T
3-PA,389,1355,0,1,0,1356,A
3-PA,390,2,1338,0,0,1340,T
3-PA,391,0,1331,0,1,1332,T
3-PA,392,1364,0,0,0,1364,A
3-PA,393,1,1,0,1355,1357,C
3-PA,394,3,0,0,1300,1303,C
3-PA,395,1,1271,1,0,1273,T
3-PA,396,0,1244,1,1,1246,T
3-PA,397,0,10,1245,1,1256,G
3-PA,398,1259,0,0,0,1259,A
3-PA,399,1258,0,0,0,1258,A
3-PA,400,1260,0,0,0,1260,A
3-PA,401,1220,0,2,0,1222,A
3-PA,402,0,3,1232,0,1235,G
3-PA,403,1,0,1231,0,1232,G
3-PA,404,1,0,0,1231,1232,C
3-PA,405,7,0,0,1232,1239,C
3-PA,406,1237,0,0,0,1237,A
3-PA,407,1237,0,1,1,1239,A
3-PA,408,0,1235,0,1,1236,T
3-PA,409,1239,0,1,0,1240,A
3-PA,410,1239,0,0,0,1239,A
3-PA,411,1,8,1254,0,1263,G
3-PA,412,1250,0,1,0,1251,A
3-PA,413,1,1248,0,0,1249,T
3-PA,414,0,1247,0,1,1248,T
3-PA,415,1248,1,1,0,1250,A
3-PA,416,1247,0,1,0,1248,A
3-PA,417,1248,0,0,0,1248,A
3-PA,418,0,1258,0,0,1258,T
3-PA,419,3,0,0,1258,1261,C
3-PA,420,0,1213,0,0,1213,T
3-PA,421,0,6,1214,0,1220,G
3-PA,422,1220,0,1,0,1221,A
3-PA,423,1,7,1234,0,1242,G
3-PA,424,1236,0,1,0,1237,A
3-PA,425,1233,0,1,0,1234,A
3-PA,426,0,2,0,1232,1234,C
3-PA,427,1223,0,0,0,1223,A
3-PA,428,1,2,0,1234,1237,C
3-PA,429,1235,0,0,0,1235,A
3-PA,430,0,1,0,1248,1249,C
3-PA,431,1227,0,6,0,1233,A
3-PA,432,0,1,0,1255,1256,C
3-PA,433,1245,0,2,0,1247,A
3-PA,434,0,1243,0,0,1243,T
3-PA,435,0,1231,0,0,1231,T
3-PA,436,15,2,0,1226,1243,C
3-PA,437,1238,1,2,0,1241,A
3-PA,438,0,0,0,1251,1251,C
3-PA,439,1234,0,0,0,1234,A
3-PA,440,0,1240,0,0,1240,T
3-PA,441,1,1201,0,0,1202,T
3-PA,442,0,1217,0,0,1217,T
3-PA,443,0,1217,0,2,1219,T
3-PA,444,8,1,0,1218,1227,C
3-PA,445,2,1211,0,1,1214,T
3-PA,446,6,0,0,1223,1229,C
3-PA,447,1221,1,1,0,1223,A
3-PA,448,0,1222,0,0,1222,T
3-PA,449,0,1235,0,0,1235,T
3-PA,450,9,1,0,1229,1239,C
3-PA,451,1224,0,0,0,1224,A
3-PA,452,1,0,0,1236,1237,C
3-PA,453,0,1228,0,0,1228,T
3-PA,454,0,6,1235,0,1241,G
3-PA,455,1,8,1230,0,1239,G
3-PA,456,2,5,1236,0,1243,G
3-PA,457,0,5,1239,0,1244,G
3-PA,458,1230,0,1,0,1231,A
3-PA,459,1,4,1234,0,1239,G
3-PA,460,2,7,1231,0,1240,G
3-PA,461,1231,0,0,0,1231,A
3-PA,462,1232,0,1,0,1233,A
3-PA,463,1210,1,1,0,1212,A
3-PA,464,0,1194,0,1,1195,T
3-PA,465,3,6,1171,0,1180,G
3-PA,466,0,1,1188,0,1189,G
3-PA,467,1,0,0,1185,1186,C
3-PA,468,4,2,0,1180,1186,C
3-PA,469,1179,2,0,0,1181,A
3-PA,470,0,0,0,1185,1185,C
3-PA,471,1186,0,0,0,1186,A
3-PA,472,1191,1,0,0,1192,A
3-PA,473,1192,0,1,0,1193,A
3-PA,474,1,4,1196,0,1201,G
3-PA,475,0,0,1204,0,1204,G
3-PA,476,2,0,0,1197,1199,C
3-PA,477,1206,0,1,0,1207,A
3-PA,478,0,8,1212,0,1220,G
3-PA,479,1216,0,0,0,1216,A
3-PA,480,0,0,0,1230,1230,C
3-PA,481,0,1219,1,4,1224,T
3-PA,482,1227,0,1,1,1229,A
3-PA,483,1,0,0,1224,1225,C
3-PA,484,1216,0,1,0,1217,A
3-PA,485,1,0,0,1221,1222,C
3-PA,486,0,1193,0,1,1194,T
3-PA,487,13,0,0,1197,1210,C
3-PA,488,0,1201,1,0,1202,T
3-PA,489,6,0,0,1173,1179,C
3-PA,490,0,9,1170,0,1179,G
3-PA,491,1177,0,3,0,1180,A
3-PA,492,0,2,0,1176,1178,C
3-PA,493,0,5,1176,0,1181,G
3-PA,494,1160,0,1,0,1161,A
3-PA,495,0,3,1167,0,1170,G
3-PA,496,2,3,1165,1,1171,G
3-PA,497,1167,0,1,0,1168,A
3-PA,498,1174,2,1,0,1177,A
3-PA,499,1177,0,0,0,1177,A
3-PA,500,0,0,1183,0,1183,G
3-PA,501,2,1,0,1177,1180,C
3-PA,502,1167,0,0,0,1167,A
3-PA,503,0,5,1182,0,1187,G
3-PA,504,0,2,1183,0,1185,G
3-PA,505,1,0,1192,0,1193,G
3-PA,506,0,0,0,1191,1191,C
3-PA,507,0,1179,0,1,1180,T
3-PA,508,1178,0,0,0,1178,A
3-PA,509,0,3,1200,0,1203,G
3-PA,510,0,7,1249,0,1256,G
3-PA,511,1266,0,0,0,1266,A
3-PA,512,0,1224,0,0,1224,T
3-PA,513,0,1209,0,0,1209,T
3-PA,514,1203,1,0,0,1204,A
3-PA,515,1219,0,2,0,1221,A
3-PA,516,0,13,1217,0,1230,G
3-PA,517,1229,0,2,0,1231,A
3-PA,518,0,0,0,1229,1229,C
3-PA,519,11,0,0,1141,1152,C
3-PA,520,1136,0,0,0,1136,A
3-PA,521,0,3,1147,0,1150,G
3-PA,522,1,1,1149,0,1151,G
3-PA,523,0,0,0,1155,1155,C
3-PA,524,0,1139,0,1,1140,T
3-PA,525,0,1,1177,0,1178,G
3-PA,526,1,1171,0,0,1172,T
3-PA,527,0,1167,0,0,1167,T
3-PA,528,0,1172,0,0,1172,T
3-PA,529,1171,0,2,0,1173,A
3-PA,530,1,0,0,1194,1195,C
3-PA,531,8,0,0,1163,1171,C
3-PA,532,1160,0,0,0,1160,A
3-PA,533,0,1158,0,1,1159,T
3-PA,534,1105,0,1,0,1106,A
3-PA,535,1113,1,0,0,1114,A
3-PA,536,0,7,1121,0,1128,G
3-PA,537,1124,0,2,1,1127,A
3-PA,538,0,0,0,1127,1127,C
3-PA,539,1085,0,1,0,1086,A
3-PA,540,1086,1,0,0,1087,A
3-PA,541,0,8,1092,0,1100,G
3-PA,542,1098,0,1,0,1099,A
3-PA,543,1092,0,1,0,1093,A
3-PA,544,1093,0,0,0,1093,A
3-PA,545,1,1067,0,0,1068,T
3-PA,546,0,5,1079,0,1084,G
3-PA,547,0,0,1081,0,1081,G
3-PA,548,0,1,0,1080,1081,C
3-PA,549,3,1,1,1082,1087,C
3-PA,550,1076,0,0,0,1076,A
3-PA,551,1090,1,1,0,1092,A
3-PA,552,0,2,1,1091,1094,C
3-PA,553,1091,0,0,0,1091,A
3-PA,554,0,5,1089,0,1094,G
3-PA,555,1074,0,3,0,1077,A
3-PA,556,0,4,1081,1,1086,G
3-PA,557,0,0,1090,0,1090,G
3-PA,558,2,0,0,1092,1094,C
3-PA,559,6,0,0,1106,1112,C
3-PA,560,0,1076,0,1,1077,T
3-PA,561,3,0,0,1087,1090,C
3-PA,562,0,1089,0,0,1089,T
3-PA,563,0,4,1086,1,1091,G
3-PA,564,0,3,1086,0,1089,G
3-PA,565,1,6,1075,0,1082,G
3-PA,566,1077,1,1,0,1079,A
3-PA,567,0,1051,0,1,1052,T
3-PA,568,0,1034,1,2,1037,T
3-PA,569,7,0,0,1165,1172,C
3-PA,570,3,1,0,1158,1162,C
3-PA,571,0,1103,0,4,1107,T
3-PA,572,0,1100,0,0,1100,T
3-PA,573,0,1107,0,2,1109,T
3-PA,574,4,0,0,1111,1115,C
3-PA,575,0,0,1115,0,1115,G
3-PA,576,1,1109,0,2,1112,T
3-PA,577,5,0,0,1107,1112,C
3-PA,578,1085,0,0,0,1085,A
3-PA,579,1,2,1275,0,1278,G
3-PA,580,0,1275,0,0,1275,T
3-PA,581,5,0,0,1270,1275,C
3-PA,582,8,4,0,1276,1288,C
3-PA,583,3,12,1284,1,1300,G
3-PA,584,1296,1,1,0,1298,A
3-PA,585,1298,0,1,0,1299,A
3-PA,586,1297,1,1,0,1299,A
3-PA,587,1,6,1308,0,1315,G
3-PA,588,1279,1,1,0,1281,A
3-PA,589,0,5,1293,0,1298,G
3-PA,590,0,0,1306,0,1306,G
3-PA,591,3,1,0,1301,1305,C
3-PA,592,0,6,1305,0,1311,G
3-PA,593,1310,1,1,0,1312,A
3-PA,594,1313,0,2,0,1315,A
3-PA,595,0,8,1326,0,1334,G
3-PA,596,1337,0,1,0,1338,A
3-PA,597,1333,0,3,0,1336,A
3-PA,598,1326,0,2,0,1328,A
3-PA,599,0,0,1,1346,1347,C
3-PA,600,1342,0,0,0,1342,A
3-PA,601,1344,0,0,1,1345,A
3-PA,602,0,1342,0,0,1342,T
3-PA,603,1,1339,0,1,1341,T
3-PA,604,1,5,1338,0,1344,G
3-PA,605,1336,0,0,0,1336,A
3-PA,606,1335,0,0,0,1335,A
3-PA,607,0,6,1330,0,1336,G
3-PA,608,1334,0,1,0,1335,A
3-PA,609,1332,0,0,0,1332,A
3-PA,610,1338,0,0,0,1338,A
3-PA,611,1340,0,0,0,1340,A
3-PA,612,1349,0,0,0,1349,A
3-PA,613,0,1351,0,0,1351,T
3-PA,614,0,1352,1,1,1354,T
3-PA,615,0,1353,0,2,1355,T
3-PA,616,1,9,1348,0,1358,G
3-PA,617,1352,0,2,0,1354,A
3-PA,618,1359,0,0,0,1359,A
3-PA,619,1362,0,0,0,1362,A
3-PA,620,0,1393,0,0,1393,T
3-PA,621,13,1,0,1507,1521,C
3-PA,622,1514,1,1,0,1516,A
3-PA,623,0,1,0,1547,1548,C
3-PA,624,1536,0,5,0,1541,A
3-PA,625,1,8,1573,0,1582,G
3-PA,626,0,14,1628,1,1643,G
3-PA,627,1678,0,1,0,1679,A
3-PA,628,1690,0,2,0,1692,A
3-PA,629,0,0,1,1720,1721,C
3-PA,630,0,1669,0,1,1670,T
3-PA,631,1802,1,1,0,1804,A
3-PA,632,0,1807,0,2,1809,T
3-PA,633,1,2,1881,0,1884,G
3-PA,634,2,1,0,1868,1871,C
3-PA,635,0,1,1849,0,1850,G
3-PA,636,0,1836,0,4,1840,T
3-PA,637,1819,0,1,0,1820,A
3-PA,638,0,10,1828,0,1838,G
3-PA,639,0,0,1834,0,1834,G
3-PA,640,2,0,0,1805,1807,C
3-PA,641,0,1787,0,0,1787,T
3-PA,642,1,1764,0,1,1766,T
3-PA,643,0,1,1763,0,1764,G
3-PA,644,1,3,0,1762,1766,C
3-PA,645,5,3,0,1765,1773,C
3-PA,646,1,18,1773,0,1792,G
3-PA,647,1805,0,1,0,1806,A
3-PA,648,0,0,0,1820,1820,C
3-PA,649,13,1,0,1805,1819,C
3-PA,650,1823,0,1,0,1824,A
3-PA,651,1830,0,1,1,1832,A
3-PA,652,1832,1,0,1,1834,A
3-PA,653,0,4,1877,0,1881,G
3-PA,654,0,1875,0,1,1876,T
3-PA,655,8,0,0,1863,1871,C
3-PA,656,1,1868,0,0,1869,T
3-PA,657,5,1,0,1869,1875,C
3-PA,658,6,1,0,1881,1888,C
3-PA,659,5,0,0,1895,1900,C
3-PA,660,1891,1,1,0,1893,A
3-PA,661,3,0,0,1900,1903,C
3-PA,662,9,2,0,1884,1895,C
3-PA,663,4,22,1884,0,1910,G
3-PA,664,1928,1,4,0,1933,A
3-PA,665,1933,1,0,0,1934,A
3-PA,666,0,0,0,1949,1949,C
3-PA,667,0,1922,0,2,1924,T
3-PA,668,0,1958,1,2,1961,T
3-PA,669,3,0,0,1983,1986,C
3-PA,670,1,1973,0,2,1976,T
3-PA,671,14,1,0,1965,1980,C
3-PA,672,9,2,0,1965,1976,C
3-PA,673,1,1972,0,3,1976,T
3-PA,674,0,1,2000,1,2002,G
3-PA,675,0,1,0,2000,2001,C
3-PA,676,9,0,1,1992,2002,C
3-PA,677,0,1990,0,1,1991,T
3-PA,678,0,1977,0,3,1980,T
3-PA,679,0,14,1973,0,1987,G
3-PA,680,1993,0,1,0,1994,A
3-PA,681,1,10,2012,0,2023,G
3-PA,682,2017,0,1,0,2018,A
3-PA,683,2037,0,0,0,2037,A
3-PA,684,1,2083,0,2,2086,T
3-PA,685,0,2088,0,0,2088,T
3-PA,686,0,2094,0,0,2094,T
3-PA,687,0,2098,1,0,2099,T
3-PA,688,2095,0,0,0,2095,A
3-PA,689,1,9,2088,0,2098,G
3-PA,690,2084,0,5,0,2089,A
3-PA,691,1,1,2162,0,2164,G
3-PA,692,2,1,0,2154,2157,C
3-PA,693,7,1,0,2168,2176,C
3-PA,694,2,2198,0,3,2203,T
3-PA,695,2261,1,1,0,2263,A
3-PA,696,0,2270,0,0,2270,T
3-PA,697,3,3,2282,0,2288,G
3-PA,698,0,2279,0,1,2280,T
3-PA,699,2,17,2284,2,2305,G
3-PA,700,0,3,2266,0,2269,G
3-PA,701,2261,0,3,0,2264,A
3-PA,702,0,2250,0,1,2251,T
3-PA,703,0,13,2195,0,2208,G
3-PA,704,0,13,2230,0,2243,G
3-PA,705,2255,0,0,0,2255,A
3-PA,706,0,2239,0,1,2240,T
3-PA,707,0,2238,0,0,2238,T
3-PA,708,10,4,0,2217,2231,C
3-PA,709,3,14,2219,1,2237,G
3-PA,710,2232,1,3,0,2236,A
3-PA,711,2235,0,2,0,2237,A
3-PA,712,0,3,0,2254,2257,C
3-PA,713,16,1,0,2189,2206,C
3-PA,714,3,24,2183,0,2210,G
3-PA,715,2211,0,2,0,2213,A
3-PA,716,2207,0,2,0,2209,A
3-PA,717,0,4,1,2232,2237,C
3-PA,718,0,6,2218,0,2224,G
3-PA,719,1,2,2275,0,2278,G
3-PA,720,5,0,0,2280,2285,C
3-PA,721,0,2268,0,5,2273,T
3-PA,722,0,2,2341,1,2344,G
3-PA,723,0,1,2,2345,2348,C
3-PA,724,2360,1,0,0,2361,A
3-PA,725,0,2362,0,3,2365,T
3-PA,726,0,2334,0,0,2334,T
3-PA,727,0,10,2329,0,2339,G
3-PA,728,2264,0,2,0,2266,A
3-PA,729,0,12,2284,1,2297,G
3-PA,730,0,20,2270,1,2291,G
3-PA,731,3,1,2255,0,2259,G
3-PA,732,1,2,0,2253,2256,C
3-PA,733,2243,0,0,0,2243,A
3-PA,734,2252,0,4,0,2256,A
3-PA,735,0,0,2262,0,2262,G
3-PA,736,0,0,0,2277,2277,C
3-PA,737,1,2263,0,3,2267,T
3-PA,738,0,2257,0,0,2257,T
3-PA,739,0,2273,1,3,2277,T
3-PA,740,4,0,0,2279,2283,C
3-PA,741,0,2277,0,3,2280,T
3-PA,742,19,0,2,2266,2287,C
3-PA,743,2277,0,0,0,2277,A
3-PA,744,2262,0,1,0,2263,A
3-PA,745,2258,0,0,1,2259,A
3-PA,746,0,2258,0,1,2259,T
3-PA,747,2,0,2339,0,2341,G
3-PA,748,0,2323,0,6,2329,T
3-PA,749,12,2,0,2343,2357,C
3-PA,750,11,1,1,2347,2360,C
3-PA,751,2360,0,2,0,2362,A
3-PA,752,2361,1,2,0,2364,A
3-PA,753,2359,0,4,1,2364,A
3-PA,754,0,7,2399,0,2406,G
3-PA,755,2393,0,4,0,2397,A
3-PA,756,2332,0,2,2,2336,A
3-PA,757,0,1,2346,0,2347,G
3-PA,758,0,2319,1,1,2321,T
3-PA,759,2,26,2289,0,2317,G
3-PA,760,2310,0,4,0,2314,A
3-PA,761,2310,0,2,1,2313,A
3-PA,762,0,2313,0,2,2315,T
3-PA,763,1,0,2320,0,2321,G
3-PA,764,1,2,0,2320,2323,C
3-PA,765,18,0,1,2295,2314,C
3-PA,766,10,0,0,2305,2315,C
3-PA,767,2331,0,1,2,2334,A
3-PA,768,2358,0,0,1,2359,A
3-PA,769,2366,0,0,0,2366,A
3-PA,770,0,2366,0,0,2366,T
3-PA,771,0,2358,0,0,2358,T
3-PA,772,0,31,2327,0,2358,G
3-PA,773,2346,2,1,0,2349,A
3-PA,774,2363,1,6,0,2370,A
3-PA,775,2,1,0,2376,2379,C
3-PA,776,9,2,0,2363,2374,C
3-PA,777,0,2346,0,2,2348,T
3-PA,778,0,2396,0,2,2398,T
3-PA,779,0,2407,0,1,2408,T
3-PA,780,0,2434,0,0,2434,T
3-PA,781,4,0,0,2434,2438,C
3-PA,782,2,2430,1,2,2435,T
3-PA,783,0,6,2435,0,2441,G
3-PA,784,2430,0,2,0,2432,A
3-PA,785,2448,0,3,0,2451,A
3-PA,786,0,12,2456,1,2469,G
3-PA,787,2434,0,2,0,2436,A
3-PA,788,0,1,0,2447,2448,C
3-PA,789,2419,0,4,0,2423,A
3-PA,790,2450,0,1,0,2451,A
3-PA,791,2,3,0,2674,2679,C
3-PA,792,2683,0,1,1,2685,A
3-PA,793,2,1,1,2688,2692,C
3-PA,794,12,2,0,2650,2664,C
3-PA,795,2650,0,3,0,2653,A
3-PA,796,2647,2,5,2,2656,A
3-PA,797,1,29,2632,0,2662,G
3-PA,798,2654,0,4,0,2658,A
3-PA,799,2,0,1,2650,2653,C
3-PA,800,15,1,0,2436,2452,C
3-PA,801,2445,0,2,0,2447,A
3-PA,802,2455,0,2,1,2458,A
3-PA,803,0,2461,0,2,2463,T
3-PA,804,11,0,0,2452,2463,C
3-PA,805,2451,0,3,0,2454,A
3-PA,806,2449,1,0,0,2450,A
3-PA,807,2452,0,0,0,2452,A
3-PA,808,1,1,1,2483,2486,C
3-PA,809,0,2454,0,0,2454,T
3-PA,810,0,2482,0,0,2482,T
3-PA,811,4,0,1,2484,2489,C
3-PA,812,13,3,0,2479,2495,C
3-PA,813,2,18,2485,0,2505,G
3-PA,814,2506,0,0,0,2506,A
3-PA,815,2507,0,3,0,2510,A
3-PA,816,1,2521,0,0,2522,T
3-PA,817,2,17,2486,0,2505,G
3-PA,818,2,25,2498,0,2525,G
3-PA,819,2523,1,7,0,2531,A
3-PA,820,5,14,0,2520,2539,C
3-PA,821,14,1,0,2519,2534,C
3-PA,822,1,2600,1,3,2605,T
3-PA,823,8,1,0,2646,2655,C
3-PA,824,10,0,0,2654,2664,C
3-PA,825,0,2658,1,1,2660,T
3-PA,826,2,2662,1,0,2665,T
3-PA,827,0,1,2770,0,2771,G
3-PA,828,1,2744,0,2,2747,T
3-PA,829,0,2730,0,3,2733,T
3-PA,830,2728,1,0,0,2729,A
3-PA,831,0,2642,0,1,2643,T
3-PA,832,15,2,0,2613,2630,C
3-PA,833,2583,0,0,1,2584,A
3-PA,834,0,3,2580,0,2583,G
3-PA,835,2,2,0,2579,2583,C
3-PA,836,2,18,2485,0,2505,G
3-PA,837,2,2,2582,0,2586,G
3-PA,838,0,2583,0,3,2586,T
3-PA,839,19,0,2,2570,2591,C
3-PA,840,22,0,0,2573,2595,C
3-PA,841,2602,1,1,0,2604,A
3-PA,842,2615,0,1,0,2616,A
3-PA,843,2613,1,3,0,2617,A
3-PA,844,0,2618,0,3,2621,T
3-PA,845,1,2608,0,0,2609,T
3-PA,846,19,1,2,2580,2602,C
3-PA,847,7,1,0,2568,2576,C
3-PA,848,1,2565,0,1,2567,T
3-PA,849,19,0,1,2572,2592,C
3-PA,850,8,1,0,2583,2592,C
3-PA,851,2,2570,0,1,2573,T
3-PA,852,0,7,2590,0,2597,G
3-PA,853,2587,1,3,1,2592,A
3-PA,854,1,2590,0,2,2593,T
3-PA,855,2,12,2545,1,2560,G
3-PA,856,0,6,2525,0,2531,G
3-PA,857,2524,2,3,0,2529,A
3-PA,858,0,2494,0,0,2494,T
3-PA,859,0,0,2499,0,2499,G
3-PA,860,4,0,0,2606,2610,C
3-PA,861,0,2584,0,5,2589,T
3-PA,862,0,2596,0,2,2598,T
3-PA,863,0,2599,0,1,2600,T
3-PA,864,2602,0,0,1,2603,A
3-PA,865,2611,0,3,0,2614,A
3-PA,866,2615,0,0,0,2615,A
3-PA,867,2624,1,1,0,2626,A
3-PA,868,0,2622,0,0,2622,T
3-PA,869,1,2397,1,3,2402,T
3-PA,870,1,21,2387,0,2409,G
3-PA,871,2392,0,5,0,2397,A
3-PA,872,0,1,2425,0,2426,G
3-PA,873,0,0,0,2425,2425,C
3-PA,874,2412,0,0,0,2412,A
3-PA,875,0,2456,0,2,2458,T
3-PA,876,0,2445,1,1,2447,T
3-PA,877,1,3,2441,2,2447,G
3-PA,878,2448,2,2,1,2453,A
3-PA,879,2431,0,5,0,2436,A
3-PA,880,1,21,2420,0,2442,G
3-PA,881,2410,1,3,0,2414,A
3-PA,882,3,0,0,2422,2425,C
3-PA,883,9,2,0,2404,2415,C
3-PA,884,11,0,0,2352,2363,C
3-PA,885,2354,0,4,0,2358,A
3-PA,886,2367,0,3,0,2370,A
3-PA,887,1,0,2374,0,2375,G
3-PA,888,0,2382,1,0,2383,T
3-PA,889,22,0,0,2359,2381,C
3-PA,890,2381,2,2,0,2385,A
3-PA,891,1,5,0,2373,2379,C
3-PA,892,1,3,2371,1,2376,G
3-PA,893,2415,1,2,0,2418,A
3-PA,894,2406,1,5,1,2413,A
3-PA,895,1,2,2489,0,2492,G
3-PA,896,1,14,2460,0,2475,G
3-PA,897,2461,0,3,0,2464,A
3-PA,898,0,8,2476,0,2484,G
3-PA,899,2476,1,8,0,2485,A
3-PA,900,2473,0,7,0,2480,A
3-PA,901,0,9,2479,0,2488,G
3-PA,902,1,8,2453,0,2462,G
3-PA,903,1,12,2453,0,2466,G
3-PA,904,2404,0,1,0,2405,A
3-PA,905,1,2407,0,1,2409,T
3-PA,906,16,1,0,2399,2416,C
3-PA,907,12,0,0,2596,2608,C
3-PA,908,13,1,0,2629,2643,C
3-PA,909,2657,0,1,0,2658,A
3-PA,910,1,2666,0,0,2667,T
3-PA,911,0,2681,0,0,2681,T
3-PA,912,2725,0,1,0,2726,A
3-PA,913,0,2720,0,2,2722,T
3-PA,914,2717,0,1,1,2719,A
3-PA,915,1,2700,0,2,2703,T
3-PA,916,1,14,2412,0,2427,G
3-PA,917,2414,0,3,0,2417,A
3-PA,918,0,2387,1,3,2391,T
3-PA,919,0,4,2399,0,2403,G
3-PA,920,0,2,0,2378,2380,C
3-PA,921,2,22,2356,0,2380,G
3-PA,922,2391,0,3,0,2394,A
3-PA,923,0,2393,0,1,2394,T
3-PA,924,18,0,0,2383,2401,C
3-PA,925,2394,0,1,0,2395,A
3-PA,926,2366,3,3,0,2372,A
3-PA,927,1,0,2382,0,2383,G
3-PA,928,1,2366,1,2,2370,T
3-PA,929,0,3,2391,0,2394,G
3-PA,930,2,0,0,2388,2390,C
3-PA,931,2378,1,2,0,2381,A
3-PA,932,0,2390,1,1,2392,T
3-PA,933,2386,0,1,1,2388,A
3-PA,934,2417,0,0,0,2417,A
3-PA,935,2414,0,0,0,2414,A
3-PA,936,2403,0,0,1,2404,A
3-PA,937,2405,0,2,0,2407,A
3-PA,938,3,0,0,2404,2407,C
3-PA,939,2386,0,2,1,2389,A
3-PA,940,0,2401,1,1,2403,T
3-PA,941,0,2404,0,0,2404,T
3-PA,942,12,0,0,2399,2411,C
3-PA,943,0,2341,0,1,2342,T
3-PA,944,0,2337,0,1,2338,T
3-PA,945,0,2333,0,2,2335,T
3-PA,946,0,10,2329,1,2340,G
3-PA,947,0,5,2339,0,2344,G
3-PA,948,2336,0,2,0,2338,A
3-PA,949,0,2330,0,2,2332,T
3-PA,950,0,9,2336,0,2345,G
3-PA,951,0,12,2376,0,2388,G
3-PA,952,2397,0,4,0,2401,A
3-PA,953,2398,0,2,0,2400,A
3-PA,954,2401,1,3,0,2405,A
3-PA,955,0,13,2412,0,2425,G
3-PA,956,2414,0,3,0,2417,A
3-PA,957,2639,0,1,0,2640,A
3-PA,958,1,1,0,2681,2683,C
3-PA,959,15,0,0,2680,2695,C
3-PA,960,0,2674,0,3,2677,T
3-PA,961,1,2730,0,1,2732,T
3-PA,962,2738,0,2,0,2740,A
3-PA,963,0,2739,0,1,2740,T
3-PA,964,2711,0,3,1,2715,A
3-PA,965,0,2735,0,4,2739,T
3-PA,966,2474,0,2,0,2476,A
3-PA,967,0,1,2494,0,2495,G
3-PA,968,0,2474,0,1,2475,T
3-PA,969,16,0,0,2456,2472,C
3-PA,970,2442,0,1,0,2443,A
3-PA,971,2448,0,1,0,2449,A
3-PA,972,2450,0,3,0,2453,A
3-PA,973,3,0,0,2469,2472,C
3-PA,974,8,0,0,2441,2449,C
3-PA,975,2417,0,1,0,2418,A
3-PA,976,2,0,0,2439,2441,C
3-PA,977,2444,0,3,0,2447,A
3-PA,978,0,3,0,2459,2462,C
3-PA,979,2,16,2444,1,2463,G
3-PA,980,2465,1,2,0,2468,A
3-PA,981,2466,0,1,0,2467,A
3-PA,982,2458,1,3,0,2462,A
3-PA,983,2458,0,3,0,2461,A
3-PA,984,2,11,2462,1,2476,G
3-PA,985,0,11,2451,0,2462,G
3-PA,986,1,12,2472,0,2485,G
3-PA,987,2477,0,4,0,2481,A
3-PA,988,2480,1,0,1,2482,A
3-PA,989,1,2478,0,1,2480,T
3-PA,990,2482,1,0,0,2483,A
3-PA,991,2487,0,0,1,2488,A
3-PA,992,2494,0,0,0,2494,A
3-PA,993,0,2483,0,0,2483,T
3-PA,994,2,2457,0,2,2461,T
3-PA,995,11,1,1,2463,2476,C
3-PA,996,2470,0,1,1,2472,A
3-PA,997,2477,0,1,0,2478,A
3-PA,998,2487,0,1,0,2488,A
3-PA,999,1,2482,1,0,2484,T
3-PA,1000,0,2506,0,1,2507,T
3-PA,1001,2518,0,1,1,2520,A
3-PA,1002,3,2,1,2511,2517,C
3-PA,1003,11,1,0,2503,2515,C
3-PA,1004,0,2465,0,2,2467,T
3-PA,1005,1,2,2481,0,2484,G
3-PA,1006,1,0,0,2494,2495,C
3-PA,1007,0,2492,0,3,2495,T
3-PA,1008,0,0,2560,0,2560,G
3-PA,1009,0,2550,1,2,2553,T
3-PA,1010,29,2,0,2522,2553,C
3-PA,1011,2553,0,3,1,2557,A
3-PA,1012,1,2554,1,0,2556,T
3-PA,1013,0,11,2546,1,2558,G
3-PA,1014,1,11,2539,0,2551,G
3-PA,1015,2543,0,3,0,2546,A
3-PA,1016,2593,0,5,0,2598,A
3-PA,1017,1,0,2588,1,2590,G
3-PA,1018,1,3,0,2587,2591,C
3-PA,1019,2574,0,2,0,2576,A
3-PA,1020,2582,0,6,0,2588,A
3-PA,1021,1,1,2614,0,2616,G
3-PA,1022,1,2621,0,1,2623,T
3-PA,1023,2595,2,1,1,2599,A
3-PA,1024,1,4,0,2608,2613,C
3-PA,1025,1,2569,0,2,2572,T
3-PA,1026,5,0,2592,2,2599,G
3-PA,1027,0,2582,0,3,2585,T
3-PA,1028,19,2,1,2567,2589,C
3-PA,1029,2574,1,1,0,2576,A
3-PA,1030,0,11,2593,0,2604,G
3-PA,1031,2599,1,1,0,2601,A
3-PA,1032,2597,0,1,0,2598,A
3-PA,1033,0,2637,0,4,2641,T
3-PA,1034,0,2613,0,3,2616,T
3-PA,1035,2,2,2611,0,2615,G
3-PA,1036,6,0,0,2597,2603,C
3-PA,1037,2590,2,4,0,2596,A
3-PA,1038,0,9,2604,0,2613,G
3-PA,1039,0,14,2579,0,2593,G
3-PA,1040,2595,1,2,0,2598,A
3-PA,1041,0,1,0,2612,2613,C
3-PA,1042,2575,0,1,0,2576,A
3-PA,1043,0,2600,0,0,2600,T
3-PA,1044,0,2592,0,1,2593,T
3-PA,1045,1,11,2595,0,2607,G
3-PA,1046,2620,0,2,1,2623,A
3-PA,1047,2614,0,0,0,2614,A
3-PA,1048,2602,0,2,0,2604,A
3-PA,1049,2594,0,9,0,2603,A
3-PA,1050,1,2573,0,0,2574,T
3-PA,1051,1,16,2584,0,2601,G
3-PA,1052,2595,0,3,0,2598,A
3-PA,1053,3,7,2611,0,2621,G
3-PA,1054,1,17,2607,0,2625,G
3-PA,1055,2601,0,2,0,2603,A
3-PA,1056,2,4,2601,0,2607,G
3-PA,1057,2621,1,0,0,2622,A
3-PA,1058,2616,1,2,0,2619,A
3-PA,1059,3,16,2600,0,2619,G
3-PA,1060,0,4,2576,1,2581,G
3-PA,1061,2,2678,0,4,2684,T
3-PA,1062,0,2696,0,1,2697,T
3-PA,1063,15,0,1,2682,2698,C
3-PA,1064,2,1,2,2693,2698,C
3-PA,1065,2697,0,4,0,2701,A
3-PA,1066,2692,0,1,0,2693,A
3-PA,1067,2,11,2694,0,2707,G
3-PA,1068,0,16,2733,0,2749,G
3-PA,1069,2705,0,0,0,2705,A
3-PA,1070,0,1,0,2719,2720,C
3-PA,1071,1,2717,0,1,2719,T
3-PA,1072,2717,0,2,0,2719,A
3-PA,1073,2719,0,1,0,2720,A
3-PA,1074,2716,0,1,1,2718,A
3-PA,1075,2725,0,2,0,2727,A
3-PA,1076,2711,1,1,0,2713,A
3-PA,1077,3,3,0,2701,2707,C
3-PA,1078,2688,1,1,0,2690,A
3-PA,1079,0,2675,0,2,2677,T
3-PA,1080,0,12,2677,1,2690,G
3-PA,1081,2691,0,3,0,2694,A
3-PA,1082,2690,0,5,0,2695,A
3-PA,1083,1,23,2692,0,2716,G
3-PA,1084,2712,0,2,0,2714,A
3-PA,1085,2714,0,2,0,2716,A
3-PA,1086,2690,0,2,0,2692,A
3-PA,1087,2687,0,3,0,2690,A
3-PA,1088,1,2,0,2695,2698,C
3-PA,1089,1,21,2664,0,2686,G
3-PA,1090,2688,0,3,0,2691,A
3-PA,1091,0,1,2698,0,2699,G
3-PA,1092,1,2685,0,2,2688,T
3-PA,1093,24,0,1,2718,2743,C
3-PA,1094,2748,0,1,0,2749,A
3-PA,1095,2790,0,0,0,2790,A
3-PA,1096,0,0,0,2793,2793,C
3-PA,1097,0,2780,0,1,2781,T
3-PA,1098,1,9,2823,0,2833,G
3-PA,1099,2821,2,4,0,2827,A
3-PA,1100,2832,1,1,0,2834,A
3-PA,1101,0,2,2837,0,2839,G
3-PA,1102,1,2781,0,5,2787,T
3-PA,1103,2,15,2782,1,2800,G
3-PA,1104,0,12,2772,0,2784,G
3-PA,1105,1,1,2784,0,2786,G
3-PA,1106,1,1,0,2793,2795,C
3-PA,1107,0,2765,1,3,2769,T
3-PA,1108,20,6,1,2739,2766,C
3-PA,1109,1,2761,1,3,2766,T
3-PA,1110,0,2773,0,0,2773,T
3-PA,1111,1,9,2819,0,2829,G
3-PA,1112,0,2,2847,2,2851,G
3-PA,1113,2,2833,0,4,2839,T
3-PA,1114,0,17,2822,0,2839,G
3-PA,1115,2830,0,0,0,2830,A
3-PA,1116,2845,1,1,0,2847,A
3-PA,1117,2841,0,1,1,2843,A
3-PA,1118,2857,1,1,0,2859,A
3-PA,1119,2,3,0,2868,2873,C
3-PA,1120,2823,0,0,1,2824,A
3-PA,1121,1,2823,0,1,2825,T
3-PA,1122,1,24,2798,1,2824,G
3-PA,1123,4,5,2856,0,2865,G
3-PA,1124,1,1,0,2864,2866,C
3-PA,1125,2877,1,2,0,2880,A
3-PA,1126,4,4,0,2884,2892,C
3-PA,1127,8,1,0,2891,2900,C
3-PA,1128,2938,1,2,0,2941,A
3-PA,1129,0,7,2970,0,2977,G
3-PA,1130,2949,1,6,1,2957,A
3-PA,1131,8,4,2987,0,2999,G
3-PA,1132,2977,0,3,0,2980,A
3-PA,1133,2981,1,6,0,2988,A
3-PA,1134,0,12,2989,0,3001,G
3-PA,1135,3,2,2977,1,2983,G
3-PA,1136,0,2979,2,2,2983,T
3-PA,1137,2947,2,3,1,2953,A
3-PA,1138,0,16,2935,0,2951,G
3-PA,1139,2952,0,2,2,2956,A
3-PA,1140,0,0,1,2966,2967,C
3-PA,1141,1,2920,0,3,2924,T
3-PA,1142,0,2915,1,0,2916,T
3-PA,1143,1,2914,0,1,2916,T
3-PA,1144,1,9,2917,1,2928,G
3-PA,1145,2919,1,4,0,2924,A
3-PA,1146,2930,0,3,1,2934,A
3-PA,1147,2923,0,0,1,2924,A
3-PA,1148,2919,0,1,0,2920,A
3-PA,1149,0,0,0,2976,2976,C
3-PA,1150,0,2937,1,1,2939,T
3-PA,1151,1,1,2971,1,2974,G
3-PA,1152,0,3,1,2967,2971,C
3-PA,1153,2967,0,3,0,2970,A
3-PA,1154,2,1,2968,0,2971,G
3-PA,1155,2958,0,4,2,2964,A
3-PA,1156,2,15,3062,0,3079,G
3-PA,1157,3084,1,1,0,3086,A
3-PA,1158,0,2,0,3050,3052,C
3-PA,1159,3049,0,3,1,3053,A
3-PA,1160,1,3040,0,1,3042,T
3-PA,1161,3039,1,1,2,3043,A
3-PA,1162,3039,0,4,0,3043,A
3-PA,1163,0,1,3045,0,3046,G
3-PA,1164,1,5,0,3029,3035,C
3-PA,1165,3,17,2954,0,2974,G
3-PA,1166,3038,0,2,0,3040,A
3-PA,1167,2,3013,2,3,3020,T
3-PA,1168,1,3023,0,1,3025,T
3-PA,1169,0,3022,0,1,3023,T
3-PA,1170,0,15,3020,0,3035,G
3-PA,1171,3045,1,5,1,3052,A
3-PA,1172,3046,1,3,1,3051,A
3-PA,1173,0,2,3061,0,3063,G
3-PA,1174,1,2,0,3132,3135,C
3-PA,1175,3085,0,0,1,3086,A
3-PA,1176,3293,1,1,0,3295,A
3-PA,1177,1,3298,0,2,3301,T
3-PA,1178,3305,0,1,0,3306,A
3-PA,1179,1,3316,0,1,3318,T
3-PA,1180,1,21,3302,2,3326,G
3-PA,1181,3347,1,7,0,3355,A
3-PA,1182,1,3353,0,0,3354,T
3-PA,1183,3237,0,2,0,3239,A
3-PA,1184,0,2,3245,0,3247,G
3-PA,1185,0,3100,0,0,3100,T
3-PA,1186,0,22,3084,0,3106,G
3-PA,1187,3098,0,3,1,3102,A
3-PA,1188,1,5,0,3085,3091,C
3-PA,1189,2,28,3058,0,3088,G
3-PA,1190,3086,1,3,0,3090,A
3-PA,1191,3090,0,2,1,3093,A
3-PA,1192,5,2,0,3118,3125,C
3-PA,1193,14,0,0,3108,3122,C
3-PA,1194,0,3108,1,1,3110,T
3-PA,1195,2,14,3204,1,3221,G
3-PA,1196,3216,0,1,1,3218,A
3-PA,1197,3228,0,1,0,3229,A
3-PA,1198,1,3231,0,2,3234,T
3-PA,1199,1,3196,0,0,3197,T
3-PA,1200,3198,0,0,0,3198,A
3-PA,1201,3164,1,2,2,3169,A
3-PA,1202,0,10,3170,1,3181,G
3-PA,1203,0,0,3186,1,3187,G
3-PA,1204,0,3097,0,7,3104,T
3-PA,1205,29,2,0,3065,3096,C
3-PA,1206,3101,1,2,0,3104,A
3-PA,1207,0,1,0,3196,3197,C
3-PA,1208,1,3195,1,4,3201,T
3-PA,1209,2,3199,0,3,3204,T
3-PA,1210,2,3200,1,4,3207,T
3-PA,1211,14,0,0,3186,3200,C
3-PA,1212,3192,0,0,0,3192,A
3-PA,1213,3187,1,5,0,3193,A
3-PA,1214,1,2,3226,1,3230,G
3-PA,1215,1,2,0,3225,3228,C
3-PA,1216,1,3142,0,0,3143,T
3-PA,1217,1,14,3184,0,3199,G
3-PA,1218,0,14,3194,0,3208,G
3-PA,1219,3245,0,1,0,3246,A
3-PA,1220,0,3267,0,1,3268,T
3-PA,1221,3257,0,4,0,3261,A
3-PA,1222,3,3,0,3291,3297,C
3-PA,1223,3173,1,5,0,3179,A
3-PA,1224,0,12,3208,0,3220,G
3-PA,1225,3200,0,3,1,3204,A
3-PA,1226,3155,0,3,1,3159,A
3-PA,1227,0,3122,0,0,3122,T
3-PA,1228,0,18,3117,1,3136,G
3-PA,1229,3109,0,4,0,3113,A
3-PA,1230,2,2,3144,0,3148,G
3-PA,1231,0,3118,1,3,3122,T
3-PA,1232,0,3105,0,1,3106,T
3-PA,1233,27,2,0,3117,3146,C
3-PA,1234,3159,0,1,0,3160,A
3-PA,1235,3162,1,2,0,3165,A
3-PA,1236,1,4,0,3157,3162,C
3-PA,1237,3142,0,3,0,3145,A
3-PA,1238,3136,0,4,0,3140,A
3-PA,1239,1,5,3106,0,3112,G
3-PA,1240,0,3,3137,0,3140,G
3-PA,1241,3,2,1,3144,3150,C
3-PA,1242,11,0,0,3109,3120,C
3-PA,1243,1,3084,1,4,3090,T
3-PA,1244,2,1,3122,0,3125,G
3-PA,1245,0,3119,0,2,3121,T
3-PA,1246,1,38,3115,1,3155,G
3-PA,1247,3148,0,9,0,3157,A
3-PA,1248,2,1,3153,0,3156,G
3-PA,1249,2,0,0,3128,3130,C
3-PA,1250,0,3095,0,2,3097,T
3-PA,1251,3168,0,1,0,3169,A
3-PA,1252,3169,2,1,0,3172,A
3-PA,1253,0,0,0,3184,3184,C
3-PA,1254,0,3150,0,4,3154,T
3-PA,1255,1,19,3127,1,3148,G
3-PA,1256,3140,0,3,0,3143,A
3-PA,1257,1,3140,0,2,3143,T
3-PA,1258,0,3139,0,0,3139,T
3-PA,1259,18,1,0,3133,3152,C
3-PA,1260,3186,0,2,0,3188,A
3-PA,1261,2,2,3228,0,3232,G
3-PA,1262,0,3223,0,2,3225,T
3-PA,1263,22,1,1,3201,3225,C
3-PA,1264,1,3198,0,3,3202,T
3-PA,1265,3,13,3332,1,3349,G
3-PA,1266,0,8,3339,0,3347,G
3-PA,1267,3347,0,3,0,3350,A
3-PA,1268,0,3351,0,1,3352,T
3-PA,1269,3195,0,4,0,3199,A
3-PA,1270,1,25,3183,0,3209,G
3-PA,1271,3220,0,4,0,3224,A
3-PA,1272,0,0,3235,0,3235,G
3-PA,1273,2,0,0,3234,3236,C
3-PA,1274,0,3119,0,1,3120,T
3-PA,1275,0,3110,0,3,3113,T
3-PA,1276,0,8,3115,0,3123,G
3-PA,1277,3118,0,3,0,3121,A
3-PA,1278,0,3124,1,0,3125,T
3-PA,1279,2,21,3084,0,3107,G
3-PA,1280,3131,0,4,0,3135,A
3-PA,1281,3122,0,3,1,3126,A
3-PA,1282,3140,1,0,0,3141,A
3-PA,1283,0,3142,1,0,3143,T
3-PA,1284,1,3130,1,0,3132,T
3-PA,1285,2,10,3161,0,3173,G
3-PA,1286,2,20,3151,1,3174,G
3-PA,1287,3161,0,8,0,3169,A
3-PA,1288,1,17,3158,0,3176,G
3-PA,1289,3117,1,3,0,3121,A
3-PA,1290,1,13,3131,0,3145,G
3-PA,1291,1,13,3142,0,3156,G
3-PA,1292,3182,0,4,0,3186,A
3-PA,1293,3,1,0,3187,3191,C
3-PA,1294,5,1,3152,0,3158,G
3-PA,1295,0,3157,0,1,3158,T
3-PA,1296,3168,0,1,0,3169,A
3-PA,1297,0,3,3201,0,3204,G
3-PA,1298,3,5,0,3215,3223,C
3-PA,1299,13,0,0,3198,3211,C
3-PA,1300,20,3,0,3169,3192,C
3-PA,1301,15,1,0,3164,3180,C
3-PA,1302,3179,0,1,1,3181,A
3-PA,1303,3280,0,0,0,3280,A
3-PA,1304,0,3281,1,0,3282,T
3-PA,1305,0,3238,0,2,3240,T
3-PA,1306,0,36,3205,2,3243,G
3-PA,1307,3177,0,2,0,3179,A
3-PA,1308,0,2,3182,0,3184,G
3-PA,1309,4,2,0,3178,3184,C
3-PA,1310,3154,0,2,1,3157,A
3-PA,1311,0,2,0,3215,3217,C
3-PA,1312,3129,0,1,0,3130,A
3-PA,1313,1,3217,0,0,3218,T
3-PA,1314,1,3216,0,2,3219,T
3-PA,1315,0,4,3222,0,3226,G
3-PA,1316,1,2,0,3219,3222,C
3-PA,1317,3208,1,6,0,3215,A
3-PA,1318,3214,0,1,0,3215,A
3-PA,1319,0,6,3216,0,3222,G
3-PA,1320,0,1,0,3185,3186,C
3-PA,1321,3181,1,2,0,3184,A
3-PA,1322,1,3107,0,2,3110,T
3-PA,1323,0,31,3086,1,3118,G
3-PA,1324,3091,0,3,1,3095,A
3-PA,1325,0,8,3104,0,3112,G
3-PA,1326,3103,1,7,1,3112,A
3-PA,1327,3102,0,1,0,3103,A
3-PA,1328,1,8,3084,0,3093,G
3-PA,1329,1,22,3077,0,3100,G
3-PA,1330,3104,1,0,0,3105,A
3-PA,1331,3096,1,0,0,3097,A
3-PA,1332,0,3095,0,2,3097,T
3-PA,1333,0,3099,2,0,3101,T
3-PA,1334,3127,2,0,0,3129,A
3-PA,1335,0,3137,0,2,3139,T
3-PA,1336,0,3136,0,1,3137,T
3-PA,1337,1,3138,0,2,3141,T
3-PA,1338,19,5,0,3093,3117,C
3-PA,1339,3108,0,2,0,3110,A
3-PA,1340,2,0,0,3176,3178,C
3-PA,1341,3157,0,1,0,3158,A
3-PA,1342,1,1,3177,0,3179,G
3-PA,1343,3,3,0,3168,3174,C
3-PA,1344,3159,2,0,0,3161,A
3-PA,1345,2,5,3171,0,3178,G
3-PA,1346,3162,1,4,1,3168,A
3-PA,1347,0,8,3182,0,3190,G
3-PA,1348,1,4,3197,0,3202,G
3-PA,1349,0,3107,0,4,3111,T
3-PA,1350,1,0,3151,1,3153,G
3-PA,1351,0,3126,0,4,3130,T
3-PA,1352,13,1,0,3111,3125,C
3-PA,1353,12,2,0,3149,3163,C
3-PA,1354,27,4,0,3121,3152,C
3-PA,1355,3168,0,1,0,3169,A
3-PA,1356,2,3189,0,5,3196,T
3-PA,1357,2,3164,0,2,3168,T
3-PA,1358,1,0,3188,0,3189,G
3-PA,1359,0,3130,0,1,3131,T
3-PA,1360,3088,0,1,0,3089,A
3-PA,1361,0,16,3076,0,3092,G
3-PA,1362,2997,0,4,0,3001,A
3-PA,1363,2,1,3017,0,3020,G
3-PA,1364,3,2,0,2978,2983,C
3-PA,1365,13,3,0,2928,2944,C
3-PA,1366,2982,0,2,1,2985,A
3-PA,1367,0,0,0,2997,2997,C
3-PA,1368,0,2976,0,1,2977,T
3-PA,1369,0,13,2965,0,2978,G
3-PA,1370,2961,0,2,1,2964,A
3-PA,1371,2915,1,6,1,2923,A
3-PA,1372,0,2994,0,0,2994,T
3-PA,1373,3021,0,2,0,3023,A
3-PA,1374,1,2,1,3056,3060,C
3-PA,1375,2973,1,6,1,2981,A
3-PA,1376,0,2990,0,4,2994,T
3-PA,1377,2961,0,2,0,2963,A
3-PA,1378,2973,0,3,0,2976,A
3-PA,1379,0,2965,2,1,2968,T
3-PA,1380,1,10,2926,0,2937,G
3-PA,1381,2915,0,2,0,2917,A
3-PA,1382,2879,0,2,1,2882,A
3-PA,1383,0,15,2870,0,2885,G
3-PA,1384,0,22,2842,1,2865,G
3-PA,1385,0,20,2868,0,2888,G
3-PA,1386,0,15,2883,1,2899,G
3-PA,1387,2,5,2921,0,2928,G
3-PA,1388,0,2874,0,1,2875,T
3-PA,1389,2890,1,1,0,2892,A
3-PA,1390,0,2896,1,1,2898,T
3-PA,1391,2931,0,0,0,2931,A
3-PA,1392,1,0,0,3187,3188,C
3-PA,1393,3100,0,0,0,3100,A
3-PA,1394,0,3048,0,3,3051,T
3-PA,1395,0,3020,0,3,3023,T
3-PA,1396,2976,0,0,0,2976,A
3-PA,1397,3024,0,2,1,3027,A
3-PA,1398,0,1,0,3037,3038,C
3-PA,1399,2989,1,1,0,2991,A
3-PA,1400,3,0,0,2995,2998,C
3-PA,1401,0,2664,0,2,2666,T
3-PA,1402,0,3,2770,0,2773,G
3-PA,1403,1,2,0,2761,2764,C
3-PA,1404,13,3,0,2739,2755,C
3-PA,1405,10,0,0,2762,2772,C
3-PA,1406,1,2698,0,3,2702,T
3-PA,1407,0,3,2815,0,2818,G
3-PA,1408,1,2,0,2818,2821,C
3-PA,1409,0,2811,0,4,2815,T
3-PA,1410,29,0,0,2853,2882,C
3-PA,1411,2775,0,0,0,2775,A
3-PA,1412,2803,0,1,1,2805,A
3-PA,1413,0,2806,0,1,2807,T
3-PA,1414,0,2,2799,1,2802,G
3-PA,1415,5,0,0,2796,2801,C
3-PA,1416,2738,1,2,0,2741,A
3-PA,1417,1,2729,1,6,2737,T
3-PA,1418,10,0,0,2726,2736,C
3-PA,1419,9,0,0,2748,2757,C
3-PA,1420,0,2676,0,0,2676,T
3-PA,1421,0,0,2731,0,2731,G
3-PA,1422,0,2717,1,3,2721,T
3-PA,1423,1,1,2709,0,2711,G
3-PA,1424,2,2,1,2709,2714,C
3-PA,1425,2676,0,0,0,2676,A
3-PA,1426,0,0,2706,0,2706,G
3-PA,1427,0,0,0,2700,2700,C
3-PA,1428,2666,1,1,0,2668,A
3-PA,1429,2663,0,2,1,2666,A
3-PA,1430,0,2571,0,0,2571,T
3-PA,1431,0,14,2553,1,2568,G
3-PA,1432,1,8,2562,0,2571,G
3-PA,1433,2562,0,3,0,2565,A
3-PA,1434,2,2,0,2561,2565,C
3-PA,1435,3,23,2502,0,2528,G
3-PA,1436,2563,0,0,0,2563,A
3-PA,1437,0,2564,0,1,2565,T
3-PA,1438,1,2553,0,1,2555,T
3-PA,1439,0,2556,0,2,2558,T
3-PA,1440,0,2548,0,3,2551,T
3-PA,1441,19,2,0,2538,2559,C
3-PA,1442,2556,0,2,0,2558,A
3-PA,1443,2559,0,2,0,2561,A
3-PA,1444,0,0,0,2571,2571,C
3-PA,1445,1,2510,0,3,2514,T
3-PA,1446,2510,0,0,0,2510,A
3-PA,1447,2510,0,3,2,2515,A
3-PA,1448,0,2511,0,1,2512,T
3-PA,1449,0,2508,0,2,2510,T
3-PA,1450,17,0,0,2496,2513,C
3-PA,1451,5,1,0,2502,2508,C
3-PA,1452,16,0,1,2483,2500,C
3-PA,1453,2495,0,1,0,2496,A
3-PA,1454,0,2521,0,5,2526,T
3-PA,1455,2,11,2518,0,2531,G
3-PA,1456,2529,0,2,0,2531,A
3-PA,1457,0,2514,0,3,2517,T
3-PA,1458,2509,0,0,0,2509,A
3-PA,1459,2506,0,5,2,2513,A
3-PA,1460,0,2,2510,0,2512,G
3-PA,1461,1,3,0,2513,2517,C
3-PA,1462,2495,0,1,0,2496,A
3-PA,1463,2426,0,1,0,2427,A
3-PA,1464,2,2,2471,0,2475,G
3-PA,1465,0,2449,0,3,2452,T
3-PA,1466,1,0,2446,0,2447,G
3-PA,1467,1,0,0,2440,2441,C
3-PA,1468,2431,0,2,0,2433,A
3-PA,1469,1,16,2468,0,2485,G
3-PA,1470,2478,0,0,0,2478,A
3-PA,1471,2512,0,1,0,2513,A
3-PA,1472,3,1,0,2519,2523,C
3-PA,1473,0,2442,1,2,2445,T
3-PA,1474,2458,0,0,0,2458,A
3-PA,1475,2457,0,0,0,2457,A
3-PA,1476,2461,0,1,0,2462,A
3-PA,1477,0,6,2462,0,2468,G
3-PA,1478,2356,0,1,0,2357,A
3-PA,1479,1,10,2344,0,2355,G
3-PA,1480,0,11,2272,0,2283,G
3-PA,1481,2,5,2274,1,2282,G
3-PA,1482,2254,3,2,0,2259,A
3-PA,1483,2212,0,2,0,2214,A
3-PA,1484,1,7,2213,0,2221,G
3-PA,1485,2,0,2220,0,2222,G
3-PA,1486,1,0,0,2214,2215,C
3-PA,1487,2,11,2213,0,2226,G
3-PA,1488,2206,0,1,0,2207,A
3-PA,1489,2202,2,0,2,2206,A
3-PA,1490,2207,0,3,0,2210,A
3-PA,1491,2215,0,1,0,2216,A
3-PA,1492,2214,0,1,1,2216,A
3-PA,1493,3,0,0,2209,2212,C
3-PA,1494,12,1,0,2194,2207,C
3-PA,1495,2199,0,1,0,2200,A
3-PA,1496,2225,0,1,0,2226,A
3-PA,1497,0,2219,0,0,2219,T
3-PA,1498,0,2218,1,0,2219,T
3-PA,1499,0,2230,0,0,2230,T
3-PA,1500,2232,1,0,0,2233,A
3-PA,1501,1,2228,0,0,2229,T
3-PA,1502,2223,0,2,0,2225,A
3-PA,1503,1,2220,0,0,2221,T
3-PA,1504,2,6,2184,0,2192,G
3-PA,1505,1,13,2143,0,2157,G
3-PA,1506,2155,0,0,0,2155,A
3-PA,1507,0,2155,0,0,2155,T
3-PA,1508,0,2116,1,1,2118,T
3-PA,1509,10,1,0,2094,2105,C
3-PA,1510,2099,1,6,0,2106,A
3-PA,1511,0,2118,0,2,2120,T
3-PA,1512,8,0,0,2113,2121,C
3-PA,1513,2118,0,0,0,2118,A
3-PA,1514,0,2100,0,2,2102,T
3-PA,1515,2093,0,0,0,2093,A
3-PA,1516,2094,0,0,0,2094,A
3-PA,1517,2090,0,4,0,2094,A
3-PA,1518,0,9,2069,0,2078,G
3-PA,1519,0,7,2029,0,2036,G
3-PA,1520,0,7,2001,0,2008,G
3-PA,1521,1981,0,2,0,1983,A
3-PA,1522,1955,0,2,0,1957,A
3-PA,1523,0,7,1962,0,1969,G
3-PA,1524,1941,0,4,0,1945,A
3-PA,1525,0,1936,0,1,1937,T
3-PA,1526,10,0,0,1922,1932,C
3-PA,1527,0,1885,0,2,1887,T
3-PA,1528,25,0,0,1877,1902,C
3-PA,1529,1900,0,0,0,1900,A
3-PA,1530,1,1892,0,2,1895,T
3-PA,1531,0,1898,0,1,1899,T
3-PA,1532,0,1881,0,0,1881,T
3-PA,1533,1879,1,1,0,1881,A
3-PA,1534,1876,0,3,0,1879,A
3-PA,1535,0,9,1869,0,1878,G
3-PA,1536,1781,0,1,0,1782,A
3-PA,1537,1797,0,1,0,1798,A
3-PA,1538,1802,0,1,0,1803,A
3-PA,1539,0,1796,0,5,1801,T
3-PA,1540,0,22,1794,0,1816,G
3-PA,1541,1836,0,0,0,1836,A
3-PA,1542,1,0,0,1831,1832,C
3-PA,1543,1816,0,5,0,1821,A
3-PA,1544,1,2,0,1819,1822,C
3-PA,1545,1779,0,2,0,1781,A
3-PA,1546,1,5,1787,0,1793,G
3-PA,1547,1782,0,1,0,1783,A
3-PA,1548,0,2,1,1750,1753,C
3-PA,1549,1,0,1737,0,1738,G
3-PA,1550,0,1663,0,1,1664,T
3-PA,1551,2,8,1658,0,1668,G
3-PA,1552,0,1,1671,0,1672,G
3-PA,1553,0,1669,0,1,1670,T
3-PA,1554,1671,0,0,0,1671,A
3-PA,1555,1625,0,1,0,1626,A
3-PA,1556,1623,0,1,0,1624,A
3-PA,1557,0,1612,0,2,1614,T
3-PA,1558,0,1582,1,0,1583,T
3-PA,1559,1,1576,1,0,1578,T
3-PA,1560,0,1549,0,0,1549,T
3-PA,1561,1,0,1553,0,1554,G
3-PA,1562,0,1515,0,2,1517,T
3-PA,1563,0,14,1508,0,1522,G
3-PA,1564,1505,1,0,0,1506,A
3-PA,1565,0,1,1507,0,1508,G
3-PA,1566,2,0,0,1497,1499,C
3-PA,1567,1499,0,0,0,1499,A
3-PA,1568,0,1495,0,1,1496,T
3-PA,1569,0,2,1493,0,1495,G
3-PA,1570,0,10,1489,0,1499,G
3-PA,1571,1499,0,0,0,1499,A
3-PA,1572,0,1,1503,0,1504,G
3-PA,1573,0,1468,1,5,1474,T
3-PA,1574,1,1450,0,2,1453,T
3-PA,1575,0,1452,0,0,1452,T
3-PA,1576,0,1453,0,0,1453,T
3-PA,1577,7,0,0,1447,1454,C
3-PA,1578,1,1438,1,2,1442,T
3-PA,1579,14,0,0,1430,1444,C
3-PA,1580,0,1387,0,1,1388,T
3-PA,1581,13,0,0,1367,1380,C
3-PA,1582,1380,0,0,0,1380,A
3-PA,1583,0,0,0,1373,1373,C
3-PA,1584,0,1328,0,3,1331,T
3-PA,1585,0,13,1314,0,1327,G
3-PA,1586,1330,0,2,0,1332,A
3-PA,1587,4,1,0,1329,1334,C
3-PA,1588,5,1,0,1315,1321,C
3-PA,1589,4,1,0,1298,1303,C
3-PA,1590,4,6,1281,0,1291,G
3-PA,1591,1282,0,2,0,1284,A
3-PA,1592,0,4,1283,0,1287,G
3-PA,1593,1288,0,0,0,1288,A
3-PA,1594,0,0,0,1253,1253,C
3-PA,1595,0,1227,1,2,1230,T
3-PA,1596,0,1144,1,3,1148,T
3-PA,1597,0,7,1137,0,1144,G
3-PA,1598,1136,0,2,1,1139,A
3-PA,1599,0,2,1145,0,1147,G
3-PA,1600,1,0,0,1139,1140,C
3-PA,1601,6,1,1,1086,1094,C
3-PA,1602,1086,1,2,0,1089,A
3-PA,1603,2,2,0,1083,1087,C
3-PA,1604,1087,0,0,0,1087,A
3-PA,1605,0,1088,0,0,1088,T
3-PA,1606,1075,0,0,0,1075,A
3-PA,1607,1068,0,0,0,1068,A
3-PA,1608,1067,0,1,0,1068,A
3-PA,1609,0,1061,0,0,1061,T
3-PA,1610,2,6,1043,0,1051,G
3-PA,1611,0,4,924,0,928,G
3-PA,1612,0,5,902,0,907,G
3-PA,1613,882,0,1,0,883,A
3-PA,1614,0,1,864,0,865,G
3-PA,1615,846,0,0,0,846,A
3-PA,1616,829,0,0,0,829,A
3-PA,1617,830,0,0,0,830,A
3-PA,1618,0,822,0,0,822,T
3-PA,1619,813,1,1,0,815,A
3-PA,1620,0,0,0,814,814,C
3-PA,1621,0,413,0,0,413,T
3-PA,1622,1,0,410,0,411,G
3-PA,1623,0,242,0,0,242,T
3-PA,1624,1,0,247,0,248,G
3-PA,1625,0,228,1,0,229,T
3-PA,1626,1,0,0,152,153,C
3-PA,1627,1,0,0,140,141,C
3-PA,1628,0,130,0,0,130,T
3-PA,1629,0,130,1,0,131,T
3-PA,1630,0,1,133,0,134,G
3-PA,1631,136,0,0,0,136,A
3-PA,1632,0,0,136,0,136,G
3-PA,1633,129,0,0,0,129,A
3-PA,1634,0,130,0,0,130,T
3-PA,1635,129,0,0,0,129,A
3-PA,1636,1,0,133,0,134,G
3-PA,1637,0,1,132,0,133,G
3-PA,1638,133,0,0,1,134,A
3-PA,1639,0,0,131,0,131,G
3-PA,1640,132,0,0,0,132,A
3-PA,1641,0,133,0,0,133,T
3-PA,1642,135,0,0,0,135,A
3-PA,1643,0,134,0,0,134,T
3-PA,1644,0,0,135,0,135,G
3-PA,1645,0,132,0,0,132,T
3-PA,1646,0,131,0,0,131,T
3-PA,1647,134,0,1,0,135,A
3-PA,1648,0,0,0,135,135,C
3-PA,1649,0,132,0,0,132,T
3-PA,1650,132,0,0,0,132,A
3-PA,1651,132,0,0,0,132,A
3-PA,1652,0,0,133,0,133,G
3-PA,1653,131,0,0,0,131,A
3-PA,1654,129,0,0,0,129,A
3-PA,1655,0,0,128,0,128,G
3-PA,1656,0,131,0,0,131,T
3-PA,1657,0,0,135,0,135,G
3-PA,1658,1,0,0,133,134,C
3-PA,1659,0,0,0,133,133,C
3-PA,1660,133,0,0,0,133,A
3-PA,1661,0,133,0,0,133,T
3-PA,1662,130,0,1,0,131,A
3-PA,1663,0,1,131,0,132,G
3-PA,1664,0,0,133,0,133,G
3-PA,1665,0,0,0,132,132,C
3-PA,1666,3,1,0,126,130,C
3-PA,1667,131,0,0,0,131,A
3-PA,1668,130,0,1,0,131,A
3-PA,1669,132,0,0,0,132,A
3-PA,1670,0,133,0,0,133,T
3-PA,1671,0,131,0,0,131,T
3-PA,1672,0,132,0,0,132,T
3-PA,1673,2,0,0,131,133,C
3-PA,1674,120,0,0,0,120,A
3-PA,1675,124,0,0,0,124,A
3-PA,1676,0,0,128,0,128,G
3-PA,1677,0,0,131,0,131,G
3-PA,1678,0,0,0,130,130,C
3-PA,1679,0,0,0,130,130,C
3-PA,1680,0,0,131,0,131,G
3-PA,1681,131,0,0,0,131,A
3-PA,1682,0,132,0,0,132,T
3-PA,1683,0,0,133,0,133,G
3-PA,1684,0,133,0,0,133,T
3-PA,1685,0,136,0,0,136,T
3-PA,1686,0,0,0,134,134,C
3-PA,1687,0,137,0,0,137,T
3-PA,1688,0,136,0,0,136,T
3-PA,1689,0,0,137,0,137,G
3-PA,1690,0,136,0,0,136,T
3-PA,1691,136,0,0,0,136,A
3-PA,1692,0,133,0,0,133,T
3-PA,1693,0,0,132,0,132,G
3-PA,1694,0,129,0,0,129,T
3-PA,1695,0,1,129,0,130,G
3-PA,1696,129,0,0,0,129,A
3-PA,1697,0,0,130,0,130,G
3-PA,1698,0,1,128,0,129,G
3-PA,1699,129,0,0,0,129,A
3-PA,1700,0,0,0,127,127,C
3-PA,1701,126,0,0,0,126,A
3-PA,1702,125,0,0,0,125,A
3-PA,1703,126,0,0,0,126,A
3-PA,1704,0,0,0,125,125,C
3-PA,1705,0,0,126,0,126,G
3-PA,1706,0,1,124,0,125,G
3-PA,1707,125,0,0,0,125,A
3-PA,1708,124,0,0,0,124,A
3-PA,1709,0,0,0,127,127,C
3-PA,1710,127,0,0,0,127,A
3-PA,1711,0,127,0,0,127,T
3-PA,1712,0,0,0,127,127,C
3-PA,1713,127,0,0,0,127,A
3-PA,1714,128,0,0,0,128,A
3-PA,1715,125,0,0,0,125,A
3-PA,1716,0,2,125,0,127,G
3-PA,1717,0,0,128,0,128,G
3-PA,1718,0,125,0,0,125,T
3-PA,1719,1,0,0,123,124,C
3-PA,1720,125,0,0,0,125,A
3-PA,1721,125,0,0,0,125,A
3-PA,1722,125,0,0,0,125,A
3-PA,1723,124,0,0,0,124,A
3-PA,1724,0,124,0,0,124,T
3-PA,1725,0,1,124,0,125,G
3-PA,1726,125,0,0,0,125,A
3-PA,1727,125,0,0,0,125,A
3-PA,1728,125,0,0,0,125,A
3-PA,1729,0,125,0,0,125,T
3-PA,1730,0,0,124,0,124,G
3-PA,1731,0,1,124,0,125,G
3-PA,1732,0,1,123,0,124,G
3-PA,1733,0,1,124,0,125,G
3-PA,1734,126,0,0,0,126,A
3-PA,1735,126,0,0,0,126,A
3-PA,1736,0,125,0,1,126,T
3-PA,1737,0,0,126,0,126,G
3-PA,1738,0,0,126,0,126,G
3-PA,1739,124,0,0,0,124,A
3-PA,1740,0,0,126,0,126,G
3-PA,1741,123,0,0,0,123,A
3-PA,1742,0,121,0,1,122,T
3-PA,1743,0,1,121,0,122,G
3-PA,1744,121,0,0,0,121,A
3-PA,1745,0,1,121,0,122,G
3-PA,1746,121,0,0,0,121,A
3-PA,1747,0,0,0,121,121,C
3-PA,1748,0,0,121,0,121,G
3-PA,1749,0,121,0,0,121,T
3-PA,1750,0,121,0,0,121,T
3-PA,1751,0,0,122,0,122,G
3-PA,1752,1,0,0,120,121,C
3-PA,1753,0,0,0,122,122,C
3-PA,1754,0,124,0,0,124,T
3-PA,1755,0,0,0,124,124,C
3-PA,1756,0,0,0,125,125,C
3-PA,1757,0,124,0,0,124,T
3-PA,1758,0,125,0,0,125,T
3-PA,1759,1,0,0,123,124,C
3-PA,1760,123,0,0,0,123,A
3-PA,1761,0,0,124,0,124,G
3-PA,1762,0,122,1,0,123,T
3-PA,1763,2,0,0,120,122,C
3-PA,1764,119,0,0,0,119,A
3-PA,1765,0,0,0,123,123,C
3-PA,1766,0,124,0,0,124,T
3-PA,1767,2,0,0,124,126,C
3-PA,1768,0,0,0,126,126,C
3-PA,1769,125,0,0,0,125,A
3-PA,1770,0,0,127,0,127,G
3-PA,1771,0,0,0,126,126,C
3-PA,1772,126,0,0,0,126,A
3-PA,1773,0,0,128,0,128,G
3-PA,1774,120,0,0,0,120,A
3-PA,1775,0,119,0,0,119,T
3-PA,1776,3,0,0,117,120,C
3-PA,1777,0,0,120,0,120,G
3-PA,1778,120,0,0,0,120,A
3-PA,1779,0,1,119,0,120,G
3-PA,1780,120,0,0,0,120,A
3-PA,1781,0,1,121,0,122,G
3-PA,1782,0,0,0,121,121,C
3-PA,1783,121,0,0,0,121,A
3-PA,1784,0,121,0,0,121,T
3-PA,1785,0,0,122,0,122,G
3-PA,1786,122,0,1,0,123,A
3-PA,1787,0,124,0,0,124,T
3-PA,1788,0,124,0,0,124,T
3-PA,1789,0,0,124,0,124,G
3-PA,1790,123,0,0,0,123,A
3-PA,1791,123,0,0,0,123,A
3-PA,1792,0,0,123,0,123,G
3-PA,1793,0,0,0,123,123,C
3-PA,1794,1,1,0,117,119,C
3-PA,1795,0,0,119,0,119,G
3-PA,1796,119,0,0,0,119,A
3-PA,1797,0,0,119,0,119,G
3-PA,1798,0,118,0,0,118,T
3-PA,1799,1,0,0,116,117,C
3-PA,1800,0,0,0,118,118,C
3-PA,1801,0,117,0,0,117,T
3-PA,1802,0,0,0,120,120,C
3-PA,1803,0,0,121,0,121,G
3-PA,1804,0,0,124,0,124,G
3-PA,1805,0,125,0,0,125,T
3-PA,1806,0,123,0,0,123,T
3-PA,1807,122,0,0,0,122,A
3-PA,1808,123,0,0,0,123,A
3-PA,1809,122,0,0,0,122,A
3-PA,1810,0,0,127,0,127,G
3-PA,1811,127,0,0,0,127,A
3-PA,1812,0,0,127,0,127,G
3-PA,1813,119,0,0,0,119,A
3-PA,1814,119,0,0,0,119,A
3-PA,1815,119,0,0,0,119,A
3-PA,1816,0,0,117,0,117,G
3-PA,1817,116,0,0,0,116,A
3-PA,1818,1,0,0,116,117,C
3-PA,1819,116,0,0,0,116,A
3-PA,1820,0,116,0,0,116,T
3-PA,1821,0,2,114,0,116,G
3-PA,1822,116,0,0,0,116,A
3-PA,1823,0,0,0,116,116,C
3-PA,1824,0,0,0,115,115,C
3-PA,1825,114,0,0,0,114,A
3-PA,1826,114,0,0,0,114,A
3-PA,1827,114,0,0,0,114,A
3-PA,1828,0,0,114,0,114,G
3-PA,1829,114,0,0,0,114,A
3-PA,1830,111,0,0,0,111,A
3-PA,1831,1,112,0,0,113,T
3-PA,1832,0,113,0,0,113,T
3-PA,1833,0,112,0,0,112,T
3-PA,1834,0,111,0,0,111,T
3-PA,1835,1,110,0,0,111,T
3-PA,1836,0,111,0,0,111,T
3-PA,1837,0,0,110,0,110,G
3-PA,1838,111,0,0,0,111,A
3-PA,1839,0,0,111,0,111,G
3-PA,1840,111,0,0,0,111,A
3-PA,1841,110,0,0,0,110,A
3-PA,1842,0,111,0,0,111,T
3-PA,1843,111,0,0,0,111,A
3-PA,1844,111,0,0,0,111,A
3-PA,1845,0,0,109,0,109,G
3-PA,1846,0,113,0,0,113,T
3-PA,1847,0,0,0,113,113,C
3-PA,1848,112,0,0,0,112,A
3-PA,1849,0,0,113,0,113,G
3-PA,1850,113,0,0,0,113,A
3-PA,1851,116,0,0,0,116,A
3-PA,1852,0,0,116,0,116,G
3-PA,1853,1,0,0,113,114,C
3-PA,1854,110,0,0,0,110,A
3-PA,1855,0,106,1,0,107,T
3-PA,1856,0,0,107,0,107,G
3-PA,1857,0,0,109,0,109,G
3-PA,1858,0,0,0,108,108,C
3-PA,1859,0,0,0,108,108,C
3-PA,1860,2,0,0,105,107,C
3-PA,1861,106,0,0,0,106,A
3-PA,1862,0,108,0,0,108,T
3-PA,1863,0,108,0,0,108,T
3-PA,1864,0,0,108,0,108,G
3-PA,1865,0,1,108,0,109,G
3-PA,1866,0,0,107,0,107,G
3-PA,1867,0,0,107,0,107,G
3-PA,1868,101,0,0,0,101,A
3-PA,1869,0,0,103,0,103,G
3-PA,1870,0,101,0,0,101,T
3-PA,1871,2,0,0,102,104,C
3-PA,1872,1,0,0,107,108,C
3-PA,1873,1,1,0,108,110,C
3-PA,1874,0,0,0,108,108,C
3-PA,1875,1,0,0,107,108,C
3-PA,1876,108,0,0,0,108,A
3-PA,1877,107,0,1,0,108,A
3-PA,1878,0,0,108,0,108,G
3-PA,1879,0,0,108,0,108,G
3-PA,1880,0,0,108,0,108,G
3-PA,1881,95,0,1,0,96,A
3-PA,1882,0,0,96,0,96,G
3-PA,1883,0,98,0,0,98,T
3-PA,1884,0,0,98,0,98,G
3-PA,1885,0,0,98,0,98,G
3-PA,1886,98,0,0,0,98,A
3-PA,1887,98,0,0,0,98,A
3-PA,1888,0,1,95,0,96,G
3-PA,1889,94,0,0,0,94,A
3-PA,1890,94,0,0,0,94,A
3-PA,1891,0,0,92,0,92,G
3-PA,1892,0,0,91,0,91,G
3-PA,1893,0,91,0,0,91,T
3-PA,1894,0,91,0,0,91,T
3-PA,1895,0,0,0,92,92,C
3-PA,1896,0,0,0,90,90,C
3-PA,1897,89,0,0,0,89,A
3-PA,1898,0,91,0,0,91,T
3-PA,1899,0,91,0,0,91,T
3-PA,1900,0,0,92,0,92,G
3-PA,1901,0,0,91,0,91,G
3-PA,1902,0,0,91,0,91,G
3-PA,1903,91,0,0,0,91,A
3-PA,1904,91,0,0,0,91,A
3-PA,1905,92,0,1,0,93,A
3-PA,1906,0,0,97,0,97,G
3-PA,1907,0,96,0,0,96,T
3-PA,1908,1,0,0,94,95,C
3-PA,1909,0,95,0,0,95,T
3-PA,1910,0,0,95,0,95,G
3-PA,1911,0,95,0,0,95,T
3-PA,1912,96,0,0,0,96,A
3-PA,1913,0,0,96,0,96,G
3-PA,1914,0,0,97,0,97,G
3-PA,1915,94,0,0,0,94,A
3-PA,1916,0,0,0,93,93,C
3-PA,1917,0,92,0,1,93,T
3-PA,1918,0,0,1,97,98,C
3-PA,1919,0,95,0,1,96,T
3-PA,1920,96,0,0,0,96,A
3-PA,1921,0,96,0,0,96,T
3-PA,1922,0,92,0,1,93,T
3-PA,1923,0,0,95,0,95,G
3-PA,1924,0,0,95,0,95,G
3-PA,1925,0,0,0,95,95,C
3-PA,1926,0,93,0,0,93,T
3-PA,1927,84,0,0,0,84,A
3-PA,1928,85,0,0,0,85,A
3-PA,1929,0,0,86,0,86,G
3-PA,1930,0,86,0,0,86,T
3-PA,1931,1,0,0,85,86,C
3-PA,1932,84,0,0,0,84,A
3-PA,1933,0,0,88,0,88,G
3-PA,1934,0,88,0,0,88,T
3-PA,1935,90,0,0,0,90,A
3-PA,1936,0,90,0,0,90,T
3-PA,1937,0,95,0,0,95,T
3-PA,1938,0,0,0,95,95,C
3-PA,1939,94,0,0,0,94,A
3-PA,1940,93,0,0,0,93,A
3-PA,1941,0,94,0,0,94,T
3-PA,1942,93,0,0,0,93,A
3-PA,1943,0,0,95,0,95,G
3-PA,1944,0,0,0,92,92,C
3-PA,1945,0,0,0,92,92,C
3-PA,1946,0,91,0,1,92,T
3-PA,1947,0,0,94,0,94,G
3-PA,1948,0,90,0,1,91,T
3-PA,1949,92,0,0,0,92,A
3-PA,1950,0,92,0,0,92,T
3-PA,1951,0,0,91,0,91,G
3-PA,1952,0,0,0,93,93,C
3-PA,1953,93,0,0,0,93,A
3-PA,1954,0,91,0,0,91,T
3-PA,1955,2,0,0,88,90,C
3-PA,1956,89,0,0,0,89,A
3-PA,1957,0,0,0,90,90,C
3-PA,1958,1,0,0,90,91,C
3-PA,1959,90,0,0,0,90,A
3-PA,1960,0,0,0,93,93,C
3-PA,1961,92,0,0,0,92,A
3-PA,1962,93,0,0,0,93,A
3-PA,1963,0,92,0,0,92,T
3-PA,1964,0,92,0,0,92,T
3-PA,1965,0,1,91,0,92,G
3-PA,1966,0,1,91,0,92,G
3-PA,1967,92,0,0,0,92,A
3-PA,1968,92,0,0,0,92,A
3-PA,1969,0,0,91,0,91,G
3-PA,1970,0,0,88,0,88,G
3-PA,1971,87,0,0,0,87,A
3-PA,1972,0,85,0,0,85,T
3-PA,1973,0,85,0,0,85,T
3-PA,1974,0,86,0,0,86,T
3-PA,1975,0,85,0,0,85,T
3-PA,1976,0,0,0,85,85,C
3-PA,1977,85,0,0,0,85,A
3-PA,1978,0,0,85,0,85,G
3-PA,1979,0,0,0,84,84,C
3-PA,1980,0,0,85,0,85,G
3-PA,1981,0,0,85,0,85,G
3-PA,1982,84,0,0,0,84,A
3-PA,1983,0,0,84,0,84,G
3-PA,1984,0,84,0,0,84,T
3-PA,1985,1,0,0,83,84,C
3-PA,1986,85,0,0,0,85,A
3-PA,1987,86,0,0,0,86,A
3-PA,1988,0,0,86,0,86,G
3-PA,1989,86,0,0,0,86,A
3-PA,1990,86,0,0,0,86,A
3-PA,1991,86,0,0,0,86,A
3-PA,1992,86,0,0,0,86,A
3-PA,1993,0,0,0,86,86,C
3-PA,1994,0,84,0,0,84,T
3-PA,1995,0,0,85,0,85,G
3-PA,1996,0,0,0,85,85,C
3-PA,1997,0,85,0,0,85,T
3-PA,1998,1,0,0,84,85,C
3-PA,1999,0,0,0,84,84,C
3-PA,2000,0,83,0,0,83,T
3-PA,2001,0,83,0,0,83,T
3-PA,2002,0,0,84,0,84,G
3-PA,2003,0,84,0,0,84,T
3-PA,2004,0,83,0,0,83,T
3-PA,2005,0,0,83,0,83,G
3-PA,2006,0,83,0,0,83,T
3-PA,2007,0,83,0,0,83,T
3-PA,2008,3,0,0,80,83,C
3-PA,2009,81,0,0,0,81,A
3-PA,2010,0,0,83,0,83,G
3-PA,2011,0,0,83,0,83,G
3-PA,2012,0,0,0,83,83,C
3-PA,2013,0,82,0,1,83,T
3-PA,2014,0,0,0,83,83,C
3-PA,2015,0,82,0,0,82,T
3-PA,2016,0,82,0,0,82,T
3-PA,2017,82,0,0,0,82,A
3-PA,2018,0,1,81,0,82,G
3-PA,2019,0,0,79,1,80,G
3-PA,2020,0,0,80,0,80,G
3-PA,2021,78,0,0,0,78,A
3-PA,2022,0,0,0,78,78,C
3-PA,2023,72,0,0,0,72,A
3-PA,2024,73,0,0,0,73,A
3-PA,2025,0,0,0,75,75,C
3-PA,2026,1,0,0,74,75,C
3-PA,2027,0,75,0,0,75,T
3-PA,2028,1,0,0,72,73,C
3-PA,2029,0,1,72,0,73,G
3-PA,2030,73,0,0,0,73,A
3-PA,2031,73,0,1,0,74,A
3-PA,2032,0,0,0,74,74,C
3-PA,2033,0,0,0,70,70,C
3-PA,2034,0,69,0,0,69,T
3-PA,2035,0,0,69,0,69,G
3-PA,2036,0,0,70,0,70,G
3-PA,2037,0,0,70,0,70,G
3-PA,2038,70,0,0,0,70,A
3-PA,2039,0,0,0,70,70,C
3-PA,2040,0,0,0,67,67,C
3-PA,2041,0,63,0,0,63,T
3-PA,2042,0,63,0,0,63,T
3-PA,2043,0,63,0,0,63,T
3-PA,2044,0,0,63,0,63,G
3-PA,2045,63,0,0,0,63,A
3-PA,2046,0,64,0,0,64,T
3-PA,2047,0,0,0,64,64,C
3-PA,2048,0,61,0,0,61,T
3-PA,2049,0,61,0,0,61,T
3-PA,2050,0,1,60,0,61,G
3-PA,2051,0,0,61,0,61,G
3-PA,2052,0,0,60,0,60,G
3-PA,2053,0,0,62,0,62,G
3-PA,2054,0,2,62,0,64,G
3-PA,2055,0,0,63,0,63,G
3-PA,2056,0,0,0,64,64,C
3-PA,2057,0,63,0,1,64,T
3-PA,2058,64,0,0,0,64,A
3-PA,2059,0,64,0,0,64,T
3-PA,2060,64,0,0,0,64,A
3-PA,2061,0,64,0,0,64,T
3-PA,2062,0,0,61,0,61,G
3-PA,2063,62,0,0,0,62,A
3-PA,2064,62,0,0,0,62,A
3-PA,2065,0,0,62,0,62,G
3-PA,2066,0,0,0,65,65,C
3-PA,2067,60,0,0,0,60,A
3-PA,2068,60,0,0,0,60,A
3-PA,2069,0,60,0,0,60,T
3-PA,2070,0,60,0,0,60,T
3-PA,2071,0,0,60,0,60,G
3-PA,2072,59,0,0,0,59,A
3-PA,2073,0,0,59,0,59,G
3-PA,2074,0,0,59,0,59,G
3-PA,2075,55,0,0,0,55,A
3-PA,2076,0,0,55,0,55,G
3-PA,2077,0,53,0,0,53,T
3-PA,2078,0,0,53,0,53,G
3-PA,2079,0,0,0,53,53,C
3-PA,2080,0,0,0,53,53,C
3-PA,2081,0,52,0,0,52,T
3-PA,2082,0,0,52,0,52,G
3-PA,2083,52,0,0,0,52,A
3-PA,2084,0,52,0,0,52,T
3-PA,2085,0,49,0,0,49,T
3-PA,2086,48,0,0,0,48,A
3-PA,2087,48,0,0,0,48,A
3-PA,2088,0,48,0,0,48,T
3-PA,2089,0,1,47,0,48,G
3-PA,2090,48,0,0,0,48,A
3-PA,2091,0,46,0,0,46,T
3-PA,2092,0,0,0,46,46,C
3-PA,2093,0,0,0,46,46,C
3-PA,2094,0,0,0,46,46,C
3-PA,2095,0,46,0,0,46,T
3-PA,2096,0,0,46,0,46,G
3-PA,2097,0,0,46,0,46,G
3-PA,2098,0,0,48,0,48,G
3-PA,2099,0,48,0,0,48,T
3-PA,2100,0,46,0,0,46,T
3-PA,2101,0,46,0,0,46,T
3-PA,2102,0,44,0,0,44,T
3-PA,2103,0,0,45,0,45,G
3-PA,2104,0,0,0,45,45,C
3-PA,2105,0,45,0,0,45,T
3-PA,2106,0,0,0,45,45,C
3-PA,2107,43,0,0,0,43,A
3-PA,2108,43,0,0,0,43,A
3-PA,2109,0,43,0,0,43,T
3-PA,2110,0,0,43,0,43,G
3-PA,2111,1,0,0,42,43,C
3-PA,2112,0,0,42,0,42,G
3-PA,2113,0,42,0,0,42,T
3-PA,2114,0,0,0,42,42,C
3-PA,2115,0,42,0,0,42,T
3-PA,2116,0,41,0,0,41,T
3-PA,2117,0,0,40,0,40,G
3-PA,2118,0,0,40,0,40,G
3-PA,2119,0,40,0,0,40,T
3-PA,2120,0,37,0,1,38,T
3-PA,2121,0,0,0,37,37,C
3-PA,2122,36,0,0,0,36,A
3-PA,2123,36,0,0,0,36,A
3-PA,2124,0,0,0,36,36,C
3-PA,2125,0,34,0,1,35,T
3-PA,2126,0,0,0,35,35,C
3-PA,2127,0,0,0,33,33,C
3-PA,2128,0,33,0,0,33,T
3-PA,2129,0,33,0,0,33,T
3-PA,2130,0,0,0,33,33,C
3-PA,2131,0,0,0,33,33,C
3-PA,2132,0,32,0,0,32,T
3-PA,2133,0,0,32,0,32,G
3-PA,2134,31,0,1,0,32,A
3-PA,2135,0,0,0,32,32,C
3-PA,2136,30,0,0,0,30,A
3-PA,2137,0,0,0,27,27,C
3-PA,2138,26,0,0,0,26,A
3-PA,2139,0,25,0,0,25,T
3-PA,2140,0,0,25,0,25,G
3-PA,2141,0,0,0,25,25,C
3-PA,2142,25,0,0,0,25,A
3-PA,2143,0,25,0,0,25,T
3-PA,2144,0,24,0,0,24,T
3-PA,2145,24,0,0,0,24,A
3-PA,2146,24,0,0,0,24,A
3-PA,2147,24,0,0,0,24,A
3-PA,2148,24,0,0,0,24,A
3-PA,2149,0,24,0,0,24,T
3-PA,2150,15,0,0,0,15,A
3-PA,2151,0,0,15,0,15,G
4-HA,1,423,0,0,0,423,A
4-HA,2,0,426,0,0,426,T
4-HA,3,0,0,435,0,435,G
4-HA,4,440,0,0,0,440,A
4-HA,5,445,0,0,0,445,A
4-HA,6,0,2,480,0,482,G
4-HA,7,483,0,0,0,483,A
4-HA,8,0,0,0,540,540,C
4-HA,9,0,546,0,1,547,T
4-HA,10,573,0,0,0,573,A
4-HA,11,0,600,0,1,601,T
4-HA,12,0,0,0,603,603,C
4-HA,13,604,0,0,1,605,A
4-HA,14,0,606,0,0,606,T
4-HA,15,0,606,0,0,606,T
4-HA,16,1,1,652,0,654,G
4-HA,17,0,0,0,653,653,C
4-HA,18,0,659,1,0,660,T
4-HA,19,0,659,0,0,659,T
4-HA,20,0,659,0,2,661,T
4-HA,21,0,2,701,0,703,G
4-HA,22,704,0,0,0,704,A
4-HA,23,0,1,727,0,728,G
4-HA,24,1,0,0,728,729,C
4-HA,25,0,728,0,1,729,T
4-HA,26,799,0,0,0,799,A
4-HA,27,0,1,0,813,814,C
4-HA,28,832,0,0,0,832,A
4-HA,29,0,892,0,0,892,T
4-HA,30,0,890,0,0,890,T
4-HA,31,3,0,0,906,909,C
4-HA,32,0,906,0,1,907,T
4-HA,33,930,0,1,0,931,A
4-HA,34,0,931,0,2,933,T
4-HA,35,1,0,937,0,938,G
4-HA,36,0,936,0,1,937,T
4-HA,37,4,0,0,932,936,C
4-HA,38,0,929,0,4,933,T
4-HA,39,0,7,926,0,933,G
4-HA,40,1,0,939,0,940,G
4-HA,41,0,938,0,0,938,T
4-HA,42,0,939,0,1,940,T
4-HA,43,0,938,0,0,938,T
4-HA,44,0,937,0,1,938,T
4-HA,45,5,1,0,929,935,C
4-HA,46,1,1,934,0,936,G
4-HA,47,1,1,0,949,951,C
4-HA,48,0,946,0,1,947,T
4-HA,49,4,0,0,951,955,C
4-HA,50,955,0,0,0,955,A
4-HA,51,955,0,0,0,955,A
4-HA,52,951,1,1,0,953,A
4-HA,53,955,0,0,0,955,A
4-HA,54,959,0,0,0,959,A
4-HA,55,1,0,0,964,965,C
4-HA,56,0,963,0,0,963,T
4-HA,57,0,967,1,0,968,T
4-HA,58,3,0,0,962,965,C
4-HA,59,4,0,0,961,965,C
4-HA,60,0,963,0,2,965,T
4-HA,61,1,6,967,0,974,G
4-HA,62,0,2,984,0,986,G
4-HA,63,986,0,1,0,987,A
4-HA,64,995,0,0,1,996,A
4-HA,65,1000,0,0,0,1000,A
4-HA,66,0,1014,0,0,1014,T
4-HA,67,0,14,1007,0,1021,G
4-HA,68,1023,0,0,0,1023,A
4-HA,69,0,1,0,1035,1036,C
4-HA,70,1033,1,0,0,1034,A
4-HA,71,1036,0,0,0,1036,A
4-HA,72,0,0,0,1057,1057,C
4-HA,73,1052,0,0,0,1052,A
4-HA,74,0,4,1059,0,1063,G
4-HA,75,1,1,1,1061,1064,C
4-HA,76,1060,0,3,0,1063,A
4-HA,77,0,6,0,1080,1086,C
4-HA,78,0,7,1072,1,1080,G
4-HA,79,1,2,1092,0,1095,G
4-HA,80,0,0,0,1097,1097,C
4-HA,81,1085,0,3,0,1088,A
4-HA,82,1102,0,1,0,1103,A
4-HA,83,1,1,0,1112,1114,C
4-HA,84,2,0,1122,0,1124,G
4-HA,85,0,0,0,1131,1131,C
4-HA,86,0,1122,0,1,1123,T
4-HA,87,1,2,1131,0,1134,G
4-HA,88,0,1133,0,1,1134,T
4-HA,89,1,1,1161,0,1163,G
4-HA,90,0,0,0,1185,1185,C
4-HA,91,6,0,0,1204,1210,C
4-HA,92,1,1203,0,0,1204,T
4-HA,93,2,1197,0,0,1199,T
4-HA,94,0,8,1201,1,1210,G
4-HA,95,1,8,1209,0,1218,G
4-HA,96,0,2,1231,0,1233,G
4-HA,97,1,1,0,1233,1235,C
4-HA,98,1219,0,0,0,1219,A
4-HA,99,0,1,0,1236,1237,C
4-HA,100,8,0,0,1219,1227,C
4-HA,101,1308,0,4,0,1312,A
4-HA,102,0,1320,0,2,1322,T
4-HA,103,0,1,1323,0,1324,G
4-HA,104,1,1,0,1321,1323,C
4-HA,105,1301,1,0,0,1302,A
4-HA,106,0,0,1381,0,1381,G
4-HA,107,0,1374,0,2,1376,T
4-HA,108,1377,0,1,0,1378,A
4-HA,109,1,0,0,1378,1379,C
4-HA,110,10,0,0,1337,1347,C
4-HA,111,1356,0,1,0,1357,A
4-HA,112,1353,0,0,0,1353,A
4-HA,113,1354,1,0,0,1355,A
4-HA,114,1,3,0,1363,1367,C
4-HA,115,1,4,1328,0,1333,G
4-HA,116,0,11,1387,0,1398,G
4-HA,117,1390,0,1,0,1391,A
4-HA,118,1386,1,3,0,1390,A
4-HA,119,1,0,0,1389,1390,C
4-HA,120,1375,0,0,0,1375,A
4-HA,121,1414,0,0,0,1414,A
4-HA,122,0,1416,0,0,1416,T
4-HA,123,1434,0,0,0,1434,A
4-HA,124,1,0,1441,0,1442,G
4-HA,125,0,1413,0,1,1414,T
4-HA,126,0,11,1403,0,1414,G
4-HA,127,1409,0,1,0,1410,A
4-HA,128,1412,0,0,0,1412,A
4-HA,129,1407,0,6,0,1413,A
4-HA,130,1414,0,1,0,1415,A
4-HA,131,1,0,0,1433,1434,C
4-HA,132,1436,1,0,0,1437,A
4-HA,133,1444,0,1,0,1445,A
4-HA,134,0,1435,0,1,1436,T
4-HA,135,13,0,0,1427,1440,C
4-HA,136,1443,1,1,0,1445,A
4-HA,137,1,1,0,1448,1450,C
4-HA,138,2,9,1434,0,1445,G
4-HA,139,1442,0,1,0,1443,A
4-HA,140,1440,0,0,0,1440,A
4-HA,141,0,1439,0,0,1439,T
4-HA,142,0,26,1408,0,1434,G
4-HA,143,1436,0,5,0,1441,A
4-HA,144,2,1,0,1436,1439,C
4-HA,145,8,4,0,1432,1444,C
4-HA,146,1461,1,0,0,1462,A
4-HA,147,1467,0,1,0,1468,A
4-HA,148,1472,0,0,0,1472,A
4-HA,149,0,1469,0,0,1469,T
4-HA,150,0,1469,0,0,1469,T
4-HA,151,1,5,1469,0,1475,G
4-HA,152,1470,0,0,0,1470,A
4-HA,153,1472,0,2,1,1475,A
4-HA,154,0,0,1488,2,1490,G
4-HA,155,0,1486,0,0,1486,T
4-HA,156,0,1526,0,1,1527,T
4-HA,157,1533,1,0,0,1534,A
4-HA,158,0,1,0,1539,1540,C
4-HA,159,0,1544,0,1,1545,T
4-HA,160,1548,0,1,1,1550,A
4-HA,161,1578,0,3,0,1581,A
4-HA,162,0,1585,0,0,1585,T
4-HA,163,0,1,1585,0,1586,G
4-HA,164,0,2,0,1638,1640,C
4-HA,165,0,1614,0,1,1615,T
4-HA,166,1618,0,1,0,1619,A
4-HA,167,1,1,0,1623,1625,C
4-HA,168,1,1607,0,1,1609,T
4-HA,169,0,11,1604,1,1616,G
4-HA,170,1592,1,0,1,1594,A
4-HA,171,0,0,1602,0,1602,G
4-HA,172,2,1,0,1601,1604,C
4-HA,173,0,1567,0,0,1567,T
4-HA,174,0,3,1621,0,1624,G
4-HA,175,2,1,1656,0,1659,G
4-HA,176,0,1657,0,0,1657,T
4-HA,177,0,1658,0,1,1659,T
4-HA,178,18,0,0,1636,1654,C
4-HA,179,1646,0,3,0,1649,A
4-HA,180,0,18,1641,0,1659,G
4-HA,181,1655,0,1,1,1657,A
4-HA,182,0,0,1699,0,1699,G
4-HA,183,0,1680,0,2,1682,T
4-HA,184,0,1659,0,1,1660,T
4-HA,185,10,1,0,1665,1676,C
4-HA,186,5,0,0,1678,1683,C
4-HA,187,1,1674,0,2,1677,T
4-HA,188,5,0,0,1683,1688,C
4-HA,189,1677,1,1,0,1679,A
4-HA,190,1681,0,1,0,1682,A
4-HA,191,0,1,0,1690,1691,C
4-HA,192,1662,0,1,0,1663,A
4-HA,193,1,5,1690,0,1696,G
4-HA,194,0,1,1699,0,1700,G
4-HA,195,0,1691,0,1,1692,T
4-HA,196,0,12,1686,0,1698,G
4-HA,197,1698,0,2,0,1700,A
4-HA,198,1703,0,3,0,1706,A
4-HA,199,1756,0,2,0,1758,A
4-HA,200,0,1750,0,2,1752,T
4-HA,201,1768,0,1,0,1769,A
4-HA,202,1,1735,0,0,1736,T
4-HA,203,1,2,1730,1,1734,G
4-HA,204,0,3,0,1745,1748,C
4-HA,205,3,23,1717,0,1743,G
4-HA,206,1752,0,1,0,1753,A
4-HA,207,1,0,0,1752,1753,C
4-HA,208,1712,0,0,0,1712,A
4-HA,209,0,4,1799,0,1803,G
4-HA,210,0,1791,0,4,1795,T
4-HA,211,6,0,0,1800,1806,C
4-HA,212,9,0,0,1799,1808,C
4-HA,213,0,1791,0,0,1791,T
4-HA,214,10,0,0,1821,1831,C
4-HA,215,1830,1,0,0,1831,A
4-HA,216,0,1832,0,1,1833,T
4-HA,217,6,4,0,1826,1836,C
4-HA,218,1748,0,1,0,1749,A
4-HA,219,0,6,1756,0,1762,G
4-HA,220,1752,0,1,0,1753,A
4-HA,221,0,1747,0,2,1749,T
4-HA,222,7,0,2,1751,1760,C
4-HA,223,4,0,0,1746,1750,C
4-HA,224,0,1756,0,0,1756,T
4-HA,225,0,1757,0,1,1758,T
4-HA,226,0,4,1756,0,1760,G
4-HA,227,1759,1,1,1,1762,A
4-HA,228,0,1754,0,0,1754,T
4-HA,229,1,6,1747,0,1754,G
4-HA,230,0,11,1747,1,1759,G
4-HA,231,1724,0,1,0,1725,A
4-HA,232,0,6,1722,0,1728,G
4-HA,233,1694,2,2,0,1698,A
4-HA,234,1,18,1677,0,1696,G
4-HA,235,1736,0,1,0,1737,A
4-HA,236,1742,1,3,0,1746,A
4-HA,237,1,0,0,1750,1751,C
4-HA,238,0,1732,0,1,1733,T
4-HA,239,0,1,1785,0,1786,G
4-HA,240,2,2,0,1779,1783,C
4-HA,241,1783,0,3,1,1787,A
4-HA,242,0,2,1,1830,1833,C
4-HA,243,1822,0,0,0,1822,A
4-HA,244,4,2,0,2029,2035,C
4-HA,245,0,2023,0,0,2023,T
4-HA,246,2046,0,0,0,2046,A
4-HA,247,2044,0,1,1,2046,A
4-HA,248,0,2042,0,0,2042,T
4-HA,249,2029,2,1,0,2032,A
4-HA,250,0,3,2033,0,2036,G
4-HA,251,1994,0,0,0,1994,A
4-HA,252,0,1972,0,0,1972,T
4-HA,253,0,4,1894,0,1898,G
4-HA,254,0,0,0,1924,1924,C
4-HA,255,1,1904,0,2,1907,T
4-HA,256,17,0,0,2031,2048,C
4-HA,257,1,2050,0,0,2051,T
4-HA,258,2097,0,0,0,2097,A
4-HA,259,1,2101,0,1,2103,T
4-HA,260,1,2086,0,1,2088,T
4-HA,261,1,16,2077,1,2095,G
4-HA,262,1,7,2077,0,2085,G
4-HA,263,0,6,2082,0,2088,G
4-HA,264,2052,0,2,1,2055,A
4-HA,265,0,19,2012,0,2031,G
4-HA,266,1977,0,4,0,1981,A
4-HA,267,4,0,1,2118,2123,C
4-HA,268,9,2,0,2150,2161,C
4-HA,269,8,2,0,2172,2182,C
4-HA,270,0,2180,0,2,2182,T
4-HA,271,10,2,0,2188,2200,C
4-HA,272,2204,0,0,0,2204,A
4-HA,273,1945,0,253,0,2198,A
4-HA,274,2,2249,0,2,2253,T
4-HA,275,1,9,2260,0,2270,G
4-HA,276,1,2276,0,1,2278,T
4-HA,277,0,13,2246,1,2260,G
4-HA,278,2240,8,4,0,2252,A
4-HA,279,0,2240,0,4,2244,T
4-HA,280,0,13,2225,0,2238,G
4-HA,281,0,0,2240,0,2240,G
4-HA,282,1,0,0,2235,2236,C
4-HA,283,0,2239,0,3,2242,T
4-HA,284,0,2233,0,1,2234,T
4-HA,285,7,0,2,2228,2237,C
4-HA,286,7,1,0,2229,2237,C
4-HA,287,2241,0,0,0,2241,A
4-HA,288,2250,1,1,0,2252,A
4-HA,289,2244,2,0,0,2246,A
4-HA,290,2249,0,0,1,2250,A
4-HA,291,0,2253,0,0,2253,T
4-HA,292,2247,0,0,0,2247,A
4-HA,293,2250,0,0,0,2250,A
4-HA,294,1,12,2248,0,2261,G
4-HA,295,2269,1,0,1,2271,A
4-HA,296,2274,0,1,0,2275,A
4-HA,297,2278,2,1,0,2281,A
4-HA,298,1,2274,1,1,2277,T
4-HA,299,1,8,2274,1,2284,G
4-HA,300,1,10,2265,0,2276,G
4-HA,301,0,15,2258,1,2274,G
4-HA,302,2277,0,3,0,2280,A
4-HA,303,1,0,0,2294,2295,C
4-HA,304,10,0,0,2276,2286,C
4-HA,305,0,2311,0,3,2314,T
4-HA,306,0,2310,1,1,2312,T
4-HA,307,0,2309,0,2,2311,T
4-HA,308,1,2325,0,2,2328,T
4-HA,309,1,2327,0,0,2328,T
4-HA,310,1,1,2343,0,2345,G
4-HA,311,0,2335,2,4,2341,T
4-HA,312,0,2325,1,0,2326,T
4-HA,313,8,15,2303,1,2327,G
4-HA,314,2308,1,1,1,2311,A
4-HA,315,2307,0,1,1,2309,A
4-HA,316,1,1,0,2317,2319,C
4-HA,317,0,4,2295,1,2300,G
4-HA,318,2,0,1,2333,2336,C
4-HA,319,2326,1,3,0,2330,A
4-HA,320,0,1,2333,0,2334,G
4-HA,321,2,0,0,2332,2334,C
4-HA,322,2331,0,1,1,2333,A
4-HA,323,2326,0,1,2,2329,A
4-HA,324,2335,0,4,2,2341,A
4-HA,325,0,2,2441,0,2443,G
4-HA,326,4,2,0,2437,2443,C
4-HA,327,7,0,0,2420,2427,C
4-HA,328,0,2433,0,2,2435,T
4-HA,329,2432,0,2,0,2434,A
4-HA,330,1,0,0,2460,2461,C
4-HA,331,2459,0,1,0,2460,A
4-HA,332,0,1,2462,0,2463,G
4-HA,333,2,0,0,2444,2446,C
4-HA,334,2388,0,0,0,2388,A
4-HA,335,2415,0,1,0,2416,A
4-HA,336,0,1,0,2497,2498,C
4-HA,337,0,2472,0,1,2473,T
4-HA,338,2,3,2487,0,2492,G
4-HA,339,0,2469,0,1,2470,T
4-HA,340,0,2467,0,0,2467,T
4-HA,341,2472,0,3,1,2476,A
4-HA,342,4,1,0,2624,2629,C
4-HA,343,8,2,0,2622,2632,C
4-HA,344,17,1,0,2679,2697,C
4-HA,345,0,2603,0,1,2604,T
4-HA,346,0,2598,0,2,2600,T
4-HA,347,2611,2,0,0,2613,A
4-HA,348,0,2612,0,1,2613,T
4-HA,349,1,8,2601,0,2610,G
4-HA,350,2601,0,5,1,2607,A
4-HA,351,0,2430,0,0,2430,T
4-HA,352,1,2,2457,0,2460,G
4-HA,353,0,2403,0,0,2403,T
4-HA,354,1,0,2405,0,2406,G
4-HA,355,1,1,0,2410,2412,C
4-HA,356,11,3,0,2384,2398,C
4-HA,357,4,3,2449,1,2457,G
4-HA,358,0,15,2475,0,2490,G
4-HA,359,2487,0,1,0,2488,A
4-HA,360,0,2487,0,0,2487,T
4-HA,361,0,2448,0,0,2448,T
4-HA,362,2469,0,0,0,2469,A
4-HA,363,1,2461,0,1,2463,T
4-HA,364,0,0,2472,0,2472,G
4-HA,365,2,2,1,2471,2476,C
4-HA,366,9,0,0,2431,2440,C
4-HA,367,1,2471,0,1,2473,T
4-HA,368,8,1,0,2566,2575,C
4-HA,369,13,0,1,2577,2591,C
4-HA,370,26,1,1,2569,2597,C
4-HA,371,1,2578,0,1,2580,T
4-HA,372,0,2583,0,2,2585,T
4-HA,373,2580,0,1,0,2581,A
4-HA,374,0,10,2630,0,2640,G
4-HA,375,1,6,2638,0,2645,G
4-HA,376,1,2613,0,0,2614,T
4-HA,377,27,1,0,2524,2552,C
4-HA,378,2512,0,1,1,2514,A
4-HA,379,1,1,0,2574,2576,C
4-HA,380,0,2574,0,3,2577,T
4-HA,381,2567,0,4,1,2572,A
4-HA,382,1,0,2574,0,2575,G
4-HA,383,2,2528,0,4,2534,T
4-HA,384,0,2516,0,2,2518,T
4-HA,385,4,0,2548,0,2552,G
4-HA,386,1,0,0,2545,2546,C
4-HA,387,12,0,0,2539,2551,C
4-HA,388,2,2514,0,4,2520,T
4-HA,389,10,0,0,2529,2539,C
4-HA,390,2617,0,1,2,2620,A
4-HA,391,0,2619,0,0,2619,T
4-HA,392,7,0,1,2610,2618,C
4-HA,393,6,7,0,2606,2619,C
4-HA,394,1,17,2575,0,2593,G
4-HA,395,6,0,2591,0,2597,G
4-HA,396,2,1,0,2604,2607,C
4-HA,397,2624,0,1,0,2625,A
4-HA,398,4,2,0,2666,2672,C
4-HA,399,2622,1,2,0,2625,A
4-HA,400,1,1,0,2640,2642,C
4-HA,401,0,2631,1,4,2636,T
4-HA,402,3,6,2654,0,2663,G
4-HA,403,0,14,2672,0,2686,G
4-HA,404,2656,0,4,0,2660,A
4-HA,405,1,2,2687,0,2690,G
4-HA,406,0,2670,0,2,2672,T
4-HA,407,2,2646,1,1,2650,T
4-HA,408,0,2655,0,6,2661,T
4-HA,409,2646,0,2,0,2648,A
4-HA,410,2653,0,4,0,2657,A
4-HA,411,2,1,0,2673,2676,C
4-HA,412,2612,0,0,0,2612,A
4-HA,413,2615,0,5,0,2620,A
4-HA,414,0,2592,0,0,2592,T
4-HA,415,0,15,2578,0,2593,G
4-HA,416,2590,0,1,0,2591,A
4-HA,417,2585,5,1,0,2591,A
4-HA,418,2590,2,5,0,2597,A
4-HA,419,1,2,2617,0,2620,G
4-HA,420,3,0,0,2628,2631,C
4-HA,421,1,2613,1,5,2620,T
4-HA,422,0,2619,1,1,2621,T
4-HA,423,11,0,0,2633,2644,C
4-HA,424,2646,1,0,2,2649,A
4-HA,425,2651,1,0,0,2652,A
4-HA,426,0,2652,0,1,2653,T
4-HA,427,0,2648,0,1,2649,T
4-HA,428,4,12,2689,0,2705,G
4-HA,429,2,21,2702,0,2725,G
4-HA,430,2720,0,1,0,2721,A
4-HA,431,2,0,1,2720,2723,C
4-HA,432,0,2688,1,4,2693,T
4-HA,433,1,3,2698,0,2702,G
4-HA,434,2,10,2707,0,2719,G
4-HA,435,2712,1,4,0,2717,A
4-HA,436,0,1,2719,0,2720,G
4-HA,437,0,2651,2,3,2656,T
4-HA,438,17,0,0,2629,2646,C
4-HA,439,2672,0,3,0,2675,A
4-HA,440,0,1,0,2691,2692,C
4-HA,441,1,2678,0,1,2680,T
4-HA,442,19,0,0,2663,2682,C
4-HA,443,2652,0,1,0,2653,A
4-HA,444,2666,0,0,0,2666,A
4-HA,445,2663,0,1,0,2664,A
4-HA,446,2663,1,3,0,2667,A
4-HA,447,0,6,0,2667,2673,C
4-HA,448,3,8,2626,1,2638,G
4-HA,449,0,26,2649,0,2675,G
4-HA,450,2673,1,2,0,2676,A
4-HA,451,2675,0,1,1,2677,A
4-HA,452,2,3,0,2676,2681,C
4-HA,453,2657,2,1,0,2660,A
4-HA,454,2684,1,0,0,2685,A
4-HA,455,1,2,2711,0,2714,G
4-HA,456,0,1,0,2711,2712,C
4-HA,457,1,2683,1,4,2689,T
4-HA,458,13,1,0,2695,2709,C
4-HA,459,1,2692,0,3,2696,T
4-HA,460,2,1,2711,0,2714,G
4-HA,461,1,1,0,2711,2713,C
4-HA,462,0,2712,0,2,2714,T
4-HA,463,0,2756,2,4,2762,T
4-HA,464,2,3,2811,0,2816,G
4-HA,465,3,3,0,2824,2830,C
4-HA,466,2829,0,2,0,2831,A
4-HA,467,0,2812,0,3,2815,T
4-HA,468,2812,0,1,0,2813,A
4-HA,469,2796,0,1,0,2797,A
4-HA,470,0,8,2796,0,2804,G
4-HA,471,0,11,2799,0,2810,G
4-HA,472,2695,0,4,0,2699,A
4-HA,473,0,11,2665,0,2676,G
4-HA,474,2659,1,2,0,2662,A
4-HA,475,1,2752,0,0,2753,T
4-HA,476,9,1,0,2780,2790,C
4-HA,477,0,2800,0,2,2802,T
4-HA,478,2809,0,0,0,2809,A
4-HA,479,2805,0,3,0,2808,A
4-HA,480,0,2800,0,0,2800,T
4-HA,481,2797,0,2,0,2799,A
4-HA,482,2779,1,3,0,2783,A
4-HA,483,0,0,1,2797,2798,C
4-HA,484,2704,1,0,0,2705,A
4-HA,485,1,1,2740,0,2742,G
4-HA,486,2,2679,0,1,2682,T
4-HA,487,0,2712,1,1,2714,T
4-HA,488,0,2712,2,3,2717,T
4-HA,489,3,0,0,2775,2778,C
4-HA,490,1,2763,2,2,2768,T
4-HA,491,1,2778,2,0,2781,T
4-HA,492,0,2778,0,0,2778,T
4-HA,493,2750,1,3,0,2754,A
4-HA,494,1,2,2749,0,2752,G
4-HA,495,0,2742,0,1,2743,T
4-HA,496,2736,1,1,0,2738,A
4-HA,497,0,8,2735,0,2743,G
4-HA,498,2679,0,2,0,2681,A
4-HA,499,1,2690,0,0,2691,T
4-HA,500,0,2678,0,2,2680,T
4-HA,501,4,24,2695,0,2723,G
4-HA,502,2721,0,0,0,2721,A
4-HA,503,2721,0,1,0,2722,A
4-HA,504,0,2718,0,0,2718,T
4-HA,505,0,2683,0,1,2684,T
4-HA,506,1,16,2694,0,2711,G
4-HA,507,0,0,2708,0,2708,G
4-HA,508,0,2712,0,3,2715,T
4-HA,509,2,2703,1,1,2707,T
4-HA,510,2,20,2638,0,2660,G
4-HA,511,2664,1,1,0,2666,A
4-HA,512,0,1,0,2655,2656,C
4-HA,513,7,2,1,2640,2650,C
4-HA,514,12,2,0,2638,2652,C
4-HA,515,2634,1,0,1,2636,A
4-HA,516,0,0,0,2666,2666,C
4-HA,517,1,2659,0,3,2663,T
4-HA,518,0,2661,0,1,2662,T
4-HA,519,2661,1,0,1,2663,A
4-HA,520,2657,0,0,0,2657,A
4-HA,521,2654,0,2,0,2656,A
4-HA,522,2669,0,0,0,2669,A
4-HA,523,0,2712,0,1,2713,T
4-HA,524,0,2699,0,1,2700,T
4-HA,525,15,1,1,2686,2703,C
4-HA,526,2691,1,0,0,2692,A
4-HA,527,2695,0,3,1,2699,A
4-HA,528,2704,0,4,0,2708,A
4-HA,529,0,2707,0,0,2707,T
4-HA,530,2771,0,0,0,2771,A
4-HA,531,7,2,0,2763,2772,C
4-HA,532,10,0,0,2699,2709,C
4-HA,533,11,2,0,2708,2721,C
4-HA,534,2699,0,2,0,2701,A
4-HA,535,2,0,2833,0,2835,G
4-HA,536,2,4,0,2839,2845,C
4-HA,537,2836,1,2,1,2840,A
4-HA,538,0,2829,0,3,2832,T
4-HA,539,1,2763,1,3,2768,T
4-HA,540,0,21,2837,0,2858,G
4-HA,541,2862,0,1,0,2863,A
4-HA,542,2860,0,4,0,2864,A
4-HA,543,1,2,0,2859,2862,C
4-HA,544,2,1,2785,0,2788,G
4-HA,545,0,2784,0,3,2787,T
4-HA,546,2,29,2770,0,2801,G
4-HA,547,2796,0,6,0,2802,A
4-HA,548,0,1,0,2810,2811,C
4-HA,549,0,2715,0,0,2715,T
4-HA,550,2768,1,0,1,2770,A
4-HA,551,0,2767,0,2,2769,T
4-HA,552,3,2,2791,0,2796,G
4-HA,553,3,2,0,2787,2792,C
4-HA,554,11,3,1,2749,2764,C
4-HA,555,2749,0,4,0,2753,A
4-HA,556,2750,0,1,0,2751,A
4-HA,557,2790,0,2,0,2792,A
4-HA,558,3,1,0,2797,2801,C
4-HA,559,2735,0,2,0,2737,A
4-HA,560,2742,1,1,0,2744,A
4-HA,561,0,2721,0,0,2721,T
4-HA,562,1,29,2693,0,2723,G
4-HA,563,2720,1,0,0,2721,A
4-HA,564,2717,0,2,0,2719,A
4-HA,565,2,2,0,2655,2659,C
4-HA,566,2684,0,0,0,2684,A
4-HA,567,2714,0,0,0,2714,A
4-HA,568,1,2701,0,1,2703,T
4-HA,569,1,2714,0,1,2716,T
4-HA,570,0,2718,0,3,2721,T
4-HA,571,0,25,2692,2,2719,G
4-HA,572,2718,4,1,0,2723,A
4-HA,573,1,1,0,2728,2730,C
4-HA,574,2727,1,0,0,2728,A
4-HA,575,2732,0,1,0,2733,A
4-HA,576,2753,0,0,0,2753,A
4-HA,577,0,2781,0,0,2781,T
4-HA,578,0,2752,0,0,2752,T
4-HA,579,1,1,2770,0,2772,G
4-HA,580,0,2762,0,1,2763,T
4-HA,581,2772,0,1,0,2773,A
4-HA,582,1,1,1,2842,2845,C
4-HA,583,2849,0,0,0,2849,A
4-HA,584,0,2910,0,0,2910,T
4-HA,585,0,2863,2,1,2866,T
4-HA,586,0,2852,1,0,2853,T
4-HA,587,0,14,2817,1,2832,G
4-HA,588,2,15,2817,0,2834,G
4-HA,589,0,22,2802,1,2825,G
4-HA,590,2,29,2806,0,2837,G
4-HA,591,0,16,2770,0,2786,G
4-HA,592,1,1,2847,0,2849,G
4-HA,593,2,2805,0,2,2809,T
4-HA,594,0,2811,0,2,2813,T
4-HA,595,22,1,0,2796,2819,C
4-HA,596,2819,0,5,0,2824,A
4-HA,597,0,0,1,2854,2855,C
4-HA,598,8,1,0,2842,2851,C
4-HA,599,2845,0,0,0,2845,A
4-HA,600,1,0,0,2873,2874,C
4-HA,601,4,0,0,2833,2837,C
4-HA,602,17,2,1,2798,2818,C
4-HA,603,2,19,2801,0,2822,G
4-HA,604,0,9,2917,0,2926,G
4-HA,605,1,1,2934,0,2936,G
4-HA,606,2,2910,0,5,2917,T
4-HA,607,2917,0,0,0,2917,A
4-HA,608,1,7,0,2889,2897,C
4-HA,609,7,18,2844,1,2870,G
4-HA,610,1,15,2875,1,2892,G
4-HA,611,2892,2,3,0,2897,A
4-HA,612,0,1,0,2883,2884,C
4-HA,613,2742,0,1,0,2743,A
4-HA,614,2747,0,1,0,2748,A
4-HA,615,1,2750,0,0,2751,T
4-HA,616,2,28,2759,0,2789,G
4-HA,617,2789,1,3,1,2794,A
4-HA,618,2,0,0,2785,2787,C
4-HA,619,16,2,1,2730,2749,C
4-HA,620,2746,0,2,0,2748,A
4-HA,621,2751,0,1,0,2752,A
4-HA,622,2792,0,1,0,2793,A
4-HA,623,0,2785,0,1,2786,T
4-HA,624,10,0,0,2807,2817,C
4-HA,625,0,2693,0,1,2694,T
4-HA,626,0,2681,0,2,2683,T
4-HA,627,7,0,0,2704,2711,C
4-HA,628,3,0,0,2714,2717,C
4-HA,629,1,2704,0,4,2709,T
4-HA,630,1,1,2721,0,2723,G
4-HA,631,0,2673,0,2,2675,T
4-HA,632,2695,0,0,0,2695,A
4-HA,633,2,2669,0,3,2674,T
4-HA,634,0,2,2700,0,2702,G
4-HA,635,1,0,1,2709,2711,C
4-HA,636,2,2677,0,11,2690,T
4-HA,637,24,3,0,2661,2688,C
4-HA,638,2686,0,4,0,2690,A
4-HA,639,2683,0,4,0,2687,A
4-HA,640,0,2,2703,0,2705,G
4-HA,641,2,1,0,2707,2710,C
4-HA,642,2712,0,1,0,2713,A
4-HA,643,0,2689,0,0,2689,T
4-HA,644,8,0,0,2675,2683,C
4-HA,645,2674,0,4,0,2678,A
4-HA,646,1,9,2706,0,2716,G
4-HA,647,2,8,2714,0,2724,G
4-HA,648,2723,0,0,0,2723,A
4-HA,649,2696,0,5,0,2701,A
4-HA,650,2,16,2805,0,2823,G
4-HA,651,2807,1,3,0,2811,A
4-HA,652,2849,0,5,0,2854,A
4-HA,653,1,2878,0,0,2879,T
4-HA,654,18,1,1,2854,2874,C
4-HA,655,2856,1,0,1,2858,A
4-HA,656,0,2,0,2860,2862,C
4-HA,657,2847,0,1,0,2848,A
4-HA,658,0,0,2909,1,2910,G
4-HA,659,0,2849,0,1,2850,T
4-HA,660,22,1,0,2844,2867,C
4-HA,661,1,2818,0,4,2823,T
4-HA,662,15,0,0,2885,2900,C
4-HA,663,1,2908,0,2,2911,T
4-HA,664,2942,2,1,0,2945,A
4-HA,665,3,1,0,2940,2944,C
4-HA,666,16,4,1,2920,2941,C
4-HA,667,2888,0,0,2,2890,A
4-HA,668,2900,3,1,0,2904,A
4-HA,669,2884,1,5,0,2890,A
4-HA,670,2897,0,3,0,2900,A
4-HA,671,1,7,2897,0,2905,G
4-HA,672,2836,1,1,0,2838,A
4-HA,673,2828,1,1,0,2830,A
4-HA,674,3,1,2846,0,2850,G
4-HA,675,6,1,0,2851,2858,C
4-HA,676,9,2,1,2846,2858,C
4-HA,677,2854,1,2,0,2857,A
4-HA,678,2851,9,2,0,2862,A
4-HA,679,2,1,0,2862,2865,C
4-HA,680,2863,0,1,0,2864,A
4-HA,681,2854,0,2,8,2864,A
4-HA,682,2860,0,2,0,2862,A
4-HA,683,2,0,0,2925,2927,C
4-HA,684,0,2917,0,2,2919,T
4-HA,685,2,5,2918,0,2925,G
4-HA,686,1,2918,0,0,2919,T
4-HA,687,2907,0,0,1,2908,A
4-HA,688,2918,0,0,0,2918,A
4-HA,689,0,2908,0,2,2910,T
4-HA,690,12,2,0,2920,2934,C
4-HA,691,10,1,0,2920,2931,C
4-HA,692,13,3,0,2866,2882,C
4-HA,693,1,22,2860,0,2883,G
4-HA,694,2874,2,0,0,2876,A
4-HA,695,2881,0,0,0,2881,A
4-HA,696,0,2892,0,1,2893,T
4-HA,697,2895,0,0,0,2895,A
4-HA,698,2,2878,0,3,2883,T
4-HA,699,6,1,0,2853,2860,C
4-HA,700,2,11,2850,0,2863,G
4-HA,701,1,9,2918,0,2928,G
4-HA,702,2926,0,2,1,2929,A
4-HA,703,0,2944,0,1,2945,T
4-HA,704,8,2,0,2935,2945,C
4-HA,705,0,2935,0,0,2935,T
4-HA,706,2931,0,1,0,2932,A
4-HA,707,0,16,2931,1,2948,G
4-HA,708,2968,1,1,0,2970,A
4-HA,709,2,1,0,2956,2959,C
4-HA,710,13,0,0,2873,2886,C
4-HA,711,14,0,0,2871,2885,C
4-HA,712,2857,0,3,0,2860,A
4-HA,713,0,11,3019,0,3030,G
4-HA,714,3032,0,1,0,3033,A
4-HA,715,1,2,3076,1,3080,G
4-HA,716,0,3043,0,3,3046,T
4-HA,717,3029,0,0,0,3029,A
4-HA,718,3025,0,4,0,3029,A
4-HA,719,0,6,3078,0,3084,G
4-HA,720,0,15,3078,1,3094,G
4-HA,721,3051,0,0,1,3052,A
4-HA,722,2831,0,2,0,2833,A
4-HA,723,0,2837,0,0,2837,T
4-HA,724,2842,0,1,1,2844,A
4-HA,725,0,2831,0,1,2832,T
4-HA,726,13,2,2,2840,2857,C
4-HA,727,11,2,0,2834,2847,C
4-HA,728,17,2,0,2765,2784,C
4-HA,729,0,2747,0,9,2756,T
4-HA,730,2767,1,1,0,2769,A
4-HA,731,1,1,2775,0,2777,G
4-HA,732,1,1,0,2783,2785,C
4-HA,733,2711,0,3,0,2714,A
4-HA,734,2,16,2784,0,2802,G
4-HA,735,2771,0,0,0,2771,A
4-HA,736,2779,2,0,0,2781,A
4-HA,737,0,2773,0,0,2773,T
4-HA,738,2768,0,1,1,2770,A
4-HA,739,2782,0,2,0,2784,A
4-HA,740,0,3,2778,0,2781,G
4-HA,741,4,1,1,2781,2787,C
4-HA,742,2789,0,0,0,2789,A
4-HA,743,0,2719,0,4,2723,T
4-HA,744,3,0,1,2845,2849,C
4-HA,745,1,2838,0,1,2840,T
4-HA,746,2863,5,0,1,2869,A
4-HA,747,0,2868,0,2,2870,T
4-HA,748,0,2833,0,0,2833,T
4-HA,749,2,12,2855,0,2869,G
4-HA,750,0,17,2842,0,2859,G
4-HA,751,2850,0,5,0,2855,A
4-HA,752,2,1,0,2845,2848,C
4-HA,753,2678,1,2,0,2681,A
4-HA,754,2736,0,1,0,2737,A
4-HA,755,0,2853,0,2,2855,T
4-HA,756,2861,0,4,0,2865,A
4-HA,757,2,1,2889,0,2892,G
4-HA,758,1,2857,0,2,2860,T
4-HA,759,2852,0,2,1,2855,A
4-HA,760,2869,0,0,0,2869,A
4-HA,761,2886,0,1,0,2887,A
4-HA,762,2901,0,4,0,2905,A
4-HA,763,1,3,0,2902,2906,C
4-HA,764,10,3,0,2748,2761,C
4-HA,765,2,13,2736,0,2751,G
4-HA,766,0,5,2754,0,2759,G
4-HA,767,2,19,2760,0,2781,G
4-HA,768,2776,1,2,0,2779,A
4-HA,769,0,15,2782,0,2797,G
4-HA,770,2824,1,6,0,2831,A
4-HA,771,0,1,0,2832,2833,C
4-HA,772,2820,0,2,1,2823,A
4-HA,773,0,2826,0,1,2827,T
4-HA,774,2833,0,2,0,2835,A
4-HA,775,2,0,0,2865,2867,C
4-HA,776,0,2848,1,5,2854,T
4-HA,777,0,2859,0,3,2862,T
4-HA,778,0,2863,0,3,2866,T
4-HA,779,1,2845,0,2,2848,T
4-HA,780,0,22,2855,0,2877,G
4-HA,781,2882,0,2,3,2887,A
4-HA,782,0,2892,0,0,2892,T
4-HA,783,0,2941,1,0,2942,T
4-HA,784,2908,1,1,0,2910,A
4-HA,785,2924,1,1,0,2926,A
4-HA,786,1,2,0,2951,2954,C
4-HA,787,2942,1,1,0,2944,A
4-HA,788,1,9,3020,0,3030,G
4-HA,789,4,2,0,3014,3020,C
4-HA,790,3024,0,2,0,3026,A
4-HA,791,2,2,0,3036,3040,C
4-HA,792,2995,0,6,0,3001,A
4-HA,793,1,10,3042,0,3053,G
4-HA,794,1,11,3026,0,3038,G
4-HA,795,1,14,3097,1,3113,G
4-HA,796,3097,0,1,0,3098,A
4-HA,797,3102,0,8,0,3110,A
4-HA,798,0,3104,0,4,3108,T
4-HA,799,11,0,0,3107,3118,C
4-HA,800,0,3113,0,0,3113,T
4-HA,801,3125,0,1,0,3126,A
4-HA,802,3105,1,0,0,3106,A
4-HA,803,0,3098,0,1,3099,T
4-HA,804,0,3012,0,1,3013,T
4-HA,805,2,1,3029,0,3032,G
4-HA,806,0,2,0,3076,3078,C
4-HA,807,0,3164,0,3,3167,T
4-HA,808,27,3,0,3223,3253,C
4-HA,809,9,0,0,3242,3251,C
4-HA,810,1,3235,1,3,3240,T
4-HA,811,3244,0,1,0,3245,A
4-HA,812,1,10,3234,0,3245,G
4-HA,813,4,36,3219,3,3262,G
4-HA,814,0,18,3241,0,3259,G
4-HA,815,3,0,3210,0,3213,G
4-HA,816,0,3127,0,0,3127,T
4-HA,817,0,3096,0,0,3096,T
4-HA,818,3091,1,0,0,3092,A
4-HA,819,0,0,0,3140,3140,C
4-HA,820,0,3108,0,3,3111,T
4-HA,821,0,3136,0,3,3139,T
4-HA,822,6,0,0,3123,3129,C
4-HA,823,3104,0,1,1,3106,A
4-HA,824,3110,1,0,2,3113,A
4-HA,825,3122,2,0,0,3124,A
4-HA,826,3144,1,2,0,3147,A
4-HA,827,0,3144,1,0,3145,T
4-HA,828,3109,1,1,0,3111,A
4-HA,829,2,0,0,3108,3110,C
4-HA,830,2,8,3087,0,3097,G
4-HA,831,3100,0,0,0,3100,A
4-HA,832,3102,1,1,0,3104,A
4-HA,833,1,1,3143,0,3145,G
4-HA,834,0,3121,0,5,3126,T
4-HA,835,0,9,3141,0,3150,G
4-HA,836,1,8,3136,1,3146,G
4-HA,837,0,11,3150,0,3161,G
4-HA,838,3154,0,1,0,3155,A
4-HA,839,3156,0,0,1,3157,A
4-HA,840,3147,1,2,0,3150,A
4-HA,841,3141,0,7,0,3148,A
4-HA,842,0,1,3201,0,3202,G
4-HA,843,2,0,0,3181,3183,C
4-HA,844,0,3159,0,0,3159,T
4-HA,845,25,0,0,3177,3202,C
4-HA,846,3188,0,2,0,3190,A
4-HA,847,3217,1,0,1,3219,A
4-HA,848,1,3215,0,0,3216,T
4-HA,849,3235,0,2,0,3237,A
4-HA,850,3238,1,0,0,3239,A
4-HA,851,0,3159,0,2,3161,T
4-HA,852,0,27,3145,0,3172,G
4-HA,853,3137,0,2,0,3139,A
4-HA,854,0,8,3210,1,3219,G
4-HA,855,3214,0,3,0,3217,A
4-HA,856,0,3179,0,2,3181,T
4-HA,857,23,0,0,3222,3245,C
4-HA,858,3210,2,4,0,3216,A
4-HA,859,0,11,3265,0,3276,G
4-HA,860,3284,2,1,2,3289,A
4-HA,861,0,3265,0,2,3267,T
4-HA,862,4,2,3253,0,3259,G
4-HA,863,3,0,1,3196,3200,C
4-HA,864,3200,0,1,0,3201,A
4-HA,865,4,1,0,3250,3255,C
4-HA,866,7,2,0,3204,3213,C
4-HA,867,13,2,0,3203,3218,C
4-HA,868,3153,0,0,0,3153,A
4-HA,869,0,3138,0,1,3139,T
4-HA,870,1,3137,0,5,3143,T
4-HA,871,5,23,3150,0,3178,G
4-HA,872,1,4,3164,1,3170,G
4-HA,873,0,1,0,3169,3170,C
4-HA,874,3106,1,2,0,3109,A
4-HA,875,3099,0,0,1,3100,A
4-HA,876,3139,0,2,0,3141,A
4-HA,877,0,3141,0,2,3143,T
4-HA,878,2,5,3139,0,3146,G
4-HA,879,1,2,0,3142,3145,C
4-HA,880,3091,0,1,0,3092,A
4-HA,881,3168,0,3,0,3171,A
4-HA,882,0,3163,0,4,3167,T
4-HA,883,0,3192,0,1,3193,T
4-HA,884,16,2,0,3179,3197,C
4-HA,885,1,3113,0,6,3120,T
4-HA,886,1,13,3133,2,3149,G
4-HA,887,3137,0,0,0,3137,A
4-HA,888,3149,0,1,0,3150,A
4-HA,889,1,3149,0,1,3151,T
4-HA,890,2,2,3091,0,3095,G
4-HA,891,3,3,0,3102,3108,C
4-HA,892,3096,1,3,0,3100,A
4-HA,893,0,3096,0,2,3098,T
4-HA,894,11,1,0,3081,3093,C
4-HA,895,3084,0,6,0,3090,A
4-HA,896,0,1,0,3195,3196,C
4-HA,897,3,3175,0,3,3181,T
4-HA,898,17,0,0,3171,3188,C
4-HA,899,12,1,2,3158,3173,C
4-HA,900,3196,0,2,0,3198,A
4-HA,901,3195,0,2,0,3197,A
4-HA,902,3185,2,2,0,3189,A
4-HA,903,0,3048,1,1,3050,T
4-HA,904,0,14,3057,0,3071,G
4-HA,905,1,9,3077,0,3087,G
4-HA,906,3087,1,4,0,3092,A
4-HA,907,3080,1,4,0,3085,A
4-HA,908,0,2,3098,0,3100,G
4-HA,909,4,0,0,3057,3061,C
4-HA,910,3020,0,0,0,3020,A
4-HA,911,0,3032,1,2,3035,T
4-HA,912,0,3019,0,2,3021,T
4-HA,913,12,3,0,3095,3110,C
4-HA,914,7,1,0,3086,3094,C
4-HA,915,19,3,0,3077,3099,C
4-HA,916,3085,1,1,0,3087,A
4-HA,917,3109,0,1,12,3122,A
4-HA,918,0,3148,0,3,3151,T
4-HA,919,1,27,3124,0,3152,G
4-HA,920,3147,0,1,0,3148,A
4-HA,921,1,0,0,3144,3145,C
4-HA,922,3044,0,2,0,3046,A
4-HA,923,3051,0,0,0,3051,A
4-HA,924,3040,1,1,0,3042,A
4-HA,925,0,0,0,3056,3056,C
4-HA,926,20,2,0,3001,3023,C
4-HA,927,2968,0,0,0,2968,A
4-HA,928,2,2968,0,4,2974,T
4-HA,929,0,2962,0,5,2967,T
4-HA,930,19,1,0,2967,2987,C
4-HA,931,16,1,0,2965,2982,C
4-HA,932,2978,0,1,0,2979,A
4-HA,933,2972,0,1,1,2974,A
4-HA,934,2953,0,2,0,2955,A
4-HA,935,2993,1,0,0,2994,A
4-HA,936,1,2984,0,2,2987,T
4-HA,937,0,3,2972,1,2976,G
4-HA,938,0,2957,0,2,2959,T
4-HA,939,1,2942,0,0,2943,T
4-HA,940,2984,0,0,0,2984,A
4-HA,941,2984,1,0,0,2985,A
4-HA,942,1,0,0,2987,2988,C
4-HA,943,2959,1,1,0,2961,A
4-HA,944,0,10,2957,0,2967,G
4-HA,945,0,12,2979,0,2991,G
4-HA,946,3014,0,5,0,3019,A
4-HA,947,0,2994,0,4,2998,T
4-HA,948,23,1,0,3012,3036,C
4-HA,949,3043,0,4,0,3047,A
4-HA,950,0,1,1,3141,3143,C
4-HA,951,3133,0,0,0,3133,A
4-HA,952,0,3200,1,1,3202,T
4-HA,953,3128,0,1,0,3129,A
4-HA,954,2,6,1,3087,3096,C
4-HA,955,2,8,2964,0,2974,G
4-HA,956,2,13,2966,2,2983,G
4-HA,957,2,20,2930,0,2952,G
4-HA,958,2,1,2954,1,2958,G
4-HA,959,3,0,0,2874,2877,C
4-HA,960,14,2,1,2830,2847,C
4-HA,961,0,2774,0,3,2777,T
4-HA,962,0,0,2971,0,2971,G
4-HA,963,1,2970,0,2,2973,T
4-HA,964,14,0,0,2966,2980,C
4-HA,965,29,1,0,2945,2975,C
4-HA,966,13,0,0,2968,2981,C
4-HA,967,2967,0,2,0,2969,A
4-HA,968,0,9,2983,0,2992,G
4-HA,969,2987,1,2,0,2990,A
4-HA,970,1,2985,0,0,2986,T
4-HA,971,2757,0,2,0,2759,A
4-HA,972,0,2709,1,1,2711,T
4-HA,973,1,2,2718,1,2722,G
4-HA,974,1,2703,0,1,2705,T
4-HA,975,0,2645,0,1,2646,T
4-HA,976,2679,1,1,0,2681,A
4-HA,977,2636,0,1,0,2637,A
4-HA,978,0,15,2660,0,2675,G
4-HA,979,3,2,0,2663,2668,C
4-HA,980,2606,0,1,0,2607,A
4-HA,981,2602,0,2,0,2604,A
4-HA,982,2578,0,3,2,2583,A
4-HA,983,2592,0,3,1,2596,A
4-HA,984,2,1,0,2596,2599,C
4-HA,985,2542,0,2,0,2544,A
4-HA,986,0,0,0,2572,2572,C
4-HA,987,0,2513,0,1,2514,T
4-HA,988,14,0,1,2513,2528,C
4-HA,989,0,2526,1,1,2528,T
4-HA,990,2,10,2537,1,2550,G
4-HA,991,2545,0,1,1,2547,A
4-HA,992,2543,0,0,1,2544,A
4-HA,993,2545,1,0,0,2546,A
4-HA,994,0,2523,0,2,2525,T
4-HA,995,0,2495,0,1,2496,T
4-HA,996,2,11,2508,0,2521,G
4-HA,997,1,0,2514,0,2515,G
4-HA,998,0,0,0,2519,2519,C
4-HA,999,2481,0,2,1,2484,A
4-HA,1000,2482,1,1,1,2485,A
4-HA,1001,1,1,0,2483,2485,C
4-HA,1002,2479,0,3,1,2483,A
4-HA,1003,1,12,2496,0,2509,G
4-HA,1004,1,9,2492,0,2502,G
4-HA,1005,0,8,2474,0,2482,G
4-HA,1006,2470,0,4,0,2474,A
4-HA,1007,0,2455,1,2,2458,T
4-HA,1008,0,3,2463,0,2466,G
4-HA,1009,1,2,0,2453,2456,C
4-HA,1010,1,10,2458,0,2469,G
4-HA,1011,2488,1,1,0,2490,A
4-HA,1012,2456,0,0,0,2456,A
4-HA,1013,2464,0,3,1,2468,A
4-HA,1014,0,2425,0,3,2428,T
4-HA,1015,2,0,2458,0,2460,G
4-HA,1016,0,2454,0,2,2456,T
4-HA,1017,2451,0,0,1,2452,A
4-HA,1018,4,4,0,2443,2451,C
4-HA,1019,14,1,1,2416,2432,C
4-HA,1020,2363,0,1,0,2364,A
4-HA,1021,0,15,2352,0,2367,G
4-HA,1022,2322,0,2,0,2324,A
4-HA,1023,1,4,2339,1,2345,G
4-HA,1024,2291,1,1,0,2293,A
4-HA,1025,2293,0,3,0,2296,A
4-HA,1026,2291,0,4,0,2295,A
4-HA,1027,0,0,0,2288,2288,C
4-HA,1028,2270,0,0,0,2270,A
4-HA,1029,2313,0,1,0,2314,A
4-HA,1030,2295,0,2,1,2298,A
4-HA,1031,3,1,0,2311,2315,C
4-HA,1032,1,2287,0,1,2289,T
4-HA,1033,2267,0,1,0,2268,A
4-HA,1034,0,8,2264,0,2272,G
4-HA,1035,2251,1,3,1,2256,A
4-HA,1036,0,6,2294,1,2301,G
4-HA,1037,1,3,2294,1,2299,G
4-HA,1038,2,1,0,2245,2248,C
4-HA,1039,2245,0,2,0,2247,A
4-HA,1040,1,2242,0,2,2245,T
4-HA,1041,2257,1,0,0,2258,A
4-HA,1042,0,2252,0,1,2253,T
4-HA,1043,0,2242,0,1,2243,T
4-HA,1044,0,2244,0,1,2245,T
4-HA,1045,1,18,2126,1,2146,G
4-HA,1046,1,1,2149,0,2151,G
4-HA,1047,4,4,1,2135,2144,C
4-HA,1048,3,4,2139,0,2146,G
4-HA,1049,3,0,0,2128,2131,C
4-HA,1050,2093,1,1,0,2095,A
4-HA,1051,2113,1,0,0,2114,A
4-HA,1052,0,2108,1,0,2109,T
4-HA,1053,8,2,0,2103,2113,C
4-HA,1054,1,1,2110,0,2112,G
4-HA,1055,1,6,1,2088,2096,C
4-HA,1056,1,5,2089,1,2096,G
4-HA,1057,0,9,2106,0,2115,G
4-HA,1058,2,1,2117,0,2120,G
4-HA,1059,0,2107,1,0,2108,T
4-HA,1060,0,2066,0,0,2066,T
4-HA,1061,1,2058,0,6,2065,T
4-HA,1062,9,0,0,2057,2066,C
4-HA,1063,2073,1,1,0,2075,A
4-HA,1064,0,2077,0,0,2077,T
4-HA,1065,2071,0,1,2,2074,A
4-HA,1066,0,5,2083,0,2088,G
4-HA,1067,2008,0,1,0,2009,A
4-HA,1068,2013,0,1,0,2014,A
4-HA,1069,2016,0,1,0,2017,A
4-HA,1070,2014,1,3,0,2018,A
4-HA,1071,1,2005,0,1,2007,T
4-HA,1072,4,7,2015,0,2026,G
4-HA,1073,1,1,2040,0,2042,G
4-HA,1074,1,2021,0,1,2023,T
4-HA,1075,0,1951,1,0,1952,T
4-HA,1076,3,13,1933,0,1949,G
4-HA,1077,0,4,1928,0,1932,G
4-HA,1078,2,6,1931,0,1939,G
4-HA,1079,1891,1,3,0,1895,A
4-HA,1080,0,5,1896,0,1901,G
4-HA,1081,0,6,1839,0,1845,G
4-HA,1082,3,7,1857,1,1868,G
4-HA,1083,1862,0,3,0,1865,A
4-HA,1084,1886,0,2,0,1888,A
4-HA,1085,1,1884,0,0,1885,T
4-HA,1086,0,12,1870,0,1882,G
4-HA,1087,3,1,1910,0,1914,G
4-HA,1088,0,1885,0,1,1886,T
4-HA,1089,2,6,1880,0,1888,G
4-HA,1090,1,6,1873,0,1880,G
4-HA,1091,1836,0,1,0,1837,A
4-HA,1092,0,1840,0,0,1840,T
4-HA,1093,0,7,1844,0,1851,G
4-HA,1094,1,2,1877,0,1880,G
4-HA,1095,0,1821,0,1,1822,T
4-HA,1096,0,1755,0,1,1756,T
4-HA,1097,1,18,1740,0,1759,G
4-HA,1098,0,5,1775,0,1780,G
4-HA,1099,1,1774,1,0,1776,T
4-HA,1100,1772,1,0,0,1773,A
4-HA,1101,0,6,0,1673,1679,C
4-HA,1102,0,4,1690,0,1694,G
4-HA,1103,2,1,1756,0,1759,G
4-HA,1104,0,1754,0,4,1758,T
4-HA,1105,0,1752,0,1,1753,T
4-HA,1106,0,1741,0,5,1746,T
4-HA,1107,7,0,0,1718,1725,C
4-HA,1108,1713,2,1,0,1716,A
4-HA,1109,1,9,1710,0,1720,G
4-HA,1110,1,2,1715,0,1718,G
4-HA,1111,0,1,1,1715,1717,C
4-HA,1112,1670,0,0,0,1670,A
4-HA,1113,1,1684,0,2,1687,T
4-HA,1114,9,0,0,1686,1695,C
4-HA,1115,1697,0,0,0,1697,A
4-HA,1116,1694,0,1,0,1695,A
4-HA,1117,1693,0,2,0,1695,A
4-HA,1118,1710,0,0,1,1711,A
4-HA,1119,0,1709,0,0,1709,T
4-HA,1120,0,1704,0,1,1705,T
4-HA,1121,10,1,0,1703,1714,C
4-HA,1122,0,1672,0,2,1674,T
4-HA,1123,1,2,1664,0,1667,G
4-HA,1124,1665,0,1,0,1666,A
4-HA,1125,1643,0,3,0,1646,A
4-HA,1126,0,9,1660,0,1669,G
4-HA,1127,0,8,1676,0,1684,G
4-HA,1128,1682,0,0,0,1682,A
4-HA,1129,1682,0,1,0,1683,A
4-HA,1130,1,5,1658,0,1664,G
4-HA,1131,1669,0,3,0,1672,A
4-HA,1132,0,9,1675,0,1684,G
4-HA,1133,0,14,1685,0,1699,G
4-HA,1134,1700,0,5,0,1705,A
4-HA,1135,0,1,0,1704,1705,C
4-HA,1136,1682,1,0,0,1683,A
4-HA,1137,1679,0,0,0,1679,A
4-HA,1138,0,4,1680,0,1684,G
4-HA,1139,0,1,0,1692,1693,C
4-HA,1140,1664,0,2,0,1666,A
4-HA,1141,1,2,1675,0,1678,G
4-HA,1142,1,1,0,1668,1670,C
4-HA,1143,1662,0,1,0,1663,A
4-HA,1144,0,4,1679,0,1683,G
4-HA,1145,1667,0,1,0,1668,A
4-HA,1146,0,1708,0,0,1708,T
4-HA,1147,10,1,0,1713,1724,C
4-HA,1148,0,1702,0,2,1704,T
4-HA,1149,11,1,0,1719,1731,C
4-HA,1150,1721,0,0,0,1721,A
4-HA,1151,1716,0,3,1,1720,A
4-HA,1152,1717,0,2,1,1720,A
4-HA,1153,1687,0,5,0,1692,A
4-HA,1154,0,0,1698,0,1698,G
4-HA,1155,1,1,0,1668,1670,C
4-HA,1156,1657,1,1,0,1659,A
4-HA,1157,0,0,0,1699,1699,C
4-HA,1158,0,1686,0,1,1687,T
4-HA,1159,11,0,0,1690,1701,C
4-HA,1160,1698,0,0,0,1698,A
4-HA,1161,1714,0,0,0,1714,A
4-HA,1162,1,2,1714,0,1717,G
4-HA,1163,2,1,0,1705,1708,C
4-HA,1164,1693,0,3,0,1696,A
4-HA,1165,0,0,1711,0,1711,G
4-HA,1166,0,2,0,1687,1689,C
4-HA,1167,1680,0,0,0,1680,A
4-HA,1168,1678,0,0,0,1678,A
4-HA,1169,0,1675,0,0,1675,T
4-HA,1170,8,0,0,1636,1644,C
4-HA,1171,2,11,1644,0,1657,G
4-HA,1172,1653,0,0,0,1653,A
4-HA,1173,0,1647,0,1,1648,T
4-HA,1174,12,0,0,1622,1634,C
4-HA,1175,1627,0,1,0,1628,A
4-HA,1176,1669,1,0,0,1670,A
4-HA,1177,1676,1,1,0,1678,A
4-HA,1178,0,1676,0,1,1677,T
4-HA,1179,15,0,0,1663,1678,C
4-HA,1180,1654,1,1,0,1656,A
4-HA,1181,1669,0,1,0,1670,A
4-HA,1182,0,1670,0,0,1670,T
4-HA,1183,2,9,1658,1,1670,G
4-HA,1184,0,6,1668,0,1674,G
4-HA,1185,4,2,1635,0,1641,G
4-HA,1186,1638,0,1,0,1639,A
4-HA,1187,1636,0,2,0,1638,A
4-HA,1188,1,0,1668,0,1669,G
4-HA,1189,0,0,0,1675,1675,C
4-HA,1190,0,1657,0,2,1659,T
4-HA,1191,0,16,1711,0,1727,G
4-HA,1192,1723,0,0,0,1723,A
4-HA,1193,1727,0,1,0,1728,A
4-HA,1194,2,1725,0,2,1729,T
4-HA,1195,1687,0,1,0,1688,A
4-HA,1196,0,6,1679,0,1685,G
4-HA,1197,1549,0,2,1,1552,A
4-HA,1198,0,1560,0,0,1560,T
4-HA,1199,0,1559,0,0,1559,T
4-HA,1200,0,13,1561,0,1574,G
4-HA,1201,1567,0,0,0,1567,A
4-HA,1202,0,1556,0,1,1557,T
4-HA,1203,9,1,0,1553,1563,C
4-HA,1204,2,2,1562,0,1566,G
4-HA,1205,1,4,1560,0,1565,G
4-HA,1206,0,7,1560,0,1567,G
4-HA,1207,1563,0,0,0,1563,A
4-HA,1208,1568,0,2,0,1570,A
4-HA,1209,1562,0,4,1,1567,A
4-HA,1210,1567,1,1,0,1569,A
4-HA,1211,0,0,0,1576,1576,C
4-HA,1212,8,1,0,1564,1573,C
4-HA,1213,1560,0,2,0,1562,A
4-HA,1214,1561,0,0,0,1561,A
4-HA,1215,0,2,0,1568,1570,C
4-HA,1216,3,6,1570,0,1579,G
4-HA,1217,1575,0,1,0,1576,A
4-HA,1218,0,3,1576,0,1579,G
4-HA,1219,1576,0,2,2,1580,A
4-HA,1220,1572,0,1,0,1573,A
4-HA,1221,1569,0,1,0,1570,A
4-HA,1222,0,1576,0,2,1578,T
4-HA,1223,0,1561,0,1,1562,T
4-HA,1224,9,2,0,1552,1563,C
4-HA,1225,4,2,0,1554,1560,C
4-HA,1226,1559,1,0,1,1561,A
4-HA,1227,1,1553,0,1,1555,T
4-HA,1228,6,0,1,1551,1558,C
4-HA,1229,1543,0,1,0,1544,A
4-HA,1230,0,5,1550,0,1555,G
4-HA,1231,1539,0,1,0,1540,A
4-HA,1232,0,1536,0,1,1537,T
4-HA,1233,0,1528,0,2,1530,T
4-HA,1234,0,7,1536,0,1543,G
4-HA,1235,1544,1,1,0,1546,A
4-HA,1236,1546,0,1,0,1547,A
4-HA,1237,1544,0,2,0,1546,A
4-HA,1238,1546,0,0,0,1546,A
4-HA,1239,1530,1,2,0,1533,A
4-HA,1240,0,8,1531,0,1539,G
4-HA,1241,1526,0,1,0,1527,A
4-HA,1242,1532,0,3,0,1535,A
4-HA,1243,0,1518,0,1,1519,T
4-HA,1244,0,1515,0,2,1517,T
4-HA,1245,5,1,0,1512,1518,C
4-HA,1246,0,1508,0,4,1512,T
4-HA,1247,8,0,0,1508,1516,C
4-HA,1248,1513,0,0,0,1513,A
4-HA,1249,0,1,1517,0,1518,G
4-HA,1250,1511,0,0,1,1512,A
4-HA,1251,1511,1,0,0,1512,A
4-HA,1252,0,0,1524,0,1524,G
4-HA,1253,0,1512,0,1,1513,T
4-HA,1254,10,1,0,1499,1510,C
4-HA,1255,1,3,1504,0,1508,G
4-HA,1256,1506,0,0,0,1506,A
4-HA,1257,1506,0,3,1,1510,A
4-HA,1258,0,10,1493,0,1503,G
4-HA,1259,3,3,1511,0,1517,G
4-HA,1260,2,8,1506,0,1516,G
4-HA,1261,1481,0,1,0,1482,A
4-HA,1262,0,8,1477,0,1485,G
4-HA,1263,1478,0,2,0,1480,A
4-HA,1264,1568,0,0,0,1568,A
4-HA,1265,0,1570,1,0,1571,T
4-HA,1266,0,1568,0,2,1570,T
4-HA,1267,7,0,0,1566,1573,C
4-HA,1268,1529,0,2,0,1531,A
4-HA,1269,1,7,1524,0,1532,G
4-HA,1270,2,8,1520,0,1530,G
4-HA,1271,1511,2,4,0,1517,A
4-HA,1272,2,0,0,1521,1523,C
4-HA,1273,7,0,0,1400,1407,C
4-HA,1274,0,1396,2,0,1398,T
4-HA,1275,0,1356,0,45,1401,T
4-HA,1276,1,5,1404,0,1410,G
4-HA,1277,1402,1,2,0,1405,A
4-HA,1278,0,4,1436,0,1440,G
4-HA,1279,1428,0,0,0,1428,A
4-HA,1280,1359,0,1,0,1360,A
4-HA,1281,1347,0,1,0,1348,A
4-HA,1282,0,1326,0,1,1327,T
4-HA,1283,1363,0,0,0,1363,A
4-HA,1284,0,1353,0,0,1353,T
4-HA,1285,0,4,1352,0,1356,G
4-HA,1286,0,1353,0,3,1356,T
4-HA,1287,0,1315,0,0,1315,T
4-HA,1288,0,5,1315,0,1320,G
4-HA,1289,1305,0,0,0,1305,A
4-HA,1290,0,9,1305,0,1314,G
4-HA,1291,0,4,1302,0,1306,G
4-HA,1292,1285,0,2,0,1287,A
4-HA,1293,1,0,0,1311,1312,C
4-HA,1294,1299,0,2,1,1302,A
4-HA,1295,3,1,0,1334,1338,C
4-HA,1296,6,0,0,1332,1338,C
4-HA,1297,1340,0,0,0,1340,A
4-HA,1298,1381,1,0,0,1382,A
4-HA,1299,1378,0,1,0,1379,A
4-HA,1300,1390,0,2,0,1392,A
4-HA,1301,0,1389,0,1,1390,T
4-HA,1302,1351,0,1,0,1352,A
4-HA,1303,1,9,1354,0,1364,G
4-HA,1304,1337,1,0,0,1338,A
4-HA,1305,0,1364,0,1,1365,T
4-HA,1306,1,1,0,1364,1366,C
4-HA,1307,1,1327,0,2,1330,T
4-HA,1308,6,0,0,1350,1356,C
4-HA,1309,0,1346,0,0,1346,T
4-HA,1310,3,8,1363,0,1374,G
4-HA,1311,0,1,1401,0,1402,G
4-HA,1312,0,1393,0,1,1394,T
4-HA,1313,26,1,0,1370,1397,C
4-HA,1314,1402,0,0,0,1402,A
4-HA,1315,0,1399,0,2,1401,T
4-HA,1316,1398,0,2,0,1400,A
4-HA,1317,0,0,0,1401,1401,C
4-HA,1318,1357,0,2,0,1359,A
4-HA,1319,1371,0,2,0,1373,A
4-HA,1320,0,3,1,1343,1347,C
4-HA,1321,1,1,1348,0,1350,G
4-HA,1322,3,2,0,1341,1346,C
4-HA,1323,2,1,1336,0,1339,G
4-HA,1324,0,4,1339,0,1343,G
4-HA,1325,1341,0,1,0,1342,A
4-HA,1326,3,0,1361,0,1364,G
4-HA,1327,2,1,0,1361,1364,C
4-HA,1328,0,1344,0,2,1346,T
4-HA,1329,0,1350,2,2,1354,T
4-HA,1330,3,0,0,1352,1355,C
4-HA,1331,0,1357,0,2,1359,T
4-HA,1332,0,1361,0,0,1361,T
4-HA,1333,1,0,1355,0,1356,G
4-HA,1334,0,1350,0,0,1350,T
4-HA,1335,1,1319,0,1,1321,T
4-HA,1336,1,0,1347,0,1348,G
4-HA,1337,0,0,0,1348,1348,C
4-HA,1338,5,0,0,1335,1340,C
4-HA,1339,10,1,0,1333,1344,C
4-HA,1340,0,1340,0,1,1341,T
4-HA,1341,0,2,1349,2,1353,G
4-HA,1342,0,5,1354,0,1359,G
4-HA,1343,1352,0,1,0,1353,A
4-HA,1344,0,7,1352,0,1359,G
4-HA,1345,1327,1,3,0,1331,A
4-HA,1346,1334,0,0,0,1334,A
4-HA,1347,4,0,0,1351,1355,C
4-HA,1348,4,1,0,1349,1354,C
4-HA,1349,1352,0,1,0,1353,A
4-HA,1350,1402,0,0,1,1403,A
4-HA,1351,1,1,0,1417,1419,C
4-HA,1352,1425,0,2,0,1427,A
4-HA,1353,0,1425,0,0,1425,T
4-HA,1354,1417,1,0,0,1418,A
4-HA,1355,0,1,0,1455,1456,C
4-HA,1356,1414,1,0,0,1415,A
4-HA,1357,1416,1,1,0,1418,A
4-HA,1358,0,1423,0,0,1423,T
4-HA,1359,0,1364,1,1,1366,T
4-HA,1360,0,14,1370,0,1384,G
4-HA,1361,1389,0,0,0,1389,A
4-HA,1362,0,1379,0,2,1381,T
4-HA,1363,8,0,1,1375,1384,C
4-HA,1364,1,1345,0,1,1347,T
4-HA,1365,1355,0,0,0,1355,A
4-HA,1366,1353,0,0,1,1354,A
4-HA,1367,0,0,0,1352,1352,C
4-HA,1368,0,1342,0,2,1344,T
4-HA,1369,0,18,1322,0,1340,G
4-HA,1370,1343,0,0,0,1343,A
4-HA,1371,0,0,0,1347,1347,C
4-HA,1372,0,1339,0,0,1339,T
4-HA,1373,11,0,0,1335,1346,C
4-HA,1374,1339,0,1,0,1340,A
4-HA,1375,0,3,1386,0,1389,G
4-HA,1376,1385,0,1,0,1386,A
4-HA,1377,1385,0,1,0,1386,A
4-HA,1378,1384,0,1,0,1385,A
4-HA,1379,0,1375,0,1,1376,T
4-HA,1380,1,16,1373,0,1390,G
4-HA,1381,1386,0,2,0,1388,A
4-HA,1382,1388,1,1,0,1390,A
4-HA,1383,1,1,0,1389,1391,C
4-HA,1384,1365,0,0,0,1365,A
4-HA,1385,1361,0,0,0,1361,A
4-HA,1386,1361,0,1,0,1362,A
4-HA,1387,2,0,0,1364,1366,C
4-HA,1388,0,1350,0,0,1350,T
4-HA,1389,1,2,1353,0,1356,G
4-HA,1390,0,1336,0,1,1337,T
4-HA,1391,0,1338,0,2,1340,T
4-HA,1392,0,1340,0,0,1340,T
4-HA,1393,0,4,1335,1,1340,G
4-HA,1394,1339,1,0,0,1340,A
4-HA,1395,1340,0,0,1,1341,A
4-HA,1396,1336,0,2,0,1338,A
4-HA,1397,1340,0,0,2,1342,A
4-HA,1398,1326,1,0,0,1327,A
4-HA,1399,1329,0,0,0,1329,A
4-HA,1400,0,0,0,1339,1339,C
4-HA,1401,1333,1,0,0,1334,A
4-HA,1402,1331,0,1,0,1332,A
4-HA,1403,1332,0,0,0,1332,A
4-HA,1404,0,7,1329,0,1336,G
4-HA,1405,1336,1,0,0,1337,A
4-HA,1406,1329,0,3,0,1332,A
4-HA,1407,0,2,1329,0,1331,G
4-HA,1408,1,0,0,1322,1323,C
4-HA,1409,1322,1,1,0,1324,A
4-HA,1410,1326,1,0,0,1327,A
4-HA,1411,0,0,0,1332,1332,C
4-HA,1412,1,1331,0,1,1333,T
4-HA,1413,2,2,1334,0,1338,G
4-HA,1414,1327,0,4,0,1331,A
4-HA,1415,0,13,1330,0,1343,G
4-HA,1416,0,3,1341,0,1344,G
4-HA,1417,1,4,1338,1,1344,G
4-HA,1418,1345,0,2,0,1347,A
4-HA,1419,1335,0,0,1,1336,A
4-HA,1420,1328,2,0,0,1330,A
4-HA,1421,1353,0,0,0,1353,A
4-HA,1422,0,1342,0,0,1342,T
4-HA,1423,0,2,1346,0,1348,G
4-HA,1424,0,0,0,1347,1347,C
4-HA,1425,0,1328,0,0,1328,T
4-HA,1426,1,8,1324,0,1333,G
4-HA,1427,1331,0,1,0,1332,A
4-HA,1428,0,5,1389,0,1394,G
4-HA,1429,0,5,1406,0,1411,G
4-HA,1430,1390,1,1,0,1392,A
4-HA,1431,0,1384,0,0,1384,T
4-HA,1432,1372,0,1,1,1374,A
4-HA,1433,0,1364,0,1,1365,T
4-HA,1434,0,11,1377,0,1388,G
4-HA,1435,0,8,1388,0,1396,G
4-HA,1436,0,1,1388,0,1389,G
4-HA,1437,0,0,0,1327,1327,C
4-HA,1438,1299,0,1,0,1300,A
4-HA,1439,1299,0,0,0,1299,A
4-HA,1440,0,1298,0,0,1298,T
4-HA,1441,1,0,1308,0,1309,G
4-HA,1442,0,0,1312,0,1312,G
4-HA,1443,0,1282,0,0,1282,T
4-HA,1444,0,1247,0,0,1247,T
4-HA,1445,2,1,1249,0,1252,G
4-HA,1446,1,1253,0,2,1256,T
4-HA,1447,2,1256,0,1,1259,T
4-HA,1448,1,1258,0,2,1261,T
4-HA,1449,5,0,0,1258,1263,C
4-HA,1450,1258,0,0,0,1258,A
4-HA,1451,1259,0,0,0,1259,A
4-HA,1452,1262,0,1,0,1263,A
4-HA,1453,1283,0,1,0,1284,A
4-HA,1454,0,1281,0,0,1281,T
4-HA,1455,1277,0,0,0,1277,A
4-HA,1456,0,1275,0,2,1277,T
4-HA,1457,1283,0,0,0,1283,A
4-HA,1458,0,1,0,1320,1321,C
4-HA,1459,11,0,0,1302,1313,C
4-HA,1460,1316,1,0,0,1317,A
4-HA,1461,0,0,0,1333,1333,C
4-HA,1462,1333,0,0,0,1333,A
4-HA,1463,1337,0,1,0,1338,A
4-HA,1464,1171,0,1,171,1343,A
4-HA,1465,0,1347,0,0,1347,T
4-HA,1466,1,1,1351,0,1353,G
4-HA,1467,1,1302,0,2,1305,T
4-HA,1468,1,17,1301,0,1319,G
4-HA,1469,1315,0,0,0,1315,A
4-HA,1470,2,0,0,1313,1315,C
4-HA,1471,1282,0,0,0,1282,A
4-HA,1472,1281,0,0,0,1281,A
4-HA,1473,0,1293,1,1,1295,T
4-HA,1474,1,0,1301,0,1302,G
4-HA,1475,1,0,0,1297,1298,C
4-HA,1476,3,1,0,1297,1301,C
4-HA,1477,0,1286,0,0,1286,T
4-HA,1478,0,1,1334,0,1335,G
4-HA,1479,1,2,0,1336,1339,C
4-HA,1480,1334,0,0,0,1334,A
4-HA,1481,0,1335,0,0,1335,T
4-HA,1482,1273,0,0,1,1274,A
4-HA,1483,0,6,1282,0,1288,G
4-HA,1484,0,7,1283,0,1290,G
4-HA,1485,1286,1,0,0,1287,A
4-HA,1486,0,1285,0,0,1285,T
4-HA,1487,6,0,0,1236,1242,C
4-HA,1488,1231,0,1,0,1232,A
4-HA,1489,1235,0,0,0,1235,A
4-HA,1490,0,1232,0,3,1235,T
4-HA,1491,7,0,0,1229,1236,C
4-HA,1492,1216,0,0,0,1216,A
4-HA,1493,0,4,1218,0,1222,G
4-HA,1494,1225,0,0,0,1225,A
4-HA,1495,1223,0,2,0,1225,A
4-HA,1496,1223,0,2,0,1225,A
4-HA,1497,0,1222,0,0,1222,T
4-HA,1498,3,5,1209,0,1217,G
4-HA,1499,0,11,1216,0,1227,G
4-HA,1500,1220,0,0,0,1220,A
4-HA,1501,1229,0,1,0,1230,A
4-HA,1502,3,1,0,1222,1226,C
4-HA,1503,0,1214,0,1,1215,T
4-HA,1504,0,1215,0,0,1215,T
4-HA,1505,1218,0,0,0,1218,A
4-HA,1506,0,1218,0,0,1218,T
4-HA,1507,0,13,1205,0,1218,G
4-HA,1508,1215,0,1,0,1216,A
4-HA,1509,0,0,0,1219,1219,C
4-HA,1510,10,0,0,1184,1194,C
4-HA,1511,1196,0,0,0,1196,A
4-HA,1512,1,5,0,1224,1230,C
4-HA,1513,1,3,1249,0,1253,G
4-HA,1514,1275,1,0,0,1276,A
4-HA,1515,0,1289,0,0,1289,T
4-HA,1516,2,1,1321,0,1324,G
4-HA,1517,0,1312,0,1,1313,T
4-HA,1518,1363,0,1,0,1364,A
4-HA,1519,0,1364,0,0,1364,T
4-HA,1520,1359,0,2,0,1361,A
4-HA,1521,0,0,0,1359,1359,C
4-HA,1522,1252,0,0,0,1252,A
4-HA,1523,0,7,1262,0,1269,G
4-HA,1524,1188,0,1,0,1189,A
4-HA,1525,0,2,1156,0,1158,G
4-HA,1526,1152,0,0,0,1152,A
4-HA,1527,0,1080,0,1,1081,T
4-HA,1528,0,3,1075,0,1078,G
4-HA,1529,1076,0,0,0,1076,A
4-HA,1530,1070,0,4,0,1074,A
4-HA,1531,0,1,1106,0,1107,G
4-HA,1532,1,1,1,1072,1075,C
4-HA,1533,1071,0,0,0,1071,A
4-HA,1534,0,1064,0,1,1065,T
4-HA,1535,0,1061,0,0,1061,T
4-HA,1536,1070,0,0,0,1070,A
4-HA,1537,1068,0,1,0,1069,A
4-HA,1538,1067,1,1,1,1070,A
4-HA,1539,0,0,0,1074,1074,C
4-HA,1540,1033,0,0,0,1033,A
4-HA,1541,1034,0,0,0,1034,A
4-HA,1542,0,0,0,1034,1034,C
4-HA,1543,3,0,0,1020,1023,C
4-HA,1544,1,7,1018,0,1026,G
4-HA,1545,0,0,1044,0,1044,G
4-HA,1546,0,1044,0,1,1045,T
4-HA,1547,0,1045,0,1,1046,T
4-HA,1548,4,0,0,1038,1042,C
4-HA,1549,4,0,0,1038,1042,C
4-HA,1550,1032,0,1,0,1033,A
4-HA,1551,0,7,1036,0,1043,G
4-HA,1552,1042,0,1,0,1043,A
4-HA,1553,0,1040,0,1,1041,T
4-HA,1554,7,0,0,1012,1019,C
4-HA,1555,1009,0,0,0,1009,A
4-HA,1556,1007,2,0,2,1011,A
4-HA,1557,0,6,1006,0,1012,G
4-HA,1558,1,6,1005,0,1012,G
4-HA,1559,0,4,1006,0,1010,G
4-HA,1560,968,1,1,0,970,A
4-HA,1561,0,0,981,0,981,G
4-HA,1562,0,983,0,0,983,T
4-HA,1563,0,982,0,1,983,T
4-HA,1564,0,5,982,0,987,G
4-HA,1565,979,0,2,0,981,A
4-HA,1566,1,1,983,0,985,G
4-HA,1567,2,0,1,981,984,C
4-HA,1568,0,971,0,0,971,T
4-HA,1569,1,1,975,1,978,G
4-HA,1570,972,0,0,0,972,A
4-HA,1571,974,0,1,0,975,A
4-HA,1572,0,1,973,0,974,G
4-HA,1573,0,959,0,0,959,T
4-HA,1574,13,0,0,947,960,C
4-HA,1575,938,0,1,0,939,A
4-HA,1576,0,5,935,0,940,G
4-HA,1577,0,4,935,0,939,G
4-HA,1578,3,1,917,0,921,G
4-HA,1579,0,945,0,0,945,T
4-HA,1580,950,0,0,0,950,A
4-HA,1581,1,1,1,946,949,C
4-HA,1582,943,0,0,0,943,A
4-HA,1583,943,0,2,0,945,A
4-HA,1584,946,0,0,0,946,A
4-HA,1585,1,4,941,0,946,G
4-HA,1586,927,0,0,0,927,A
4-HA,1587,1,899,0,0,900,T
4-HA,1588,0,888,0,0,888,T
4-HA,1589,0,3,883,0,886,G
4-HA,1590,0,2,883,0,885,G
4-HA,1591,889,0,1,0,890,A
4-HA,1592,0,891,0,0,891,T
4-HA,1593,6,0,0,877,883,C
4-HA,1594,2,1,0,865,868,C
4-HA,1595,0,854,0,1,855,T
4-HA,1596,859,0,1,0,860,A
4-HA,1597,0,860,1,1,862,T
4-HA,1598,2,4,856,0,862,G
4-HA,1599,0,7,851,0,858,G
4-HA,1600,830,0,0,0,830,A
4-HA,1601,0,825,3,0,828,T
4-HA,1602,0,813,0,0,813,T
4-HA,1603,0,801,0,0,801,T
4-HA,1604,1,0,0,796,797,C
4-HA,1605,6,0,0,785,791,C
4-HA,1606,0,773,0,0,773,T
4-HA,1607,0,771,0,2,773,T
4-HA,1608,0,766,0,2,768,T
4-HA,1609,1,0,781,0,782,G
4-HA,1610,1,0,0,778,779,C
4-HA,1611,3,1,1,775,780,C
4-HA,1612,763,0,2,0,765,A
4-HA,1613,0,765,0,1,766,T
4-HA,1614,775,0,0,0,775,A
4-HA,1615,0,776,0,0,776,T
4-HA,1616,6,0,0,766,772,C
4-HA,1617,773,0,0,0,773,A
4-HA,1618,0,768,0,0,768,T
4-HA,1619,0,0,772,0,772,G
4-HA,1620,0,769,2,0,771,T
4-HA,1621,0,758,0,0,758,T
4-HA,1622,0,752,1,1,754,T
4-HA,1623,0,731,1,0,732,T
4-HA,1624,0,730,0,0,730,T
4-HA,1625,0,731,0,0,731,T
4-HA,1626,0,0,736,0,736,G
4-HA,1627,0,0,0,733,733,C
4-HA,1628,1,707,0,1,709,T
4-HA,1629,0,709,0,0,709,T
4-HA,1630,0,704,0,0,704,T
4-HA,1631,0,0,717,0,717,G
4-HA,1632,0,716,0,0,716,T
4-HA,1633,0,0,716,1,717,G
4-HA,1634,0,716,0,2,718,T
4-HA,1635,1,694,0,0,695,T
4-HA,1636,1,1,702,0,704,G
4-HA,1637,0,0,0,703,703,C
4-HA,1638,0,693,0,4,697,T
4-HA,1639,0,700,0,1,701,T
4-HA,1640,0,663,0,0,663,T
4-HA,1641,1,2,666,0,669,G
4-HA,1642,0,666,0,0,666,T
4-HA,1643,0,665,0,0,665,T
4-HA,1644,0,4,661,0,665,G
4-HA,1645,0,2,650,0,652,G
4-HA,1646,0,2,652,0,654,G
4-HA,1647,0,1,654,0,655,G
4-HA,1648,0,625,0,1,626,T
4-HA,1649,0,622,0,1,623,T
4-HA,1650,7,0,0,605,612,C
4-HA,1651,608,1,0,0,609,A
4-HA,1652,0,607,0,1,608,T
4-HA,1653,4,0,0,606,610,C
4-HA,1654,601,0,0,0,601,A
4-HA,1655,0,588,0,1,589,T
4-HA,1656,0,1,586,0,587,G
4-HA,1657,0,572,0,1,573,T
4-HA,1658,1,2,560,0,563,G
4-HA,1659,0,0,551,0,551,G
4-HA,1660,0,0,547,0,547,G
4-HA,1661,1,1,0,532,534,C
4-HA,1662,3,0,0,517,520,C
4-HA,1663,0,495,0,3,498,T
4-HA,1664,0,1,499,0,500,G
4-HA,1665,1,0,0,498,499,C
4-HA,1666,5,1,0,492,498,C
4-HA,1667,499,0,0,0,499,A
4-HA,1668,494,0,0,0,494,A
4-HA,1669,494,0,0,0,494,A
4-HA,1670,493,0,1,0,494,A
4-HA,1671,495,0,0,0,495,A
4-HA,1672,0,2,493,0,495,G
4-HA,1673,0,0,475,0,475,G
4-HA,1674,0,0,0,467,467,C
4-HA,1675,462,0,0,0,462,A
4-HA,1676,465,0,1,0,466,A
4-HA,1677,0,0,0,466,466,C
4-HA,1678,462,0,0,0,462,A
4-HA,1679,0,457,0,0,457,T
4-HA,1680,0,455,0,0,455,T
4-HA,1681,439,0,0,0,439,A
4-HA,1682,0,1,437,0,438,G
4-HA,1683,0,0,437,0,437,G
4-HA,1684,0,419,0,0,419,T
4-HA,1685,1,0,391,0,392,G
4-HA,1686,0,0,0,376,376,C
4-HA,1687,368,0,0,0,368,A
4-HA,1688,368,0,0,0,368,A
4-HA,1689,0,1,0,367,368,C
4-HA,1690,364,0,0,0,364,A
4-HA,1691,0,356,0,1,357,T
4-HA,1692,0,332,0,0,332,T
4-HA,1693,0,329,0,0,329,T
4-HA,1694,0,0,330,0,330,G
4-HA,1695,0,0,0,327,327,C
4-HA,1696,328,0,0,0,328,A
4-HA,1697,0,308,0,0,308,T
4-HA,1698,0,299,0,0,299,T
4-HA,1699,0,285,0,0,285,T
4-HA,1700,0,0,284,0,284,G
4-HA,1701,270,0,0,0,270,A
5-NP,1,1459,0,0,0,1459,A
5-NP,2,0,1466,0,0,1466,T
5-NP,3,0,0,1463,0,1463,G
5-NP,4,0,2,1479,0,1481,G
5-NP,5,2,1,0,1485,1488,C
5-NP,6,1,1,1523,0,1525,G
5-NP,7,1,1600,0,2,1603,T
5-NP,8,1,1,0,1637,1639,C
5-NP,9,9,2,1,1638,1650,C
5-NP,10,9,1,0,1646,1656,C
5-NP,11,1654,0,2,0,1656,A
5-NP,12,1659,1,0,0,1660,A
5-NP,13,1,9,1671,0,1681,G
5-NP,14,2,1,1723,1,1727,G
5-NP,15,3,0,0,1734,1737,C
5-NP,16,1740,0,3,0,1743,A
5-NP,17,0,0,0,1770,1770,C
5-NP,18,6,1,0,1771,1778,C
5-NP,19,1792,0,0,0,1792,A
5-NP,20,1786,0,2,0,1788,A
5-NP,21,1793,0,0,0,1793,A
5-NP,22,1,6,0,1792,1799,C
5-NP,23,0,16,1793,0,1809,G
5-NP,24,0,1,1982,0,1983,G
5-NP,25,0,1986,0,0,1986,T
5-NP,26,10,0,0,2149,2159,C
5-NP,27,0,2153,0,2,2155,T
5-NP,28,0,2187,0,0,2187,T
5-NP,29,2190,0,0,1,2191,A
5-NP,30,0,2191,0,0,2191,T
5-NP,31,1,39,2168,1,2209,G
5-NP,32,2202,1,1,0,2204,A
5-NP,33,2178,1,3,0,2182,A
5-NP,34,2,0,0,2191,2193,C
5-NP,35,2139,0,0,0,2139,A
5-NP,36,0,5,2297,0,2302,G
5-NP,37,2291,0,0,0,2291,A
5-NP,38,2,2293,0,2,2297,T
5-NP,39,0,8,2287,1,2296,G
5-NP,40,2,6,2302,0,2310,G
5-NP,41,2309,0,5,1,2315,A
5-NP,42,2325,0,0,0,2325,A
5-NP,43,2323,0,2,1,2326,A
5-NP,44,0,0,0,2408,2408,C
5-NP,45,0,2377,0,1,2378,T
5-NP,46,0,5,2404,0,2409,G
5-NP,47,2395,0,6,0,2401,A
5-NP,48,0,2400,0,0,2400,T
5-NP,49,0,20,2392,0,2412,G
5-NP,50,1,18,2403,0,2422,G
5-NP,51,1,11,2409,1,2422,G
5-NP,52,0,14,2423,1,2438,G
5-NP,53,2420,0,3,0,2423,A
5-NP,54,0,2424,0,1,2425,T
5-NP,55,11,2,0,2432,2445,C
5-NP,56,2,2,2450,1,2455,G
5-NP,57,1,1,0,2490,2492,C
5-NP,58,6,0,0,2494,2500,C
5-NP,59,2491,2,0,1,2494,A
5-NP,60,1,13,2509,0,2523,G
5-NP,61,2512,0,2,0,2514,A
5-NP,62,2548,0,1,0,2549,A
5-NP,63,0,2546,0,2,2548,T
5-NP,64,0,3,2554,0,2557,G
5-NP,65,2,0,0,2581,2583,C
5-NP,66,2564,2,1,0,2567,A
5-NP,67,2609,0,2,0,2611,A
5-NP,68,2,1,0,2608,2611,C
5-NP,69,0,2596,0,2,2598,T
5-NP,70,0,25,2610,1,2636,G
5-NP,71,2669,0,2,0,2671,A
5-NP,72,1,6,2799,0,2806,G
5-NP,73,2802,0,0,0,2802,A
5-NP,74,0,2784,0,2,2786,T
5-NP,75,0,2788,1,0,2789,T
5-NP,76,2765,0,1,0,2766,A
5-NP,77,0,18,2774,0,2792,G
5-NP,78,1,9,2780,1,2791,G
5-NP,79,0,1,2794,0,2795,G
5-NP,80,3,0,0,2761,2764,C
5-NP,81,2742,1,0,0,2743,A
5-NP,82,0,2764,0,0,2764,T
5-NP,83,11,1,1,2758,2771,C
5-NP,84,9,3,1,2763,2776,C
5-NP,85,3,4,2797,0,2804,G
5-NP,86,1,2800,0,0,2801,T
5-NP,87,20,2,0,2778,2800,C
5-NP,88,4,15,2793,0,2812,G
5-NP,89,0,14,2806,0,2820,G
5-NP,90,0,11,2824,0,2835,G
5-NP,91,2823,0,0,0,2823,A
5-NP,92,2824,1,1,0,2826,A
5-NP,93,0,6,2841,0,2847,G
5-NP,94,2831,0,3,0,2834,A
5-NP,95,0,2846,0,1,2847,T
5-NP,96,0,23,2837,0,2860,G
5-NP,97,2872,0,2,0,2874,A
5-NP,98,0,2885,0,1,2886,T
5-NP,99,1,2870,0,0,2871,T
5-NP,100,2,9,2869,0,2880,G
5-NP,101,2871,0,2,0,2873,A
5-NP,102,1,2862,0,1,2864,T
5-NP,103,0,15,2840,0,2855,G
5-NP,104,1,14,2814,0,2829,G
5-NP,105,2,8,2791,0,2801,G
5-NP,106,2967,0,3,0,2970,A
5-NP,107,1,2971,1,1,2974,T
5-NP,108,0,2979,0,2,2981,T
5-NP,109,1,14,2995,0,3010,G
5-NP,110,0,4,3005,0,3009,G
5-NP,111,0,14,2997,1,3012,G
5-NP,112,2999,2,2,0,3003,A
5-NP,113,0,19,2967,2,2988,G
5-NP,114,2946,0,0,0,2946,A
5-NP,115,0,3002,0,0,3002,T
5-NP,116,0,3017,0,1,3018,T
5-NP,117,11,0,0,3008,3019,C
5-NP,118,0,2999,0,1,3000,T
5-NP,119,3028,0,2,0,3030,A
5-NP,120,2,1,0,3039,3042,C
5-NP,121,3113,0,2,0,3115,A
5-NP,122,2,3130,0,1,3133,T
5-NP,123,10,0,0,3111,3121,C
5-NP,124,14,1,0,3111,3126,C
5-NP,125,3128,1,1,0,3130,A
5-NP,126,3185,0,0,0,3185,A
5-NP,127,3190,0,1,0,3191,A
5-NP,128,0,3163,0,0,3163,T
5-NP,129,0,0,3175,0,3175,G
5-NP,130,3,3122,0,2,3127,T
5-NP,131,1,3,3140,0,3144,G
5-NP,132,1,3,0,3150,3154,C
5-NP,133,3136,1,1,0,3138,A
5-NP,134,3,0,0,3138,3141,C
5-NP,135,2,3094,0,0,3096,T
5-NP,136,0,29,3216,1,3246,G
5-NP,137,3295,0,0,0,3295,A
5-NP,138,3345,0,2,2,3349,A
5-NP,139,1,0,0,3395,3396,C
5-NP,140,0,3374,0,2,3376,T
5-NP,141,0,3380,0,1,3381,T
5-NP,142,3381,0,0,0,3381,A
5-NP,143,3380,1,1,0,3382,A
5-NP,144,3404,1,0,1,3406,A
5-NP,145,2,4,0,3411,3417,C
5-NP,146,0,3328,0,0,3328,T
5-NP,147,28,0,0,3327,3355,C
5-NP,148,3294,0,2,1,3297,A
5-NP,149,0,1,3338,1,3340,G
5-NP,150,0,3332,0,1,3333,T
5-NP,151,1,27,3329,1,3358,G
5-NP,152,3414,1,3,0,3418,A
5-NP,153,0,3429,0,3,3432,T
5-NP,154,35,1,1,3435,3472,C
5-NP,155,3475,1,3,1,3480,A
5-NP,156,1,3468,0,1,3470,T
5-NP,157,1,22,3446,0,3469,G
5-NP,158,3447,0,3,0,3450,A
5-NP,159,3446,0,5,0,3451,A
5-NP,160,2,20,3433,0,3455,G
5-NP,161,0,17,3392,0,3409,G
5-NP,162,0,3,3417,0,3420,G
5-NP,163,4,3,0,3387,3394,C
5-NP,164,5,10,3394,0,3409,G
5-NP,165,1,1,3423,1,3426,G
5-NP,166,3,3415,0,2,3420,T
5-NP,167,0,3416,0,1,3417,T
5-NP,168,3,28,3402,0,3433,G
5-NP,169,3720,1,2,1,3724,A
5-NP,170,0,3717,0,3,3720,T
5-NP,171,25,3,0,3693,3721,C
5-NP,172,16,2,1,3710,3729,C
5-NP,173,3717,2,2,0,3721,A
5-NP,174,1,27,3710,0,3738,G
5-NP,175,3726,0,1,0,3727,A
5-NP,176,3728,0,4,0,3732,A
5-NP,177,2,5,0,3754,3761,C
5-NP,178,3540,0,2,2,3544,A
5-NP,179,0,2,3596,0,3598,G
5-NP,180,2,1,0,3597,3600,C
5-NP,181,0,3594,0,1,3595,T
5-NP,182,0,3620,0,2,3622,T
5-NP,183,0,22,3604,0,3626,G
5-NP,184,3642,0,6,1,3649,A
5-NP,185,0,1,0,3669,3670,C
5-NP,186,3642,0,1,1,3644,A
5-NP,187,3662,0,3,1,3666,A
5-NP,188,0,3634,0,3,3637,T
5-NP,189,3644,0,1,1,3646,A
5-NP,190,0,11,3670,0,3681,G
5-NP,191,3659,0,3,0,3662,A
5-NP,192,0,17,3668,0,3685,G
5-NP,193,3652,0,0,1,3653,A
5-NP,194,3727,1,2,2,3732,A
5-NP,195,3737,0,0,1,3738,A
5-NP,196,3811,1,1,1,3814,A
5-NP,197,0,3820,0,0,3820,T
5-NP,198,2,21,3795,0,3818,G
5-NP,199,1,0,3813,0,3814,G
5-NP,200,0,3794,0,2,3796,T
5-NP,201,3705,1,6,2,3714,A
5-NP,202,1,0,0,3764,3765,C
5-NP,203,3,3771,0,3,3777,T
5-NP,204,18,0,0,3820,3838,C
5-NP,205,0,3753,1,1,3755,T
5-NP,206,19,3,0,3817,3839,C
5-NP,207,0,3829,0,2,3831,T
5-NP,208,2,2,3857,0,3861,G
5-NP,209,1,3,0,3851,3855,C
5-NP,210,0,3833,1,6,3840,T
5-NP,211,2,3836,1,1,3840,T
5-NP,212,0,3834,0,0,3834,T
5-NP,213,0,3787,1,0,3788,T
5-NP,214,0,14,3794,0,3808,G
5-NP,215,3768,0,5,26,3799,A
5-NP,216,0,3786,2,3,3791,T
5-NP,217,1,18,3764,0,3783,G
5-NP,218,3755,0,3,0,3758,A
5-NP,219,3767,0,1,0,3768,A
5-NP,220,3773,1,3,0,3777,A
5-NP,221,0,12,3771,0,3783,G
5-NP,222,3784,1,2,0,3787,A
5-NP,223,3779,1,6,0,3786,A
5-NP,224,1,8,3810,1,3820,G
5-NP,225,0,14,3892,0,3906,G
5-NP,226,3921,0,1,0,3922,A
5-NP,227,3953,0,2,0,3955,A
5-NP,228,0,3954,0,1,3955,T
5-NP,229,3942,1,2,0,3945,A
5-NP,230,3933,0,1,0,3934,A
5-NP,231,3975,0,1,1,3977,A
5-NP,232,0,3976,0,0,3976,T
5-NP,233,3971,1,0,1,3973,A
5-NP,234,2,0,0,3967,3969,C
5-NP,235,18,1,0,3875,3894,C
5-NP,236,0,3886,1,1,3888,T
5-NP,237,1,6,3884,1,3892,G
5-NP,238,4,6,3932,0,3942,G
5-NP,239,3944,1,2,1,3948,A
5-NP,240,3930,1,2,1,3934,A
5-NP,241,0,29,3949,2,3980,G
5-NP,242,3952,0,5,0,3957,A
5-NP,243,3923,1,3,0,3927,A
5-NP,244,3,0,0,3925,3928,C
5-NP,245,3906,1,2,0,3909,A
5-NP,246,2,1,0,4017,4020,C
5-NP,247,15,0,0,3968,3983,C
5-NP,248,15,2,2,3951,3970,C
5-NP,249,14,1,0,3962,3977,C
5-NP,250,3914,0,4,0,3918,A
5-NP,251,2,2,3913,0,3917,G
5-NP,252,2,1,0,3915,3918,C
5-NP,253,4,2,3918,0,3924,G
5-NP,254,9,2,0,3913,3924,C
5-NP,255,0,12,3859,0,3871,G
5-NP,256,4,13,3886,0,3903,G
5-NP,257,0,9,3897,1,3907,G
5-NP,258,0,14,3907,1,3922,G
5-NP,259,3914,0,1,0,3915,A
5-NP,260,3909,0,3,1,3913,A
5-NP,261,3901,0,5,0,3906,A
5-NP,262,0,12,3906,1,3919,G
5-NP,263,3912,0,3,2,3917,A
5-NP,264,3,3901,2,0,3906,T
5-NP,265,18,0,0,3858,3876,C
5-NP,266,15,1,2,3854,3872,C
5-NP,267,21,1,0,3880,3902,C
5-NP,268,3905,0,0,3,3908,A
5-NP,269,3911,0,2,0,3913,A
5-NP,270,0,8,3940,0,3948,G
5-NP,271,3926,0,1,2,3929,A
5-NP,272,3931,1,1,1,3934,A
5-NP,273,3944,0,1,0,3945,A
5-NP,274,3940,1,3,1,3945,A
5-NP,275,2,0,0,3949,3951,C
5-NP,276,1,3907,1,3,3912,T
5-NP,277,1,18,3886,0,3905,G
5-NP,278,3,15,3892,0,3910,G
5-NP,279,1,14,3887,0,3902,G
5-NP,280,0,14,3890,0,3904,G
5-NP,281,0,13,3890,0,3903,G
5-NP,282,0,5,3953,0,3958,G
5-NP,283,1,0,0,4218,4219,C
5-NP,284,15,5,0,4198,4218,C
5-NP,285,18,2,1,4225,4246,C
5-NP,286,4735,1,1,0,4737,A
5-NP,287,0,4750,0,1,4751,T
5-NP,288,4997,0,1,1,4999,A
5-NP,289,0,5004,0,0,5004,T
5-NP,290,4962,0,5,0,4967,A
5-NP,291,3,1,0,4997,5001,C
5-NP,292,4588,2,0,0,4590,A
5-NP,293,2,10,4644,0,4656,G
5-NP,294,2,33,4614,0,4649,G
5-NP,295,4205,1,3,3,4212,A
5-NP,296,0,16,4234,0,4250,G
5-NP,297,4047,0,3,0,4050,A
5-NP,298,2,2,4096,0,4100,G
5-NP,299,2,4089,0,3,4094,T
5-NP,300,4055,0,1,0,4056,A
5-NP,301,0,7,4069,0,4076,G
5-NP,302,4017,1,6,0,4024,A
5-NP,303,0,4016,0,3,4019,T
5-NP,304,0,14,3991,0,4005,G
5-NP,305,1,17,4014,0,4032,G
5-NP,306,4027,0,1,0,4028,A
5-NP,307,3994,1,1,0,3996,A
5-NP,308,3997,0,1,0,3998,A
5-NP,309,3999,0,4,0,4003,A
5-NP,310,1,3985,1,1,3988,T
5-NP,311,0,20,4018,1,4039,G
5-NP,312,1,13,4027,0,4041,G
5-NP,313,4038,0,3,0,4041,A
5-NP,314,0,4003,1,3,4007,T
5-NP,315,0,18,3997,1,4016,G
5-NP,316,4004,1,5,0,4010,A
5-NP,317,1,17,4011,1,4030,G
5-NP,318,4,13,4001,0,4018,G
5-NP,319,5,33,4008,2,4048,G
5-NP,320,4032,0,6,1,4039,A
5-NP,321,4038,0,3,0,4041,A
5-NP,322,0,2,0,4087,4089,C
5-NP,323,1,4075,0,3,4079,T
5-NP,324,24,1,1,4107,4133,C
5-NP,325,3,1,4144,0,4148,G
5-NP,326,1,4151,0,5,4157,T
5-NP,327,26,0,1,4141,4168,C
5-NP,328,16,2,0,4398,4416,C
5-NP,329,0,4385,1,4,4390,T
5-NP,330,1,4398,1,0,4400,T
5-NP,331,0,4397,0,5,4402,T
5-NP,332,4415,0,1,0,4416,A
5-NP,333,2,4402,0,1,4405,T
5-NP,334,2,44,4349,1,4396,G
5-NP,335,4409,3,13,0,4425,A
5-NP,336,1,3,0,4412,4416,C
5-NP,337,4312,0,2,0,4314,A
5-NP,338,4310,1,1,1,4313,A
5-NP,339,4337,0,0,1,4338,A
5-NP,340,0,13,4464,0,4477,G
5-NP,341,4473,1,0,0,4474,A
5-NP,342,4470,1,2,2,4475,A
5-NP,343,0,25,4592,0,4617,G
5-NP,344,4637,0,2,0,4639,A
5-NP,345,4649,1,1,0,4651,A
5-NP,346,4648,0,1,1,4650,A
5-NP,347,0,4646,1,0,4647,T
5-NP,348,4631,1,0,0,4632,A
5-NP,349,4571,1,3,1,4576,A
5-NP,350,0,18,4597,0,4615,G
5-NP,351,3,4,4602,0,4609,G
5-NP,352,5,7,0,4557,4569,C
5-NP,353,3,46,4504,0,4553,G
5-NP,354,4563,2,0,0,4565,A
5-NP,355,4626,0,0,0,4626,A
5-NP,356,0,4618,1,2,4621,T
5-NP,357,20,0,0,4613,4633,C
5-NP,358,0,4621,1,1,4623,T
5-NP,359,2,19,4600,0,4621,G
5-NP,360,4,4,4617,0,4625,G
5-NP,361,2,6,0,4622,4630,C
5-NP,362,2,4,4633,1,4640,G
5-NP,363,4,6,0,4618,4628,C
5-NP,364,20,0,0,4595,4615,C
5-NP,365,4630,1,1,2,4634,A
5-NP,366,4672,1,3,1,4677,A
5-NP,367,1,1,4787,0,4789,G
5-NP,368,2,1,0,4778,4781,C
5-NP,369,27,3,0,4787,4817,C
5-NP,370,4818,2,6,1,4827,A
5-NP,371,4909,0,4,0,4913,A
5-NP,372,0,0,0,4965,4965,C
5-NP,373,4963,2,0,0,4965,A
5-NP,374,5011,1,2,0,5014,A
5-NP,375,0,4997,1,1,4999,T
5-NP,376,2,29,5031,2,5064,G
5-NP,377,2,3,5069,0,5074,G
5-NP,378,0,5009,0,2,5011,T
5-NP,379,1,20,5004,0,5025,G
5-NP,380,4974,1,4,0,4979,A
5-NP,381,2,19,5069,0,5090,G
5-NP,382,0,23,5069,0,5092,G
5-NP,383,5090,1,2,0,5093,A
5-NP,384,0,5358,0,1,5359,T
5-NP,385,7,2,5387,1,5397,G
5-NP,386,2,2,1,5399,5404,C
5-NP,387,2,5396,0,8,5406,T
5-NP,388,5428,2,2,0,5432,A
5-NP,389,4,2,0,5509,5515,C
5-NP,390,5455,0,2,1,5458,A
5-NP,391,0,5438,0,4,5442,T
5-NP,392,8,0,0,5412,5420,C
5-NP,393,0,5167,0,3,5170,T
5-NP,394,2,31,5285,0,5318,G
5-NP,395,0,6,5406,1,5413,G
5-NP,396,2,5389,0,12,5403,T
5-NP,397,45,2,0,5362,5409,C
5-NP,398,0,5333,0,3,5336,T
5-NP,399,5407,0,1,0,5408,A
5-NP,400,5412,1,4,0,5417,A
5-NP,401,2,1,1,5469,5473,C
5-NP,402,0,5455,0,11,5466,T
5-NP,403,37,2,0,5467,5506,C
5-NP,404,5446,0,4,0,5450,A
5-NP,405,2,2,0,5652,5656,C
5-NP,406,5652,0,0,0,5652,A
5-NP,407,0,5687,0,3,5690,T
5-NP,408,5616,1,3,0,5620,A
5-NP,409,5643,3,7,0,5653,A
5-NP,410,0,5654,0,1,5655,T
5-NP,411,0,59,5655,0,5714,G
5-NP,412,5677,0,2,0,5679,A
5-NP,413,1,5648,0,3,5652,T
5-NP,414,4,5506,0,0,5510,T
5-NP,415,1,5514,0,4,5519,T
5-NP,416,2,40,5456,0,5498,G
5-NP,417,2,4,5507,1,5514,G
5-NP,418,4,3,2,5504,5513,C
5-NP,419,5488,1,0,0,5489,A
5-NP,420,0,5469,0,5,5474,T
5-NP,421,1,5467,0,5,5473,T
5-NP,422,26,0,0,5448,5474,C
5-NP,423,18,2,1,5473,5494,C
5-NP,424,5581,0,0,0,5581,A
5-NP,425,5589,0,2,0,5591,A
5-NP,426,1,5576,0,2,5579,T
5-NP,427,0,5567,0,3,5570,T
5-NP,428,1,5579,1,1,5582,T
5-NP,429,1,35,5579,0,5615,G
5-NP,430,5602,1,8,0,5611,A
5-NP,431,5609,4,2,0,5615,A
5-NP,432,3,5632,0,1,5636,T
5-NP,433,0,30,5525,1,5556,G
5-NP,434,5716,1,6,0,5723,A
5-NP,435,0,5722,0,4,5726,T
5-NP,436,1,3,5748,0,5752,G
5-NP,437,6,4,2,5889,5901,C
5-NP,438,5878,0,5,0,5883,A
5-NP,439,6112,1,5,0,6118,A
5-NP,440,6,1,0,6104,6111,C
5-NP,441,6169,1,1,0,6171,A
5-NP,442,0,6280,0,3,6283,T
5-NP,443,6151,0,4,0,6155,A
5-NP,444,5,0,0,6258,6263,C
5-NP,445,27,0,1,6208,6236,C
5-NP,446,6074,1,7,0,6082,A
5-NP,447,1,10,6131,0,6142,G
5-NP,448,6004,1,3,0,6008,A
5-NP,449,4,24,6135,1,6164,G
5-NP,450,4,39,6087,1,6131,G
5-NP,451,6070,1,6,0,6077,A
5-NP,452,3,3,0,6116,6122,C
5-NP,453,6051,1,2,0,6054,A
5-NP,454,6032,1,7,1,6041,A
5-NP,455,2,41,6034,0,6077,G
5-NP,456,6001,0,3,0,6004,A
5-NP,457,3,2,6035,0,6040,G
5-NP,458,1,0,0,5954,5955,C
5-NP,459,1,5911,0,13,5925,T
5-NP,460,32,1,0,5923,5956,C
5-NP,461,0,5912,0,9,5921,T
5-NP,462,0,5960,0,0,5960,T
5-NP,463,0,8,5974,0,5982,G
5-NP,464,0,5941,0,0,5941,T
5-NP,465,0,5933,1,4,5938,T
5-NP,466,53,5,0,5861,5919,C
5-NP,467,6,77,5823,0,5906,G
5-NP,468,5993,1,0,2,5996,A
5-NP,469,5995,2,3,1,6001,A
5-NP,470,4,0,0,6042,6046,C
5-NP,471,1,6016,1,4,6022,T
5-NP,472,4,22,6076,0,6102,G
5-NP,473,0,30,6104,0,6134,G
5-NP,474,6131,3,1,0,6135,A
5-NP,475,6148,1,1,0,6150,A
5-NP,476,0,6127,0,1,6128,T
5-NP,477,3,33,6056,2,6094,G
5-NP,478,0,29,6094,1,6124,G
5-NP,479,6151,0,7,1,6159,A
5-NP,480,3,6209,0,4,6216,T
5-NP,481,28,0,1,6189,6218,C
5-NP,482,23,1,3,6213,6240,C
5-NP,483,22,3,0,6245,6270,C
5-NP,484,6293,1,8,2,6304,A
5-NP,485,2,27,6343,0,6372,G
5-NP,486,6342,1,1,1,6345,A
5-NP,487,6337,0,4,0,6341,A
5-NP,488,0,6281,0,1,6282,T
5-NP,489,2,4,6348,0,6354,G
5-NP,490,1,6313,1,3,6318,T
5-NP,491,6,6,6315,0,6327,G
5-NP,492,8,1,0,6326,6335,C
5-NP,493,1,6290,0,7,6298,T
5-NP,494,46,1,0,6573,6620,C
5-NP,495,3,6571,1,1,6576,T
5-NP,496,24,3,1,6770,6798,C
5-NP,497,2,6762,0,3,6767,T
5-NP,498,5,26,6725,0,6756,G
5-NP,499,6800,0,3,0,6803,A
5-NP,500,2,6768,0,2,6772,T
5-NP,501,1,0,6767,0,6768,G
5-NP,502,4,1,0,6742,6747,C
5-NP,503,6512,0,8,1,6521,A
5-NP,504,7,24,6651,0,6682,G
5-NP,505,0,33,6520,0,6553,G
5-NP,506,2,8,6595,0,6605,G
5-NP,507,6,2,0,6577,6585,C
5-NP,508,1,6564,0,5,6570,T
5-NP,509,24,6,0,6556,6586,C
5-NP,510,2,50,6545,2,6599,G
5-NP,511,6663,1,6,0,6670,A
5-NP,512,1,1,0,6663,6665,C
5-NP,513,3,6564,0,11,6578,T
5-NP,514,33,0,0,6809,6842,C
5-NP,515,0,6776,0,8,6784,T
5-NP,516,43,4,0,7542,7589,C
5-NP,517,31,1,0,7566,7598,C
5-NP,518,35,4,1,7573,7613,C
5-NP,519,0,7589,0,11,7600,T
5-NP,520,7546,0,2,0,7548,A
5-NP,521,1,19,7525,0,7545,G
5-NP,522,7538,0,2,1,7541,A
5-NP,523,7319,1,7,0,7327,A
5-NP,524,1,40,7290,0,7331,G
5-NP,525,0,8,7204,0,7212,G
5-NP,526,1,7089,1,2,7093,T
5-NP,527,33,3,1,7043,7080,C
5-NP,528,18,16,1,7056,7091,C
5-NP,529,9,16,7061,1,7087,G
5-NP,530,3,45,7100,0,7148,G
5-NP,531,7129,1,3,1,7134,A
5-NP,532,2,4,7208,1,7215,G
5-NP,533,2,1,0,7229,7232,C
5-NP,534,1,7118,0,11,7130,T
5-NP,535,4,4,7146,1,7155,G
5-NP,536,4,3,0,7161,7168,C
5-NP,537,7149,5,8,0,7162,A
5-NP,538,2,20,7169,0,7191,G
5-NP,539,1,5,7210,0,7216,G
5-NP,540,0,7208,0,2,7210,T
5-NP,541,4,4,7138,0,7146,G
5-NP,542,2,4,1,7156,7163,C
5-NP,543,2,7136,0,5,7143,T
5-NP,544,6,4,7156,0,7166,G
5-NP,545,2,3,0,7152,7157,C
5-NP,546,7235,0,3,0,7238,A
5-NP,547,0,5,7372,0,7377,G
5-NP,548,0,7309,0,1,7310,T
5-NP,549,63,3,1,7275,7342,C
5-NP,550,7316,0,2,0,7318,A
5-NP,551,7330,5,1,0,7336,A
5-NP,552,7313,3,12,2,7330,A
5-NP,553,4,36,7330,1,7371,G
5-NP,554,1,34,7389,0,7424,G
5-NP,555,7378,1,2,0,7381,A
5-NP,556,7301,0,5,1,7307,A
5-NP,557,0,7294,0,3,7297,T
5-NP,558,40,13,0,7233,7286,C
5-NP,559,5,33,7241,1,7280,G
5-NP,560,1,34,7448,1,7484,G
5-NP,561,2,50,7444,2,7498,G
5-NP,562,7466,1,6,0,7473,A
5-NP,563,1,4,0,7475,7480,C
5-NP,564,7363,1,3,0,7367,A
5-NP,565,7502,0,5,0,7507,A
5-NP,566,5,7520,1,0,7526,T
5-NP,567,5,25,7545,0,7575,G
5-NP,568,2,3,7727,2,7734,G
5-NP,569,1,7631,0,6,7638,T
5-NP,570,4,30,7632,1,7667,G
5-NP,571,7648,2,8,0,7658,A
5-NP,572,1,7619,1,7,7628,T
5-NP,573,9,33,7605,0,7647,G
5-NP,574,3,50,7634,2,7689,G
5-NP,575,7666,0,10,2,7678,A
5-NP,576,7663,0,6,0,7669,A
5-NP,577,3,5,0,7651,7659,C
5-NP,578,2,7397,0,1,7400,T
5-NP,579,4,46,7695,1,7746,G
5-NP,580,7731,4,4,2,7741,A
5-NP,581,1,7724,0,3,7728,T
5-NP,582,58,4,1,7677,7740,C
5-NP,583,7588,1,6,3,7598,A
5-NP,584,2,21,7768,1,7792,G
5-NP,585,7761,0,4,0,7765,A
5-NP,586,7771,0,2,0,7773,A
5-NP,587,1,7764,0,4,7769,T
5-NP,588,5,52,7575,1,7633,G
5-NP,589,7,3,7706,0,7716,G
5-NP,590,1,7711,0,5,7717,T
5-NP,591,57,0,0,7668,7725,C
5-NP,592,7717,0,1,0,7718,A
5-NP,593,7653,2,4,0,7659,A
5-NP,594,7663,1,0,1,7665,A
5-NP,595,2,11,0,7664,7677,C
5-NP,596,6,36,7627,3,7672,G
5-NP,597,2,28,7650,2,7682,G
5-NP,598,4,28,7573,3,7608,G
5-NP,599,4,48,7579,0,7631,G
5-NP,600,7557,2,8,0,7567,A
5-NP,601,7629,2,8,0,7639,A
5-NP,602,1,7629,1,6,7637,T
5-NP,603,50,4,0,7594,7648,C
5-NP,604,7636,1,5,0,7642,A
5-NP,605,7641,1,2,0,7644,A
5-NP,606,2,5,0,7592,7599,C
5-NP,607,2,46,7504,0,7552,G
5-NP,608,7533,1,5,0,7539,A
5-NP,609,3,7520,0,2,7525,T
5-NP,610,48,5,1,7468,7522,C
5-NP,611,5,33,7488,2,7528,G
5-NP,612,7519,2,1,0,7522,A
5-NP,613,7513,0,2,0,7515,A
5-NP,614,7530,1,2,0,7533,A
5-NP,615,1,7589,0,0,7590,T
5-NP,616,1,7584,3,1,7589,T
5-NP,617,1,7583,0,4,7588,T
5-NP,618,1,7620,0,3,7624,T
5-NP,619,0,7627,0,5,7632,T
5-NP,620,2,46,7616,1,7665,G
5-NP,621,0,41,7618,0,7659,G
5-NP,622,7607,0,12,0,7619,A
5-NP,623,0,26,7645,0,7671,G
5-NP,624,7553,1,6,0,7560,A
5-NP,625,1,23,7888,1,7913,G
5-NP,626,0,6,7941,0,7947,G
5-NP,627,0,7920,1,7,7928,T
5-NP,628,1,41,7903,1,7946,G
5-NP,629,7924,2,12,0,7938,A
5-NP,630,1,45,7930,0,7976,G
5-NP,631,7964,0,7,0,7971,A
5-NP,632,7928,0,5,0,7933,A
5-NP,633,1,7898,0,4,7903,T
5-NP,634,4,60,7589,1,7654,G
5-NP,635,1,23,7540,0,7564,G
5-NP,636,4,5,7577,0,7586,G
5-NP,637,8,10,1,7535,7554,C
5-NP,638,7,23,7526,1,7557,G
5-NP,639,1,29,7574,0,7604,G
5-NP,640,7586,1,3,0,7590,A
5-NP,641,7607,2,3,0,7612,A
5-NP,642,7718,1,5,0,7724,A
5-NP,643,7743,2,7,5,7757,A
5-NP,644,2,1,0,7811,7814,C
5-NP,645,7777,1,4,0,7782,A
5-NP,646,7765,0,8,0,7773,A
5-NP,647,2,22,7747,0,7771,G
5-NP,648,7552,0,2,2,7556,A
5-NP,649,7593,2,2,1,7598,A
5-NP,650,8,2,7772,0,7782,G
5-NP,651,3,7775,0,1,7779,T
5-NP,652,3,7,8165,1,8176,G
5-NP,653,3,1,0,8124,8128,C
5-NP,654,1,8126,0,8,8135,T
5-NP,655,0,8172,0,2,8174,T
5-NP,656,8239,1,0,0,8240,A
5-NP,657,1,8242,0,3,8246,T
5-NP,658,0,56,8227,3,8286,G
5-NP,659,8058,2,15,1,8076,A
5-NP,660,6,46,8047,3,8102,G
5-NP,661,7630,0,6,0,7636,A
5-NP,662,3,35,7649,1,7688,G
5-NP,663,7648,0,8,0,7656,A
5-NP,664,7738,3,3,0,7744,A
5-NP,665,0,7674,0,1,7675,T
5-NP,666,6,4,7784,1,7795,G
5-NP,667,2,7757,2,10,7771,T
5-NP,668,7,9,7790,0,7806,G
5-NP,669,6,2,0,7766,7774,C
5-NP,670,7742,2,4,0,7748,A
5-NP,671,7731,3,4,0,7738,A
5-NP,672,1,3,0,7725,7729,C
5-NP,673,7650,1,0,1,7652,A
5-NP,674,2,7656,1,3,7662,T
5-NP,675,2,7572,0,9,7583,T
5-NP,676,41,2,1,7565,7609,C
5-NP,677,0,7558,0,7,7565,T
5-NP,678,2,7567,1,1,7571,T
5-NP,679,7570,1,2,1,7574,A
5-NP,680,7534,1,0,0,7535,A
5-NP,681,7536,2,4,0,7542,A
5-NP,682,1,29,7514,1,7545,G
5-NP,683,1,31,7506,0,7538,G
5-NP,684,7496,0,7,0,7503,A
5-NP,685,7484,2,3,0,7489,A
5-NP,686,7474,2,6,0,7482,A
5-NP,687,7597,2,2,0,7601,A
5-NP,688,1,7605,0,0,7606,T
5-NP,689,0,7585,1,2,7588,T
5-NP,690,1,7616,0,2,7619,T
5-NP,691,33,4,0,7581,7618,C
5-NP,692,7619,0,3,0,7622,A
5-NP,693,7618,0,1,0,7619,A
5-NP,694,7602,1,7,0,7610,A
5-NP,695,3,6,2,7690,7701,C
5-NP,696,7577,0,4,0,7581,A
5-NP,697,0,8,7708,0,7716,G
5-NP,698,4,0,0,7711,7715,C
5-NP,699,1,7691,0,9,7701,T
5-NP,700,13,8,7817,3,7841,G
5-NP,701,7,7,1,7792,7807,C
5-NP,702,7881,1,8,1,7891,A
5-NP,703,4,5,0,7905,7914,C
5-NP,704,7824,0,2,0,7826,A
5-NP,705,7848,2,6,0,7856,A
5-NP,706,7687,1,8,0,7696,A
5-NP,707,1,59,7950,0,8010,G
5-NP,708,7978,3,16,0,7997,A
5-NP,709,2,2,8028,0,8032,G
5-NP,710,7,3,0,7990,8000,C
5-NP,711,7975,2,1,0,7978,A
5-NP,712,8190,1,7,2,8200,A
5-NP,713,0,8199,1,3,8203,T
5-NP,714,2,37,8172,0,8211,G
5-NP,715,3,10,8245,1,8259,G
5-NP,716,0,8005,1,9,8015,T
5-NP,717,11,36,7973,2,8022,G
5-NP,718,3,42,8040,1,8086,G
5-NP,719,8086,1,3,0,8090,A
5-NP,720,2,8064,0,7,8073,T
5-NP,721,41,0,4,7827,7872,C
5-NP,722,7892,0,3,2,7897,A
5-NP,723,7946,1,5,1,7953,A
5-NP,724,1,2,7984,0,7987,G
5-NP,725,2,7925,0,1,7928,T
5-NP,726,3,45,7902,1,7951,G
5-NP,727,7822,0,9,0,7831,A
5-NP,728,3,43,7825,0,7871,G
5-NP,729,7842,0,7,1,7850,A
5-NP,730,3,32,7821,0,7856,G
5-NP,731,7796,0,5,0,7801,A
5-NP,732,7665,1,0,1,7667,A
5-NP,733,7685,0,13,0,7698,A
5-NP,734,0,3,7733,0,7736,G
5-NP,735,0,7714,1,3,7718,T
5-NP,736,59,7,2,7632,7700,C
5-NP,737,8,26,7647,0,7681,G
5-NP,738,1,37,7663,1,7702,G
5-NP,739,7695,0,4,0,7699,A
5-NP,740,7731,2,5,0,7738,A
5-NP,741,10,0,0,7744,7754,C
5-NP,742,27,5,0,7679,7711,C
5-NP,743,46,3,0,7673,7722,C
5-NP,744,7668,0,11,3,7682,A
5-NP,745,3,17,7700,0,7720,G
5-NP,746,0,26,7701,0,7727,G
5-NP,747,7688,0,5,0,7693,A
5-NP,748,7690,0,4,1,7695,A
5-NP,749,7660,2,6,0,7668,A
5-NP,750,3,7,0,7692,7702,C
5-NP,751,6,8,7669,0,7683,G
5-NP,752,5,2,1,7656,7664,C
5-NP,753,2,7650,0,3,7655,T
5-NP,754,4,42,7632,0,7678,G
5-NP,755,7637,2,5,1,7645,A
5-NP,756,0,32,7724,0,7756,G
5-NP,757,7765,3,5,0,7773,A
5-NP,758,0,7753,0,1,7754,T
5-NP,759,34,7,0,7618,7659,C
5-NP,760,7,21,7644,2,7674,G
5-NP,761,7672,2,3,0,7677,A
5-NP,762,7666,0,1,0,7667,A
5-NP,763,0,25,7680,0,7705,G
5-NP,764,7724,1,2,0,7727,A
5-NP,765,2,7626,2,2,7632,T
5-NP,766,30,2,0,7687,7719,C
5-NP,767,1,7691,0,10,7702,T
5-NP,768,65,2,1,7744,7812,C
5-NP,769,7820,1,1,0,7822,A
5-NP,770,0,7825,1,2,7828,T
5-NP,771,7839,1,0,0,7840,A
5-NP,772,1,7817,0,3,7821,T
5-NP,773,2,7749,1,0,7752,T
5-NP,774,2,7724,0,0,7726,T
5-NP,775,0,7613,0,1,7614,T
5-NP,776,0,7624,1,5,7630,T
5-NP,777,7625,1,2,1,7629,A
5-NP,778,2,7,7603,2,7614,G
5-NP,779,2,1,0,7616,7619,C
5-NP,780,7577,1,2,2,7582,A
5-NP,781,7555,1,3,0,7559,A
5-NP,782,0,27,7748,0,7775,G
5-NP,783,7768,2,7,1,7778,A
5-NP,784,0,7786,1,0,7787,T
5-NP,785,15,0,0,7809,7824,C
5-NP,786,2,7791,0,5,7798,T
5-NP,787,4,6,7995,0,8005,G
5-NP,788,5,3,0,8008,8016,C
5-NP,789,8029,1,3,0,8033,A
5-NP,790,0,8114,3,2,8119,T
5-NP,791,0,7865,1,3,7869,T
5-NP,792,1,30,8293,2,8326,G
5-NP,793,8457,0,6,0,8463,A
5-NP,794,0,8429,1,5,8435,T
5-NP,795,8451,0,2,0,8453,A
5-NP,796,1,8296,0,1,8298,T
5-NP,797,4,8232,0,1,8237,T
5-NP,798,1,44,8246,0,8291,G
5-NP,799,8178,3,7,0,8188,A
5-NP,800,2,29,8210,1,8242,G
5-NP,801,7780,1,6,0,7787,A
5-NP,802,4,35,7630,0,7669,G
5-NP,803,1,40,7730,0,7771,G
5-NP,804,7741,1,9,0,7751,A
5-NP,805,1,7737,0,7,7745,T
5-NP,806,59,3,0,7688,7750,C
5-NP,807,7668,2,10,0,7680,A
5-NP,808,0,5,7714,3,7722,G
5-NP,809,1,7675,0,8,7684,T
5-NP,810,2,7614,0,2,7618,T
5-NP,811,4,8,7617,0,7629,G
5-NP,812,4,1,0,7554,7559,C
5-NP,813,1,7553,0,11,7565,T
5-NP,814,88,2,0,7519,7609,C
5-NP,815,7603,1,4,2,7610,A
5-NP,816,7,5,0,7630,7642,C
5-NP,817,7608,0,1,0,7609,A
5-NP,818,7654,0,2,2,7658,A
5-NP,819,7664,1,2,0,7667,A
5-NP,820,0,7658,1,5,7664,T
5-NP,821,42,0,0,7618,7660,C
5-NP,822,1,7633,2,6,7642,T
5-NP,823,0,7608,1,3,7612,T
5-NP,824,6,10,7626,2,7644,G
5-NP,825,7,4,0,7629,7640,C
5-NP,826,35,0,1,7704,7740,C
5-NP,827,1,7713,1,3,7718,T
5-NP,828,7747,2,3,0,7752,A
5-NP,829,10,4,1,7743,7758,C
5-NP,830,25,2,0,7703,7730,C
5-NP,831,2,7700,0,5,7707,T
5-NP,832,1,2,7818,0,7821,G
5-NP,833,8,3,1,7780,7792,C
5-NP,834,33,4,2,7756,7795,C
5-NP,835,2,7663,0,8,7673,T
5-NP,836,0,3,7760,0,7763,G
5-NP,837,3,7711,0,6,7720,T
5-NP,838,5,11,7774,0,7790,G
5-NP,839,9,7,0,7819,7835,C
5-NP,840,4,1,7938,0,7943,G
5-NP,841,0,7785,0,1,7786,T
5-NP,842,7774,0,6,0,7780,A
5-NP,843,0,7781,0,4,7785,T
5-NP,844,3,42,7742,0,7787,G
5-NP,845,3,49,7992,1,8045,G
5-NP,846,8018,2,4,0,8024,A
5-NP,847,8,2,0,7914,7924,C
5-NP,848,35,2,0,7840,7877,C
5-NP,849,0,7742,0,12,7754,T
5-NP,850,3,7,8079,1,8090,G
5-NP,851,4,4,1,8090,8099,C
5-NP,852,8103,2,6,0,8111,A
5-NP,853,3,0,8263,0,8266,G
5-NP,854,3,7843,0,4,7850,T
5-NP,855,8116,1,1,0,8118,A
5-NP,856,1,8095,0,12,8108,T
5-NP,857,31,1,0,8039,8071,C
5-NP,858,36,2,2,8041,8081,C
5-NP,859,7676,1,2,1,7680,A
5-NP,860,0,4,7713,0,7717,G
5-NP,861,0,7674,0,5,7679,T
5-NP,862,3,53,7658,0,7714,G
5-NP,863,0,37,7649,1,7687,G
5-NP,864,1,3,7536,0,7540,G
5-NP,865,3,7500,0,8,7511,T
5-NP,866,7482,1,6,0,7489,A
5-NP,867,3,14,0,7462,7479,C
5-NP,868,6,64,7371,0,7441,G
5-NP,869,7406,2,5,1,7414,A
5-NP,870,2,0,0,7409,7411,C
5-NP,871,0,7197,1,7,7205,T
5-NP,872,2,7207,1,1,7211,T
5-NP,873,31,7,1,7132,7171,C
5-NP,874,5,44,7146,0,7195,G
5-NP,875,7192,1,3,1,7197,A
5-NP,876,7192,1,2,0,7195,A
5-NP,877,7210,0,4,0,7214,A
5-NP,878,7219,1,2,0,7222,A
5-NP,879,7180,2,6,1,7189,A
5-NP,880,0,21,7210,0,7231,G
5-NP,881,7192,1,12,1,7206,A
5-NP,882,1,38,7217,0,7256,G
5-NP,883,3,40,7272,0,7315,G
5-NP,884,3,29,7294,0,7326,G
5-NP,885,7324,0,10,0,7334,A
5-NP,886,0,7326,2,3,7331,T
5-NP,887,7366,2,3,0,7371,A
5-NP,888,1,7348,0,6,7355,T
5-NP,889,0,7362,0,2,7364,T
5-NP,890,46,0,0,7363,7409,C
5-NP,891,16,1,0,7302,7319,C
5-NP,892,0,7209,0,3,7212,T
5-NP,893,2,7198,0,0,7200,T
5-NP,894,2,35,7253,1,7291,G
5-NP,895,2,10,7314,0,7326,G
5-NP,896,1,7257,0,6,7264,T
5-NP,897,5,31,7189,1,7226,G
5-NP,898,6,12,7114,1,7133,G
5-NP,899,3,32,7330,1,7366,G
5-NP,900,7350,3,3,0,7356,A
5-NP,901,7355,1,2,0,7358,A
5-NP,902,0,7362,0,2,7364,T
5-NP,903,7209,3,8,1,7221,A
5-NP,904,2,38,7188,0,7228,G
5-NP,905,7155,1,10,2,7168,A
5-NP,906,4,2,0,7147,7153,C
5-NP,907,41,2,0,7037,7080,C
5-NP,908,47,2,0,6751,6800,C
5-NP,909,2,6759,0,51,6812,T
5-NP,910,2,6816,1,5,6824,T
5-NP,911,2,6815,0,6,6823,T
5-NP,912,40,1,0,6785,6826,C
5-NP,913,6784,0,2,0,6786,A
5-NP,914,6793,1,1,0,6795,A
5-NP,915,6778,1,3,0,6782,A
5-NP,916,2,0,0,6779,6781,C
5-NP,917,1,6551,0,3,6555,T
5-NP,918,6519,2,2,0,6523,A
5-NP,919,2,0,0,6585,6587,C
5-NP,920,1,6549,1,9,6560,T
5-NP,921,0,6568,0,3,6571,T
5-NP,922,16,1,2,6570,6589,C
5-NP,923,6563,0,1,2,6566,A
5-NP,924,6574,0,1,0,6575,A
5-NP,925,6541,0,2,1,6544,A
5-NP,926,6533,1,5,3,6542,A
5-NP,927,1,6487,0,0,6488,T
5-NP,928,6345,0,1,0,6346,A
5-NP,929,1,1,6424,1,6427,G
5-NP,930,3,1,0,6450,6454,C
5-NP,931,30,5,1,6495,6531,C
5-NP,932,6541,0,1,0,6542,A
5-NP,933,6554,0,2,0,6556,A
5-NP,934,6766,2,5,2,6775,A
5-NP,935,0,6787,1,1,6789,T
5-NP,936,6815,1,2,0,6818,A
5-NP,937,1,6798,0,1,6800,T
5-NP,938,6650,0,4,1,6655,A
5-NP,939,2,6,2,6654,6664,C
5-NP,940,6443,2,2,1,6448,A
5-NP,941,0,3,6581,0,6584,G
5-NP,942,2,1,0,6535,6538,C
5-NP,943,0,6283,0,11,6294,T
5-NP,944,1,6331,0,1,6333,T
5-NP,945,6348,0,0,0,6348,A
5-NP,946,6349,1,4,0,6354,A
5-NP,947,1,6353,0,4,6358,T
5-NP,948,37,6,0,6299,6342,C
5-NP,949,6032,0,3,0,6035,A
5-NP,950,1,37,6050,0,6088,G
5-NP,951,6075,1,5,0,6081,A
5-NP,952,3,0,1,6117,6121,C
5-NP,953,26,2,0,6031,6059,C
5-NP,954,0,5953,0,3,5956,T
5-NP,955,5975,0,3,0,5978,A
5-NP,956,5974,0,3,0,5977,A
5-NP,957,1,1,0,6014,6016,C
5-NP,958,2,36,5980,1,6019,G
5-NP,959,5842,0,1,0,5843,A
5-NP,960,1,31,5817,1,5850,G
5-NP,961,5759,0,3,0,5762,A
5-NP,962,5810,0,0,1,5811,A
5-NP,963,0,5790,0,5,5795,T
5-NP,964,28,2,0,5703,5733,C
5-NP,965,19,1,1,5705,5726,C
5-NP,966,5567,0,6,0,5573,A
5-NP,967,0,1,5610,0,5611,G
5-NP,968,6,5,1,5595,5607,C
5-NP,969,5645,1,1,0,5647,A
5-NP,970,1,4,0,5689,5694,C
5-NP,971,5584,0,2,0,5586,A
5-NP,972,3,1,0,5594,5598,C
5-NP,973,5569,0,2,4,5575,A
5-NP,974,5585,0,8,1,5594,A
5-NP,975,1,32,5589,1,5623,G
5-NP,976,5524,0,8,0,5532,A
5-NP,977,1,3,5557,0,5561,G
5-NP,978,2,5400,0,6,5408,T
5-NP,979,37,3,0,5326,5366,C
5-NP,980,5320,1,5,0,5326,A
5-NP,981,1,2,5314,0,5317,G
5-NP,982,5,1,0,5304,5310,C
5-NP,983,0,5214,0,4,5218,T
5-NP,984,2,22,5224,0,5248,G
5-NP,985,6,4,5238,0,5248,G
5-NP,986,2,5167,0,3,5172,T
5-NP,987,4,2,5198,1,5205,G
5-NP,988,1,5107,0,7,5115,T
5-NP,989,2,22,5059,0,5083,G
5-NP,990,1,9,5055,0,5065,G
5-NP,991,5010,0,1,0,5011,A
5-NP,992,0,5016,0,4,5020,T
5-NP,993,4,19,4674,0,4697,G
5-NP,994,3,5,4623,0,4631,G
5-NP,995,4,1,0,4604,4609,C
5-NP,996,4506,1,5,0,4512,A
5-NP,997,0,4500,7,4,4511,T
5-NP,998,8,3,4451,0,4462,G
5-NP,999,3,1,0,4509,4513,C
5-NP,1000,28,3,0,4472,4503,C
5-NP,1001,4479,0,2,0,4481,A
5-NP,1002,0,4458,0,2,4460,T
5-NP,1003,0,4340,0,2,4342,T
5-NP,1004,16,0,0,4343,4359,C
5-NP,1005,2,4212,1,1,4216,T
5-NP,1006,4,4,4207,0,4215,G
5-NP,1007,1,0,0,4205,4206,C
5-NP,1008,0,3894,2,6,3902,T
5-NP,1009,2,3,3935,2,3942,G
5-NP,1010,0,2,0,3765,3767,C
5-NP,1011,3767,1,0,0,3768,A
5-NP,1012,0,3766,0,0,3766,T
5-NP,1013,0,3686,0,3,3689,T
5-NP,1014,1,3680,0,1,3682,T
5-NP,1015,0,17,3652,1,3670,G
5-NP,1016,3665,0,0,0,3665,A
5-NP,1017,3666,1,2,0,3669,A
5-NP,1018,1,17,3684,0,3702,G
5-NP,1019,3692,0,1,0,3693,A
5-NP,1020,0,3687,0,0,3687,T
5-NP,1021,0,3680,0,1,3681,T
5-NP,1022,0,3673,0,2,3675,T
5-NP,1023,3674,0,1,0,3675,A
5-NP,1024,3673,0,4,1,3678,A
5-NP,1025,2,16,3663,0,3681,G
5-NP,1026,3670,0,0,0,3670,A
5-NP,1027,2,3674,0,1,3677,T
5-NP,1028,0,3604,0,0,3604,T
5-NP,1029,1,1,3627,0,3629,G
5-NP,1030,1,3620,0,4,3625,T
5-NP,1031,1,3615,0,0,3616,T
5-NP,1032,3614,0,2,0,3616,A
5-NP,1033,3612,0,1,0,3613,A
5-NP,1034,3,2,3614,0,3619,G
5-NP,1035,2,0,0,3624,3626,C
5-NP,1036,1,3526,0,3,3530,T
5-NP,1037,0,3539,1,4,3544,T
5-NP,1038,12,1,0,3529,3542,C
5-NP,1039,3538,0,4,0,3542,A
5-NP,1040,1,3540,0,0,3541,T
5-NP,1041,9,2,0,3531,3542,C
5-NP,1042,3475,1,3,0,3479,A
5-NP,1043,0,13,3466,1,3480,G
5-NP,1044,3430,0,4,0,3434,A
5-NP,1045,1,16,3427,0,3444,G
5-NP,1046,2,22,3426,0,3450,G
5-NP,1047,0,18,3417,0,3435,G
5-NP,1048,3426,0,7,1,3434,A
5-NP,1049,0,2,0,3432,3434,C
5-NP,1050,3429,0,2,0,3431,A
5-NP,1051,3438,1,3,0,3442,A
5-NP,1052,3444,0,0,0,3444,A
5-NP,1053,3448,0,6,0,3454,A
5-NP,1054,2,1,3462,0,3465,G
5-NP,1055,0,3365,0,4,3369,T
5-NP,1056,3334,0,3,0,3337,A
5-NP,1057,0,3325,0,6,3331,T
5-NP,1058,11,3,0,3312,3326,C
5-NP,1059,0,3301,0,1,3302,T
5-NP,1060,26,1,0,3295,3322,C
5-NP,1061,8,0,0,3284,3292,C
5-NP,1062,0,3268,0,2,3270,T
5-NP,1063,13,0,1,3247,3261,C
5-NP,1064,7,13,3226,0,3246,G
5-NP,1065,0,9,3249,0,3258,G
5-NP,1066,0,19,3235,0,3254,G
5-NP,1067,0,14,3238,0,3252,G
5-NP,1068,3,12,3238,0,3253,G
5-NP,1069,3175,1,0,0,3176,A
5-NP,1070,3168,4,1,1,3174,A
5-NP,1071,3176,0,1,0,3177,A
5-NP,1072,1,0,0,3196,3197,C
5-NP,1073,0,3179,0,0,3179,T
5-NP,1074,2,0,3219,0,3221,G
5-NP,1075,2,3182,1,5,3190,T
5-NP,1076,34,0,2,3160,3196,C
5-NP,1077,3241,0,4,0,3245,A
5-NP,1078,3256,0,5,0,3261,A
5-NP,1079,0,0,1,3270,3271,C
5-NP,1080,0,3249,0,4,3253,T
5-NP,1081,3191,0,1,0,3192,A
5-NP,1082,0,11,3191,0,3202,G
5-NP,1083,3126,0,2,0,3128,A
5-NP,1084,0,6,3119,1,3126,G
5-NP,1085,0,13,3111,0,3124,G
5-NP,1086,2994,1,1,0,2996,A
5-NP,1087,2,0,3092,0,3094,G
5-NP,1088,0,3054,0,0,3054,T
5-NP,1089,3051,0,3,0,3054,A
5-NP,1090,3,2,0,3050,3055,C
5-NP,1091,3014,1,0,0,3015,A
5-NP,1092,3010,0,4,0,3014,A
5-NP,1093,2976,0,0,0,2976,A
5-NP,1094,0,2944,0,0,2944,T
5-NP,1095,0,2931,0,0,2931,T
5-NP,1096,1,2,2839,0,2842,G
5-NP,1097,1,0,0,2815,2816,C
5-NP,1098,1,2798,0,2,2801,T
5-NP,1099,2,2796,0,4,2802,T
5-NP,1100,13,1,2,2788,2804,C
5-NP,1101,2798,0,0,0,2798,A
5-NP,1102,2796,1,0,1,2798,A
5-NP,1103,2803,0,1,0,2804,A
5-NP,1104,0,2814,0,0,2814,T
5-NP,1105,1,11,2801,0,2813,G
5-NP,1106,2734,1,7,0,2742,A
5-NP,1107,1,14,2744,0,2759,G
5-NP,1108,2758,0,4,0,2762,A
5-NP,1109,2759,1,0,0,2760,A
5-NP,1110,0,1,0,2760,2761,C
5-NP,1111,2718,0,3,0,2721,A
5-NP,1112,0,2724,0,0,2724,T
5-NP,1113,1,10,2740,1,2752,G
5-NP,1114,0,7,2762,0,2769,G
5-NP,1115,2764,0,1,1,2766,A
5-NP,1116,0,2720,1,1,2722,T
5-NP,1117,2677,1,0,0,2678,A
5-NP,1118,2795,0,1,1,2797,A
5-NP,1119,1,2738,0,0,2739,T
5-NP,1120,2725,0,1,0,2726,A
5-NP,1121,3,2707,0,2,2712,T
5-NP,1122,0,19,2479,0,2498,G
5-NP,1123,0,7,2429,0,2436,G
5-NP,1124,0,3,2409,0,2412,G
5-NP,1125,2391,1,2,0,2394,A
5-NP,1126,0,2390,0,0,2390,T
5-NP,1127,14,1,0,1851,1866,C
5-NP,1128,3,14,1852,0,1869,G
5-NP,1129,1860,2,1,1,1864,A
5-NP,1130,4,0,1860,0,1864,G
5-NP,1131,1,0,0,1859,1860,C
5-NP,1132,1830,0,0,1,1831,A
5-NP,1133,5,1,1,1876,1883,C
5-NP,1134,0,1855,2,0,1857,T
5-NP,1135,7,0,2,1855,1864,C
5-NP,1136,1,1851,0,3,1855,T
5-NP,1137,0,1823,0,0,1823,T
5-NP,1138,0,9,1817,0,1826,G
5-NP,1139,1816,0,0,0,1816,A
5-NP,1140,1813,0,0,0,1813,A
5-NP,1141,0,2,0,1810,1812,C
5-NP,1142,0,1382,1,0,1383,T
5-NP,1143,0,4,1383,0,1387,G
5-NP,1144,1315,0,3,0,1318,A
5-NP,1145,0,1,1322,0,1323,G
5-NP,1146,1321,0,0,0,1321,A
5-NP,1147,1308,0,2,0,1310,A
5-NP,1148,0,1,1321,1,1323,G
5-NP,1149,3,3,0,1290,1296,C
5-NP,1150,4,4,1282,1,1291,G
5-NP,1151,0,2,1285,0,1287,G
5-NP,1152,1,1,1263,0,1265,G
5-NP,1153,0,1255,1,0,1256,T
5-NP,1154,1221,1,1,0,1223,A
5-NP,1155,2,0,0,1221,1223,C
5-NP,1156,1,976,1,0,978,T
5-NP,1157,1,3,953,0,957,G
5-NP,1158,0,2,944,0,946,G
5-NP,1159,1,1,927,0,929,G
5-NP,1160,1,0,0,914,915,C
5-NP,1161,4,0,0,853,857,C
5-NP,1162,859,0,0,0,859,A
5-NP,1163,0,857,0,0,857,T
5-NP,1164,855,0,0,0,855,A
5-NP,1165,856,0,0,0,856,A
5-NP,1166,0,3,848,0,851,G
5-NP,1167,1,4,864,0,869,G
5-NP,1168,855,1,1,0,857,A
5-NP,1169,0,0,0,853,853,C
5-NP,1170,2,1,0,850,853,C
5-NP,1171,843,0,0,0,843,A
5-NP,1172,0,2,859,0,861,G
5-NP,1173,1,4,860,0,865,G
5-NP,1174,861,0,0,0,861,A
5-NP,1175,0,0,868,0,868,G
5-NP,1176,0,821,0,1,822,T
5-NP,1177,0,0,822,0,822,G
5-NP,1178,1,2,830,0,833,G
5-NP,1179,832,0,1,0,833,A
5-NP,1180,0,2,832,0,834,G
5-NP,1181,0,2,823,0,825,G
5-NP,1182,822,0,0,0,822,A
5-NP,1183,821,0,0,0,821,A
5-NP,1184,815,0,2,0,817,A
5-NP,1185,1,0,0,818,819,C
5-NP,1186,816,0,0,0,816,A
5-NP,1187,0,0,0,843,843,C
5-NP,1188,0,831,0,0,831,T
5-NP,1189,857,0,1,0,858,A
5-NP,1190,861,0,1,0,862,A
5-NP,1191,0,855,0,1,856,T
5-NP,1192,1,0,0,866,867,C
5-NP,1193,852,0,1,0,853,A
5-NP,1194,863,0,0,0,863,A
5-NP,1195,1,0,0,859,860,C
5-NP,1196,834,0,0,0,834,A
5-NP,1197,0,3,834,0,837,G
5-NP,1198,813,0,1,1,815,A
5-NP,1199,0,0,823,0,823,G
5-NP,1200,1,2,825,0,828,G
5-NP,1201,1,1,821,0,823,G
5-NP,1202,0,1,0,817,818,C
5-NP,1203,5,0,0,810,815,C
5-NP,1204,1,797,0,2,800,T
5-NP,1205,2,2,0,807,811,C
5-NP,1206,3,0,0,803,806,C
5-NP,1207,2,0,808,0,810,G
5-NP,1208,0,1,0,807,808,C
5-NP,1209,798,0,1,0,799,A
5-NP,1210,1,1,825,0,827,G
5-NP,1211,1,0,823,0,824,G
5-NP,1212,0,0,1,824,825,C
5-NP,1213,4,1,0,823,828,C
5-NP,1214,820,0,0,0,820,A
5-NP,1215,821,0,2,1,824,A
5-NP,1216,822,0,1,0,823,A
5-NP,1217,0,1,0,832,833,C
5-NP,1218,4,0,0,832,836,C
5-NP,1219,760,0,1,0,761,A
5-NP,1220,0,0,768,0,768,G
5-NP,1221,0,760,0,0,760,T
5-NP,1222,1,0,775,0,776,G
5-NP,1223,0,774,0,0,774,T
5-NP,1224,0,0,764,0,764,G
5-NP,1225,0,0,0,767,767,C
5-NP,1226,761,0,0,0,761,A
5-NP,1227,769,0,0,0,769,A
5-NP,1228,0,0,0,763,763,C
5-NP,1229,2,0,1,756,759,C
5-NP,1230,0,755,0,0,755,T
5-NP,1231,756,0,0,0,756,A
5-NP,1232,1,0,0,753,754,C
5-NP,1233,2,0,754,0,756,G
5-NP,1234,0,752,0,1,753,T
5-NP,1235,0,762,0,1,763,T
5-NP,1236,0,756,0,1,757,T
5-NP,1237,0,745,0,0,745,T
5-NP,1238,1,0,0,744,745,C
5-NP,1239,0,724,0,0,724,T
5-NP,1240,0,0,752,0,752,G
5-NP,1241,0,748,0,0,748,T
5-NP,1242,747,0,0,0,747,A
5-NP,1243,0,0,0,750,750,C
5-NP,1244,739,0,0,0,739,A
5-NP,1245,742,0,0,0,742,A
5-NP,1246,740,0,0,0,740,A
5-NP,1247,0,1,741,0,742,G
5-NP,1248,736,0,1,0,737,A
5-NP,1249,711,0,0,0,711,A
5-NP,1250,715,0,0,0,715,A
5-NP,1251,1,0,0,716,717,C
5-NP,1252,1,0,0,707,708,C
5-NP,1253,0,702,0,0,702,T
5-NP,1254,0,0,0,700,700,C
5-NP,1255,3,1,0,700,704,C
5-NP,1256,5,0,0,698,703,C
5-NP,1257,701,0,0,0,701,A
5-NP,1258,0,708,0,0,708,T
5-NP,1259,0,706,0,1,707,T
5-NP,1260,0,709,0,1,710,T
5-NP,1261,0,4,705,0,709,G
5-NP,1262,708,0,0,0,708,A
5-NP,1263,709,0,0,0,709,A
5-NP,1264,706,0,1,0,707,A
5-NP,1265,702,0,1,0,703,A
5-NP,1266,0,0,716,0,716,G
5-NP,1267,0,707,0,0,707,T
5-NP,1268,2,1,0,708,711,C
5-NP,1269,708,0,1,0,709,A
5-NP,1270,717,1,0,0,718,A
5-NP,1271,0,0,0,723,723,C
5-NP,1272,10,0,0,726,736,C
5-NP,1273,735,1,0,0,736,A
5-NP,1274,0,736,0,0,736,T
5-NP,1275,3,0,0,723,726,C
5-NP,1276,719,1,0,1,721,A
5-NP,1277,0,724,0,0,724,T
5-NP,1278,0,2,720,0,722,G
5-NP,1279,1,0,718,0,719,G
5-NP,1280,0,0,1,719,720,C
5-NP,1281,702,0,2,0,704,A
5-NP,1282,0,0,708,0,708,G
5-NP,1283,1,0,0,700,701,C
5-NP,1284,702,0,0,0,702,A
5-NP,1285,0,699,0,0,699,T
5-NP,1286,0,696,0,0,696,T
5-NP,1287,4,0,1,688,693,C
5-NP,1288,691,0,0,0,691,A
5-NP,1289,0,0,0,701,701,C
5-NP,1290,1,699,0,0,700,T
5-NP,1291,2,4,703,0,709,G
5-NP,1292,0,0,710,0,710,G
5-NP,1293,704,0,0,0,704,A
5-NP,1294,703,0,0,0,703,A
5-NP,1295,704,0,0,0,704,A
5-NP,1296,0,693,0,0,693,T
5-NP,1297,695,0,0,0,695,A
5-NP,1298,1,1,0,687,689,C
5-NP,1299,0,0,667,0,667,G
5-NP,1300,0,3,663,0,666,G
5-NP,1301,642,0,1,0,643,A
5-NP,1302,0,7,649,0,656,G
5-NP,1303,0,2,654,0,656,G
5-NP,1304,0,2,657,0,659,G
5-NP,1305,658,0,0,0,658,A
5-NP,1306,654,0,0,0,654,A
5-NP,1307,0,3,654,0,657,G
5-NP,1308,656,0,0,0,656,A
5-NP,1309,658,1,0,0,659,A
5-NP,1310,0,0,0,667,667,C
5-NP,1311,0,652,0,0,652,T
5-NP,1312,0,651,1,1,653,T
5-NP,1313,1,0,0,652,653,C
5-NP,1314,652,0,0,0,652,A
5-NP,1315,0,3,651,0,654,G
5-NP,1316,651,0,0,0,651,A
5-NP,1317,1,0,0,654,655,C
5-NP,1318,646,0,1,0,647,A
5-NP,1319,0,632,0,1,633,T
5-NP,1320,0,3,630,0,633,G
5-NP,1321,623,0,1,0,624,A
5-NP,1322,0,2,627,0,629,G
5-NP,1323,0,0,625,0,625,G
5-NP,1324,0,0,624,0,624,G
5-NP,1325,0,0,0,623,623,C
5-NP,1326,614,0,0,0,614,A
5-NP,1327,0,1,617,0,618,G
5-NP,1328,616,0,0,0,616,A
5-NP,1329,617,0,0,0,617,A
5-NP,1330,615,0,0,0,615,A
5-NP,1331,0,603,0,0,603,T
5-NP,1332,2,0,0,608,610,C
5-NP,1333,611,0,0,0,611,A
5-NP,1334,0,608,0,0,608,T
5-NP,1335,609,0,1,0,610,A
5-NP,1336,602,0,2,0,604,A
5-NP,1337,0,5,609,0,614,G
5-NP,1338,606,0,1,0,607,A
5-NP,1339,607,0,0,0,607,A
5-NP,1340,0,593,0,1,594,T
5-NP,1341,0,1,594,0,595,G
5-NP,1342,593,0,0,0,593,A
5-NP,1343,0,590,0,1,591,T
5-NP,1344,1,1,590,0,592,G
5-NP,1345,0,1,588,0,589,G
5-NP,1346,574,0,1,0,575,A
5-NP,1347,569,0,0,1,570,A
5-NP,1348,1,2,558,0,561,G
5-NP,1349,0,0,578,0,578,G
5-NP,1350,0,570,0,0,570,T
5-NP,1351,2,0,565,0,567,G
5-NP,1352,1,0,0,567,568,C
5-NP,1353,568,0,0,0,568,A
5-NP,1354,567,0,1,0,568,A
5-NP,1355,565,1,0,0,566,A
5-NP,1356,573,0,0,0,573,A
5-NP,1357,0,1,0,573,574,C
5-NP,1358,2,0,0,563,565,C
5-NP,1359,553,0,0,0,553,A
5-NP,1360,0,0,559,0,559,G
5-NP,1361,559,0,0,0,559,A
5-NP,1362,557,0,0,0,557,A
5-NP,1363,0,0,559,0,559,G
5-NP,1364,556,0,0,0,556,A
5-NP,1365,537,0,0,0,537,A
5-NP,1366,0,1,545,0,546,G
5-NP,1367,0,543,0,1,544,T
5-NP,1368,0,1,545,0,546,G
5-NP,1369,0,540,0,1,541,T
5-NP,1370,3,0,0,539,542,C
5-NP,1371,543,0,0,0,543,A
5-NP,1372,0,553,0,0,553,T
5-NP,1373,0,550,0,0,550,T
5-NP,1374,2,0,1,550,553,C
5-NP,1375,2,1,0,539,542,C
5-NP,1376,0,2,541,0,543,G
5-NP,1377,0,1,542,0,543,G
5-NP,1378,0,4,539,0,543,G
5-NP,1379,1,2,539,0,542,G
5-NP,1380,0,0,543,0,543,G
5-NP,1381,525,0,1,0,526,A
5-NP,1382,1,3,522,0,526,G
5-NP,1383,0,1,527,0,528,G
5-NP,1384,1,2,523,0,526,G
5-NP,1385,0,3,525,0,528,G
5-NP,1386,525,1,0,0,526,A
5-NP,1387,0,0,524,0,524,G
5-NP,1388,0,519,1,0,520,T
5-NP,1389,0,517,0,0,517,T
5-NP,1390,1,520,0,0,521,T
5-NP,1391,0,519,0,0,519,T
5-NP,1392,1,3,0,515,519,C
5-NP,1393,0,2,517,0,519,G
5-NP,1394,517,0,0,0,517,A
5-NP,1395,0,0,526,0,526,G
5-NP,1396,0,0,0,524,524,C
5-NP,1397,0,518,0,2,520,T
5-NP,1398,0,0,0,526,526,C
5-NP,1399,0,523,0,0,523,T
5-NP,1400,2,0,0,524,526,C
5-NP,1401,524,0,1,0,525,A
5-NP,1402,0,0,530,0,530,G
5-NP,1403,529,0,0,0,529,A
5-NP,1404,0,0,0,529,529,C
5-NP,1405,0,2,521,0,523,G
5-NP,1406,512,1,0,0,513,A
5-NP,1407,0,3,507,0,510,G
5-NP,1408,505,0,1,0,506,A
5-NP,1409,501,0,0,0,501,A
5-NP,1410,0,2,503,0,505,G
5-NP,1411,0,0,502,0,502,G
5-NP,1412,0,0,0,503,503,C
5-NP,1413,498,1,0,0,499,A
5-NP,1414,500,0,0,0,500,A
5-NP,1415,1,1,0,494,496,C
5-NP,1416,1,0,495,0,496,G
5-NP,1417,495,0,0,0,495,A
5-NP,1418,494,0,0,0,494,A
5-NP,1419,0,0,0,495,495,C
5-NP,1420,2,1,0,489,492,C
5-NP,1421,4,1,0,481,486,C
5-NP,1422,0,3,483,0,486,G
5-NP,1423,487,0,0,0,487,A
5-NP,1424,0,486,0,0,486,T
5-NP,1425,0,0,0,481,481,C
5-NP,1426,0,0,478,0,478,G
5-NP,1427,0,474,0,0,474,T
5-NP,1428,0,1,472,0,473,G
5-NP,1429,1,0,0,471,472,C
5-NP,1430,2,0,0,468,470,C
5-NP,1431,1,0,0,473,474,C
5-NP,1432,0,464,0,2,466,T
5-NP,1433,1,0,0,489,490,C
5-NP,1434,0,489,0,0,489,T
5-NP,1435,0,486,3,0,489,T
5-NP,1436,0,486,0,1,487,T
5-NP,1437,0,482,0,0,482,T
5-NP,1438,0,4,479,0,483,G
5-NP,1439,481,0,1,0,482,A
5-NP,1440,0,476,0,0,476,T
5-NP,1441,471,0,0,0,471,A
5-NP,1442,0,398,0,0,398,T
5-NP,1443,0,2,403,0,405,G
5-NP,1444,405,0,0,0,405,A
5-NP,1445,0,0,409,0,409,G
5-NP,1446,0,409,0,0,409,T
5-NP,1447,385,0,0,0,385,A
5-NP,1448,385,0,0,0,385,A
5-NP,1449,0,383,0,0,383,T
5-NP,1450,0,0,382,0,382,G
5-NP,1451,378,0,1,0,379,A
5-NP,1452,332,0,0,0,332,A
5-NP,1453,1,0,332,0,333,G
5-NP,1454,0,2,313,0,315,G
5-NP,1455,312,0,0,0,312,A
5-NP,1456,0,307,0,0,307,T
5-NP,1457,4,2,0,304,310,C
5-NP,1458,0,305,0,0,305,T
5-NP,1459,0,303,0,0,303,T
5-NP,1460,304,0,0,0,304,A
5-NP,1461,0,303,0,1,304,T
5-NP,1462,0,302,0,0,302,T
5-NP,1463,1,297,0,0,298,T
5-NP,1464,0,0,0,291,291,C
5-NP,1465,0,279,0,2,281,T
5-NP,1466,0,280,0,0,280,T
5-NP,1467,2,0,1,277,280,C
5-NP,1468,1,0,276,0,277,G
5-NP,1469,0,1,278,0,279,G
5-NP,1470,278,0,0,0,278,A
5-NP,1471,0,0,276,0,276,G
5-NP,1472,274,0,1,0,275,A
5-NP,1473,0,0,0,275,275,C
5-NP,1474,256,0,0,0,256,A
5-NP,1475,256,0,0,0,256,A
5-NP,1476,0,253,0,0,253,T
5-NP,1477,0,0,254,0,254,G
5-NP,1478,1,0,0,251,252,C
5-NP,1479,246,0,0,0,246,A
5-NP,1480,0,0,246,0,246,G
5-NP,1481,241,0,0,4,245,A
5-NP,1482,225,0,1,0,226,A
5-NP,1483,0,0,226,0,226,G
5-NP,1484,156,0,0,0,156,A
5-NP,1485,0,0,150,0,150,G
5-NP,1486,0,141,0,0,141,T
5-NP,1487,141,0,0,0,141,A
5-NP,1488,1,0,0,139,140,C
5-NP,1489,0,0,125,0,125,G
5-NP,1490,123,0,1,0,124,A
5-NP,1491,0,0,0,122,122,C
5-NP,1492,81,0,0,0,81,A
5-NP,1493,80,0,0,0,80,A
5-NP,1494,0,69,0,0,69,T
5-NP,1495,0,66,0,0,66,T
5-NP,1496,66,0,0,0,66,A
5-NP,1497,63,0,0,0,63,A
6-NA,1,57,0,0,0,57,A
6-NA,2,0,57,0,0,57,T
6-NA,3,0,0,58,0,58,G
6-NA,4,59,0,1,0,60,A
6-NA,5,69,0,0,0,69,A
6-NA,6,0,69,0,0,69,T
6-NA,7,0,0,0,70,70,C
6-NA,8,2,0,0,68,70,C
6-NA,9,70,0,0,0,70,A
6-NA,10,72,0,0,0,72,A
6-NA,11,71,0,0,0,71,A
6-NA,12,0,75,0,0,75,T
6-NA,13,1,0,0,75,76,C
6-NA,14,75,0,1,0,76,A
6-NA,15,78,0,0,0,78,A
6-NA,16,78,0,0,0,78,A
6-NA,17,81,0,0,0,81,A
6-NA,18,0,0,89,0,89,G
6-NA,19,96,0,0,0,96,A
6-NA,20,0,97,0,0,97,T
6-NA,21,97,0,0,0,97,A
6-NA,22,99,0,0,0,99,A
6-NA,23,0,100,0,0,100,T
6-NA,24,100,0,0,0,100,A
6-NA,25,102,0,0,0,102,A
6-NA,26,0,0,0,107,107,C
6-NA,27,0,1,111,0,112,G
6-NA,28,110,0,0,0,110,A
6-NA,29,0,112,0,0,112,T
6-NA,30,0,112,0,0,112,T
6-NA,31,0,0,114,0,114,G
6-NA,32,0,0,121,0,121,G
6-NA,33,0,0,0,122,122,C
6-NA,34,0,122,0,0,122,T
6-NA,35,0,0,0,128,128,C
6-NA,36,0,128,0,0,128,T
6-NA,37,0,1,128,0,129,G
6-NA,38,0,128,0,0,128,T
6-NA,39,0,131,0,0,131,T
6-NA,40,0,134,0,0,134,T
6-NA,41,1,0,0,140,141,C
6-NA,42,0,142,0,0,142,T
6-NA,43,0,0,0,142,142,C
6-NA,44,0,141,0,0,141,T
6-NA,45,0,0,0,148,148,C
6-NA,46,147,0,0,0,147,A
6-NA,47,0,0,0,158,158,C
6-NA,48,1,0,0,158,159,C
6-NA,49,159,0,0,0,159,A
6-NA,50,0,164,0,1,165,T
6-NA,51,0,170,0,0,170,T
6-NA,52,0,171,0,0,171,T
6-NA,53,0,0,0,179,179,C
6-NA,54,1,0,0,178,179,C
6-NA,55,181,0,0,0,181,A
6-NA,56,0,0,0,188,188,C
6-NA,57,186,0,0,0,186,A
6-NA,58,198,0,0,0,198,A
6-NA,59,0,199,0,0,199,T
6-NA,60,208,0,1,0,209,A
6-NA,61,0,210,0,0,210,T
6-NA,62,0,0,211,0,211,G
6-NA,63,0,0,0,209,209,C
6-NA,64,0,210,0,0,210,T
6-NA,65,0,212,0,0,212,T
6-NA,66,0,0,0,212,212,C
6-NA,67,0,212,0,0,212,T
6-NA,68,0,212,0,0,212,T
6-NA,69,1,0,0,210,211,C
6-NA,70,210,0,1,0,211,A
6-NA,71,0,210,0,0,210,T
6-NA,72,0,0,211,0,211,G
6-NA,73,0,0,0,212,212,C
6-NA,74,212,0,0,0,212,A
6-NA,75,212,0,0,1,213,A
6-NA,76,213,0,0,0,213,A
6-NA,77,0,215,0,0,215,T
6-NA,78,0,215,0,0,215,T
6-NA,79,0,2,211,0,213,G
6-NA,80,0,0,0,215,215,C
6-NA,81,1,0,0,217,218,C
6-NA,82,220,0,0,0,220,A
6-NA,83,0,220,0,0,220,T
6-NA,84,0,0,0,233,233,C
6-NA,85,0,235,0,0,235,T
6-NA,86,0,236,0,0,236,T
6-NA,87,0,1,242,0,243,G
6-NA,88,242,0,0,0,242,A
6-NA,89,0,243,0,0,243,T
6-NA,90,243,0,0,0,243,A
6-NA,91,243,0,0,0,243,A
6-NA,92,0,0,0,272,272,C
6-NA,93,0,271,0,1,272,T
6-NA,94,272,0,2,0,274,A
6-NA,95,0,0,0,282,282,C
6-NA,96,0,278,0,0,278,T
6-NA,97,0,1,284,0,285,G
6-NA,98,0,284,0,0,284,T
6-NA,99,284,0,0,0,284,A
6-NA,100,286,0,0,0,286,A
6-NA,101,0,0,0,277,277,C
6-NA,102,274,0,0,0,274,A
6-NA,103,0,276,0,1,277,T
6-NA,104,0,273,0,0,273,T
6-NA,105,0,0,272,0,272,G
6-NA,106,0,0,0,273,273,C
6-NA,107,277,0,0,0,277,A
6-NA,108,0,275,0,0,275,T
6-NA,109,0,274,0,0,274,T
6-NA,110,0,274,0,0,274,T
6-NA,111,0,0,0,275,275,C
6-NA,112,276,0,0,0,276,A
6-NA,113,275,0,0,1,276,A
6-NA,114,0,0,276,0,276,G
6-NA,115,0,0,0,278,278,C
6-NA,116,278,0,0,0,278,A
6-NA,117,286,0,0,0,286,A
6-NA,118,0,289,0,0,289,T
6-NA,119,289,0,0,0,289,A
6-NA,120,0,289,0,0,289,T
6-NA,121,1,3,292,0,296,G
6-NA,122,296,0,0,0,296,A
6-NA,123,295,0,0,0,295,A
6-NA,124,0,295,0,0,295,T
6-NA,125,0,295,0,0,295,T
6-NA,126,1,0,0,292,293,C
6-NA,127,294,0,0,0,294,A
6-NA,128,294,0,0,0,294,A
6-NA,129,0,0,0,294,294,C
6-NA,130,1,292,0,0,293,T
6-NA,131,4,0,0,289,293,C
6-NA,132,1,0,0,294,295,C
6-NA,133,3,0,0,300,303,C
6-NA,134,2,0,0,300,302,C
6-NA,135,2,0,0,302,304,C
6-NA,136,0,0,0,310,310,C
6-NA,137,1,0,0,307,308,C
6-NA,138,310,0,0,0,310,A
6-NA,139,314,0,0,0,314,A
6-NA,140,312,0,0,0,312,A
6-NA,141,0,0,0,325,325,C
6-NA,142,322,0,0,0,322,A
6-NA,143,328,0,0,0,328,A
6-NA,144,0,0,0,328,328,C
6-NA,145,1,0,0,329,330,C
6-NA,146,337,0,0,0,337,A
6-NA,147,340,0,0,0,340,A
6-NA,148,0,0,346,0,346,G
6-NA,149,0,347,0,0,347,T
6-NA,150,0,2,342,0,344,G
6-NA,151,348,0,0,0,348,A
6-NA,152,0,346,0,0,346,T
6-NA,153,0,0,345,0,345,G
6-NA,154,0,0,0,345,345,C
6-NA,155,0,342,0,0,342,T
6-NA,156,0,0,361,0,361,G
6-NA,157,0,359,0,1,360,T
6-NA,158,0,0,359,0,359,G
6-NA,159,0,363,0,0,363,T
6-NA,160,0,2,361,0,363,G
6-NA,161,364,0,0,0,364,A
6-NA,162,366,0,0,0,366,A
6-NA,163,2,0,0,365,367,C
6-NA,164,1,0,0,361,362,C
6-NA,165,356,0,0,0,356,A
6-NA,166,357,0,0,0,357,A
6-NA,167,0,0,0,367,367,C
6-NA,168,367,0,0,0,367,A
6-NA,169,369,0,0,0,369,A
6-NA,170,0,371,0,0,371,T
6-NA,171,370,0,0,0,370,A
6-NA,172,370,0,0,0,370,A
6-NA,173,0,370,0,0,370,T
6-NA,174,366,0,1,0,367,A
6-NA,175,0,3,367,0,370,G
6-NA,176,364,0,0,0,364,A
6-NA,177,366,0,0,0,366,A
6-NA,178,366,0,0,0,366,A
6-NA,179,0,0,371,0,371,G
6-NA,180,382,0,1,0,383,A
6-NA,181,383,0,0,0,383,A
6-NA,182,396,0,1,0,397,A
6-NA,183,0,0,0,401,401,C
6-NA,184,397,0,1,0,398,A
6-NA,185,0,405,0,0,405,T
6-NA,186,406,0,0,0,406,A
6-NA,187,407,0,1,0,408,A
6-NA,188,0,0,0,412,412,C
6-NA,189,409,0,0,0,409,A
6-NA,190,0,2,423,0,425,G
6-NA,191,422,0,0,0,422,A
6-NA,192,0,1,423,0,424,G
6-NA,193,424,0,0,0,424,A
6-NA,194,0,435,0,0,435,T
6-NA,195,434,0,0,0,434,A
6-NA,196,0,0,449,0,449,G
6-NA,197,0,449,0,0,449,T
6-NA,198,0,0,460,0,460,G
6-NA,199,0,462,0,1,463,T
6-NA,200,464,0,0,0,464,A
6-NA,201,0,465,0,0,465,T
6-NA,202,1,0,0,464,465,C
6-NA,203,0,447,0,1,448,T
6-NA,204,0,2,460,0,462,G
6-NA,205,462,0,0,0,462,A
6-NA,206,0,0,0,461,461,C
6-NA,207,3,0,0,465,468,C
6-NA,208,467,1,1,0,469,A
6-NA,209,470,0,1,0,471,A
6-NA,210,0,0,0,479,479,C
6-NA,211,479,0,0,0,479,A
6-NA,212,0,0,0,497,497,C
6-NA,213,2,0,0,484,486,C
6-NA,214,494,0,1,0,495,A
6-NA,215,0,0,0,516,516,C
6-NA,216,4,0,0,510,514,C
6-NA,217,515,0,0,0,515,A
6-NA,218,0,515,0,0,515,T
6-NA,219,509,0,0,0,509,A
6-NA,220,0,3,510,0,513,G
6-NA,221,505,0,1,0,506,A
6-NA,222,0,0,522,0,522,G
6-NA,223,515,1,0,0,516,A
6-NA,224,508,0,2,0,510,A
6-NA,225,0,0,514,0,514,G
6-NA,226,0,0,514,0,514,G
6-NA,227,516,0,0,0,516,A
6-NA,228,516,0,1,0,517,A
6-NA,229,515,0,0,0,515,A
6-NA,230,0,510,0,0,510,T
6-NA,231,505,0,0,0,505,A
6-NA,232,0,504,0,1,505,T
6-NA,233,0,0,504,0,504,G
6-NA,234,0,0,0,502,502,C
6-NA,235,1,0,0,501,502,C
6-NA,236,1,1,0,501,503,C
6-NA,237,3,0,0,498,501,C
6-NA,238,505,0,0,0,505,A
6-NA,239,501,1,1,0,503,A
6-NA,240,505,0,0,0,505,A
6-NA,241,0,503,0,0,503,T
6-NA,242,0,512,0,0,512,T
6-NA,243,514,0,0,0,514,A
6-NA,244,0,0,517,0,517,G
6-NA,245,0,0,0,514,514,C
6-NA,246,513,0,0,0,513,A
6-NA,247,0,5,519,0,524,G
6-NA,248,519,1,0,0,520,A
6-NA,249,541,0,0,0,541,A
6-NA,250,0,543,0,0,543,T
6-NA,251,545,0,0,0,545,A
6-NA,252,0,0,0,547,547,C
6-NA,253,540,0,0,1,541,A
6-NA,254,0,2,541,0,543,G
6-NA,255,547,0,0,0,547,A
6-NA,256,535,0,0,0,535,A
6-NA,257,536,0,0,0,536,A
6-NA,258,0,523,0,0,523,T
6-NA,259,0,520,0,0,520,T
6-NA,260,0,3,520,0,523,G
6-NA,261,0,0,523,0,523,G
6-NA,262,0,524,0,1,525,T
6-NA,263,4,0,1,518,523,C
6-NA,264,519,0,0,0,519,A
6-NA,265,522,0,0,0,522,A
6-NA,266,520,0,2,0,522,A
6-NA,267,0,0,523,0,523,G
6-NA,268,0,0,0,525,525,C
6-NA,269,0,0,1,520,521,C
6-NA,270,2,0,523,0,525,G
6-NA,271,0,0,0,524,524,C
6-NA,272,528,0,0,0,528,A
6-NA,273,531,1,0,0,532,A
6-NA,274,0,530,0,0,530,T
6-NA,275,1,0,529,0,530,G
6-NA,276,0,9,0,518,527,C
6-NA,277,0,8,518,0,526,G
6-NA,278,532,0,1,0,533,A
6-NA,279,0,0,0,536,536,C
6-NA,280,543,0,0,0,543,A
6-NA,281,0,558,0,0,558,T
6-NA,282,0,555,0,1,556,T
6-NA,283,555,0,0,1,556,A
6-NA,284,0,0,0,556,556,C
6-NA,285,552,0,0,0,552,A
6-NA,286,0,2,562,0,564,G
6-NA,287,0,3,559,0,562,G
6-NA,288,563,0,0,0,563,A
6-NA,289,0,557,0,0,557,T
6-NA,290,1,552,0,0,553,T
6-NA,291,0,553,0,0,553,T
6-NA,292,1,2,551,0,554,G
6-NA,293,1,0,0,551,552,C
6-NA,294,554,0,0,0,554,A
6-NA,295,0,0,0,557,557,C
6-NA,296,4,0,0,548,552,C
6-NA,297,0,550,0,1,551,T
6-NA,298,0,552,0,0,552,T
6-NA,299,0,560,0,0,560,T
6-NA,300,0,560,0,0,560,T
6-NA,301,0,569,0,0,569,T
6-NA,302,1,0,0,570,571,C
6-NA,303,0,568,0,1,569,T
6-NA,304,569,0,0,0,569,A
6-NA,305,566,0,0,0,566,A
6-NA,306,0,4,570,0,574,G
6-NA,307,0,4,568,0,572,G
6-NA,308,570,0,0,0,570,A
6-NA,309,1,0,0,570,571,C
6-NA,310,565,0,0,0,565,A
6-NA,311,568,0,0,0,568,A
6-NA,312,0,566,0,0,566,T
6-NA,313,0,566,0,0,566,T
6-NA,314,5,1,0,576,582,C
6-NA,315,1,4,575,0,580,G
6-NA,316,581,0,0,0,581,A
6-NA,317,0,577,0,0,577,T
6-NA,318,0,577,0,0,577,T
6-NA,319,576,0,0,0,576,A
6-NA,320,0,2,575,0,577,G
6-NA,321,0,0,579,0,579,G
6-NA,322,0,0,0,576,576,C
6-NA,323,0,569,0,0,569,T
6-NA,324,0,574,0,0,574,T
6-NA,325,0,573,0,0,573,T
6-NA,326,1,0,0,574,575,C
6-NA,327,0,0,0,575,575,C
6-NA,328,0,0,574,0,574,G
6-NA,329,0,0,0,577,577,C
6-NA,330,0,574,0,0,574,T
6-NA,331,0,2,593,0,595,G
6-NA,332,0,0,588,0,588,G
6-NA,333,0,590,0,1,591,T
6-NA,334,0,5,586,0,591,G
6-NA,335,0,1,586,0,587,G
6-NA,336,1,0,585,0,586,G
6-NA,337,0,3,588,0,591,G
6-NA,338,587,0,1,0,588,A
6-NA,339,0,0,0,597,597,C
6-NA,340,586,0,1,0,587,A
6-NA,341,0,586,0,1,587,T
6-NA,342,4,0,0,586,590,C
6-NA,343,0,586,0,1,587,T
6-NA,344,0,2,582,0,584,G
6-NA,345,0,0,586,0,586,G
6-NA,346,0,0,601,0,601,G
6-NA,347,0,601,0,1,602,T
6-NA,348,0,5,591,0,596,G
6-NA,349,597,0,1,0,598,A
6-NA,350,1,0,0,610,611,C
6-NA,351,608,0,0,0,608,A
6-NA,352,620,0,1,0,621,A
6-NA,353,0,2,629,0,631,G
6-NA,354,623,1,0,0,624,A
6-NA,355,1,1,635,0,637,G
6-NA,356,645,0,0,0,645,A
6-NA,357,681,0,1,0,682,A
6-NA,358,1,0,0,777,778,C
6-NA,359,2,1,0,805,808,C
6-NA,360,0,805,1,0,806,T
6-NA,361,0,808,0,0,808,T
6-NA,362,808,0,1,1,810,A
6-NA,363,0,814,0,0,814,T
6-NA,364,0,0,846,0,846,G
6-NA,365,0,837,0,0,837,T
6-NA,366,0,0,846,0,846,G
6-NA,367,0,836,0,0,836,T
6-NA,368,6,0,0,830,836,C
6-NA,369,851,1,0,4,856,A
6-NA,370,0,857,0,0,857,T
6-NA,371,0,1,853,0,854,G
6-NA,372,0,2,0,856,858,C
6-NA,373,1,2,854,0,857,G
6-NA,374,941,0,2,0,943,A
6-NA,375,0,954,0,0,954,T
6-NA,376,4,0,0,973,977,C
6-NA,377,2,1,0,976,979,C
6-NA,378,0,984,0,3,987,T
6-NA,379,0,5,995,0,1000,G
6-NA,380,998,0,2,0,1000,A
6-NA,381,1,0,0,999,1000,C
6-NA,382,997,1,0,0,998,A
6-NA,383,978,0,0,0,978,A
6-NA,384,0,0,1028,0,1028,G
6-NA,385,1,1017,0,0,1018,T
6-NA,386,0,0,1030,0,1030,G
6-NA,387,0,1019,0,1,1020,T
6-NA,388,0,1019,0,1,1020,T
6-NA,389,1019,0,1,0,1020,A
6-NA,390,1,1020,1,0,1022,T
6-NA,391,3,0,1,1037,1041,C
6-NA,392,1037,0,0,0,1037,A
6-NA,393,1032,0,0,0,1032,A
6-NA,394,0,1027,0,1,1028,T
6-NA,395,0,1021,0,1,1022,T
6-NA,396,0,1021,0,0,1021,T
6-NA,397,0,2,1028,1,1031,G
6-NA,398,1,0,0,1086,1087,C
6-NA,399,2,1,0,1085,1088,C
6-NA,400,6,2,0,1092,1100,C
6-NA,401,0,1100,0,0,1100,T
6-NA,402,1,1098,0,0,1099,T
6-NA,403,0,8,1107,0,1115,G
6-NA,404,1,6,1106,0,1113,G
6-NA,405,1126,1,1,0,1128,A
6-NA,406,0,1,0,1130,1131,C
6-NA,407,1105,0,2,0,1107,A
6-NA,408,1,6,1132,0,1139,G
6-NA,409,0,3,1143,0,1146,G
6-NA,410,2,8,1181,0,1191,G
6-NA,411,1196,0,2,0,1198,A
6-NA,412,1190,0,1,0,1191,A
6-NA,413,0,1,0,1189,1190,C
6-NA,414,1145,0,3,0,1148,A
6-NA,415,1261,1,1,0,1263,A
6-NA,416,0,0,0,1275,1275,C
6-NA,417,1272,0,1,0,1273,A
6-NA,418,0,0,0,1299,1299,C
6-NA,419,0,1281,0,1,1282,T
6-NA,420,1302,0,0,0,1302,A
6-NA,421,1297,0,1,0,1298,A
6-NA,422,1302,0,1,0,1303,A
6-NA,423,0,3,0,1301,1304,C
6-NA,424,1251,0,0,0,1251,A
6-NA,425,1258,0,0,0,1258,A
6-NA,426,1,0,0,1255,1256,C
6-NA,427,1,0,1255,0,1256,G
6-NA,428,0,1255,0,1,1256,T
6-NA,429,2,3,1246,0,1251,G
6-NA,430,0,1,0,1258,1259,C
6-NA,431,1263,0,0,0,1263,A
6-NA,432,0,1254,0,0,1254,T
6-NA,433,1,1262,0,0,1263,T
6-NA,434,6,0,0,1264,1270,C
6-NA,435,1306,0,1,0,1307,A
6-NA,436,1322,0,0,0,1322,A
6-NA,437,1340,0,0,0,1340,A
6-NA,438,0,1343,0,1,1344,T
6-NA,439,2,18,1324,1,1345,G
6-NA,440,1368,0,2,0,1370,A
6-NA,441,1,1,0,1372,1374,C
6-NA,442,1377,1,1,0,1379,A
6-NA,443,0,0,0,1406,1406,C
6-NA,444,1391,0,0,0,1391,A
6-NA,445,0,0,1622,0,1622,G
6-NA,446,0,1621,0,0,1621,T
6-NA,447,1643,0,0,0,1643,A
6-NA,448,2,1,0,1642,1645,C
6-NA,449,2,1,1639,0,1642,G
6-NA,450,0,1695,0,0,1695,T
6-NA,451,0,9,1689,1,1699,G
6-NA,452,1707,1,1,0,1709,A
6-NA,453,0,1713,0,0,1713,T
6-NA,454,1553,0,1,0,1554,A
6-NA,455,1,8,1550,0,1559,G
6-NA,456,0,10,1537,0,1547,G
6-NA,457,1544,0,1,0,1545,A
6-NA,458,1,0,1,1563,1565,C
6-NA,459,4,0,1,1539,1544,C
6-NA,460,8,1,0,1546,1555,C
6-NA,461,6,0,0,1554,1560,C
6-NA,462,0,1577,0,1,1578,T
6-NA,463,0,1600,0,0,1600,T
6-NA,464,1606,0,0,0,1606,A
6-NA,465,0,1602,0,2,1604,T
6-NA,466,3,1,0,1597,1601,C
6-NA,467,3,2,1583,0,1588,G
6-NA,468,0,7,1580,0,1587,G
6-NA,469,1582,2,0,0,1584,A
6-NA,470,1,0,0,1606,1607,C
6-NA,471,4,0,0,1600,1604,C
6-NA,472,3,1,0,1662,1666,C
6-NA,473,0,1657,0,5,1662,T
6-NA,474,1683,0,0,0,1683,A
6-NA,475,0,1679,0,1,1680,T
6-NA,476,0,1680,0,2,1682,T
6-NA,477,0,2,1687,0,1689,G
6-NA,478,1682,0,1,0,1683,A
6-NA,479,0,1673,0,0,1673,T
6-NA,480,1,6,1674,0,1681,G
6-NA,481,1642,0,0,0,1642,A
6-NA,482,1643,0,1,0,1644,A
6-NA,483,0,1637,0,0,1637,T
6-NA,484,0,6,1649,0,1655,G
6-NA,485,1665,0,2,0,1667,A
6-NA,486,1,0,1681,0,1682,G
6-NA,487,0,1679,0,1,1680,T
6-NA,488,0,1674,0,0,1674,T
6-NA,489,1678,0,3,0,1681,A
6-NA,490,0,3,1677,0,1680,G
6-NA,491,0,5,1678,1,1684,G
6-NA,492,0,1683,0,1,1684,T
6-NA,493,3,0,1674,0,1677,G
6-NA,494,1,1654,0,5,1660,T
6-NA,495,0,1650,0,2,1652,T
6-NA,496,7,1,0,1661,1669,C
6-NA,497,4,1,1,1670,1676,C
6-NA,498,0,1660,0,4,1664,T
6-NA,499,0,1661,0,1,1662,T
6-NA,500,0,1655,0,3,1658,T
6-NA,501,0,1658,0,1,1659,T
6-NA,502,13,0,0,1660,1673,C
6-NA,503,1668,0,0,0,1668,A
6-NA,504,1,1711,0,0,1712,T
6-NA,505,3,0,0,1709,1712,C
6-NA,506,0,1696,0,0,1696,T
6-NA,507,0,9,1684,1,1694,G
6-NA,508,0,6,1683,0,1689,G
6-NA,509,3,13,1674,0,1690,G
6-NA,510,1,11,1702,0,1714,G
6-NA,511,1706,1,1,0,1708,A
6-NA,512,1,1,0,1724,1726,C
6-NA,513,10,1,0,1668,1679,C
6-NA,514,1705,0,0,0,1705,A
6-NA,515,1701,0,5,0,1706,A
6-NA,516,1,0,1711,1,1713,G
6-NA,517,0,2,0,1708,1710,C
6-NA,518,1704,0,0,0,1704,A
6-NA,519,1719,1,4,0,1724,A
6-NA,520,0,0,1738,0,1738,G
6-NA,521,1,1722,0,0,1723,T
6-NA,522,2,0,1764,0,1766,G
6-NA,523,0,1752,0,2,1754,T
6-NA,524,1,3,1809,0,1813,G
6-NA,525,1,1,0,1811,1813,C
6-NA,526,1809,0,0,0,1809,A
6-NA,527,0,1832,0,0,1832,T
6-NA,528,1805,0,0,0,1805,A
6-NA,529,1,1,1861,0,1863,G
6-NA,530,0,0,0,1857,1857,C
6-NA,531,1822,0,1,0,1823,A
6-NA,532,0,1826,0,1,1827,T
6-NA,533,1,12,1756,0,1769,G
6-NA,534,0,0,1930,0,1930,G
6-NA,535,1,1931,0,3,1935,T
6-NA,536,15,1,0,1910,1926,C
6-NA,537,1,1,0,1944,1946,C
6-NA,538,1972,0,2,0,1974,A
6-NA,539,0,0,2118,0,2118,G
6-NA,540,0,0,0,2133,2133,C
6-NA,541,1,2122,0,4,2127,T
6-NA,542,12,2,1,2123,2138,C
6-NA,543,2106,0,2,0,2108,A
6-NA,544,2162,0,2,1,2165,A
6-NA,545,0,4,2177,0,2181,G
6-NA,546,1,2299,0,2,2302,T
6-NA,547,0,2294,0,3,2297,T
6-NA,548,0,1,2320,1,2322,G
6-NA,549,0,2322,0,3,2325,T
6-NA,550,15,1,0,2313,2329,C
6-NA,551,2329,0,0,0,2329,A
6-NA,552,3,2,0,2354,2359,C
6-NA,553,0,8,2347,2,2357,G
6-NA,554,2427,1,2,0,2430,A
6-NA,555,0,2432,0,2,2434,T
6-NA,556,2,8,2498,0,2508,G
6-NA,557,0,11,2517,1,2529,G
6-NA,558,2523,0,2,1,2526,A
6-NA,559,2532,0,5,0,2537,A
6-NA,560,2577,0,0,1,2578,A
6-NA,561,2595,0,1,1,2597,A
6-NA,562,3,2,2646,0,2651,G
6-NA,563,4,0,0,2632,2636,C
6-NA,564,2635,0,3,0,2638,A
6-NA,565,2,2641,0,1,2644,T
6-NA,566,2,10,2670,0,2682,G
6-NA,567,0,1,2709,0,2710,G
6-NA,568,2,1,0,2744,2747,C
6-NA,569,0,2722,0,4,2726,T
6-NA,570,0,1,2760,1,2762,G
6-NA,571,2,0,0,2749,2751,C
6-NA,572,2753,0,4,0,2757,A
6-NA,573,1,2905,0,0,2906,T
6-NA,574,2,3,2914,0,2919,G
6-NA,575,0,2920,1,1,2922,T
6-NA,576,1,3025,0,2,3028,T
6-NA,577,1,3024,0,2,3027,T
6-NA,578,0,0,3279,1,3280,G
6-NA,579,2,3266,0,0,3268,T
6-NA,580,3282,0,1,0,3283,A
6-NA,581,1,3305,0,0,3306,T
6-NA,582,3280,0,1,0,3281,A
6-NA,583,3304,0,2,0,3306,A
6-NA,584,1,2,0,3289,3292,C
6-NA,585,5,11,3249,1,3266,G
6-NA,586,0,16,3275,0,3291,G
6-NA,587,0,20,3220,0,3240,G
6-NA,588,0,9,3242,0,3251,G
6-NA,589,3,12,3248,0,3263,G
6-NA,590,3250,0,5,0,3255,A
6-NA,591,1,3269,1,0,3271,T
6-NA,592,1,18,3275,0,3294,G
6-NA,593,3315,1,4,0,3320,A
6-NA,594,2,3331,0,0,3333,T
6-NA,595,3315,0,3,0,3318,A
6-NA,596,3415,0,1,0,3416,A
6-NA,597,3448,0,2,0,3450,A
6-NA,598,3452,0,1,0,3453,A
6-NA,599,3482,0,0,0,3482,A
6-NA,600,0,3480,0,2,3482,T
6-NA,601,0,2,3480,0,3482,G
6-NA,602,5,1,0,3465,3471,C
6-NA,603,3472,0,2,0,3474,A
6-NA,604,3495,1,3,1,3500,A
6-NA,605,3,0,0,3540,3543,C
6-NA,606,0,3538,0,4,3542,T
6-NA,607,1,2,3558,0,3561,G
6-NA,608,2,0,0,3552,3554,C
6-NA,609,1,3558,0,1,3560,T
6-NA,610,3557,2,1,0,3560,A
6-NA,611,1,0,3562,0,3563,G
6-NA,612,2,2,0,3619,3623,C
6-NA,613,0,3621,0,5,3626,T
6-NA,614,0,3611,1,2,3614,T
6-NA,615,10,3,1,3651,3665,C
6-NA,616,3689,0,2,1,3692,A
6-NA,617,0,3698,0,0,3698,T
6-NA,618,1,3699,0,4,3704,T
6-NA,619,0,3722,0,0,3722,T
6-NA,620,3749,0,3,0,3752,A
6-NA,621,3,3,0,3798,3804,C
6-NA,622,3776,0,1,0,3777,A
6-NA,623,3824,0,1,0,3825,A
6-NA,624,0,3796,0,1,3797,T
6-NA,625,0,32,3760,0,3792,G
6-NA,626,1,14,3772,1,3788,G
6-NA,627,6,6,3766,0,3778,G
6-NA,628,3774,1,3,1,3779,A
6-NA,629,0,12,3875,0,3887,G
6-NA,630,1,4,3923,0,3928,G
6-NA,631,1,0,0,4190,4191,C
6-NA,632,0,4182,0,3,4185,T
6-NA,633,0,4236,0,2,4238,T
6-NA,634,3,3,4282,0,4288,G
6-NA,635,1,4280,0,3,4284,T
6-NA,636,4359,3,7,1,4370,A
6-NA,637,0,12,4373,0,4385,G
6-NA,638,4342,0,6,0,4348,A
6-NA,639,0,4373,0,0,4373,T
6-NA,640,4109,1,1,1,4112,A
6-NA,641,3,2,4115,0,4120,G
6-NA,642,0,4052,0,2,4054,T
6-NA,643,2,2,3971,0,3975,G
6-NA,644,1,4222,1,1,4225,T
6-NA,645,1,4220,0,2,4223,T
6-NA,646,1,1,4307,0,4309,G
6-NA,647,0,4296,0,10,4306,T
6-NA,648,0,4306,1,2,4309,T
6-NA,649,0,4317,0,2,4319,T
6-NA,650,39,1,0,4224,4264,C
6-NA,651,4246,3,6,1,4256,A
6-NA,652,1,4243,0,2,4246,T
6-NA,653,2,27,4219,0,4248,G
6-NA,654,2,2,4521,0,4525,G
6-NA,655,3,4388,0,5,4396,T
6-NA,656,27,1,0,4329,4357,C
6-NA,657,25,1,0,4319,4345,C
6-NA,658,4368,0,1,0,4369,A
6-NA,659,4417,0,1,0,4418,A
6-NA,660,4379,3,33,1,4416,A
6-NA,661,1,11,4442,0,4454,G
6-NA,662,4452,1,3,0,4456,A
6-NA,663,4335,0,2,0,4337,A
6-NA,664,4351,2,2,0,4355,A
6-NA,665,0,4347,0,0,4347,T
6-NA,666,23,2,0,4484,4509,C
6-NA,667,15,2,0,4503,4520,C
6-NA,668,0,4509,0,2,4511,T
6-NA,669,20,2,1,4497,4520,C
6-NA,670,4504,1,4,0,4509,A
6-NA,671,1,21,4551,0,4573,G
6-NA,672,3,33,4536,0,4572,G
6-NA,673,4679,0,7,0,4686,A
6-NA,674,4,0,0,4692,4696,C
6-NA,675,18,3,1,4594,4616,C
6-NA,676,23,5,1,4583,4612,C
6-NA,677,4613,0,4,1,4618,A
6-NA,678,0,6,4634,0,4640,G
6-NA,679,3,27,4624,0,4654,G
6-NA,680,4621,2,5,0,4628,A
6-NA,681,0,0,4699,0,4699,G
6-NA,682,3,4625,0,3,4631,T
6-NA,683,34,2,0,4604,4640,C
6-NA,684,4631,0,5,0,4636,A
6-NA,685,0,14,4663,0,4677,G
6-NA,686,4661,0,7,1,4669,A
6-NA,687,4670,0,2,0,4672,A
6-NA,688,0,4651,1,3,4655,T
6-NA,689,2,4,4677,0,4683,G
6-NA,690,4,6,0,4669,4679,C
6-NA,691,5,3,4698,0,4706,G
6-NA,692,0,4695,0,1,4696,T
6-NA,693,1,4692,1,4,4698,T
6-NA,694,1,4671,0,2,4674,T
6-NA,695,0,2,4717,0,4719,G
6-NA,696,1,4737,0,5,4743,T
6-NA,697,4746,0,3,0,4749,A
6-NA,698,2,4736,0,5,4743,T
6-NA,699,30,1,0,4722,4753,C
6-NA,700,4753,0,0,1,4754,A
6-NA,701,4759,0,2,0,4761,A
6-NA,702,1,4760,0,2,4763,T
6-NA,703,1,19,4741,0,4761,G
6-NA,704,0,39,4740,1,4780,G
6-NA,705,4864,1,11,0,4876,A
6-NA,706,4885,2,4,0,4891,A
6-NA,707,0,0,0,4940,4940,C
6-NA,708,0,4950,0,7,4957,T
6-NA,709,0,4935,0,4,4939,T
6-NA,710,3,1,5120,0,5124,G
6-NA,711,1,5118,0,0,5119,T
6-NA,712,5107,1,6,0,5114,A
6-NA,713,7,4,0,5173,5184,C
6-NA,714,5049,1,5,0,5055,A
6-NA,715,1,3,5403,1,5408,G
6-NA,716,0,5370,0,4,5374,T
6-NA,717,5575,0,2,0,5577,A
6-NA,718,2,2,5607,0,5611,G
6-NA,719,0,5499,0,3,5502,T
6-NA,720,5495,1,1,0,5497,A
6-NA,721,5500,0,1,0,5501,A
6-NA,722,0,5488,0,1,5489,T
6-NA,723,1,78,5435,0,5514,G
6-NA,724,5388,0,4,1,5393,A
6-NA,725,1,4,1,5447,5453,C
6-NA,726,1,5290,2,4,5297,T
6-NA,727,7,23,5274,1,5305,G
6-NA,728,5289,2,2,0,5293,A
6-NA,729,1,5322,1,2,5326,T
6-NA,730,1,37,5287,1,5326,G
6-NA,731,3,21,5286,2,5312,G
6-NA,732,6,30,5277,0,5313,G
6-NA,733,5238,1,6,1,5246,A
6-NA,734,1,4,5244,0,5249,G
6-NA,735,2,5196,2,6,5206,T
6-NA,736,2,2,5214,0,5218,G
6-NA,737,3,3,0,5217,5223,C
6-NA,738,0,5196,0,4,5200,T
6-NA,739,3,5192,0,3,5198,T
6-NA,740,18,2,0,5168,5188,C
6-NA,741,3,19,5145,1,5168,G
6-NA,742,1,11,5217,0,5229,G
6-NA,743,1,21,5212,0,5234,G
6-NA,744,5232,0,2,0,5234,A
6-NA,745,5200,1,4,0,5205,A
6-NA,746,5181,1,7,0,5189,A
6-NA,747,5216,1,8,0,5225,A
6-NA,748,0,10,5256,0,5266,G
6-NA,749,3,2,0,5262,5267,C
6-NA,750,1,5227,0,0,5228,T
6-NA,751,3,27,5205,0,5235,G
6-NA,752,5221,2,3,0,5226,A
6-NA,753,1,5274,0,4,5279,T
6-NA,754,5302,1,5,0,5308,A
6-NA,755,4,2,0,5637,5643,C
6-NA,756,0,5579,1,2,5582,T
6-NA,757,5574,0,1,0,5575,A
6-NA,758,5581,2,5,0,5588,A
6-NA,759,5587,0,0,0,5587,A
6-NA,760,5702,1,1,0,5704,A
6-NA,761,0,5705,0,1,5706,T
6-NA,762,5680,1,3,0,5684,A
6-NA,763,2,0,0,5711,5713,C
6-NA,764,2,5458,1,4,5465,T
6-NA,765,5582,0,2,0,5584,A
6-NA,766,3,5540,0,8,5551,T
6-NA,767,1,5983,0,2,5986,T
6-NA,768,45,0,0,6004,6049,C
6-NA,769,5955,0,1,0,5956,A
6-NA,770,2,5940,0,4,5946,T
6-NA,771,1,5938,0,1,5940,T
6-NA,772,5852,0,5,1,5858,A
6-NA,773,5872,1,7,1,5881,A
6-NA,774,1,19,5903,0,5923,G
6-NA,775,0,23,5905,0,5928,G
6-NA,776,5579,0,3,0,5582,A
6-NA,777,0,22,5618,1,5641,G
6-NA,778,2,37,5608,1,5648,G
6-NA,779,2,12,5634,1,5649,G
6-NA,780,2,35,5617,2,5656,G
6-NA,781,5637,0,5,0,5642,A
6-NA,782,5651,2,6,0,5659,A
6-NA,783,5620,1,6,2,5629,A
6-NA,784,5620,0,3,1,5624,A
6-NA,785,1,5629,0,1,5631,T
6-NA,786,40,8,0,5548,5596,C
6-NA,787,9,0,5646,0,5655,G
6-NA,788,1,5640,0,2,5643,T
6-NA,789,1,5633,0,3,5637,T
6-NA,790,55,2,1,5593,5651,C
6-NA,791,5602,0,2,1,5605,A
6-NA,792,0,6008,0,4,6012,T
6-NA,793,5995,1,4,0,6000,A
6-NA,794,2,2,0,6046,6050,C
6-NA,795,0,6016,0,3,6019,T
6-NA,796,6007,1,7,0,6015,A
6-NA,797,1,5,6010,1,6017,G
6-NA,798,1,6,0,5998,6005,C
6-NA,799,6006,1,3,0,6010,A
6-NA,800,2,1,0,6031,6034,C
6-NA,801,5791,1,1,0,5793,A
6-NA,802,1,6062,0,1,6064,T
6-NA,803,0,6023,1,7,6031,T
6-NA,804,1,0,6459,0,6460,G
6-NA,805,1,6421,0,5,6427,T
6-NA,806,54,4,1,6364,6423,C
6-NA,807,6404,1,10,2,6417,A
6-NA,808,1,16,6419,1,6437,G
6-NA,809,0,22,6433,2,6457,G
6-NA,810,6437,1,5,0,6443,A
6-NA,811,6351,0,2,0,6353,A
6-NA,812,1,4,6436,0,6441,G
6-NA,813,1,6075,2,3,6081,T
6-NA,814,1,10,6119,0,6130,G
6-NA,815,11,4,0,6106,6121,C
6-NA,816,0,6111,0,7,6118,T
6-NA,817,50,3,1,6089,6143,C
6-NA,818,6103,0,7,0,6110,A
6-NA,819,3,2,6174,0,6179,G
6-NA,820,6,5,2,6169,6182,C
6-NA,821,6170,0,1,0,6171,A
6-NA,822,1,6171,0,0,6172,T
6-NA,823,7,3,6346,1,6357,G
6-NA,824,2,6353,0,2,6357,T
6-NA,825,43,6,2,6304,6355,C
6-NA,826,2,25,6339,0,6366,G
6-NA,827,6349,3,3,0,6355,A
6-NA,828,2,17,6310,0,6329,G
6-NA,829,0,34,6311,0,6345,G
6-NA,830,6272,0,8,0,6280,A
6-NA,831,4,4,6349,1,6358,G
6-NA,832,1,6195,0,2,6198,T
6-NA,833,2,5,6212,1,6220,G
6-NA,834,7,4,0,6292,6303,C
6-NA,835,0,6277,0,8,6285,T
6-NA,836,39,0,0,6299,6338,C
6-NA,837,20,4,0,6327,6351,C
6-NA,838,0,6339,1,6,6346,T
6-NA,839,5,4,6358,0,6367,G
6-NA,840,6,2,0,6299,6307,C
6-NA,841,1,6256,0,4,6261,T
6-NA,842,6332,0,5,0,6337,A
6-NA,843,1,6258,0,5,6264,T
6-NA,844,18,2,3,6282,6305,C
6-NA,845,25,1,0,6263,6289,C
6-NA,846,0,6272,0,12,6284,T
6-NA,847,26,6,0,6296,6328,C
6-NA,848,7,20,6299,0,6326,G
6-NA,849,6398,0,1,0,6399,A
6-NA,850,1,6394,1,10,6406,T
6-NA,851,6395,1,0,0,6396,A
6-NA,852,0,6385,0,1,6386,T
6-NA,853,19,0,8,6342,6369,C
6-NA,854,23,1,0,6339,6363,C
6-NA,855,0,6297,1,4,6302,T
6-NA,856,5,18,6309,1,6333,G
6-NA,857,1,3,6366,1,6371,G
6-NA,858,1,6403,0,5,6409,T
6-NA,859,3,2,6420,0,6425,G
6-NA,860,0,6356,0,5,6361,T
6-NA,861,67,3,0,6294,6364,C
6-NA,862,6346,0,6,1,6353,A
6-NA,863,2,11,6360,0,6373,G
6-NA,864,6358,6,9,0,6373,A
6-NA,865,2,6300,0,7,6309,T
6-NA,866,1,0,6335,0,6336,G
6-NA,867,1,6214,0,4,6219,T
6-NA,868,3,5,6232,6,6246,G
6-NA,869,0,6213,0,5,6218,T
6-NA,870,42,1,0,6197,6240,C
6-NA,871,3,6220,0,8,6231,T
6-NA,872,1,3,6237,0,6241,G
6-NA,873,8,4,1,6229,6242,C
6-NA,874,6216,1,11,1,6229,A
6-NA,875,2,25,6206,1,6234,G
6-NA,876,6116,1,14,0,6131,A
6-NA,877,1,22,6138,5,6166,G
6-NA,878,6150,1,3,0,6154,A
6-NA,879,5,0,0,6212,6217,C
6-NA,880,6198,1,2,0,6201,A
6-NA,881,6220,7,3,0,6230,A
6-NA,882,3,1,0,6343,6347,C
6-NA,883,3,6327,2,2,6334,T
6-NA,884,6,13,6313,0,6332,G
6-NA,885,1,14,6296,0,6311,G
6-NA,886,6287,0,0,1,6288,A
6-NA,887,6285,0,4,1,6290,A
6-NA,888,6143,0,4,1,6148,A
6-NA,889,0,17,6226,0,6243,G
6-NA,890,0,5,6226,0,6231,G
6-NA,891,5,4,0,6221,6230,C
6-NA,892,2,6203,0,8,6213,T
6-NA,893,27,0,0,6324,6351,C
6-NA,894,16,7,0,6382,6405,C
6-NA,895,6423,2,1,0,6426,A
6-NA,896,6425,1,2,1,6429,A
6-NA,897,0,6429,0,3,6432,T
6-NA,898,6259,1,3,0,6263,A
6-NA,899,4,13,6238,0,6255,G
6-NA,900,4,8,6243,0,6255,G
6-NA,901,5,4,0,6251,6260,C
6-NA,902,16,1,0,6126,6143,C
6-NA,903,44,4,1,6036,6085,C
6-NA,904,6125,0,3,1,6129,A
6-NA,905,1,6173,0,1,6175,T
6-NA,906,28,1,1,6162,6192,C
6-NA,907,7,0,6206,0,6213,G
6-NA,908,1,6190,0,3,6194,T
6-NA,909,6077,1,5,0,6083,A
6-NA,910,1,10,6214,0,6225,G
6-NA,911,6231,1,6,0,6238,A
6-NA,912,0,6257,0,2,6259,T
6-NA,913,6161,0,1,0,6162,A
6-NA,914,0,6096,0,0,6096,T
6-NA,915,6096,0,1,0,6097,A
6-NA,916,6082,0,6,0,6088,A
6-NA,917,6248,1,5,2,6256,A
6-NA,918,4,0,0,6385,6389,C
6-NA,919,6237,1,0,1,6239,A
6-NA,920,1,6223,0,1,6225,T
6-NA,921,6165,0,6,1,6172,A
6-NA,922,6170,0,6,0,6176,A
6-NA,923,6163,0,17,1,6181,A
6-NA,924,5,24,6204,0,6233,G
6-NA,925,0,26,6264,0,6290,G
6-NA,926,6070,2,4,0,6076,A
6-NA,927,2,6006,0,4,6012,T
6-NA,928,45,2,0,5957,6004,C
6-NA,929,6038,1,6,0,6045,A
6-NA,930,1,6047,0,3,6051,T
6-NA,931,6038,0,5,0,6043,A
6-NA,932,0,2,6097,0,6099,G
6-NA,933,7,2,0,6027,6036,C
6-NA,934,5927,0,0,0,5927,A
6-NA,935,0,5755,1,2,5758,T
6-NA,936,0,5780,0,3,5783,T
6-NA,937,2,2,5943,0,5947,G
6-NA,938,1,5949,0,5,5955,T
6-NA,939,0,6034,0,9,6043,T
6-NA,940,3,6012,0,11,6026,T
6-NA,941,18,1,0,5982,6001,C
6-NA,942,16,1,1,6020,6038,C
6-NA,943,6100,3,6,0,6109,A
6-NA,944,0,5,6191,0,6196,G
6-NA,945,1,6175,1,7,6184,T
6-NA,946,0,6019,0,3,6022,T
6-NA,947,6025,0,1,0,6026,A
6-NA,948,1,5946,0,3,5950,T
6-NA,949,4,3,5959,0,5966,G
6-NA,950,2,5879,1,3,5885,T
6-NA,951,5,2,5902,1,5910,G
6-NA,952,2,5785,0,4,5791,T
6-NA,953,3,3,5905,0,5911,G
6-NA,954,0,5895,1,4,5900,T
6-NA,955,1,5869,0,6,5876,T
6-NA,956,37,1,1,5848,5887,C
6-NA,957,5835,0,7,2,5844,A
6-NA,958,1,24,5846,2,5873,G
6-NA,959,0,43,5827,0,5870,G
6-NA,960,5852,1,4,0,5857,A
6-NA,961,6,1,0,5859,5866,C
6-NA,962,0,5708,0,4,5712,T
6-NA,963,1,5730,0,3,5734,T
6-NA,964,0,1,5939,0,5940,G
6-NA,965,3,5930,0,10,5943,T
6-NA,966,1,5933,0,5,5939,T
6-NA,967,5,15,5886,1,5907,G
6-NA,968,2,35,5877,0,5914,G
6-NA,969,5894,1,10,0,5905,A
6-NA,970,1,35,5871,0,5907,G
6-NA,971,5874,0,6,1,5881,A
6-NA,972,2,4,0,5859,5865,C
6-NA,973,5698,1,4,0,5703,A
6-NA,974,3,7,0,5720,5730,C
6-NA,975,5720,3,11,0,5734,A
6-NA,976,7,2,0,5751,5760,C
6-NA,977,23,1,0,5699,5723,C
6-NA,978,29,2,3,5711,5745,C
6-NA,979,5732,0,5,3,5740,A
6-NA,980,0,16,5765,0,5781,G
6-NA,981,5764,0,7,1,5772,A
6-NA,982,5809,0,1,0,5810,A
6-NA,983,5773,0,3,0,5776,A
6-NA,984,5769,1,0,2,5772,A
6-NA,985,5735,0,5,0,5740,A
6-NA,986,5743,1,3,5,5752,A
6-NA,987,2,11,0,5737,5750,C
6-NA,988,4,77,5660,1,5742,G
6-NA,989,5734,1,3,0,5738,A
6-NA,990,1,3,0,5726,5730,C
6-NA,991,5707,0,7,0,5714,A
6-NA,992,1,4,5772,0,5777,G
6-NA,993,5,0,0,5947,5952,C
6-NA,994,0,5928,0,2,5930,T
6-NA,995,31,1,0,5909,5941,C
6-NA,996,18,2,1,5949,5970,C
6-NA,997,5962,0,10,0,5972,A
6-NA,998,3,3,6034,0,6040,G
6-NA,999,4,4,0,6034,6042,C
6-NA,1000,6021,2,2,0,6025,A
6-NA,1001,7,0,6027,0,6034,G
6-NA,1002,3,5815,0,5,5823,T
6-NA,1003,5824,0,4,0,5828,A
6-NA,1004,1,4,5831,0,5836,G
6-NA,1005,4,6,0,5840,5850,C
6-NA,1006,19,1,1,5845,5866,C
6-NA,1007,5775,0,1,2,5778,A
6-NA,1008,0,5782,0,0,5782,T
6-NA,1009,0,5747,0,4,5751,T
6-NA,1010,2,0,5865,0,5867,G
6-NA,1011,0,5823,2,4,5829,T
6-NA,1012,1,5812,0,6,5819,T
6-NA,1013,7,5803,0,0,5810,T
6-NA,1014,4,30,5732,0,5766,G
6-NA,1015,4,16,5805,0,5825,G
6-NA,1016,5799,3,1,0,5803,A
6-NA,1017,1,5843,0,4,5848,T
6-NA,1018,32,0,1,5821,5854,C
6-NA,1019,20,0,0,5726,5746,C
6-NA,1020,5,5729,0,4,5738,T
6-NA,1021,5716,1,22,0,5739,A
6-NA,1022,5747,4,4,0,5755,A
6-NA,1023,4,3,0,5859,5866,C
6-NA,1024,5765,0,1,0,5766,A
6-NA,1025,5872,1,0,0,5873,A
6-NA,1026,0,5843,0,4,5847,T
6-NA,1027,1,23,5910,1,5935,G
6-NA,1028,5910,0,7,0,5917,A
6-NA,1029,5888,0,11,0,5899,A
6-NA,1030,1,12,5914,0,5927,G
6-NA,1031,5882,1,10,0,5893,A
6-NA,1032,5731,0,10,0,5741,A
6-NA,1033,3,20,5747,0,5770,G
6-NA,1034,2,3,5790,0,5795,G
6-NA,1035,0,5713,0,8,5721,T
6-NA,1036,3,46,5650,0,5699,G
6-NA,1037,1,4,5863,1,5869,G
6-NA,1038,0,5849,0,3,5852,T
6-NA,1039,82,2,1,5738,5823,C
6-NA,1040,5824,1,3,0,5828,A
6-NA,1041,2,5798,0,8,5808,T
6-NA,1042,0,30,5794,0,5824,G
6-NA,1043,0,35,5831,0,5866,G
6-NA,1044,5826,1,8,0,5835,A
6-NA,1045,6,0,5981,0,5987,G
6-NA,1046,0,5772,0,8,5780,T
6-NA,1047,1,26,5770,0,5797,G
6-NA,1048,5780,3,6,0,5789,A
6-NA,1049,5779,1,5,1,5786,A
6-NA,1050,5804,1,9,0,5814,A
6-NA,1051,0,22,5834,0,5856,G
6-NA,1052,1,4,5798,0,5803,G
6-NA,1053,2,0,0,5786,5788,C
6-NA,1054,1,5622,1,7,5631,T
6-NA,1055,2,21,5612,0,5635,G
6-NA,1056,4,19,5617,0,5640,G
6-NA,1057,1,2,5697,3,5703,G
6-NA,1058,2,0,0,5710,5712,C
6-NA,1059,14,1,1,5680,5696,C
6-NA,1060,1,5589,4,8,5602,T
6-NA,1061,0,5616,1,4,5621,T
6-NA,1062,3,5619,3,0,5625,T
6-NA,1063,2,15,5631,0,5648,G
6-NA,1064,5644,2,4,0,5650,A
6-NA,1065,0,5599,0,2,5601,T
6-NA,1066,4,19,5520,0,5543,G
6-NA,1067,5496,2,5,0,5503,A
6-NA,1068,0,5510,1,0,5511,T
6-NA,1069,4,21,5502,0,5527,G
6-NA,1070,0,15,5606,0,5621,G
6-NA,1071,5609,2,4,1,5616,A
6-NA,1072,5604,0,4,1,5609,A
6-NA,1073,5613,0,4,0,5617,A
6-NA,1074,0,5615,1,1,5617,T
6-NA,1075,1,28,5605,0,5634,G
6-NA,1076,5621,0,9,1,5631,A
6-NA,1077,5,3,0,5612,5620,C
6-NA,1078,9,1,5636,0,5646,G
6-NA,1079,1,5527,0,3,5531,T
6-NA,1080,5,2,5581,0,5588,G
6-NA,1081,0,5577,2,3,5582,T
6-NA,1082,1,24,5563,0,5588,G
6-NA,1083,0,16,5606,0,5622,G
6-NA,1084,5587,0,3,0,5590,A
6-NA,1085,3,5582,0,1,5586,T
6-NA,1086,2,27,5537,0,5566,G
6-NA,1087,3,16,5531,2,5552,G
6-NA,1088,3,14,5559,0,5576,G
6-NA,1089,5544,0,5,0,5549,A
6-NA,1090,5541,0,2,0,5543,A
6-NA,1091,2,45,5499,2,5548,G
6-NA,1092,5480,0,3,0,5483,A
6-NA,1093,5487,2,4,0,5493,A
6-NA,1094,2,8,0,5466,5476,C
6-NA,1095,5,47,5387,1,5440,G
6-NA,1096,5436,1,6,0,5443,A
6-NA,1097,0,5368,0,2,5370,T
6-NA,1098,30,2,0,5345,5377,C
6-NA,1099,5357,0,4,0,5361,A
6-NA,1100,2,4,5377,1,5384,G
6-NA,1101,5,4,1,5355,5365,C
6-NA,1102,6,26,5337,0,5369,G
6-NA,1103,5344,0,9,0,5353,A
6-NA,1104,1,11,5358,0,5370,G
6-NA,1105,5360,0,5,0,5365,A
6-NA,1106,5361,0,5,0,5366,A
6-NA,1107,1,0,5412,0,5413,G
6-NA,1108,2,5376,0,8,5386,T
6-NA,1109,41,0,2,5294,5337,C
6-NA,1110,5319,1,1,0,5321,A
6-NA,1111,2,4,2,5494,5502,C
6-NA,1112,3,5,5507,0,5515,G
6-NA,1113,1,0,0,5506,5507,C
6-NA,1114,1,5464,0,5,5470,T
6-NA,1115,0,5488,0,0,5488,T
6-NA,1116,5395,1,0,0,5396,A
6-NA,1117,0,20,5539,0,5559,G
6-NA,1118,4,37,5528,0,5569,G
6-NA,1119,4,3,5659,0,5666,G
6-NA,1120,0,5382,0,6,5388,T
6-NA,1121,5368,0,6,0,5374,A
6-NA,1122,1,5361,0,2,5364,T
6-NA,1123,1,27,5330,0,5358,G
6-NA,1124,5342,1,3,1,5347,A
6-NA,1125,5333,0,2,0,5335,A
6-NA,1126,5142,2,8,1,5153,A
6-NA,1127,3,2,0,5078,5083,C
6-NA,1128,19,1,0,4895,4915,C
6-NA,1129,0,4573,0,1,4574,T
6-NA,1130,1,4552,0,6,4559,T
6-NA,1131,11,1,0,4558,4570,C
6-NA,1132,4563,2,0,0,4565,A
6-NA,1133,4578,0,2,1,4581,A
6-NA,1134,4565,2,7,0,4574,A
6-NA,1135,0,2,4622,0,4624,G
6-NA,1136,1,4548,0,6,4555,T
6-NA,1137,54,1,2,4504,4561,C
6-NA,1138,4630,2,6,0,4638,A
6-NA,1139,0,4648,0,2,4650,T
6-NA,1140,0,4647,0,5,4652,T
6-NA,1141,2,10,4638,1,4651,G
6-NA,1142,4626,1,4,0,4631,A
6-NA,1143,4657,1,8,1,4667,A
6-NA,1144,0,21,4665,0,4686,G
6-NA,1145,0,1,4679,0,4680,G
6-NA,1146,1,0,0,4660,4661,C
6-NA,1147,0,4547,0,5,4552,T
6-NA,1148,0,18,4565,0,4583,G
6-NA,1149,1,4,4714,0,4719,G
6-NA,1150,1,4717,0,7,4725,T
6-NA,1151,45,4,1,4665,4715,C
6-NA,1152,17,0,0,4673,4690,C
6-NA,1153,4658,1,7,0,4666,A
6-NA,1154,4700,0,1,0,4701,A
6-NA,1155,3,6,0,4726,4735,C
6-NA,1156,15,0,1,4687,4703,C
6-NA,1157,29,1,5,4628,4663,C
6-NA,1158,0,4468,0,5,4473,T
6-NA,1159,4479,0,1,0,4480,A
6-NA,1160,4483,0,2,0,4485,A
6-NA,1161,2,2,4536,0,4540,G
6-NA,1162,1,4509,0,10,4520,T
6-NA,1163,29,2,0,4465,4496,C
6-NA,1164,31,1,1,4425,4458,C
6-NA,1165,4440,0,2,0,4442,A
6-NA,1166,4440,2,0,0,4442,A
6-NA,1167,4442,0,1,0,4443,A
6-NA,1168,0,4444,0,3,4447,T
6-NA,1169,0,4432,0,0,4432,T
6-NA,1170,3,2,4432,0,4437,G
6-NA,1171,1,2,0,4400,4403,C
6-NA,1172,4396,0,5,0,4401,A
6-NA,1173,2,7,4423,0,4432,G
6-NA,1174,4419,0,2,0,4421,A
6-NA,1175,1,4521,1,1,4524,T
6-NA,1176,4526,0,1,0,4527,A
6-NA,1177,4516,0,3,1,4520,A
6-NA,1178,4520,1,5,0,4526,A
6-NA,1179,1,4515,0,0,4516,T
6-NA,1180,4493,0,2,1,4496,A
6-NA,1181,0,11,4499,0,4510,G
6-NA,1182,1,3,4476,0,4480,G
6-NA,1183,4,0,0,4458,4462,C
6-NA,1184,4338,0,2,0,4340,A
6-NA,1185,4393,1,7,0,4401,A
6-NA,1186,1,0,4456,0,4457,G
6-NA,1187,1,4442,0,6,4449,T
6-NA,1188,68,0,1,4383,4452,C
6-NA,1189,4463,0,4,1,4468,A
6-NA,1190,0,4477,1,0,4478,T
6-NA,1191,4483,1,5,0,4489,A
6-NA,1192,2,2,4505,0,4509,G
6-NA,1193,0,4499,0,3,4502,T
6-NA,1194,0,4371,0,4,4375,T
6-NA,1195,1,43,4277,0,4321,G
6-NA,1196,4287,2,6,0,4295,A
6-NA,1197,2,0,0,4292,4294,C
6-NA,1198,4220,0,2,1,4223,A
6-NA,1199,0,6,4286,0,4292,G
6-NA,1200,4233,4,4,0,4241,A
6-NA,1201,2,12,4405,0,4419,G
6-NA,1202,2,2,4434,0,4438,G
6-NA,1203,1,4434,0,5,4440,T
6-NA,1204,4420,0,1,0,4421,A
6-NA,1205,4406,0,8,0,4414,A
6-NA,1206,0,4426,0,0,4426,T
6-NA,1207,4406,0,2,0,4408,A
6-NA,1208,7,22,4319,0,4348,G
6-NA,1209,2,1,4290,0,4293,G
6-NA,1210,1,3964,1,2,3968,T
6-NA,1211,30,1,1,3911,3943,C
6-NA,1212,21,7,1,3891,3920,C
6-NA,1213,5,11,3913,0,3929,G
6-NA,1214,1,4,3931,0,3936,G
6-NA,1215,0,3928,2,2,3932,T
6-NA,1216,0,3924,1,1,3926,T
6-NA,1217,3883,0,1,1,3885,A
6-NA,1218,0,3839,1,0,3840,T
6-NA,1219,0,3824,0,0,3824,T
6-NA,1220,21,3,0,3809,3833,C
6-NA,1221,1,3706,0,5,3712,T
6-NA,1222,0,13,3726,0,3739,G
6-NA,1223,3,4,3744,0,3751,G
6-NA,1224,0,3734,0,2,3736,T
6-NA,1225,3737,0,2,0,3739,A
6-NA,1226,1,3678,1,2,3682,T
6-NA,1227,0,3670,0,7,3677,T
6-NA,1228,1,3668,1,5,3675,T
6-NA,1229,0,3686,0,3,3689,T
6-NA,1230,17,1,0,3676,3694,C
6-NA,1231,0,3617,0,7,3624,T
6-NA,1232,24,0,0,3622,3646,C
6-NA,1233,0,3622,0,3,3625,T
6-NA,1234,1,0,3683,0,3684,G
6-NA,1235,0,3676,0,5,3681,T
6-NA,1236,1,3655,0,1,3657,T
6-NA,1237,4,6,3651,0,3661,G
6-NA,1238,3619,0,2,0,3621,A
6-NA,1239,3615,0,8,1,3624,A
6-NA,1240,1,12,3639,1,3653,G
6-NA,1241,4,2,3642,0,3648,G
6-NA,1242,4,4,0,3639,3647,C
6-NA,1243,3594,2,1,3,3600,A
6-NA,1244,3593,0,8,0,3601,A
6-NA,1245,3610,1,2,0,3613,A
6-NA,1246,3600,0,7,1,3608,A
6-NA,1247,0,1,3617,0,3618,G
6-NA,1248,3,0,0,3607,3610,C
6-NA,1249,1,3556,0,4,3561,T
6-NA,1250,3,2,3596,0,3601,G
6-NA,1251,4,4,1,3590,3599,C
6-NA,1252,3603,0,4,0,3607,A
6-NA,1253,3,3592,1,3,3599,T
6-NA,1254,15,1,0,3561,3577,C
6-NA,1255,3579,1,1,1,3582,A
6-NA,1256,3584,1,1,1,3587,A
6-NA,1257,0,3573,0,0,3573,T
6-NA,1258,13,7,0,3560,3580,C
6-NA,1259,8,11,3506,0,3525,G
6-NA,1260,3,5,3565,0,3573,G
6-NA,1261,1,3567,0,2,3570,T
6-NA,1262,1,2,3593,0,3596,G
6-NA,1263,1,3,0,3611,3615,C
6-NA,1264,1,3568,0,12,3581,T
6-NA,1265,0,3621,0,3,3624,T
6-NA,1266,1,3616,0,3,3620,T
6-NA,1267,0,3641,0,1,3642,T
6-NA,1268,3666,1,0,0,3667,A
6-NA,1269,0,3510,1,3,3514,T
6-NA,1270,0,0,3517,0,3517,G
6-NA,1271,1,3469,0,3,3473,T
6-NA,1272,1,7,3436,1,3445,G
6-NA,1273,0,22,3479,0,3501,G
6-NA,1274,3408,1,3,0,3412,A
6-NA,1275,3,2,3446,0,3451,G
6-NA,1276,2,3429,0,1,3432,T
6-NA,1277,1,3415,1,4,3421,T
6-NA,1278,7,18,3419,0,3444,G
6-NA,1279,3430,0,3,0,3433,A
6-NA,1280,0,3439,0,0,3439,T
6-NA,1281,3425,0,1,0,3426,A
6-NA,1282,3335,1,4,0,3340,A
6-NA,1283,2,19,3349,0,3370,G
6-NA,1284,0,23,3298,1,3322,G
6-NA,1285,1,11,3284,1,3297,G
6-NA,1286,1,9,3282,0,3292,G
6-NA,1287,3253,0,2,0,3255,A
6-NA,1288,3245,1,3,0,3249,A
6-NA,1289,2,19,3247,0,3268,G
6-NA,1290,3262,0,1,0,3263,A
6-NA,1291,3258,0,1,1,3260,A
6-NA,1292,3220,0,0,0,3220,A
6-NA,1293,3169,0,6,0,3175,A
6-NA,1294,1,10,3181,0,3192,G
6-NA,1295,3151,0,4,0,3155,A
6-NA,1296,33,11,3114,0,3158,G
6-NA,1297,27,21,3108,1,3157,G
6-NA,1298,3108,1,6,0,3115,A
6-NA,1299,3081,0,37,0,3118,A
6-NA,1300,3116,1,3,0,3120,A
6-NA,1301,0,1,0,3134,3135,C
6-NA,1302,0,3117,0,0,3117,T
6-NA,1303,2,5,3114,1,3122,G
6-NA,1304,3093,0,3,0,3096,A
6-NA,1305,3081,2,7,0,3090,A
6-NA,1306,0,0,3111,0,3111,G
6-NA,1307,1,3072,0,5,3078,T
6-NA,1308,29,0,0,3081,3110,C
6-NA,1309,0,3102,0,5,3107,T
6-NA,1310,0,3063,0,0,3063,T
6-NA,1311,1,0,3072,0,3073,G
6-NA,1312,2,3058,0,1,3061,T
6-NA,1313,3,22,3033,1,3059,G
6-NA,1314,0,20,3016,0,3036,G
6-NA,1315,2999,0,0,0,2999,A
6-NA,1316,2,0,0,2996,2998,C
6-NA,1317,2873,0,0,1,2874,A
6-NA,1318,0,2871,0,3,2874,T
6-NA,1319,8,0,0,2868,2876,C
6-NA,1320,5,23,2846,0,2874,G
6-NA,1321,2922,2,0,0,2924,A
6-NA,1322,2923,1,2,0,2926,A
6-NA,1323,1,3,0,2942,2946,C
6-NA,1324,2872,0,5,0,2877,A
6-NA,1325,2,0,2993,0,2995,G
6-NA,1326,2,2970,0,1,2973,T
6-NA,1327,2966,0,2,0,2968,A
6-NA,1328,1,2978,0,0,2979,T
6-NA,1329,0,2871,0,0,2871,T
6-NA,1330,0,1,2911,0,2912,G
6-NA,1331,0,2893,0,4,2897,T
6-NA,1332,1,2819,0,4,2824,T
6-NA,1333,1,1,2825,0,2827,G
6-NA,1334,0,2545,0,1,2546,T
6-NA,1335,1,0,2559,0,2560,G
6-NA,1336,0,2540,2,7,2549,T
6-NA,1337,0,2508,0,6,2514,T
6-NA,1338,0,2519,0,1,2520,T
6-NA,1339,0,2450,0,2,2452,T
6-NA,1340,0,2,2456,1,2459,G
6-NA,1341,1,2453,0,2,2456,T
6-NA,1342,3,14,2411,0,2428,G
6-NA,1343,1,4,2427,0,2432,G
6-NA,1344,5,1,0,2380,2386,C
6-NA,1345,2369,1,1,0,2371,A
6-NA,1346,2,0,0,2388,2390,C
6-NA,1347,14,0,0,2368,2382,C
6-NA,1348,0,2377,0,2,2379,T
6-NA,1349,13,1,1,2369,2384,C
6-NA,1350,2377,1,5,0,2383,A
6-NA,1351,0,6,2399,0,2405,G
6-NA,1352,0,0,2410,0,2410,G
6-NA,1353,0,2401,0,0,2401,T
6-NA,1354,2384,0,2,0,2386,A
6-NA,1355,0,1,0,2290,2291,C
6-NA,1356,2274,0,1,0,2275,A
6-NA,1357,0,2273,0,1,2274,T
6-NA,1358,2211,0,7,0,2218,A
6-NA,1359,0,2207,1,1,2209,T
6-NA,1360,3,2,2071,0,2076,G
6-NA,1361,0,6,2077,0,2083,G
6-NA,1362,2066,1,0,0,2067,A
6-NA,1363,2052,0,0,0,2052,A
6-NA,1364,1,0,0,2024,2025,C
6-NA,1365,1664,0,2,0,1666,A
6-NA,1366,1,3,1667,0,1671,G
6-NA,1367,1,0,1669,0,1670,G
6-NA,1368,3,1,1,1673,1678,C
6-NA,1369,0,1666,1,5,1672,T
6-NA,1370,16,3,0,1593,1612,C
6-NA,1371,1600,0,5,0,1605,A
6-NA,1372,0,1600,0,2,1602,T
6-NA,1373,1,8,1597,0,1606,G
6-NA,1374,0,0,1616,0,1616,G
6-NA,1375,2,1,0,1551,1554,C
6-NA,1376,1,0,1,1533,1535,C
6-NA,1377,0,1455,0,1,1456,T
6-NA,1378,0,2,1456,0,1458,G
6-NA,1379,1454,1,0,0,1455,A
6-NA,1380,1,1452,0,0,1453,T
6-NA,1381,2,10,1418,0,1430,G
6-NA,1382,1,6,1392,0,1399,G
6-NA,1383,0,3,1330,0,1333,G
6-NA,1384,0,0,1330,0,1330,G
6-NA,1385,1,3,0,1295,1299,C
6-NA,1386,0,3,1296,0,1299,G
6-NA,1387,0,8,1270,0,1278,G
6-NA,1388,1258,0,0,0,1258,A
6-NA,1389,0,1,0,1253,1254,C
6-NA,1390,1246,1,0,0,1247,A
6-NA,1391,0,1231,0,1,1232,T
6-NA,1392,9,0,0,1207,1216,C
6-NA,1393,1198,0,0,1,1199,A
6-NA,1394,1198,0,1,0,1199,A
6-NA,1395,0,1195,0,1,1196,T
6-NA,1396,1,0,0,1174,1175,C
6-NA,1397,0,1133,0,1,1134,T
6-NA,1398,16,0,0,945,961,C
6-NA,1399,953,0,1,0,954,A
6-NA,1400,0,950,0,0,950,T
6-NA,1401,1,0,949,0,950,G
6-NA,1402,3,0,0,948,951,C
6-NA,1403,6,0,0,909,915,C
6-NA,1404,0,799,0,1,800,T
6-NA,1405,780,0,0,0,780,A
6-NA,1406,0,779,0,1,780,T
6-NA,1407,764,0,1,0,765,A
6-NA,1408,0,760,0,0,760,T
6-NA,1409,690,0,0,0,690,A
6-NA,1410,665,0,0,0,665,A
7-M,1,64,0,0,0,64,A
7-M,2,0,66,0,0,66,T
7-M,3,0,0,63,0,63,G
7-M,4,67,0,0,0,67,A
7-M,5,0,0,70,0,70,G
7-M,6,0,0,0,75,75,C
7-M,7,0,0,0,80,80,C
7-M,8,0,105,0,0,105,T
7-M,9,0,106,0,0,106,T
7-M,10,0,0,0,106,106,C
7-M,11,0,107,0,0,107,T
7-M,12,112,0,0,0,112,A
7-M,13,113,0,0,0,113,A
7-M,14,0,0,0,113,113,C
7-M,15,1,0,0,112,113,C
7-M,16,0,1,111,1,113,G
7-M,17,115,0,0,0,115,A
7-M,18,0,1,114,0,115,G
7-M,19,0,0,121,0,121,G
7-M,20,0,121,0,0,121,T
7-M,21,3,1,0,117,121,C
7-M,22,0,0,121,0,121,G
7-M,23,123,0,1,0,124,A
7-M,24,126,0,0,0,126,A
7-M,25,130,0,0,0,130,A
7-M,26,0,0,0,149,149,C
7-M,27,0,0,152,0,152,G
7-M,28,0,155,0,0,155,T
7-M,29,157,0,0,0,157,A
7-M,30,0,158,0,0,158,T
7-M,31,0,1,161,0,162,G
7-M,32,0,161,0,0,161,T
7-M,33,0,176,0,1,177,T
7-M,34,0,0,0,185,185,C
7-M,35,0,185,0,0,185,T
7-M,36,0,0,0,197,197,C
7-M,37,0,197,0,0,197,T
7-M,38,0,0,0,202,202,C
7-M,39,0,203,0,0,203,T
7-M,40,205,0,0,0,205,A
7-M,41,0,205,0,0,205,T
7-M,42,0,0,0,208,208,C
7-M,43,0,0,206,0,206,G
7-M,44,0,212,0,0,212,T
7-M,45,0,210,0,2,212,T
7-M,46,1,0,0,213,214,C
7-M,47,0,0,0,220,220,C
7-M,48,222,0,0,0,222,A
7-M,49,0,221,0,2,223,T
7-M,50,0,0,0,224,224,C
7-M,51,225,0,0,0,225,A
7-M,52,0,0,227,0,227,G
7-M,53,1,1,223,1,226,G
7-M,54,0,1,0,224,225,C
7-M,55,0,0,0,224,224,C
7-M,56,0,0,0,226,226,C
7-M,57,0,0,0,240,240,C
7-M,58,1,0,0,242,243,C
7-M,59,0,242,0,0,242,T
7-M,60,1,0,0,244,245,C
7-M,61,244,0,0,0,244,A
7-M,62,247,0,0,0,247,A
7-M,63,249,0,0,0,249,A
7-M,64,0,0,251,0,251,G
7-M,65,0,0,0,251,251,C
7-M,66,0,0,0,252,252,C
7-M,67,0,1,251,0,252,G
7-M,68,253,0,1,0,254,A
7-M,69,1,1,252,0,254,G
7-M,70,256,0,0,0,256,A
7-M,71,0,258,0,0,258,T
7-M,72,1,0,0,255,256,C
7-M,73,0,0,257,0,257,G
7-M,74,0,0,0,258,258,C
7-M,75,0,0,259,0,259,G
7-M,76,0,0,0,258,258,C
7-M,77,258,0,1,0,259,A
7-M,78,0,0,264,0,264,G
7-M,79,260,0,1,0,261,A
7-M,80,0,2,278,0,280,G
7-M,81,281,0,0,0,281,A
7-M,82,1,0,0,279,280,C
7-M,83,0,281,0,0,281,T
7-M,84,0,279,0,0,279,T
7-M,85,0,2,280,0,282,G
7-M,86,283,0,0,0,283,A
7-M,87,281,0,0,0,281,A
7-M,88,0,1,280,0,281,G
7-M,89,271,0,0,0,271,A
7-M,90,0,277,0,0,277,T
7-M,91,0,0,284,0,284,G
7-M,92,0,282,0,0,282,T
7-M,93,2,0,0,281,283,C
7-M,94,0,282,0,1,283,T
7-M,95,0,282,0,0,282,T
7-M,96,0,282,0,0,282,T
7-M,97,1,0,283,0,284,G
7-M,98,0,0,0,284,284,C
7-M,99,0,283,0,1,284,T
7-M,100,0,0,288,0,288,G
7-M,101,0,1,286,0,287,G
7-M,102,0,0,291,0,291,G
7-M,103,289,0,0,0,289,A
7-M,104,291,0,0,0,291,A
7-M,105,287,0,3,0,290,A
7-M,106,289,0,0,0,289,A
7-M,107,291,0,0,0,291,A
7-M,108,0,0,0,297,297,C
7-M,109,296,0,0,0,296,A
7-M,110,0,0,0,297,297,C
7-M,111,295,0,0,0,295,A
7-M,112,0,0,304,0,304,G
7-M,113,314,0,0,0,314,A
7-M,114,0,321,0,0,321,T
7-M,115,1,0,0,320,321,C
7-M,116,0,320,0,1,321,T
7-M,117,0,321,0,0,321,T
7-M,118,0,3,317,0,320,G
7-M,119,319,0,1,0,320,A
7-M,120,0,3,316,0,319,G
7-M,121,0,0,318,0,318,G
7-M,122,0,0,0,317,317,C
7-M,123,0,319,1,0,320,T
7-M,124,0,0,0,353,353,C
7-M,125,0,354,0,0,354,T
7-M,126,2,0,0,353,355,C
7-M,127,354,0,1,0,355,A
7-M,128,0,356,0,0,356,T
7-M,129,0,2,353,0,355,G
7-M,130,0,3,357,0,360,G
7-M,131,355,1,0,0,356,A
7-M,132,354,0,1,1,356,A
7-M,133,0,345,1,0,346,T
7-M,134,0,1,357,0,358,G
7-M,135,0,0,371,0,371,G
7-M,136,0,0,0,373,373,C
7-M,137,0,370,0,0,370,T
7-M,138,371,0,0,0,371,A
7-M,139,369,0,1,0,370,A
7-M,140,375,0,1,0,376,A
7-M,141,0,2,383,0,385,G
7-M,142,384,0,1,0,385,A
7-M,143,1,0,0,380,381,C
7-M,144,375,0,0,0,375,A
7-M,145,377,0,1,0,378,A
7-M,146,0,2,387,0,389,G
7-M,147,391,0,0,0,391,A
7-M,148,0,0,0,392,392,C
7-M,149,1,0,0,392,393,C
7-M,150,390,0,0,0,390,A
7-M,151,400,0,0,0,400,A
7-M,152,0,400,0,0,400,T
7-M,153,0,400,0,0,400,T
7-M,154,0,0,0,406,406,C
7-M,155,0,405,0,0,405,T
7-M,156,0,1,403,0,404,G
7-M,157,0,405,0,0,405,T
7-M,158,1,0,0,404,405,C
7-M,159,402,0,1,0,403,A
7-M,160,1,0,0,416,417,C
7-M,161,4,0,0,412,416,C
7-M,162,0,412,0,1,413,T
7-M,163,0,0,0,413,413,C
7-M,164,0,409,0,0,409,T
7-M,165,1,4,420,0,425,G
7-M,166,427,0,0,0,427,A
7-M,167,0,0,0,429,429,C
7-M,168,0,428,0,1,429,T
7-M,169,421,0,0,0,421,A
7-M,170,417,0,0,0,417,A
7-M,171,1,2,416,0,419,G
7-M,172,0,2,419,0,421,G
7-M,173,0,1,420,0,421,G
7-M,174,0,2,412,2,416,G
7-M,175,422,0,0,0,422,A
7-M,176,0,425,0,0,425,T
7-M,177,0,423,0,0,423,T
7-M,178,0,425,0,0,425,T
7-M,179,0,421,0,0,421,T
7-M,180,2,3,417,0,422,G
7-M,181,0,5,413,0,418,G
7-M,182,0,0,415,0,415,G
7-M,183,1,0,417,0,418,G
7-M,184,0,410,0,0,410,T
7-M,185,0,410,0,1,411,T
7-M,186,0,410,0,0,410,T
7-M,187,0,0,420,0,420,G
7-M,188,1,420,0,0,421,T
7-M,189,0,1,424,0,425,G
7-M,190,0,427,0,0,427,T
7-M,191,0,426,0,0,426,T
7-M,192,3,0,0,427,430,C
7-M,193,431,0,0,0,431,A
7-M,194,0,1,0,437,438,C
7-M,195,0,0,438,0,438,G
7-M,196,0,0,0,435,435,C
7-M,197,0,429,0,0,429,T
7-M,198,3,0,0,441,444,C
7-M,199,444,1,1,0,446,A
7-M,200,0,0,0,455,455,C
7-M,201,1,3,0,446,450,C
7-M,202,3,0,450,0,453,G
7-M,203,0,454,3,0,457,T
7-M,204,0,0,463,0,463,G
7-M,205,0,0,0,464,464,C
7-M,206,6,0,0,459,465,C
7-M,207,1,0,0,463,464,C
7-M,208,456,0,3,0,459,A
7-M,209,0,0,468,0,468,G
7-M,210,0,459,0,0,459,T
7-M,211,0,4,458,0,462,G
7-M,212,470,0,0,0,470,A
7-M,213,0,0,471,0,471,G
7-M,214,0,0,0,470,470,C
7-M,215,0,1,469,0,470,G
7-M,216,468,0,0,0,468,A
7-M,217,0,4,468,0,472,G
7-M,218,0,1,473,0,474,G
7-M,219,469,0,0,0,469,A
7-M,220,0,0,0,475,475,C
7-M,221,0,466,0,0,466,T
7-M,222,2,0,466,0,468,G
7-M,223,0,1,0,467,468,C
7-M,224,466,0,1,0,467,A
7-M,225,0,0,477,0,477,G
7-M,226,1,0,0,475,476,C
7-M,227,0,0,478,0,478,G
7-M,228,0,479,0,0,479,T
7-M,229,476,0,1,0,477,A
7-M,230,0,1,476,0,477,G
7-M,231,474,0,0,0,474,A
7-M,232,0,2,0,482,484,C
7-M,233,0,0,484,0,484,G
7-M,234,0,0,0,483,483,C
7-M,235,0,477,0,0,477,T
7-M,236,0,477,0,0,477,T
7-M,237,0,475,0,0,475,T
7-M,238,1,0,494,0,495,G
7-M,239,0,494,0,1,495,T
7-M,240,1,0,0,491,492,C
7-M,241,2,0,0,495,497,C
7-M,242,491,0,0,0,491,A
7-M,243,489,0,0,1,490,A
7-M,244,491,0,0,0,491,A
7-M,245,492,0,0,0,492,A
7-M,246,0,493,0,0,493,T
7-M,247,0,0,486,0,486,G
7-M,248,0,0,0,486,486,C
7-M,249,1,0,0,487,488,C
7-M,250,5,0,0,486,491,C
7-M,251,0,492,0,0,492,T
7-M,252,0,1,0,504,505,C
7-M,253,506,0,0,0,506,A
7-M,254,503,0,0,0,503,A
7-M,255,1,506,0,0,507,T
7-M,256,0,0,505,0,505,G
7-M,257,0,3,504,0,507,G
7-M,258,0,6,499,0,505,G
7-M,259,501,0,0,0,501,A
7-M,260,501,0,0,0,501,A
7-M,261,0,495,0,1,496,T
7-M,262,0,2,494,0,496,G
7-M,263,0,2,492,1,495,G
7-M,264,490,0,1,0,491,A
7-M,265,0,7,486,0,493,G
7-M,266,486,0,0,0,486,A
7-M,267,1,0,0,477,478,C
7-M,268,4,0,0,505,509,C
7-M,269,0,0,0,512,512,C
7-M,270,523,0,0,0,523,A
7-M,271,523,0,1,0,524,A
7-M,272,524,0,0,0,524,A
7-M,273,0,527,0,0,527,T
7-M,274,540,0,0,0,540,A
7-M,275,540,0,1,0,541,A
7-M,276,0,0,0,531,531,C
7-M,277,527,0,0,0,527,A
7-M,278,0,525,0,0,525,T
7-M,279,1,2,533,0,536,G
7-M,280,1,2,533,0,536,G
7-M,281,536,0,0,0,536,A
7-M,282,0,0,0,534,534,C
7-M,283,522,0,0,0,522,A
7-M,284,523,0,1,0,524,A
7-M,285,522,0,0,0,522,A
7-M,286,0,0,526,0,526,G
7-M,287,0,0,0,540,540,C
7-M,288,529,0,1,0,530,A
7-M,289,1,0,537,0,538,G
7-M,290,0,537,0,1,538,T
7-M,291,0,537,0,0,537,T
7-M,292,541,0,0,0,541,A
7-M,293,538,0,0,1,539,A
7-M,294,540,0,1,1,542,A
7-M,295,0,0,0,547,547,C
7-M,296,0,534,0,0,534,T
7-M,297,1,1,573,0,575,G
7-M,298,0,566,0,0,566,T
7-M,299,572,0,0,0,572,A
7-M,300,0,572,0,1,573,T
7-M,301,565,0,0,0,565,A
7-M,302,0,2,564,0,566,G
7-M,303,530,0,0,0,530,A
7-M,304,533,1,0,0,534,A
7-M,305,531,0,1,0,532,A
7-M,306,545,0,0,0,545,A
7-M,307,1,0,0,555,556,C
7-M,308,0,550,0,0,550,T
7-M,309,0,547,0,0,547,T
7-M,310,550,0,0,0,550,A
7-M,311,550,0,2,0,552,A
7-M,312,0,2,554,0,556,G
7-M,313,547,1,1,0,549,A
7-M,314,1,5,547,0,553,G
7-M,315,0,1,545,0,546,G
7-M,316,0,4,545,0,549,G
7-M,317,547,0,2,0,549,A
7-M,318,0,2,550,0,552,G
7-M,319,556,0,1,0,557,A
7-M,320,0,554,0,1,555,T
7-M,321,558,0,0,0,558,A
7-M,322,559,0,2,0,561,A
7-M,323,0,1,0,563,564,C
7-M,324,0,0,560,0,560,G
7-M,325,0,555,0,1,556,T
7-M,326,1,552,0,0,553,T
7-M,327,5,0,0,551,556,C
7-M,328,3,0,0,551,554,C
7-M,329,552,0,1,0,553,A
7-M,330,0,554,0,0,554,T
7-M,331,0,2,549,0,551,G
7-M,332,1,4,547,0,552,G
7-M,333,0,2,543,1,546,G
7-M,334,0,0,549,0,549,G
7-M,335,1,0,0,547,548,C
7-M,336,3,0,0,545,548,C
7-M,337,547,0,0,0,547,A
7-M,338,549,0,0,0,549,A
7-M,339,549,0,2,0,551,A
7-M,340,0,1,553,0,554,G
7-M,341,550,0,0,0,550,A
7-M,342,545,0,0,0,545,A
7-M,343,542,0,0,0,542,A
7-M,344,0,546,0,0,546,T
7-M,345,544,0,2,0,546,A
7-M,346,1,0,550,0,551,G
7-M,347,0,0,0,545,545,C
7-M,348,0,539,0,1,540,T
7-M,349,4,0,0,540,544,C
7-M,350,0,538,0,1,539,T
7-M,351,4,1,0,550,555,C
7-M,352,554,0,0,0,554,A
7-M,353,0,0,555,0,555,G
7-M,354,1,550,0,2,553,T
7-M,355,0,559,0,0,559,T
7-M,356,560,0,0,0,560,A
7-M,357,0,563,0,0,563,T
7-M,358,0,560,0,0,560,T
7-M,359,3,0,0,563,566,C
7-M,360,0,538,0,0,538,T
7-M,361,0,0,543,0,543,G
7-M,362,0,0,0,545,545,C
7-M,363,0,545,0,0,545,T
7-M,364,0,2,541,1,544,G
7-M,365,0,1,543,0,544,G
7-M,366,0,543,0,1,544,T
7-M,367,1,1,538,0,540,G
7-M,368,0,0,0,542,542,C
7-M,369,541,0,1,0,542,A
7-M,370,0,0,0,545,545,C
7-M,371,0,540,0,1,541,T
7-M,372,0,545,0,1,546,T
7-M,373,0,0,544,0,544,G
7-M,374,0,0,0,547,547,C
7-M,375,4,0,0,545,549,C
7-M,376,542,0,1,0,543,A
7-M,377,0,1,547,0,548,G
7-M,378,0,548,0,1,549,T
7-M,379,0,550,0,0,550,T
7-M,380,0,1,551,0,552,G
7-M,381,1,0,0,542,543,C
7-M,382,541,0,0,0,541,A
7-M,383,0,543,0,0,543,T
7-M,384,0,3,536,0,539,G
7-M,385,0,3,543,0,546,G
7-M,386,0,1,547,0,548,G
7-M,387,1,1,0,551,553,C
7-M,388,2,0,0,565,567,C
7-M,389,0,559,0,0,559,T
7-M,390,3,0,0,567,570,C
7-M,391,595,0,0,0,595,A
7-M,392,0,600,0,0,600,T
7-M,393,623,0,0,0,623,A
7-M,394,1,616,0,0,617,T
7-M,395,600,0,0,0,600,A
7-M,396,0,0,0,647,647,C
7-M,397,623,0,1,0,624,A
7-M,398,627,0,0,0,627,A
7-M,399,0,624,0,0,624,T
7-M,400,591,0,1,0,592,A
7-M,401,0,1,598,0,599,G
7-M,402,0,0,599,0,599,G
7-M,403,596,0,1,0,597,A
7-M,404,0,594,0,0,594,T
7-M,405,1,2,557,0,560,G
7-M,406,0,2,556,0,558,G
7-M,407,0,3,564,0,567,G
7-M,408,0,2,569,0,571,G
7-M,409,0,1,571,0,572,G
7-M,410,2,0,0,570,572,C
7-M,411,0,561,0,0,561,T
7-M,412,0,0,563,0,563,G
7-M,413,0,564,0,0,564,T
7-M,414,563,0,0,0,563,A
7-M,415,561,0,1,0,562,A
7-M,416,0,0,0,567,567,C
7-M,417,3,0,0,557,560,C
7-M,418,554,0,0,0,554,A
7-M,419,0,0,0,555,555,C
7-M,420,0,553,0,0,553,T
7-M,421,0,3,558,0,561,G
7-M,422,561,0,0,0,561,A
7-M,423,560,0,0,0,560,A
7-M,424,0,0,564,0,564,G
7-M,425,0,555,0,0,555,T
7-M,426,0,4,551,1,556,G
7-M,427,1,1,554,0,556,G
7-M,428,0,0,0,556,556,C
7-M,429,557,0,0,0,557,A
7-M,430,1,552,0,0,553,T
7-M,431,0,553,0,0,553,T
7-M,432,0,551,0,2,553,T
7-M,433,0,2,566,0,568,G
7-M,434,0,1,567,0,568,G
7-M,435,0,0,0,570,570,C
7-M,436,3,0,0,563,566,C
7-M,437,0,558,0,0,558,T
7-M,438,0,3,580,0,583,G
7-M,439,0,0,588,0,588,G
7-M,440,1,587,0,0,588,T
7-M,441,592,0,0,0,592,A
7-M,442,0,564,0,1,565,T
7-M,443,0,0,583,0,583,G
7-M,444,0,580,0,2,582,T
7-M,445,0,1,580,0,581,G
7-M,446,0,1,1,581,583,C
7-M,447,570,0,0,0,570,A
7-M,448,573,0,0,0,573,A
7-M,449,3,0,0,576,579,C
7-M,450,577,0,0,0,577,A
7-M,451,0,581,0,0,581,T
7-M,452,0,0,577,0,577,G
7-M,453,0,562,0,0,562,T
7-M,454,0,7,556,0,563,G
7-M,455,558,0,0,0,558,A
7-M,456,0,0,564,0,564,G
7-M,457,2,0,0,563,565,C
7-M,458,555,0,1,0,556,A
7-M,459,0,2,557,0,559,G
7-M,460,557,0,1,0,558,A
7-M,461,0,559,0,1,560,T
7-M,462,0,561,0,0,561,T
7-M,463,0,0,564,0,564,G
7-M,464,0,0,0,565,565,C
7-M,465,0,558,0,1,559,T
7-M,466,0,6,551,1,558,G
7-M,467,556,0,0,0,556,A
7-M,468,0,0,0,589,589,C
7-M,469,0,592,0,1,593,T
7-M,470,4,0,0,588,592,C
7-M,471,2,1,0,585,588,C
7-M,472,3,0,0,590,593,C
7-M,473,592,0,1,0,593,A
7-M,474,1,1,597,0,599,G
7-M,475,1,0,0,598,599,C
7-M,476,599,0,0,0,599,A
7-M,477,0,1,0,595,596,C
7-M,478,566,0,0,0,566,A
7-M,479,0,1,577,0,578,G
7-M,480,0,0,580,0,580,G
7-M,481,0,581,0,0,581,T
7-M,482,6,0,0,593,599,C
7-M,483,0,587,0,2,589,T
7-M,484,3,0,1,587,591,C
7-M,485,585,0,1,0,586,A
7-M,486,0,584,0,1,585,T
7-M,487,588,0,1,0,589,A
7-M,488,0,1,577,0,578,G
7-M,489,0,0,577,0,577,G
7-M,490,2,0,0,573,575,C
7-M,491,555,0,0,0,555,A
7-M,492,0,1,544,0,545,G
7-M,493,552,0,0,0,552,A
7-M,494,0,554,0,0,554,T
7-M,495,0,0,554,0,554,G
7-M,496,0,0,554,0,554,G
7-M,497,0,549,0,0,549,T
7-M,498,0,5,556,0,561,G
7-M,499,0,0,562,0,562,G
7-M,500,0,1,0,559,560,C
7-M,501,556,0,2,0,558,A
7-M,502,557,0,2,0,559,A
7-M,503,0,0,0,563,563,C
7-M,504,563,0,0,0,563,A
7-M,505,562,0,0,0,562,A
7-M,506,0,0,0,558,558,C
7-M,507,2,0,0,549,551,C
7-M,508,546,0,0,0,546,A
7-M,509,545,0,0,0,545,A
7-M,510,0,546,0,1,547,T
7-M,511,1,0,0,545,546,C
7-M,512,2,0,0,538,540,C
7-M,513,530,0,0,0,530,A
7-M,514,0,527,1,0,528,T
7-M,515,0,528,0,0,528,T
7-M,516,530,0,0,0,530,A
7-M,517,530,0,0,0,530,A
7-M,518,0,531,0,0,531,T
7-M,519,528,0,0,0,528,A
7-M,520,526,0,2,0,528,A
7-M,521,522,0,0,0,522,A
7-M,522,526,0,1,0,527,A
7-M,523,0,0,0,539,539,C
7-M,524,540,0,0,0,540,A
7-M,525,0,536,0,0,536,T
7-M,526,0,3,533,0,536,G
7-M,527,534,0,0,0,534,A
7-M,528,1,2,535,0,538,G
7-M,529,535,0,0,0,535,A
7-M,530,540,0,0,0,540,A
7-M,531,1,1,0,542,544,C
7-M,532,525,0,0,0,525,A
7-M,533,0,0,532,0,532,G
7-M,534,528,0,1,0,529,A
7-M,535,527,0,0,1,528,A
7-M,536,0,528,0,0,528,T
7-M,537,2,4,513,0,519,G
7-M,538,0,0,519,0,519,G
7-M,539,0,516,0,1,517,T
7-M,540,0,499,0,0,499,T
7-M,541,0,508,0,0,508,T
7-M,542,0,507,0,0,507,T
7-M,543,1,4,510,0,515,G
7-M,544,0,0,516,0,516,G
7-M,545,1,0,0,515,516,C
7-M,546,1,1,0,515,517,C
7-M,547,503,0,0,0,503,A
7-M,548,0,1,515,0,516,G
7-M,549,0,0,0,517,517,C
7-M,550,521,0,0,0,521,A
7-M,551,0,0,0,526,526,C
7-M,552,0,521,0,0,521,T
7-M,553,523,0,0,0,523,A
7-M,554,1,0,0,523,524,C
7-M,555,529,0,0,0,529,A
7-M,556,0,0,532,0,532,G
7-M,557,0,1,0,513,514,C
7-M,558,0,510,0,0,510,T
7-M,559,510,0,0,0,510,A
7-M,560,502,0,1,0,503,A
7-M,561,1,0,503,0,504,G
7-M,562,0,0,506,0,506,G
7-M,563,0,0,0,504,504,C
7-M,564,0,463,0,0,463,T
7-M,565,465,0,0,0,465,A
7-M,566,0,462,0,0,462,T
7-M,567,0,1,464,0,465,G
7-M,568,1,0,470,0,471,G
7-M,569,457,0,2,0,459,A
7-M,570,0,0,461,0,461,G
7-M,571,1,0,0,456,457,C
7-M,572,450,0,1,0,451,A
7-M,573,451,0,0,0,451,A
7-M,574,448,0,1,1,450,A
7-M,575,0,452,1,1,454,T
7-M,576,0,3,450,1,454,G
7-M,577,0,0,452,0,452,G
7-M,578,0,0,0,452,452,C
7-M,579,0,442,0,0,442,T
7-M,580,0,2,443,1,446,G
7-M,581,0,2,456,0,458,G
7-M,582,458,0,0,0,458,A
7-M,583,0,456,0,1,457,T
7-M,584,2,0,0,450,452,C
7-M,585,453,0,0,0,453,A
7-M,586,453,0,0,0,453,A
7-M,587,0,0,455,0,455,G
7-M,588,0,454,0,1,455,T
7-M,589,1,4,449,0,454,G
7-M,590,443,0,0,0,443,A
7-M,591,0,0,443,0,443,G
7-M,592,2,1,0,441,444,C
7-M,593,441,1,1,0,443,A
7-M,594,0,1,446,0,447,G
7-M,595,0,0,444,0,444,G
7-M,596,0,0,0,445,445,C
7-M,597,440,0,2,0,442,A
7-M,598,0,0,444,0,444,G
7-M,599,0,0,0,441,441,C
7-M,600,0,0,441,0,441,G
7-M,601,0,1,443,0,444,G
7-M,602,440,0,0,0,440,A
7-M,603,0,1,447,0,448,G
7-M,604,0,0,458,0,458,G
7-M,605,0,0,0,458,458,C
7-M,606,3,0,0,452,455,C
7-M,607,454,0,0,0,454,A
7-M,608,0,453,0,1,454,T
7-M,609,0,1,456,0,457,G
7-M,610,0,0,457,0,457,G
7-M,611,456,0,0,0,456,A
7-M,612,0,1,451,0,452,G
7-M,613,436,0,2,0,438,A
7-M,614,0,448,0,0,448,T
7-M,615,0,447,0,1,448,T
7-M,616,0,1,448,0,449,G
7-M,617,1,0,0,446,447,C
7-M,618,0,446,0,0,446,T
7-M,619,446,0,0,0,446,A
7-M,620,1,0,446,0,447,G
7-M,621,0,443,0,0,443,T
7-M,622,2,1,0,442,445,C
7-M,623,432,0,1,0,433,A
7-M,624,0,1,443,0,444,G
7-M,625,0,0,443,0,443,G
7-M,626,0,0,0,443,443,C
7-M,627,2,0,0,441,443,C
7-M,628,438,0,2,0,440,A
7-M,629,0,0,450,0,450,G
7-M,630,0,0,450,0,450,G
7-M,631,0,0,0,451,451,C
7-M,632,446,0,0,0,446,A
7-M,633,0,0,447,0,447,G
7-M,634,444,0,0,0,444,A
7-M,635,0,445,0,0,445,T
7-M,636,0,1,445,0,446,G
7-M,637,0,1,460,0,461,G
7-M,638,1,457,0,0,458,T
7-M,639,0,0,459,0,459,G
7-M,640,0,0,0,462,462,C
7-M,641,461,2,0,0,463,A
7-M,642,0,2,470,0,472,G
7-M,643,0,0,470,0,470,G
7-M,644,1,0,0,474,475,C
7-M,645,473,0,0,0,473,A
7-M,646,469,0,0,0,469,A
7-M,647,0,467,0,0,467,T
7-M,648,0,4,463,0,467,G
7-M,649,463,0,0,0,463,A
7-M,650,1,2,463,0,466,G
7-M,651,455,0,1,0,456,A
7-M,652,0,0,461,0,461,G
7-M,653,0,0,0,465,465,C
7-M,654,0,1,0,465,466,C
7-M,655,471,0,0,0,471,A
7-M,656,0,475,0,0,475,T
7-M,657,0,473,0,0,473,T
7-M,658,1,1,473,0,475,G
7-M,659,0,1,472,0,473,G
7-M,660,0,1,474,0,475,G
7-M,661,474,0,0,0,474,A
7-M,662,0,0,0,473,473,C
7-M,663,0,458,0,0,458,T
7-M,664,2,0,0,455,457,C
7-M,665,461,0,0,0,461,A
7-M,666,0,485,0,2,487,T
7-M,667,1,0,0,485,486,C
7-M,668,1,0,0,485,486,C
7-M,669,0,480,0,1,481,T
7-M,670,477,0,0,0,477,A
7-M,671,0,0,482,0,482,G
7-M,672,0,531,0,1,532,T
7-M,673,0,530,0,0,530,T
7-M,674,3,0,0,519,522,C
7-M,675,5,0,0,505,510,C
7-M,676,511,1,0,0,512,A
7-M,677,0,0,521,0,521,G
7-M,678,0,520,0,0,520,T
7-M,679,520,0,1,0,521,A
7-M,680,0,0,1,520,521,C
7-M,681,0,466,0,0,466,T
7-M,682,0,1,484,0,485,G
7-M,683,0,0,503,0,503,G
7-M,684,0,500,0,0,500,T
7-M,685,3,0,0,499,502,C
7-M,686,0,494,0,0,494,T
7-M,687,494,0,1,0,495,A
7-M,688,493,0,0,0,493,A
7-M,689,0,4,500,0,504,G
7-M,690,495,0,0,0,495,A
7-M,691,0,0,488,0,488,G
7-M,692,465,0,0,0,465,A
7-M,693,0,460,0,3,463,T
7-M,694,0,0,465,0,465,G
7-M,695,463,0,0,0,463,A
7-M,696,0,459,0,1,460,T
7-M,697,2,0,0,460,462,C
7-M,698,0,456,0,0,456,T
7-M,699,0,457,0,1,458,T
7-M,700,0,0,0,462,462,C
7-M,701,0,461,0,0,461,T
7-M,702,0,459,0,2,461,T
7-M,703,0,4,456,0,460,G
7-M,704,460,0,1,0,461,A
7-M,705,458,0,1,0,459,A
7-M,706,462,0,0,0,462,A
7-M,707,462,0,0,0,462,A
7-M,708,1,454,1,0,456,T
7-M,709,1,458,0,0,459,T
7-M,710,0,460,0,0,460,T
7-M,711,0,0,460,0,460,G
7-M,712,0,0,0,457,457,C
7-M,713,456,0,2,0,458,A
7-M,714,0,3,456,0,459,G
7-M,715,459,0,1,0,460,A
7-M,716,1,0,0,471,472,C
7-M,717,1,0,0,464,465,C
7-M,718,1,466,0,0,467,T
7-M,719,476,0,0,0,476,A
7-M,720,0,477,0,0,477,T
7-M,721,0,1,0,475,476,C
7-M,722,474,0,1,0,475,A
7-M,723,0,4,478,0,482,G
7-M,724,481,0,0,0,481,A
7-M,725,478,0,0,0,478,A
7-M,726,481,0,1,0,482,A
7-M,727,0,2,0,478,480,C
7-M,728,2,3,476,1,482,G
7-M,729,475,0,0,0,475,A
7-M,730,477,0,0,0,477,A
7-M,731,0,476,1,0,477,T
7-M,732,0,2,476,0,478,G
7-M,733,0,5,477,0,482,G
7-M,734,0,1,476,1,478,G
7-M,735,0,2,476,0,478,G
7-M,736,0,1,483,0,484,G
7-M,737,0,463,0,2,465,T
7-M,738,0,0,465,0,465,G
7-M,739,1,0,0,464,465,C
7-M,740,463,0,2,0,465,A
7-M,741,0,0,471,0,471,G
7-M,742,465,0,0,0,465,A
7-M,743,0,463,0,1,464,T
7-M,744,0,0,467,0,467,G
7-M,745,0,0,1,462,463,C
7-M,746,462,0,0,0,462,A
7-M,747,463,0,0,0,463,A
7-M,748,0,1,0,470,471,C
7-M,749,1,4,469,0,474,G
7-M,750,477,0,0,0,477,A
7-M,751,0,476,0,0,476,T
7-M,752,0,473,0,0,473,T
7-M,753,3,0,0,473,476,C
7-M,754,462,0,0,0,462,A
7-M,755,461,0,1,0,462,A
7-M,756,0,0,467,0,467,G
7-M,757,0,456,0,0,456,T
7-M,758,0,4,452,0,456,G
7-M,759,448,0,0,0,448,A
7-M,760,0,0,0,449,449,C
7-M,761,0,0,0,449,449,C
7-M,762,0,1,0,446,447,C
7-M,763,0,0,449,0,449,G
7-M,764,1,0,0,449,450,C
7-M,765,0,452,0,1,453,T
7-M,766,0,452,0,0,452,T
7-M,767,0,0,455,0,455,G
7-M,768,1,455,0,0,456,T
7-M,769,0,453,0,0,453,T
7-M,770,0,0,455,0,455,G
7-M,771,0,447,0,0,447,T
7-M,772,0,441,0,0,441,T
7-M,773,0,0,444,0,444,G
7-M,774,0,0,0,438,438,C
7-M,775,5,0,0,434,439,C
7-M,776,1,0,439,0,440,G
7-M,777,1,0,1,439,441,C
7-M,778,2,3,438,0,443,G
7-M,779,441,0,0,0,441,A
7-M,780,441,1,0,1,443,A
7-M,781,0,447,0,0,447,T
7-M,782,440,0,0,0,440,A
7-M,783,0,442,0,1,443,T
7-M,784,4,0,0,446,450,C
7-M,785,451,0,0,0,451,A
7-M,786,0,449,0,0,449,T
7-M,787,0,446,0,0,446,T
7-M,788,1,1,442,1,445,G
7-M,789,0,1,446,0,447,G
7-M,790,0,2,444,0,446,G
7-M,791,451,0,0,0,451,A
7-M,792,0,449,0,0,449,T
7-M,793,2,0,0,439,441,C
7-M,794,0,441,0,0,441,T
7-M,795,0,443,0,0,443,T
7-M,796,0,0,448,0,448,G
7-M,797,0,0,0,449,449,C
7-M,798,451,0,0,0,451,A
7-M,799,0,0,0,454,454,C
7-M,800,0,438,0,0,438,T
7-M,801,0,443,0,0,443,T
7-M,802,0,3,440,0,443,G
7-M,803,447,0,0,0,447,A
7-M,804,0,448,0,1,449,T
7-M,805,441,0,1,0,442,A
7-M,806,0,437,0,1,438,T
7-M,807,0,436,0,0,436,T
7-M,808,1,0,437,0,438,G
7-M,809,0,432,0,2,434,T
7-M,810,0,1,431,0,432,G
7-M,811,0,4,425,0,429,G
7-M,812,421,0,0,0,421,A
7-M,813,0,424,0,0,424,T
7-M,814,0,423,0,0,423,T
7-M,815,2,0,0,422,424,C
7-M,816,0,423,0,1,424,T
7-M,817,0,416,0,1,417,T
7-M,818,0,3,413,0,416,G
7-M,819,414,0,0,0,414,A
7-M,820,0,417,0,0,417,T
7-M,821,5,0,0,406,411,C
7-M,822,0,0,413,0,413,G
7-M,823,0,413,0,0,413,T
7-M,824,3,0,0,409,412,C
7-M,825,0,411,0,1,412,T
7-M,826,0,412,0,0,412,T
7-M,827,0,411,0,0,411,T
7-M,828,0,413,0,0,413,T
7-M,829,0,416,0,0,416,T
7-M,830,0,415,0,1,416,T
7-M,831,0,414,0,0,414,T
7-M,832,3,0,0,411,414,C
7-M,833,411,0,0,0,411,A
7-M,834,412,0,0,0,412,A
7-M,835,412,0,0,0,412,A
7-M,836,0,410,0,0,410,T
7-M,837,0,2,410,0,412,G
7-M,838,0,1,0,411,412,C
7-M,839,0,0,411,0,411,G
7-M,840,0,428,0,1,429,T
7-M,841,2,0,0,429,431,C
7-M,842,0,431,0,0,431,T
7-M,843,434,0,0,0,434,A
7-M,844,0,433,0,1,434,T
7-M,845,3,0,0,432,435,C
7-M,846,1,2,432,0,435,G
7-M,847,432,0,1,0,433,A
7-M,848,0,0,0,433,433,C
7-M,849,0,424,0,1,425,T
7-M,850,2,0,0,429,431,C
7-M,851,0,425,0,4,429,T
7-M,852,0,428,0,0,428,T
7-M,853,2,0,0,428,430,C
7-M,854,429,0,1,0,430,A
7-M,855,430,0,0,0,430,A
7-M,856,430,0,0,0,430,A
7-M,857,1,0,0,428,429,C
7-M,858,427,0,0,0,427,A
7-M,859,0,0,0,405,405,C
7-M,860,0,0,397,0,397,G
7-M,861,0,0,408,0,408,G
7-M,862,1,0,0,408,409,C
7-M,863,2,0,0,405,407,C
7-M,864,0,408,0,0,408,T
7-M,865,0,408,0,0,408,T
7-M,866,409,0,0,0,409,A
7-M,867,409,0,0,0,409,A
7-M,868,409,0,0,0,409,A
7-M,869,407,0,0,0,407,A
7-M,870,0,1,403,0,404,G
7-M,871,348,0,1,0,349,A
7-M,872,0,3,345,0,348,G
7-M,873,0,0,346,0,346,G
7-M,874,0,0,0,348,348,C
7-M,875,1,0,0,347,348,C
7-M,876,6,0,0,343,349,C
7-M,877,0,348,0,1,349,T
7-M,878,0,352,0,0,352,T
7-M,879,1,0,0,353,354,C
7-M,880,0,354,0,0,354,T
7-M,881,357,0,0,0,357,A
7-M,882,0,0,0,357,357,C
7-M,883,0,1,349,0,350,G
7-M,884,0,0,351,0,351,G
7-M,885,339,0,0,0,339,A
7-M,886,339,0,0,0,339,A
7-M,887,0,2,335,0,337,G
7-M,888,0,2,337,0,339,G
7-M,889,334,0,0,0,334,A
7-M,890,0,0,336,0,336,G
7-M,891,0,330,0,0,330,T
7-M,892,332,0,0,0,332,A
7-M,893,2,1,0,329,332,C
7-M,894,5,0,0,323,328,C
7-M,895,0,322,0,0,322,T
7-M,896,0,1,323,0,324,G
7-M,897,307,0,0,1,308,A
7-M,898,0,0,312,0,312,G
7-M,899,0,296,0,0,296,T
7-M,900,1,0,0,296,297,C
7-M,901,0,288,0,0,288,T
7-M,902,287,0,0,0,287,A
7-M,903,0,286,0,1,287,T
7-M,904,0,0,287,0,287,G
7-M,905,277,0,1,0,278,A
7-M,906,0,2,275,0,277,G
7-M,907,1,1,257,0,259,G
7-M,908,0,0,260,0,260,G
7-M,909,256,0,0,0,256,A
7-M,910,256,0,0,0,256,A
7-M,911,0,0,256,0,256,G
7-M,912,255,0,0,0,255,A
7-M,913,260,0,0,0,260,A
7-M,914,0,256,0,0,256,T
7-M,915,255,0,0,0,255,A
7-M,916,0,255,0,0,255,T
7-M,917,1,5,0,243,249,C
7-M,918,1,1,249,0,251,G
7-M,919,249,0,0,0,249,A
7-M,920,245,0,0,0,245,A
7-M,921,244,0,0,0,244,A
7-M,922,1,0,241,0,242,G
7-M,923,0,3,240,0,243,G
7-M,924,241,0,0,0,241,A
7-M,925,241,0,0,0,241,A
7-M,926,0,0,0,243,243,C
7-M,927,236,0,0,0,236,A
7-M,928,0,0,237,0,237,G
7-M,929,1,0,0,236,237,C
7-M,930,236,0,0,0,236,A
7-M,931,0,0,236,0,236,G
7-M,932,225,0,1,0,226,A
7-M,933,228,0,0,0,228,A
7-M,934,0,228,0,0,228,T
7-M,935,0,0,216,0,216,G
7-M,936,0,0,0,216,216,C
7-M,937,0,199,0,0,199,T
7-M,938,0,0,200,0,200,G
7-M,939,0,200,0,0,200,T
7-M,940,0,0,199,0,199,G
7-M,941,0,0,198,0,198,G
7-M,942,192,0,0,0,192,A
7-M,943,0,191,0,1,192,T
7-M,944,0,0,188,0,188,G
7-M,945,0,1,0,181,182,C
7-M,946,0,166,0,0,166,T
7-M,947,0,0,164,0,164,G
7-M,948,164,0,0,0,164,A
7-M,949,0,0,0,163,163,C
7-M,950,0,3,155,0,158,G
7-M,951,156,0,1,0,157,A
7-M,952,1,1,0,153,155,C
7-M,953,148,0,0,0,148,A
7-M,954,0,0,148,0,148,G
7-M,955,0,148,0,0,148,T
7-M,956,0,0,0,146,146,C
7-M,957,146,0,0,0,146,A
7-M,958,0,142,0,0,142,T
7-M,959,0,142,0,0,142,T
7-M,960,0,142,0,0,142,T
7-M,961,0,139,0,0,139,T
7-M,962,0,0,139,0,139,G
7-M,963,0,127,0,0,127,T
7-M,964,1,0,0,126,127,C
7-M,965,116,0,0,0,116,A
7-M,966,0,0,116,0,116,G
7-M,967,0,0,0,114,114,C
7-M,968,114,0,0,0,114,A
7-M,969,0,114,0,0,114,T
7-M,970,107,0,0,0,107,A
7-M,971,0,0,106,0,106,G
7-M,972,103,0,0,0,103,A
7-M,973,0,0,103,0,103,G
7-M,974,0,100,0,0,100,T
7-M,975,0,67,0,0,67,T
7-M,976,0,0,66,0,66,G
7-M,977,0,2,64,0,66,G
7-M,978,65,0,1,0,66,A
7-M,979,0,0,66,0,66,G
7-M,980,0,42,0,0,42,T
7-M,981,42,0,0,0,42,A
7-M,982,42,0,0,0,42,A
8-NS,1,236,0,0,0,236,A
8-NS,2,0,236,0,0,236,T
8-NS,3,0,0,253,0,253,G
8-NS,4,0,2,270,0,272,G
8-NS,5,289,0,0,0,289,A
8-NS,6,0,562,0,0,562,T
8-NS,7,0,563,0,1,564,T
8-NS,8,0,0,0,593,593,C
8-NS,9,2,0,1,592,595,C
8-NS,10,595,0,1,0,596,A
8-NS,11,605,0,0,0,605,A
8-NS,12,0,1,0,606,607,C
8-NS,13,609,0,0,0,609,A
8-NS,14,0,0,0,614,614,C
8-NS,15,0,615,0,1,616,T
8-NS,16,0,0,680,0,680,G
8-NS,17,0,681,0,0,681,T
8-NS,18,0,0,695,0,695,G
8-NS,19,0,693,0,1,694,T
8-NS,20,4,0,0,693,697,C
8-NS,21,695,0,1,0,696,A
8-NS,22,696,0,0,0,696,A
8-NS,23,0,0,708,0,708,G
8-NS,24,0,725,1,0,726,T
8-NS,25,0,721,0,0,721,T
8-NS,26,0,728,0,0,728,T
8-NS,27,1,0,0,731,732,C
8-NS,28,0,1,0,732,733,C
8-NS,29,733,0,0,0,733,A
8-NS,30,1,6,734,0,741,G
8-NS,31,0,0,755,0,755,G
8-NS,32,0,752,0,0,752,T
8-NS,33,756,0,0,0,756,A
8-NS,34,0,2,758,0,760,G
8-NS,35,756,0,1,0,757,A
8-NS,36,0,758,0,3,761,T
8-NS,37,0,759,0,0,759,T
8-NS,38,0,0,770,0,770,G
8-NS,39,0,0,0,770,770,C
8-NS,40,0,767,0,1,768,T
8-NS,41,0,775,0,0,775,T
8-NS,42,0,776,0,1,777,T
8-NS,43,1,0,0,785,786,C
8-NS,44,0,784,0,0,784,T
8-NS,45,0,783,0,0,783,T
8-NS,46,0,783,0,1,784,T
8-NS,47,1,5,785,0,791,G
8-NS,48,0,0,790,0,790,G
8-NS,49,2,0,0,789,791,C
8-NS,50,789,0,0,0,789,A
8-NS,51,0,801,0,2,803,T
8-NS,52,807,0,0,0,807,A
8-NS,53,0,818,0,2,820,T
8-NS,54,1,0,0,819,820,C
8-NS,55,24,1,0,799,824,C
8-NS,56,3,5,818,0,826,G
8-NS,57,1,3,830,0,834,G
8-NS,58,830,1,1,0,832,A
8-NS,59,837,0,0,0,837,A
8-NS,60,835,0,2,0,837,A
8-NS,61,1,1,0,853,855,C
8-NS,62,850,0,0,0,850,A
8-NS,63,849,0,3,0,852,A
8-NS,64,0,1,875,0,876,G
8-NS,65,0,879,0,2,881,T
8-NS,66,0,875,0,1,876,T
8-NS,67,2,0,877,0,879,G
8-NS,68,0,877,0,0,877,T
8-NS,69,875,2,1,0,878,A
8-NS,70,0,3,888,1,892,G
8-NS,71,939,0,3,0,942,A
8-NS,72,0,0,0,956,956,C
8-NS,73,4,1,0,943,948,C
8-NS,74,948,0,0,0,948,A
8-NS,75,953,0,2,0,955,A
8-NS,76,1,6,1003,0,1010,G
8-NS,77,1012,0,1,0,1013,A
8-NS,78,1016,0,0,0,1016,A
8-NS,79,0,0,0,1023,1023,C
8-NS,80,0,1002,0,1,1003,T
8-NS,81,0,10,1004,0,1014,G
8-NS,82,1010,0,1,0,1011,A
8-NS,83,0,0,1035,0,1035,G
8-NS,84,0,1034,0,0,1034,T
8-NS,85,0,8,1007,0,1015,G
8-NS,86,1021,0,0,0,1021,A
8-NS,87,0,1014,0,0,1014,T
8-NS,88,0,0,1031,0,1031,G
8-NS,89,3,1,0,1038,1042,C
8-NS,90,2,0,0,1043,1045,C
8-NS,91,3,2,0,1047,1052,C
8-NS,92,7,0,0,1047,1054,C
8-NS,93,1065,0,0,0,1065,A
8-NS,94,0,1079,0,1,1080,T
8-NS,95,1,1096,0,1,1098,T
8-NS,96,8,1,0,1099,1108,C
8-NS,97,5,1,0,1104,1110,C
8-NS,98,0,1101,0,3,1104,T
8-NS,99,0,1104,0,0,1104,T
8-NS,100,1,13,1084,0,1098,G
8-NS,101,1099,1,0,0,1100,A
8-NS,102,0,1100,0,0,1100,T
8-NS,103,8,0,0,1085,1093,C
8-NS,104,2,4,1081,0,1087,G
8-NS,105,2,1,1102,0,1105,G
8-NS,106,0,0,0,1106,1106,C
8-NS,107,0,1104,0,0,1104,T
8-NS,108,0,1106,0,0,1106,T
8-NS,109,3,0,0,1100,1103,C
8-NS,110,1,0,1109,0,1110,G
8-NS,111,0,0,0,1114,1114,C
8-NS,112,7,1,0,1107,1115,C
8-NS,113,2,3,1111,0,1116,G
8-NS,114,1108,1,0,0,1109,A
8-NS,115,1,4,1141,0,1146,G
8-NS,116,1146,0,0,0,1146,A
8-NS,117,0,1150,0,1,1151,T
8-NS,118,8,0,0,1145,1153,C
8-NS,119,1148,0,0,0,1148,A
8-NS,120,0,3,1147,0,1150,G
8-NS,121,1144,0,2,0,1146,A
8-NS,122,1,5,1146,0,1152,G
8-NS,123,1,4,1166,0,1171,G
8-NS,124,0,1180,0,0,1180,T
8-NS,125,6,1,0,1230,1237,C
8-NS,126,8,0,0,1245,1253,C
8-NS,127,3,0,0,1258,1261,C
8-NS,128,0,1259,0,0,1259,T
8-NS,129,1262,0,0,0,1262,A
8-NS,130,1260,0,0,0,1260,A
8-NS,131,0,7,1282,0,1289,G
8-NS,132,1,11,1272,1,1285,G
8-NS,133,0,6,1268,1,1275,G
8-NS,134,0,7,1240,0,1247,G
8-NS,135,1237,0,1,0,1238,A
8-NS,136,1233,1,2,0,1236,A
8-NS,137,0,4,1243,0,1247,G
8-NS,138,1270,0,0,0,1270,A
8-NS,139,0,5,1276,0,1281,G
8-NS,140,0,1,1277,0,1278,G
8-NS,141,2,3,1,1273,1279,C
8-NS,142,1268,0,0,0,1268,A
8-NS,143,1272,0,3,0,1275,A
8-NS,144,0,1279,0,0,1279,T
8-NS,145,1293,0,0,0,1293,A
8-NS,146,1,0,0,1313,1314,C
8-NS,147,0,1278,0,4,1282,T
8-NS,148,4,0,0,1275,1279,C
8-NS,149,0,1268,0,1,1269,T
8-NS,150,10,3,2,1255,1270,C
8-NS,151,1,8,1274,0,1283,G
8-NS,152,1,1,1339,0,1341,G
8-NS,153,0,1339,0,1,1340,T
8-NS,154,8,1,0,1336,1345,C
8-NS,155,0,1338,0,1,1339,T
8-NS,156,1353,0,0,0,1353,A
8-NS,157,0,12,1340,1,1353,G
8-NS,158,1354,0,3,0,1357,A
8-NS,159,2,0,0,1401,1403,C
8-NS,160,1380,2,1,0,1383,A
8-NS,161,0,1356,0,1,1357,T
8-NS,162,7,1,0,1350,1358,C
8-NS,163,1352,0,0,0,1352,A
8-NS,164,1351,0,1,0,1352,A
8-NS,165,1343,0,1,0,1344,A
8-NS,166,0,0,1346,0,1346,G
8-NS,167,2,1,0,1345,1348,C
8-NS,168,1328,0,0,0,1328,A
8-NS,169,1,2,1341,0,1344,G
8-NS,170,1,3,0,1345,1349,C
8-NS,171,5,0,0,1344,1349,C
8-NS,172,1357,0,3,0,1360,A
8-NS,173,0,0,0,1386,1386,C
8-NS,174,0,0,0,1391,1391,C
8-NS,175,12,0,0,1378,1390,C
8-NS,176,1396,8,2,0,1406,A
8-NS,177,0,1408,0,2,1410,T
8-NS,178,1,2,1402,0,1405,G
8-NS,179,0,1403,0,4,1407,T
8-NS,180,0,1400,0,0,1400,T
8-NS,181,1,11,1384,0,1396,G
8-NS,182,0,4,1377,0,1381,G
8-NS,183,1376,0,0,0,1376,A
8-NS,184,1378,0,0,0,1378,A
8-NS,185,1355,0,4,0,1359,A
8-NS,186,0,0,1367,0,1367,G
8-NS,187,2,2,0,1367,1371,C
8-NS,188,1372,0,0,0,1372,A
8-NS,189,1372,0,1,0,1373,A
8-NS,190,1371,0,0,0,1371,A
8-NS,191,0,1379,0,0,1379,T
8-NS,192,1,1371,0,1,1373,T
8-NS,193,0,0,1408,0,1408,G
8-NS,194,0,1404,1,3,1408,T
8-NS,195,1391,1,3,0,1395,A
8-NS,196,1,4,1390,0,1395,G
8-NS,197,1391,0,1,1,1393,A
8-NS,198,1389,0,0,0,1389,A
8-NS,199,1392,0,1,0,1393,A
8-NS,200,1377,0,2,0,1379,A
8-NS,201,0,7,1384,0,1391,G
8-NS,202,1361,0,2,0,1363,A
8-NS,203,0,1356,0,0,1356,T
8-NS,204,0,1357,0,1,1358,T
8-NS,205,6,0,0,1357,1363,C
8-NS,206,0,1362,0,1,1363,T
8-NS,207,1,9,1358,0,1368,G
8-NS,208,1371,0,1,0,1372,A
8-NS,209,1362,0,4,0,1366,A
8-NS,210,1366,0,2,0,1368,A
8-NS,211,0,3,1374,0,1377,G
8-NS,212,1372,0,1,0,1373,A
8-NS,213,1373,0,3,0,1376,A
8-NS,214,0,9,1375,0,1384,G
8-NS,215,1385,0,3,0,1388,A
8-NS,216,1392,1,0,0,1393,A
8-NS,217,1,1391,0,0,1392,T
8-NS,218,12,0,0,1394,1406,C
8-NS,219,1,1404,0,1,1406,T
8-NS,220,0,9,1405,0,1414,G
8-NS,221,1407,0,2,0,1409,A
8-NS,222,0,1410,1,0,1411,T
8-NS,223,0,4,1397,0,1401,G
8-NS,224,1387,0,0,1,1388,A
8-NS,225,0,9,1377,0,1386,G
8-NS,226,2,0,1385,0,1387,G
8-NS,227,0,1,0,1391,1392,C
8-NS,228,1395,0,1,0,1396,A
8-NS,229,0,0,0,1427,1427,C
8-NS,230,0,1426,0,0,1426,T
8-NS,231,0,1434,0,1,1435,T
8-NS,232,1440,0,0,0,1440,A
8-NS,233,1442,0,2,0,1444,A
8-NS,234,1441,0,0,0,1441,A
8-NS,235,1438,1,0,0,1439,A
8-NS,236,0,1440,1,0,1441,T
8-NS,237,3,21,1422,0,1446,G
8-NS,238,1446,0,1,0,1447,A
8-NS,239,0,0,0,1449,1449,C
8-NS,240,13,0,0,1431,1444,C
8-NS,241,1446,0,1,0,1447,A
8-NS,242,0,1439,0,1,1440,T
8-NS,243,1,2,1469,0,1472,G
8-NS,244,0,1,1488,0,1489,G
8-NS,245,0,1492,0,0,1492,T
8-NS,246,10,1,0,1535,1546,C
8-NS,247,0,1525,0,4,1529,T
8-NS,248,5,1,0,1552,1558,C
8-NS,249,1,1,0,1552,1554,C
8-NS,250,1556,0,0,0,1556,A
8-NS,251,2,0,0,1571,1573,C
8-NS,252,1544,1,1,0,1546,A
8-NS,253,3,0,0,1574,1577,C
8-NS,254,2,0,0,1565,1567,C
8-NS,255,0,1507,0,2,1509,T
8-NS,256,0,2,1522,0,1524,G
8-NS,257,0,2,0,1513,1515,C
8-NS,258,0,1500,0,1,1501,T
8-NS,259,1,1510,0,0,1511,T
8-NS,260,5,7,0,1487,1499,C
8-NS,261,2,1,1500,0,1503,G
8-NS,262,0,2,0,1500,1502,C
8-NS,263,0,8,1490,0,1498,G
8-NS,264,1564,0,0,0,1564,A
8-NS,265,0,1559,0,2,1561,T
8-NS,266,1613,0,0,1,1614,A
8-NS,267,0,0,0,1619,1619,C
8-NS,268,1617,0,0,0,1617,A
8-NS,269,0,1646,0,3,1649,T
8-NS,270,1635,0,0,1,1636,A
8-NS,271,1646,0,1,0,1647,A
8-NS,272,0,0,0,1646,1646,C
8-NS,273,0,1597,0,1,1598,T
8-NS,274,0,13,1599,0,1612,G
8-NS,275,1580,0,3,0,1583,A
8-NS,276,0,1,0,1591,1592,C
8-NS,277,1589,0,0,0,1589,A
8-NS,278,0,1562,0,1,1563,T
8-NS,279,0,16,1549,0,1565,G
8-NS,280,1564,1,0,0,1565,A
8-NS,281,1,2,0,1620,1623,C
8-NS,282,0,1604,0,0,1604,T
8-NS,283,1615,0,1,0,1616,A
8-NS,284,0,1617,0,0,1617,T
8-NS,285,0,1600,0,1,1601,T
8-NS,286,0,4,1598,0,1602,G
8-NS,287,1594,0,0,0,1594,A
8-NS,288,0,5,1596,0,1601,G
8-NS,289,0,13,1581,0,1594,G
8-NS,290,1557,0,1,0,1558,A
8-NS,291,1570,0,1,0,1571,A
8-NS,292,0,1549,0,0,1549,T
8-NS,293,0,1551,0,0,1551,T
8-NS,294,0,1,1579,0,1580,G
8-NS,295,0,1575,0,3,1578,T
8-NS,296,13,0,1,1561,1575,C
8-NS,297,1575,0,1,0,1576,A
8-NS,298,1574,1,1,0,1576,A
8-NS,299,1,5,1574,0,1580,G
8-NS,300,1575,0,0,0,1575,A
8-NS,301,1579,0,1,0,1580,A
8-NS,302,1576,1,0,0,1577,A
8-NS,303,0,0,0,1573,1573,C
8-NS,304,1,1546,0,1,1548,T
8-NS,305,0,8,1566,0,1574,G
8-NS,306,0,0,1601,0,1601,G
8-NS,307,0,1597,0,1,1598,T
8-NS,308,1,1593,0,4,1598,T
8-NS,309,18,0,0,1566,1584,C
8-NS,310,1590,0,0,0,1590,A
8-NS,311,0,1609,0,4,1613,T
8-NS,312,0,1,1631,0,1632,G
8-NS,313,0,0,0,1644,1644,C
8-NS,314,1,1627,0,0,1628,T
8-NS,315,1615,0,0,0,1615,A
8-NS,316,1632,0,1,1,1634,A
8-NS,317,0,1650,0,0,1650,T
8-NS,318,0,2,1647,0,1649,G
8-NS,319,1,0,0,1647,1648,C
8-NS,320,10,0,1,1622,1633,C
8-NS,321,11,3,0,1614,1628,C
8-NS,322,1625,0,0,1,1626,A
8-NS,323,1634,0,0,0,1634,A
8-NS,324,1,0,1638,0,1639,G
8-NS,325,0,2,0,1637,1639,C
8-NS,326,1625,1,1,1,1628,A
8-NS,327,1,6,1633,0,1640,G
8-NS,328,1631,0,1,0,1632,A
8-NS,329,1627,0,2,2,1631,A
8-NS,330,1626,0,2,0,1628,A
8-NS,331,2,1,1657,0,1660,G
8-NS,332,0,1642,0,0,1642,T
8-NS,333,1,7,1635,0,1643,G
8-NS,334,0,6,1634,0,1640,G
8-NS,335,1635,0,2,1,1638,A
8-NS,336,1628,0,2,0,1630,A
8-NS,337,0,5,1623,0,1628,G
8-NS,338,0,7,1636,0,1643,G
8-NS,339,1636,0,4,0,1640,A
8-NS,340,2,0,0,1633,1635,C
8-NS,341,7,0,0,1614,1621,C
8-NS,342,0,1618,0,0,1618,T
8-NS,343,9,1,0,1642,1652,C
8-NS,344,0,1641,0,2,1643,T
8-NS,345,0,1649,0,0,1649,T
8-NS,346,0,1647,0,0,1647,T
8-NS,347,1,2,1657,0,1660,G
8-NS,348,0,0,0,1669,1669,C
8-NS,349,1660,0,1,0,1661,A
8-NS,350,0,1660,0,4,1664,T
8-NS,351,3,4,0,1657,1664,C
8-NS,352,1665,0,0,0,1665,A
8-NS,353,0,6,1724,0,1730,G
8-NS,354,1717,1,0,4,1722,A
8-NS,355,1735,1,1,0,1737,A
8-NS,356,0,1734,0,0,1734,T
8-NS,357,2,11,1708,1,1722,G
8-NS,358,14,20,1702,0,1736,G
8-NS,359,1727,1,0,0,1728,A
8-NS,360,2,1,0,1729,1732,C
8-NS,361,13,1,0,1682,1696,C
8-NS,362,1660,1,1,0,1662,A
8-NS,363,1,7,1667,0,1675,G
8-NS,364,1,1,1664,0,1666,G
8-NS,365,3,0,0,1672,1675,C
8-NS,366,1669,0,0,0,1669,A
8-NS,367,1685,0,0,0,1685,A
8-NS,368,0,1686,0,0,1686,T
8-NS,369,8,1,1,1672,1682,C
8-NS,370,1685,1,1,0,1687,A
8-NS,371,0,1682,0,1,1683,T
8-NS,372,1,5,1656,0,1662,G
8-NS,373,1,10,1657,0,1668,G
8-NS,374,1650,0,4,0,1654,A
8-NS,375,1,6,1672,1,1680,G
8-NS,376,1645,1,1,0,1647,A
8-NS,377,1651,0,0,0,1651,A
8-NS,378,1647,0,1,0,1648,A
8-NS,379,1647,1,1,0,1649,A
8-NS,380,1658,0,2,0,1660,A
8-NS,381,2,2,0,1664,1668,C
8-NS,382,1655,0,1,0,1656,A
8-NS,383,1,1656,1,0,1658,T
8-NS,384,4,0,0,1641,1645,C
8-NS,385,1643,0,1,0,1644,A
8-NS,386,0,1651,0,0,1651,T
8-NS,387,1,2,1649,0,1652,G
8-NS,388,0,1650,0,2,1652,T
8-NS,389,0,1636,0,0,1636,T
8-NS,390,0,8,1626,1,1635,G
8-NS,391,1631,0,1,1,1633,A
8-NS,392,1645,0,0,0,1645,A
8-NS,393,1641,0,3,0,1644,A
8-NS,394,1,1,1647,0,1649,G
8-NS,395,3,2,0,1624,1629,C
8-NS,396,1,16,1610,0,1627,G
8-NS,397,1628,0,0,0,1628,A
8-NS,398,1631,1,0,0,1632,A
8-NS,399,1,1628,1,1,1631,T
8-NS,400,0,1618,0,13,1631,T
8-NS,401,1,1634,0,1,1636,T
8-NS,402,6,0,0,1629,1635,C
8-NS,403,1597,0,1,0,1598,A
8-NS,404,3,0,1600,0,1603,G
8-NS,405,0,1607,0,2,1609,T
8-NS,406,0,1,1610,0,1611,G
8-NS,407,0,1598,0,1,1599,T
8-NS,408,1,9,1600,0,1610,G
8-NS,409,1624,2,0,0,1626,A
8-NS,410,1,1620,0,1,1622,T
8-NS,411,0,1622,0,0,1622,T
8-NS,412,0,1616,0,0,1616,T
8-NS,413,0,1617,0,0,1617,T
8-NS,414,1,1612,0,1,1614,T
8-NS,415,1,17,1579,0,1597,G
8-NS,416,1603,0,2,0,1605,A
8-NS,417,0,2,0,1599,1601,C
8-NS,418,8,2,0,1579,1589,C
8-NS,419,0,14,1580,1,1595,G
8-NS,420,1652,0,0,0,1652,A
8-NS,421,2,3,0,1689,1694,C
8-NS,422,0,1687,0,1,1688,T
8-NS,423,1695,2,4,0,1701,A
8-NS,424,2,4,1696,0,1702,G
8-NS,425,1698,1,4,0,1703,A
8-NS,426,0,15,1704,1,1720,G
8-NS,427,1716,1,2,0,1719,A
8-NS,428,1,1,0,1772,1774,C
8-NS,429,13,0,1,1697,1711,C
8-NS,430,1661,0,1,1,1663,A
8-NS,431,1,1739,0,0,1740,T
8-NS,432,1725,0,1,0,1726,A
8-NS,433,0,1,1859,1,1861,G
8-NS,434,0,1847,0,0,1847,T
8-NS,435,1832,0,0,0,1832,A
8-NS,436,0,1823,0,3,1826,T
8-NS,437,0,1770,0,0,1770,T
8-NS,438,1833,0,0,0,1833,A
8-NS,439,1,0,0,1833,1834,C
8-NS,440,0,1758,0,0,1758,T
8-NS,441,1752,0,1,0,1753,A
8-NS,442,1586,0,6,0,1592,A
8-NS,443,0,4,1601,0,1605,G
8-NS,444,0,12,1595,0,1607,G
8-NS,445,0,3,1607,0,1610,G
8-NS,446,0,0,0,1590,1590,C
8-NS,447,1,1556,0,2,1559,T
8-NS,448,1,1553,0,5,1559,T
8-NS,449,1,1572,0,0,1573,T
8-NS,450,9,0,0,1573,1582,C
8-NS,451,1597,1,1,0,1599,A
8-NS,452,2,1,0,1597,1600,C
8-NS,453,5,2,0,1579,1586,C
8-NS,454,3,4,1577,0,1584,G
8-NS,455,1580,0,0,0,1580,A
8-NS,456,1579,4,0,0,1583,A
8-NS,457,0,2,1586,0,1588,G
8-NS,458,1564,0,4,0,1568,A
8-NS,459,0,6,1564,0,1570,G
8-NS,460,0,5,1538,0,1543,G
8-NS,461,1,11,1544,0,1556,G
8-NS,462,1557,0,0,0,1557,A
8-NS,463,4,0,1555,0,1559,G
8-NS,464,1,0,0,1556,1557,C
8-NS,465,1556,1,0,0,1557,A
8-NS,466,1558,1,1,0,1560,A
8-NS,467,0,1563,0,0,1563,T
8-NS,468,0,1552,0,1,1553,T
8-NS,469,0,0,1552,0,1552,G
8-NS,470,1,1534,0,0,1535,T
8-NS,471,0,1535,0,1,1536,T
8-NS,472,1,9,1531,0,1541,G
8-NS,473,0,1,1535,0,1536,G
8-NS,474,0,1,0,1539,1540,C
8-NS,475,1,1,1532,0,1534,G
8-NS,476,1533,0,1,0,1534,A
8-NS,477,1541,0,0,0,1541,A
8-NS,478,1548,0,0,0,1548,A
8-NS,479,0,1559,0,1,1560,T
8-NS,480,12,0,0,1549,1561,C
8-NS,481,1,1548,0,4,1553,T
8-NS,482,9,0,1,1544,1554,C
8-NS,483,1561,0,2,0,1563,A
8-NS,484,1,0,2,1568,1571,C
8-NS,485,5,0,0,1563,1568,C
8-NS,486,1552,0,1,0,1553,A
8-NS,487,0,1545,0,0,1545,T
8-NS,488,0,1530,0,0,1530,T
8-NS,489,1,0,1529,0,1530,G
8-NS,490,0,1,0,1521,1522,C
8-NS,491,4,0,1,1522,1527,C
8-NS,492,0,1530,0,2,1532,T
8-NS,493,0,1520,0,2,1522,T
8-NS,494,4,1,0,1526,1531,C
8-NS,495,0,1530,0,1,1531,T
8-NS,496,0,1529,0,0,1529,T
8-NS,497,0,1547,0,2,1549,T
8-NS,498,1,1539,0,2,1542,T
8-NS,499,4,1,0,1535,1540,C
8-NS,500,7,0,0,1526,1533,C
8-NS,501,1541,0,2,0,1543,A
8-NS,502,1,5,1558,0,1564,G
8-NS,503,0,7,1549,0,1556,G
8-NS,504,1583,1,2,0,1586,A
8-NS,505,0,2,0,1587,1589,C
8-NS,506,1615,0,2,0,1617,A
8-NS,507,0,1620,0,0,1620,T
8-NS,508,1619,0,1,0,1620,A
8-NS,509,3,0,0,1750,1753,C
8-NS,510,1,1733,0,2,1736,T
8-NS,511,1729,0,1,0,1730,A
8-NS,512,0,1729,0,3,1732,T
8-NS,513,1,1684,0,0,1685,T
8-NS,514,1,6,1678,0,1685,G
8-NS,515,1630,0,0,0,1630,A
8-NS,516,0,8,1627,0,1635,G
8-NS,517,1,6,1621,1,1629,G
8-NS,518,1495,0,0,0,1495,A
8-NS,519,0,1497,0,0,1497,T
8-NS,520,0,1,1494,0,1495,G
8-NS,521,0,1492,0,3,1495,T
8-NS,522,17,0,0,1482,1499,C
8-NS,523,1500,0,2,0,1502,A
8-NS,524,1502,0,0,0,1502,A
8-NS,525,1494,0,1,0,1495,A
8-NS,526,1494,0,0,0,1494,A
8-NS,527,1493,2,0,0,1495,A
8-NS,528,0,1487,0,0,1487,T
8-NS,529,0,1,1486,0,1487,G
8-NS,530,2,2,0,1495,1499,C
8-NS,531,1497,0,0,0,1497,A
8-NS,532,1509,0,0,0,1509,A
8-NS,533,1,1512,0,0,1513,T
8-NS,534,0,1508,0,0,1508,T
8-NS,535,0,9,1500,0,1509,G
8-NS,536,0,10,1491,0,1501,G
8-NS,537,3,6,1493,0,1502,G
8-NS,538,0,1,1523,0,1524,G
8-NS,539,2,1492,0,0,1494,T
8-NS,540,5,0,0,1505,1510,C
8-NS,541,8,0,0,1497,1505,C
8-NS,542,0,1497,0,5,1502,T
8-NS,543,5,0,1,1508,1514,C
8-NS,544,1499,4,2,0,1505,A
8-NS,545,1,1513,0,3,1517,T
8-NS,546,3,4,1,1512,1520,C
8-NS,547,4,4,1500,0,1508,G
8-NS,548,0,5,1499,0,1504,G
8-NS,549,1490,0,0,0,1490,A
8-NS,550,1,5,1483,0,1489,G
8-NS,551,0,14,1487,0,1501,G
8-NS,552,1476,0,2,0,1478,A
8-NS,553,1,0,0,1496,1497,C
8-NS,554,0,1492,0,4,1496,T
8-NS,555,0,1489,0,4,1493,T
8-NS,556,0,15,1485,0,1500,G
8-NS,557,1499,0,1,0,1500,A
8-NS,558,1502,0,0,0,1502,A
8-NS,559,0,1498,0,0,1498,T
8-NS,560,0,3,1472,0,1475,G
8-NS,561,0,4,1489,0,1493,G
8-NS,562,1472,0,0,0,1472,A
8-NS,563,1477,0,1,0,1478,A
8-NS,564,1,1526,0,0,1527,T
8-NS,565,1,8,1530,0,1539,G
8-NS,566,1539,0,4,0,1543,A
8-NS,567,0,1540,0,0,1540,T
8-NS,568,1528,0,5,0,1533,A
8-NS,569,1548,0,1,0,1549,A
8-NS,570,1,0,0,1535,1536,C
8-NS,571,1506,1,0,0,1507,A
8-NS,572,1,1,0,1518,1520,C
8-NS,573,1398,0,0,0,1398,A
8-NS,574,2,1,1423,0,1426,G
8-NS,575,0,1414,0,1,1415,T
8-NS,576,0,1412,0,3,1415,T
8-NS,577,14,0,0,1396,1410,C
8-NS,578,0,6,1398,0,1404,G
8-NS,579,1404,0,1,0,1405,A
8-NS,580,1,0,1403,0,1404,G
8-NS,581,0,1381,0,1,1382,T
8-NS,582,7,0,0,1389,1396,C
8-NS,583,0,1351,0,2,1353,T
8-NS,584,6,0,0,1363,1369,C
8-NS,585,0,1371,0,1,1372,T
8-NS,586,1372,0,1,0,1373,A
8-NS,587,1372,0,0,0,1372,A
8-NS,588,1369,1,0,0,1370,A
8-NS,589,1378,1,0,0,1379,A
8-NS,590,1382,0,1,0,1383,A
8-NS,591,0,1368,0,0,1368,T
8-NS,592,9,0,0,1371,1380,C
8-NS,593,1,1362,0,0,1363,T
8-NS,594,1374,0,1,0,1375,A
8-NS,595,1,1,0,1373,1375,C
8-NS,596,1370,0,0,0,1370,A
8-NS,597,0,3,1371,0,1374,G
8-NS,598,1343,0,0,0,1343,A
8-NS,599,1,9,1333,0,1343,G
8-NS,600,1346,0,0,0,1346,A
8-NS,601,1,1323,0,2,1326,T
8-NS,602,0,1328,0,0,1328,T
8-NS,603,11,1,0,1317,1329,C
8-NS,604,0,0,1334,0,1334,G
8-NS,605,0,0,0,1333,1333,C
8-NS,606,0,1328,1,1,1330,T
8-NS,607,0,1330,0,1,1331,T
8-NS,608,0,4,1309,0,1313,G
8-NS,609,0,6,1314,0,1320,G
8-NS,610,1319,0,2,0,1321,A
8-NS,611,0,6,1318,0,1324,G
8-NS,612,1314,0,0,0,1314,A
8-NS,613,1310,0,0,0,1310,A
8-NS,614,0,0,1334,0,1334,G
8-NS,615,3,2,0,1328,1333,C
8-NS,616,1324,2,0,0,1326,A
8-NS,617,0,0,1338,0,1338,G
8-NS,618,1,1326,0,0,1327,T
8-NS,619,1342,0,0,0,1342,A
8-NS,620,1344,0,1,0,1345,A
8-NS,621,0,1345,0,0,1345,T
8-NS,622,0,8,1347,0,1355,G
8-NS,623,1304,0,1,0,1305,A
8-NS,624,0,7,1323,0,1330,G
8-NS,625,1317,0,0,0,1317,A
8-NS,626,1294,0,1,0,1295,A
8-NS,627,0,1295,0,0,1295,T
8-NS,628,1,6,1263,0,1270,G
8-NS,629,1,6,1265,0,1272,G
8-NS,630,0,5,1265,0,1270,G
8-NS,631,0,3,1262,0,1265,G
8-NS,632,0,4,1258,0,1262,G
8-NS,633,1228,0,1,0,1229,A
8-NS,634,0,0,0,1246,1246,C
8-NS,635,7,0,0,1239,1246,C
8-NS,636,1,1215,0,4,1220,T
8-NS,637,6,1,0,1235,1242,C
8-NS,638,5,0,0,1226,1231,C
8-NS,639,1231,1,0,0,1232,A
8-NS,640,0,1175,0,4,1179,T
8-NS,641,0,1185,0,2,1187,T
8-NS,642,0,1191,0,0,1191,T
8-NS,643,1198,0,1,0,1199,A
8-NS,644,0,0,0,1213,1213,C
8-NS,645,0,1193,0,2,1195,T
8-NS,646,13,3,0,1171,1187,C
8-NS,647,6,1,0,1162,1169,C
8-NS,648,1167,0,0,0,1167,A
8-NS,649,1171,0,0,0,1171,A
8-NS,650,1169,0,0,0,1169,A
8-NS,651,1171,0,1,0,1172,A
8-NS,652,0,2,0,1169,1171,C
8-NS,653,1145,0,1,0,1146,A
8-NS,654,0,3,1146,0,1149,G
8-NS,655,1146,0,0,0,1146,A
8-NS,656,1145,0,0,0,1145,A
8-NS,657,1144,0,0,0,1144,A
8-NS,658,2,2,0,1144,1148,C
8-NS,659,0,5,1144,0,1149,G
8-NS,660,0,2,1151,0,1153,G
8-NS,661,0,4,1149,0,1153,G
8-NS,662,1150,0,1,0,1151,A
8-NS,663,1148,0,1,0,1149,A
8-NS,664,1152,0,0,0,1152,A
8-NS,665,0,1147,0,2,1149,T
8-NS,666,1,8,1150,0,1159,G
8-NS,667,0,1,1156,0,1157,G
8-NS,668,2,5,0,1133,1140,C
8-NS,669,2,5,1136,0,1143,G
8-NS,670,1135,0,2,0,1137,A
8-NS,671,0,7,1134,0,1141,G
8-NS,672,1142,0,0,0,1142,A
8-NS,673,1141,0,0,0,1141,A
8-NS,674,0,1,0,1139,1140,C
8-NS,675,1110,0,1,0,1111,A
8-NS,676,0,0,1109,0,1109,G
8-NS,677,0,0,0,1109,1109,C
8-NS,678,0,1107,0,0,1107,T
8-NS,679,1103,0,0,0,1103,A
8-NS,680,1,4,1081,0,1086,G
8-NS,681,0,0,1086,0,1086,G
8-NS,682,0,1087,0,1,1088,T
8-NS,683,11,0,1,1056,1068,C
8-NS,684,1063,1,1,0,1065,A
8-NS,685,1062,0,1,0,1063,A
8-NS,686,1062,0,0,0,1062,A
8-NS,687,1071,0,0,0,1071,A
8-NS,688,0,0,1075,0,1075,G
8-NS,689,0,1040,0,0,1040,T
8-NS,690,0,1038,0,0,1038,T
8-NS,691,1,1033,0,2,1036,T
8-NS,692,0,4,1034,0,1038,G
8-NS,693,1036,0,0,0,1036,A
8-NS,694,1036,0,3,0,1039,A
8-NS,695,0,6,1050,0,1056,G
8-NS,696,1025,0,0,0,1025,A
8-NS,697,0,2,1025,0,1027,G
8-NS,698,1024,0,0,0,1024,A
8-NS,699,1,1024,0,1,1026,T
8-NS,700,1027,0,1,0,1028,A
8-NS,701,1023,0,0,0,1023,A
8-NS,702,0,2,1021,0,1023,G
8-NS,703,953,0,1,0,954,A
8-NS,704,0,957,0,0,957,T
8-NS,705,0,3,959,0,962,G
8-NS,706,0,0,965,0,965,G
8-NS,707,0,0,0,963,963,C
8-NS,708,0,959,0,0,959,T
8-NS,709,958,0,0,0,958,A
8-NS,710,957,0,0,0,957,A
8-NS,711,0,964,0,0,964,T
8-NS,712,1,960,0,0,961,T
8-NS,713,2,4,957,0,963,G
8-NS,714,953,0,1,0,954,A
8-NS,715,952,0,0,1,953,A
8-NS,716,0,0,952,0,952,G
8-NS,717,947,0,0,0,947,A
8-NS,718,940,0,2,0,942,A
8-NS,719,1,0,949,0,950,G
8-NS,720,0,929,0,0,929,T
8-NS,721,0,2,929,0,931,G
8-NS,722,920,0,3,0,923,A
8-NS,723,0,6,919,0,925,G
8-NS,724,920,1,3,1,925,A
8-NS,725,1,0,0,916,917,C
8-NS,726,916,0,0,0,916,A
8-NS,727,0,0,0,918,918,C
8-NS,728,856,0,2,0,858,A
8-NS,729,3,3,875,0,881,G
8-NS,730,871,0,2,0,873,A
8-NS,731,1,864,1,2,868,T
8-NS,732,0,865,0,1,866,T
8-NS,733,859,0,0,0,859,A
8-NS,734,860,0,0,0,860,A
8-NS,735,859,0,0,0,859,A
8-NS,736,856,0,0,0,856,A
8-NS,737,855,0,0,0,855,A
8-NS,738,1,1,0,829,831,C
8-NS,739,794,0,0,0,794,A
8-NS,740,803,0,0,0,803,A
8-NS,741,0,0,0,805,805,C
8-NS,742,0,793,0,1,794,T
8-NS,743,0,3,798,0,801,G
8-NS,744,795,0,2,0,797,A
8-NS,745,798,0,0,0,798,A
8-NS,746,798,0,0,0,798,A
8-NS,747,789,0,0,0,789,A
8-NS,748,0,790,0,1,791,T
8-NS,749,766,0,1,0,767,A
8-NS,750,1,0,771,1,773,G
8-NS,751,1,0,0,772,773,C
8-NS,752,0,757,0,0,757,T
8-NS,753,0,756,0,0,756,T
8-NS,754,0,744,0,0,744,T
8-NS,755,1,8,740,0,749,G
8-NS,756,748,0,0,0,748,A
8-NS,757,748,0,0,0,748,A
8-NS,758,1,0,0,744,745,C
8-NS,759,738,0,0,0,738,A
8-NS,760,738,0,0,0,738,A
8-NS,761,738,1,0,0,739,A
8-NS,762,0,741,0,0,741,T
8-NS,763,742,0,0,0,742,A
8-NS,764,728,0,2,0,730,A
8-NS,765,0,0,0,729,729,C
8-NS,766,724,0,0,0,724,A
8-NS,767,0,711,0,0,711,T
8-NS,768,0,694,0,1,695,T
8-NS,769,4,0,0,677,681,C
8-NS,770,677,0,0,0,677,A
8-NS,771,0,678,0,0,678,T
8-NS,772,2,1,675,0,678,G
8-NS,773,1,0,0,667,668,C
8-NS,774,659,0,0,0,659,A
8-NS,775,656,0,2,0,658,A
8-NS,776,0,0,652,0,652,G
8-NS,777,0,0,0,653,653,C
8-NS,778,645,0,0,0,645,A
8-NS,779,0,642,0,2,644,T
8-NS,780,0,643,0,0,643,T
8-NS,781,642,0,1,0,643,A
8-NS,782,0,0,0,641,641,C
8-NS,783,626,0,0,0,626,A
8-NS,784,1,0,546,0,547,G
8-NS,785,1,0,0,548,549,C
8-NS,786,0,549,0,0,549,T
8-NS,787,1,0,553,0,554,G
8-NS,788,0,0,0,545,545,C
8-NS,789,0,535,0,0,535,T
8-NS,790,0,0,538,0,538,G
8-NS,791,0,519,0,10,529,T
8-NS,792,0,528,0,1,529,T
8-NS,793,0,528,0,0,528,T
8-NS,794,0,3,519,0,522,G
8-NS,795,522,0,2,0,524,A
8-NS,796,508,0,1,0,509,A
8-NS,797,0,0,506,0,506,G
8-NS,798,0,499,0,1,500,T
8-NS,799,0,1,471,0,472,G
8-NS,800,0,2,472,0,474,G
8-NS,801,471,0,0,0,471,A
8-NS,802,474,0,0,0,474,A
8-NS,803,1,0,0,473,474,C
8-NS,804,452,0,0,0,452,A
8-NS,805,0,0,451,0,451,G
8-NS,806,0,1,441,0,442,G
8-NS,807,431,0,1,0,432,A
8-NS,808,0,1,434,0,435,G
8-NS,809,368,0,1,0,369,A
8-NS,810,0,364,0,0,364,T
8-NS,811,361,0,0,0,361,A
8-NS,812,356,1,0,0,357,A
8-NS,813,0,0,358,0,358,G
8-NS,814,319,0,0,0,319,A
8-NS,815,314,0,1,0,315,A
8-NS,816,3,0,0,311,314,C
8-NS,817,0,264,0,0,264,T
8-NS,818,0,256,0,0,256,T
8-NS,819,0,255,0,0,255,T
8-NS,820,2,1,0,252,255,C
8-NS,821,0,247,0,0,247,T
8-NS,822,2,0,0,245,247,C
8-NS,823,233,0,0,0,233,A
8-NS,824,0,233,0,0,233,T
8-NS,825,0,228,0,0,228,T
8-NS,826,1,224,0,1,226,T
8-NS,827,1,0,0,223,224,C
8-NS,828,221,1,0,0,222,A
8-NS,829,0,0,221,0,221,G
8-NS,830,0,0,0,221,221,C
8-NS,831,0,203,0,1,204,T
8-NS,832,0,202,0,1,203,T
8-NS,833,193,0,0,0,193,A
8-NS,834,0,192,0,0,192,T
8-NS,835,0,192,0,0,192,T
8-NS,836,0,190,0,0,190,T
8-NS,837,185,0,1,0,186,A
8-NS,838,180,0,0,0,180,A
8-NS,839,0,172,0,0,172,T
8-NS,840,0,1,169,0,170,G
8-NS,841,167,0,0,0,167,A
8-NS,842,0,157,0,0,157,T
8-NS,843,151,0,0,0,151,A
8-NS,844,151,0,0,0,151,A
8-NS,845,151,0,0,0,151,A
8-NS,846,151,0,0,0,151,A
8-NS,847,150,0,0,0,150,A
8-NS,848,149,0,0,1,150,A
8-NS,849,0,0,0,148,148,C
8-NS,850,121,0,0,0,121,A
8-NS,851,0,0,0,121,121,C
8-NS,852,1,0,1,112,114,C
8-NS,853,0,0,0,106,106,C
8-NS,854,0,102,0,0,102,T
8-NS,855,0,98,0,0,98,T
8-NS,856,1,0,97,0,98,G
8-NS,857,0,97,0,0,97,T
8-NS,858,0,96,0,0,96,T
8-NS,859,0,93,0,0,93,T
8-NS,860,0,0,0,39,39,C
8-NS,861,0,28,0,0,28,T
8-NS,862,24,0,0,0,24,A
8-NS,863,0,0,0,24,24,C
