Gene,Position,A,T,G,C,Coverage,Consensus
1-PB2,1,307,0,0,0,307,A
1-PB2,2,0,307,0,0,307,T
1-PB2,3,0,0,311,0,311,G
1-PB2,4,0,0,312,0,312,G
1-PB2,5,311,0,0,0,311,A
1-PB2,6,312,0,0,0,312,A
1-PB2,7,312,0,0,0,312,A
1-PB2,8,0,0,342,0,342,G
1-PB2,9,343,0,1,0,344,A
1-PB2,10,342,1,2,0,345,A
1-PB2,11,0,354,0,0,354,T
1-PB2,12,355,0,0,0,355,A
1-PB2,13,355,0,0,0,355,A
1-PB2,14,356,0,1,0,357,A
1-PB2,15,357,0,0,0,357,A
1-PB2,16,0,1,369,0,370,G
1-PB2,17,371,0,0,0,371,A
1-PB2,18,371,0,0,0,371,A
1-PB2,19,0,0,0,380,380,C
1-PB2,20,0,380,0,0,380,T
1-PB2,21,396,0,0,0,396,A
1-PB2,22,0,0,0,397,397,C
1-PB2,23,0,0,398,0,398,G
1-PB2,24,0,1,406,0,407,G
1-PB2,25,408,0,0,0,408,A
1-PB2,26,427,0,0,0,427,A
1-PB2,27,0,428,0,1,429,T
1-PB2,28,0,0,0,428,428,C
1-PB2,29,0,428,0,1,429,T
1-PB2,30,1,2,428,0,431,G
1-PB2,31,434,0,0,0,434,A
1-PB2,32,0,435,0,0,435,T
1-PB2,33,0,0,435,0,435,G
1-PB2,34,0,441,1,0,442,T
1-PB2,35,1,1,0,440,442,C
1-PB2,36,0,0,442,0,442,G
1-PB2,37,0,0,0,443,443,C
1-PB2,38,442,0,0,0,442,A
1-PB2,39,0,0,470,0,470,G
1-PB2,40,0,471,0,0,471,T
1-PB2,41,0,1,0,473,474,C
1-PB2,42,0,473,0,0,473,T
1-PB2,43,1,1,0,469,471,C
1-PB2,44,0,0,471,0,471,G
1-PB2,45,0,0,0,474,474,C
1-PB2,46,472,1,1,0,474,A
1-PB2,47,1,0,0,481,482,C
1-PB2,48,0,480,0,0,480,T
1-PB2,49,2,0,0,495,497,C
1-PB2,50,0,0,501,0,501,G
1-PB2,51,0,0,0,502,502,C
1-PB2,52,0,1,501,0,502,G
1-PB2,53,502,0,0,0,502,A
1-PB2,54,0,0,505,0,505,G
1-PB2,55,516,0,0,0,516,A
1-PB2,56,0,515,0,0,515,T
1-PB2,57,517,0,1,0,518,A
1-PB2,58,0,0,0,516,516,C
1-PB2,59,0,511,0,0,511,T
1-PB2,60,0,1,522,0,523,G
1-PB2,61,525,0,1,0,526,A
1-PB2,62,1,0,0,528,529,C
1-PB2,63,531,0,0,0,531,A
1-PB2,64,527,0,0,0,527,A
1-PB2,65,536,0,0,0,536,A
1-PB2,66,543,0,0,0,543,A
1-PB2,67,541,0,0,0,541,A
1-PB2,68,0,0,0,547,547,C
1-PB2,69,0,0,0,545,545,C
1-PB2,70,551,0,0,0,551,A
1-PB2,71,0,0,0,558,558,C
1-PB2,72,556,0,1,0,557,A
1-PB2,73,0,0,574,0,574,G
1-PB2,74,0,572,0,0,572,T
1-PB2,75,0,2,590,0,592,G
1-PB2,76,0,0,597,0,597,G
1-PB2,77,596,0,0,0,596,A
1-PB2,78,0,0,0,632,632,C
1-PB2,79,3,0,0,625,628,C
1-PB2,80,636,0,0,2,638,A
1-PB2,81,0,639,0,1,640,T
1-PB2,82,634,0,1,0,635,A
1-PB2,83,0,634,0,1,635,T
1-PB2,84,0,1,628,0,629,G
1-PB2,85,0,0,633,0,633,G
1-PB2,86,0,0,0,633,633,C
1-PB2,87,1,0,0,624,625,C
1-PB2,88,624,0,1,0,625,A
1-PB2,89,0,660,0,1,661,T
1-PB2,90,661,0,0,0,661,A
1-PB2,91,685,0,1,0,686,A
1-PB2,92,0,687,0,0,687,T
1-PB2,93,0,682,0,0,682,T
1-PB2,94,691,0,0,0,691,A
1-PB2,95,690,0,0,0,690,A
1-PB2,96,0,0,712,0,712,G
1-PB2,97,712,0,0,0,712,A
1-PB2,98,699,0,0,0,699,A
1-PB2,99,0,1,733,0,734,G
1-PB2,100,0,729,0,0,729,T
1-PB2,101,732,0,0,0,732,A
1-PB2,102,0,1,0,731,732,C
1-PB2,103,732,0,0,0,732,A
1-PB2,104,0,0,0,745,745,C
1-PB2,105,744,0,0,0,744,A
1-PB2,106,0,745,0,0,745,T
1-PB2,107,1,0,0,746,747,C
1-PB2,108,0,1,745,0,746,G
1-PB2,109,0,1,746,0,747,G
1-PB2,110,0,0,742,0,742,G
1-PB2,111,1,1,744,0,746,G
1-PB2,112,745,0,1,0,746,A
1-PB2,113,0,1,749,0,750,G
1-PB2,114,742,0,2,0,744,A
1-PB2,115,0,0,0,755,755,C
1-PB2,116,751,0,1,1,753,A
1-PB2,117,0,1,757,0,758,G
1-PB2,118,0,2,767,0,769,G
1-PB2,119,768,0,4,0,772,A
1-PB2,120,773,0,1,0,774,A
1-PB2,121,773,0,0,0,773,A
1-PB2,122,769,1,2,0,772,A
1-PB2,123,0,1,774,0,775,G
1-PB2,124,770,0,1,0,771,A
1-PB2,125,775,0,0,0,775,A
1-PB2,126,0,0,0,775,775,C
1-PB2,127,0,0,2,773,775,C
1-PB2,128,0,0,0,775,775,C
1-PB2,129,0,0,780,0,780,G
1-PB2,130,0,779,0,1,780,T
1-PB2,131,1,0,0,784,785,C
1-PB2,132,785,0,0,0,785,A
1-PB2,133,0,0,0,791,791,C
1-PB2,134,2,784,0,0,786,T
1-PB2,135,0,780,0,0,780,T
1-PB2,136,784,0,1,0,785,A
1-PB2,137,0,0,800,0,800,G
1-PB2,138,1,0,802,0,803,G
1-PB2,139,800,0,1,0,801,A
1-PB2,140,0,796,0,0,796,T
1-PB2,141,0,1,801,0,802,G
1-PB2,142,814,0,0,0,814,A
1-PB2,143,816,0,0,0,816,A
1-PB2,144,816,0,2,0,818,A
1-PB2,145,0,821,0,0,821,T
1-PB2,146,1,0,818,0,819,G
1-PB2,147,0,1,825,0,826,G
1-PB2,148,821,0,3,0,824,A
1-PB2,149,0,824,0,1,825,T
1-PB2,150,0,1,821,0,822,G
1-PB2,151,807,0,1,0,808,A
1-PB2,152,0,812,0,0,812,T
1-PB2,153,1,1,811,0,813,G
1-PB2,154,0,1,811,0,812,G
1-PB2,155,2,0,0,807,809,C
1-PB2,156,803,0,0,0,803,A
1-PB2,157,809,0,0,0,809,A
1-PB2,158,0,815,0,0,815,T
1-PB2,159,0,3,849,0,852,G
1-PB2,160,850,1,1,0,852,A
1-PB2,161,844,0,2,0,846,A
1-PB2,162,848,0,4,1,853,A
1-PB2,163,0,857,0,1,858,T
1-PB2,164,860,0,1,0,861,A
1-PB2,165,1,2,0,874,877,C
1-PB2,166,1,0,0,868,869,C
1-PB2,167,0,0,0,865,865,C
1-PB2,168,867,0,0,0,867,A
1-PB2,169,869,0,1,0,870,A
1-PB2,170,0,867,0,0,867,T
1-PB2,171,1,0,0,869,870,C
1-PB2,172,870,0,1,0,871,A
1-PB2,173,0,0,0,873,873,C
1-PB2,174,0,861,0,0,861,T
1-PB2,175,0,0,862,0,862,G
1-PB2,176,0,0,0,858,858,C
1-PB2,177,1,855,0,2,858,T
1-PB2,178,0,0,871,0,871,G
1-PB2,179,870,0,1,0,871,A
1-PB2,180,0,0,0,873,873,C
1-PB2,181,871,0,0,0,871,A
1-PB2,182,862,0,3,0,865,A
1-PB2,183,864,0,1,0,865,A
1-PB2,184,857,0,2,0,859,A
1-PB2,185,0,3,874,0,877,G
1-PB2,186,0,0,877,0,877,G
1-PB2,187,867,0,2,0,869,A
1-PB2,188,0,871,0,0,871,T
1-PB2,189,870,0,0,0,870,A
1-PB2,190,894,0,0,0,894,A
1-PB2,191,2,1,0,913,916,C
1-PB2,192,916,0,0,0,916,A
1-PB2,193,0,0,919,0,919,G
1-PB2,194,822,0,87,0,909,A
1-PB2,195,908,0,0,0,908,A
1-PB2,196,909,0,0,0,909,A
1-PB2,197,0,904,0,2,906,T
1-PB2,198,0,3,903,0,906,G
1-PB2,199,0,0,901,0,901,G
1-PB2,200,0,874,0,0,874,T
1-PB2,201,0,871,0,2,873,T
1-PB2,202,6,0,0,865,871,C
1-PB2,203,2,1,0,865,868,C
1-PB2,204,0,0,872,0,872,G
1-PB2,205,0,0,877,0,877,G
1-PB2,206,857,0,18,0,875,A
1-PB2,207,1,1,873,0,875,G
1-PB2,208,863,0,1,0,864,A
1-PB2,209,0,1,876,0,877,G
1-PB2,210,873,1,1,0,875,A
1-PB2,211,877,0,1,0,878,A
1-PB2,212,877,0,2,0,879,A
1-PB2,213,0,873,1,0,874,T
1-PB2,214,0,2,886,0,888,G
1-PB2,215,891,0,0,0,891,A
1-PB2,216,889,2,2,0,893,A
1-PB2,217,0,1,0,890,891,C
1-PB2,218,883,0,0,0,883,A
1-PB2,219,883,0,3,0,886,A
1-PB2,220,1,1,912,0,914,G
1-PB2,221,0,2,935,0,937,G
1-PB2,222,933,0,1,1,935,A
1-PB2,223,0,1,0,935,936,C
1-PB2,224,931,0,0,1,932,A
1-PB2,225,936,0,0,0,936,A
1-PB2,226,935,1,0,0,936,A
1-PB2,227,0,0,0,934,934,C
1-PB2,228,2,1,0,890,893,C
1-PB2,229,2,0,0,960,962,C
1-PB2,230,0,961,0,0,961,T
1-PB2,231,968,0,0,0,968,A
1-PB2,232,0,966,0,1,967,T
1-PB2,233,0,0,967,0,967,G
1-PB2,234,0,3,990,0,993,G
1-PB2,235,940,0,1,0,941,A
1-PB2,236,0,1,941,0,942,G
1-PB2,237,0,941,0,1,942,T
1-PB2,238,942,0,0,0,942,A
1-PB2,239,944,0,1,0,945,A
1-PB2,240,943,0,0,0,943,A
1-PB2,241,942,0,1,0,943,A
1-PB2,242,0,937,0,0,937,T
1-PB2,243,0,1,929,0,930,G
1-PB2,244,905,0,0,0,905,A
1-PB2,245,1,0,907,0,908,G
1-PB2,246,0,897,0,3,900,T
1-PB2,247,0,0,902,0,902,G
1-PB2,248,907,0,2,0,909,A
1-PB2,249,0,913,0,1,914,T
1-PB2,250,0,0,914,0,914,G
1-PB2,251,0,0,0,910,910,C
1-PB2,252,0,914,0,0,914,T
1-PB2,253,0,3,930,0,933,G
1-PB2,254,0,0,935,0,935,G
1-PB2,255,953,0,2,0,955,A
1-PB2,256,0,951,0,0,951,T
1-PB2,257,0,0,1,946,947,C
1-PB2,258,950,0,2,0,952,A
1-PB2,259,0,1,974,0,975,G
1-PB2,260,975,0,0,0,975,A
1-PB2,261,0,975,0,0,975,T
1-PB2,262,956,0,0,0,956,A
1-PB2,263,0,0,984,0,984,G
1-PB2,264,974,0,0,0,974,A
1-PB2,265,0,0,984,0,984,G
1-PB2,266,0,978,0,0,978,T
1-PB2,267,2,1,967,1,971,G
1-PB2,268,957,0,0,0,957,A
1-PB2,269,0,957,0,1,958,T
1-PB2,270,0,2,973,0,975,G
1-PB2,271,0,0,992,0,992,G
1-PB2,272,0,973,0,0,973,T
1-PB2,273,972,0,0,0,972,A
1-PB2,274,0,956,0,1,957,T
1-PB2,275,2,1,0,951,954,C
1-PB2,276,977,1,1,0,979,A
1-PB2,277,1,0,1,996,998,C
1-PB2,278,0,0,0,994,994,C
1-PB2,279,0,971,0,0,971,T
1-PB2,280,0,957,0,0,957,T
1-PB2,281,0,953,0,1,954,T
1-PB2,282,1,1,970,0,972,G
1-PB2,283,0,0,974,1,975,G
1-PB2,284,0,0,0,991,991,C
1-PB2,285,0,966,0,3,969,T
1-PB2,286,1,0,976,0,977,G
1-PB2,287,0,979,0,0,979,T
1-PB2,288,983,0,1,0,984,A
1-PB2,289,984,0,4,0,988,A
1-PB2,290,0,0,0,986,986,C
1-PB2,291,969,0,0,0,969,A
1-PB2,292,0,961,0,0,961,T
1-PB2,293,0,1,953,0,954,G
1-PB2,294,0,0,977,0,977,G
1-PB2,295,0,970,0,0,970,T
1-PB2,296,0,1,968,0,969,G
1-PB2,297,1,0,980,1,982,G
1-PB2,298,979,1,1,1,982,A
1-PB2,299,984,0,0,0,984,A
1-PB2,300,0,982,0,1,983,T
1-PB2,301,978,1,0,0,979,A
1-PB2,302,0,3,994,0,997,G
1-PB2,303,981,1,0,1,983,A
1-PB2,304,980,0,4,0,984,A
1-PB2,305,984,0,1,0,985,A
1-PB2,306,0,967,0,1,968,T
1-PB2,307,1,3,967,0,971,G
1-PB2,308,0,3,966,0,969,G
1-PB2,309,971,0,1,0,972,A
1-PB2,310,0,0,0,967,967,C
1-PB2,311,0,0,0,961,961,C
1-PB2,312,1,0,0,960,961,C
1-PB2,313,1,0,962,0,963,G
1-PB2,314,0,968,0,1,969,T
1-PB2,315,0,2,982,1,985,G
1-PB2,316,984,0,2,0,986,A
1-PB2,317,0,0,0,991,991,C
1-PB2,318,989,0,1,0,990,A
1-PB2,319,982,0,2,0,984,A
1-PB2,320,1,0,1007,0,1008,G
1-PB2,321,0,1006,0,0,1006,T
1-PB2,322,1000,1,0,0,1001,A
1-PB2,323,0,0,0,994,994,C
1-PB2,324,0,3,963,0,966,G
1-PB2,325,0,0,992,0,992,G
1-PB2,326,0,993,0,1,994,T
1-PB2,327,2,1,0,997,1000,C
1-PB2,328,3,0,0,995,998,C
1-PB2,329,986,0,0,0,986,A
1-PB2,330,1,983,0,4,988,T
1-PB2,331,0,991,0,0,991,T
1-PB2,332,1036,0,2,0,1038,A
1-PB2,333,0,0,0,1034,1034,C
1-PB2,334,2,0,0,1013,1015,C
1-PB2,335,2,0,0,1007,1009,C
1-PB2,336,990,0,0,0,990,A
1-PB2,337,998,0,1,0,999,A
1-PB2,338,993,0,1,0,994,A
1-PB2,339,994,0,3,1,998,A
1-PB2,340,0,0,1010,0,1010,G
1-PB2,341,0,963,0,0,963,T
1-PB2,342,0,0,984,0,984,G
1-PB2,343,0,983,0,1,984,T
1-PB2,344,982,0,1,0,983,A
1-PB2,345,0,1,0,985,986,C
1-PB2,346,984,0,0,0,984,A
1-PB2,347,987,0,1,0,988,A
1-PB2,348,0,1,990,0,991,G
1-PB2,349,984,0,0,0,984,A
1-PB2,350,0,2,0,982,984,C
1-PB2,351,1,956,0,2,959,T
1-PB2,352,0,964,0,2,966,T
1-PB2,353,968,0,0,0,968,A
1-PB2,354,0,967,0,1,968,T
1-PB2,355,0,968,0,0,968,T
1-PB2,356,0,961,0,0,961,T
1-PB2,357,0,0,0,951,951,C
1-PB2,358,1,1,946,0,948,G
1-PB2,359,948,0,1,0,949,A
1-PB2,360,0,3,0,948,951,C
1-PB2,361,948,0,0,0,948,A
1-PB2,362,946,0,0,0,946,A
1-PB2,363,947,0,0,0,947,A
1-PB2,364,0,0,957,0,957,G
1-PB2,365,0,955,0,2,957,T
1-PB2,366,0,0,0,952,952,C
1-PB2,367,0,0,957,0,957,G
1-PB2,368,955,0,0,0,955,A
1-PB2,369,955,0,1,1,957,A
1-PB2,370,958,0,0,0,958,A
1-PB2,371,0,1,982,0,983,G
1-PB2,372,0,1,989,0,990,G
1-PB2,373,0,974,0,0,974,T
1-PB2,374,0,976,0,0,976,T
1-PB2,375,975,0,0,1,976,A
1-PB2,376,975,1,0,0,976,A
1-PB2,377,975,0,2,0,977,A
1-PB2,378,993,0,0,0,993,A
1-PB2,379,0,1,0,1010,1011,C
1-PB2,380,975,0,0,0,975,A
1-PB2,381,0,970,0,0,970,T
1-PB2,382,0,2,964,0,966,G
1-PB2,383,0,1,966,1,968,G
1-PB2,384,967,0,4,0,971,A
1-PB2,385,975,0,0,0,975,A
1-PB2,386,0,0,0,1002,1002,C
1-PB2,387,1,0,0,1001,1002,C
1-PB2,388,0,992,1,1,994,T
1-PB2,389,0,992,0,3,995,T
1-PB2,390,0,992,0,2,994,T
1-PB2,391,1,4,990,0,995,G
1-PB2,392,0,1,1001,0,1002,G
1-PB2,393,1,1,0,998,1000,C
1-PB2,394,2,0,0,995,997,C
1-PB2,395,1,1,0,987,989,C
1-PB2,396,0,942,0,3,945,T
1-PB2,397,1,0,955,0,956,G
1-PB2,398,0,955,0,1,956,T
1-PB2,399,0,950,0,3,953,T
1-PB2,400,1,0,0,956,957,C
1-PB2,401,948,1,0,0,949,A
1-PB2,402,1,949,0,0,950,T
1-PB2,403,1,949,0,0,950,T
1-PB2,404,0,948,0,0,948,T
1-PB2,405,0,948,0,0,948,T
1-PB2,406,927,2,1,0,930,A
1-PB2,407,0,0,934,0,934,G
1-PB2,408,933,0,0,0,933,A
1-PB2,409,936,0,0,0,936,A
1-PB2,410,933,0,0,0,933,A
1-PB2,411,0,930,0,0,930,T
1-PB2,412,926,0,0,1,927,A
1-PB2,413,933,0,0,0,933,A
1-PB2,414,934,0,1,0,935,A
1-PB2,415,0,0,951,0,951,G
1-PB2,416,0,944,0,2,946,T
1-PB2,417,0,0,0,943,943,C
1-PB2,418,945,0,1,0,946,A
1-PB2,419,949,0,0,0,949,A
1-PB2,420,0,0,951,0,951,G
1-PB2,421,951,0,2,0,953,A
1-PB2,422,0,953,0,0,953,T
1-PB2,423,965,0,2,0,967,A
1-PB2,424,0,0,0,960,960,C
1-PB2,425,1,1,962,0,964,G
1-PB2,426,0,1,0,973,974,C
1-PB2,427,964,0,1,0,965,A
1-PB2,428,0,0,979,0,979,G
1-PB2,429,971,0,1,0,972,A
1-PB2,430,978,0,0,0,978,A
1-PB2,431,0,0,994,0,994,G
1-PB2,432,969,0,4,0,973,A
1-PB2,433,0,1,976,0,977,G
1-PB2,434,0,968,0,1,969,T
1-PB2,435,956,0,3,0,959,A
1-PB2,436,0,1,971,0,972,G
1-PB2,437,977,0,1,0,978,A
1-PB2,438,1,0,0,1016,1017,C
1-PB2,439,1007,0,1,0,1008,A
1-PB2,440,0,987,0,0,987,T
1-PB2,441,985,0,0,0,985,A
1-PB2,442,985,0,0,0,985,A
1-PB2,443,995,0,0,0,995,A
1-PB2,444,0,0,0,996,996,C
1-PB2,445,1,0,0,976,977,C
1-PB2,446,1,0,0,971,972,C
1-PB2,447,0,923,0,2,925,T
1-PB2,448,1,1,932,0,934,G
1-PB2,449,0,1,952,0,953,G
1-PB2,450,0,952,0,2,954,T
1-PB2,451,4,0,0,939,943,C
1-PB2,452,950,1,0,0,951,A
1-PB2,453,0,945,0,1,946,T
1-PB2,454,2,0,957,0,959,G
1-PB2,455,0,0,0,960,960,C
1-PB2,456,954,0,0,0,954,A
1-PB2,457,0,0,960,0,960,G
1-PB2,458,944,0,0,0,944,A
1-PB2,459,0,0,0,952,952,C
1-PB2,460,0,1,0,946,947,C
1-PB2,461,0,928,0,0,928,T
1-PB2,462,0,0,0,928,928,C
1-PB2,463,919,0,0,0,919,A
1-PB2,464,0,1,934,0,935,G
1-PB2,465,0,932,0,2,934,T
1-PB2,466,0,0,934,0,934,G
1-PB2,467,1,0,0,929,930,C
1-PB2,468,3,0,0,922,925,C
1-PB2,469,925,0,0,0,925,A
1-PB2,470,926,0,0,0,926,A
1-PB2,471,923,0,0,0,923,A
1-PB2,472,0,1,930,0,931,G
1-PB2,473,907,0,4,0,911,A
1-PB2,474,0,1,911,0,912,G
1-PB2,475,2,0,919,0,921,G
1-PB2,476,0,2,0,916,918,C
1-PB2,477,918,0,1,0,919,A
1-PB2,478,0,0,0,918,918,C
1-PB2,479,916,0,0,0,916,A
1-PB2,480,938,0,1,0,939,A
1-PB2,481,0,0,940,0,940,G
1-PB2,482,948,0,0,0,948,A
1-PB2,483,0,940,0,0,940,T
1-PB2,484,0,1,934,0,935,G
1-PB2,485,0,930,0,0,930,T
1-PB2,486,929,0,0,0,929,A
1-PB2,487,926,0,0,0,926,A
1-PB2,488,0,926,0,0,926,T
1-PB2,489,0,0,0,856,856,C
1-PB2,490,862,0,0,0,862,A
1-PB2,491,1,862,0,0,863,T
1-PB2,492,0,1,864,0,865,G
1-PB2,493,0,1,863,1,865,G
1-PB2,494,864,1,0,0,865,A
1-PB2,495,857,0,1,0,858,A
1-PB2,496,0,0,856,0,856,G
1-PB2,497,0,854,0,2,856,T
1-PB2,498,0,853,0,2,855,T
1-PB2,499,0,0,860,0,860,G
1-PB2,500,1,854,0,0,855,T
1-PB2,501,0,856,0,0,856,T
1-PB2,502,0,849,0,2,851,T
1-PB2,503,0,854,0,0,854,T
1-PB2,504,0,858,0,1,859,T
1-PB2,505,2,1,0,854,857,C
1-PB2,506,1,0,0,851,852,C
1-PB2,507,0,0,0,850,850,C
1-PB2,508,846,0,1,0,847,A
1-PB2,509,856,0,0,0,856,A
1-PB2,510,0,853,0,1,854,T
1-PB2,511,0,0,855,1,856,G
1-PB2,512,853,0,0,0,853,A
1-PB2,513,847,0,0,0,847,A
1-PB2,514,0,1,851,1,853,G
1-PB2,515,0,853,0,0,853,T
1-PB2,516,1,3,842,0,846,G
1-PB2,517,0,0,846,0,846,G
1-PB2,518,1,1,838,0,840,G
1-PB2,519,842,0,1,1,844,A
1-PB2,520,1,0,844,0,845,G
1-PB2,521,0,0,0,844,844,C
1-PB2,522,1,0,0,845,846,C
1-PB2,523,844,0,1,0,845,A
1-PB2,524,0,0,866,0,866,G
1-PB2,525,0,0,868,1,869,G
1-PB2,526,876,0,1,0,877,A
1-PB2,527,0,879,0,0,879,T
1-PB2,528,879,0,0,0,879,A
1-PB2,529,0,1,0,877,878,C
1-PB2,530,0,872,0,0,872,T
1-PB2,531,867,0,2,0,869,A
1-PB2,532,859,0,4,0,863,A
1-PB2,533,0,1,0,870,871,C
1-PB2,534,853,0,0,0,853,A
1-PB2,535,0,846,0,0,846,T
1-PB2,536,0,0,0,851,851,C
1-PB2,537,833,0,0,0,833,A
1-PB2,538,0,0,832,0,832,G
1-PB2,539,833,0,1,0,834,A
1-PB2,540,836,0,0,0,836,A
1-PB2,541,0,833,0,1,834,T
1-PB2,542,1,0,0,810,811,C
1-PB2,543,812,0,1,0,813,A
1-PB2,544,0,0,0,825,825,C
1-PB2,545,822,0,0,0,822,A
1-PB2,546,824,0,0,0,824,A
1-PB2,547,0,812,0,1,813,T
1-PB2,548,0,811,0,1,812,T
1-PB2,549,819,0,0,0,819,A
1-PB2,550,821,0,1,0,822,A
1-PB2,551,2,0,0,821,823,C
1-PB2,552,817,0,1,0,818,A
1-PB2,553,806,0,0,0,806,A
1-PB2,554,0,809,0,0,809,T
1-PB2,555,799,0,3,0,802,A
1-PB2,556,806,0,1,0,807,A
1-PB2,557,0,1,0,809,810,C
1-PB2,558,0,803,0,0,803,T
1-PB2,559,804,0,0,0,804,A
1-PB2,560,800,0,0,1,801,A
1-PB2,561,800,0,0,0,800,A
1-PB2,562,2,0,800,0,802,G
1-PB2,563,783,0,2,0,785,A
1-PB2,564,0,0,796,0,796,G
1-PB2,565,787,0,2,0,789,A
1-PB2,566,795,0,0,0,795,A
1-PB2,567,795,0,0,0,795,A
1-PB2,568,795,0,0,0,795,A
1-PB2,569,797,0,1,0,798,A
1-PB2,570,796,1,0,1,798,A
1-PB2,571,0,1,799,0,800,G
1-PB2,572,797,0,0,0,797,A
1-PB2,573,794,0,0,0,794,A
1-PB2,574,1,0,796,0,797,G
1-PB2,575,794,0,0,0,794,A
1-PB2,576,794,1,0,0,795,A
1-PB2,577,0,0,0,803,803,C
1-PB2,578,0,791,0,0,791,T
1-PB2,579,2,0,0,799,801,C
1-PB2,580,3,0,0,795,798,C
1-PB2,581,0,1,798,0,799,G
1-PB2,582,798,0,0,0,798,A
1-PB2,583,1,2,797,0,800,G
1-PB2,584,796,0,0,0,796,A
1-PB2,585,0,790,0,0,790,T
1-PB2,586,0,783,0,0,783,T
1-PB2,587,0,0,777,0,777,G
1-PB2,588,0,0,0,781,781,C
1-PB2,589,785,0,0,0,785,A
1-PB2,590,785,0,0,0,785,A
1-PB2,591,784,0,0,0,784,A
1-PB2,592,786,0,0,0,786,A
1-PB2,593,0,788,0,0,788,T
1-PB2,594,0,779,0,0,779,T
1-PB2,595,0,776,0,1,777,T
1-PB2,596,2,0,0,772,774,C
1-PB2,597,0,765,0,1,766,T
1-PB2,598,1,0,0,796,797,C
1-PB2,599,0,0,0,800,800,C
1-PB2,600,1,0,0,848,849,C
1-PB2,601,0,845,0,0,845,T
1-PB2,602,0,849,0,1,850,T
1-PB2,603,0,0,852,1,853,G
1-PB2,604,852,0,0,0,852,A
1-PB2,605,0,875,0,0,875,T
1-PB2,606,0,3,892,0,895,G
1-PB2,607,0,1,948,0,949,G
1-PB2,608,0,968,0,0,968,T
1-PB2,609,0,958,0,0,958,T
1-PB2,610,2,0,1019,0,1021,G
1-PB2,611,0,0,0,1035,1035,C
1-PB2,612,1049,0,0,0,1049,A
1-PB2,613,0,1048,0,1,1049,T
1-PB2,614,1053,0,0,0,1053,A
1-PB2,615,0,1,0,1094,1095,C
1-PB2,616,1189,0,1,1,1191,A
1-PB2,617,0,1223,0,1,1224,T
1-PB2,618,0,0,1279,0,1279,G
1-PB2,619,0,1263,0,2,1265,T
1-PB2,620,0,1264,0,0,1264,T
1-PB2,621,1267,0,0,0,1267,A
1-PB2,622,1,1,1270,0,1272,G
1-PB2,623,1276,0,5,0,1281,A
1-PB2,624,0,1,1291,0,1292,G
1-PB2,625,1217,0,0,0,1217,A
1-PB2,626,0,1,1221,0,1222,G
1-PB2,627,1198,0,3,0,1201,A
1-PB2,628,1,2,1203,0,1206,G
1-PB2,629,1214,1,2,0,1217,A
1-PB2,630,1213,0,1,0,1214,A
1-PB2,631,1,1,0,1220,1222,C
1-PB2,632,0,1217,0,1,1218,T
1-PB2,633,0,1208,0,0,1208,T
1-PB2,634,0,0,1211,0,1211,G
1-PB2,635,0,1208,0,1,1209,T
1-PB2,636,1211,0,2,0,1213,A
1-PB2,637,0,1,0,1210,1211,C
1-PB2,638,0,0,1212,0,1212,G
1-PB2,639,1219,0,0,0,1219,A
1-PB2,640,1216,1,0,0,1217,A
1-PB2,641,1229,0,1,0,1230,A
1-PB2,642,1233,0,0,0,1233,A
1-PB2,643,1230,0,2,1,1233,A
1-PB2,644,0,0,0,1236,1236,C
1-PB2,645,1233,0,2,0,1235,A
1-PB2,646,1238,0,2,0,1240,A
1-PB2,647,1,0,1241,0,1242,G
1-PB2,648,1245,0,0,0,1245,A
1-PB2,649,0,1240,0,4,1244,T
1-PB2,650,0,1234,0,2,1236,T
1-PB2,651,0,1238,0,1,1239,T
1-PB2,652,1,0,0,1239,1240,C
1-PB2,653,0,1242,0,3,1245,T
1-PB2,654,1,1,0,1243,1245,C
1-PB2,655,0,0,0,1239,1239,C
1-PB2,656,0,0,0,1242,1242,C
1-PB2,657,1240,0,0,0,1240,A
1-PB2,658,0,0,1251,0,1251,G
1-PB2,659,1,1250,0,2,1253,T
1-PB2,660,1,1251,0,0,1252,T
1-PB2,661,0,0,1251,0,1251,G
1-PB2,662,1,0,0,1252,1253,C
1-PB2,663,0,1244,0,2,1246,T
1-PB2,664,0,1,1251,0,1252,G
1-PB2,665,2,0,1246,1,1249,G
1-PB2,666,0,2,1,1251,1254,C
1-PB2,667,1,1,1251,0,1253,G
1-PB2,668,0,0,1267,0,1267,G
1-PB2,669,1265,1,1,0,1267,A
1-PB2,670,1265,1,1,0,1267,A
1-PB2,671,0,2,0,1265,1267,C
1-PB2,672,1272,0,0,0,1272,A
1-PB2,673,1278,0,1,0,1279,A
1-PB2,674,0,0,1342,0,1342,G
1-PB2,675,0,1,0,1360,1361,C
1-PB2,676,1372,0,0,0,1372,A
1-PB2,677,0,0,1702,0,1702,G
1-PB2,678,0,1701,0,2,1703,T
1-PB2,679,1716,0,0,0,1716,A
1-PB2,680,1,1712,0,0,1713,T
1-PB2,681,1718,0,1,0,1719,A
1-PB2,682,0,1713,1,3,1717,T
1-PB2,683,1683,0,1,0,1684,A
1-PB2,684,0,1,0,1690,1691,C
1-PB2,685,1610,0,2,0,1612,A
1-PB2,686,1,1522,0,1,1524,T
1-PB2,687,0,1474,0,0,1474,T
1-PB2,688,0,0,1474,1,1475,G
1-PB2,689,1470,0,0,0,1470,A
1-PB2,690,1470,0,1,0,1471,A
1-PB2,691,0,0,1492,0,1492,G
1-PB2,692,0,1478,1,2,1481,T
1-PB2,693,0,1474,0,2,1476,T
1-PB2,694,0,1475,0,1,1476,T
1-PB2,695,0,1477,0,1,1478,T
1-PB2,696,1492,0,4,0,1496,A
1-PB2,697,0,0,1,1505,1506,C
1-PB2,698,1509,0,0,0,1509,A
1-PB2,699,0,1501,0,1,1502,T
1-PB2,700,0,1487,0,3,1490,T
1-PB2,701,0,1488,0,0,1488,T
1-PB2,702,0,2,1503,0,1505,G
1-PB2,703,1509,0,1,0,1510,A
1-PB2,704,0,1,0,1517,1518,C
1-PB2,705,0,1500,0,2,1502,T
1-PB2,706,1,0,0,1505,1506,C
1-PB2,707,1503,0,1,0,1504,A
1-PB2,708,1,3,1484,1,1489,G
1-PB2,709,1,0,1519,0,1520,G
1-PB2,710,0,1,1521,0,1522,G
1-PB2,711,1527,0,2,0,1529,A
1-PB2,712,1529,0,2,0,1531,A
1-PB2,713,0,1,0,1532,1533,C
1-PB2,714,0,0,1545,0,1545,G
1-PB2,715,0,1540,1,0,1541,T
1-PB2,716,0,0,1551,0,1551,G
1-PB2,717,1,1532,1,3,1537,T
1-PB2,718,1,1535,0,0,1536,T
1-PB2,719,0,2,1537,0,1539,G
1-PB2,720,0,2,1541,0,1543,G
1-PB2,721,0,1,1550,0,1551,G
1-PB2,722,1540,0,2,0,1542,A
1-PB2,723,1537,1,1,0,1539,A
1-PB2,724,0,0,0,1583,1583,C
1-PB2,725,1572,0,1,0,1573,A
1-PB2,726,1609,0,2,0,1611,A
1-PB2,727,1614,0,3,1,1618,A
1-PB2,728,0,1623,0,1,1624,T
1-PB2,729,2,0,1646,0,1648,G
1-PB2,730,0,1639,0,0,1639,T
1-PB2,731,1640,0,1,0,1641,A
1-PB2,732,1,1,0,1647,1649,C
1-PB2,733,1612,0,1,0,1613,A
1-PB2,734,0,0,0,1611,1611,C
1-PB2,735,0,1553,0,4,1557,T
1-PB2,736,2,0,0,1669,1671,C
1-PB2,737,0,0,0,1674,1674,C
1-PB2,738,1699,0,1,0,1700,A
1-PB2,739,1,1,1710,0,1712,G
1-PB2,740,0,2,1748,0,1750,G
1-PB2,741,1,1741,0,1,1743,T
1-PB2,742,0,3,1742,0,1745,G
1-PB2,743,0,2,1692,0,1694,G
1-PB2,744,1678,0,4,0,1682,A
1-PB2,745,0,0,1684,0,1684,G
1-PB2,746,0,0,1685,0,1685,G
1-PB2,747,1656,0,3,0,1659,A
1-PB2,748,0,0,1671,0,1671,G
1-PB2,749,0,1620,0,0,1620,T
1-PB2,750,3,3,1622,0,1628,G
1-PB2,751,1629,0,3,0,1632,A
1-PB2,752,0,2,1630,0,1632,G
1-PB2,753,1,0,1642,0,1643,G
1-PB2,754,1625,0,2,0,1627,A
1-PB2,755,1624,0,5,0,1629,A
1-PB2,756,0,1636,0,1,1637,T
1-PB2,757,0,3,1631,0,1634,G
1-PB2,758,1627,0,2,1,1630,A
1-PB2,759,0,3,0,1621,1624,C
1-PB2,760,1,0,1623,0,1624,G
1-PB2,761,1641,0,0,0,1641,A
1-PB2,762,0,1632,0,1,1633,T
1-PB2,763,2,0,1643,0,1645,G
1-PB2,764,0,1643,0,2,1645,T
1-PB2,765,0,1626,0,1,1627,T
1-PB2,766,1,1,1641,0,1643,G
1-PB2,767,1656,0,1,0,1657,A
1-PB2,768,1,0,0,1653,1654,C
1-PB2,769,5,0,0,1643,1648,C
1-PB2,770,1634,0,0,0,1634,A
1-PB2,771,1630,0,2,0,1632,A
1-PB2,772,1647,0,2,0,1649,A
1-PB2,773,0,0,1685,0,1685,G
1-PB2,774,0,1,0,1683,1684,C
1-PB2,775,2,0,0,1680,1682,C
1-PB2,776,2,1689,0,0,1691,T
1-PB2,777,1696,0,0,0,1696,A
1-PB2,778,1695,0,1,0,1696,A
1-PB2,779,0,1695,0,2,1697,T
1-PB2,780,0,1692,0,1,1693,T
1-PB2,781,1676,0,0,0,1676,A
1-PB2,782,2,1635,0,0,1637,T
1-PB2,783,0,1633,0,1,1634,T
1-PB2,784,1,1,1625,0,1627,G
1-PB2,785,2,2,0,1616,1620,C
1-PB2,786,2,1,1614,0,1617,G
1-PB2,787,2,1,1639,1,1643,G
1-PB2,788,0,0,0,1644,1644,C
1-PB2,789,0,1,0,1653,1654,C
1-PB2,790,1647,0,1,1,1649,A
1-PB2,791,1,2,1666,0,1669,G
1-PB2,792,0,2,1680,0,1682,G
1-PB2,793,1683,0,2,0,1685,A
1-PB2,794,1686,2,4,1,1693,A
1-PB2,795,2,1,0,1697,1700,C
1-PB2,796,1673,1,2,0,1676,A
1-PB2,797,0,1695,0,2,1697,T
1-PB2,798,1718,0,0,0,1718,A
1-PB2,799,0,1,1731,0,1732,G
1-PB2,800,0,1700,0,0,1700,T
1-PB2,801,1692,0,0,0,1692,A
1-PB2,802,1684,0,1,0,1685,A
1-PB2,803,1,2,1684,0,1687,G
1-PB2,804,1676,0,0,0,1676,A
1-PB2,805,1645,0,2,0,1647,A
1-PB2,806,1,3,1644,0,1648,G
1-PB2,807,1598,0,2,0,1600,A
1-PB2,808,0,0,1598,0,1598,G
1-PB2,809,0,0,0,1590,1590,C
1-PB2,810,1,1,0,1586,1588,C
1-PB2,811,0,1,1590,0,1591,G
1-PB2,812,1,1,0,1599,1601,C
1-PB2,813,1603,0,0,0,1603,A
1-PB2,814,1,0,1705,0,1706,G
1-PB2,815,1,1697,0,0,1698,T
1-PB2,816,1701,0,1,0,1702,A
1-PB2,817,0,1688,0,2,1690,T
1-PB2,818,0,0,0,1700,1700,C
1-PB2,819,1697,1,2,1,1701,A
1-PB2,820,1,0,1701,0,1702,G
1-PB2,821,1,0,0,1700,1701,C
1-PB2,822,1632,0,3,0,1635,A
1-PB2,823,0,1,1615,0,1616,G
1-PB2,824,1619,0,1,0,1620,A
1-PB2,825,0,1619,0,1,1620,T
1-PB2,826,1,0,0,1617,1618,C
1-PB2,827,3,0,0,1619,1622,C
1-PB2,828,1629,0,1,0,1630,A
1-PB2,829,0,2,0,1625,1627,C
1-PB2,830,0,1628,0,0,1628,T
1-PB2,831,1627,0,2,0,1629,A
1-PB2,832,1,0,1628,0,1629,G
1-PB2,833,0,0,0,1620,1620,C
1-PB2,834,1619,0,0,0,1619,A
1-PB2,835,0,1616,0,1,1617,T
1-PB2,836,3,1,0,1629,1633,C
1-PB2,837,0,1622,0,5,1627,T
1-PB2,838,0,1650,0,1,1651,T
1-PB2,839,0,1652,0,2,1654,T
1-PB2,840,1641,1,0,0,1642,A
1-PB2,841,0,1649,0,0,1649,T
1-PB2,842,0,1629,0,0,1629,T
1-PB2,843,0,4,1618,0,1622,G
1-PB2,844,0,0,1624,0,1624,G
1-PB2,845,1570,0,4,0,1574,A
1-PB2,846,1,3,1579,0,1583,G
1-PB2,847,1541,0,2,0,1543,A
1-PB2,848,0,1526,0,0,1526,T
1-PB2,849,0,0,1564,0,1564,G
1-PB2,850,0,1565,0,3,1568,T
1-PB2,851,1,1,1571,0,1573,G
1-PB2,852,1,0,0,1580,1581,C
1-PB2,853,1,1,0,1571,1573,C
1-PB2,854,1571,0,3,0,1574,A
1-PB2,855,1,32,0,1541,1574,C
1-PB2,856,1546,0,3,0,1549,A
1-PB2,857,2,0,1566,0,1568,G
1-PB2,858,0,0,0,1535,1535,C
1-PB2,859,1528,0,0,0,1528,A
1-PB2,860,1,3,0,1515,1519,C
1-PB2,861,1515,0,2,0,1517,A
1-PB2,862,0,1,0,1519,1520,C
1-PB2,863,1511,0,1,0,1512,A
1-PB2,864,1513,1,1,0,1515,A
1-PB2,865,1509,1,1,0,1511,A
1-PB2,866,0,1466,0,0,1466,T
1-PB2,867,0,1466,0,1,1467,T
1-PB2,868,0,2,1458,0,1460,G
1-PB2,869,0,1,1454,0,1455,G
1-PB2,870,3,0,0,1449,1452,C
1-PB2,871,1,0,1437,0,1438,G
1-PB2,872,0,0,1439,0,1439,G
1-PB2,873,1432,0,0,0,1432,A
1-PB2,874,1471,1,1,0,1473,A
1-PB2,875,1,0,0,1476,1477,C
1-PB2,876,1477,0,2,0,1479,A
1-PB2,877,1490,0,1,0,1491,A
1-PB2,878,1,2,1491,0,1494,G
1-PB2,879,3,2,1493,0,1498,G
1-PB2,880,1501,0,4,0,1505,A
1-PB2,881,0,1406,0,0,1406,T
1-PB2,882,1,1,1399,0,1401,G
1-PB2,883,1,0,1408,0,1409,G
1-PB2,884,1,1391,0,2,1394,T
1-PB2,885,0,1,1394,0,1395,G
1-PB2,886,0,0,1392,0,1392,G
1-PB2,887,1380,1,2,0,1383,A
1-PB2,888,0,0,0,1374,1374,C
1-PB2,889,1357,1,0,0,1358,A
1-PB2,890,0,1505,0,1,1506,T
1-PB2,891,0,1496,0,1,1497,T
1-PB2,892,1,1,0,1491,1493,C
1-PB2,893,0,1456,0,2,1458,T
1-PB2,894,0,1459,0,0,1459,T
1-PB2,895,1456,0,3,0,1459,A
1-PB2,896,0,1,1465,1,1467,G
1-PB2,897,1464,0,1,0,1465,A
1-PB2,898,0,1,0,1463,1464,C
1-PB2,899,1134,1,2,0,1137,A
1-PB2,900,0,1,1156,0,1157,G
1-PB2,901,1142,0,3,0,1145,A
1-PB2,902,1154,0,0,0,1154,A
1-PB2,903,1,0,0,1155,1156,C
1-PB2,904,0,0,0,1149,1149,C
1-PB2,905,2,1,0,1147,1150,C
1-PB2,906,2,0,1147,1,1150,G
1-PB2,907,1152,0,0,0,1152,A
1-PB2,908,0,0,0,1160,1160,C
1-PB2,909,1,1143,0,1,1145,T
1-PB2,910,0,0,1156,0,1156,G
1-PB2,911,1157,0,0,0,1157,A
1-PB2,912,1157,1,1,0,1159,A
1-PB2,913,1,2,1161,0,1164,G
1-PB2,914,1162,1,2,1,1166,A
1-PB2,915,1158,1,1,0,1160,A
1-PB2,916,0,1,0,1159,1160,C
1-PB2,917,1157,0,0,0,1157,A
1-PB2,918,1157,0,1,0,1158,A
1-PB2,919,0,0,1164,0,1164,G
1-PB2,920,0,0,0,1171,1171,C
1-PB2,921,0,1162,0,1,1163,T
1-PB2,922,0,0,1186,0,1186,G
1-PB2,923,1,1181,0,1,1183,T
1-PB2,924,0,1,1196,0,1197,G
1-PB2,925,3,0,1242,0,1245,G
1-PB2,926,1244,0,1,0,1245,A
1-PB2,927,0,1239,0,0,1239,T
1-PB2,928,1223,1,0,0,1224,A
1-PB2,929,0,1212,0,0,1212,T
1-PB2,930,1265,0,1,0,1266,A
1-PB2,931,0,1249,0,3,1252,T
1-PB2,932,1,0,1247,0,1248,G
1-PB2,933,0,0,0,1233,1233,C
1-PB2,934,1184,0,1,0,1185,A
1-PB2,935,1187,0,1,0,1188,A
1-PB2,936,0,2,1182,0,1184,G
1-PB2,937,2,0,1188,0,1190,G
1-PB2,938,0,0,0,1183,1183,C
1-PB2,939,0,1159,0,0,1159,T
1-PB2,940,0,1,1162,0,1163,G
1-PB2,941,0,0,0,1168,1168,C
1-PB2,942,1166,0,2,0,1168,A
1-PB2,943,1173,0,0,0,1173,A
1-PB2,944,0,1165,0,1,1166,T
1-PB2,945,2,2,1165,0,1169,G
1-PB2,946,1,0,1151,0,1152,G
1-PB2,947,1,1,1153,0,1155,G
1-PB2,948,1156,0,1,0,1157,A
1-PB2,949,0,1154,2,0,1156,T
1-PB2,950,0,1143,0,1,1144,T
1-PB2,951,1,1,1143,0,1145,G
1-PB2,952,1142,0,3,0,1145,A
1-PB2,953,0,0,1150,1,1151,G
1-PB2,954,1140,0,3,0,1143,A
1-PB2,955,1135,0,0,0,1135,A
1-PB2,956,0,1125,0,0,1125,T
1-PB2,957,0,2,0,1126,1128,C
1-PB2,958,1124,0,1,0,1125,A
1-PB2,959,1,0,1128,0,1129,G
1-PB2,960,0,2,0,1128,1130,C
1-PB2,961,0,1121,0,1,1122,T
1-PB2,962,0,0,0,1123,1123,C
1-PB2,963,1120,1,1,0,1122,A
1-PB2,964,0,1141,0,0,1141,T
1-PB2,965,1,0,0,1134,1135,C
1-PB2,966,0,0,0,1152,1152,C
1-PB2,967,1,1143,0,2,1146,T
1-PB2,968,0,1146,0,0,1146,T
1-PB2,969,0,0,0,1148,1148,C
1-PB2,970,1146,0,3,0,1149,A
1-PB2,971,0,0,1172,0,1172,G
1-PB2,972,0,1,0,1166,1167,C
1-PB2,973,0,1157,0,3,1160,T
1-PB2,974,0,1164,0,0,1164,T
1-PB2,975,0,1151,0,0,1151,T
1-PB2,976,2,2,1150,0,1154,G
1-PB2,977,0,1,1154,0,1155,G
1-PB2,978,1,1151,0,1,1153,T
1-PB2,979,1,2,1154,0,1157,G
1-PB2,980,1,2,1141,0,1144,G
1-PB2,981,1,0,1160,0,1161,G
1-PB2,982,0,1161,0,2,1163,T
1-PB2,983,0,1157,0,1,1158,T
1-PB2,984,0,1161,0,0,1161,T
1-PB2,985,1163,0,0,0,1163,A
1-PB2,986,0,0,0,1170,1170,C
1-PB2,987,1170,0,0,0,1170,A
1-PB2,988,0,1159,0,2,1161,T
1-PB2,989,0,1146,0,0,1146,T
1-PB2,990,0,1149,0,0,1149,T
1-PB2,991,1148,0,0,0,1148,A
1-PB2,992,1143,2,0,0,1145,A
1-PB2,993,1148,1,0,0,1149,A
1-PB2,994,1140,0,3,0,1143,A
1-PB2,995,0,0,1154,0,1154,G
1-PB2,996,1148,0,1,1,1150,A
1-PB2,997,1149,1,2,0,1152,A
1-PB2,998,1,0,0,1155,1156,C
1-PB2,999,1147,1,0,0,1148,A
1-PB2,1000,1148,0,0,0,1148,A
1-PB2,1001,0,1,1145,0,1146,G
1-PB2,1002,0,1,0,1143,1144,C
1-PB2,1003,0,0,1143,0,1143,G
1-PB2,1004,2,1,1143,0,1146,G
1-PB2,1005,1,2,1144,0,1147,G
1-PB2,1006,0,1141,0,1,1142,T
1-PB2,1007,5,0,0,1136,1141,C
1-PB2,1008,1137,1,5,0,1143,A
1-PB2,1009,0,1132,0,2,1134,T
1-PB2,1010,3,0,0,1138,1141,C
1-PB2,1011,1132,0,0,0,1132,A
1-PB2,1012,0,0,1149,0,1149,G
1-PB2,1013,0,1137,0,2,1139,T
1-PB2,1014,2,0,0,1139,1141,C
1-PB2,1015,1137,0,0,1,1138,A
1-PB2,1016,1140,0,2,0,1142,A
1-PB2,1017,1136,0,4,0,1140,A
1-PB2,1018,1138,0,0,0,1138,A
1-PB2,1019,1147,0,0,0,1147,A
1-PB2,1020,1145,0,1,0,1146,A
1-PB2,1021,1,0,1146,0,1147,G
1-PB2,1022,1136,0,3,0,1139,A
1-PB2,1023,1134,0,2,0,1136,A
1-PB2,1024,1,2,1134,0,1137,G
1-PB2,1025,1131,0,0,0,1131,A
1-PB2,1026,1097,0,5,0,1102,A
1-PB2,1027,0,2,1097,0,1099,G
1-PB2,1028,1096,0,2,0,1098,A
1-PB2,1029,0,0,1099,0,1099,G
1-PB2,1030,0,0,1118,0,1118,G
1-PB2,1031,0,1110,0,0,1110,T
1-PB2,1032,1,0,1137,0,1138,G
1-PB2,1033,0,1,0,1135,1136,C
1-PB2,1034,0,1135,0,3,1138,T
1-PB2,1035,0,1140,0,0,1140,T
1-PB2,1036,1141,0,1,0,1142,A
1-PB2,1037,0,0,0,1143,1143,C
1-PB2,1038,1133,0,0,0,1133,A
1-PB2,1039,0,0,1139,0,1139,G
1-PB2,1040,0,2,1133,0,1135,G
1-PB2,1041,0,1,0,1121,1122,C
1-PB2,1042,1105,0,1,0,1106,A
1-PB2,1043,1111,0,1,0,1112,A
1-PB2,1044,0,1127,0,1,1128,T
1-PB2,1045,2,0,0,1135,1137,C
1-PB2,1046,0,1133,0,0,1133,T
1-PB2,1047,2,1,0,1136,1139,C
1-PB2,1048,5,0,0,1130,1135,C
1-PB2,1049,1127,0,1,0,1128,A
1-PB2,1050,1127,1,0,0,1128,A
1-PB2,1051,1133,0,3,0,1136,A
1-PB2,1052,0,0,0,1144,1144,C
1-PB2,1053,1108,0,0,0,1108,A
1-PB2,1054,0,1100,0,0,1100,T
1-PB2,1055,0,1072,0,1,1073,T
1-PB2,1056,0,1,1072,0,1073,G
1-PB2,1057,1065,0,1,0,1066,A
1-PB2,1058,1,3,1040,0,1044,G
1-PB2,1059,1105,0,0,0,1105,A
1-PB2,1060,1106,0,1,0,1107,A
1-PB2,1061,0,1113,0,0,1113,T
1-PB2,1062,1113,1,0,0,1114,A
1-PB2,1063,1119,0,2,0,1121,A
1-PB2,1064,1,1,1159,0,1161,G
1-PB2,1065,1146,0,2,0,1148,A
1-PB2,1066,0,0,1181,0,1181,G
1-PB2,1067,0,1140,0,0,1140,T
1-PB2,1068,1145,0,1,0,1146,A
1-PB2,1069,0,0,0,1160,1160,C
1-PB2,1070,1152,0,1,0,1153,A
1-PB2,1071,0,1146,0,0,1146,T
1-PB2,1072,0,1,1143,0,1144,G
1-PB2,1073,1111,0,2,0,1113,A
1-PB2,1074,0,3,1125,0,1128,G
1-PB2,1075,1,0,1113,0,1114,G
1-PB2,1076,0,2,1140,0,1142,G
1-PB2,1077,0,0,1149,1,1150,G
1-PB2,1078,0,1131,1,2,1134,T
1-PB2,1079,1128,1,2,0,1131,A
1-PB2,1080,0,1125,0,0,1125,T
1-PB2,1081,0,1,1128,0,1129,G
1-PB2,1082,1126,0,2,0,1128,A
1-PB2,1083,0,0,1117,1,1118,G
1-PB2,1084,0,2,1113,0,1115,G
1-PB2,1085,1009,0,2,0,1011,A
1-PB2,1086,0,1,1040,0,1041,G
1-PB2,1087,0,1039,0,2,1041,T
1-PB2,1088,0,1061,0,2,1063,T
1-PB2,1089,2,0,0,1066,1068,C
1-PB2,1090,1056,1,2,0,1059,A
1-PB2,1091,0,0,0,1057,1057,C
1-PB2,1092,1052,0,1,0,1053,A
1-PB2,1093,1060,0,2,0,1062,A
1-PB2,1094,0,1059,0,0,1059,T
1-PB2,1095,1,1,1023,0,1025,G
1-PB2,1096,1,0,1033,0,1034,G
1-PB2,1097,0,1006,0,1,1007,T
1-PB2,1098,1,1,1005,0,1007,G
1-PB2,1099,1,0,1003,1,1005,G
1-PB2,1100,0,1,1001,0,1002,G
1-PB2,1101,1,0,1011,0,1012,G
1-PB2,1102,1007,0,0,0,1007,A
1-PB2,1103,1007,0,0,0,1007,A
1-PB2,1104,1002,0,0,1,1003,A
1-PB2,1105,977,0,7,0,984,A
1-PB2,1106,0,1,998,1,1000,G
1-PB2,1107,995,0,4,0,999,A
1-PB2,1108,0,1,1000,0,1001,G
1-PB2,1109,0,0,0,996,996,C
1-PB2,1110,987,0,2,0,989,A
1-PB2,1111,992,0,1,0,993,A
1-PB2,1112,0,0,0,1034,1034,C
1-PB2,1113,1032,1,0,0,1033,A
1-PB2,1114,0,0,1047,0,1047,G
1-PB2,1115,1,0,0,1034,1035,C
1-PB2,1116,0,1029,0,3,1032,T
1-PB2,1117,1072,0,0,0,1072,A
1-PB2,1118,0,1069,0,1,1070,T
1-PB2,1119,1076,0,1,1,1078,A
1-PB2,1120,0,0,0,1072,1072,C
1-PB2,1121,0,1008,0,1,1009,T
1-PB2,1122,1017,0,1,0,1018,A
1-PB2,1123,1003,0,0,0,1003,A
1-PB2,1124,0,1,1006,1,1008,G
1-PB2,1125,1007,0,0,0,1007,A
1-PB2,1126,984,0,0,0,984,A
1-PB2,1127,986,0,0,0,986,A
1-PB2,1128,984,0,0,0,984,A
1-PB2,1129,0,0,990,0,990,G
1-PB2,1130,0,0,0,989,989,C
1-PB2,1131,975,0,1,1,977,A
1-PB2,1132,982,1,0,0,983,A
1-PB2,1133,1,0,0,980,981,C
1-PB2,1134,0,0,0,983,983,C
1-PB2,1135,983,0,0,0,983,A
1-PB2,1136,1,0,985,0,986,G
1-PB2,1137,982,0,2,0,984,A
1-PB2,1138,986,0,0,0,986,A
1-PB2,1139,0,1,994,0,995,G
1-PB2,1140,995,0,0,0,995,A
1-PB2,1141,0,986,0,1,987,T
1-PB2,1142,1,982,0,0,983,T
1-PB2,1143,0,2,985,0,987,G
1-PB2,1144,0,0,1000,0,1000,G
1-PB2,1145,0,989,0,2,991,T
1-PB2,1146,0,990,0,3,993,T
1-PB2,1147,7,0,0,985,992,C
1-PB2,1148,979,0,2,0,981,A
1-PB2,1149,972,0,0,0,972,A
1-PB2,1150,0,0,0,1043,1043,C
1-PB2,1151,0,1040,0,0,1040,T
1-PB2,1152,4,0,0,1047,1051,C
1-PB2,1153,1025,0,1,1,1027,A
1-PB2,1154,0,1029,0,0,1029,T
1-PB2,1155,1025,1,1,0,1027,A
1-PB2,1156,0,0,1030,0,1030,G
1-PB2,1157,0,999,0,0,999,T
1-PB2,1158,0,2,1012,0,1014,G
1-PB2,1159,954,0,0,0,954,A
1-PB2,1160,0,0,975,0,975,G
1-PB2,1161,0,965,0,1,966,T
1-PB2,1162,0,2,968,1,971,G
1-PB2,1163,0,0,978,0,978,G
1-PB2,1164,975,0,1,0,976,A
1-PB2,1165,975,0,1,0,976,A
1-PB2,1166,0,2,986,0,988,G
1-PB2,1167,969,0,1,0,970,A
1-PB2,1168,1,0,974,0,975,G
1-PB2,1169,958,1,1,0,960,A
1-PB2,1170,2,2,0,957,961,C
1-PB2,1171,2,2,956,0,960,G
1-PB2,1172,951,0,1,0,952,A
1-PB2,1173,950,0,6,0,956,A
1-PB2,1174,0,0,0,959,959,C
1-PB2,1175,953,0,0,0,953,A
1-PB2,1176,0,0,1000,0,1000,G
1-PB2,1177,0,994,0,0,994,T
1-PB2,1178,1,0,0,992,993,C
1-PB2,1179,993,0,0,0,993,A
1-PB2,1180,992,0,0,0,992,A
1-PB2,1181,1,991,0,0,992,T
1-PB2,1182,989,0,1,0,990,A
1-PB2,1183,2,0,993,0,995,G
1-PB2,1184,0,0,1,983,984,C
1-PB2,1185,1,0,0,953,954,C
1-PB2,1186,3,0,942,0,945,G
1-PB2,1187,947,0,0,0,947,A
1-PB2,1188,951,0,0,0,951,A
1-PB2,1189,0,0,961,0,961,G
1-PB2,1190,0,0,0,977,977,C
1-PB2,1191,983,0,0,0,983,A
1-PB2,1192,984,0,0,0,984,A
1-PB2,1193,0,985,0,0,985,T
1-PB2,1194,988,0,0,0,988,A
1-PB2,1195,994,0,2,0,996,A
1-PB2,1196,0,995,0,0,995,T
1-PB2,1197,0,1,0,994,995,C
1-PB2,1198,0,0,987,0,987,G
1-PB2,1199,0,952,0,2,954,T
1-PB2,1200,2,0,954,0,956,G
1-PB2,1201,0,1,957,0,958,G
1-PB2,1202,0,2,0,955,957,C
1-PB2,1203,0,0,0,954,954,C
1-PB2,1204,947,0,0,0,947,A
1-PB2,1205,0,945,0,2,947,T
1-PB2,1206,0,1,947,0,948,G
1-PB2,1207,0,1,956,0,957,G
1-PB2,1208,0,944,0,0,944,T
1-PB2,1209,0,0,946,0,946,G
1-PB2,1210,0,925,0,3,928,T
1-PB2,1211,0,926,1,1,928,T
1-PB2,1212,0,926,1,0,927,T
1-PB2,1213,0,928,1,1,930,T
1-PB2,1214,0,0,0,943,943,C
1-PB2,1215,941,0,1,0,942,A
1-PB2,1216,0,0,0,1034,1034,C
1-PB2,1217,1031,0,0,0,1031,A
1-PB2,1218,1068,0,0,0,1068,A
1-PB2,1219,0,0,1072,0,1072,G
1-PB2,1220,1073,0,1,0,1074,A
1-PB2,1221,995,0,78,0,1073,A
1-PB2,1222,0,0,1101,0,1101,G
1-PB2,1223,1101,0,0,0,1101,A
1-PB2,1224,0,1101,0,2,1103,T
1-PB2,1225,0,1094,0,0,1094,T
1-PB2,1226,1,1,1090,0,1092,G
1-PB2,1227,1,0,0,1084,1085,C
1-PB2,1228,1094,0,0,0,1094,A
1-PB2,1229,1,1107,0,0,1108,T
1-PB2,1230,0,2,1179,1,1182,G
1-PB2,1231,1187,1,1,0,1189,A
1-PB2,1232,0,1196,0,0,1196,T
1-PB2,1233,1192,0,1,0,1193,A
1-PB2,1234,1198,0,0,0,1198,A
1-PB2,1235,1201,0,1,0,1202,A
1-PB2,1236,1208,1,0,0,1209,A
1-PB2,1237,0,2,1208,0,1210,G
1-PB2,1238,0,0,0,1247,1247,C
1-PB2,1239,1275,1,0,0,1276,A
1-PB2,1240,0,1,1333,0,1334,G
1-PB2,1241,0,1329,0,1,1330,T
1-PB2,1242,0,1331,0,2,1333,T
1-PB2,1243,1335,0,0,0,1335,A
1-PB2,1244,0,1,1341,0,1342,G
1-PB2,1245,1330,2,1,0,1333,A
1-PB2,1246,0,0,1339,0,1339,G
1-PB2,1247,0,1,1333,0,1334,G
1-PB2,1248,0,1285,0,2,1287,T
1-PB2,1249,0,2,1311,0,1313,G
1-PB2,1250,1316,0,3,0,1319,A
1-PB2,1251,0,0,0,1330,1330,C
1-PB2,1252,0,0,0,1333,1333,C
1-PB2,1253,0,1309,0,5,1314,T
1-PB2,1254,0,2,1316,0,1318,G
1-PB2,1255,1316,0,0,0,1316,A
1-PB2,1256,1315,0,1,0,1316,A
1-PB2,1257,0,1323,0,1,1324,T
1-PB2,1258,0,1329,0,0,1329,T
1-PB2,1259,0,1335,0,2,1337,T
1-PB2,1260,1,2,0,1333,1336,C
1-PB2,1261,3,1,1332,0,1336,G
1-PB2,1262,0,1338,0,0,1338,T
1-PB2,1263,2,0,0,1337,1339,C
1-PB2,1264,1335,0,0,0,1335,A
1-PB2,1265,1335,0,0,0,1335,A
1-PB2,1266,1,0,0,1336,1337,C
1-PB2,1267,1318,1,0,0,1319,A
1-PB2,1268,0,1,1340,0,1341,G
1-PB2,1269,1332,0,2,0,1334,A
1-PB2,1270,0,0,1342,0,1342,G
1-PB2,1271,0,0,0,1340,1340,C
1-PB2,1272,1335,0,1,0,1336,A
1-PB2,1273,1360,0,1,0,1361,A
1-PB2,1274,1356,1,1,0,1358,A
1-PB2,1275,1,1359,0,0,1360,T
1-PB2,1276,1,0,0,1355,1356,C
1-PB2,1277,1345,0,0,0,1345,A
1-PB2,1278,0,0,1348,0,1348,G
1-PB2,1279,1,0,0,1350,1351,C
1-PB2,1280,0,0,1355,0,1355,G
1-PB2,1281,3,0,1420,0,1423,G
1-PB2,1282,0,1420,0,0,1420,T
1-PB2,1283,0,1419,0,1,1420,T
1-PB2,1284,0,2,1425,0,1427,G
1-PB2,1285,1429,0,2,0,1431,A
1-PB2,1286,1444,0,2,0,1446,A
1-PB2,1287,1,0,0,1451,1452,C
1-PB2,1288,1,0,0,1445,1446,C
1-PB2,1289,1,1,0,1449,1451,C
1-PB2,1290,1,0,0,1406,1407,C
1-PB2,1291,1415,0,0,0,1415,A
1-PB2,1292,2,1411,0,1,1414,T
1-PB2,1293,0,1,1415,0,1416,G
1-PB2,1294,1,0,0,1416,1417,C
1-PB2,1295,1412,0,3,0,1415,A
1-PB2,1296,0,1397,0,2,1399,T
1-PB2,1297,0,0,0,1397,1397,C
1-PB2,1298,1383,0,0,0,1383,A
1-PB2,1299,0,1,1421,0,1422,G
1-PB2,1300,0,0,0,1429,1429,C
1-PB2,1301,0,1420,0,4,1424,T
1-PB2,1302,0,1418,0,0,1418,T
1-PB2,1303,0,1412,0,0,1412,T
1-PB2,1304,0,1414,0,0,1414,T
1-PB2,1305,1415,0,0,0,1415,A
1-PB2,1306,1412,1,0,0,1413,A
1-PB2,1307,1,2,1412,0,1415,G
1-PB2,1308,1,0,1402,0,1403,G
1-PB2,1309,0,0,0,1400,1400,C
1-PB2,1310,1395,0,0,0,1395,A
1-PB2,1311,0,1397,0,1,1398,T
1-PB2,1312,0,1399,0,0,1399,T
1-PB2,1313,0,1396,0,3,1399,T
1-PB2,1314,0,1404,1,0,1405,T
1-PB2,1315,2,2,0,1403,1407,C
1-PB2,1316,1402,1,1,1,1405,A
1-PB2,1317,1,0,1403,0,1404,G
1-PB2,1318,1403,0,0,0,1403,A
1-PB2,1319,1400,0,0,0,1400,A
1-PB2,1320,1400,0,0,0,1400,A
1-PB2,1321,0,0,1413,0,1413,G
1-PB2,1322,1428,0,2,0,1430,A
1-PB2,1323,0,1429,0,2,1431,T
1-PB2,1324,1,0,1431,0,1432,G
1-PB2,1325,0,0,0,1435,1435,C
1-PB2,1326,0,0,1436,0,1436,G
1-PB2,1327,1439,0,1,0,1440,A
1-PB2,1328,1433,0,1,0,1434,A
1-PB2,1329,1438,0,1,0,1439,A
1-PB2,1330,0,0,1439,0,1439,G
1-PB2,1331,0,1428,0,4,1432,T
1-PB2,1332,0,0,1430,0,1430,G
1-PB2,1333,0,0,0,1424,1424,C
1-PB2,1334,0,1420,0,4,1424,T
1-PB2,1335,0,1423,0,0,1423,T
1-PB2,1336,0,1420,0,2,1422,T
1-PB2,1337,0,1418,0,3,1421,T
1-PB2,1338,0,1424,1,0,1425,T
1-PB2,1339,1,0,0,1422,1423,C
1-PB2,1340,1422,0,0,0,1422,A
1-PB2,1341,1433,0,1,0,1434,A
1-PB2,1342,1429,0,1,0,1430,A
1-PB2,1343,1436,0,1,0,1437,A
1-PB2,1344,1,1425,1,0,1427,T
1-PB2,1345,0,1430,1,1,1432,T
1-PB2,1346,1,1,1435,0,1437,G
1-PB2,1347,1,2,1433,0,1436,G
1-PB2,1348,1,0,1434,2,1437,G
1-PB2,1349,0,3,1457,1,1461,G
1-PB2,1350,1451,0,3,0,1454,A
1-PB2,1351,0,1,1493,0,1494,G
1-PB2,1352,1,1487,0,2,1490,T
1-PB2,1353,0,1487,0,0,1487,T
1-PB2,1354,2,3,1488,1,1494,G
1-PB2,1355,1495,0,2,1,1498,A
1-PB2,1356,1498,0,1,0,1499,A
1-PB2,1357,0,1,0,1541,1542,C
1-PB2,1358,1522,0,2,0,1524,A
1-PB2,1359,1,0,0,1562,1563,C
1-PB2,1360,1545,0,0,0,1545,A
1-PB2,1361,0,1548,0,3,1551,T
1-PB2,1362,0,1,0,1562,1563,C
1-PB2,1363,2,0,1553,0,1555,G
1-PB2,1364,1569,0,2,0,1571,A
1-PB2,1365,1,0,0,1570,1571,C
1-PB2,1366,1527,0,1,0,1528,A
1-PB2,1367,0,0,1592,0,1592,G
1-PB2,1368,0,1556,0,0,1556,T
1-PB2,1369,1,0,1584,0,1585,G
1-PB2,1370,0,1576,0,0,1576,T
1-PB2,1371,0,0,1582,0,1582,G
1-PB2,1372,1582,0,1,0,1583,A
1-PB2,1373,0,1572,0,1,1573,T
1-PB2,1374,0,3,1576,0,1579,G
1-PB2,1375,0,2,1575,1,1578,G
1-PB2,1376,0,3,1554,0,1557,G
1-PB2,1377,1548,1,2,0,1551,A
1-PB2,1378,1533,0,0,0,1533,A
1-PB2,1379,0,1551,0,1,1552,T
1-PB2,1380,0,1,1567,0,1568,G
1-PB2,1381,1579,0,1,0,1580,A
1-PB2,1382,0,1582,0,0,1582,T
1-PB2,1383,0,1577,0,2,1579,T
1-PB2,1384,0,2,1572,0,1574,G
1-PB2,1385,1,2,1608,0,1611,G
1-PB2,1386,1600,1,1,1,1603,A
1-PB2,1387,0,1,1625,0,1626,G
1-PB2,1388,0,1612,0,1,1613,T
1-PB2,1389,1611,0,1,0,1612,A
1-PB2,1390,0,1616,0,1,1617,T
1-PB2,1391,0,1623,0,0,1623,T
1-PB2,1392,1637,2,2,0,1641,A
1-PB2,1393,0,1,0,1640,1641,C
1-PB2,1394,1,2,0,1607,1610,C
1-PB2,1395,1592,0,0,0,1592,A
1-PB2,1396,0,1,1612,0,1613,G
1-PB2,1397,1669,0,0,0,1669,A
1-PB2,1398,0,1663,0,0,1663,T
1-PB2,1399,1654,0,1,0,1655,A
1-PB2,1400,0,1644,0,0,1644,T
1-PB2,1401,0,3,1629,0,1632,G
1-PB2,1402,1642,0,2,0,1644,A
1-PB2,1403,1,0,0,1664,1665,C
1-PB2,1404,0,1662,0,2,1664,T
1-PB2,1405,0,0,0,1668,1668,C
1-PB2,1406,1,0,0,1644,1645,C
1-PB2,1407,1650,2,1,1,1654,A
1-PB2,1408,1656,0,2,0,1658,A
1-PB2,1409,1,0,1704,0,1705,G
1-PB2,1410,0,0,0,1696,1696,C
1-PB2,1411,1700,0,0,0,1700,A
1-PB2,1412,0,1,0,1705,1706,C
1-PB2,1413,1685,2,3,0,1690,A
1-PB2,1414,0,0,1693,0,1693,G
1-PB2,1415,1679,0,2,0,1681,A
1-PB2,1416,0,1,1699,0,1700,G
1-PB2,1417,1706,0,4,0,1710,A
1-PB2,1418,0,1667,0,2,1669,T
1-PB2,1419,0,1,1684,0,1685,G
1-PB2,1420,0,1677,0,2,1679,T
1-PB2,1421,3,1,0,1672,1676,C
1-PB2,1422,1681,0,3,0,1684,A
1-PB2,1423,1680,0,0,0,1680,A
1-PB2,1424,0,1684,0,0,1684,T
1-PB2,1425,1,3,1672,0,1676,G
1-PB2,1426,1662,0,1,0,1663,A
1-PB2,1427,0,1,1676,0,1677,G
1-PB2,1428,1661,0,2,0,1663,A
1-PB2,1429,0,2,1665,0,1667,G
1-PB2,1430,2,3,1744,0,1749,G
1-PB2,1431,1745,1,0,0,1746,A
1-PB2,1432,1745,0,5,0,1750,A
1-PB2,1433,0,1751,0,1,1752,T
1-PB2,1434,1745,0,1,0,1746,A
1-PB2,1435,1746,0,2,0,1748,A
1-PB2,1436,0,0,1745,0,1745,G
1-PB2,1437,1741,0,2,0,1743,A
1-PB2,1438,0,0,1746,0,1746,G
1-PB2,1439,0,1647,0,1,1648,T
1-PB2,1440,4,1,0,1646,1651,C
1-PB2,1441,1651,0,4,0,1655,A
1-PB2,1442,0,0,1670,0,1670,G
1-PB2,1443,0,2,0,1692,1694,C
1-PB2,1444,1689,0,0,0,1689,A
1-PB2,1445,1689,1,2,0,1692,A
1-PB2,1446,1681,0,1,0,1682,A
1-PB2,1447,1684,0,1,0,1685,A
1-PB2,1448,0,1678,0,0,1678,T
1-PB2,1449,1,1,1676,0,1678,G
1-PB2,1450,0,0,1698,0,1698,G
1-PB2,1451,1,0,1704,1,1706,G
1-PB2,1452,0,1673,0,3,1676,T
1-PB2,1453,1,0,1673,0,1674,G
1-PB2,1454,0,1676,0,1,1677,T
1-PB2,1455,0,1,1685,0,1686,G
1-PB2,1456,0,1,1714,0,1715,G
1-PB2,1457,1712,0,1,0,1713,A
1-PB2,1458,0,1706,0,0,1706,T
1-PB2,1459,2,3,1718,0,1723,G
1-PB2,1460,1718,0,2,0,1720,A
1-PB2,1461,1720,1,4,1,1726,A
1-PB2,1462,1,1724,0,0,1725,T
1-PB2,1463,1715,0,1,0,1716,A
1-PB2,1464,1,0,0,1847,1848,C
1-PB2,1465,2,1791,0,1,1794,T
1-PB2,1466,4,0,0,1837,1841,C
1-PB2,1467,1,1,0,1839,1841,C
1-PB2,1468,1833,1,4,0,1838,A
1-PB2,1469,0,0,1928,0,1928,G
1-PB2,1470,0,1921,0,1,1922,T
1-PB2,1471,1939,0,0,0,1939,A
1-PB2,1472,2,0,0,1945,1947,C
1-PB2,1473,1802,0,2,0,1804,A
1-PB2,1474,2,1,1808,1,1812,G
1-PB2,1475,1754,0,11,1,1766,A
1-PB2,1476,0,1,1774,0,1775,G
1-PB2,1477,1737,1,1,0,1739,A
1-PB2,1478,1,4,1678,0,1683,G
1-PB2,1479,1,3,1676,0,1680,G
1-PB2,1480,0,0,1683,0,1683,G
1-PB2,1481,0,1658,0,1,1659,T
1-PB2,1482,0,5,1651,0,1656,G
1-PB2,1483,0,2,1661,0,1663,G
1-PB2,1484,1,1653,0,2,1656,T
1-PB2,1485,0,1,1710,0,1711,G
1-PB2,1486,0,1,1714,0,1715,G
1-PB2,1487,0,1680,0,2,1682,T
1-PB2,1488,0,1678,0,1,1679,T
1-PB2,1489,1668,0,1,0,1669,A
1-PB2,1490,0,1,1690,0,1691,G
1-PB2,1491,1,1,0,1688,1690,C
1-PB2,1492,1677,0,0,0,1677,A
1-PB2,1493,0,1668,1,2,1671,T
1-PB2,1494,0,1596,0,0,1596,T
1-PB2,1495,1,3,1598,0,1602,G
1-PB2,1496,1596,1,0,0,1597,A
1-PB2,1497,0,1596,0,1,1597,T
1-PB2,1498,1,0,0,1595,1596,C
1-PB2,1499,0,0,1593,0,1593,G
1-PB2,1500,0,1,1627,0,1628,G
1-PB2,1501,0,1628,0,0,1628,T
1-PB2,1502,0,1618,0,1,1619,T
1-PB2,1503,0,1625,0,2,1627,T
1-PB2,1504,0,1624,0,0,1624,T
1-PB2,1505,0,1625,0,0,1625,T
1-PB2,1506,1,2,1622,0,1625,G
1-PB2,1507,1625,0,2,0,1627,A
1-PB2,1508,1,3,1627,0,1631,G
1-PB2,1509,1588,0,2,0,1590,A
1-PB2,1510,1,0,1601,0,1602,G
1-PB2,1511,0,1600,0,1,1601,T
1-PB2,1512,0,1597,0,1,1598,T
1-PB2,1513,0,1,0,1599,1600,C
1-PB2,1514,0,2,1600,0,1602,G
1-PB2,1515,1602,0,7,0,1609,A
1-PB2,1516,0,4,1599,0,1603,G
1-PB2,1517,1603,0,4,0,1607,A
1-PB2,1518,0,0,0,1601,1601,C
1-PB2,1519,0,1,0,1595,1596,C
1-PB2,1520,1582,0,0,0,1582,A
1-PB2,1521,1600,0,3,1,1604,A
1-PB2,1522,0,2,0,1617,1619,C
1-PB2,1523,1,0,1624,0,1625,G
1-PB2,1524,0,1612,0,1,1613,T
1-PB2,1525,0,1,1612,0,1613,G
1-PB2,1526,0,0,1623,0,1623,G
1-PB2,1527,2,4,1620,0,1626,G
1-PB2,1528,1612,1,2,0,1615,A
1-PB2,1529,1620,0,0,0,1620,A
1-PB2,1530,0,1573,0,0,1573,T
1-PB2,1531,0,0,1682,0,1682,G
1-PB2,1532,0,1675,0,0,1675,T
1-PB2,1533,1686,0,0,0,1686,A
1-PB2,1534,1,1691,0,0,1692,T
1-PB2,1535,0,1665,0,0,1665,T
1-PB2,1536,1680,1,3,0,1684,A
1-PB2,1537,0,1678,0,0,1678,T
1-PB2,1538,0,1662,0,0,1662,T
1-PB2,1539,1662,0,1,0,1663,A
1-PB2,1540,0,1495,0,1,1496,T
1-PB2,1541,1,0,0,1548,1549,C
1-PB2,1542,1,1531,1,4,1537,T
1-PB2,1543,0,0,0,1545,1545,C
1-PB2,1544,0,2,0,1543,1545,C
1-PB2,1545,3,1496,0,1,1500,T
1-PB2,1546,1,2,1502,0,1505,G
1-PB2,1547,1492,0,1,0,1493,A
1-PB2,1548,1,1,1499,0,1501,G
1-PB2,1549,0,3,1492,0,1495,G
1-PB2,1550,1362,2,0,0,1364,A
1-PB2,1551,1,1,1377,0,1379,G
1-PB2,1552,2,3,1366,0,1371,G
1-PB2,1553,0,1324,0,1,1325,T
1-PB2,1554,2,1,0,1327,1330,C
1-PB2,1555,1323,0,1,0,1324,A
1-PB2,1556,0,0,1345,0,1345,G
1-PB2,1557,1,1343,0,1,1345,T
1-PB2,1558,0,3,1335,2,1340,G
1-PB2,1559,1343,0,2,0,1345,A
1-PB2,1560,1293,0,3,0,1296,A
1-PB2,1561,1310,0,1,0,1311,A
1-PB2,1562,0,0,0,1312,1312,C
1-PB2,1563,1315,0,0,0,1315,A
1-PB2,1564,0,0,0,1318,1318,C
1-PB2,1565,1261,0,1,0,1262,A
1-PB2,1566,0,3,1262,0,1265,G
1-PB2,1567,0,2,1261,0,1263,G
1-PB2,1568,1,5,1280,1,1287,G
1-PB2,1569,1289,0,0,0,1289,A
1-PB2,1570,1278,0,4,0,1282,A
1-PB2,1571,0,0,0,1296,1296,C
1-PB2,1572,1,1283,0,0,1284,T
1-PB2,1573,3,2,1281,0,1286,G
1-PB2,1574,1276,0,1,0,1277,A
1-PB2,1575,1,2,1281,0,1284,G
1-PB2,1576,1266,0,2,0,1268,A
1-PB2,1577,0,2,1220,0,1222,G
1-PB2,1578,1217,1,3,1,1222,A
1-PB2,1579,1,0,0,1217,1218,C
1-PB2,1580,0,1182,0,0,1182,T
1-PB2,1581,0,2,1203,0,1205,G
1-PB2,1582,1202,0,3,0,1205,A
1-PB2,1583,2,0,0,1207,1209,C
1-PB2,1584,1202,0,1,0,1203,A
1-PB2,1585,1200,0,4,0,1204,A
1-PB2,1586,0,1205,0,0,1205,T
1-PB2,1587,1214,0,0,0,1214,A
1-PB2,1588,1215,0,0,0,1215,A
1-PB2,1589,1,0,0,1216,1217,C
1-PB2,1590,1,1156,0,1,1158,T
1-PB2,1591,0,1145,0,1,1146,T
1-PB2,1592,1135,0,0,0,1135,A
1-PB2,1593,0,1130,0,2,1132,T
1-PB2,1594,0,1131,0,0,1131,T
1-PB2,1595,2,0,0,1126,1128,C
1-PB2,1596,1075,1,0,0,1076,A
1-PB2,1597,1,1077,0,0,1078,T
1-PB2,1598,0,0,0,1045,1045,C
1-PB2,1599,2,1,1046,0,1049,G
1-PB2,1600,0,1058,0,0,1058,T
1-PB2,1601,1,1,0,1046,1048,C
1-PB2,1602,0,0,1044,0,1044,G
1-PB2,1603,1050,0,0,0,1050,A
1-PB2,1604,0,1051,1,0,1052,T
1-PB2,1605,0,0,1053,0,1053,G
1-PB2,1606,1056,0,2,0,1058,A
1-PB2,1607,0,1059,0,0,1059,T
1-PB2,1608,1,0,1054,0,1055,G
1-PB2,1609,1,1031,0,2,1034,T
1-PB2,1610,0,0,1032,1,1033,G
1-PB2,1611,1,2,1037,0,1040,G
1-PB2,1612,0,0,1043,0,1043,G
1-PB2,1613,1031,0,0,0,1031,A
1-PB2,1614,0,1,1036,0,1037,G
1-PB2,1615,991,0,2,0,993,A
1-PB2,1616,0,971,0,0,971,T
1-PB2,1617,0,962,0,0,962,T
1-PB2,1618,960,0,0,0,960,A
1-PB2,1619,962,0,1,0,963,A
1-PB2,1620,0,1,1,956,958,C
1-PB2,1621,0,0,929,0,929,G
1-PB2,1622,0,0,961,0,961,G
1-PB2,1623,0,912,0,0,912,T
1-PB2,1624,0,0,0,905,905,C
1-PB2,1625,0,1,0,902,903,C
1-PB2,1626,0,879,0,0,879,T
1-PB2,1627,0,0,891,0,891,G
1-PB2,1628,890,0,2,0,892,A
1-PB2,1629,0,0,894,0,894,G
1-PB2,1630,0,894,0,0,894,T
1-PB2,1631,1,0,0,870,871,C
1-PB2,1632,0,1,870,0,871,G
1-PB2,1633,1,0,888,0,889,G
1-PB2,1634,0,888,0,1,889,T
1-PB2,1635,0,887,0,0,887,T
1-PB2,1636,0,885,0,0,885,T
1-PB2,1637,0,884,0,1,885,T
1-PB2,1638,0,0,907,0,907,G
1-PB2,1639,0,0,915,0,915,G
1-PB2,1640,0,912,0,0,912,T
1-PB2,1641,0,0,0,910,910,C
1-PB2,1642,895,0,0,1,896,A
1-PB2,1643,927,0,1,0,928,A
1-PB2,1644,0,929,0,0,929,T
1-PB2,1645,934,0,0,0,934,A
1-PB2,1646,0,1,0,952,953,C
1-PB2,1647,1,0,0,928,929,C
1-PB2,1648,0,917,2,2,921,T
1-PB2,1649,931,0,0,0,931,A
1-PB2,1650,0,924,0,3,927,T
1-PB2,1651,1,0,0,926,927,C
1-PB2,1652,895,0,0,0,895,A
1-PB2,1653,897,0,0,0,897,A
1-PB2,1654,0,894,0,0,894,T
1-PB2,1655,0,0,867,0,867,G
1-PB2,1656,1,1,866,0,868,G
1-PB2,1657,859,0,0,0,859,A
1-PB2,1658,0,845,0,0,845,T
1-PB2,1659,0,0,0,840,840,C
1-PB2,1660,840,0,0,0,840,A
1-PB2,1661,0,841,0,0,841,T
1-PB2,1662,0,0,0,840,840,C
1-PB2,1663,840,0,1,0,841,A
1-PB2,1664,0,1,846,0,847,G
1-PB2,1665,842,1,0,0,843,A
1-PB2,1666,846,0,1,0,847,A
1-PB2,1667,848,0,0,0,848,A
1-PB2,1668,0,849,0,0,849,T
1-PB2,1669,1,845,0,0,846,T
1-PB2,1670,0,0,849,0,849,G
1-PB2,1671,0,2,842,0,844,G
1-PB2,1672,0,1,847,0,848,G
1-PB2,1673,841,0,0,0,841,A
1-PB2,1674,836,0,3,0,839,A
1-PB2,1675,0,0,841,0,841,G
1-PB2,1676,0,0,0,836,836,C
1-PB2,1677,1,833,0,0,834,T
1-PB2,1678,1,0,850,0,851,G
1-PB2,1679,0,849,0,0,849,T
1-PB2,1680,4,0,0,842,846,C
1-PB2,1681,851,0,0,0,851,A
1-PB2,1682,855,0,0,0,855,A
1-PB2,1683,850,0,1,0,851,A
1-PB2,1684,857,0,0,0,857,A
1-PB2,1685,0,854,0,0,854,T
1-PB2,1686,0,855,0,0,855,T
1-PB2,1687,0,0,0,851,851,C
1-PB2,1688,847,0,1,0,848,A
1-PB2,1689,846,0,1,0,847,A
1-PB2,1690,0,848,0,0,848,T
1-PB2,1691,0,0,847,0,847,G
1-PB2,1692,0,0,855,0,855,G
1-PB2,1693,0,859,0,3,862,T
1-PB2,1694,2,0,0,863,865,C
1-PB2,1695,0,867,0,3,870,T
1-PB2,1696,0,0,0,872,872,C
1-PB2,1697,871,0,0,0,871,A
1-PB2,1698,0,0,871,0,871,G
1-PB2,1699,871,0,0,0,871,A
1-PB2,1700,882,0,0,0,882,A
1-PB2,1701,0,876,0,0,876,T
1-PB2,1702,0,0,0,859,859,C
1-PB2,1703,1,1,0,858,860,C
1-PB2,1704,0,860,0,1,861,T
1-PB2,1705,0,0,863,0,863,G
1-PB2,1706,0,0,0,865,865,C
1-PB2,1707,865,0,0,0,865,A
1-PB2,1708,872,0,0,0,872,A
1-PB2,1709,0,864,0,1,865,T
1-PB2,1710,0,0,885,0,885,G
1-PB2,1711,1,883,0,1,885,T
1-PB2,1712,0,863,0,0,863,T
1-PB2,1713,2,0,875,0,877,G
1-PB2,1714,0,873,0,2,875,T
1-PB2,1715,874,0,1,0,875,A
1-PB2,1716,0,4,1,869,874,C
1-PB2,1717,845,0,1,0,846,A
1-PB2,1718,860,0,1,0,861,A
1-PB2,1719,0,0,0,844,844,C
1-PB2,1720,834,0,0,0,834,A
1-PB2,1721,834,0,0,0,834,A
1-PB2,1722,814,0,0,0,814,A
1-PB2,1723,812,0,1,0,813,A
1-PB2,1724,0,815,0,0,815,T
1-PB2,1725,0,2,810,0,812,G
1-PB2,1726,3,1,808,1,813,G
1-PB2,1727,805,1,0,0,806,A
1-PB2,1728,808,1,0,0,809,A
1-PB2,1729,0,806,0,1,807,T
1-PB2,1730,0,806,0,0,806,T
1-PB2,1731,0,805,0,1,806,T
1-PB2,1732,0,4,802,0,806,G
1-PB2,1733,806,0,0,0,806,A
1-PB2,1734,807,0,0,0,807,A
1-PB2,1735,1,0,0,805,806,C
1-PB2,1736,0,0,0,785,785,C
1-PB2,1737,796,0,1,1,798,A
1-PB2,1738,0,802,0,1,803,T
1-PB2,1739,0,805,0,1,806,T
1-PB2,1740,0,802,0,1,803,T
1-PB2,1741,2,0,0,800,802,C
1-PB2,1742,805,0,1,0,806,A
1-PB2,1743,804,0,1,0,805,A
1-PB2,1744,0,804,0,0,804,T
1-PB2,1745,0,0,0,817,817,C
1-PB2,1746,1,799,0,0,800,T
1-PB2,1747,0,795,0,1,796,T
1-PB2,1748,0,799,0,0,799,T
1-PB2,1749,798,0,1,0,799,A
1-PB2,1750,0,0,800,0,800,G
1-PB2,1751,0,795,0,3,798,T
1-PB2,1752,0,0,0,821,821,C
1-PB2,1753,1,0,0,823,824,C
1-PB2,1754,2,0,0,806,808,C
1-PB2,1755,2,1,0,806,809,C
1-PB2,1756,807,0,0,0,807,A
1-PB2,1757,803,0,1,1,805,A
1-PB2,1758,0,0,815,0,815,G
1-PB2,1759,1,1,816,0,818,G
1-PB2,1760,0,1,0,819,820,C
1-PB2,1761,1,0,0,806,807,C
1-PB2,1762,804,0,1,0,805,A
1-PB2,1763,0,814,0,1,815,T
1-PB2,1764,0,814,0,0,814,T
1-PB2,1765,816,1,0,0,817,A
1-PB2,1766,1,0,815,0,816,G
1-PB2,1767,794,0,0,0,794,A
1-PB2,1768,822,1,0,0,823,A
1-PB2,1769,0,0,840,0,840,G
1-PB2,1770,0,0,0,832,832,C
1-PB2,1771,1,1,0,834,836,C
1-PB2,1772,827,0,0,1,828,A
1-PB2,1773,832,0,1,0,833,A
1-PB2,1774,0,845,0,0,845,T
1-PB2,1775,852,1,2,0,855,A
1-PB2,1776,0,0,0,855,855,C
1-PB2,1777,801,0,0,0,801,A
1-PB2,1778,0,0,806,0,806,G
1-PB2,1779,0,791,1,1,793,T
1-PB2,1780,0,1,794,0,795,G
1-PB2,1781,1,2,792,0,795,G
1-PB2,1782,0,0,801,0,801,G
1-PB2,1783,0,792,0,3,795,T
1-PB2,1784,0,791,0,0,791,T
1-PB2,1785,0,792,0,0,792,T
1-PB2,1786,1,0,803,0,804,G
1-PB2,1787,1,800,0,1,802,T
1-PB2,1788,2,0,0,802,804,C
1-PB2,1789,787,1,0,0,788,A
1-PB2,1790,0,1,790,1,792,G
1-PB2,1791,788,0,1,0,789,A
1-PB2,1792,788,1,0,0,789,A
1-PB2,1793,0,0,0,787,787,C
1-PB2,1794,0,772,0,1,773,T
1-PB2,1795,0,0,0,798,798,C
1-PB2,1796,0,802,0,0,802,T
1-PB2,1797,803,0,1,0,804,A
1-PB2,1798,1,800,0,0,801,T
1-PB2,1799,0,795,0,1,796,T
1-PB2,1800,2,2,0,788,792,C
1-PB2,1801,1,0,0,788,789,C
1-PB2,1802,790,0,0,0,790,A
1-PB2,1803,792,0,0,0,792,A
1-PB2,1804,1,0,0,786,787,C
1-PB2,1805,775,0,0,0,775,A
1-PB2,1806,773,0,0,0,773,A
1-PB2,1807,774,0,0,0,774,A
1-PB2,1808,1,776,0,0,777,T
1-PB2,1809,1,1,775,0,777,G
1-PB2,1810,769,1,2,0,772,A
1-PB2,1811,0,0,784,0,784,G
1-PB2,1812,779,0,3,0,782,A
1-PB2,1813,1,1,782,0,784,G
1-PB2,1814,784,0,0,0,784,A
1-PB2,1815,1,0,0,777,778,C
1-PB2,1816,0,0,783,0,783,G
1-PB2,1817,0,792,0,0,792,T
1-PB2,1818,797,0,1,0,798,A
1-PB2,1819,0,1,0,801,802,C
1-PB2,1820,0,792,0,0,792,T
1-PB2,1821,0,795,0,0,795,T
1-PB2,1822,0,0,787,0,787,G
1-PB2,1823,1,0,786,0,787,G
1-PB2,1824,4,2,775,0,781,G
1-PB2,1825,778,0,0,0,778,A
1-PB2,1826,0,1,0,786,787,C
1-PB2,1827,783,0,0,0,783,A
1-PB2,1828,0,783,0,0,783,T
1-PB2,1829,0,779,0,0,779,T
1-PB2,1830,0,782,1,0,783,T
1-PB2,1831,0,2,784,0,786,G
1-PB2,1832,785,0,2,0,787,A
1-PB2,1833,0,1,0,784,785,C
1-PB2,1834,780,0,0,0,780,A
1-PB2,1835,1,0,0,780,781,C
1-PB2,1836,2,0,0,769,771,C
1-PB2,1837,773,0,0,0,773,A
1-PB2,1838,0,1,0,774,775,C
1-PB2,1839,1,0,0,776,777,C
1-PB2,1840,0,0,0,778,778,C
1-PB2,1841,773,1,0,0,774,A
1-PB2,1842,0,0,788,1,789,G
1-PB2,1843,786,1,1,0,788,A
1-PB2,1844,0,818,0,0,818,T
1-PB2,1845,816,0,0,0,816,A
1-PB2,1846,808,0,1,0,809,A
1-PB2,1847,0,808,0,0,808,T
1-PB2,1848,802,0,0,0,802,A
1-PB2,1849,800,0,0,0,800,A
1-PB2,1850,799,0,0,0,799,A
1-PB2,1851,0,0,813,0,813,G
1-PB2,1852,0,0,0,808,808,C
1-PB2,1853,0,775,0,1,776,T
1-PB2,1854,0,776,0,2,778,T
1-PB2,1855,0,1,0,780,781,C
1-PB2,1856,1,774,0,2,777,T
1-PB2,1857,1,0,0,781,782,C
1-PB2,1858,0,0,0,781,781,C
1-PB2,1859,0,0,0,778,778,C
1-PB2,1860,1,0,0,767,768,C
1-PB2,1861,0,780,0,0,780,T
1-PB2,1862,0,782,0,0,782,T
1-PB2,1863,0,780,0,0,780,T
1-PB2,1864,0,0,782,0,782,G
1-PB2,1865,0,1,0,783,784,C
1-PB2,1866,775,0,2,0,777,A
1-PB2,1867,0,0,776,0,776,G
1-PB2,1868,0,0,0,773,773,C
1-PB2,1869,0,764,0,0,764,T
1-PB2,1870,0,1,766,0,767,G
1-PB2,1871,0,1,0,766,767,C
1-PB2,1872,0,762,0,3,765,T
1-PB2,1873,3,1,0,767,771,C
1-PB2,1874,2,0,0,775,777,C
1-PB2,1875,780,0,2,0,782,A
1-PB2,1876,0,0,0,780,780,C
1-PB2,1877,1,0,0,775,776,C
1-PB2,1878,777,0,1,0,778,A
1-PB2,1879,785,0,0,0,785,A
1-PB2,1880,782,0,1,0,783,A
1-PB2,1881,0,0,789,0,789,G
1-PB2,1882,0,0,0,793,793,C
1-PB2,1883,780,0,1,0,781,A
1-PB2,1884,780,0,2,0,782,A
1-PB2,1885,780,1,2,0,783,A
1-PB2,1886,0,0,801,0,801,G
1-PB2,1887,1,1,0,802,804,C
1-PB2,1888,789,0,1,0,790,A
1-PB2,1889,0,2,789,0,791,G
1-PB2,1890,783,0,1,0,784,A
1-PB2,1891,796,0,1,0,797,A
1-PB2,1892,0,797,0,0,797,T
1-PB2,1893,1,0,798,0,799,G
1-PB2,1894,0,0,0,800,800,C
1-PB2,1895,782,0,0,0,782,A
1-PB2,1896,0,1,790,0,791,G
1-PB2,1897,0,789,0,2,791,T
1-PB2,1898,0,816,0,0,816,T
1-PB2,1899,1,4,0,810,815,C
1-PB2,1900,0,800,0,1,801,T
1-PB2,1901,0,0,0,801,801,C
1-PB2,1902,1,803,0,0,804,T
1-PB2,1903,0,804,0,0,804,T
1-PB2,1904,0,0,0,807,807,C
1-PB2,1905,797,1,0,0,798,A
1-PB2,1906,1,0,0,795,796,C
1-PB2,1907,0,767,0,0,767,T
1-PB2,1908,0,1,780,0,781,G
1-PB2,1909,781,0,0,0,781,A
1-PB2,1910,0,1,0,795,796,C
1-PB2,1911,0,780,0,2,782,T
1-PB2,1912,0,0,788,0,788,G
1-PB2,1913,0,783,0,0,783,T
1-PB2,1914,0,1,792,0,793,G
1-PB2,1915,789,0,2,0,791,A
1-PB2,1916,806,0,1,0,807,A
1-PB2,1917,0,792,0,0,792,T
1-PB2,1918,0,0,793,0,793,G
1-PB2,1919,0,763,0,2,765,T
1-PB2,1920,750,0,1,0,751,A
1-PB2,1921,757,0,1,0,758,A
1-PB2,1922,2,1,757,0,760,G
1-PB2,1923,0,1,762,0,763,G
1-PB2,1924,0,0,756,0,756,G
1-PB2,1925,0,0,766,0,766,G
1-PB2,1926,761,2,1,0,764,A
1-PB2,1927,0,760,0,1,761,T
1-PB2,1928,1,0,0,760,761,C
1-PB2,1929,762,0,1,0,763,A
1-PB2,1930,0,1,777,0,778,G
1-PB2,1931,1,0,777,0,778,G
1-PB2,1932,0,1,780,0,781,G
1-PB2,1933,779,0,0,0,779,A
1-PB2,1934,0,764,0,0,764,T
1-PB2,1935,0,2,762,0,764,G
1-PB2,1936,762,1,1,0,764,A
1-PB2,1937,0,1,783,0,784,G
1-PB2,1938,784,0,0,0,784,A
1-PB2,1939,762,0,0,0,762,A
1-PB2,1940,1,765,0,0,766,T
1-PB2,1941,755,1,0,0,756,A
1-PB2,1942,1,1,0,768,770,C
1-PB2,1943,0,763,0,1,764,T
1-PB2,1944,0,762,0,0,762,T
1-PB2,1945,0,0,762,0,762,G
1-PB2,1946,0,737,0,0,737,T
1-PB2,1947,737,0,0,0,737,A
1-PB2,1948,735,0,0,0,735,A
1-PB2,1949,0,0,724,0,724,G
1-PB2,1950,0,0,729,0,729,G
1-PB2,1951,0,0,720,0,720,G
1-PB2,1952,0,1,722,0,723,G
1-PB2,1953,0,0,0,726,726,C
1-PB2,1954,724,0,0,0,724,A
1-PB2,1955,739,0,0,0,739,A
1-PB2,1956,0,737,0,2,739,T
1-PB2,1957,0,738,0,1,739,T
1-PB2,1958,0,0,0,755,755,C
1-PB2,1959,0,733,0,2,735,T
1-PB2,1960,0,0,0,753,753,C
1-PB2,1961,1,0,0,750,751,C
1-PB2,1962,0,739,0,4,743,T
1-PB2,1963,1,0,773,0,774,G
1-PB2,1964,0,757,0,0,757,T
1-PB2,1965,759,0,1,0,760,A
1-PB2,1966,0,761,0,0,761,T
1-PB2,1967,0,748,0,0,748,T
1-PB2,1968,0,0,0,753,753,C
1-PB2,1969,750,0,1,0,751,A
1-PB2,1970,757,0,2,0,759,A
1-PB2,1971,0,0,0,759,759,C
1-PB2,1972,0,742,0,1,743,T
1-PB2,1973,748,0,0,1,749,A
1-PB2,1974,0,0,1,766,767,C
1-PB2,1975,762,2,2,0,766,A
1-PB2,1976,763,0,0,0,763,A
1-PB2,1977,1,0,0,764,765,C
1-PB2,1978,759,0,0,0,759,A
1-PB2,1979,758,0,0,0,758,A
1-PB2,1980,1,3,754,0,758,G
1-PB2,1981,758,0,0,0,758,A
1-PB2,1982,1,0,0,759,760,C
1-PB2,1983,2,0,0,738,740,C
1-PB2,1984,738,0,1,1,740,A
1-PB2,1985,0,0,0,758,758,C
1-PB2,1986,0,758,0,0,758,T
1-PB2,1987,756,0,0,0,756,A
1-PB2,1988,756,0,0,0,756,A
1-PB2,1989,754,0,0,0,754,A
1-PB2,1990,752,0,1,0,753,A
1-PB2,1991,0,1,761,0,762,G
1-PB2,1992,756,0,0,0,756,A
1-PB2,1993,0,0,0,759,759,C
1-PB2,1994,0,732,0,0,732,T
1-PB2,1995,732,0,0,0,732,A
1-PB2,1996,733,0,1,0,734,A
1-PB2,1997,0,0,0,733,733,C
1-PB2,1998,731,1,0,0,732,A
1-PB2,1999,728,1,0,0,729,A
1-PB2,2000,0,719,1,0,720,T
1-PB2,2001,0,716,0,0,716,T
1-PB2,2002,2,1,1,713,717,C
1-PB2,2003,1,716,0,0,717,T
1-PB2,2004,1,0,0,717,718,C
1-PB2,2005,0,1,717,0,718,G
1-PB2,2006,0,0,723,0,723,G
1-PB2,2007,719,1,0,0,720,A
1-PB2,2008,719,0,0,0,719,A
1-PB2,2009,719,1,0,0,720,A
1-PB2,2010,719,1,0,0,720,A
1-PB2,2011,0,0,724,0,724,G
1-PB2,2012,723,0,0,0,723,A
1-PB2,2013,0,722,0,0,722,T
1-PB2,2014,0,0,723,0,723,G
1-PB2,2015,0,0,0,718,718,C
1-PB2,2016,0,1,0,716,717,C
1-PB2,2017,1,0,715,0,716,G
1-PB2,2018,0,0,716,0,716,G
1-PB2,2019,0,0,0,712,712,C
1-PB2,2020,718,0,0,0,718,A
1-PB2,2021,0,0,0,732,732,C
1-PB2,2022,0,727,0,0,727,T
1-PB2,2023,0,729,0,0,729,T
1-PB2,2024,1,727,0,1,729,T
1-PB2,2025,730,0,1,0,731,A
1-PB2,2026,733,0,0,1,734,A
1-PB2,2027,0,735,0,0,735,T
1-PB2,2028,0,733,0,0,733,T
1-PB2,2029,0,0,732,0,732,G
1-PB2,2030,713,0,2,0,715,A
1-PB2,2031,714,1,2,0,717,A
1-PB2,2032,0,2,715,0,717,G
1-PB2,2033,724,0,1,0,725,A
1-PB2,2034,1,0,0,717,718,C
1-PB2,2035,0,0,0,715,715,C
1-PB2,2036,2,0,0,715,717,C
1-PB2,2037,712,0,0,0,712,A
1-PB2,2038,2,0,728,0,730,G
1-PB2,2039,730,0,1,0,731,A
1-PB2,2040,0,728,0,2,730,T
1-PB2,2041,0,0,731,0,731,G
1-PB2,2042,711,0,0,0,711,A
1-PB2,2043,709,0,4,0,713,A
1-PB2,2044,714,0,1,0,715,A
1-PB2,2045,0,0,715,0,715,G
1-PB2,2046,0,1,0,708,709,C
1-PB2,2047,694,0,2,0,696,A
1-PB2,2048,1,0,0,696,697,C
1-PB2,2049,696,0,1,1,698,A
1-PB2,2050,0,694,0,0,694,T
1-PB2,2051,0,0,0,706,706,C
1-PB2,2052,0,13,0,687,700,C
1-PB2,2053,0,0,702,0,702,G
1-PB2,2054,0,1,705,1,707,G
1-PB2,2055,701,0,0,0,701,A
1-PB2,2056,0,0,703,0,703,G
1-PB2,2057,0,686,0,1,687,T
1-PB2,2058,0,0,686,0,686,G
1-PB2,2059,0,1,685,0,686,G
1-PB2,2060,672,0,1,0,673,A
1-PB2,2061,0,1,674,0,675,G
1-PB2,2062,0,667,0,1,668,T
1-PB2,2063,0,1,0,662,663,C
1-PB2,2064,1,0,0,658,659,C
1-PB2,2065,0,0,659,0,659,G
1-PB2,2066,0,0,0,655,655,C
1-PB2,2067,0,0,0,654,654,C
1-PB2,2068,1,0,676,0,677,G
1-PB2,2069,0,677,0,1,678,T
1-PB2,2070,0,0,0,686,686,C
1-PB2,2071,0,683,1,1,685,T
1-PB2,2072,0,686,0,0,686,T
1-PB2,2073,0,1,683,0,684,G
1-PB2,2074,676,1,0,0,677,A
1-PB2,2075,1,0,681,0,682,G
1-PB2,2076,678,0,3,0,681,A
1-PB2,2077,0,0,665,0,665,G
1-PB2,2078,0,3,665,0,668,G
1-PB2,2079,0,1,671,0,672,G
1-PB2,2080,0,671,0,0,671,T
1-PB2,2081,0,672,0,0,672,T
1-PB2,2082,0,678,0,1,679,T
1-PB2,2083,1,0,0,680,681,C
1-PB2,2084,0,676,0,1,677,T
1-PB2,2085,1,0,0,691,692,C
1-PB2,2086,691,0,0,0,691,A
1-PB2,2087,0,684,0,0,684,T
1-PB2,2088,0,685,0,0,685,T
1-PB2,2089,687,0,0,0,687,A
1-PB2,2090,0,689,0,0,689,T
1-PB2,2091,680,0,1,0,681,A
1-PB2,2092,0,1,685,0,686,G
1-PB2,2093,0,0,687,0,687,G
1-PB2,2094,0,643,0,1,644,T
1-PB2,2095,641,0,1,1,643,A
1-PB2,2096,640,0,0,0,640,A
1-PB2,2097,0,1,642,0,643,G
1-PB2,2098,0,0,646,1,647,G
1-PB2,2099,642,0,0,0,642,A
1-PB2,2100,629,0,0,0,629,A
1-PB2,2101,0,2,629,0,631,G
1-PB2,2102,627,0,1,0,628,A
1-PB2,2103,0,0,0,630,630,C
1-PB2,2104,619,0,0,0,619,A
1-PB2,2105,0,0,623,0,623,G
1-PB2,2106,613,0,0,0,613,A
1-PB2,2107,606,0,1,1,608,A
1-PB2,2108,0,1,604,0,605,G
1-PB2,2109,0,1,594,0,595,G
1-PB2,2110,0,612,0,0,612,T
1-PB2,2111,614,0,1,0,615,A
1-PB2,2112,0,1,0,614,615,C
1-PB2,2113,0,0,611,0,611,G
1-PB2,2114,2,3,614,0,619,G
1-PB2,2115,617,0,2,0,619,A
1-PB2,2116,1,0,0,611,612,C
1-PB2,2117,5,0,0,609,614,C
1-PB2,2118,590,0,1,0,591,A
1-PB2,2119,0,0,615,0,615,G
1-PB2,2120,1,0,0,616,617,C
1-PB2,2121,619,0,0,0,619,A
1-PB2,2122,0,616,0,0,616,T
1-PB2,2123,0,582,0,0,582,T
1-PB2,2124,582,0,0,0,582,A
1-PB2,2125,581,0,0,0,581,A
1-PB2,2126,0,0,583,0,583,G
1-PB2,2127,0,0,0,580,580,C
1-PB2,2128,538,1,0,0,539,A
1-PB2,2129,0,554,0,1,555,T
1-PB2,2130,0,0,0,553,553,C
1-PB2,2131,550,0,0,0,550,A
1-PB2,2132,551,1,1,0,553,A
1-PB2,2133,0,548,0,1,549,T
1-PB2,2134,0,2,548,0,550,G
1-PB2,2135,546,0,1,0,547,A
1-PB2,2136,544,0,0,0,544,A
1-PB2,2137,0,0,0,552,552,C
1-PB2,2138,0,514,0,0,514,T
1-PB2,2139,0,0,525,0,525,G
1-PB2,2140,518,0,1,0,519,A
1-PB2,2141,1,0,519,0,520,G
1-PB2,2142,0,519,0,0,519,T
1-PB2,2143,512,0,1,0,513,A
1-PB2,2144,518,0,1,0,519,A
1-PB2,2145,0,0,0,521,521,C
1-PB2,2146,0,0,0,508,508,C
1-PB2,2147,0,507,0,0,507,T
1-PB2,2148,0,479,0,1,480,T
1-PB2,2149,1,0,479,0,480,G
1-PB2,2150,0,0,0,478,478,C
1-PB2,2151,476,0,0,0,476,A
1-PB2,2152,480,0,0,0,480,A
1-PB2,2153,470,0,0,0,470,A
1-PB2,2154,460,0,3,0,463,A
1-PB2,2155,0,0,468,0,468,G
1-PB2,2156,0,0,466,0,466,G
1-PB2,2157,0,0,464,0,464,G
1-PB2,2158,0,1,466,0,467,G
1-PB2,2159,464,0,2,0,466,A
1-PB2,2160,465,0,0,0,465,A
1-PB2,2161,466,0,0,0,466,A
1-PB2,2162,465,0,2,0,467,A
1-PB2,2163,0,0,466,0,466,G
1-PB2,2164,0,0,465,0,465,G
1-PB2,2165,1,0,0,462,463,C
1-PB2,2166,0,459,0,0,459,T
1-PB2,2167,459,0,0,0,459,A
1-PB2,2168,459,0,0,0,459,A
1-PB2,2169,1,459,0,0,460,T
1-PB2,2170,0,0,464,0,464,G
1-PB2,2171,0,444,0,0,444,T
1-PB2,2172,0,0,439,0,439,G
1-PB2,2173,0,0,1,436,437,C
1-PB2,2174,0,432,0,0,432,T
1-PB2,2175,432,0,1,0,433,A
1-PB2,2176,432,0,0,0,432,A
1-PB2,2177,0,432,0,1,433,T
1-PB2,2178,0,0,0,433,433,C
1-PB2,2179,0,0,405,0,405,G
1-PB2,2180,0,0,411,0,411,G
1-PB2,2181,0,0,411,0,411,G
1-PB2,2182,1,0,0,410,411,C
1-PB2,2183,409,0,0,0,409,A
1-PB2,2184,406,0,0,0,406,A
1-PB2,2185,0,0,404,0,404,G
1-PB2,2186,0,2,406,1,409,G
1-PB2,2187,408,0,2,0,410,A
1-PB2,2188,0,0,408,0,408,G
1-PB2,2189,395,0,0,0,395,A
1-PB2,2190,0,0,0,395,395,C
1-PB2,2191,0,0,393,0,393,G
1-PB2,2192,1,390,0,1,392,T
1-PB2,2193,0,0,395,0,395,G
1-PB2,2194,0,0,394,0,394,G
1-PB2,2195,0,389,0,0,389,T
1-PB2,2196,0,0,390,0,390,G
1-PB2,2197,0,386,0,1,387,T
1-PB2,2198,0,385,0,0,385,T
1-PB2,2199,0,0,381,0,381,G
1-PB2,2200,0,0,382,0,382,G
1-PB2,2201,0,382,0,0,382,T
1-PB2,2202,376,0,0,0,376,A
1-PB2,2203,365,0,0,0,365,A
1-PB2,2204,0,362,0,0,362,T
1-PB2,2205,0,0,357,0,357,G
1-PB2,2206,355,0,1,0,356,A
1-PB2,2207,353,0,0,0,353,A
1-PB2,2208,350,0,0,0,350,A
1-PB2,2209,0,0,0,350,350,C
1-PB2,2210,0,0,349,0,349,G
1-PB2,2211,350,0,1,0,351,A
1-PB2,2212,350,0,0,0,350,A
1-PB2,2213,348,0,1,0,349,A
1-PB2,2214,350,0,0,0,350,A
1-PB2,2215,0,0,0,350,350,C
1-PB2,2216,0,0,345,0,345,G
1-PB2,2217,0,2,345,0,347,G
1-PB2,2218,0,0,347,0,347,G
1-PB2,2219,346,0,0,0,346,A
1-PB2,2220,0,0,0,346,346,C
1-PB2,2221,0,342,0,1,343,T
1-PB2,2222,2,0,0,348,350,C
1-PB2,2223,0,349,0,0,349,T
1-PB2,2224,352,0,0,0,352,A
1-PB2,2225,0,0,352,0,352,G
1-PB2,2226,0,1,0,347,348,C
1-PB2,2227,348,0,0,0,348,A
1-PB2,2228,0,345,0,0,345,T
1-PB2,2229,335,0,0,0,335,A
1-PB2,2230,0,0,0,344,344,C
1-PB2,2231,0,298,0,1,299,T
1-PB2,2232,0,300,0,0,300,T
1-PB2,2233,299,0,0,0,299,A
1-PB2,2234,0,0,0,299,299,C
1-PB2,2235,0,296,0,1,297,T
1-PB2,2236,0,1,295,0,296,G
1-PB2,2237,288,0,1,0,289,A
1-PB2,2238,0,0,0,289,289,C
1-PB2,2239,265,0,0,0,265,A
1-PB2,2240,0,0,265,0,265,G
1-PB2,2241,0,0,0,268,268,C
1-PB2,2242,0,0,0,268,268,C
1-PB2,2243,263,0,0,0,263,A
1-PB2,2244,0,0,263,0,263,G
1-PB2,2245,263,0,0,0,263,A
1-PB2,2246,0,0,0,263,263,C
1-PB2,2247,242,0,0,0,242,A
1-PB2,2248,0,0,242,0,242,G
1-PB2,2249,0,0,0,232,232,C
1-PB2,2250,0,2,228,0,230,G
1-PB2,2251,229,0,0,0,229,A
1-PB2,2252,0,0,0,229,229,C
1-PB2,2253,0,0,0,226,226,C
1-PB2,2254,226,0,0,0,226,A
1-PB2,2255,227,0,0,0,227,A
1-PB2,2256,227,0,0,0,227,A
1-PB2,2257,226,0,0,0,226,A
1-PB2,2258,0,0,227,0,227,G
1-PB2,2259,220,0,0,0,220,A
1-PB2,2260,219,0,1,0,220,A
1-PB2,2261,0,219,0,0,219,T
1-PB2,2262,0,218,0,0,218,T
1-PB2,2263,0,0,0,218,218,C
1-PB2,2264,0,0,211,0,211,G
1-PB2,2265,0,0,212,0,212,G
1-PB2,2266,212,0,0,0,212,A
1-PB2,2267,0,199,0,0,199,T
1-PB2,2268,0,0,199,0,199,G
1-PB2,2269,0,0,198,0,198,G
1-PB2,2270,0,0,0,197,197,C
1-PB2,2271,0,1,0,197,198,C
1-PB2,2272,195,0,1,1,197,A
1-PB2,2273,0,196,0,0,196,T
1-PB2,2274,0,0,0,196,196,C
1-PB2,2275,194,0,0,0,194,A
1-PB2,2276,194,0,0,0,194,A
1-PB2,2277,0,193,0,0,193,T
1-PB2,2278,0,170,0,0,170,T
1-PB2,2279,161,0,0,0,161,A
1-PB2,2280,162,0,0,0,162,A
2-PB1,1,149,0,0,0,149,A
2-PB1,2,0,151,0,0,151,T
2-PB1,3,0,0,154,0,154,G
2-PB1,4,0,0,173,0,173,G
2-PB1,5,187,0,0,0,187,A
2-PB1,6,0,198,0,0,198,T
2-PB1,7,1,0,198,0,199,G
2-PB1,8,0,198,0,1,199,T
2-PB1,9,0,0,0,216,216,C
2-PB1,10,216,0,0,0,216,A
2-PB1,11,228,0,0,0,228,A
2-PB1,12,0,228,0,0,228,T
2-PB1,13,0,0,0,230,230,C
2-PB1,14,0,1,0,242,243,C
2-PB1,15,0,1,244,0,245,G
2-PB1,16,278,0,0,0,278,A
2-PB1,17,0,0,0,281,281,C
2-PB1,18,0,279,0,0,279,T
2-PB1,19,0,0,0,324,324,C
2-PB1,20,0,324,0,1,325,T
2-PB1,21,327,0,0,0,327,A
2-PB1,22,0,0,0,329,329,C
2-PB1,23,0,328,0,1,329,T
2-PB1,24,0,0,364,0,364,G
2-PB1,25,0,367,0,0,367,T
2-PB1,26,0,366,0,0,366,T
2-PB1,27,0,0,0,366,366,C
2-PB1,28,0,0,0,366,366,C
2-PB1,29,0,415,0,0,415,T
2-PB1,30,420,0,0,0,420,A
2-PB1,31,419,0,0,0,419,A
2-PB1,32,422,0,1,0,423,A
2-PB1,33,0,0,419,0,419,G
2-PB1,34,1,1,422,0,424,G
2-PB1,35,0,433,0,0,433,T
2-PB1,36,0,433,0,1,434,T
2-PB1,37,0,1,0,432,433,C
2-PB1,38,0,0,0,432,432,C
2-PB1,39,434,0,0,0,434,A
2-PB1,40,1,0,439,0,440,G
2-PB1,41,0,0,0,440,440,C
2-PB1,42,1,0,442,0,443,G
2-PB1,43,0,0,0,445,445,C
2-PB1,44,446,0,0,0,446,A
2-PB1,45,445,0,0,0,445,A
2-PB1,46,445,0,0,0,445,A
2-PB1,47,446,0,1,0,447,A
2-PB1,48,0,449,0,0,449,T
2-PB1,49,0,0,465,0,465,G
2-PB1,50,0,0,0,467,467,C
2-PB1,51,1,0,0,469,470,C
2-PB1,52,472,0,1,0,473,A
2-PB1,53,0,474,0,0,474,T
2-PB1,54,508,0,0,0,508,A
2-PB1,55,508,0,0,1,509,A
2-PB1,56,0,0,523,0,523,G
2-PB1,57,1,0,0,522,523,C
2-PB1,58,520,0,0,0,520,A
2-PB1,59,0,1,0,536,537,C
2-PB1,60,536,0,0,0,536,A
2-PB1,61,567,0,1,0,568,A
2-PB1,62,0,0,0,570,570,C
2-PB1,63,567,0,0,0,567,A
2-PB1,64,0,572,0,0,572,T
2-PB1,65,0,566,0,1,567,T
2-PB1,66,0,0,0,726,726,C
2-PB1,67,0,0,0,727,727,C
2-PB1,68,2,0,0,736,738,C
2-PB1,69,0,742,0,1,743,T
2-PB1,70,0,741,0,0,741,T
2-PB1,71,815,0,0,0,815,A
2-PB1,72,0,819,0,0,819,T
2-PB1,73,823,1,0,0,824,A
2-PB1,74,0,0,0,834,834,C
2-PB1,75,0,803,0,2,805,T
2-PB1,76,0,0,820,0,820,G
2-PB1,77,0,3,819,0,822,G
2-PB1,78,821,0,2,0,823,A
2-PB1,79,0,0,823,0,823,G
2-PB1,80,818,0,0,0,818,A
2-PB1,81,1,819,0,1,821,T
2-PB1,82,0,0,0,881,881,C
2-PB1,83,1,0,0,883,884,C
2-PB1,84,0,885,0,1,886,T
2-PB1,85,2,0,0,935,937,C
2-PB1,86,2,0,0,943,945,C
2-PB1,87,950,0,0,1,951,A
2-PB1,88,0,953,0,0,953,T
2-PB1,89,953,0,0,0,953,A
2-PB1,90,0,0,0,953,953,C
2-PB1,91,944,0,0,0,944,A
2-PB1,92,0,0,981,0,981,G
2-PB1,93,0,0,0,987,987,C
2-PB1,94,1,0,0,975,976,C
2-PB1,95,980,0,0,0,980,A
2-PB1,96,0,979,0,0,979,T
2-PB1,97,0,2,979,0,981,G
2-PB1,98,0,2,1032,0,1034,G
2-PB1,99,1037,0,4,0,1041,A
2-PB1,100,1042,0,2,0,1044,A
2-PB1,101,2,0,0,1044,1046,C
2-PB1,102,1036,0,1,0,1037,A
2-PB1,103,0,1,1061,0,1062,G
2-PB1,104,0,4,1074,0,1078,G
2-PB1,105,1075,0,2,1,1078,A
2-PB1,106,1088,0,0,0,1088,A
2-PB1,107,0,0,0,1092,1092,C
2-PB1,108,1090,0,1,0,1091,A
2-PB1,109,0,2,1202,0,1204,G
2-PB1,110,0,7,1194,0,1201,G
2-PB1,111,0,1,1216,1,1218,G
2-PB1,112,0,1221,0,0,1221,T
2-PB1,113,1220,0,0,0,1220,A
2-PB1,114,0,0,0,1235,1235,C
2-PB1,115,1266,1,2,0,1269,A
2-PB1,116,2,0,0,1321,1323,C
2-PB1,117,2,1,0,1315,1318,C
2-PB1,118,1269,0,2,0,1271,A
2-PB1,119,0,1264,0,3,1267,T
2-PB1,120,1,2,1265,0,1268,G
2-PB1,121,1,4,1261,0,1266,G
2-PB1,122,1265,0,1,0,1266,A
2-PB1,123,0,1,0,1263,1264,C
2-PB1,124,1249,0,1,0,1250,A
2-PB1,125,1,0,0,1282,1283,C
2-PB1,126,1288,1,1,0,1290,A
2-PB1,127,0,0,1320,0,1320,G
2-PB1,128,0,1312,0,4,1316,T
2-PB1,129,1,1,0,1358,1360,C
2-PB1,130,1357,0,0,0,1357,A
2-PB1,131,1370,1,0,0,1371,A
2-PB1,132,0,0,0,1373,1373,C
2-PB1,133,1365,1,0,0,1366,A
2-PB1,134,1,1,1382,0,1384,G
2-PB1,135,1361,0,1,0,1362,A
2-PB1,136,1353,0,3,0,1356,A
2-PB1,137,1,1,0,1356,1358,C
2-PB1,138,1330,1,1,0,1332,A
2-PB1,139,0,0,0,1329,1329,C
2-PB1,140,1327,0,1,0,1328,A
2-PB1,141,0,1309,1,0,1310,T
2-PB1,142,4,0,0,1418,1422,C
2-PB1,143,1427,0,2,0,1429,A
2-PB1,144,1444,0,1,0,1445,A
2-PB1,145,0,1465,0,0,1465,T
2-PB1,146,1510,0,1,0,1511,A
2-PB1,147,0,1513,0,0,1513,T
2-PB1,148,0,1491,0,1,1492,T
2-PB1,149,4,0,0,1492,1496,C
2-PB1,150,1478,0,2,0,1480,A
2-PB1,151,2,0,1476,0,1478,G
2-PB1,152,1470,0,1,0,1471,A
2-PB1,153,0,1,1472,0,1473,G
2-PB1,154,1442,0,7,0,1449,A
2-PB1,155,1,2,1412,0,1415,G
2-PB1,156,1,2,1414,0,1417,G
2-PB1,157,0,2,1471,0,1473,G
2-PB1,158,0,5,1466,1,1472,G
2-PB1,159,0,2,1482,0,1484,G
2-PB1,160,1479,0,3,0,1482,A
2-PB1,161,1484,0,1,0,1485,A
2-PB1,162,0,1,1491,0,1492,G
2-PB1,163,0,1479,0,2,1481,T
2-PB1,164,1,1,1474,0,1476,G
2-PB1,165,0,2,1468,0,1470,G
2-PB1,166,1468,1,2,0,1471,A
2-PB1,167,0,1,0,1471,1472,C
2-PB1,168,1,2,1464,0,1467,G
2-PB1,169,1477,0,1,0,1478,A
2-PB1,170,0,0,0,1484,1484,C
2-PB1,171,1481,0,0,0,1481,A
2-PB1,172,1485,0,1,0,1486,A
2-PB1,173,1499,0,0,0,1499,A
2-PB1,174,0,1521,0,0,1521,T
2-PB1,175,1527,0,1,0,1528,A
2-PB1,176,0,2,0,1528,1530,C
2-PB1,177,1515,0,3,0,1518,A
2-PB1,178,0,0,1525,0,1525,G
2-PB1,179,1518,0,0,0,1518,A
2-PB1,180,1532,1,1,0,1534,A
2-PB1,181,1533,0,0,0,1533,A
2-PB1,182,1,0,0,1532,1533,C
2-PB1,183,0,1521,0,1,1522,T
2-PB1,184,1,1,1514,0,1516,G
2-PB1,185,1,2,1508,0,1511,G
2-PB1,186,0,3,1512,0,1515,G
2-PB1,187,1,1,1513,0,1515,G
2-PB1,188,0,2,0,1516,1518,C
2-PB1,189,1507,0,0,0,1507,A
2-PB1,190,0,1,0,1555,1556,C
2-PB1,191,1,2,0,1550,1553,C
2-PB1,192,3,0,0,1551,1554,C
2-PB1,193,0,2,0,1561,1563,C
2-PB1,194,1567,0,1,0,1568,A
2-PB1,195,1581,0,0,0,1581,A
2-PB1,196,0,0,0,1581,1581,C
2-PB1,197,0,1578,0,0,1578,T
2-PB1,198,3,1,0,1578,1582,C
2-PB1,199,1538,0,0,1,1539,A
2-PB1,200,1560,0,1,0,1561,A
2-PB1,201,1,0,0,1563,1564,C
2-PB1,202,1,0,1,1564,1566,C
2-PB1,203,0,0,0,1568,1568,C
2-PB1,204,1568,0,1,1,1570,A
2-PB1,205,1577,1,0,0,1578,A
2-PB1,206,0,1576,0,0,1576,T
2-PB1,207,0,1572,0,0,1572,T
2-PB1,208,0,1,1573,0,1574,G
2-PB1,209,1559,0,0,0,1559,A
2-PB1,210,0,1557,0,2,1559,T
2-PB1,211,2,3,1558,0,1563,G
2-PB1,212,0,3,1577,0,1580,G
2-PB1,213,1586,0,1,0,1587,A
2-PB1,214,0,0,0,1596,1596,C
2-PB1,215,1,1,0,1591,1593,C
2-PB1,216,1571,0,11,0,1582,A
2-PB1,217,1,0,0,1617,1618,C
2-PB1,218,0,1618,0,0,1618,T
2-PB1,219,1632,1,0,0,1633,A
2-PB1,220,1,1,0,1638,1640,C
2-PB1,221,0,1,0,1626,1627,C
2-PB1,222,0,1611,0,4,1615,T
2-PB1,223,1,1,1622,0,1624,G
2-PB1,224,1624,0,0,0,1624,A
2-PB1,225,0,2,1639,0,1641,G
2-PB1,226,1,2,1634,0,1637,G
2-PB1,227,1639,0,0,0,1639,A
2-PB1,228,0,1636,0,0,1636,T
2-PB1,229,1612,0,0,0,1612,A
2-PB1,230,1607,0,4,1,1612,A
2-PB1,231,0,1610,0,0,1610,T
2-PB1,232,0,2,1610,0,1612,G
2-PB1,233,1615,2,1,0,1618,A
2-PB1,234,1602,0,2,0,1604,A
2-PB1,235,1,0,0,1601,1602,C
2-PB1,236,3,1,1,1574,1579,C
2-PB1,237,1580,0,1,0,1581,A
2-PB1,238,1586,0,0,0,1586,A
2-PB1,239,1,0,1593,0,1594,G
2-PB1,240,1,1587,0,1,1589,T
2-PB1,241,1,0,1588,0,1589,G
2-PB1,242,0,3,1605,0,1608,G
2-PB1,243,1605,1,1,0,1607,A
2-PB1,244,0,1603,0,0,1603,T
2-PB1,245,1607,0,2,0,1609,A
2-PB1,246,0,1634,0,1,1635,T
2-PB1,247,2,2,1640,0,1644,G
2-PB1,248,0,0,0,1647,1647,C
2-PB1,249,1640,0,2,0,1642,A
2-PB1,250,2,0,0,1678,1680,C
2-PB1,251,1651,1,0,0,1652,A
2-PB1,252,1679,2,0,0,1681,A
2-PB1,253,1681,0,3,0,1684,A
2-PB1,254,1,0,0,1684,1685,C
2-PB1,255,1632,1,0,0,1633,A
2-PB1,256,0,3,1657,1,1661,G
2-PB1,257,1649,0,3,0,1652,A
2-PB1,258,0,1,0,1648,1649,C
2-PB1,259,1,1590,0,3,1594,T
2-PB1,260,1,0,1625,0,1626,G
2-PB1,261,0,1607,0,1,1608,T
2-PB1,262,1,0,1685,1,1687,G
2-PB1,263,0,1684,0,2,1686,T
2-PB1,264,1,0,0,1682,1683,C
2-PB1,265,3,0,0,1678,1681,C
2-PB1,266,1,1676,0,0,1677,T
2-PB1,267,0,0,1669,0,1669,G
2-PB1,268,2,0,1667,0,1669,G
2-PB1,269,1647,0,0,0,1647,A
2-PB1,270,0,0,1668,0,1668,G
2-PB1,271,0,0,1637,0,1637,G
2-PB1,272,1,1,0,1641,1643,C
2-PB1,273,1,1626,0,4,1631,T
2-PB1,274,1632,1,2,0,1635,A
2-PB1,275,0,1631,0,0,1631,T
2-PB1,276,1,3,1623,0,1627,G
2-PB1,277,2,0,1623,0,1625,G
2-PB1,278,0,0,0,1619,1619,C
2-PB1,279,0,1,0,1592,1593,C
2-PB1,280,0,1574,0,2,1576,T
2-PB1,281,0,1651,0,1,1652,T
2-PB1,282,1,1,0,1657,1659,C
2-PB1,283,1,0,0,1654,1655,C
2-PB1,284,0,1659,0,0,1659,T
2-PB1,285,0,1656,0,1,1657,T
2-PB1,286,0,2,1666,0,1668,G
2-PB1,287,1669,0,1,0,1670,A
2-PB1,288,1669,0,1,0,1670,A
2-PB1,289,0,0,1676,1,1677,G
2-PB1,290,1607,0,0,0,1607,A
2-PB1,291,1612,0,1,0,1613,A
2-PB1,292,1,1605,0,1,1607,T
2-PB1,293,1,1,0,1611,1613,C
2-PB1,294,1,0,0,1605,1606,C
2-PB1,295,4,1,0,1593,1598,C
2-PB1,296,1600,0,2,0,1602,A
2-PB1,297,3,0,0,1602,1605,C
2-PB1,298,1,0,0,1597,1598,C
2-PB1,299,5,1,0,1593,1599,C
2-PB1,300,1594,0,2,0,1596,A
2-PB1,301,1,0,1613,1,1615,G
2-PB1,302,1,2,1617,1,1621,G
2-PB1,303,0,1613,0,0,1613,T
2-PB1,304,1618,0,0,0,1618,A
2-PB1,305,1,1609,0,2,1612,T
2-PB1,306,3,0,0,1607,1610,C
2-PB1,307,1,1610,0,2,1613,T
2-PB1,308,0,1610,0,1,1611,T
2-PB1,309,0,1606,1,0,1607,T
2-PB1,310,0,2,1602,0,1604,G
2-PB1,311,1582,0,3,0,1585,A
2-PB1,312,1,4,1580,1,1586,G
2-PB1,313,1584,1,1,0,1586,A
2-PB1,314,1586,0,0,0,1586,A
2-PB1,315,0,0,0,1596,1596,C
2-PB1,316,0,1581,0,1,1582,T
2-PB1,317,2,0,0,1585,1587,C
2-PB1,318,1583,0,1,0,1584,A
2-PB1,319,0,1584,0,1,1585,T
2-PB1,320,0,0,1586,0,1586,G
2-PB1,321,0,0,0,1610,1610,C
2-PB1,322,2,0,0,1606,1608,C
2-PB1,323,0,1604,0,1,1605,T
2-PB1,324,0,1596,0,0,1596,T
2-PB1,325,0,1,1594,0,1595,G
2-PB1,326,1605,0,2,0,1607,A
2-PB1,327,1605,0,1,0,1606,A
2-PB1,328,1608,1,2,0,1611,A
2-PB1,329,1,0,0,1620,1621,C
2-PB1,330,1589,2,2,0,1593,A
2-PB1,331,1601,0,2,0,1603,A
2-PB1,332,0,1601,0,1,1602,T
2-PB1,333,1,2,1596,0,1599,G
2-PB1,334,1,0,1599,0,1600,G
2-PB1,335,1573,1,1,0,1575,A
2-PB1,336,1572,0,2,0,1574,A
2-PB1,337,2,0,1569,0,1571,G
2-PB1,338,0,1,0,1580,1581,C
2-PB1,339,6,0,1,1558,1565,C
2-PB1,340,0,0,1586,0,1586,G
2-PB1,341,0,1576,0,3,1579,T
2-PB1,342,0,1579,0,3,1582,T
2-PB1,343,4,0,0,1589,1593,C
2-PB1,344,1591,0,2,0,1593,A
2-PB1,345,1613,0,0,0,1613,A
2-PB1,346,0,1,0,1615,1616,C
2-PB1,347,1612,0,0,0,1612,A
2-PB1,348,1,3,1625,0,1629,G
2-PB1,349,1600,1,7,0,1608,A
2-PB1,350,1,0,0,1609,1610,C
2-PB1,351,1607,0,0,0,1607,A
2-PB1,352,1616,0,2,0,1618,A
2-PB1,353,2,1,1626,0,1629,G
2-PB1,354,1,0,1611,0,1612,G
2-PB1,355,1,0,1621,0,1622,G
2-PB1,356,0,1588,0,2,1590,T
2-PB1,357,2,1,1586,0,1589,G
2-PB1,358,0,1,1586,0,1587,G
2-PB1,359,1586,1,1,0,1588,A
2-PB1,360,0,1,0,1585,1586,C
2-PB1,361,1547,0,0,0,1547,A
2-PB1,362,1571,0,0,1,1572,A
2-PB1,363,1567,0,1,0,1568,A
2-PB1,364,2,0,0,1565,1567,C
2-PB1,365,2,1556,0,1,1559,T
2-PB1,366,1565,0,0,0,1565,A
2-PB1,367,1574,0,1,0,1575,A
2-PB1,368,2,0,0,1578,1580,C
2-PB1,369,0,0,0,1575,1575,C
2-PB1,370,0,1,0,1573,1574,C
2-PB1,371,1545,0,0,0,1545,A
2-PB1,372,1544,0,1,0,1545,A
2-PB1,373,0,0,1541,0,1541,G
2-PB1,374,0,0,1543,0,1543,G
2-PB1,375,0,1537,0,1,1538,T
2-PB1,376,5,0,0,1525,1530,C
2-PB1,377,2,0,1523,0,1525,G
2-PB1,378,0,0,0,1522,1522,C
2-PB1,379,0,0,0,1530,1530,C
2-PB1,380,1532,0,0,0,1532,A
2-PB1,381,0,1,1557,0,1558,G
2-PB1,382,1580,0,1,0,1581,A
2-PB1,383,0,0,0,1586,1586,C
2-PB1,384,0,1582,0,1,1583,T
2-PB1,385,0,1580,0,1,1581,T
2-PB1,386,1585,0,0,0,1585,A
2-PB1,387,0,1585,0,0,1585,T
2-PB1,388,0,2,1585,0,1587,G
2-PB1,389,1586,0,0,0,1586,A
2-PB1,390,0,1553,0,0,1553,T
2-PB1,391,0,1508,0,0,1508,T
2-PB1,392,0,2,1497,0,1499,G
2-PB1,393,1,2,1502,0,1505,G
2-PB1,394,1520,1,3,0,1524,A
2-PB1,395,0,0,0,1524,1524,C
2-PB1,396,1503,0,0,0,1503,A
2-PB1,397,1,1485,0,0,1486,T
2-PB1,398,0,1501,0,0,1501,T
2-PB1,399,1512,1,0,0,1513,A
2-PB1,400,1507,0,1,0,1508,A
2-PB1,401,1509,0,2,0,1511,A
2-PB1,402,2,1,0,1510,1513,C
2-PB1,403,1478,0,1,0,1479,A
2-PB1,404,1,1,1490,0,1492,G
2-PB1,405,1488,0,1,0,1489,A
2-PB1,406,1484,0,0,0,1484,A
2-PB1,407,1484,0,1,0,1485,A
2-PB1,408,0,1469,0,1,1470,T
2-PB1,409,1,1,0,1472,1474,C
2-PB1,410,1469,0,1,0,1470,A
2-PB1,411,1470,0,0,0,1470,A
2-PB1,412,0,0,0,1471,1471,C
2-PB1,413,1,2,0,1456,1459,C
2-PB1,414,3,1,1454,0,1458,G
2-PB1,415,2,0,1461,0,1463,G
2-PB1,416,1,0,1,1465,1467,C
2-PB1,417,1467,0,1,0,1468,A
2-PB1,418,1,1,1462,0,1464,G
2-PB1,419,0,2,0,1467,1469,C
2-PB1,420,1467,0,0,0,1467,A
2-PB1,421,1468,0,1,0,1469,A
2-PB1,422,0,0,0,1474,1474,C
2-PB1,423,0,1466,0,2,1468,T
2-PB1,424,0,0,1529,0,1529,G
2-PB1,425,1,0,0,1521,1522,C
2-PB1,426,1522,1,1,0,1524,A
2-PB1,427,0,1522,0,0,1522,T
2-PB1,428,0,1508,0,0,1508,T
2-PB1,429,1564,1,3,0,1568,A
2-PB1,430,0,0,1570,0,1570,G
2-PB1,431,0,0,0,1563,1563,C
2-PB1,432,1,1,0,1557,1559,C
2-PB1,433,1497,0,1,0,1498,A
2-PB1,434,1506,1,2,0,1509,A
2-PB1,435,2,1,0,1511,1514,C
2-PB1,436,1510,0,2,0,1512,A
2-PB1,437,5,0,0,1541,1546,C
2-PB1,438,2,0,0,1458,1460,C
2-PB1,439,1456,1,3,0,1460,A
2-PB1,440,0,1462,0,0,1462,T
2-PB1,441,1461,0,0,0,1461,A
2-PB1,442,0,2,1452,0,1454,G
2-PB1,443,1440,0,0,0,1440,A
2-PB1,444,1437,0,1,1,1439,A
2-PB1,445,0,0,1448,0,1448,G
2-PB1,446,0,1402,1,0,1403,T
2-PB1,447,0,1410,0,1,1411,T
2-PB1,448,0,1397,0,3,1400,T
2-PB1,449,0,1410,0,0,1410,T
2-PB1,450,1,1410,0,0,1411,T
2-PB1,451,1410,0,0,0,1410,A
2-PB1,452,0,1,1415,0,1416,G
2-PB1,453,1411,2,0,0,1413,A
2-PB1,454,0,1404,0,1,1405,T
2-PB1,455,2,0,1,1369,1372,C
2-PB1,456,2,3,1371,0,1376,G
2-PB1,457,1374,0,1,0,1375,A
2-PB1,458,1380,0,0,0,1380,A
2-PB1,459,0,1,0,1387,1388,C
2-PB1,460,0,1,1389,0,1390,G
2-PB1,461,0,0,1452,0,1452,G
2-PB1,462,1452,0,3,0,1455,A
2-PB1,463,0,1448,0,3,1451,T
2-PB1,464,0,1446,0,2,1448,T
2-PB1,465,1454,0,0,0,1454,A
2-PB1,466,1453,0,0,0,1453,A
2-PB1,467,0,0,0,1452,1452,C
2-PB1,468,1443,0,2,0,1445,A
2-PB1,469,1,0,1473,0,1474,G
2-PB1,470,0,0,0,1409,1409,C
2-PB1,471,0,1403,0,0,1403,T
2-PB1,472,1409,0,0,1,1410,A
2-PB1,473,1404,0,2,0,1406,A
2-PB1,474,0,1405,0,0,1405,T
2-PB1,475,0,2,1429,0,1431,G
2-PB1,476,1415,1,0,0,1416,A
2-PB1,477,1423,1,1,0,1425,A
2-PB1,478,0,1399,0,1,1400,T
2-PB1,479,0,0,0,1408,1408,C
2-PB1,480,1395,0,4,0,1399,A
2-PB1,481,0,0,1401,0,1401,G
2-PB1,482,0,1,1399,0,1400,G
2-PB1,483,1401,0,2,0,1403,A
2-PB1,484,1375,1,0,0,1376,A
2-PB1,485,0,0,1449,0,1449,G
2-PB1,486,0,0,1463,0,1463,G
2-PB1,487,0,0,0,1461,1461,C
2-PB1,488,0,1461,0,1,1462,T
2-PB1,489,1459,2,1,0,1462,A
2-PB1,490,1457,1,1,1,1460,A
2-PB1,491,0,1462,0,0,1462,T
2-PB1,492,1460,0,1,0,1461,A
2-PB1,493,0,2,1462,0,1464,G
2-PB1,494,1371,0,0,0,1371,A
2-PB1,495,0,1347,0,1,1348,T
2-PB1,496,1,1333,0,0,1334,T
2-PB1,497,0,1335,0,2,1337,T
2-PB1,498,1,0,0,1371,1372,C
2-PB1,499,0,1,0,1376,1377,C
2-PB1,500,0,1369,0,1,1370,T
2-PB1,501,2,0,0,1378,1380,C
2-PB1,502,1374,0,0,0,1374,A
2-PB1,503,1378,0,1,0,1379,A
2-PB1,504,1,4,1380,0,1385,G
2-PB1,505,0,2,1398,0,1400,G
2-PB1,506,1396,0,3,0,1399,A
2-PB1,507,0,1341,0,0,1341,T
2-PB1,508,0,0,1348,0,1348,G
2-PB1,509,0,1345,0,1,1346,T
2-PB1,510,0,1,1350,0,1351,G
2-PB1,511,1352,0,2,0,1354,A
2-PB1,512,0,1349,0,0,1349,T
2-PB1,513,0,1,1345,0,1346,G
2-PB1,514,0,2,1349,0,1351,G
2-PB1,515,1342,0,7,0,1349,A
2-PB1,516,1349,1,2,0,1352,A
2-PB1,517,0,1340,0,0,1340,T
2-PB1,518,1,0,0,1352,1353,C
2-PB1,519,1334,0,0,0,1334,A
2-PB1,520,1334,0,1,0,1335,A
2-PB1,521,0,1336,0,0,1336,T
2-PB1,522,11,3,1339,0,1353,G
2-PB1,523,0,1,1361,0,1362,G
2-PB1,524,1352,1,1,0,1354,A
2-PB1,525,0,1351,0,1,1352,T
2-PB1,526,1352,0,1,0,1353,A
2-PB1,527,1341,0,1,0,1342,A
2-PB1,528,1337,0,2,0,1339,A
2-PB1,529,0,0,1363,0,1363,G
2-PB1,530,1359,1,1,0,1361,A
2-PB1,531,0,2,1349,0,1351,G
2-PB1,532,0,1,1336,0,1337,G
2-PB1,533,1325,0,1,0,1326,A
2-PB1,534,1332,0,0,0,1332,A
2-PB1,535,1334,0,1,0,1335,A
2-PB1,536,0,1331,0,2,1333,T
2-PB1,537,1,0,1351,0,1352,G
2-PB1,538,0,1,1344,0,1345,G
2-PB1,539,1329,1,0,0,1330,A
2-PB1,540,0,4,1330,0,1334,G
2-PB1,541,1323,0,1,0,1324,A
2-PB1,542,0,1341,0,1,1342,T
2-PB1,543,1342,0,1,0,1343,A
2-PB1,544,1353,0,3,0,1356,A
2-PB1,545,0,0,0,1363,1363,C
2-PB1,546,1341,0,0,0,1341,A
2-PB1,547,1344,0,1,0,1345,A
2-PB1,548,0,2,0,1339,1341,C
2-PB1,549,1334,0,1,0,1335,A
2-PB1,550,0,0,0,1341,1341,C
2-PB1,551,1304,1,1,1,1307,A
2-PB1,552,0,0,0,1310,1310,C
2-PB1,553,0,1290,0,4,1294,T
2-PB1,554,1,1291,1,0,1293,T
2-PB1,555,0,1290,0,2,1292,T
2-PB1,556,1,1,0,1293,1295,C
2-PB1,557,1297,0,1,0,1298,A
2-PB1,558,1297,0,0,0,1297,A
2-PB1,559,1298,0,2,0,1300,A
2-PB1,560,0,0,1319,0,1319,G
2-PB1,561,1304,0,1,0,1305,A
2-PB1,562,1305,0,1,0,1306,A
2-PB1,563,1311,0,0,0,1311,A
2-PB1,564,1311,0,0,0,1311,A
2-PB1,565,1308,0,4,0,1312,A
2-PB1,566,1,1,1315,0,1317,G
2-PB1,567,0,1,1316,0,1317,G
2-PB1,568,1295,0,5,0,1300,A
2-PB1,569,0,2,1320,0,1322,G
2-PB1,570,1316,0,6,0,1322,A
2-PB1,571,0,0,1373,0,1373,G
2-PB1,572,0,1367,0,0,1367,T
2-PB1,573,1369,1,0,0,1370,A
2-PB1,574,1363,1,4,1,1369,A
2-PB1,575,0,0,1368,0,1368,G
2-PB1,576,0,0,1366,0,1366,G
2-PB1,577,2,6,1356,0,1364,G
2-PB1,578,1330,1,4,0,1335,A
2-PB1,579,1,0,0,1341,1342,C
2-PB1,580,1315,0,1,0,1316,A
2-PB1,581,1318,0,2,0,1320,A
2-PB1,582,0,1,0,1316,1317,C
2-PB1,583,1316,1,2,0,1319,A
2-PB1,584,1,1309,0,2,1312,T
2-PB1,585,0,2,1301,0,1303,G
2-PB1,586,1300,0,2,0,1302,A
2-PB1,587,0,1,0,1303,1304,C
2-PB1,588,1,0,0,1288,1289,C
2-PB1,589,1284,0,2,0,1286,A
2-PB1,590,1292,0,2,0,1294,A
2-PB1,591,1,1,1299,0,1301,G
2-PB1,592,1301,0,1,1,1303,A
2-PB1,593,1302,0,0,0,1302,A
2-PB1,594,1291,0,0,0,1291,A
2-PB1,595,1289,0,0,0,1289,A
2-PB1,596,0,1288,0,1,1289,T
2-PB1,597,0,2,1287,0,1289,G
2-PB1,598,1,0,1293,1,1295,G
2-PB1,599,0,1278,0,1,1279,T
2-PB1,600,0,1,0,1265,1266,C
2-PB1,601,1274,0,4,0,1278,A
2-PB1,602,0,0,0,1345,1345,C
2-PB1,603,1360,0,0,0,1360,A
2-PB1,604,0,0,0,1366,1366,C
2-PB1,605,1360,0,0,0,1360,A
2-PB1,606,1419,0,1,0,1420,A
2-PB1,607,1407,0,3,1,1411,A
2-PB1,608,0,3,1459,0,1462,G
2-PB1,609,164,2,1220,0,1386,G
2-PB1,610,1449,0,2,0,1451,A
2-PB1,611,0,1,0,1479,1480,C
2-PB1,612,1484,0,2,0,1486,A
2-PB1,613,1494,0,0,0,1494,A
2-PB1,614,0,1483,0,1,1484,T
2-PB1,615,1468,1,2,0,1471,A
2-PB1,616,0,1,1470,0,1471,G
2-PB1,617,4,0,1413,0,1417,G
2-PB1,618,1,2,1420,0,1423,G
2-PB1,619,1416,0,0,0,1416,A
2-PB1,620,1398,1,1,0,1400,A
2-PB1,621,0,3,1412,1,1416,G
2-PB1,622,1406,0,1,0,1407,A
2-PB1,623,1411,1,0,0,1412,A
2-PB1,624,1414,0,1,0,1415,A
2-PB1,625,1413,0,0,1,1414,A
2-PB1,626,1442,0,1,0,1443,A
2-PB1,627,1447,0,1,0,1448,A
2-PB1,628,0,0,0,1453,1453,C
2-PB1,629,1451,0,0,0,1451,A
2-PB1,630,1451,0,0,0,1451,A
2-PB1,631,1437,0,2,0,1439,A
2-PB1,632,0,1,1470,0,1471,G
2-PB1,633,1469,0,2,0,1471,A
2-PB1,634,0,0,1530,0,1530,G
2-PB1,635,0,1506,0,4,1510,T
2-PB1,636,0,4,1688,0,1692,G
2-PB1,637,1696,1,2,0,1699,A
2-PB1,638,1700,0,0,0,1700,A
2-PB1,639,0,1727,0,0,1727,T
2-PB1,640,1726,1,0,0,1727,A
2-PB1,641,1726,0,0,0,1726,A
2-PB1,642,0,0,1731,0,1731,G
2-PB1,643,1686,0,7,0,1693,A
2-PB1,644,0,1,1702,0,1703,G
2-PB1,645,1580,1,10,1,1592,A
2-PB1,646,1,2,1595,0,1598,G
2-PB1,647,0,0,1601,0,1601,G
2-PB1,648,0,3,0,1600,1603,C
2-PB1,649,0,1595,1,1,1597,T
2-PB1,650,1646,0,0,0,1646,A
2-PB1,651,1,0,0,1713,1714,C
2-PB1,652,1,1,0,1725,1727,C
2-PB1,653,0,1739,0,1,1740,T
2-PB1,654,1798,0,0,0,1798,A
2-PB1,655,1789,1,0,0,1790,A
2-PB1,656,1,1791,0,0,1792,T
2-PB1,657,1788,0,0,0,1788,A
2-PB1,658,1784,0,0,0,1784,A
2-PB1,659,0,0,1805,0,1805,G
2-PB1,660,1737,1,7,0,1745,A
2-PB1,661,0,0,1757,0,1757,G
2-PB1,662,0,0,0,1757,1757,C
2-PB1,663,0,1722,0,6,1728,T
2-PB1,664,1,1716,0,6,1723,T
2-PB1,665,0,1732,0,0,1732,T
2-PB1,666,0,6,1730,0,1736,G
2-PB1,667,1761,0,1,0,1762,A
2-PB1,668,0,0,0,1768,1768,C
2-PB1,669,1756,0,1,0,1757,A
2-PB1,670,1,1744,0,6,1751,T
2-PB1,671,0,1737,0,2,1739,T
2-PB1,672,0,0,1766,0,1766,G
2-PB1,673,1757,0,2,0,1759,A
2-PB1,674,1759,1,3,0,1763,A
2-PB1,675,0,0,0,1770,1770,C
2-PB1,676,1759,0,2,0,1761,A
2-PB1,677,1,1,0,1762,1764,C
2-PB1,678,2,2,1755,0,1759,G
2-PB1,679,1763,0,3,0,1766,A
2-PB1,680,0,1763,0,0,1763,T
2-PB1,681,1,2,1790,0,1793,G
2-PB1,682,1791,1,3,0,1795,A
2-PB1,683,1,0,0,1795,1796,C
2-PB1,684,3,5,0,1782,1790,C
2-PB1,685,1793,0,1,0,1794,A
2-PB1,686,1808,1,1,0,1810,A
2-PB1,687,1807,0,1,0,1808,A
2-PB1,688,0,1,1852,0,1853,G
2-PB1,689,1863,0,4,1,1868,A
2-PB1,690,1,1833,0,3,1837,T
2-PB1,691,1,0,1844,0,1845,G
2-PB1,692,1,2,0,1832,1835,C
2-PB1,693,1829,0,3,0,1832,A
2-PB1,694,2,1,1844,0,1847,G
2-PB1,695,1827,1,1,0,1829,A
2-PB1,696,2,2,1832,0,1836,G
2-PB1,697,1784,0,4,1,1789,A
2-PB1,698,1,0,1769,0,1770,G
2-PB1,699,1740,0,4,0,1744,A
2-PB1,700,1,2,1744,0,1747,G
2-PB1,701,0,1,1741,0,1742,G
2-PB1,702,0,0,0,1738,1738,C
2-PB1,703,1730,0,0,0,1730,A
2-PB1,704,1729,0,0,0,1729,A
2-PB1,705,1741,0,2,0,1743,A
2-PB1,706,0,1752,0,0,1752,T
2-PB1,707,0,1752,1,1,1754,T
2-PB1,708,1756,0,1,0,1757,A
2-PB1,709,1751,0,1,1,1753,A
2-PB1,710,1757,0,1,0,1758,A
2-PB1,711,1762,0,1,0,1763,A
2-PB1,712,1767,0,1,0,1768,A
2-PB1,713,0,0,1770,0,1770,G
2-PB1,714,1763,1,0,0,1764,A
2-PB1,715,1750,0,4,0,1754,A
2-PB1,716,1,2,1786,0,1789,G
2-PB1,717,0,1,1827,0,1828,G
2-PB1,718,0,0,1827,0,1827,G
2-PB1,719,0,0,0,1842,1842,C
2-PB1,720,1,1834,0,3,1838,T
2-PB1,721,1799,0,53,0,1852,A
2-PB1,722,0,1872,0,2,1874,T
2-PB1,723,0,1869,0,2,1871,T
2-PB1,724,0,1,1874,0,1875,G
2-PB1,725,0,0,0,1866,1866,C
2-PB1,726,1785,0,7,0,1792,A
2-PB1,727,1790,0,0,0,1790,A
2-PB1,728,0,0,0,1788,1788,C
2-PB1,729,1782,0,1,0,1783,A
2-PB1,730,0,1,0,1788,1789,C
2-PB1,731,1,1,0,1747,1749,C
2-PB1,732,2,1,0,1746,1749,C
2-PB1,733,1,2,1748,0,1751,G
2-PB1,734,0,2,1752,0,1754,G
2-PB1,735,0,1,1755,0,1756,G
2-PB1,736,1769,1,1,0,1771,A
2-PB1,737,0,1755,0,3,1758,T
2-PB1,738,1,0,1760,0,1761,G
2-PB1,739,2,2,0,1752,1756,C
2-PB1,740,1790,1,0,0,1791,A
2-PB1,741,1812,0,1,0,1813,A
2-PB1,742,1827,1,0,0,1828,A
2-PB1,743,0,1836,0,1,1837,T
2-PB1,744,0,1837,0,1,1838,T
2-PB1,745,1829,0,2,2,1833,A
2-PB1,746,0,1,1832,0,1833,G
2-PB1,747,1815,0,7,0,1822,A
2-PB1,748,0,3,1832,0,1835,G
2-PB1,749,1,2,1792,0,1795,G
2-PB1,750,0,0,1834,0,1834,G
2-PB1,751,0,1819,0,2,1821,T
2-PB1,752,1,1813,0,1,1815,T
2-PB1,753,3,2,0,1821,1826,C
2-PB1,754,2,0,1852,0,1854,G
2-PB1,755,0,1850,0,2,1852,T
2-PB1,756,2,1,1853,0,1856,G
2-PB1,757,1,1839,0,1,1841,T
2-PB1,758,1832,0,1,0,1833,A
2-PB1,759,0,0,1,1825,1826,C
2-PB1,760,0,1725,1,3,1729,T
2-PB1,761,2,1729,0,1,1732,T
2-PB1,762,1,0,0,1721,1722,C
2-PB1,763,0,0,1704,0,1704,G
2-PB1,764,0,1700,0,1,1701,T
2-PB1,765,0,1695,0,5,1700,T
2-PB1,766,0,3,1695,0,1698,G
2-PB1,767,1693,1,1,0,1695,A
2-PB1,768,1696,1,2,0,1699,A
2-PB1,769,1703,0,1,3,1707,A
2-PB1,770,1,1,0,1712,1714,C
2-PB1,771,0,1702,0,1,1703,T
2-PB1,772,0,1687,0,1,1688,T
2-PB1,773,0,1692,1,0,1693,T
2-PB1,774,1711,0,1,0,1712,A
2-PB1,775,0,1,1712,0,1713,G
2-PB1,776,0,0,0,1722,1722,C
2-PB1,777,0,1718,0,2,1720,T
2-PB1,778,1700,0,0,0,1700,A
2-PB1,779,0,1,1694,0,1695,G
2-PB1,780,1697,0,1,0,1698,A
2-PB1,781,1694,0,0,0,1694,A
2-PB1,782,0,0,1704,0,1704,G
2-PB1,783,0,0,0,1666,1666,C
2-PB1,784,1666,0,1,0,1667,A
2-PB1,785,0,1655,0,0,1655,T
2-PB1,786,1,1656,0,0,1657,T
2-PB1,787,0,1656,0,1,1657,T
2-PB1,788,0,1,1659,0,1660,G
2-PB1,789,0,0,0,1660,1660,C
2-PB1,790,0,2,1661,0,1663,G
2-PB1,791,1659,0,1,0,1660,A
2-PB1,792,1650,1,0,0,1651,A
2-PB1,793,1649,1,0,0,1650,A
2-PB1,794,1690,0,1,0,1691,A
2-PB1,795,0,0,1707,0,1707,G
2-PB1,796,1,0,0,1703,1704,C
2-PB1,797,0,1698,0,5,1703,T
2-PB1,798,0,1704,0,0,1704,T
2-PB1,799,0,5,1694,0,1699,G
2-PB1,800,1706,0,2,0,1708,A
2-PB1,801,1698,0,5,0,1703,A
2-PB1,802,0,0,0,1714,1714,C
2-PB1,803,1654,1,0,0,1655,A
2-PB1,804,0,1,1796,0,1797,G
2-PB1,805,0,1776,0,3,1779,T
2-PB1,806,3,0,0,1771,1774,C
2-PB1,807,0,1769,1,3,1773,T
2-PB1,808,1,2,1778,0,1781,G
2-PB1,809,0,4,1779,0,1783,G
2-PB1,810,1786,1,0,0,1787,A
2-PB1,811,0,0,0,1794,1794,C
2-PB1,812,0,1736,0,1,1737,T
2-PB1,813,0,1637,0,1,1638,T
2-PB1,814,1,0,0,1635,1636,C
2-PB1,815,0,2,0,1638,1640,C
2-PB1,816,1,2,1645,0,1648,G
2-PB1,817,2,1,1642,0,1645,G
2-PB1,818,1,1638,0,0,1639,T
2-PB1,819,0,1636,0,0,1636,T
2-PB1,820,0,1,1629,0,1630,G
2-PB1,821,0,3,1630,0,1633,G
2-PB1,822,0,1,1646,0,1647,G
2-PB1,823,0,1,1641,0,1642,G
2-PB1,824,2,1,1641,0,1644,G
2-PB1,825,0,1627,0,2,1629,T
2-PB1,826,1603,0,1,0,1604,A
2-PB1,827,1617,0,0,0,1617,A
2-PB1,828,0,1615,0,1,1616,T
2-PB1,829,0,4,1622,0,1626,G
2-PB1,830,1607,2,1,0,1610,A
2-PB1,831,1595,1,1,0,1597,A
2-PB1,832,1594,0,1,0,1595,A
2-PB1,833,1591,0,0,1,1592,A
2-PB1,834,0,0,1592,0,1592,G
2-PB1,835,1580,0,3,0,1583,A
2-PB1,836,1575,1,0,0,1576,A
2-PB1,837,0,2,1578,0,1580,G
2-PB1,838,1,0,1577,0,1578,G
2-PB1,839,1,2,0,1569,1572,C
2-PB1,840,4,1,0,1562,1567,C
2-PB1,841,1575,0,0,0,1575,A
2-PB1,842,1575,0,0,0,1575,A
2-PB1,843,1573,0,1,0,1574,A
2-PB1,844,1,0,0,1579,1580,C
2-PB1,845,0,1572,0,3,1575,T
2-PB1,846,0,2,1604,0,1606,G
2-PB1,847,3,0,1605,0,1608,G
2-PB1,848,0,2,0,1610,1612,C
2-PB1,849,1617,0,0,0,1617,A
2-PB1,850,1618,0,1,0,1619,A
2-PB1,851,1619,0,1,0,1620,A
2-PB1,852,0,1627,0,0,1627,T
2-PB1,853,1,0,1630,0,1631,G
2-PB1,854,1,1624,0,0,1625,T
2-PB1,855,0,1583,0,0,1583,T
2-PB1,856,0,0,1587,0,1587,G
2-PB1,857,2,1577,0,2,1581,T
2-PB1,858,0,2,1580,0,1582,G
2-PB1,859,1575,0,0,0,1575,A
2-PB1,860,0,1,1589,0,1590,G
2-PB1,861,1584,0,0,0,1584,A
2-PB1,862,1585,0,0,0,1585,A
2-PB1,863,1582,0,2,0,1584,A
2-PB1,864,1588,0,0,0,1588,A
2-PB1,865,1599,0,0,0,1599,A
2-PB1,866,0,1592,0,0,1592,T
2-PB1,867,0,3,1592,0,1595,G
2-PB1,868,1587,0,2,0,1589,A
2-PB1,869,2,1568,0,2,1572,T
2-PB1,870,1,1,1590,0,1592,G
2-PB1,871,1590,0,0,0,1590,A
2-PB1,872,2,1,0,1606,1609,C
2-PB1,873,0,1603,1,0,1604,T
2-PB1,874,1596,0,3,0,1599,A
2-PB1,875,1608,0,0,0,1608,A
2-PB1,876,1,1599,0,1,1601,T
2-PB1,877,0,1621,0,2,1623,T
2-PB1,878,4,1,0,1624,1629,C
2-PB1,879,1622,0,0,0,1622,A
2-PB1,880,1,1,0,1621,1623,C
2-PB1,881,1600,1,1,0,1602,A
2-PB1,882,1601,1,2,0,1604,A
2-PB1,883,0,1,1605,0,1606,G
2-PB1,884,1621,0,3,0,1624,A
2-PB1,885,0,1,0,1622,1623,C
2-PB1,886,1602,1,1,0,1604,A
2-PB1,887,0,0,0,1608,1608,C
2-PB1,888,1584,1,2,0,1587,A
2-PB1,889,1,1,1591,1,1594,G
2-PB1,890,1579,0,1,1,1581,A
2-PB1,891,1,0,1593,0,1594,G
2-PB1,892,0,0,0,1584,1584,C
2-PB1,893,0,1543,0,1,1544,T
2-PB1,894,0,1548,1,1,1550,T
2-PB1,895,0,1545,1,5,1551,T
2-PB1,896,1,0,0,1554,1555,C
2-PB1,897,0,1552,0,2,1554,T
2-PB1,898,0,1540,0,2,1542,T
2-PB1,899,1,1536,0,2,1539,T
2-PB1,900,2,1,0,1533,1536,C
2-PB1,901,1534,1,2,0,1537,A
2-PB1,902,0,2,0,1542,1544,C
2-PB1,903,1518,0,0,0,1518,A
2-PB1,904,1520,3,1,0,1524,A
2-PB1,905,0,1534,0,0,1534,T
2-PB1,906,4,0,0,1550,1554,C
2-PB1,907,1551,1,1,1,1554,A
2-PB1,908,1,0,0,1565,1566,C
2-PB1,909,1,1549,0,4,1554,T
2-PB1,910,1,2,1565,1,1569,G
2-PB1,911,1,1,1554,2,1558,G
2-PB1,912,1,0,1588,0,1589,G
2-PB1,913,0,1,1585,1,1587,G
2-PB1,914,1551,0,5,0,1556,A
2-PB1,915,2,0,0,1494,1496,C
2-PB1,916,1523,0,1,0,1524,A
2-PB1,917,1604,0,0,0,1604,A
2-PB1,918,1,0,0,1611,1612,C
2-PB1,919,1604,0,1,0,1605,A
2-PB1,920,0,0,0,1605,1605,C
2-PB1,921,0,1537,0,0,1537,T
2-PB1,922,1539,0,0,1,1540,A
2-PB1,923,1528,0,4,1,1533,A
2-PB1,924,0,1,1543,0,1544,G
2-PB1,925,0,1538,0,0,1538,T
2-PB1,926,0,4,1403,1,1408,G
2-PB1,927,0,2,1392,0,1394,G
2-PB1,928,1387,0,2,0,1389,A
2-PB1,929,1394,0,1,0,1395,A
2-PB1,930,0,1388,0,2,1390,T
2-PB1,931,0,3,1386,0,1389,G
2-PB1,932,1384,0,1,0,1385,A
2-PB1,933,1367,0,0,0,1367,A
2-PB1,934,1377,0,2,0,1379,A
2-PB1,935,1386,0,0,0,1386,A
2-PB1,936,0,1379,0,0,1379,T
2-PB1,937,1,0,0,1378,1379,C
2-PB1,938,1378,0,0,0,1378,A
2-PB1,939,1376,0,2,0,1378,A
2-PB1,940,1370,0,2,0,1372,A
2-PB1,941,1373,0,1,0,1374,A
2-PB1,942,0,0,0,1381,1381,C
2-PB1,943,6,0,0,1363,1369,C
2-PB1,944,2,2,0,1368,1372,C
2-PB1,945,0,1364,0,2,1366,T
2-PB1,946,1,1,0,1368,1370,C
2-PB1,947,0,2,1367,0,1369,G
2-PB1,948,1368,0,1,0,1369,A
2-PB1,949,1368,0,0,0,1368,A
2-PB1,950,0,1363,0,0,1363,T
2-PB1,951,0,0,1361,0,1361,G
2-PB1,952,0,1350,2,1,1353,T
2-PB1,953,0,1342,1,0,1343,T
2-PB1,954,0,1345,0,1,1346,T
2-PB1,955,0,1342,0,1,1343,T
2-PB1,956,0,1342,0,1,1343,T
2-PB1,957,1,2,1338,0,1341,G
2-PB1,958,0,1,1336,0,1337,G
2-PB1,959,1,1,0,1332,1334,C
2-PB1,960,1,0,1299,0,1300,G
2-PB1,961,1299,0,0,0,1299,A
2-PB1,962,0,1322,0,1,1323,T
2-PB1,963,0,5,1351,0,1356,G
2-PB1,964,1421,0,1,0,1422,A
2-PB1,965,1,1427,0,0,1428,T
2-PB1,966,1,1423,0,0,1424,T
2-PB1,967,1439,0,0,0,1439,A
2-PB1,968,0,0,0,1439,1439,C
2-PB1,969,1451,1,1,0,1453,A
2-PB1,970,0,1443,0,1,1444,T
2-PB1,971,1347,0,1,0,1348,A
2-PB1,972,0,0,0,1351,1351,C
2-PB1,973,1206,0,0,0,1206,A
2-PB1,974,0,1206,0,2,1208,T
2-PB1,975,2,1,0,1199,1202,C
2-PB1,976,1190,0,0,1,1191,A
2-PB1,977,0,0,0,1194,1194,C
2-PB1,978,1177,1,0,0,1178,A
2-PB1,979,1179,1,0,0,1180,A
2-PB1,980,1175,0,1,0,1176,A
2-PB1,981,1,2,1116,0,1119,G
2-PB1,982,1177,0,0,0,1177,A
2-PB1,983,1180,0,0,0,1180,A
2-PB1,984,0,1174,0,2,1176,T
2-PB1,985,5,1,0,1168,1174,C
2-PB1,986,1169,0,0,0,1169,A
2-PB1,987,1172,1,1,0,1174,A
2-PB1,988,0,1,0,1175,1176,C
2-PB1,989,2,0,0,1174,1176,C
2-PB1,990,1,1102,0,0,1103,T
2-PB1,991,0,3,1105,0,1108,G
2-PB1,992,1104,1,2,0,1107,A
2-PB1,993,0,0,1105,0,1105,G
2-PB1,994,0,1098,0,0,1098,T
2-PB1,995,0,3,1058,0,1061,G
2-PB1,996,0,0,1111,1,1112,G
2-PB1,997,0,1100,0,0,1100,T
2-PB1,998,0,1098,0,1,1099,T
2-PB1,999,4,0,0,1099,1103,C
2-PB1,1000,1086,0,0,0,1086,A
2-PB1,1001,0,1,1104,0,1105,G
2-PB1,1002,1101,1,0,0,1102,A
2-PB1,1003,1099,0,0,0,1099,A
2-PB1,1004,1097,0,0,0,1097,A
2-PB1,1005,0,0,0,995,995,C
2-PB1,1006,995,0,0,0,995,A
2-PB1,1007,0,994,0,1,995,T
2-PB1,1008,0,0,0,1002,1002,C
2-PB1,1009,0,0,0,1004,1004,C
2-PB1,1010,1,944,0,2,947,T
2-PB1,1011,1,1,949,0,951,G
2-PB1,1012,947,0,1,0,948,A
2-PB1,1013,0,0,953,0,953,G
2-PB1,1014,0,0,0,939,939,C
2-PB1,1015,914,0,0,0,914,A
2-PB1,1016,0,917,0,0,917,T
2-PB1,1017,1,0,0,902,903,C
2-PB1,1018,1,0,901,0,902,G
2-PB1,1019,0,0,0,931,931,C
2-PB1,1020,933,1,1,0,935,A
2-PB1,1021,0,0,0,972,972,C
2-PB1,1022,3,0,0,960,963,C
2-PB1,1023,961,0,2,0,963,A
2-PB1,1024,979,0,0,0,979,A
2-PB1,1025,0,974,0,1,975,T
2-PB1,1026,978,0,0,0,978,A
2-PB1,1027,971,0,0,0,971,A
2-PB1,1028,0,931,0,0,931,T
2-PB1,1029,0,0,936,0,936,G
2-PB1,1030,0,912,0,0,912,T
2-PB1,1031,0,904,1,1,906,T
2-PB1,1032,0,0,0,906,906,C
2-PB1,1033,0,898,0,0,898,T
2-PB1,1034,0,1,0,900,901,C
2-PB1,1035,904,0,0,0,904,A
2-PB1,1036,906,0,0,0,906,A
2-PB1,1037,902,0,1,0,903,A
2-PB1,1038,0,0,0,910,910,C
2-PB1,1039,905,0,0,0,905,A
2-PB1,1040,904,1,0,0,905,A
2-PB1,1041,899,1,1,0,901,A
2-PB1,1042,900,0,0,0,900,A
2-PB1,1043,1,908,0,0,909,T
2-PB1,1044,0,2,910,0,912,G
2-PB1,1045,1,0,906,0,907,G
2-PB1,1046,2,0,0,903,905,C
2-PB1,1047,903,0,3,0,906,A
2-PB1,1048,908,0,0,0,908,A
2-PB1,1049,1,1,908,0,910,G
2-PB1,1050,906,0,0,0,906,A
2-PB1,1051,1,896,0,0,897,T
2-PB1,1052,0,916,0,0,916,T
2-PB1,1053,0,1,925,0,926,G
2-PB1,1054,0,0,927,0,927,G
2-PB1,1055,0,0,933,0,933,G
2-PB1,1056,935,0,1,0,936,A
2-PB1,1057,927,0,2,0,929,A
2-PB1,1058,926,0,1,0,927,A
2-PB1,1059,919,0,1,0,920,A
2-PB1,1060,0,0,952,0,952,G
2-PB1,1061,0,3,951,0,954,G
2-PB1,1062,949,0,0,0,949,A
2-PB1,1063,0,946,0,1,947,T
2-PB1,1064,943,1,2,0,946,A
2-PB1,1065,0,0,0,947,947,C
2-PB1,1066,952,0,0,0,952,A
2-PB1,1067,0,953,0,0,953,T
2-PB1,1068,1,0,960,0,961,G
2-PB1,1069,1,936,0,2,939,T
2-PB1,1070,0,939,0,0,939,T
2-PB1,1071,1,0,0,933,934,C
2-PB1,1072,0,2,933,0,935,G
2-PB1,1073,941,0,1,0,942,A
2-PB1,1074,1,1,959,0,961,G
2-PB1,1075,950,0,1,0,951,A
2-PB1,1076,0,0,968,0,968,G
2-PB1,1077,0,958,0,2,960,T
2-PB1,1078,956,0,1,0,957,A
2-PB1,1079,959,0,1,0,960,A
2-PB1,1080,1,0,963,0,964,G
2-PB1,1081,963,0,1,0,964,A
2-PB1,1082,0,3,973,0,976,G
2-PB1,1083,945,0,2,1,948,A
2-PB1,1084,954,0,0,0,954,A
2-PB1,1085,0,942,0,1,943,T
2-PB1,1086,0,0,942,0,942,G
2-PB1,1087,944,0,1,0,945,A
2-PB1,1088,934,0,4,0,938,A
2-PB1,1089,0,0,939,0,939,G
2-PB1,1090,2,1,1,931,935,C
2-PB1,1091,0,912,0,1,913,T
2-PB1,1092,3,1,1,915,920,C
2-PB1,1093,0,0,0,919,919,C
2-PB1,1094,0,1,921,0,922,G
2-PB1,1095,0,2,921,0,923,G
2-PB1,1096,920,0,4,0,924,A
2-PB1,1097,0,1,0,939,940,C
2-PB1,1098,943,0,0,0,943,A
2-PB1,1099,0,1,0,952,953,C
2-PB1,1100,951,0,1,0,952,A
2-PB1,1101,951,0,2,0,953,A
2-PB1,1102,950,0,1,0,951,A
2-PB1,1103,0,949,0,0,949,T
2-PB1,1104,947,0,0,0,947,A
2-PB1,1105,0,0,0,943,943,C
2-PB1,1106,1,2,1,937,941,C
2-PB1,1107,0,935,0,1,936,T
2-PB1,1108,1,0,946,0,947,G
2-PB1,1109,0,0,0,948,948,C
2-PB1,1110,947,0,1,0,948,A
2-PB1,1111,1,1,947,0,949,G
2-PB1,1112,944,0,1,1,946,A
2-PB1,1113,939,0,0,0,939,A
2-PB1,1114,944,0,0,0,944,A
2-PB1,1115,0,942,0,1,943,T
2-PB1,1116,0,0,949,0,949,G
2-PB1,1117,0,0,0,942,942,C
2-PB1,1118,0,939,0,0,939,T
2-PB1,1119,947,1,1,0,949,A
2-PB1,1120,3,0,947,0,950,G
2-PB1,1121,0,0,0,952,952,C
2-PB1,1122,949,0,0,0,949,A
2-PB1,1123,950,0,1,0,951,A
2-PB1,1124,0,0,949,0,949,G
2-PB1,1125,0,0,0,947,947,C
2-PB1,1126,939,0,0,0,939,A
2-PB1,1127,0,955,0,0,955,T
2-PB1,1128,1,957,0,0,958,T
2-PB1,1129,1,2,988,0,991,G
2-PB1,1130,998,0,0,0,998,A
2-PB1,1131,0,0,0,996,996,C
2-PB1,1132,0,0,0,1000,1000,C
2-PB1,1133,0,979,0,0,979,T
2-PB1,1134,0,3,991,0,994,G
2-PB1,1135,994,1,2,0,997,A
2-PB1,1136,995,0,2,0,997,A
2-PB1,1137,0,0,1007,0,1007,G
2-PB1,1138,0,988,0,0,988,T
2-PB1,1139,994,0,0,0,994,A
2-PB1,1140,0,976,0,2,978,T
2-PB1,1141,0,979,0,1,980,T
2-PB1,1142,0,972,0,4,976,T
2-PB1,1143,2,0,0,967,969,C
2-PB1,1144,971,0,0,0,971,A
2-PB1,1145,971,0,0,0,971,A
2-PB1,1146,0,956,0,1,957,T
2-PB1,1147,0,3,963,0,966,G
2-PB1,1148,954,1,1,0,956,A
2-PB1,1149,959,0,1,0,960,A
2-PB1,1150,0,955,0,1,956,T
2-PB1,1151,1,0,0,962,963,C
2-PB1,1152,959,0,1,0,960,A
2-PB1,1153,963,0,1,0,964,A
2-PB1,1154,0,0,0,961,961,C
2-PB1,1155,961,0,2,0,963,A
2-PB1,1156,958,0,1,0,959,A
2-PB1,1157,0,1,958,0,959,G
2-PB1,1158,0,0,954,0,954,G
2-PB1,1159,953,0,0,1,954,A
2-PB1,1160,949,0,2,0,951,A
2-PB1,1161,0,0,951,0,951,G
2-PB1,1162,948,0,1,0,949,A
2-PB1,1163,950,0,0,0,950,A
2-PB1,1164,950,0,0,0,950,A
2-PB1,1165,950,0,0,0,950,A
2-PB1,1166,0,948,0,0,948,T
2-PB1,1167,0,934,0,1,935,T
2-PB1,1168,1,2,937,0,940,G
2-PB1,1169,933,0,0,0,933,A
2-PB1,1170,0,1,932,1,934,G
2-PB1,1171,940,0,1,0,941,A
2-PB1,1172,948,0,0,0,948,A
2-PB1,1173,957,0,1,0,958,A
2-PB1,1174,957,0,3,0,960,A
2-PB1,1175,0,961,0,0,961,T
2-PB1,1176,963,0,0,0,963,A
2-PB1,1177,959,2,0,0,961,A
2-PB1,1178,0,0,966,0,966,G
2-PB1,1179,0,0,960,0,960,G
2-PB1,1180,1,0,0,960,961,C
2-PB1,1181,1,1,0,955,957,C
2-PB1,1182,0,956,0,1,957,T
2-PB1,1183,2,0,0,1069,1071,C
2-PB1,1184,0,1082,1,2,1085,T
2-PB1,1185,0,1092,1,0,1093,T
2-PB1,1186,1,0,0,1108,1109,C
2-PB1,1187,1,1110,0,0,1111,T
2-PB1,1188,1107,0,0,0,1107,A
2-PB1,1189,1109,0,0,0,1109,A
2-PB1,1190,0,1109,0,0,1109,T
2-PB1,1191,1113,0,1,0,1114,A
2-PB1,1192,0,1,1093,0,1094,G
2-PB1,1193,988,0,2,0,990,A
2-PB1,1194,0,983,0,1,984,T
2-PB1,1195,1,1,969,1,972,G
2-PB1,1196,2,0,985,0,987,G
2-PB1,1197,0,0,0,985,985,C
2-PB1,1198,989,0,0,0,989,A
2-PB1,1199,0,0,0,992,992,C
2-PB1,1200,980,0,0,0,980,A
2-PB1,1201,0,0,1023,0,1023,G
2-PB1,1202,0,1,0,1019,1020,C
2-PB1,1203,1023,0,1,0,1024,A
2-PB1,1204,0,1045,0,0,1045,T
2-PB1,1205,1,1,0,1038,1040,C
2-PB1,1206,1047,0,0,0,1047,A
2-PB1,1207,1,1044,0,0,1045,T
2-PB1,1208,0,1039,0,0,1039,T
2-PB1,1209,0,0,1038,0,1038,G
2-PB1,1210,1004,0,1,0,1005,A
2-PB1,1211,0,0,1036,0,1036,G
2-PB1,1212,0,0,0,1034,1034,C
2-PB1,1213,1,1,0,1019,1021,C
2-PB1,1214,0,0,1,1046,1047,C
2-PB1,1215,0,1038,0,1,1039,T
2-PB1,1216,2,0,1164,0,1166,G
2-PB1,1217,0,1,1187,0,1188,G
2-PB1,1218,1184,0,4,0,1188,A
2-PB1,1219,1245,0,0,0,1245,A
2-PB1,1220,0,1213,0,1,1214,T
2-PB1,1221,0,1,1274,0,1275,G
2-PB1,1222,1297,0,3,0,1300,A
2-PB1,1223,0,1317,0,0,1317,T
2-PB1,1224,0,2,1324,0,1326,G
2-PB1,1225,1306,1,0,0,1307,A
2-PB1,1226,0,1291,0,0,1291,T
2-PB1,1227,1,3,1290,0,1294,G
2-PB1,1228,0,1,1331,0,1332,G
2-PB1,1229,1,2,1328,2,1333,G
2-PB1,1230,2,0,0,1322,1324,C
2-PB1,1231,1331,1,0,0,1332,A
2-PB1,1232,0,1336,0,3,1339,T
2-PB1,1233,1,0,1388,0,1389,G
2-PB1,1234,0,1386,0,3,1389,T
2-PB1,1235,0,1394,0,1,1395,T
2-PB1,1236,3,0,0,1399,1402,C
2-PB1,1237,1387,0,1,0,1388,A
2-PB1,1238,1394,0,2,0,1396,A
2-PB1,1239,0,2,0,1399,1401,C
2-PB1,1240,1401,0,1,0,1402,A
2-PB1,1241,0,1398,0,1,1399,T
2-PB1,1242,1,0,1421,0,1422,G
2-PB1,1243,1,1,0,1423,1425,C
2-PB1,1244,0,1420,0,0,1420,T
2-PB1,1245,1432,0,0,0,1432,A
2-PB1,1246,1429,0,1,0,1430,A
2-PB1,1247,0,0,1476,0,1476,G
2-PB1,1248,0,1473,0,1,1474,T
2-PB1,1249,1472,0,0,0,1472,A
2-PB1,1250,0,0,0,1482,1482,C
2-PB1,1251,0,2,1475,0,1477,G
2-PB1,1252,0,0,1613,0,1613,G
2-PB1,1253,1,1607,0,3,1611,T
2-PB1,1254,0,1611,0,1,1612,T
2-PB1,1255,0,1612,0,0,1612,T
2-PB1,1256,0,1598,0,1,1599,T
2-PB1,1257,1595,0,6,0,1601,A
2-PB1,1258,0,1,1596,2,1599,G
2-PB1,1259,0,1,1593,0,1594,G
2-PB1,1260,1576,0,1,1,1578,A
2-PB1,1261,0,0,1569,0,1569,G
2-PB1,1262,2,1592,0,1,1595,T
2-PB1,1263,2,1,0,1594,1597,C
2-PB1,1264,0,1601,0,0,1601,T
2-PB1,1265,5,1,0,1595,1601,C
2-PB1,1266,1,0,1601,0,1602,G
2-PB1,1267,1660,0,0,0,1660,A
2-PB1,1268,0,1666,0,1,1667,T
2-PB1,1269,1675,1,0,0,1676,A
2-PB1,1270,0,1,0,1676,1677,C
2-PB1,1271,1,1648,0,5,1654,T
2-PB1,1272,1,1,1658,0,1660,G
2-PB1,1273,1657,0,1,0,1658,A
2-PB1,1274,1692,0,1,0,1693,A
2-PB1,1275,0,1687,0,1,1688,T
2-PB1,1276,0,0,0,1659,1659,C
2-PB1,1277,0,1658,0,3,1661,T
2-PB1,1278,0,1650,0,3,1653,T
2-PB1,1279,0,1,1666,0,1667,G
2-PB1,1280,0,0,1666,0,1666,G
2-PB1,1281,1665,2,1,0,1668,A
2-PB1,1282,0,0,0,1675,1675,C
2-PB1,1283,1650,0,0,0,1650,A
2-PB1,1284,1674,1,0,0,1675,A
2-PB1,1285,1683,0,0,0,1683,A
2-PB1,1286,1682,1,2,0,1685,A
2-PB1,1287,0,0,1739,0,1739,G
2-PB1,1288,1740,1,2,0,1743,A
2-PB1,1289,1736,0,2,0,1738,A
2-PB1,1290,1745,0,0,0,1745,A
2-PB1,1291,0,1743,0,0,1743,T
2-PB1,1292,1738,0,1,0,1739,A
2-PB1,1293,0,0,0,1792,1792,C
2-PB1,1294,1778,1,2,0,1781,A
2-PB1,1295,1,0,0,1787,1788,C
2-PB1,1296,2,0,0,1771,1773,C
2-PB1,1297,1775,0,0,0,1775,A
2-PB1,1298,1792,1,1,0,1794,A
2-PB1,1299,0,1,1852,0,1853,G
2-PB1,1300,1888,0,2,0,1890,A
2-PB1,1301,0,0,0,1902,1902,C
2-PB1,1302,1867,0,2,0,1869,A
2-PB1,1303,1948,0,4,0,1952,A
2-PB1,1304,0,1,0,1960,1961,C
2-PB1,1305,2002,1,1,0,2004,A
2-PB1,1306,0,2017,0,0,2017,T
2-PB1,1307,1996,0,2,0,1998,A
2-PB1,1308,0,1,0,2024,2025,C
2-PB1,1309,0,1944,0,13,1957,T
2-PB1,1310,3,0,1995,0,1998,G
2-PB1,1311,0,0,1998,0,1998,G
2-PB1,1312,0,1968,0,0,1968,T
2-PB1,1313,0,2,1964,0,1966,G
2-PB1,1314,1,1,1942,0,1944,G
2-PB1,1315,0,1,1954,0,1955,G
2-PB1,1316,1942,1,7,0,1950,A
2-PB1,1317,0,1912,1,3,1916,T
2-PB1,1318,4,1,1910,0,1915,G
2-PB1,1319,0,2,1897,0,1899,G
2-PB1,1320,2,0,1908,0,1910,G
2-PB1,1321,0,0,0,1934,1934,C
2-PB1,1322,0,1920,0,5,1925,T
2-PB1,1323,2,4,0,1931,1937,C
2-PB1,1324,0,0,0,1937,1937,C
2-PB1,1325,1933,0,1,0,1934,A
2-PB1,1326,1938,0,0,0,1938,A
2-PB1,1327,0,1931,0,4,1935,T
2-PB1,1328,3,0,1,1924,1928,C
2-PB1,1329,3,0,0,1908,1911,C
2-PB1,1330,1,1899,0,2,1902,T
2-PB1,1331,2,0,0,1899,1901,C
2-PB1,1332,3,0,0,1897,1900,C
2-PB1,1333,1,4,1895,0,1900,G
2-PB1,1334,1895,0,1,1,1897,A
2-PB1,1335,0,1,0,1896,1897,C
2-PB1,1336,0,0,1903,0,1903,G
2-PB1,1337,1909,0,0,0,1909,A
2-PB1,1338,0,1908,0,1,1909,T
2-PB1,1339,0,1906,0,0,1906,T
2-PB1,1340,0,1905,0,3,1908,T
2-PB1,1341,3,1903,1,0,1907,T
2-PB1,1342,0,1,1909,0,1910,G
2-PB1,1343,1,2,1,1929,1933,C
2-PB1,1344,0,0,0,1931,1931,C
2-PB1,1345,3,1,0,1989,1993,C
2-PB1,1346,0,1968,0,3,1971,T
2-PB1,1347,1,0,0,2060,2061,C
2-PB1,1348,2075,0,0,0,2075,A
2-PB1,1349,0,2082,0,0,2082,T
2-PB1,1350,2075,1,1,0,2077,A
2-PB1,1351,0,0,2102,0,2102,G
2-PB1,1352,1,2085,0,0,2086,T
2-PB1,1353,2,3,2102,1,2108,G
2-PB1,1354,2053,0,1,0,2054,A
2-PB1,1355,2048,2,4,1,2055,A
2-PB1,1356,0,1960,0,1,1961,T
2-PB1,1357,2,2,1954,0,1958,G
2-PB1,1358,1,1,0,1974,1976,C
2-PB1,1359,1976,0,4,0,1980,A
2-PB1,1360,1,0,0,1982,1983,C
2-PB1,1361,5,1,0,1963,1969,C
2-PB1,1362,1958,0,1,0,1959,A
2-PB1,1363,1953,1,1,1,1956,A
2-PB1,1364,1951,0,1,0,1952,A
2-PB1,1365,0,1904,0,2,1906,T
2-PB1,1366,4,0,0,1960,1964,C
2-PB1,1367,1960,0,2,0,1962,A
2-PB1,1368,0,1964,0,0,1964,T
2-PB1,1369,0,1,1969,0,1970,G
2-PB1,1370,1966,0,5,0,1971,A
2-PB1,1371,1,1,1984,0,1986,G
2-PB1,1372,0,0,1989,0,1989,G
2-PB1,1373,0,4,2003,0,2007,G
2-PB1,1374,1995,0,1,0,1996,A
2-PB1,1375,2035,0,3,0,2038,A
2-PB1,1376,1,2040,0,1,2042,T
2-PB1,1377,2048,1,1,0,2050,A
2-PB1,1378,0,0,0,2057,2057,C
2-PB1,1379,2052,0,4,0,2056,A
2-PB1,1380,2062,1,4,0,2067,A
2-PB1,1381,0,1,2063,0,2064,G
2-PB1,1382,1,3,1,2052,2057,C
2-PB1,1383,2035,0,2,0,2037,A
2-PB1,1384,4,2,2056,0,2062,G
2-PB1,1385,2,4,2058,1,2065,G
2-PB1,1386,2051,0,0,1,2052,A
2-PB1,1387,0,1,2063,0,2064,G
2-PB1,1388,3,2037,1,2,2043,T
2-PB1,1389,1,2,2066,0,2069,G
2-PB1,1390,1,2,2070,1,2074,G
2-PB1,1391,2074,0,3,0,2077,A
2-PB1,1392,1,2073,0,1,2075,T
2-PB1,1393,2056,0,1,0,2057,A
2-PB1,1394,0,2,2081,0,2083,G
2-PB1,1395,2138,1,0,0,2139,A
2-PB1,1396,0,2141,0,2,2143,T
2-PB1,1397,0,2141,0,0,2141,T
2-PB1,1398,0,0,0,2203,2203,C
2-PB1,1399,1,2191,0,1,2193,T
2-PB1,1400,2197,1,0,0,2198,A
2-PB1,1401,0,0,0,2191,2191,C
2-PB1,1402,2161,2,1,0,2164,A
2-PB1,1403,0,2,2167,0,2169,G
2-PB1,1404,1,5,2128,0,2134,G
2-PB1,1405,2142,1,7,0,2150,A
2-PB1,1406,2,1,0,2143,2146,C
2-PB1,1407,2,0,0,2098,2100,C
2-PB1,1408,1,2076,0,6,2083,T
2-PB1,1409,0,0,2086,0,2086,G
2-PB1,1410,0,0,0,2081,2081,C
2-PB1,1411,2077,0,1,0,2078,A
2-PB1,1412,2095,1,4,1,2101,A
2-PB1,1413,1,1,2104,0,2106,G
2-PB1,1414,0,2076,0,1,2077,T
2-PB1,1415,0,2070,0,1,2071,T
2-PB1,1416,2042,0,3,0,2045,A
2-PB1,1417,0,0,2055,0,2055,G
2-PB1,1418,1,2047,0,1,2049,T
2-PB1,1419,0,0,2046,0,2046,G
2-PB1,1420,2,3,2031,3,2039,G
2-PB1,1421,1,2,2046,0,2049,G
2-PB1,1422,2037,1,2,0,2040,A
2-PB1,1423,2057,0,0,0,2057,A
2-PB1,1424,0,2049,0,3,2052,T
2-PB1,1425,1,4,0,2049,2054,C
2-PB1,1426,2058,0,1,0,2059,A
2-PB1,1427,2057,1,4,0,2062,A
2-PB1,1428,1,0,0,2058,2059,C
2-PB1,1429,2051,0,1,0,2052,A
2-PB1,1430,0,2002,0,2,2004,T
2-PB1,1431,1,1,2004,1,2007,G
2-PB1,1432,2007,1,5,0,2013,A
2-PB1,1433,0,1,2027,0,2028,G
2-PB1,1434,0,1,0,2014,2015,C
2-PB1,1435,2013,1,0,0,2014,A
2-PB1,1436,2022,0,1,0,2023,A
2-PB1,1437,2019,0,3,0,2022,A
2-PB1,1438,2033,1,2,0,2036,A
2-PB1,1439,2032,0,6,0,2038,A
2-PB1,1440,3,2,2029,1,2035,G
2-PB1,1441,2004,0,0,0,2004,A
2-PB1,1442,1983,3,10,0,1996,A
2-PB1,1443,0,0,2092,0,2092,G
2-PB1,1444,0,2096,0,1,2097,T
2-PB1,1445,3,1,0,2087,2091,C
2-PB1,1446,2,0,0,2101,2103,C
2-PB1,1447,1,2090,0,1,2092,T
2-PB1,1448,2128,0,1,0,2129,A
2-PB1,1449,0,2120,0,2,2122,T
2-PB1,1450,2126,1,1,1,2129,A
2-PB1,1451,0,2125,0,0,2125,T
2-PB1,1452,2063,0,1,0,2064,A
2-PB1,1453,2066,0,3,0,2069,A
2-PB1,1454,2067,1,0,1,2069,A
2-PB1,1455,0,2069,0,1,2070,T
2-PB1,1456,2053,0,2,0,2055,A
2-PB1,1457,2042,1,0,0,2043,A
2-PB1,1458,2059,1,1,0,2061,A
2-PB1,1459,2058,0,1,0,2059,A
2-PB1,1460,0,0,0,2064,2064,C
2-PB1,1461,1961,1,2,0,1964,A
2-PB1,1462,1,2,1952,0,1955,G
2-PB1,1463,0,5,1948,0,1953,G
2-PB1,1464,0,1,1951,0,1952,G
2-PB1,1465,1954,1,3,0,1958,A
2-PB1,1466,1,1,0,1969,1971,C
2-PB1,1467,1957,1,3,0,1961,A
2-PB1,1468,0,1981,0,0,1981,T
2-PB1,1469,1,1974,0,2,1977,T
2-PB1,1470,0,1979,0,1,1980,T
2-PB1,1471,1,4,1980,0,1985,G
2-PB1,1472,1974,0,1,1,1976,A
2-PB1,1473,1980,0,1,0,1981,A
2-PB1,1474,1,1984,0,1,1986,T
2-PB1,1475,0,1947,0,0,1947,T
2-PB1,1476,2,1,0,1957,1960,C
2-PB1,1477,1946,0,1,0,1947,A
2-PB1,1478,0,0,0,1949,1949,C
2-PB1,1479,0,1947,0,1,1948,T
2-PB1,1480,1947,1,1,0,1949,A
2-PB1,1481,0,0,1953,0,1953,G
2-PB1,1482,0,1,0,1951,1952,C
2-PB1,1483,0,1932,0,4,1936,T
2-PB1,1484,0,1958,0,0,1958,T
2-PB1,1485,0,1941,0,0,1941,T
2-PB1,1486,1,1940,0,1,1942,T
2-PB1,1487,0,1936,1,3,1940,T
2-PB1,1488,1,1941,0,1,1943,T
2-PB1,1489,0,1935,0,0,1935,T
2-PB1,1490,1931,3,0,0,1934,A
2-PB1,1491,0,1924,0,0,1924,T
2-PB1,1492,2,0,0,1927,1929,C
2-PB1,1493,1,5,1916,0,1922,G
2-PB1,1494,1980,0,1,0,1981,A
2-PB1,1495,0,1990,0,0,1990,T
2-PB1,1496,1991,2,1,0,1994,A
2-PB1,1497,0,2003,0,3,2006,T
2-PB1,1498,0,5,2001,0,2006,G
2-PB1,1499,0,5,2020,0,2025,G
2-PB1,1500,2028,0,0,0,2028,A
2-PB1,1501,0,2012,0,1,2013,T
2-PB1,1502,0,1991,0,0,1991,T
2-PB1,1503,0,1936,0,0,1936,T
2-PB1,1504,2,1,1935,0,1938,G
2-PB1,1505,0,1930,0,1,1931,T
2-PB1,1506,0,0,1927,0,1927,G
2-PB1,1507,2,1,1924,0,1927,G
2-PB1,1508,0,0,0,1912,1912,C
2-PB1,1509,0,1907,0,1,1908,T
2-PB1,1510,1921,0,0,0,1921,A
2-PB1,1511,1930,0,0,1,1931,A
2-PB1,1512,0,1940,1,0,1941,T
2-PB1,1513,2,1930,0,1,1933,T
2-PB1,1514,1,1930,0,0,1931,T
2-PB1,1515,0,1937,0,0,1937,T
2-PB1,1516,1933,0,4,0,1937,A
2-PB1,1517,0,0,1955,0,1955,G
2-PB1,1518,0,1,0,1952,1953,C
2-PB1,1519,1945,0,1,1,1947,A
2-PB1,1520,0,1932,0,1,1933,T
2-PB1,1521,0,0,1919,1,1920,G
2-PB1,1522,0,1,1944,0,1945,G
2-PB1,1523,1942,0,2,0,1944,A
2-PB1,1524,0,0,1949,0,1949,G
2-PB1,1525,0,1,1,1940,1942,C
2-PB1,1526,0,1910,1,3,1914,T
2-PB1,1527,2,0,1930,0,1932,G
2-PB1,1528,1,1,0,1921,1923,C
2-PB1,1529,0,1,1,1913,1915,C
2-PB1,1530,15,0,0,1918,1933,C
2-PB1,1531,1905,0,1,0,1906,A
2-PB1,1532,0,0,2019,0,2019,G
2-PB1,1533,0,2004,1,4,2009,T
2-PB1,1534,0,2011,1,1,2013,T
2-PB1,1535,0,2015,0,1,2016,T
2-PB1,1536,0,1998,0,1,1999,T
2-PB1,1537,0,5,1989,0,1994,G
2-PB1,1538,2,2,1987,0,1991,G
2-PB1,1539,1990,0,1,0,1991,A
2-PB1,1540,0,1,1994,0,1995,G
2-PB1,1541,0,1864,0,1,1865,T
2-PB1,1542,0,0,1945,0,1945,G
2-PB1,1543,1,1934,0,1,1936,T
2-PB1,1544,2,0,0,1938,1940,C
2-PB1,1545,0,1942,0,1,1943,T
2-PB1,1546,1,2,1943,0,1946,G
2-PB1,1547,0,1,1962,0,1963,G
2-PB1,1548,1968,0,0,0,1968,A
2-PB1,1549,1971,0,4,0,1975,A
2-PB1,1550,0,1968,0,0,1968,T
2-PB1,1551,1853,0,1,0,1854,A
2-PB1,1552,1851,0,1,0,1852,A
2-PB1,1553,1851,1,4,0,1856,A
2-PB1,1554,0,1,0,1856,1857,C
2-PB1,1555,2,4,1844,0,1850,G
2-PB1,1556,1831,0,0,0,1831,A
2-PB1,1557,0,0,1830,1,1831,G
2-PB1,1558,1,1828,0,1,1830,T
2-PB1,1559,3,0,0,1830,1833,C
2-PB1,1560,1823,1,1,0,1825,A
2-PB1,1561,1,1,1853,0,1855,G
2-PB1,1562,1,0,0,1854,1855,C
2-PB1,1563,0,1847,0,4,1851,T
2-PB1,1564,2,1,1910,0,1913,G
2-PB1,1565,1907,0,2,0,1909,A
2-PB1,1566,0,1909,0,0,1909,T
2-PB1,1567,1914,1,0,0,1915,A
2-PB1,1568,0,1893,0,0,1893,T
2-PB1,1569,1,3,1897,0,1901,G
2-PB1,1570,1841,0,1,0,1842,A
2-PB1,1571,0,1,1876,0,1877,G
2-PB1,1572,1,1,1,1874,1877,C
2-PB1,1573,1784,0,0,0,1784,A
2-PB1,1574,1,1775,0,0,1776,T
2-PB1,1575,0,1777,0,0,1777,T
2-PB1,1576,1,4,1788,0,1793,G
2-PB1,1577,1,1,1858,0,1860,G
2-PB1,1578,1833,1,5,1,1840,A
2-PB1,1579,0,0,1846,0,1846,G
2-PB1,1580,0,1786,0,2,1788,T
2-PB1,1581,1781,0,3,0,1784,A
2-PB1,1582,1783,0,2,0,1785,A
2-PB1,1583,0,0,0,1791,1791,C
2-PB1,1584,1779,0,1,0,1780,A
2-PB1,1585,0,2,1817,0,1819,G
2-PB1,1586,1,1652,0,4,1657,T
2-PB1,1587,2,0,1684,0,1686,G
2-PB1,1588,1700,1,4,0,1705,A
2-PB1,1589,0,1705,0,1,1706,T
2-PB1,1590,1698,0,1,0,1699,A
2-PB1,1591,1695,0,0,1,1696,A
2-PB1,1592,1656,0,4,0,1660,A
2-PB1,1593,0,4,1676,0,1680,G
2-PB1,1594,1601,0,9,0,1610,A
2-PB1,1595,1610,0,1,1,1612,A
2-PB1,1596,0,1,0,1615,1616,C
2-PB1,1597,1558,0,3,0,1561,A
2-PB1,1598,1576,0,3,0,1579,A
2-PB1,1599,0,1,0,1583,1584,C
2-PB1,1600,1606,0,2,0,1608,A
2-PB1,1601,0,1603,5,0,1608,T
2-PB1,1602,0,2,1589,0,1591,G
2-PB1,1603,1591,1,0,1,1593,A
2-PB1,1604,1,1590,0,1,1592,T
2-PB1,1605,1579,0,1,0,1580,A
2-PB1,1606,1590,0,0,0,1590,A
2-PB1,1607,1592,0,2,0,1594,A
2-PB1,1608,0,1,0,1596,1597,C
2-PB1,1609,1542,0,0,0,1542,A
2-PB1,1610,1540,0,0,0,1540,A
2-PB1,1611,0,1517,1,0,1518,T
2-PB1,1612,0,6,1511,0,1517,G
2-PB1,1613,1548,0,0,0,1548,A
2-PB1,1614,1,0,0,1566,1567,C
2-PB1,1615,4,0,0,1531,1535,C
2-PB1,1616,0,1496,0,2,1498,T
2-PB1,1617,1,1456,0,2,1459,T
2-PB1,1618,0,0,1462,0,1462,G
2-PB1,1619,1,3,1469,0,1473,G
2-PB1,1620,1478,0,1,0,1479,A
2-PB1,1621,0,0,0,1471,1471,C
2-PB1,1622,3,1,0,1454,1458,C
2-PB1,1623,1446,0,3,0,1449,A
2-PB1,1624,1,2,1457,0,1460,G
2-PB1,1625,1,1,0,1456,1458,C
2-PB1,1626,1462,0,1,0,1463,A
2-PB1,1627,1460,0,2,0,1462,A
2-PB1,1628,0,1,0,1458,1459,C
2-PB1,1629,1444,0,1,0,1445,A
2-PB1,1630,0,0,1477,0,1477,G
2-PB1,1631,2,1,0,1477,1480,C
2-PB1,1632,3,0,0,1482,1485,C
2-PB1,1633,2,0,0,1488,1490,C
2-PB1,1634,1484,1,1,0,1486,A
2-PB1,1635,1487,1,0,0,1488,A
2-PB1,1636,1485,0,1,0,1486,A
2-PB1,1637,0,1490,0,0,1490,T
2-PB1,1638,1,1,1487,0,1489,G
2-PB1,1639,3,2,1462,0,1467,G
2-PB1,1640,0,0,0,1477,1477,C
2-PB1,1641,0,1463,0,3,1466,T
2-PB1,1642,3,1,0,1503,1507,C
2-PB1,1643,0,1503,0,3,1506,T
2-PB1,1644,3,0,0,1507,1510,C
2-PB1,1645,2,0,0,1510,1512,C
2-PB1,1646,1519,0,0,0,1519,A
2-PB1,1647,1521,0,0,0,1521,A
2-PB1,1648,0,1502,0,0,1502,T
2-PB1,1649,0,1487,0,1,1488,T
2-PB1,1650,1,1,1494,0,1496,G
2-PB1,1651,0,1464,0,3,1467,T
2-PB1,1652,0,1462,0,0,1462,T
2-PB1,1653,6,1,0,1461,1468,C
2-PB1,1654,1466,0,1,0,1467,A
2-PB1,1655,1,1465,0,2,1468,T
2-PB1,1656,0,0,1,1466,1467,C
2-PB1,1657,1473,0,2,0,1475,A
2-PB1,1658,1474,0,0,0,1474,A
2-PB1,1659,1472,0,0,0,1472,A
2-PB1,1660,0,1,1503,0,1504,G
2-PB1,1661,1499,0,1,0,1500,A
2-PB1,1662,0,1497,0,1,1498,T
2-PB1,1663,0,1503,0,0,1503,T
2-PB1,1664,1510,0,2,0,1512,A
2-PB1,1665,0,0,0,1544,1544,C
2-PB1,1666,1533,0,2,0,1535,A
2-PB1,1667,0,0,1564,0,1564,G
2-PB1,1668,1559,0,1,0,1560,A
2-PB1,1669,1,1583,0,0,1584,T
2-PB1,1670,1588,0,1,1,1590,A
2-PB1,1671,2,0,0,1669,1671,C
2-PB1,1672,1700,0,2,0,1702,A
2-PB1,1673,0,0,0,1808,1808,C
2-PB1,1674,1770,0,1,0,1771,A
2-PB1,1675,0,1778,0,1,1779,T
2-PB1,1676,1757,0,0,0,1757,A
2-PB1,1677,0,1754,0,0,1754,T
2-PB1,1678,1712,0,1,0,1713,A
2-PB1,1679,1,3,1711,0,1715,G
2-PB1,1680,0,1,1685,0,1686,G
2-PB1,1681,1,1602,0,2,1605,T
2-PB1,1682,0,1,1574,0,1575,G
2-PB1,1683,1,0,0,1633,1634,C
2-PB1,1684,1,1,0,1627,1629,C
2-PB1,1685,1650,0,0,0,1650,A
2-PB1,1686,0,1650,0,1,1651,T
2-PB1,1687,1654,0,0,0,1654,A
2-PB1,1688,2,3,1656,0,1661,G
2-PB1,1689,1624,2,1,0,1627,A
2-PB1,1690,0,5,1631,0,1636,G
2-PB1,1691,0,1,1626,0,1627,G
2-PB1,1692,1569,0,2,1,1572,A
2-PB1,1693,2,3,1566,0,1571,G
2-PB1,1694,1557,0,2,0,1559,A
2-PB1,1695,0,1,0,1563,1564,C
2-PB1,1696,1563,0,2,0,1565,A
2-PB1,1697,0,2,0,1580,1582,C
2-PB1,1698,1585,0,2,1,1588,A
2-PB1,1699,2,0,1,1584,1587,C
2-PB1,1700,1559,1,1,0,1561,A
2-PB1,1701,1564,0,3,0,1567,A
2-PB1,1702,1566,0,1,0,1567,A
2-PB1,1703,0,1563,0,0,1563,T
2-PB1,1704,0,0,0,1569,1569,C
2-PB1,1705,2,1,0,1567,1570,C
2-PB1,1706,1540,0,0,0,1540,A
2-PB1,1707,0,1,1544,0,1545,G
2-PB1,1708,1539,0,3,0,1542,A
2-PB1,1709,1,2,0,1545,1548,C
2-PB1,1710,1,4,1540,0,1545,G
2-PB1,1711,1531,1,0,1,1533,A
2-PB1,1712,1,0,1538,0,1539,G
2-PB1,1713,1527,0,5,1,1533,A
2-PB1,1714,1540,0,0,0,1540,A
2-PB1,1715,0,3,1545,0,1548,G
2-PB1,1716,1537,0,3,0,1540,A
2-PB1,1717,0,1533,0,1,1534,T
2-PB1,1718,4,0,0,1509,1513,C
2-PB1,1719,1514,0,0,0,1514,A
2-PB1,1720,0,1501,0,0,1501,T
2-PB1,1721,0,1508,0,0,1508,T
2-PB1,1722,4,1,0,1501,1506,C
2-PB1,1723,1,1,1507,0,1509,G
2-PB1,1724,1497,1,0,0,1498,A
2-PB1,1725,0,2,1502,0,1504,G
2-PB1,1726,1497,0,1,0,1498,A
2-PB1,1727,0,1550,0,0,1550,T
2-PB1,1728,1545,0,1,0,1546,A
2-PB1,1729,1555,0,1,0,1556,A
2-PB1,1730,1550,1,7,1,1559,A
2-PB1,1731,2,0,1559,0,1561,G
2-PB1,1732,1556,1,1,0,1558,A
2-PB1,1733,1520,0,3,0,1523,A
2-PB1,1734,0,2,1529,0,1531,G
2-PB1,1735,0,0,0,1537,1537,C
2-PB1,1736,0,1509,0,0,1509,T
2-PB1,1737,0,2,1514,0,1516,G
2-PB1,1738,0,1513,0,0,1513,T
2-PB1,1739,1,0,1504,0,1505,G
2-PB1,1740,1,0,1517,0,1518,G
2-PB1,1741,1,1,1529,0,1531,G
2-PB1,1742,1533,2,1,0,1536,A
2-PB1,1743,1,1519,0,2,1522,T
2-PB1,1744,1,0,0,1520,1521,C
2-PB1,1745,1517,0,0,1,1518,A
2-PB1,1746,1520,1,6,1,1528,A
2-PB1,1747,1532,0,1,1,1534,A
2-PB1,1748,0,0,0,1534,1534,C
2-PB1,1749,0,0,0,1526,1526,C
2-PB1,1750,1,0,0,1521,1522,C
2-PB1,1751,1522,0,2,0,1524,A
2-PB1,1752,1543,0,2,1,1546,A
2-PB1,1753,1,1535,0,0,1536,T
2-PB1,1754,0,0,0,1544,1544,C
2-PB1,1755,1525,0,2,0,1527,A
2-PB1,1756,1518,0,1,0,1519,A
2-PB1,1757,0,4,1539,0,1543,G
2-PB1,1758,0,1,1536,0,1537,G
2-PB1,1759,0,1,1539,0,1540,G
2-PB1,1760,0,1,0,1537,1538,C
2-PB1,1761,1504,1,2,0,1507,A
2-PB1,1762,1,0,1549,0,1550,G
2-PB1,1763,0,1,1571,0,1572,G
2-PB1,1764,1570,0,3,0,1573,A
2-PB1,1765,2,1,0,1586,1589,C
2-PB1,1766,1,1553,0,2,1556,T
2-PB1,1767,1590,0,2,0,1592,A
2-PB1,1768,0,1590,0,1,1591,T
2-PB1,1769,2,1585,0,2,1589,T
2-PB1,1770,0,0,1592,0,1592,G
2-PB1,1771,4,0,1593,1,1598,G
2-PB1,1772,0,1584,0,1,1585,T
2-PB1,1773,1582,0,0,0,1582,A
2-PB1,1774,1,1558,0,1,1560,T
2-PB1,1775,2,3,0,1558,1563,C
2-PB1,1776,1532,0,0,0,1532,A
2-PB1,1777,0,1,1538,0,1539,G
2-PB1,1778,1541,1,0,0,1542,A
2-PB1,1779,0,1535,0,0,1535,T
2-PB1,1780,1,4,1474,1,1480,G
2-PB1,1781,1,3,1464,0,1468,G
2-PB1,1782,1,2,1474,0,1477,G
2-PB1,1783,0,1,1483,0,1484,G
2-PB1,1784,0,2,1483,0,1485,G
2-PB1,1785,1480,0,2,0,1482,A
2-PB1,1786,0,0,0,1476,1476,C
2-PB1,1787,0,1,0,1476,1477,C
2-PB1,1788,1473,0,0,0,1473,A
2-PB1,1789,1583,0,0,0,1583,A
2-PB1,1790,1594,0,0,0,1594,A
2-PB1,1791,0,0,0,1626,1626,C
2-PB1,1792,0,1611,0,2,1613,T
2-PB1,1793,0,1612,0,1,1613,T
2-PB1,1794,1615,0,1,0,1616,A
2-PB1,1795,0,1615,0,2,1617,T
2-PB1,1796,1617,0,1,0,1618,A
2-PB1,1797,1,2,0,1622,1625,C
2-PB1,1798,1475,0,1,0,1476,A
2-PB1,1799,1486,1,2,0,1489,A
2-PB1,1800,0,1451,0,0,1451,T
2-PB1,1801,1475,0,0,0,1475,A
2-PB1,1802,1,1473,0,0,1474,T
2-PB1,1803,0,0,0,1469,1469,C
2-PB1,1804,3,3,0,1459,1465,C
2-PB1,1805,1,0,1465,0,1466,G
2-PB1,1806,1,1,1461,0,1463,G
2-PB1,1807,1473,0,0,0,1473,A
2-PB1,1808,1472,0,1,0,1473,A
2-PB1,1809,0,1464,0,0,1464,T
2-PB1,1810,1,0,0,1473,1474,C
2-PB1,1811,0,1461,0,2,1463,T
2-PB1,1812,1,1468,1,0,1470,T
2-PB1,1813,0,1,0,1467,1468,C
2-PB1,1814,1464,1,3,0,1468,A
2-PB1,1815,0,0,1,1472,1473,C
2-PB1,1816,1467,1,1,0,1469,A
2-PB1,1817,0,1567,0,3,1570,T
2-PB1,1818,1,0,0,1573,1574,C
2-PB1,1819,1,1,0,1560,1562,C
2-PB1,1820,1,1,0,1569,1571,C
2-PB1,1821,1,1570,0,2,1573,T
2-PB1,1822,0,1,1570,0,1571,G
2-PB1,1823,1571,0,1,0,1572,A
2-PB1,1824,1569,0,0,0,1569,A
2-PB1,1825,0,0,1570,0,1570,G
2-PB1,1826,0,1477,0,1,1478,T
2-PB1,1827,0,0,0,1473,1473,C
2-PB1,1828,1,1437,0,0,1438,T
2-PB1,1829,0,0,1468,0,1468,G
2-PB1,1830,1,0,0,1466,1467,C
2-PB1,1831,1,1462,1,2,1466,T
2-PB1,1832,0,1468,0,1,1469,T
2-PB1,1833,1464,0,0,0,1464,A
2-PB1,1834,1461,0,1,0,1462,A
2-PB1,1835,1462,0,1,0,1463,A
2-PB1,1836,1415,0,3,0,1418,A
2-PB1,1837,0,1436,0,0,1436,T
2-PB1,1838,0,2,1429,0,1431,G
2-PB1,1839,0,1,1432,0,1433,G
2-PB1,1840,0,3,1433,0,1436,G
2-PB1,1841,1426,1,1,0,1428,A
2-PB1,1842,0,0,1440,0,1440,G
2-PB1,1843,2,0,0,1433,1435,C
2-PB1,1844,0,1433,0,2,1435,T
2-PB1,1845,0,1,1442,0,1443,G
2-PB1,1846,1441,0,0,0,1441,A
2-PB1,1847,0,1443,0,1,1444,T
2-PB1,1848,2,0,1453,0,1455,G
2-PB1,1849,0,1,1455,0,1456,G
2-PB1,1850,1448,0,2,0,1450,A
2-PB1,1851,0,1450,0,1,1451,T
2-PB1,1852,0,3,1446,0,1449,G
2-PB1,1853,1448,0,0,0,1448,A
2-PB1,1854,1,3,1460,0,1464,G
2-PB1,1855,1467,0,1,0,1468,A
2-PB1,1856,1467,0,0,0,1467,A
2-PB1,1857,0,1454,0,0,1454,T
2-PB1,1858,0,1453,0,0,1453,T
2-PB1,1859,1455,0,0,0,1455,A
2-PB1,1860,0,1450,0,4,1454,T
2-PB1,1861,0,1,0,1446,1447,C
2-PB1,1862,2,1,1456,0,1459,G
2-PB1,1863,2,1,1436,0,1439,G
2-PB1,1864,0,2,1440,0,1442,G
2-PB1,1865,0,2,1442,0,1444,G
2-PB1,1866,1435,1,3,0,1439,A
2-PB1,1867,1436,0,5,0,1441,A
2-PB1,1868,0,1,1453,0,1454,G
2-PB1,1869,1463,0,0,0,1463,A
2-PB1,1870,0,0,0,1471,1471,C
2-PB1,1871,0,1459,0,1,1460,T
2-PB1,1872,0,1489,0,0,1489,T
2-PB1,1873,0,1493,0,1,1494,T
2-PB1,1874,0,0,1512,0,1512,G
2-PB1,1875,1,1514,0,0,1515,T
2-PB1,1876,1506,0,0,0,1506,A
2-PB1,1877,1505,0,0,0,1505,A
2-PB1,1878,1,1480,0,1,1482,T
2-PB1,1879,3,1,0,1492,1496,C
2-PB1,1880,2,0,0,1487,1489,C
2-PB1,1881,2,2,0,1482,1486,C
2-PB1,1882,2,1,0,1488,1491,C
2-PB1,1883,0,1484,0,2,1486,T
2-PB1,1884,0,1,1490,0,1491,G
2-PB1,1885,1487,1,0,0,1488,A
2-PB1,1886,1493,0,0,0,1493,A
2-PB1,1887,0,1493,0,3,1496,T
2-PB1,1888,0,1,1,1499,1501,C
2-PB1,1889,0,0,0,1484,1484,C
2-PB1,1890,3,1,0,1481,1485,C
2-PB1,1891,0,1480,0,3,1483,T
2-PB1,1892,1,1476,0,1,1478,T
2-PB1,1893,1,1472,0,1,1474,T
2-PB1,1894,0,0,1476,0,1476,G
2-PB1,1895,1,1467,0,1,1469,T
2-PB1,1896,1,2,0,1465,1468,C
2-PB1,1897,1447,1,1,2,1451,A
2-PB1,1898,1,0,1473,0,1474,G
2-PB1,1899,0,0,0,1466,1466,C
2-PB1,1900,3,1,0,1469,1473,C
2-PB1,1901,1474,1,0,0,1475,A
2-PB1,1902,1,1478,0,0,1479,T
2-PB1,1903,1479,0,1,0,1480,A
2-PB1,1904,1482,0,1,0,1483,A
2-PB1,1905,1482,0,0,0,1482,A
2-PB1,1906,1,2,1499,0,1502,G
2-PB1,1907,1472,0,1,0,1473,A
2-PB1,1908,1474,0,1,0,1475,A
2-PB1,1909,1474,1,2,0,1477,A
2-PB1,1910,1,1469,0,1,1471,T
2-PB1,1911,0,1469,0,0,1469,T
2-PB1,1912,0,1,1468,1,1470,G
2-PB1,1913,1455,0,2,0,1457,A
2-PB1,1914,0,0,1490,0,1490,G
2-PB1,1915,0,1478,0,0,1478,T
2-PB1,1916,3,0,0,1490,1493,C
2-PB1,1917,0,1486,0,3,1489,T
2-PB1,1918,3,0,1523,0,1526,G
2-PB1,1919,1,1525,0,1,1527,T
2-PB1,1920,1545,0,2,0,1547,A
2-PB1,1921,1542,0,1,0,1543,A
2-PB1,1922,1546,0,0,0,1546,A
2-PB1,1923,0,1,0,1550,1551,C
2-PB1,1924,1501,0,0,0,1501,A
2-PB1,1925,1540,2,1,0,1543,A
2-PB1,1926,1,1549,1,0,1551,T
2-PB1,1927,1,3,1546,0,1550,G
2-PB1,1928,1,0,0,1562,1563,C
2-PB1,1929,0,1535,0,2,1537,T
2-PB1,1930,1,1,1595,0,1597,G
2-PB1,1931,0,1595,0,1,1596,T
2-PB1,1932,1626,0,2,0,1628,A
2-PB1,1933,0,0,1634,0,1634,G
2-PB1,1934,0,1586,0,0,1586,T
2-PB1,1935,1579,0,1,0,1580,A
2-PB1,1936,1565,0,2,0,1567,A
2-PB1,1937,0,1552,0,0,1552,T
2-PB1,1938,0,0,1551,0,1551,G
2-PB1,1939,0,0,0,1517,1517,C
2-PB1,1940,2,1,1,1494,1498,C
2-PB1,1941,1473,0,0,0,1473,A
2-PB1,1942,1,0,1517,0,1518,G
2-PB1,1943,0,0,0,1542,1542,C
2-PB1,1944,1,1,0,1536,1538,C
2-PB1,1945,2,1,0,1532,1535,C
2-PB1,1946,1527,0,2,1,1530,A
2-PB1,1947,2,1526,0,2,1530,T
2-PB1,1948,1,0,1532,0,1533,G
2-PB1,1949,0,1,1554,0,1555,G
2-PB1,1950,0,1549,0,0,1549,T
2-PB1,1951,3,0,0,1516,1519,C
2-PB1,1952,1,0,0,1497,1498,C
2-PB1,1953,1,1481,0,3,1485,T
2-PB1,1954,2,0,1511,0,1513,G
2-PB1,1955,1,0,0,1507,1508,C
2-PB1,1956,0,1,0,1510,1511,C
2-PB1,1957,1505,0,1,0,1506,A
2-PB1,1958,1494,0,0,0,1494,A
2-PB1,1959,1498,0,0,0,1498,A
2-PB1,1960,1501,0,0,0,1501,A
2-PB1,1961,0,1,1526,0,1527,G
2-PB1,1962,0,1496,0,1,1497,T
2-PB1,1963,1496,0,0,0,1496,A
2-PB1,1964,0,1493,0,2,1495,T
2-PB1,1965,0,2,1497,0,1499,G
2-PB1,1966,1,2,1527,0,1530,G
2-PB1,1967,1529,0,0,0,1529,A
2-PB1,1968,1546,0,0,1,1547,A
2-PB1,1969,0,1533,0,0,1533,T
2-PB1,1970,1501,0,0,0,1501,A
2-PB1,1971,0,1497,0,4,1501,T
2-PB1,1972,0,1,1493,0,1494,G
2-PB1,1973,1489,1,2,0,1492,A
2-PB1,1974,0,1489,1,1,1491,T
2-PB1,1975,0,0,1461,0,1461,G
2-PB1,1976,0,2,0,1462,1464,C
2-PB1,1977,2,1,0,1439,1442,C
2-PB1,1978,2,1,1443,0,1446,G
2-PB1,1979,0,1445,0,2,1447,T
2-PB1,1980,0,1445,0,2,1447,T
2-PB1,1981,0,1,1455,0,1456,G
2-PB1,1982,0,1,0,1484,1485,C
2-PB1,1983,1485,0,1,0,1486,A
2-PB1,1984,1506,0,0,0,1506,A
2-PB1,1985,0,0,0,1512,1512,C
2-PB1,1986,0,1507,0,2,1509,T
2-PB1,1987,1520,1,0,0,1521,A
2-PB1,1988,1,0,0,1517,1518,C
2-PB1,1989,1515,1,2,0,1518,A
2-PB1,1990,0,0,0,1519,1519,C
2-PB1,1991,1462,1,0,1,1464,A
2-PB1,1992,0,0,0,1567,1567,C
2-PB1,1993,0,1529,0,2,1531,T
2-PB1,1994,5,1,0,1532,1538,C
2-PB1,1995,0,0,0,1535,1535,C
2-PB1,1996,1,1525,0,1,1527,T
2-PB1,1997,0,1,1525,0,1526,G
2-PB1,1998,0,2,1528,0,1530,G
2-PB1,1999,1531,0,1,1,1533,A
2-PB1,2000,1,1522,1,3,1527,T
2-PB1,2001,0,1394,0,1,1395,T
2-PB1,2002,1,0,0,1421,1422,C
2-PB1,2003,3,0,0,1412,1415,C
2-PB1,2004,1,0,0,1416,1417,C
2-PB1,2005,1418,1,2,0,1421,A
2-PB1,2006,1418,0,0,0,1418,A
2-PB1,2007,1,1,1419,0,1421,G
2-PB1,2008,1410,1,2,0,1413,A
2-PB1,2009,2,4,1410,0,1416,G
2-PB1,2010,0,2,1415,0,1417,G
2-PB1,2011,1399,0,1,0,1400,A
2-PB1,2012,1400,0,1,0,1401,A
2-PB1,2013,0,1,0,1402,1403,C
2-PB1,2014,1,1,0,1385,1387,C
2-PB1,2015,1,0,1408,0,1409,G
2-PB1,2016,1,0,0,1402,1403,C
2-PB1,2017,1,1402,0,2,1405,T
2-PB1,2018,2,0,0,1411,1413,C
2-PB1,2019,0,1400,0,1,1401,T
2-PB1,2020,1507,1,0,0,1508,A
2-PB1,2021,0,1506,0,2,1508,T
2-PB1,2022,0,1512,0,0,1512,T
2-PB1,2023,1,0,0,1516,1517,C
2-PB1,2024,0,1463,1,1,1465,T
2-PB1,2025,1468,0,0,0,1468,A
2-PB1,2026,1469,0,0,0,1469,A
2-PB1,2027,1474,0,1,0,1475,A
2-PB1,2028,2,0,0,1475,1477,C
2-PB1,2029,1360,0,0,0,1360,A
2-PB1,2030,0,0,0,1364,1364,C
2-PB1,2031,1334,0,0,0,1334,A
2-PB1,2032,1353,0,0,0,1353,A
2-PB1,2033,1,0,1357,0,1358,G
2-PB1,2034,0,0,1,1364,1365,C
2-PB1,2035,2,0,0,1365,1367,C
2-PB1,2036,1351,0,2,0,1353,A
2-PB1,2037,1354,0,0,0,1354,A
2-PB1,2038,1345,0,6,0,1351,A
2-PB1,2039,0,3,1363,0,1366,G
2-PB1,2040,0,1,1367,0,1368,G
2-PB1,2041,1,1,1349,0,1351,G
2-PB1,2042,0,2,1343,0,1345,G
2-PB1,2043,1332,0,0,0,1332,A
2-PB1,2044,1334,0,1,0,1335,A
2-PB1,2045,0,1331,0,0,1331,T
2-PB1,2046,0,1336,0,0,1336,T
2-PB1,2047,3,0,0,1345,1348,C
2-PB1,2048,1,1332,0,1,1334,T
2-PB1,2049,1,1330,0,0,1331,T
2-PB1,2050,1,2,1330,0,1333,G
2-PB1,2051,1322,0,3,0,1325,A
2-PB1,2052,1,3,1327,0,1331,G
2-PB1,2053,1,1,1327,0,1329,G
2-PB1,2054,1321,1,1,0,1323,A
2-PB1,2055,0,1314,0,2,1316,T
2-PB1,2056,1,5,1319,0,1325,G
2-PB1,2057,1322,0,2,0,1324,A
2-PB1,2058,1323,0,2,0,1325,A
2-PB1,2059,1,0,0,1330,1331,C
2-PB1,2060,1306,0,2,0,1308,A
2-PB1,2061,1,3,1317,0,1321,G
2-PB1,2062,1318,0,1,0,1319,A
2-PB1,2063,0,1311,0,2,1313,T
2-PB1,2064,0,1,1320,0,1321,G
2-PB1,2065,1,1330,0,1,1332,T
2-PB1,2066,1335,0,0,0,1335,A
2-PB1,2067,1,0,1,1329,1331,C
2-PB1,2068,2,0,0,1326,1328,C
2-PB1,2069,1318,0,1,0,1319,A
2-PB1,2070,0,0,1298,0,1298,G
2-PB1,2071,1280,1,2,0,1283,A
2-PB1,2072,1275,0,2,0,1277,A
2-PB1,2073,0,0,1286,0,1286,G
2-PB1,2074,0,1222,0,1,1223,T
2-PB1,2075,0,0,1230,0,1230,G
2-PB1,2076,0,0,0,1231,1231,C
2-PB1,2077,0,1226,0,3,1229,T
2-PB1,2078,0,2,1229,0,1231,G
2-PB1,2079,1,0,0,1226,1227,C
2-PB1,2080,1226,0,2,0,1228,A
2-PB1,2081,1227,1,1,0,1229,A
2-PB1,2082,0,0,0,1209,1209,C
2-PB1,2083,0,1203,0,3,1206,T
2-PB1,2084,0,1185,0,0,1185,T
2-PB1,2085,0,0,1189,0,1189,G
2-PB1,2086,0,1189,0,0,1189,T
2-PB1,2087,0,1183,0,1,1184,T
2-PB1,2088,1,0,0,1184,1185,C
2-PB1,2089,0,1,1184,0,1185,G
2-PB1,2090,1186,0,0,0,1186,A
2-PB1,2091,0,1,1184,0,1185,G
2-PB1,2092,1185,0,0,0,1185,A
2-PB1,2093,1183,0,1,0,1184,A
2-PB1,2094,1182,0,0,0,1182,A
2-PB1,2095,1,1182,0,0,1183,T
2-PB1,2096,0,1178,0,1,1179,T
2-PB1,2097,0,1179,0,3,1182,T
2-PB1,2098,0,1183,0,0,1183,T
2-PB1,2099,0,1180,0,1,1181,T
2-PB1,2100,1,1,0,1191,1193,C
2-PB1,2101,0,0,0,1188,1188,C
2-PB1,2102,4,0,0,1191,1195,C
2-PB1,2103,2,1139,0,50,1191,T
2-PB1,2104,1187,0,0,0,1187,A
2-PB1,2105,0,1,1190,0,1191,G
2-PB1,2106,0,1192,0,0,1192,T
2-PB1,2107,1200,0,0,0,1200,A
2-PB1,2108,1,1,1207,0,1209,G
2-PB1,2109,0,1192,0,1,1193,T
2-PB1,2110,0,1241,0,4,1245,T
2-PB1,2111,2,0,0,1247,1249,C
2-PB1,2112,1262,0,1,0,1263,A
2-PB1,2113,0,1266,0,0,1266,T
2-PB1,2114,1264,0,1,0,1265,A
2-PB1,2115,0,1264,0,0,1264,T
2-PB1,2116,1221,0,0,0,1221,A
2-PB1,2117,0,1,1209,0,1210,G
2-PB1,2118,1,1,1200,0,1202,G
2-PB1,2119,1077,0,1,0,1078,A
2-PB1,2120,0,0,1081,0,1081,G
2-PB1,2121,1020,0,2,0,1022,A
2-PB1,2122,0,0,0,1020,1020,C
2-PB1,2123,1,1,1,976,979,C
2-PB1,2124,0,0,983,0,983,G
2-PB1,2125,982,0,1,0,983,A
2-PB1,2126,0,981,0,0,981,T
2-PB1,2127,0,980,0,1,981,T
2-PB1,2128,0,1,975,0,976,G
2-PB1,2129,0,3,975,0,978,G
2-PB1,2130,979,0,1,0,980,A
2-PB1,2131,982,0,0,1,983,A
2-PB1,2132,0,978,0,0,978,T
2-PB1,2133,0,976,0,0,976,T
2-PB1,2134,0,971,0,1,972,T
2-PB1,2135,0,0,0,972,972,C
2-PB1,2136,0,974,0,0,974,T
2-PB1,2137,966,0,2,0,968,A
2-PB1,2138,0,0,969,0,969,G
2-PB1,2139,0,1,1,963,965,C
2-PB1,2140,963,0,0,0,963,A
2-PB1,2141,2,957,0,0,959,T
2-PB1,2142,1,2,940,0,943,G
2-PB1,2143,0,1,971,0,972,G
2-PB1,2144,0,966,0,1,967,T
2-PB1,2145,0,0,967,0,967,G
2-PB1,2146,0,2,960,1,963,G
2-PB1,2147,944,0,7,0,951,A
2-PB1,2148,1,1,948,0,950,G
2-PB1,2149,0,0,944,0,944,G
2-PB1,2150,1,0,0,936,937,C
2-PB1,2151,1,0,0,921,922,C
2-PB1,2152,864,0,1,0,865,A
2-PB1,2153,0,858,0,4,862,T
2-PB1,2154,0,2,865,0,867,G
2-PB1,2155,0,1,874,0,875,G
2-PB1,2156,0,843,0,2,845,T
2-PB1,2157,1,0,854,0,855,G
2-PB1,2158,0,836,0,5,841,T
2-PB1,2159,3,0,0,832,835,C
2-PB1,2160,0,832,0,1,833,T
2-PB1,2161,820,0,3,0,823,A
2-PB1,2162,1,0,822,0,823,G
2-PB1,2163,0,1,798,0,799,G
2-PB1,2164,0,0,786,0,786,G
2-PB1,2165,1,0,0,771,772,C
2-PB1,2166,0,0,0,739,739,C
2-PB1,2167,0,1,0,718,719,C
2-PB1,2168,0,1,717,0,718,G
2-PB1,2169,0,0,718,0,718,G
2-PB1,2170,718,0,0,0,718,A
2-PB1,2171,0,717,0,0,717,T
2-PB1,2172,0,691,0,0,691,T
2-PB1,2173,0,0,686,0,686,G
2-PB1,2174,685,0,1,0,686,A
2-PB1,2175,0,688,0,0,688,T
2-PB1,2176,0,0,688,0,688,G
2-PB1,2177,0,0,0,676,676,C
2-PB1,2178,1,0,0,674,675,C
2-PB1,2179,667,2,0,0,669,A
2-PB1,2180,0,0,671,0,671,G
2-PB1,2181,668,0,0,0,668,A
2-PB1,2182,668,1,1,0,670,A
2-PB1,2183,0,668,0,1,669,T
2-PB1,2184,0,643,0,1,644,T
2-PB1,2185,0,0,645,0,645,G
2-PB1,2186,638,1,0,0,639,A
2-PB1,2187,0,0,0,633,633,C
2-PB1,2188,0,635,0,1,636,T
2-PB1,2189,0,629,0,1,630,T
2-PB1,2190,1,1,0,623,625,C
2-PB1,2191,0,0,626,0,626,G
2-PB1,2192,626,0,0,0,626,A
2-PB1,2193,0,0,610,0,610,G
2-PB1,2194,2,612,1,0,615,T
2-PB1,2195,8,2,0,604,614,C
2-PB1,2196,0,616,0,1,617,T
2-PB1,2197,1,1,615,0,617,G
2-PB1,2198,0,0,618,0,618,G
2-PB1,2199,616,0,0,0,616,A
2-PB1,2200,577,0,0,0,577,A
2-PB1,2201,0,0,578,0,578,G
2-PB1,2202,0,1,584,0,585,G
2-PB1,2203,585,0,0,0,585,A
2-PB1,2204,0,577,1,0,578,T
2-PB1,2205,0,578,1,0,579,T
2-PB1,2206,576,0,0,0,576,A
2-PB1,2207,573,0,0,0,573,A
2-PB1,2208,0,1,570,0,571,G
2-PB1,2209,573,0,0,0,573,A
2-PB1,2210,539,0,2,0,541,A
2-PB1,2211,0,1,501,0,502,G
2-PB1,2212,0,0,503,0,503,G
2-PB1,2213,503,0,1,0,504,A
2-PB1,2214,502,0,2,0,504,A
2-PB1,2215,0,3,501,0,504,G
2-PB1,2216,479,0,0,0,479,A
2-PB1,2217,0,0,480,0,480,G
2-PB1,2218,0,461,0,0,461,T
2-PB1,2219,0,459,0,0,459,T
2-PB1,2220,0,0,0,462,462,C
2-PB1,2221,0,434,0,1,435,T
2-PB1,2222,2,0,0,433,435,C
2-PB1,2223,0,434,0,0,434,T
2-PB1,2224,0,0,432,0,432,G
2-PB1,2225,415,0,2,0,417,A
2-PB1,2226,0,0,412,0,412,G
2-PB1,2227,407,0,0,0,407,A
2-PB1,2228,0,398,0,0,398,T
2-PB1,2229,3,0,0,368,371,C
2-PB1,2230,371,0,1,0,372,A
2-PB1,2231,0,368,0,0,368,T
2-PB1,2232,0,0,368,0,368,G
2-PB1,2233,365,0,1,0,366,A
2-PB1,2234,363,0,2,0,365,A
2-PB1,2235,0,0,353,0,353,G
2-PB1,2236,344,0,0,0,344,A
2-PB1,2237,0,341,0,1,342,T
2-PB1,2238,0,1,0,339,340,C
2-PB1,2239,0,322,0,0,322,T
2-PB1,2240,0,0,322,0,322,G
2-PB1,2241,0,319,0,1,320,T
2-PB1,2242,0,320,0,0,320,T
2-PB1,2243,1,1,0,319,321,C
2-PB1,2244,0,1,0,297,298,C
2-PB1,2245,299,0,0,0,299,A
2-PB1,2246,0,0,0,299,299,C
2-PB1,2247,0,0,0,291,291,C
2-PB1,2248,284,0,0,0,284,A
2-PB1,2249,0,269,0,0,269,T
2-PB1,2250,0,257,0,0,257,T
2-PB1,2251,0,0,257,0,257,G
2-PB1,2252,254,0,0,0,254,A
2-PB1,2253,254,0,1,0,255,A
2-PB1,2254,0,0,255,0,255,G
2-PB1,2255,226,0,1,0,227,A
2-PB1,2256,227,0,0,0,227,A
2-PB1,2257,0,0,0,225,225,C
2-PB1,2258,0,209,0,1,210,T
2-PB1,2259,0,0,0,211,211,C
2-PB1,2260,203,0,0,0,203,A
2-PB1,2261,0,0,203,0,203,G
2-PB1,2262,203,0,0,0,203,A
2-PB1,2263,0,0,0,194,194,C
2-PB1,2264,0,1,187,0,188,G
2-PB1,2265,0,0,180,0,180,G
2-PB1,2266,0,0,0,182,182,C
2-PB1,2267,182,0,0,0,182,A
2-PB1,2268,182,0,0,0,182,A
2-PB1,2269,181,0,0,0,181,A
2-PB1,2270,182,0,0,0,182,A
2-PB1,2271,182,0,0,0,182,A
2-PB1,2272,0,179,0,0,179,T
2-PB1,2273,174,0,0,0,174,A
2-PB1,2274,174,0,0,0,174,A
3-PA,1,82,0,0,0,82,A
3-PA,2,0,84,0,0,84,T
3-PA,3,0,0,87,0,87,G
3-PA,4,0,0,91,0,91,G
3-PA,5,91,0,0,0,91,A
3-PA,6,90,0,0,0,90,A
3-PA,7,0,0,94,0,94,G
3-PA,8,98,0,0,0,98,A
3-PA,9,0,98,0,0,98,T
3-PA,10,0,98,0,0,98,T
3-PA,11,0,102,0,0,102,T
3-PA,12,0,103,0,0,103,T
3-PA,13,0,0,106,0,106,G
3-PA,14,0,107,0,0,107,T
3-PA,15,0,0,107,0,107,G
3-PA,16,0,0,0,111,111,C
3-PA,17,0,1,109,0,110,G
3-PA,18,118,0,0,0,118,A
3-PA,19,0,0,0,118,118,C
3-PA,20,117,0,0,0,117,A
3-PA,21,120,0,0,0,120,A
3-PA,22,0,126,0,0,126,T
3-PA,23,0,0,143,0,143,G
3-PA,24,0,0,0,146,146,C
3-PA,25,0,146,0,0,146,T
3-PA,26,0,145,0,1,146,T
3-PA,27,0,0,0,147,147,C
3-PA,28,151,0,0,0,151,A
3-PA,29,157,0,0,0,157,A
3-PA,30,0,0,0,161,161,C
3-PA,31,0,0,0,162,162,C
3-PA,32,1,0,0,162,163,C
3-PA,33,0,0,163,0,163,G
3-PA,34,162,0,0,0,162,A
3-PA,35,0,163,0,0,163,T
3-PA,36,0,1,163,0,164,G
3-PA,37,166,0,0,0,166,A
3-PA,38,0,171,0,0,171,T
3-PA,39,0,172,0,0,172,T
3-PA,40,0,0,173,0,173,G
3-PA,41,0,172,0,1,173,T
3-PA,42,1,0,0,172,173,C
3-PA,43,0,1,171,0,172,G
3-PA,44,173,0,0,0,173,A
3-PA,45,174,0,0,0,174,A
3-PA,46,0,0,0,173,173,C
3-PA,47,0,174,0,0,174,T
3-PA,48,0,174,0,0,174,T
3-PA,49,0,0,176,0,176,G
3-PA,50,0,0,0,180,180,C
3-PA,51,180,0,0,0,180,A
3-PA,52,0,0,181,0,181,G
3-PA,53,181,0,0,0,181,A
3-PA,54,179,0,1,0,180,A
3-PA,55,179,0,0,0,179,A
3-PA,56,181,0,0,0,181,A
3-PA,57,181,0,1,0,182,A
3-PA,58,0,0,183,0,183,G
3-PA,59,0,0,0,193,193,C
3-PA,60,194,0,0,0,194,A
3-PA,61,207,0,1,0,208,A
3-PA,62,0,208,0,0,208,T
3-PA,63,0,1,209,0,210,G
3-PA,64,217,0,0,0,217,A
3-PA,65,218,0,0,0,218,A
3-PA,66,221,0,1,0,222,A
3-PA,67,0,0,231,0,231,G
3-PA,68,249,0,1,0,250,A
3-PA,69,0,0,303,0,303,G
3-PA,70,0,302,0,0,302,T
3-PA,71,304,0,0,0,304,A
3-PA,72,0,305,1,0,306,T
3-PA,73,0,2,308,0,310,G
3-PA,74,0,1,313,0,314,G
3-PA,75,0,0,314,0,314,G
3-PA,76,0,0,315,0,315,G
3-PA,77,310,0,0,0,310,A
3-PA,78,0,2,302,0,304,G
3-PA,79,0,0,311,0,311,G
3-PA,80,310,0,0,0,310,A
3-PA,81,0,312,0,0,312,T
3-PA,82,0,0,0,314,314,C
3-PA,83,0,314,0,0,314,T
3-PA,84,0,0,314,0,314,G
3-PA,85,313,0,0,0,313,A
3-PA,86,314,0,0,0,314,A
3-PA,87,317,0,0,0,317,A
3-PA,88,316,0,0,0,316,A
3-PA,89,0,316,0,0,316,T
3-PA,90,0,316,0,0,316,T
3-PA,91,0,1,317,0,318,G
3-PA,92,318,0,0,0,318,A
3-PA,93,318,0,0,0,318,A
3-PA,94,316,0,0,0,316,A
3-PA,95,0,0,0,320,320,C
3-PA,96,321,0,0,0,321,A
3-PA,97,322,0,0,0,322,A
3-PA,98,322,0,1,0,323,A
3-PA,99,0,0,0,327,327,C
3-PA,100,327,0,0,0,327,A
3-PA,101,330,1,0,0,331,A
3-PA,102,331,0,0,0,331,A
3-PA,103,0,332,0,0,332,T
3-PA,104,1,327,0,2,330,T
3-PA,105,0,332,0,0,332,T
3-PA,106,1,0,330,0,331,G
3-PA,107,0,0,0,334,334,C
3-PA,108,333,0,0,0,333,A
3-PA,109,0,0,347,0,347,G
3-PA,110,0,0,0,350,350,C
3-PA,111,378,0,0,0,378,A
3-PA,112,383,0,0,0,383,A
3-PA,113,0,392,0,0,392,T
3-PA,114,405,0,1,0,406,A
3-PA,115,0,405,0,0,405,T
3-PA,116,0,0,411,0,411,G
3-PA,117,0,0,0,415,415,C
3-PA,118,408,0,0,0,408,A
3-PA,119,0,0,0,414,414,C
3-PA,120,0,412,0,0,412,T
3-PA,121,0,0,0,490,490,C
3-PA,122,496,0,3,0,499,A
3-PA,123,0,0,0,511,511,C
3-PA,124,0,509,0,1,510,T
3-PA,125,0,512,0,0,512,T
3-PA,126,0,0,512,0,512,G
3-PA,127,0,0,521,0,521,G
3-PA,128,515,0,1,0,516,A
3-PA,129,0,0,525,0,525,G
3-PA,130,1,0,524,0,525,G
3-PA,131,0,503,0,0,503,T
3-PA,132,0,0,528,0,528,G
3-PA,133,0,528,0,1,529,T
3-PA,134,1,0,536,0,537,G
3-PA,135,0,537,0,0,537,T
3-PA,136,1,538,0,0,539,T
3-PA,137,0,539,0,0,539,T
3-PA,138,1,0,0,546,547,C
3-PA,139,546,0,1,0,547,A
3-PA,140,0,545,0,0,545,T
3-PA,141,0,0,568,0,568,G
3-PA,142,0,563,0,0,563,T
3-PA,143,572,0,0,0,572,A
3-PA,144,0,569,0,1,570,T
3-PA,145,0,572,0,0,572,T
3-PA,146,0,0,1,572,573,C
3-PA,147,573,0,0,0,573,A
3-PA,148,0,1,577,0,578,G
3-PA,149,577,0,0,0,577,A
3-PA,150,0,575,0,0,575,T
3-PA,151,0,576,0,1,577,T
3-PA,152,0,578,0,1,579,T
3-PA,153,0,0,0,576,576,C
3-PA,154,0,0,0,586,586,C
3-PA,155,586,0,0,0,586,A
3-PA,156,0,587,0,0,587,T
3-PA,157,0,583,1,0,584,T
3-PA,158,1,585,0,1,587,T
3-PA,159,0,2,0,586,588,C
3-PA,160,589,0,1,0,590,A
3-PA,161,0,610,0,0,610,T
3-PA,162,1,1,0,606,608,C
3-PA,163,605,1,0,0,606,A
3-PA,164,609,0,1,0,610,A
3-PA,165,0,611,0,0,611,T
3-PA,166,0,2,627,0,629,G
3-PA,167,625,0,0,0,625,A
3-PA,168,623,0,0,0,623,A
3-PA,169,0,1,0,623,624,C
3-PA,170,615,0,0,0,615,A
3-PA,171,620,0,2,0,622,A
3-PA,172,0,0,623,0,623,G
3-PA,173,0,0,630,0,630,G
3-PA,174,0,0,0,629,629,C
3-PA,175,1,2,625,0,628,G
3-PA,176,670,0,1,0,671,A
3-PA,177,673,0,0,0,673,A
3-PA,178,0,676,0,0,676,T
3-PA,179,2,0,0,682,684,C
3-PA,180,685,0,0,0,685,A
3-PA,181,689,0,1,0,690,A
3-PA,182,0,691,0,0,691,T
3-PA,183,690,0,1,0,691,A
3-PA,184,0,0,704,0,704,G
3-PA,185,0,703,0,0,703,T
3-PA,186,1,0,709,0,710,G
3-PA,187,0,0,711,0,711,G
3-PA,188,0,706,0,1,707,T
3-PA,189,707,0,0,0,707,A
3-PA,190,0,0,716,0,716,G
3-PA,191,718,0,0,0,718,A
3-PA,192,716,1,0,0,717,A
3-PA,193,0,0,0,715,715,C
3-PA,194,0,707,0,0,707,T
3-PA,195,0,709,0,0,709,T
3-PA,196,0,2,706,0,708,G
3-PA,197,709,0,0,0,709,A
3-PA,198,0,2,0,708,710,C
3-PA,199,0,0,706,0,706,G
3-PA,200,724,0,0,0,724,A
3-PA,201,0,735,0,0,735,T
3-PA,202,1,0,0,745,746,C
3-PA,203,0,0,0,752,752,C
3-PA,204,759,0,0,0,759,A
3-PA,205,756,0,1,0,757,A
3-PA,206,759,0,1,0,760,A
3-PA,207,0,758,1,0,759,T
3-PA,208,0,0,762,0,762,G
3-PA,209,0,0,0,757,757,C
3-PA,210,750,1,1,0,752,A
3-PA,211,0,0,0,790,790,C
3-PA,212,0,788,0,0,788,T
3-PA,213,0,0,881,0,881,G
3-PA,214,0,882,0,0,882,T
3-PA,215,0,883,0,1,884,T
3-PA,216,883,0,1,0,884,A
3-PA,217,881,0,0,0,881,A
3-PA,218,884,0,0,0,884,A
3-PA,219,0,0,883,0,883,G
3-PA,220,0,0,0,879,879,C
3-PA,221,871,0,0,0,871,A
3-PA,222,0,0,0,868,868,C
3-PA,223,826,0,0,0,826,A
3-PA,224,0,0,860,0,860,G
3-PA,225,861,0,0,0,861,A
3-PA,226,1,857,0,0,858,T
3-PA,227,0,858,0,0,858,T
3-PA,228,0,856,0,1,857,T
3-PA,229,0,1,857,0,858,G
3-PA,230,856,1,1,0,858,A
3-PA,231,857,0,2,0,859,A
3-PA,232,860,0,0,0,860,A
3-PA,233,0,838,1,0,839,T
3-PA,234,842,0,0,0,842,A
3-PA,235,857,0,1,0,858,A
3-PA,236,0,856,1,0,857,T
3-PA,237,1,1,0,858,860,C
3-PA,238,0,0,862,0,862,G
3-PA,239,857,0,0,0,857,A
3-PA,240,0,0,856,0,856,G
3-PA,241,0,2,868,0,870,G
3-PA,242,0,1,870,0,871,G
3-PA,243,0,1,872,0,873,G
3-PA,244,851,1,3,1,856,A
3-PA,245,0,3,856,0,859,G
3-PA,246,877,0,1,1,879,A
3-PA,247,1,1,882,0,884,G
3-PA,248,884,0,1,0,885,A
3-PA,249,0,0,0,885,885,C
3-PA,250,877,0,1,0,878,A
3-PA,251,0,0,899,0,899,G
3-PA,252,892,0,2,1,895,A
3-PA,253,906,0,0,0,906,A
3-PA,254,0,0,0,902,902,C
3-PA,255,891,0,0,0,891,A
3-PA,256,892,0,0,0,892,A
3-PA,257,0,890,1,1,892,T
3-PA,258,0,3,920,1,924,G
3-PA,259,0,0,928,0,928,G
3-PA,260,0,1,0,911,912,C
3-PA,261,0,1,0,917,918,C
3-PA,262,0,916,0,0,916,T
3-PA,263,0,2,929,0,931,G
3-PA,264,0,3,928,0,931,G
3-PA,265,932,0,0,0,932,A
3-PA,266,0,0,0,943,943,C
3-PA,267,903,0,0,0,903,A
3-PA,268,1,0,1011,0,1012,G
3-PA,269,0,1003,1,2,1006,T
3-PA,270,1026,0,0,0,1026,A
3-PA,271,2,1,1026,0,1029,G
3-PA,272,1,1009,0,0,1010,T
3-PA,273,1015,0,1,0,1016,A
3-PA,274,1014,0,1,0,1015,A
3-PA,275,1009,0,3,2,1014,A
3-PA,276,0,1,0,1014,1015,C
3-PA,277,950,0,0,0,950,A
3-PA,278,0,0,970,0,970,G
3-PA,279,0,963,0,0,963,T
3-PA,280,979,1,0,0,980,A
3-PA,281,1,979,0,0,980,T
3-PA,282,0,0,0,999,999,C
3-PA,283,1,992,0,4,997,T
3-PA,284,0,1,995,0,996,G
3-PA,285,0,0,0,986,986,C
3-PA,286,986,0,0,0,986,A
3-PA,287,989,0,1,0,990,A
3-PA,288,1,1,0,996,998,C
3-PA,289,990,1,1,0,992,A
3-PA,290,2,0,0,1041,1043,C
3-PA,291,0,1030,0,2,1032,T
3-PA,292,1035,0,2,0,1037,A
3-PA,293,0,0,0,1039,1039,C
3-PA,294,1,1027,1,2,1031,T
3-PA,295,1,2,1028,0,1031,G
3-PA,296,0,3,1024,0,1027,G
3-PA,297,1027,0,0,0,1027,A
3-PA,298,0,0,1032,0,1032,G
3-PA,299,0,1,0,1008,1009,C
3-PA,300,0,1008,1,2,1011,T
3-PA,301,0,0,1010,0,1010,G
3-PA,302,0,1,1007,0,1008,G
3-PA,303,0,0,1000,0,1000,G
3-PA,304,1006,1,1,0,1008,A
3-PA,305,1004,0,1,0,1005,A
3-PA,306,1008,0,3,0,1011,A
3-PA,307,1,0,0,1005,1006,C
3-PA,308,0,0,0,1011,1011,C
3-PA,309,0,1,1012,0,1013,G
3-PA,310,1009,0,0,0,1009,A
3-PA,311,1008,0,0,0,1008,A
3-PA,312,0,0,1021,0,1021,G
3-PA,313,0,1016,0,0,1016,T
3-PA,314,0,1016,0,0,1016,T
3-PA,315,1,1015,0,0,1016,T
3-PA,316,2,0,0,1018,1020,C
3-PA,317,0,1020,0,0,1020,T
3-PA,318,1020,0,1,0,1021,A
3-PA,319,0,0,0,1011,1011,C
3-PA,320,0,0,0,1019,1019,C
3-PA,321,1005,0,2,0,1007,A
3-PA,322,0,0,1018,0,1018,G
3-PA,323,1020,0,0,0,1020,A
3-PA,324,0,1022,0,0,1022,T
3-PA,325,0,1018,0,0,1018,T
3-PA,326,0,1014,0,0,1014,T
3-PA,327,0,0,1025,0,1025,G
3-PA,328,0,1023,0,0,1023,T
3-PA,329,1024,0,1,0,1025,A
3-PA,330,0,1028,0,0,1028,T
3-PA,331,0,0,1015,0,1015,G
3-PA,332,1060,1,3,0,1064,A
3-PA,333,0,1059,0,0,1059,T
3-PA,334,0,1064,0,1,1065,T
3-PA,335,1064,0,0,0,1064,A
3-PA,336,0,0,0,1057,1057,C
3-PA,337,1051,0,2,0,1053,A
3-PA,338,1054,0,1,0,1055,A
3-PA,339,0,1,1055,0,1056,G
3-PA,340,0,0,1064,0,1064,G
3-PA,341,1014,0,2,0,1016,A
3-PA,342,0,2,1032,1,1035,G
3-PA,343,1029,0,4,0,1033,A
3-PA,344,1033,0,0,0,1033,A
3-PA,345,0,1,0,1036,1037,C
3-PA,346,1015,0,0,0,1015,A
3-PA,347,0,0,1026,0,1026,G
3-PA,348,1020,0,2,0,1022,A
3-PA,349,0,1004,0,2,1006,T
3-PA,350,0,1002,0,0,1002,T
3-PA,351,1,0,0,994,995,C
3-PA,352,994,0,0,0,994,A
3-PA,353,0,993,0,1,994,T
3-PA,354,2,0,0,991,993,C
3-PA,355,1,1,992,0,994,G
3-PA,356,997,0,0,0,997,A
3-PA,357,995,0,1,0,996,A
3-PA,358,1000,0,0,0,1000,A
3-PA,359,0,1000,0,0,1000,T
3-PA,360,0,992,0,1,993,T
3-PA,361,0,2,992,0,994,G
3-PA,362,0,3,986,0,989,G
3-PA,363,0,0,992,0,992,G
3-PA,364,0,1,995,0,996,G
3-PA,365,0,984,0,1,985,T
3-PA,366,1,0,999,0,1000,G
3-PA,367,999,0,1,0,1000,A
3-PA,368,1,0,0,1008,1009,C
3-PA,369,1011,0,1,0,1012,A
3-PA,370,1012,0,0,0,1012,A
3-PA,371,0,0,1030,0,1030,G
3-PA,372,1,2,1031,0,1034,G
3-PA,373,1017,0,4,0,1021,A
3-PA,374,0,2,1022,1,1025,G
3-PA,375,1004,0,0,1,1005,A
3-PA,376,0,0,1007,0,1007,G
3-PA,377,1000,0,0,0,1000,A
3-PA,378,1000,1,1,1,1003,A
3-PA,379,0,0,1035,0,1035,G
3-PA,380,0,1019,0,0,1019,T
3-PA,381,1,0,0,1021,1022,C
3-PA,382,1,1,0,1022,1024,C
3-PA,383,1030,0,0,0,1030,A
3-PA,384,1,0,0,1049,1050,C
3-PA,385,1064,0,1,0,1065,A
3-PA,386,0,1086,0,1,1087,T
3-PA,387,1131,0,0,0,1131,A
3-PA,388,0,1104,1,0,1105,T
3-PA,389,1105,0,0,0,1105,A
3-PA,390,0,1091,0,0,1091,T
3-PA,391,0,1087,0,2,1089,T
3-PA,392,1142,0,0,0,1142,A
3-PA,393,1,0,0,1132,1133,C
3-PA,394,0,0,0,1092,1092,C
3-PA,395,0,1075,0,0,1075,T
3-PA,396,0,1036,0,1,1037,T
3-PA,397,0,1,1034,0,1035,G
3-PA,398,1032,0,1,0,1033,A
3-PA,399,1,0,962,0,963,G
3-PA,400,965,0,2,0,967,A
3-PA,401,965,0,4,0,969,A
3-PA,402,0,3,976,0,979,G
3-PA,403,2,1,973,0,976,G
3-PA,404,0,0,0,975,975,C
3-PA,405,2,1,0,978,981,C
3-PA,406,974,0,1,0,975,A
3-PA,407,977,0,0,0,977,A
3-PA,408,0,978,0,0,978,T
3-PA,409,974,2,2,0,978,A
3-PA,410,980,0,0,0,980,A
3-PA,411,0,1,984,0,985,G
3-PA,412,975,1,0,0,976,A
3-PA,413,0,971,0,0,971,T
3-PA,414,0,964,0,2,966,T
3-PA,415,964,0,0,1,965,A
3-PA,416,962,0,2,0,964,A
3-PA,417,968,0,0,0,968,A
3-PA,418,0,970,0,3,973,T
3-PA,419,0,1,0,974,975,C
3-PA,420,0,942,0,1,943,T
3-PA,421,0,2,950,0,952,G
3-PA,422,952,1,0,0,953,A
3-PA,423,0,0,956,0,956,G
3-PA,424,955,1,1,0,957,A
3-PA,425,961,0,0,0,961,A
3-PA,426,0,0,0,960,960,C
3-PA,427,947,0,1,0,948,A
3-PA,428,0,1,0,954,955,C
3-PA,429,953,0,2,0,955,A
3-PA,430,3,0,0,960,963,C
3-PA,431,959,0,1,0,960,A
3-PA,432,0,0,0,981,981,C
3-PA,433,981,0,0,0,981,A
3-PA,434,0,973,0,0,973,T
3-PA,435,0,970,0,1,971,T
3-PA,436,0,2,0,976,978,C
3-PA,437,971,0,0,0,971,A
3-PA,438,1,1,0,976,978,C
3-PA,439,965,0,0,0,965,A
3-PA,440,0,963,0,2,965,T
3-PA,441,0,932,0,2,934,T
3-PA,442,0,942,0,1,943,T
3-PA,443,0,944,0,1,945,T
3-PA,444,1,0,0,949,950,C
3-PA,445,0,943,0,1,944,T
3-PA,446,2,0,0,945,947,C
3-PA,447,944,0,0,0,944,A
3-PA,448,0,943,0,0,943,T
3-PA,449,0,949,0,1,950,T
3-PA,450,3,0,0,951,954,C
3-PA,451,940,1,2,1,944,A
3-PA,452,0,0,0,958,958,C
3-PA,453,0,956,0,1,957,T
3-PA,454,0,1,956,0,957,G
3-PA,455,0,1,957,0,958,G
3-PA,456,941,1,1,0,943,A
3-PA,457,0,1,972,0,973,G
3-PA,458,971,1,2,0,974,A
3-PA,459,0,0,979,0,979,G
3-PA,460,0,0,982,0,982,G
3-PA,461,971,0,2,0,973,A
3-PA,462,973,0,2,0,975,A
3-PA,463,957,0,0,0,957,A
3-PA,464,0,947,0,0,947,T
3-PA,465,0,5,940,1,946,G
3-PA,466,0,0,942,0,942,G
3-PA,467,0,0,0,947,947,C
3-PA,468,0,0,0,945,945,C
3-PA,469,942,0,0,0,942,A
3-PA,470,0,0,0,943,943,C
3-PA,471,937,0,1,0,938,A
3-PA,472,943,0,1,0,944,A
3-PA,473,945,1,0,1,947,A
3-PA,474,0,1,945,0,946,G
3-PA,475,0,1,941,0,942,G
3-PA,476,0,0,0,949,949,C
3-PA,477,946,0,1,0,947,A
3-PA,478,0,3,957,0,960,G
3-PA,479,956,0,2,0,958,A
3-PA,480,0,0,0,969,969,C
3-PA,481,0,965,0,2,967,T
3-PA,482,973,0,1,1,975,A
3-PA,483,0,1,0,966,967,C
3-PA,484,961,0,1,0,962,A
3-PA,485,1,0,0,967,968,C
3-PA,486,1,941,0,0,942,T
3-PA,487,0,1,0,945,946,C
3-PA,488,1,933,1,3,938,T
3-PA,489,1,0,0,933,934,C
3-PA,490,0,2,935,0,937,G
3-PA,491,938,0,0,0,938,A
3-PA,492,0,0,0,935,935,C
3-PA,493,0,0,939,0,939,G
3-PA,494,935,0,0,0,935,A
3-PA,495,0,0,937,0,937,G
3-PA,496,0,0,935,0,935,G
3-PA,497,935,0,2,0,937,A
3-PA,498,937,0,0,0,937,A
3-PA,499,934,0,1,0,935,A
3-PA,500,1,0,933,0,934,G
3-PA,501,1,0,0,930,931,C
3-PA,502,930,0,1,0,931,A
3-PA,503,1,3,946,0,950,G
3-PA,504,0,0,949,1,950,G
3-PA,505,0,0,947,0,947,G
3-PA,506,1,0,0,944,945,C
3-PA,507,0,940,0,0,940,T
3-PA,508,940,0,0,0,940,A
3-PA,509,1,0,955,0,956,G
3-PA,510,0,0,1005,0,1005,G
3-PA,511,1009,0,0,0,1009,A
3-PA,512,0,976,0,0,976,T
3-PA,513,0,958,0,0,958,T
3-PA,514,955,1,0,1,957,A
3-PA,515,965,0,2,0,967,A
3-PA,516,0,1,974,0,975,G
3-PA,517,973,0,1,0,974,A
3-PA,518,1,2,0,961,964,C
3-PA,519,3,1,0,892,896,C
3-PA,520,882,0,0,0,882,A
3-PA,521,1,0,884,0,885,G
3-PA,522,0,1,889,0,890,G
3-PA,523,0,0,0,891,891,C
3-PA,524,0,847,0,2,849,T
3-PA,525,0,0,870,0,870,G
3-PA,526,0,862,0,1,863,T
3-PA,527,0,864,0,0,864,T
3-PA,528,0,863,0,0,863,T
3-PA,529,863,0,0,0,863,A
3-PA,530,0,0,0,867,867,C
3-PA,531,4,0,0,854,858,C
3-PA,532,853,0,0,0,853,A
3-PA,533,0,852,0,0,852,T
3-PA,534,803,0,0,0,803,A
3-PA,535,806,0,1,0,807,A
3-PA,536,0,1,811,0,812,G
3-PA,537,811,0,0,0,811,A
3-PA,538,0,1,0,810,811,C
3-PA,539,798,0,2,0,800,A
3-PA,540,802,0,0,0,802,A
3-PA,541,1,2,803,0,806,G
3-PA,542,800,0,1,0,801,A
3-PA,543,804,0,1,0,805,A
3-PA,544,799,0,1,0,800,A
3-PA,545,0,783,0,0,783,T
3-PA,546,0,0,792,0,792,G
3-PA,547,2,0,793,0,795,G
3-PA,548,0,0,0,796,796,C
3-PA,549,1,0,0,795,796,C
3-PA,550,793,0,0,0,793,A
3-PA,551,812,0,0,0,812,A
3-PA,552,0,1,0,810,811,C
3-PA,553,809,0,0,0,809,A
3-PA,554,0,1,808,0,809,G
3-PA,555,785,0,3,0,788,A
3-PA,556,0,1,813,0,814,G
3-PA,557,0,0,818,0,818,G
3-PA,558,0,0,0,815,815,C
3-PA,559,1,0,0,812,813,C
3-PA,560,0,786,0,0,786,T
3-PA,561,784,0,2,0,786,A
3-PA,562,0,799,0,0,799,T
3-PA,563,0,0,799,0,799,G
3-PA,564,1,0,799,0,800,G
3-PA,565,0,1,767,0,768,G
3-PA,566,742,0,1,0,743,A
3-PA,567,0,734,0,1,735,T
3-PA,568,1,720,0,0,721,T
3-PA,569,1,0,0,783,784,C
3-PA,570,0,1,0,774,775,C
3-PA,571,0,762,1,0,763,T
3-PA,572,0,762,0,0,762,T
3-PA,573,0,754,0,0,754,T
3-PA,574,1,0,0,760,761,C
3-PA,575,0,0,761,0,761,G
3-PA,576,0,757,0,1,758,T
3-PA,577,1,0,0,763,764,C
3-PA,578,735,0,1,0,736,A
3-PA,579,0,0,803,0,803,G
3-PA,580,0,805,0,0,805,T
3-PA,581,1,0,0,800,801,C
3-PA,582,0,0,0,806,806,C
3-PA,583,0,1,813,0,814,G
3-PA,584,815,0,1,0,816,A
3-PA,585,817,0,1,0,818,A
3-PA,586,814,0,2,0,816,A
3-PA,587,0,0,822,0,822,G
3-PA,588,791,0,0,0,791,A
3-PA,589,0,1,796,0,797,G
3-PA,590,0,0,797,0,797,G
3-PA,591,0,0,0,802,802,C
3-PA,592,0,0,805,0,805,G
3-PA,593,804,0,0,0,804,A
3-PA,594,805,1,0,0,806,A
3-PA,595,0,1,813,0,814,G
3-PA,596,814,0,0,0,814,A
3-PA,597,813,0,2,0,815,A
3-PA,598,810,1,0,0,811,A
3-PA,599,0,0,0,821,821,C
3-PA,600,817,1,0,0,818,A
3-PA,601,820,0,0,0,820,A
3-PA,602,0,821,0,0,821,T
3-PA,603,1,816,0,0,817,T
3-PA,604,0,0,820,0,820,G
3-PA,605,819,0,1,0,820,A
3-PA,606,819,0,0,1,820,A
3-PA,607,0,3,818,0,821,G
3-PA,608,815,0,1,0,816,A
3-PA,609,813,1,0,0,814,A
3-PA,610,810,0,0,1,811,A
3-PA,611,813,0,1,0,814,A
3-PA,612,820,0,0,0,820,A
3-PA,613,0,810,0,1,811,T
3-PA,614,0,814,0,0,814,T
3-PA,615,1,814,0,0,815,T
3-PA,616,0,0,815,1,816,G
3-PA,617,813,0,1,0,814,A
3-PA,618,813,0,2,0,815,A
3-PA,619,818,0,0,0,818,A
3-PA,620,0,818,0,0,818,T
3-PA,621,1,0,0,881,882,C
3-PA,622,879,0,0,0,879,A
3-PA,623,0,1,0,893,894,C
3-PA,624,893,1,0,0,894,A
3-PA,625,0,2,907,0,909,G
3-PA,626,0,2,939,0,941,G
3-PA,627,964,0,1,0,965,A
3-PA,628,975,0,0,0,975,A
3-PA,629,0,2,0,981,983,C
3-PA,630,0,940,0,0,940,T
3-PA,631,987,0,2,0,989,A
3-PA,632,0,1004,0,1,1005,T
3-PA,633,0,0,1035,0,1035,G
3-PA,634,0,0,0,1032,1032,C
3-PA,635,0,0,1017,0,1017,G
3-PA,636,0,1007,0,0,1007,T
3-PA,637,1000,1,0,0,1001,A
3-PA,638,0,0,997,0,997,G
3-PA,639,0,0,999,0,999,G
3-PA,640,0,0,0,983,983,C
3-PA,641,0,967,0,0,967,T
3-PA,642,0,958,0,0,958,T
3-PA,643,0,0,959,0,959,G
3-PA,644,1,2,0,958,961,C
3-PA,645,2,1,0,959,962,C
3-PA,646,1,1,974,0,976,G
3-PA,647,977,1,1,0,979,A
3-PA,648,0,0,0,982,982,C
3-PA,649,2,0,0,981,983,C
3-PA,650,985,1,1,0,987,A
3-PA,651,984,0,0,0,984,A
3-PA,652,986,0,2,0,988,A
3-PA,653,0,1,1021,0,1022,G
3-PA,654,0,1024,0,0,1024,T
3-PA,655,3,0,0,1016,1019,C
3-PA,656,0,1019,0,2,1021,T
3-PA,657,2,2,0,1020,1024,C
3-PA,658,0,0,0,1028,1028,C
3-PA,659,0,0,0,1040,1040,C
3-PA,660,1036,0,1,0,1037,A
3-PA,661,1,0,0,1040,1041,C
3-PA,662,1,1,0,1029,1031,C
3-PA,663,1,0,1031,0,1032,G
3-PA,664,1046,0,0,0,1046,A
3-PA,665,1046,0,0,0,1046,A
3-PA,666,0,0,0,1055,1055,C
3-PA,667,0,1036,0,3,1039,T
3-PA,668,0,1051,0,0,1051,T
3-PA,669,1,0,0,1071,1072,C
3-PA,670,0,1067,0,1,1068,T
3-PA,671,2,0,1,1067,1070,C
3-PA,672,2,0,0,1066,1068,C
3-PA,673,0,1052,0,1,1053,T
3-PA,674,0,0,1065,0,1065,G
3-PA,675,0,0,0,1065,1065,C
3-PA,676,3,0,0,1065,1068,C
3-PA,677,0,1061,0,1,1062,T
3-PA,678,0,1052,0,0,1052,T
3-PA,679,0,3,1053,0,1056,G
3-PA,680,1054,0,0,0,1054,A
3-PA,681,0,2,1073,0,1075,G
3-PA,682,1071,0,1,0,1072,A
3-PA,683,1081,0,1,0,1082,A
3-PA,684,0,1105,0,1,1106,T
3-PA,685,0,1117,0,0,1117,T
3-PA,686,0,1118,0,1,1119,T
3-PA,687,0,1118,0,0,1118,T
3-PA,688,1118,0,0,0,1118,A
3-PA,689,1,1,1120,0,1122,G
3-PA,690,1116,0,2,0,1118,A
3-PA,691,1,1,1165,0,1167,G
3-PA,692,0,1,0,1158,1159,C
3-PA,693,0,0,0,1165,1165,C
3-PA,694,0,1163,0,0,1163,T
3-PA,695,1201,0,0,0,1201,A
3-PA,696,0,1205,1,0,1206,T
3-PA,697,0,1,1209,0,1210,G
3-PA,698,0,1211,0,0,1211,T
3-PA,699,0,6,1214,0,1220,G
3-PA,700,1,0,1203,0,1204,G
3-PA,701,1196,0,2,0,1198,A
3-PA,702,0,1188,0,2,1190,T
3-PA,703,2,0,1176,0,1178,G
3-PA,704,0,1,1197,0,1198,G
3-PA,705,1197,0,1,0,1198,A
3-PA,706,0,1186,0,1,1187,T
3-PA,707,0,1183,0,0,1183,T
3-PA,708,0,0,0,1176,1176,C
3-PA,709,0,4,1175,0,1179,G
3-PA,710,1183,1,0,0,1184,A
3-PA,711,1183,0,1,0,1184,A
3-PA,712,0,0,0,1189,1189,C
3-PA,713,2,0,0,1146,1148,C
3-PA,714,0,0,1152,1,1153,G
3-PA,715,1153,0,1,0,1154,A
3-PA,716,1155,0,1,0,1156,A
3-PA,717,0,3,0,1162,1165,C
3-PA,718,1,2,1156,0,1159,G
3-PA,719,1,0,1178,0,1179,G
3-PA,720,0,0,0,1183,1183,C
3-PA,721,1,1174,1,3,1179,T
3-PA,722,0,1,1212,0,1213,G
3-PA,723,0,1,0,1214,1215,C
3-PA,724,1220,0,0,0,1220,A
3-PA,725,1,1219,0,0,1220,T
3-PA,726,0,1208,0,1,1209,T
3-PA,727,0,1,1210,0,1211,G
3-PA,728,1155,0,1,0,1156,A
3-PA,729,0,3,1171,0,1174,G
3-PA,730,1,3,1168,0,1172,G
3-PA,731,0,1,1158,0,1159,G
3-PA,732,0,0,0,1148,1148,C
3-PA,733,1145,0,0,0,1145,A
3-PA,734,1145,1,2,0,1148,A
3-PA,735,0,0,1158,0,1158,G
3-PA,736,1,0,0,1158,1159,C
3-PA,737,0,1160,0,0,1160,T
3-PA,738,0,1153,0,0,1153,T
3-PA,739,0,1152,0,0,1152,T
3-PA,740,0,1,0,1156,1157,C
3-PA,741,0,1155,0,0,1155,T
3-PA,742,2,1,0,1161,1164,C
3-PA,743,1155,0,0,0,1155,A
3-PA,744,1145,0,0,0,1145,A
3-PA,745,1142,0,0,1,1143,A
3-PA,746,0,1145,0,0,1145,T
3-PA,747,1,0,1179,0,1180,G
3-PA,748,0,1174,0,1,1175,T
3-PA,749,0,1,0,1183,1184,C
3-PA,750,3,0,0,1184,1187,C
3-PA,751,1192,0,2,0,1194,A
3-PA,752,1198,0,2,0,1200,A
3-PA,753,1196,0,2,1,1199,A
3-PA,754,1,1,1214,0,1216,G
3-PA,755,1209,0,1,0,1210,A
3-PA,756,1182,0,1,0,1183,A
3-PA,757,0,1,1186,0,1187,G
3-PA,758,0,1169,0,1,1170,T
3-PA,759,0,2,1166,0,1168,G
3-PA,760,1156,0,2,0,1158,A
3-PA,761,1158,0,1,0,1159,A
3-PA,762,0,1159,0,1,1160,T
3-PA,763,0,0,1146,0,1146,G
3-PA,764,1,0,0,1153,1154,C
3-PA,765,2,0,0,1145,1147,C
3-PA,766,1,1,0,1146,1148,C
3-PA,767,1158,0,0,0,1158,A
3-PA,768,1169,1,3,0,1173,A
3-PA,769,1181,0,0,0,1181,A
3-PA,770,0,1180,0,0,1180,T
3-PA,771,0,1175,0,2,1177,T
3-PA,772,0,4,1178,0,1182,G
3-PA,773,1169,1,2,0,1172,A
3-PA,774,1169,0,2,0,1171,A
3-PA,775,0,2,1,1170,1173,C
3-PA,776,0,0,0,1170,1170,C
3-PA,777,1,1148,0,4,1153,T
3-PA,778,0,1185,0,0,1185,T
3-PA,779,0,1190,0,1,1191,T
3-PA,780,0,1203,0,0,1203,T
3-PA,781,0,1,0,1211,1212,C
3-PA,782,0,1206,0,1,1207,T
3-PA,783,0,1,1212,0,1213,G
3-PA,784,1208,0,1,0,1209,A
3-PA,785,1218,0,5,1,1224,A
3-PA,786,0,2,1230,0,1232,G
3-PA,787,1213,2,1,0,1216,A
3-PA,788,0,0,0,1215,1215,C
3-PA,789,1196,0,1,0,1197,A
3-PA,790,1210,0,4,0,1214,A
3-PA,791,0,0,0,1327,1327,C
3-PA,792,1329,0,1,0,1330,A
3-PA,793,0,0,0,1331,1331,C
3-PA,794,2,1,0,1320,1323,C
3-PA,795,1311,1,1,0,1313,A
3-PA,796,1314,0,2,0,1316,A
3-PA,797,0,7,1316,0,1323,G
3-PA,798,1322,0,1,0,1323,A
3-PA,799,0,0,0,1323,1323,C
3-PA,800,3,0,0,1209,1212,C
3-PA,801,1201,2,1,0,1204,A
3-PA,802,1209,0,0,0,1209,A
3-PA,803,0,1210,0,0,1210,T
3-PA,804,0,3,0,1204,1207,C
3-PA,805,1209,0,0,0,1209,A
3-PA,806,1199,0,0,0,1199,A
3-PA,807,1199,0,0,0,1199,A
3-PA,808,0,0,0,1209,1209,C
3-PA,809,0,1199,0,2,1201,T
3-PA,810,0,1204,0,0,1204,T
3-PA,811,0,0,0,1206,1206,C
3-PA,812,0,0,0,1212,1212,C
3-PA,813,1,2,1221,0,1224,G
3-PA,814,1221,1,0,0,1222,A
3-PA,815,1223,0,0,0,1223,A
3-PA,816,0,1224,0,0,1224,T
3-PA,817,2,1,1207,0,1210,G
3-PA,818,0,0,1219,0,1219,G
3-PA,819,1228,0,0,0,1228,A
3-PA,820,0,2,0,1227,1229,C
3-PA,821,1,1,0,1228,1230,C
3-PA,822,0,1265,0,1,1266,T
3-PA,823,4,0,0,1298,1302,C
3-PA,824,1,1,0,1301,1303,C
3-PA,825,0,1297,0,0,1297,T
3-PA,826,0,1307,0,0,1307,T
3-PA,827,0,0,1368,0,1368,G
3-PA,828,0,1363,0,0,1363,T
3-PA,829,0,1359,1,0,1360,T
3-PA,830,1356,1,0,0,1357,A
3-PA,831,0,1315,0,0,1315,T
3-PA,832,0,0,0,1303,1303,C
3-PA,833,1268,0,0,0,1268,A
3-PA,834,0,1,1268,0,1269,G
3-PA,835,0,0,0,1262,1262,C
3-PA,836,1,2,1218,0,1221,G
3-PA,837,2,2,1243,0,1247,G
3-PA,838,0,1246,0,3,1249,T
3-PA,839,1,1,0,1244,1246,C
3-PA,840,4,2,0,1246,1252,C
3-PA,841,1256,0,0,0,1256,A
3-PA,842,1256,0,2,0,1258,A
3-PA,843,1254,1,2,0,1257,A
3-PA,844,0,1258,0,0,1258,T
3-PA,845,0,1252,0,0,1252,T
3-PA,846,1,2,0,1238,1241,C
3-PA,847,0,1,0,1221,1222,C
3-PA,848,0,1221,0,1,1222,T
3-PA,849,1,0,0,1228,1229,C
3-PA,850,0,0,0,1231,1231,C
3-PA,851,0,1216,0,2,1218,T
3-PA,852,0,1,1223,0,1224,G
3-PA,853,1219,0,0,0,1219,A
3-PA,854,0,1225,0,0,1225,T
3-PA,855,1,2,1203,0,1206,G
3-PA,856,0,3,1190,0,1193,G
3-PA,857,1193,0,1,0,1194,A
3-PA,858,0,1182,0,0,1182,T
3-PA,859,0,0,1186,0,1186,G
3-PA,860,0,0,0,1250,1250,C
3-PA,861,0,1236,0,3,1239,T
3-PA,862,0,1246,0,0,1246,T
3-PA,863,0,1244,0,1,1245,T
3-PA,864,1237,0,2,0,1239,A
3-PA,865,1246,1,0,0,1247,A
3-PA,866,1243,0,0,0,1243,A
3-PA,867,1245,0,2,1,1248,A
3-PA,868,0,1248,0,0,1248,T
3-PA,869,3,1133,4,0,1140,T
3-PA,870,0,2,1138,0,1140,G
3-PA,871,1131,0,1,0,1132,A
3-PA,872,0,0,1145,0,1145,G
3-PA,873,1,0,0,1148,1149,C
3-PA,874,1143,0,0,0,1143,A
3-PA,875,0,1155,0,0,1155,T
3-PA,876,0,1154,0,0,1154,T
3-PA,877,0,2,1152,0,1154,G
3-PA,878,1152,0,1,0,1153,A
3-PA,879,1137,0,4,0,1141,A
3-PA,880,0,1,1145,0,1146,G
3-PA,881,1128,0,0,0,1128,A
3-PA,882,2,0,0,1135,1137,C
3-PA,883,2,1,0,1124,1127,C
3-PA,884,1,0,1,1107,1109,C
3-PA,885,1100,1,0,0,1101,A
3-PA,886,1107,0,3,0,1110,A
3-PA,887,0,0,1114,0,1114,G
3-PA,888,0,1116,0,0,1116,T
3-PA,889,1,0,0,1113,1114,C
3-PA,890,1112,0,1,0,1113,A
3-PA,891,0,0,0,1110,1110,C
3-PA,892,0,0,1103,0,1103,G
3-PA,893,1118,1,0,1,1120,A
3-PA,894,1113,0,2,0,1115,A
3-PA,895,0,0,1160,0,1160,G
3-PA,896,0,1,1156,0,1157,G
3-PA,897,1153,0,2,0,1155,A
3-PA,898,0,1,1164,0,1165,G
3-PA,899,1158,0,3,0,1161,A
3-PA,900,1158,0,0,1,1159,A
3-PA,901,0,0,1157,0,1157,G
3-PA,902,0,2,1149,0,1151,G
3-PA,903,0,5,1151,0,1156,G
3-PA,904,1137,0,0,0,1137,A
3-PA,905,1,1136,0,2,1139,T
3-PA,906,1,2,0,1137,1140,C
3-PA,907,1,1,0,1213,1215,C
3-PA,908,1,0,0,1233,1234,C
3-PA,909,1255,0,1,0,1256,A
3-PA,910,0,1259,0,0,1259,T
3-PA,911,0,1264,0,0,1264,T
3-PA,912,1307,0,1,0,1308,A
3-PA,913,0,1309,0,0,1309,T
3-PA,914,1304,0,2,0,1306,A
3-PA,915,0,1296,0,3,1299,T
3-PA,916,0,4,1155,0,1159,G
3-PA,917,1155,0,1,0,1156,A
3-PA,918,0,1145,0,0,1145,T
3-PA,919,0,0,1158,0,1158,G
3-PA,920,0,1,0,1150,1151,C
3-PA,921,0,2,1135,0,1137,G
3-PA,922,1143,0,3,0,1146,A
3-PA,923,0,1143,0,2,1145,T
3-PA,924,3,0,0,1149,1152,C
3-PA,925,1148,0,1,0,1149,A
3-PA,926,1138,0,1,0,1139,A
3-PA,927,0,0,1145,0,1145,G
3-PA,928,0,1137,0,2,1139,T
3-PA,929,1,1,1145,0,1147,G
3-PA,930,1,1,0,1150,1152,C
3-PA,931,1154,0,0,0,1154,A
3-PA,932,1,1158,0,0,1159,T
3-PA,933,1155,0,0,0,1155,A
3-PA,934,1164,0,1,0,1165,A
3-PA,935,1160,1,1,0,1162,A
3-PA,936,1162,0,0,0,1162,A
3-PA,937,1162,0,0,0,1162,A
3-PA,938,0,0,0,1167,1167,C
3-PA,939,1150,0,1,0,1151,A
3-PA,940,0,1153,0,1,1154,T
3-PA,941,0,1146,0,1,1147,T
3-PA,942,0,1,0,1152,1153,C
3-PA,943,0,1131,1,0,1132,T
3-PA,944,0,1131,0,0,1131,T
3-PA,945,0,1133,0,0,1133,T
3-PA,946,0,2,1137,1,1140,G
3-PA,947,1,0,1138,0,1139,G
3-PA,948,1138,1,0,0,1139,A
3-PA,949,0,1137,0,0,1137,T
3-PA,950,0,1,1145,0,1146,G
3-PA,951,0,0,1161,0,1161,G
3-PA,952,1159,0,1,0,1160,A
3-PA,953,1160,0,1,1,1162,A
3-PA,954,1160,0,4,0,1164,A
3-PA,955,0,1,1172,0,1173,G
3-PA,956,1165,0,5,0,1170,A
3-PA,957,1267,0,2,0,1269,A
3-PA,958,0,0,0,1282,1282,C
3-PA,959,0,1,0,1277,1278,C
3-PA,960,0,1264,0,0,1264,T
3-PA,961,0,1285,0,0,1285,T
3-PA,962,1292,0,2,0,1294,A
3-PA,963,0,1291,0,0,1291,T
3-PA,964,1285,0,0,0,1285,A
3-PA,965,0,1315,0,0,1315,T
3-PA,966,1203,0,2,0,1205,A
3-PA,967,2,0,1213,0,1215,G
3-PA,968,0,1191,0,3,1194,T
3-PA,969,0,0,0,1189,1189,C
3-PA,970,1174,0,0,0,1174,A
3-PA,971,1179,0,0,0,1179,A
3-PA,972,1178,0,0,1,1179,A
3-PA,973,0,0,0,1187,1187,C
3-PA,974,1,0,1,1153,1155,C
3-PA,975,1148,0,4,0,1152,A
3-PA,976,1,0,1,1160,1162,C
3-PA,977,1166,0,2,0,1168,A
3-PA,978,0,1,0,1174,1175,C
3-PA,979,0,3,1174,0,1177,G
3-PA,980,1170,0,1,0,1171,A
3-PA,981,1177,0,0,0,1177,A
3-PA,982,1167,0,4,0,1171,A
3-PA,983,1162,0,2,1,1165,A
3-PA,984,0,0,1176,0,1176,G
3-PA,985,0,0,1161,0,1161,G
3-PA,986,0,0,1180,0,1180,G
3-PA,987,1173,1,1,0,1175,A
3-PA,988,1180,0,0,0,1180,A
3-PA,989,0,1177,0,0,1177,T
3-PA,990,1183,0,0,0,1183,A
3-PA,991,1182,0,4,0,1186,A
3-PA,992,1181,1,2,0,1184,A
3-PA,993,0,1179,0,1,1180,T
3-PA,994,0,1178,0,1,1179,T
3-PA,995,1,0,2,1182,1185,C
3-PA,996,1187,0,0,0,1187,A
3-PA,997,1193,0,0,0,1193,A
3-PA,998,1194,0,0,0,1194,A
3-PA,999,0,1197,0,0,1197,T
3-PA,1000,0,1203,0,1,1204,T
3-PA,1001,1206,0,0,0,1206,A
3-PA,1002,1,0,0,1207,1208,C
3-PA,1003,2,0,0,1209,1211,C
3-PA,1004,0,1204,0,1,1205,T
3-PA,1005,0,1,1211,0,1212,G
3-PA,1006,0,0,0,1219,1219,C
3-PA,1007,0,1218,0,0,1218,T
3-PA,1008,0,0,1243,0,1243,G
3-PA,1009,0,1231,0,2,1233,T
3-PA,1010,2,0,0,1240,1242,C
3-PA,1011,1241,1,5,0,1247,A
3-PA,1012,1,1241,0,0,1242,T
3-PA,1013,2,4,1239,0,1245,G
3-PA,1014,1,1,1244,0,1246,G
3-PA,1015,1243,0,0,0,1243,A
3-PA,1016,1280,0,2,0,1282,A
3-PA,1017,0,0,1271,0,1271,G
3-PA,1018,0,0,0,1264,1264,C
3-PA,1019,1263,0,0,0,1263,A
3-PA,1020,1266,1,1,0,1268,A
3-PA,1021,0,0,1281,0,1281,G
3-PA,1022,1,1277,0,1,1279,T
3-PA,1023,1275,0,0,0,1275,A
3-PA,1024,2,1,0,1274,1277,C
3-PA,1025,0,1257,0,2,1259,T
3-PA,1026,0,0,1277,0,1277,G
3-PA,1027,0,1265,0,3,1268,T
3-PA,1028,6,0,0,1259,1265,C
3-PA,1029,1267,0,0,0,1267,A
3-PA,1030,1,2,1284,0,1287,G
3-PA,1031,1286,0,1,0,1287,A
3-PA,1032,1287,0,2,0,1289,A
3-PA,1033,0,1300,0,0,1300,T
3-PA,1034,0,1292,0,1,1293,T
3-PA,1035,2,0,1285,0,1287,G
3-PA,1036,0,1,0,1277,1278,C
3-PA,1037,1279,0,2,0,1281,A
3-PA,1038,1,3,1278,1,1283,G
3-PA,1039,0,1,1267,0,1268,G
3-PA,1040,1270,0,0,0,1270,A
3-PA,1041,1,0,0,1272,1273,C
3-PA,1042,3,0,1248,0,1251,G
3-PA,1043,0,1270,1,0,1271,T
3-PA,1044,0,1274,0,0,1274,T
3-PA,1045,0,2,1277,0,1279,G
3-PA,1046,1283,0,0,0,1283,A
3-PA,1047,1280,0,1,0,1281,A
3-PA,1048,1278,0,0,1,1279,A
3-PA,1049,1278,0,1,0,1279,A
3-PA,1050,0,1273,0,1,1274,T
3-PA,1051,0,2,1279,0,1281,G
3-PA,1052,1265,0,3,0,1268,A
3-PA,1053,0,2,1273,0,1275,G
3-PA,1054,1,1,1273,0,1275,G
3-PA,1055,1274,0,1,0,1275,A
3-PA,1056,0,1,1279,0,1280,G
3-PA,1057,1271,0,1,0,1272,A
3-PA,1058,1278,0,0,0,1278,A
3-PA,1059,0,0,1275,0,1275,G
3-PA,1060,1,0,1262,0,1263,G
3-PA,1061,0,1313,1,0,1314,T
3-PA,1062,0,1320,0,0,1320,T
3-PA,1063,1,0,0,1312,1313,C
3-PA,1064,0,0,0,1316,1316,C
3-PA,1065,1315,0,2,0,1317,A
3-PA,1066,1312,0,1,0,1313,A
3-PA,1067,0,1,1321,0,1322,G
3-PA,1068,0,3,1343,0,1346,G
3-PA,1069,1327,0,2,0,1329,A
3-PA,1070,0,0,0,1336,1336,C
3-PA,1071,0,1335,0,1,1336,T
3-PA,1072,1337,0,1,0,1338,A
3-PA,1073,1338,0,1,0,1339,A
3-PA,1074,1338,0,1,0,1339,A
3-PA,1075,1342,0,1,0,1343,A
3-PA,1076,1331,0,2,2,1335,A
3-PA,1077,0,1,0,1317,1318,C
3-PA,1078,1306,0,0,1,1307,A
3-PA,1079,0,1297,0,1,1298,T
3-PA,1080,0,0,1310,0,1310,G
3-PA,1081,1309,0,2,0,1311,A
3-PA,1082,1312,0,0,0,1312,A
3-PA,1083,0,0,1325,0,1325,G
3-PA,1084,1329,0,0,0,1329,A
3-PA,1085,1328,0,0,0,1328,A
3-PA,1086,1315,0,3,1,1319,A
3-PA,1087,1316,0,1,2,1319,A
3-PA,1088,0,0,0,1325,1325,C
3-PA,1089,0,6,1315,0,1321,G
3-PA,1090,1333,0,2,0,1335,A
3-PA,1091,2,0,1335,0,1337,G
3-PA,1092,1,1322,1,2,1326,T
3-PA,1093,4,0,0,1352,1356,C
3-PA,1094,1363,0,1,0,1364,A
3-PA,1095,1381,0,0,0,1381,A
3-PA,1096,0,0,1,1381,1382,C
3-PA,1097,0,1376,1,2,1379,T
3-PA,1098,0,1,1392,0,1393,G
3-PA,1099,1389,0,0,0,1389,A
3-PA,1100,1387,0,2,1,1390,A
3-PA,1101,0,0,1391,0,1391,G
3-PA,1102,0,1360,0,4,1364,T
3-PA,1103,0,1,1358,0,1359,G
3-PA,1104,0,2,1358,0,1360,G
3-PA,1105,2,2,1357,0,1361,G
3-PA,1106,0,1,0,1355,1356,C
3-PA,1107,0,1351,0,0,1351,T
3-PA,1108,0,0,0,1368,1368,C
3-PA,1109,0,1356,1,2,1359,T
3-PA,1110,0,1369,0,0,1369,T
3-PA,1111,2,0,1470,0,1472,G
3-PA,1112,1,0,1483,0,1484,G
3-PA,1113,0,1484,0,1,1485,T
3-PA,1114,1,1,1481,0,1483,G
3-PA,1115,1470,0,4,0,1474,A
3-PA,1116,1505,0,1,0,1506,A
3-PA,1117,1500,0,0,0,1500,A
3-PA,1118,1527,0,0,0,1527,A
3-PA,1119,1,1,0,1543,1545,C
3-PA,1120,1528,0,0,0,1528,A
3-PA,1121,0,1533,2,2,1537,T
3-PA,1122,1,2,1534,1,1538,G
3-PA,1123,0,2,1593,0,1595,G
3-PA,1124,1,2,0,1621,1624,C
3-PA,1125,1613,1,3,10,1627,A
3-PA,1126,1,0,0,1659,1660,C
3-PA,1127,2,1,1,1667,1671,C
3-PA,1128,1731,1,1,0,1733,A
3-PA,1129,0,1,1783,0,1784,G
3-PA,1130,1781,0,2,1,1784,A
3-PA,1131,0,2,1813,0,1815,G
3-PA,1132,1826,0,3,0,1829,A
3-PA,1133,1847,0,4,0,1851,A
3-PA,1134,0,2,1863,0,1865,G
3-PA,1135,1,1,1864,0,1866,G
3-PA,1136,0,1863,0,1,1864,T
3-PA,1137,1841,0,1,0,1842,A
3-PA,1138,1,0,1852,0,1853,G
3-PA,1139,1858,0,2,0,1860,A
3-PA,1140,0,0,0,1881,1881,C
3-PA,1141,0,1870,1,1,1872,T
3-PA,1142,0,1867,0,2,1869,T
3-PA,1143,0,1874,0,4,1878,T
3-PA,1144,0,3,1878,0,1881,G
3-PA,1145,1870,0,5,1,1876,A
3-PA,1146,1884,0,0,1,1885,A
3-PA,1147,1890,1,0,0,1891,A
3-PA,1148,1883,0,2,1,1886,A
3-PA,1149,2,0,0,1957,1959,C
3-PA,1150,0,1951,0,1,1952,T
3-PA,1151,0,0,1998,0,1998,G
3-PA,1152,0,1,0,1997,1998,C
3-PA,1153,1991,2,7,0,2000,A
3-PA,1154,1,2,2002,0,2005,G
3-PA,1155,1996,2,3,0,2001,A
3-PA,1156,2,5,2166,0,2173,G
3-PA,1157,2180,1,1,0,2182,A
3-PA,1158,0,0,0,2198,2198,C
3-PA,1159,2199,1,2,0,2202,A
3-PA,1160,0,2201,0,0,2201,T
3-PA,1161,2203,0,3,0,2206,A
3-PA,1162,2192,0,6,2,2200,A
3-PA,1163,0,0,2201,0,2201,G
3-PA,1164,0,0,0,2204,2204,C
3-PA,1165,0,4,2158,0,2162,G
3-PA,1166,2267,0,3,0,2270,A
3-PA,1167,0,2253,0,1,2254,T
3-PA,1168,0,2246,0,1,2247,T
3-PA,1169,0,2254,0,2,2256,T
3-PA,1170,0,3,2265,0,2268,G
3-PA,1171,2276,0,2,0,2278,A
3-PA,1172,2269,0,3,2,2274,A
3-PA,1173,2,0,2297,0,2299,G
3-PA,1174,0,1,0,2395,2396,C
3-PA,1175,2378,1,0,0,2379,A
3-PA,1176,2660,1,1,0,2662,A
3-PA,1177,0,2668,0,0,2668,T
3-PA,1178,2681,0,0,0,2681,A
3-PA,1179,0,2701,0,2,2703,T
3-PA,1180,2,6,2708,1,2717,G
3-PA,1181,2748,1,2,1,2752,A
3-PA,1182,0,2742,0,2,2744,T
3-PA,1183,2679,0,3,0,2682,A
3-PA,1184,1,0,2698,0,2699,G
3-PA,1185,0,2625,1,0,2626,T
3-PA,1186,0,2,2622,0,2624,G
3-PA,1187,2623,2,4,0,2629,A
3-PA,1188,0,2,0,2610,2612,C
3-PA,1189,1,4,2604,0,2609,G
3-PA,1190,2636,0,1,1,2638,A
3-PA,1191,2646,3,2,0,2651,A
3-PA,1192,1,0,1,2683,2685,C
3-PA,1193,4,0,0,2684,2688,C
3-PA,1194,2,2679,1,4,2686,T
3-PA,1195,0,5,2799,1,2805,G
3-PA,1196,2808,0,1,0,2809,A
3-PA,1197,2816,1,1,0,2818,A
3-PA,1198,0,2811,0,3,2814,T
3-PA,1199,1,2790,0,0,2791,T
3-PA,1200,2800,1,1,0,2802,A
3-PA,1201,2779,0,5,0,2784,A
3-PA,1202,1,2,2801,0,2804,G
3-PA,1203,2,1,2802,0,2805,G
3-PA,1204,1,2756,0,8,2765,T
3-PA,1205,8,0,3,2748,2759,C
3-PA,1206,2757,1,3,0,2761,A
3-PA,1207,2,2,0,2886,2890,C
3-PA,1208,0,2885,0,5,2890,T
3-PA,1209,0,2898,0,2,2900,T
3-PA,1210,0,2900,0,2,2902,T
3-PA,1211,0,0,0,2893,2893,C
3-PA,1212,2900,0,2,0,2902,A
3-PA,1213,2899,0,1,0,2900,A
3-PA,1214,0,1,2958,0,2959,G
3-PA,1215,0,0,0,2962,2962,C
3-PA,1216,0,2911,0,1,2912,T
3-PA,1217,0,3,3014,0,3017,G
3-PA,1218,1,3,3022,0,3026,G
3-PA,1219,3104,0,5,0,3109,A
3-PA,1220,1,3141,0,1,3143,T
3-PA,1221,3139,1,4,0,3144,A
3-PA,1222,3,1,0,3171,3175,C
3-PA,1223,3132,2,0,0,3134,A
3-PA,1224,0,5,3172,0,3177,G
3-PA,1225,3171,0,5,0,3176,A
3-PA,1226,3144,0,0,0,3144,A
3-PA,1227,0,3111,0,1,3112,T
3-PA,1228,0,5,3144,0,3149,G
3-PA,1229,3131,1,11,0,3143,A
3-PA,1230,1,1,3213,0,3215,G
3-PA,1231,0,3193,0,3,3196,T
3-PA,1232,1,3184,0,3,3188,T
3-PA,1233,5,1,0,3269,3275,C
3-PA,1234,3295,0,2,0,3297,A
3-PA,1235,3302,0,4,1,3307,A
3-PA,1236,0,0,0,3307,3307,C
3-PA,1237,3279,1,2,0,3282,A
3-PA,1238,3292,0,1,0,3293,A
3-PA,1239,3,3,3299,0,3305,G
3-PA,1240,1,4,3341,0,3346,G
3-PA,1241,1,0,2,3366,3369,C
3-PA,1242,1,0,0,3342,3343,C
3-PA,1243,0,3314,0,8,3322,T
3-PA,1244,0,0,3369,0,3369,G
3-PA,1245,0,3365,0,0,3365,T
3-PA,1246,0,8,3400,0,3408,G
3-PA,1247,3408,0,6,0,3414,A
3-PA,1248,1,1,3418,1,3421,G
3-PA,1249,2,0,0,3405,3407,C
3-PA,1250,0,3377,0,4,3381,T
3-PA,1251,3490,0,0,0,3490,A
3-PA,1252,3490,2,2,0,3494,A
3-PA,1253,1,1,0,3512,3514,C
3-PA,1254,1,3494,0,1,3496,T
3-PA,1255,1,10,3501,0,3512,G
3-PA,1256,3500,1,6,1,3508,A
3-PA,1257,0,3510,1,1,3512,T
3-PA,1258,0,3509,0,2,3511,T
3-PA,1259,5,1,0,3509,3515,C
3-PA,1260,3625,0,3,0,3628,A
3-PA,1261,0,0,3725,0,3725,G
3-PA,1262,1,3723,0,3,3727,T
3-PA,1263,6,1,0,3722,3729,C
3-PA,1264,1,3703,0,2,3706,T
3-PA,1265,4,4,3858,0,3866,G
3-PA,1266,2,1,3865,0,3868,G
3-PA,1267,3873,0,6,0,3879,A
3-PA,1268,0,3874,1,2,3877,T
3-PA,1269,3747,1,3,0,3751,A
3-PA,1270,2,4,3754,0,3760,G
3-PA,1271,3725,0,2,0,3727,A
3-PA,1272,2,1,3740,0,3743,G
3-PA,1273,0,2,0,3738,3740,C
3-PA,1274,2,3677,1,1,3681,T
3-PA,1275,8,0,0,3699,3707,C
3-PA,1276,2,1,3709,0,3712,G
3-PA,1277,3722,0,2,0,3724,A
3-PA,1278,1,3717,0,2,3720,T
3-PA,1279,2,4,3714,1,3721,G
3-PA,1280,3793,0,1,0,3794,A
3-PA,1281,3787,0,8,0,3795,A
3-PA,1282,3798,0,2,0,3800,A
3-PA,1283,3,3798,0,3,3804,T
3-PA,1284,1,3796,0,4,3801,T
3-PA,1285,1,3,3833,0,3837,G
3-PA,1286,1,7,3838,0,3846,G
3-PA,1287,3831,2,9,0,3842,A
3-PA,1288,1,1,3850,0,3852,G
3-PA,1289,3791,0,4,0,3795,A
3-PA,1290,0,3,3842,0,3845,G
3-PA,1291,1,2,3871,0,3874,G
3-PA,1292,3911,1,2,0,3914,A
3-PA,1293,0,1,0,3916,3917,C
3-PA,1294,1,0,3891,1,3893,G
3-PA,1295,0,3891,0,1,3892,T
3-PA,1296,3932,0,0,0,3932,A
3-PA,1297,0,1,3979,0,3980,G
3-PA,1298,5,0,0,4020,4025,C
3-PA,1299,2,17,0,3959,3978,C
3-PA,1300,5,0,0,3967,3972,C
3-PA,1301,5,0,0,3955,3960,C
3-PA,1302,3977,0,1,0,3978,A
3-PA,1303,4114,0,2,0,4116,A
3-PA,1304,1,4118,0,2,4121,T
3-PA,1305,1,4106,0,2,4109,T
3-PA,1306,1,10,4092,0,4103,G
3-PA,1307,4023,1,8,2,4034,A
3-PA,1308,1,0,4045,0,4046,G
3-PA,1309,4,0,0,4033,4037,C
3-PA,1310,4021,0,4,0,4025,A
3-PA,1311,0,0,0,4129,4129,C
3-PA,1312,4036,3,2,0,4041,A
3-PA,1313,0,4168,0,5,4173,T
3-PA,1314,2,4167,0,0,4169,T
3-PA,1315,2,2,4185,0,4189,G
3-PA,1316,1,3,0,4174,4178,C
3-PA,1317,4174,0,4,0,4178,A
3-PA,1318,4174,0,10,0,4184,A
3-PA,1319,1,1,4181,0,4183,G
3-PA,1320,1,1,0,4171,4173,C
3-PA,1321,4172,0,5,0,4177,A
3-PA,1322,1,4089,0,5,4095,T
3-PA,1323,1,7,4092,0,4100,G
3-PA,1324,4080,0,8,0,4088,A
3-PA,1325,0,1,4108,0,4109,G
3-PA,1326,4098,1,5,0,4104,A
3-PA,1327,4099,0,1,0,4100,A
3-PA,1328,1,5,4091,0,4097,G
3-PA,1329,0,9,4107,0,4116,G
3-PA,1330,4113,0,5,1,4119,A
3-PA,1331,4113,0,3,0,4116,A
3-PA,1332,0,4136,1,1,4138,T
3-PA,1333,1,4137,0,1,4139,T
3-PA,1334,4158,1,1,0,4160,A
3-PA,1335,1,4165,0,1,4167,T
3-PA,1336,0,4164,0,1,4165,T
3-PA,1337,0,4172,0,6,4178,T
3-PA,1338,2,2,0,4146,4150,C
3-PA,1339,4137,1,7,0,4145,A
3-PA,1340,0,1,0,4237,4238,C
3-PA,1341,4203,0,3,0,4206,A
3-PA,1342,1,0,4275,0,4276,G
3-PA,1343,3,2,0,4263,4268,C
3-PA,1344,4255,0,1,0,4256,A
3-PA,1345,2,6,4277,0,4285,G
3-PA,1346,4263,2,6,0,4271,A
3-PA,1347,0,6,4304,0,4310,G
3-PA,1348,1,3,4322,0,4326,G
3-PA,1349,0,4246,0,3,4249,T
3-PA,1350,1,0,4329,0,4330,G
3-PA,1351,3,4286,0,8,4297,T
3-PA,1352,7,0,0,4286,4293,C
3-PA,1353,0,2,2,4335,4339,C
3-PA,1354,4,0,0,4328,4332,C
3-PA,1355,4372,1,3,1,4377,A
3-PA,1356,1,4411,0,7,4419,T
3-PA,1357,1,4390,0,2,4393,T
3-PA,1358,5,1,4405,0,4411,G
3-PA,1359,1,4349,0,1,4351,T
3-PA,1360,4294,2,2,0,4298,A
3-PA,1361,2,1,4298,0,4301,G
3-PA,1362,4193,0,10,0,4203,A
3-PA,1363,2,2,4218,1,4223,G
3-PA,1364,3,2,0,4200,4205,C
3-PA,1365,8,1,0,4144,4153,C
3-PA,1366,4209,0,6,0,4215,A
3-PA,1367,6,0,0,4215,4221,C
3-PA,1368,2,4203,0,4,4209,T
3-PA,1369,0,4,4203,0,4207,G
3-PA,1370,4192,2,4,1,4199,A
3-PA,1371,4147,1,2,0,4150,A
3-PA,1372,1,4290,0,1,4292,T
3-PA,1373,4341,0,2,0,4343,A
3-PA,1374,0,1,1,4378,4380,C
3-PA,1375,4308,2,4,0,4314,A
3-PA,1376,0,4351,0,0,4351,T
3-PA,1377,4340,0,0,0,4340,A
3-PA,1378,4425,0,1,0,4426,A
3-PA,1379,1,4425,0,2,4428,T
3-PA,1380,0,4,4364,1,4369,G
3-PA,1381,4333,1,2,0,4336,A
3-PA,1382,4278,0,6,0,4284,A
3-PA,1383,1,6,4283,0,4290,G
3-PA,1384,2,6,4245,0,4253,G
3-PA,1385,5,10,4225,0,4240,G
3-PA,1386,2,5,4223,0,4230,G
3-PA,1387,1,3,4242,0,4246,G
3-PA,1388,2,4088,0,2,4092,T
3-PA,1389,1,2,4070,0,4073,G
3-PA,1390,0,4234,0,0,4234,T
3-PA,1391,4306,1,3,0,4310,A
3-PA,1392,2,1,0,4653,4656,C
3-PA,1393,4580,1,1,0,4582,A
3-PA,1394,0,4560,0,1,4561,T
3-PA,1395,0,4519,1,7,4527,T
3-PA,1396,4497,1,2,2,4502,A
3-PA,1397,4591,2,5,0,4598,A
3-PA,1398,0,1,0,4588,4589,C
3-PA,1399,4475,0,2,0,4477,A
3-PA,1400,2,1,0,4490,4493,C
3-PA,1401,0,4173,0,1,4174,T
3-PA,1402,0,3,4356,1,4360,G
3-PA,1403,2,2,0,4349,4353,C
3-PA,1404,10,1,0,4330,4341,C
3-PA,1405,3,3,0,4347,4353,C
3-PA,1406,2,4254,2,5,4263,T
3-PA,1407,1,0,4429,0,4430,G
3-PA,1408,1,0,0,4434,4435,C
3-PA,1409,1,4423,0,4,4428,T
3-PA,1410,10,3,1,4567,4581,C
3-PA,1411,4446,1,3,0,4450,A
3-PA,1412,4489,1,4,0,4494,A
3-PA,1413,0,4495,1,3,4499,T
3-PA,1414,1,4,4502,0,4507,G
3-PA,1415,1,1,0,4494,4496,C
3-PA,1416,4384,2,5,0,4391,A
3-PA,1417,0,4390,0,5,4395,T
3-PA,1418,2,1,0,4380,4383,C
3-PA,1419,2,1,0,4420,4423,C
3-PA,1420,1,4278,0,4,4283,T
3-PA,1421,1,0,4392,0,4393,G
3-PA,1422,1,4379,0,2,4382,T
3-PA,1423,1,0,4372,0,4373,G
3-PA,1424,0,2,1,4371,4374,C
3-PA,1425,4321,0,5,0,4326,A
3-PA,1426,2,1,4366,0,4369,G
3-PA,1427,1,2,0,4347,4350,C
3-PA,1428,4291,3,1,1,4296,A
3-PA,1429,4297,3,0,0,4300,A
3-PA,1430,2,4169,0,2,4173,T
3-PA,1431,0,6,4187,0,4193,G
3-PA,1432,1,4,4193,0,4198,G
3-PA,1433,4193,1,8,1,4203,A
3-PA,1434,0,1,0,4195,4196,C
3-PA,1435,1,5,4150,0,4156,G
3-PA,1436,4199,0,1,2,4202,A
3-PA,1437,1,4192,0,2,4195,T
3-PA,1438,0,4190,1,0,4191,T
3-PA,1439,0,4185,0,7,4192,T
3-PA,1440,1,4188,0,1,4190,T
3-PA,1441,4,0,0,4190,4194,C
3-PA,1442,4186,5,3,2,4196,A
3-PA,1443,4213,0,3,1,4217,A
3-PA,1444,0,0,1,4216,4217,C
3-PA,1445,0,4160,0,1,4161,T
3-PA,1446,4155,0,0,1,4156,A
3-PA,1447,4146,0,3,4,4153,A
3-PA,1448,0,4159,2,0,4161,T
3-PA,1449,1,4150,0,1,4152,T
3-PA,1450,5,1,0,4151,4157,C
3-PA,1451,6,1,0,4147,4154,C
3-PA,1452,2,1,0,4151,4154,C
3-PA,1453,4161,0,5,0,4166,A
3-PA,1454,1,4252,0,4,4257,T
3-PA,1455,1,2,4261,0,4264,G
3-PA,1456,4268,0,3,0,4271,A
3-PA,1457,0,4251,0,1,4252,T
3-PA,1458,4241,0,3,0,4244,A
3-PA,1459,4246,0,11,0,4257,A
3-PA,1460,0,2,4255,0,4257,G
3-PA,1461,3,0,0,4236,4239,C
3-PA,1462,4231,0,1,0,4232,A
3-PA,1463,4133,0,3,0,4136,A
3-PA,1464,0,0,4212,0,4212,G
3-PA,1465,0,4184,0,4,4188,T
3-PA,1466,2,0,4180,0,4182,G
3-PA,1467,2,0,0,4174,4176,C
3-PA,1468,4131,3,3,1,4138,A
3-PA,1469,3,7,4214,0,4224,G
3-PA,1470,4202,1,2,0,4205,A
3-PA,1471,4292,0,4,0,4296,A
3-PA,1472,0,1,0,4305,4306,C
3-PA,1473,0,4223,0,5,4228,T
3-PA,1474,4273,0,0,1,4274,A
3-PA,1475,4263,0,4,0,4267,A
3-PA,1476,4262,0,9,0,4271,A
3-PA,1477,1,0,4284,0,4285,G
3-PA,1478,4129,1,12,0,4142,A
3-PA,1479,2,1,4145,0,4148,G
3-PA,1480,1,5,4060,0,4066,G
3-PA,1481,0,4,4057,2,4063,G
3-PA,1482,4020,0,12,0,4032,A
3-PA,1483,3959,2,3,0,3964,A
3-PA,1484,0,1,3970,0,3971,G
3-PA,1485,1,0,3976,0,3977,G
3-PA,1486,0,3,0,3963,3966,C
3-PA,1487,0,3,3972,0,3975,G
3-PA,1488,3949,0,7,0,3956,A
3-PA,1489,3959,1,1,0,3961,A
3-PA,1490,3959,0,2,0,3961,A
3-PA,1491,3969,0,4,0,3973,A
3-PA,1492,3975,0,6,1,3982,A
3-PA,1493,2,0,0,3976,3978,C
3-PA,1494,9,1,0,3965,3975,C
3-PA,1495,3988,0,2,0,3990,A
3-PA,1496,4044,1,1,0,4046,A
3-PA,1497,0,4044,0,1,4045,T
3-PA,1498,1,4045,1,1,4048,T
3-PA,1499,0,4063,0,2,4065,T
3-PA,1500,4074,0,1,0,4075,A
3-PA,1501,0,4058,1,2,4061,T
3-PA,1502,4046,0,7,0,4053,A
3-PA,1503,2,4040,0,0,4042,T
3-PA,1504,1,6,4013,0,4020,G
3-PA,1505,0,4,3987,0,3991,G
3-PA,1506,3992,1,4,0,3997,A
3-PA,1507,0,3973,2,3,3978,T
3-PA,1508,0,3938,0,5,3943,T
3-PA,1509,6,3,0,3935,3944,C
3-PA,1510,3962,0,4,0,3966,A
3-PA,1511,1,4009,0,5,4015,T
3-PA,1512,7,2,0,4014,4023,C
3-PA,1513,4025,0,4,0,4029,A
3-PA,1514,0,3995,3,0,3998,T
3-PA,1515,3993,0,3,0,3996,A
3-PA,1516,3988,1,5,1,3995,A
3-PA,1517,3986,0,8,0,3994,A
3-PA,1518,3,2,4019,1,4025,G
3-PA,1519,1,5,3951,0,3957,G
3-PA,1520,0,6,3917,0,3923,G
3-PA,1521,3901,0,4,0,3905,A
3-PA,1522,3864,1,8,0,3873,A
3-PA,1523,1,4,3880,0,3885,G
3-PA,1524,3869,0,4,0,3873,A
3-PA,1525,0,3860,0,4,3864,T
3-PA,1526,1,2,0,3859,3862,C
3-PA,1527,1,3790,0,7,3798,T
3-PA,1528,4,1,0,3900,3905,C
3-PA,1529,3906,0,3,0,3909,A
3-PA,1530,0,3910,1,2,3913,T
3-PA,1531,1,3908,0,0,3909,T
3-PA,1532,0,3865,0,3,3868,T
3-PA,1533,3853,0,2,0,3855,A
3-PA,1534,3849,1,8,0,3858,A
3-PA,1535,2,3,3866,0,3871,G
3-PA,1536,0,5,3911,1,3917,G
3-PA,1537,3741,3,3,0,3747,A
3-PA,1538,3750,0,2,0,3752,A
3-PA,1539,0,3745,2,2,3749,T
3-PA,1540,0,6,3779,0,3785,G
3-PA,1541,3882,2,7,0,3891,A
3-PA,1542,1,2,0,3894,3897,C
3-PA,1543,3877,0,13,1,3891,A
3-PA,1544,1,1,2,3878,3882,C
3-PA,1545,3795,0,6,0,3801,A
3-PA,1546,0,4,3825,0,3829,G
3-PA,1547,3811,0,6,0,3817,A
3-PA,1548,2,0,0,3799,3801,C
3-PA,1549,0,0,3768,0,3768,G
3-PA,1550,1,3593,0,1,3595,T
3-PA,1551,0,4,3619,0,3623,G
3-PA,1552,1,0,3638,0,3639,G
3-PA,1553,1,3639,0,1,3641,T
3-PA,1554,3630,0,0,0,3630,A
3-PA,1555,3590,1,2,0,3593,A
3-PA,1556,3596,1,0,0,3597,A
3-PA,1557,0,3589,0,0,3589,T
3-PA,1558,0,3551,0,1,3552,T
3-PA,1559,0,3551,0,0,3551,T
3-PA,1560,0,3522,0,0,3522,T
3-PA,1561,0,0,3529,0,3529,G
3-PA,1562,1,3499,0,4,3504,T
3-PA,1563,1,8,3490,1,3500,G
3-PA,1564,3488,1,3,0,3492,A
3-PA,1565,1,0,3494,0,3495,G
3-PA,1566,2,2,0,3475,3479,C
3-PA,1567,3490,0,0,0,3490,A
3-PA,1568,2,3485,0,0,3487,T
3-PA,1569,3,4,3477,0,3484,G
3-PA,1570,1,2,3520,0,3523,G
3-PA,1571,3524,1,4,0,3529,A
3-PA,1572,1,0,3535,0,3536,G
3-PA,1573,0,3504,0,4,3508,T
3-PA,1574,0,3461,1,11,3473,T
3-PA,1575,2,3520,0,4,3526,T
3-PA,1576,1,3528,0,3,3532,T
3-PA,1577,5,1,0,3528,3534,C
3-PA,1578,0,3508,0,9,3517,T
3-PA,1579,2,2,0,3520,3524,C
3-PA,1580,0,3467,0,3,3470,T
3-PA,1581,6,1,1,3458,3466,C
3-PA,1582,3471,0,2,0,3473,A
3-PA,1583,1,0,1,3467,3469,C
3-PA,1584,0,3418,0,0,3418,T
3-PA,1585,1,7,3423,1,3432,G
3-PA,1586,3435,0,5,0,3440,A
3-PA,1587,3,0,1,3459,3463,C
3-PA,1588,2,4,0,3454,3460,C
3-PA,1589,10,2,0,3434,3446,C
3-PA,1590,2,3,3434,0,3439,G
3-PA,1591,3411,0,13,2,3426,A
3-PA,1592,0,5,3455,0,3460,G
3-PA,1593,3466,1,2,0,3469,A
3-PA,1594,1,2,0,3433,3436,C
3-PA,1595,0,3418,0,1,3419,T
3-PA,1596,0,3323,0,2,3325,T
3-PA,1597,0,2,3317,1,3320,G
3-PA,1598,3307,2,5,1,3315,A
3-PA,1599,2,0,3320,0,3322,G
3-PA,1600,1,1,0,3305,3307,C
3-PA,1601,8,2,0,3233,3243,C
3-PA,1602,3329,1,1,0,3331,A
3-PA,1603,1,0,0,3342,3343,C
3-PA,1604,3355,0,3,0,3358,A
3-PA,1605,0,3355,0,2,3357,T
3-PA,1606,3347,0,1,1,3349,A
3-PA,1607,3339,0,2,0,3341,A
3-PA,1608,3340,0,2,0,3342,A
3-PA,1609,0,3336,0,1,3337,T
3-PA,1610,2,5,3323,1,3331,G
3-PA,1611,0,2,3294,0,3296,G
3-PA,1612,0,2,3329,0,3331,G
3-PA,1613,3300,0,4,0,3304,A
3-PA,1614,4,3,3365,1,3373,G
3-PA,1615,3364,0,0,0,3364,A
3-PA,1616,3360,0,2,0,3362,A
3-PA,1617,3392,0,4,0,3396,A
3-PA,1618,0,3396,0,2,3398,T
3-PA,1619,3406,0,3,0,3409,A
3-PA,1620,2,3,0,3402,3407,C
3-PA,1621,2,3038,0,2,3042,T
3-PA,1622,2,1,3049,0,3052,G
3-PA,1623,0,2899,0,6,2905,T
3-PA,1624,0,1,3038,0,3039,G
3-PA,1625,1,3024,5,1,3031,T
3-PA,1626,5,1,0,2953,2959,C
3-PA,1627,1,0,1,2967,2969,C
3-PA,1628,0,2947,1,3,2951,T
3-PA,1629,1,2959,0,6,2966,T
3-PA,1630,2,2,2968,0,2972,G
3-PA,1631,2980,1,4,1,2986,A
3-PA,1632,1,1,3028,0,3030,G
3-PA,1633,2877,1,3,0,2881,A
3-PA,1634,1,2878,0,0,2879,T
3-PA,1635,2825,2,5,0,2832,A
3-PA,1636,3,3,2905,0,2911,G
3-PA,1637,0,1,2920,0,2921,G
3-PA,1638,2898,0,2,0,2900,A
3-PA,1639,0,2,2895,0,2897,G
3-PA,1640,2848,0,6,1,2855,A
3-PA,1641,0,2827,0,1,2828,T
3-PA,1642,2860,0,4,0,2864,A
3-PA,1643,0,2856,0,2,2858,T
3-PA,1644,1,2,2889,0,2892,G
3-PA,1645,1,2850,0,2,2853,T
3-PA,1646,0,2845,0,1,2846,T
3-PA,1647,2896,1,3,0,2900,A
3-PA,1648,2,1,1,2881,2885,C
3-PA,1649,1,2854,0,0,2855,T
3-PA,1650,2868,0,1,0,2869,A
3-PA,1651,2835,0,2,0,2837,A
3-PA,1652,0,4,2869,0,2873,G
3-PA,1653,2847,0,0,0,2847,A
3-PA,1654,2791,0,2,0,2793,A
3-PA,1655,0,1,2730,0,2731,G
3-PA,1656,1,2761,0,1,2763,T
3-PA,1657,3,0,2794,0,2797,G
3-PA,1658,2,1,1,2801,2805,C
3-PA,1659,2,0,0,2788,2790,C
3-PA,1660,2791,0,5,0,2796,A
3-PA,1661,0,2775,0,2,2777,T
3-PA,1662,2774,0,2,0,2776,A
3-PA,1663,0,1,2793,0,2794,G
3-PA,1664,1,0,2785,0,2786,G
3-PA,1665,2,2,1,2759,2764,C
3-PA,1666,2,2,0,2750,2754,C
3-PA,1667,2747,0,0,0,2747,A
3-PA,1668,2751,0,2,0,2753,A
3-PA,1669,2746,0,0,0,2746,A
3-PA,1670,1,2773,1,2,2777,T
3-PA,1671,0,2772,0,1,2773,T
3-PA,1672,1,2752,0,0,2753,T
3-PA,1673,4,1,0,2745,2750,C
3-PA,1674,2718,0,3,1,2722,A
3-PA,1675,2727,0,1,1,2729,A
3-PA,1676,2,4,2745,0,2751,G
3-PA,1677,1,0,2773,0,2774,G
3-PA,1678,1,0,0,2776,2777,C
3-PA,1679,4,0,1,2735,2740,C
3-PA,1680,2755,1,4,0,2760,A
3-PA,1681,2821,1,3,0,2825,A
3-PA,1682,1,2822,0,0,2823,T
3-PA,1683,0,0,2965,0,2965,G
3-PA,1684,1,2965,0,1,2967,T
3-PA,1685,0,3157,0,2,3159,T
3-PA,1686,2,0,0,3207,3209,C
3-PA,1687,1,3182,0,0,3183,T
3-PA,1688,0,3177,0,0,3177,T
3-PA,1689,2994,0,0,0,2994,A
3-PA,1690,0,3024,1,0,3025,T
3-PA,1691,3040,0,0,1,3041,A
3-PA,1692,0,3078,0,0,3078,T
3-PA,1693,2,0,3073,1,3076,G
3-PA,1694,0,2920,0,0,2920,T
3-PA,1695,2,4,2911,0,2917,G
3-PA,1696,2883,0,9,0,2892,A
3-PA,1697,0,2,2899,0,2901,G
3-PA,1698,0,5,2906,0,2911,G
3-PA,1699,2910,2,3,0,2915,A
3-PA,1700,0,2,0,2919,2921,C
3-PA,1701,2887,0,1,1,2889,A
3-PA,1702,2869,2,4,3,2878,A
3-PA,1703,2888,1,6,1,2896,A
3-PA,1704,2,5,0,2890,2897,C
3-PA,1705,3,2,2887,1,2893,G
3-PA,1706,0,5,2915,0,2920,G
3-PA,1707,2890,2,2,1,2895,A
3-PA,1708,2894,0,5,1,2900,A
3-PA,1709,1,1,0,2923,2925,C
3-PA,1710,2913,1,0,0,2914,A
3-PA,1711,0,2927,0,2,2929,T
3-PA,1712,2,0,0,2922,2924,C
3-PA,1713,2916,2,1,0,2919,A
3-PA,1714,2915,0,2,0,2917,A
3-PA,1715,2887,1,3,1,2892,A
3-PA,1716,0,2,2918,0,2920,G
3-PA,1717,0,1,2919,0,2920,G
3-PA,1718,0,2871,0,6,2877,T
3-PA,1719,6,0,0,2870,2876,C
3-PA,1720,2869,0,3,0,2872,A
3-PA,1721,2888,0,0,0,2888,A
3-PA,1722,2882,1,3,0,2886,A
3-PA,1723,2914,0,0,0,2914,A
3-PA,1724,0,2911,0,0,2911,T
3-PA,1725,1,2,2930,1,2934,G
3-PA,1726,2915,0,2,0,2917,A
3-PA,1727,2912,0,2,0,2914,A
3-PA,1728,2916,0,1,0,2917,A
3-PA,1729,0,2913,0,2,2915,T
3-PA,1730,1,3,2933,0,2937,G
3-PA,1731,1,4,2939,0,2944,G
3-PA,1732,4,2,2923,1,2930,G
3-PA,1733,1,2,2955,0,2958,G
3-PA,1734,2925,0,4,0,2929,A
3-PA,1735,2948,0,1,0,2949,A
3-PA,1736,1,2948,0,0,2949,T
3-PA,1737,1,3,2965,0,2969,G
3-PA,1738,0,0,2988,0,2988,G
3-PA,1739,2939,2,3,0,2944,A
3-PA,1740,2,1,2978,0,2981,G
3-PA,1741,2966,1,3,0,2970,A
3-PA,1742,0,2917,0,1,2918,T
3-PA,1743,0,1,2920,1,2922,G
3-PA,1744,2896,0,3,0,2899,A
3-PA,1745,0,0,2920,0,2920,G
3-PA,1746,2913,0,10,0,2923,A
3-PA,1747,0,2,0,2878,2880,C
3-PA,1748,0,0,2871,0,2871,G
3-PA,1749,0,2856,0,0,2856,T
3-PA,1750,1,2854,0,0,2855,T
3-PA,1751,0,2,2873,0,2875,G
3-PA,1752,3,1,1,2858,2863,C
3-PA,1753,1,1,0,2882,2884,C
3-PA,1754,0,2870,0,3,2873,T
3-PA,1755,5,0,0,2943,2948,C
3-PA,1756,2,5,0,2942,2949,C
3-PA,1757,0,2945,0,3,2948,T
3-PA,1758,0,2954,0,2,2956,T
3-PA,1759,1,0,0,2958,2959,C
3-PA,1760,2942,0,1,1,2944,A
3-PA,1761,1,2,2948,0,2951,G
3-PA,1762,1,2921,0,8,2930,T
3-PA,1763,6,1,0,2941,2948,C
3-PA,1764,2879,0,0,0,2879,A
3-PA,1765,0,0,0,3009,3009,C
3-PA,1766,2,2997,0,3,3002,T
3-PA,1767,4,1,0,3024,3029,C
3-PA,1768,3,1,0,3014,3018,C
3-PA,1769,3010,0,6,0,3016,A
3-PA,1770,1,0,3019,0,3020,G
3-PA,1771,1,1,0,3026,3028,C
3-PA,1772,2988,1,1,0,2990,A
3-PA,1773,0,1,3016,0,3017,G
3-PA,1774,2907,0,5,0,2912,A
3-PA,1775,0,2907,0,1,2908,T
3-PA,1776,2,2,0,2901,2905,C
3-PA,1777,1,0,2899,0,2900,G
3-PA,1778,2896,0,3,0,2899,A
3-PA,1779,3,6,2897,0,2906,G
3-PA,1780,2891,0,8,0,2899,A
3-PA,1781,0,1,2929,0,2930,G
3-PA,1782,2,2,0,2891,2895,C
3-PA,1783,2890,0,0,0,2890,A
3-PA,1784,0,2890,0,1,2891,T
3-PA,1785,0,6,2945,0,2951,G
3-PA,1786,2967,0,3,0,2970,A
3-PA,1787,0,2964,0,4,2968,T
3-PA,1788,1,2951,1,1,2954,T
3-PA,1789,1,4,2957,1,2963,G
3-PA,1790,2925,1,2,1,2929,A
3-PA,1791,2933,1,1,1,2936,A
3-PA,1792,1,0,2938,0,2939,G
3-PA,1793,1,2,0,2926,2929,C
3-PA,1794,6,0,0,2885,2891,C
3-PA,1795,1,0,2880,0,2881,G
3-PA,1796,2875,0,2,0,2877,A
3-PA,1797,2,0,2899,0,2901,G
3-PA,1798,1,2887,1,4,2893,T
3-PA,1799,2,1,0,2889,2892,C
3-PA,1800,1,0,0,2893,2894,C
3-PA,1801,0,2868,1,3,2872,T
3-PA,1802,0,0,0,2910,2910,C
3-PA,1803,2,1,2914,0,2917,G
3-PA,1804,1,2,3025,0,3028,G
3-PA,1805,2,3019,0,1,3022,T
3-PA,1806,0,2986,0,1,2987,T
3-PA,1807,2985,1,1,0,2987,A
3-PA,1808,2981,0,0,1,2982,A
3-PA,1809,2988,0,2,0,2990,A
3-PA,1810,0,2,3051,0,3053,G
3-PA,1811,3007,0,4,0,3011,A
3-PA,1812,0,2,3019,0,3021,G
3-PA,1813,2927,0,4,0,2931,A
3-PA,1814,2934,2,2,0,2938,A
3-PA,1815,2941,0,12,0,2953,A
3-PA,1816,0,2,2976,0,2978,G
3-PA,1817,2967,2,3,0,2972,A
3-PA,1818,1,1,0,2970,2972,C
3-PA,1819,2898,0,6,0,2904,A
3-PA,1820,1,2897,0,2,2900,T
3-PA,1821,1,5,2897,1,2904,G
3-PA,1822,2930,0,3,1,2934,A
3-PA,1823,1,0,0,2934,2935,C
3-PA,1824,5,1,1,2917,2924,C
3-PA,1825,2886,1,2,0,2889,A
3-PA,1826,2886,0,2,1,2889,A
3-PA,1827,2876,1,5,0,2882,A
3-PA,1828,3,1,2901,0,2905,G
3-PA,1829,2894,0,0,0,2894,A
3-PA,1830,0,0,2904,0,2904,G
3-PA,1831,0,2861,1,3,2865,T
3-PA,1832,0,2857,1,1,2859,T
3-PA,1833,1,2854,0,1,2856,T
3-PA,1834,1,2864,0,0,2865,T
3-PA,1835,0,2874,0,1,2875,T
3-PA,1836,0,2878,0,0,2878,T
3-PA,1837,1,3,2868,0,2872,G
3-PA,1838,2855,1,1,0,2857,A
3-PA,1839,0,5,2881,0,2886,G
3-PA,1840,2872,0,1,1,2874,A
3-PA,1841,2868,2,1,0,2871,A
3-PA,1842,0,2881,0,2,2883,T
3-PA,1843,2886,0,1,0,2887,A
3-PA,1844,2965,0,2,0,2967,A
3-PA,1845,2981,1,0,1,2983,A
3-PA,1846,1,2979,0,1,2981,T
3-PA,1847,5,2,0,2980,2987,C
3-PA,1848,2952,2,4,1,2959,A
3-PA,1849,1,1,2966,0,2968,G
3-PA,1850,2966,0,3,1,2970,A
3-PA,1851,2971,1,7,0,2979,A
3-PA,1852,1,2,2996,0,2999,G
3-PA,1853,1,0,0,2936,2937,C
3-PA,1854,2927,1,1,0,2929,A
3-PA,1855,0,2921,0,2,2923,T
3-PA,1856,0,2,2920,0,2922,G
3-PA,1857,0,0,2957,1,2958,G
3-PA,1858,0,1,0,2941,2942,C
3-PA,1859,2,1,0,3021,3024,C
3-PA,1860,5,2,1,3023,3031,C
3-PA,1861,3057,0,2,0,3059,A
3-PA,1862,3,3059,0,0,3062,T
3-PA,1863,0,3054,0,3,3057,T
3-PA,1864,0,3,3069,0,3072,G
3-PA,1865,0,3,3059,0,3062,G
3-PA,1866,0,2,3017,0,3019,G
3-PA,1867,0,3,3022,0,3025,G
3-PA,1868,2868,0,3,0,2871,A
3-PA,1869,1,0,2931,0,2932,G
3-PA,1870,0,2891,0,3,2894,T
3-PA,1871,3,2,0,2947,2952,C
3-PA,1872,7,1,0,3065,3073,C
3-PA,1873,4,1,0,3072,3077,C
3-PA,1874,4,0,0,3080,3084,C
3-PA,1875,3,0,0,3076,3079,C
3-PA,1876,3080,0,2,0,3082,A
3-PA,1877,3081,0,4,0,3085,A
3-PA,1878,0,2,3080,0,3082,G
3-PA,1879,0,2,3033,0,3035,G
3-PA,1880,1,5,3037,0,3043,G
3-PA,1881,2783,0,5,0,2788,A
3-PA,1882,1,0,2819,0,2820,G
3-PA,1883,0,2801,1,5,2807,T
3-PA,1884,0,0,2812,0,2812,G
3-PA,1885,2,3,2842,0,2847,G
3-PA,1886,2834,2,1,0,2837,A
3-PA,1887,2824,1,2,0,2827,A
3-PA,1888,0,1,2824,0,2825,G
3-PA,1889,2795,4,2,0,2801,A
3-PA,1890,2803,0,1,0,2804,A
3-PA,1891,0,2,2778,1,2781,G
3-PA,1892,0,1,2786,0,2787,G
3-PA,1893,0,2779,0,3,2782,T
3-PA,1894,0,2743,0,2,2745,T
3-PA,1895,2,1,0,2750,2753,C
3-PA,1896,2,0,0,2760,2762,C
3-PA,1897,2766,0,0,0,2766,A
3-PA,1898,0,2774,0,0,2774,T
3-PA,1899,0,2757,0,1,2758,T
3-PA,1900,1,2,2768,0,2771,G
3-PA,1901,0,2,2760,0,2762,G
3-PA,1902,1,2,2762,0,2765,G
3-PA,1903,2766,0,2,0,2768,A
3-PA,1904,2738,0,1,0,2739,A
3-PA,1905,2758,0,5,1,2764,A
3-PA,1906,0,2,2827,0,2829,G
3-PA,1907,1,2816,1,2,2820,T
3-PA,1908,3,1,0,2864,2868,C
3-PA,1909,0,2837,0,2,2839,T
3-PA,1910,5,0,2848,0,2853,G
3-PA,1911,0,2850,2,4,2856,T
3-PA,1912,2847,1,4,0,2852,A
3-PA,1913,1,1,2862,0,2864,G
3-PA,1914,1,4,2815,0,2820,G
3-PA,1915,2734,0,3,0,2737,A
3-PA,1916,0,0,0,2732,2732,C
3-PA,1917,0,2656,0,8,2664,T
3-PA,1918,1,1,0,2807,2809,C
3-PA,1919,1,2799,0,3,2803,T
3-PA,1920,2812,0,0,0,2812,A
3-PA,1921,1,2809,0,1,2811,T
3-PA,1922,2,2785,0,1,2788,T
3-PA,1923,0,5,2811,0,2816,G
3-PA,1924,0,0,2800,0,2800,G
3-PA,1925,0,1,0,2797,2798,C
3-PA,1926,0,2785,0,1,2786,T
3-PA,1927,2596,0,0,0,2596,A
3-PA,1928,2623,0,1,0,2624,A
3-PA,1929,0,0,2647,0,2647,G
3-PA,1930,2,2640,1,1,2644,T
3-PA,1931,5,0,0,2632,2637,C
3-PA,1932,2564,0,3,0,2567,A
3-PA,1933,0,2,2667,0,2669,G
3-PA,1934,0,2664,1,2,2667,T
3-PA,1935,2746,0,0,0,2746,A
3-PA,1936,0,2750,0,3,2753,T
3-PA,1937,0,2777,0,0,2777,T
3-PA,1938,3,2,0,2778,2783,C
3-PA,1939,2754,2,0,0,2756,A
3-PA,1940,2753,0,4,0,2757,A
3-PA,1941,0,2755,1,0,2756,T
3-PA,1942,2670,1,6,0,2677,A
3-PA,1943,0,0,2699,0,2699,G
3-PA,1944,0,0,0,2674,2674,C
3-PA,1945,1,0,1,2678,2680,C
3-PA,1946,0,2595,1,2,2598,T
3-PA,1947,0,2,2672,0,2674,G
3-PA,1948,2,2668,0,6,2676,T
3-PA,1949,2675,0,1,0,2676,A
3-PA,1950,0,2678,0,3,2681,T
3-PA,1951,4,0,2612,0,2616,G
3-PA,1952,0,4,0,2609,2613,C
3-PA,1953,2543,0,5,0,2548,A
3-PA,1954,1,2530,0,1,2532,T
3-PA,1955,2,1,0,2535,2538,C
3-PA,1956,2468,1,4,0,2473,A
3-PA,1957,1,1,0,2499,2501,C
3-PA,1958,4,2,0,2481,2487,C
3-PA,1959,2478,2,5,2,2487,A
3-PA,1960,0,2,0,2507,2509,C
3-PA,1961,2474,0,0,0,2474,A
3-PA,1962,2483,0,0,0,2483,A
3-PA,1963,0,2475,0,1,2476,T
3-PA,1964,0,2475,0,1,2476,T
3-PA,1965,0,2,2466,0,2468,G
3-PA,1966,0,2,2429,0,2431,G
3-PA,1967,2422,0,2,0,2424,A
3-PA,1968,2423,2,2,0,2427,A
3-PA,1969,1,3,2397,0,2401,G
3-PA,1970,1,1,2404,0,2406,G
3-PA,1971,2398,0,2,0,2400,A
3-PA,1972,0,2400,0,1,2401,T
3-PA,1973,0,2401,1,2,2404,T
3-PA,1974,0,2397,1,2,2400,T
3-PA,1975,0,2402,0,0,2402,T
3-PA,1976,2,2,0,2398,2402,C
3-PA,1977,2391,1,2,0,2394,A
3-PA,1978,0,0,2396,0,2396,G
3-PA,1979,1,2,0,2380,2383,C
3-PA,1980,0,1,2361,0,2362,G
3-PA,1981,0,1,2361,0,2362,G
3-PA,1982,2355,2,2,0,2359,A
3-PA,1983,2,1,2394,0,2397,G
3-PA,1984,0,2397,0,3,2400,T
3-PA,1985,6,0,0,2404,2410,C
3-PA,1986,2411,1,2,0,2414,A
3-PA,1987,2403,1,7,1,2412,A
3-PA,1988,1,3,2409,0,2413,G
3-PA,1989,2415,1,0,0,2416,A
3-PA,1990,2402,1,1,0,2404,A
3-PA,1991,2396,0,4,0,2400,A
3-PA,1992,2342,1,2,1,2346,A
3-PA,1993,1,1,0,2349,2351,C
3-PA,1994,0,2315,1,0,2316,T
3-PA,1995,1,0,2326,1,2328,G
3-PA,1996,0,0,0,2318,2318,C
3-PA,1997,1,2309,0,3,2313,T
3-PA,1998,3,1,1,2313,2318,C
3-PA,1999,4,0,0,2300,2304,C
3-PA,2000,1,2314,1,3,2319,T
3-PA,2001,1,2322,0,1,2324,T
3-PA,2002,1,0,2323,0,2324,G
3-PA,2003,0,2319,0,1,2320,T
3-PA,2004,0,2292,1,1,2294,T
3-PA,2005,0,1,2316,0,2317,G
3-PA,2006,1,2301,0,3,2305,T
3-PA,2007,0,2303,0,2,2305,T
3-PA,2008,7,1,0,2296,2304,C
3-PA,2009,2242,1,4,0,2247,A
3-PA,2010,1,1,2264,0,2266,G
3-PA,2011,0,1,2264,0,2265,G
3-PA,2012,0,0,0,2290,2290,C
3-PA,2013,0,2286,1,1,2288,T
3-PA,2014,3,0,0,2330,2333,C
3-PA,2015,0,2319,0,5,2324,T
3-PA,2016,0,2324,0,1,2325,T
3-PA,2017,2325,0,2,0,2327,A
3-PA,2018,0,4,2326,0,2330,G
3-PA,2019,0,4,2289,0,2293,G
3-PA,2020,0,8,2277,0,2285,G
3-PA,2021,2220,1,6,0,2227,A
3-PA,2022,0,7,0,2228,2235,C
3-PA,2023,2081,0,1,0,2082,A
3-PA,2024,2111,0,0,0,2111,A
3-PA,2025,1,0,0,2126,2127,C
3-PA,2026,2,0,0,2118,2120,C
3-PA,2027,0,2111,1,2,2114,T
3-PA,2028,4,1,0,2110,2115,C
3-PA,2029,1,5,2104,0,2110,G
3-PA,2030,2112,1,2,0,2115,A
3-PA,2031,2128,0,1,0,2129,A
3-PA,2032,1,0,0,2131,2132,C
3-PA,2033,2,1,0,2066,2069,C
3-PA,2034,0,2029,0,3,2032,T
3-PA,2035,2,2,2027,0,2031,G
3-PA,2036,1,1,2027,0,2029,G
3-PA,2037,1,2,2029,0,2032,G
3-PA,2038,2031,0,3,0,2034,A
3-PA,2039,3,1,1,2038,2043,C
3-PA,2040,2,0,0,2025,2027,C
3-PA,2041,1,2003,0,4,2008,T
3-PA,2042,0,2011,0,3,2014,T
3-PA,2043,0,2007,0,2,2009,T
3-PA,2044,0,3,2017,0,2020,G
3-PA,2045,2031,2,0,0,2033,A
3-PA,2046,0,2035,0,2,2037,T
3-PA,2047,2,2,0,2038,2042,C
3-PA,2048,0,1991,0,0,1991,T
3-PA,2049,0,1977,0,2,1979,T
3-PA,2050,0,4,1974,0,1978,G
3-PA,2051,0,3,1968,0,1971,G
3-PA,2052,1,2,1966,0,1969,G
3-PA,2053,0,1,1975,0,1976,G
3-PA,2054,1,2,1950,0,1953,G
3-PA,2055,2,0,1958,0,1960,G
3-PA,2056,1,0,1,1954,1956,C
3-PA,2057,0,1936,0,2,1938,T
3-PA,2058,2002,0,0,1,2003,A
3-PA,2059,0,2002,0,2,2004,T
3-PA,2060,2004,1,3,0,2008,A
3-PA,2061,0,2003,0,0,2003,T
3-PA,2062,0,4,1887,0,1891,G
3-PA,2063,1882,0,2,0,1884,A
3-PA,2064,1853,0,3,0,1856,A
3-PA,2065,0,0,1863,0,1863,G
3-PA,2066,0,1,0,1881,1882,C
3-PA,2067,1786,0,2,0,1788,A
3-PA,2068,1833,0,1,0,1834,A
3-PA,2069,2,1831,0,1,1834,T
3-PA,2070,0,1827,0,3,1830,T
3-PA,2071,0,3,1832,0,1835,G
3-PA,2072,1806,0,2,0,1808,A
3-PA,2073,0,2,1808,0,1810,G
3-PA,2074,0,3,1808,0,1811,G
3-PA,2075,1691,0,2,0,1693,A
3-PA,2076,0,0,1718,0,1718,G
3-PA,2077,0,1616,0,4,1620,T
3-PA,2078,1,0,1624,0,1625,G
3-PA,2079,1,0,0,1624,1625,C
3-PA,2080,5,1,0,1614,1620,C
3-PA,2081,1,1611,0,0,1612,T
3-PA,2082,0,2,1639,1,1642,G
3-PA,2083,1641,0,0,0,1641,A
3-PA,2084,0,1644,0,0,1644,T
3-PA,2085,1,1596,0,0,1597,T
3-PA,2086,1588,0,0,0,1588,A
3-PA,2087,1582,0,2,0,1584,A
3-PA,2088,1,1567,0,1,1569,T
3-PA,2089,0,4,1565,0,1569,G
3-PA,2090,1562,0,0,0,1562,A
3-PA,2091,1,1510,0,2,1513,T
3-PA,2092,5,0,0,1504,1509,C
3-PA,2093,3,2,0,1488,1493,C
3-PA,2094,0,0,0,1498,1498,C
3-PA,2095,1,1484,1,5,1491,T
3-PA,2096,1,0,1495,0,1496,G
3-PA,2097,1,3,1486,1,1491,G
3-PA,2098,0,0,1502,0,1502,G
3-PA,2099,0,1489,0,2,1491,T
3-PA,2100,0,1422,0,1,1423,T
3-PA,2101,0,1424,0,2,1426,T
3-PA,2102,1,1414,0,0,1415,T
3-PA,2103,1,1,1425,0,1427,G
3-PA,2104,0,0,0,1427,1427,C
3-PA,2105,0,1416,0,3,1419,T
3-PA,2106,3,0,0,1417,1420,C
3-PA,2107,1363,1,2,1,1367,A
3-PA,2108,1371,0,1,0,1372,A
3-PA,2109,0,1373,0,0,1373,T
3-PA,2110,0,1,1376,0,1377,G
3-PA,2111,0,0,0,1371,1371,C
3-PA,2112,1,1,1349,0,1351,G
3-PA,2113,1,1346,0,5,1352,T
3-PA,2114,1,1,0,1351,1353,C
3-PA,2115,0,1341,0,2,1343,T
3-PA,2116,1,1341,1,1,1344,T
3-PA,2117,0,1,1327,0,1328,G
3-PA,2118,2,0,1327,0,1329,G
3-PA,2119,1,1317,0,1,1319,T
3-PA,2120,0,1310,0,4,1314,T
3-PA,2121,4,11,0,1264,1279,C
3-PA,2122,1255,0,0,0,1255,A
3-PA,2123,1258,0,1,0,1259,A
3-PA,2124,1,0,0,1255,1256,C
3-PA,2125,0,1242,0,1,1243,T
3-PA,2126,3,0,0,1238,1241,C
3-PA,2127,1,0,0,1189,1190,C
3-PA,2128,0,1177,0,2,1179,T
3-PA,2129,1,1180,1,1,1183,T
3-PA,2130,2,1,0,1172,1175,C
3-PA,2131,0,0,0,1178,1178,C
3-PA,2132,0,1146,1,5,1152,T
3-PA,2133,0,1,1147,0,1148,G
3-PA,2134,1147,0,0,0,1147,A
3-PA,2135,0,1,0,1129,1130,C
3-PA,2136,1077,0,0,0,1077,A
3-PA,2137,0,0,0,1050,1050,C
3-PA,2138,1032,1,1,0,1034,A
3-PA,2139,0,1021,0,1,1022,T
3-PA,2140,0,0,1022,0,1022,G
3-PA,2141,0,0,0,1023,1023,C
3-PA,2142,997,0,1,0,998,A
3-PA,2143,0,997,0,1,998,T
3-PA,2144,1,980,0,0,981,T
3-PA,2145,984,0,0,0,984,A
3-PA,2146,978,0,2,0,980,A
3-PA,2147,976,0,1,0,977,A
3-PA,2148,976,0,0,0,976,A
3-PA,2149,0,967,0,0,967,T
3-PA,2150,761,0,0,0,761,A
3-PA,2151,0,0,757,0,757,G
4-HA,1,476,0,0,0,476,A
4-HA,2,0,481,0,0,481,T
4-HA,3,0,0,493,0,493,G
4-HA,4,499,0,0,0,499,A
4-HA,5,499,0,0,0,499,A
4-HA,6,0,1,540,0,541,G
4-HA,7,538,0,0,0,538,A
4-HA,8,0,0,0,587,587,C
4-HA,9,0,591,0,0,591,T
4-HA,10,610,0,1,0,611,A
4-HA,11,0,626,0,0,626,T
4-HA,12,1,0,0,628,629,C
4-HA,13,628,0,1,0,629,A
4-HA,14,0,629,0,0,629,T
4-HA,15,0,627,0,0,627,T
4-HA,16,0,1,665,0,666,G
4-HA,17,0,0,0,670,670,C
4-HA,18,0,671,0,0,671,T
4-HA,19,0,670,0,1,671,T
4-HA,20,0,672,0,0,672,T
4-HA,21,1,1,697,0,699,G
4-HA,22,703,0,1,0,704,A
4-HA,23,0,0,733,0,733,G
4-HA,24,1,0,0,735,736,C
4-HA,25,0,734,0,1,735,T
4-HA,26,805,0,0,0,805,A
4-HA,27,0,0,0,818,818,C
4-HA,28,830,0,0,0,830,A
4-HA,29,0,889,0,0,889,T
4-HA,30,1,881,0,0,882,T
4-HA,31,2,0,0,893,895,C
4-HA,32,0,889,0,1,890,T
4-HA,33,906,0,1,0,907,A
4-HA,34,0,911,0,0,911,T
4-HA,35,0,0,913,0,913,G
4-HA,36,1,912,0,2,915,T
4-HA,37,1,0,0,913,914,C
4-HA,38,0,913,0,0,913,T
4-HA,39,0,1,915,0,916,G
4-HA,40,2,0,916,0,918,G
4-HA,41,0,915,0,0,915,T
4-HA,42,1,914,0,1,916,T
4-HA,43,0,915,0,0,915,T
4-HA,44,0,913,0,1,914,T
4-HA,45,1,1,0,911,913,C
4-HA,46,0,0,914,0,914,G
4-HA,47,0,0,0,932,932,C
4-HA,48,0,925,0,1,926,T
4-HA,49,0,0,0,935,935,C
4-HA,50,934,0,1,0,935,A
4-HA,51,938,0,0,0,938,A
4-HA,52,937,0,0,0,937,A
4-HA,53,938,0,0,1,939,A
4-HA,54,938,0,0,0,938,A
4-HA,55,0,0,0,942,942,C
4-HA,56,0,938,0,0,938,T
4-HA,57,0,941,0,0,941,T
4-HA,58,0,0,0,939,939,C
4-HA,59,1,0,0,939,940,C
4-HA,60,0,937,0,0,937,T
4-HA,61,1,0,950,0,951,G
4-HA,62,0,4,953,0,957,G
4-HA,63,956,0,0,0,956,A
4-HA,64,976,0,1,0,977,A
4-HA,65,980,0,0,0,980,A
4-HA,66,0,993,0,1,994,T
4-HA,67,0,2,993,0,995,G
4-HA,68,996,0,1,0,997,A
4-HA,69,0,0,0,1010,1010,C
4-HA,70,1007,0,0,0,1007,A
4-HA,71,1002,0,2,0,1004,A
4-HA,72,0,0,0,1026,1026,C
4-HA,73,1021,0,0,0,1021,A
4-HA,74,0,0,1030,0,1030,G
4-HA,75,0,0,0,1023,1023,C
4-HA,76,1029,0,3,0,1032,A
4-HA,77,0,0,0,1063,1063,C
4-HA,78,1,1,1052,0,1054,G
4-HA,79,1,0,1070,0,1071,G
4-HA,80,0,1,0,1069,1070,C
4-HA,81,1064,0,0,0,1064,A
4-HA,82,1079,0,1,0,1080,A
4-HA,83,1,1,0,1094,1096,C
4-HA,84,0,0,1116,0,1116,G
4-HA,85,2,0,0,1120,1122,C
4-HA,86,0,1110,0,1,1111,T
4-HA,87,0,2,1127,0,1129,G
4-HA,88,1,1123,0,0,1124,T
4-HA,89,1,0,1171,0,1172,G
4-HA,90,1,0,0,1176,1177,C
4-HA,91,3,0,0,1190,1193,C
4-HA,92,0,1193,0,0,1193,T
4-HA,93,0,1185,0,0,1185,T
4-HA,94,0,2,1188,0,1190,G
4-HA,95,0,0,1185,0,1185,G
4-HA,96,0,0,1217,1,1218,G
4-HA,97,0,1,0,1219,1220,C
4-HA,98,1209,0,0,0,1209,A
4-HA,99,0,0,0,1231,1231,C
4-HA,100,2,0,0,1209,1211,C
4-HA,101,1318,0,3,0,1321,A
4-HA,102,0,1330,0,0,1330,T
4-HA,103,0,0,1337,0,1337,G
4-HA,104,0,0,0,1339,1339,C
4-HA,105,1314,0,2,0,1316,A
4-HA,106,1,0,1401,0,1402,G
4-HA,107,0,1399,0,1,1400,T
4-HA,108,1414,0,1,0,1415,A
4-HA,109,0,0,0,1415,1415,C
4-HA,110,2,1,0,1379,1382,C
4-HA,111,1393,0,0,0,1393,A
4-HA,112,1384,0,0,0,1384,A
4-HA,113,1389,0,2,0,1391,A
4-HA,114,1,1,0,1398,1400,C
4-HA,115,0,5,1366,1,1372,G
4-HA,116,0,3,1390,0,1393,G
4-HA,117,1389,0,2,0,1391,A
4-HA,118,1394,0,2,0,1396,A
4-HA,119,1,0,0,1399,1400,C
4-HA,120,1,2,1381,0,1384,G
4-HA,121,0,0,1389,0,1389,G
4-HA,122,0,1448,0,1,1449,T
4-HA,123,1468,0,0,0,1468,A
4-HA,124,0,1,1470,0,1471,G
4-HA,125,0,1460,0,1,1461,T
4-HA,126,1,3,1462,1,1467,G
4-HA,127,1462,0,2,0,1464,A
4-HA,128,1469,0,2,0,1471,A
4-HA,129,1471,0,2,0,1473,A
4-HA,130,1449,0,0,0,1449,A
4-HA,131,0,1,0,1465,1466,C
4-HA,132,1465,0,1,0,1466,A
4-HA,133,1465,0,3,0,1468,A
4-HA,134,0,1463,0,2,1465,T
4-HA,135,0,2,1,1463,1466,C
4-HA,136,1469,0,1,0,1470,A
4-HA,137,0,1,0,1472,1473,C
4-HA,138,0,2,1470,0,1472,G
4-HA,139,1472,0,0,0,1472,A
4-HA,140,1469,0,0,0,1469,A
4-HA,141,0,1471,1,2,1474,T
4-HA,142,0,3,1473,0,1476,G
4-HA,143,1482,0,0,0,1482,A
4-HA,144,0,2,0,1480,1482,C
4-HA,145,5,1,0,1473,1479,C
4-HA,146,1498,0,1,0,1499,A
4-HA,147,1496,1,1,0,1498,A
4-HA,148,1498,0,0,0,1498,A
4-HA,149,0,1504,0,0,1504,T
4-HA,150,0,1498,0,0,1498,T
4-HA,151,1,2,1505,0,1508,G
4-HA,152,1501,0,1,0,1502,A
4-HA,153,1503,0,4,1,1508,A
4-HA,154,0,0,1512,0,1512,G
4-HA,155,0,1506,0,0,1506,T
4-HA,156,0,1552,0,0,1552,T
4-HA,157,1557,0,0,0,1557,A
4-HA,158,0,1,0,1561,1562,C
4-HA,159,1,1563,0,1,1565,T
4-HA,160,1560,0,2,0,1562,A
4-HA,161,1595,0,1,0,1596,A
4-HA,162,1,1592,0,1,1594,T
4-HA,163,1,2,1595,1,1599,G
4-HA,164,0,1,0,1658,1659,C
4-HA,165,0,1641,0,1,1642,T
4-HA,166,1647,0,1,0,1648,A
4-HA,167,0,1,0,1650,1651,C
4-HA,168,0,1645,0,1,1646,T
4-HA,169,0,6,1649,0,1655,G
4-HA,170,1639,0,1,0,1640,A
4-HA,171,0,0,1646,0,1646,G
4-HA,172,0,0,0,1643,1643,C
4-HA,173,0,1606,0,4,1610,T
4-HA,174,0,1,1658,0,1659,G
4-HA,175,1,0,1700,0,1701,G
4-HA,176,0,1700,0,1,1701,T
4-HA,177,1,1704,0,1,1706,T
4-HA,178,0,1,0,1699,1700,C
4-HA,179,1689,1,1,0,1691,A
4-HA,180,0,8,1694,0,1702,G
4-HA,181,1700,0,1,0,1701,A
4-HA,182,0,0,1741,0,1741,G
4-HA,183,0,1715,0,3,1718,T
4-HA,184,0,1695,1,0,1696,T
4-HA,185,5,0,0,1701,1706,C
4-HA,186,2,0,0,1715,1717,C
4-HA,187,0,1704,0,2,1706,T
4-HA,188,5,0,0,1716,1721,C
4-HA,189,1713,0,3,0,1716,A
4-HA,190,1716,0,1,0,1717,A
4-HA,191,0,0,0,1724,1724,C
4-HA,192,1690,0,2,0,1692,A
4-HA,193,0,2,1722,0,1724,G
4-HA,194,0,0,1722,1,1723,G
4-HA,195,0,1717,0,2,1719,T
4-HA,196,2,0,1723,0,1725,G
4-HA,197,1724,0,3,0,1727,A
4-HA,198,1736,0,1,0,1737,A
4-HA,199,1784,0,2,0,1786,A
4-HA,200,0,1783,0,0,1783,T
4-HA,201,1797,0,1,1,1799,A
4-HA,202,1,1776,0,2,1779,T
4-HA,203,0,1,1778,0,1779,G
4-HA,204,0,0,0,1790,1790,C
4-HA,205,2,8,1778,0,1788,G
4-HA,206,1789,0,0,1,1790,A
4-HA,207,0,2,0,1789,1791,C
4-HA,208,1744,0,17,0,1761,A
4-HA,209,0,1,1878,1,1880,G
4-HA,210,0,1873,0,3,1876,T
4-HA,211,2,1,0,1899,1902,C
4-HA,212,2,2,0,1897,1901,C
4-HA,213,0,1892,0,4,1896,T
4-HA,214,3,3,1,1926,1933,C
4-HA,215,1938,0,1,0,1939,A
4-HA,216,0,1937,0,1,1938,T
4-HA,217,4,2,0,1938,1944,C
4-HA,218,1867,0,2,0,1869,A
4-HA,219,0,2,1879,0,1881,G
4-HA,220,1859,1,0,0,1860,A
4-HA,221,0,1868,0,1,1869,T
4-HA,222,1,0,1,1868,1870,C
4-HA,223,2,1,0,1842,1845,C
4-HA,224,1,1842,0,0,1843,T
4-HA,225,0,1844,0,0,1844,T
4-HA,226,1,0,1846,0,1847,G
4-HA,227,1845,0,2,0,1847,A
4-HA,228,0,1840,0,2,1842,T
4-HA,229,0,3,1856,0,1859,G
4-HA,230,0,1,1850,0,1851,G
4-HA,231,1850,1,1,0,1852,A
4-HA,232,1844,0,0,0,1844,A
4-HA,233,1853,0,0,0,1853,A
4-HA,234,1854,0,1,0,1855,A
4-HA,235,1855,1,1,0,1857,A
4-HA,236,1867,0,1,0,1868,A
4-HA,237,0,0,1,1875,1876,C
4-HA,238,0,1865,0,0,1865,T
4-HA,239,0,0,1875,0,1875,G
4-HA,240,1,1,1,1866,1869,C
4-HA,241,1869,1,3,0,1873,A
4-HA,242,0,0,0,1962,1962,C
4-HA,243,1956,1,1,0,1958,A
4-HA,244,0,1,0,2195,2196,C
4-HA,245,0,2188,0,1,2189,T
4-HA,246,2221,0,1,0,2222,A
4-HA,247,2215,0,5,0,2220,A
4-HA,248,0,2226,0,1,2227,T
4-HA,249,2226,0,2,0,2228,A
4-HA,250,0,2,2226,0,2228,G
4-HA,251,2170,1,0,0,2171,A
4-HA,252,0,2132,0,1,2133,T
4-HA,253,3,0,2006,0,2009,G
4-HA,254,0,0,0,2017,2017,C
4-HA,255,0,1993,0,2,1995,T
4-HA,256,3,0,0,2125,2128,C
4-HA,257,0,2121,1,0,2122,T
4-HA,258,2185,0,0,0,2185,A
4-HA,259,0,2178,0,1,2179,T
4-HA,260,0,2178,0,0,2178,T
4-HA,261,0,2,2189,1,2192,G
4-HA,262,0,3,2175,0,2178,G
4-HA,263,0,3,2179,0,2182,G
4-HA,264,2150,1,3,0,2154,A
4-HA,265,0,3,2129,0,2132,G
4-HA,266,2093,1,1,0,2095,A
4-HA,267,4,0,0,2202,2206,C
4-HA,268,3,0,0,2253,2256,C
4-HA,269,1,0,0,2256,2257,C
4-HA,270,0,2250,0,3,2253,T
4-HA,271,1,0,0,2296,2297,C
4-HA,272,2283,0,3,0,2286,A
4-HA,273,0,1,2396,0,2397,G
4-HA,274,0,2387,0,5,2392,T
4-HA,275,1,7,2399,0,2407,G
4-HA,276,0,2336,0,5,2341,T
4-HA,277,2,0,2328,0,2330,G
4-HA,278,2316,7,3,0,2326,A
4-HA,279,0,2320,0,5,2325,T
4-HA,280,1,4,2294,0,2299,G
4-HA,281,0,0,2303,0,2303,G
4-HA,282,2,0,0,2247,2249,C
4-HA,283,1,2247,0,2,2250,T
4-HA,284,0,2239,0,1,2240,T
4-HA,285,3,0,1,2240,2244,C
4-HA,286,7,0,0,2235,2242,C
4-HA,287,2245,1,1,1,2248,A
4-HA,288,2257,0,0,0,2257,A
4-HA,289,2243,1,4,0,2248,A
4-HA,290,2253,0,2,0,2255,A
4-HA,291,0,2261,0,3,2264,T
4-HA,292,2258,0,2,0,2260,A
4-HA,293,2261,0,1,0,2262,A
4-HA,294,2,2,2268,0,2272,G
4-HA,295,2286,1,1,0,2288,A
4-HA,296,2302,0,1,0,2303,A
4-HA,297,2302,0,0,1,2303,A
4-HA,298,0,2303,0,0,2303,T
4-HA,299,1,4,2292,0,2297,G
4-HA,300,1,3,2281,0,2285,G
4-HA,301,0,2,2299,0,2301,G
4-HA,302,2294,1,7,0,2302,A
4-HA,303,2,1,0,2298,2301,C
4-HA,304,1,2,0,2289,2292,C
4-HA,305,0,2327,0,6,2333,T
4-HA,306,0,2327,0,0,2327,T
4-HA,307,0,2326,0,4,2330,T
4-HA,308,0,2343,0,1,2344,T
4-HA,309,0,2341,0,1,2342,T
4-HA,310,1,0,2356,0,2357,G
4-HA,311,0,2355,0,1,2356,T
4-HA,312,0,2342,0,0,2342,T
4-HA,313,2,8,2335,0,2345,G
4-HA,314,2319,0,3,0,2322,A
4-HA,315,2328,0,0,0,2328,A
4-HA,316,1,2,0,2325,2328,C
4-HA,317,4,0,2309,0,2313,G
4-HA,318,1,0,0,2354,2355,C
4-HA,319,2341,0,3,0,2344,A
4-HA,320,1,1,2357,0,2359,G
4-HA,321,0,1,0,2363,2364,C
4-HA,322,2357,0,3,0,2360,A
4-HA,323,2361,0,0,0,2361,A
4-HA,324,2359,0,2,1,2362,A
4-HA,325,0,0,2461,1,2462,G
4-HA,326,0,2,0,2466,2468,C
4-HA,327,1,0,0,2454,2455,C
4-HA,328,1,2448,0,3,2452,T
4-HA,329,2442,0,2,0,2444,A
4-HA,330,0,1,0,2474,2475,C
4-HA,331,2469,0,5,0,2474,A
4-HA,332,8,1,2469,0,2478,G
4-HA,333,1,0,0,2458,2459,C
4-HA,334,2413,1,4,0,2418,A
4-HA,335,2432,0,1,0,2433,A
4-HA,336,0,1,1,2523,2525,C
4-HA,337,0,2519,0,0,2519,T
4-HA,338,0,2,2526,0,2528,G
4-HA,339,1,2503,0,3,2507,T
4-HA,340,0,2508,0,1,2509,T
4-HA,341,2517,0,1,0,2518,A
4-HA,342,2,0,1,2715,2718,C
4-HA,343,3,1,0,2730,2734,C
4-HA,344,2,1,0,2786,2789,C
4-HA,345,0,2690,0,7,2697,T
4-HA,346,0,2657,0,38,2695,T
4-HA,347,2709,0,0,1,2710,A
4-HA,348,1,2704,0,1,2706,T
4-HA,349,1,7,2701,0,2709,G
4-HA,350,2694,1,4,0,2699,A
4-HA,351,1,2516,0,1,2518,T
4-HA,352,3,0,2549,0,2552,G
4-HA,353,0,2493,0,1,2494,T
4-HA,354,0,0,2489,0,2489,G
4-HA,355,0,3,0,2492,2495,C
4-HA,356,3,2,0,2482,2487,C
4-HA,357,3,0,2517,0,2520,G
4-HA,358,0,3,2559,0,2562,G
4-HA,359,2566,2,0,0,2568,A
4-HA,360,0,2574,0,1,2575,T
4-HA,361,0,2534,2,3,2539,T
4-HA,362,2560,0,0,0,2560,A
4-HA,363,2,2550,0,0,2552,T
4-HA,364,1,0,2560,0,2561,G
4-HA,365,1,1,1,2561,2564,C
4-HA,366,7,1,0,2536,2544,C
4-HA,367,1,2540,0,2,2543,T
4-HA,368,2,0,0,2658,2660,C
4-HA,369,0,2,1,2673,2676,C
4-HA,370,1,1,0,2678,2680,C
4-HA,371,0,2667,0,4,2671,T
4-HA,372,0,2676,0,1,2677,T
4-HA,373,2670,0,3,0,2673,A
4-HA,374,1,2,2714,0,2717,G
4-HA,375,0,3,2733,0,2736,G
4-HA,376,1,2690,0,5,2696,T
4-HA,377,6,0,0,2615,2621,C
4-HA,378,2587,1,2,1,2591,A
4-HA,379,2,0,0,2647,2649,C
4-HA,380,3,2648,0,2,2653,T
4-HA,381,2647,0,1,0,2648,A
4-HA,382,1,2,2653,0,2656,G
4-HA,383,1,2616,0,2,2619,T
4-HA,384,0,2605,0,1,2606,T
4-HA,385,0,0,2628,0,2628,G
4-HA,386,2,1,0,2618,2621,C
4-HA,387,3,1,0,2618,2622,C
4-HA,388,0,2591,0,9,2600,T
4-HA,389,2,0,0,2604,2606,C
4-HA,390,2682,0,1,0,2683,A
4-HA,391,0,2682,0,1,2683,T
4-HA,392,1,1,0,2680,2682,C
4-HA,393,1,4,0,2681,2686,C
4-HA,394,1,1,2655,0,2657,G
4-HA,395,4,2,2668,0,2674,G
4-HA,396,0,1,0,2675,2676,C
4-HA,397,2698,1,2,1,2702,A
4-HA,398,0,0,1,2731,2732,C
4-HA,399,2677,0,2,1,2680,A
4-HA,400,3,2,0,2691,2696,C
4-HA,401,0,2682,0,3,2685,T
4-HA,402,1,4,2701,0,2706,G
4-HA,403,0,2,2735,0,2737,G
4-HA,404,2716,0,6,1,2723,A
4-HA,405,4,0,2759,0,2763,G
4-HA,406,0,2729,0,1,2730,T
4-HA,407,0,2695,1,1,2697,T
4-HA,408,0,2698,0,3,2701,T
4-HA,409,2687,1,1,0,2689,A
4-HA,410,2690,1,5,0,2696,A
4-HA,411,1,2,0,2703,2706,C
4-HA,412,2644,1,2,0,2647,A
4-HA,413,2656,0,0,0,2656,A
4-HA,414,1,2635,0,2,2638,T
4-HA,415,0,2,2637,0,2639,G
4-HA,416,2634,0,1,0,2635,A
4-HA,417,2624,0,1,0,2625,A
4-HA,418,2622,0,4,1,2627,A
4-HA,419,0,1,2629,0,2630,G
4-HA,420,2,1,0,2652,2655,C
4-HA,421,0,2644,0,4,2648,T
4-HA,422,1,2640,0,1,2642,T
4-HA,423,1,0,0,2667,2668,C
4-HA,424,2669,0,1,0,2670,A
4-HA,425,2673,0,3,0,2676,A
4-HA,426,0,2677,0,4,2681,T
4-HA,427,0,2667,0,0,2667,T
4-HA,428,1,0,2715,0,2716,G
4-HA,429,0,4,2740,0,2744,G
4-HA,430,2743,0,1,0,2744,A
4-HA,431,0,2,1,2745,2748,C
4-HA,432,2,2711,0,2,2715,T
4-HA,433,3,1,2721,0,2725,G
4-HA,434,2,5,2729,0,2736,G
4-HA,435,2731,1,4,0,2736,A
4-HA,436,0,0,2739,0,2739,G
4-HA,437,0,2682,0,4,2686,T
4-HA,438,7,2,0,2646,2655,C
4-HA,439,2678,0,0,0,2678,A
4-HA,440,1,0,0,2688,2689,C
4-HA,441,1,2683,0,1,2685,T
4-HA,442,5,2,0,2676,2683,C
4-HA,443,2658,0,1,0,2659,A
4-HA,444,2669,0,2,0,2671,A
4-HA,445,2662,0,4,0,2666,A
4-HA,446,2667,1,2,1,2671,A
4-HA,447,0,2,0,2669,2671,C
4-HA,448,1,3,2642,0,2646,G
4-HA,449,3,3,2681,0,2687,G
4-HA,450,2678,0,3,0,2681,A
4-HA,451,2682,0,3,1,2686,A
4-HA,452,1,0,0,2686,2687,C
4-HA,453,2660,1,1,1,2663,A
4-HA,454,2685,0,4,0,2689,A
4-HA,455,0,0,2716,0,2716,G
4-HA,456,0,2,0,2711,2713,C
4-HA,457,0,2696,0,4,2700,T
4-HA,458,3,0,0,2712,2715,C
4-HA,459,1,2699,0,3,2703,T
4-HA,460,3,1,2706,0,2710,G
4-HA,461,1,0,1,2709,2711,C
4-HA,462,0,2706,1,5,2712,T
4-HA,463,0,2767,0,3,2770,T
4-HA,464,1,1,2831,0,2833,G
4-HA,465,1,0,0,2854,2855,C
4-HA,466,2855,1,0,0,2856,A
4-HA,467,1,2835,0,2,2838,T
4-HA,468,2832,0,1,1,2834,A
4-HA,469,2818,1,0,0,2819,A
4-HA,470,0,5,2809,2,2816,G
4-HA,471,0,1,2815,0,2816,G
4-HA,472,2712,0,1,1,2714,A
4-HA,473,2,1,2685,1,2689,G
4-HA,474,2668,0,3,0,2671,A
4-HA,475,0,2754,0,1,2755,T
4-HA,476,0,0,0,2761,2761,C
4-HA,477,2,2758,0,0,2760,T
4-HA,478,2755,0,2,0,2757,A
4-HA,479,2748,0,1,0,2749,A
4-HA,480,2724,1,2,0,2727,A
4-HA,481,2731,1,1,1,2734,A
4-HA,482,2739,2,2,0,2743,A
4-HA,483,0,2,0,2755,2757,C
4-HA,484,2672,0,0,0,2672,A
4-HA,485,2,1,2684,0,2687,G
4-HA,486,0,2663,0,3,2666,T
4-HA,487,0,2704,0,1,2705,T
4-HA,488,1,2714,0,2,2717,T
4-HA,489,0,2,0,2784,2786,C
4-HA,490,0,2788,0,1,2789,T
4-HA,491,0,2804,0,0,2804,T
4-HA,492,0,2801,1,2,2804,T
4-HA,493,2796,0,5,0,2801,A
4-HA,494,0,1,2799,0,2800,G
4-HA,495,0,2796,0,0,2796,T
4-HA,496,2779,0,0,2,2781,A
4-HA,497,0,0,2800,0,2800,G
4-HA,498,2744,0,2,1,2747,A
4-HA,499,1,2749,0,0,2750,T
4-HA,500,0,2746,0,1,2747,T
4-HA,501,1,3,2797,0,2801,G
4-HA,502,2787,0,1,0,2788,A
4-HA,503,2791,1,2,0,2794,A
4-HA,504,0,2793,0,0,2793,T
4-HA,505,0,2766,0,4,2770,T
4-HA,506,1,4,2789,1,2795,G
4-HA,507,0,1,2790,0,2791,G
4-HA,508,1,2793,0,1,2795,T
4-HA,509,0,2781,0,3,2784,T
4-HA,510,0,6,2747,0,2753,G
4-HA,511,2763,2,4,0,2769,A
4-HA,512,2,1,0,2743,2746,C
4-HA,513,9,0,0,2736,2745,C
4-HA,514,5,0,0,2793,2798,C
4-HA,515,2786,1,1,0,2788,A
4-HA,516,1,0,0,2810,2811,C
4-HA,517,0,2800,0,3,2803,T
4-HA,518,0,2805,0,1,2806,T
4-HA,519,2802,1,2,1,2806,A
4-HA,520,2784,0,3,0,2787,A
4-HA,521,2795,0,0,1,2796,A
4-HA,522,0,0,0,2728,2728,C
4-HA,523,0,2791,0,3,2794,T
4-HA,524,1,2800,1,3,2805,T
4-HA,525,2,1,0,2834,2837,C
4-HA,526,2834,0,2,0,2836,A
4-HA,527,2836,0,2,0,2838,A
4-HA,528,2839,0,4,0,2843,A
4-HA,529,0,2844,0,0,2844,T
4-HA,530,2887,1,1,0,2889,A
4-HA,531,0,1,0,2881,2882,C
4-HA,532,3,1,0,2801,2805,C
4-HA,533,4,0,1,2807,2812,C
4-HA,534,2796,0,3,0,2799,A
4-HA,535,1,1,2909,0,2911,G
4-HA,536,0,0,1,2925,2926,C
4-HA,537,2919,0,0,0,2919,A
4-HA,538,0,2911,0,3,2914,T
4-HA,539,0,2864,0,3,2867,T
4-HA,540,1,8,2937,1,2947,G
4-HA,541,2949,0,4,0,2953,A
4-HA,542,2949,2,4,0,2955,A
4-HA,543,2,0,0,2953,2955,C
4-HA,544,2,2,2858,0,2862,G
4-HA,545,0,2877,0,4,2881,T
4-HA,546,2,4,2887,1,2894,G
4-HA,547,2902,1,0,0,2903,A
4-HA,548,0,1,0,2899,2900,C
4-HA,549,0,2808,0,2,2810,T
4-HA,550,2873,1,2,0,2876,A
4-HA,551,1,2866,0,2,2869,T
4-HA,552,4,3,2894,0,2901,G
4-HA,553,2,3,0,2888,2893,C
4-HA,554,6,2,1,2839,2848,C
4-HA,555,2834,2,3,0,2839,A
4-HA,556,2833,1,1,0,2835,A
4-HA,557,2881,0,2,1,2884,A
4-HA,558,1,0,0,2896,2897,C
4-HA,559,2825,0,0,0,2825,A
4-HA,560,2829,3,3,0,2835,A
4-HA,561,1,2814,0,0,2815,T
4-HA,562,1,5,2816,0,2822,G
4-HA,563,2815,5,2,0,2822,A
4-HA,564,2808,0,6,0,2814,A
4-HA,565,3,1,0,2752,2756,C
4-HA,566,2781,1,0,0,2782,A
4-HA,567,2799,0,2,0,2801,A
4-HA,568,0,2799,0,0,2799,T
4-HA,569,2,2792,1,1,2796,T
4-HA,570,1,2798,0,0,2799,T
4-HA,571,2,6,2793,0,2801,G
4-HA,572,2799,3,5,0,2807,A
4-HA,573,1,2,0,2806,2809,C
4-HA,574,2796,0,0,0,2796,A
4-HA,575,2791,1,1,0,2793,A
4-HA,576,2842,0,1,0,2843,A
4-HA,577,0,2876,0,1,2877,T
4-HA,578,0,2843,0,1,2844,T
4-HA,579,3,2,2863,0,2868,G
4-HA,580,1,2866,0,2,2869,T
4-HA,581,2875,0,2,0,2877,A
4-HA,582,2,0,0,2928,2930,C
4-HA,583,2920,1,1,1,2923,A
4-HA,584,0,2960,0,2,2962,T
4-HA,585,0,2905,1,2,2908,T
4-HA,586,0,2909,0,0,2909,T
4-HA,587,0,3,2891,0,2894,G
4-HA,588,2,7,2877,0,2886,G
4-HA,589,1,3,2883,0,2887,G
4-HA,590,0,1,2895,2,2898,G
4-HA,591,2,2,2854,0,2858,G
4-HA,592,1,2,2915,0,2918,G
4-HA,593,0,2876,0,7,2883,T
4-HA,594,0,2892,0,3,2895,T
4-HA,595,5,0,0,2899,2904,C
4-HA,596,2906,0,5,2,2913,A
4-HA,597,1,0,0,2921,2922,C
4-HA,598,2,3,0,2916,2921,C
4-HA,599,2926,0,1,0,2927,A
4-HA,600,1,2,0,2938,2941,C
4-HA,601,4,2,0,2908,2914,C
4-HA,602,4,1,0,2886,2891,C
4-HA,603,0,2,2889,1,2892,G
4-HA,604,3,4,2955,0,2962,G
4-HA,605,1,2,2958,0,2961,G
4-HA,606,0,2949,0,0,2949,T
4-HA,607,2953,0,1,0,2954,A
4-HA,608,0,6,0,2927,2933,C
4-HA,609,2,4,2904,0,2910,G
4-HA,610,0,7,2951,0,2958,G
4-HA,611,2962,1,3,0,2966,A
4-HA,612,0,1,0,2968,2969,C
4-HA,613,2894,0,3,0,2897,A
4-HA,614,2884,1,2,0,2887,A
4-HA,615,2866,1,16,0,2883,A
4-HA,616,1,1,2939,0,2941,G
4-HA,617,2935,0,5,0,2940,A
4-HA,618,0,0,0,2941,2941,C
4-HA,619,4,1,0,2870,2875,C
4-HA,620,2895,0,3,0,2898,A
4-HA,621,2895,0,1,0,2896,A
4-HA,622,2933,2,0,0,2935,A
4-HA,623,0,2928,1,2,2931,T
4-HA,624,3,1,0,2948,2952,C
4-HA,625,0,2787,0,0,2787,T
4-HA,626,1,2778,0,5,2784,T
4-HA,627,4,0,0,2810,2814,C
4-HA,628,4,2,0,2809,2815,C
4-HA,629,2,2800,0,1,2803,T
4-HA,630,2,0,2825,0,2827,G
4-HA,631,1,2777,0,1,2779,T
4-HA,632,2800,1,1,0,2802,A
4-HA,633,0,2785,0,5,2790,T
4-HA,634,2,3,2821,0,2826,G
4-HA,635,1,2,0,2830,2833,C
4-HA,636,1,2803,0,10,2814,T
4-HA,637,8,2,0,2806,2816,C
4-HA,638,2812,0,3,1,2816,A
4-HA,639,2808,0,2,0,2810,A
4-HA,640,1,1,2822,0,2824,G
4-HA,641,2,2,0,2829,2833,C
4-HA,642,2832,1,1,0,2834,A
4-HA,643,0,2804,0,1,2805,T
4-HA,644,5,1,0,2794,2800,C
4-HA,645,2790,0,3,0,2793,A
4-HA,646,0,2,2819,0,2821,G
4-HA,647,1,6,2817,0,2824,G
4-HA,648,2818,2,3,1,2824,A
4-HA,649,2797,0,4,0,2801,A
4-HA,650,2,4,2855,0,2861,G
4-HA,651,2853,1,1,0,2855,A
4-HA,652,2893,1,2,1,2897,A
4-HA,653,0,2915,0,4,2919,T
4-HA,654,6,0,0,2912,2918,C
4-HA,655,2888,1,4,0,2893,A
4-HA,656,0,1,0,2895,2896,C
4-HA,657,2895,0,1,0,2896,A
4-HA,658,0,1,2950,0,2951,G
4-HA,659,0,2896,0,2,2898,T
4-HA,660,5,1,0,2899,2905,C
4-HA,661,0,2870,0,6,2876,T
4-HA,662,3,0,0,2940,2943,C
4-HA,663,0,2945,0,3,2948,T
4-HA,664,2977,0,0,0,2977,A
4-HA,665,0,4,0,2964,2968,C
4-HA,666,3,2,0,2966,2971,C
4-HA,667,2931,1,2,0,2934,A
4-HA,668,2933,0,1,0,2934,A
4-HA,669,2913,0,1,0,2914,A
4-HA,670,2918,0,4,0,2922,A
4-HA,671,0,0,2911,0,2911,G
4-HA,672,2838,0,3,0,2841,A
4-HA,673,2820,0,1,0,2821,A
4-HA,674,3,2,2816,0,2821,G
4-HA,675,0,1,0,2829,2830,C
4-HA,676,2,2,1,2826,2831,C
4-HA,677,2833,1,0,0,2834,A
4-HA,678,2838,6,2,0,2846,A
4-HA,679,0,0,0,2844,2844,C
4-HA,680,2842,0,0,0,2842,A
4-HA,681,2841,0,1,6,2848,A
4-HA,682,2840,0,1,1,2842,A
4-HA,683,0,1,0,2891,2892,C
4-HA,684,2,2875,0,1,2878,T
4-HA,685,0,2,2889,0,2891,G
4-HA,686,0,2873,0,6,2879,T
4-HA,687,2874,0,0,0,2874,A
4-HA,688,2888,0,2,0,2890,A
4-HA,689,0,2881,0,0,2881,T
4-HA,690,2,1,1,2894,2898,C
4-HA,691,5,0,0,2892,2897,C
4-HA,692,5,0,0,2862,2867,C
4-HA,693,1,2,2861,0,2864,G
4-HA,694,2862,0,0,1,2863,A
4-HA,695,2864,0,1,0,2865,A
4-HA,696,1,2861,0,0,2862,T
4-HA,697,2870,1,2,0,2873,A
4-HA,698,0,2867,0,1,2868,T
4-HA,699,2,2,0,2844,2848,C
4-HA,700,4,2,2843,0,2849,G
4-HA,701,1,6,2922,0,2929,G
4-HA,702,2929,0,4,0,2933,A
4-HA,703,0,2955,0,1,2956,T
4-HA,704,2,0,0,2954,2956,C
4-HA,705,1,2942,0,2,2945,T
4-HA,706,2944,0,1,1,2946,A
4-HA,707,0,6,2980,0,2986,G
4-HA,708,3004,1,3,0,3008,A
4-HA,709,0,1,1,2993,2995,C
4-HA,710,2,0,0,2910,2912,C
4-HA,711,3,38,0,2867,2908,C
4-HA,712,2870,1,1,0,2872,A
4-HA,713,1,2,3041,0,3044,G
4-HA,714,3043,1,2,0,3046,A
4-HA,715,1,3,3088,0,3092,G
4-HA,716,0,3046,0,3,3049,T
4-HA,717,3016,0,4,0,3020,A
4-HA,718,3012,1,9,0,3022,A
4-HA,719,8,2,3067,0,3077,G
4-HA,720,0,1,3099,1,3101,G
4-HA,721,3067,0,0,0,3067,A
4-HA,722,2844,0,2,1,2847,A
4-HA,723,1,2831,0,1,2833,T
4-HA,724,2851,0,2,0,2853,A
4-HA,725,2,2841,0,1,2844,T
4-HA,726,1,1,0,2883,2885,C
4-HA,727,2,2,0,2874,2878,C
4-HA,728,2,0,0,2798,2800,C
4-HA,729,1,2775,0,5,2781,T
4-HA,730,2793,0,1,0,2794,A
4-HA,731,1,0,2797,0,2798,G
4-HA,732,2,2,0,2797,2801,C
4-HA,733,2720,0,1,0,2721,A
4-HA,734,3,5,2791,0,2799,G
4-HA,735,2763,0,5,0,2768,A
4-HA,736,2766,0,2,0,2768,A
4-HA,737,0,2772,0,1,2773,T
4-HA,738,2765,0,0,1,2766,A
4-HA,739,2764,1,8,0,2773,A
4-HA,740,1,2,2762,0,2765,G
4-HA,741,2,3,0,2770,2775,C
4-HA,742,2768,1,2,0,2771,A
4-HA,743,4,2705,0,8,2717,T
4-HA,744,3,2,0,2827,2832,C
4-HA,745,0,2827,0,0,2827,T
4-HA,746,2838,2,1,0,2841,A
4-HA,747,1,2835,1,4,2841,T
4-HA,748,0,2819,0,1,2820,T
4-HA,749,1,6,2842,0,2849,G
4-HA,750,3,0,2821,1,2825,G
4-HA,751,2827,0,3,0,2830,A
4-HA,752,1,0,0,2821,2822,C
4-HA,753,2652,0,2,0,2654,A
4-HA,754,2693,2,2,0,2697,A
4-HA,755,0,2801,0,2,2803,T
4-HA,756,2824,1,3,0,2828,A
4-HA,757,1,1,2831,0,2833,G
4-HA,758,2,2809,0,1,2812,T
4-HA,759,2809,0,2,0,2811,A
4-HA,760,2807,0,5,0,2812,A
4-HA,761,2895,0,0,1,2896,A
4-HA,762,2918,0,1,3,2922,A
4-HA,763,0,1,0,2930,2931,C
4-HA,764,2,1,0,2795,2798,C
4-HA,765,245,4,2544,1,2794,G
4-HA,766,2,1,2815,0,2818,G
4-HA,767,1,6,2817,0,2824,G
4-HA,768,2827,0,2,0,2829,A
4-HA,769,1,2,2843,0,2846,G
4-HA,770,2786,0,8,0,2794,A
4-HA,771,0,0,0,2796,2796,C
4-HA,772,2777,0,2,2,2781,A
4-HA,773,0,2782,0,2,2784,T
4-HA,774,2789,0,6,0,2795,A
4-HA,775,1,1,0,2827,2829,C
4-HA,776,0,2816,0,2,2818,T
4-HA,777,0,2817,1,1,2819,T
4-HA,778,0,2825,1,4,2830,T
4-HA,779,0,2825,0,1,2826,T
4-HA,780,0,8,2829,2,2839,G
4-HA,781,2831,1,3,0,2835,A
4-HA,782,0,2834,0,5,2839,T
4-HA,783,0,2887,0,1,2888,T
4-HA,784,2861,0,0,1,2862,A
4-HA,785,2867,1,2,1,2871,A
4-HA,786,0,1,1,2897,2899,C
4-HA,787,2882,0,1,0,2883,A
4-HA,788,0,0,2967,0,2967,G
4-HA,789,0,1,0,2952,2953,C
4-HA,790,2947,0,3,1,2951,A
4-HA,791,0,0,0,2960,2960,C
4-HA,792,2918,2,2,0,2922,A
4-HA,793,0,5,2955,0,2960,G
4-HA,794,2,8,2947,0,2957,G
4-HA,795,0,3,3024,0,3027,G
4-HA,796,3003,2,6,0,3011,A
4-HA,797,3014,1,4,0,3019,A
4-HA,798,0,3018,0,0,3018,T
4-HA,799,2,2,0,3023,3027,C
4-HA,800,1,3030,0,2,3033,T
4-HA,801,3031,0,4,1,3036,A
4-HA,802,3010,1,2,1,3014,A
4-HA,803,0,3003,0,3,3006,T
4-HA,804,1,2934,0,2,2937,T
4-HA,805,0,0,2964,0,2964,G
4-HA,806,0,2,1,3015,3018,C
4-HA,807,0,3082,0,10,3092,T
4-HA,808,8,1,1,3143,3153,C
4-HA,809,2,1,0,3141,3144,C
4-HA,810,1,3139,0,3,3143,T
4-HA,811,3147,0,2,0,3149,A
4-HA,812,0,6,3140,0,3146,G
4-HA,813,1,2,3151,0,3154,G
4-HA,814,1,4,3139,1,3145,G
4-HA,815,1,0,3110,1,3112,G
4-HA,816,0,3012,0,4,3016,T
4-HA,817,0,2983,0,1,2984,T
4-HA,818,2981,0,2,1,2984,A
4-HA,819,0,1,0,3022,3023,C
4-HA,820,1,3007,0,3,3011,T
4-HA,821,1,3029,0,1,3031,T
4-HA,822,4,0,1,3013,3018,C
4-HA,823,2996,1,2,0,2999,A
4-HA,824,2999,0,1,0,3000,A
4-HA,825,2993,0,4,0,2997,A
4-HA,826,3022,3,4,1,3030,A
4-HA,827,0,3023,0,1,3024,T
4-HA,828,2996,0,0,0,2996,A
4-HA,829,0,1,0,2992,2993,C
4-HA,830,1,3,2981,0,2985,G
4-HA,831,2977,0,2,1,2980,A
4-HA,832,2985,0,0,1,2986,A
4-HA,833,1,0,3026,0,3027,G
4-HA,834,0,3020,0,0,3020,T
4-HA,835,2,3,3035,0,3040,G
4-HA,836,2,1,3040,1,3044,G
4-HA,837,1,3,3046,0,3050,G
4-HA,838,3056,1,3,0,3060,A
4-HA,839,3050,0,2,0,3052,A
4-HA,840,3042,1,3,0,3046,A
4-HA,841,3030,0,6,0,3036,A
4-HA,842,0,0,3099,0,3099,G
4-HA,843,0,0,0,3086,3086,C
4-HA,844,0,3057,0,4,3061,T
4-HA,845,5,2,0,3089,3096,C
4-HA,846,3098,1,3,1,3103,A
4-HA,847,3122,0,3,1,3126,A
4-HA,848,0,3127,0,0,3127,T
4-HA,849,3147,0,1,1,3149,A
4-HA,850,3148,0,1,0,3149,A
4-HA,851,0,3084,0,1,3085,T
4-HA,852,0,4,3087,0,3091,G
4-HA,853,3056,0,2,0,3058,A
4-HA,854,1,1,3120,0,3122,G
4-HA,855,3121,1,1,0,3123,A
4-HA,856,0,3108,0,3,3111,T
4-HA,857,6,1,0,3148,3155,C
4-HA,858,3116,0,6,0,3122,A
4-HA,859,0,0,3172,0,3172,G
4-HA,860,3162,1,4,0,3167,A
4-HA,861,0,3161,1,4,3166,T
4-HA,862,2,1,3150,0,3153,G
4-HA,863,1,2,1,3088,3092,C
4-HA,864,3100,0,3,0,3103,A
4-HA,865,1,1,1,3161,3164,C
4-HA,866,3,0,0,3108,3111,C
4-HA,867,3,2,0,3114,3119,C
4-HA,868,3068,0,0,0,3068,A
4-HA,869,1,3049,1,4,3055,T
4-HA,870,0,3053,0,3,3056,T
4-HA,871,2,1,3087,0,3090,G
4-HA,872,0,1,3083,0,3084,G
4-HA,873,2,2,0,3078,3082,C
4-HA,874,3033,1,0,0,3034,A
4-HA,875,3020,0,1,1,3022,A
4-HA,876,3072,0,1,0,3073,A
4-HA,877,0,3070,0,1,3071,T
4-HA,878,0,2,3071,0,3073,G
4-HA,879,0,2,0,3068,3070,C
4-HA,880,3031,0,0,0,3031,A
4-HA,881,3104,0,2,0,3106,A
4-HA,882,0,3105,0,2,3107,T
4-HA,883,1,3142,0,0,3143,T
4-HA,884,4,1,0,3134,3139,C
4-HA,885,0,3087,0,4,3091,T
4-HA,886,2,3,3122,0,3127,G
4-HA,887,3122,1,2,0,3125,A
4-HA,888,3134,0,0,0,3134,A
4-HA,889,1,3132,0,0,3133,T
4-HA,890,2,0,3100,0,3102,G
4-HA,891,0,2,0,3112,3114,C
4-HA,892,3101,1,1,0,3103,A
4-HA,893,1,3101,0,4,3106,T
4-HA,894,6,0,0,3096,3102,C
4-HA,895,3076,0,8,0,3084,A
4-HA,896,1,1,0,3187,3189,C
4-HA,897,2,3160,0,4,3166,T
4-HA,898,1,0,0,3182,3183,C
4-HA,899,4,2,0,3159,3165,C
4-HA,900,3173,0,0,0,3173,A
4-HA,901,3170,2,1,0,3173,A
4-HA,902,3158,0,1,0,3159,A
4-HA,903,0,3023,0,1,3024,T
4-HA,904,0,4,3033,0,3037,G
4-HA,905,1,1,3047,0,3049,G
4-HA,906,3043,0,3,1,3047,A
4-HA,907,3038,1,5,0,3044,A
4-HA,908,5,2,3039,0,3046,G
4-HA,909,1,0,0,2996,2997,C
4-HA,910,2979,0,1,0,2980,A
4-HA,911,0,2980,0,4,2984,T
4-HA,912,1,2975,0,3,2979,T
4-HA,913,1,0,1,3054,3056,C
4-HA,914,2,0,0,3033,3035,C
4-HA,915,5,1,0,3034,3040,C
4-HA,916,3032,0,2,0,3034,A
4-HA,917,3070,0,2,8,3080,A
4-HA,918,1,3101,0,3,3105,T
4-HA,919,0,7,3093,0,3100,G
4-HA,920,3091,0,2,0,3093,A
4-HA,921,1,1,0,3097,3099,C
4-HA,922,3007,0,1,0,3008,A
4-HA,923,3002,1,3,0,3006,A
4-HA,924,2999,0,3,0,3002,A
4-HA,925,1,2,0,3019,3022,C
4-HA,926,5,2,0,2983,2990,C
4-HA,927,2916,1,0,0,2917,A
4-HA,928,1,2914,0,3,2918,T
4-HA,929,1,2912,1,4,2918,T
4-HA,930,1,0,0,2923,2924,C
4-HA,931,3,0,0,2925,2928,C
4-HA,932,2915,0,0,0,2915,A
4-HA,933,2914,2,3,0,2919,A
4-HA,934,2903,0,4,0,2907,A
4-HA,935,2948,1,2,0,2951,A
4-HA,936,0,2932,3,0,2935,T
4-HA,937,1,1,2943,0,2945,G
4-HA,938,1,2942,0,3,2946,T
4-HA,939,2950,0,3,0,2953,A
4-HA,940,2951,0,3,0,2954,A
4-HA,941,2954,1,2,0,2957,A
4-HA,942,0,1,0,2972,2973,C
4-HA,943,2918,0,2,0,2920,A
4-HA,944,1,6,2916,0,2923,G
4-HA,945,1,2,2924,0,2927,G
4-HA,946,2952,1,3,0,2956,A
4-HA,947,2,2945,1,3,2951,T
4-HA,948,5,2,0,2967,2974,C
4-HA,949,2984,0,3,1,2988,A
4-HA,950,2,1,0,3065,3068,C
4-HA,951,3054,2,4,1,3061,A
4-HA,952,1,3127,0,0,3128,T
4-HA,953,3038,1,2,1,3042,A
4-HA,954,0,2,0,3012,3014,C
4-HA,955,2,5,2915,0,2922,G
4-HA,956,1,3,2925,0,2929,G
4-HA,957,1,1,2896,0,2898,G
4-HA,958,1,2,2889,1,2893,G
4-HA,959,1,0,0,2807,2808,C
4-HA,960,0,2,0,2796,2798,C
4-HA,961,1,2715,0,5,2721,T
4-HA,962,3,0,2934,0,2937,G
4-HA,963,0,2922,0,7,2929,T
4-HA,964,4,3,0,2945,2952,C
4-HA,965,6,3,0,2936,2945,C
4-HA,966,1,3,0,2929,2933,C
4-HA,967,2899,1,3,0,2903,A
4-HA,968,2,2,2933,0,2937,G
4-HA,969,2916,1,3,1,2921,A
4-HA,970,0,2918,1,0,2919,T
4-HA,971,2657,0,1,0,2658,A
4-HA,972,1,2608,1,2,2612,T
4-HA,973,0,1,2625,0,2626,G
4-HA,974,2,2605,0,1,2608,T
4-HA,975,1,2572,0,0,2573,T
4-HA,976,2581,0,0,0,2581,A
4-HA,977,2540,0,1,0,2541,A
4-HA,978,0,5,2558,0,2563,G
4-HA,979,1,1,0,2550,2552,C
4-HA,980,2471,0,1,1,2473,A
4-HA,981,2470,0,3,0,2473,A
4-HA,982,2444,0,2,0,2446,A
4-HA,983,2444,0,2,1,2447,A
4-HA,984,0,0,0,2442,2442,C
4-HA,985,2406,2,1,0,2409,A
4-HA,986,1,0,0,2436,2437,C
4-HA,987,0,2387,0,1,2388,T
4-HA,988,2,0,0,2407,2409,C
4-HA,989,1,2404,0,1,2406,T
4-HA,990,0,2,2427,0,2429,G
4-HA,991,2420,0,1,0,2421,A
4-HA,992,2414,0,1,0,2415,A
4-HA,993,2413,2,2,0,2417,A
4-HA,994,0,2395,0,0,2395,T
4-HA,995,0,2357,0,0,2357,T
4-HA,996,1,1,2383,0,2385,G
4-HA,997,2,0,2379,0,2381,G
4-HA,998,0,1,0,2392,2393,C
4-HA,999,2374,1,5,0,2380,A
4-HA,1000,2377,0,1,0,2378,A
4-HA,1001,1,1,0,2381,2383,C
4-HA,1002,2372,1,2,0,2375,A
4-HA,1003,0,1,2394,0,2395,G
4-HA,1004,0,4,2381,0,2385,G
4-HA,1005,0,3,2367,0,2370,G
4-HA,1006,2361,0,7,0,2368,A
4-HA,1007,0,2353,0,2,2355,T
4-HA,1008,0,0,2350,0,2350,G
4-HA,1009,2,3,0,2349,2354,C
4-HA,1010,1,2,2356,0,2359,G
4-HA,1011,2382,0,1,0,2383,A
4-HA,1012,2335,0,0,0,2335,A
4-HA,1013,2350,1,3,1,2355,A
4-HA,1014,0,2328,0,2,2330,T
4-HA,1015,2,0,2377,0,2379,G
4-HA,1016,0,2374,0,2,2376,T
4-HA,1017,2361,0,5,0,2366,A
4-HA,1018,1,1,0,2363,2365,C
4-HA,1019,2,0,0,2340,2342,C
4-HA,1020,2298,1,2,0,2301,A
4-HA,1021,0,2,2301,0,2303,G
4-HA,1022,2258,0,7,1,2266,A
4-HA,1023,1,1,2279,0,2281,G
4-HA,1024,2227,1,4,0,2232,A
4-HA,1025,2218,0,1,0,2219,A
4-HA,1026,2223,1,3,0,2227,A
4-HA,1027,1,1,0,2222,2224,C
4-HA,1028,2208,0,0,0,2208,A
4-HA,1029,2239,0,1,0,2240,A
4-HA,1030,2226,1,4,0,2231,A
4-HA,1031,0,0,0,2243,2243,C
4-HA,1032,0,2204,1,2,2207,T
4-HA,1033,2185,0,2,0,2187,A
4-HA,1034,0,4,2178,0,2182,G
4-HA,1035,2158,1,9,0,2168,A
4-HA,1036,0,1,2205,1,2207,G
4-HA,1037,0,2,2198,0,2200,G
4-HA,1038,1,2,0,2131,2134,C
4-HA,1039,2129,3,3,1,2136,A
4-HA,1040,1,2127,0,2,2130,T
4-HA,1041,2148,0,0,0,2148,A
4-HA,1042,0,2141,0,1,2142,T
4-HA,1043,1,2134,0,1,2136,T
4-HA,1044,0,2134,0,0,2134,T
4-HA,1045,0,1,2027,0,2028,G
4-HA,1046,2,0,2035,0,2037,G
4-HA,1047,1,1,0,2027,2029,C
4-HA,1048,0,0,2030,0,2030,G
4-HA,1049,0,2,0,2009,2011,C
4-HA,1050,1990,0,5,0,1995,A
4-HA,1051,2007,1,1,0,2009,A
4-HA,1052,0,2000,0,0,2000,T
4-HA,1053,1,7,0,1999,2007,C
4-HA,1054,1,0,2007,0,2008,G
4-HA,1055,1,1,1,1988,1991,C
4-HA,1056,4,1,1987,0,1992,G
4-HA,1057,1,0,2004,0,2005,G
4-HA,1058,1,0,2009,0,2010,G
4-HA,1059,0,1995,2,3,2000,T
4-HA,1060,0,1961,0,1,1962,T
4-HA,1061,0,1960,0,3,1963,T
4-HA,1062,3,1,0,1962,1966,C
4-HA,1063,1970,0,1,0,1971,A
4-HA,1064,0,1969,0,2,1971,T
4-HA,1065,1974,0,0,0,1974,A
4-HA,1066,0,3,1985,0,1988,G
4-HA,1067,1905,1,0,0,1906,A
4-HA,1068,1910,1,2,0,1913,A
4-HA,1069,1911,1,0,0,1912,A
4-HA,1070,1924,1,0,0,1925,A
4-HA,1071,1,1908,0,1,1910,T
4-HA,1072,1,7,1910,0,1918,G
4-HA,1073,0,0,1924,0,1924,G
4-HA,1074,0,1902,0,2,1904,T
4-HA,1075,0,1848,0,3,1851,T
4-HA,1076,0,4,1838,0,1842,G
4-HA,1077,1,0,1845,0,1846,G
4-HA,1078,0,2,1850,0,1852,G
4-HA,1079,1811,0,2,0,1813,A
4-HA,1080,1,1,1818,0,1820,G
4-HA,1081,0,2,1755,0,1757,G
4-HA,1082,3,0,1772,0,1775,G
4-HA,1083,1769,0,4,0,1773,A
4-HA,1084,1789,0,0,1,1790,A
4-HA,1085,0,1772,0,1,1773,T
4-HA,1086,2,2,1773,1,1778,G
4-HA,1087,1,2,1806,0,1809,G
4-HA,1088,1,1780,0,1,1782,T
4-HA,1089,0,4,1780,1,1785,G
4-HA,1090,1,1,1779,0,1781,G
4-HA,1091,1743,0,5,1,1749,A
4-HA,1092,0,1742,0,2,1744,T
4-HA,1093,0,3,1763,0,1766,G
4-HA,1094,0,0,1779,0,1779,G
4-HA,1095,1,1745,0,0,1746,T
4-HA,1096,0,1710,0,0,1710,T
4-HA,1097,1,3,1710,0,1714,G
4-HA,1098,0,2,1739,0,1741,G
4-HA,1099,0,1731,0,0,1731,T
4-HA,1100,1734,0,0,0,1734,A
4-HA,1101,0,3,0,1630,1633,C
4-HA,1102,0,4,1637,0,1641,G
4-HA,1103,1,0,1684,0,1685,G
4-HA,1104,0,1679,0,3,1682,T
4-HA,1105,0,1683,0,0,1683,T
4-HA,1106,0,1679,0,0,1679,T
4-HA,1107,1,1,0,1642,1644,C
4-HA,1108,1636,0,6,1,1643,A
4-HA,1109,0,4,1635,0,1639,G
4-HA,1110,0,0,1638,0,1638,G
4-HA,1111,0,1,1,1627,1629,C
4-HA,1112,1571,2,0,0,1573,A
4-HA,1113,1,1582,0,2,1585,T
4-HA,1114,1,0,0,1585,1586,C
4-HA,1115,1589,0,1,0,1590,A
4-HA,1116,1591,0,0,0,1591,A
4-HA,1117,1588,0,1,0,1589,A
4-HA,1118,1601,0,2,0,1603,A
4-HA,1119,0,1596,1,2,1599,T
4-HA,1120,0,1595,0,0,1595,T
4-HA,1121,2,1,0,1600,1603,C
4-HA,1122,2,1587,0,1,1590,T
4-HA,1123,1,1,1592,0,1594,G
4-HA,1124,1584,0,3,0,1587,A
4-HA,1125,0,2,1602,0,1604,G
4-HA,1126,0,0,1608,0,1608,G
4-HA,1127,1,1,1613,0,1615,G
4-HA,1128,1607,0,1,0,1608,A
4-HA,1129,1605,1,4,0,1610,A
4-HA,1130,0,1,1595,1,1597,G
4-HA,1131,1610,0,3,0,1613,A
4-HA,1132,0,2,1626,0,1628,G
4-HA,1133,1,1,1631,0,1633,G
4-HA,1134,1625,1,4,0,1630,A
4-HA,1135,0,0,0,1626,1626,C
4-HA,1136,1616,0,0,0,1616,A
4-HA,1137,1614,1,1,0,1616,A
4-HA,1138,0,0,1618,0,1618,G
4-HA,1139,2,2,0,1614,1618,C
4-HA,1140,1596,0,0,0,1596,A
4-HA,1141,0,1,1607,0,1608,G
4-HA,1142,3,2,0,1599,1604,C
4-HA,1143,1600,0,1,0,1601,A
4-HA,1144,0,0,1617,0,1617,G
4-HA,1145,1604,0,2,1,1607,A
4-HA,1146,0,1637,0,0,1637,T
4-HA,1147,1,0,0,1635,1636,C
4-HA,1148,0,1622,2,6,1630,T
4-HA,1149,2,0,0,1642,1644,C
4-HA,1150,1637,0,1,0,1638,A
4-HA,1151,1633,0,3,0,1636,A
4-HA,1152,1635,0,1,0,1636,A
4-HA,1153,1597,0,6,0,1603,A
4-HA,1154,0,1,1605,0,1606,G
4-HA,1155,0,1,0,1564,1565,C
4-HA,1156,1557,0,1,0,1558,A
4-HA,1157,0,0,0,1592,1592,C
4-HA,1158,1,1585,0,3,1589,T
4-HA,1159,2,2,0,1590,1594,C
4-HA,1160,1590,0,0,1,1591,A
4-HA,1161,1614,0,2,0,1616,A
4-HA,1162,2,1,1613,0,1616,G
4-HA,1163,0,2,0,1608,1610,C
4-HA,1164,1598,0,0,0,1598,A
4-HA,1165,1,0,1611,0,1612,G
4-HA,1166,1,0,1,1577,1579,C
4-HA,1167,1576,1,0,0,1577,A
4-HA,1168,1569,1,1,0,1571,A
4-HA,1169,1,1565,0,3,1569,T
4-HA,1170,1,0,0,1539,1540,C
4-HA,1171,0,3,1555,0,1558,G
4-HA,1172,1559,0,0,0,1559,A
4-HA,1173,0,1547,0,2,1549,T
4-HA,1174,2,3,0,1542,1547,C
4-HA,1175,1533,0,4,0,1537,A
4-HA,1176,1570,0,3,0,1573,A
4-HA,1177,1576,0,0,0,1576,A
4-HA,1178,0,1567,0,1,1568,T
4-HA,1179,3,0,0,1569,1572,C
4-HA,1180,1538,0,3,0,1541,A
4-HA,1181,1559,0,0,0,1559,A
4-HA,1182,0,1557,0,1,1558,T
4-HA,1183,1,0,1562,0,1563,G
4-HA,1184,0,1,1557,0,1558,G
4-HA,1185,1,3,1529,0,1533,G
4-HA,1186,1537,0,3,1,1541,A
4-HA,1187,1536,0,0,0,1536,A
4-HA,1188,0,1,1567,0,1568,G
4-HA,1189,1,0,0,1565,1566,C
4-HA,1190,0,1537,2,6,1545,T
4-HA,1191,1,0,1592,0,1593,G
4-HA,1192,1589,0,2,0,1591,A
4-HA,1193,1589,0,2,0,1591,A
4-HA,1194,0,1591,0,1,1592,T
4-HA,1195,1552,1,1,0,1554,A
4-HA,1196,1,2,1553,0,1556,G
4-HA,1197,1417,1,3,0,1421,A
4-HA,1198,0,1432,0,0,1432,T
4-HA,1199,1,1434,0,1,1436,T
4-HA,1200,0,2,1448,0,1450,G
4-HA,1201,1438,0,0,0,1438,A
4-HA,1202,0,1439,0,2,1441,T
4-HA,1203,0,0,0,1447,1447,C
4-HA,1204,2,0,1442,0,1444,G
4-HA,1205,0,1,1443,0,1444,G
4-HA,1206,2,1,1440,0,1443,G
4-HA,1207,1434,0,3,0,1437,A
4-HA,1208,1445,0,0,0,1445,A
4-HA,1209,1431,0,1,1,1433,A
4-HA,1210,1431,0,3,1,1435,A
4-HA,1211,0,0,0,1440,1440,C
4-HA,1212,1,0,0,1439,1440,C
4-HA,1213,1428,0,1,0,1429,A
4-HA,1214,1424,0,2,0,1426,A
4-HA,1215,1,0,0,1427,1428,C
4-HA,1216,2,1,1430,0,1433,G
4-HA,1217,1431,1,0,0,1432,A
4-HA,1218,1,0,1430,0,1431,G
4-HA,1219,1432,0,0,2,1434,A
4-HA,1220,1430,0,1,1,1432,A
4-HA,1221,1432,1,0,0,1433,A
4-HA,1222,0,1437,0,1,1438,T
4-HA,1223,0,1428,0,3,1431,T
4-HA,1224,1,0,0,1438,1439,C
4-HA,1225,2,0,1,1426,1429,C
4-HA,1226,1434,0,0,1,1435,A
4-HA,1227,0,1432,0,0,1432,T
4-HA,1228,1,0,0,1430,1431,C
4-HA,1229,1419,0,0,1,1420,A
4-HA,1230,0,0,1440,0,1440,G
4-HA,1231,1431,0,1,1,1433,A
4-HA,1232,1,1434,0,1,1436,T
4-HA,1233,0,1420,0,0,1420,T
4-HA,1234,1,2,1436,0,1439,G
4-HA,1235,1432,0,1,1,1434,A
4-HA,1236,1437,0,0,0,1437,A
4-HA,1237,1436,0,3,0,1439,A
4-HA,1238,1439,0,0,0,1439,A
4-HA,1239,1428,1,0,0,1429,A
4-HA,1240,0,3,1428,0,1431,G
4-HA,1241,1419,0,1,0,1420,A
4-HA,1242,1422,0,2,0,1424,A
4-HA,1243,1,1406,0,0,1407,T
4-HA,1244,0,1408,0,1,1409,T
4-HA,1245,3,0,0,1412,1415,C
4-HA,1246,1,1409,0,0,1410,T
4-HA,1247,0,2,0,1406,1408,C
4-HA,1248,1407,0,0,0,1407,A
4-HA,1249,0,1,1408,0,1409,G
4-HA,1250,1401,0,2,0,1403,A
4-HA,1251,1399,0,3,0,1402,A
4-HA,1252,0,0,1415,0,1415,G
4-HA,1253,1,1407,1,0,1409,T
4-HA,1254,3,1,0,1400,1404,C
4-HA,1255,1,2,1404,0,1407,G
4-HA,1256,1405,0,2,0,1407,A
4-HA,1257,1404,0,2,0,1406,A
4-HA,1258,0,1,1407,0,1408,G
4-HA,1259,1,2,1407,0,1410,G
4-HA,1260,2,1,1407,0,1410,G
4-HA,1261,1381,0,3,0,1384,A
4-HA,1262,1,2,1392,0,1395,G
4-HA,1263,1390,1,4,0,1395,A
4-HA,1264,1480,0,0,0,1480,A
4-HA,1265,0,1480,0,0,1480,T
4-HA,1266,1,1480,0,1,1482,T
4-HA,1267,3,2,0,1478,1483,C
4-HA,1268,1452,0,1,0,1453,A
4-HA,1269,0,2,1452,0,1454,G
4-HA,1270,0,0,1452,0,1452,G
4-HA,1271,1449,0,2,0,1451,A
4-HA,1272,0,0,0,1446,1446,C
4-HA,1273,3,2,0,1346,1351,C
4-HA,1274,0,1344,1,0,1345,T
4-HA,1275,0,1301,0,47,1348,T
4-HA,1276,1,3,1360,0,1364,G
4-HA,1277,1365,0,2,0,1367,A
4-HA,1278,1,2,1389,0,1392,G
4-HA,1279,1378,0,1,0,1379,A
4-HA,1280,1217,1,0,0,1218,A
4-HA,1281,1205,0,0,0,1205,A
4-HA,1282,0,1194,0,0,1194,T
4-HA,1283,1225,0,0,0,1225,A
4-HA,1284,0,1224,0,0,1224,T
4-HA,1285,1,1,1227,0,1229,G
4-HA,1286,0,1224,0,3,1227,T
4-HA,1287,0,1187,0,1,1188,T
4-HA,1288,0,1,1189,0,1190,G
4-HA,1289,1178,0,2,0,1180,A
4-HA,1290,0,2,1184,0,1186,G
4-HA,1291,0,1,1182,0,1183,G
4-HA,1292,1163,0,0,0,1163,A
4-HA,1293,1,2,0,1210,1213,C
4-HA,1294,1187,0,0,0,1187,A
4-HA,1295,1,1,0,1184,1186,C
4-HA,1296,0,1175,0,2,1177,T
4-HA,1297,1246,0,3,0,1249,A
4-HA,1298,1264,0,1,1,1266,A
4-HA,1299,1264,0,1,0,1265,A
4-HA,1300,1271,0,4,1,1276,A
4-HA,1301,0,1277,0,1,1278,T
4-HA,1302,1226,0,1,0,1227,A
4-HA,1303,0,0,1237,0,1237,G
4-HA,1304,1190,0,4,0,1194,A
4-HA,1305,0,1208,0,2,1210,T
4-HA,1306,0,0,0,1199,1199,C
4-HA,1307,0,1180,1,0,1181,T
4-HA,1308,2,0,0,1215,1217,C
4-HA,1309,0,1210,0,2,1212,T
4-HA,1310,1,2,1238,0,1241,G
4-HA,1311,0,1,1264,0,1265,G
4-HA,1312,1,1251,0,2,1254,T
4-HA,1313,5,0,0,1256,1261,C
4-HA,1314,1267,0,1,0,1268,A
4-HA,1315,0,1270,0,0,1270,T
4-HA,1316,1267,0,2,0,1269,A
4-HA,1317,0,0,0,1268,1268,C
4-HA,1318,1241,0,1,0,1242,A
4-HA,1319,1250,1,2,0,1253,A
4-HA,1320,1,0,0,1212,1213,C
4-HA,1321,0,0,1213,0,1213,G
4-HA,1322,1,1,0,1209,1211,C
4-HA,1323,0,0,1198,0,1198,G
4-HA,1324,0,3,1206,0,1209,G
4-HA,1325,1201,0,1,0,1202,A
4-HA,1326,1,0,1230,0,1231,G
4-HA,1327,0,0,0,1230,1230,C
4-HA,1328,0,1219,0,2,1221,T
4-HA,1329,0,1228,0,1,1229,T
4-HA,1330,1,0,1,1228,1230,C
4-HA,1331,1,1229,0,2,1232,T
4-HA,1332,0,1233,0,0,1233,T
4-HA,1333,0,0,1231,0,1231,G
4-HA,1334,0,1226,0,2,1228,T
4-HA,1335,0,1213,0,0,1213,T
4-HA,1336,0,0,1224,0,1224,G
4-HA,1337,0,0,0,1216,1216,C
4-HA,1338,0,0,0,1212,1212,C
4-HA,1339,2,3,0,1222,1227,C
4-HA,1340,1,1217,0,5,1223,T
4-HA,1341,0,1,1241,0,1242,G
4-HA,1342,1,3,1239,0,1243,G
4-HA,1343,1243,0,0,0,1243,A
4-HA,1344,1,0,1247,0,1248,G
4-HA,1345,1221,0,1,0,1222,A
4-HA,1346,1225,0,2,0,1227,A
4-HA,1347,0,1,0,1230,1231,C
4-HA,1348,2,2,0,1226,1230,C
4-HA,1349,1224,1,1,1,1227,A
4-HA,1350,1279,0,1,0,1280,A
4-HA,1351,0,0,0,1286,1286,C
4-HA,1352,1296,0,2,0,1298,A
4-HA,1353,0,1294,0,1,1295,T
4-HA,1354,1294,0,1,0,1295,A
4-HA,1355,0,2,0,1325,1327,C
4-HA,1356,1301,0,0,0,1301,A
4-HA,1357,1301,0,0,0,1301,A
4-HA,1358,0,1301,0,0,1301,T
4-HA,1359,0,1248,0,0,1248,T
4-HA,1360,0,3,1272,0,1275,G
4-HA,1361,1290,0,0,0,1290,A
4-HA,1362,0,1280,0,1,1281,T
4-HA,1363,0,0,0,1289,1289,C
4-HA,1364,1,1263,0,1,1265,T
4-HA,1365,1271,0,0,0,1271,A
4-HA,1366,1270,0,1,0,1271,A
4-HA,1367,0,1,0,1271,1272,C
4-HA,1368,0,1264,0,3,1267,T
4-HA,1369,0,5,1252,0,1257,G
4-HA,1370,1266,0,1,0,1267,A
4-HA,1371,0,0,0,1263,1263,C
4-HA,1372,0,1262,0,1,1263,T
4-HA,1373,4,0,0,1261,1265,C
4-HA,1374,1262,0,0,0,1262,A
4-HA,1375,0,0,1288,0,1288,G
4-HA,1376,1283,0,0,0,1283,A
4-HA,1377,1283,1,1,0,1285,A
4-HA,1378,1284,0,0,0,1284,A
4-HA,1379,0,1276,0,0,1276,T
4-HA,1380,1,2,1283,1,1287,G
4-HA,1381,1285,0,2,0,1287,A
4-HA,1382,1284,0,2,0,1286,A
4-HA,1383,0,0,0,1285,1285,C
4-HA,1384,1268,1,0,0,1269,A
4-HA,1385,1265,0,2,0,1267,A
4-HA,1386,1266,0,1,0,1267,A
4-HA,1387,0,0,0,1267,1267,C
4-HA,1388,0,1254,0,0,1254,T
4-HA,1389,0,0,1257,0,1257,G
4-HA,1390,0,1238,0,2,1240,T
4-HA,1391,0,1242,0,0,1242,T
4-HA,1392,0,1241,0,1,1242,T
4-HA,1393,0,1,1245,0,1246,G
4-HA,1394,1243,1,1,0,1245,A
4-HA,1395,1241,0,1,1,1243,A
4-HA,1396,1241,0,1,0,1242,A
4-HA,1397,1244,1,0,0,1245,A
4-HA,1398,1238,0,0,0,1238,A
4-HA,1399,1238,0,2,0,1240,A
4-HA,1400,0,0,0,1241,1241,C
4-HA,1401,1240,0,1,0,1241,A
4-HA,1402,1241,0,0,0,1241,A
4-HA,1403,1239,0,0,1,1240,A
4-HA,1404,0,0,1248,0,1248,G
4-HA,1405,1245,0,0,0,1245,A
4-HA,1406,1247,0,0,0,1247,A
4-HA,1407,1,0,1249,0,1250,G
4-HA,1408,0,1,0,1247,1248,C
4-HA,1409,1242,0,3,0,1245,A
4-HA,1410,1249,0,1,0,1250,A
4-HA,1411,0,0,0,1253,1253,C
4-HA,1412,0,1246,1,2,1249,T
4-HA,1413,0,0,1252,0,1252,G
4-HA,1414,1246,0,2,0,1248,A
4-HA,1415,0,0,1259,0,1259,G
4-HA,1416,0,1,1266,0,1267,G
4-HA,1417,1,5,1261,0,1267,G
4-HA,1418,1271,0,1,0,1272,A
4-HA,1419,1241,1,27,0,1269,A
4-HA,1420,1253,0,4,0,1257,A
4-HA,1421,1276,0,1,0,1277,A
4-HA,1422,0,1275,0,0,1275,T
4-HA,1423,1,1,1284,0,1286,G
4-HA,1424,0,0,0,1289,1289,C
4-HA,1425,0,1266,0,0,1266,T
4-HA,1426,1,0,1269,0,1270,G
4-HA,1427,1268,0,2,0,1270,A
4-HA,1428,0,1,1323,0,1324,G
4-HA,1429,0,2,1340,0,1342,G
4-HA,1430,1332,0,0,0,1332,A
4-HA,1431,0,1320,0,2,1322,T
4-HA,1432,1319,1,2,0,1322,A
4-HA,1433,0,1316,1,0,1317,T
4-HA,1434,4,2,1323,0,1329,G
4-HA,1435,3,1,1346,0,1350,G
4-HA,1436,1,0,1351,0,1352,G
4-HA,1437,0,0,0,1277,1277,C
4-HA,1438,1247,0,1,0,1248,A
4-HA,1439,1247,0,3,0,1250,A
4-HA,1440,1,1250,0,0,1251,T
4-HA,1441,0,1,1253,0,1254,G
4-HA,1442,1,0,1254,0,1255,G
4-HA,1443,0,1231,0,0,1231,T
4-HA,1444,0,1207,0,0,1207,T
4-HA,1445,0,0,1212,0,1212,G
4-HA,1446,0,1215,0,3,1218,T
4-HA,1447,1,1217,0,0,1218,T
4-HA,1448,0,1224,0,0,1224,T
4-HA,1449,0,0,0,1230,1230,C
4-HA,1450,1231,0,0,0,1231,A
4-HA,1451,1233,0,0,0,1233,A
4-HA,1452,1232,0,0,1,1233,A
4-HA,1453,1251,0,0,0,1251,A
4-HA,1454,0,1242,0,0,1242,T
4-HA,1455,1235,1,0,0,1236,A
4-HA,1456,0,1234,0,5,1239,T
4-HA,1457,1230,0,1,0,1231,A
4-HA,1458,1,0,0,1243,1244,C
4-HA,1459,1,0,0,1235,1236,C
4-HA,1460,1233,0,2,0,1235,A
4-HA,1461,0,0,0,1237,1237,C
4-HA,1462,1236,0,0,0,1236,A
4-HA,1463,1234,0,0,0,1234,A
4-HA,1464,1237,0,0,0,1237,A
4-HA,1465,0,1229,0,1,1230,T
4-HA,1466,1,1,1233,1,1236,G
4-HA,1467,1,1214,0,2,1217,T
4-HA,1468,0,3,1233,0,1236,G
4-HA,1469,1232,0,1,0,1233,A
4-HA,1470,0,0,0,1231,1231,C
4-HA,1471,1216,0,0,0,1216,A
4-HA,1472,1218,0,0,0,1218,A
4-HA,1473,0,1237,0,0,1237,T
4-HA,1474,2,0,1249,0,1251,G
4-HA,1475,0,2,0,1242,1244,C
4-HA,1476,0,0,0,1243,1243,C
4-HA,1477,1,1231,0,4,1236,T
4-HA,1478,0,0,1287,0,1287,G
4-HA,1479,0,1,0,1287,1288,C
4-HA,1480,1288,0,0,0,1288,A
4-HA,1481,1,1287,0,0,1288,T
4-HA,1482,1237,1,2,1,1241,A
4-HA,1483,1,0,1254,0,1255,G
4-HA,1484,1,1,1252,0,1254,G
4-HA,1485,1249,0,0,0,1249,A
4-HA,1486,1,1241,0,2,1244,T
4-HA,1487,0,0,0,1181,1181,C
4-HA,1488,1185,0,0,0,1185,A
4-HA,1489,1186,1,1,0,1188,A
4-HA,1490,0,1184,0,1,1185,T
4-HA,1491,0,0,0,1189,1189,C
4-HA,1492,1163,0,0,0,1163,A
4-HA,1493,0,1,1163,0,1164,G
4-HA,1494,1167,0,1,0,1168,A
4-HA,1495,1168,0,1,0,1169,A
4-HA,1496,1171,0,0,0,1171,A
4-HA,1497,0,1154,0,0,1154,T
4-HA,1498,0,0,1155,0,1155,G
4-HA,1499,0,4,1152,0,1156,G
4-HA,1500,1156,0,1,1,1158,A
4-HA,1501,1165,1,1,0,1167,A
4-HA,1502,2,1,0,1163,1166,C
4-HA,1503,0,1148,0,1,1149,T
4-HA,1504,0,1159,0,0,1159,T
4-HA,1505,1159,0,1,0,1160,A
4-HA,1506,0,1160,0,0,1160,T
4-HA,1507,1,1,1157,0,1159,G
4-HA,1508,1155,0,4,0,1159,A
4-HA,1509,1,0,1,1151,1153,C
4-HA,1510,5,1,0,1145,1151,C
4-HA,1511,1151,0,0,0,1151,A
4-HA,1512,0,2,0,1174,1176,C
4-HA,1513,1,1,1215,1,1218,G
4-HA,1514,1240,0,0,0,1240,A
4-HA,1515,0,1251,0,0,1251,T
4-HA,1516,0,1,1293,0,1294,G
4-HA,1517,0,1287,0,1,1288,T
4-HA,1518,1309,0,0,0,1309,A
4-HA,1519,0,1305,0,0,1305,T
4-HA,1520,1305,0,1,0,1306,A
4-HA,1521,0,1,0,1303,1304,C
4-HA,1522,1159,0,3,0,1162,A
4-HA,1523,0,1,1169,0,1170,G
4-HA,1524,1088,0,0,0,1088,A
4-HA,1525,0,0,1065,0,1065,G
4-HA,1526,1059,0,1,1,1061,A
4-HA,1527,0,983,0,0,983,T
4-HA,1528,0,1,981,0,982,G
4-HA,1529,982,0,0,0,982,A
4-HA,1530,972,0,7,0,979,A
4-HA,1531,1,1,989,0,991,G
4-HA,1532,0,1,0,966,967,C
4-HA,1533,963,0,0,0,963,A
4-HA,1534,1,958,0,2,961,T
4-HA,1535,0,953,0,0,953,T
4-HA,1536,957,0,1,0,958,A
4-HA,1537,960,0,0,0,960,A
4-HA,1538,960,1,1,0,962,A
4-HA,1539,0,2,0,961,963,C
4-HA,1540,917,0,0,0,917,A
4-HA,1541,916,0,0,0,916,A
4-HA,1542,0,0,0,914,914,C
4-HA,1543,2,2,0,905,909,C
4-HA,1544,0,0,912,0,912,G
4-HA,1545,0,1,923,0,924,G
4-HA,1546,0,923,0,1,924,T
4-HA,1547,0,923,0,0,923,T
4-HA,1548,0,917,0,0,917,T
4-HA,1549,0,0,0,920,920,C
4-HA,1550,919,0,1,0,920,A
4-HA,1551,1,0,936,0,937,G
4-HA,1552,934,0,2,0,936,A
4-HA,1553,1,934,0,1,936,T
4-HA,1554,0,0,0,917,917,C
4-HA,1555,907,0,1,0,908,A
4-HA,1556,913,0,1,0,914,A
4-HA,1557,1,1,915,0,917,G
4-HA,1558,0,0,916,0,916,G
4-HA,1559,0,1,915,0,916,G
4-HA,1560,884,0,0,0,884,A
4-HA,1561,0,0,894,0,894,G
4-HA,1562,0,893,0,1,894,T
4-HA,1563,1,891,0,1,893,T
4-HA,1564,0,0,897,0,897,G
4-HA,1565,886,0,2,0,888,A
4-HA,1566,0,0,895,0,895,G
4-HA,1567,0,2,0,895,897,C
4-HA,1568,0,879,1,2,882,T
4-HA,1569,0,1,881,0,882,G
4-HA,1570,877,0,0,0,877,A
4-HA,1571,879,0,0,1,880,A
4-HA,1572,0,0,882,0,882,G
4-HA,1573,1,863,0,1,865,T
4-HA,1574,0,0,0,861,861,C
4-HA,1575,839,0,3,0,842,A
4-HA,1576,0,0,844,0,844,G
4-HA,1577,1,0,842,0,843,G
4-HA,1578,0,1,812,0,813,G
4-HA,1579,0,838,0,0,838,T
4-HA,1580,838,0,0,0,838,A
4-HA,1581,0,1,0,837,838,C
4-HA,1582,838,0,1,0,839,A
4-HA,1583,840,0,0,0,840,A
4-HA,1584,838,0,2,0,840,A
4-HA,1585,0,1,837,0,838,G
4-HA,1586,812,0,0,0,812,A
4-HA,1587,0,781,0,0,781,T
4-HA,1588,0,772,0,0,772,T
4-HA,1589,0,3,765,0,768,G
4-HA,1590,0,0,769,0,769,G
4-HA,1591,768,0,0,0,768,A
4-HA,1592,0,765,1,3,769,T
4-HA,1593,2,1,0,762,765,C
4-HA,1594,1,1,0,749,751,C
4-HA,1595,0,745,0,0,745,T
4-HA,1596,745,0,0,0,745,A
4-HA,1597,0,744,0,3,747,T
4-HA,1598,0,1,742,0,743,G
4-HA,1599,0,0,742,0,742,G
4-HA,1600,730,1,0,0,731,A
4-HA,1601,0,729,1,2,732,T
4-HA,1602,0,720,0,2,722,T
4-HA,1603,0,720,0,1,721,T
4-HA,1604,0,0,0,722,722,C
4-HA,1605,0,0,0,718,718,C
4-HA,1606,0,696,0,2,698,T
4-HA,1607,0,691,0,0,691,T
4-HA,1608,0,686,0,1,687,T
4-HA,1609,0,0,691,0,691,G
4-HA,1610,0,0,1,686,687,C
4-HA,1611,1,1,0,690,692,C
4-HA,1612,678,0,2,0,680,A
4-HA,1613,0,673,0,0,673,T
4-HA,1614,677,0,1,0,678,A
4-HA,1615,0,678,0,0,678,T
4-HA,1616,2,0,0,666,668,C
4-HA,1617,667,0,1,0,668,A
4-HA,1618,0,655,0,1,656,T
4-HA,1619,0,0,661,0,661,G
4-HA,1620,0,655,0,0,655,T
4-HA,1621,0,652,0,0,652,T
4-HA,1622,0,650,0,0,650,T
4-HA,1623,0,631,1,0,632,T
4-HA,1624,1,629,0,2,632,T
4-HA,1625,0,629,0,0,629,T
4-HA,1626,0,0,629,0,629,G
4-HA,1627,0,0,0,629,629,C
4-HA,1628,0,606,0,0,606,T
4-HA,1629,0,606,0,1,607,T
4-HA,1630,0,601,0,1,602,T
4-HA,1631,0,0,612,0,612,G
4-HA,1632,0,610,0,1,611,T
4-HA,1633,0,0,610,0,610,G
4-HA,1634,0,610,0,0,610,T
4-HA,1635,0,597,0,0,597,T
4-HA,1636,0,0,602,0,602,G
4-HA,1637,1,1,0,602,604,C
4-HA,1638,0,602,0,0,602,T
4-HA,1639,0,605,0,0,605,T
4-HA,1640,0,565,0,0,565,T
4-HA,1641,0,0,568,1,569,G
4-HA,1642,0,569,0,0,569,T
4-HA,1643,0,570,0,0,570,T
4-HA,1644,1,2,568,0,571,G
4-HA,1645,0,0,550,0,550,G
4-HA,1646,0,0,551,0,551,G
4-HA,1647,0,0,555,0,555,G
4-HA,1648,0,536,0,1,537,T
4-HA,1649,1,531,0,0,532,T
4-HA,1650,0,0,0,519,519,C
4-HA,1651,515,0,0,0,515,A
4-HA,1652,1,512,0,0,513,T
4-HA,1653,0,1,0,507,508,C
4-HA,1654,503,0,1,0,504,A
4-HA,1655,0,485,0,2,487,T
4-HA,1656,0,0,487,0,487,G
4-HA,1657,0,478,0,0,478,T
4-HA,1658,0,0,475,0,475,G
4-HA,1659,0,0,466,0,466,G
4-HA,1660,0,0,465,0,465,G
4-HA,1661,0,0,0,458,458,C
4-HA,1662,1,0,0,448,449,C
4-HA,1663,0,428,1,1,430,T
4-HA,1664,0,0,431,0,431,G
4-HA,1665,0,0,0,430,430,C
4-HA,1666,1,0,0,431,432,C
4-HA,1667,432,0,0,0,432,A
4-HA,1668,429,0,0,0,429,A
4-HA,1669,426,0,1,1,428,A
4-HA,1670,427,0,0,0,427,A
4-HA,1671,425,0,0,0,425,A
4-HA,1672,0,0,427,0,427,G
4-HA,1673,0,0,408,0,408,G
4-HA,1674,1,1,0,403,405,C
4-HA,1675,402,0,2,0,404,A
4-HA,1676,404,0,0,0,404,A
4-HA,1677,0,0,0,404,404,C
4-HA,1678,401,0,0,0,401,A
4-HA,1679,0,401,0,1,402,T
4-HA,1680,0,395,0,1,396,T
4-HA,1681,378,0,0,0,378,A
4-HA,1682,0,0,377,0,377,G
4-HA,1683,0,0,377,0,377,G
4-HA,1684,0,356,0,2,358,T
4-HA,1685,0,0,335,0,335,G
4-HA,1686,1,0,0,315,316,C
4-HA,1687,311,0,1,0,312,A
4-HA,1688,313,0,0,0,313,A
4-HA,1689,0,0,0,312,312,C
4-HA,1690,306,0,0,0,306,A
4-HA,1691,0,292,0,1,293,T
4-HA,1692,0,274,0,0,274,T
4-HA,1693,0,274,0,0,274,T
4-HA,1694,0,1,274,0,275,G
4-HA,1695,0,0,0,270,270,C
4-HA,1696,269,0,1,0,270,A
4-HA,1697,0,247,0,0,247,T
4-HA,1698,0,237,0,1,238,T
4-HA,1699,1,228,0,0,229,T
4-HA,1700,0,0,231,0,231,G
4-HA,1701,225,0,0,0,225,A
5-NP,1,908,0,0,0,908,A
5-NP,2,0,910,0,0,910,T
5-NP,3,0,0,915,0,915,G
5-NP,4,1,1,909,0,911,G
5-NP,5,0,1,0,919,920,C
5-NP,6,0,0,942,0,942,G
5-NP,7,0,970,0,3,973,T
5-NP,8,1,0,0,985,986,C
5-NP,9,1,0,0,995,996,C
5-NP,10,1,1,0,993,995,C
5-NP,11,999,0,0,0,999,A
5-NP,12,998,0,2,0,1000,A
5-NP,13,1,0,1009,0,1010,G
5-NP,14,0,0,1033,0,1033,G
5-NP,15,0,1,0,1039,1040,C
5-NP,16,1043,0,2,1,1046,A
5-NP,17,0,0,0,1053,1053,C
5-NP,18,2,0,0,1055,1057,C
5-NP,19,1067,0,0,0,1067,A
5-NP,20,1068,0,0,0,1068,A
5-NP,21,1069,0,1,0,1070,A
5-NP,22,0,0,0,1073,1073,C
5-NP,23,2,3,1073,0,1078,G
5-NP,24,0,0,1195,0,1195,G
5-NP,25,0,1192,0,2,1194,T
5-NP,26,2,0,0,1302,1304,C
5-NP,27,0,1304,0,2,1306,T
5-NP,28,0,1322,0,0,1322,T
5-NP,29,1319,0,3,0,1322,A
5-NP,30,0,1319,0,1,1320,T
5-NP,31,0,4,1328,0,1332,G
5-NP,32,1326,0,3,0,1329,A
5-NP,33,1305,1,1,0,1307,A
5-NP,34,0,1,0,1317,1318,C
5-NP,35,1289,0,1,0,1290,A
5-NP,36,0,0,1393,0,1393,G
5-NP,37,1381,2,2,1,1386,A
5-NP,38,0,1388,0,0,1388,T
5-NP,39,1,4,1391,1,1397,G
5-NP,40,0,2,1397,0,1399,G
5-NP,41,1400,1,2,0,1403,A
5-NP,42,1414,0,1,0,1415,A
5-NP,43,1411,0,5,0,1416,A
5-NP,44,1,0,0,1466,1467,C
5-NP,45,1,1441,0,0,1442,T
5-NP,46,0,1,1461,0,1462,G
5-NP,47,1456,1,2,0,1459,A
5-NP,48,0,1456,0,1,1457,T
5-NP,49,1,0,1458,0,1459,G
5-NP,50,1,3,1452,0,1456,G
5-NP,51,0,3,1456,0,1459,G
5-NP,52,0,1,1467,0,1468,G
5-NP,53,1453,0,2,0,1455,A
5-NP,54,0,1459,0,2,1461,T
5-NP,55,1,0,1,1456,1458,C
5-NP,56,2,0,1466,0,1468,G
5-NP,57,0,0,0,1491,1491,C
5-NP,58,1,2,0,1486,1489,C
5-NP,59,1492,0,3,0,1495,A
5-NP,60,0,1,1506,1,1508,G
5-NP,61,1504,0,2,0,1506,A
5-NP,62,1521,1,1,0,1523,A
5-NP,63,1,1520,1,1,1523,T
5-NP,64,0,2,1524,0,1526,G
5-NP,65,0,0,0,1538,1538,C
5-NP,66,1534,0,1,0,1535,A
5-NP,67,1556,0,1,0,1557,A
5-NP,68,1,0,0,1553,1554,C
5-NP,69,1,1550,0,0,1551,T
5-NP,70,0,0,1566,0,1566,G
5-NP,71,1588,0,3,0,1591,A
5-NP,72,0,0,1663,0,1663,G
5-NP,73,1660,0,1,0,1661,A
5-NP,74,0,1650,0,0,1650,T
5-NP,75,0,1655,0,2,1657,T
5-NP,76,1647,0,1,0,1648,A
5-NP,77,0,0,1656,0,1656,G
5-NP,78,4,1,1652,0,1657,G
5-NP,79,1,0,1660,0,1661,G
5-NP,80,0,0,0,1647,1647,C
5-NP,81,1632,0,1,0,1633,A
5-NP,82,1,1636,0,1,1638,T
5-NP,83,1,2,0,1638,1641,C
5-NP,84,0,1,0,1640,1641,C
5-NP,85,0,2,1658,0,1660,G
5-NP,86,0,1663,0,0,1663,T
5-NP,87,0,1,0,1658,1659,C
5-NP,88,1,1,1660,0,1662,G
5-NP,89,0,1,1664,0,1665,G
5-NP,90,0,2,1678,0,1680,G
5-NP,91,1675,0,0,1,1676,A
5-NP,92,1675,1,2,0,1678,A
5-NP,93,0,0,1699,0,1699,G
5-NP,94,1685,0,1,0,1686,A
5-NP,95,0,1701,0,1,1702,T
5-NP,96,0,0,1709,0,1709,G
5-NP,97,1717,0,1,0,1718,A
5-NP,98,0,1720,0,1,1721,T
5-NP,99,1,1717,0,0,1718,T
5-NP,100,0,2,1721,0,1723,G
5-NP,101,1713,2,2,0,1717,A
5-NP,102,0,1712,0,0,1712,T
5-NP,103,0,2,1708,0,1710,G
5-NP,104,1,2,1698,1,1702,G
5-NP,105,1,3,1695,0,1699,G
5-NP,106,1796,0,2,0,1798,A
5-NP,107,1,1790,0,0,1791,T
5-NP,108,0,1800,0,3,1803,T
5-NP,109,1,1,1813,0,1815,G
5-NP,110,1,1,1815,0,1817,G
5-NP,111,0,2,1821,0,1823,G
5-NP,112,1821,1,4,0,1826,A
5-NP,113,0,2,1818,0,1820,G
5-NP,114,1798,0,1,0,1799,A
5-NP,115,0,1829,0,1,1830,T
5-NP,116,1,1832,0,2,1835,T
5-NP,117,2,0,0,1836,1838,C
5-NP,118,1,1830,0,0,1831,T
5-NP,119,1863,0,2,0,1865,A
5-NP,120,0,0,0,1871,1871,C
5-NP,121,1924,0,0,1,1925,A
5-NP,122,0,1932,0,2,1934,T
5-NP,123,0,1,0,1927,1928,C
5-NP,124,2,0,1,1933,1936,C
5-NP,125,1938,0,2,0,1940,A
5-NP,126,1981,0,1,0,1982,A
5-NP,127,1980,0,0,0,1980,A
5-NP,128,0,1969,0,0,1969,T
5-NP,129,2,1,1973,0,1976,G
5-NP,130,1,1941,0,1,1943,T
5-NP,131,1,1,1972,0,1974,G
5-NP,132,0,3,0,1976,1979,C
5-NP,133,1964,1,1,0,1966,A
5-NP,134,1,0,0,1978,1979,C
5-NP,135,0,1952,1,0,1953,T
5-NP,136,0,3,2042,0,2045,G
5-NP,137,2072,0,0,0,2072,A
5-NP,138,2096,1,1,0,2098,A
5-NP,139,1,0,0,2124,2125,C
5-NP,140,0,2106,0,1,2107,T
5-NP,141,0,2112,0,1,2113,T
5-NP,142,2107,0,0,1,2108,A
5-NP,143,2105,0,0,0,2105,A
5-NP,144,0,1,2045,0,2046,G
5-NP,145,0,0,0,2077,2077,C
5-NP,146,1,2063,0,1,2065,T
5-NP,147,3,0,0,2099,2102,C
5-NP,148,2099,1,0,0,2100,A
5-NP,149,0,0,2144,0,2144,G
5-NP,150,1,2144,0,0,2145,T
5-NP,151,0,3,2157,0,2160,G
5-NP,152,2171,0,5,0,2176,A
5-NP,153,0,2177,0,3,2180,T
5-NP,154,1,1,0,2219,2221,C
5-NP,155,2232,0,3,0,2235,A
5-NP,156,1,2225,0,2,2228,T
5-NP,157,3,2,2225,0,2230,G
5-NP,158,2213,0,5,0,2218,A
5-NP,159,2212,0,2,0,2214,A
5-NP,160,0,1,2206,0,2207,G
5-NP,161,2,2,2180,0,2184,G
5-NP,162,0,2,2184,0,2186,G
5-NP,163,2,1,0,2155,2158,C
5-NP,164,1,3,2166,0,2170,G
5-NP,165,2,1,2179,0,2182,G
5-NP,166,0,2182,0,0,2182,T
5-NP,167,0,2182,0,0,2182,T
5-NP,168,0,2,2179,0,2181,G
5-NP,169,2364,0,3,0,2367,A
5-NP,170,1,2363,0,2,2366,T
5-NP,171,4,0,0,2361,2365,C
5-NP,172,1,3,0,2363,2367,C
5-NP,173,2359,0,1,0,2360,A
5-NP,174,1,5,2364,0,2370,G
5-NP,175,2367,0,3,0,2370,A
5-NP,176,2371,1,0,0,2372,A
5-NP,177,0,0,0,2385,2385,C
5-NP,178,2271,0,1,1,2273,A
5-NP,179,0,0,2313,0,2313,G
5-NP,180,0,1,0,2315,2316,C
5-NP,181,0,2312,0,1,2313,T
5-NP,182,0,2321,0,1,2322,T
5-NP,183,2,2,2318,0,2322,G
5-NP,184,2334,0,6,0,2340,A
5-NP,185,1,0,0,2341,2342,C
5-NP,186,2322,0,1,0,2323,A
5-NP,187,2341,0,2,0,2343,A
5-NP,188,0,2325,0,0,2325,T
5-NP,189,2327,0,1,1,2329,A
5-NP,190,1,0,2334,0,2335,G
5-NP,191,2319,1,1,1,2322,A
5-NP,192,1,1,2338,0,2340,G
5-NP,193,2319,0,3,0,2322,A
5-NP,194,2380,0,1,0,2381,A
5-NP,195,2388,0,1,1,2390,A
5-NP,196,2446,0,0,1,2447,A
5-NP,197,0,2447,0,1,2448,T
5-NP,198,1,4,2453,0,2458,G
5-NP,199,2,0,2454,0,2456,G
5-NP,200,1,2433,0,4,2438,T
5-NP,201,2398,0,2,2,2402,A
5-NP,202,0,0,1,2416,2417,C
5-NP,203,0,2417,0,1,2418,T
5-NP,204,1,0,0,2454,2455,C
5-NP,205,3,2391,0,5,2399,T
5-NP,206,2,0,0,2421,2423,C
5-NP,207,2,2407,0,5,2414,T
5-NP,208,0,0,2434,0,2434,G
5-NP,209,1,1,0,2436,2438,C
5-NP,210,0,2421,0,6,2427,T
5-NP,211,0,2419,0,2,2421,T
5-NP,212,0,2408,1,2,2411,T
5-NP,213,0,2389,0,1,2390,T
5-NP,214,0,2,2393,0,2395,G
5-NP,215,2383,2,4,1,2390,A
5-NP,216,0,2388,0,2,2390,T
5-NP,217,0,2,2381,0,2383,G
5-NP,218,2367,0,2,1,2370,A
5-NP,219,2367,1,2,0,2370,A
5-NP,220,2361,1,6,0,2368,A
5-NP,221,0,2,2376,0,2378,G
5-NP,222,2368,0,2,2,2372,A
5-NP,223,2371,0,3,0,2374,A
5-NP,224,0,0,2398,0,2398,G
5-NP,225,0,3,2458,0,2461,G
5-NP,226,2467,2,2,0,2471,A
5-NP,227,2484,0,0,2,2486,A
5-NP,228,0,2481,0,2,2483,T
5-NP,229,2483,0,1,1,2485,A
5-NP,230,2480,2,3,0,2485,A
5-NP,231,2487,2,0,0,2489,A
5-NP,232,0,2493,0,1,2494,T
5-NP,233,2490,0,1,0,2491,A
5-NP,234,1,2,0,2493,2496,C
5-NP,235,0,0,0,2460,2460,C
5-NP,236,0,2448,0,2,2450,T
5-NP,237,1,6,2446,0,2453,G
5-NP,238,1,2,2495,0,2498,G
5-NP,239,2499,2,0,1,2502,A
5-NP,240,2492,0,1,0,2493,A
5-NP,241,0,3,2522,0,2525,G
5-NP,242,2490,1,5,0,2496,A
5-NP,243,2488,0,5,0,2493,A
5-NP,244,0,0,0,2485,2485,C
5-NP,245,2480,0,4,0,2484,A
5-NP,246,1,1,0,2534,2536,C
5-NP,247,0,1,0,2500,2501,C
5-NP,248,11,0,0,2498,2509,C
5-NP,249,6,1,0,2506,2513,C
5-NP,250,2478,0,1,1,2480,A
5-NP,251,0,0,2485,0,2485,G
5-NP,252,1,3,0,2478,2482,C
5-NP,253,0,2,2488,0,2490,G
5-NP,254,0,1,0,2487,2488,C
5-NP,255,1,3,2447,0,2451,G
5-NP,256,1,0,2479,0,2480,G
5-NP,257,0,1,2473,0,2474,G
5-NP,258,2,1,2485,0,2488,G
5-NP,259,2484,1,0,0,2485,A
5-NP,260,2471,0,2,0,2473,A
5-NP,261,2463,0,4,0,2467,A
5-NP,262,1,0,2481,0,2482,G
5-NP,263,2458,0,5,0,2463,A
5-NP,264,0,2454,0,1,2455,T
5-NP,265,2,0,0,2442,2444,C
5-NP,266,1,2,0,2429,2432,C
5-NP,267,3,0,0,2456,2459,C
5-NP,268,2469,0,1,0,2470,A
5-NP,269,2474,0,2,0,2476,A
5-NP,270,0,0,2482,0,2482,G
5-NP,271,2470,0,2,0,2472,A
5-NP,272,2478,1,2,0,2481,A
5-NP,273,2478,0,1,1,2480,A
5-NP,274,2480,0,1,1,2482,A
5-NP,275,0,0,0,2482,2482,C
5-NP,276,0,2458,0,0,2458,T
5-NP,277,1,3,2449,1,2454,G
5-NP,278,0,4,2455,0,2459,G
5-NP,279,3,3,2450,0,2456,G
5-NP,280,0,4,2443,0,2447,G
5-NP,281,0,2,2461,0,2463,G
5-NP,282,2,0,2489,0,2491,G
5-NP,283,1,0,0,2687,2688,C
5-NP,284,3,1,0,2681,2685,C
5-NP,285,6,3,0,2700,2709,C
5-NP,286,3057,1,1,0,3059,A
5-NP,287,0,3061,0,0,3061,T
5-NP,288,3233,0,1,0,3234,A
5-NP,289,0,3232,0,2,3234,T
5-NP,290,3194,0,3,0,3197,A
5-NP,291,0,0,0,3217,3217,C
5-NP,292,2943,0,1,0,2944,A
5-NP,293,0,3,2982,0,2985,G
5-NP,294,0,3,2980,0,2983,G
5-NP,295,2712,0,0,0,2712,A
5-NP,296,1,0,2739,0,2740,G
5-NP,297,2606,1,2,0,2609,A
5-NP,298,0,0,2636,0,2636,G
5-NP,299,0,2626,0,1,2627,T
5-NP,300,2605,0,4,0,2609,A
5-NP,301,0,0,2615,0,2615,G
5-NP,302,2575,1,7,1,2584,A
5-NP,303,1,2579,0,1,2581,T
5-NP,304,1,2,2563,0,2566,G
5-NP,305,0,2,2580,0,2582,G
5-NP,306,2571,1,3,0,2575,A
5-NP,307,2557,2,1,0,2560,A
5-NP,308,2562,1,1,0,2564,A
5-NP,309,2570,0,3,1,2574,A
5-NP,310,1,2564,0,1,2566,T
5-NP,311,0,2,2588,0,2590,G
5-NP,312,0,2,2595,0,2597,G
5-NP,313,2596,0,1,0,2597,A
5-NP,314,1,2573,1,0,2575,T
5-NP,315,1,0,2580,0,2581,G
5-NP,316,2563,1,6,0,2570,A
5-NP,317,3,5,2569,0,2577,G
5-NP,318,1,8,2556,0,2565,G
5-NP,319,2,6,2558,0,2566,G
5-NP,320,2564,1,3,0,2568,A
5-NP,321,2572,0,3,0,2575,A
5-NP,322,2,1,0,2587,2590,C
5-NP,323,1,2578,0,0,2579,T
5-NP,324,4,1,0,2594,2599,C
5-NP,325,1,0,2602,0,2603,G
5-NP,326,0,2602,0,3,2605,T
5-NP,327,0,0,0,2611,2611,C
5-NP,328,4,0,0,2693,2697,C
5-NP,329,1,2679,0,6,2686,T
5-NP,330,0,2678,1,1,2680,T
5-NP,331,0,2673,0,1,2674,T
5-NP,332,2686,0,0,0,2686,A
5-NP,333,1,2669,0,1,2671,T
5-NP,334,3,3,2667,0,2673,G
5-NP,335,2676,2,1,1,2680,A
5-NP,336,0,0,0,2680,2680,C
5-NP,337,2616,1,2,0,2619,A
5-NP,338,2623,0,2,0,2625,A
5-NP,339,2629,2,1,1,2633,A
5-NP,340,1,4,2710,0,2715,G
5-NP,341,2712,0,0,0,2712,A
5-NP,342,2709,0,6,0,2715,A
5-NP,343,1,2,2789,0,2792,G
5-NP,344,2788,1,2,0,2791,A
5-NP,345,2790,1,6,0,2797,A
5-NP,346,2792,1,0,0,2793,A
5-NP,347,0,2787,0,0,2787,T
5-NP,348,2777,0,4,0,2781,A
5-NP,349,2740,0,6,1,2747,A
5-NP,350,0,2,2764,0,2766,G
5-NP,351,2,1,2758,0,2761,G
5-NP,352,2,0,1,2723,2726,C
5-NP,353,3,4,2721,0,2728,G
5-NP,354,2721,1,3,0,2725,A
5-NP,355,2747,0,0,0,2747,A
5-NP,356,1,2747,0,4,2752,T
5-NP,357,1,0,0,2751,2752,C
5-NP,358,0,2749,0,2,2751,T
5-NP,359,4,0,2737,0,2741,G
5-NP,360,0,2,2743,0,2745,G
5-NP,361,2,0,0,2737,2739,C
5-NP,362,1,1,2751,0,2753,G
5-NP,363,0,0,0,2741,2741,C
5-NP,364,3,2,0,2721,2726,C
5-NP,365,2739,1,3,0,2743,A
5-NP,366,2760,0,1,1,2762,A
5-NP,367,0,0,2804,0,2804,G
5-NP,368,0,0,0,2803,2803,C
5-NP,369,5,0,0,2825,2830,C
5-NP,370,2829,0,6,0,2835,A
5-NP,371,2865,3,2,1,2871,A
5-NP,372,1,0,0,2896,2897,C
5-NP,373,2894,2,1,0,2897,A
5-NP,374,2922,0,4,1,2927,A
5-NP,375,0,2911,0,1,2912,T
5-NP,376,0,5,2935,0,2940,G
5-NP,377,0,1,2943,0,2944,G
5-NP,378,0,2898,0,2,2900,T
5-NP,379,0,5,2893,0,2898,G
5-NP,380,2878,0,4,1,2883,A
5-NP,381,0,3,2912,0,2915,G
5-NP,382,0,1,2907,0,2908,G
5-NP,383,2916,1,0,0,2917,A
5-NP,384,1,3082,0,1,3084,T
5-NP,385,2,1,3087,0,3090,G
5-NP,386,0,2,0,3092,3094,C
5-NP,387,1,3094,0,5,3100,T
5-NP,388,3104,1,2,0,3107,A
5-NP,389,1,0,0,3157,3158,C
5-NP,390,3117,0,4,0,3121,A
5-NP,391,0,3103,1,1,3105,T
5-NP,392,0,1,0,3086,3087,C
5-NP,393,0,2944,0,2,2946,T
5-NP,394,1,2,3014,0,3017,G
5-NP,395,1,0,3061,0,3062,G
5-NP,396,1,3052,0,7,3060,T
5-NP,397,6,0,0,3053,3059,C
5-NP,398,0,3005,0,4,3009,T
5-NP,399,3039,0,1,0,3040,A
5-NP,400,3045,0,0,0,3045,A
5-NP,401,2,1,0,3059,3062,C
5-NP,402,1,3045,0,6,3052,T
5-NP,403,1,1,0,3050,3052,C
5-NP,404,3034,0,0,0,3034,A
5-NP,405,0,4,0,3130,3134,C
5-NP,406,3131,0,0,1,3132,A
5-NP,407,1,3142,1,0,3144,T
5-NP,408,3116,0,1,0,3117,A
5-NP,409,3114,0,3,0,3117,A
5-NP,410,0,3131,0,1,3132,T
5-NP,411,1,5,3161,0,3167,G
5-NP,412,3141,0,1,0,3142,A
5-NP,413,0,3113,1,1,3115,T
5-NP,414,4,3042,1,5,3052,T
5-NP,415,0,3068,0,1,3069,T
5-NP,416,4,3,3049,0,3056,G
5-NP,417,2,2,3056,0,3060,G
5-NP,418,1,2,0,3058,3061,C
5-NP,419,3043,0,0,0,3043,A
5-NP,420,1,3037,0,2,3040,T
5-NP,421,1,3032,0,3,3036,T
5-NP,422,2,0,0,3034,3036,C
5-NP,423,1,1,0,3039,3041,C
5-NP,424,3086,0,0,0,3086,A
5-NP,425,3089,1,4,0,3094,A
5-NP,426,0,3090,0,0,3090,T
5-NP,427,0,3091,0,0,3091,T
5-NP,428,0,3075,0,3,3078,T
5-NP,429,0,4,3100,0,3104,G
5-NP,430,3107,1,1,0,3109,A
5-NP,431,3112,1,2,0,3115,A
5-NP,432,0,3127,0,4,3131,T
5-NP,433,0,3,3089,0,3092,G
5-NP,434,3182,1,8,0,3191,A
5-NP,435,0,3199,0,1,3200,T
5-NP,436,0,3,3205,1,3209,G
5-NP,437,0,2,0,3281,3283,C
5-NP,438,3265,2,5,0,3272,A
5-NP,439,3363,2,3,1,3369,A
5-NP,440,1,0,0,3364,3365,C
5-NP,441,3403,1,1,0,3405,A
5-NP,442,0,3445,0,3,3448,T
5-NP,443,3367,2,2,1,3372,A
5-NP,444,0,2,0,3418,3420,C
5-NP,445,4,1,0,3406,3411,C
5-NP,446,3330,0,1,1,3332,A
5-NP,447,1,1,3364,0,3366,G
5-NP,448,3263,0,2,0,3265,A
5-NP,449,0,9,3310,0,3319,G
5-NP,450,0,5,3309,0,3314,G
5-NP,451,3276,0,4,0,3280,A
5-NP,452,0,1,0,3293,3294,C
5-NP,453,3257,2,4,0,3263,A
5-NP,454,3259,0,4,0,3263,A
5-NP,455,0,5,3265,0,3270,G
5-NP,456,3224,1,9,0,3234,A
5-NP,457,0,3,3250,0,3253,G
5-NP,458,0,1,0,3202,3203,C
5-NP,459,1,3173,0,9,3183,T
5-NP,460,4,0,1,3192,3197,C
5-NP,461,1,3182,0,2,3185,T
5-NP,462,0,3200,0,0,3200,T
5-NP,463,1,3,3209,0,3213,G
5-NP,464,1,3198,0,1,3200,T
5-NP,465,1,3194,0,3,3198,T
5-NP,466,9,3,1,3174,3187,C
5-NP,467,2,6,3179,0,3187,G
5-NP,468,3222,3,1,1,3227,A
5-NP,469,3225,2,0,1,3228,A
5-NP,470,1,1,0,3238,3240,C
5-NP,471,0,3228,0,3,3231,T
5-NP,472,1,0,3275,0,3276,G
5-NP,473,2,8,3274,0,3284,G
5-NP,474,3281,0,3,0,3284,A
5-NP,475,3280,0,6,3,3289,A
5-NP,476,0,3283,0,0,3283,T
5-NP,477,1,2,3266,0,3269,G
5-NP,478,1,4,3269,0,3274,G
5-NP,479,3286,0,2,0,3288,A
5-NP,480,1,3297,0,1,3299,T
5-NP,481,7,2,0,3277,3286,C
5-NP,482,2,0,0,3281,3283,C
5-NP,483,0,0,0,3303,3303,C
5-NP,484,3318,0,3,1,3322,A
5-NP,485,1,2,3359,0,3362,G
5-NP,486,3358,1,0,0,3359,A
5-NP,487,3348,1,0,2,3351,A
5-NP,488,2,3309,0,2,3313,T
5-NP,489,1,1,3356,0,3358,G
5-NP,490,1,3321,0,5,3327,T
5-NP,491,1,2,3334,0,3337,G
5-NP,492,1,1,0,3340,3342,C
5-NP,493,0,3326,0,5,3331,T
5-NP,494,5,1,0,3475,3481,C
5-NP,495,1,3465,0,5,3471,T
5-NP,496,1,1,0,3580,3582,C
5-NP,497,0,3574,0,5,3579,T
5-NP,498,2,2,3577,0,3581,G
5-NP,499,3593,2,1,0,3596,A
5-NP,500,1,3585,1,1,3588,T
5-NP,501,1,1,3577,1,3580,G
5-NP,502,2,3,0,3568,3573,C
5-NP,503,3452,1,3,0,3456,A
5-NP,504,2,2,3529,0,3533,G
5-NP,505,0,2,3449,0,3451,G
5-NP,506,2,0,3488,0,3490,G
5-NP,507,0,1,0,3485,3486,C
5-NP,508,0,3465,0,8,3473,T
5-NP,509,10,4,0,3520,3534,C
5-NP,510,1,3,3555,0,3559,G
5-NP,511,3583,0,5,0,3588,A
5-NP,512,0,0,0,3584,3584,C
5-NP,513,0,2921,6,580,3507,T
5-NP,514,3,0,0,3633,3636,C
5-NP,515,1,3613,0,10,3624,T
5-NP,516,5,2,0,3976,3983,C
5-NP,517,4,0,0,3981,3985,C
5-NP,518,1,0,1,3932,3934,C
5-NP,519,0,3921,0,5,3926,T
5-NP,520,3884,0,1,1,3886,A
5-NP,521,0,3,3886,0,3889,G
5-NP,522,3880,0,0,0,3880,A
5-NP,523,3765,1,1,0,3767,A
5-NP,524,1,4,3764,0,3769,G
5-NP,525,65,1,3609,0,3675,G
5-NP,526,0,3611,0,2,3613,T
5-NP,527,2,0,0,3616,3618,C
5-NP,528,3,0,1,3609,3613,C
5-NP,529,1,3,3608,0,3612,G
5-NP,530,1,0,3642,1,3644,G
5-NP,531,3631,0,2,0,3633,A
5-NP,532,1,0,3662,0,3663,G
5-NP,533,0,3,0,3673,3676,C
5-NP,534,2,3630,0,1,3633,T
5-NP,535,1,2,3645,0,3648,G
5-NP,536,0,1,0,3645,3646,C
5-NP,537,3639,1,5,1,3646,A
5-NP,538,2,2,3663,0,3667,G
5-NP,539,1,2,3659,0,3662,G
5-NP,540,1,3655,0,4,3660,T
5-NP,541,1,0,3614,0,3615,G
5-NP,542,0,1,0,3633,3634,C
5-NP,543,1,3626,0,4,3631,T
5-NP,544,2,0,3625,0,3627,G
5-NP,545,0,1,0,3619,3620,C
5-NP,546,3656,1,4,0,3661,A
5-NP,547,3,2,3705,0,3710,G
5-NP,548,0,3673,0,2,3675,T
5-NP,549,6,1,0,3670,3677,C
5-NP,550,3676,0,2,1,3679,A
5-NP,551,3679,1,2,1,3683,A
5-NP,552,3677,1,10,0,3688,A
5-NP,553,0,1,3703,0,3704,G
5-NP,554,0,1,3732,0,3733,G
5-NP,555,3694,1,5,0,3700,A
5-NP,556,3652,0,3,1,3656,A
5-NP,557,0,3660,0,2,3662,T
5-NP,558,21,2,0,3636,3659,C
5-NP,559,3,4,3648,0,3655,G
5-NP,560,0,6,3756,0,3762,G
5-NP,561,0,2,3767,1,3770,G
5-NP,562,3737,0,5,0,3742,A
5-NP,563,2,1,1,3740,3744,C
5-NP,564,3680,0,2,0,3682,A
5-NP,565,3758,1,2,1,3762,A
5-NP,566,1,3767,0,0,3768,T
5-NP,567,0,5,3787,0,3792,G
5-NP,568,2,2,3817,0,3821,G
5-NP,569,1,3732,0,5,3738,T
5-NP,570,2,5,3743,0,3750,G
5-NP,571,3749,0,1,0,3750,A
5-NP,572,0,3733,0,3,3736,T
5-NP,573,1,1,3740,0,3742,G
5-NP,574,0,3,3815,0,3818,G
5-NP,575,3803,1,3,0,3807,A
5-NP,576,3801,0,0,0,3801,A
5-NP,577,2,2,0,3788,3792,C
5-NP,578,0,3749,1,1,3751,T
5-NP,579,3740,0,1,0,3741,A
5-NP,580,3913,0,3,0,3916,A
5-NP,581,4,3916,2,1,3923,T
5-NP,582,4,0,1,3922,3927,C
5-NP,583,3808,0,1,0,3809,A
5-NP,584,1,2,3865,0,3868,G
5-NP,585,3860,0,2,0,3862,A
5-NP,586,3858,0,3,0,3861,A
5-NP,587,0,3855,1,3,3859,T
5-NP,588,2,7,3831,1,3841,G
5-NP,589,5,0,3880,0,3885,G
5-NP,590,3,3881,0,4,3888,T
5-NP,591,6,1,0,3888,3895,C
5-NP,592,3896,0,1,1,3898,A
5-NP,593,3890,0,0,1,3891,A
5-NP,594,3898,0,3,1,3902,A
5-NP,595,2,0,1,3900,3903,C
5-NP,596,2,4,3884,0,3890,G
5-NP,597,2,5,3896,0,3903,G
5-NP,598,2,3,3844,0,3849,G
5-NP,599,1,6,3857,1,3865,G
5-NP,600,0,9,3865,0,3874,G
5-NP,601,3878,1,4,0,3883,A
5-NP,602,2,3849,1,4,3856,T
5-NP,603,2,2,2,3854,3860,C
5-NP,604,3865,1,1,0,3867,A
5-NP,605,3869,1,5,0,3875,A
5-NP,606,1,2,0,3848,3851,C
5-NP,607,0,2,3835,1,3838,G
5-NP,608,3836,0,3,0,3839,A
5-NP,609,0,3820,0,1,3821,T
5-NP,610,7,0,0,3824,3831,C
5-NP,611,1,3,3832,1,3837,G
5-NP,612,3836,0,0,2,3838,A
5-NP,613,3832,1,1,0,3834,A
5-NP,614,3838,0,1,0,3839,A
5-NP,615,0,3859,1,0,3860,T
5-NP,616,0,3858,0,1,3859,T
5-NP,617,0,3848,0,2,3850,T
5-NP,618,0,3868,1,1,3870,T
5-NP,619,0,3874,0,2,3876,T
5-NP,620,0,4,3875,0,3879,G
5-NP,621,2,7,3863,2,3874,G
5-NP,622,3853,0,6,0,3859,A
5-NP,623,2,5,3871,1,3879,G
5-NP,624,3824,0,1,0,3825,A
5-NP,625,2,5,3984,0,3991,G
5-NP,626,3,0,3999,0,4002,G
5-NP,627,0,4002,0,3,4005,T
5-NP,628,0,4,3999,0,4003,G
5-NP,629,4001,3,6,1,4011,A
5-NP,630,1,1,4033,0,4035,G
5-NP,631,4025,0,3,1,4029,A
5-NP,632,4014,0,3,0,4017,A
5-NP,633,1,4010,0,0,4011,T
5-NP,634,0,3,3875,0,3878,G
5-NP,635,1,4,3853,1,3859,G
5-NP,636,3789,0,29,0,3818,A
5-NP,637,1,3,0,3819,3823,C
5-NP,638,2,4,3825,0,3831,G
5-NP,639,2,3,3878,0,3883,G
5-NP,640,3874,0,1,1,3876,A
5-NP,641,3876,1,2,1,3880,A
5-NP,642,3907,0,3,1,3911,A
5-NP,643,3908,2,6,2,3918,A
5-NP,644,1,1,0,3955,3957,C
5-NP,645,3947,0,4,0,3951,A
5-NP,646,3941,1,4,0,3946,A
5-NP,647,0,1,3948,0,3949,G
5-NP,648,3809,0,2,0,3811,A
5-NP,649,3821,1,3,1,3826,A
5-NP,650,0,0,3908,1,3909,G
5-NP,651,2,3895,0,2,3899,T
5-NP,652,0,2,4073,0,4075,G
5-NP,653,0,0,0,4045,4045,C
5-NP,654,0,4034,0,9,4043,T
5-NP,655,0,4055,0,1,4056,T
5-NP,656,4102,1,0,0,4103,A
5-NP,657,1,4099,0,4,4104,T
5-NP,658,0,4,4123,0,4127,G
5-NP,659,4033,0,8,0,4041,A
5-NP,660,1,6,4053,0,4060,G
5-NP,661,3834,0,4,0,3838,A
5-NP,662,0,2,3851,1,3854,G
5-NP,663,3827,1,3,0,3831,A
5-NP,664,3869,0,2,0,3871,A
5-NP,665,0,3830,0,4,3834,T
5-NP,666,1,1,3873,0,3875,G
5-NP,667,2,3865,0,4,3871,T
5-NP,668,1,2,3883,0,3886,G
5-NP,669,2,0,0,3878,3880,C
5-NP,670,3867,0,3,0,3870,A
5-NP,671,3879,1,8,0,3888,A
5-NP,672,1,0,0,3866,3867,C
5-NP,673,3808,15,1,0,3824,A
5-NP,674,0,3828,1,2,3831,T
5-NP,675,2,3789,1,5,3797,T
5-NP,676,6,0,0,3799,3805,C
5-NP,677,1,3784,1,1,3787,T
5-NP,678,1,3784,2,1,3788,T
5-NP,679,3791,4,1,1,3797,A
5-NP,680,3769,0,1,0,3770,A
5-NP,681,3772,0,7,0,3779,A
5-NP,682,0,2,3774,0,3776,G
5-NP,683,3,7,3759,0,3769,G
5-NP,684,3746,0,3,0,3749,A
5-NP,685,3741,1,1,0,3743,A
5-NP,686,3734,1,3,2,3740,A
5-NP,687,3797,0,0,0,3797,A
5-NP,688,1,3774,1,3,3779,T
5-NP,689,1,3784,0,0,3785,T
5-NP,690,1,3799,2,0,3802,T
5-NP,691,6,3,0,3793,3802,C
5-NP,692,3794,0,4,0,3798,A
5-NP,693,3791,2,2,0,3795,A
5-NP,694,3800,0,2,0,3802,A
5-NP,695,2,1,0,3837,3840,C
5-NP,696,3776,0,1,0,3777,A
5-NP,697,0,0,3838,0,3838,G
5-NP,698,0,4,0,3829,3833,C
5-NP,699,1,3827,0,5,3833,T
5-NP,700,4,0,3899,0,3903,G
5-NP,701,3,0,0,3886,3889,C
5-NP,702,3906,1,7,0,3914,A
5-NP,703,0,1,0,3919,3920,C
5-NP,704,3872,1,1,2,3876,A
5-NP,705,3880,0,3,1,3884,A
5-NP,706,3773,1,6,2,3782,A
5-NP,707,0,6,3888,0,3894,G
5-NP,708,3890,1,2,0,3893,A
5-NP,709,3,1,3876,0,3880,G
5-NP,710,1,0,0,3860,3861,C
5-NP,711,3846,1,1,0,3848,A
5-NP,712,3939,0,3,2,3944,A
5-NP,713,0,3940,1,1,3942,T
5-NP,714,2,7,3952,0,3961,G
5-NP,715,1,0,3969,0,3970,G
5-NP,716,0,3860,0,7,3867,T
5-NP,717,5,6,3856,0,3867,G
5-NP,718,0,4,3895,0,3899,G
5-NP,719,3881,1,6,0,3888,A
5-NP,720,1,3864,0,3,3868,T
5-NP,721,5,0,0,3771,3776,C
5-NP,722,3786,1,1,0,3788,A
5-NP,723,3816,2,4,0,3822,A
5-NP,724,1,0,3836,1,3838,G
5-NP,725,1,3811,0,0,3812,T
5-NP,726,1,6,3797,0,3804,G
5-NP,727,3743,1,9,0,3753,A
5-NP,728,0,5,3766,0,3771,G
5-NP,729,3757,1,4,0,3762,A
5-NP,730,1,2,3762,0,3765,G
5-NP,731,3739,0,7,0,3746,A
5-NP,732,3678,0,0,0,3678,A
5-NP,733,3688,0,11,0,3699,A
5-NP,734,2,0,3723,0,3725,G
5-NP,735,2,3711,1,1,3715,T
5-NP,736,5,1,0,3703,3709,C
5-NP,737,1,4,3684,0,3689,G
5-NP,738,1,4,3699,0,3704,G
5-NP,739,3694,1,0,0,3695,A
5-NP,740,3724,0,2,0,3726,A
5-NP,741,0,0,0,3738,3738,C
5-NP,742,3,2,0,3694,3699,C
5-NP,743,2,4,0,3717,3723,C
5-NP,744,3707,0,3,0,3710,A
5-NP,745,3,1,3717,0,3721,G
5-NP,746,0,2,3728,0,3730,G
5-NP,747,3720,0,1,0,3721,A
5-NP,748,3718,0,1,0,3719,A
5-NP,749,3700,0,5,0,3705,A
5-NP,750,1,2,0,3705,3708,C
5-NP,751,1,2,3693,0,3696,G
5-NP,752,2,1,0,3705,3708,C
5-NP,753,0,3696,1,0,3697,T
5-NP,754,1,4,3696,0,3701,G
5-NP,755,3690,1,2,0,3693,A
5-NP,756,112,3,3632,0,3747,G
5-NP,757,3784,1,4,1,3790,A
5-NP,758,2,3784,0,2,3788,T
5-NP,759,10,1,0,3744,3755,C
5-NP,760,1,4,3748,0,3753,G
5-NP,761,3736,0,3,0,3739,A
5-NP,762,3728,0,4,0,3732,A
5-NP,763,1,5,3721,0,3727,G
5-NP,764,3711,1,4,0,3716,A
5-NP,765,1,2,0,3599,3602,C
5-NP,766,4,0,0,3726,3730,C
5-NP,767,0,3732,0,8,3740,T
5-NP,768,6,0,0,3748,3754,C
5-NP,769,3758,2,4,0,3764,A
5-NP,770,0,3758,0,1,3759,T
5-NP,771,3769,2,3,0,3774,A
5-NP,772,1,3762,0,1,3764,T
5-NP,773,1,3743,1,1,3746,T
5-NP,774,0,3661,0,0,3661,T
5-NP,775,0,3624,0,0,3624,T
5-NP,776,0,3625,0,2,3627,T
5-NP,777,3632,0,2,1,3635,A
5-NP,778,1,2,3629,0,3632,G
5-NP,779,0,1,1,3629,3631,C
5-NP,780,3609,0,2,0,3611,A
5-NP,781,3600,0,1,1,3602,A
5-NP,782,1,1,3705,0,3707,G
5-NP,783,3706,0,3,0,3709,A
5-NP,784,2,3694,1,4,3701,T
5-NP,785,1,1,0,3725,3727,C
5-NP,786,0,3699,2,6,3707,T
5-NP,787,2,1,3810,0,3813,G
5-NP,788,0,4,0,3803,3807,C
5-NP,789,3813,0,5,0,3818,A
5-NP,790,0,3856,0,3,3859,T
5-NP,791,0,3709,0,2,3711,T
5-NP,792,2,4,3938,1,3945,G
5-NP,793,4013,0,3,0,4016,A
5-NP,794,1,4006,1,2,4010,T
5-NP,795,4026,0,1,0,4027,A
5-NP,796,0,3924,0,4,3928,T
5-NP,797,0,3893,0,4,3897,T
5-NP,798,0,4,3925,0,3929,G
5-NP,799,3884,0,1,0,3885,A
5-NP,800,0,7,3899,0,3906,G
5-NP,801,3679,2,5,0,3686,A
5-NP,802,1,5,3616,0,3622,G
5-NP,803,1,8,3663,0,3672,G
5-NP,804,3659,0,2,0,3661,A
5-NP,805,0,3657,1,1,3659,T
5-NP,806,4,1,0,3663,3668,C
5-NP,807,3644,0,2,0,3646,A
5-NP,808,1,2,3661,0,3664,G
5-NP,809,0,3641,0,5,3646,T
5-NP,810,0,3627,0,0,3627,T
5-NP,811,0,3,3624,0,3627,G
5-NP,812,0,4,1,3589,3594,C
5-NP,813,1,3581,0,13,3595,T
5-NP,814,5,0,0,3613,3618,C
5-NP,815,3616,0,3,0,3619,A
5-NP,816,3,1,0,3622,3626,C
5-NP,817,3613,0,3,0,3616,A
5-NP,818,3630,1,2,0,3633,A
5-NP,819,3632,0,1,1,3634,A
5-NP,820,2,3619,1,0,3622,T
5-NP,821,0,0,0,3623,3623,C
5-NP,822,1,3614,1,3,3619,T
5-NP,823,0,3611,0,3,3614,T
5-NP,824,1,0,3618,1,3620,G
5-NP,825,1,2,0,3611,3614,C
5-NP,826,7,0,0,3671,3678,C
5-NP,827,1,3651,0,0,3652,T
5-NP,828,3672,1,0,0,3673,A
5-NP,829,3,1,1,3660,3665,C
5-NP,830,6,0,1,3657,3664,C
5-NP,831,0,3657,0,0,3657,T
5-NP,832,0,0,3707,0,3707,G
5-NP,833,0,2,0,3682,3684,C
5-NP,834,8,2,0,3674,3684,C
5-NP,835,0,3618,0,3,3621,T
5-NP,836,1,1,3661,0,3663,G
5-NP,837,1,3639,1,2,3643,T
5-NP,838,0,1,3675,0,3676,G
5-NP,839,1,3,0,3683,3687,C
5-NP,840,2,0,3727,1,3730,G
5-NP,841,0,3666,1,4,3671,T
5-NP,842,3659,0,1,0,3660,A
5-NP,843,0,3654,0,3,3657,T
5-NP,844,1,8,3645,1,3655,G
5-NP,845,0,2,3750,0,3752,G
5-NP,846,3733,1,0,0,3734,A
5-NP,847,2,1,0,3672,3675,C
5-NP,848,4,0,1,3658,3663,C
5-NP,849,1,3582,0,6,3589,T
5-NP,850,3,1,3766,0,3770,G
5-NP,851,0,2,0,3771,3773,C
5-NP,852,3780,1,1,0,3782,A
5-NP,853,2,0,3845,0,3847,G
5-NP,854,1,3648,0,2,3651,T
5-NP,855,3755,0,3,0,3758,A
5-NP,856,0,3742,0,3,3745,T
5-NP,857,7,1,0,3726,3734,C
5-NP,858,4,2,0,3744,3750,C
5-NP,859,3524,0,0,0,3524,A
5-NP,860,1,1,3542,0,3544,G
5-NP,861,0,3517,0,7,3524,T
5-NP,862,0,4,3536,0,3540,G
5-NP,863,0,8,3517,0,3525,G
5-NP,864,1,2,3450,0,3453,G
5-NP,865,0,3443,0,5,3448,T
5-NP,866,3437,0,1,0,3438,A
5-NP,867,0,2,0,3433,3435,C
5-NP,868,1,4,3414,1,3420,G
5-NP,869,3402,0,2,0,3404,A
5-NP,870,0,1,1,3395,3397,C
5-NP,871,0,3292,0,2,3294,T
5-NP,872,0,3296,0,1,3297,T
5-NP,873,4,3,0,3279,3286,C
5-NP,874,1,1,3295,0,3297,G
5-NP,875,3302,0,1,0,3303,A
5-NP,876,3303,0,0,0,3303,A
5-NP,877,3301,0,5,1,3307,A
5-NP,878,3302,0,1,0,3303,A
5-NP,879,3291,1,4,0,3296,A
5-NP,880,1,2,3304,0,3307,G
5-NP,881,3291,0,6,0,3297,A
5-NP,882,1,4,3312,0,3317,G
5-NP,883,3,2,3349,1,3355,G
5-NP,884,1,0,3359,0,3360,G
5-NP,885,3361,1,6,0,3368,A
5-NP,886,0,3360,0,1,3361,T
5-NP,887,3376,0,1,0,3377,A
5-NP,888,1,3361,0,2,3364,T
5-NP,889,0,3345,0,6,3351,T
5-NP,890,4,0,0,3387,3391,C
5-NP,891,3,0,0,3350,3353,C
5-NP,892,0,3300,0,1,3301,T
5-NP,893,1,3298,1,2,3302,T
5-NP,894,0,3,3324,1,3328,G
5-NP,895,0,3,3339,0,3342,G
5-NP,896,1,3313,0,2,3316,T
5-NP,897,2,4,3302,1,3309,G
5-NP,898,0,2,3284,0,3286,G
5-NP,899,0,4,3435,0,3439,G
5-NP,900,3433,1,1,1,3436,A
5-NP,901,3439,0,2,1,3442,A
5-NP,902,0,3442,1,0,3443,T
5-NP,903,3374,0,3,1,3378,A
5-NP,904,0,2,3386,0,3388,G
5-NP,905,3358,0,7,0,3365,A
5-NP,906,4,0,0,3357,3361,C
5-NP,907,4,0,1,3306,3311,C
5-NP,908,7,0,0,3156,3163,C
5-NP,909,0,3171,0,7,3178,T
5-NP,910,0,3174,0,1,3175,T
5-NP,911,0,3170,1,3,3174,T
5-NP,912,2,1,0,3181,3184,C
5-NP,913,3160,0,3,0,3163,A
5-NP,914,3170,0,0,0,3170,A
5-NP,915,3159,1,1,0,3161,A
5-NP,916,1,0,0,3166,3167,C
5-NP,917,0,3071,0,1,3072,T
5-NP,918,3037,1,0,0,3038,A
5-NP,919,1,1,0,3067,3069,C
5-NP,920,2,3041,2,5,3050,T
5-NP,921,1,3052,0,3,3056,T
5-NP,922,2,1,0,3061,3064,C
5-NP,923,3051,0,3,1,3055,A
5-NP,924,3054,2,0,0,3056,A
5-NP,925,3039,0,1,2,3042,A
5-NP,926,3035,0,4,1,3040,A
5-NP,927,1,3004,0,0,3005,T
5-NP,928,2958,0,0,2,2960,A
5-NP,929,2,1,3000,0,3003,G
5-NP,930,0,1,0,3001,3002,C
5-NP,931,2,0,0,3031,3033,C
5-NP,932,3038,0,0,0,3038,A
5-NP,933,3043,0,1,0,3044,A
5-NP,934,3115,2,2,0,3119,A
5-NP,935,0,3124,1,1,3126,T
5-NP,936,3141,1,0,1,3143,A
5-NP,937,1,3136,0,0,3137,T
5-NP,938,3070,0,2,1,3073,A
5-NP,939,0,1,0,3082,3083,C
5-NP,940,2965,0,4,1,2970,A
5-NP,941,1,0,3031,0,3032,G
5-NP,942,2,0,0,3019,3021,C
5-NP,943,0,2887,2,3,2892,T
5-NP,944,0,2910,0,0,2910,T
5-NP,945,2929,0,1,0,2930,A
5-NP,946,2928,1,2,0,2931,A
5-NP,947,1,2935,0,2,2938,T
5-NP,948,4,1,0,2930,2935,C
5-NP,949,2778,0,3,0,2781,A
5-NP,950,1,8,2767,0,2776,G
5-NP,951,2777,1,1,0,2779,A
5-NP,952,2,1,0,2790,2793,C
5-NP,953,3,0,0,2752,2755,C
5-NP,954,0,2696,0,0,2696,T
5-NP,955,2704,0,2,0,2706,A
5-NP,956,2704,0,3,0,2707,A
5-NP,957,0,1,1,2716,2718,C
5-NP,958,0,5,2713,0,2718,G
5-NP,959,2631,2,3,1,2637,A
5-NP,960,1,3,2642,0,2646,G
5-NP,961,2603,0,4,1,2608,A
5-NP,962,2621,0,2,0,2623,A
5-NP,963,0,2615,0,1,2616,T
5-NP,964,1,0,0,2574,2575,C
5-NP,965,0,0,0,2581,2581,C
5-NP,966,2518,2,4,1,2525,A
5-NP,967,2,0,2539,0,2541,G
5-NP,968,0,0,1,2536,2537,C
5-NP,969,2551,0,2,0,2553,A
5-NP,970,0,2,0,2557,2559,C
5-NP,971,2515,1,2,0,2518,A
5-NP,972,0,0,0,2525,2525,C
5-NP,973,2514,1,1,0,2516,A
5-NP,974,2519,0,4,0,2523,A
5-NP,975,1,3,2524,0,2528,G
5-NP,976,2472,1,2,0,2475,A
5-NP,977,0,2,2481,0,2483,G
5-NP,978,1,2410,1,2,2414,T
5-NP,979,14,0,0,2388,2402,C
5-NP,980,2387,1,3,1,2392,A
5-NP,981,0,2,2381,0,2383,G
5-NP,982,0,1,0,2380,2381,C
5-NP,983,0,2349,1,1,2351,T
5-NP,984,0,2,2355,1,2358,G
5-NP,985,1,0,2353,0,2354,G
5-NP,986,0,2327,0,0,2327,T
5-NP,987,1,1,2329,0,2331,G
5-NP,988,0,2298,0,0,2298,T
5-NP,989,0,2,2295,0,2297,G
5-NP,990,2,0,2281,0,2283,G
5-NP,991,2260,0,1,0,2261,A
5-NP,992,1,2251,1,1,2254,T
5-NP,993,1,3,2109,1,2114,G
5-NP,994,0,1,2072,0,2073,G
5-NP,995,2,1,0,2058,2061,C
5-NP,996,2031,0,1,0,2032,A
5-NP,997,0,2022,6,2,2030,T
5-NP,998,0,1,2004,0,2005,G
5-NP,999,1,1,0,2015,2017,C
5-NP,1000,5,0,0,2010,2015,C
5-NP,1001,1990,1,0,0,1991,A
5-NP,1002,0,1976,0,0,1976,T
5-NP,1003,0,1910,0,0,1910,T
5-NP,1004,3,1,0,1913,1917,C
5-NP,1005,1,1856,0,0,1857,T
5-NP,1006,0,0,1858,0,1858,G
5-NP,1007,0,1,0,1850,1851,C
5-NP,1008,0,1684,0,3,1687,T
5-NP,1009,2,0,1690,0,1692,G
5-NP,1010,0,0,0,1612,1612,C
5-NP,1011,1615,0,0,0,1615,A
5-NP,1012,0,1620,0,0,1620,T
5-NP,1013,0,1583,0,1,1584,T
5-NP,1014,0,1581,0,1,1582,T
5-NP,1015,1,0,1577,0,1578,G
5-NP,1016,1579,0,0,0,1579,A
5-NP,1017,1572,1,2,0,1575,A
5-NP,1018,1,1,1593,0,1595,G
5-NP,1019,1593,0,0,0,1593,A
5-NP,1020,0,1583,0,0,1583,T
5-NP,1021,0,1582,0,0,1582,T
5-NP,1022,0,1585,0,0,1585,T
5-NP,1023,1583,0,0,0,1583,A
5-NP,1024,1581,0,2,0,1583,A
5-NP,1025,0,0,1587,0,1587,G
5-NP,1026,1576,0,3,0,1579,A
5-NP,1027,0,1581,0,1,1582,T
5-NP,1028,1,1545,0,0,1546,T
5-NP,1029,0,0,1556,0,1556,G
5-NP,1030,0,1554,0,2,1556,T
5-NP,1031,1,1555,0,0,1556,T
5-NP,1032,1551,0,0,0,1551,A
5-NP,1033,1555,1,2,0,1558,A
5-NP,1034,1,0,1564,0,1565,G
5-NP,1035,0,0,0,1565,1565,C
5-NP,1036,0,1530,0,4,1534,T
5-NP,1037,2,1549,0,0,1551,T
5-NP,1038,1,0,0,1564,1565,C
5-NP,1039,1563,1,1,0,1565,A
5-NP,1040,1,1562,0,2,1565,T
5-NP,1041,2,0,0,1567,1569,C
5-NP,1042,1547,0,2,1,1550,A
5-NP,1043,2,0,1552,0,1554,G
5-NP,1044,1536,0,1,0,1537,A
5-NP,1045,1,2,1531,0,1534,G
5-NP,1046,2,3,1534,0,1539,G
5-NP,1047,0,2,1531,0,1533,G
5-NP,1048,1536,0,1,0,1537,A
5-NP,1049,1,1,0,1538,1540,C
5-NP,1050,1536,0,2,0,1538,A
5-NP,1051,1542,0,1,0,1543,A
5-NP,1052,1549,0,0,0,1549,A
5-NP,1053,1548,1,2,0,1551,A
5-NP,1054,0,0,1557,0,1557,G
5-NP,1055,0,1499,0,1,1500,T
5-NP,1056,1490,0,3,0,1493,A
5-NP,1057,1,1475,0,4,1480,T
5-NP,1058,2,0,0,1484,1486,C
5-NP,1059,3,1466,0,4,1473,T
5-NP,1060,2,0,0,1479,1481,C
5-NP,1061,0,0,0,1469,1469,C
5-NP,1062,0,1456,0,0,1456,T
5-NP,1063,1,0,0,1450,1451,C
5-NP,1064,1,2,1440,0,1443,G
5-NP,1065,0,3,1443,0,1446,G
5-NP,1066,0,0,1447,0,1447,G
5-NP,1067,0,1,1438,0,1439,G
5-NP,1068,1,3,1432,0,1436,G
5-NP,1069,1417,0,0,0,1417,A
5-NP,1070,1412,0,1,1,1414,A
5-NP,1071,1412,0,4,0,1416,A
5-NP,1072,0,1,0,1422,1423,C
5-NP,1073,0,1412,0,2,1414,T
5-NP,1074,1,0,1431,0,1432,G
5-NP,1075,0,1422,1,1,1424,T
5-NP,1076,3,1,0,1423,1427,C
5-NP,1077,1449,0,2,0,1451,A
5-NP,1078,1460,0,2,0,1462,A
5-NP,1079,2,0,0,1463,1465,C
5-NP,1080,0,1464,0,0,1464,T
5-NP,1081,1434,0,0,0,1434,A
5-NP,1082,0,2,1437,0,1439,G
5-NP,1083,1412,0,1,0,1413,A
5-NP,1084,0,1,1421,0,1422,G
5-NP,1085,1,4,1417,0,1422,G
5-NP,1086,1363,0,1,0,1364,A
5-NP,1087,0,0,1400,0,1400,G
5-NP,1088,0,1389,1,0,1390,T
5-NP,1089,1390,0,1,0,1391,A
5-NP,1090,0,1,0,1386,1387,C
5-NP,1091,1372,0,1,0,1373,A
5-NP,1092,1374,0,1,0,1375,A
5-NP,1093,1364,0,0,0,1364,A
5-NP,1094,0,1351,0,1,1352,T
5-NP,1095,0,1340,0,2,1342,T
5-NP,1096,0,0,1299,0,1299,G
5-NP,1097,0,0,0,1284,1284,C
5-NP,1098,0,1279,0,3,1282,T
5-NP,1099,0,1283,1,0,1284,T
5-NP,1100,0,1,0,1282,1283,C
5-NP,1101,1285,0,0,0,1285,A
5-NP,1102,1289,0,0,0,1289,A
5-NP,1103,1289,0,0,0,1289,A
5-NP,1104,0,1293,1,0,1294,T
5-NP,1105,0,4,1288,0,1292,G
5-NP,1106,1268,0,3,1,1272,A
5-NP,1107,0,9,1274,1,1284,G
5-NP,1108,1284,0,2,2,1288,A
5-NP,1109,1287,0,1,0,1288,A
5-NP,1110,0,0,0,1294,1294,C
5-NP,1111,1281,2,2,0,1285,A
5-NP,1112,1,1282,0,1,1284,T
5-NP,1113,0,2,1307,0,1309,G
5-NP,1114,2,0,1316,0,1318,G
5-NP,1115,1315,0,1,0,1316,A
5-NP,1116,1,1282,1,0,1284,T
5-NP,1117,1268,0,1,0,1269,A
5-NP,1118,1358,0,1,0,1359,A
5-NP,1119,0,1330,1,0,1331,T
5-NP,1120,1323,0,0,0,1323,A
5-NP,1121,0,1319,0,1,1320,T
5-NP,1122,0,1,1236,0,1237,G
5-NP,1123,0,1,1216,0,1217,G
5-NP,1124,0,2,1205,0,1207,G
5-NP,1125,1203,0,0,0,1203,A
5-NP,1126,0,1198,0,0,1198,T
5-NP,1127,1,0,0,970,971,C
5-NP,1128,0,1,969,0,970,G
5-NP,1129,971,0,2,0,973,A
5-NP,1130,1,0,971,0,972,G
5-NP,1131,0,2,1,964,967,C
5-NP,1132,960,0,1,0,961,A
5-NP,1133,0,0,0,1003,1003,C
5-NP,1134,0,986,0,0,986,T
5-NP,1135,1,0,0,991,992,C
5-NP,1136,2,988,0,1,991,T
5-NP,1137,0,976,0,2,978,T
5-NP,1138,0,1,983,0,984,G
5-NP,1139,978,0,0,0,978,A
5-NP,1140,984,0,0,0,984,A
5-NP,1141,0,0,0,979,979,C
5-NP,1142,0,807,0,0,807,T
5-NP,1143,0,1,808,0,809,G
5-NP,1144,789,0,0,0,789,A
5-NP,1145,0,1,792,0,793,G
5-NP,1146,791,0,1,0,792,A
5-NP,1147,784,0,0,0,784,A
5-NP,1148,0,0,788,0,788,G
5-NP,1149,1,0,0,770,771,C
5-NP,1150,7,1,762,0,770,G
5-NP,1151,0,1,771,0,772,G
5-NP,1152,0,2,755,0,757,G
5-NP,1153,0,747,0,1,748,T
5-NP,1154,730,0,1,0,731,A
5-NP,1155,1,0,0,730,731,C
5-NP,1156,0,619,0,0,619,T
5-NP,1157,1,0,622,0,623,G
5-NP,1158,1,0,612,0,613,G
5-NP,1159,2,1,612,0,615,G
5-NP,1160,2,1,0,608,611,C
5-NP,1161,2,0,0,588,590,C
5-NP,1162,596,1,1,0,598,A
5-NP,1163,0,595,1,1,597,T
5-NP,1164,599,0,0,0,599,A
5-NP,1165,599,1,1,1,602,A
5-NP,1166,0,0,591,0,591,G
5-NP,1167,0,0,602,1,603,G
5-NP,1168,587,0,3,1,591,A
5-NP,1169,0,0,0,589,589,C
5-NP,1170,0,0,0,592,592,C
5-NP,1171,587,0,0,0,587,A
5-NP,1172,0,0,602,0,602,G
5-NP,1173,0,0,605,0,605,G
5-NP,1174,602,0,1,0,603,A
5-NP,1175,0,0,605,0,605,G
5-NP,1176,0,578,1,0,579,T
5-NP,1177,0,0,584,0,584,G
5-NP,1178,0,0,584,0,584,G
5-NP,1179,583,0,1,0,584,A
5-NP,1180,0,0,587,0,587,G
5-NP,1181,0,0,581,0,581,G
5-NP,1182,576,0,0,0,576,A
5-NP,1183,575,0,1,0,576,A
5-NP,1184,570,1,1,1,573,A
5-NP,1185,0,1,0,574,575,C
5-NP,1186,576,0,0,0,576,A
5-NP,1187,0,0,0,584,584,C
5-NP,1188,0,576,0,0,576,T
5-NP,1189,591,0,1,0,592,A
5-NP,1190,594,0,0,0,594,A
5-NP,1191,1,591,0,0,592,T
5-NP,1192,0,1,0,594,595,C
5-NP,1193,594,0,0,0,594,A
5-NP,1194,598,0,0,0,598,A
5-NP,1195,0,0,0,601,601,C
5-NP,1196,585,0,0,0,585,A
5-NP,1197,0,0,585,0,585,G
5-NP,1198,563,0,2,0,565,A
5-NP,1199,0,1,567,0,568,G
5-NP,1200,0,0,569,0,569,G
5-NP,1201,1,0,566,0,567,G
5-NP,1202,2,0,0,560,562,C
5-NP,1203,1,0,0,560,561,C
5-NP,1204,0,552,0,1,553,T
5-NP,1205,1,0,0,568,569,C
5-NP,1206,0,0,0,562,562,C
5-NP,1207,0,0,569,0,569,G
5-NP,1208,0,0,0,568,568,C
5-NP,1209,561,0,0,0,561,A
5-NP,1210,0,0,575,0,575,G
5-NP,1211,0,0,576,0,576,G
5-NP,1212,0,0,0,580,580,C
5-NP,1213,0,0,0,578,578,C
5-NP,1214,571,0,0,0,571,A
5-NP,1215,578,0,0,0,578,A
5-NP,1216,578,0,1,0,579,A
5-NP,1217,1,0,0,582,583,C
5-NP,1218,3,0,0,582,585,C
5-NP,1219,545,0,0,0,545,A
5-NP,1220,0,0,557,0,557,G
5-NP,1221,0,549,0,1,550,T
5-NP,1222,1,0,552,0,553,G
5-NP,1223,0,549,0,0,549,T
5-NP,1224,0,0,548,0,548,G
5-NP,1225,1,2,0,547,550,C
5-NP,1226,543,0,1,0,544,A
5-NP,1227,546,0,2,0,548,A
5-NP,1228,0,0,0,549,549,C
5-NP,1229,0,0,0,551,551,C
5-NP,1230,0,551,0,0,551,T
5-NP,1231,553,0,0,0,553,A
5-NP,1232,0,0,0,554,554,C
5-NP,1233,0,0,554,0,554,G
5-NP,1234,0,548,0,1,549,T
5-NP,1235,0,552,0,0,552,T
5-NP,1236,0,548,0,0,548,T
5-NP,1237,0,544,0,0,544,T
5-NP,1238,0,0,0,544,544,C
5-NP,1239,0,535,0,0,535,T
5-NP,1240,1,0,545,0,546,G
5-NP,1241,0,543,0,0,543,T
5-NP,1242,541,0,1,0,542,A
5-NP,1243,0,0,0,543,543,C
5-NP,1244,538,0,0,0,538,A
5-NP,1245,540,0,0,0,540,A
5-NP,1246,540,0,1,0,541,A
5-NP,1247,0,1,544,0,545,G
5-NP,1248,539,0,2,0,541,A
5-NP,1249,525,0,1,0,526,A
5-NP,1250,529,0,1,0,530,A
5-NP,1251,0,0,0,528,528,C
5-NP,1252,0,0,0,522,522,C
5-NP,1253,0,522,0,0,522,T
5-NP,1254,0,0,0,525,525,C
5-NP,1255,1,0,0,521,522,C
5-NP,1256,0,0,0,523,523,C
5-NP,1257,524,1,0,0,525,A
5-NP,1258,0,527,0,0,527,T
5-NP,1259,0,525,0,0,525,T
5-NP,1260,0,525,0,0,525,T
5-NP,1261,0,1,523,1,525,G
5-NP,1262,522,0,0,0,522,A
5-NP,1263,525,0,0,0,525,A
5-NP,1264,524,0,0,0,524,A
5-NP,1265,520,0,0,1,521,A
5-NP,1266,2,0,525,0,527,G
5-NP,1267,0,526,0,0,526,T
5-NP,1268,1,0,0,523,524,C
5-NP,1269,524,0,1,0,525,A
5-NP,1270,526,0,1,0,527,A
5-NP,1271,1,1,0,530,532,C
5-NP,1272,1,0,0,539,540,C
5-NP,1273,539,1,0,0,540,A
5-NP,1274,1,539,0,1,541,T
5-NP,1275,1,0,0,537,538,C
5-NP,1276,529,0,1,0,530,A
5-NP,1277,0,532,0,1,533,T
5-NP,1278,0,0,530,0,530,G
5-NP,1279,2,0,526,0,528,G
5-NP,1280,0,0,0,531,531,C
5-NP,1281,516,0,1,0,517,A
5-NP,1282,0,0,515,0,515,G
5-NP,1283,0,0,0,508,508,C
5-NP,1284,507,0,0,0,507,A
5-NP,1285,0,506,0,1,507,T
5-NP,1286,0,507,0,0,507,T
5-NP,1287,2,0,0,504,506,C
5-NP,1288,505,0,0,0,505,A
5-NP,1289,0,0,0,505,505,C
5-NP,1290,0,504,0,0,504,T
5-NP,1291,0,0,509,0,509,G
5-NP,1292,0,1,511,0,512,G
5-NP,1293,511,0,0,0,511,A
5-NP,1294,510,0,0,0,510,A
5-NP,1295,511,0,0,0,511,A
5-NP,1296,0,506,0,0,506,T
5-NP,1297,506,0,0,0,506,A
5-NP,1298,0,0,0,503,503,C
5-NP,1299,1,2,489,0,492,G
5-NP,1300,0,0,490,0,490,G
5-NP,1301,475,0,0,0,475,A
5-NP,1302,0,1,480,0,481,G
5-NP,1303,0,1,481,0,482,G
5-NP,1304,0,0,478,0,478,G
5-NP,1305,480,0,2,0,482,A
5-NP,1306,480,0,0,0,480,A
5-NP,1307,0,0,481,0,481,G
5-NP,1308,480,0,0,0,480,A
5-NP,1309,484,0,0,0,484,A
5-NP,1310,0,1,0,485,486,C
5-NP,1311,0,475,0,1,476,T
5-NP,1312,0,483,0,0,483,T
5-NP,1313,1,0,0,480,481,C
5-NP,1314,479,0,2,0,481,A
5-NP,1315,0,0,483,0,483,G
5-NP,1316,481,0,0,0,481,A
5-NP,1317,0,0,0,484,484,C
5-NP,1318,481,0,0,0,481,A
5-NP,1319,0,465,0,0,465,T
5-NP,1320,0,0,467,0,467,G
5-NP,1321,465,0,0,0,465,A
5-NP,1322,0,1,466,0,467,G
5-NP,1323,1,0,467,0,468,G
5-NP,1324,0,0,466,0,466,G
5-NP,1325,0,0,0,466,466,C
5-NP,1326,457,0,0,0,457,A
5-NP,1327,0,0,460,0,460,G
5-NP,1328,459,0,0,0,459,A
5-NP,1329,463,0,0,0,463,A
5-NP,1330,463,0,0,0,463,A
5-NP,1331,0,455,0,1,456,T
5-NP,1332,0,1,0,461,462,C
5-NP,1333,459,0,1,0,460,A
5-NP,1334,0,461,1,0,462,T
5-NP,1335,462,0,0,0,462,A
5-NP,1336,459,0,0,0,459,A
5-NP,1337,0,0,465,0,465,G
5-NP,1338,459,0,0,0,459,A
5-NP,1339,457,0,0,0,457,A
5-NP,1340,0,450,0,0,450,T
5-NP,1341,0,1,443,0,444,G
5-NP,1342,444,0,0,0,444,A
5-NP,1343,0,445,0,0,445,T
5-NP,1344,0,0,447,0,447,G
5-NP,1345,1,0,443,0,444,G
5-NP,1346,440,0,0,0,440,A
5-NP,1347,438,0,0,0,438,A
5-NP,1348,417,0,1,0,418,A
5-NP,1349,1,0,420,0,421,G
5-NP,1350,0,423,0,0,423,T
5-NP,1351,0,1,422,0,423,G
5-NP,1352,1,0,0,420,421,C
5-NP,1353,420,1,0,0,421,A
5-NP,1354,419,0,0,0,419,A
5-NP,1355,421,0,1,0,422,A
5-NP,1356,420,0,1,0,421,A
5-NP,1357,0,0,1,422,423,C
5-NP,1358,0,0,0,421,421,C
5-NP,1359,408,0,0,0,408,A
5-NP,1360,0,1,411,0,412,G
5-NP,1361,410,0,0,1,411,A
5-NP,1362,411,0,0,0,411,A
5-NP,1363,0,0,410,1,411,G
5-NP,1364,411,0,0,0,411,A
5-NP,1365,393,1,0,0,394,A
5-NP,1366,0,1,397,0,398,G
5-NP,1367,0,394,0,0,394,T
5-NP,1368,0,1,392,1,394,G
5-NP,1369,0,393,0,0,393,T
5-NP,1370,1,0,0,391,392,C
5-NP,1371,391,0,0,0,391,A
5-NP,1372,1,398,0,0,399,T
5-NP,1373,0,399,0,0,399,T
5-NP,1374,0,0,0,401,401,C
5-NP,1375,0,0,0,393,393,C
5-NP,1376,0,0,394,0,394,G
5-NP,1377,0,1,394,0,395,G
5-NP,1378,0,1,392,0,393,G
5-NP,1379,0,0,395,0,395,G
5-NP,1380,0,0,396,0,396,G
5-NP,1381,386,0,1,0,387,A
5-NP,1382,0,0,386,0,386,G
5-NP,1383,0,1,387,0,388,G
5-NP,1384,0,0,384,0,384,G
5-NP,1385,0,1,384,0,385,G
5-NP,1386,373,0,0,0,373,A
5-NP,1387,0,0,374,0,374,G
5-NP,1388,0,366,0,0,366,T
5-NP,1389,0,0,0,359,359,C
5-NP,1390,0,360,0,1,361,T
5-NP,1391,0,363,0,0,363,T
5-NP,1392,1,0,0,361,362,C
5-NP,1393,0,0,362,0,362,G
5-NP,1394,362,0,0,0,362,A
5-NP,1395,0,0,364,0,364,G
5-NP,1396,0,0,0,355,355,C
5-NP,1397,0,351,0,1,352,T
5-NP,1398,0,0,0,353,353,C
5-NP,1399,0,351,0,1,352,T
5-NP,1400,0,1,0,352,353,C
5-NP,1401,351,0,0,0,351,A
5-NP,1402,0,0,351,0,351,G
5-NP,1403,352,0,0,0,352,A
5-NP,1404,0,0,0,351,351,C
5-NP,1405,1,1,350,0,352,G
5-NP,1406,345,0,0,0,345,A
5-NP,1407,0,0,348,0,348,G
5-NP,1408,344,0,0,0,344,A
5-NP,1409,343,0,0,0,343,A
5-NP,1410,0,0,343,0,343,G
5-NP,1411,0,0,341,0,341,G
5-NP,1412,0,0,0,339,339,C
5-NP,1413,341,0,1,0,342,A
5-NP,1414,342,0,0,0,342,A
5-NP,1415,1,0,0,341,342,C
5-NP,1416,0,0,344,0,344,G
5-NP,1417,343,0,0,0,343,A
5-NP,1418,342,0,0,0,342,A
5-NP,1419,0,0,0,340,340,C
5-NP,1420,0,0,0,339,339,C
5-NP,1421,0,0,0,337,337,C
5-NP,1422,0,1,336,0,337,G
5-NP,1423,339,0,0,0,339,A
5-NP,1424,0,338,0,1,339,T
5-NP,1425,2,1,0,327,330,C
5-NP,1426,1,0,330,0,331,G
5-NP,1427,0,327,0,0,327,T
5-NP,1428,0,0,326,0,326,G
5-NP,1429,0,1,0,326,327,C
5-NP,1430,0,0,0,324,324,C
5-NP,1431,0,0,0,326,326,C
5-NP,1432,0,318,0,0,318,T
5-NP,1433,0,0,0,321,321,C
5-NP,1434,0,318,0,1,319,T
5-NP,1435,0,316,2,0,318,T
5-NP,1436,0,320,0,0,320,T
5-NP,1437,0,316,0,0,316,T
5-NP,1438,0,0,316,0,316,G
5-NP,1439,317,0,0,0,317,A
5-NP,1440,0,311,0,0,311,T
5-NP,1441,309,0,0,0,309,A
5-NP,1442,0,267,0,0,267,T
5-NP,1443,0,0,271,1,272,G
5-NP,1444,267,0,0,0,267,A
5-NP,1445,0,0,274,0,274,G
5-NP,1446,0,275,0,0,275,T
5-NP,1447,262,0,0,0,262,A
5-NP,1448,263,0,0,0,263,A
5-NP,1449,0,262,0,0,262,T
5-NP,1450,0,0,260,0,260,G
5-NP,1451,257,0,3,0,260,A
5-NP,1452,226,0,0,0,226,A
5-NP,1453,0,0,223,0,223,G
5-NP,1454,0,0,213,0,213,G
5-NP,1455,213,0,0,0,213,A
5-NP,1456,0,213,0,0,213,T
5-NP,1457,1,0,0,206,207,C
5-NP,1458,0,203,0,1,204,T
5-NP,1459,0,204,0,0,204,T
5-NP,1460,202,0,0,0,202,A
5-NP,1461,0,203,0,0,203,T
5-NP,1462,0,197,0,0,197,T
5-NP,1463,0,196,0,0,196,T
5-NP,1464,0,0,0,190,190,C
5-NP,1465,0,182,0,1,183,T
5-NP,1466,0,183,0,0,183,T
5-NP,1467,0,0,0,183,183,C
5-NP,1468,0,0,183,0,183,G
5-NP,1469,0,0,183,0,183,G
5-NP,1470,182,0,0,0,182,A
5-NP,1471,0,1,180,0,181,G
5-NP,1472,182,0,0,0,182,A
5-NP,1473,0,0,0,178,178,C
5-NP,1474,170,0,0,0,170,A
5-NP,1475,170,0,0,0,170,A
5-NP,1476,0,170,0,0,170,T
5-NP,1477,0,0,170,0,170,G
5-NP,1478,0,0,0,170,170,C
5-NP,1479,163,0,1,1,165,A
5-NP,1480,0,0,164,0,164,G
5-NP,1481,164,0,0,0,164,A
5-NP,1482,146,0,0,0,146,A
5-NP,1483,0,0,146,0,146,G
5-NP,1484,98,0,1,0,99,A
5-NP,1485,0,0,98,0,98,G
5-NP,1486,0,86,0,0,86,T
5-NP,1487,86,0,0,0,86,A
5-NP,1488,0,78,0,0,78,T
5-NP,1489,0,0,78,0,78,G
5-NP,1490,78,0,0,0,78,A
5-NP,1491,0,0,0,77,77,C
5-NP,1492,50,0,0,0,50,A
5-NP,1493,50,0,0,0,50,A
5-NP,1494,0,32,0,0,32,T
5-NP,1495,0,32,0,0,32,T
5-NP,1496,31,0,0,0,31,A
5-NP,1497,31,0,0,0,31,A
6-NA,1,265,0,0,0,265,A
6-NA,2,0,272,0,0,272,T
6-NA,3,0,0,275,0,275,G
6-NA,4,272,0,7,0,279,A
6-NA,5,293,0,0,0,293,A
6-NA,6,0,294,0,0,294,T
6-NA,7,0,6,0,289,295,C
6-NA,8,0,0,0,294,294,C
6-NA,9,293,0,0,0,293,A
6-NA,10,307,1,0,0,308,A
6-NA,11,308,0,1,0,309,A
6-NA,12,0,313,0,0,313,T
6-NA,13,0,0,0,317,317,C
6-NA,14,316,1,0,0,317,A
6-NA,15,323,0,0,0,323,A
6-NA,16,322,0,0,1,323,A
6-NA,17,341,0,0,0,341,A
6-NA,18,0,0,378,0,378,G
6-NA,19,394,0,1,0,395,A
6-NA,20,0,402,0,0,402,T
6-NA,21,407,0,1,0,408,A
6-NA,22,415,1,0,0,416,A
6-NA,23,0,416,0,0,416,T
6-NA,24,417,0,0,0,417,A
6-NA,25,420,0,1,0,421,A
6-NA,26,0,0,0,435,435,C
6-NA,27,0,1,446,0,447,G
6-NA,28,450,0,0,0,450,A
6-NA,29,1,448,0,1,450,T
6-NA,30,0,449,1,1,451,T
6-NA,31,1,0,453,0,454,G
6-NA,32,0,0,487,1,488,G
6-NA,33,0,0,0,492,492,C
6-NA,34,0,488,0,4,492,T
6-NA,35,3,0,0,516,519,C
6-NA,36,0,519,0,0,519,T
6-NA,37,0,0,538,0,538,G
6-NA,38,0,537,0,2,539,T
6-NA,39,0,540,0,1,541,T
6-NA,40,0,549,0,1,550,T
6-NA,41,0,1,0,557,558,C
6-NA,42,0,556,0,1,557,T
6-NA,43,2,0,0,559,561,C
6-NA,44,0,563,0,0,563,T
6-NA,45,0,0,0,577,577,C
6-NA,46,573,0,0,0,573,A
6-NA,47,0,0,0,615,615,C
6-NA,48,0,0,0,618,618,C
6-NA,49,617,0,0,0,617,A
6-NA,50,0,630,0,1,631,T
6-NA,51,0,638,0,2,640,T
6-NA,52,0,645,0,0,645,T
6-NA,53,0,0,0,667,667,C
6-NA,54,0,1,0,664,665,C
6-NA,55,671,0,0,0,671,A
6-NA,56,0,0,0,704,704,C
6-NA,57,698,0,1,0,699,A
6-NA,58,747,0,1,0,748,A
6-NA,59,0,748,0,0,748,T
6-NA,60,787,0,1,0,788,A
6-NA,61,0,790,0,0,790,T
6-NA,62,1,2,784,0,787,G
6-NA,63,0,1,0,786,787,C
6-NA,64,0,784,0,2,786,T
6-NA,65,1,803,0,0,804,T
6-NA,66,0,1,0,805,806,C
6-NA,67,0,803,0,0,803,T
6-NA,68,0,805,0,1,806,T
6-NA,69,1,0,0,801,802,C
6-NA,70,803,1,0,0,804,A
6-NA,71,0,804,0,1,805,T
6-NA,72,0,0,803,1,804,G
6-NA,73,1,0,0,805,806,C
6-NA,74,804,0,0,0,804,A
6-NA,75,802,0,0,0,802,A
6-NA,76,802,0,0,0,802,A
6-NA,77,0,814,0,0,814,T
6-NA,78,0,811,0,1,812,T
6-NA,79,0,1,816,0,817,G
6-NA,80,0,0,0,814,814,C
6-NA,81,2,1,0,815,818,C
6-NA,82,824,0,2,0,826,A
6-NA,83,0,829,0,0,829,T
6-NA,84,1,0,0,888,889,C
6-NA,85,0,893,0,0,893,T
6-NA,86,0,893,0,1,894,T
6-NA,87,0,2,926,0,928,G
6-NA,88,927,0,0,0,927,A
6-NA,89,0,933,0,0,933,T
6-NA,90,933,0,1,0,934,A
6-NA,91,934,0,0,0,934,A
6-NA,92,0,2,0,1069,1071,C
6-NA,93,0,1055,0,0,1055,T
6-NA,94,1076,0,0,0,1076,A
6-NA,95,0,0,0,1130,1130,C
6-NA,96,0,1123,0,0,1123,T
6-NA,97,0,0,1147,0,1147,G
6-NA,98,0,1150,1,0,1151,T
6-NA,99,1148,0,1,0,1149,A
6-NA,100,1153,0,4,0,1157,A
6-NA,101,0,0,0,1139,1139,C
6-NA,102,1120,0,0,0,1120,A
6-NA,103,0,1133,0,1,1134,T
6-NA,104,0,1113,0,2,1115,T
6-NA,105,0,0,1116,0,1116,G
6-NA,106,0,0,0,1117,1117,C
6-NA,107,1125,0,0,0,1125,A
6-NA,108,0,1130,0,0,1130,T
6-NA,109,0,1131,0,0,1131,T
6-NA,110,0,1131,0,1,1132,T
6-NA,111,1,2,0,1125,1128,C
6-NA,112,1129,0,1,0,1130,A
6-NA,113,1136,0,1,0,1137,A
6-NA,114,0,0,1141,0,1141,G
6-NA,115,0,1,0,1146,1147,C
6-NA,116,1133,1,0,0,1134,A
6-NA,117,1186,0,0,0,1186,A
6-NA,118,0,1205,0,2,1207,T
6-NA,119,1206,0,0,0,1206,A
6-NA,120,0,1206,0,1,1207,T
6-NA,121,2,1,1245,0,1248,G
6-NA,122,1243,0,2,0,1245,A
6-NA,123,1257,1,1,1,1260,A
6-NA,124,0,1262,0,1,1263,T
6-NA,125,0,1269,0,0,1269,T
6-NA,126,1,0,0,1262,1263,C
6-NA,127,1258,0,0,0,1258,A
6-NA,128,1263,3,1,0,1267,A
6-NA,129,1,0,0,1267,1268,C
6-NA,130,2,1254,0,3,1259,T
6-NA,131,0,2,0,1258,1260,C
6-NA,132,0,0,0,1259,1259,C
6-NA,133,0,0,0,1288,1288,C
6-NA,134,0,0,1,1294,1295,C
6-NA,135,0,2,0,1289,1291,C
6-NA,136,1,0,0,1306,1307,C
6-NA,137,1,0,0,1307,1308,C
6-NA,138,1310,0,0,0,1310,A
6-NA,139,1312,0,0,0,1312,A
6-NA,140,1316,0,0,0,1316,A
6-NA,141,0,0,0,1342,1342,C
6-NA,142,1322,0,2,0,1324,A
6-NA,143,1346,1,0,0,1347,A
6-NA,144,0,0,0,1351,1351,C
6-NA,145,0,0,0,1345,1345,C
6-NA,146,1388,0,2,0,1390,A
6-NA,147,1397,0,2,0,1399,A
6-NA,148,0,2,1417,0,1419,G
6-NA,149,1,1416,0,2,1419,T
6-NA,150,0,1,1412,0,1413,G
6-NA,151,1439,1,3,0,1443,A
6-NA,152,1,1437,0,1,1439,T
6-NA,153,1,0,1436,0,1437,G
6-NA,154,1,1,0,1442,1444,C
6-NA,155,0,1429,0,3,1432,T
6-NA,156,1,0,1551,0,1552,G
6-NA,157,0,1540,0,1,1541,T
6-NA,158,1,0,1548,0,1549,G
6-NA,159,0,1551,0,4,1555,T
6-NA,160,2,4,1531,0,1537,G
6-NA,161,1541,0,5,0,1546,A
6-NA,162,1553,0,0,0,1553,A
6-NA,163,2,1,0,1550,1553,C
6-NA,164,0,0,0,1554,1554,C
6-NA,165,1515,0,0,0,1515,A
6-NA,166,1524,0,1,0,1525,A
6-NA,167,1,1,0,1585,1587,C
6-NA,168,1585,1,1,0,1587,A
6-NA,169,1607,2,0,0,1609,A
6-NA,170,1,1609,0,0,1610,T
6-NA,171,1607,0,0,0,1607,A
6-NA,172,1615,0,2,0,1617,A
6-NA,173,0,1614,0,1,1615,T
6-NA,174,1607,0,0,1,1608,A
6-NA,175,0,2,1613,0,1615,G
6-NA,176,1591,0,0,0,1591,A
6-NA,177,1592,1,2,0,1595,A
6-NA,178,1594,0,1,0,1595,A
6-NA,179,1,1,1604,0,1606,G
6-NA,180,1633,0,4,0,1637,A
6-NA,181,1644,0,0,0,1644,A
6-NA,182,1740,0,2,0,1742,A
6-NA,183,0,1,0,1751,1752,C
6-NA,184,1753,0,0,0,1753,A
6-NA,185,1,1783,1,1,1786,T
6-NA,186,1795,0,1,0,1796,A
6-NA,187,1803,0,4,0,1807,A
6-NA,188,0,0,0,1843,1843,C
6-NA,189,1827,0,1,1,1829,A
6-NA,190,0,4,1901,0,1905,G
6-NA,191,1869,1,3,0,1873,A
6-NA,192,0,0,1884,0,1884,G
6-NA,193,1876,0,4,1,1881,A
6-NA,194,0,1944,0,1,1945,T
6-NA,195,1941,0,2,0,1943,A
6-NA,196,0,0,1982,0,1982,G
6-NA,197,0,1967,0,3,1970,T
6-NA,198,1,0,2031,0,2032,G
6-NA,199,0,2020,0,2,2022,T
6-NA,200,2027,0,0,0,2027,A
6-NA,201,0,2022,0,0,2022,T
6-NA,202,0,1,0,2025,2026,C
6-NA,203,0,1991,0,3,1994,T
6-NA,204,1,3,2050,1,2055,G
6-NA,205,2056,0,2,1,2059,A
6-NA,206,0,1,0,2060,2061,C
6-NA,207,5,0,0,2047,2052,C
6-NA,208,2043,0,0,0,2043,A
6-NA,209,2062,1,1,0,2064,A
6-NA,210,0,0,0,2100,2100,C
6-NA,211,2098,0,1,0,2099,A
6-NA,212,1,0,0,2147,2148,C
6-NA,213,4,1,1,2123,2129,C
6-NA,214,2176,0,3,0,2179,A
6-NA,215,1,2,0,2251,2254,C
6-NA,216,3,0,0,2248,2251,C
6-NA,217,2267,0,3,1,2271,A
6-NA,218,0,2273,0,0,2273,T
6-NA,219,2257,0,1,0,2258,A
6-NA,220,1,2,2264,0,2267,G
6-NA,221,2232,0,2,0,2234,A
6-NA,222,2,2,2271,0,2275,G
6-NA,223,2251,0,1,0,2252,A
6-NA,224,2207,1,1,0,2209,A
6-NA,225,1,2,2226,0,2229,G
6-NA,226,0,2,2236,0,2238,G
6-NA,227,2245,1,0,1,2247,A
6-NA,228,2253,0,1,0,2254,A
6-NA,229,2243,0,4,0,2247,A
6-NA,230,0,2241,0,1,2242,T
6-NA,231,2230,0,1,0,2231,A
6-NA,232,1,2220,0,1,2222,T
6-NA,233,1,2,2217,0,2220,G
6-NA,234,0,1,0,2214,2215,C
6-NA,235,2,0,1,2189,2192,C
6-NA,236,0,0,0,2205,2205,C
6-NA,237,4,2,0,2211,2217,C
6-NA,238,2228,0,0,0,2228,A
6-NA,239,2259,0,2,0,2261,A
6-NA,240,2262,0,1,0,2263,A
6-NA,241,2,1,0,2263,2266,C
6-NA,242,0,2265,0,2,2267,T
6-NA,243,2260,1,1,0,2262,A
6-NA,244,1,0,2268,0,2269,G
6-NA,245,1,0,0,2262,2263,C
6-NA,246,2262,0,3,0,2265,A
6-NA,247,2,2,2297,0,2301,G
6-NA,248,2267,0,2,0,2269,A
6-NA,249,2343,1,1,0,2345,A
6-NA,250,1,2344,0,0,2345,T
6-NA,251,2346,0,1,0,2347,A
6-NA,252,0,2,1,2346,2349,C
6-NA,253,2326,0,5,1,2332,A
6-NA,254,2,4,2326,0,2332,G
6-NA,255,2333,0,1,0,2334,A
6-NA,256,2320,0,0,0,2320,A
6-NA,257,2322,0,0,1,2323,A
6-NA,258,0,2280,1,0,2281,T
6-NA,259,0,2256,0,1,2257,T
6-NA,260,2,1,2261,0,2264,G
6-NA,261,2,1,2263,0,2266,G
6-NA,262,0,2272,0,2,2274,T
6-NA,263,8,0,0,2268,2276,C
6-NA,264,2269,1,1,0,2271,A
6-NA,265,2279,0,0,1,2280,A
6-NA,266,2274,0,3,0,2277,A
6-NA,267,0,0,2291,0,2291,G
6-NA,268,0,1,0,2288,2289,C
6-NA,269,2,1,0,2273,2276,C
6-NA,270,2,0,2286,0,2288,G
6-NA,271,1,0,0,2303,2304,C
6-NA,272,2308,0,1,0,2309,A
6-NA,273,2344,0,1,0,2345,A
6-NA,274,0,2334,0,1,2335,T
6-NA,275,2,0,2360,1,2363,G
6-NA,276,0,2357,0,1,2358,T
6-NA,277,0,4,2349,1,2354,G
6-NA,278,2394,2,4,0,2400,A
6-NA,279,0,1,0,2437,2438,C
6-NA,280,2499,0,0,0,2499,A
6-NA,281,0,2510,0,2,2512,T
6-NA,282,1,2494,0,3,2498,T
6-NA,283,2497,0,1,0,2498,A
6-NA,284,1,3,1,2491,2496,C
6-NA,285,2484,1,0,0,2485,A
6-NA,286,0,4,2474,0,2478,G
6-NA,287,2,1,2443,0,2446,G
6-NA,288,2,1,2371,1,2375,G
6-NA,289,1,2465,0,1,2467,T
6-NA,290,0,2465,0,3,2468,T
6-NA,291,0,2469,0,1,2470,T
6-NA,292,1,0,2459,0,2460,G
6-NA,293,1,2,0,2460,2463,C
6-NA,294,2470,1,1,1,2473,A
6-NA,295,0,1,1,2483,2485,C
6-NA,296,2,0,0,2459,2461,C
6-NA,297,1,2435,0,2,2438,T
6-NA,298,1,2436,1,1,2439,T
6-NA,299,1,2458,0,0,2459,T
6-NA,300,1,2458,0,2,2461,T
6-NA,301,1,2488,0,2,2491,T
6-NA,302,2,0,0,2503,2505,C
6-NA,303,0,2504,1,1,2506,T
6-NA,304,2498,0,2,0,2500,A
6-NA,305,2485,1,4,0,2490,A
6-NA,306,3,0,2512,0,2515,G
6-NA,307,2,3,2506,0,2511,G
6-NA,308,2506,1,3,0,2510,A
6-NA,309,1,0,0,2523,2524,C
6-NA,310,2481,0,1,0,2482,A
6-NA,311,2487,0,1,0,2488,A
6-NA,312,0,2487,1,1,2489,T
6-NA,313,0,2492,0,1,2493,T
6-NA,314,5,1,0,2525,2531,C
6-NA,315,2,7,2525,0,2534,G
6-NA,316,2524,2,1,1,2528,A
6-NA,317,0,2529,1,1,2531,T
6-NA,318,0,2528,0,1,2529,T
6-NA,319,2529,1,1,0,2531,A
6-NA,320,1,1,2534,0,2536,G
6-NA,321,1,1,2541,1,2544,G
6-NA,322,0,0,0,2546,2546,C
6-NA,323,1,2490,0,3,2494,T
6-NA,324,0,2520,0,2,2522,T
6-NA,325,0,2517,0,2,2519,T
6-NA,326,3,0,0,2524,2527,C
6-NA,327,2,2,0,2528,2532,C
6-NA,328,1,8,2523,0,2532,G
6-NA,329,1,2,0,2535,2538,C
6-NA,330,0,2520,0,0,2520,T
6-NA,331,1,2,2584,0,2587,G
6-NA,332,1,2,2588,0,2591,G
6-NA,333,1,2589,0,1,2591,T
6-NA,334,1,0,2592,0,2593,G
6-NA,335,0,2,2580,0,2582,G
6-NA,336,1,1,2587,0,2589,G
6-NA,337,0,3,2587,0,2590,G
6-NA,338,2594,0,4,0,2598,A
6-NA,339,1,0,0,2630,2631,C
6-NA,340,2585,0,4,0,2589,A
6-NA,341,0,2586,0,1,2587,T
6-NA,342,1,1,0,2591,2593,C
6-NA,343,0,2580,0,2,2582,T
6-NA,344,3,2,2592,0,2597,G
6-NA,345,0,3,2589,0,2592,G
6-NA,346,4,2,2595,0,2601,G
6-NA,347,1,2600,0,2,2603,T
6-NA,348,1,6,2559,0,2566,G
6-NA,349,2565,0,1,0,2566,A
6-NA,350,0,2,0,2614,2616,C
6-NA,351,2605,0,2,0,2607,A
6-NA,352,2623,0,6,0,2629,A
6-NA,353,0,4,2642,0,2646,G
6-NA,354,2618,0,4,0,2622,A
6-NA,355,1,4,2661,0,2666,G
6-NA,356,2673,0,7,1,2681,A
6-NA,357,2733,0,3,0,2736,A
6-NA,358,0,0,0,2932,2932,C
6-NA,359,4,2,0,2977,2983,C
6-NA,360,1,2971,0,7,2979,T
6-NA,361,0,2978,1,2,2981,T
6-NA,362,2983,0,0,0,2983,A
6-NA,363,0,2985,0,3,2988,T
6-NA,364,1,1,3058,0,3060,G
6-NA,365,1,3048,0,4,3053,T
6-NA,366,0,0,3073,0,3073,G
6-NA,367,1,3000,0,4,3005,T
6-NA,368,5,1,1,2982,2989,C
6-NA,369,2993,0,1,7,3001,A
6-NA,370,0,3002,0,4,3006,T
6-NA,371,0,1,2999,0,3000,G
6-NA,372,3,1,1,3000,3005,C
6-NA,373,1,2,2987,0,2990,G
6-NA,374,3191,3,2,0,3196,A
6-NA,375,0,3194,0,0,3194,T
6-NA,376,2,0,0,3222,3224,C
6-NA,377,4,2,0,3234,3240,C
6-NA,378,1,3241,2,12,3256,T
6-NA,379,3,6,3275,0,3284,G
6-NA,380,3280,0,3,1,3284,A
6-NA,381,1,2,0,3285,3288,C
6-NA,382,3278,2,5,0,3285,A
6-NA,383,3190,0,6,0,3196,A
6-NA,384,1,1,3306,0,3308,G
6-NA,385,0,3288,0,0,3288,T
6-NA,386,2,0,3323,1,3326,G
6-NA,387,0,3295,0,2,3297,T
6-NA,388,0,3293,0,2,3295,T
6-NA,389,3291,0,7,0,3298,A
6-NA,390,2,3294,0,0,3296,T
6-NA,391,7,0,0,3330,3337,C
6-NA,392,3327,1,2,0,3330,A
6-NA,393,3295,0,4,0,3299,A
6-NA,394,3,3272,0,3,3278,T
6-NA,395,0,3271,0,1,3272,T
6-NA,396,0,3276,0,0,3276,T
6-NA,397,1,4,3290,0,3295,G
6-NA,398,0,1,0,3418,3419,C
6-NA,399,7,0,0,3405,3412,C
6-NA,400,0,2,0,3413,3415,C
6-NA,401,0,3401,0,6,3407,T
6-NA,402,2,3407,0,3,3412,T
6-NA,403,3,4,3442,1,3450,G
6-NA,404,5,9,3435,1,3450,G
6-NA,405,3469,1,6,0,3476,A
6-NA,406,2,4,0,3471,3477,C
6-NA,407,3359,1,15,1,3376,A
6-NA,408,0,4,3432,0,3436,G
6-NA,409,0,9,3421,0,3430,G
6-NA,410,2,3,3523,0,3528,G
6-NA,411,3524,0,8,0,3532,A
6-NA,412,3505,1,2,0,3508,A
6-NA,413,0,1,0,3516,3517,C
6-NA,414,3440,1,1,1,3443,A
6-NA,415,3644,2,3,0,3649,A
6-NA,416,2,3,0,3659,3664,C
6-NA,417,3624,0,4,0,3628,A
6-NA,418,0,2,0,3649,3651,C
6-NA,419,0,3573,0,4,3577,T
6-NA,420,3611,0,1,2,3614,A
6-NA,421,3603,1,3,1,3608,A
6-NA,422,3629,0,5,0,3634,A
6-NA,423,1,0,0,3634,3635,C
6-NA,424,3406,0,0,1,3407,A
6-NA,425,3445,0,3,0,3448,A
6-NA,426,3,0,0,3458,3461,C
6-NA,427,1,0,3442,1,3444,G
6-NA,428,0,3433,0,0,3433,T
6-NA,429,3388,0,0,0,3388,A
6-NA,430,0,1,0,3439,3440,C
6-NA,431,3439,0,2,0,3441,A
6-NA,432,1,3448,0,3,3452,T
6-NA,433,0,3451,0,5,3456,T
6-NA,434,2,0,0,3578,3580,C
6-NA,435,3648,1,3,1,3653,A
6-NA,436,3674,0,1,1,3676,A
6-NA,437,3672,0,0,1,3673,A
6-NA,438,0,3674,0,2,3676,T
6-NA,439,3620,0,1,2,3623,A
6-NA,440,3720,0,3,1,3724,A
6-NA,441,2,3,0,3728,3733,C
6-NA,442,3728,2,3,0,3733,A
6-NA,443,2,0,0,3778,3780,C
6-NA,444,3653,0,4,1,3658,A
6-NA,445,2,1,4205,0,4208,G
6-NA,446,0,4205,0,0,4205,T
6-NA,447,4271,2,1,0,4274,A
6-NA,448,2,4,0,4281,4287,C
6-NA,449,3,1,4252,0,4256,G
6-NA,450,1,4402,1,5,4409,T
6-NA,451,2,3,4399,0,4404,G
6-NA,452,4425,0,3,1,4429,A
6-NA,453,1,4446,0,2,4449,T
6-NA,454,4089,0,5,0,4094,A
6-NA,455,2,2,4085,0,4089,G
6-NA,456,1,4,4062,0,4067,G
6-NA,457,4077,1,4,1,4083,A
6-NA,458,2,2,1,4134,4139,C
6-NA,459,5,1,1,4027,4034,C
6-NA,460,4,0,0,4062,4066,C
6-NA,461,1,0,1,4071,4073,C
6-NA,462,1,4100,0,1,4102,T
6-NA,463,0,4154,0,6,4160,T
6-NA,464,4171,0,1,2,4174,A
6-NA,465,0,4180,0,0,4180,T
6-NA,466,2,3,0,4174,4179,C
6-NA,467,7,6,4124,1,4138,G
6-NA,468,1,7,4122,0,4130,G
6-NA,469,4129,3,4,1,4137,A
6-NA,470,0,1,0,4167,4168,C
6-NA,471,9,0,0,4128,4137,C
6-NA,472,3,1,0,4338,4342,C
6-NA,473,2,4309,1,5,4317,T
6-NA,474,4382,0,0,1,4383,A
6-NA,475,0,4371,1,5,4377,T
6-NA,476,0,4376,1,1,4378,T
6-NA,477,1,4,4377,0,4382,G
6-NA,478,4374,0,3,0,4377,A
6-NA,479,1,4348,0,0,4349,T
6-NA,480,1,7,4354,0,4362,G
6-NA,481,4212,2,6,0,4220,A
6-NA,482,4206,2,4,1,4213,A
6-NA,483,0,4215,0,4,4219,T
6-NA,484,2,14,4249,0,4265,G
6-NA,485,4337,0,2,1,4340,A
6-NA,486,3,0,4363,0,4366,G
6-NA,487,0,4352,0,1,4353,T
6-NA,488,0,4364,1,1,4366,T
6-NA,489,4369,2,5,0,4376,A
6-NA,490,0,7,4381,1,4389,G
6-NA,491,0,3,4388,0,4391,G
6-NA,492,1,4366,0,4,4371,T
6-NA,493,1,4,4359,0,4364,G
6-NA,494,2,4291,0,3,4296,T
6-NA,495,1,4271,0,11,4283,T
6-NA,496,3,1,0,4321,4325,C
6-NA,497,1,3,0,4342,4346,C
6-NA,498,0,4320,0,6,4326,T
6-NA,499,1,4316,0,4,4321,T
6-NA,500,1,4313,0,3,4317,T
6-NA,501,1,4323,1,4,4329,T
6-NA,502,5,0,0,4326,4331,C
6-NA,503,4313,0,4,0,4317,A
6-NA,504,0,4405,0,7,4412,T
6-NA,505,4,0,0,4403,4407,C
6-NA,506,1,4358,0,5,4364,T
6-NA,507,2,7,4354,0,4363,G
6-NA,508,1,10,4332,0,4343,G
6-NA,509,1,5,4341,1,4348,G
6-NA,510,2,5,4391,0,4398,G
6-NA,511,4380,2,5,0,4387,A
6-NA,512,0,3,0,4414,4417,C
6-NA,513,1,2,0,4350,4353,C
6-NA,514,4397,1,4,1,4403,A
6-NA,515,4403,0,5,0,4408,A
6-NA,516,5,0,4396,0,4401,G
6-NA,517,0,2,0,4408,4410,C
6-NA,518,4397,3,3,0,4403,A
6-NA,519,4434,2,4,0,4440,A
6-NA,520,2,2,4465,1,4470,G
6-NA,521,0,4438,0,2,4440,T
6-NA,522,1,0,4556,0,4557,G
6-NA,523,0,4503,0,6,4509,T
6-NA,524,0,2,4621,1,4624,G
6-NA,525,0,0,0,4625,4625,C
6-NA,526,4607,0,2,0,4609,A
6-NA,527,0,4632,0,6,4638,T
6-NA,528,4552,1,4,0,4557,A
6-NA,529,1,1,4682,0,4684,G
6-NA,530,3,1,0,4676,4680,C
6-NA,531,4593,1,2,0,4596,A
6-NA,532,0,4578,0,1,4579,T
6-NA,533,1,5,4460,0,4466,G
6-NA,534,0,1,4683,0,4684,G
6-NA,535,1,4687,0,8,4696,T
6-NA,536,12,4,1,4643,4660,C
6-NA,537,1,1,0,4665,4667,C
6-NA,538,4585,0,4,0,4589,A
6-NA,539,3,1,4685,0,4689,G
6-NA,540,2,2,0,4679,4683,C
6-NA,541,2,4659,0,9,4670,T
6-NA,542,11,0,0,4663,4674,C
6-NA,543,4528,2,5,2,4537,A
6-NA,544,4570,0,1,1,4572,A
6-NA,545,2,1,4586,0,4589,G
6-NA,546,3,4612,0,1,4616,T
6-NA,547,1,4601,0,6,4608,T
6-NA,548,1,2,4592,0,4595,G
6-NA,549,1,4593,0,2,4596,T
6-NA,550,6,1,1,4584,4592,C
6-NA,551,4585,0,4,0,4589,A
6-NA,552,1,5,0,4614,4620,C
6-NA,553,1,4,4606,0,4611,G
6-NA,554,4666,1,2,0,4669,A
6-NA,555,1,4674,0,2,4677,T
6-NA,556,1,7,4734,0,4742,G
6-NA,557,0,7,4749,0,4756,G
6-NA,558,4745,1,6,0,4752,A
6-NA,559,4750,0,6,0,4756,A
6-NA,560,4788,3,10,2,4803,A
6-NA,561,4801,1,4,0,4806,A
6-NA,562,0,1,4859,0,4860,G
6-NA,563,1,1,0,4836,4838,C
6-NA,564,4819,1,4,0,4824,A
6-NA,565,0,4814,1,3,4818,T
6-NA,566,1,8,4845,0,4854,G
6-NA,567,1,0,4866,0,4867,G
6-NA,568,2,1,0,4893,4896,C
6-NA,569,4,4864,0,8,4876,T
6-NA,570,1,4,4893,0,4898,G
6-NA,571,2,2,0,4861,4865,C
6-NA,572,4877,0,5,0,4882,A
6-NA,573,1,5009,0,3,5013,T
6-NA,574,0,3,5019,0,5022,G
6-NA,575,1,4965,0,5,4971,T
6-NA,576,1,4995,2,6,5004,T
6-NA,577,2,4978,0,4,4984,T
6-NA,578,1,1,5128,0,5130,G
6-NA,579,1,5128,0,5,5134,T
6-NA,580,5134,1,2,0,5137,A
6-NA,581,1,5146,2,3,5152,T
6-NA,582,5051,1,3,0,5055,A
6-NA,583,5073,0,1,1,5075,A
6-NA,584,0,1,3,5050,5054,C
6-NA,585,3,6,5026,0,5035,G
6-NA,586,0,6,5016,0,5022,G
6-NA,587,1,2,4992,1,4996,G
6-NA,588,4921,1,7,1,4930,A
6-NA,589,0,3,4978,0,4981,G
6-NA,590,4973,0,7,0,4980,A
6-NA,591,0,5001,0,5,5006,T
6-NA,592,2,27,5003,0,5032,G
6-NA,593,5023,2,9,1,5035,A
6-NA,594,4,5056,0,2,5062,T
6-NA,595,5047,2,2,0,5051,A
6-NA,596,5100,1,1,0,5102,A
6-NA,597,5111,4,4,0,5119,A
6-NA,598,5114,0,1,0,5115,A
6-NA,599,5121,1,3,0,5125,A
6-NA,600,0,5101,0,1,5102,T
6-NA,601,0,2,5114,0,5116,G
6-NA,602,1,2,0,5104,5107,C
6-NA,603,5105,0,1,0,5106,A
6-NA,604,5111,0,6,1,5118,A
6-NA,605,0,1,0,5142,5143,C
6-NA,606,1,5138,0,4,5143,T
6-NA,607,3,2,5140,1,5146,G
6-NA,608,3,5,0,5126,5134,C
6-NA,609,1,5137,0,6,5144,T
6-NA,610,5140,0,8,0,5148,A
6-NA,611,3,0,5144,0,5147,G
6-NA,612,2,0,0,5180,5182,C
6-NA,613,1,5173,0,6,5180,T
6-NA,614,1,5151,1,2,5155,T
6-NA,615,3,3,0,5189,5195,C
6-NA,616,5203,2,1,0,5206,A
6-NA,617,0,5202,1,4,5207,T
6-NA,618,2,5215,0,3,5220,T
6-NA,619,0,5238,0,1,5239,T
6-NA,620,5248,1,4,0,5253,A
6-NA,621,3,1,0,5294,5298,C
6-NA,622,5267,0,2,1,5270,A
6-NA,623,5296,1,6,0,5303,A
6-NA,624,1,5254,0,2,5257,T
6-NA,625,2,4,5243,1,5250,G
6-NA,626,0,2,5242,0,5244,G
6-NA,627,1,4,5231,1,5237,G
6-NA,628,5221,1,8,0,5230,A
6-NA,629,0,2,5333,0,5335,G
6-NA,630,1,2,5349,0,5352,G
6-NA,631,1,2,0,5626,5629,C
6-NA,632,1,5601,0,6,5608,T
6-NA,633,2,5651,2,1,5656,T
6-NA,634,2,4,5700,0,5706,G
6-NA,635,0,5707,0,2,5709,T
6-NA,636,5799,1,4,0,5804,A
6-NA,637,0,6,5812,0,5818,G
6-NA,638,5681,0,10,0,5691,A
6-NA,639,0,5700,0,0,5700,T
6-NA,640,5275,1,3,0,5279,A
6-NA,641,2,1,5288,0,5291,G
6-NA,642,1,5210,1,6,5218,T
6-NA,643,3,1,5084,0,5088,G
6-NA,644,1,5280,0,6,5287,T
6-NA,645,0,5277,0,3,5280,T
6-NA,646,2,0,5360,0,5362,G
6-NA,647,0,5332,2,13,5347,T
6-NA,648,2,5347,1,5,5355,T
6-NA,649,0,5345,0,5,5350,T
6-NA,650,5,4,0,5260,5269,C
6-NA,651,5262,1,8,1,5272,A
6-NA,652,1,5237,0,3,5241,T
6-NA,653,1,8,5230,2,5241,G
6-NA,654,3,2,5512,1,5518,G
6-NA,655,0,5414,0,7,5421,T
6-NA,656,11,2,1,5397,5411,C
6-NA,657,9,3,1,5388,5401,C
6-NA,658,5426,1,4,0,5431,A
6-NA,659,5446,1,4,0,5451,A
6-NA,660,5449,0,7,1,5457,A
6-NA,661,3,8,5480,0,5491,G
6-NA,662,5471,2,3,2,5478,A
6-NA,663,5277,0,3,1,5281,A
6-NA,664,5278,1,5,0,5284,A
6-NA,665,1,5270,0,2,5273,T
6-NA,666,9,0,1,5391,5401,C
6-NA,667,4,0,1,5377,5382,C
6-NA,668,1,5374,2,2,5379,T
6-NA,669,6,3,1,5372,5382,C
6-NA,670,5356,1,6,0,5363,A
6-NA,671,2,4,5410,0,5416,G
6-NA,672,2,9,5403,1,5415,G
6-NA,673,5495,2,5,0,5502,A
6-NA,674,5,2,1,5495,5503,C
6-NA,675,6,4,0,5395,5405,C
6-NA,676,3,2,0,5405,5410,C
6-NA,677,5412,0,4,10,5426,A
6-NA,678,2,1,5425,0,5428,G
6-NA,679,1,15,5429,1,5446,G
6-NA,680,5416,1,7,1,5425,A
6-NA,681,0,0,5470,1,5471,G
6-NA,682,1,5366,0,8,5375,T
6-NA,683,10,2,0,5376,5388,C
6-NA,684,5362,3,8,3,5376,A
6-NA,685,1,6,5410,0,5417,G
6-NA,686,5398,3,2,1,5404,A
6-NA,687,5392,0,5,0,5397,A
6-NA,688,0,5363,0,4,5367,T
6-NA,689,2,3,5373,0,5378,G
6-NA,690,5,4,0,5342,5351,C
6-NA,691,3,0,5393,0,5396,G
6-NA,692,0,5367,1,5,5373,T
6-NA,693,1,5372,1,1,5375,T
6-NA,694,2,5332,1,1,5336,T
6-NA,695,3,2,5391,0,5396,G
6-NA,696,0,5405,0,2,5407,T
6-NA,697,5415,0,2,0,5417,A
6-NA,698,1,5374,2,4,5381,T
6-NA,699,9,3,1,5366,5379,C
6-NA,700,5346,1,3,0,5350,A
6-NA,701,5345,1,0,0,5346,A
6-NA,702,2,5347,0,2,5351,T
6-NA,703,1,5,5344,0,5350,G
6-NA,704,3,9,5344,1,5357,G
6-NA,705,5419,1,3,2,5425,A
6-NA,706,5417,2,12,1,5432,A
6-NA,707,1,1,0,5470,5472,C
6-NA,708,0,5481,0,12,5493,T
6-NA,709,0,5492,0,1,5493,T
6-NA,710,1,1,5634,0,5636,G
6-NA,711,2,5628,1,5,5636,T
6-NA,712,5634,2,2,0,5638,A
6-NA,713,0,2,0,5695,5697,C
6-NA,714,5511,0,4,1,5516,A
6-NA,715,2,1,5901,0,5904,G
6-NA,716,0,5844,0,8,5852,T
6-NA,717,6050,1,4,1,6056,A
6-NA,718,2,4,6081,1,6088,G
6-NA,719,0,5975,0,1,5976,T
6-NA,720,5969,1,0,1,5971,A
6-NA,721,5969,0,0,0,5969,A
6-NA,722,0,5935,0,4,5939,T
6-NA,723,0,12,5951,0,5963,G
6-NA,724,5761,2,3,0,5766,A
6-NA,725,1,0,1,5827,5829,C
6-NA,726,0,5624,0,4,5628,T
6-NA,727,2,6,5636,1,5645,G
6-NA,728,5629,1,6,0,5636,A
6-NA,729,2,5637,0,5,5644,T
6-NA,730,2,8,5638,0,5648,G
6-NA,731,2,3,5589,1,5595,G
6-NA,732,1,9,5597,0,5607,G
6-NA,733,5510,1,9,0,5520,A
6-NA,734,2,2,5530,0,5534,G
6-NA,735,1,5498,1,5,5505,T
6-NA,736,1,0,5513,0,5514,G
6-NA,737,1,3,1,5544,5549,C
6-NA,738,1,5519,1,10,5531,T
6-NA,739,1,5527,0,3,5531,T
6-NA,740,3,2,0,5541,5546,C
6-NA,741,5523,1,11,2,5537,A
6-NA,742,0,4,5556,0,5560,G
6-NA,743,1,3,5558,1,5563,G
6-NA,744,5551,0,2,0,5553,A
6-NA,745,5494,0,5,1,5500,A
6-NA,746,5466,0,0,1,5467,A
6-NA,747,5467,4,6,1,5478,A
6-NA,748,1,2,5494,0,5497,G
6-NA,749,1,11,3,5477,5492,C
6-NA,750,0,5456,0,3,5459,T
6-NA,751,3,4,5447,1,5455,G
6-NA,752,5438,1,3,0,5442,A
6-NA,753,0,5508,0,1,5509,T
6-NA,754,5529,1,6,0,5536,A
6-NA,755,1,1,0,5769,5771,C
6-NA,756,2,5730,0,3,5735,T
6-NA,757,5726,0,1,0,5727,A
6-NA,758,5713,0,5,1,5719,A
6-NA,759,5714,1,5,3,5723,A
6-NA,760,5856,1,3,0,5860,A
6-NA,761,0,5857,0,0,5857,T
6-NA,762,5856,3,2,0,5861,A
6-NA,763,2,3,0,5882,5887,C
6-NA,764,0,5586,0,3,5589,T
6-NA,765,5656,1,2,0,5659,A
6-NA,766,2,5609,1,11,5623,T
6-NA,767,2,5820,0,4,5826,T
6-NA,768,6,3,0,5852,5861,C
6-NA,769,5716,0,4,0,5720,A
6-NA,770,0,5705,1,3,5709,T
6-NA,771,0,5678,0,2,5680,T
6-NA,772,1,2,5704,0,5707,G
6-NA,773,5677,0,4,0,5681,A
6-NA,774,1,2,5649,0,5652,G
6-NA,775,5,3,5640,1,5649,G
6-NA,776,5386,1,6,0,5393,A
6-NA,777,1,7,5459,1,5468,G
6-NA,778,1,12,5459,0,5472,G
6-NA,779,3,8,5473,0,5484,G
6-NA,780,1,9,5481,0,5491,G
6-NA,781,5451,1,9,1,5462,A
6-NA,782,5472,0,5,1,5478,A
6-NA,783,5437,1,8,0,5446,A
6-NA,784,5447,0,5,1,5453,A
6-NA,785,0,5457,0,0,5457,T
6-NA,786,7,1,0,5384,5392,C
6-NA,787,2,0,5440,1,5443,G
6-NA,788,1,5421,0,2,5424,T
6-NA,789,1,5413,0,5,5419,T
6-NA,790,5,3,1,5425,5434,C
6-NA,791,5425,1,1,0,5427,A
6-NA,792,3,5753,0,4,5760,T
6-NA,793,5755,0,1,1,5757,A
6-NA,794,4,1,1,5778,5784,C
6-NA,795,1,5760,1,5,5767,T
6-NA,796,5750,0,6,0,5756,A
6-NA,797,2,0,5756,0,5758,G
6-NA,798,0,2,1,5753,5756,C
6-NA,799,5752,0,2,0,5754,A
6-NA,800,0,2,0,5765,5767,C
6-NA,801,5506,0,5,0,5511,A
6-NA,802,0,5838,1,2,5841,T
6-NA,803,0,5806,0,5,5811,T
6-NA,804,2,0,6147,0,6149,G
6-NA,805,4,6104,0,6,6114,T
6-NA,806,9,1,1,6102,6113,C
6-NA,807,6104,0,9,1,6114,A
6-NA,808,5,1,6117,0,6123,G
6-NA,809,3,5,6112,0,6120,G
6-NA,810,6114,0,0,0,6114,A
6-NA,811,6014,0,4,1,6019,A
6-NA,812,0,1,6079,0,6080,G
6-NA,813,0,5734,0,4,5738,T
6-NA,814,3,2,5754,0,5759,G
6-NA,815,1,3,0,5747,5751,C
6-NA,816,2,5732,0,7,5741,T
6-NA,817,10,2,0,5757,5769,C
6-NA,818,5717,2,5,0,5724,A
6-NA,819,2,1,5730,0,5733,G
6-NA,820,2,0,1,5733,5736,C
6-NA,821,5671,1,4,0,5676,A
6-NA,822,0,5680,0,0,5680,T
6-NA,823,0,0,5741,1,5742,G
6-NA,824,1,5741,0,6,5748,T
6-NA,825,11,1,0,5725,5737,C
6-NA,826,5,4,5733,0,5742,G
6-NA,827,5719,2,3,0,5724,A
6-NA,828,2,2,5694,0,5698,G
6-NA,829,0,6,5684,0,5690,G
6-NA,830,5665,4,3,0,5672,A
6-NA,831,5505,0,4,1,5510,A
6-NA,832,0,5563,0,4,5567,T
6-NA,833,1,2,5579,0,5582,G
6-NA,834,2,0,0,5641,5643,C
6-NA,835,1,5617,0,8,5626,T
6-NA,836,7,2,1,5633,5643,C
6-NA,837,5,2,0,5654,5661,C
6-NA,838,1,5648,0,8,5657,T
6-NA,839,5,0,5681,0,5686,G
6-NA,840,1,1,1,5666,5669,C
6-NA,841,0,5643,0,2,5645,T
6-NA,842,5689,3,3,0,5695,A
6-NA,843,0,5600,0,7,5607,T
6-NA,844,6,1,1,5635,5643,C
6-NA,845,7,1,0,5616,5624,C
6-NA,846,0,5633,0,5,5638,T
6-NA,847,7,1,0,5633,5641,C
6-NA,848,3,2,5631,0,5636,G
6-NA,849,5693,1,1,0,5695,A
6-NA,850,1,5684,0,4,5689,T
6-NA,851,5677,1,1,0,5679,A
6-NA,852,0,5667,1,7,5675,T
6-NA,853,2,3,2,5645,5652,C
6-NA,854,1,5,0,5635,5641,C
6-NA,855,2,5593,0,10,5605,T
6-NA,856,1,11,5597,0,5609,G
6-NA,857,1,1,5633,0,5635,G
6-NA,858,0,5652,0,6,5658,T
6-NA,859,2,2,5678,0,5682,G
6-NA,860,1,5624,0,10,5635,T
6-NA,861,3,0,0,5627,5630,C
6-NA,862,5611,1,9,1,5622,A
6-NA,863,0,2,5634,0,5636,G
6-NA,864,5622,6,5,0,5633,A
6-NA,865,0,5570,0,5,5575,T
6-NA,866,0,1,5562,0,5563,G
6-NA,867,0,5457,0,7,5464,T
6-NA,868,0,0,5459,5,5464,G
6-NA,869,2,5440,0,6,5448,T
6-NA,870,8,2,0,5451,5461,C
6-NA,871,1,5433,2,8,5444,T
6-NA,872,1,3,5447,0,5451,G
6-NA,873,3,1,0,5442,5446,C
6-NA,874,5433,2,4,0,5439,A
6-NA,875,2,5,5438,0,5445,G
6-NA,876,5317,1,9,0,5327,A
6-NA,877,4,3,5322,5,5334,G
6-NA,878,5330,0,1,0,5331,A
6-NA,879,3,1,0,5341,5345,C
6-NA,880,5352,1,1,0,5354,A
6-NA,881,5381,5,3,0,5389,A
6-NA,882,0,2,0,5507,5509,C
6-NA,883,2,5496,0,1,5499,T
6-NA,884,3,6,5509,0,5518,G
6-NA,885,1,4,5498,1,5504,G
6-NA,886,5472,0,7,1,5480,A
6-NA,887,5464,0,9,0,5473,A
6-NA,888,5373,1,11,2,5387,A
6-NA,889,1,3,5373,0,5377,G
6-NA,890,0,6,5305,1,5312,G
6-NA,891,5178,0,8,1,5187,A
6-NA,892,0,5278,0,2,5280,T
6-NA,893,6,1,0,5306,5313,C
6-NA,894,4,0,1,5384,5389,C
6-NA,895,5383,1,5,0,5389,A
6-NA,896,5375,0,2,0,5377,A
6-NA,897,1,5388,0,1,5390,T
6-NA,898,5213,1,6,1,5221,A
6-NA,899,1,3,5191,1,5196,G
6-NA,900,3,1,5194,0,5198,G
6-NA,901,5,2,0,5187,5194,C
6-NA,902,3,4,0,5157,5164,C
6-NA,903,8,3,0,5015,5026,C
6-NA,904,5035,1,1,0,5037,A
6-NA,905,2,5069,1,6,5078,T
6-NA,906,3,3,0,5084,5090,C
6-NA,907,2,0,5100,0,5102,G
6-NA,908,1,5073,0,2,5076,T
6-NA,909,4985,1,1,1,4988,A
6-NA,910,1,1,5054,0,5056,G
6-NA,911,5061,0,9,0,5070,A
6-NA,912,0,5063,0,2,5065,T
6-NA,913,4979,0,3,0,4982,A
6-NA,914,1,4913,0,0,4914,T
6-NA,915,4916,0,3,0,4919,A
6-NA,916,4893,1,6,0,4900,A
6-NA,917,4964,0,8,3,4975,A
6-NA,918,3,1,0,5048,5052,C
6-NA,919,4862,0,1,0,4863,A
6-NA,920,1,4833,3,4,4841,T
6-NA,921,4789,0,2,0,4791,A
6-NA,922,4782,0,1,0,4783,A
6-NA,923,4786,0,4,0,4790,A
6-NA,924,3,6,4823,0,4832,G
6-NA,925,0,4,4881,0,4885,G
6-NA,926,4709,0,5,0,4714,A
6-NA,927,2,4663,0,4,4669,T
6-NA,928,3,3,0,4668,4674,C
6-NA,929,4691,1,4,0,4696,A
6-NA,930,2,4687,0,8,4697,T
6-NA,931,4685,0,5,0,4690,A
6-NA,932,1,0,4706,1,4708,G
6-NA,933,2,0,0,4612,4614,C
6-NA,934,4475,0,3,0,4478,A
6-NA,935,1,4201,1,6,4209,T
6-NA,936,1,4228,0,3,4232,T
6-NA,937,0,0,4219,0,4219,G
6-NA,938,2,4224,1,2,4229,T
6-NA,939,6,3,0,4139,4148,C
6-NA,940,0,4345,0,7,4352,T
6-NA,941,5,0,1,4395,4401,C
6-NA,942,2,2,0,4418,4422,C
6-NA,943,4446,1,3,0,4450,A
6-NA,944,2,1,4486,1,4490,G
6-NA,945,1,4466,0,2,4469,T
6-NA,946,0,4182,0,2,4184,T
6-NA,947,4187,1,3,1,4192,A
6-NA,948,0,4019,0,4,4023,T
6-NA,949,3,3,4019,1,4026,G
6-NA,950,0,3918,0,3,3921,T
6-NA,951,1,1,3932,0,3934,G
6-NA,952,3,3761,1,1,3766,T
6-NA,953,2,0,3776,0,3778,G
6-NA,954,1,3757,0,5,3763,T
6-NA,955,0,3740,12,3,3755,T
6-NA,956,6,0,0,3746,3752,C
6-NA,957,3696,0,2,0,3698,A
6-NA,958,5,0,3713,0,3718,G
6-NA,959,1,3,3711,0,3715,G
6-NA,960,3453,0,178,0,3631,A
6-NA,961,2,1,0,3656,3659,C
6-NA,962,0,3487,1,2,3490,T
6-NA,963,1,3491,0,4,3496,T
6-NA,964,0,0,3579,0,3579,G
6-NA,965,2,3562,0,7,3571,T
6-NA,966,0,3567,0,1,3568,T
6-NA,967,1,3,3508,0,3512,G
6-NA,968,0,4,3493,0,3497,G
6-NA,969,3467,0,11,0,3478,A
6-NA,970,0,6,3482,0,3488,G
6-NA,971,3484,1,7,0,3492,A
6-NA,972,0,0,0,3523,3523,C
6-NA,973,3425,0,4,1,3430,A
6-NA,974,1,2,0,3454,3457,C
6-NA,975,3448,0,5,2,3455,A
6-NA,976,0,3,0,3447,3450,C
6-NA,977,3,0,0,3439,3442,C
6-NA,978,2,0,0,3436,3438,C
6-NA,979,3439,1,2,0,3442,A
6-NA,980,2,4,3452,0,3458,G
6-NA,981,3444,0,1,0,3445,A
6-NA,982,3459,1,3,0,3463,A
6-NA,983,3445,0,2,1,3448,A
6-NA,984,3444,0,1,0,3445,A
6-NA,985,3426,0,4,0,3430,A
6-NA,986,3432,0,4,1,3437,A
6-NA,987,0,2,1,3438,3441,C
6-NA,988,3,1,3439,0,3443,G
6-NA,989,3425,0,3,0,3428,A
6-NA,990,2,1,1,3420,3424,C
6-NA,991,3401,1,2,0,3404,A
6-NA,992,0,0,3444,0,3444,G
6-NA,993,1,2,0,3571,3574,C
6-NA,994,0,3554,0,3,3557,T
6-NA,995,4,2,0,3565,3571,C
6-NA,996,2,0,0,3574,3576,C
6-NA,997,3572,1,2,0,3575,A
6-NA,998,1,1,3589,0,3591,G
6-NA,999,0,2,0,3586,3588,C
6-NA,1000,3575,1,3,2,3581,A
6-NA,1001,0,1,3571,0,3572,G
6-NA,1002,0,3332,0,4,3336,T
6-NA,1003,3,2,3324,1,3330,G
6-NA,1004,1,0,3348,0,3349,G
6-NA,1005,0,1,0,3354,3355,C
6-NA,1006,3,2,0,3356,3361,C
6-NA,1007,3325,0,4,0,3329,A
6-NA,1008,1,3335,0,1,3337,T
6-NA,1009,1,3324,0,0,3325,T
6-NA,1010,1,0,3390,1,3392,G
6-NA,1011,0,3369,2,3,3374,T
6-NA,1012,1,3363,0,4,3368,T
6-NA,1013,0,3364,0,2,3366,T
6-NA,1014,0,3,3342,0,3345,G
6-NA,1015,0,1,3372,0,3373,G
6-NA,1016,3357,0,0,0,3357,A
6-NA,1017,1,3377,0,3,3381,T
6-NA,1018,5,0,0,3363,3368,C
6-NA,1019,4,0,1,3310,3315,C
6-NA,1020,1,3305,0,6,3312,T
6-NA,1021,3311,0,6,0,3317,A
6-NA,1022,3323,2,4,0,3329,A
6-NA,1023,1,1,0,3365,3367,C
6-NA,1024,3300,0,0,0,3300,A
6-NA,1025,3313,1,2,0,3316,A
6-NA,1026,0,3302,0,3,3305,T
6-NA,1027,0,0,3304,0,3304,G
6-NA,1028,3262,5,4,0,3271,A
6-NA,1029,0,1,3146,0,3147,G
6-NA,1030,2,3,3189,0,3194,G
6-NA,1031,3191,0,1,0,3192,A
6-NA,1032,3193,1,8,0,3202,A
6-NA,1033,3,4,3206,0,3213,G
6-NA,1034,3,1,3217,0,3221,G
6-NA,1035,0,3181,0,4,3185,T
6-NA,1036,1,3,3168,0,3172,G
6-NA,1037,2,1,3236,0,3239,G
6-NA,1038,0,3181,0,20,3201,T
6-NA,1039,1,0,0,3198,3199,C
6-NA,1040,3201,2,0,0,3203,A
6-NA,1041,0,3185,0,6,3191,T
6-NA,1042,0,4,3179,0,3183,G
6-NA,1043,1,2,3165,0,3168,G
6-NA,1044,0,0,3071,0,3071,G
6-NA,1045,4,0,3197,0,3201,G
6-NA,1046,0,3198,0,6,3204,T
6-NA,1047,3,3,3203,0,3209,G
6-NA,1048,3199,0,3,0,3202,A
6-NA,1049,3196,0,2,1,3199,A
6-NA,1050,3198,1,8,0,3207,A
6-NA,1051,0,2,3212,0,3214,G
6-NA,1052,1,0,3191,0,3192,G
6-NA,1053,1,2,0,3177,3180,C
6-NA,1054,0,3078,1,6,3085,T
6-NA,1055,2,5,3083,0,3090,G
6-NA,1056,3,4,3084,0,3091,G
6-NA,1057,0,1,3112,0,3113,G
6-NA,1058,2,2,1,3114,3119,C
6-NA,1059,3,1,1,3107,3112,C
6-NA,1060,0,3067,0,7,3074,T
6-NA,1061,1,3080,0,2,3083,T
6-NA,1062,0,3075,0,2,3077,T
6-NA,1063,0,2,3092,0,3094,G
6-NA,1064,3083,1,2,1,3087,A
6-NA,1065,0,3069,0,1,3070,T
6-NA,1066,2,2,3029,0,3033,G
6-NA,1067,2991,2,5,0,2998,A
6-NA,1068,1,2997,0,3,3001,T
6-NA,1069,1,0,2998,0,2999,G
6-NA,1070,1,3,3023,1,3028,G
6-NA,1071,3021,1,2,0,3024,A
6-NA,1072,3009,0,3,1,3013,A
6-NA,1073,3008,0,7,1,3016,A
6-NA,1074,2,3018,0,0,3020,T
6-NA,1075,3,1,3023,0,3027,G
6-NA,1076,3029,1,3,0,3033,A
6-NA,1077,0,0,0,3016,3016,C
6-NA,1078,5,0,3026,0,3031,G
6-NA,1079,0,2958,0,0,2958,T
6-NA,1080,0,1,2973,0,2974,G
6-NA,1081,0,2965,0,1,2966,T
6-NA,1082,0,3,2972,0,2975,G
6-NA,1083,1,1,2986,0,2988,G
6-NA,1084,2968,0,3,0,2971,A
6-NA,1085,1,2968,0,3,2972,T
6-NA,1086,0,5,2960,0,2965,G
6-NA,1087,0,1,2946,0,2947,G
6-NA,1088,0,2,2977,0,2979,G
6-NA,1089,2954,0,5,1,2960,A
6-NA,1090,2946,0,5,0,2951,A
6-NA,1091,1,7,2942,0,2950,G
6-NA,1092,2904,0,5,1,2910,A
6-NA,1093,2903,0,5,0,2908,A
6-NA,1094,1,1,0,2891,2893,C
6-NA,1095,2,2,2880,0,2884,G
6-NA,1096,2867,0,3,0,2870,A
6-NA,1097,0,2819,0,2,2821,T
6-NA,1098,2,0,0,2825,2827,C
6-NA,1099,2831,0,2,0,2833,A
6-NA,1100,0,0,2836,0,2836,G
6-NA,1101,3,3,0,2824,2830,C
6-NA,1102,1,7,2820,0,2828,G
6-NA,1103,2816,4,1,1,2822,A
6-NA,1104,0,1,2832,0,2833,G
6-NA,1105,2820,1,2,0,2823,A
6-NA,1106,2821,1,2,0,2824,A
6-NA,1107,0,2,2819,0,2821,G
6-NA,1108,0,2796,0,5,2801,T
6-NA,1109,12,0,1,2776,2789,C
6-NA,1110,2728,0,3,1,2732,A
6-NA,1111,1,0,0,2724,2725,C
6-NA,1112,1,2,2726,0,2729,G
6-NA,1113,0,2723,0,1,2724,T
6-NA,1114,1,2801,0,0,2802,T
6-NA,1115,0,2804,2,1,2807,T
6-NA,1116,2805,0,1,0,2806,A
6-NA,1117,0,1,2842,0,2843,G
6-NA,1118,2,3,2829,0,2834,G
6-NA,1119,0,3,2882,0,2885,G
6-NA,1120,0,2750,1,4,2755,T
6-NA,1121,2745,0,3,0,2748,A
6-NA,1122,1,2734,0,7,2742,T
6-NA,1123,0,4,2739,0,2743,G
6-NA,1124,2735,0,2,0,2737,A
6-NA,1125,2737,1,1,0,2739,A
6-NA,1126,2683,1,2,0,2686,A
6-NA,1127,0,1,0,2694,2695,C
6-NA,1128,1,1,0,2579,2581,C
6-NA,1129,0,2317,0,3,2320,T
6-NA,1130,1,2317,0,2,2320,T
6-NA,1131,1,1,0,2316,2318,C
6-NA,1132,2317,1,1,0,2319,A
6-NA,1133,2319,0,0,0,2319,A
6-NA,1134,2315,0,2,1,2318,A
6-NA,1135,0,4,2334,0,2338,G
6-NA,1136,0,2279,0,4,2283,T
6-NA,1137,4,0,0,2283,2287,C
6-NA,1138,2330,0,1,0,2331,A
6-NA,1139,0,2334,0,2,2336,T
6-NA,1140,0,2335,0,1,2336,T
6-NA,1141,1,1,2334,0,2336,G
6-NA,1142,2326,0,2,0,2328,A
6-NA,1143,2323,0,4,1,2328,A
6-NA,1144,1,0,2336,0,2337,G
6-NA,1145,2,0,2332,0,2334,G
6-NA,1146,0,1,0,2318,2319,C
6-NA,1147,0,2230,0,1,2231,T
6-NA,1148,1,2,2247,0,2250,G
6-NA,1149,2,1,2294,0,2297,G
6-NA,1150,2,2294,0,2,2298,T
6-NA,1151,4,1,0,2278,2283,C
6-NA,1152,2,2,0,2281,2285,C
6-NA,1153,2264,1,4,0,2269,A
6-NA,1154,2279,0,2,0,2281,A
6-NA,1155,3,2,0,2288,2293,C
6-NA,1156,7,0,0,2253,2260,C
6-NA,1157,2,0,0,2243,2245,C
6-NA,1158,1,2140,0,1,2142,T
6-NA,1159,2143,0,0,0,2143,A
6-NA,1160,2140,0,0,1,2141,A
6-NA,1161,0,0,2157,0,2157,G
6-NA,1162,1,2140,0,4,2145,T
6-NA,1163,2,2,0,2131,2135,C
6-NA,1164,4,1,0,2085,2090,C
6-NA,1165,2076,1,1,0,2078,A
6-NA,1166,2080,0,1,0,2081,A
6-NA,1167,2074,0,0,0,2074,A
6-NA,1168,0,2071,1,1,2073,T
6-NA,1169,0,2070,1,0,2071,T
6-NA,1170,2,0,2045,0,2047,G
6-NA,1171,1,0,0,2031,2032,C
6-NA,1172,2033,0,3,0,2036,A
6-NA,1173,1,0,2045,0,2046,G
6-NA,1174,2039,1,0,0,2040,A
6-NA,1175,0,2066,1,1,2068,T
6-NA,1176,2070,0,0,0,2070,A
6-NA,1177,2066,0,1,0,2067,A
6-NA,1178,2067,0,1,0,2068,A
6-NA,1179,0,2054,1,0,2055,T
6-NA,1180,2037,0,1,0,2038,A
6-NA,1181,1,1,2041,0,2043,G
6-NA,1182,2,1,2023,0,2026,G
6-NA,1183,2,2,0,2010,2014,C
6-NA,1184,1954,0,2,0,1956,A
6-NA,1185,1972,0,2,0,1974,A
6-NA,1186,1,0,1991,0,1992,G
6-NA,1187,1,1976,0,2,1979,T
6-NA,1188,6,0,1,1966,1973,C
6-NA,1189,1973,0,3,1,1977,A
6-NA,1190,0,1966,0,1,1967,T
6-NA,1191,1977,0,2,0,1979,A
6-NA,1192,0,1,1983,0,1984,G
6-NA,1193,0,1979,0,3,1982,T
6-NA,1194,0,1891,1,3,1895,T
6-NA,1195,0,1,1853,1,1855,G
6-NA,1196,1844,0,4,0,1848,A
6-NA,1197,1,1,0,1843,1845,C
6-NA,1198,1822,1,1,0,1824,A
6-NA,1199,0,1,1845,0,1846,G
6-NA,1200,1801,1,6,0,1808,A
6-NA,1201,1,4,1862,0,1867,G
6-NA,1202,0,1,1863,0,1864,G
6-NA,1203,0,1864,0,1,1865,T
6-NA,1204,1860,0,1,0,1861,A
6-NA,1205,1853,1,7,0,1861,A
6-NA,1206,1,1855,0,0,1856,T
6-NA,1207,1852,0,3,0,1855,A
6-NA,1208,0,0,1804,0,1804,G
6-NA,1209,1,0,1755,0,1756,G
6-NA,1210,1,1507,0,2,1510,T
6-NA,1211,2,1,0,1496,1499,C
6-NA,1212,1,2,0,1499,1502,C
6-NA,1213,1,1,1497,0,1499,G
6-NA,1214,1,0,1505,0,1506,G
6-NA,1215,0,1502,0,1,1503,T
6-NA,1216,0,1504,0,0,1504,T
6-NA,1217,1482,0,0,0,1482,A
6-NA,1218,0,1448,0,0,1448,T
6-NA,1219,0,1438,0,1,1439,T
6-NA,1220,2,0,1,1440,1443,C
6-NA,1221,0,1343,0,2,1345,T
6-NA,1222,0,0,1350,0,1350,G
6-NA,1223,1,1,1347,0,1349,G
6-NA,1224,0,1344,0,1,1345,T
6-NA,1225,1346,0,1,0,1347,A
6-NA,1226,0,1323,0,0,1323,T
6-NA,1227,0,1319,0,3,1322,T
6-NA,1228,1,1324,0,1,1326,T
6-NA,1229,0,1329,0,1,1330,T
6-NA,1230,0,1,0,1331,1332,C
6-NA,1231,0,1306,0,1,1307,T
6-NA,1232,1,0,0,1309,1310,C
6-NA,1233,0,1298,0,0,1298,T
6-NA,1234,0,0,1316,0,1316,G
6-NA,1235,0,1312,0,1,1313,T
6-NA,1236,0,1306,1,0,1307,T
6-NA,1237,0,0,1308,0,1308,G
6-NA,1238,1292,0,1,0,1293,A
6-NA,1239,1289,1,3,0,1293,A
6-NA,1240,0,2,1303,0,1305,G
6-NA,1241,0,0,1302,0,1302,G
6-NA,1242,0,2,0,1300,1302,C
6-NA,1243,1278,0,0,0,1278,A
6-NA,1244,1282,0,0,0,1282,A
6-NA,1245,1281,0,1,0,1282,A
6-NA,1246,1281,0,5,0,1286,A
6-NA,1247,0,0,1288,0,1288,G
6-NA,1248,0,1,0,1281,1282,C
6-NA,1249,0,1257,0,5,1262,T
6-NA,1250,6,0,1274,0,1280,G
6-NA,1251,0,2,0,1268,1270,C
6-NA,1252,1276,0,1,1,1278,A
6-NA,1253,0,1271,0,2,1273,T
6-NA,1254,0,2,1,1263,1266,C
6-NA,1255,1259,0,1,0,1260,A
6-NA,1256,1261,0,0,0,1261,A
6-NA,1257,0,1262,0,0,1262,T
6-NA,1258,0,1,0,1253,1254,C
6-NA,1259,2,3,1227,0,1232,G
6-NA,1260,0,1,1258,0,1259,G
6-NA,1261,0,1261,0,3,1264,T
6-NA,1262,1,1,1269,0,1271,G
6-NA,1263,1,0,0,1277,1278,C
6-NA,1264,0,1264,0,3,1267,T
6-NA,1265,0,1284,0,0,1284,T
6-NA,1266,0,1286,0,0,1286,T
6-NA,1267,0,1292,0,0,1292,T
6-NA,1268,1301,0,0,0,1301,A
6-NA,1269,0,1244,0,1,1245,T
6-NA,1270,0,1,1247,0,1248,G
6-NA,1271,2,1227,0,1,1230,T
6-NA,1272,1,0,1212,0,1213,G
6-NA,1273,0,2,1232,0,1234,G
6-NA,1274,1200,1,0,0,1201,A
6-NA,1275,1,0,1212,0,1213,G
6-NA,1276,0,1210,0,1,1211,T
6-NA,1277,0,1194,0,2,1196,T
6-NA,1278,0,0,1206,0,1206,G
6-NA,1279,1202,1,1,0,1204,A
6-NA,1280,0,1204,0,0,1204,T
6-NA,1281,1198,1,0,0,1199,A
6-NA,1282,1159,0,2,0,1161,A
6-NA,1283,0,0,1170,0,1170,G
6-NA,1284,1,2,1141,0,1144,G
6-NA,1285,0,1,1139,0,1140,G
6-NA,1286,0,0,1133,0,1133,G
6-NA,1287,1107,0,0,0,1107,A
6-NA,1288,1104,0,1,1,1106,A
6-NA,1289,0,0,1116,0,1116,G
6-NA,1290,1111,0,1,0,1112,A
6-NA,1291,1111,0,0,0,1111,A
6-NA,1292,1089,0,1,0,1090,A
6-NA,1293,1068,0,2,0,1070,A
6-NA,1294,0,1,1069,0,1070,G
6-NA,1295,1057,0,4,0,1061,A
6-NA,1296,1,2,1056,0,1059,G
6-NA,1297,1,3,1055,0,1059,G
6-NA,1298,1050,1,0,0,1051,A
6-NA,1299,1052,0,0,0,1052,A
6-NA,1300,1053,0,0,0,1053,A
6-NA,1301,0,0,0,1054,1054,C
6-NA,1302,0,1052,0,0,1052,T
6-NA,1303,0,1,1057,0,1058,G
6-NA,1304,1050,1,1,0,1052,A
6-NA,1305,1051,0,1,0,1052,A
6-NA,1306,0,0,1053,0,1053,G
6-NA,1307,0,1039,0,2,1041,T
6-NA,1308,0,0,0,1048,1048,C
6-NA,1309,0,1034,0,5,1039,T
6-NA,1310,1,1026,0,2,1029,T
6-NA,1311,0,0,1028,0,1028,G
6-NA,1312,1,1022,0,1,1024,T
6-NA,1313,1,2,1022,1,1026,G
6-NA,1314,0,0,1022,0,1022,G
6-NA,1315,1002,0,1,0,1003,A
6-NA,1316,1,0,0,1011,1012,C
6-NA,1317,0,1,0,983,984,C
6-NA,1318,0,976,0,1,977,T
6-NA,1319,1,1,0,985,987,C
6-NA,1320,989,0,0,0,989,A
6-NA,1321,989,0,2,0,991,A
6-NA,1322,990,0,0,0,990,A
6-NA,1323,0,0,0,1004,1004,C
6-NA,1324,976,0,2,0,978,A
6-NA,1325,1,0,994,0,995,G
6-NA,1326,1,983,0,1,985,T
6-NA,1327,986,0,1,0,987,A
6-NA,1328,0,988,0,1,989,T
6-NA,1329,1,963,0,0,964,T
6-NA,1330,0,0,967,0,967,G
6-NA,1331,0,964,0,1,965,T
6-NA,1332,0,922,0,0,922,T
6-NA,1333,0,0,924,0,924,G
6-NA,1334,0,853,0,1,854,T
6-NA,1335,0,0,856,0,856,G
6-NA,1336,0,844,2,1,847,T
6-NA,1337,0,836,0,1,837,T
6-NA,1338,1,836,1,0,838,T
6-NA,1339,0,824,0,0,824,T
6-NA,1340,0,0,826,0,826,G
6-NA,1341,0,824,0,0,824,T
6-NA,1342,0,1,819,0,820,G
6-NA,1343,0,0,818,0,818,G
6-NA,1344,0,2,0,802,804,C
6-NA,1345,804,0,1,0,805,A
6-NA,1346,0,0,0,811,811,C
6-NA,1347,2,0,0,807,809,C
6-NA,1348,0,810,0,0,810,T
6-NA,1349,2,0,0,816,818,C
6-NA,1350,814,0,1,0,815,A
6-NA,1351,0,0,821,0,821,G
6-NA,1352,0,0,825,0,825,G
6-NA,1353,0,815,0,0,815,T
6-NA,1354,809,0,2,0,811,A
6-NA,1355,0,1,0,774,775,C
6-NA,1356,773,0,3,0,776,A
6-NA,1357,0,776,0,0,776,T
6-NA,1358,754,0,2,0,756,A
6-NA,1359,0,754,0,1,755,T
6-NA,1360,1,0,685,0,686,G
6-NA,1361,0,0,693,0,693,G
6-NA,1362,689,0,1,0,690,A
6-NA,1363,685,0,0,0,685,A
6-NA,1364,2,0,0,675,677,C
6-NA,1365,576,0,0,1,577,A
6-NA,1366,0,0,576,0,576,G
6-NA,1367,0,0,575,0,575,G
6-NA,1368,1,0,0,574,575,C
6-NA,1369,0,571,0,3,574,T
6-NA,1370,0,0,0,543,543,C
6-NA,1371,538,0,1,0,539,A
6-NA,1372,0,540,0,0,540,T
6-NA,1373,0,1,542,0,543,G
6-NA,1374,1,0,542,0,543,G
6-NA,1375,0,0,0,526,526,C
6-NA,1376,1,1,0,522,524,C
6-NA,1377,0,501,0,0,501,T
6-NA,1378,0,1,498,0,499,G
6-NA,1379,497,0,0,0,497,A
6-NA,1380,0,497,0,0,497,T
6-NA,1381,0,0,490,0,490,G
6-NA,1382,0,0,479,0,479,G
6-NA,1383,0,0,458,0,458,G
6-NA,1384,0,0,458,0,458,G
6-NA,1385,0,0,0,447,447,C
6-NA,1386,0,1,444,0,445,G
6-NA,1387,0,0,440,0,440,G
6-NA,1388,432,0,0,0,432,A
6-NA,1389,0,0,0,431,431,C
6-NA,1390,431,0,0,0,431,A
6-NA,1391,0,421,1,1,423,T
6-NA,1392,1,0,0,417,418,C
6-NA,1393,418,0,0,0,418,A
6-NA,1394,414,0,1,0,415,A
6-NA,1395,0,418,0,0,418,T
6-NA,1396,0,1,0,411,412,C
6-NA,1397,0,401,0,2,403,T
6-NA,1398,0,0,0,341,341,C
6-NA,1399,339,0,1,0,340,A
6-NA,1400,0,336,0,0,336,T
6-NA,1401,0,0,336,0,336,G
6-NA,1402,0,0,0,329,329,C
6-NA,1403,2,1,0,314,317,C
6-NA,1404,0,288,0,0,288,T
6-NA,1405,285,0,0,0,285,A
6-NA,1406,0,285,0,0,285,T
6-NA,1407,285,0,0,0,285,A
6-NA,1408,0,283,0,0,283,T
6-NA,1409,262,0,0,0,262,A
6-NA,1410,249,0,0,0,249,A
7-M,1,88,0,0,0,88,A
7-M,2,0,91,0,0,91,T
7-M,3,0,0,92,0,92,G
7-M,4,92,0,0,0,92,A
7-M,5,0,0,100,0,100,G
7-M,6,0,0,0,108,108,C
7-M,7,0,0,0,114,114,C
7-M,8,0,147,0,1,148,T
7-M,9,0,146,0,1,147,T
7-M,10,0,0,0,149,149,C
7-M,11,0,150,0,0,150,T
7-M,12,151,0,0,0,151,A
7-M,13,154,0,0,0,154,A
7-M,14,0,0,0,154,154,C
7-M,15,0,0,0,154,154,C
7-M,16,0,0,154,0,154,G
7-M,17,153,0,0,0,153,A
7-M,18,0,0,156,0,156,G
7-M,19,0,0,161,0,161,G
7-M,20,0,162,0,0,162,T
7-M,21,0,0,0,163,163,C
7-M,22,1,1,163,0,165,G
7-M,23,170,0,1,0,171,A
7-M,24,173,0,0,0,173,A
7-M,25,176,0,0,0,176,A
7-M,26,0,0,0,192,192,C
7-M,27,0,0,194,0,194,G
7-M,28,0,195,0,0,195,T
7-M,29,196,0,0,0,196,A
7-M,30,0,200,0,0,200,T
7-M,31,0,0,209,0,209,G
7-M,32,0,212,0,0,212,T
7-M,33,0,233,0,0,233,T
7-M,34,0,0,0,245,245,C
7-M,35,0,246,0,0,246,T
7-M,36,0,0,0,265,265,C
7-M,37,0,265,0,0,265,T
7-M,38,0,0,0,299,299,C
7-M,39,0,298,0,0,298,T
7-M,40,301,0,0,0,301,A
7-M,41,0,302,0,0,302,T
7-M,42,0,13,0,291,304,C
7-M,43,0,0,308,0,308,G
7-M,44,0,310,0,1,311,T
7-M,45,0,308,0,1,309,T
7-M,46,0,0,0,314,314,C
7-M,47,1,0,0,324,325,C
7-M,48,325,1,0,0,326,A
7-M,49,0,325,0,0,325,T
7-M,50,0,1,0,324,325,C
7-M,51,325,0,1,0,326,A
7-M,52,0,0,330,0,330,G
7-M,53,0,1,329,0,330,G
7-M,54,0,0,0,333,333,C
7-M,55,0,0,1,332,333,C
7-M,56,2,0,0,335,337,C
7-M,57,0,0,0,349,349,C
7-M,58,0,0,0,355,355,C
7-M,59,0,351,0,1,352,T
7-M,60,0,0,0,354,354,C
7-M,61,355,0,0,0,355,A
7-M,62,355,0,1,0,356,A
7-M,63,359,0,1,0,360,A
7-M,64,0,0,366,0,366,G
7-M,65,0,0,0,363,363,C
7-M,66,0,0,0,361,361,C
7-M,67,1,0,360,0,361,G
7-M,68,360,0,0,0,360,A
7-M,69,0,0,361,0,361,G
7-M,70,367,0,0,0,367,A
7-M,71,0,364,0,0,364,T
7-M,72,0,0,0,367,367,C
7-M,73,0,0,367,0,367,G
7-M,74,0,0,0,369,369,C
7-M,75,0,0,369,0,369,G
7-M,76,0,0,0,369,369,C
7-M,77,369,0,0,0,369,A
7-M,78,0,0,371,0,371,G
7-M,79,370,0,1,0,371,A
7-M,80,0,0,403,1,404,G
7-M,81,398,0,1,1,400,A
7-M,82,1,0,0,408,409,C
7-M,83,0,410,0,0,410,T
7-M,84,0,410,0,0,410,T
7-M,85,0,0,416,0,416,G
7-M,86,417,0,0,0,417,A
7-M,87,414,0,1,0,415,A
7-M,88,0,1,416,0,417,G
7-M,89,404,0,1,0,405,A
7-M,90,0,415,0,0,415,T
7-M,91,0,0,416,0,416,G
7-M,92,0,416,0,0,416,T
7-M,93,1,1,0,416,418,C
7-M,94,0,414,0,0,414,T
7-M,95,0,416,0,0,416,T
7-M,96,0,416,0,0,416,T
7-M,97,0,0,416,0,416,G
7-M,98,0,0,0,415,415,C
7-M,99,0,414,0,0,414,T
7-M,100,0,0,413,0,413,G
7-M,101,0,0,416,0,416,G
7-M,102,0,1,418,0,419,G
7-M,103,416,0,1,0,417,A
7-M,104,414,0,0,1,415,A
7-M,105,420,0,0,0,420,A
7-M,106,422,0,1,0,423,A
7-M,107,424,0,1,0,425,A
7-M,108,0,0,0,429,429,C
7-M,109,428,0,0,0,428,A
7-M,110,1,1,0,429,431,C
7-M,111,429,0,0,0,429,A
7-M,112,0,0,443,0,443,G
7-M,113,451,0,1,0,452,A
7-M,114,0,456,0,0,456,T
7-M,115,0,0,0,461,461,C
7-M,116,0,460,0,0,460,T
7-M,117,0,460,0,1,461,T
7-M,118,0,0,460,0,460,G
7-M,119,457,0,0,0,457,A
7-M,120,0,1,460,0,461,G
7-M,121,0,0,461,0,461,G
7-M,122,0,0,0,466,466,C
7-M,123,0,460,0,1,461,T
7-M,124,0,0,0,522,522,C
7-M,125,0,521,0,0,521,T
7-M,126,1,1,0,522,524,C
7-M,127,523,0,1,0,524,A
7-M,128,0,524,0,0,524,T
7-M,129,0,0,524,0,524,G
7-M,130,0,0,529,0,529,G
7-M,131,525,0,1,0,526,A
7-M,132,526,0,1,0,527,A
7-M,133,0,513,0,0,513,T
7-M,134,1,1,536,0,538,G
7-M,135,0,0,564,0,564,G
7-M,136,0,0,0,565,565,C
7-M,137,0,564,0,1,565,T
7-M,138,565,0,0,0,565,A
7-M,139,562,1,0,0,563,A
7-M,140,576,0,0,0,576,A
7-M,141,0,1,586,0,587,G
7-M,142,586,0,1,0,587,A
7-M,143,0,0,0,584,584,C
7-M,144,572,1,0,0,573,A
7-M,145,573,0,2,0,575,A
7-M,146,1,0,590,0,591,G
7-M,147,590,1,0,0,591,A
7-M,148,1,0,0,592,593,C
7-M,149,1,0,0,586,587,C
7-M,150,588,0,0,0,588,A
7-M,151,597,0,0,0,597,A
7-M,152,0,597,0,1,598,T
7-M,153,0,600,0,0,600,T
7-M,154,2,0,0,605,607,C
7-M,155,0,602,0,0,602,T
7-M,156,1,0,602,0,603,G
7-M,157,0,603,0,0,603,T
7-M,158,0,0,0,599,599,C
7-M,159,605,0,0,0,605,A
7-M,160,0,0,0,622,622,C
7-M,161,2,0,0,619,621,C
7-M,162,0,618,0,0,618,T
7-M,163,2,0,1,620,623,C
7-M,164,0,620,0,0,620,T
7-M,165,0,1,635,0,636,G
7-M,166,636,0,0,0,636,A
7-M,167,1,1,0,636,638,C
7-M,168,0,633,0,0,633,T
7-M,169,628,0,0,0,628,A
7-M,170,621,0,0,0,621,A
7-M,171,1,1,622,0,624,G
7-M,172,0,1,626,0,627,G
7-M,173,0,0,626,0,626,G
7-M,174,0,0,619,1,620,G
7-M,175,635,0,1,0,636,A
7-M,176,0,637,0,0,637,T
7-M,177,0,635,0,0,635,T
7-M,178,0,637,0,0,637,T
7-M,179,0,637,0,0,637,T
7-M,180,0,3,632,0,635,G
7-M,181,0,0,634,0,634,G
7-M,182,0,1,629,0,630,G
7-M,183,0,0,635,0,635,G
7-M,184,0,623,1,2,626,T
7-M,185,2,622,0,1,625,T
7-M,186,0,625,0,1,626,T
7-M,187,1,0,642,0,643,G
7-M,188,0,642,0,0,642,T
7-M,189,0,0,649,0,649,G
7-M,190,0,648,0,1,649,T
7-M,191,0,643,0,2,645,T
7-M,192,2,0,0,650,652,C
7-M,193,651,0,0,0,651,A
7-M,194,0,1,0,669,670,C
7-M,195,1,1,667,0,669,G
7-M,196,1,0,0,665,666,C
7-M,197,0,660,0,2,662,T
7-M,198,0,0,0,682,682,C
7-M,199,685,1,0,0,686,A
7-M,200,1,1,0,691,693,C
7-M,201,0,2,0,690,692,C
7-M,202,0,0,695,0,695,G
7-M,203,0,694,0,1,695,T
7-M,204,0,0,693,0,693,G
7-M,205,0,0,0,694,694,C
7-M,206,1,0,0,691,692,C
7-M,207,0,0,0,695,695,C
7-M,208,689,0,0,0,689,A
7-M,209,0,0,698,0,698,G
7-M,210,0,695,0,0,695,T
7-M,211,0,1,699,0,700,G
7-M,212,715,0,1,0,716,A
7-M,213,0,0,718,0,718,G
7-M,214,0,0,0,714,714,C
7-M,215,0,3,709,0,712,G
7-M,216,709,1,1,0,711,A
7-M,217,0,0,718,0,718,G
7-M,218,0,2,724,0,726,G
7-M,219,724,0,0,0,724,A
7-M,220,0,1,0,731,732,C
7-M,221,0,725,0,0,725,T
7-M,222,0,1,728,0,729,G
7-M,223,0,1,0,727,728,C
7-M,224,731,0,1,0,732,A
7-M,225,0,0,756,0,756,G
7-M,226,0,0,0,756,756,C
7-M,227,0,1,761,0,762,G
7-M,228,0,764,0,0,764,T
7-M,229,756,0,1,0,757,A
7-M,230,0,0,759,0,759,G
7-M,231,754,0,1,0,755,A
7-M,232,0,0,0,760,760,C
7-M,233,0,0,759,0,759,G
7-M,234,0,1,0,759,760,C
7-M,235,0,744,0,1,745,T
7-M,236,0,746,0,1,747,T
7-M,237,0,746,0,0,746,T
7-M,238,1,0,777,0,778,G
7-M,239,0,777,0,0,777,T
7-M,240,0,2,0,775,777,C
7-M,241,1,1,0,771,773,C
7-M,242,776,0,0,0,776,A
7-M,243,777,0,0,0,777,A
7-M,244,777,0,1,0,778,A
7-M,245,778,0,0,0,778,A
7-M,246,0,777,0,1,778,T
7-M,247,0,0,779,0,779,G
7-M,248,0,0,1,776,777,C
7-M,249,1,0,0,774,775,C
7-M,250,0,0,0,783,783,C
7-M,251,0,780,0,0,780,T
7-M,252,0,0,0,804,804,C
7-M,253,807,0,0,0,807,A
7-M,254,807,0,0,0,807,A
7-M,255,0,810,0,0,810,T
7-M,256,1,0,814,0,815,G
7-M,257,1,1,816,0,818,G
7-M,258,0,0,824,0,824,G
7-M,259,817,0,1,0,818,A
7-M,260,819,0,1,0,820,A
7-M,261,0,805,0,0,805,T
7-M,262,0,1,800,0,801,G
7-M,263,0,2,804,0,806,G
7-M,264,795,0,3,0,798,A
7-M,265,0,0,799,0,799,G
7-M,266,792,0,0,0,792,A
7-M,267,0,0,0,781,781,C
7-M,268,2,2,0,817,821,C
7-M,269,1,1,0,832,834,C
7-M,270,844,0,0,0,844,A
7-M,271,844,0,0,0,844,A
7-M,272,843,0,0,0,843,A
7-M,273,1,850,0,0,851,T
7-M,274,875,0,0,0,875,A
7-M,275,876,0,1,0,877,A
7-M,276,0,0,0,857,857,C
7-M,277,856,0,1,0,857,A
7-M,278,0,853,0,2,855,T
7-M,279,0,3,864,0,867,G
7-M,280,0,0,868,0,868,G
7-M,281,863,0,3,0,866,A
7-M,282,0,0,0,870,870,C
7-M,283,852,0,0,0,852,A
7-M,284,855,0,1,0,856,A
7-M,285,847,0,1,0,848,A
7-M,286,0,0,865,1,866,G
7-M,287,0,0,0,888,888,C
7-M,288,862,2,0,0,864,A
7-M,289,1,0,880,0,881,G
7-M,290,1,873,0,3,877,T
7-M,291,0,878,0,0,878,T
7-M,292,881,0,0,0,881,A
7-M,293,878,0,0,0,878,A
7-M,294,881,0,3,0,884,A
7-M,295,0,0,0,906,906,C
7-M,296,0,881,0,0,881,T
7-M,297,0,1,975,0,976,G
7-M,298,0,961,1,0,962,T
7-M,299,967,0,1,0,968,A
7-M,300,0,973,0,0,973,T
7-M,301,967,0,0,0,967,A
7-M,302,0,3,961,0,964,G
7-M,303,0,0,962,0,962,G
7-M,304,959,0,1,0,960,A
7-M,305,962,0,0,1,963,A
7-M,306,929,0,3,0,932,A
7-M,307,0,0,0,941,941,C
7-M,308,0,935,0,0,935,T
7-M,309,0,931,0,1,932,T
7-M,310,934,0,0,0,934,A
7-M,311,935,0,0,0,935,A
7-M,312,1,2,931,0,934,G
7-M,313,927,0,0,0,927,A
7-M,314,0,1,928,0,929,G
7-M,315,897,2,1,0,900,A
7-M,316,0,1,920,0,921,G
7-M,317,927,0,1,0,928,A
7-M,318,1,0,935,0,936,G
7-M,319,940,0,3,0,943,A
7-M,320,0,942,0,0,942,T
7-M,321,944,0,2,0,946,A
7-M,322,945,0,0,0,945,A
7-M,323,0,0,0,952,952,C
7-M,324,0,0,958,0,958,G
7-M,325,0,953,0,1,954,T
7-M,326,0,943,0,1,944,T
7-M,327,1,1,0,948,950,C
7-M,328,0,2,0,942,944,C
7-M,329,946,0,1,0,947,A
7-M,330,0,939,0,5,944,T
7-M,331,0,0,935,0,935,G
7-M,332,0,2,934,0,936,G
7-M,333,1,2,933,0,936,G
7-M,334,0,2,934,0,936,G
7-M,335,1,0,0,934,935,C
7-M,336,0,1,2,934,937,C
7-M,337,938,2,2,0,942,A
7-M,338,949,0,2,0,951,A
7-M,339,946,0,5,0,951,A
7-M,340,0,1,958,0,959,G
7-M,341,955,0,0,0,955,A
7-M,342,948,0,0,0,948,A
7-M,343,946,0,1,0,947,A
7-M,344,0,948,0,0,948,T
7-M,345,940,0,1,0,941,A
7-M,346,0,0,946,0,946,G
7-M,347,0,1,0,937,938,C
7-M,348,0,932,0,2,934,T
7-M,349,2,1,0,932,935,C
7-M,350,0,929,0,1,930,T
7-M,351,1,0,0,957,958,C
7-M,352,956,0,0,1,957,A
7-M,353,0,0,957,0,957,G
7-M,354,0,948,0,1,949,T
7-M,355,0,960,0,1,961,T
7-M,356,964,0,0,0,964,A
7-M,357,0,965,0,1,966,T
7-M,358,0,963,0,0,963,T
7-M,359,1,0,0,967,968,C
7-M,360,0,938,0,0,938,T
7-M,361,1,0,957,0,958,G
7-M,362,0,0,0,953,953,C
7-M,363,0,950,0,1,951,T
7-M,364,0,5,943,0,948,G
7-M,365,1,0,947,0,948,G
7-M,366,0,949,0,0,949,T
7-M,367,1,1,949,0,951,G
7-M,368,0,0,2,942,944,C
7-M,369,950,0,0,0,950,A
7-M,370,0,0,0,958,958,C
7-M,371,0,950,0,0,950,T
7-M,372,0,956,0,1,957,T
7-M,373,0,2,956,0,958,G
7-M,374,0,0,0,959,959,C
7-M,375,3,0,0,954,957,C
7-M,376,956,0,0,1,957,A
7-M,377,1,0,975,0,976,G
7-M,378,0,976,0,1,977,T
7-M,379,0,972,0,1,973,T
7-M,380,0,0,970,0,970,G
7-M,381,0,948,0,0,948,T
7-M,382,977,0,1,0,978,A
7-M,383,0,976,0,2,978,T
7-M,384,0,0,975,0,975,G
7-M,385,1,0,988,0,989,G
7-M,386,0,0,981,0,981,G
7-M,387,0,0,0,986,986,C
7-M,388,0,0,0,1003,1003,C
7-M,389,0,983,0,2,985,T
7-M,390,1,1,0,1005,1007,C
7-M,391,1044,0,0,0,1044,A
7-M,392,0,1046,0,0,1046,T
7-M,393,1074,1,0,0,1075,A
7-M,394,0,1072,0,0,1072,T
7-M,395,1061,0,1,1,1063,A
7-M,396,0,2,0,1117,1119,C
7-M,397,1081,0,0,0,1081,A
7-M,398,1081,0,2,0,1083,A
7-M,399,0,1068,0,0,1068,T
7-M,400,1019,0,2,0,1021,A
7-M,401,0,1,1034,0,1035,G
7-M,402,1,1,1019,0,1021,G
7-M,403,1011,0,1,0,1012,A
7-M,404,0,1009,1,0,1010,T
7-M,405,0,1,942,0,943,G
7-M,406,1,1,939,0,941,G
7-M,407,0,1,938,0,939,G
7-M,408,0,3,951,0,954,G
7-M,409,0,0,953,0,953,G
7-M,410,0,0,0,950,950,C
7-M,411,0,935,1,1,937,T
7-M,412,1,1,939,0,941,G
7-M,413,0,941,1,0,942,T
7-M,414,940,0,1,1,942,A
7-M,415,939,0,1,0,940,A
7-M,416,0,0,0,954,954,C
7-M,417,1,0,0,942,943,C
7-M,418,937,0,0,1,938,A
7-M,419,1,1,0,936,938,C
7-M,420,0,934,0,0,934,T
7-M,421,2,1,940,0,943,G
7-M,422,939,0,0,1,940,A
7-M,423,938,0,0,1,939,A
7-M,424,0,0,940,0,940,G
7-M,425,1,926,0,1,928,T
7-M,426,0,0,929,0,929,G
7-M,427,1,1,929,0,931,G
7-M,428,0,2,0,932,934,C
7-M,429,931,0,0,0,931,A
7-M,430,0,927,0,0,927,T
7-M,431,0,923,0,3,926,T
7-M,432,0,929,0,0,929,T
7-M,433,0,0,949,0,949,G
7-M,434,0,0,954,0,954,G
7-M,435,0,0,0,953,953,C
7-M,436,0,0,0,951,951,C
7-M,437,0,941,0,1,942,T
7-M,438,0,0,975,1,976,G
7-M,439,0,0,988,0,988,G
7-M,440,0,990,0,0,990,T
7-M,441,989,0,0,0,989,A
7-M,442,0,951,0,0,951,T
7-M,443,2,0,969,0,971,G
7-M,444,0,967,0,0,967,T
7-M,445,0,0,968,0,968,G
7-M,446,0,0,0,971,971,C
7-M,447,930,0,2,0,932,A
7-M,448,930,0,1,0,931,A
7-M,449,1,0,0,943,944,C
7-M,450,935,0,0,0,935,A
7-M,451,0,940,0,0,940,T
7-M,452,0,1,930,0,931,G
7-M,453,0,906,0,1,907,T
7-M,454,0,3,903,0,906,G
7-M,455,905,0,2,0,907,A
7-M,456,0,0,909,0,909,G
7-M,457,0,0,0,905,905,C
7-M,458,881,0,0,0,881,A
7-M,459,0,0,889,0,889,G
7-M,460,884,0,1,0,885,A
7-M,461,0,891,0,0,891,T
7-M,462,0,892,0,0,892,T
7-M,463,0,0,897,0,897,G
7-M,464,0,0,1,895,896,C
7-M,465,0,889,0,1,890,T
7-M,466,1,4,884,0,889,G
7-M,467,891,0,0,0,891,A
7-M,468,0,1,0,925,926,C
7-M,469,0,927,0,3,930,T
7-M,470,2,0,0,923,925,C
7-M,471,0,3,0,918,921,C
7-M,472,2,1,0,926,929,C
7-M,473,926,1,1,0,928,A
7-M,474,0,0,934,0,934,G
7-M,475,1,0,0,932,933,C
7-M,476,929,1,1,0,931,A
7-M,477,0,0,0,932,932,C
7-M,478,878,0,0,0,878,A
7-M,479,0,1,887,0,888,G
7-M,480,0,0,891,0,891,G
7-M,481,0,894,0,0,894,T
7-M,482,1,0,0,907,908,C
7-M,483,0,900,0,0,900,T
7-M,484,1,0,0,905,906,C
7-M,485,905,0,0,0,905,A
7-M,486,0,906,0,1,907,T
7-M,487,905,0,2,1,908,A
7-M,488,0,0,891,0,891,G
7-M,489,1,0,885,0,886,G
7-M,490,1,0,0,882,883,C
7-M,491,840,0,1,0,841,A
7-M,492,0,1,835,0,836,G
7-M,493,842,0,0,0,842,A
7-M,494,0,844,0,0,844,T
7-M,495,0,0,845,0,845,G
7-M,496,0,0,845,0,845,G
7-M,497,1,829,0,0,830,T
7-M,498,0,1,839,0,840,G
7-M,499,0,0,848,0,848,G
7-M,500,1,0,0,845,846,C
7-M,501,840,0,1,0,841,A
7-M,502,840,0,1,0,841,A
7-M,503,1,0,0,850,851,C
7-M,504,849,0,0,0,849,A
7-M,505,850,0,0,0,850,A
7-M,506,1,0,0,846,847,C
7-M,507,1,0,0,839,840,C
7-M,508,837,0,0,0,837,A
7-M,509,836,0,1,0,837,A
7-M,510,0,837,0,0,837,T
7-M,511,0,0,0,840,840,C
7-M,512,0,1,0,828,829,C
7-M,513,813,0,0,0,813,A
7-M,514,0,813,0,1,814,T
7-M,515,0,815,0,1,816,T
7-M,516,821,0,0,0,821,A
7-M,517,823,0,0,0,823,A
7-M,518,1,822,0,0,823,T
7-M,519,818,0,0,0,818,A
7-M,520,816,0,0,0,816,A
7-M,521,809,0,1,0,810,A
7-M,522,817,0,0,0,817,A
7-M,523,0,0,0,836,836,C
7-M,524,834,0,1,0,835,A
7-M,525,0,830,0,1,831,T
7-M,526,1,2,830,0,833,G
7-M,527,826,0,3,0,829,A
7-M,528,0,1,833,0,834,G
7-M,529,827,0,2,0,829,A
7-M,530,834,0,0,1,835,A
7-M,531,0,0,0,836,836,C
7-M,532,812,0,0,0,812,A
7-M,533,1,0,823,0,824,G
7-M,534,817,0,1,0,818,A
7-M,535,819,0,1,0,820,A
7-M,536,0,816,0,0,816,T
7-M,537,0,1,814,0,815,G
7-M,538,0,0,817,0,817,G
7-M,539,1,803,0,1,805,T
7-M,540,0,791,0,2,793,T
7-M,541,0,806,0,0,806,T
7-M,542,0,808,0,0,808,T
7-M,543,0,0,822,0,822,G
7-M,544,0,0,824,0,824,G
7-M,545,1,1,1,820,823,C
7-M,546,3,1,0,820,824,C
7-M,547,812,0,1,1,814,A
7-M,548,0,0,844,0,844,G
7-M,549,0,0,0,849,849,C
7-M,550,851,0,1,0,852,A
7-M,551,0,0,0,863,863,C
7-M,552,0,851,0,1,852,T
7-M,553,852,0,3,1,856,A
7-M,554,0,0,0,862,862,C
7-M,555,869,0,5,0,874,A
7-M,556,0,0,885,0,885,G
7-M,557,0,0,0,854,854,C
7-M,558,0,843,0,1,844,T
7-M,559,841,1,0,0,842,A
7-M,560,825,0,1,0,826,A
7-M,561,0,0,833,1,834,G
7-M,562,0,1,839,0,840,G
7-M,563,0,0,0,834,834,C
7-M,564,0,788,0,0,788,T
7-M,565,789,0,0,0,789,A
7-M,566,1,784,0,0,785,T
7-M,567,0,0,787,0,787,G
7-M,568,0,0,789,0,789,G
7-M,569,774,0,1,0,775,A
7-M,570,0,0,777,0,777,G
7-M,571,0,1,0,765,766,C
7-M,572,758,0,0,0,758,A
7-M,573,757,0,0,0,757,A
7-M,574,751,0,1,0,752,A
7-M,575,0,760,0,1,761,T
7-M,576,0,2,762,0,764,G
7-M,577,1,0,755,0,756,G
7-M,578,0,0,0,756,756,C
7-M,579,0,746,0,1,747,T
7-M,580,1,0,747,0,748,G
7-M,581,0,2,750,0,752,G
7-M,582,751,0,0,0,751,A
7-M,583,0,745,0,0,745,T
7-M,584,0,0,0,742,742,C
7-M,585,741,0,1,0,742,A
7-M,586,746,0,1,0,747,A
7-M,587,0,0,751,0,751,G
7-M,588,0,748,0,1,749,T
7-M,589,1,1,746,0,748,G
7-M,590,742,0,0,0,742,A
7-M,591,735,0,1,0,736,A
7-M,592,0,0,0,738,738,C
7-M,593,740,0,0,0,740,A
7-M,594,0,0,744,0,744,G
7-M,595,0,0,737,0,737,G
7-M,596,0,0,0,734,734,C
7-M,597,727,1,1,0,729,A
7-M,598,0,0,735,0,735,G
7-M,599,0,0,0,731,731,C
7-M,600,0,1,730,0,731,G
7-M,601,0,2,727,0,729,G
7-M,602,723,0,2,0,725,A
7-M,603,0,0,731,0,731,G
7-M,604,1,0,744,0,745,G
7-M,605,0,1,0,739,740,C
7-M,606,2,1,0,740,743,C
7-M,607,731,0,2,0,733,A
7-M,608,0,731,0,1,732,T
7-M,609,0,1,731,0,732,G
7-M,610,0,0,734,0,734,G
7-M,611,728,0,2,0,730,A
7-M,612,0,0,729,0,729,G
7-M,613,713,0,0,0,713,A
7-M,614,1,732,0,1,734,T
7-M,615,0,725,0,0,725,T
7-M,616,1,0,731,0,732,G
7-M,617,0,1,0,731,732,C
7-M,618,0,729,0,1,730,T
7-M,619,730,0,1,0,731,A
7-M,620,0,0,731,0,731,G
7-M,621,1,725,0,1,727,T
7-M,622,1,0,0,728,729,C
7-M,623,708,0,0,0,708,A
7-M,624,0,0,715,0,715,G
7-M,625,0,0,714,0,714,G
7-M,626,0,0,0,716,716,C
7-M,627,0,0,0,714,714,C
7-M,628,712,1,0,0,713,A
7-M,629,0,0,726,0,726,G
7-M,630,0,0,730,0,730,G
7-M,631,0,0,0,729,729,C
7-M,632,731,0,1,0,732,A
7-M,633,1,0,721,0,722,G
7-M,634,717,0,2,0,719,A
7-M,635,0,719,0,0,719,T
7-M,636,0,0,729,0,729,G
7-M,637,0,0,742,0,742,G
7-M,638,0,737,0,0,737,T
7-M,639,0,0,736,0,736,G
7-M,640,0,0,0,734,734,C
7-M,641,727,0,1,0,728,A
7-M,642,0,2,740,0,742,G
7-M,643,0,0,737,0,737,G
7-M,644,0,0,0,739,739,C
7-M,645,738,0,0,0,738,A
7-M,646,722,0,0,0,722,A
7-M,647,0,713,0,1,714,T
7-M,648,0,0,716,0,716,G
7-M,649,707,1,1,0,709,A
7-M,650,0,0,720,0,720,G
7-M,651,702,1,0,0,703,A
7-M,652,0,0,704,0,704,G
7-M,653,0,0,0,710,710,C
7-M,654,0,1,0,718,719,C
7-M,655,716,0,0,0,716,A
7-M,656,0,719,0,0,719,T
7-M,657,0,715,0,1,716,T
7-M,658,0,1,717,0,718,G
7-M,659,1,1,712,0,714,G
7-M,660,0,1,715,0,716,G
7-M,661,716,1,0,0,717,A
7-M,662,0,0,0,716,716,C
7-M,663,0,688,1,0,689,T
7-M,664,2,0,0,692,694,C
7-M,665,699,0,0,0,699,A
7-M,666,0,724,0,2,726,T
7-M,667,2,0,0,724,726,C
7-M,668,0,0,0,726,726,C
7-M,669,0,722,0,0,722,T
7-M,670,722,0,0,0,722,A
7-M,671,0,0,721,0,721,G
7-M,672,0,762,0,0,762,T
7-M,673,0,755,0,0,755,T
7-M,674,0,0,0,752,752,C
7-M,675,0,1,0,719,720,C
7-M,676,720,0,0,0,720,A
7-M,677,0,0,734,0,734,G
7-M,678,1,735,0,1,737,T
7-M,679,731,0,0,0,731,A
7-M,680,1,2,0,726,729,C
7-M,681,0,683,0,1,684,T
7-M,682,1,2,710,0,713,G
7-M,683,1,0,712,0,713,G
7-M,684,0,711,0,2,713,T
7-M,685,0,698,0,1,699,T
7-M,686,0,712,0,1,713,T
7-M,687,709,0,0,0,709,A
7-M,688,715,0,0,0,715,A
7-M,689,0,0,719,0,719,G
7-M,690,698,0,2,0,700,A
7-M,691,0,0,693,0,693,G
7-M,692,670,0,0,0,670,A
7-M,693,0,661,0,2,663,T
7-M,694,0,3,658,0,661,G
7-M,695,662,1,1,0,664,A
7-M,696,0,660,0,0,660,T
7-M,697,0,1,0,664,665,C
7-M,698,0,651,1,0,652,T
7-M,699,0,659,0,0,659,T
7-M,700,0,0,0,662,662,C
7-M,701,0,660,0,0,660,T
7-M,702,0,661,0,0,661,T
7-M,703,2,0,658,1,661,G
7-M,704,658,0,0,1,659,A
7-M,705,658,0,0,0,658,A
7-M,706,662,0,0,0,662,A
7-M,707,664,0,0,0,664,A
7-M,708,0,661,0,0,661,T
7-M,709,0,665,0,0,665,T
7-M,710,0,666,0,1,667,T
7-M,711,0,0,664,0,664,G
7-M,712,0,2,0,665,667,C
7-M,713,662,0,1,0,663,A
7-M,714,0,2,663,0,665,G
7-M,715,661,0,0,0,661,A
7-M,716,0,0,0,678,678,C
7-M,717,0,0,0,670,670,C
7-M,718,0,668,1,0,669,T
7-M,719,679,0,1,0,680,A
7-M,720,0,676,0,0,676,T
7-M,721,0,0,0,680,680,C
7-M,722,677,0,1,0,678,A
7-M,723,0,1,676,0,677,G
7-M,724,672,0,0,0,672,A
7-M,725,649,0,0,0,649,A
7-M,726,654,0,1,0,655,A
7-M,727,0,1,0,653,654,C
7-M,728,1,1,658,0,660,G
7-M,729,656,0,0,0,656,A
7-M,730,654,0,0,0,654,A
7-M,731,0,656,0,0,656,T
7-M,732,0,0,653,0,653,G
7-M,733,0,0,654,0,654,G
7-M,734,0,0,653,0,653,G
7-M,735,0,0,651,0,651,G
7-M,736,0,1,661,0,662,G
7-M,737,0,640,0,2,642,T
7-M,738,0,1,641,0,642,G
7-M,739,0,0,0,645,645,C
7-M,740,645,0,1,0,646,A
7-M,741,2,1,651,0,654,G
7-M,742,637,0,0,0,637,A
7-M,743,1,631,0,1,633,T
7-M,744,0,0,630,0,630,G
7-M,745,0,0,0,617,617,C
7-M,746,614,0,0,0,614,A
7-M,747,616,0,1,0,617,A
7-M,748,1,0,0,620,621,C
7-M,749,0,1,619,0,620,G
7-M,750,622,1,2,0,625,A
7-M,751,0,620,0,1,621,T
7-M,752,0,618,0,1,619,T
7-M,753,1,0,0,622,623,C
7-M,754,611,0,0,1,612,A
7-M,755,613,0,0,0,613,A
7-M,756,0,0,612,0,612,G
7-M,757,0,597,0,1,598,T
7-M,758,0,0,594,0,594,G
7-M,759,586,0,0,0,586,A
7-M,760,0,0,0,586,586,C
7-M,761,2,0,0,584,586,C
7-M,762,1,0,0,584,585,C
7-M,763,0,1,585,0,586,G
7-M,764,0,2,0,585,587,C
7-M,765,0,585,0,0,585,T
7-M,766,0,587,0,0,587,T
7-M,767,0,0,592,0,592,G
7-M,768,0,587,0,2,589,T
7-M,769,0,585,0,0,585,T
7-M,770,0,0,585,0,585,G
7-M,771,0,570,0,0,570,T
7-M,772,1,564,2,0,567,T
7-M,773,0,0,567,0,567,G
7-M,774,0,0,0,566,566,C
7-M,775,0,1,0,557,558,C
7-M,776,0,1,561,0,562,G
7-M,777,0,0,0,559,559,C
7-M,778,0,1,559,0,560,G
7-M,779,560,0,0,0,560,A
7-M,780,563,0,0,0,563,A
7-M,781,0,568,0,0,568,T
7-M,782,570,0,0,0,570,A
7-M,783,0,572,0,1,573,T
7-M,784,1,0,0,586,587,C
7-M,785,585,0,1,0,586,A
7-M,786,0,585,0,2,587,T
7-M,787,0,583,0,0,583,T
7-M,788,0,0,578,0,578,G
7-M,789,0,0,581,0,581,G
7-M,790,0,1,578,0,579,G
7-M,791,586,0,0,0,586,A
7-M,792,0,580,0,0,580,T
7-M,793,1,0,0,561,562,C
7-M,794,1,561,0,1,563,T
7-M,795,0,562,0,0,562,T
7-M,796,0,0,561,0,561,G
7-M,797,0,0,0,560,560,C
7-M,798,559,0,0,0,559,A
7-M,799,0,0,0,556,556,C
7-M,800,0,545,0,0,545,T
7-M,801,0,548,0,0,548,T
7-M,802,0,0,550,0,550,G
7-M,803,552,0,1,0,553,A
7-M,804,0,555,0,0,555,T
7-M,805,541,0,0,0,541,A
7-M,806,0,541,0,1,542,T
7-M,807,0,537,0,0,537,T
7-M,808,0,0,539,0,539,G
7-M,809,0,535,0,3,538,T
7-M,810,0,1,533,0,534,G
7-M,811,0,0,533,0,533,G
7-M,812,523,0,0,0,523,A
7-M,813,0,530,0,0,530,T
7-M,814,0,524,0,0,524,T
7-M,815,1,0,0,520,521,C
7-M,816,0,522,0,1,523,T
7-M,817,0,518,0,1,519,T
7-M,818,0,0,517,0,517,G
7-M,819,515,0,1,0,516,A
7-M,820,0,519,0,0,519,T
7-M,821,1,0,0,514,515,C
7-M,822,0,0,511,0,511,G
7-M,823,1,509,0,1,511,T
7-M,824,0,0,0,510,510,C
7-M,825,0,488,0,1,489,T
7-M,826,0,508,0,0,508,T
7-M,827,0,505,0,1,506,T
7-M,828,0,506,0,1,507,T
7-M,829,0,509,0,0,509,T
7-M,830,0,508,0,1,509,T
7-M,831,0,504,0,3,507,T
7-M,832,1,0,0,502,503,C
7-M,833,504,0,0,0,504,A
7-M,834,504,0,0,0,504,A
7-M,835,505,0,0,0,505,A
7-M,836,0,506,0,0,506,T
7-M,837,0,0,505,0,505,G
7-M,838,0,0,0,502,502,C
7-M,839,0,0,505,0,505,G
7-M,840,0,510,0,0,510,T
7-M,841,0,0,0,509,509,C
7-M,842,0,511,0,0,511,T
7-M,843,514,0,0,0,514,A
7-M,844,0,514,0,1,515,T
7-M,845,1,0,0,512,513,C
7-M,846,0,0,512,0,512,G
7-M,847,509,0,1,0,510,A
7-M,848,0,0,0,513,513,C
7-M,849,0,502,0,1,503,T
7-M,850,2,0,0,507,509,C
7-M,851,0,509,0,1,510,T
7-M,852,0,508,0,0,508,T
7-M,853,0,1,0,506,507,C
7-M,854,508,0,0,0,508,A
7-M,855,510,0,0,1,511,A
7-M,856,506,0,1,0,507,A
7-M,857,0,0,0,509,509,C
7-M,858,508,0,0,0,508,A
7-M,859,0,0,0,486,486,C
7-M,860,1,0,472,0,473,G
7-M,861,1,0,492,0,493,G
7-M,862,0,0,0,491,491,C
7-M,863,2,0,0,487,489,C
7-M,864,0,484,1,1,486,T
7-M,865,0,485,1,1,487,T
7-M,866,487,0,1,0,488,A
7-M,867,489,0,0,0,489,A
7-M,868,487,0,0,0,487,A
7-M,869,486,0,1,0,487,A
7-M,870,0,0,481,0,481,G
7-M,871,401,0,1,0,402,A
7-M,872,0,1,396,0,397,G
7-M,873,0,0,400,0,400,G
7-M,874,1,1,0,393,395,C
7-M,875,1,0,0,391,392,C
7-M,876,0,0,0,391,391,C
7-M,877,0,390,0,1,391,T
7-M,878,0,393,0,0,393,T
7-M,879,0,0,0,394,394,C
7-M,880,0,393,0,1,394,T
7-M,881,392,0,0,0,392,A
7-M,882,0,0,0,395,395,C
7-M,883,0,0,387,0,387,G
7-M,884,0,1,387,0,388,G
7-M,885,375,0,0,0,375,A
7-M,886,377,0,0,0,377,A
7-M,887,0,1,371,0,372,G
7-M,888,0,0,372,0,372,G
7-M,889,368,0,2,0,370,A
7-M,890,0,0,370,0,370,G
7-M,891,0,371,0,0,371,T
7-M,892,376,0,0,0,376,A
7-M,893,0,0,0,376,376,C
7-M,894,0,0,0,375,375,C
7-M,895,0,371,0,0,371,T
7-M,896,0,1,371,0,372,G
7-M,897,347,0,0,0,347,A
7-M,898,0,0,355,0,355,G
7-M,899,0,340,0,0,340,T
7-M,900,0,0,0,341,341,C
7-M,901,0,333,0,0,333,T
7-M,902,331,0,1,1,333,A
7-M,903,0,332,0,0,332,T
7-M,904,0,0,334,0,334,G
7-M,905,324,0,0,0,324,A
7-M,906,0,0,322,0,322,G
7-M,907,0,0,293,0,293,G
7-M,908,0,0,294,0,294,G
7-M,909,292,0,1,0,293,A
7-M,910,287,0,0,0,287,A
7-M,911,0,0,287,0,287,G
7-M,912,285,0,0,0,285,A
7-M,913,294,0,0,0,294,A
7-M,914,0,286,0,0,286,T
7-M,915,278,0,0,0,278,A
7-M,916,0,277,0,0,277,T
7-M,917,0,12,0,262,274,C
7-M,918,0,0,277,0,277,G
7-M,919,277,0,0,0,277,A
7-M,920,272,0,1,0,273,A
7-M,921,272,0,0,0,272,A
7-M,922,0,0,269,0,269,G
7-M,923,0,1,272,0,273,G
7-M,924,270,0,0,0,270,A
7-M,925,270,0,0,0,270,A
7-M,926,0,0,0,270,270,C
7-M,927,265,1,0,0,266,A
7-M,928,0,0,271,0,271,G
7-M,929,0,0,0,271,271,C
7-M,930,272,0,0,0,272,A
7-M,931,0,0,271,0,271,G
7-M,932,256,0,0,0,256,A
7-M,933,257,0,0,0,257,A
7-M,934,0,257,0,0,257,T
7-M,935,1,0,250,0,251,G
7-M,936,0,0,0,252,252,C
7-M,937,0,229,0,2,231,T
7-M,938,0,0,233,0,233,G
7-M,939,0,231,0,0,231,T
7-M,940,0,0,230,0,230,G
7-M,941,0,0,228,0,228,G
7-M,942,220,0,0,0,220,A
7-M,943,0,221,0,0,221,T
7-M,944,0,0,214,0,214,G
7-M,945,0,0,0,211,211,C
7-M,946,0,205,0,1,206,T
7-M,947,0,0,205,0,205,G
7-M,948,204,0,0,0,204,A
7-M,949,0,0,0,202,202,C
7-M,950,1,0,201,0,202,G
7-M,951,201,0,0,0,201,A
7-M,952,0,0,0,199,199,C
7-M,953,190,0,1,0,191,A
7-M,954,0,0,193,0,193,G
7-M,955,0,192,0,0,192,T
7-M,956,0,0,0,190,190,C
7-M,957,191,0,0,0,191,A
7-M,958,0,186,0,1,187,T
7-M,959,0,186,0,1,187,T
7-M,960,0,187,0,0,187,T
7-M,961,0,182,0,0,182,T
7-M,962,1,0,180,0,181,G
7-M,963,0,172,0,0,172,T
7-M,964,1,0,0,171,172,C
7-M,965,162,0,1,0,163,A
7-M,966,1,0,161,0,162,G
7-M,967,0,0,0,162,162,C
7-M,968,162,0,0,0,162,A
7-M,969,0,162,0,0,162,T
7-M,970,151,0,0,0,151,A
7-M,971,0,0,150,0,150,G
7-M,972,149,0,0,0,149,A
7-M,973,0,0,149,0,149,G
7-M,974,0,146,0,0,146,T
7-M,975,0,98,0,0,98,T
7-M,976,0,0,97,0,97,G
7-M,977,0,1,94,0,95,G
7-M,978,95,0,0,0,95,A
7-M,979,0,0,95,0,95,G
7-M,980,0,61,0,0,61,T
7-M,981,58,0,0,0,58,A
7-M,982,58,0,0,0,58,A
8-NS,1,116,0,0,0,116,A
8-NS,2,0,116,0,0,116,T
8-NS,3,0,0,123,0,123,G
8-NS,4,0,0,129,0,129,G
8-NS,5,136,0,0,0,136,A
8-NS,6,0,277,0,0,277,T
8-NS,7,0,277,0,0,277,T
8-NS,8,1,0,0,285,286,C
8-NS,9,0,0,0,286,286,C
8-NS,10,286,0,1,0,287,A
8-NS,11,288,0,1,0,289,A
8-NS,12,0,0,0,289,289,C
8-NS,13,290,0,0,0,290,A
8-NS,14,0,0,0,291,291,C
8-NS,15,0,289,0,0,289,T
8-NS,16,0,0,322,0,322,G
8-NS,17,0,320,0,1,321,T
8-NS,18,0,0,327,0,327,G
8-NS,19,0,327,0,0,327,T
8-NS,20,2,1,0,321,324,C
8-NS,21,327,0,0,0,327,A
8-NS,22,328,0,0,0,328,A
8-NS,23,0,0,334,0,334,G
8-NS,24,0,341,0,0,341,T
8-NS,25,0,340,0,0,340,T
8-NS,26,0,348,0,0,348,T
8-NS,27,1,0,0,347,348,C
8-NS,28,0,0,0,351,351,C
8-NS,29,351,0,1,0,352,A
8-NS,30,0,0,354,0,354,G
8-NS,31,0,0,355,0,355,G
8-NS,32,0,354,0,2,356,T
8-NS,33,354,0,0,0,354,A
8-NS,34,0,0,359,0,359,G
8-NS,35,355,0,0,0,355,A
8-NS,36,0,359,0,0,359,T
8-NS,37,0,358,0,0,358,T
8-NS,38,0,0,361,0,361,G
8-NS,39,0,0,0,360,360,C
8-NS,40,0,359,0,1,360,T
8-NS,41,0,363,0,0,363,T
8-NS,42,0,363,0,0,363,T
8-NS,43,0,0,0,364,364,C
8-NS,44,0,363,0,0,363,T
8-NS,45,0,362,0,0,362,T
8-NS,46,0,363,0,0,363,T
8-NS,47,0,0,372,0,372,G
8-NS,48,0,0,377,0,377,G
8-NS,49,0,0,0,378,378,C
8-NS,50,377,0,0,0,377,A
8-NS,51,0,380,0,0,380,T
8-NS,52,379,0,0,0,379,A
8-NS,53,0,409,0,0,409,T
8-NS,54,1,0,0,405,406,C
8-NS,55,1,0,0,405,406,C
8-NS,56,0,0,407,0,407,G
8-NS,57,0,404,0,2,406,T
8-NS,58,409,0,0,0,409,A
8-NS,59,412,0,0,0,412,A
8-NS,60,411,0,1,0,412,A
8-NS,61,0,0,0,414,414,C
8-NS,62,408,0,0,0,408,A
8-NS,63,408,0,0,0,408,A
8-NS,64,0,0,431,0,431,G
8-NS,65,0,431,0,1,432,T
8-NS,66,0,431,0,0,431,T
8-NS,67,0,0,432,1,433,G
8-NS,68,0,433,0,0,433,T
8-NS,69,427,0,2,0,429,A
8-NS,70,0,0,428,0,428,G
8-NS,71,453,0,0,0,453,A
8-NS,72,0,0,0,459,459,C
8-NS,73,1,0,0,449,450,C
8-NS,74,451,0,0,0,451,A
8-NS,75,453,1,0,0,454,A
8-NS,76,0,0,474,0,474,G
8-NS,77,473,0,0,0,473,A
8-NS,78,480,0,0,0,480,A
8-NS,79,0,0,1,479,480,C
8-NS,80,0,468,0,1,469,T
8-NS,81,0,2,474,0,476,G
8-NS,82,477,0,0,0,477,A
8-NS,83,0,0,483,0,483,G
8-NS,84,0,481,0,0,481,T
8-NS,85,1,0,476,0,477,G
8-NS,86,481,0,0,0,481,A
8-NS,87,0,479,0,0,479,T
8-NS,88,1,0,484,0,485,G
8-NS,89,0,2,0,490,492,C
8-NS,90,2,0,0,494,496,C
8-NS,91,1,0,0,497,498,C
8-NS,92,1,0,0,492,493,C
8-NS,93,497,0,0,0,497,A
8-NS,94,0,503,0,1,504,T
8-NS,95,0,508,0,1,509,T
8-NS,96,1,0,0,509,510,C
8-NS,97,1,0,0,508,509,C
8-NS,98,0,498,0,1,499,T
8-NS,99,0,497,0,0,497,T
8-NS,100,0,0,500,0,500,G
8-NS,101,499,0,0,0,499,A
8-NS,102,0,495,0,1,496,T
8-NS,103,0,1,0,497,498,C
8-NS,104,0,1,496,0,497,G
8-NS,105,0,1,498,0,499,G
8-NS,106,0,0,0,498,498,C
8-NS,107,0,498,0,0,498,T
8-NS,108,0,501,0,0,501,T
8-NS,109,0,1,0,498,499,C
8-NS,110,0,1,500,0,501,G
8-NS,111,0,1,0,497,498,C
8-NS,112,0,0,0,500,500,C
8-NS,113,0,2,498,0,500,G
8-NS,114,498,0,0,0,498,A
8-NS,115,0,0,520,0,520,G
8-NS,116,522,0,1,0,523,A
8-NS,117,0,524,0,0,524,T
8-NS,118,0,0,0,522,522,C
8-NS,119,522,0,0,0,522,A
8-NS,120,0,0,526,0,526,G
8-NS,121,523,0,2,0,525,A
8-NS,122,0,0,530,1,531,G
8-NS,123,0,0,541,0,541,G
8-NS,124,0,550,0,0,550,T
8-NS,125,0,0,0,580,580,C
8-NS,126,0,1,1,576,578,C
8-NS,127,0,0,0,582,582,C
8-NS,128,0,583,0,0,583,T
8-NS,129,584,0,0,0,584,A
8-NS,130,583,0,0,1,584,A
8-NS,131,0,1,590,0,591,G
8-NS,132,0,1,592,0,593,G
8-NS,133,0,2,585,0,587,G
8-NS,134,0,2,574,0,576,G
8-NS,135,578,0,0,0,578,A
8-NS,136,577,0,1,0,578,A
8-NS,137,0,0,581,0,581,G
8-NS,138,602,0,0,0,602,A
8-NS,139,0,1,609,0,610,G
8-NS,140,0,0,606,0,606,G
8-NS,141,0,0,1,603,604,C
8-NS,142,602,0,0,0,602,A
8-NS,143,603,0,0,0,603,A
8-NS,144,0,594,0,4,598,T
8-NS,145,604,0,0,0,604,A
8-NS,146,1,0,0,618,619,C
8-NS,147,0,608,0,2,610,T
8-NS,148,0,0,0,613,613,C
8-NS,149,0,606,0,1,607,T
8-NS,150,1,0,0,612,613,C
8-NS,151,0,0,618,0,618,G
8-NS,152,0,0,644,0,644,G
8-NS,153,0,645,0,0,645,T
8-NS,154,0,0,0,650,650,C
8-NS,155,0,648,0,0,648,T
8-NS,156,653,0,0,0,653,A
8-NS,157,0,2,652,0,654,G
8-NS,158,657,0,0,1,658,A
8-NS,159,0,0,1,666,667,C
8-NS,160,654,0,0,0,654,A
8-NS,161,0,645,0,1,646,T
8-NS,162,0,0,0,646,646,C
8-NS,163,644,0,1,0,645,A
8-NS,164,647,0,0,0,647,A
8-NS,165,641,0,0,0,641,A
8-NS,166,0,0,646,0,646,G
8-NS,167,0,0,0,652,652,C
8-NS,168,631,0,0,0,631,A
8-NS,169,0,0,633,0,633,G
8-NS,170,0,1,0,632,633,C
8-NS,171,2,3,0,629,634,C
8-NS,172,643,0,0,0,643,A
8-NS,173,0,0,0,643,643,C
8-NS,174,0,0,0,649,649,C
8-NS,175,2,0,0,645,647,C
8-NS,176,649,0,0,0,649,A
8-NS,177,1,650,0,1,652,T
8-NS,178,0,0,654,0,654,G
8-NS,179,0,654,0,0,654,T
8-NS,180,1,642,0,2,645,T
8-NS,181,0,2,643,0,645,G
8-NS,182,0,0,641,0,641,G
8-NS,183,639,0,2,0,641,A
8-NS,184,639,0,1,0,640,A
8-NS,185,632,1,3,0,636,A
8-NS,186,1,0,638,0,639,G
8-NS,187,0,0,0,641,641,C
8-NS,188,637,0,0,0,637,A
8-NS,189,637,0,0,0,637,A
8-NS,190,637,0,1,0,638,A
8-NS,191,0,638,0,0,638,T
8-NS,192,0,636,0,3,639,T
8-NS,193,0,0,652,0,652,G
8-NS,194,0,650,0,1,651,T
8-NS,195,651,0,0,0,651,A
8-NS,196,0,1,650,0,651,G
8-NS,197,652,0,0,0,652,A
8-NS,198,649,0,0,0,649,A
8-NS,199,651,0,0,0,651,A
8-NS,200,649,0,0,0,649,A
8-NS,201,1,0,651,0,652,G
8-NS,202,644,1,0,0,645,A
8-NS,203,0,643,0,0,643,T
8-NS,204,0,642,0,1,643,T
8-NS,205,0,0,0,644,644,C
8-NS,206,0,642,0,1,643,T
8-NS,207,0,0,646,0,646,G
8-NS,208,646,0,0,0,646,A
8-NS,209,647,0,0,0,647,A
8-NS,210,643,1,1,0,645,A
8-NS,211,0,2,645,0,647,G
8-NS,212,644,0,0,0,644,A
8-NS,213,645,0,0,0,645,A
8-NS,214,0,0,649,0,649,G
8-NS,215,654,1,0,0,655,A
8-NS,216,650,0,0,0,650,A
8-NS,217,0,652,0,0,652,T
8-NS,218,0,1,0,657,658,C
8-NS,219,0,654,0,0,654,T
8-NS,220,0,0,659,0,659,G
8-NS,221,660,0,0,0,660,A
8-NS,222,0,659,0,0,659,T
8-NS,223,0,0,656,0,656,G
8-NS,224,645,0,1,0,646,A
8-NS,225,1,0,648,0,649,G
8-NS,226,0,0,645,0,645,G
8-NS,227,0,1,0,645,646,C
8-NS,228,649,0,0,0,649,A
8-NS,229,0,0,0,658,658,C
8-NS,230,0,661,0,0,661,T
8-NS,231,1,662,0,0,663,T
8-NS,232,665,0,0,0,665,A
8-NS,233,664,0,1,0,665,A
8-NS,234,663,0,0,0,663,A
8-NS,235,661,0,1,0,662,A
8-NS,236,0,655,0,0,655,T
8-NS,237,0,2,655,0,657,G
8-NS,238,662,0,0,0,662,A
8-NS,239,0,0,0,659,659,C
8-NS,240,1,0,0,657,658,C
8-NS,241,660,1,0,0,661,A
8-NS,242,0,661,0,0,661,T
8-NS,243,0,1,673,1,675,G
8-NS,244,0,0,682,0,682,G
8-NS,245,0,680,0,2,682,T
8-NS,246,1,0,0,710,711,C
8-NS,247,0,700,0,2,702,T
8-NS,248,3,1,0,704,708,C
8-NS,249,0,1,0,709,710,C
8-NS,250,709,0,0,0,709,A
8-NS,251,0,0,0,721,721,C
8-NS,252,710,0,1,0,711,A
8-NS,253,0,0,2,718,720,C
8-NS,254,0,0,0,720,720,C
8-NS,255,0,691,0,1,692,T
8-NS,256,1,0,697,0,698,G
8-NS,257,0,1,0,699,700,C
8-NS,258,0,696,0,0,696,T
8-NS,259,0,697,0,0,697,T
8-NS,260,1,2,0,691,694,C
8-NS,261,0,0,700,0,700,G
8-NS,262,1,0,0,697,698,C
8-NS,263,1,3,696,0,700,G
8-NS,264,723,0,0,0,723,A
8-NS,265,0,720,0,0,720,T
8-NS,266,746,0,0,0,746,A
8-NS,267,0,0,0,751,751,C
8-NS,268,749,0,0,0,749,A
8-NS,269,0,773,0,0,773,T
8-NS,270,768,0,0,0,768,A
8-NS,271,768,1,0,0,769,A
8-NS,272,0,0,0,771,771,C
8-NS,273,0,754,0,2,756,T
8-NS,274,0,1,761,0,762,G
8-NS,275,746,0,1,0,747,A
8-NS,276,0,0,1,750,751,C
8-NS,277,749,1,1,0,751,A
8-NS,278,0,741,0,1,742,T
8-NS,279,0,3,738,0,741,G
8-NS,280,742,0,0,0,742,A
8-NS,281,0,0,0,771,771,C
8-NS,282,1,764,0,1,766,T
8-NS,283,783,1,0,0,784,A
8-NS,284,1,779,0,2,782,T
8-NS,285,0,773,0,0,773,T
8-NS,286,0,1,774,0,775,G
8-NS,287,770,0,0,0,770,A
8-NS,288,0,0,767,0,767,G
8-NS,289,0,1,773,0,774,G
8-NS,290,754,0,1,0,755,A
8-NS,291,756,0,3,0,759,A
8-NS,292,0,743,0,0,743,T
8-NS,293,0,744,0,1,745,T
8-NS,294,0,0,760,0,760,G
8-NS,295,0,755,0,0,755,T
8-NS,296,1,0,0,755,756,C
8-NS,297,754,0,2,0,756,A
8-NS,298,756,0,0,0,756,A
8-NS,299,1,1,756,0,758,G
8-NS,300,760,1,0,0,761,A
8-NS,301,759,1,1,0,761,A
8-NS,302,759,0,1,0,760,A
8-NS,303,0,0,0,758,758,C
8-NS,304,0,744,1,0,745,T
8-NS,305,0,0,755,0,755,G
8-NS,306,1,0,763,0,764,G
8-NS,307,1,765,0,0,766,T
8-NS,308,0,768,0,1,769,T
8-NS,309,0,0,0,765,765,C
8-NS,310,766,0,1,0,767,A
8-NS,311,0,777,0,1,778,T
8-NS,312,0,0,790,0,790,G
8-NS,313,0,0,0,798,798,C
8-NS,314,0,787,0,1,788,T
8-NS,315,779,0,0,0,779,A
8-NS,316,785,0,0,0,785,A
8-NS,317,0,795,0,0,795,T
8-NS,318,0,1,793,0,794,G
8-NS,319,0,1,0,783,784,C
8-NS,320,0,1,0,768,769,C
8-NS,321,2,0,0,773,775,C
8-NS,322,773,0,0,0,773,A
8-NS,323,776,0,0,0,776,A
8-NS,324,0,0,780,0,780,G
8-NS,325,0,0,0,780,780,C
8-NS,326,774,0,2,0,776,A
8-NS,327,0,1,780,0,781,G
8-NS,328,778,0,0,0,778,A
8-NS,329,779,0,0,0,779,A
8-NS,330,777,0,0,0,777,A
8-NS,331,766,0,3,1,770,A
8-NS,332,0,778,0,0,778,T
8-NS,333,0,0,780,0,780,G
8-NS,334,0,1,783,0,784,G
8-NS,335,782,0,2,0,784,A
8-NS,336,773,1,1,0,775,A
8-NS,337,0,1,770,0,771,G
8-NS,338,0,2,778,0,780,G
8-NS,339,778,0,0,0,778,A
8-NS,340,1,1,0,777,779,C
8-NS,341,1,0,0,784,785,C
8-NS,342,0,777,0,2,779,T
8-NS,343,0,0,0,786,786,C
8-NS,344,0,784,1,2,787,T
8-NS,345,0,788,1,0,789,T
8-NS,346,0,788,0,0,788,T
8-NS,347,0,0,779,0,779,G
8-NS,348,0,0,0,783,783,C
8-NS,349,776,0,0,0,776,A
8-NS,350,0,775,1,0,776,T
8-NS,351,0,0,0,776,776,C
8-NS,352,781,0,0,0,781,A
8-NS,353,0,1,800,1,802,G
8-NS,354,802,0,0,0,802,A
8-NS,355,800,0,0,0,800,A
8-NS,356,0,796,0,1,797,T
8-NS,357,1,1,783,0,785,G
8-NS,358,0,1,787,0,788,G
8-NS,359,791,0,0,0,791,A
8-NS,360,1,0,0,790,791,C
8-NS,361,1,0,0,773,774,C
8-NS,362,755,0,1,0,756,A
8-NS,363,0,0,766,0,766,G
8-NS,364,2,0,760,0,762,G
8-NS,365,0,0,1,767,768,C
8-NS,366,767,0,0,0,767,A
8-NS,367,773,0,0,0,773,A
8-NS,368,0,771,0,0,771,T
8-NS,369,1,0,0,767,768,C
8-NS,370,770,0,0,0,770,A
8-NS,371,1,766,0,0,767,T
8-NS,372,1,2,754,0,757,G
8-NS,373,0,0,762,0,762,G
8-NS,374,759,0,2,0,761,A
8-NS,375,1,1,768,0,770,G
8-NS,376,755,2,1,0,758,A
8-NS,377,757,0,0,0,757,A
8-NS,378,758,0,0,0,758,A
8-NS,379,758,0,1,0,759,A
8-NS,380,762,0,1,0,763,A
8-NS,381,0,0,0,762,762,C
8-NS,382,753,0,0,0,753,A
8-NS,383,0,754,0,1,755,T
8-NS,384,2,1,0,743,746,C
8-NS,385,747,0,0,0,747,A
8-NS,386,0,746,1,0,747,T
8-NS,387,0,0,749,0,749,G
8-NS,388,0,749,0,0,749,T
8-NS,389,1,738,0,1,740,T
8-NS,390,0,0,741,0,741,G
8-NS,391,737,1,0,0,738,A
8-NS,392,734,0,2,0,736,A
8-NS,393,734,0,1,0,735,A
8-NS,394,0,0,739,0,739,G
8-NS,395,0,1,0,732,733,C
8-NS,396,0,2,730,0,732,G
8-NS,397,730,0,0,0,730,A
8-NS,398,731,0,0,0,731,A
8-NS,399,0,733,0,2,735,T
8-NS,400,0,731,0,1,732,T
8-NS,401,0,736,0,0,736,T
8-NS,402,0,1,0,734,735,C
8-NS,403,729,0,3,0,732,A
8-NS,404,2,0,737,0,739,G
8-NS,405,0,737,0,0,737,T
8-NS,406,0,0,736,0,736,G
8-NS,407,0,730,0,2,732,T
8-NS,408,0,1,735,0,736,G
8-NS,409,742,0,1,0,743,A
8-NS,410,0,741,0,1,742,T
8-NS,411,0,739,0,0,739,T
8-NS,412,1,740,0,1,742,T
8-NS,413,0,736,0,2,738,T
8-NS,414,0,737,0,1,738,T
8-NS,415,0,2,734,0,736,G
8-NS,416,737,0,2,0,739,A
8-NS,417,1,0,0,736,737,C
8-NS,418,1,1,0,720,722,C
8-NS,419,0,0,728,0,728,G
8-NS,420,762,0,1,0,763,A
8-NS,421,1,0,0,769,770,C
8-NS,422,0,771,0,0,771,T
8-NS,423,775,0,1,0,776,A
8-NS,424,0,0,775,0,775,G
8-NS,425,777,0,3,0,780,A
8-NS,426,0,1,786,0,787,G
8-NS,427,782,0,1,0,783,A
8-NS,428,0,0,0,821,821,C
8-NS,429,2,1,0,794,797,C
8-NS,430,778,0,0,0,778,A
8-NS,431,0,822,0,0,822,T
8-NS,432,812,1,0,0,813,A
8-NS,433,0,1,887,0,888,G
8-NS,434,0,881,0,1,882,T
8-NS,435,876,0,1,0,877,A
8-NS,436,0,880,0,2,882,T
8-NS,437,0,850,0,1,851,T
8-NS,438,879,1,1,0,881,A
8-NS,439,0,1,0,877,878,C
8-NS,440,0,856,1,1,858,T
8-NS,441,857,0,0,0,857,A
8-NS,442,793,1,0,0,794,A
8-NS,443,0,1,796,0,797,G
8-NS,444,0,0,788,0,788,G
8-NS,445,0,0,795,0,795,G
8-NS,446,1,1,0,785,787,C
8-NS,447,0,766,0,1,767,T
8-NS,448,0,763,0,1,764,T
8-NS,449,0,772,0,2,774,T
8-NS,450,2,1,0,770,773,C
8-NS,451,788,0,0,0,788,A
8-NS,452,0,0,0,788,788,C
8-NS,453,2,1,0,776,779,C
8-NS,454,0,0,779,0,779,G
8-NS,455,780,0,0,0,780,A
8-NS,456,777,2,0,0,779,A
8-NS,457,0,0,785,0,785,G
8-NS,458,778,0,0,0,778,A
8-NS,459,0,0,777,0,777,G
8-NS,460,0,1,757,0,758,G
8-NS,461,0,3,763,0,766,G
8-NS,462,759,1,2,0,762,A
8-NS,463,2,0,764,0,766,G
8-NS,464,0,0,0,760,760,C
8-NS,465,759,1,0,0,760,A
8-NS,466,758,0,1,0,759,A
8-NS,467,0,757,0,0,757,T
8-NS,468,0,752,0,3,755,T
8-NS,469,1,0,760,0,761,G
8-NS,470,0,754,0,0,754,T
8-NS,471,0,754,0,0,754,T
8-NS,472,1,0,755,0,756,G
8-NS,473,0,0,753,0,753,G
8-NS,474,0,1,0,751,752,C
8-NS,475,0,1,755,0,756,G
8-NS,476,755,0,0,0,755,A
8-NS,477,757,0,0,0,757,A
8-NS,478,762,0,0,0,762,A
8-NS,479,0,762,0,2,764,T
8-NS,480,1,0,0,763,764,C
8-NS,481,0,764,0,0,764,T
8-NS,482,0,0,0,765,765,C
8-NS,483,767,0,0,0,767,A
8-NS,484,0,0,0,766,766,C
8-NS,485,0,0,0,769,769,C
8-NS,486,761,0,0,0,761,A
8-NS,487,0,759,0,0,759,T
8-NS,488,0,748,0,1,749,T
8-NS,489,1,0,748,0,749,G
8-NS,490,0,0,0,751,751,C
8-NS,491,0,1,0,748,749,C
8-NS,492,0,751,0,0,751,T
8-NS,493,0,748,0,0,748,T
8-NS,494,1,0,0,753,754,C
8-NS,495,0,754,0,0,754,T
8-NS,496,0,757,0,2,759,T
8-NS,497,0,768,0,2,770,T
8-NS,498,0,761,1,1,763,T
8-NS,499,0,0,0,761,761,C
8-NS,500,1,0,0,763,764,C
8-NS,501,757,0,0,0,757,A
8-NS,502,0,0,761,0,761,G
8-NS,503,1,0,758,0,759,G
8-NS,504,770,0,2,0,772,A
8-NS,505,0,0,0,776,776,C
8-NS,506,779,0,1,0,780,A
8-NS,507,0,779,0,3,782,T
8-NS,508,783,0,1,0,784,A
8-NS,509,0,0,0,841,841,C
8-NS,510,1,838,0,1,840,T
8-NS,511,824,0,0,0,824,A
8-NS,512,0,821,0,0,821,T
8-NS,513,0,798,0,0,798,T
8-NS,514,1,1,793,0,795,G
8-NS,515,768,0,0,0,768,A
8-NS,516,0,1,767,0,768,G
8-NS,517,0,0,769,0,769,G
8-NS,518,698,0,0,0,698,A
8-NS,519,0,699,0,0,699,T
8-NS,520,0,0,697,0,697,G
8-NS,521,0,693,0,1,694,T
8-NS,522,2,1,0,696,699,C
8-NS,523,699,1,0,0,700,A
8-NS,524,696,1,0,0,697,A
8-NS,525,698,0,0,0,698,A
8-NS,526,701,0,0,0,701,A
8-NS,527,704,0,1,1,706,A
8-NS,528,0,706,0,0,706,T
8-NS,529,0,0,706,0,706,G
8-NS,530,0,0,0,712,712,C
8-NS,531,705,0,0,1,706,A
8-NS,532,711,1,1,1,714,A
8-NS,533,0,714,0,0,714,T
8-NS,534,0,711,0,1,712,T
8-NS,535,0,2,707,0,709,G
8-NS,536,0,0,709,0,709,G
8-NS,537,0,1,710,0,711,G
8-NS,538,0,0,715,0,715,G
8-NS,539,0,703,0,3,706,T
8-NS,540,1,1,0,707,709,C
8-NS,541,0,0,0,706,706,C
8-NS,542,0,704,0,0,704,T
8-NS,543,1,0,0,711,712,C
8-NS,544,704,1,1,0,706,A
8-NS,545,0,706,0,3,709,T
8-NS,546,0,0,0,709,709,C
8-NS,547,1,2,697,0,700,G
8-NS,548,0,1,702,0,703,G
8-NS,549,688,1,0,1,690,A
8-NS,550,0,0,694,0,694,G
8-NS,551,1,1,691,0,693,G
8-NS,552,681,0,0,1,682,A
8-NS,553,0,0,0,690,690,C
8-NS,554,0,689,0,1,690,T
8-NS,555,0,691,0,0,691,T
8-NS,556,0,3,693,0,696,G
8-NS,557,687,0,0,0,687,A
8-NS,558,691,0,0,0,691,A
8-NS,559,0,691,0,0,691,T
8-NS,560,0,1,669,0,670,G
8-NS,561,1,1,676,0,678,G
8-NS,562,667,0,0,0,667,A
8-NS,563,672,0,0,1,673,A
8-NS,564,0,699,0,0,699,T
8-NS,565,0,3,702,0,705,G
8-NS,566,705,1,0,1,707,A
8-NS,567,0,707,0,1,708,T
8-NS,568,704,0,1,1,706,A
8-NS,569,713,0,0,0,713,A
8-NS,570,0,0,1,706,707,C
8-NS,571,698,0,0,0,698,A
8-NS,572,0,0,0,703,703,C
8-NS,573,636,0,0,0,636,A
8-NS,574,0,0,642,0,642,G
8-NS,575,0,639,0,0,639,T
8-NS,576,0,634,0,2,636,T
8-NS,577,2,0,0,632,634,C
8-NS,578,1,1,625,0,627,G
8-NS,579,628,0,0,2,630,A
8-NS,580,0,0,634,0,634,G
8-NS,581,0,629,0,0,629,T
8-NS,582,0,0,0,637,637,C
8-NS,583,3,619,0,0,622,T
8-NS,584,0,0,0,625,625,C
8-NS,585,0,626,0,0,626,T
8-NS,586,623,0,0,0,623,A
8-NS,587,625,0,1,0,626,A
8-NS,588,621,0,0,0,621,A
8-NS,589,627,0,1,0,628,A
8-NS,590,627,0,0,0,627,A
8-NS,591,0,613,0,0,613,T
8-NS,592,0,0,0,622,622,C
8-NS,593,0,623,0,0,623,T
8-NS,594,620,1,0,0,621,A
8-NS,595,0,0,0,621,621,C
8-NS,596,621,0,0,0,621,A
8-NS,597,0,0,621,0,621,G
8-NS,598,608,0,1,0,609,A
8-NS,599,1,1,611,0,613,G
8-NS,600,614,0,0,0,614,A
8-NS,601,0,601,0,1,602,T
8-NS,602,0,606,0,0,606,T
8-NS,603,0,0,0,604,604,C
8-NS,604,0,0,606,0,606,G
8-NS,605,0,1,0,605,606,C
8-NS,606,0,602,0,0,602,T
8-NS,607,0,598,0,1,599,T
8-NS,608,0,0,594,0,594,G
8-NS,609,0,2,595,0,597,G
8-NS,610,594,0,1,1,596,A
8-NS,611,0,0,598,0,598,G
8-NS,612,591,0,1,0,592,A
8-NS,613,585,0,0,0,585,A
8-NS,614,0,0,599,0,599,G
8-NS,615,0,0,0,600,600,C
8-NS,616,599,0,0,0,599,A
8-NS,617,0,0,608,0,608,G
8-NS,618,0,604,0,1,605,T
8-NS,619,605,0,0,0,605,A
8-NS,620,607,0,0,0,607,A
8-NS,621,0,598,0,0,598,T
8-NS,622,0,0,602,0,602,G
8-NS,623,562,0,1,0,563,A
8-NS,624,0,0,578,0,578,G
8-NS,625,575,0,1,0,576,A
8-NS,626,557,0,0,0,557,A
8-NS,627,1,557,0,0,558,T
8-NS,628,0,1,547,0,548,G
8-NS,629,1,1,545,0,547,G
8-NS,630,1,1,545,0,547,G
8-NS,631,0,0,541,0,541,G
8-NS,632,0,0,538,0,538,G
8-NS,633,517,0,0,0,517,A
8-NS,634,0,498,0,1,499,T
8-NS,635,1,0,0,510,511,C
8-NS,636,0,507,0,1,508,T
8-NS,637,1,0,0,511,512,C
8-NS,638,0,1,0,514,515,C
8-NS,639,514,0,1,0,515,A
8-NS,640,0,0,0,514,514,C
8-NS,641,0,499,0,1,500,T
8-NS,642,0,495,0,0,495,T
8-NS,643,485,0,1,0,486,A
8-NS,644,0,0,0,492,492,C
8-NS,645,1,485,0,1,487,T
8-NS,646,1,0,0,487,488,C
8-NS,647,2,0,0,479,481,C
8-NS,648,480,0,0,0,480,A
8-NS,649,481,0,1,0,482,A
8-NS,650,482,0,0,0,482,A
8-NS,651,481,0,0,0,481,A
8-NS,652,0,2,0,483,485,C
8-NS,653,464,0,1,0,465,A
8-NS,654,0,0,467,0,467,G
8-NS,655,462,0,0,0,462,A
8-NS,656,463,0,0,0,463,A
8-NS,657,461,1,0,0,462,A
8-NS,658,0,0,1,459,460,C
8-NS,659,0,0,459,0,459,G
8-NS,660,0,0,458,0,458,G
8-NS,661,0,0,460,0,460,G
8-NS,662,459,0,0,0,459,A
8-NS,663,461,0,0,0,461,A
8-NS,664,457,0,1,0,458,A
8-NS,665,0,455,0,0,455,T
8-NS,666,0,0,459,0,459,G
8-NS,667,0,0,458,1,459,G
8-NS,668,0,0,0,453,453,C
8-NS,669,0,1,453,0,454,G
8-NS,670,448,0,0,0,448,A
8-NS,671,0,2,454,0,456,G
8-NS,672,456,0,0,0,456,A
8-NS,673,453,0,0,0,453,A
8-NS,674,0,0,0,456,456,C
8-NS,675,443,0,0,0,443,A
8-NS,676,0,0,444,0,444,G
8-NS,677,0,0,0,441,441,C
8-NS,678,0,442,0,0,442,T
8-NS,679,440,0,2,0,442,A
8-NS,680,0,0,437,0,437,G
8-NS,681,0,0,436,0,436,G
8-NS,682,0,434,0,0,434,T
8-NS,683,1,0,0,422,423,C
8-NS,684,425,0,2,0,427,A
8-NS,685,424,0,0,0,424,A
8-NS,686,421,0,1,0,422,A
8-NS,687,423,1,3,0,427,A
8-NS,688,0,0,429,0,429,G
8-NS,689,0,416,0,1,417,T
8-NS,690,0,415,0,0,415,T
8-NS,691,0,418,0,0,418,T
8-NS,692,0,0,418,0,418,G
8-NS,693,417,1,1,0,419,A
8-NS,694,419,0,0,0,419,A
8-NS,695,0,0,422,0,422,G
8-NS,696,413,0,0,0,413,A
8-NS,697,0,0,417,0,417,G
8-NS,698,415,0,2,0,417,A
8-NS,699,0,417,0,0,417,T
8-NS,700,416,0,0,0,416,A
8-NS,701,414,0,0,0,414,A
8-NS,702,0,0,413,0,413,G
8-NS,703,390,1,1,0,392,A
8-NS,704,0,391,0,0,391,T
8-NS,705,0,0,392,0,392,G
8-NS,706,0,0,396,0,396,G
8-NS,707,0,0,0,391,391,C
8-NS,708,0,389,0,1,390,T
8-NS,709,386,0,0,0,386,A
8-NS,710,389,0,1,0,390,A
8-NS,711,0,390,0,0,390,T
8-NS,712,0,390,0,0,390,T
8-NS,713,0,0,390,0,390,G
8-NS,714,382,0,0,0,382,A
8-NS,715,381,0,0,0,381,A
8-NS,716,0,0,380,0,380,G
8-NS,717,377,0,2,0,379,A
8-NS,718,378,0,0,0,378,A
8-NS,719,0,1,375,0,376,G
8-NS,720,1,367,0,0,368,T
8-NS,721,0,1,369,0,370,G
8-NS,722,361,0,1,0,362,A
8-NS,723,0,0,362,0,362,G
8-NS,724,361,0,0,0,361,A
8-NS,725,0,1,0,362,363,C
8-NS,726,357,0,0,0,357,A
8-NS,727,0,0,0,355,355,C
8-NS,728,337,0,0,0,337,A
8-NS,729,1,1,345,0,347,G
8-NS,730,342,0,0,0,342,A
8-NS,731,0,342,0,0,342,T
8-NS,732,0,341,0,0,341,T
8-NS,733,339,0,0,0,339,A
8-NS,734,340,0,0,0,340,A
8-NS,735,343,0,0,0,343,A
8-NS,736,339,0,0,0,339,A
8-NS,737,341,0,0,0,341,A
8-NS,738,0,0,0,326,326,C
8-NS,739,304,0,0,0,304,A
8-NS,740,302,1,0,0,303,A
8-NS,741,0,0,0,302,302,C
8-NS,742,0,301,0,0,301,T
8-NS,743,0,0,304,0,304,G
8-NS,744,305,0,0,0,305,A
8-NS,745,304,0,1,0,305,A
8-NS,746,303,1,0,0,304,A
8-NS,747,301,0,0,0,301,A
8-NS,748,0,300,0,1,301,T
8-NS,749,299,0,0,0,299,A
8-NS,750,0,0,297,0,297,G
8-NS,751,0,0,0,297,297,C
8-NS,752,0,294,0,0,294,T
8-NS,753,0,292,0,2,294,T
8-NS,754,0,292,1,0,293,T
8-NS,755,0,0,293,1,294,G
8-NS,756,294,0,1,0,295,A
8-NS,757,294,0,0,0,294,A
8-NS,758,0,0,0,296,296,C
8-NS,759,290,0,0,0,290,A
8-NS,760,291,0,0,0,291,A
8-NS,761,292,0,0,0,292,A
8-NS,762,0,292,0,0,292,T
8-NS,763,291,0,0,0,291,A
8-NS,764,284,0,0,0,284,A
8-NS,765,0,0,0,283,283,C
8-NS,766,282,0,0,0,282,A
8-NS,767,0,276,0,0,276,T
8-NS,768,0,271,0,0,271,T
8-NS,769,3,0,0,263,266,C
8-NS,770,262,0,2,0,264,A
8-NS,771,0,264,0,0,264,T
8-NS,772,0,0,263,0,263,G
8-NS,773,0,0,0,252,252,C
8-NS,774,247,0,0,0,247,A
8-NS,775,243,0,0,0,243,A
8-NS,776,0,0,243,0,243,G
8-NS,777,1,0,0,246,247,C
8-NS,778,239,0,0,0,239,A
8-NS,779,0,242,0,0,242,T
8-NS,780,0,240,0,0,240,T
8-NS,781,240,0,0,0,240,A
8-NS,782,0,0,0,241,241,C
8-NS,783,240,0,0,0,240,A
8-NS,784,239,0,0,0,239,A
8-NS,785,0,0,0,238,238,C
8-NS,786,0,206,1,0,207,T
8-NS,787,0,1,205,0,206,G
8-NS,788,0,0,0,198,198,C
8-NS,789,0,189,0,0,189,T
8-NS,790,0,0,190,0,190,G
8-NS,791,0,189,0,0,189,T
8-NS,792,0,189,0,0,189,T
8-NS,793,0,188,0,1,189,T
8-NS,794,0,0,188,0,188,G
8-NS,795,187,0,1,0,188,A
8-NS,796,184,0,0,0,184,A
8-NS,797,0,0,184,0,184,G
8-NS,798,0,179,0,0,179,T
8-NS,799,0,0,178,0,178,G
8-NS,800,0,1,179,0,180,G
8-NS,801,178,0,0,0,178,A
8-NS,802,179,0,0,0,179,A
8-NS,803,0,0,0,178,178,C
8-NS,804,173,0,0,0,173,A
8-NS,805,0,0,176,0,176,G
8-NS,806,0,0,171,0,171,G
8-NS,807,169,0,0,0,169,A
8-NS,808,0,0,175,0,175,G
8-NS,809,155,0,0,0,155,A
8-NS,810,0,156,0,0,156,T
8-NS,811,156,0,0,0,156,A
8-NS,812,155,0,0,0,155,A
8-NS,813,0,1,155,0,156,G
8-NS,814,139,0,0,0,139,A
8-NS,815,139,0,0,0,139,A
8-NS,816,0,0,0,138,138,C
8-NS,817,0,118,0,0,118,T
8-NS,818,0,115,0,0,115,T
8-NS,819,0,115,0,1,116,T
8-NS,820,0,0,0,116,116,C
8-NS,821,0,111,0,0,111,T
8-NS,822,0,1,0,109,110,C
8-NS,823,106,0,0,0,106,A
8-NS,824,0,106,0,0,106,T
8-NS,825,0,105,0,0,105,T
8-NS,826,0,104,0,0,104,T
8-NS,827,0,0,0,104,104,C
8-NS,828,99,0,0,0,99,A
8-NS,829,0,0,99,0,99,G
8-NS,830,0,0,0,98,98,C
8-NS,831,0,93,0,0,93,T
8-NS,832,0,91,0,0,91,T
8-NS,833,89,0,0,0,89,A
8-NS,834,0,89,0,0,89,T
8-NS,835,0,89,0,0,89,T
8-NS,836,0,89,0,0,89,T
8-NS,837,88,0,0,0,88,A
8-NS,838,85,0,0,0,85,A
8-NS,839,0,83,0,0,83,T
8-NS,840,0,0,81,0,81,G
8-NS,841,77,0,0,0,77,A
8-NS,842,0,72,0,0,72,T
8-NS,843,71,0,0,0,71,A
8-NS,844,71,0,0,0,71,A
8-NS,845,71,0,0,0,71,A
8-NS,846,71,0,0,0,71,A
8-NS,847,71,0,0,0,71,A
8-NS,848,70,0,1,0,71,A
8-NS,849,0,0,0,71,71,C
8-NS,850,61,0,0,0,61,A
8-NS,851,0,0,0,60,60,C
8-NS,852,2,0,0,56,58,C
8-NS,853,0,0,0,56,56,C
8-NS,854,0,53,0,0,53,T
8-NS,855,0,53,0,0,53,T
8-NS,856,0,0,53,0,53,G
8-NS,857,0,51,0,0,51,T
8-NS,858,0,50,0,0,50,T
8-NS,859,0,48,0,0,48,T
8-NS,860,0,0,0,19,19,C
8-NS,861,0,16,0,0,16,T
8-NS,862,13,0,0,0,13,A
8-NS,863,0,0,0,13,13,C
