Gene,Position,A,T,G,C,Coverage,Consensus
1-PB2,1,136,0,0,0,136,A
1-PB2,2,0,136,0,0,136,T
1-PB2,3,0,0,137,0,137,G
1-PB2,4,0,0,137,0,137,G
1-PB2,5,135,0,0,0,135,A
1-PB2,6,136,0,0,0,136,A
1-PB2,7,136,0,0,0,136,A
1-PB2,8,0,0,154,0,154,G
1-PB2,9,159,0,0,0,159,A
1-PB2,10,160,0,0,0,160,A
1-PB2,11,0,164,0,0,164,T
1-PB2,12,164,0,1,0,165,A
1-PB2,13,164,0,0,0,164,A
1-PB2,14,167,0,0,0,167,A
1-PB2,15,166,0,1,0,167,A
1-PB2,16,0,0,170,0,170,G
1-PB2,17,171,0,0,0,171,A
1-PB2,18,171,0,0,0,171,A
1-PB2,19,0,0,0,175,175,C
1-PB2,20,0,175,0,0,175,T
1-PB2,21,179,0,0,0,179,A
1-PB2,22,0,0,0,178,178,C
1-PB2,23,1,0,177,0,178,G
1-PB2,24,0,0,183,0,183,G
1-PB2,25,183,0,1,0,184,A
1-PB2,26,187,0,0,0,187,A
1-PB2,27,0,188,0,0,188,T
1-PB2,28,1,0,0,194,195,C
1-PB2,29,0,195,0,0,195,T
1-PB2,30,0,0,196,0,196,G
1-PB2,31,197,1,1,0,199,A
1-PB2,32,0,200,0,0,200,T
1-PB2,33,0,0,200,0,200,G
1-PB2,34,0,202,0,0,202,T
1-PB2,35,2,0,0,200,202,C
1-PB2,36,0,0,202,0,202,G
1-PB2,37,0,0,0,202,202,C
1-PB2,38,203,0,0,0,203,A
1-PB2,39,0,0,214,0,214,G
1-PB2,40,0,215,0,0,215,T
1-PB2,41,0,0,0,216,216,C
1-PB2,42,0,212,0,1,213,T
1-PB2,43,0,0,0,215,215,C
1-PB2,44,0,0,214,0,214,G
1-PB2,45,0,0,0,213,213,C
1-PB2,46,211,0,1,0,212,A
1-PB2,47,0,0,0,214,214,C
1-PB2,48,0,215,0,0,215,T
1-PB2,49,0,0,0,219,219,C
1-PB2,50,0,0,223,0,223,G
1-PB2,51,0,0,0,223,223,C
1-PB2,52,0,1,220,0,221,G
1-PB2,53,221,0,0,0,221,A
1-PB2,54,0,0,224,0,224,G
1-PB2,55,232,0,1,0,233,A
1-PB2,56,0,232,0,0,232,T
1-PB2,57,231,0,0,0,231,A
1-PB2,58,0,0,0,230,230,C
1-PB2,59,0,228,0,0,228,T
1-PB2,60,0,1,239,0,240,G
1-PB2,61,241,0,0,0,241,A
1-PB2,62,0,0,0,244,244,C
1-PB2,63,244,0,0,0,244,A
1-PB2,64,245,0,0,0,245,A
1-PB2,65,248,0,0,0,248,A
1-PB2,66,251,0,0,0,251,A
1-PB2,67,251,0,0,0,251,A
1-PB2,68,0,0,0,253,253,C
1-PB2,69,0,0,0,252,252,C
1-PB2,70,258,0,0,0,258,A
1-PB2,71,0,0,0,262,262,C
1-PB2,72,263,0,0,0,263,A
1-PB2,73,0,0,270,0,270,G
1-PB2,74,1,267,0,0,268,T
1-PB2,75,0,2,274,0,276,G
1-PB2,76,0,0,277,0,277,G
1-PB2,77,277,0,0,0,277,A
1-PB2,78,1,1,0,291,293,C
1-PB2,79,1,0,0,291,292,C
1-PB2,80,298,0,1,0,299,A
1-PB2,81,0,299,0,0,299,T
1-PB2,82,294,0,0,0,294,A
1-PB2,83,0,294,0,1,295,T
1-PB2,84,1,3,295,0,299,G
1-PB2,85,1,0,300,0,301,G
1-PB2,86,0,0,0,301,301,C
1-PB2,87,0,0,0,294,294,C
1-PB2,88,297,0,0,0,297,A
1-PB2,89,0,321,0,1,322,T
1-PB2,90,327,0,0,0,327,A
1-PB2,91,344,0,0,0,344,A
1-PB2,92,0,346,0,0,346,T
1-PB2,93,0,340,0,0,340,T
1-PB2,94,349,0,0,1,350,A
1-PB2,95,350,0,0,0,350,A
1-PB2,96,0,1,356,0,357,G
1-PB2,97,357,0,0,0,357,A
1-PB2,98,350,0,0,1,351,A
1-PB2,99,1,0,367,0,368,G
1-PB2,100,0,368,0,0,368,T
1-PB2,101,366,0,2,0,368,A
1-PB2,102,0,1,0,366,367,C
1-PB2,103,371,0,0,0,371,A
1-PB2,104,0,0,0,378,378,C
1-PB2,105,375,0,1,0,376,A
1-PB2,106,0,376,0,0,376,T
1-PB2,107,0,0,0,377,377,C
1-PB2,108,1,0,377,0,378,G
1-PB2,109,0,0,379,0,379,G
1-PB2,110,0,1,376,0,377,G
1-PB2,111,1,3,375,0,379,G
1-PB2,112,380,0,0,0,380,A
1-PB2,113,0,1,378,0,379,G
1-PB2,114,378,0,1,0,379,A
1-PB2,115,0,0,0,385,385,C
1-PB2,116,385,0,0,0,385,A
1-PB2,117,0,0,389,0,389,G
1-PB2,118,0,2,389,0,391,G
1-PB2,119,390,0,0,0,390,A
1-PB2,120,391,0,0,0,391,A
1-PB2,121,392,0,0,0,392,A
1-PB2,122,390,0,0,0,390,A
1-PB2,123,0,1,392,0,393,G
1-PB2,124,388,0,1,0,389,A
1-PB2,125,391,0,0,0,391,A
1-PB2,126,0,0,0,387,387,C
1-PB2,127,0,0,0,381,381,C
1-PB2,128,0,0,0,378,378,C
1-PB2,129,1,0,378,0,379,G
1-PB2,130,0,380,0,0,380,T
1-PB2,131,2,0,0,379,381,C
1-PB2,132,390,0,0,0,390,A
1-PB2,133,0,0,0,392,392,C
1-PB2,134,0,392,0,0,392,T
1-PB2,135,0,392,0,0,392,T
1-PB2,136,391,0,0,0,391,A
1-PB2,137,1,0,394,0,395,G
1-PB2,138,0,0,394,0,394,G
1-PB2,139,395,0,0,0,395,A
1-PB2,140,0,392,0,0,392,T
1-PB2,141,0,1,396,0,397,G
1-PB2,142,399,0,0,0,399,A
1-PB2,143,399,0,0,0,399,A
1-PB2,144,402,0,0,0,402,A
1-PB2,145,0,400,0,0,400,T
1-PB2,146,0,0,402,0,402,G
1-PB2,147,0,0,404,0,404,G
1-PB2,148,402,0,0,0,402,A
1-PB2,149,0,403,0,0,403,T
1-PB2,150,0,1,404,0,405,G
1-PB2,151,399,0,0,0,399,A
1-PB2,152,0,402,0,0,402,T
1-PB2,153,1,0,400,0,401,G
1-PB2,154,0,0,403,0,403,G
1-PB2,155,0,0,0,399,399,C
1-PB2,156,402,0,0,0,402,A
1-PB2,157,402,0,0,0,402,A
1-PB2,158,0,402,0,0,402,T
1-PB2,159,0,1,413,0,414,G
1-PB2,160,415,0,0,0,415,A
1-PB2,161,415,0,1,0,416,A
1-PB2,162,418,0,0,0,418,A
1-PB2,163,0,418,0,0,418,T
1-PB2,164,418,0,0,0,418,A
1-PB2,165,1,0,0,422,423,C
1-PB2,166,1,0,0,422,423,C
1-PB2,167,0,0,0,422,422,C
1-PB2,168,415,0,0,0,415,A
1-PB2,169,415,0,1,0,416,A
1-PB2,170,0,414,0,0,414,T
1-PB2,171,0,0,0,417,417,C
1-PB2,172,416,0,0,0,416,A
1-PB2,173,0,0,0,420,420,C
1-PB2,174,1,412,0,0,413,T
1-PB2,175,0,0,414,0,414,G
1-PB2,176,0,0,0,412,412,C
1-PB2,177,0,410,0,0,410,T
1-PB2,178,0,3,410,0,413,G
1-PB2,179,414,0,0,0,414,A
1-PB2,180,0,0,0,416,416,C
1-PB2,181,414,0,0,0,414,A
1-PB2,182,407,0,0,0,407,A
1-PB2,183,404,0,2,0,406,A
1-PB2,184,403,0,2,0,405,A
1-PB2,185,0,0,415,0,415,G
1-PB2,186,1,1,411,0,413,G
1-PB2,187,411,0,0,0,411,A
1-PB2,188,0,412,0,0,412,T
1-PB2,189,408,0,0,0,408,A
1-PB2,190,409,0,1,0,410,A
1-PB2,191,0,0,0,410,410,C
1-PB2,192,410,0,0,0,410,A
1-PB2,193,0,0,410,0,410,G
1-PB2,194,405,0,0,0,405,A
1-PB2,195,406,0,0,0,406,A
1-PB2,196,403,0,0,0,403,A
1-PB2,197,0,401,2,1,404,T
1-PB2,198,0,1,404,0,405,G
1-PB2,199,0,0,405,0,405,G
1-PB2,200,0,403,0,0,403,T
1-PB2,201,0,402,0,0,402,T
1-PB2,202,1,0,0,402,403,C
1-PB2,203,0,0,0,402,402,C
1-PB2,204,0,0,403,0,403,G
1-PB2,205,0,1,401,0,402,G
1-PB2,206,403,0,0,0,403,A
1-PB2,207,0,1,402,0,403,G
1-PB2,208,402,0,1,0,403,A
1-PB2,209,0,1,405,0,406,G
1-PB2,210,407,0,1,0,408,A
1-PB2,211,412,0,0,0,412,A
1-PB2,212,409,0,2,0,411,A
1-PB2,213,0,408,0,0,408,T
1-PB2,214,0,1,413,0,414,G
1-PB2,215,414,0,0,0,414,A
1-PB2,216,414,0,0,0,414,A
1-PB2,217,0,0,0,411,411,C
1-PB2,218,411,0,0,0,411,A
1-PB2,219,410,0,0,0,410,A
1-PB2,220,0,0,421,0,421,G
1-PB2,221,0,1,421,1,423,G
1-PB2,222,423,0,0,0,423,A
1-PB2,223,0,0,0,420,420,C
1-PB2,224,416,0,0,0,416,A
1-PB2,225,418,0,1,0,419,A
1-PB2,226,418,0,0,0,418,A
1-PB2,227,0,0,0,412,412,C
1-PB2,228,0,0,0,397,397,C
1-PB2,229,0,0,0,423,423,C
1-PB2,230,0,424,0,0,424,T
1-PB2,231,427,0,1,0,428,A
1-PB2,232,0,430,0,0,430,T
1-PB2,233,0,0,428,0,428,G
1-PB2,234,0,1,437,0,438,G
1-PB2,235,419,0,0,0,419,A
1-PB2,236,0,0,419,0,419,G
1-PB2,237,0,420,0,0,420,T
1-PB2,238,415,0,0,0,415,A
1-PB2,239,421,0,0,0,421,A
1-PB2,240,420,0,1,0,421,A
1-PB2,241,420,0,2,0,422,A
1-PB2,242,0,420,0,0,420,T
1-PB2,243,1,1,410,0,412,G
1-PB2,244,401,0,1,0,402,A
1-PB2,245,0,0,411,0,411,G
1-PB2,246,0,408,0,0,408,T
1-PB2,247,0,1,404,0,405,G
1-PB2,248,415,0,1,0,416,A
1-PB2,249,1,414,0,0,415,T
1-PB2,250,0,1,413,0,414,G
1-PB2,251,0,0,0,417,417,C
1-PB2,252,0,417,0,0,417,T
1-PB2,253,0,0,427,0,427,G
1-PB2,254,0,1,428,0,429,G
1-PB2,255,437,0,0,0,437,A
1-PB2,256,0,435,0,0,435,T
1-PB2,257,2,0,0,427,429,C
1-PB2,258,427,0,0,0,427,A
1-PB2,259,0,0,438,0,438,G
1-PB2,260,439,0,0,0,439,A
1-PB2,261,0,437,0,0,437,T
1-PB2,262,423,0,0,0,423,A
1-PB2,263,0,1,433,0,434,G
1-PB2,264,424,0,0,0,424,A
1-PB2,265,0,0,430,0,430,G
1-PB2,266,0,427,0,0,427,T
1-PB2,267,0,0,424,0,424,G
1-PB2,268,420,0,0,0,420,A
1-PB2,269,0,422,0,0,422,T
1-PB2,270,0,0,424,0,424,G
1-PB2,271,0,0,431,0,431,G
1-PB2,272,0,428,0,0,428,T
1-PB2,273,425,0,0,0,425,A
1-PB2,274,0,417,0,1,418,T
1-PB2,275,0,0,0,418,418,C
1-PB2,276,427,0,0,0,427,A
1-PB2,277,0,0,0,437,437,C
1-PB2,278,1,1,0,434,436,C
1-PB2,279,0,433,0,1,434,T
1-PB2,280,0,427,0,0,427,T
1-PB2,281,0,428,0,0,428,T
1-PB2,282,1,1,428,0,430,G
1-PB2,283,0,0,429,0,429,G
1-PB2,284,0,1,0,433,434,C
1-PB2,285,0,422,0,1,423,T
1-PB2,286,0,0,421,0,421,G
1-PB2,287,0,421,0,1,422,T
1-PB2,288,420,0,0,0,420,A
1-PB2,289,423,0,1,0,424,A
1-PB2,290,0,0,0,423,423,C
1-PB2,291,410,0,0,1,411,A
1-PB2,292,0,408,0,0,408,T
1-PB2,293,0,0,402,0,402,G
1-PB2,294,0,0,416,0,416,G
1-PB2,295,0,407,0,1,408,T
1-PB2,296,0,0,401,0,401,G
1-PB2,297,0,0,409,0,409,G
1-PB2,298,406,1,0,0,407,A
1-PB2,299,408,0,1,0,409,A
1-PB2,300,0,409,0,0,409,T
1-PB2,301,407,0,0,0,407,A
1-PB2,302,0,1,413,0,414,G
1-PB2,303,407,0,0,0,407,A
1-PB2,304,405,1,0,0,406,A
1-PB2,305,406,0,0,0,406,A
1-PB2,306,0,391,0,0,391,T
1-PB2,307,0,1,390,0,391,G
1-PB2,308,0,0,387,0,387,G
1-PB2,309,389,0,1,0,390,A
1-PB2,310,0,0,0,390,390,C
1-PB2,311,1,0,0,389,390,C
1-PB2,312,2,0,0,388,390,C
1-PB2,313,0,0,389,0,389,G
1-PB2,314,0,392,0,0,392,T
1-PB2,315,0,3,397,0,400,G
1-PB2,316,397,0,1,0,398,A
1-PB2,317,0,0,0,402,402,C
1-PB2,318,401,0,0,0,401,A
1-PB2,319,395,0,2,0,397,A
1-PB2,320,0,0,408,0,408,G
1-PB2,321,0,402,0,1,403,T
1-PB2,322,403,0,1,0,404,A
1-PB2,323,0,0,0,400,400,C
1-PB2,324,0,2,391,0,393,G
1-PB2,325,1,0,405,0,406,G
1-PB2,326,0,401,0,0,401,T
1-PB2,327,1,0,0,404,405,C
1-PB2,328,0,1,0,402,403,C
1-PB2,329,402,0,0,0,402,A
1-PB2,330,0,402,0,0,402,T
1-PB2,331,0,403,0,0,403,T
1-PB2,332,421,0,0,0,421,A
1-PB2,333,0,0,0,418,418,C
1-PB2,334,0,0,0,412,412,C
1-PB2,335,0,0,0,409,409,C
1-PB2,336,410,0,0,0,410,A
1-PB2,337,412,0,0,0,412,A
1-PB2,338,412,0,0,0,412,A
1-PB2,339,412,0,0,0,412,A
1-PB2,340,0,0,422,0,422,G
1-PB2,341,0,404,0,0,404,T
1-PB2,342,0,0,413,0,413,G
1-PB2,343,0,411,0,1,412,T
1-PB2,344,414,0,0,0,414,A
1-PB2,345,0,0,0,415,415,C
1-PB2,346,412,0,0,0,412,A
1-PB2,347,411,0,0,0,411,A
1-PB2,348,0,1,409,0,410,G
1-PB2,349,408,0,1,0,409,A
1-PB2,350,0,0,0,407,407,C
1-PB2,351,0,397,0,0,397,T
1-PB2,352,0,399,0,0,399,T
1-PB2,353,400,0,0,0,400,A
1-PB2,354,0,397,0,0,397,T
1-PB2,355,0,398,0,0,398,T
1-PB2,356,0,398,0,0,398,T
1-PB2,357,0,0,0,398,398,C
1-PB2,358,0,2,393,0,395,G
1-PB2,359,395,0,0,0,395,A
1-PB2,360,0,0,0,395,395,C
1-PB2,361,395,0,0,0,395,A
1-PB2,362,394,0,0,0,394,A
1-PB2,363,394,0,1,0,395,A
1-PB2,364,0,0,400,0,400,G
1-PB2,365,0,395,0,1,396,T
1-PB2,366,0,0,0,398,398,C
1-PB2,367,1,0,398,0,399,G
1-PB2,368,399,0,0,0,399,A
1-PB2,369,399,0,0,0,399,A
1-PB2,370,402,0,0,0,402,A
1-PB2,371,0,0,421,0,421,G
1-PB2,372,0,0,419,0,419,G
1-PB2,373,0,414,0,0,414,T
1-PB2,374,0,416,0,0,416,T
1-PB2,375,414,0,1,0,415,A
1-PB2,376,415,0,0,1,416,A
1-PB2,377,414,1,0,0,415,A
1-PB2,378,417,0,0,0,417,A
1-PB2,379,0,0,0,422,422,C
1-PB2,380,407,0,1,0,408,A
1-PB2,381,0,408,0,0,408,T
1-PB2,382,0,0,406,0,406,G
1-PB2,383,0,1,404,0,405,G
1-PB2,384,406,0,0,0,406,A
1-PB2,385,407,0,2,0,409,A
1-PB2,386,0,1,1,418,420,C
1-PB2,387,3,0,0,431,434,C
1-PB2,388,0,430,0,0,430,T
1-PB2,389,0,427,0,0,427,T
1-PB2,390,0,430,0,0,430,T
1-PB2,391,0,1,426,0,427,G
1-PB2,392,0,0,432,0,432,G
1-PB2,393,0,0,0,431,431,C
1-PB2,394,0,0,0,431,431,C
1-PB2,395,0,0,0,431,431,C
1-PB2,396,0,420,0,0,420,T
1-PB2,397,0,0,425,0,425,G
1-PB2,398,0,426,0,0,426,T
1-PB2,399,0,423,0,0,423,T
1-PB2,400,2,0,0,423,425,C
1-PB2,401,423,0,0,0,423,A
1-PB2,402,0,424,0,0,424,T
1-PB2,403,1,420,0,0,421,T
1-PB2,404,0,425,1,0,426,T
1-PB2,405,0,426,0,0,426,T
1-PB2,406,422,0,1,0,423,A
1-PB2,407,0,0,424,0,424,G
1-PB2,408,422,1,0,0,423,A
1-PB2,409,425,0,0,0,425,A
1-PB2,410,425,0,0,0,425,A
1-PB2,411,0,422,0,0,422,T
1-PB2,412,1,0,0,422,423,C
1-PB2,413,422,0,1,0,423,A
1-PB2,414,426,0,0,0,426,A
1-PB2,415,0,1,428,0,429,G
1-PB2,416,0,426,0,0,426,T
1-PB2,417,0,0,0,430,430,C
1-PB2,418,429,0,0,0,429,A
1-PB2,419,429,0,0,0,429,A
1-PB2,420,0,0,426,0,426,G
1-PB2,421,428,0,0,0,428,A
1-PB2,422,0,429,0,0,429,T
1-PB2,423,440,0,0,0,440,A
1-PB2,424,0,0,0,438,438,C
1-PB2,425,0,0,437,0,437,G
1-PB2,426,0,0,0,444,444,C
1-PB2,427,435,0,0,1,436,A
1-PB2,428,0,1,439,0,440,G
1-PB2,429,439,0,2,0,441,A
1-PB2,430,443,0,0,0,443,A
1-PB2,431,0,1,450,0,451,G
1-PB2,432,444,0,0,0,444,A
1-PB2,433,0,0,443,0,443,G
1-PB2,434,0,441,0,0,441,T
1-PB2,435,443,0,0,0,443,A
1-PB2,436,0,2,451,0,453,G
1-PB2,437,453,0,1,0,454,A
1-PB2,438,0,0,1,461,462,C
1-PB2,439,458,0,0,0,458,A
1-PB2,440,0,443,0,1,444,T
1-PB2,441,444,0,1,0,445,A
1-PB2,442,443,0,1,0,444,A
1-PB2,443,447,0,0,0,447,A
1-PB2,444,0,1,0,444,445,C
1-PB2,445,0,0,0,435,435,C
1-PB2,446,0,0,0,420,420,C
1-PB2,447,0,395,0,2,397,T
1-PB2,448,0,1,401,0,402,G
1-PB2,449,0,0,405,0,405,G
1-PB2,450,0,407,0,0,407,T
1-PB2,451,1,1,0,405,407,C
1-PB2,452,408,0,1,0,409,A
1-PB2,453,0,407,0,0,407,T
1-PB2,454,0,0,412,0,412,G
1-PB2,455,0,1,0,411,412,C
1-PB2,456,408,0,0,0,408,A
1-PB2,457,0,0,412,0,412,G
1-PB2,458,399,1,0,0,400,A
1-PB2,459,0,0,0,408,408,C
1-PB2,460,0,1,0,405,406,C
1-PB2,461,0,401,0,0,401,T
1-PB2,462,0,0,0,402,402,C
1-PB2,463,398,0,0,0,398,A
1-PB2,464,0,0,408,0,408,G
1-PB2,465,1,407,0,0,408,T
1-PB2,466,1,0,406,0,407,G
1-PB2,467,0,0,1,403,404,C
1-PB2,468,2,0,0,399,401,C
1-PB2,469,400,0,0,0,400,A
1-PB2,470,402,0,0,0,402,A
1-PB2,471,399,0,0,0,399,A
1-PB2,472,0,1,399,0,400,G
1-PB2,473,385,0,1,0,386,A
1-PB2,474,1,0,389,0,390,G
1-PB2,475,0,0,390,0,390,G
1-PB2,476,0,0,0,392,392,C
1-PB2,477,393,0,0,0,393,A
1-PB2,478,0,0,0,393,393,C
1-PB2,479,393,0,1,0,394,A
1-PB2,480,396,0,1,0,397,A
1-PB2,481,0,0,401,0,401,G
1-PB2,482,409,0,0,0,409,A
1-PB2,483,0,405,0,0,405,T
1-PB2,484,0,0,406,0,406,G
1-PB2,485,0,401,0,0,401,T
1-PB2,486,404,0,0,0,404,A
1-PB2,487,404,0,0,0,404,A
1-PB2,488,0,402,0,0,402,T
1-PB2,489,2,0,0,373,375,C
1-PB2,490,377,0,0,0,377,A
1-PB2,491,0,377,0,0,377,T
1-PB2,492,0,0,377,0,377,G
1-PB2,493,0,0,375,0,375,G
1-PB2,494,377,0,0,0,377,A
1-PB2,495,373,0,0,0,373,A
1-PB2,496,0,0,375,0,375,G
1-PB2,497,0,376,0,0,376,T
1-PB2,498,0,375,0,0,375,T
1-PB2,499,1,0,375,0,376,G
1-PB2,500,0,373,1,2,376,T
1-PB2,501,0,375,0,0,375,T
1-PB2,502,0,374,0,1,375,T
1-PB2,503,0,374,0,2,376,T
1-PB2,504,0,375,0,0,375,T
1-PB2,505,0,0,0,376,376,C
1-PB2,506,0,0,0,376,376,C
1-PB2,507,0,0,0,378,378,C
1-PB2,508,380,0,0,0,380,A
1-PB2,509,382,0,0,0,382,A
1-PB2,510,0,383,0,0,383,T
1-PB2,511,0,0,385,0,385,G
1-PB2,512,386,0,0,0,386,A
1-PB2,513,384,0,0,0,384,A
1-PB2,514,0,0,386,0,386,G
1-PB2,515,0,386,0,1,387,T
1-PB2,516,0,0,387,0,387,G
1-PB2,517,0,0,385,0,385,G
1-PB2,518,0,0,381,0,381,G
1-PB2,519,385,0,0,0,385,A
1-PB2,520,0,0,383,1,384,G
1-PB2,521,0,0,0,382,382,C
1-PB2,522,0,0,0,381,381,C
1-PB2,523,385,0,0,0,385,A
1-PB2,524,1,0,397,0,398,G
1-PB2,525,0,1,402,0,403,G
1-PB2,526,403,0,0,0,403,A
1-PB2,527,0,401,0,0,401,T
1-PB2,528,398,0,2,0,400,A
1-PB2,529,0,0,0,400,400,C
1-PB2,530,0,396,0,0,396,T
1-PB2,531,394,0,0,0,394,A
1-PB2,532,389,1,0,0,390,A
1-PB2,533,0,0,0,395,395,C
1-PB2,534,385,0,0,0,385,A
1-PB2,535,0,376,0,0,376,T
1-PB2,536,1,0,0,376,377,C
1-PB2,537,375,0,0,0,375,A
1-PB2,538,0,1,376,0,377,G
1-PB2,539,375,0,0,0,375,A
1-PB2,540,376,0,0,0,376,A
1-PB2,541,0,377,0,0,377,T
1-PB2,542,2,0,0,370,372,C
1-PB2,543,374,0,0,0,374,A
1-PB2,544,0,0,0,381,381,C
1-PB2,545,381,0,0,0,381,A
1-PB2,546,383,0,0,0,383,A
1-PB2,547,0,380,0,0,380,T
1-PB2,548,0,381,0,1,382,T
1-PB2,549,381,0,1,0,382,A
1-PB2,550,385,0,1,0,386,A
1-PB2,551,0,0,0,389,389,C
1-PB2,552,386,0,0,0,386,A
1-PB2,553,379,0,0,0,379,A
1-PB2,554,0,385,0,0,385,T
1-PB2,555,385,0,0,0,385,A
1-PB2,556,386,0,0,0,386,A
1-PB2,557,0,0,0,387,387,C
1-PB2,558,1,384,0,0,385,T
1-PB2,559,386,1,0,0,387,A
1-PB2,560,384,0,0,0,384,A
1-PB2,561,382,1,0,0,383,A
1-PB2,562,0,1,386,0,387,G
1-PB2,563,378,0,0,0,378,A
1-PB2,564,0,1,380,0,381,G
1-PB2,565,374,0,1,0,375,A
1-PB2,566,377,0,3,0,380,A
1-PB2,567,380,0,0,0,380,A
1-PB2,568,379,0,1,0,380,A
1-PB2,569,382,0,0,0,382,A
1-PB2,570,382,0,0,0,382,A
1-PB2,571,0,0,383,0,383,G
1-PB2,572,379,0,1,0,380,A
1-PB2,573,376,0,1,0,377,A
1-PB2,574,1,0,373,0,374,G
1-PB2,575,375,0,0,0,375,A
1-PB2,576,373,0,0,0,373,A
1-PB2,577,0,0,0,380,380,C
1-PB2,578,0,371,0,0,371,T
1-PB2,579,1,0,0,373,374,C
1-PB2,580,0,0,0,374,374,C
1-PB2,581,0,0,375,0,375,G
1-PB2,582,374,0,1,0,375,A
1-PB2,583,0,0,375,0,375,G
1-PB2,584,376,0,1,0,377,A
1-PB2,585,0,375,0,0,375,T
1-PB2,586,0,365,0,1,366,T
1-PB2,587,0,0,369,0,369,G
1-PB2,588,0,0,0,368,368,C
1-PB2,589,367,0,0,0,367,A
1-PB2,590,368,0,0,0,368,A
1-PB2,591,0,0,362,0,362,G
1-PB2,592,366,0,1,0,367,A
1-PB2,593,0,370,0,0,370,T
1-PB2,594,1,366,0,1,368,T
1-PB2,595,0,369,0,0,369,T
1-PB2,596,0,0,0,371,371,C
1-PB2,597,1,369,0,1,371,T
1-PB2,598,1,0,0,390,391,C
1-PB2,599,0,0,0,391,391,C
1-PB2,600,1,0,0,404,405,C
1-PB2,601,0,405,0,0,405,T
1-PB2,602,0,406,0,0,406,T
1-PB2,603,0,0,407,0,407,G
1-PB2,604,405,0,0,0,405,A
1-PB2,605,0,413,0,0,413,T
1-PB2,606,0,0,410,0,410,G
1-PB2,607,0,0,431,0,431,G
1-PB2,608,0,441,0,0,441,T
1-PB2,609,0,433,0,2,435,T
1-PB2,610,0,0,461,0,461,G
1-PB2,611,0,0,0,459,459,C
1-PB2,612,470,0,0,0,470,A
1-PB2,613,0,468,0,0,468,T
1-PB2,614,471,0,0,0,471,A
1-PB2,615,0,0,0,498,498,C
1-PB2,616,543,0,0,0,543,A
1-PB2,617,0,553,0,0,553,T
1-PB2,618,0,0,578,0,578,G
1-PB2,619,0,571,0,0,571,T
1-PB2,620,0,568,0,0,568,T
1-PB2,621,561,0,1,0,562,A
1-PB2,622,0,0,563,0,563,G
1-PB2,623,573,0,2,0,575,A
1-PB2,624,0,2,580,0,582,G
1-PB2,625,558,0,0,0,558,A
1-PB2,626,0,0,559,0,559,G
1-PB2,627,553,0,1,0,554,A
1-PB2,628,0,0,555,0,555,G
1-PB2,629,557,1,0,0,558,A
1-PB2,630,560,0,0,0,560,A
1-PB2,631,0,0,0,566,566,C
1-PB2,632,0,561,0,0,561,T
1-PB2,633,0,561,0,0,561,T
1-PB2,634,0,1,560,0,561,G
1-PB2,635,0,562,0,1,563,T
1-PB2,636,561,0,2,0,563,A
1-PB2,637,0,0,0,559,559,C
1-PB2,638,0,0,560,0,560,G
1-PB2,639,561,0,0,0,561,A
1-PB2,640,557,0,0,0,557,A
1-PB2,641,558,0,0,0,558,A
1-PB2,642,559,0,0,0,559,A
1-PB2,643,560,0,0,0,560,A
1-PB2,644,0,0,0,560,560,C
1-PB2,645,560,0,1,0,561,A
1-PB2,646,563,0,0,0,563,A
1-PB2,647,0,0,567,0,567,G
1-PB2,648,570,0,0,0,570,A
1-PB2,649,0,570,0,1,571,T
1-PB2,650,0,567,0,0,567,T
1-PB2,651,0,568,0,0,568,T
1-PB2,652,0,1,0,571,572,C
1-PB2,653,1,571,0,0,572,T
1-PB2,654,0,0,0,575,575,C
1-PB2,655,1,0,0,575,576,C
1-PB2,656,1,0,0,571,572,C
1-PB2,657,567,0,0,0,567,A
1-PB2,658,0,1,573,0,574,G
1-PB2,659,0,576,0,0,576,T
1-PB2,660,0,576,0,0,576,T
1-PB2,661,0,1,574,0,575,G
1-PB2,662,0,0,0,576,576,C
1-PB2,663,0,570,1,1,572,T
1-PB2,664,0,0,574,0,574,G
1-PB2,665,1,0,572,0,573,G
1-PB2,666,0,2,0,569,571,C
1-PB2,667,0,0,573,0,573,G
1-PB2,668,1,2,577,0,580,G
1-PB2,669,576,0,2,0,578,A
1-PB2,670,579,0,0,0,579,A
1-PB2,671,0,0,0,582,582,C
1-PB2,672,586,0,0,0,586,A
1-PB2,673,585,0,0,0,585,A
1-PB2,674,0,0,617,0,617,G
1-PB2,675,0,1,0,627,628,C
1-PB2,676,628,0,0,0,628,A
1-PB2,677,1,0,764,0,765,G
1-PB2,678,0,765,0,0,765,T
1-PB2,679,766,0,0,0,766,A
1-PB2,680,0,764,0,0,764,T
1-PB2,681,767,0,2,0,769,A
1-PB2,682,0,770,0,0,770,T
1-PB2,683,750,0,0,0,750,A
1-PB2,684,0,0,0,751,751,C
1-PB2,685,711,0,0,0,711,A
1-PB2,686,0,660,0,0,660,T
1-PB2,687,0,634,0,0,634,T
1-PB2,688,0,1,631,0,632,G
1-PB2,689,633,0,0,0,633,A
1-PB2,690,632,1,0,0,633,A
1-PB2,691,0,0,644,0,644,G
1-PB2,692,1,640,0,0,641,T
1-PB2,693,0,632,0,1,633,T
1-PB2,694,0,632,0,0,632,T
1-PB2,695,0,632,0,1,633,T
1-PB2,696,644,0,0,0,644,A
1-PB2,697,0,0,0,648,648,C
1-PB2,698,646,0,0,0,646,A
1-PB2,699,0,644,0,1,645,T
1-PB2,700,0,641,0,0,641,T
1-PB2,701,1,640,0,1,642,T
1-PB2,702,0,5,645,1,651,G
1-PB2,703,648,1,1,0,650,A
1-PB2,704,0,0,0,650,650,C
1-PB2,705,0,648,0,0,648,T
1-PB2,706,1,0,0,650,651,C
1-PB2,707,648,0,0,0,648,A
1-PB2,708,1,0,642,0,643,G
1-PB2,709,0,0,650,0,650,G
1-PB2,710,0,4,645,0,649,G
1-PB2,711,652,0,0,0,652,A
1-PB2,712,650,0,0,0,650,A
1-PB2,713,0,0,0,654,654,C
1-PB2,714,0,0,656,0,656,G
1-PB2,715,0,651,0,0,651,T
1-PB2,716,0,0,652,0,652,G
1-PB2,717,1,648,0,1,650,T
1-PB2,718,0,647,0,0,647,T
1-PB2,719,0,2,648,0,650,G
1-PB2,720,0,1,647,0,648,G
1-PB2,721,0,0,651,0,651,G
1-PB2,722,645,0,2,0,647,A
1-PB2,723,641,0,1,0,642,A
1-PB2,724,0,0,0,667,667,C
1-PB2,725,662,0,0,0,662,A
1-PB2,726,684,0,0,0,684,A
1-PB2,727,685,1,0,0,686,A
1-PB2,728,0,686,0,0,686,T
1-PB2,729,0,0,689,0,689,G
1-PB2,730,1,684,0,0,685,T
1-PB2,731,685,0,0,0,685,A
1-PB2,732,0,0,0,685,685,C
1-PB2,733,665,0,0,0,665,A
1-PB2,734,1,0,0,664,665,C
1-PB2,735,0,642,0,0,642,T
1-PB2,736,1,0,0,688,689,C
1-PB2,737,1,0,0,690,691,C
1-PB2,738,698,0,0,0,698,A
1-PB2,739,0,1,701,0,702,G
1-PB2,740,0,0,714,0,714,G
1-PB2,741,0,714,0,0,714,T
1-PB2,742,0,1,711,0,712,G
1-PB2,743,0,1,682,0,683,G
1-PB2,744,675,1,1,0,677,A
1-PB2,745,0,0,678,0,678,G
1-PB2,746,0,0,680,0,680,G
1-PB2,747,667,1,0,1,669,A
1-PB2,748,0,1,670,0,671,G
1-PB2,749,0,655,0,3,658,T
1-PB2,750,0,1,659,0,660,G
1-PB2,751,662,0,0,0,662,A
1-PB2,752,0,0,657,0,657,G
1-PB2,753,0,1,663,0,664,G
1-PB2,754,662,0,0,0,662,A
1-PB2,755,660,1,1,0,662,A
1-PB2,756,0,663,0,1,664,T
1-PB2,757,0,5,656,0,661,G
1-PB2,758,658,0,1,0,659,A
1-PB2,759,0,0,0,655,655,C
1-PB2,760,1,0,652,0,653,G
1-PB2,761,659,0,0,0,659,A
1-PB2,762,0,656,0,0,656,T
1-PB2,763,1,0,661,0,662,G
1-PB2,764,0,658,0,2,660,T
1-PB2,765,0,657,0,0,657,T
1-PB2,766,0,2,661,0,663,G
1-PB2,767,665,2,1,0,668,A
1-PB2,768,0,0,0,666,666,C
1-PB2,769,1,0,0,664,665,C
1-PB2,770,659,0,0,0,659,A
1-PB2,771,663,0,1,0,664,A
1-PB2,772,664,0,1,0,665,A
1-PB2,773,0,0,682,0,682,G
1-PB2,774,0,0,0,685,685,C
1-PB2,775,2,0,0,680,682,C
1-PB2,776,0,687,0,0,687,T
1-PB2,777,688,0,1,0,689,A
1-PB2,778,688,0,0,1,689,A
1-PB2,779,0,686,0,1,687,T
1-PB2,780,0,684,0,0,684,T
1-PB2,781,677,0,0,0,677,A
1-PB2,782,0,656,0,0,656,T
1-PB2,783,0,649,0,0,649,T
1-PB2,784,0,0,649,0,649,G
1-PB2,785,0,0,0,646,646,C
1-PB2,786,0,0,648,0,648,G
1-PB2,787,0,0,655,0,655,G
1-PB2,788,0,0,0,653,653,C
1-PB2,789,1,0,0,652,653,C
1-PB2,790,656,0,0,0,656,A
1-PB2,791,0,1,663,0,664,G
1-PB2,792,0,1,666,0,667,G
1-PB2,793,667,0,0,0,667,A
1-PB2,794,671,0,0,0,671,A
1-PB2,795,0,0,0,672,672,C
1-PB2,796,653,0,0,0,653,A
1-PB2,797,0,662,0,0,662,T
1-PB2,798,671,0,0,0,671,A
1-PB2,799,0,0,683,0,683,G
1-PB2,800,0,679,0,0,679,T
1-PB2,801,675,0,2,0,677,A
1-PB2,802,676,0,0,0,676,A
1-PB2,803,0,1,678,0,679,G
1-PB2,804,678,0,0,0,678,A
1-PB2,805,659,0,2,0,661,A
1-PB2,806,1,0,657,0,658,G
1-PB2,807,632,0,2,0,634,A
1-PB2,808,0,0,630,0,630,G
1-PB2,809,1,0,0,631,632,C
1-PB2,810,2,1,0,626,629,C
1-PB2,811,0,0,627,0,627,G
1-PB2,812,0,0,0,636,636,C
1-PB2,813,634,0,0,0,634,A
1-PB2,814,0,0,688,0,688,G
1-PB2,815,0,681,0,0,681,T
1-PB2,816,681,0,0,0,681,A
1-PB2,817,0,675,0,1,676,T
1-PB2,818,0,1,0,674,675,C
1-PB2,819,671,0,0,0,671,A
1-PB2,820,0,0,675,0,675,G
1-PB2,821,0,0,0,673,673,C
1-PB2,822,639,0,0,0,639,A
1-PB2,823,0,4,629,0,633,G
1-PB2,824,631,1,0,0,632,A
1-PB2,825,1,633,0,0,634,T
1-PB2,826,0,0,0,638,638,C
1-PB2,827,1,0,0,637,638,C
1-PB2,828,636,1,1,0,638,A
1-PB2,829,0,0,0,642,642,C
1-PB2,830,0,636,0,0,636,T
1-PB2,831,641,0,0,0,641,A
1-PB2,832,0,1,636,0,637,G
1-PB2,833,0,0,0,631,631,C
1-PB2,834,631,0,0,0,631,A
1-PB2,835,0,638,1,0,639,T
1-PB2,836,0,0,0,647,647,C
1-PB2,837,0,642,0,0,642,T
1-PB2,838,0,650,0,0,650,T
1-PB2,839,0,655,0,1,656,T
1-PB2,840,659,0,0,0,659,A
1-PB2,841,0,662,0,0,662,T
1-PB2,842,0,656,0,0,656,T
1-PB2,843,0,1,655,0,656,G
1-PB2,844,1,0,653,0,654,G
1-PB2,845,643,0,0,0,643,A
1-PB2,846,1,2,639,0,642,G
1-PB2,847,630,1,1,0,632,A
1-PB2,848,1,624,0,2,627,T
1-PB2,849,0,0,633,0,633,G
1-PB2,850,0,633,0,0,633,T
1-PB2,851,0,0,632,0,632,G
1-PB2,852,0,0,0,636,636,C
1-PB2,853,1,0,0,631,632,C
1-PB2,854,629,0,0,0,629,A
1-PB2,855,0,1,0,629,630,C
1-PB2,856,618,0,2,0,620,A
1-PB2,857,0,1,625,0,626,G
1-PB2,858,0,0,0,612,612,C
1-PB2,859,613,0,0,0,613,A
1-PB2,860,0,0,0,612,612,C
1-PB2,861,610,0,0,0,610,A
1-PB2,862,1,1,0,614,616,C
1-PB2,863,609,0,0,0,609,A
1-PB2,864,607,0,1,0,608,A
1-PB2,865,610,0,0,0,610,A
1-PB2,866,0,590,0,0,590,T
1-PB2,867,0,584,0,1,585,T
1-PB2,868,0,1,586,0,587,G
1-PB2,869,1,1,586,0,588,G
1-PB2,870,0,1,0,587,588,C
1-PB2,871,0,0,581,0,581,G
1-PB2,872,0,0,582,0,582,G
1-PB2,873,576,0,1,0,577,A
1-PB2,874,593,0,0,0,593,A
1-PB2,875,0,1,0,590,591,C
1-PB2,876,593,0,0,0,593,A
1-PB2,877,592,0,0,0,592,A
1-PB2,878,0,1,592,0,593,G
1-PB2,879,0,0,595,0,595,G
1-PB2,880,595,0,2,0,597,A
1-PB2,881,1,560,0,0,561,T
1-PB2,882,0,2,558,0,560,G
1-PB2,883,1,0,559,0,560,G
1-PB2,884,0,549,0,0,549,T
1-PB2,885,0,0,550,0,550,G
1-PB2,886,1,0,543,0,544,G
1-PB2,887,537,0,0,0,537,A
1-PB2,888,0,0,0,533,533,C
1-PB2,889,522,0,0,0,522,A
1-PB2,890,0,605,0,0,605,T
1-PB2,891,0,604,0,0,604,T
1-PB2,892,1,0,0,602,603,C
1-PB2,893,0,586,0,1,587,T
1-PB2,894,0,585,0,0,585,T
1-PB2,895,585,0,0,0,585,A
1-PB2,896,0,2,584,0,586,G
1-PB2,897,582,0,1,0,583,A
1-PB2,898,0,0,0,582,582,C
1-PB2,899,450,0,0,0,450,A
1-PB2,900,0,1,456,0,457,G
1-PB2,901,455,0,0,0,455,A
1-PB2,902,455,0,0,0,455,A
1-PB2,903,0,0,0,455,455,C
1-PB2,904,2,0,0,451,453,C
1-PB2,905,0,0,0,452,452,C
1-PB2,906,1,0,450,0,451,G
1-PB2,907,451,1,1,0,453,A
1-PB2,908,1,0,0,454,455,C
1-PB2,909,0,447,0,0,447,T
1-PB2,910,0,2,451,0,453,G
1-PB2,911,447,1,2,0,450,A
1-PB2,912,455,0,0,0,455,A
1-PB2,913,0,1,457,0,458,G
1-PB2,914,455,0,2,0,457,A
1-PB2,915,456,0,1,0,457,A
1-PB2,916,0,0,0,457,457,C
1-PB2,917,455,0,0,0,455,A
1-PB2,918,458,0,0,0,458,A
1-PB2,919,1,0,456,0,457,G
1-PB2,920,0,0,0,461,461,C
1-PB2,921,0,448,0,2,450,T
1-PB2,922,0,0,459,0,459,G
1-PB2,923,0,456,0,0,456,T
1-PB2,924,0,0,465,0,465,G
1-PB2,925,0,1,494,0,495,G
1-PB2,926,493,0,1,0,494,A
1-PB2,927,0,493,0,0,493,T
1-PB2,928,485,0,0,0,485,A
1-PB2,929,0,481,0,0,481,T
1-PB2,930,495,0,1,0,496,A
1-PB2,931,1,491,0,1,493,T
1-PB2,932,0,0,492,0,492,G
1-PB2,933,1,0,0,485,486,C
1-PB2,934,469,1,0,0,470,A
1-PB2,935,474,0,0,0,474,A
1-PB2,936,0,0,473,0,473,G
1-PB2,937,1,0,474,0,475,G
1-PB2,938,0,0,0,476,476,C
1-PB2,939,1,471,0,2,474,T
1-PB2,940,0,0,476,0,476,G
1-PB2,941,1,0,0,476,477,C
1-PB2,942,478,0,1,0,479,A
1-PB2,943,479,0,2,0,481,A
1-PB2,944,0,480,0,0,480,T
1-PB2,945,0,0,483,0,483,G
1-PB2,946,0,0,480,0,480,G
1-PB2,947,0,0,484,0,484,G
1-PB2,948,485,0,0,0,485,A
1-PB2,949,0,484,0,0,484,T
1-PB2,950,0,484,0,0,484,T
1-PB2,951,0,1,482,0,483,G
1-PB2,952,481,0,0,0,481,A
1-PB2,953,0,1,487,0,488,G
1-PB2,954,485,0,0,0,485,A
1-PB2,955,481,0,0,0,481,A
1-PB2,956,1,472,0,1,474,T
1-PB2,957,1,0,0,478,479,C
1-PB2,958,476,1,0,0,477,A
1-PB2,959,0,0,481,0,481,G
1-PB2,960,0,0,0,481,481,C
1-PB2,961,0,478,0,0,478,T
1-PB2,962,2,1,0,473,476,C
1-PB2,963,477,0,0,0,477,A
1-PB2,964,0,485,0,1,486,T
1-PB2,965,0,0,0,484,484,C
1-PB2,966,0,0,0,493,493,C
1-PB2,967,0,488,0,1,489,T
1-PB2,968,0,490,0,1,491,T
1-PB2,969,1,0,0,487,488,C
1-PB2,970,491,0,0,0,491,A
1-PB2,971,0,0,498,0,498,G
1-PB2,972,0,0,0,494,494,C
1-PB2,973,0,492,0,1,493,T
1-PB2,974,0,493,0,0,493,T
1-PB2,975,0,491,0,0,491,T
1-PB2,976,0,0,491,0,491,G
1-PB2,977,0,0,490,0,490,G
1-PB2,978,0,489,0,0,489,T
1-PB2,979,0,0,489,0,489,G
1-PB2,980,0,1,489,0,490,G
1-PB2,981,0,1,496,0,497,G
1-PB2,982,0,491,0,1,492,T
1-PB2,983,0,491,0,1,492,T
1-PB2,984,0,493,0,0,493,T
1-PB2,985,495,0,0,0,495,A
1-PB2,986,0,0,0,495,495,C
1-PB2,987,493,0,0,0,493,A
1-PB2,988,0,492,0,0,492,T
1-PB2,989,0,481,0,0,481,T
1-PB2,990,0,479,0,0,479,T
1-PB2,991,479,0,0,0,479,A
1-PB2,992,477,0,0,0,477,A
1-PB2,993,480,0,0,0,480,A
1-PB2,994,473,0,0,0,473,A
1-PB2,995,0,0,477,0,477,G
1-PB2,996,476,0,0,0,476,A
1-PB2,997,475,0,1,0,476,A
1-PB2,998,0,0,0,479,479,C
1-PB2,999,478,0,1,0,479,A
1-PB2,1000,481,0,2,0,483,A
1-PB2,1001,0,0,484,0,484,G
1-PB2,1002,0,0,0,484,484,C
1-PB2,1003,1,1,479,0,481,G
1-PB2,1004,0,0,483,0,483,G
1-PB2,1005,0,0,486,0,486,G
1-PB2,1006,0,483,0,0,483,T
1-PB2,1007,2,0,0,482,484,C
1-PB2,1008,484,0,1,0,485,A
1-PB2,1009,0,480,0,3,483,T
1-PB2,1010,1,0,0,483,484,C
1-PB2,1011,483,1,1,0,485,A
1-PB2,1012,0,0,489,1,490,G
1-PB2,1013,0,475,0,2,477,T
1-PB2,1014,1,0,0,478,479,C
1-PB2,1015,483,0,0,0,483,A
1-PB2,1016,482,0,0,0,482,A
1-PB2,1017,0,477,0,0,477,T
1-PB2,1018,481,0,0,0,481,A
1-PB2,1019,488,0,0,0,488,A
1-PB2,1020,491,0,1,0,492,A
1-PB2,1021,0,1,496,0,497,G
1-PB2,1022,491,0,0,0,491,A
1-PB2,1023,485,1,0,0,486,A
1-PB2,1024,0,0,486,0,486,G
1-PB2,1025,480,0,1,0,481,A
1-PB2,1026,460,0,2,0,462,A
1-PB2,1027,0,1,460,0,461,G
1-PB2,1028,458,1,0,0,459,A
1-PB2,1029,1,0,459,0,460,G
1-PB2,1030,0,0,472,0,472,G
1-PB2,1031,0,474,0,0,474,T
1-PB2,1032,0,1,475,0,476,G
1-PB2,1033,0,0,0,474,474,C
1-PB2,1034,0,476,1,0,477,T
1-PB2,1035,0,475,0,1,476,T
1-PB2,1036,478,0,0,0,478,A
1-PB2,1037,0,0,0,477,477,C
1-PB2,1038,473,0,0,0,473,A
1-PB2,1039,0,1,472,0,473,G
1-PB2,1040,0,0,477,0,477,G
1-PB2,1041,0,0,0,465,465,C
1-PB2,1042,467,0,0,0,467,A
1-PB2,1043,470,0,0,0,470,A
1-PB2,1044,0,469,0,1,470,T
1-PB2,1045,0,0,0,476,476,C
1-PB2,1046,0,477,0,0,477,T
1-PB2,1047,0,0,0,475,475,C
1-PB2,1048,0,0,0,476,476,C
1-PB2,1049,476,1,0,0,477,A
1-PB2,1050,477,0,0,0,477,A
1-PB2,1051,474,1,0,0,475,A
1-PB2,1052,0,1,0,481,482,C
1-PB2,1053,464,0,0,0,464,A
1-PB2,1054,0,459,0,0,459,T
1-PB2,1055,0,443,0,0,443,T
1-PB2,1056,0,0,443,0,443,G
1-PB2,1057,442,0,0,0,442,A
1-PB2,1058,0,1,437,0,438,G
1-PB2,1059,451,0,0,0,451,A
1-PB2,1060,449,0,0,0,449,A
1-PB2,1061,0,455,0,0,455,T
1-PB2,1062,455,0,0,0,455,A
1-PB2,1063,456,0,1,0,457,A
1-PB2,1064,0,1,465,0,466,G
1-PB2,1065,462,0,0,0,462,A
1-PB2,1066,0,0,476,0,476,G
1-PB2,1067,0,460,0,1,461,T
1-PB2,1068,469,0,0,0,469,A
1-PB2,1069,1,0,0,474,475,C
1-PB2,1070,471,0,0,0,471,A
1-PB2,1071,0,470,0,0,470,T
1-PB2,1072,0,0,468,0,468,G
1-PB2,1073,447,0,1,1,449,A
1-PB2,1074,0,2,448,0,450,G
1-PB2,1075,0,1,458,0,459,G
1-PB2,1076,0,1,474,0,475,G
1-PB2,1077,0,0,477,0,477,G
1-PB2,1078,0,460,0,1,461,T
1-PB2,1079,461,1,0,0,462,A
1-PB2,1080,0,460,0,0,460,T
1-PB2,1081,0,0,463,0,463,G
1-PB2,1082,458,0,1,0,459,A
1-PB2,1083,1,0,456,0,457,G
1-PB2,1084,0,1,455,0,456,G
1-PB2,1085,419,0,0,0,419,A
1-PB2,1086,0,0,431,0,431,G
1-PB2,1087,0,429,0,0,429,T
1-PB2,1088,0,441,0,0,441,T
1-PB2,1089,1,0,0,440,441,C
1-PB2,1090,438,1,1,0,440,A
1-PB2,1091,0,0,0,440,440,C
1-PB2,1092,437,0,0,0,437,A
1-PB2,1093,443,0,0,0,443,A
1-PB2,1094,0,444,0,0,444,T
1-PB2,1095,0,1,432,0,433,G
1-PB2,1096,0,1,436,0,437,G
1-PB2,1097,0,418,0,0,418,T
1-PB2,1098,0,0,424,0,424,G
1-PB2,1099,0,1,425,0,426,G
1-PB2,1100,0,1,420,0,421,G
1-PB2,1101,0,1,428,0,429,G
1-PB2,1102,422,0,1,0,423,A
1-PB2,1103,426,0,0,0,426,A
1-PB2,1104,424,0,0,0,424,A
1-PB2,1105,419,0,0,0,419,A
1-PB2,1106,0,0,420,0,420,G
1-PB2,1107,418,0,1,0,419,A
1-PB2,1108,0,0,419,0,419,G
1-PB2,1109,0,0,0,417,417,C
1-PB2,1110,414,0,1,0,415,A
1-PB2,1111,417,0,1,0,418,A
1-PB2,1112,0,0,0,426,426,C
1-PB2,1113,426,0,0,0,426,A
1-PB2,1114,0,0,439,0,439,G
1-PB2,1115,1,0,0,434,435,C
1-PB2,1116,0,433,0,2,435,T
1-PB2,1117,448,0,0,0,448,A
1-PB2,1118,0,449,0,0,449,T
1-PB2,1119,450,0,0,0,450,A
1-PB2,1120,0,2,0,448,450,C
1-PB2,1121,0,423,0,0,423,T
1-PB2,1122,428,0,0,0,428,A
1-PB2,1123,419,0,0,0,419,A
1-PB2,1124,0,0,420,0,420,G
1-PB2,1125,420,0,0,0,420,A
1-PB2,1126,409,0,0,0,409,A
1-PB2,1127,409,0,1,0,410,A
1-PB2,1128,407,0,0,0,407,A
1-PB2,1129,0,0,410,0,410,G
1-PB2,1130,0,0,1,408,409,C
1-PB2,1131,408,0,0,0,408,A
1-PB2,1132,408,0,1,0,409,A
1-PB2,1133,0,0,0,412,412,C
1-PB2,1134,0,0,0,413,413,C
1-PB2,1135,412,0,0,0,412,A
1-PB2,1136,0,0,412,0,412,G
1-PB2,1137,411,0,0,0,411,A
1-PB2,1138,407,0,0,1,408,A
1-PB2,1139,0,0,408,0,408,G
1-PB2,1140,0,1,399,0,400,G
1-PB2,1141,0,402,0,0,402,T
1-PB2,1142,0,405,0,1,406,T
1-PB2,1143,0,0,406,0,406,G
1-PB2,1144,0,0,415,0,415,G
1-PB2,1145,0,413,0,0,413,T
1-PB2,1146,1,411,0,0,412,T
1-PB2,1147,3,1,0,406,410,C
1-PB2,1148,405,0,1,0,406,A
1-PB2,1149,406,0,1,0,407,A
1-PB2,1150,0,0,0,429,429,C
1-PB2,1151,0,428,0,1,429,T
1-PB2,1152,1,0,0,431,432,C
1-PB2,1153,417,0,0,0,417,A
1-PB2,1154,0,418,0,0,418,T
1-PB2,1155,415,0,1,0,416,A
1-PB2,1156,1,0,417,0,418,G
1-PB2,1157,0,396,0,0,396,T
1-PB2,1158,0,0,397,1,398,G
1-PB2,1159,385,0,0,0,385,A
1-PB2,1160,0,0,390,0,390,G
1-PB2,1161,0,387,0,0,387,T
1-PB2,1162,0,0,386,0,386,G
1-PB2,1163,0,0,387,0,387,G
1-PB2,1164,385,0,0,0,385,A
1-PB2,1165,379,0,3,0,382,A
1-PB2,1166,0,0,383,0,383,G
1-PB2,1167,380,1,0,0,381,A
1-PB2,1168,0,0,381,0,381,G
1-PB2,1169,376,0,0,0,376,A
1-PB2,1170,0,0,0,375,375,C
1-PB2,1171,0,2,375,0,377,G
1-PB2,1172,376,0,0,0,376,A
1-PB2,1173,377,0,0,0,377,A
1-PB2,1174,0,1,0,376,377,C
1-PB2,1175,378,0,1,0,379,A
1-PB2,1176,0,0,401,0,401,G
1-PB2,1177,0,403,0,0,403,T
1-PB2,1178,2,0,0,397,399,C
1-PB2,1179,400,0,1,0,401,A
1-PB2,1180,398,0,1,0,399,A
1-PB2,1181,0,397,0,0,397,T
1-PB2,1182,398,0,0,0,398,A
1-PB2,1183,0,0,397,0,397,G
1-PB2,1184,0,0,0,393,393,C
1-PB2,1185,1,0,0,374,375,C
1-PB2,1186,0,0,372,0,372,G
1-PB2,1187,372,0,0,0,372,A
1-PB2,1188,374,0,0,0,374,A
1-PB2,1189,0,0,379,0,379,G
1-PB2,1190,0,0,0,380,380,C
1-PB2,1191,384,0,0,0,384,A
1-PB2,1192,382,0,0,0,382,A
1-PB2,1193,0,382,0,0,382,T
1-PB2,1194,386,0,0,0,386,A
1-PB2,1195,388,1,0,0,389,A
1-PB2,1196,0,389,0,0,389,T
1-PB2,1197,1,0,0,387,388,C
1-PB2,1198,0,0,388,0,388,G
1-PB2,1199,0,378,0,2,380,T
1-PB2,1200,2,0,377,0,379,G
1-PB2,1201,0,0,384,0,384,G
1-PB2,1202,0,1,0,379,380,C
1-PB2,1203,1,0,0,381,382,C
1-PB2,1204,381,0,0,0,381,A
1-PB2,1205,0,381,0,0,381,T
1-PB2,1206,0,0,381,1,382,G
1-PB2,1207,0,0,390,0,390,G
1-PB2,1208,0,389,0,0,389,T
1-PB2,1209,0,0,391,0,391,G
1-PB2,1210,0,383,1,0,384,T
1-PB2,1211,0,384,0,0,384,T
1-PB2,1212,0,384,0,0,384,T
1-PB2,1213,0,385,0,1,386,T
1-PB2,1214,0,0,0,390,390,C
1-PB2,1215,390,0,0,0,390,A
1-PB2,1216,0,0,0,416,416,C
1-PB2,1217,410,0,1,0,411,A
1-PB2,1218,418,0,0,0,418,A
1-PB2,1219,0,0,419,0,419,G
1-PB2,1220,418,0,0,0,418,A
1-PB2,1221,385,0,26,0,411,A
1-PB2,1222,0,1,415,0,416,G
1-PB2,1223,419,0,0,0,419,A
1-PB2,1224,0,419,0,0,419,T
1-PB2,1225,0,415,0,0,415,T
1-PB2,1226,0,0,416,0,416,G
1-PB2,1227,0,0,0,410,410,C
1-PB2,1228,412,0,0,0,412,A
1-PB2,1229,1,416,0,0,417,T
1-PB2,1230,0,1,437,0,438,G
1-PB2,1231,449,0,0,0,449,A
1-PB2,1232,0,449,0,0,449,T
1-PB2,1233,446,0,0,0,446,A
1-PB2,1234,449,0,0,0,449,A
1-PB2,1235,449,0,0,0,449,A
1-PB2,1236,448,0,1,0,449,A
1-PB2,1237,0,0,450,0,450,G
1-PB2,1238,0,0,0,464,464,C
1-PB2,1239,478,0,0,0,478,A
1-PB2,1240,1,0,494,0,495,G
1-PB2,1241,0,494,0,0,494,T
1-PB2,1242,0,492,0,1,493,T
1-PB2,1243,493,0,1,0,494,A
1-PB2,1244,0,0,500,0,500,G
1-PB2,1245,497,0,1,0,498,A
1-PB2,1246,0,2,499,0,501,G
1-PB2,1247,0,0,495,0,495,G
1-PB2,1248,2,475,0,0,477,T
1-PB2,1249,1,2,477,0,480,G
1-PB2,1250,481,0,1,0,482,A
1-PB2,1251,0,0,0,485,485,C
1-PB2,1252,1,0,0,485,486,C
1-PB2,1253,0,479,0,1,480,T
1-PB2,1254,0,0,480,0,480,G
1-PB2,1255,479,0,0,0,479,A
1-PB2,1256,479,0,0,0,479,A
1-PB2,1257,0,482,0,0,482,T
1-PB2,1258,0,482,0,0,482,T
1-PB2,1259,0,484,0,0,484,T
1-PB2,1260,0,0,1,483,484,C
1-PB2,1261,0,0,486,0,486,G
1-PB2,1262,0,481,0,4,485,T
1-PB2,1263,0,0,0,486,486,C
1-PB2,1264,485,1,0,0,486,A
1-PB2,1265,488,0,0,0,488,A
1-PB2,1266,0,0,0,488,488,C
1-PB2,1267,481,0,0,0,481,A
1-PB2,1268,0,1,493,0,494,G
1-PB2,1269,488,0,0,0,488,A
1-PB2,1270,0,1,490,0,491,G
1-PB2,1271,1,0,0,489,490,C
1-PB2,1272,491,0,0,0,491,A
1-PB2,1273,502,0,1,0,503,A
1-PB2,1274,502,0,0,0,502,A
1-PB2,1275,0,505,0,0,505,T
1-PB2,1276,0,0,0,506,506,C
1-PB2,1277,498,0,0,0,498,A
1-PB2,1278,0,0,497,0,497,G
1-PB2,1279,1,0,0,499,500,C
1-PB2,1280,0,0,503,0,503,G
1-PB2,1281,0,0,531,0,531,G
1-PB2,1282,0,532,0,0,532,T
1-PB2,1283,0,530,0,1,531,T
1-PB2,1284,0,1,527,0,528,G
1-PB2,1285,531,0,2,0,533,A
1-PB2,1286,536,0,0,0,536,A
1-PB2,1287,0,1,0,536,537,C
1-PB2,1288,0,0,0,533,533,C
1-PB2,1289,0,0,0,538,538,C
1-PB2,1290,1,1,0,512,514,C
1-PB2,1291,517,0,1,0,518,A
1-PB2,1292,0,522,0,0,522,T
1-PB2,1293,0,0,523,0,523,G
1-PB2,1294,0,0,1,521,522,C
1-PB2,1295,520,0,0,0,520,A
1-PB2,1296,0,516,0,0,516,T
1-PB2,1297,0,0,0,515,515,C
1-PB2,1298,510,0,0,0,510,A
1-PB2,1299,1,0,515,0,516,G
1-PB2,1300,0,0,0,513,513,C
1-PB2,1301,0,509,0,1,510,T
1-PB2,1302,0,506,0,1,507,T
1-PB2,1303,0,504,0,2,506,T
1-PB2,1304,0,509,0,0,509,T
1-PB2,1305,506,0,1,0,507,A
1-PB2,1306,506,0,1,0,507,A
1-PB2,1307,0,0,512,0,512,G
1-PB2,1308,0,1,507,0,508,G
1-PB2,1309,0,0,0,503,503,C
1-PB2,1310,499,0,1,0,500,A
1-PB2,1311,0,500,0,0,500,T
1-PB2,1312,0,503,0,0,503,T
1-PB2,1313,0,504,0,0,504,T
1-PB2,1314,0,505,0,0,505,T
1-PB2,1315,0,0,0,508,508,C
1-PB2,1316,506,0,0,0,506,A
1-PB2,1317,0,0,506,0,506,G
1-PB2,1318,504,0,0,0,504,A
1-PB2,1319,503,0,0,0,503,A
1-PB2,1320,506,0,0,0,506,A
1-PB2,1321,0,0,502,0,502,G
1-PB2,1322,514,0,0,0,514,A
1-PB2,1323,0,514,0,0,514,T
1-PB2,1324,0,0,515,0,515,G
1-PB2,1325,0,0,0,515,515,C
1-PB2,1326,0,1,516,0,517,G
1-PB2,1327,516,0,0,0,516,A
1-PB2,1328,516,0,0,0,516,A
1-PB2,1329,516,0,0,0,516,A
1-PB2,1330,0,0,517,0,517,G
1-PB2,1331,0,513,0,1,514,T
1-PB2,1332,0,2,513,0,515,G
1-PB2,1333,0,0,0,515,515,C
1-PB2,1334,0,509,0,0,509,T
1-PB2,1335,0,513,0,0,513,T
1-PB2,1336,0,513,0,0,513,T
1-PB2,1337,0,511,0,0,511,T
1-PB2,1338,0,513,0,0,513,T
1-PB2,1339,2,0,0,512,514,C
1-PB2,1340,513,0,0,0,513,A
1-PB2,1341,516,1,1,0,518,A
1-PB2,1342,514,0,0,0,514,A
1-PB2,1343,520,0,1,0,521,A
1-PB2,1344,0,520,0,0,520,T
1-PB2,1345,0,521,0,1,522,T
1-PB2,1346,0,1,521,0,522,G
1-PB2,1347,2,0,522,0,524,G
1-PB2,1348,0,0,523,0,523,G
1-PB2,1349,0,0,530,0,530,G
1-PB2,1350,527,0,0,0,527,A
1-PB2,1351,0,1,536,0,537,G
1-PB2,1352,0,534,0,0,534,T
1-PB2,1353,0,530,0,2,532,T
1-PB2,1354,0,3,529,0,532,G
1-PB2,1355,536,0,0,0,536,A
1-PB2,1356,534,0,1,0,535,A
1-PB2,1357,0,1,0,550,551,C
1-PB2,1358,544,0,1,0,545,A
1-PB2,1359,0,0,0,571,571,C
1-PB2,1360,560,1,0,0,561,A
1-PB2,1361,0,565,0,0,565,T
1-PB2,1362,1,1,0,563,565,C
1-PB2,1363,0,1,560,1,562,G
1-PB2,1364,565,0,1,0,566,A
1-PB2,1365,0,0,0,565,565,C
1-PB2,1366,546,1,1,0,548,A
1-PB2,1367,0,0,570,0,570,G
1-PB2,1368,0,556,0,1,557,T
1-PB2,1369,0,0,572,0,572,G
1-PB2,1370,0,568,0,1,569,T
1-PB2,1371,0,1,570,0,571,G
1-PB2,1372,569,0,1,0,570,A
1-PB2,1373,0,566,0,0,566,T
1-PB2,1374,0,3,567,0,570,G
1-PB2,1375,0,1,567,0,568,G
1-PB2,1376,1,2,556,0,559,G
1-PB2,1377,552,0,0,0,552,A
1-PB2,1378,553,0,0,0,553,A
1-PB2,1379,0,553,0,0,553,T
1-PB2,1380,1,0,557,0,558,G
1-PB2,1381,561,0,0,0,561,A
1-PB2,1382,0,562,1,0,563,T
1-PB2,1383,0,562,0,0,562,T
1-PB2,1384,1,0,561,0,562,G
1-PB2,1385,0,0,571,0,571,G
1-PB2,1386,568,0,0,0,568,A
1-PB2,1387,0,0,583,0,583,G
1-PB2,1388,0,572,0,1,573,T
1-PB2,1389,572,0,0,0,572,A
1-PB2,1390,0,573,0,2,575,T
1-PB2,1391,0,572,0,0,572,T
1-PB2,1392,578,0,0,0,578,A
1-PB2,1393,0,1,0,576,577,C
1-PB2,1394,0,0,0,561,561,C
1-PB2,1395,0,0,554,0,554,G
1-PB2,1396,0,1,567,0,568,G
1-PB2,1397,579,0,1,0,580,A
1-PB2,1398,0,577,0,0,577,T
1-PB2,1399,571,0,1,0,572,A
1-PB2,1400,0,569,1,0,570,T
1-PB2,1401,0,0,566,0,566,G
1-PB2,1402,571,0,0,0,571,A
1-PB2,1403,0,0,0,582,582,C
1-PB2,1404,0,573,0,1,574,T
1-PB2,1405,1,0,0,574,575,C
1-PB2,1406,1,0,0,565,566,C
1-PB2,1407,572,0,1,0,573,A
1-PB2,1408,572,0,1,1,574,A
1-PB2,1409,0,0,584,0,584,G
1-PB2,1410,0,0,0,582,582,C
1-PB2,1411,577,0,0,0,577,A
1-PB2,1412,0,1,0,574,575,C
1-PB2,1413,577,1,0,0,578,A
1-PB2,1414,0,0,581,0,581,G
1-PB2,1415,579,0,0,0,579,A
1-PB2,1416,0,0,582,0,582,G
1-PB2,1417,588,0,0,0,588,A
1-PB2,1418,1,579,0,0,580,T
1-PB2,1419,1,0,587,0,588,G
1-PB2,1420,1,585,0,0,586,T
1-PB2,1421,2,0,0,580,582,C
1-PB2,1422,588,0,2,0,590,A
1-PB2,1423,590,0,0,0,590,A
1-PB2,1424,0,590,0,0,590,T
1-PB2,1425,1,0,589,0,590,G
1-PB2,1426,581,0,0,0,581,A
1-PB2,1427,0,0,583,0,583,G
1-PB2,1428,574,1,0,0,575,A
1-PB2,1429,0,1,578,0,579,G
1-PB2,1430,1,2,605,0,608,G
1-PB2,1431,608,0,1,0,609,A
1-PB2,1432,609,0,1,0,610,A
1-PB2,1433,0,610,0,0,610,T
1-PB2,1434,608,0,0,0,608,A
1-PB2,1435,611,0,0,0,611,A
1-PB2,1436,0,1,610,0,611,G
1-PB2,1437,607,0,0,0,607,A
1-PB2,1438,0,0,613,0,613,G
1-PB2,1439,0,575,1,0,576,T
1-PB2,1440,1,0,0,581,582,C
1-PB2,1441,581,0,0,0,581,A
1-PB2,1442,0,0,589,0,589,G
1-PB2,1443,0,0,0,599,599,C
1-PB2,1444,598,0,0,0,598,A
1-PB2,1445,600,0,0,0,600,A
1-PB2,1446,603,0,0,0,603,A
1-PB2,1447,598,0,2,1,601,A
1-PB2,1448,0,601,0,0,601,T
1-PB2,1449,0,1,601,0,602,G
1-PB2,1450,0,0,606,0,606,G
1-PB2,1451,0,0,607,0,607,G
1-PB2,1452,0,598,0,0,598,T
1-PB2,1453,0,0,602,0,602,G
1-PB2,1454,0,597,0,1,598,T
1-PB2,1455,0,2,598,0,600,G
1-PB2,1456,0,0,608,0,608,G
1-PB2,1457,606,0,2,0,608,A
1-PB2,1458,0,602,0,0,602,T
1-PB2,1459,0,1,612,0,613,G
1-PB2,1460,611,0,0,0,611,A
1-PB2,1461,613,0,0,0,613,A
1-PB2,1462,0,615,0,0,615,T
1-PB2,1463,610,0,0,0,610,A
1-PB2,1464,0,0,0,661,661,C
1-PB2,1465,0,643,0,0,643,T
1-PB2,1466,1,0,0,655,656,C
1-PB2,1467,1,0,0,657,658,C
1-PB2,1468,662,1,0,1,664,A
1-PB2,1469,1,0,696,0,697,G
1-PB2,1470,0,693,1,0,694,T
1-PB2,1471,698,0,1,0,699,A
1-PB2,1472,0,0,0,700,700,C
1-PB2,1473,640,0,1,0,641,A
1-PB2,1474,0,1,640,0,641,G
1-PB2,1475,628,0,0,0,628,A
1-PB2,1476,0,0,637,0,637,G
1-PB2,1477,624,0,1,0,625,A
1-PB2,1478,0,1,595,0,596,G
1-PB2,1479,0,2,594,0,596,G
1-PB2,1480,0,1,599,0,600,G
1-PB2,1481,0,590,0,0,590,T
1-PB2,1482,0,0,587,0,587,G
1-PB2,1483,1,0,587,0,588,G
1-PB2,1484,0,582,0,2,584,T
1-PB2,1485,0,0,598,0,598,G
1-PB2,1486,1,0,598,0,599,G
1-PB2,1487,0,584,0,0,584,T
1-PB2,1488,0,581,0,0,581,T
1-PB2,1489,578,0,0,0,578,A
1-PB2,1490,0,0,578,0,578,G
1-PB2,1491,0,0,0,577,577,C
1-PB2,1492,574,1,1,0,576,A
1-PB2,1493,0,575,0,0,575,T
1-PB2,1494,0,559,0,0,559,T
1-PB2,1495,1,1,558,0,560,G
1-PB2,1496,556,0,0,0,556,A
1-PB2,1497,0,561,0,0,561,T
1-PB2,1498,0,0,0,559,559,C
1-PB2,1499,0,0,551,0,551,G
1-PB2,1500,0,0,558,0,558,G
1-PB2,1501,0,558,1,0,559,T
1-PB2,1502,0,559,0,0,559,T
1-PB2,1503,0,560,0,0,560,T
1-PB2,1504,0,557,1,1,559,T
1-PB2,1505,0,556,0,1,557,T
1-PB2,1506,0,2,556,0,558,G
1-PB2,1507,558,0,0,0,558,A
1-PB2,1508,0,0,561,0,561,G
1-PB2,1509,546,0,0,0,546,A
1-PB2,1510,0,0,551,0,551,G
1-PB2,1511,0,552,0,0,552,T
1-PB2,1512,0,551,0,1,552,T
1-PB2,1513,1,1,0,551,553,C
1-PB2,1514,0,0,553,0,553,G
1-PB2,1515,553,0,1,0,554,A
1-PB2,1516,0,2,555,0,557,G
1-PB2,1517,553,0,2,0,555,A
1-PB2,1518,0,0,0,553,553,C
1-PB2,1519,2,0,0,546,548,C
1-PB2,1520,543,0,0,0,543,A
1-PB2,1521,554,0,0,0,554,A
1-PB2,1522,0,0,0,555,555,C
1-PB2,1523,1,0,555,0,556,G
1-PB2,1524,0,552,0,0,552,T
1-PB2,1525,0,0,551,0,551,G
1-PB2,1526,0,1,552,0,553,G
1-PB2,1527,0,1,551,0,552,G
1-PB2,1528,553,0,0,0,553,A
1-PB2,1529,553,0,1,0,554,A
1-PB2,1530,0,541,0,1,542,T
1-PB2,1531,1,0,571,0,572,G
1-PB2,1532,0,572,0,0,572,T
1-PB2,1533,571,0,0,0,571,A
1-PB2,1534,0,573,0,0,573,T
1-PB2,1535,0,566,0,0,566,T
1-PB2,1536,574,0,0,0,574,A
1-PB2,1537,1,570,0,0,571,T
1-PB2,1538,0,570,0,0,570,T
1-PB2,1539,568,0,0,0,568,A
1-PB2,1540,0,514,0,0,514,T
1-PB2,1541,0,0,0,543,543,C
1-PB2,1542,0,531,0,0,531,T
1-PB2,1543,2,0,0,531,533,C
1-PB2,1544,1,0,0,534,535,C
1-PB2,1545,0,523,0,1,524,T
1-PB2,1546,0,0,525,0,525,G
1-PB2,1547,525,0,0,0,525,A
1-PB2,1548,0,0,527,0,527,G
1-PB2,1549,0,0,524,0,524,G
1-PB2,1550,483,0,1,0,484,A
1-PB2,1551,0,0,486,0,486,G
1-PB2,1552,0,0,481,0,481,G
1-PB2,1553,1,449,0,0,450,T
1-PB2,1554,2,0,0,451,453,C
1-PB2,1555,443,0,0,0,443,A
1-PB2,1556,1,0,450,0,451,G
1-PB2,1557,0,453,0,0,453,T
1-PB2,1558,0,1,452,0,453,G
1-PB2,1559,455,0,0,0,455,A
1-PB2,1560,433,0,1,1,435,A
1-PB2,1561,434,0,2,0,436,A
1-PB2,1562,0,0,0,438,438,C
1-PB2,1563,429,0,1,0,430,A
1-PB2,1564,0,0,0,431,431,C
1-PB2,1565,414,0,0,0,414,A
1-PB2,1566,0,0,416,0,416,G
1-PB2,1567,0,1,415,0,416,G
1-PB2,1568,0,0,417,1,418,G
1-PB2,1569,417,0,0,0,417,A
1-PB2,1570,414,0,0,0,414,A
1-PB2,1571,0,0,0,416,416,C
1-PB2,1572,0,413,0,0,413,T
1-PB2,1573,0,1,416,0,417,G
1-PB2,1574,413,0,1,0,414,A
1-PB2,1575,0,0,421,0,421,G
1-PB2,1576,415,0,0,0,415,A
1-PB2,1577,0,0,400,0,400,G
1-PB2,1578,401,0,0,0,401,A
1-PB2,1579,0,0,0,400,400,C
1-PB2,1580,1,385,0,0,386,T
1-PB2,1581,0,0,391,0,391,G
1-PB2,1582,391,0,2,0,393,A
1-PB2,1583,0,1,0,396,397,C
1-PB2,1584,393,0,3,0,396,A
1-PB2,1585,397,0,0,0,397,A
1-PB2,1586,0,397,0,0,397,T
1-PB2,1587,402,0,1,0,403,A
1-PB2,1588,403,0,0,0,403,A
1-PB2,1589,0,0,0,405,405,C
1-PB2,1590,0,378,0,0,378,T
1-PB2,1591,0,381,0,0,381,T
1-PB2,1592,377,0,0,0,377,A
1-PB2,1593,1,375,0,0,376,T
1-PB2,1594,0,375,0,0,375,T
1-PB2,1595,0,0,0,374,374,C
1-PB2,1596,349,0,0,0,349,A
1-PB2,1597,0,349,0,0,349,T
1-PB2,1598,0,0,0,341,341,C
1-PB2,1599,0,0,343,0,343,G
1-PB2,1600,0,344,0,1,345,T
1-PB2,1601,0,0,0,339,339,C
1-PB2,1602,1,0,340,0,341,G
1-PB2,1603,338,0,0,0,338,A
1-PB2,1604,0,340,0,0,340,T
1-PB2,1605,0,0,341,0,341,G
1-PB2,1606,335,0,2,0,337,A
1-PB2,1607,0,343,0,1,344,T
1-PB2,1608,0,0,344,0,344,G
1-PB2,1609,0,337,0,0,337,T
1-PB2,1610,1,2,334,0,337,G
1-PB2,1611,0,0,338,0,338,G
1-PB2,1612,0,0,337,0,337,G
1-PB2,1613,329,0,0,0,329,A
1-PB2,1614,0,0,335,1,336,G
1-PB2,1615,313,0,0,0,313,A
1-PB2,1616,0,307,0,0,307,T
1-PB2,1617,0,302,0,0,302,T
1-PB2,1618,302,0,1,0,303,A
1-PB2,1619,302,0,1,0,303,A
1-PB2,1620,0,0,0,301,301,C
1-PB2,1621,0,0,294,0,294,G
1-PB2,1622,0,0,298,0,298,G
1-PB2,1623,0,280,0,0,280,T
1-PB2,1624,0,0,0,280,280,C
1-PB2,1625,0,0,0,280,280,C
1-PB2,1626,0,261,0,0,261,T
1-PB2,1627,0,0,259,0,259,G
1-PB2,1628,259,0,0,0,259,A
1-PB2,1629,0,0,261,0,261,G
1-PB2,1630,0,261,0,0,261,T
1-PB2,1631,1,0,0,249,250,C
1-PB2,1632,0,0,250,0,250,G
1-PB2,1633,0,0,254,0,254,G
1-PB2,1634,1,251,0,1,253,T
1-PB2,1635,1,252,0,1,254,T
1-PB2,1636,0,254,0,0,254,T
1-PB2,1637,0,252,0,0,252,T
1-PB2,1638,1,0,256,0,257,G
1-PB2,1639,0,0,257,0,257,G
1-PB2,1640,0,255,0,0,255,T
1-PB2,1641,1,0,1,252,254,C
1-PB2,1642,248,0,0,0,248,A
1-PB2,1643,261,0,0,0,261,A
1-PB2,1644,0,260,0,0,260,T
1-PB2,1645,262,0,0,0,262,A
1-PB2,1646,0,0,0,269,269,C
1-PB2,1647,0,0,0,264,264,C
1-PB2,1648,0,262,1,0,263,T
1-PB2,1649,275,0,0,0,275,A
1-PB2,1650,0,276,0,0,276,T
1-PB2,1651,0,0,0,278,278,C
1-PB2,1652,264,0,0,0,264,A
1-PB2,1653,265,0,0,0,265,A
1-PB2,1654,0,267,0,0,267,T
1-PB2,1655,0,1,255,0,256,G
1-PB2,1656,0,0,258,0,258,G
1-PB2,1657,256,0,0,0,256,A
1-PB2,1658,0,253,0,0,253,T
1-PB2,1659,0,0,0,255,255,C
1-PB2,1660,257,0,0,0,257,A
1-PB2,1661,0,255,0,0,255,T
1-PB2,1662,0,0,0,258,258,C
1-PB2,1663,258,0,0,0,258,A
1-PB2,1664,0,2,258,0,260,G
1-PB2,1665,260,0,0,0,260,A
1-PB2,1666,258,0,0,0,258,A
1-PB2,1667,258,0,0,0,258,A
1-PB2,1668,0,259,0,0,259,T
1-PB2,1669,0,258,0,0,258,T
1-PB2,1670,0,0,258,0,258,G
1-PB2,1671,1,0,254,0,255,G
1-PB2,1672,0,0,255,0,255,G
1-PB2,1673,255,0,0,0,255,A
1-PB2,1674,254,0,0,0,254,A
1-PB2,1675,0,0,256,0,256,G
1-PB2,1676,0,0,0,254,254,C
1-PB2,1677,0,253,0,0,253,T
1-PB2,1678,0,0,256,0,256,G
1-PB2,1679,0,256,0,0,256,T
1-PB2,1680,1,0,0,254,255,C
1-PB2,1681,256,0,0,0,256,A
1-PB2,1682,256,0,0,0,256,A
1-PB2,1683,256,0,0,0,256,A
1-PB2,1684,254,0,0,0,254,A
1-PB2,1685,0,255,0,0,255,T
1-PB2,1686,0,255,0,0,255,T
1-PB2,1687,4,0,0,248,252,C
1-PB2,1688,251,0,0,0,251,A
1-PB2,1689,250,0,0,0,250,A
1-PB2,1690,0,249,0,1,250,T
1-PB2,1691,0,0,250,0,250,G
1-PB2,1692,0,0,252,0,252,G
1-PB2,1693,0,255,0,0,255,T
1-PB2,1694,0,0,0,253,253,C
1-PB2,1695,0,256,0,2,258,T
1-PB2,1696,0,0,0,258,258,C
1-PB2,1697,258,0,0,0,258,A
1-PB2,1698,0,0,259,0,259,G
1-PB2,1699,259,0,0,0,259,A
1-PB2,1700,260,0,0,0,260,A
1-PB2,1701,0,254,0,0,254,T
1-PB2,1702,0,0,0,252,252,C
1-PB2,1703,0,0,0,244,244,C
1-PB2,1704,0,244,0,1,245,T
1-PB2,1705,0,0,245,0,245,G
1-PB2,1706,0,0,0,245,245,C
1-PB2,1707,243,0,0,0,243,A
1-PB2,1708,248,0,0,0,248,A
1-PB2,1709,0,245,0,0,245,T
1-PB2,1710,0,0,252,0,252,G
1-PB2,1711,0,251,0,0,251,T
1-PB2,1712,0,244,0,0,244,T
1-PB2,1713,0,0,246,0,246,G
1-PB2,1714,0,246,0,0,246,T
1-PB2,1715,246,0,0,0,246,A
1-PB2,1716,0,1,0,245,246,C
1-PB2,1717,238,0,0,0,238,A
1-PB2,1718,238,0,1,0,239,A
1-PB2,1719,0,0,0,237,237,C
1-PB2,1720,232,0,0,0,232,A
1-PB2,1721,233,0,0,0,233,A
1-PB2,1722,227,0,0,0,227,A
1-PB2,1723,227,0,0,0,227,A
1-PB2,1724,0,227,0,0,227,T
1-PB2,1725,0,0,226,0,226,G
1-PB2,1726,0,1,228,0,229,G
1-PB2,1727,226,0,0,0,226,A
1-PB2,1728,227,0,0,0,227,A
1-PB2,1729,0,227,0,0,227,T
1-PB2,1730,0,225,0,0,225,T
1-PB2,1731,0,226,0,0,226,T
1-PB2,1732,0,0,226,0,226,G
1-PB2,1733,225,0,0,0,225,A
1-PB2,1734,227,0,0,0,227,A
1-PB2,1735,0,0,0,227,227,C
1-PB2,1736,1,0,0,219,220,C
1-PB2,1737,224,0,0,0,224,A
1-PB2,1738,0,229,0,1,230,T
1-PB2,1739,0,230,0,0,230,T
1-PB2,1740,0,230,0,0,230,T
1-PB2,1741,0,0,0,230,230,C
1-PB2,1742,230,0,0,0,230,A
1-PB2,1743,229,0,0,0,229,A
1-PB2,1744,0,231,0,0,231,T
1-PB2,1745,0,0,0,233,233,C
1-PB2,1746,0,232,0,0,232,T
1-PB2,1747,0,230,0,0,230,T
1-PB2,1748,0,230,0,0,230,T
1-PB2,1749,231,0,0,0,231,A
1-PB2,1750,0,0,231,0,231,G
1-PB2,1751,0,232,0,0,232,T
1-PB2,1752,0,0,0,236,236,C
1-PB2,1753,0,0,0,235,235,C
1-PB2,1754,0,0,0,235,235,C
1-PB2,1755,0,0,0,233,233,C
1-PB2,1756,233,0,0,0,233,A
1-PB2,1757,231,0,2,0,233,A
1-PB2,1758,0,0,236,0,236,G
1-PB2,1759,0,0,236,0,236,G
1-PB2,1760,0,0,0,237,237,C
1-PB2,1761,0,0,0,233,233,C
1-PB2,1762,234,0,0,0,234,A
1-PB2,1763,0,238,0,0,238,T
1-PB2,1764,0,238,0,0,238,T
1-PB2,1765,238,0,0,0,238,A
1-PB2,1766,0,0,237,0,237,G
1-PB2,1767,239,0,0,0,239,A
1-PB2,1768,250,0,0,0,250,A
1-PB2,1769,0,0,251,0,251,G
1-PB2,1770,0,0,0,255,255,C
1-PB2,1771,0,0,0,255,255,C
1-PB2,1772,251,0,0,0,251,A
1-PB2,1773,256,0,0,0,256,A
1-PB2,1774,0,257,0,0,257,T
1-PB2,1775,258,0,0,0,258,A
1-PB2,1776,0,0,0,259,259,C
1-PB2,1777,238,0,0,0,238,A
1-PB2,1778,0,0,238,0,238,G
1-PB2,1779,0,226,0,1,227,T
1-PB2,1780,0,1,229,0,230,G
1-PB2,1781,0,0,229,0,229,G
1-PB2,1782,0,0,230,0,230,G
1-PB2,1783,0,227,0,0,227,T
1-PB2,1784,0,226,0,1,227,T
1-PB2,1785,0,229,0,0,229,T
1-PB2,1786,0,0,233,0,233,G
1-PB2,1787,1,233,0,0,234,T
1-PB2,1788,0,0,0,233,233,C
1-PB2,1789,231,0,0,0,231,A
1-PB2,1790,0,0,232,0,232,G
1-PB2,1791,231,0,0,0,231,A
1-PB2,1792,231,0,0,0,231,A
1-PB2,1793,0,0,0,231,231,C
1-PB2,1794,0,224,0,0,224,T
1-PB2,1795,0,0,0,234,234,C
1-PB2,1796,0,233,0,0,233,T
1-PB2,1797,234,0,0,0,234,A
1-PB2,1798,0,233,0,0,233,T
1-PB2,1799,0,230,0,1,231,T
1-PB2,1800,0,0,1,229,230,C
1-PB2,1801,0,0,0,228,228,C
1-PB2,1802,227,0,0,0,227,A
1-PB2,1803,226,0,0,0,226,A
1-PB2,1804,0,0,0,227,227,C
1-PB2,1805,224,0,0,0,224,A
1-PB2,1806,223,0,0,0,223,A
1-PB2,1807,223,1,0,0,224,A
1-PB2,1808,0,225,0,0,225,T
1-PB2,1809,0,0,226,0,226,G
1-PB2,1810,222,0,0,0,222,A
1-PB2,1811,0,0,227,0,227,G
1-PB2,1812,229,0,0,0,229,A
1-PB2,1813,0,0,228,0,228,G
1-PB2,1814,230,0,1,0,231,A
1-PB2,1815,0,0,0,228,228,C
1-PB2,1816,0,0,230,0,230,G
1-PB2,1817,0,228,0,0,228,T
1-PB2,1818,231,0,0,0,231,A
1-PB2,1819,0,0,0,234,234,C
1-PB2,1820,0,231,0,0,231,T
1-PB2,1821,0,232,0,0,232,T
1-PB2,1822,0,0,228,0,228,G
1-PB2,1823,0,0,230,0,230,G
1-PB2,1824,0,1,230,0,231,G
1-PB2,1825,226,0,1,0,227,A
1-PB2,1826,0,0,0,229,229,C
1-PB2,1827,227,0,0,0,227,A
1-PB2,1828,0,228,0,0,228,T
1-PB2,1829,0,227,1,0,228,T
1-PB2,1830,0,227,0,0,227,T
1-PB2,1831,0,0,229,0,229,G
1-PB2,1832,231,0,0,0,231,A
1-PB2,1833,0,0,0,230,230,C
1-PB2,1834,229,0,1,0,230,A
1-PB2,1835,0,0,0,231,231,C
1-PB2,1836,1,0,0,226,227,C
1-PB2,1837,228,0,0,0,228,A
1-PB2,1838,0,0,0,234,234,C
1-PB2,1839,0,1,0,234,235,C
1-PB2,1840,0,0,0,234,234,C
1-PB2,1841,232,0,0,0,232,A
1-PB2,1842,0,0,235,0,235,G
1-PB2,1843,236,0,1,0,237,A
1-PB2,1844,0,242,0,0,242,T
1-PB2,1845,236,0,0,0,236,A
1-PB2,1846,236,0,0,0,236,A
1-PB2,1847,0,232,1,1,234,T
1-PB2,1848,234,0,0,0,234,A
1-PB2,1849,234,0,0,0,234,A
1-PB2,1850,229,0,0,0,229,A
1-PB2,1851,0,0,233,0,233,G
1-PB2,1852,0,0,0,232,232,C
1-PB2,1853,0,216,0,0,216,T
1-PB2,1854,0,217,0,0,217,T
1-PB2,1855,0,2,0,214,216,C
1-PB2,1856,0,213,0,0,213,T
1-PB2,1857,0,0,0,220,220,C
1-PB2,1858,1,0,0,221,222,C
1-PB2,1859,0,0,0,222,222,C
1-PB2,1860,0,0,0,216,216,C
1-PB2,1861,0,222,0,0,222,T
1-PB2,1862,0,223,0,0,223,T
1-PB2,1863,0,223,0,0,223,T
1-PB2,1864,0,0,223,0,223,G
1-PB2,1865,0,0,0,224,224,C
1-PB2,1866,220,0,0,0,220,A
1-PB2,1867,0,0,221,0,221,G
1-PB2,1868,0,0,0,222,222,C
1-PB2,1869,1,220,0,0,221,T
1-PB2,1870,0,0,220,0,220,G
1-PB2,1871,0,0,0,222,222,C
1-PB2,1872,1,218,0,1,220,T
1-PB2,1873,0,0,0,224,224,C
1-PB2,1874,0,0,0,225,225,C
1-PB2,1875,225,0,1,0,226,A
1-PB2,1876,0,0,0,226,226,C
1-PB2,1877,0,0,0,226,226,C
1-PB2,1878,225,0,0,0,225,A
1-PB2,1879,229,0,0,0,229,A
1-PB2,1880,226,0,2,0,228,A
1-PB2,1881,0,0,232,0,232,G
1-PB2,1882,0,0,0,231,231,C
1-PB2,1883,227,0,1,0,228,A
1-PB2,1884,232,0,0,0,232,A
1-PB2,1885,230,0,0,0,230,A
1-PB2,1886,0,0,232,0,232,G
1-PB2,1887,0,0,0,232,232,C
1-PB2,1888,229,0,0,0,229,A
1-PB2,1889,0,0,228,0,228,G
1-PB2,1890,226,0,0,0,226,A
1-PB2,1891,226,0,0,0,226,A
1-PB2,1892,0,226,0,0,226,T
1-PB2,1893,0,0,228,0,228,G
1-PB2,1894,0,0,0,228,228,C
1-PB2,1895,225,0,0,0,225,A
1-PB2,1896,0,0,228,0,228,G
1-PB2,1897,0,226,0,1,227,T
1-PB2,1898,0,234,0,0,234,T
1-PB2,1899,0,0,0,235,235,C
1-PB2,1900,0,231,0,0,231,T
1-PB2,1901,0,0,0,232,232,C
1-PB2,1902,0,232,0,0,232,T
1-PB2,1903,0,231,0,0,231,T
1-PB2,1904,1,0,0,231,232,C
1-PB2,1905,229,0,0,0,229,A
1-PB2,1906,0,0,0,232,232,C
1-PB2,1907,0,226,0,0,226,T
1-PB2,1908,0,2,227,0,229,G
1-PB2,1909,223,1,1,0,225,A
1-PB2,1910,0,0,0,228,228,C
1-PB2,1911,0,223,0,1,224,T
1-PB2,1912,0,0,224,0,224,G
1-PB2,1913,0,224,0,0,224,T
1-PB2,1914,0,0,223,0,223,G
1-PB2,1915,224,0,0,0,224,A
1-PB2,1916,229,0,0,0,229,A
1-PB2,1917,1,229,0,0,230,T
1-PB2,1918,0,0,230,0,230,G
1-PB2,1919,0,223,0,0,223,T
1-PB2,1920,219,0,0,0,219,A
1-PB2,1921,221,0,0,0,221,A
1-PB2,1922,0,1,220,0,221,G
1-PB2,1923,0,0,221,0,221,G
1-PB2,1924,0,0,219,0,219,G
1-PB2,1925,0,2,221,0,223,G
1-PB2,1926,224,0,0,0,224,A
1-PB2,1927,0,222,0,0,222,T
1-PB2,1928,0,2,0,219,221,C
1-PB2,1929,219,0,0,0,219,A
1-PB2,1930,0,0,222,0,222,G
1-PB2,1931,0,0,220,0,220,G
1-PB2,1932,0,0,221,0,221,G
1-PB2,1933,220,0,0,0,220,A
1-PB2,1934,0,216,0,0,216,T
1-PB2,1935,0,0,217,0,217,G
1-PB2,1936,215,0,0,0,215,A
1-PB2,1937,0,0,220,0,220,G
1-PB2,1938,218,0,1,0,219,A
1-PB2,1939,217,0,0,0,217,A
1-PB2,1940,0,218,0,0,218,T
1-PB2,1941,216,0,0,0,216,A
1-PB2,1942,0,0,0,220,220,C
1-PB2,1943,0,216,0,0,216,T
1-PB2,1944,0,215,0,0,215,T
1-PB2,1945,0,0,212,0,212,G
1-PB2,1946,0,209,0,0,209,T
1-PB2,1947,206,0,0,0,206,A
1-PB2,1948,207,0,0,0,207,A
1-PB2,1949,0,0,207,0,207,G
1-PB2,1950,0,0,210,0,210,G
1-PB2,1951,1,0,205,0,206,G
1-PB2,1952,0,0,205,0,205,G
1-PB2,1953,0,0,0,206,206,C
1-PB2,1954,207,0,0,0,207,A
1-PB2,1955,209,0,0,0,209,A
1-PB2,1956,0,209,0,0,209,T
1-PB2,1957,0,208,0,0,208,T
1-PB2,1958,0,0,0,210,210,C
1-PB2,1959,1,207,0,0,208,T
1-PB2,1960,0,0,0,206,206,C
1-PB2,1961,0,0,0,208,208,C
1-PB2,1962,0,206,0,0,206,T
1-PB2,1963,0,0,210,0,210,G
1-PB2,1964,0,207,0,0,207,T
1-PB2,1965,208,0,0,0,208,A
1-PB2,1966,0,206,0,1,207,T
1-PB2,1967,0,199,0,0,199,T
1-PB2,1968,0,0,0,202,202,C
1-PB2,1969,202,0,0,0,202,A
1-PB2,1970,209,0,0,0,209,A
1-PB2,1971,0,0,0,209,209,C
1-PB2,1972,0,206,0,0,206,T
1-PB2,1973,206,0,0,0,206,A
1-PB2,1974,0,0,0,211,211,C
1-PB2,1975,212,0,0,0,212,A
1-PB2,1976,211,0,1,0,212,A
1-PB2,1977,0,0,0,211,211,C
1-PB2,1978,210,0,0,0,210,A
1-PB2,1979,208,0,0,0,208,A
1-PB2,1980,0,0,208,0,208,G
1-PB2,1981,207,0,0,0,207,A
1-PB2,1982,0,0,0,209,209,C
1-PB2,1983,0,0,0,204,204,C
1-PB2,1984,203,0,0,0,203,A
1-PB2,1985,0,1,0,211,212,C
1-PB2,1986,0,212,0,0,212,T
1-PB2,1987,210,0,0,0,210,A
1-PB2,1988,210,0,1,0,211,A
1-PB2,1989,208,0,0,0,208,A
1-PB2,1990,207,0,2,0,209,A
1-PB2,1991,0,2,209,0,211,G
1-PB2,1992,208,0,2,0,210,A
1-PB2,1993,0,0,0,210,210,C
1-PB2,1994,0,205,0,0,205,T
1-PB2,1995,207,0,0,0,207,A
1-PB2,1996,206,1,0,0,207,A
1-PB2,1997,0,0,0,206,206,C
1-PB2,1998,206,0,0,0,206,A
1-PB2,1999,206,0,0,0,206,A
1-PB2,2000,0,201,0,0,201,T
1-PB2,2001,0,202,0,0,202,T
1-PB2,2002,0,0,0,201,201,C
1-PB2,2003,0,201,0,0,201,T
1-PB2,2004,0,2,0,202,204,C
1-PB2,2005,0,0,204,0,204,G
1-PB2,2006,0,0,204,0,204,G
1-PB2,2007,200,0,0,0,200,A
1-PB2,2008,205,0,0,0,205,A
1-PB2,2009,204,0,0,0,204,A
1-PB2,2010,203,0,0,1,204,A
1-PB2,2011,0,0,207,0,207,G
1-PB2,2012,205,0,0,0,205,A
1-PB2,2013,0,205,0,0,205,T
1-PB2,2014,0,0,203,0,203,G
1-PB2,2015,0,0,0,204,204,C
1-PB2,2016,1,0,0,201,202,C
1-PB2,2017,0,0,204,0,204,G
1-PB2,2018,0,0,204,0,204,G
1-PB2,2019,0,0,0,203,203,C
1-PB2,2020,205,0,0,0,205,A
1-PB2,2021,0,0,0,208,208,C
1-PB2,2022,0,205,0,0,205,T
1-PB2,2023,0,205,0,0,205,T
1-PB2,2024,0,206,0,0,206,T
1-PB2,2025,205,0,0,0,205,A
1-PB2,2026,204,0,0,0,204,A
1-PB2,2027,0,206,0,0,206,T
1-PB2,2028,0,202,0,0,202,T
1-PB2,2029,0,0,205,0,205,G
1-PB2,2030,198,0,0,0,198,A
1-PB2,2031,198,0,0,0,198,A
1-PB2,2032,1,0,197,0,198,G
1-PB2,2033,203,0,0,0,203,A
1-PB2,2034,0,0,0,204,204,C
1-PB2,2035,1,0,0,202,203,C
1-PB2,2036,0,0,0,203,203,C
1-PB2,2037,202,0,0,1,203,A
1-PB2,2038,0,0,205,0,205,G
1-PB2,2039,205,0,0,0,205,A
1-PB2,2040,0,206,0,0,206,T
1-PB2,2041,0,0,205,0,205,G
1-PB2,2042,199,0,0,0,199,A
1-PB2,2043,198,0,1,0,199,A
1-PB2,2044,200,0,0,0,200,A
1-PB2,2045,0,0,200,0,200,G
1-PB2,2046,0,0,0,199,199,C
1-PB2,2047,190,0,0,0,190,A
1-PB2,2048,0,0,0,193,193,C
1-PB2,2049,193,0,0,0,193,A
1-PB2,2050,0,190,0,0,190,T
1-PB2,2051,0,0,0,194,194,C
1-PB2,2052,0,0,0,193,193,C
1-PB2,2053,1,0,192,0,193,G
1-PB2,2054,0,1,194,0,195,G
1-PB2,2055,192,0,0,0,192,A
1-PB2,2056,0,0,191,0,191,G
1-PB2,2057,0,189,0,0,189,T
1-PB2,2058,0,0,188,0,188,G
1-PB2,2059,0,0,188,0,188,G
1-PB2,2060,184,0,0,0,184,A
1-PB2,2061,0,0,184,0,184,G
1-PB2,2062,0,184,0,0,184,T
1-PB2,2063,1,0,0,183,184,C
1-PB2,2064,1,0,0,185,186,C
1-PB2,2065,0,0,185,0,185,G
1-PB2,2066,0,0,0,186,186,C
1-PB2,2067,1,0,0,183,184,C
1-PB2,2068,0,0,186,0,186,G
1-PB2,2069,0,185,0,1,186,T
1-PB2,2070,0,0,0,189,189,C
1-PB2,2071,0,189,0,0,189,T
1-PB2,2072,0,188,0,0,188,T
1-PB2,2073,0,1,187,0,188,G
1-PB2,2074,185,0,0,1,186,A
1-PB2,2075,0,1,188,0,189,G
1-PB2,2076,188,0,1,0,189,A
1-PB2,2077,0,0,183,0,183,G
1-PB2,2078,0,0,182,0,182,G
1-PB2,2079,1,0,183,0,184,G
1-PB2,2080,0,184,0,1,185,T
1-PB2,2081,0,183,0,0,183,T
1-PB2,2082,0,186,0,0,186,T
1-PB2,2083,0,0,0,186,186,C
1-PB2,2084,0,184,0,0,184,T
1-PB2,2085,1,0,0,187,188,C
1-PB2,2086,188,0,0,0,188,A
1-PB2,2087,0,181,0,1,182,T
1-PB2,2088,0,183,0,0,183,T
1-PB2,2089,183,0,0,0,183,A
1-PB2,2090,0,183,0,0,183,T
1-PB2,2091,182,0,0,0,182,A
1-PB2,2092,0,0,182,0,182,G
1-PB2,2093,0,0,183,0,183,G
1-PB2,2094,0,171,0,0,171,T
1-PB2,2095,171,0,0,0,171,A
1-PB2,2096,170,0,0,0,170,A
1-PB2,2097,0,0,169,0,169,G
1-PB2,2098,0,0,170,0,170,G
1-PB2,2099,169,0,1,0,170,A
1-PB2,2100,163,0,1,0,164,A
1-PB2,2101,0,0,165,0,165,G
1-PB2,2102,164,0,1,0,165,A
1-PB2,2103,0,0,0,167,167,C
1-PB2,2104,166,0,0,0,166,A
1-PB2,2105,0,0,167,0,167,G
1-PB2,2106,161,0,0,0,161,A
1-PB2,2107,160,0,0,0,160,A
1-PB2,2108,0,0,160,0,160,G
1-PB2,2109,0,0,158,0,158,G
1-PB2,2110,0,165,0,0,165,T
1-PB2,2111,165,0,0,0,165,A
1-PB2,2112,0,1,0,164,165,C
1-PB2,2113,0,0,164,0,164,G
1-PB2,2114,0,2,164,0,166,G
1-PB2,2115,166,0,0,0,166,A
1-PB2,2116,0,0,0,164,164,C
1-PB2,2117,1,0,0,161,162,C
1-PB2,2118,160,0,1,0,161,A
1-PB2,2119,0,0,169,0,169,G
1-PB2,2120,0,0,0,169,169,C
1-PB2,2121,169,0,0,0,169,A
1-PB2,2122,0,168,0,0,168,T
1-PB2,2123,0,160,0,0,160,T
1-PB2,2124,161,0,0,0,161,A
1-PB2,2125,161,0,0,0,161,A
1-PB2,2126,0,0,159,0,159,G
1-PB2,2127,0,0,0,158,158,C
1-PB2,2128,151,0,0,0,151,A
1-PB2,2129,0,157,0,0,157,T
1-PB2,2130,1,0,0,156,157,C
1-PB2,2131,157,0,0,0,157,A
1-PB2,2132,158,0,0,0,158,A
1-PB2,2133,0,158,0,0,158,T
1-PB2,2134,0,0,159,0,159,G
1-PB2,2135,155,0,0,0,155,A
1-PB2,2136,156,0,0,0,156,A
1-PB2,2137,0,0,0,158,158,C
1-PB2,2138,0,149,0,0,149,T
1-PB2,2139,0,0,152,0,152,G
1-PB2,2140,151,0,0,0,151,A
1-PB2,2141,0,0,151,0,151,G
1-PB2,2142,0,151,0,0,151,T
1-PB2,2143,150,0,0,0,150,A
1-PB2,2144,151,0,0,0,151,A
1-PB2,2145,0,0,0,152,152,C
1-PB2,2146,0,0,0,143,143,C
1-PB2,2147,0,145,0,0,145,T
1-PB2,2148,0,134,0,0,134,T
1-PB2,2149,0,0,134,0,134,G
1-PB2,2150,0,1,0,133,134,C
1-PB2,2151,134,0,0,0,134,A
1-PB2,2152,134,0,0,0,134,A
1-PB2,2153,133,0,0,0,133,A
1-PB2,2154,132,0,0,0,132,A
1-PB2,2155,0,0,131,0,131,G
1-PB2,2156,0,0,132,0,132,G
1-PB2,2157,0,0,132,0,132,G
1-PB2,2158,0,0,133,0,133,G
1-PB2,2159,131,0,1,0,132,A
1-PB2,2160,133,0,0,0,133,A
1-PB2,2161,133,0,0,0,133,A
1-PB2,2162,135,0,0,0,135,A
1-PB2,2163,0,0,139,0,139,G
1-PB2,2164,0,0,139,0,139,G
1-PB2,2165,1,0,0,139,140,C
1-PB2,2166,0,139,0,0,139,T
1-PB2,2167,139,0,0,0,139,A
1-PB2,2168,139,0,0,0,139,A
1-PB2,2169,0,139,0,0,139,T
1-PB2,2170,0,0,141,0,141,G
1-PB2,2171,0,137,0,0,137,T
1-PB2,2172,0,0,134,0,134,G
1-PB2,2173,0,0,0,134,134,C
1-PB2,2174,0,134,0,0,134,T
1-PB2,2175,134,0,0,0,134,A
1-PB2,2176,132,0,0,0,132,A
1-PB2,2177,0,132,0,0,132,T
1-PB2,2178,1,0,0,131,132,C
1-PB2,2179,0,0,128,0,128,G
1-PB2,2180,0,0,128,0,128,G
1-PB2,2181,0,0,127,0,127,G
1-PB2,2182,0,0,0,127,127,C
1-PB2,2183,126,0,1,0,127,A
1-PB2,2184,128,0,0,0,128,A
1-PB2,2185,0,1,126,0,127,G
1-PB2,2186,0,0,128,0,128,G
1-PB2,2187,128,0,0,0,128,A
1-PB2,2188,0,0,128,0,128,G
1-PB2,2189,122,0,1,0,123,A
1-PB2,2190,0,0,0,123,123,C
1-PB2,2191,1,0,122,0,123,G
1-PB2,2192,0,121,0,0,121,T
1-PB2,2193,0,0,121,0,121,G
1-PB2,2194,0,0,123,0,123,G
1-PB2,2195,0,118,0,0,118,T
1-PB2,2196,0,0,118,0,118,G
1-PB2,2197,0,115,0,0,115,T
1-PB2,2198,0,114,0,0,114,T
1-PB2,2199,0,0,115,0,115,G
1-PB2,2200,0,0,116,0,116,G
1-PB2,2201,0,114,0,0,114,T
1-PB2,2202,110,0,0,0,110,A
1-PB2,2203,107,0,0,0,107,A
1-PB2,2204,0,105,0,0,105,T
1-PB2,2205,0,0,104,0,104,G
1-PB2,2206,103,0,0,0,103,A
1-PB2,2207,104,0,0,0,104,A
1-PB2,2208,103,0,1,0,104,A
1-PB2,2209,0,0,0,103,103,C
1-PB2,2210,0,0,103,0,103,G
1-PB2,2211,103,0,0,0,103,A
1-PB2,2212,103,0,0,0,103,A
1-PB2,2213,102,0,0,0,102,A
1-PB2,2214,102,0,0,0,102,A
1-PB2,2215,0,1,0,101,102,C
1-PB2,2216,0,0,100,0,100,G
1-PB2,2217,0,1,100,0,101,G
1-PB2,2218,100,0,0,0,100,A
1-PB2,2219,100,0,0,0,100,A
1-PB2,2220,0,0,0,101,101,C
1-PB2,2221,0,101,0,0,101,T
1-PB2,2222,0,0,0,100,100,C
1-PB2,2223,0,101,0,0,101,T
1-PB2,2224,101,0,0,0,101,A
1-PB2,2225,0,0,101,0,101,G
1-PB2,2226,0,0,0,98,98,C
1-PB2,2227,97,0,1,0,98,A
1-PB2,2228,0,98,0,0,98,T
1-PB2,2229,91,0,0,0,91,A
1-PB2,2230,0,0,0,91,91,C
1-PB2,2231,0,83,0,1,84,T
1-PB2,2232,0,84,0,0,84,T
1-PB2,2233,82,0,0,0,82,A
1-PB2,2234,0,0,0,82,82,C
1-PB2,2235,0,81,0,0,81,T
1-PB2,2236,0,0,81,0,81,G
1-PB2,2237,79,0,0,0,79,A
1-PB2,2238,0,0,0,79,79,C
1-PB2,2239,74,0,0,0,74,A
1-PB2,2240,0,0,74,0,74,G
1-PB2,2241,0,0,0,74,74,C
1-PB2,2242,0,0,0,73,73,C
1-PB2,2243,72,0,0,0,72,A
1-PB2,2244,0,0,72,0,72,G
1-PB2,2245,72,0,0,0,72,A
1-PB2,2246,0,0,0,72,72,C
1-PB2,2247,69,0,0,0,69,A
1-PB2,2248,0,0,69,0,69,G
1-PB2,2249,0,0,0,64,64,C
1-PB2,2250,0,0,64,0,64,G
1-PB2,2251,64,0,0,0,64,A
1-PB2,2252,0,0,0,64,64,C
1-PB2,2253,0,0,0,64,64,C
1-PB2,2254,64,0,0,0,64,A
1-PB2,2255,64,0,0,0,64,A
1-PB2,2256,64,0,0,0,64,A
1-PB2,2257,64,0,0,0,64,A
1-PB2,2258,0,0,64,0,64,G
1-PB2,2259,61,0,0,0,61,A
1-PB2,2260,61,0,0,0,61,A
1-PB2,2261,0,61,0,0,61,T
1-PB2,2262,0,61,0,0,61,T
1-PB2,2263,0,0,0,61,61,C
1-PB2,2264,0,0,60,0,60,G
1-PB2,2265,0,0,60,0,60,G
1-PB2,2266,60,0,0,0,60,A
1-PB2,2267,0,57,0,0,57,T
1-PB2,2268,0,0,56,0,56,G
1-PB2,2269,0,0,56,0,56,G
1-PB2,2270,0,0,0,56,56,C
1-PB2,2271,0,0,0,55,55,C
1-PB2,2272,55,0,0,0,55,A
1-PB2,2273,0,55,0,0,55,T
1-PB2,2274,0,0,0,55,55,C
1-PB2,2275,55,0,0,0,55,A
1-PB2,2276,55,0,0,0,55,A
1-PB2,2277,0,55,0,0,55,T
1-PB2,2278,0,51,0,0,51,T
1-PB2,2279,51,0,0,0,51,A
1-PB2,2280,50,0,0,0,50,A
2-PB1,1,85,0,0,0,85,A
2-PB1,2,0,85,0,0,85,T
2-PB1,3,0,0,85,0,85,G
2-PB1,4,0,0,97,0,97,G
2-PB1,5,110,0,0,0,110,A
2-PB1,6,0,118,0,0,118,T
2-PB1,7,0,0,121,0,121,G
2-PB1,8,0,120,0,0,120,T
2-PB1,9,0,0,0,132,132,C
2-PB1,10,132,0,0,0,132,A
2-PB1,11,142,0,0,0,142,A
2-PB1,12,0,142,0,1,143,T
2-PB1,13,0,0,0,144,144,C
2-PB1,14,0,0,0,154,154,C
2-PB1,15,0,2,153,0,155,G
2-PB1,16,180,0,0,0,180,A
2-PB1,17,0,0,0,187,187,C
2-PB1,18,0,187,0,1,188,T
2-PB1,19,0,0,0,215,215,C
2-PB1,20,0,214,1,0,215,T
2-PB1,21,215,0,0,0,215,A
2-PB1,22,0,0,0,218,218,C
2-PB1,23,0,216,0,0,216,T
2-PB1,24,0,0,241,0,241,G
2-PB1,25,0,242,0,2,244,T
2-PB1,26,0,244,0,0,244,T
2-PB1,27,1,0,0,243,244,C
2-PB1,28,0,0,0,243,243,C
2-PB1,29,1,289,0,0,290,T
2-PB1,30,293,0,0,0,293,A
2-PB1,31,294,0,0,0,294,A
2-PB1,32,296,0,0,0,296,A
2-PB1,33,0,1,296,0,297,G
2-PB1,34,0,0,305,0,305,G
2-PB1,35,0,307,0,1,308,T
2-PB1,36,0,310,0,0,310,T
2-PB1,37,0,0,0,311,311,C
2-PB1,38,0,0,0,311,311,C
2-PB1,39,313,0,0,0,313,A
2-PB1,40,0,0,315,0,315,G
2-PB1,41,0,0,0,315,315,C
2-PB1,42,0,0,318,0,318,G
2-PB1,43,0,0,0,319,319,C
2-PB1,44,319,0,0,0,319,A
2-PB1,45,319,0,0,0,319,A
2-PB1,46,318,0,0,0,318,A
2-PB1,47,320,1,0,0,321,A
2-PB1,48,0,323,0,0,323,T
2-PB1,49,0,0,342,0,342,G
2-PB1,50,0,0,0,345,345,C
2-PB1,51,0,0,0,347,347,C
2-PB1,52,346,0,0,0,346,A
2-PB1,53,0,346,0,0,346,T
2-PB1,54,372,0,0,0,372,A
2-PB1,55,372,0,0,0,372,A
2-PB1,56,0,1,393,0,394,G
2-PB1,57,0,1,0,390,391,C
2-PB1,58,390,0,0,0,390,A
2-PB1,59,0,0,0,408,408,C
2-PB1,60,408,0,0,0,408,A
2-PB1,61,437,0,1,0,438,A
2-PB1,62,0,0,0,439,439,C
2-PB1,63,440,0,0,0,440,A
2-PB1,64,0,442,0,0,442,T
2-PB1,65,0,438,0,1,439,T
2-PB1,66,1,0,0,533,534,C
2-PB1,67,0,1,0,536,537,C
2-PB1,68,0,0,0,539,539,C
2-PB1,69,0,540,0,1,541,T
2-PB1,70,0,542,0,0,542,T
2-PB1,71,587,0,0,0,587,A
2-PB1,72,0,592,0,0,592,T
2-PB1,73,591,0,0,0,591,A
2-PB1,74,0,0,0,596,596,C
2-PB1,75,0,579,0,1,580,T
2-PB1,76,0,0,587,0,587,G
2-PB1,77,0,1,585,0,586,G
2-PB1,78,587,0,0,0,587,A
2-PB1,79,0,0,586,0,586,G
2-PB1,80,586,1,0,0,587,A
2-PB1,81,0,587,0,1,588,T
2-PB1,82,0,0,0,624,624,C
2-PB1,83,1,0,0,624,625,C
2-PB1,84,0,626,0,1,627,T
2-PB1,85,0,0,0,675,675,C
2-PB1,86,0,0,0,676,676,C
2-PB1,87,678,0,0,0,678,A
2-PB1,88,0,677,0,0,677,T
2-PB1,89,677,0,0,0,677,A
2-PB1,90,0,1,0,677,678,C
2-PB1,91,669,0,0,0,669,A
2-PB1,92,0,0,693,0,693,G
2-PB1,93,0,1,0,698,699,C
2-PB1,94,2,0,0,685,687,C
2-PB1,95,690,0,1,0,691,A
2-PB1,96,0,691,0,0,691,T
2-PB1,97,0,1,693,0,694,G
2-PB1,98,0,0,726,0,726,G
2-PB1,99,732,1,0,0,733,A
2-PB1,100,733,1,1,0,735,A
2-PB1,101,0,0,0,738,738,C
2-PB1,102,732,0,1,0,733,A
2-PB1,103,0,0,746,0,746,G
2-PB1,104,1,1,755,0,757,G
2-PB1,105,757,0,2,0,759,A
2-PB1,106,762,0,0,0,762,A
2-PB1,107,0,0,0,768,768,C
2-PB1,108,757,0,0,0,757,A
2-PB1,109,0,0,865,0,865,G
2-PB1,110,0,1,865,0,866,G
2-PB1,111,0,0,879,0,879,G
2-PB1,112,0,880,0,1,881,T
2-PB1,113,879,0,0,0,879,A
2-PB1,114,0,0,0,883,883,C
2-PB1,115,914,0,1,0,915,A
2-PB1,116,0,0,0,963,963,C
2-PB1,117,2,0,0,955,957,C
2-PB1,118,922,1,0,0,923,A
2-PB1,119,0,923,0,0,923,T
2-PB1,120,1,1,922,0,924,G
2-PB1,121,0,4,921,0,925,G
2-PB1,122,928,0,0,0,928,A
2-PB1,123,1,0,1,928,930,C
2-PB1,124,908,0,1,0,909,A
2-PB1,125,0,0,0,928,928,C
2-PB1,126,924,0,1,1,926,A
2-PB1,127,0,0,946,0,946,G
2-PB1,128,0,940,0,2,942,T
2-PB1,129,4,0,0,964,968,C
2-PB1,130,962,0,0,1,963,A
2-PB1,131,971,0,1,1,973,A
2-PB1,132,0,1,0,974,975,C
2-PB1,133,973,0,0,0,973,A
2-PB1,134,0,4,981,0,985,G
2-PB1,135,974,0,0,0,974,A
2-PB1,136,971,0,0,0,971,A
2-PB1,137,0,0,0,974,974,C
2-PB1,138,956,0,1,0,957,A
2-PB1,139,0,0,0,957,957,C
2-PB1,140,950,0,0,0,950,A
2-PB1,141,1,944,0,0,945,T
2-PB1,142,1,0,0,1031,1032,C
2-PB1,143,1037,0,0,0,1037,A
2-PB1,144,1051,0,0,0,1051,A
2-PB1,145,2,1057,0,0,1059,T
2-PB1,146,1091,0,1,0,1092,A
2-PB1,147,0,1092,0,0,1092,T
2-PB1,148,0,1078,0,0,1078,T
2-PB1,149,2,0,0,1076,1078,C
2-PB1,150,1056,1,1,0,1058,A
2-PB1,151,0,0,1058,0,1058,G
2-PB1,152,1052,0,0,0,1052,A
2-PB1,153,0,1,1048,0,1049,G
2-PB1,154,1039,0,0,0,1039,A
2-PB1,155,3,0,1017,0,1020,G
2-PB1,156,0,2,1015,0,1017,G
2-PB1,157,0,2,1050,0,1052,G
2-PB1,158,0,2,1049,0,1051,G
2-PB1,159,0,0,1060,0,1060,G
2-PB1,160,1060,0,1,0,1061,A
2-PB1,161,1062,1,1,0,1064,A
2-PB1,162,0,0,1077,0,1077,G
2-PB1,163,0,1069,0,0,1069,T
2-PB1,164,0,0,1068,0,1068,G
2-PB1,165,0,2,1062,0,1064,G
2-PB1,166,1061,0,2,0,1063,A
2-PB1,167,1,0,0,1066,1067,C
2-PB1,168,0,3,1065,0,1068,G
2-PB1,169,1076,0,0,0,1076,A
2-PB1,170,0,1,0,1081,1082,C
2-PB1,171,1078,0,0,0,1078,A
2-PB1,172,1077,0,1,0,1078,A
2-PB1,173,1085,0,0,1,1086,A
2-PB1,174,0,1097,0,1,1098,T
2-PB1,175,1099,1,0,0,1100,A
2-PB1,176,1,0,0,1103,1104,C
2-PB1,177,1095,0,0,0,1095,A
2-PB1,178,1,1,1095,0,1097,G
2-PB1,179,1092,0,1,0,1093,A
2-PB1,180,1101,0,0,1,1102,A
2-PB1,181,1101,0,0,0,1101,A
2-PB1,182,1,0,0,1104,1105,C
2-PB1,183,0,1088,0,1,1089,T
2-PB1,184,0,1,1088,0,1089,G
2-PB1,185,0,2,1088,0,1090,G
2-PB1,186,0,0,1085,0,1085,G
2-PB1,187,0,0,1086,0,1086,G
2-PB1,188,0,1,0,1084,1085,C
2-PB1,189,1082,0,0,0,1082,A
2-PB1,190,2,0,0,1119,1121,C
2-PB1,191,0,0,0,1121,1121,C
2-PB1,192,5,0,0,1112,1117,C
2-PB1,193,1,0,0,1118,1119,C
2-PB1,194,1122,0,2,0,1124,A
2-PB1,195,1126,0,1,0,1127,A
2-PB1,196,0,0,0,1127,1127,C
2-PB1,197,0,1121,0,0,1121,T
2-PB1,198,4,0,0,1121,1125,C
2-PB1,199,1090,0,0,0,1090,A
2-PB1,200,1104,0,0,0,1104,A
2-PB1,201,0,0,0,1107,1107,C
2-PB1,202,1,0,0,1108,1109,C
2-PB1,203,2,0,0,1108,1110,C
2-PB1,204,1104,1,0,0,1105,A
2-PB1,205,1112,0,0,0,1112,A
2-PB1,206,0,1111,0,0,1111,T
2-PB1,207,0,1106,0,0,1106,T
2-PB1,208,0,1,1111,0,1112,G
2-PB1,209,1093,0,1,0,1094,A
2-PB1,210,0,1095,0,1,1096,T
2-PB1,211,0,1,1094,0,1095,G
2-PB1,212,0,3,1100,0,1103,G
2-PB1,213,1112,0,2,0,1114,A
2-PB1,214,2,0,0,1111,1113,C
2-PB1,215,1,0,0,1114,1115,C
2-PB1,216,1112,0,0,0,1112,A
2-PB1,217,0,0,0,1139,1139,C
2-PB1,218,0,1137,0,0,1137,T
2-PB1,219,1158,0,2,0,1160,A
2-PB1,220,0,1,0,1168,1169,C
2-PB1,221,0,1,0,1163,1164,C
2-PB1,222,0,1144,1,1,1146,T
2-PB1,223,1,2,1148,0,1151,G
2-PB1,224,1144,0,1,0,1145,A
2-PB1,225,1,1,1165,0,1167,G
2-PB1,226,0,1,1158,0,1159,G
2-PB1,227,1170,1,0,0,1171,A
2-PB1,228,0,1171,0,0,1171,T
2-PB1,229,1166,0,0,0,1166,A
2-PB1,230,1161,1,1,0,1163,A
2-PB1,231,1,1163,0,1,1165,T
2-PB1,232,0,3,1160,0,1163,G
2-PB1,233,1162,0,2,0,1164,A
2-PB1,234,1150,0,3,0,1153,A
2-PB1,235,0,0,0,1153,1153,C
2-PB1,236,2,0,2,1129,1133,C
2-PB1,237,1138,0,0,0,1138,A
2-PB1,238,1136,0,1,0,1137,A
2-PB1,239,0,0,1144,0,1144,G
2-PB1,240,1,1140,0,0,1141,T
2-PB1,241,0,1,1141,0,1142,G
2-PB1,242,1,1,1153,0,1155,G
2-PB1,243,1152,0,1,1,1154,A
2-PB1,244,0,1154,0,0,1154,T
2-PB1,245,1157,0,0,0,1157,A
2-PB1,246,0,1167,0,6,1173,T
2-PB1,247,0,1,1176,0,1177,G
2-PB1,248,0,0,0,1178,1178,C
2-PB1,249,1175,0,0,0,1175,A
2-PB1,250,0,0,0,1211,1211,C
2-PB1,251,1175,0,1,0,1176,A
2-PB1,252,1186,0,0,0,1186,A
2-PB1,253,1185,0,2,0,1187,A
2-PB1,254,0,0,0,1190,1190,C
2-PB1,255,1166,0,1,0,1167,A
2-PB1,256,0,3,1176,0,1179,G
2-PB1,257,1173,1,4,0,1178,A
2-PB1,258,0,0,0,1178,1178,C
2-PB1,259,0,1142,0,1,1143,T
2-PB1,260,0,0,1163,0,1163,G
2-PB1,261,0,1152,1,2,1155,T
2-PB1,262,0,0,1209,0,1209,G
2-PB1,263,0,1205,0,0,1205,T
2-PB1,264,1,0,0,1206,1207,C
2-PB1,265,3,1,0,1204,1208,C
2-PB1,266,0,1199,0,2,1201,T
2-PB1,267,0,2,1198,0,1200,G
2-PB1,268,0,1,1196,0,1197,G
2-PB1,269,1182,0,1,0,1183,A
2-PB1,270,0,1,1206,0,1207,G
2-PB1,271,0,0,1166,0,1166,G
2-PB1,272,1,1,0,1172,1174,C
2-PB1,273,0,1164,0,0,1164,T
2-PB1,274,1165,0,0,0,1165,A
2-PB1,275,1,1163,0,0,1164,T
2-PB1,276,0,1,1163,0,1164,G
2-PB1,277,0,1,1160,0,1161,G
2-PB1,278,1,2,0,1156,1159,C
2-PB1,279,3,0,0,1136,1139,C
2-PB1,280,0,1124,0,0,1124,T
2-PB1,281,0,1191,0,1,1192,T
2-PB1,282,2,0,1,1185,1188,C
2-PB1,283,1,1,0,1192,1194,C
2-PB1,284,0,1196,0,0,1196,T
2-PB1,285,0,1190,0,2,1192,T
2-PB1,286,0,0,1202,0,1202,G
2-PB1,287,1203,1,0,0,1204,A
2-PB1,288,1202,0,1,0,1203,A
2-PB1,289,0,1,1207,0,1208,G
2-PB1,290,1140,0,0,0,1140,A
2-PB1,291,1147,0,0,0,1147,A
2-PB1,292,0,1136,0,1,1137,T
2-PB1,293,2,0,0,1136,1138,C
2-PB1,294,2,0,0,1143,1145,C
2-PB1,295,2,0,0,1142,1144,C
2-PB1,296,1144,1,0,0,1145,A
2-PB1,297,0,0,0,1147,1147,C
2-PB1,298,2,1,0,1141,1144,C
2-PB1,299,2,0,0,1142,1144,C
2-PB1,300,1129,0,0,0,1129,A
2-PB1,301,0,1,1145,0,1146,G
2-PB1,302,0,0,1151,0,1151,G
2-PB1,303,0,1147,0,1,1148,T
2-PB1,304,1157,0,0,0,1157,A
2-PB1,305,0,1151,0,0,1151,T
2-PB1,306,0,0,0,1154,1154,C
2-PB1,307,0,1155,0,1,1156,T
2-PB1,308,0,1154,0,1,1155,T
2-PB1,309,0,1152,0,1,1153,T
2-PB1,310,0,2,1148,0,1150,G
2-PB1,311,1142,0,2,1,1145,A
2-PB1,312,0,1,1145,0,1146,G
2-PB1,313,1128,0,0,0,1128,A
2-PB1,314,1125,0,2,0,1127,A
2-PB1,315,0,0,1,1135,1136,C
2-PB1,316,0,1129,0,0,1129,T
2-PB1,317,3,1,0,1122,1126,C
2-PB1,318,1129,0,1,0,1130,A
2-PB1,319,0,1134,0,0,1134,T
2-PB1,320,0,0,1137,0,1137,G
2-PB1,321,1,0,0,1155,1156,C
2-PB1,322,0,0,0,1155,1155,C
2-PB1,323,0,1148,0,3,1151,T
2-PB1,324,0,1145,0,2,1147,T
2-PB1,325,0,2,1145,0,1147,G
2-PB1,326,1161,0,0,1,1162,A
2-PB1,327,1159,0,1,0,1160,A
2-PB1,328,1165,0,0,0,1165,A
2-PB1,329,0,0,0,1176,1176,C
2-PB1,330,1142,1,1,0,1144,A
2-PB1,331,1147,0,0,0,1147,A
2-PB1,332,0,1146,0,1,1147,T
2-PB1,333,1,0,1146,0,1147,G
2-PB1,334,0,0,1146,0,1146,G
2-PB1,335,1133,1,0,0,1134,A
2-PB1,336,1133,0,1,0,1134,A
2-PB1,337,2,0,1136,0,1138,G
2-PB1,338,0,0,0,1142,1142,C
2-PB1,339,2,1,0,1127,1130,C
2-PB1,340,0,0,1147,0,1147,G
2-PB1,341,1,1143,0,2,1146,T
2-PB1,342,1,1145,0,0,1146,T
2-PB1,343,5,0,0,1152,1157,C
2-PB1,344,1154,0,1,0,1155,A
2-PB1,345,1169,0,1,0,1170,A
2-PB1,346,1,1,0,1170,1172,C
2-PB1,347,1172,0,1,0,1173,A
2-PB1,348,0,2,1182,0,1184,G
2-PB1,349,1164,0,0,1,1165,A
2-PB1,350,0,0,0,1164,1164,C
2-PB1,351,1159,0,3,0,1162,A
2-PB1,352,1164,0,0,0,1164,A
2-PB1,353,0,2,1175,0,1177,G
2-PB1,354,1,2,1162,0,1165,G
2-PB1,355,1,0,1168,0,1169,G
2-PB1,356,0,1150,0,0,1150,T
2-PB1,357,0,1,1153,0,1154,G
2-PB1,358,2,1,1149,0,1152,G
2-PB1,359,1155,0,2,0,1157,A
2-PB1,360,0,1,0,1158,1159,C
2-PB1,361,1137,0,1,0,1138,A
2-PB1,362,1147,1,0,0,1148,A
2-PB1,363,1146,0,2,0,1148,A
2-PB1,364,0,0,0,1144,1144,C
2-PB1,365,0,1143,0,0,1143,T
2-PB1,366,1141,0,0,0,1141,A
2-PB1,367,1148,0,0,0,1148,A
2-PB1,368,0,0,0,1155,1155,C
2-PB1,369,1,0,0,1152,1153,C
2-PB1,370,3,0,0,1148,1151,C
2-PB1,371,1112,0,0,0,1112,A
2-PB1,372,1111,0,0,0,1111,A
2-PB1,373,0,2,1109,0,1111,G
2-PB1,374,0,0,1117,0,1117,G
2-PB1,375,0,1114,0,0,1114,T
2-PB1,376,2,1,0,1109,1112,C
2-PB1,377,0,0,1112,0,1112,G
2-PB1,378,1,1,0,1109,1111,C
2-PB1,379,2,0,0,1111,1113,C
2-PB1,380,1112,0,0,0,1112,A
2-PB1,381,0,0,1137,0,1137,G
2-PB1,382,1173,0,0,0,1173,A
2-PB1,383,0,0,0,1177,1177,C
2-PB1,384,0,1168,0,2,1170,T
2-PB1,385,0,1173,0,1,1174,T
2-PB1,386,1173,0,0,0,1173,A
2-PB1,387,0,1187,0,2,1189,T
2-PB1,388,1,1,1187,0,1189,G
2-PB1,389,1186,0,0,0,1186,A
2-PB1,390,0,1166,0,0,1166,T
2-PB1,391,0,1132,0,0,1132,T
2-PB1,392,0,2,1121,0,1123,G
2-PB1,393,0,1,1121,0,1122,G
2-PB1,394,1136,0,0,0,1136,A
2-PB1,395,0,1,0,1131,1132,C
2-PB1,396,1127,0,0,0,1127,A
2-PB1,397,0,1122,0,0,1122,T
2-PB1,398,1,1123,0,0,1124,T
2-PB1,399,1135,0,1,0,1136,A
2-PB1,400,1138,0,0,0,1138,A
2-PB1,401,1138,1,1,1,1141,A
2-PB1,402,0,0,0,1143,1143,C
2-PB1,403,1118,0,2,0,1120,A
2-PB1,404,0,2,1122,0,1124,G
2-PB1,405,1119,0,0,1,1120,A
2-PB1,406,1119,0,1,0,1120,A
2-PB1,407,1117,0,1,0,1118,A
2-PB1,408,0,1114,1,0,1115,T
2-PB1,409,2,0,0,1112,1114,C
2-PB1,410,1108,0,1,0,1109,A
2-PB1,411,1110,1,0,0,1111,A
2-PB1,412,0,0,0,1110,1110,C
2-PB1,413,0,1,0,1098,1099,C
2-PB1,414,0,1,1100,0,1101,G
2-PB1,415,1,0,1100,0,1101,G
2-PB1,416,0,0,0,1107,1107,C
2-PB1,417,1103,0,0,0,1103,A
2-PB1,418,0,0,1104,0,1104,G
2-PB1,419,0,1,0,1111,1112,C
2-PB1,420,1112,0,0,0,1112,A
2-PB1,421,1111,0,0,0,1111,A
2-PB1,422,0,0,0,1112,1112,C
2-PB1,423,1,1105,0,1,1107,T
2-PB1,424,1,0,1156,0,1157,G
2-PB1,425,1,0,0,1151,1152,C
2-PB1,426,1153,1,1,0,1155,A
2-PB1,427,0,1151,0,1,1152,T
2-PB1,428,0,1138,0,0,1138,T
2-PB1,429,1198,1,0,0,1199,A
2-PB1,430,0,0,1201,0,1201,G
2-PB1,431,0,1,0,1193,1194,C
2-PB1,432,0,0,0,1196,1196,C
2-PB1,433,1137,0,1,0,1138,A
2-PB1,434,1148,0,0,0,1148,A
2-PB1,435,0,0,0,1151,1151,C
2-PB1,436,1149,0,0,0,1149,A
2-PB1,437,0,0,0,1195,1195,C
2-PB1,438,1,0,0,1131,1132,C
2-PB1,439,1136,0,1,0,1137,A
2-PB1,440,0,1136,0,0,1136,T
2-PB1,441,1140,0,0,0,1140,A
2-PB1,442,0,1,1138,0,1139,G
2-PB1,443,1127,0,0,0,1127,A
2-PB1,444,1107,0,2,0,1109,A
2-PB1,445,0,0,1116,0,1116,G
2-PB1,446,1,1078,0,0,1079,T
2-PB1,447,0,1080,0,0,1080,T
2-PB1,448,0,1075,0,0,1075,T
2-PB1,449,0,1077,0,0,1077,T
2-PB1,450,0,1079,0,0,1079,T
2-PB1,451,1079,0,0,0,1079,A
2-PB1,452,1,0,1077,0,1078,G
2-PB1,453,1075,1,1,0,1077,A
2-PB1,454,1,1071,0,1,1073,T
2-PB1,455,1,0,0,1054,1055,C
2-PB1,456,1,3,1053,0,1057,G
2-PB1,457,1059,1,0,0,1060,A
2-PB1,458,1057,0,3,0,1060,A
2-PB1,459,0,1,0,1061,1062,C
2-PB1,460,1,2,1066,0,1069,G
2-PB1,461,0,2,1124,0,1126,G
2-PB1,462,1123,0,1,0,1124,A
2-PB1,463,0,1121,0,2,1123,T
2-PB1,464,0,1124,0,0,1124,T
2-PB1,465,1118,0,1,0,1119,A
2-PB1,466,1115,1,0,0,1116,A
2-PB1,467,0,1,0,1121,1122,C
2-PB1,468,1111,0,0,0,1111,A
2-PB1,469,0,1,1112,0,1113,G
2-PB1,470,1,0,0,1054,1055,C
2-PB1,471,0,1055,0,1,1056,T
2-PB1,472,1057,0,0,0,1057,A
2-PB1,473,1060,0,0,0,1060,A
2-PB1,474,1,1057,0,1,1059,T
2-PB1,475,1,0,1076,0,1077,G
2-PB1,476,1070,1,1,0,1072,A
2-PB1,477,1073,0,1,1,1075,A
2-PB1,478,0,1053,0,0,1053,T
2-PB1,479,0,0,0,1052,1052,C
2-PB1,480,1050,0,1,0,1051,A
2-PB1,481,0,0,1055,0,1055,G
2-PB1,482,0,1,1049,0,1050,G
2-PB1,483,1052,0,0,0,1052,A
2-PB1,484,1039,0,2,0,1041,A
2-PB1,485,1,2,1083,0,1086,G
2-PB1,486,0,0,1098,1,1099,G
2-PB1,487,0,0,0,1093,1093,C
2-PB1,488,0,1094,0,2,1096,T
2-PB1,489,1096,0,1,0,1097,A
2-PB1,490,1095,0,1,0,1096,A
2-PB1,491,0,1090,0,0,1090,T
2-PB1,492,1095,0,0,0,1095,A
2-PB1,493,1,1,1097,0,1099,G
2-PB1,494,1031,0,0,0,1031,A
2-PB1,495,0,1020,0,1,1021,T
2-PB1,496,0,1008,0,1,1009,T
2-PB1,497,2,1004,0,0,1006,T
2-PB1,498,3,0,0,1033,1036,C
2-PB1,499,0,0,0,1040,1040,C
2-PB1,500,0,1044,0,1,1045,T
2-PB1,501,1,0,0,1045,1046,C
2-PB1,502,1042,0,1,0,1043,A
2-PB1,503,1049,0,1,0,1050,A
2-PB1,504,0,2,1050,0,1052,G
2-PB1,505,0,1,1065,0,1066,G
2-PB1,506,1062,0,0,0,1062,A
2-PB1,507,0,1010,0,0,1010,T
2-PB1,508,0,0,1018,0,1018,G
2-PB1,509,0,1010,0,1,1011,T
2-PB1,510,0,1,1023,0,1024,G
2-PB1,511,1024,0,0,1,1025,A
2-PB1,512,0,1020,0,1,1021,T
2-PB1,513,0,0,1019,0,1019,G
2-PB1,514,0,4,999,0,1003,G
2-PB1,515,1005,0,0,0,1005,A
2-PB1,516,1006,0,1,0,1007,A
2-PB1,517,0,986,0,0,986,T
2-PB1,518,2,0,0,988,990,C
2-PB1,519,981,0,0,0,981,A
2-PB1,520,984,0,0,0,984,A
2-PB1,521,0,983,0,0,983,T
2-PB1,522,1,2,995,0,998,G
2-PB1,523,0,1,997,0,998,G
2-PB1,524,993,1,2,0,996,A
2-PB1,525,0,994,0,0,994,T
2-PB1,526,985,0,0,0,985,A
2-PB1,527,988,0,1,0,989,A
2-PB1,528,988,1,0,0,989,A
2-PB1,529,0,0,1004,0,1004,G
2-PB1,530,996,0,2,0,998,A
2-PB1,531,1,0,994,0,995,G
2-PB1,532,0,0,990,0,990,G
2-PB1,533,986,0,1,0,987,A
2-PB1,534,987,0,1,0,988,A
2-PB1,535,986,0,3,0,989,A
2-PB1,536,0,989,0,0,989,T
2-PB1,537,0,0,1009,0,1009,G
2-PB1,538,0,1,1009,0,1010,G
2-PB1,539,997,0,1,0,998,A
2-PB1,540,0,0,1009,0,1009,G
2-PB1,541,990,1,0,0,991,A
2-PB1,542,1,1014,0,0,1015,T
2-PB1,543,1011,0,0,0,1011,A
2-PB1,544,1018,0,0,0,1018,A
2-PB1,545,0,0,0,1019,1019,C
2-PB1,546,1002,0,0,0,1002,A
2-PB1,547,1003,0,0,0,1003,A
2-PB1,548,0,0,0,998,998,C
2-PB1,549,992,0,0,0,992,A
2-PB1,550,0,0,0,992,992,C
2-PB1,551,970,0,0,0,970,A
2-PB1,552,0,0,0,978,978,C
2-PB1,553,0,965,0,1,966,T
2-PB1,554,0,964,0,2,966,T
2-PB1,555,0,967,0,1,968,T
2-PB1,556,0,0,0,971,971,C
2-PB1,557,970,1,0,0,971,A
2-PB1,558,975,0,1,0,976,A
2-PB1,559,977,0,0,0,977,A
2-PB1,560,0,0,1000,0,1000,G
2-PB1,561,990,0,1,1,992,A
2-PB1,562,992,0,0,0,992,A
2-PB1,563,992,0,0,0,992,A
2-PB1,564,998,0,0,0,998,A
2-PB1,565,996,0,3,0,999,A
2-PB1,566,1,0,1000,0,1001,G
2-PB1,567,1,2,997,0,1000,G
2-PB1,568,986,1,3,0,990,A
2-PB1,569,1,0,1016,0,1017,G
2-PB1,570,1011,0,3,0,1014,A
2-PB1,571,0,0,1052,0,1052,G
2-PB1,572,0,1050,0,0,1050,T
2-PB1,573,1048,0,1,0,1049,A
2-PB1,574,1047,2,2,0,1051,A
2-PB1,575,0,1,1059,0,1060,G
2-PB1,576,0,2,1066,0,1068,G
2-PB1,577,0,4,1065,0,1069,G
2-PB1,578,1041,0,4,0,1045,A
2-PB1,579,0,1,0,1049,1050,C
2-PB1,580,1020,0,1,0,1021,A
2-PB1,581,1022,0,0,0,1022,A
2-PB1,582,0,0,0,1022,1022,C
2-PB1,583,1020,1,0,0,1021,A
2-PB1,584,0,1011,0,0,1011,T
2-PB1,585,1,9,994,0,1004,G
2-PB1,586,1005,0,2,0,1007,A
2-PB1,587,0,0,0,1007,1007,C
2-PB1,588,2,0,0,988,990,C
2-PB1,589,992,0,0,0,992,A
2-PB1,590,991,0,0,0,991,A
2-PB1,591,0,0,997,0,997,G
2-PB1,592,998,0,0,0,998,A
2-PB1,593,999,0,0,0,999,A
2-PB1,594,988,1,2,0,991,A
2-PB1,595,990,0,1,0,991,A
2-PB1,596,0,996,0,1,997,T
2-PB1,597,0,2,995,0,997,G
2-PB1,598,0,1,999,0,1000,G
2-PB1,599,0,995,0,3,998,T
2-PB1,600,9,1,0,976,986,C
2-PB1,601,997,0,0,0,997,A
2-PB1,602,0,0,0,1042,1042,C
2-PB1,603,1045,0,0,0,1045,A
2-PB1,604,0,0,0,1046,1046,C
2-PB1,605,1035,0,1,0,1036,A
2-PB1,606,1061,0,0,0,1061,A
2-PB1,607,1057,0,1,0,1058,A
2-PB1,608,0,1,1078,0,1079,G
2-PB1,609,64,3,971,0,1038,G
2-PB1,610,1074,0,1,0,1075,A
2-PB1,611,0,0,0,1104,1104,C
2-PB1,612,1110,0,1,0,1111,A
2-PB1,613,1113,0,1,0,1114,A
2-PB1,614,0,1111,0,0,1111,T
2-PB1,615,1093,0,2,0,1095,A
2-PB1,616,1,0,1098,0,1099,G
2-PB1,617,1,0,1051,0,1052,G
2-PB1,618,0,1,1049,0,1050,G
2-PB1,619,1052,0,0,0,1052,A
2-PB1,620,1033,0,2,0,1035,A
2-PB1,621,0,4,1033,0,1037,G
2-PB1,622,1039,0,0,0,1039,A
2-PB1,623,1042,0,0,0,1042,A
2-PB1,624,1043,0,0,0,1043,A
2-PB1,625,1042,1,1,0,1044,A
2-PB1,626,1063,0,0,0,1063,A
2-PB1,627,1059,0,0,2,1061,A
2-PB1,628,0,0,0,1065,1065,C
2-PB1,629,1064,0,0,0,1064,A
2-PB1,630,1062,0,1,0,1063,A
2-PB1,631,1059,0,0,0,1059,A
2-PB1,632,0,2,1075,0,1077,G
2-PB1,633,1074,0,3,0,1077,A
2-PB1,634,0,0,1111,0,1111,G
2-PB1,635,0,1093,0,0,1093,T
2-PB1,636,0,1,1244,0,1245,G
2-PB1,637,1244,0,1,0,1245,A
2-PB1,638,1245,2,4,0,1251,A
2-PB1,639,0,1260,0,3,1263,T
2-PB1,640,1266,0,1,0,1267,A
2-PB1,641,1255,0,1,0,1256,A
2-PB1,642,0,0,1255,0,1255,G
2-PB1,643,1225,0,1,0,1226,A
2-PB1,644,1,0,1228,0,1229,G
2-PB1,645,1172,1,1,1,1175,A
2-PB1,646,0,1,1175,0,1176,G
2-PB1,647,1,0,1172,0,1173,G
2-PB1,648,2,0,0,1165,1167,C
2-PB1,649,0,1169,1,1,1171,T
2-PB1,650,1208,0,0,0,1208,A
2-PB1,651,2,1,0,1261,1264,C
2-PB1,652,1,1,0,1267,1269,C
2-PB1,653,0,1275,0,0,1275,T
2-PB1,654,1319,0,1,0,1320,A
2-PB1,655,1306,0,2,1,1309,A
2-PB1,656,0,1314,0,0,1314,T
2-PB1,657,1303,0,1,0,1304,A
2-PB1,658,1302,0,1,0,1303,A
2-PB1,659,0,1,1304,0,1305,G
2-PB1,660,1244,0,4,0,1248,A
2-PB1,661,0,0,1260,0,1260,G
2-PB1,662,0,0,0,1262,1262,C
2-PB1,663,0,1232,1,2,1235,T
2-PB1,664,0,1240,0,0,1240,T
2-PB1,665,0,1240,0,0,1240,T
2-PB1,666,1,4,1233,0,1238,G
2-PB1,667,1261,0,1,1,1263,A
2-PB1,668,0,0,0,1267,1267,C
2-PB1,669,1262,0,0,0,1262,A
2-PB1,670,0,1256,0,2,1258,T
2-PB1,671,0,1251,0,1,1252,T
2-PB1,672,0,3,1287,0,1290,G
2-PB1,673,1281,2,1,0,1284,A
2-PB1,674,1290,0,2,0,1292,A
2-PB1,675,1,0,0,1299,1300,C
2-PB1,676,1288,0,0,0,1288,A
2-PB1,677,1,0,0,1286,1287,C
2-PB1,678,0,2,1280,0,1282,G
2-PB1,679,1281,0,2,0,1283,A
2-PB1,680,1,1287,0,0,1288,T
2-PB1,681,2,4,1305,0,1311,G
2-PB1,682,1311,0,1,0,1312,A
2-PB1,683,0,0,0,1316,1316,C
2-PB1,684,3,1,1,1305,1310,C
2-PB1,685,1311,2,2,0,1315,A
2-PB1,686,1323,0,2,0,1325,A
2-PB1,687,1322,0,4,0,1326,A
2-PB1,688,0,1,1358,0,1359,G
2-PB1,689,1368,0,0,0,1368,A
2-PB1,690,0,1345,0,1,1346,T
2-PB1,691,0,1,1340,0,1341,G
2-PB1,692,0,0,0,1334,1334,C
2-PB1,693,1340,0,3,0,1343,A
2-PB1,694,0,1,1353,0,1354,G
2-PB1,695,1345,1,0,0,1346,A
2-PB1,696,1,0,1343,0,1344,G
2-PB1,697,1308,0,0,0,1308,A
2-PB1,698,0,4,1304,0,1308,G
2-PB1,699,1294,0,3,0,1297,A
2-PB1,700,0,2,1295,0,1297,G
2-PB1,701,0,0,1295,0,1295,G
2-PB1,702,0,0,0,1297,1297,C
2-PB1,703,1292,0,0,0,1292,A
2-PB1,704,1294,0,1,1,1296,A
2-PB1,705,1301,0,1,0,1302,A
2-PB1,706,0,1313,0,1,1314,T
2-PB1,707,0,1308,0,1,1309,T
2-PB1,708,1307,0,1,0,1308,A
2-PB1,709,1308,0,0,0,1308,A
2-PB1,710,1308,0,2,0,1310,A
2-PB1,711,1315,0,0,0,1315,A
2-PB1,712,1315,0,1,0,1316,A
2-PB1,713,0,0,1319,0,1319,G
2-PB1,714,1309,0,1,0,1310,A
2-PB1,715,1306,0,1,0,1307,A
2-PB1,716,0,1,1320,0,1321,G
2-PB1,717,1,3,1350,0,1354,G
2-PB1,718,1,0,1354,0,1355,G
2-PB1,719,0,0,0,1365,1365,C
2-PB1,720,1,1359,0,0,1360,T
2-PB1,721,1364,0,1,0,1365,A
2-PB1,722,0,1374,0,0,1374,T
2-PB1,723,0,1380,0,0,1380,T
2-PB1,724,0,1,1391,0,1392,G
2-PB1,725,0,0,0,1372,1372,C
2-PB1,726,1323,0,3,1,1327,A
2-PB1,727,1328,0,1,0,1329,A
2-PB1,728,0,0,0,1332,1332,C
2-PB1,729,1330,0,1,0,1331,A
2-PB1,730,1,0,0,1327,1328,C
2-PB1,731,1,1,0,1293,1295,C
2-PB1,732,1,1,1,1292,1295,C
2-PB1,733,0,3,1289,0,1292,G
2-PB1,734,0,1,1298,0,1299,G
2-PB1,735,3,1,1293,0,1297,G
2-PB1,736,1302,1,1,0,1304,A
2-PB1,737,0,1295,0,1,1296,T
2-PB1,738,1,1,1301,0,1303,G
2-PB1,739,0,0,0,1295,1295,C
2-PB1,740,1306,0,2,0,1308,A
2-PB1,741,1324,0,1,0,1325,A
2-PB1,742,1345,0,0,0,1345,A
2-PB1,743,0,1343,0,1,1344,T
2-PB1,744,0,1341,0,1,1342,T
2-PB1,745,1328,0,0,0,1328,A
2-PB1,746,1,1,1324,0,1326,G
2-PB1,747,1316,0,2,0,1318,A
2-PB1,748,1,0,1323,1,1325,G
2-PB1,749,0,0,1295,0,1295,G
2-PB1,750,0,1,1322,0,1323,G
2-PB1,751,0,1326,0,1,1327,T
2-PB1,752,0,1323,0,1,1324,T
2-PB1,753,3,0,1,1329,1333,C
2-PB1,754,2,0,1347,0,1349,G
2-PB1,755,0,1348,0,1,1349,T
2-PB1,756,0,0,1351,0,1351,G
2-PB1,757,0,1337,0,1,1338,T
2-PB1,758,1331,0,1,0,1332,A
2-PB1,759,0,0,0,1329,1329,C
2-PB1,760,0,1249,0,1,1250,T
2-PB1,761,0,1263,0,0,1263,T
2-PB1,762,1,0,0,1259,1260,C
2-PB1,763,1,0,1236,0,1237,G
2-PB1,764,1,1233,0,3,1237,T
2-PB1,765,0,1230,0,3,1233,T
2-PB1,766,0,2,1230,0,1232,G
2-PB1,767,1228,0,0,0,1228,A
2-PB1,768,1233,0,2,0,1235,A
2-PB1,769,1239,0,1,1,1241,A
2-PB1,770,0,0,0,1248,1248,C
2-PB1,771,0,1228,0,1,1229,T
2-PB1,772,0,1217,1,0,1218,T
2-PB1,773,0,1219,0,0,1219,T
2-PB1,774,1237,0,1,1,1239,A
2-PB1,775,0,0,1246,0,1246,G
2-PB1,776,0,1,0,1246,1247,C
2-PB1,777,0,1245,0,2,1247,T
2-PB1,778,1235,1,0,1,1237,A
2-PB1,779,0,1,1235,0,1236,G
2-PB1,780,1236,0,2,0,1238,A
2-PB1,781,1239,0,1,0,1240,A
2-PB1,782,0,0,1240,0,1240,G
2-PB1,783,0,0,0,1222,1222,C
2-PB1,784,1221,0,1,0,1222,A
2-PB1,785,0,1216,0,0,1216,T
2-PB1,786,0,1215,0,1,1216,T
2-PB1,787,0,1214,0,0,1214,T
2-PB1,788,1,0,1219,0,1220,G
2-PB1,789,0,0,0,1216,1216,C
2-PB1,790,0,1,1216,0,1217,G
2-PB1,791,1213,0,0,0,1213,A
2-PB1,792,1209,0,1,0,1210,A
2-PB1,793,1211,0,1,0,1212,A
2-PB1,794,1250,1,1,0,1252,A
2-PB1,795,0,0,1264,0,1264,G
2-PB1,796,0,0,0,1264,1264,C
2-PB1,797,0,1263,0,1,1264,T
2-PB1,798,0,1260,0,1,1261,T
2-PB1,799,0,4,1259,0,1263,G
2-PB1,800,1264,0,1,0,1265,A
2-PB1,801,1260,0,1,0,1261,A
2-PB1,802,0,0,0,1268,1268,C
2-PB1,803,1230,0,2,0,1232,A
2-PB1,804,0,0,1333,0,1333,G
2-PB1,805,0,1308,0,2,1310,T
2-PB1,806,6,0,0,1306,1312,C
2-PB1,807,1,1312,1,2,1316,T
2-PB1,808,1,2,1320,0,1323,G
2-PB1,809,0,2,1315,0,1317,G
2-PB1,810,1325,1,1,0,1327,A
2-PB1,811,0,0,0,1323,1323,C
2-PB1,812,0,1291,0,0,1291,T
2-PB1,813,0,1190,0,0,1190,T
2-PB1,814,2,0,0,1181,1183,C
2-PB1,815,1,2,0,1182,1185,C
2-PB1,816,1,2,1184,0,1187,G
2-PB1,817,0,0,1192,0,1192,G
2-PB1,818,0,1184,0,0,1184,T
2-PB1,819,0,1181,0,0,1181,T
2-PB1,820,0,3,1173,0,1176,G
2-PB1,821,1,2,1186,0,1189,G
2-PB1,822,0,1,1188,0,1189,G
2-PB1,823,0,0,1192,0,1192,G
2-PB1,824,1,0,1198,0,1199,G
2-PB1,825,0,1198,0,0,1198,T
2-PB1,826,1208,0,0,0,1208,A
2-PB1,827,1210,0,2,0,1212,A
2-PB1,828,1,1209,0,1,1211,T
2-PB1,829,0,1,1210,0,1211,G
2-PB1,830,1202,0,1,0,1203,A
2-PB1,831,1177,0,1,0,1178,A
2-PB1,832,1179,0,2,0,1181,A
2-PB1,833,1174,0,0,0,1174,A
2-PB1,834,0,0,1174,0,1174,G
2-PB1,835,1157,0,1,0,1158,A
2-PB1,836,1150,0,3,0,1153,A
2-PB1,837,1,1,1156,0,1158,G
2-PB1,838,0,1,1151,0,1152,G
2-PB1,839,0,0,0,1154,1154,C
2-PB1,840,2,1,0,1147,1150,C
2-PB1,841,1157,0,0,0,1157,A
2-PB1,842,1155,0,2,0,1157,A
2-PB1,843,1162,0,2,0,1164,A
2-PB1,844,0,1,0,1162,1163,C
2-PB1,845,0,1157,0,2,1159,T
2-PB1,846,1,1,1177,0,1179,G
2-PB1,847,0,1,1177,0,1178,G
2-PB1,848,0,0,0,1174,1174,C
2-PB1,849,1183,0,0,0,1183,A
2-PB1,850,1179,0,1,1,1181,A
2-PB1,851,1181,0,0,0,1181,A
2-PB1,852,0,1181,0,0,1181,T
2-PB1,853,0,0,1182,0,1182,G
2-PB1,854,0,1174,0,1,1175,T
2-PB1,855,0,1151,0,0,1151,T
2-PB1,856,0,0,1156,0,1156,G
2-PB1,857,0,1154,0,1,1155,T
2-PB1,858,0,3,1157,0,1160,G
2-PB1,859,1156,0,1,0,1157,A
2-PB1,860,0,2,1153,0,1155,G
2-PB1,861,1153,0,1,1,1155,A
2-PB1,862,1146,0,1,0,1147,A
2-PB1,863,1149,0,1,0,1150,A
2-PB1,864,1149,0,1,0,1150,A
2-PB1,865,1159,0,0,0,1159,A
2-PB1,866,1,1155,0,0,1156,T
2-PB1,867,0,0,1148,0,1148,G
2-PB1,868,1145,1,2,0,1148,A
2-PB1,869,1,1137,0,0,1138,T
2-PB1,870,0,1,1149,0,1150,G
2-PB1,871,1147,0,1,0,1148,A
2-PB1,872,0,0,0,1161,1161,C
2-PB1,873,0,1161,0,0,1161,T
2-PB1,874,1157,0,0,0,1157,A
2-PB1,875,1164,0,0,0,1164,A
2-PB1,876,0,1157,0,2,1159,T
2-PB1,877,0,1169,0,0,1169,T
2-PB1,878,3,0,0,1173,1176,C
2-PB1,879,1171,0,0,0,1171,A
2-PB1,880,0,1,0,1173,1174,C
2-PB1,881,1154,0,2,0,1156,A
2-PB1,882,1152,0,2,0,1154,A
2-PB1,883,0,2,1154,0,1156,G
2-PB1,884,1166,1,2,0,1169,A
2-PB1,885,0,0,0,1166,1166,C
2-PB1,886,1163,1,1,0,1165,A
2-PB1,887,0,0,0,1156,1156,C
2-PB1,888,1146,1,0,0,1147,A
2-PB1,889,1,3,1146,0,1150,G
2-PB1,890,1144,0,2,0,1146,A
2-PB1,891,0,1,1150,0,1151,G
2-PB1,892,0,0,0,1146,1146,C
2-PB1,893,0,1111,0,3,1114,T
2-PB1,894,0,1130,0,0,1130,T
2-PB1,895,0,1123,0,0,1123,T
2-PB1,896,1,1,0,1129,1131,C
2-PB1,897,0,1133,0,0,1133,T
2-PB1,898,1,1132,0,0,1133,T
2-PB1,899,0,1130,0,1,1131,T
2-PB1,900,4,1,0,1119,1124,C
2-PB1,901,1120,0,0,0,1120,A
2-PB1,902,1,0,0,1123,1124,C
2-PB1,903,1104,0,0,0,1104,A
2-PB1,904,1107,0,0,0,1107,A
2-PB1,905,0,1120,0,2,1122,T
2-PB1,906,0,0,0,1133,1133,C
2-PB1,907,1130,0,0,0,1130,A
2-PB1,908,0,0,0,1135,1135,C
2-PB1,909,0,1119,0,0,1119,T
2-PB1,910,1,2,1122,1,1126,G
2-PB1,911,1,2,1122,0,1125,G
2-PB1,912,0,3,1149,1,1153,G
2-PB1,913,0,0,1142,0,1142,G
2-PB1,914,1124,0,3,0,1127,A
2-PB1,915,1,2,0,1082,1085,C
2-PB1,916,1101,1,3,0,1105,A
2-PB1,917,1165,0,2,0,1167,A
2-PB1,918,0,0,0,1181,1181,C
2-PB1,919,1170,0,2,0,1172,A
2-PB1,920,0,0,0,1171,1171,C
2-PB1,921,0,1099,0,3,1102,T
2-PB1,922,1111,0,4,0,1115,A
2-PB1,923,1110,0,1,0,1111,A
2-PB1,924,0,0,1120,0,1120,G
2-PB1,925,0,1114,0,1,1115,T
2-PB1,926,1,2,1011,0,1014,G
2-PB1,927,0,2,1002,0,1004,G
2-PB1,928,995,1,3,0,999,A
2-PB1,929,1002,0,0,0,1002,A
2-PB1,930,0,1002,0,0,1002,T
2-PB1,931,1,3,994,0,998,G
2-PB1,932,999,0,0,0,999,A
2-PB1,933,985,0,0,0,985,A
2-PB1,934,993,0,1,0,994,A
2-PB1,935,997,0,1,0,998,A
2-PB1,936,0,991,0,0,991,T
2-PB1,937,2,0,0,993,995,C
2-PB1,938,992,0,2,0,994,A
2-PB1,939,993,0,0,0,993,A
2-PB1,940,989,0,1,1,991,A
2-PB1,941,991,0,0,0,991,A
2-PB1,942,0,1,0,995,996,C
2-PB1,943,1,0,0,981,982,C
2-PB1,944,2,0,0,975,977,C
2-PB1,945,1,0,0,972,973,C
2-PB1,946,0,0,0,986,986,C
2-PB1,947,0,4,981,0,985,G
2-PB1,948,982,0,1,1,984,A
2-PB1,949,981,0,0,0,981,A
2-PB1,950,0,982,0,0,982,T
2-PB1,951,0,0,989,0,989,G
2-PB1,952,2,974,0,0,976,T
2-PB1,953,1,971,0,2,974,T
2-PB1,954,0,971,0,1,972,T
2-PB1,955,1,973,0,0,974,T
2-PB1,956,0,974,0,0,974,T
2-PB1,957,0,1,974,0,975,G
2-PB1,958,0,0,974,0,974,G
2-PB1,959,0,0,0,971,971,C
2-PB1,960,1,0,964,0,965,G
2-PB1,961,961,0,0,0,961,A
2-PB1,962,0,982,0,0,982,T
2-PB1,963,0,1,1008,0,1009,G
2-PB1,964,1044,0,0,0,1044,A
2-PB1,965,0,1046,0,0,1046,T
2-PB1,966,0,1044,0,0,1044,T
2-PB1,967,1049,0,1,0,1050,A
2-PB1,968,0,0,0,1052,1052,C
2-PB1,969,1053,0,1,0,1054,A
2-PB1,970,0,1054,0,0,1054,T
2-PB1,971,972,0,2,0,974,A
2-PB1,972,1,0,1,973,975,C
2-PB1,973,859,0,0,0,859,A
2-PB1,974,0,852,0,2,854,T
2-PB1,975,1,0,0,848,849,C
2-PB1,976,842,0,0,0,842,A
2-PB1,977,0,0,0,837,837,C
2-PB1,978,833,0,0,0,833,A
2-PB1,979,832,0,0,0,832,A
2-PB1,980,831,0,1,0,832,A
2-PB1,981,1,1,797,0,799,G
2-PB1,982,837,0,0,0,837,A
2-PB1,983,834,0,2,0,836,A
2-PB1,984,0,835,0,1,836,T
2-PB1,985,2,1,0,819,822,C
2-PB1,986,825,0,1,1,827,A
2-PB1,987,826,0,1,0,827,A
2-PB1,988,0,0,0,825,825,C
2-PB1,989,0,0,0,826,826,C
2-PB1,990,0,764,0,0,764,T
2-PB1,991,0,0,770,0,770,G
2-PB1,992,764,0,1,0,765,A
2-PB1,993,0,0,770,0,770,G
2-PB1,994,0,768,0,0,768,T
2-PB1,995,0,0,744,0,744,G
2-PB1,996,1,0,781,0,782,G
2-PB1,997,0,774,0,2,776,T
2-PB1,998,0,777,0,0,777,T
2-PB1,999,1,0,0,775,776,C
2-PB1,1000,767,0,0,0,767,A
2-PB1,1001,1,1,781,0,783,G
2-PB1,1002,780,1,0,0,781,A
2-PB1,1003,782,0,1,0,783,A
2-PB1,1004,779,0,1,1,781,A
2-PB1,1005,0,0,0,679,679,C
2-PB1,1006,679,0,1,0,680,A
2-PB1,1007,0,675,0,0,675,T
2-PB1,1008,1,1,0,681,683,C
2-PB1,1009,0,1,0,680,681,C
2-PB1,1010,1,645,0,1,647,T
2-PB1,1011,0,5,646,0,651,G
2-PB1,1012,650,0,0,0,650,A
2-PB1,1013,2,2,651,0,655,G
2-PB1,1014,0,0,0,645,645,C
2-PB1,1015,618,1,1,0,620,A
2-PB1,1016,0,619,0,1,620,T
2-PB1,1017,1,1,0,611,613,C
2-PB1,1018,1,0,612,0,613,G
2-PB1,1019,0,0,0,613,613,C
2-PB1,1020,617,0,1,0,618,A
2-PB1,1021,0,0,0,615,615,C
2-PB1,1022,1,1,0,608,610,C
2-PB1,1023,0,4,607,0,611,G
2-PB1,1024,642,0,0,0,642,A
2-PB1,1025,0,642,0,0,642,T
2-PB1,1026,643,0,0,0,643,A
2-PB1,1027,641,0,0,0,641,A
2-PB1,1028,0,634,0,0,634,T
2-PB1,1029,0,0,641,0,641,G
2-PB1,1030,0,628,0,1,629,T
2-PB1,1031,0,622,0,1,623,T
2-PB1,1032,1,1,0,619,621,C
2-PB1,1033,0,618,0,0,618,T
2-PB1,1034,1,0,0,622,623,C
2-PB1,1035,624,0,1,0,625,A
2-PB1,1036,622,1,0,0,623,A
2-PB1,1037,623,0,1,0,624,A
2-PB1,1038,0,1,0,627,628,C
2-PB1,1039,623,0,0,0,623,A
2-PB1,1040,624,0,0,0,624,A
2-PB1,1041,621,0,2,0,623,A
2-PB1,1042,622,0,1,0,623,A
2-PB1,1043,0,624,0,0,624,T
2-PB1,1044,0,1,625,0,626,G
2-PB1,1045,0,0,626,0,626,G
2-PB1,1046,0,0,0,621,621,C
2-PB1,1047,626,0,0,0,626,A
2-PB1,1048,622,0,1,0,623,A
2-PB1,1049,0,0,625,0,625,G
2-PB1,1050,623,0,0,0,623,A
2-PB1,1051,0,621,0,0,621,T
2-PB1,1052,2,628,0,1,631,T
2-PB1,1053,0,2,630,0,632,G
2-PB1,1054,0,0,633,0,633,G
2-PB1,1055,0,1,640,0,641,G
2-PB1,1056,642,0,0,0,642,A
2-PB1,1057,644,0,0,0,644,A
2-PB1,1058,639,0,1,0,640,A
2-PB1,1059,641,0,0,0,641,A
2-PB1,1060,1,0,660,0,661,G
2-PB1,1061,1,1,658,0,660,G
2-PB1,1062,655,0,1,0,656,A
2-PB1,1063,0,652,0,0,652,T
2-PB1,1064,651,0,1,0,652,A
2-PB1,1065,0,0,0,655,655,C
2-PB1,1066,663,0,0,0,663,A
2-PB1,1067,0,659,0,0,659,T
2-PB1,1068,0,0,668,0,668,G
2-PB1,1069,0,645,0,2,647,T
2-PB1,1070,0,645,1,0,646,T
2-PB1,1071,1,0,0,642,643,C
2-PB1,1072,0,3,641,0,644,G
2-PB1,1073,643,0,1,0,644,A
2-PB1,1074,0,0,656,0,656,G
2-PB1,1075,643,0,0,0,643,A
2-PB1,1076,0,0,647,0,647,G
2-PB1,1077,0,642,0,0,642,T
2-PB1,1078,639,0,0,0,639,A
2-PB1,1079,642,0,0,0,642,A
2-PB1,1080,0,1,642,0,643,G
2-PB1,1081,639,0,0,0,639,A
2-PB1,1082,0,0,647,0,647,G
2-PB1,1083,622,0,1,0,623,A
2-PB1,1084,629,0,0,0,629,A
2-PB1,1085,0,620,0,0,620,T
2-PB1,1086,0,0,622,0,622,G
2-PB1,1087,623,0,0,0,623,A
2-PB1,1088,618,0,0,0,618,A
2-PB1,1089,0,0,612,0,612,G
2-PB1,1090,0,0,0,612,612,C
2-PB1,1091,1,601,0,0,602,T
2-PB1,1092,2,0,1,601,604,C
2-PB1,1093,0,0,0,604,604,C
2-PB1,1094,0,1,606,0,607,G
2-PB1,1095,1,3,603,0,607,G
2-PB1,1096,608,0,0,0,608,A
2-PB1,1097,0,0,0,610,610,C
2-PB1,1098,611,1,1,0,613,A
2-PB1,1099,0,1,0,618,619,C
2-PB1,1100,621,0,0,0,621,A
2-PB1,1101,623,0,0,0,623,A
2-PB1,1102,618,0,1,1,620,A
2-PB1,1103,0,621,0,0,621,T
2-PB1,1104,620,0,0,0,620,A
2-PB1,1105,1,1,0,616,618,C
2-PB1,1106,0,0,0,619,619,C
2-PB1,1107,0,597,0,4,601,T
2-PB1,1108,0,0,606,0,606,G
2-PB1,1109,1,0,0,604,605,C
2-PB1,1110,605,0,1,0,606,A
2-PB1,1111,0,0,607,0,607,G
2-PB1,1112,602,0,0,0,602,A
2-PB1,1113,599,0,1,0,600,A
2-PB1,1114,604,0,0,0,604,A
2-PB1,1115,0,607,0,0,607,T
2-PB1,1116,0,0,607,0,607,G
2-PB1,1117,1,0,0,603,604,C
2-PB1,1118,0,602,1,0,603,T
2-PB1,1119,611,0,2,0,613,A
2-PB1,1120,0,0,613,0,613,G
2-PB1,1121,0,0,0,616,616,C
2-PB1,1122,612,0,0,0,612,A
2-PB1,1123,608,0,0,0,608,A
2-PB1,1124,0,0,607,0,607,G
2-PB1,1125,0,0,0,606,606,C
2-PB1,1126,595,0,1,0,596,A
2-PB1,1127,0,614,0,0,614,T
2-PB1,1128,0,615,0,1,616,T
2-PB1,1129,0,0,635,0,635,G
2-PB1,1130,640,0,0,0,640,A
2-PB1,1131,0,0,0,635,635,C
2-PB1,1132,0,0,0,640,640,C
2-PB1,1133,0,622,0,0,622,T
2-PB1,1134,1,1,634,0,636,G
2-PB1,1135,638,0,1,0,639,A
2-PB1,1136,635,0,3,0,638,A
2-PB1,1137,0,0,649,0,649,G
2-PB1,1138,0,622,0,0,622,T
2-PB1,1139,630,0,0,0,630,A
2-PB1,1140,0,622,0,0,622,T
2-PB1,1141,0,618,0,0,618,T
2-PB1,1142,0,619,0,1,620,T
2-PB1,1143,2,0,0,601,603,C
2-PB1,1144,610,0,0,0,610,A
2-PB1,1145,613,0,0,0,613,A
2-PB1,1146,0,603,0,0,603,T
2-PB1,1147,0,1,602,1,604,G
2-PB1,1148,600,0,0,0,600,A
2-PB1,1149,601,0,2,0,603,A
2-PB1,1150,0,598,0,1,599,T
2-PB1,1151,0,0,0,605,605,C
2-PB1,1152,599,0,0,0,599,A
2-PB1,1153,604,0,0,0,604,A
2-PB1,1154,0,0,0,601,601,C
2-PB1,1155,605,0,0,0,605,A
2-PB1,1156,603,0,1,0,604,A
2-PB1,1157,0,0,605,0,605,G
2-PB1,1158,0,1,609,0,610,G
2-PB1,1159,609,0,0,0,609,A
2-PB1,1160,610,0,0,0,610,A
2-PB1,1161,0,1,613,0,614,G
2-PB1,1162,613,0,0,0,613,A
2-PB1,1163,615,0,0,0,615,A
2-PB1,1164,611,0,0,1,612,A
2-PB1,1165,614,1,0,0,615,A
2-PB1,1166,0,607,0,0,607,T
2-PB1,1167,0,603,0,0,603,T
2-PB1,1168,0,3,602,1,606,G
2-PB1,1169,604,0,0,0,604,A
2-PB1,1170,1,0,604,0,605,G
2-PB1,1171,607,0,0,0,607,A
2-PB1,1172,609,0,0,0,609,A
2-PB1,1173,612,0,1,0,613,A
2-PB1,1174,616,0,0,0,616,A
2-PB1,1175,1,615,0,0,616,T
2-PB1,1176,615,0,0,1,616,A
2-PB1,1177,616,0,1,0,617,A
2-PB1,1178,0,0,618,0,618,G
2-PB1,1179,0,0,609,1,610,G
2-PB1,1180,0,1,0,611,612,C
2-PB1,1181,0,0,0,611,611,C
2-PB1,1182,0,605,0,0,605,T
2-PB1,1183,1,0,0,685,686,C
2-PB1,1184,0,701,0,0,701,T
2-PB1,1185,0,701,0,1,702,T
2-PB1,1186,0,0,0,714,714,C
2-PB1,1187,0,708,0,1,709,T
2-PB1,1188,710,0,0,0,710,A
2-PB1,1189,715,0,0,0,715,A
2-PB1,1190,0,713,1,0,714,T
2-PB1,1191,717,0,0,0,717,A
2-PB1,1192,0,0,699,0,699,G
2-PB1,1193,636,1,1,0,638,A
2-PB1,1194,0,636,0,0,636,T
2-PB1,1195,0,2,624,0,626,G
2-PB1,1196,1,0,643,0,644,G
2-PB1,1197,0,0,0,641,641,C
2-PB1,1198,638,0,1,1,640,A
2-PB1,1199,0,0,0,648,648,C
2-PB1,1200,637,1,0,0,638,A
2-PB1,1201,0,0,666,0,666,G
2-PB1,1202,0,1,1,661,663,C
2-PB1,1203,664,0,0,0,664,A
2-PB1,1204,0,674,0,2,676,T
2-PB1,1205,0,1,0,674,675,C
2-PB1,1206,674,1,0,0,675,A
2-PB1,1207,0,675,0,0,675,T
2-PB1,1208,0,667,0,1,668,T
2-PB1,1209,0,0,663,0,663,G
2-PB1,1210,635,0,2,0,637,A
2-PB1,1211,0,0,657,0,657,G
2-PB1,1212,0,0,0,650,650,C
2-PB1,1213,1,0,0,639,640,C
2-PB1,1214,2,0,0,653,655,C
2-PB1,1215,0,643,1,3,647,T
2-PB1,1216,0,2,715,0,717,G
2-PB1,1217,0,0,734,0,734,G
2-PB1,1218,734,0,2,0,736,A
2-PB1,1219,770,0,0,0,770,A
2-PB1,1220,0,742,0,0,742,T
2-PB1,1221,0,0,780,0,780,G
2-PB1,1222,791,0,0,0,791,A
2-PB1,1223,0,799,0,0,799,T
2-PB1,1224,0,0,799,0,799,G
2-PB1,1225,796,0,0,0,796,A
2-PB1,1226,0,790,0,0,790,T
2-PB1,1227,0,0,788,1,789,G
2-PB1,1228,0,0,810,0,810,G
2-PB1,1229,1,1,810,0,812,G
2-PB1,1230,0,0,0,808,808,C
2-PB1,1231,808,1,1,0,810,A
2-PB1,1232,0,807,0,2,809,T
2-PB1,1233,0,0,840,0,840,G
2-PB1,1234,0,841,0,1,842,T
2-PB1,1235,1,842,0,0,843,T
2-PB1,1236,3,0,1,840,844,C
2-PB1,1237,844,1,0,0,845,A
2-PB1,1238,842,0,1,0,843,A
2-PB1,1239,1,0,0,845,846,C
2-PB1,1240,844,0,0,0,844,A
2-PB1,1241,0,847,0,0,847,T
2-PB1,1242,0,0,861,0,861,G
2-PB1,1243,2,0,0,855,857,C
2-PB1,1244,0,860,0,0,860,T
2-PB1,1245,862,1,1,0,864,A
2-PB1,1246,863,0,0,0,863,A
2-PB1,1247,1,0,884,0,885,G
2-PB1,1248,1,885,0,0,886,T
2-PB1,1249,878,0,0,0,878,A
2-PB1,1250,0,1,0,889,890,C
2-PB1,1251,0,1,899,0,900,G
2-PB1,1252,1,0,976,0,977,G
2-PB1,1253,0,972,0,2,974,T
2-PB1,1254,0,966,0,3,969,T
2-PB1,1255,0,966,0,1,967,T
2-PB1,1256,0,958,0,0,958,T
2-PB1,1257,957,0,1,0,958,A
2-PB1,1258,0,2,958,0,960,G
2-PB1,1259,0,2,956,1,959,G
2-PB1,1260,938,0,1,0,939,A
2-PB1,1261,1,0,939,0,940,G
2-PB1,1262,1,954,0,0,955,T
2-PB1,1263,1,0,0,958,959,C
2-PB1,1264,0,961,0,0,961,T
2-PB1,1265,2,1,0,961,964,C
2-PB1,1266,0,0,964,0,964,G
2-PB1,1267,996,0,0,0,996,A
2-PB1,1268,0,997,0,0,997,T
2-PB1,1269,1001,0,2,0,1003,A
2-PB1,1270,1,0,0,1000,1001,C
2-PB1,1271,0,991,0,1,992,T
2-PB1,1272,0,2,986,0,988,G
2-PB1,1273,989,0,1,0,990,A
2-PB1,1274,1002,1,0,0,1003,A
2-PB1,1275,0,1003,0,1,1004,T
2-PB1,1276,2,0,0,980,982,C
2-PB1,1277,1,975,0,0,976,T
2-PB1,1278,0,978,0,0,978,T
2-PB1,1279,1,2,978,0,981,G
2-PB1,1280,0,2,979,0,981,G
2-PB1,1281,983,0,2,0,985,A
2-PB1,1282,0,1,0,982,983,C
2-PB1,1283,973,0,0,0,973,A
2-PB1,1284,982,0,0,0,982,A
2-PB1,1285,983,0,1,0,984,A
2-PB1,1286,990,0,0,0,990,A
2-PB1,1287,0,0,1013,0,1013,G
2-PB1,1288,1015,0,0,0,1015,A
2-PB1,1289,1006,1,0,0,1007,A
2-PB1,1290,1011,1,2,0,1014,A
2-PB1,1291,0,1010,0,0,1010,T
2-PB1,1292,1014,0,0,0,1014,A
2-PB1,1293,0,0,0,1058,1058,C
2-PB1,1294,1050,0,0,0,1050,A
2-PB1,1295,0,1,0,1052,1053,C
2-PB1,1296,0,0,0,1042,1042,C
2-PB1,1297,1045,0,0,0,1045,A
2-PB1,1298,1051,0,3,0,1054,A
2-PB1,1299,0,2,1090,0,1092,G
2-PB1,1300,1111,0,1,0,1112,A
2-PB1,1301,1,0,0,1125,1126,C
2-PB1,1302,1104,0,0,0,1104,A
2-PB1,1303,1139,0,1,0,1140,A
2-PB1,1304,0,0,0,1138,1138,C
2-PB1,1305,1156,0,0,0,1156,A
2-PB1,1306,0,1170,0,0,1170,T
2-PB1,1307,1156,0,1,0,1157,A
2-PB1,1308,0,0,0,1166,1166,C
2-PB1,1309,0,1136,0,1,1137,T
2-PB1,1310,0,1,1161,0,1162,G
2-PB1,1311,0,0,1158,0,1158,G
2-PB1,1312,0,1127,0,0,1127,T
2-PB1,1313,1,0,1122,0,1123,G
2-PB1,1314,0,1,1117,0,1118,G
2-PB1,1315,1,1,1130,0,1132,G
2-PB1,1316,1129,0,1,0,1130,A
2-PB1,1317,0,1118,0,0,1118,T
2-PB1,1318,0,1,1114,1,1116,G
2-PB1,1319,1,0,1108,0,1109,G
2-PB1,1320,2,0,1116,0,1118,G
2-PB1,1321,0,0,0,1137,1137,C
2-PB1,1322,0,1128,0,2,1130,T
2-PB1,1323,2,0,0,1133,1135,C
2-PB1,1324,2,0,0,1129,1131,C
2-PB1,1325,1132,0,0,0,1132,A
2-PB1,1326,1130,0,0,0,1130,A
2-PB1,1327,0,1127,0,0,1127,T
2-PB1,1328,0,0,2,1126,1128,C
2-PB1,1329,0,1,0,1116,1117,C
2-PB1,1330,0,1112,0,1,1113,T
2-PB1,1331,0,0,0,1112,1112,C
2-PB1,1332,0,2,0,1108,1110,C
2-PB1,1333,1,0,1113,0,1114,G
2-PB1,1334,1114,0,1,0,1115,A
2-PB1,1335,0,0,0,1113,1113,C
2-PB1,1336,0,3,1112,0,1115,G
2-PB1,1337,1121,0,0,0,1121,A
2-PB1,1338,0,1121,0,0,1121,T
2-PB1,1339,0,1119,0,0,1119,T
2-PB1,1340,0,1121,0,0,1121,T
2-PB1,1341,1,1120,0,0,1121,T
2-PB1,1342,0,2,1118,0,1120,G
2-PB1,1343,0,5,0,1131,1136,C
2-PB1,1344,2,0,0,1124,1126,C
2-PB1,1345,0,0,0,1181,1181,C
2-PB1,1346,0,1159,1,4,1164,T
2-PB1,1347,3,0,0,1225,1228,C
2-PB1,1348,1232,0,1,0,1233,A
2-PB1,1349,0,1236,0,0,1236,T
2-PB1,1350,1234,0,1,0,1235,A
2-PB1,1351,0,0,1253,0,1253,G
2-PB1,1352,1,1234,0,0,1235,T
2-PB1,1353,0,3,1241,0,1244,G
2-PB1,1354,1199,0,0,0,1199,A
2-PB1,1355,1202,0,0,0,1202,A
2-PB1,1356,0,1147,0,2,1149,T
2-PB1,1357,0,1,1151,0,1152,G
2-PB1,1358,0,0,0,1154,1154,C
2-PB1,1359,1162,1,1,0,1164,A
2-PB1,1360,0,1,0,1169,1170,C
2-PB1,1361,0,0,0,1163,1163,C
2-PB1,1362,1154,1,0,0,1155,A
2-PB1,1363,1155,1,0,0,1156,A
2-PB1,1364,1155,0,0,0,1155,A
2-PB1,1365,0,1123,0,1,1124,T
2-PB1,1366,2,0,0,1163,1165,C
2-PB1,1367,1167,0,0,0,1167,A
2-PB1,1368,1,1164,0,0,1165,T
2-PB1,1369,0,2,1163,0,1165,G
2-PB1,1370,1165,0,2,0,1167,A
2-PB1,1371,0,1,1171,0,1172,G
2-PB1,1372,1,2,1167,0,1170,G
2-PB1,1373,0,1,1170,0,1171,G
2-PB1,1374,1163,0,1,0,1164,A
2-PB1,1375,1184,0,0,0,1184,A
2-PB1,1376,0,1185,0,1,1186,T
2-PB1,1377,1190,0,0,0,1190,A
2-PB1,1378,0,0,0,1192,1192,C
2-PB1,1379,1188,0,1,0,1189,A
2-PB1,1380,1187,0,4,0,1191,A
2-PB1,1381,0,0,1183,0,1183,G
2-PB1,1382,0,0,0,1171,1171,C
2-PB1,1383,1163,0,1,0,1164,A
2-PB1,1384,0,0,1188,0,1188,G
2-PB1,1385,0,3,1184,0,1187,G
2-PB1,1386,1188,0,1,0,1189,A
2-PB1,1387,0,0,1192,1,1193,G
2-PB1,1388,0,1174,0,0,1174,T
2-PB1,1389,1,5,1180,0,1186,G
2-PB1,1390,0,2,1188,0,1190,G
2-PB1,1391,1187,0,3,0,1190,A
2-PB1,1392,0,1187,1,0,1188,T
2-PB1,1393,1165,0,0,0,1165,A
2-PB1,1394,1,2,1175,0,1178,G
2-PB1,1395,1183,0,1,1,1185,A
2-PB1,1396,0,1190,0,1,1191,T
2-PB1,1397,0,1188,0,0,1188,T
2-PB1,1398,1,0,0,1222,1223,C
2-PB1,1399,0,1213,0,0,1213,T
2-PB1,1400,1212,0,0,0,1212,A
2-PB1,1401,0,1,0,1208,1209,C
2-PB1,1402,1198,1,2,0,1201,A
2-PB1,1403,0,0,1198,0,1198,G
2-PB1,1404,0,1,1173,0,1174,G
2-PB1,1405,1191,1,2,0,1194,A
2-PB1,1406,1,1,0,1188,1190,C
2-PB1,1407,0,1,0,1150,1151,C
2-PB1,1408,1,1135,0,2,1138,T
2-PB1,1409,0,1,1146,0,1147,G
2-PB1,1410,0,0,0,1148,1148,C
2-PB1,1411,1146,0,0,1,1147,A
2-PB1,1412,1163,0,1,0,1164,A
2-PB1,1413,0,0,1164,0,1164,G
2-PB1,1414,0,1144,0,0,1144,T
2-PB1,1415,0,1150,0,0,1150,T
2-PB1,1416,1139,0,0,0,1139,A
2-PB1,1417,0,0,1143,0,1143,G
2-PB1,1418,0,1137,0,1,1138,T
2-PB1,1419,0,2,1133,0,1135,G
2-PB1,1420,1,2,1131,0,1134,G
2-PB1,1421,2,2,1136,0,1140,G
2-PB1,1422,1140,1,1,0,1142,A
2-PB1,1423,1145,0,1,0,1146,A
2-PB1,1424,0,1141,0,0,1141,T
2-PB1,1425,6,2,0,1138,1146,C
2-PB1,1426,1145,0,2,0,1147,A
2-PB1,1427,1154,0,1,0,1155,A
2-PB1,1428,1,0,0,1153,1154,C
2-PB1,1429,1152,0,1,0,1153,A
2-PB1,1430,0,1135,0,0,1135,T
2-PB1,1431,0,6,1138,0,1144,G
2-PB1,1432,1142,2,2,0,1146,A
2-PB1,1433,1,1,1156,0,1158,G
2-PB1,1434,0,0,0,1153,1153,C
2-PB1,1435,1151,0,2,0,1153,A
2-PB1,1436,1154,0,1,0,1155,A
2-PB1,1437,1153,0,1,0,1154,A
2-PB1,1438,1159,0,1,0,1160,A
2-PB1,1439,1159,0,0,0,1159,A
2-PB1,1440,0,0,1155,0,1155,G
2-PB1,1441,1141,0,1,0,1142,A
2-PB1,1442,1127,0,1,0,1128,A
2-PB1,1443,0,0,1180,0,1180,G
2-PB1,1444,0,1186,0,0,1186,T
2-PB1,1445,2,0,0,1183,1185,C
2-PB1,1446,2,2,0,1188,1192,C
2-PB1,1447,2,1178,1,0,1181,T
2-PB1,1448,1201,0,0,0,1201,A
2-PB1,1449,0,1195,0,1,1196,T
2-PB1,1450,1199,0,1,0,1200,A
2-PB1,1451,0,1197,0,0,1197,T
2-PB1,1452,1187,0,0,0,1187,A
2-PB1,1453,1187,0,1,0,1188,A
2-PB1,1454,1182,0,1,0,1183,A
2-PB1,1455,0,1175,0,2,1177,T
2-PB1,1456,1165,0,0,0,1165,A
2-PB1,1457,1160,0,0,0,1160,A
2-PB1,1458,1161,0,0,1,1162,A
2-PB1,1459,1163,0,1,0,1164,A
2-PB1,1460,0,0,0,1165,1165,C
2-PB1,1461,1113,0,0,0,1113,A
2-PB1,1462,2,0,1107,0,1109,G
2-PB1,1463,0,1,1108,1,1110,G
2-PB1,1464,0,2,1107,0,1109,G
2-PB1,1465,1107,0,1,0,1108,A
2-PB1,1466,1,0,0,1109,1110,C
2-PB1,1467,1105,0,1,0,1106,A
2-PB1,1468,0,1115,0,0,1115,T
2-PB1,1469,0,1108,0,0,1108,T
2-PB1,1470,0,1117,0,0,1117,T
2-PB1,1471,0,6,1104,0,1110,G
2-PB1,1472,1098,0,1,0,1099,A
2-PB1,1473,1105,0,0,0,1105,A
2-PB1,1474,0,1103,0,2,1105,T
2-PB1,1475,0,1084,0,0,1084,T
2-PB1,1476,2,1,0,1087,1090,C
2-PB1,1477,1080,0,0,0,1080,A
2-PB1,1478,0,0,0,1078,1078,C
2-PB1,1479,0,1075,0,0,1075,T
2-PB1,1480,1077,0,1,0,1078,A
2-PB1,1481,1,0,1080,0,1081,G
2-PB1,1482,0,0,0,1079,1079,C
2-PB1,1483,0,1069,0,0,1069,T
2-PB1,1484,0,1075,0,2,1077,T
2-PB1,1485,0,1076,0,0,1076,T
2-PB1,1486,0,1078,0,1,1079,T
2-PB1,1487,0,1078,0,0,1078,T
2-PB1,1488,0,1077,0,0,1077,T
2-PB1,1489,0,1074,0,0,1074,T
2-PB1,1490,1071,0,0,0,1071,A
2-PB1,1491,0,1066,0,0,1066,T
2-PB1,1492,2,0,0,1069,1071,C
2-PB1,1493,1,3,1082,0,1086,G
2-PB1,1494,1111,0,0,0,1111,A
2-PB1,1495,0,1112,0,1,1113,T
2-PB1,1496,1110,0,1,0,1111,A
2-PB1,1497,1,1117,0,1,1119,T
2-PB1,1498,1,1,1115,1,1118,G
2-PB1,1499,0,1,1120,0,1121,G
2-PB1,1500,1125,0,0,0,1125,A
2-PB1,1501,0,1117,1,0,1118,T
2-PB1,1502,1,1106,0,0,1107,T
2-PB1,1503,1,1070,0,0,1071,T
2-PB1,1504,0,0,1077,0,1077,G
2-PB1,1505,0,1074,0,0,1074,T
2-PB1,1506,0,2,1068,0,1070,G
2-PB1,1507,0,0,1069,0,1069,G
2-PB1,1508,0,1,0,1054,1055,C
2-PB1,1509,0,1058,0,2,1060,T
2-PB1,1510,1060,0,0,0,1060,A
2-PB1,1511,1069,0,0,0,1069,A
2-PB1,1512,0,1068,0,0,1068,T
2-PB1,1513,1,1072,0,0,1073,T
2-PB1,1514,0,1073,0,0,1073,T
2-PB1,1515,0,1074,0,1,1075,T
2-PB1,1516,1068,0,2,0,1070,A
2-PB1,1517,0,1,1080,0,1081,G
2-PB1,1518,0,1,0,1076,1077,C
2-PB1,1519,1075,0,0,0,1075,A
2-PB1,1520,0,1066,0,1,1067,T
2-PB1,1521,0,2,1054,0,1056,G
2-PB1,1522,0,1,1072,1,1074,G
2-PB1,1523,1065,0,0,0,1065,A
2-PB1,1524,0,1,1072,0,1073,G
2-PB1,1525,1,0,0,1066,1067,C
2-PB1,1526,0,1054,0,1,1055,T
2-PB1,1527,0,0,1055,0,1055,G
2-PB1,1528,0,2,0,1055,1057,C
2-PB1,1529,3,1,1,1051,1056,C
2-PB1,1530,1,0,0,1057,1058,C
2-PB1,1531,1035,0,0,0,1035,A
2-PB1,1532,0,0,1100,0,1100,G
2-PB1,1533,0,1098,0,4,1102,T
2-PB1,1534,0,1102,0,1,1103,T
2-PB1,1535,0,1100,0,1,1101,T
2-PB1,1536,0,1078,0,2,1080,T
2-PB1,1537,1,0,1076,0,1077,G
2-PB1,1538,1,0,1080,0,1081,G
2-PB1,1539,1072,0,2,0,1074,A
2-PB1,1540,0,0,1079,0,1079,G
2-PB1,1541,0,984,0,1,985,T
2-PB1,1542,2,0,1025,0,1027,G
2-PB1,1543,0,1022,0,1,1023,T
2-PB1,1544,2,0,0,1023,1025,C
2-PB1,1545,0,1025,0,2,1027,T
2-PB1,1546,0,0,1029,0,1029,G
2-PB1,1547,0,3,1035,0,1038,G
2-PB1,1548,1035,0,2,1,1038,A
2-PB1,1549,1037,0,1,0,1038,A
2-PB1,1550,0,1036,0,0,1036,T
2-PB1,1551,964,0,0,1,965,A
2-PB1,1552,959,0,1,1,961,A
2-PB1,1553,962,0,0,0,962,A
2-PB1,1554,0,0,0,964,964,C
2-PB1,1555,0,3,953,0,956,G
2-PB1,1556,947,0,1,0,948,A
2-PB1,1557,0,0,946,0,946,G
2-PB1,1558,0,944,0,0,944,T
2-PB1,1559,1,0,0,948,949,C
2-PB1,1560,946,0,2,0,948,A
2-PB1,1561,0,0,960,0,960,G
2-PB1,1562,2,0,0,958,960,C
2-PB1,1563,1,958,0,0,959,T
2-PB1,1564,0,2,988,0,990,G
2-PB1,1565,977,0,0,0,977,A
2-PB1,1566,0,984,0,0,984,T
2-PB1,1567,981,1,0,0,982,A
2-PB1,1568,0,964,1,1,966,T
2-PB1,1569,0,2,961,0,963,G
2-PB1,1570,936,0,1,0,937,A
2-PB1,1571,0,0,951,0,951,G
2-PB1,1572,1,0,0,956,957,C
2-PB1,1573,891,0,0,0,891,A
2-PB1,1574,0,894,0,1,895,T
2-PB1,1575,0,895,0,0,895,T
2-PB1,1576,0,1,901,0,902,G
2-PB1,1577,0,2,931,0,933,G
2-PB1,1578,924,0,0,0,924,A
2-PB1,1579,0,0,926,0,926,G
2-PB1,1580,0,898,0,1,899,T
2-PB1,1581,891,0,3,0,894,A
2-PB1,1582,894,0,0,0,894,A
2-PB1,1583,0,0,0,898,898,C
2-PB1,1584,895,0,0,0,895,A
2-PB1,1585,0,0,913,0,913,G
2-PB1,1586,1,821,0,1,823,T
2-PB1,1587,0,1,828,0,829,G
2-PB1,1588,845,0,0,0,845,A
2-PB1,1589,1,839,1,1,842,T
2-PB1,1590,839,1,1,0,841,A
2-PB1,1591,839,0,0,0,839,A
2-PB1,1592,808,0,2,0,810,A
2-PB1,1593,0,3,816,0,819,G
2-PB1,1594,779,1,1,0,781,A
2-PB1,1595,782,0,0,0,782,A
2-PB1,1596,0,0,0,782,782,C
2-PB1,1597,753,1,1,0,755,A
2-PB1,1598,764,0,0,0,764,A
2-PB1,1599,0,0,0,771,771,C
2-PB1,1600,780,0,0,0,780,A
2-PB1,1601,0,776,0,2,778,T
2-PB1,1602,0,0,774,1,775,G
2-PB1,1603,776,0,1,0,777,A
2-PB1,1604,0,776,0,0,776,T
2-PB1,1605,761,0,0,0,761,A
2-PB1,1606,768,0,3,0,771,A
2-PB1,1607,768,0,0,0,768,A
2-PB1,1608,0,0,0,772,772,C
2-PB1,1609,737,0,0,0,737,A
2-PB1,1610,739,0,0,0,739,A
2-PB1,1611,0,719,0,2,721,T
2-PB1,1612,0,2,716,0,718,G
2-PB1,1613,740,0,0,0,740,A
2-PB1,1614,0,0,0,745,745,C
2-PB1,1615,2,1,0,729,732,C
2-PB1,1616,0,715,0,2,717,T
2-PB1,1617,0,703,0,0,703,T
2-PB1,1618,0,1,705,0,706,G
2-PB1,1619,0,2,709,0,711,G
2-PB1,1620,715,0,0,0,715,A
2-PB1,1621,1,0,0,704,705,C
2-PB1,1622,2,0,0,697,699,C
2-PB1,1623,694,0,0,0,694,A
2-PB1,1624,0,0,699,0,699,G
2-PB1,1625,0,0,0,694,694,C
2-PB1,1626,701,0,0,0,701,A
2-PB1,1627,697,0,2,0,699,A
2-PB1,1628,0,1,0,696,697,C
2-PB1,1629,688,0,1,0,689,A
2-PB1,1630,0,0,699,0,699,G
2-PB1,1631,1,0,0,699,700,C
2-PB1,1632,1,0,0,695,696,C
2-PB1,1633,1,0,0,702,703,C
2-PB1,1634,704,0,0,0,704,A
2-PB1,1635,701,0,0,0,701,A
2-PB1,1636,705,0,1,0,706,A
2-PB1,1637,0,705,0,0,705,T
2-PB1,1638,0,1,702,0,703,G
2-PB1,1639,0,0,694,0,694,G
2-PB1,1640,0,0,0,694,694,C
2-PB1,1641,0,688,0,0,688,T
2-PB1,1642,1,1,0,698,700,C
2-PB1,1643,0,701,0,1,702,T
2-PB1,1644,0,0,0,705,705,C
2-PB1,1645,0,0,0,712,712,C
2-PB1,1646,714,0,0,0,714,A
2-PB1,1647,713,0,0,0,713,A
2-PB1,1648,0,707,0,0,707,T
2-PB1,1649,0,703,0,0,703,T
2-PB1,1650,0,0,703,0,703,G
2-PB1,1651,0,685,0,2,687,T
2-PB1,1652,0,683,0,1,684,T
2-PB1,1653,2,1,0,680,683,C
2-PB1,1654,684,0,0,0,684,A
2-PB1,1655,0,683,0,1,684,T
2-PB1,1656,2,0,0,682,684,C
2-PB1,1657,689,0,0,0,689,A
2-PB1,1658,687,0,0,1,688,A
2-PB1,1659,682,0,0,0,682,A
2-PB1,1660,0,2,698,0,700,G
2-PB1,1661,695,1,0,0,696,A
2-PB1,1662,0,691,0,0,691,T
2-PB1,1663,0,692,0,0,692,T
2-PB1,1664,696,0,0,0,696,A
2-PB1,1665,0,0,0,709,709,C
2-PB1,1666,706,0,0,0,706,A
2-PB1,1667,0,0,715,0,715,G
2-PB1,1668,712,0,0,0,712,A
2-PB1,1669,1,702,0,1,704,T
2-PB1,1670,709,0,0,0,709,A
2-PB1,1671,0,0,0,743,743,C
2-PB1,1672,754,0,2,0,756,A
2-PB1,1673,0,1,0,794,795,C
2-PB1,1674,789,0,0,0,789,A
2-PB1,1675,0,795,0,0,795,T
2-PB1,1676,794,0,0,0,794,A
2-PB1,1677,0,795,0,0,795,T
2-PB1,1678,775,0,1,0,776,A
2-PB1,1679,1,1,773,0,775,G
2-PB1,1680,0,0,766,0,766,G
2-PB1,1681,0,723,0,1,724,T
2-PB1,1682,0,0,705,0,705,G
2-PB1,1683,0,0,0,738,738,C
2-PB1,1684,2,1,0,732,735,C
2-PB1,1685,747,0,0,0,747,A
2-PB1,1686,0,747,0,0,747,T
2-PB1,1687,745,0,0,0,745,A
2-PB1,1688,0,0,749,0,749,G
2-PB1,1689,720,0,2,0,722,A
2-PB1,1690,0,1,723,0,724,G
2-PB1,1691,0,0,722,0,722,G
2-PB1,1692,695,0,3,0,698,A
2-PB1,1693,0,2,694,0,696,G
2-PB1,1694,689,0,0,1,690,A
2-PB1,1695,0,0,0,693,693,C
2-PB1,1696,694,0,1,0,695,A
2-PB1,1697,0,1,0,707,708,C
2-PB1,1698,708,0,0,0,708,A
2-PB1,1699,0,0,0,710,710,C
2-PB1,1700,704,0,1,0,705,A
2-PB1,1701,710,0,0,0,710,A
2-PB1,1702,713,0,1,0,714,A
2-PB1,1703,0,713,0,0,713,T
2-PB1,1704,0,0,0,712,712,C
2-PB1,1705,1,0,0,711,712,C
2-PB1,1706,700,0,0,0,700,A
2-PB1,1707,0,3,696,1,700,G
2-PB1,1708,699,0,0,0,699,A
2-PB1,1709,0,0,0,700,700,C
2-PB1,1710,0,0,700,0,700,G
2-PB1,1711,691,0,0,0,691,A
2-PB1,1712,0,0,695,0,695,G
2-PB1,1713,695,0,0,0,695,A
2-PB1,1714,692,0,2,0,694,A
2-PB1,1715,0,0,703,0,703,G
2-PB1,1716,699,0,2,0,701,A
2-PB1,1717,1,697,0,0,698,T
2-PB1,1718,4,0,0,687,691,C
2-PB1,1719,695,0,0,0,695,A
2-PB1,1720,0,691,0,0,691,T
2-PB1,1721,0,691,0,0,691,T
2-PB1,1722,1,1,0,687,689,C
2-PB1,1723,0,2,688,0,690,G
2-PB1,1724,687,1,0,0,688,A
2-PB1,1725,0,0,684,0,684,G
2-PB1,1726,684,0,1,0,685,A
2-PB1,1727,0,723,0,0,723,T
2-PB1,1728,725,0,1,0,726,A
2-PB1,1729,726,0,0,0,726,A
2-PB1,1730,725,0,0,0,725,A
2-PB1,1731,0,0,728,0,728,G
2-PB1,1732,731,1,1,0,733,A
2-PB1,1733,708,0,1,0,709,A
2-PB1,1734,0,0,713,0,713,G
2-PB1,1735,0,0,0,718,718,C
2-PB1,1736,0,704,0,0,704,T
2-PB1,1737,1,0,710,0,711,G
2-PB1,1738,0,703,0,0,703,T
2-PB1,1739,1,3,696,0,700,G
2-PB1,1740,1,0,697,0,698,G
2-PB1,1741,1,0,705,0,706,G
2-PB1,1742,710,0,0,0,710,A
2-PB1,1743,0,705,0,1,706,T
2-PB1,1744,3,0,0,700,703,C
2-PB1,1745,704,1,0,0,705,A
2-PB1,1746,703,1,0,0,704,A
2-PB1,1747,708,0,0,0,708,A
2-PB1,1748,0,0,0,710,710,C
2-PB1,1749,2,0,0,703,705,C
2-PB1,1750,1,0,0,703,704,C
2-PB1,1751,703,0,0,0,703,A
2-PB1,1752,715,0,1,0,716,A
2-PB1,1753,1,717,0,0,718,T
2-PB1,1754,1,0,0,718,719,C
2-PB1,1755,714,0,1,0,715,A
2-PB1,1756,707,0,0,0,707,A
2-PB1,1757,0,1,719,0,720,G
2-PB1,1758,0,2,715,0,717,G
2-PB1,1759,0,1,715,0,716,G
2-PB1,1760,0,0,0,713,713,C
2-PB1,1761,701,0,1,0,702,A
2-PB1,1762,0,2,720,0,722,G
2-PB1,1763,0,2,728,0,730,G
2-PB1,1764,731,0,1,0,732,A
2-PB1,1765,0,0,0,740,740,C
2-PB1,1766,0,724,0,0,724,T
2-PB1,1767,746,0,0,0,746,A
2-PB1,1768,0,743,0,1,744,T
2-PB1,1769,0,745,0,0,745,T
2-PB1,1770,0,4,742,0,746,G
2-PB1,1771,1,0,743,0,744,G
2-PB1,1772,0,738,0,0,738,T
2-PB1,1773,732,0,0,1,733,A
2-PB1,1774,0,719,0,1,720,T
2-PB1,1775,0,1,0,721,722,C
2-PB1,1776,707,0,0,0,707,A
2-PB1,1777,0,0,714,0,714,G
2-PB1,1778,706,0,1,0,707,A
2-PB1,1779,0,708,0,0,708,T
2-PB1,1780,0,2,677,0,679,G
2-PB1,1781,0,1,675,0,676,G
2-PB1,1782,0,2,672,0,674,G
2-PB1,1783,0,3,673,0,676,G
2-PB1,1784,0,3,679,0,682,G
2-PB1,1785,680,0,1,0,681,A
2-PB1,1786,0,0,0,677,677,C
2-PB1,1787,1,2,0,668,671,C
2-PB1,1788,677,0,0,0,677,A
2-PB1,1789,749,0,0,0,749,A
2-PB1,1790,752,0,1,0,753,A
2-PB1,1791,0,0,0,770,770,C
2-PB1,1792,0,758,0,0,758,T
2-PB1,1793,0,756,0,0,756,T
2-PB1,1794,765,0,0,0,765,A
2-PB1,1795,0,761,0,2,763,T
2-PB1,1796,767,0,0,0,767,A
2-PB1,1797,0,0,0,768,768,C
2-PB1,1798,691,1,0,0,692,A
2-PB1,1799,694,0,0,0,694,A
2-PB1,1800,0,667,0,0,667,T
2-PB1,1801,690,0,0,0,690,A
2-PB1,1802,0,696,0,0,696,T
2-PB1,1803,2,0,0,691,693,C
2-PB1,1804,0,0,0,694,694,C
2-PB1,1805,0,0,691,0,691,G
2-PB1,1806,0,0,691,0,691,G
2-PB1,1807,692,0,0,0,692,A
2-PB1,1808,691,0,0,0,691,A
2-PB1,1809,0,694,0,0,694,T
2-PB1,1810,0,0,0,701,701,C
2-PB1,1811,0,696,0,2,698,T
2-PB1,1812,0,699,0,0,699,T
2-PB1,1813,1,2,0,697,700,C
2-PB1,1814,699,0,1,0,700,A
2-PB1,1815,0,0,0,703,703,C
2-PB1,1816,702,0,0,0,702,A
2-PB1,1817,0,763,0,2,765,T
2-PB1,1818,3,0,0,763,766,C
2-PB1,1819,0,0,0,769,769,C
2-PB1,1820,2,0,0,771,773,C
2-PB1,1821,0,770,0,2,772,T
2-PB1,1822,0,0,773,0,773,G
2-PB1,1823,769,0,1,1,771,A
2-PB1,1824,768,0,1,0,769,A
2-PB1,1825,0,1,770,0,771,G
2-PB1,1826,0,715,0,2,717,T
2-PB1,1827,3,0,0,715,718,C
2-PB1,1828,0,709,0,0,709,T
2-PB1,1829,0,0,723,0,723,G
2-PB1,1830,0,1,0,722,723,C
2-PB1,1831,0,722,0,0,722,T
2-PB1,1832,0,725,0,0,725,T
2-PB1,1833,726,0,0,0,726,A
2-PB1,1834,723,0,1,0,724,A
2-PB1,1835,725,0,1,0,726,A
2-PB1,1836,705,0,0,0,705,A
2-PB1,1837,0,713,0,0,713,T
2-PB1,1838,0,2,711,0,713,G
2-PB1,1839,0,1,714,0,715,G
2-PB1,1840,0,0,718,0,718,G
2-PB1,1841,715,0,2,0,717,A
2-PB1,1842,0,0,718,0,718,G
2-PB1,1843,0,0,0,718,718,C
2-PB1,1844,0,716,0,0,716,T
2-PB1,1845,0,2,717,0,719,G
2-PB1,1846,719,0,1,0,720,A
2-PB1,1847,0,717,0,1,718,T
2-PB1,1848,0,1,716,0,717,G
2-PB1,1849,0,0,722,0,722,G
2-PB1,1850,715,0,1,0,716,A
2-PB1,1851,0,719,0,0,719,T
2-PB1,1852,0,2,719,0,721,G
2-PB1,1853,717,0,1,0,718,A
2-PB1,1854,0,1,723,0,724,G
2-PB1,1855,727,0,0,0,727,A
2-PB1,1856,727,0,0,0,727,A
2-PB1,1857,0,724,0,0,724,T
2-PB1,1858,0,718,0,0,718,T
2-PB1,1859,719,0,1,0,720,A
2-PB1,1860,0,718,0,1,719,T
2-PB1,1861,0,0,0,720,720,C
2-PB1,1862,1,0,720,0,721,G
2-PB1,1863,0,1,716,0,717,G
2-PB1,1864,0,1,710,0,711,G
2-PB1,1865,1,0,711,0,712,G
2-PB1,1866,714,0,0,0,714,A
2-PB1,1867,712,0,1,1,714,A
2-PB1,1868,0,0,718,0,718,G
2-PB1,1869,717,0,1,0,718,A
2-PB1,1870,0,0,0,724,724,C
2-PB1,1871,0,722,0,1,723,T
2-PB1,1872,0,739,0,0,739,T
2-PB1,1873,0,740,0,1,741,T
2-PB1,1874,0,0,747,0,747,G
2-PB1,1875,1,745,0,1,747,T
2-PB1,1876,744,0,0,0,744,A
2-PB1,1877,738,0,2,0,740,A
2-PB1,1878,0,725,1,0,726,T
2-PB1,1879,0,0,0,728,728,C
2-PB1,1880,0,0,0,723,723,C
2-PB1,1881,1,0,0,715,716,C
2-PB1,1882,1,0,0,718,719,C
2-PB1,1883,0,711,0,2,713,T
2-PB1,1884,0,2,712,0,714,G
2-PB1,1885,713,1,1,0,715,A
2-PB1,1886,719,0,0,0,719,A
2-PB1,1887,0,722,0,2,724,T
2-PB1,1888,2,0,0,714,716,C
2-PB1,1889,1,0,0,712,713,C
2-PB1,1890,0,0,0,715,715,C
2-PB1,1891,0,713,0,3,716,T
2-PB1,1892,0,716,0,0,716,T
2-PB1,1893,0,713,0,0,713,T
2-PB1,1894,1,0,709,0,710,G
2-PB1,1895,0,706,0,1,707,T
2-PB1,1896,0,0,0,708,708,C
2-PB1,1897,695,0,3,1,699,A
2-PB1,1898,0,0,717,0,717,G
2-PB1,1899,0,0,0,719,719,C
2-PB1,1900,0,1,0,717,718,C
2-PB1,1901,722,0,0,0,722,A
2-PB1,1902,0,723,0,0,723,T
2-PB1,1903,722,0,1,0,723,A
2-PB1,1904,721,0,0,0,721,A
2-PB1,1905,719,0,0,1,720,A
2-PB1,1906,2,0,727,0,729,G
2-PB1,1907,716,0,0,0,716,A
2-PB1,1908,709,0,0,0,709,A
2-PB1,1909,711,0,0,0,711,A
2-PB1,1910,0,706,0,1,707,T
2-PB1,1911,1,708,0,0,709,T
2-PB1,1912,0,7,705,0,712,G
2-PB1,1913,705,0,1,0,706,A
2-PB1,1914,0,0,718,0,718,G
2-PB1,1915,0,715,0,1,716,T
2-PB1,1916,4,0,1,722,727,C
2-PB1,1917,0,723,0,0,723,T
2-PB1,1918,0,0,736,0,736,G
2-PB1,1919,0,737,0,0,737,T
2-PB1,1920,749,0,0,0,749,A
2-PB1,1921,749,0,1,0,750,A
2-PB1,1922,748,0,1,0,749,A
2-PB1,1923,0,0,0,747,747,C
2-PB1,1924,728,0,0,0,728,A
2-PB1,1925,746,1,2,0,749,A
2-PB1,1926,0,745,0,0,745,T
2-PB1,1927,0,0,749,0,749,G
2-PB1,1928,0,0,0,759,759,C
2-PB1,1929,0,741,0,3,744,T
2-PB1,1930,0,0,768,0,768,G
2-PB1,1931,0,767,0,0,767,T
2-PB1,1932,781,0,0,0,781,A
2-PB1,1933,1,0,784,0,785,G
2-PB1,1934,0,766,0,0,766,T
2-PB1,1935,765,0,0,0,765,A
2-PB1,1936,764,0,0,0,764,A
2-PB1,1937,0,760,0,1,761,T
2-PB1,1938,0,0,760,0,760,G
2-PB1,1939,0,0,0,745,745,C
2-PB1,1940,1,0,0,733,734,C
2-PB1,1941,723,0,3,1,727,A
2-PB1,1942,0,0,750,0,750,G
2-PB1,1943,0,0,0,758,758,C
2-PB1,1944,0,0,0,759,759,C
2-PB1,1945,0,0,0,759,759,C
2-PB1,1946,751,0,1,0,752,A
2-PB1,1947,0,754,0,2,756,T
2-PB1,1948,0,0,756,0,756,G
2-PB1,1949,0,0,769,0,769,G
2-PB1,1950,0,768,0,0,768,T
2-PB1,1951,3,0,0,747,750,C
2-PB1,1952,1,0,1,730,732,C
2-PB1,1953,0,727,0,1,728,T
2-PB1,1954,2,1,740,0,743,G
2-PB1,1955,0,0,0,742,742,C
2-PB1,1956,2,0,0,736,738,C
2-PB1,1957,743,1,0,0,744,A
2-PB1,1958,732,0,0,0,732,A
2-PB1,1959,727,0,1,0,728,A
2-PB1,1960,730,0,2,0,732,A
2-PB1,1961,0,0,749,0,749,G
2-PB1,1962,0,736,0,0,736,T
2-PB1,1963,728,0,0,0,728,A
2-PB1,1964,0,725,0,1,726,T
2-PB1,1965,0,2,726,0,728,G
2-PB1,1966,0,1,739,0,740,G
2-PB1,1967,736,0,1,0,737,A
2-PB1,1968,745,0,0,0,745,A
2-PB1,1969,1,740,0,0,741,T
2-PB1,1970,737,0,1,0,738,A
2-PB1,1971,0,736,0,0,736,T
2-PB1,1972,1,1,727,0,729,G
2-PB1,1973,728,0,3,0,731,A
2-PB1,1974,0,728,0,0,728,T
2-PB1,1975,0,1,704,0,705,G
2-PB1,1976,0,1,0,703,704,C
2-PB1,1977,1,0,0,703,704,C
2-PB1,1978,0,0,704,0,704,G
2-PB1,1979,0,703,0,0,703,T
2-PB1,1980,0,706,0,0,706,T
2-PB1,1981,1,0,702,0,703,G
2-PB1,1982,0,0,0,717,717,C
2-PB1,1983,715,0,2,0,717,A
2-PB1,1984,728,0,2,0,730,A
2-PB1,1985,0,1,0,729,730,C
2-PB1,1986,0,721,0,1,722,T
2-PB1,1987,727,0,1,0,728,A
2-PB1,1988,0,0,0,725,725,C
2-PB1,1989,726,0,0,0,726,A
2-PB1,1990,0,0,0,731,731,C
2-PB1,1991,709,0,0,0,709,A
2-PB1,1992,0,0,0,770,770,C
2-PB1,1993,0,751,0,1,752,T
2-PB1,1994,1,1,0,757,759,C
2-PB1,1995,0,0,0,757,757,C
2-PB1,1996,0,752,0,1,753,T
2-PB1,1997,0,0,756,0,756,G
2-PB1,1998,0,1,754,0,755,G
2-PB1,1999,754,0,0,0,754,A
2-PB1,2000,0,755,0,1,756,T
2-PB1,2001,0,683,0,0,683,T
2-PB1,2002,0,0,0,688,688,C
2-PB1,2003,1,0,0,684,685,C
2-PB1,2004,0,0,0,688,688,C
2-PB1,2005,690,0,0,0,690,A
2-PB1,2006,687,0,0,0,687,A
2-PB1,2007,0,5,686,0,691,G
2-PB1,2008,684,0,2,0,686,A
2-PB1,2009,0,0,687,0,687,G
2-PB1,2010,0,1,685,0,686,G
2-PB1,2011,670,1,2,0,673,A
2-PB1,2012,673,0,2,0,675,A
2-PB1,2013,0,0,0,674,674,C
2-PB1,2014,3,0,0,667,670,C
2-PB1,2015,0,0,679,0,679,G
2-PB1,2016,0,0,0,678,678,C
2-PB1,2017,0,680,0,2,682,T
2-PB1,2018,2,1,0,678,681,C
2-PB1,2019,0,679,0,0,679,T
2-PB1,2020,724,0,0,0,724,A
2-PB1,2021,0,713,0,3,716,T
2-PB1,2022,0,723,0,0,723,T
2-PB1,2023,1,0,0,726,727,C
2-PB1,2024,0,708,0,1,709,T
2-PB1,2025,707,0,1,0,708,A
2-PB1,2026,706,0,0,0,706,A
2-PB1,2027,712,0,0,0,712,A
2-PB1,2028,0,1,0,709,710,C
2-PB1,2029,643,0,0,0,643,A
2-PB1,2030,0,0,0,639,639,C
2-PB1,2031,634,0,0,0,634,A
2-PB1,2032,636,0,1,0,637,A
2-PB1,2033,0,0,643,0,643,G
2-PB1,2034,0,1,0,642,643,C
2-PB1,2035,0,0,0,644,644,C
2-PB1,2036,636,0,4,0,640,A
2-PB1,2037,640,0,1,0,641,A
2-PB1,2038,641,0,1,0,642,A
2-PB1,2039,1,0,647,0,648,G
2-PB1,2040,0,1,644,0,645,G
2-PB1,2041,0,0,636,0,636,G
2-PB1,2042,0,0,632,0,632,G
2-PB1,2043,630,0,2,0,632,A
2-PB1,2044,633,0,1,0,634,A
2-PB1,2045,0,631,0,0,631,T
2-PB1,2046,1,633,0,0,634,T
2-PB1,2047,1,0,0,636,637,C
2-PB1,2048,0,628,0,1,629,T
2-PB1,2049,0,628,0,0,628,T
2-PB1,2050,0,1,628,0,629,G
2-PB1,2051,625,0,1,0,626,A
2-PB1,2052,0,0,630,0,630,G
2-PB1,2053,0,1,626,0,627,G
2-PB1,2054,628,0,0,0,628,A
2-PB1,2055,0,629,0,0,629,T
2-PB1,2056,0,1,631,0,632,G
2-PB1,2057,630,0,1,0,631,A
2-PB1,2058,632,0,1,0,633,A
2-PB1,2059,0,0,0,640,640,C
2-PB1,2060,630,0,0,0,630,A
2-PB1,2061,0,0,643,0,643,G
2-PB1,2062,634,0,1,0,635,A
2-PB1,2063,0,628,0,0,628,T
2-PB1,2064,0,0,632,0,632,G
2-PB1,2065,0,637,0,2,639,T
2-PB1,2066,640,1,1,0,642,A
2-PB1,2067,0,1,0,640,641,C
2-PB1,2068,1,0,0,633,634,C
2-PB1,2069,625,0,0,0,625,A
2-PB1,2070,0,0,621,0,621,G
2-PB1,2071,615,0,0,0,615,A
2-PB1,2072,611,0,1,0,612,A
2-PB1,2073,0,0,621,0,621,G
2-PB1,2074,0,581,0,0,581,T
2-PB1,2075,0,0,587,0,587,G
2-PB1,2076,0,0,0,586,586,C
2-PB1,2077,0,585,0,1,586,T
2-PB1,2078,0,0,581,0,581,G
2-PB1,2079,1,0,0,582,583,C
2-PB1,2080,581,0,1,0,582,A
2-PB1,2081,580,0,1,0,581,A
2-PB1,2082,0,0,0,576,576,C
2-PB1,2083,0,573,0,0,573,T
2-PB1,2084,0,564,0,0,564,T
2-PB1,2085,0,0,563,0,563,G
2-PB1,2086,0,560,0,1,561,T
2-PB1,2087,0,564,0,0,564,T
2-PB1,2088,3,0,0,560,563,C
2-PB1,2089,0,1,557,0,558,G
2-PB1,2090,559,0,1,0,560,A
2-PB1,2091,0,0,557,0,557,G
2-PB1,2092,560,0,0,0,560,A
2-PB1,2093,560,0,1,0,561,A
2-PB1,2094,566,0,0,0,566,A
2-PB1,2095,0,564,0,0,564,T
2-PB1,2096,0,562,0,1,563,T
2-PB1,2097,0,562,0,1,563,T
2-PB1,2098,0,565,0,1,566,T
2-PB1,2099,1,565,0,0,566,T
2-PB1,2100,0,0,0,567,567,C
2-PB1,2101,0,0,0,567,567,C
2-PB1,2102,1,0,0,566,567,C
2-PB1,2103,0,563,0,0,563,T
2-PB1,2104,565,0,0,0,565,A
2-PB1,2105,0,0,567,0,567,G
2-PB1,2106,0,565,0,1,566,T
2-PB1,2107,569,0,1,0,570,A
2-PB1,2108,0,0,573,0,573,G
2-PB1,2109,0,565,0,1,566,T
2-PB1,2110,0,584,1,0,585,T
2-PB1,2111,2,0,0,586,588,C
2-PB1,2112,610,0,0,0,610,A
2-PB1,2113,0,612,0,0,612,T
2-PB1,2114,618,0,0,0,618,A
2-PB1,2115,0,615,0,1,616,T
2-PB1,2116,598,1,1,0,600,A
2-PB1,2117,0,0,603,0,603,G
2-PB1,2118,0,1,598,0,599,G
2-PB1,2119,548,0,0,0,548,A
2-PB1,2120,0,2,544,0,546,G
2-PB1,2121,514,0,1,0,515,A
2-PB1,2122,1,0,0,514,515,C
2-PB1,2123,1,0,0,500,501,C
2-PB1,2124,0,1,502,0,503,G
2-PB1,2125,503,0,0,0,503,A
2-PB1,2126,0,498,1,0,499,T
2-PB1,2127,0,499,0,0,499,T
2-PB1,2128,0,0,500,0,500,G
2-PB1,2129,0,1,500,0,501,G
2-PB1,2130,502,0,0,0,502,A
2-PB1,2131,500,0,0,0,500,A
2-PB1,2132,0,495,0,0,495,T
2-PB1,2133,0,495,0,0,495,T
2-PB1,2134,0,496,0,0,496,T
2-PB1,2135,1,0,0,497,498,C
2-PB1,2136,0,495,0,1,496,T
2-PB1,2137,498,0,0,0,498,A
2-PB1,2138,0,0,497,0,497,G
2-PB1,2139,0,0,0,494,494,C
2-PB1,2140,492,0,0,0,492,A
2-PB1,2141,0,491,0,1,492,T
2-PB1,2142,0,1,482,0,483,G
2-PB1,2143,0,0,492,0,492,G
2-PB1,2144,1,493,0,0,494,T
2-PB1,2145,0,1,492,0,493,G
2-PB1,2146,0,0,492,0,492,G
2-PB1,2147,485,1,1,0,487,A
2-PB1,2148,0,0,488,0,488,G
2-PB1,2149,0,0,488,0,488,G
2-PB1,2150,0,0,0,485,485,C
2-PB1,2151,0,0,0,479,479,C
2-PB1,2152,431,0,1,0,432,A
2-PB1,2153,1,424,0,1,426,T
2-PB1,2154,0,1,428,0,429,G
2-PB1,2155,1,0,435,0,436,G
2-PB1,2156,0,425,0,0,425,T
2-PB1,2157,0,0,433,0,433,G
2-PB1,2158,0,426,0,0,426,T
2-PB1,2159,2,1,0,415,418,C
2-PB1,2160,0,422,0,0,422,T
2-PB1,2161,419,0,1,0,420,A
2-PB1,2162,0,0,419,0,419,G
2-PB1,2163,0,0,414,0,414,G
2-PB1,2164,0,0,409,0,409,G
2-PB1,2165,0,0,0,398,398,C
2-PB1,2166,0,0,0,374,374,C
2-PB1,2167,1,0,0,365,366,C
2-PB1,2168,0,0,367,0,367,G
2-PB1,2169,0,0,368,0,368,G
2-PB1,2170,368,0,0,0,368,A
2-PB1,2171,0,368,0,0,368,T
2-PB1,2172,0,359,0,0,359,T
2-PB1,2173,0,0,357,0,357,G
2-PB1,2174,355,0,0,0,355,A
2-PB1,2175,1,352,0,0,353,T
2-PB1,2176,0,0,356,0,356,G
2-PB1,2177,0,0,0,350,350,C
2-PB1,2178,1,0,0,350,351,C
2-PB1,2179,351,0,0,0,351,A
2-PB1,2180,0,0,350,0,350,G
2-PB1,2181,352,0,0,0,352,A
2-PB1,2182,349,0,1,0,350,A
2-PB1,2183,0,348,0,1,349,T
2-PB1,2184,0,344,0,0,344,T
2-PB1,2185,0,2,342,0,344,G
2-PB1,2186,343,0,1,0,344,A
2-PB1,2187,0,0,0,344,344,C
2-PB1,2188,0,342,0,0,342,T
2-PB1,2189,0,337,0,0,337,T
2-PB1,2190,0,0,0,338,338,C
2-PB1,2191,0,0,338,0,338,G
2-PB1,2192,336,0,0,0,336,A
2-PB1,2193,0,0,334,0,334,G
2-PB1,2194,0,336,0,0,336,T
2-PB1,2195,1,0,0,337,338,C
2-PB1,2196,0,338,0,0,338,T
2-PB1,2197,0,0,337,0,337,G
2-PB1,2198,0,0,337,0,337,G
2-PB1,2199,337,0,0,0,337,A
2-PB1,2200,315,0,0,0,315,A
2-PB1,2201,0,0,317,0,317,G
2-PB1,2202,0,2,316,0,318,G
2-PB1,2203,319,0,0,0,319,A
2-PB1,2204,0,315,0,0,315,T
2-PB1,2205,0,317,0,0,317,T
2-PB1,2206,316,0,0,0,316,A
2-PB1,2207,315,0,0,0,315,A
2-PB1,2208,2,0,313,0,315,G
2-PB1,2209,315,0,0,0,315,A
2-PB1,2210,295,0,2,0,297,A
2-PB1,2211,0,2,267,0,269,G
2-PB1,2212,0,0,270,0,270,G
2-PB1,2213,271,0,0,0,271,A
2-PB1,2214,271,0,0,0,271,A
2-PB1,2215,0,0,270,0,270,G
2-PB1,2216,261,0,0,0,261,A
2-PB1,2217,0,0,261,0,261,G
2-PB1,2218,0,248,0,0,248,T
2-PB1,2219,0,247,0,0,247,T
2-PB1,2220,0,0,0,249,249,C
2-PB1,2221,0,241,0,0,241,T
2-PB1,2222,0,0,0,243,243,C
2-PB1,2223,0,243,0,0,243,T
2-PB1,2224,0,0,243,0,243,G
2-PB1,2225,237,0,0,0,237,A
2-PB1,2226,0,1,232,0,233,G
2-PB1,2227,228,0,0,0,228,A
2-PB1,2228,0,226,0,0,226,T
2-PB1,2229,0,0,0,214,214,C
2-PB1,2230,217,0,0,0,217,A
2-PB1,2231,0,215,0,0,215,T
2-PB1,2232,0,0,215,0,215,G
2-PB1,2233,213,0,0,0,213,A
2-PB1,2234,214,0,0,0,214,A
2-PB1,2235,0,0,206,0,206,G
2-PB1,2236,204,0,0,0,204,A
2-PB1,2237,0,202,0,0,202,T
2-PB1,2238,0,0,0,199,199,C
2-PB1,2239,0,188,0,0,188,T
2-PB1,2240,0,0,189,0,189,G
2-PB1,2241,0,188,0,0,188,T
2-PB1,2242,0,187,0,1,188,T
2-PB1,2243,1,0,0,187,188,C
2-PB1,2244,1,0,0,177,178,C
2-PB1,2245,179,0,0,0,179,A
2-PB1,2246,0,0,0,179,179,C
2-PB1,2247,0,0,0,171,171,C
2-PB1,2248,167,0,0,0,167,A
2-PB1,2249,0,159,0,0,159,T
2-PB1,2250,0,155,0,0,155,T
2-PB1,2251,0,0,155,0,155,G
2-PB1,2252,153,0,1,0,154,A
2-PB1,2253,154,0,0,0,154,A
2-PB1,2254,0,1,151,0,152,G
2-PB1,2255,128,0,0,0,128,A
2-PB1,2256,128,0,0,0,128,A
2-PB1,2257,1,1,0,124,126,C
2-PB1,2258,0,118,0,0,118,T
2-PB1,2259,0,0,0,118,118,C
2-PB1,2260,113,0,0,0,113,A
2-PB1,2261,0,0,113,0,113,G
2-PB1,2262,111,0,0,0,111,A
2-PB1,2263,0,0,0,108,108,C
2-PB1,2264,0,0,107,0,107,G
2-PB1,2265,0,0,105,0,105,G
2-PB1,2266,0,0,0,105,105,C
2-PB1,2267,103,0,1,0,104,A
2-PB1,2268,105,0,0,0,105,A
2-PB1,2269,104,0,0,0,104,A
2-PB1,2270,105,0,0,0,105,A
2-PB1,2271,103,0,1,0,104,A
2-PB1,2272,0,100,0,0,100,T
2-PB1,2273,97,0,0,0,97,A
2-PB1,2274,97,0,0,0,97,A
3-PA,1,41,0,0,0,41,A
3-PA,2,0,41,0,0,41,T
3-PA,3,0,0,44,0,44,G
3-PA,4,0,0,44,0,44,G
3-PA,5,43,0,0,0,43,A
3-PA,6,44,0,0,0,44,A
3-PA,7,0,0,46,0,46,G
3-PA,8,49,0,0,0,49,A
3-PA,9,0,50,0,0,50,T
3-PA,10,0,50,0,0,50,T
3-PA,11,0,50,0,0,50,T
3-PA,12,0,49,0,0,49,T
3-PA,13,0,0,50,0,50,G
3-PA,14,0,50,0,0,50,T
3-PA,15,0,0,48,0,48,G
3-PA,16,0,0,0,55,55,C
3-PA,17,0,0,55,0,55,G
3-PA,18,60,0,0,0,60,A
3-PA,19,0,0,0,61,61,C
3-PA,20,61,0,0,0,61,A
3-PA,21,62,0,0,0,62,A
3-PA,22,0,65,0,0,65,T
3-PA,23,0,0,73,0,73,G
3-PA,24,0,0,0,73,73,C
3-PA,25,0,73,0,0,73,T
3-PA,26,0,74,0,0,74,T
3-PA,27,0,0,0,73,73,C
3-PA,28,76,0,0,0,76,A
3-PA,29,78,0,0,0,78,A
3-PA,30,0,0,0,80,80,C
3-PA,31,0,0,0,80,80,C
3-PA,32,0,0,0,80,80,C
3-PA,33,0,0,81,0,81,G
3-PA,34,79,1,0,0,80,A
3-PA,35,0,82,0,0,82,T
3-PA,36,0,0,83,0,83,G
3-PA,37,84,0,0,0,84,A
3-PA,38,0,88,0,0,88,T
3-PA,39,0,88,0,0,88,T
3-PA,40,0,0,88,0,88,G
3-PA,41,0,89,0,0,89,T
3-PA,42,0,0,0,89,89,C
3-PA,43,0,0,89,0,89,G
3-PA,44,89,0,0,0,89,A
3-PA,45,89,0,0,0,89,A
3-PA,46,0,0,0,91,91,C
3-PA,47,0,92,0,0,92,T
3-PA,48,0,93,0,0,93,T
3-PA,49,0,0,93,0,93,G
3-PA,50,0,0,0,93,93,C
3-PA,51,94,0,0,0,94,A
3-PA,52,0,0,94,0,94,G
3-PA,53,93,0,1,0,94,A
3-PA,54,94,0,0,0,94,A
3-PA,55,94,0,0,0,94,A
3-PA,56,94,0,0,0,94,A
3-PA,57,95,0,0,0,95,A
3-PA,58,0,0,97,0,97,G
3-PA,59,0,0,0,101,101,C
3-PA,60,101,0,0,0,101,A
3-PA,61,109,0,0,0,109,A
3-PA,62,0,107,0,0,107,T
3-PA,63,0,0,108,0,108,G
3-PA,64,112,0,0,0,112,A
3-PA,65,111,0,0,0,111,A
3-PA,66,112,0,0,0,112,A
3-PA,67,0,2,117,0,119,G
3-PA,68,131,0,0,0,131,A
3-PA,69,0,0,163,0,163,G
3-PA,70,0,162,0,1,163,T
3-PA,71,163,0,0,0,163,A
3-PA,72,0,162,0,0,162,T
3-PA,73,0,0,163,0,163,G
3-PA,74,0,0,164,0,164,G
3-PA,75,0,0,164,0,164,G
3-PA,76,0,0,163,0,163,G
3-PA,77,159,0,0,0,159,A
3-PA,78,0,0,160,0,160,G
3-PA,79,0,0,163,0,163,G
3-PA,80,164,0,0,0,164,A
3-PA,81,1,168,0,0,169,T
3-PA,82,0,0,0,167,167,C
3-PA,83,0,167,0,0,167,T
3-PA,84,1,0,164,0,165,G
3-PA,85,167,0,0,0,167,A
3-PA,86,167,0,0,0,167,A
3-PA,87,166,0,0,0,166,A
3-PA,88,161,0,0,0,161,A
3-PA,89,0,164,0,0,164,T
3-PA,90,0,162,0,0,162,T
3-PA,91,0,2,160,1,163,G
3-PA,92,164,0,0,0,164,A
3-PA,93,162,0,0,0,162,A
3-PA,94,163,0,0,0,163,A
3-PA,95,0,0,0,166,166,C
3-PA,96,166,0,0,0,166,A
3-PA,97,166,0,0,0,166,A
3-PA,98,166,0,0,0,166,A
3-PA,99,0,0,0,166,166,C
3-PA,100,165,0,0,0,165,A
3-PA,101,166,0,0,0,166,A
3-PA,102,169,0,0,0,169,A
3-PA,103,0,169,0,0,169,T
3-PA,104,0,171,0,0,171,T
3-PA,105,0,170,0,0,170,T
3-PA,106,0,0,170,0,170,G
3-PA,107,0,0,0,172,172,C
3-PA,108,173,0,0,0,173,A
3-PA,109,0,0,181,0,181,G
3-PA,110,0,0,0,181,181,C
3-PA,111,192,0,0,0,192,A
3-PA,112,193,0,0,0,193,A
3-PA,113,0,195,0,0,195,T
3-PA,114,196,0,0,0,196,A
3-PA,115,0,197,0,0,197,T
3-PA,116,0,0,198,0,198,G
3-PA,117,0,1,0,197,198,C
3-PA,118,194,0,2,0,196,A
3-PA,119,0,0,0,202,202,C
3-PA,120,0,200,0,0,200,T
3-PA,121,0,0,0,232,232,C
3-PA,122,241,0,0,0,241,A
3-PA,123,0,0,0,245,245,C
3-PA,124,0,244,0,1,245,T
3-PA,125,0,245,0,0,245,T
3-PA,126,0,0,245,0,245,G
3-PA,127,0,0,244,0,244,G
3-PA,128,242,0,0,0,242,A
3-PA,129,0,1,246,0,247,G
3-PA,130,0,0,244,0,244,G
3-PA,131,0,229,0,2,231,T
3-PA,132,0,0,238,0,238,G
3-PA,133,0,238,0,0,238,T
3-PA,134,0,0,242,0,242,G
3-PA,135,0,239,0,0,239,T
3-PA,136,0,241,0,0,241,T
3-PA,137,0,242,0,0,242,T
3-PA,138,1,0,0,243,244,C
3-PA,139,244,0,0,0,244,A
3-PA,140,0,244,0,0,244,T
3-PA,141,0,0,246,0,246,G
3-PA,142,0,244,0,0,244,T
3-PA,143,247,0,0,0,247,A
3-PA,144,0,247,0,0,247,T
3-PA,145,0,248,0,0,248,T
3-PA,146,0,0,1,249,250,C
3-PA,147,250,0,0,0,250,A
3-PA,148,0,0,252,0,252,G
3-PA,149,252,0,0,0,252,A
3-PA,150,0,249,0,0,249,T
3-PA,151,0,250,0,0,250,T
3-PA,152,0,249,0,1,250,T
3-PA,153,0,0,0,249,249,C
3-PA,154,0,0,0,265,265,C
3-PA,155,265,0,0,0,265,A
3-PA,156,0,264,0,0,264,T
3-PA,157,0,262,0,0,262,T
3-PA,158,0,263,0,0,263,T
3-PA,159,0,0,0,261,261,C
3-PA,160,256,0,6,0,262,A
3-PA,161,0,274,0,0,274,T
3-PA,162,0,0,0,273,273,C
3-PA,163,274,0,0,0,274,A
3-PA,164,274,0,0,0,274,A
3-PA,165,0,274,0,0,274,T
3-PA,166,0,1,284,0,285,G
3-PA,167,286,0,0,0,286,A
3-PA,168,285,0,0,0,285,A
3-PA,169,0,0,0,285,285,C
3-PA,170,282,0,0,0,282,A
3-PA,171,286,0,0,0,286,A
3-PA,172,1,0,287,0,288,G
3-PA,173,1,0,287,0,288,G
3-PA,174,0,0,0,286,286,C
3-PA,175,1,1,282,0,284,G
3-PA,176,308,0,0,0,308,A
3-PA,177,311,0,0,0,311,A
3-PA,178,0,310,0,0,310,T
3-PA,179,2,0,0,310,312,C
3-PA,180,315,0,0,1,316,A
3-PA,181,316,0,0,0,316,A
3-PA,182,0,318,0,0,318,T
3-PA,183,317,0,1,0,318,A
3-PA,184,0,0,326,0,326,G
3-PA,185,0,322,0,0,322,T
3-PA,186,0,0,324,0,324,G
3-PA,187,1,1,321,0,323,G
3-PA,188,0,321,0,0,321,T
3-PA,189,321,0,0,0,321,A
3-PA,190,1,1,328,0,330,G
3-PA,191,331,0,0,0,331,A
3-PA,192,330,0,0,0,330,A
3-PA,193,0,0,0,330,330,C
3-PA,194,0,326,0,1,327,T
3-PA,195,0,327,0,0,327,T
3-PA,196,0,0,330,0,330,G
3-PA,197,330,0,0,0,330,A
3-PA,198,0,0,0,331,331,C
3-PA,199,2,1,327,0,330,G
3-PA,200,341,0,0,0,341,A
3-PA,201,0,344,0,1,345,T
3-PA,202,1,0,0,343,344,C
3-PA,203,1,0,0,346,347,C
3-PA,204,347,0,0,0,347,A
3-PA,205,346,0,1,0,347,A
3-PA,206,349,0,0,0,349,A
3-PA,207,0,350,0,0,350,T
3-PA,208,0,0,353,0,353,G
3-PA,209,0,0,0,353,353,C
3-PA,210,349,0,0,0,349,A
3-PA,211,0,0,0,361,361,C
3-PA,212,0,358,0,1,359,T
3-PA,213,0,0,418,0,418,G
3-PA,214,0,419,0,0,419,T
3-PA,215,0,419,0,0,419,T
3-PA,216,418,0,0,0,418,A
3-PA,217,418,0,1,0,419,A
3-PA,218,418,0,1,0,419,A
3-PA,219,0,0,419,0,419,G
3-PA,220,0,0,0,416,416,C
3-PA,221,412,0,0,0,412,A
3-PA,222,0,0,0,412,412,C
3-PA,223,384,0,1,1,386,A
3-PA,224,0,0,409,0,409,G
3-PA,225,410,0,0,0,410,A
3-PA,226,0,408,0,0,408,T
3-PA,227,0,408,0,0,408,T
3-PA,228,0,408,0,0,408,T
3-PA,229,0,0,410,0,410,G
3-PA,230,410,0,0,0,410,A
3-PA,231,412,0,0,0,412,A
3-PA,232,413,0,0,1,414,A
3-PA,233,0,406,0,0,406,T
3-PA,234,403,0,0,0,403,A
3-PA,235,406,0,0,0,406,A
3-PA,236,0,407,0,0,407,T
3-PA,237,0,0,0,408,408,C
3-PA,238,1,1,407,0,409,G
3-PA,239,406,0,0,0,406,A
3-PA,240,0,0,409,0,409,G
3-PA,241,0,0,412,0,412,G
3-PA,242,0,0,410,0,410,G
3-PA,243,0,0,412,0,412,G
3-PA,244,408,0,1,0,409,A
3-PA,245,0,1,408,0,409,G
3-PA,246,423,0,0,0,423,A
3-PA,247,0,0,424,0,424,G
3-PA,248,423,0,1,0,424,A
3-PA,249,1,0,0,424,425,C
3-PA,250,415,0,1,0,416,A
3-PA,251,0,0,422,1,423,G
3-PA,252,421,0,0,0,421,A
3-PA,253,425,0,1,0,426,A
3-PA,254,0,0,0,425,425,C
3-PA,255,414,0,0,0,414,A
3-PA,256,412,0,0,0,412,A
3-PA,257,0,410,0,0,410,T
3-PA,258,1,0,424,0,425,G
3-PA,259,0,0,424,0,424,G
3-PA,260,0,0,0,420,420,C
3-PA,261,1,0,0,419,420,C
3-PA,262,0,418,0,0,418,T
3-PA,263,0,0,433,0,433,G
3-PA,264,0,1,430,0,431,G
3-PA,265,431,0,0,0,431,A
3-PA,266,0,0,0,434,434,C
3-PA,267,406,0,0,1,407,A
3-PA,268,0,0,453,0,453,G
3-PA,269,0,449,0,0,449,T
3-PA,270,454,0,0,0,454,A
3-PA,271,0,0,455,0,455,G
3-PA,272,0,443,0,0,443,T
3-PA,273,445,0,1,0,446,A
3-PA,274,447,0,0,0,447,A
3-PA,275,444,1,1,0,446,A
3-PA,276,0,0,0,449,449,C
3-PA,277,410,0,0,0,410,A
3-PA,278,0,0,420,0,420,G
3-PA,279,0,412,0,0,412,T
3-PA,280,412,0,0,0,412,A
3-PA,281,0,410,0,2,412,T
3-PA,282,0,0,0,414,414,C
3-PA,283,0,413,0,0,413,T
3-PA,284,0,0,414,0,414,G
3-PA,285,0,0,0,412,412,C
3-PA,286,409,0,0,0,409,A
3-PA,287,406,0,0,0,406,A
3-PA,288,0,0,0,406,406,C
3-PA,289,402,0,0,0,402,A
3-PA,290,0,0,0,433,433,C
3-PA,291,0,428,1,0,429,T
3-PA,292,428,0,0,0,428,A
3-PA,293,1,0,0,427,428,C
3-PA,294,0,422,0,3,425,T
3-PA,295,0,0,430,0,430,G
3-PA,296,0,1,432,0,433,G
3-PA,297,431,0,0,0,431,A
3-PA,298,0,2,428,0,430,G
3-PA,299,0,0,0,416,416,C
3-PA,300,0,411,1,1,413,T
3-PA,301,0,1,412,0,413,G
3-PA,302,0,0,413,0,413,G
3-PA,303,0,0,409,0,409,G
3-PA,304,410,0,1,0,411,A
3-PA,305,410,1,0,0,411,A
3-PA,306,412,0,0,0,412,A
3-PA,307,0,0,0,409,409,C
3-PA,308,3,0,0,406,409,C
3-PA,309,0,0,413,0,413,G
3-PA,310,411,0,0,0,411,A
3-PA,311,410,0,0,0,410,A
3-PA,312,0,0,415,0,415,G
3-PA,313,0,411,0,0,411,T
3-PA,314,0,413,0,0,413,T
3-PA,315,0,413,0,0,413,T
3-PA,316,1,0,0,411,412,C
3-PA,317,0,414,0,1,415,T
3-PA,318,417,0,0,0,417,A
3-PA,319,0,0,0,411,411,C
3-PA,320,0,1,0,414,415,C
3-PA,321,412,0,0,0,412,A
3-PA,322,0,0,420,0,420,G
3-PA,323,420,0,1,0,421,A
3-PA,324,0,416,0,1,417,T
3-PA,325,0,422,0,0,422,T
3-PA,326,0,419,0,0,419,T
3-PA,327,0,0,424,0,424,G
3-PA,328,0,426,0,0,426,T
3-PA,329,425,0,2,0,427,A
3-PA,330,1,426,0,0,427,T
3-PA,331,0,0,425,0,425,G
3-PA,332,461,0,0,0,461,A
3-PA,333,0,461,0,0,461,T
3-PA,334,1,462,0,0,463,T
3-PA,335,463,0,0,0,463,A
3-PA,336,0,0,0,462,462,C
3-PA,337,468,0,0,0,468,A
3-PA,338,469,0,0,0,469,A
3-PA,339,0,0,471,0,471,G
3-PA,340,1,4,474,0,479,G
3-PA,341,456,0,1,0,457,A
3-PA,342,0,2,466,0,468,G
3-PA,343,472,0,0,0,472,A
3-PA,344,468,0,2,0,470,A
3-PA,345,0,0,0,472,472,C
3-PA,346,463,0,2,0,465,A
3-PA,347,0,1,466,0,467,G
3-PA,348,462,0,1,0,463,A
3-PA,349,0,453,0,0,453,T
3-PA,350,0,450,0,0,450,T
3-PA,351,0,0,0,450,450,C
3-PA,352,449,0,0,0,449,A
3-PA,353,0,450,0,0,450,T
3-PA,354,0,0,0,450,450,C
3-PA,355,0,1,451,0,452,G
3-PA,356,458,0,0,0,458,A
3-PA,357,455,0,0,0,455,A
3-PA,358,458,0,0,0,458,A
3-PA,359,0,454,0,0,454,T
3-PA,360,0,455,0,0,455,T
3-PA,361,1,0,454,0,455,G
3-PA,362,0,0,456,0,456,G
3-PA,363,0,3,450,0,453,G
3-PA,364,0,1,459,0,460,G
3-PA,365,1,446,0,0,447,T
3-PA,366,0,0,450,0,450,G
3-PA,367,450,0,1,0,451,A
3-PA,368,0,0,0,454,454,C
3-PA,369,455,0,0,0,455,A
3-PA,370,456,0,0,0,456,A
3-PA,371,0,0,465,0,465,G
3-PA,372,0,0,467,0,467,G
3-PA,373,463,0,0,0,463,A
3-PA,374,0,1,464,0,465,G
3-PA,375,457,0,1,0,458,A
3-PA,376,0,0,459,0,459,G
3-PA,377,453,0,2,0,455,A
3-PA,378,455,0,0,0,455,A
3-PA,379,0,0,470,0,470,G
3-PA,380,0,457,0,0,457,T
3-PA,381,0,0,0,458,458,C
3-PA,382,1,0,0,457,458,C
3-PA,383,463,0,0,0,463,A
3-PA,384,0,0,0,470,470,C
3-PA,385,481,0,0,0,481,A
3-PA,386,0,494,0,0,494,T
3-PA,387,513,0,0,0,513,A
3-PA,388,0,492,1,0,493,T
3-PA,389,487,0,0,0,487,A
3-PA,390,0,479,0,2,481,T
3-PA,391,0,481,0,0,481,T
3-PA,392,503,0,1,0,504,A
3-PA,393,0,0,0,500,500,C
3-PA,394,0,0,0,487,487,C
3-PA,395,0,476,0,1,477,T
3-PA,396,0,469,0,0,469,T
3-PA,397,0,1,468,0,469,G
3-PA,398,469,0,0,0,469,A
3-PA,399,0,0,434,0,434,G
3-PA,400,439,0,0,0,439,A
3-PA,401,440,0,0,0,440,A
3-PA,402,0,0,448,0,448,G
3-PA,403,1,0,448,0,449,G
3-PA,404,0,0,0,445,445,C
3-PA,405,0,0,0,450,450,C
3-PA,406,446,1,0,0,447,A
3-PA,407,449,0,0,0,449,A
3-PA,408,0,448,0,0,448,T
3-PA,409,449,0,0,0,449,A
3-PA,410,450,0,0,0,450,A
3-PA,411,1,0,452,0,453,G
3-PA,412,451,0,0,0,451,A
3-PA,413,0,451,0,0,451,T
3-PA,414,0,448,0,0,448,T
3-PA,415,448,0,0,0,448,A
3-PA,416,447,0,0,0,447,A
3-PA,417,449,0,0,0,449,A
3-PA,418,1,452,0,0,453,T
3-PA,419,1,0,0,454,455,C
3-PA,420,0,439,0,1,440,T
3-PA,421,0,0,443,0,443,G
3-PA,422,442,0,0,0,442,A
3-PA,423,1,2,442,0,445,G
3-PA,424,443,0,1,0,444,A
3-PA,425,444,0,0,0,444,A
3-PA,426,0,1,0,442,443,C
3-PA,427,442,0,0,0,442,A
3-PA,428,0,0,0,441,441,C
3-PA,429,441,0,1,0,442,A
3-PA,430,0,2,0,445,447,C
3-PA,431,442,0,2,0,444,A
3-PA,432,0,0,0,458,458,C
3-PA,433,457,0,0,0,457,A
3-PA,434,0,456,0,0,456,T
3-PA,435,0,452,0,1,453,T
3-PA,436,3,0,0,451,454,C
3-PA,437,451,0,0,0,451,A
3-PA,438,0,1,0,452,453,C
3-PA,439,446,0,0,0,446,A
3-PA,440,0,447,0,0,447,T
3-PA,441,0,431,1,1,433,T
3-PA,442,0,443,0,0,443,T
3-PA,443,0,441,1,1,443,T
3-PA,444,0,0,0,444,444,C
3-PA,445,0,442,1,0,443,T
3-PA,446,0,0,0,443,443,C
3-PA,447,443,0,1,0,444,A
3-PA,448,0,441,0,0,441,T
3-PA,449,0,445,0,0,445,T
3-PA,450,1,0,0,445,446,C
3-PA,451,442,0,0,0,442,A
3-PA,452,0,0,0,446,446,C
3-PA,453,0,441,0,0,441,T
3-PA,454,1,0,441,0,442,G
3-PA,455,0,0,440,0,440,G
3-PA,456,431,0,0,0,431,A
3-PA,457,0,0,441,0,441,G
3-PA,458,441,0,1,0,442,A
3-PA,459,0,0,447,0,447,G
3-PA,460,1,1,445,0,447,G
3-PA,461,448,0,0,0,448,A
3-PA,462,444,0,1,0,445,A
3-PA,463,441,0,0,0,441,A
3-PA,464,1,435,0,0,436,T
3-PA,465,0,0,436,0,436,G
3-PA,466,0,0,433,0,433,G
3-PA,467,0,0,0,434,434,C
3-PA,468,0,1,0,433,434,C
3-PA,469,430,0,0,0,430,A
3-PA,470,0,0,0,430,430,C
3-PA,471,430,0,1,0,431,A
3-PA,472,434,0,0,0,434,A
3-PA,473,435,0,0,0,435,A
3-PA,474,0,0,436,0,436,G
3-PA,475,0,0,442,0,442,G
3-PA,476,0,0,0,441,441,C
3-PA,477,444,0,0,0,444,A
3-PA,478,0,0,446,0,446,G
3-PA,479,449,0,0,0,449,A
3-PA,480,0,0,0,457,457,C
3-PA,481,0,456,0,1,457,T
3-PA,482,457,0,0,0,457,A
3-PA,483,0,0,0,454,454,C
3-PA,484,453,1,0,0,454,A
3-PA,485,0,0,0,458,458,C
3-PA,486,0,441,0,0,441,T
3-PA,487,0,0,0,442,442,C
3-PA,488,0,434,0,0,434,T
3-PA,489,2,0,0,429,431,C
3-PA,490,0,1,427,0,428,G
3-PA,491,430,0,0,0,430,A
3-PA,492,0,0,0,429,429,C
3-PA,493,0,0,428,0,428,G
3-PA,494,425,0,0,0,425,A
3-PA,495,0,0,428,0,428,G
3-PA,496,0,0,425,1,426,G
3-PA,497,422,0,1,0,423,A
3-PA,498,421,0,3,0,424,A
3-PA,499,424,0,0,0,424,A
3-PA,500,0,1,423,0,424,G
3-PA,501,0,0,0,423,423,C
3-PA,502,424,0,0,0,424,A
3-PA,503,0,1,433,0,434,G
3-PA,504,0,0,432,0,432,G
3-PA,505,1,0,435,0,436,G
3-PA,506,0,0,0,432,432,C
3-PA,507,0,435,0,0,435,T
3-PA,508,434,0,1,0,435,A
3-PA,509,0,0,447,0,447,G
3-PA,510,0,1,467,0,468,G
3-PA,511,470,0,0,0,470,A
3-PA,512,0,460,0,0,460,T
3-PA,513,0,454,0,0,454,T
3-PA,514,453,0,0,0,453,A
3-PA,515,453,0,0,0,453,A
3-PA,516,0,0,452,0,452,G
3-PA,517,448,0,1,0,449,A
3-PA,518,0,0,0,451,451,C
3-PA,519,0,0,0,409,409,C
3-PA,520,410,0,0,0,410,A
3-PA,521,0,0,421,0,421,G
3-PA,522,0,0,425,0,425,G
3-PA,523,0,0,0,424,424,C
3-PA,524,0,419,0,1,420,T
3-PA,525,0,418,0,0,418,T
3-PA,526,0,424,0,0,424,T
3-PA,527,0,425,0,0,425,T
3-PA,528,0,424,0,0,424,T
3-PA,529,425,0,0,0,425,A
3-PA,530,0,1,0,424,425,C
3-PA,531,0,0,0,412,412,C
3-PA,532,411,0,1,0,412,A
3-PA,533,0,410,0,0,410,T
3-PA,534,404,0,1,0,405,A
3-PA,535,407,0,1,0,408,A
3-PA,536,1,0,413,0,414,G
3-PA,537,412,0,1,0,413,A
3-PA,538,0,0,0,412,412,C
3-PA,539,406,0,0,0,406,A
3-PA,540,407,0,0,0,407,A
3-PA,541,0,5,408,0,413,G
3-PA,542,414,0,0,0,414,A
3-PA,543,415,0,0,0,415,A
3-PA,544,408,0,2,0,410,A
3-PA,545,0,396,0,0,396,T
3-PA,546,0,0,401,0,401,G
3-PA,547,1,1,400,0,402,G
3-PA,548,0,2,0,398,400,C
3-PA,549,0,1,0,402,403,C
3-PA,550,399,0,0,0,399,A
3-PA,551,405,0,0,0,405,A
3-PA,552,0,0,0,405,405,C
3-PA,553,406,0,0,0,406,A
3-PA,554,0,0,404,0,404,G
3-PA,555,388,0,0,0,388,A
3-PA,556,0,2,396,0,398,G
3-PA,557,0,0,404,0,404,G
3-PA,558,1,0,0,396,397,C
3-PA,559,0,0,0,400,400,C
3-PA,560,0,387,0,1,388,T
3-PA,561,383,0,1,0,384,A
3-PA,562,0,392,0,0,392,T
3-PA,563,0,1,389,0,390,G
3-PA,564,1,0,393,0,394,G
3-PA,565,0,0,378,0,378,G
3-PA,566,361,0,2,0,363,A
3-PA,567,0,365,0,0,365,T
3-PA,568,0,360,0,0,360,T
3-PA,569,0,0,0,394,394,C
3-PA,570,2,0,0,386,388,C
3-PA,571,0,385,0,1,386,T
3-PA,572,0,385,0,0,385,T
3-PA,573,0,380,0,0,380,T
3-PA,574,0,0,0,382,382,C
3-PA,575,0,0,382,0,382,G
3-PA,576,0,379,0,1,380,T
3-PA,577,0,0,0,381,381,C
3-PA,578,367,0,0,0,367,A
3-PA,579,0,0,404,0,404,G
3-PA,580,0,404,0,0,404,T
3-PA,581,0,0,0,402,402,C
3-PA,582,1,0,0,402,403,C
3-PA,583,1,1,403,0,405,G
3-PA,584,405,0,0,0,405,A
3-PA,585,404,0,0,0,404,A
3-PA,586,404,0,1,0,405,A
3-PA,587,1,0,408,0,409,G
3-PA,588,386,0,1,0,387,A
3-PA,589,0,0,391,0,391,G
3-PA,590,0,0,391,0,391,G
3-PA,591,1,1,0,390,392,C
3-PA,592,0,0,391,1,392,G
3-PA,593,392,0,0,0,392,A
3-PA,594,393,0,0,0,393,A
3-PA,595,0,0,395,0,395,G
3-PA,596,395,0,0,0,395,A
3-PA,597,391,0,0,0,391,A
3-PA,598,385,0,1,0,386,A
3-PA,599,0,0,0,394,394,C
3-PA,600,394,0,0,1,395,A
3-PA,601,394,0,0,0,394,A
3-PA,602,0,394,0,0,394,T
3-PA,603,0,395,0,0,395,T
3-PA,604,0,0,395,0,395,G
3-PA,605,392,0,0,0,392,A
3-PA,606,393,0,0,0,393,A
3-PA,607,0,1,393,0,394,G
3-PA,608,394,0,0,0,394,A
3-PA,609,395,0,0,0,395,A
3-PA,610,395,0,0,0,395,A
3-PA,611,394,0,0,0,394,A
3-PA,612,395,0,1,0,396,A
3-PA,613,0,394,0,0,394,T
3-PA,614,0,395,0,0,395,T
3-PA,615,0,395,0,0,395,T
3-PA,616,0,0,395,0,395,G
3-PA,617,396,0,0,0,396,A
3-PA,618,394,0,0,0,394,A
3-PA,619,396,0,0,0,396,A
3-PA,620,0,397,0,0,397,T
3-PA,621,2,0,0,435,437,C
3-PA,622,434,0,0,0,434,A
3-PA,623,0,0,0,440,440,C
3-PA,624,436,0,2,0,438,A
3-PA,625,0,0,447,0,447,G
3-PA,626,0,4,452,0,456,G
3-PA,627,465,0,1,0,466,A
3-PA,628,469,0,0,0,469,A
3-PA,629,0,0,0,473,473,C
3-PA,630,0,449,1,0,450,T
3-PA,631,480,0,0,0,480,A
3-PA,632,0,475,0,0,475,T
3-PA,633,1,0,488,0,489,G
3-PA,634,0,0,0,483,483,C
3-PA,635,0,1,478,0,479,G
3-PA,636,0,476,0,0,476,T
3-PA,637,475,0,0,0,475,A
3-PA,638,0,0,477,0,477,G
3-PA,639,1,0,473,0,474,G
3-PA,640,1,0,0,465,466,C
3-PA,641,0,456,0,2,458,T
3-PA,642,0,453,0,0,453,T
3-PA,643,0,0,451,0,451,G
3-PA,644,0,0,0,451,451,C
3-PA,645,1,1,0,450,452,C
3-PA,646,0,1,455,0,456,G
3-PA,647,463,0,0,0,463,A
3-PA,648,0,0,0,463,463,C
3-PA,649,3,0,0,461,464,C
3-PA,650,464,0,0,0,464,A
3-PA,651,463,0,1,0,464,A
3-PA,652,465,1,1,0,467,A
3-PA,653,0,0,477,0,477,G
3-PA,654,0,476,0,0,476,T
3-PA,655,1,0,0,474,475,C
3-PA,656,0,471,0,1,472,T
3-PA,657,2,0,0,476,478,C
3-PA,658,1,0,0,478,479,C
3-PA,659,1,0,0,482,483,C
3-PA,660,487,0,0,0,487,A
3-PA,661,0,0,0,488,488,C
3-PA,662,2,0,0,479,481,C
3-PA,663,0,1,482,0,483,G
3-PA,664,488,0,0,0,488,A
3-PA,665,487,0,1,0,488,A
3-PA,666,0,0,0,491,491,C
3-PA,667,0,485,0,0,485,T
3-PA,668,0,494,0,0,494,T
3-PA,669,1,0,0,500,501,C
3-PA,670,0,499,0,0,499,T
3-PA,671,1,0,0,499,500,C
3-PA,672,0,0,0,499,499,C
3-PA,673,0,494,0,1,495,T
3-PA,674,0,0,505,0,505,G
3-PA,675,1,0,0,501,502,C
3-PA,676,0,0,0,503,503,C
3-PA,677,0,503,0,0,503,T
3-PA,678,0,499,0,0,499,T
3-PA,679,0,0,497,0,497,G
3-PA,680,497,0,0,0,497,A
3-PA,681,0,1,503,0,504,G
3-PA,682,503,0,0,0,503,A
3-PA,683,500,0,0,0,500,A
3-PA,684,0,508,0,0,508,T
3-PA,685,0,516,0,1,517,T
3-PA,686,0,517,0,0,517,T
3-PA,687,0,519,0,0,519,T
3-PA,688,518,0,0,0,518,A
3-PA,689,0,1,518,0,519,G
3-PA,690,508,0,2,0,510,A
3-PA,691,0,0,527,0,527,G
3-PA,692,1,0,0,523,524,C
3-PA,693,0,0,0,525,525,C
3-PA,694,0,530,0,0,530,T
3-PA,695,543,0,0,0,543,A
3-PA,696,0,544,0,0,544,T
3-PA,697,1,0,545,0,546,G
3-PA,698,0,539,0,1,540,T
3-PA,699,1,1,539,0,541,G
3-PA,700,0,0,530,0,530,G
3-PA,701,530,0,0,0,530,A
3-PA,702,0,523,0,0,523,T
3-PA,703,0,0,516,0,516,G
3-PA,704,0,1,532,0,533,G
3-PA,705,530,0,1,0,531,A
3-PA,706,0,531,0,0,531,T
3-PA,707,0,532,0,0,532,T
3-PA,708,1,0,0,524,525,C
3-PA,709,0,3,527,0,530,G
3-PA,710,533,0,0,0,533,A
3-PA,711,533,0,0,0,533,A
3-PA,712,0,0,0,533,533,C
3-PA,713,0,0,0,508,508,C
3-PA,714,0,3,510,0,513,G
3-PA,715,511,0,1,0,512,A
3-PA,716,513,0,0,0,513,A
3-PA,717,0,1,0,514,515,C
3-PA,718,1,0,512,0,513,G
3-PA,719,1,0,527,0,528,G
3-PA,720,0,0,0,532,532,C
3-PA,721,0,528,0,0,528,T
3-PA,722,0,0,541,0,541,G
3-PA,723,0,0,0,542,542,C
3-PA,724,547,0,0,0,547,A
3-PA,725,0,545,0,1,546,T
3-PA,726,0,537,0,1,538,T
3-PA,727,0,1,540,0,541,G
3-PA,728,520,0,0,0,520,A
3-PA,729,0,0,527,0,527,G
3-PA,730,0,0,525,0,525,G
3-PA,731,0,0,521,0,521,G
3-PA,732,0,0,0,519,519,C
3-PA,733,511,0,1,0,512,A
3-PA,734,514,0,0,0,514,A
3-PA,735,0,1,517,0,518,G
3-PA,736,1,0,0,519,520,C
3-PA,737,0,521,0,1,522,T
3-PA,738,0,517,0,0,517,T
3-PA,739,0,519,0,2,521,T
3-PA,740,0,0,0,522,522,C
3-PA,741,0,520,0,0,520,T
3-PA,742,0,0,0,522,522,C
3-PA,743,519,0,0,0,519,A
3-PA,744,517,0,0,0,517,A
3-PA,745,515,0,0,0,515,A
3-PA,746,0,514,0,0,514,T
3-PA,747,0,0,530,0,530,G
3-PA,748,1,522,0,1,524,T
3-PA,749,1,0,0,530,531,C
3-PA,750,0,0,0,533,533,C
3-PA,751,526,0,1,0,527,A
3-PA,752,524,0,1,0,525,A
3-PA,753,528,0,0,0,528,A
3-PA,754,1,0,533,0,534,G
3-PA,755,532,0,0,0,532,A
3-PA,756,524,0,1,0,525,A
3-PA,757,0,0,528,0,528,G
3-PA,758,0,521,0,0,521,T
3-PA,759,1,1,519,0,521,G
3-PA,760,517,0,1,0,518,A
3-PA,761,515,0,1,0,516,A
3-PA,762,1,518,0,0,519,T
3-PA,763,0,0,519,0,519,G
3-PA,764,0,1,0,515,516,C
3-PA,765,0,0,0,518,518,C
3-PA,766,1,0,2,515,518,C
3-PA,767,521,0,0,0,521,A
3-PA,768,528,0,0,0,528,A
3-PA,769,531,0,0,0,531,A
3-PA,770,0,530,0,0,530,T
3-PA,771,0,524,0,0,524,T
3-PA,772,1,3,524,0,528,G
3-PA,773,522,0,0,0,522,A
3-PA,774,525,0,0,0,525,A
3-PA,775,0,0,0,527,527,C
3-PA,776,0,0,0,525,525,C
3-PA,777,0,512,0,0,512,T
3-PA,778,0,527,0,0,527,T
3-PA,779,0,532,0,0,532,T
3-PA,780,0,541,0,0,541,T
3-PA,781,1,0,0,544,545,C
3-PA,782,1,538,0,0,539,T
3-PA,783,0,0,541,0,541,G
3-PA,784,541,0,0,0,541,A
3-PA,785,552,0,1,0,553,A
3-PA,786,0,0,555,0,555,G
3-PA,787,543,0,0,0,543,A
3-PA,788,0,0,0,544,544,C
3-PA,789,540,0,1,0,541,A
3-PA,790,541,0,2,0,543,A
3-PA,791,0,0,0,598,598,C
3-PA,792,598,0,1,0,599,A
3-PA,793,0,0,0,599,599,C
3-PA,794,1,0,0,593,594,C
3-PA,795,594,0,1,0,595,A
3-PA,796,593,0,0,0,593,A
3-PA,797,0,1,594,0,595,G
3-PA,798,596,0,0,0,596,A
3-PA,799,0,0,0,596,596,C
3-PA,800,0,0,0,543,543,C
3-PA,801,538,0,0,0,538,A
3-PA,802,537,0,0,0,537,A
3-PA,803,1,534,0,0,535,T
3-PA,804,1,0,0,535,536,C
3-PA,805,538,1,0,0,539,A
3-PA,806,537,0,0,1,538,A
3-PA,807,536,1,0,0,537,A
3-PA,808,0,0,0,542,542,C
3-PA,809,0,533,0,0,533,T
3-PA,810,1,534,0,0,535,T
3-PA,811,3,0,0,532,535,C
3-PA,812,0,0,0,538,538,C
3-PA,813,0,0,539,0,539,G
3-PA,814,540,0,0,0,540,A
3-PA,815,541,0,0,0,541,A
3-PA,816,0,539,0,0,539,T
3-PA,817,0,0,534,0,534,G
3-PA,818,0,1,532,0,533,G
3-PA,819,532,0,2,0,534,A
3-PA,820,0,0,1,534,535,C
3-PA,821,1,0,0,530,531,C
3-PA,822,0,538,0,2,540,T
3-PA,823,1,0,0,549,550,C
3-PA,824,1,0,0,553,554,C
3-PA,825,1,550,0,1,552,T
3-PA,826,0,552,0,1,553,T
3-PA,827,0,0,576,0,576,G
3-PA,828,0,570,0,0,570,T
3-PA,829,0,568,0,1,569,T
3-PA,830,565,0,0,0,565,A
3-PA,831,0,549,0,0,549,T
3-PA,832,1,0,0,542,543,C
3-PA,833,531,2,0,0,533,A
3-PA,834,0,0,531,0,531,G
3-PA,835,0,0,0,531,531,C
3-PA,836,0,0,513,0,513,G
3-PA,837,1,0,526,0,527,G
3-PA,838,0,529,0,0,529,T
3-PA,839,6,0,0,522,528,C
3-PA,840,2,0,0,528,530,C
3-PA,841,531,1,0,0,532,A
3-PA,842,533,0,0,0,533,A
3-PA,843,535,0,0,0,535,A
3-PA,844,0,535,0,0,535,T
3-PA,845,0,535,0,0,535,T
3-PA,846,0,0,0,528,528,C
3-PA,847,0,1,0,527,528,C
3-PA,848,0,524,0,0,524,T
3-PA,849,1,0,0,525,526,C
3-PA,850,0,1,0,527,528,C
3-PA,851,0,522,1,0,523,T
3-PA,852,0,1,525,0,526,G
3-PA,853,524,0,1,0,525,A
3-PA,854,0,527,0,0,527,T
3-PA,855,0,0,519,0,519,G
3-PA,856,0,1,515,0,516,G
3-PA,857,519,1,1,0,521,A
3-PA,858,0,506,0,0,506,T
3-PA,859,1,0,508,0,509,G
3-PA,860,0,0,0,545,545,C
3-PA,861,0,535,0,1,536,T
3-PA,862,0,534,0,0,534,T
3-PA,863,0,535,0,0,535,T
3-PA,864,536,0,1,0,537,A
3-PA,865,537,0,0,0,537,A
3-PA,866,540,0,1,0,541,A
3-PA,867,543,0,0,0,543,A
3-PA,868,0,541,0,1,542,T
3-PA,869,0,494,0,0,494,T
3-PA,870,0,1,494,0,495,G
3-PA,871,493,0,1,0,494,A
3-PA,872,0,0,498,0,498,G
3-PA,873,0,0,0,499,499,C
3-PA,874,494,0,0,0,494,A
3-PA,875,0,505,0,0,505,T
3-PA,876,0,504,0,0,504,T
3-PA,877,0,0,503,0,503,G
3-PA,878,505,0,0,0,505,A
3-PA,879,494,0,3,0,497,A
3-PA,880,0,3,494,0,497,G
3-PA,881,486,1,1,0,488,A
3-PA,882,0,0,0,488,488,C
3-PA,883,0,0,0,488,488,C
3-PA,884,1,0,0,475,476,C
3-PA,885,468,0,0,0,468,A
3-PA,886,470,0,1,0,471,A
3-PA,887,0,0,470,0,470,G
3-PA,888,0,469,1,0,470,T
3-PA,889,1,0,0,472,473,C
3-PA,890,471,0,0,0,471,A
3-PA,891,0,0,0,468,468,C
3-PA,892,0,0,468,0,468,G
3-PA,893,477,0,0,0,477,A
3-PA,894,476,0,0,0,476,A
3-PA,895,0,0,488,0,488,G
3-PA,896,0,1,486,1,488,G
3-PA,897,483,0,0,0,483,A
3-PA,898,0,0,491,0,491,G
3-PA,899,491,0,1,0,492,A
3-PA,900,486,0,1,0,487,A
3-PA,901,0,0,490,0,490,G
3-PA,902,0,0,480,0,480,G
3-PA,903,0,0,482,0,482,G
3-PA,904,472,0,0,0,472,A
3-PA,905,0,470,0,0,470,T
3-PA,906,2,0,0,463,465,C
3-PA,907,1,0,0,498,499,C
3-PA,908,1,0,0,503,504,C
3-PA,909,505,0,0,0,505,A
3-PA,910,0,506,0,0,506,T
3-PA,911,0,505,0,0,505,T
3-PA,912,511,0,1,0,512,A
3-PA,913,0,513,0,0,513,T
3-PA,914,510,0,1,0,511,A
3-PA,915,0,509,0,0,509,T
3-PA,916,0,0,449,0,449,G
3-PA,917,444,0,0,0,444,A
3-PA,918,0,442,0,0,442,T
3-PA,919,1,0,442,0,443,G
3-PA,920,0,0,0,440,440,C
3-PA,921,0,2,435,0,437,G
3-PA,922,442,0,0,0,442,A
3-PA,923,0,441,0,0,441,T
3-PA,924,1,0,0,443,444,C
3-PA,925,441,1,0,0,442,A
3-PA,926,441,0,1,0,442,A
3-PA,927,0,0,446,0,446,G
3-PA,928,1,438,0,0,439,T
3-PA,929,0,0,442,0,442,G
3-PA,930,0,0,0,441,441,C
3-PA,931,438,0,0,0,438,A
3-PA,932,0,444,0,0,444,T
3-PA,933,443,0,0,0,443,A
3-PA,934,449,0,0,0,449,A
3-PA,935,452,0,0,0,452,A
3-PA,936,451,0,0,0,451,A
3-PA,937,451,0,1,0,452,A
3-PA,938,0,0,0,454,454,C
3-PA,939,451,0,0,0,451,A
3-PA,940,0,454,0,0,454,T
3-PA,941,0,454,0,0,454,T
3-PA,942,1,0,0,457,458,C
3-PA,943,0,443,0,1,444,T
3-PA,944,0,442,1,0,443,T
3-PA,945,0,443,0,0,443,T
3-PA,946,0,1,443,0,444,G
3-PA,947,0,1,441,0,442,G
3-PA,948,437,1,0,0,438,A
3-PA,949,0,437,0,0,437,T
3-PA,950,0,0,440,0,440,G
3-PA,951,0,3,449,0,452,G
3-PA,952,448,0,0,0,448,A
3-PA,953,450,0,0,0,450,A
3-PA,954,451,0,0,0,451,A
3-PA,955,1,1,456,0,458,G
3-PA,956,458,0,0,0,458,A
3-PA,957,504,0,0,0,504,A
3-PA,958,0,0,0,509,509,C
3-PA,959,0,0,0,507,507,C
3-PA,960,0,498,1,0,499,T
3-PA,961,0,509,0,0,509,T
3-PA,962,510,1,0,0,511,A
3-PA,963,0,511,0,0,511,T
3-PA,964,505,0,0,0,505,A
3-PA,965,0,515,0,0,515,T
3-PA,966,465,1,0,0,466,A
3-PA,967,0,0,469,0,469,G
3-PA,968,0,466,0,0,466,T
3-PA,969,1,0,0,463,464,C
3-PA,970,460,0,0,0,460,A
3-PA,971,456,0,1,0,457,A
3-PA,972,458,0,0,1,459,A
3-PA,973,0,0,0,462,462,C
3-PA,974,1,0,0,460,461,C
3-PA,975,449,1,0,0,450,A
3-PA,976,2,0,0,454,456,C
3-PA,977,457,0,2,0,459,A
3-PA,978,0,1,0,460,461,C
3-PA,979,0,1,461,0,462,G
3-PA,980,459,1,0,0,460,A
3-PA,981,462,0,0,0,462,A
3-PA,982,459,0,0,0,459,A
3-PA,983,459,0,2,0,461,A
3-PA,984,0,1,458,1,460,G
3-PA,985,0,1,454,0,455,G
3-PA,986,0,1,460,0,461,G
3-PA,987,459,1,1,0,461,A
3-PA,988,458,0,1,0,459,A
3-PA,989,0,459,0,1,460,T
3-PA,990,462,0,0,0,462,A
3-PA,991,462,0,0,0,462,A
3-PA,992,468,0,1,0,469,A
3-PA,993,0,462,0,1,463,T
3-PA,994,0,462,0,1,463,T
3-PA,995,0,0,0,466,466,C
3-PA,996,465,0,0,0,465,A
3-PA,997,466,0,1,0,467,A
3-PA,998,465,0,0,0,465,A
3-PA,999,0,461,0,0,461,T
3-PA,1000,0,466,0,0,466,T
3-PA,1001,468,0,1,0,469,A
3-PA,1002,0,0,0,464,464,C
3-PA,1003,0,0,0,467,467,C
3-PA,1004,0,452,0,1,453,T
3-PA,1005,0,0,452,0,452,G
3-PA,1006,0,0,0,458,458,C
3-PA,1007,0,458,0,1,459,T
3-PA,1008,0,0,467,0,467,G
3-PA,1009,0,465,0,1,466,T
3-PA,1010,1,0,0,467,468,C
3-PA,1011,465,0,0,0,465,A
3-PA,1012,0,467,0,0,467,T
3-PA,1013,0,1,462,0,463,G
3-PA,1014,0,2,467,0,469,G
3-PA,1015,469,0,1,0,470,A
3-PA,1016,487,0,1,0,488,A
3-PA,1017,0,0,485,0,485,G
3-PA,1018,0,1,0,482,483,C
3-PA,1019,482,0,0,0,482,A
3-PA,1020,481,0,2,0,483,A
3-PA,1021,1,1,491,0,493,G
3-PA,1022,0,491,0,0,491,T
3-PA,1023,492,0,0,0,492,A
3-PA,1024,0,0,0,494,494,C
3-PA,1025,0,479,0,0,479,T
3-PA,1026,1,0,484,0,485,G
3-PA,1027,1,480,0,0,481,T
3-PA,1028,0,0,0,484,484,C
3-PA,1029,481,0,0,0,481,A
3-PA,1030,0,0,482,0,482,G
3-PA,1031,482,0,1,0,483,A
3-PA,1032,485,0,0,0,485,A
3-PA,1033,0,489,0,0,489,T
3-PA,1034,0,486,0,0,486,T
3-PA,1035,0,0,487,0,487,G
3-PA,1036,0,0,0,484,484,C
3-PA,1037,484,0,1,0,485,A
3-PA,1038,0,2,481,0,483,G
3-PA,1039,0,2,478,0,480,G
3-PA,1040,479,0,0,1,480,A
3-PA,1041,0,0,0,475,475,C
3-PA,1042,0,0,472,0,472,G
3-PA,1043,0,477,1,0,478,T
3-PA,1044,0,480,0,0,480,T
3-PA,1045,0,0,482,0,482,G
3-PA,1046,486,0,0,0,486,A
3-PA,1047,485,0,0,0,485,A
3-PA,1048,486,0,0,0,486,A
3-PA,1049,484,0,0,0,484,A
3-PA,1050,0,483,0,0,483,T
3-PA,1051,0,0,485,0,485,G
3-PA,1052,479,0,2,0,481,A
3-PA,1053,0,0,487,0,487,G
3-PA,1054,0,0,491,0,491,G
3-PA,1055,488,0,0,0,488,A
3-PA,1056,0,0,493,0,493,G
3-PA,1057,501,0,1,0,502,A
3-PA,1058,499,0,0,0,499,A
3-PA,1059,0,0,501,0,501,G
3-PA,1060,0,1,495,0,496,G
3-PA,1061,0,516,1,1,518,T
3-PA,1062,0,518,0,1,519,T
3-PA,1063,0,0,0,518,518,C
3-PA,1064,1,1,0,519,521,C
3-PA,1065,520,0,0,0,520,A
3-PA,1066,518,0,0,0,518,A
3-PA,1067,1,1,523,0,525,G
3-PA,1068,0,1,532,0,533,G
3-PA,1069,528,0,0,0,528,A
3-PA,1070,0,0,0,528,528,C
3-PA,1071,0,528,0,0,528,T
3-PA,1072,526,0,1,0,527,A
3-PA,1073,526,0,0,1,527,A
3-PA,1074,527,0,0,0,527,A
3-PA,1075,528,0,0,0,528,A
3-PA,1076,522,0,1,2,525,A
3-PA,1077,0,0,0,521,521,C
3-PA,1078,517,0,0,0,517,A
3-PA,1079,1,517,0,0,518,T
3-PA,1080,0,0,519,0,519,G
3-PA,1081,518,0,0,0,518,A
3-PA,1082,521,0,0,0,521,A
3-PA,1083,0,1,520,0,521,G
3-PA,1084,516,0,1,0,517,A
3-PA,1085,520,0,0,0,520,A
3-PA,1086,515,0,0,1,516,A
3-PA,1087,516,0,0,0,516,A
3-PA,1088,0,0,0,519,519,C
3-PA,1089,0,1,517,0,518,G
3-PA,1090,519,0,0,0,519,A
3-PA,1091,0,0,517,0,517,G
3-PA,1092,0,510,0,1,511,T
3-PA,1093,1,0,0,525,526,C
3-PA,1094,525,0,0,0,525,A
3-PA,1095,531,0,1,0,532,A
3-PA,1096,0,0,0,530,530,C
3-PA,1097,0,529,0,0,529,T
3-PA,1098,0,0,540,0,540,G
3-PA,1099,536,0,0,0,536,A
3-PA,1100,532,1,2,0,535,A
3-PA,1101,0,0,537,0,537,G
3-PA,1102,0,531,0,0,531,T
3-PA,1103,0,0,530,0,530,G
3-PA,1104,0,1,527,0,528,G
3-PA,1105,0,0,528,0,528,G
3-PA,1106,0,0,0,528,528,C
3-PA,1107,0,521,0,1,522,T
3-PA,1108,0,0,0,526,526,C
3-PA,1109,1,521,1,1,524,T
3-PA,1110,0,530,0,1,531,T
3-PA,1111,0,0,538,0,538,G
3-PA,1112,0,0,541,0,541,G
3-PA,1113,0,536,0,0,536,T
3-PA,1114,0,1,534,0,535,G
3-PA,1115,532,0,0,0,532,A
3-PA,1116,534,0,1,0,535,A
3-PA,1117,534,0,1,0,535,A
3-PA,1118,540,0,0,0,540,A
3-PA,1119,0,0,0,543,543,C
3-PA,1120,536,0,0,0,536,A
3-PA,1121,0,535,0,0,535,T
3-PA,1122,0,2,529,0,531,G
3-PA,1123,0,0,548,0,548,G
3-PA,1124,0,1,0,545,546,C
3-PA,1125,548,1,1,0,550,A
3-PA,1126,0,0,0,548,548,C
3-PA,1127,0,0,0,555,555,C
3-PA,1128,561,0,0,0,561,A
3-PA,1129,1,2,564,0,567,G
3-PA,1130,568,0,0,0,568,A
3-PA,1131,2,0,573,0,575,G
3-PA,1132,577,0,1,0,578,A
3-PA,1133,577,0,2,0,579,A
3-PA,1134,0,1,584,0,585,G
3-PA,1135,0,0,583,0,583,G
3-PA,1136,0,579,0,0,579,T
3-PA,1137,572,0,1,0,573,A
3-PA,1138,0,0,567,0,567,G
3-PA,1139,573,0,0,0,573,A
3-PA,1140,0,0,0,572,572,C
3-PA,1141,0,566,0,2,568,T
3-PA,1142,0,567,0,1,568,T
3-PA,1143,0,568,0,0,568,T
3-PA,1144,0,0,566,0,566,G
3-PA,1145,563,0,4,0,567,A
3-PA,1146,568,0,0,1,569,A
3-PA,1147,566,0,2,0,568,A
3-PA,1148,566,0,0,0,566,A
3-PA,1149,0,0,0,581,581,C
3-PA,1150,0,581,0,0,581,T
3-PA,1151,0,0,586,0,586,G
3-PA,1152,1,0,0,586,587,C
3-PA,1153,584,0,0,0,584,A
3-PA,1154,0,0,583,0,583,G
3-PA,1155,582,0,0,0,582,A
3-PA,1156,1,1,615,0,617,G
3-PA,1157,618,0,0,0,618,A
3-PA,1158,0,0,0,612,612,C
3-PA,1159,613,0,1,0,614,A
3-PA,1160,0,609,0,0,609,T
3-PA,1161,606,0,0,0,606,A
3-PA,1162,608,0,0,0,608,A
3-PA,1163,0,0,606,0,606,G
3-PA,1164,0,1,1,599,601,C
3-PA,1165,0,1,590,0,591,G
3-PA,1166,607,0,0,0,607,A
3-PA,1167,0,604,0,0,604,T
3-PA,1168,1,602,0,0,603,T
3-PA,1169,0,605,0,0,605,T
3-PA,1170,0,1,605,0,606,G
3-PA,1171,609,0,1,0,610,A
3-PA,1172,608,0,1,0,609,A
3-PA,1173,0,0,616,0,616,G
3-PA,1174,0,1,0,631,632,C
3-PA,1175,623,0,1,0,624,A
3-PA,1176,674,1,2,0,677,A
3-PA,1177,0,677,0,0,677,T
3-PA,1178,674,1,0,0,675,A
3-PA,1179,0,684,0,0,684,T
3-PA,1180,0,0,684,0,684,G
3-PA,1181,686,0,1,0,687,A
3-PA,1182,1,690,0,0,691,T
3-PA,1183,663,0,1,0,664,A
3-PA,1184,0,0,660,0,660,G
3-PA,1185,0,628,0,0,628,T
3-PA,1186,0,1,624,0,625,G
3-PA,1187,626,0,1,0,627,A
3-PA,1188,0,0,0,623,623,C
3-PA,1189,0,2,618,0,620,G
3-PA,1190,630,0,0,0,630,A
3-PA,1191,628,0,2,0,630,A
3-PA,1192,1,0,0,639,640,C
3-PA,1193,0,0,0,638,638,C
3-PA,1194,0,639,0,0,639,T
3-PA,1195,0,1,672,0,673,G
3-PA,1196,672,1,0,0,673,A
3-PA,1197,673,1,0,0,674,A
3-PA,1198,0,667,0,1,668,T
3-PA,1199,0,668,0,1,669,T
3-PA,1200,668,0,0,0,668,A
3-PA,1201,665,1,0,0,666,A
3-PA,1202,2,2,665,0,669,G
3-PA,1203,1,0,670,0,671,G
3-PA,1204,0,656,0,1,657,T
3-PA,1205,4,0,0,651,655,C
3-PA,1206,658,0,0,0,658,A
3-PA,1207,1,0,0,684,685,C
3-PA,1208,0,684,1,1,686,T
3-PA,1209,0,686,0,0,686,T
3-PA,1210,0,683,0,2,685,T
3-PA,1211,2,0,0,679,681,C
3-PA,1212,685,0,1,0,686,A
3-PA,1213,680,0,1,0,681,A
3-PA,1214,0,0,693,0,693,G
3-PA,1215,0,0,0,693,693,C
3-PA,1216,0,668,0,0,668,T
3-PA,1217,0,1,689,0,690,G
3-PA,1218,1,1,692,0,694,G
3-PA,1219,703,1,0,0,704,A
3-PA,1220,0,711,0,0,711,T
3-PA,1221,710,0,0,0,710,A
3-PA,1222,0,1,0,710,711,C
3-PA,1223,705,0,0,1,706,A
3-PA,1224,0,0,715,0,715,G
3-PA,1225,712,0,0,0,712,A
3-PA,1226,695,0,0,0,695,A
3-PA,1227,0,690,0,1,691,T
3-PA,1228,1,3,690,0,694,G
3-PA,1229,696,0,0,0,696,A
3-PA,1230,0,0,703,0,703,G
3-PA,1231,1,695,0,0,696,T
3-PA,1232,0,692,0,1,693,T
3-PA,1233,2,0,0,697,699,C
3-PA,1234,697,0,1,0,698,A
3-PA,1235,698,0,0,0,698,A
3-PA,1236,0,0,0,700,700,C
3-PA,1237,688,0,1,0,689,A
3-PA,1238,692,0,0,0,692,A
3-PA,1239,0,1,690,0,691,G
3-PA,1240,0,0,693,0,693,G
3-PA,1241,1,0,0,696,697,C
3-PA,1242,2,0,0,689,691,C
3-PA,1243,0,683,0,0,683,T
3-PA,1244,1,0,688,0,689,G
3-PA,1245,0,689,0,1,690,T
3-PA,1246,0,0,691,0,691,G
3-PA,1247,692,0,1,0,693,A
3-PA,1248,0,0,694,0,694,G
3-PA,1249,0,0,0,691,691,C
3-PA,1250,0,676,0,1,677,T
3-PA,1251,695,0,0,0,695,A
3-PA,1252,695,0,0,0,695,A
3-PA,1253,0,1,0,693,694,C
3-PA,1254,0,694,0,0,694,T
3-PA,1255,0,2,701,0,703,G
3-PA,1256,700,0,0,0,700,A
3-PA,1257,0,696,0,0,696,T
3-PA,1258,0,700,0,0,700,T
3-PA,1259,1,1,0,700,702,C
3-PA,1260,718,1,0,0,719,A
3-PA,1261,0,0,743,0,743,G
3-PA,1262,0,735,0,3,738,T
3-PA,1263,4,0,0,737,741,C
3-PA,1264,0,735,0,0,735,T
3-PA,1265,1,1,767,0,769,G
3-PA,1266,1,0,766,0,767,G
3-PA,1267,768,0,0,0,768,A
3-PA,1268,0,768,0,0,768,T
3-PA,1269,734,0,0,0,734,A
3-PA,1270,0,0,734,0,734,G
3-PA,1271,726,0,1,0,727,A
3-PA,1272,0,0,726,0,726,G
3-PA,1273,1,0,0,725,726,C
3-PA,1274,0,709,0,0,709,T
3-PA,1275,1,0,0,708,709,C
3-PA,1276,0,1,709,0,710,G
3-PA,1277,713,0,0,0,713,A
3-PA,1278,0,714,0,0,714,T
3-PA,1279,0,0,715,0,715,G
3-PA,1280,722,0,0,0,722,A
3-PA,1281,722,0,3,0,725,A
3-PA,1282,725,0,0,0,725,A
3-PA,1283,0,725,0,0,725,T
3-PA,1284,0,718,0,1,719,T
3-PA,1285,0,0,726,0,726,G
3-PA,1286,0,0,727,0,727,G
3-PA,1287,725,0,2,0,727,A
3-PA,1288,0,1,725,1,727,G
3-PA,1289,717,0,1,0,718,A
3-PA,1290,1,1,721,0,723,G
3-PA,1291,0,1,726,0,727,G
3-PA,1292,733,0,0,0,733,A
3-PA,1293,0,1,0,734,735,C
3-PA,1294,1,0,722,0,723,G
3-PA,1295,0,722,0,0,722,T
3-PA,1296,726,0,0,0,726,A
3-PA,1297,0,0,726,0,726,G
3-PA,1298,0,0,0,738,738,C
3-PA,1299,0,1,0,723,724,C
3-PA,1300,1,0,0,717,718,C
3-PA,1301,3,0,0,703,706,C
3-PA,1302,707,0,0,0,707,A
3-PA,1303,731,0,0,0,731,A
3-PA,1304,0,730,0,1,731,T
3-PA,1305,0,726,0,1,727,T
3-PA,1306,0,2,726,0,728,G
3-PA,1307,709,0,1,0,710,A
3-PA,1308,0,0,711,0,711,G
3-PA,1309,0,1,0,711,712,C
3-PA,1310,709,0,1,0,710,A
3-PA,1311,0,0,0,735,735,C
3-PA,1312,713,0,0,0,713,A
3-PA,1313,0,739,0,0,739,T
3-PA,1314,0,737,0,0,737,T
3-PA,1315,1,0,738,0,739,G
3-PA,1316,1,1,0,735,737,C
3-PA,1317,737,0,1,0,738,A
3-PA,1318,737,0,2,0,739,A
3-PA,1319,0,0,739,0,739,G
3-PA,1320,0,0,0,730,730,C
3-PA,1321,725,0,1,0,726,A
3-PA,1322,0,705,0,0,705,T
3-PA,1323,0,2,703,0,705,G
3-PA,1324,708,0,0,0,708,A
3-PA,1325,0,0,709,0,709,G
3-PA,1326,707,0,0,0,707,A
3-PA,1327,708,0,0,0,708,A
3-PA,1328,0,1,706,0,707,G
3-PA,1329,0,0,703,0,703,G
3-PA,1330,700,0,0,0,700,A
3-PA,1331,700,0,0,0,700,A
3-PA,1332,0,701,0,0,701,T
3-PA,1333,0,702,0,0,702,T
3-PA,1334,711,0,0,0,711,A
3-PA,1335,0,716,0,1,717,T
3-PA,1336,0,718,0,0,718,T
3-PA,1337,0,717,0,1,718,T
3-PA,1338,2,0,0,712,714,C
3-PA,1339,712,0,0,0,712,A
3-PA,1340,0,0,0,731,731,C
3-PA,1341,725,0,1,0,726,A
3-PA,1342,0,0,733,0,733,G
3-PA,1343,0,0,0,732,732,C
3-PA,1344,731,0,1,0,732,A
3-PA,1345,0,0,733,0,733,G
3-PA,1346,733,0,0,0,733,A
3-PA,1347,0,1,736,0,737,G
3-PA,1348,1,1,732,0,734,G
3-PA,1349,1,716,0,0,717,T
3-PA,1350,0,1,725,0,726,G
3-PA,1351,0,719,0,2,721,T
3-PA,1352,1,0,0,718,719,C
3-PA,1353,1,0,0,726,727,C
3-PA,1354,0,0,0,727,727,C
3-PA,1355,733,0,1,0,734,A
3-PA,1356,0,740,0,2,742,T
3-PA,1357,0,740,0,0,740,T
3-PA,1358,0,0,743,0,743,G
3-PA,1359,0,730,0,1,731,T
3-PA,1360,718,1,0,0,719,A
3-PA,1361,0,1,718,0,719,G
3-PA,1362,699,0,1,0,700,A
3-PA,1363,1,2,697,0,700,G
3-PA,1364,0,1,0,685,686,C
3-PA,1365,1,0,0,680,681,C
3-PA,1366,691,0,3,0,694,A
3-PA,1367,0,0,0,693,693,C
3-PA,1368,0,690,0,0,690,T
3-PA,1369,0,1,687,0,688,G
3-PA,1370,688,0,0,0,688,A
3-PA,1371,674,1,0,0,675,A
3-PA,1372,2,692,0,0,694,T
3-PA,1373,700,0,0,0,700,A
3-PA,1374,0,0,0,707,707,C
3-PA,1375,690,1,1,1,693,A
3-PA,1376,0,696,0,0,696,T
3-PA,1377,693,0,0,0,693,A
3-PA,1378,699,0,0,0,699,A
3-PA,1379,0,697,0,1,698,T
3-PA,1380,0,0,690,0,690,G
3-PA,1381,686,0,0,0,686,A
3-PA,1382,676,0,0,0,676,A
3-PA,1383,0,1,678,0,679,G
3-PA,1384,1,3,671,0,675,G
3-PA,1385,0,0,676,0,676,G
3-PA,1386,0,2,678,0,680,G
3-PA,1387,1,0,689,0,690,G
3-PA,1388,0,677,0,0,677,T
3-PA,1389,682,0,0,0,682,A
3-PA,1390,0,690,0,0,690,T
3-PA,1391,704,0,0,0,704,A
3-PA,1392,0,1,0,771,772,C
3-PA,1393,746,0,0,0,746,A
3-PA,1394,0,729,0,0,729,T
3-PA,1395,0,718,0,0,718,T
3-PA,1396,708,0,1,0,709,A
3-PA,1397,717,0,1,0,718,A
3-PA,1398,0,0,0,717,717,C
3-PA,1399,709,0,0,0,709,A
3-PA,1400,0,0,0,709,709,C
3-PA,1401,0,638,0,0,638,T
3-PA,1402,0,0,672,0,672,G
3-PA,1403,0,0,0,671,671,C
3-PA,1404,1,0,0,669,670,C
3-PA,1405,0,0,0,672,672,C
3-PA,1406,0,653,1,1,655,T
3-PA,1407,0,0,685,0,685,G
3-PA,1408,0,0,0,685,685,C
3-PA,1409,0,685,0,0,685,T
3-PA,1410,3,0,0,692,695,C
3-PA,1411,672,0,0,0,672,A
3-PA,1412,677,0,0,0,677,A
3-PA,1413,0,680,0,0,680,T
3-PA,1414,0,0,681,0,681,G
3-PA,1415,0,1,0,676,677,C
3-PA,1416,675,0,1,0,676,A
3-PA,1417,0,673,0,0,673,T
3-PA,1418,3,0,0,672,675,C
3-PA,1419,0,0,0,682,682,C
3-PA,1420,0,651,0,0,651,T
3-PA,1421,0,0,665,0,665,G
3-PA,1422,0,665,0,0,665,T
3-PA,1423,0,0,660,0,660,G
3-PA,1424,0,1,0,660,661,C
3-PA,1425,655,0,1,0,656,A
3-PA,1426,0,0,661,0,661,G
3-PA,1427,0,1,0,660,661,C
3-PA,1428,653,0,1,0,654,A
3-PA,1429,653,0,0,0,653,A
3-PA,1430,0,632,0,0,632,T
3-PA,1431,0,3,626,1,630,G
3-PA,1432,0,1,630,0,631,G
3-PA,1433,631,0,1,0,632,A
3-PA,1434,0,1,0,629,630,C
3-PA,1435,0,0,624,1,625,G
3-PA,1436,639,0,0,0,639,A
3-PA,1437,0,639,0,1,640,T
3-PA,1438,0,640,0,0,640,T
3-PA,1439,0,638,0,0,638,T
3-PA,1440,0,637,0,1,638,T
3-PA,1441,1,1,0,640,642,C
3-PA,1442,644,0,0,0,644,A
3-PA,1443,643,1,0,0,644,A
3-PA,1444,0,0,0,648,648,C
3-PA,1445,0,638,0,1,639,T
3-PA,1446,640,0,0,0,640,A
3-PA,1447,638,1,0,0,639,A
3-PA,1448,0,644,0,0,644,T
3-PA,1449,1,637,0,1,639,T
3-PA,1450,3,0,0,641,644,C
3-PA,1451,2,0,0,644,646,C
3-PA,1452,1,1,0,641,643,C
3-PA,1453,641,0,0,0,641,A
3-PA,1454,0,659,0,1,660,T
3-PA,1455,0,1,663,0,664,G
3-PA,1456,666,0,0,0,666,A
3-PA,1457,0,660,0,0,660,T
3-PA,1458,660,0,0,0,660,A
3-PA,1459,658,0,0,0,658,A
3-PA,1460,1,0,657,0,658,G
3-PA,1461,0,0,0,656,656,C
3-PA,1462,651,0,1,0,652,A
3-PA,1463,634,0,1,0,635,A
3-PA,1464,0,0,659,0,659,G
3-PA,1465,0,653,0,1,654,T
3-PA,1466,0,0,654,0,654,G
3-PA,1467,0,1,0,649,650,C
3-PA,1468,649,0,0,0,649,A
3-PA,1469,1,2,652,0,655,G
3-PA,1470,649,0,0,0,649,A
3-PA,1471,658,1,0,0,659,A
3-PA,1472,0,0,0,660,660,C
3-PA,1473,0,645,0,0,645,T
3-PA,1474,649,0,0,0,649,A
3-PA,1475,649,0,0,0,649,A
3-PA,1476,643,0,4,0,647,A
3-PA,1477,0,0,650,0,650,G
3-PA,1478,630,0,0,0,630,A
3-PA,1479,0,0,628,0,628,G
3-PA,1480,0,0,604,0,604,G
3-PA,1481,0,0,601,0,601,G
3-PA,1482,601,0,0,0,601,A
3-PA,1483,588,0,1,0,589,A
3-PA,1484,0,0,587,0,587,G
3-PA,1485,0,0,589,0,589,G
3-PA,1486,0,0,0,585,585,C
3-PA,1487,0,0,587,0,587,G
3-PA,1488,585,0,0,0,585,A
3-PA,1489,585,0,0,0,585,A
3-PA,1490,587,0,0,0,587,A
3-PA,1491,587,0,0,0,587,A
3-PA,1492,586,1,0,0,587,A
3-PA,1493,0,0,0,589,589,C
3-PA,1494,0,1,0,589,590,C
3-PA,1495,592,0,1,0,593,A
3-PA,1496,604,0,0,0,604,A
3-PA,1497,0,603,0,0,603,T
3-PA,1498,0,605,0,0,605,T
3-PA,1499,0,607,0,0,607,T
3-PA,1500,609,0,0,0,609,A
3-PA,1501,0,606,0,0,606,T
3-PA,1502,602,0,4,0,606,A
3-PA,1503,0,603,0,0,603,T
3-PA,1504,0,1,592,0,593,G
3-PA,1505,0,0,585,0,585,G
3-PA,1506,585,0,0,0,585,A
3-PA,1507,0,580,0,0,580,T
3-PA,1508,0,576,0,1,577,T
3-PA,1509,2,0,0,577,579,C
3-PA,1510,577,0,0,0,577,A
3-PA,1511,0,587,0,1,588,T
3-PA,1512,0,0,0,589,589,C
3-PA,1513,589,0,1,0,590,A
3-PA,1514,0,583,0,0,583,T
3-PA,1515,583,0,1,0,584,A
3-PA,1516,586,0,0,0,586,A
3-PA,1517,585,0,0,0,585,A
3-PA,1518,0,1,586,0,587,G
3-PA,1519,0,0,578,0,578,G
3-PA,1520,0,0,576,0,576,G
3-PA,1521,572,0,1,0,573,A
3-PA,1522,567,0,3,0,570,A
3-PA,1523,0,0,574,0,574,G
3-PA,1524,569,1,0,0,570,A
3-PA,1525,0,570,0,0,570,T
3-PA,1526,0,0,0,568,568,C
3-PA,1527,0,554,0,1,555,T
3-PA,1528,3,0,0,567,570,C
3-PA,1529,568,0,1,0,569,A
3-PA,1530,0,569,0,0,569,T
3-PA,1531,1,568,0,1,570,T
3-PA,1532,0,564,0,0,564,T
3-PA,1533,563,0,0,0,563,A
3-PA,1534,560,0,1,1,562,A
3-PA,1535,0,0,562,0,562,G
3-PA,1536,0,0,565,0,565,G
3-PA,1537,538,0,1,0,539,A
3-PA,1538,539,0,0,0,539,A
3-PA,1539,0,535,0,0,535,T
3-PA,1540,0,1,539,0,540,G
3-PA,1541,545,0,0,0,545,A
3-PA,1542,0,0,0,544,544,C
3-PA,1543,541,0,2,0,543,A
3-PA,1544,0,0,0,542,542,C
3-PA,1545,523,0,0,0,523,A
3-PA,1546,0,1,526,0,527,G
3-PA,1547,524,0,1,0,525,A
3-PA,1548,0,0,0,516,516,C
3-PA,1549,0,0,514,0,514,G
3-PA,1550,0,470,0,1,471,T
3-PA,1551,0,0,476,0,476,G
3-PA,1552,0,0,477,0,477,G
3-PA,1553,0,476,0,1,477,T
3-PA,1554,477,0,0,0,477,A
3-PA,1555,468,0,0,0,468,A
3-PA,1556,470,0,0,0,470,A
3-PA,1557,0,466,0,0,466,T
3-PA,1558,0,463,0,0,463,T
3-PA,1559,0,460,0,0,460,T
3-PA,1560,0,453,0,0,453,T
3-PA,1561,1,0,454,0,455,G
3-PA,1562,0,451,0,0,451,T
3-PA,1563,0,2,448,0,450,G
3-PA,1564,443,0,1,0,444,A
3-PA,1565,0,0,442,0,442,G
3-PA,1566,0,0,0,437,437,C
3-PA,1567,440,0,0,0,440,A
3-PA,1568,0,438,0,0,438,T
3-PA,1569,0,0,436,0,436,G
3-PA,1570,0,1,439,0,440,G
3-PA,1571,440,0,0,0,440,A
3-PA,1572,0,0,439,0,439,G
3-PA,1573,0,432,0,0,432,T
3-PA,1574,0,427,0,0,427,T
3-PA,1575,1,429,0,1,431,T
3-PA,1576,0,426,0,0,426,T
3-PA,1577,0,0,0,428,428,C
3-PA,1578,0,426,0,0,426,T
3-PA,1579,0,0,0,423,423,C
3-PA,1580,0,412,0,0,412,T
3-PA,1581,1,0,0,406,407,C
3-PA,1582,406,0,0,0,406,A
3-PA,1583,0,0,0,405,405,C
3-PA,1584,0,398,0,0,398,T
3-PA,1585,0,0,397,0,397,G
3-PA,1586,396,0,0,0,396,A
3-PA,1587,0,0,0,398,398,C
3-PA,1588,1,0,0,395,396,C
3-PA,1589,1,0,0,392,393,C
3-PA,1590,1,0,392,0,393,G
3-PA,1591,391,0,1,0,392,A
3-PA,1592,0,0,395,0,395,G
3-PA,1593,396,0,1,0,397,A
3-PA,1594,1,0,0,389,390,C
3-PA,1595,0,385,0,0,385,T
3-PA,1596,0,369,0,0,369,T
3-PA,1597,0,2,365,0,367,G
3-PA,1598,364,0,2,0,366,A
3-PA,1599,0,0,365,0,365,G
3-PA,1600,0,0,0,364,364,C
3-PA,1601,1,0,0,351,352,C
3-PA,1602,356,0,1,0,357,A
3-PA,1603,0,0,0,353,353,C
3-PA,1604,354,0,0,0,354,A
3-PA,1605,0,353,0,0,353,T
3-PA,1606,351,0,0,0,351,A
3-PA,1607,350,0,0,0,350,A
3-PA,1608,349,0,0,0,349,A
3-PA,1609,1,346,0,0,347,T
3-PA,1610,0,1,344,0,345,G
3-PA,1611,1,0,316,0,317,G
3-PA,1612,1,0,316,0,317,G
3-PA,1613,310,0,0,0,310,A
3-PA,1614,0,0,312,0,312,G
3-PA,1615,310,0,0,0,310,A
3-PA,1616,305,0,0,0,305,A
3-PA,1617,304,1,0,0,305,A
3-PA,1618,0,303,0,0,303,T
3-PA,1619,299,0,0,0,299,A
3-PA,1620,0,0,0,299,299,C
3-PA,1621,0,199,0,0,199,T
3-PA,1622,0,0,198,0,198,G
3-PA,1623,0,155,0,0,155,T
3-PA,1624,0,0,159,0,159,G
3-PA,1625,0,158,0,0,158,T
3-PA,1626,0,0,0,140,140,C
3-PA,1627,0,0,0,138,138,C
3-PA,1628,0,136,0,0,136,T
3-PA,1629,0,139,0,0,139,T
3-PA,1630,0,0,139,0,139,G
3-PA,1631,143,0,0,0,143,A
3-PA,1632,1,0,142,0,143,G
3-PA,1633,135,0,0,0,135,A
3-PA,1634,0,135,0,0,135,T
3-PA,1635,133,0,0,0,133,A
3-PA,1636,0,0,135,0,135,G
3-PA,1637,0,0,136,0,136,G
3-PA,1638,136,0,0,0,136,A
3-PA,1639,0,0,136,0,136,G
3-PA,1640,133,0,0,0,133,A
3-PA,1641,0,133,0,0,133,T
3-PA,1642,136,0,0,0,136,A
3-PA,1643,0,136,0,0,136,T
3-PA,1644,0,0,137,0,137,G
3-PA,1645,0,132,0,0,132,T
3-PA,1646,0,131,0,0,131,T
3-PA,1647,135,0,0,0,135,A
3-PA,1648,0,0,0,135,135,C
3-PA,1649,0,135,0,0,135,T
3-PA,1650,136,0,0,0,136,A
3-PA,1651,134,0,0,0,134,A
3-PA,1652,0,0,135,0,135,G
3-PA,1653,134,0,0,0,134,A
3-PA,1654,130,0,0,0,130,A
3-PA,1655,0,0,128,0,128,G
3-PA,1656,0,129,0,0,129,T
3-PA,1657,0,0,129,0,129,G
3-PA,1658,0,0,0,130,130,C
3-PA,1659,0,0,0,129,129,C
3-PA,1660,129,0,0,0,129,A
3-PA,1661,0,129,0,0,129,T
3-PA,1662,129,0,0,0,129,A
3-PA,1663,0,0,129,0,129,G
3-PA,1664,0,0,124,0,124,G
3-PA,1665,0,0,0,122,122,C
3-PA,1666,1,0,0,123,124,C
3-PA,1667,124,0,0,0,124,A
3-PA,1668,125,0,0,0,125,A
3-PA,1669,125,0,0,0,125,A
3-PA,1670,0,126,0,0,126,T
3-PA,1671,0,124,0,0,124,T
3-PA,1672,0,124,0,0,124,T
3-PA,1673,0,0,0,123,123,C
3-PA,1674,121,0,0,0,121,A
3-PA,1675,123,0,0,0,123,A
3-PA,1676,0,0,123,0,123,G
3-PA,1677,0,0,125,0,125,G
3-PA,1678,0,0,0,125,125,C
3-PA,1679,0,0,0,124,124,C
3-PA,1680,125,0,0,0,125,A
3-PA,1681,134,0,0,0,134,A
3-PA,1682,0,135,0,0,135,T
3-PA,1683,0,0,146,0,146,G
3-PA,1684,0,147,0,0,147,T
3-PA,1685,0,158,1,0,159,T
3-PA,1686,0,0,0,160,160,C
3-PA,1687,0,159,0,0,159,T
3-PA,1688,0,158,0,0,158,T
3-PA,1689,144,0,0,0,144,A
3-PA,1690,0,142,0,0,142,T
3-PA,1691,144,0,0,0,144,A
3-PA,1692,0,147,0,0,147,T
3-PA,1693,0,0,147,0,147,G
3-PA,1694,0,135,0,0,135,T
3-PA,1695,0,0,135,0,135,G
3-PA,1696,135,0,0,0,135,A
3-PA,1697,0,0,135,0,135,G
3-PA,1698,0,0,138,0,138,G
3-PA,1699,138,0,0,0,138,A
3-PA,1700,0,0,0,137,137,C
3-PA,1701,134,0,0,0,134,A
3-PA,1702,134,0,0,0,134,A
3-PA,1703,134,0,1,0,135,A
3-PA,1704,1,0,0,134,135,C
3-PA,1705,0,0,135,0,135,G
3-PA,1706,0,0,133,0,133,G
3-PA,1707,133,0,0,0,133,A
3-PA,1708,134,0,0,0,134,A
3-PA,1709,0,0,0,134,134,C
3-PA,1710,134,0,0,0,134,A
3-PA,1711,0,134,0,0,134,T
3-PA,1712,0,0,0,132,132,C
3-PA,1713,131,0,0,0,131,A
3-PA,1714,132,0,0,0,132,A
3-PA,1715,131,0,0,0,131,A
3-PA,1716,0,0,133,0,133,G
3-PA,1717,0,0,135,0,135,G
3-PA,1718,0,132,0,0,132,T
3-PA,1719,0,0,0,132,132,C
3-PA,1720,132,0,0,0,132,A
3-PA,1721,133,0,0,0,133,A
3-PA,1722,133,0,0,0,133,A
3-PA,1723,135,0,0,0,135,A
3-PA,1724,0,134,0,0,134,T
3-PA,1725,0,0,139,0,139,G
3-PA,1726,137,0,1,0,138,A
3-PA,1727,136,0,2,0,138,A
3-PA,1728,138,0,1,0,139,A
3-PA,1729,0,139,0,0,139,T
3-PA,1730,0,0,141,0,141,G
3-PA,1731,0,0,141,0,141,G
3-PA,1732,0,0,142,0,142,G
3-PA,1733,0,0,143,0,143,G
3-PA,1734,143,0,1,0,144,A
3-PA,1735,145,0,0,0,145,A
3-PA,1736,0,144,0,0,144,T
3-PA,1737,0,0,144,0,144,G
3-PA,1738,0,0,145,0,145,G
3-PA,1739,146,0,0,0,146,A
3-PA,1740,0,0,149,0,149,G
3-PA,1741,147,0,0,0,147,A
3-PA,1742,0,146,0,0,146,T
3-PA,1743,0,1,145,0,146,G
3-PA,1744,145,0,0,0,145,A
3-PA,1745,0,0,145,0,145,G
3-PA,1746,143,0,0,0,143,A
3-PA,1747,0,0,0,142,142,C
3-PA,1748,0,0,143,0,143,G
3-PA,1749,0,144,0,0,144,T
3-PA,1750,0,144,0,0,144,T
3-PA,1751,0,0,146,0,146,G
3-PA,1752,0,0,0,146,146,C
3-PA,1753,0,0,0,145,145,C
3-PA,1754,0,145,0,0,145,T
3-PA,1755,1,0,0,147,148,C
3-PA,1756,0,0,0,149,149,C
3-PA,1757,1,148,0,0,149,T
3-PA,1758,0,150,0,0,150,T
3-PA,1759,1,0,0,150,151,C
3-PA,1760,150,0,0,0,150,A
3-PA,1761,0,0,150,0,150,G
3-PA,1762,0,149,0,0,149,T
3-PA,1763,0,0,0,148,148,C
3-PA,1764,148,0,0,0,148,A
3-PA,1765,0,0,0,157,157,C
3-PA,1766,0,156,0,0,156,T
3-PA,1767,0,0,0,156,156,C
3-PA,1768,0,0,0,157,157,C
3-PA,1769,154,0,1,0,155,A
3-PA,1770,0,0,155,0,155,G
3-PA,1771,0,0,0,155,155,C
3-PA,1772,156,0,0,0,156,A
3-PA,1773,0,0,157,0,157,G
3-PA,1774,152,0,0,0,152,A
3-PA,1775,0,153,0,0,153,T
3-PA,1776,0,0,0,153,153,C
3-PA,1777,0,1,152,0,153,G
3-PA,1778,153,0,0,0,153,A
3-PA,1779,0,0,152,0,152,G
3-PA,1780,151,0,1,0,152,A
3-PA,1781,0,0,153,0,153,G
3-PA,1782,0,0,0,153,153,C
3-PA,1783,154,0,0,0,154,A
3-PA,1784,0,155,0,0,155,T
3-PA,1785,0,1,160,0,161,G
3-PA,1786,162,0,0,0,162,A
3-PA,1787,0,162,0,0,162,T
3-PA,1788,0,158,0,0,158,T
3-PA,1789,0,0,158,0,158,G
3-PA,1790,155,0,0,0,155,A
3-PA,1791,0,0,152,0,152,G
3-PA,1792,0,0,157,0,157,G
3-PA,1793,0,0,0,156,156,C
3-PA,1794,0,0,0,157,157,C
3-PA,1795,0,1,155,0,156,G
3-PA,1796,155,0,0,0,155,A
3-PA,1797,0,0,158,0,158,G
3-PA,1798,0,156,0,0,156,T
3-PA,1799,0,0,0,156,156,C
3-PA,1800,0,0,0,156,156,C
3-PA,1801,0,156,0,0,156,T
3-PA,1802,0,0,0,157,157,C
3-PA,1803,0,0,158,0,158,G
3-PA,1804,0,0,162,0,162,G
3-PA,1805,0,161,0,0,161,T
3-PA,1806,0,160,0,0,160,T
3-PA,1807,159,0,0,0,159,A
3-PA,1808,159,0,0,0,159,A
3-PA,1809,159,0,0,0,159,A
3-PA,1810,0,0,160,0,160,G
3-PA,1811,158,0,0,0,158,A
3-PA,1812,0,0,157,0,157,G
3-PA,1813,154,0,0,0,154,A
3-PA,1814,155,0,0,0,155,A
3-PA,1815,154,0,1,0,155,A
3-PA,1816,0,0,156,0,156,G
3-PA,1817,155,0,0,0,155,A
3-PA,1818,0,1,0,154,155,C
3-PA,1819,148,0,0,0,148,A
3-PA,1820,0,146,1,1,148,T
3-PA,1821,0,1,149,0,150,G
3-PA,1822,152,0,0,0,152,A
3-PA,1823,0,0,0,152,152,C
3-PA,1824,0,0,0,150,150,C
3-PA,1825,150,1,0,0,151,A
3-PA,1826,150,0,0,0,150,A
3-PA,1827,150,0,0,0,150,A
3-PA,1828,0,1,150,0,151,G
3-PA,1829,152,0,0,0,152,A
3-PA,1830,0,0,152,0,152,G
3-PA,1831,0,149,0,0,149,T
3-PA,1832,0,151,0,0,151,T
3-PA,1833,1,148,0,0,149,T
3-PA,1834,0,148,0,0,148,T
3-PA,1835,0,150,0,0,150,T
3-PA,1836,0,149,0,0,149,T
3-PA,1837,0,1,149,0,150,G
3-PA,1838,148,0,0,0,148,A
3-PA,1839,0,0,149,0,149,G
3-PA,1840,148,0,0,0,148,A
3-PA,1841,148,0,0,0,148,A
3-PA,1842,0,148,0,0,148,T
3-PA,1843,148,1,0,0,149,A
3-PA,1844,151,0,0,0,151,A
3-PA,1845,151,0,0,0,151,A
3-PA,1846,0,150,0,0,150,T
3-PA,1847,0,0,0,151,151,C
3-PA,1848,147,0,0,0,147,A
3-PA,1849,0,0,148,0,148,G
3-PA,1850,145,0,0,0,145,A
3-PA,1851,145,0,0,0,145,A
3-PA,1852,0,0,143,0,143,G
3-PA,1853,0,0,0,138,138,C
3-PA,1854,139,0,0,0,139,A
3-PA,1855,0,138,0,0,138,T
3-PA,1856,0,0,138,0,138,G
3-PA,1857,1,0,139,0,140,G
3-PA,1858,0,0,0,140,140,C
3-PA,1859,0,0,0,141,141,C
3-PA,1860,0,0,0,143,143,C
3-PA,1861,146,0,0,0,146,A
3-PA,1862,0,146,0,0,146,T
3-PA,1863,0,145,0,0,145,T
3-PA,1864,0,0,147,0,147,G
3-PA,1865,0,0,147,0,147,G
3-PA,1866,0,0,146,0,146,G
3-PA,1867,0,1,145,0,146,G
3-PA,1868,139,0,0,0,139,A
3-PA,1869,0,0,140,0,140,G
3-PA,1870,0,136,0,0,136,T
3-PA,1871,0,0,0,140,140,C
3-PA,1872,0,0,0,145,145,C
3-PA,1873,0,0,0,144,144,C
3-PA,1874,0,0,0,144,144,C
3-PA,1875,0,0,0,144,144,C
3-PA,1876,144,0,0,0,144,A
3-PA,1877,145,0,0,0,145,A
3-PA,1878,0,0,145,0,145,G
3-PA,1879,0,1,143,0,144,G
3-PA,1880,0,0,145,0,145,G
3-PA,1881,128,0,0,0,128,A
3-PA,1882,0,0,130,0,130,G
3-PA,1883,0,129,0,0,129,T
3-PA,1884,0,0,130,0,130,G
3-PA,1885,0,0,131,0,131,G
3-PA,1886,130,0,0,0,130,A
3-PA,1887,131,0,0,0,131,A
3-PA,1888,0,1,127,0,128,G
3-PA,1889,129,0,0,0,129,A
3-PA,1890,129,0,0,0,129,A
3-PA,1891,0,1,127,0,128,G
3-PA,1892,0,0,129,0,129,G
3-PA,1893,0,128,0,0,128,T
3-PA,1894,0,125,0,1,126,T
3-PA,1895,0,0,0,126,126,C
3-PA,1896,0,0,0,125,125,C
3-PA,1897,125,0,0,0,125,A
3-PA,1898,0,125,0,0,125,T
3-PA,1899,0,125,0,0,125,T
3-PA,1900,0,0,127,0,127,G
3-PA,1901,0,0,125,0,125,G
3-PA,1902,0,0,125,0,125,G
3-PA,1903,125,1,0,0,126,A
3-PA,1904,124,0,0,0,124,A
3-PA,1905,126,0,0,0,126,A
3-PA,1906,0,0,128,0,128,G
3-PA,1907,0,127,0,0,127,T
3-PA,1908,0,0,0,132,132,C
3-PA,1909,0,129,0,0,129,T
3-PA,1910,0,0,130,0,130,G
3-PA,1911,0,130,0,0,130,T
3-PA,1912,130,0,0,0,130,A
3-PA,1913,0,1,128,0,129,G
3-PA,1914,0,0,128,0,128,G
3-PA,1915,125,0,0,0,125,A
3-PA,1916,0,0,0,126,126,C
3-PA,1917,0,122,0,0,122,T
3-PA,1918,0,0,0,129,129,C
3-PA,1919,0,130,0,0,130,T
3-PA,1920,129,0,1,0,130,A
3-PA,1921,0,130,0,0,130,T
3-PA,1922,0,127,0,0,127,T
3-PA,1923,0,0,128,0,128,G
3-PA,1924,0,0,127,0,127,G
3-PA,1925,0,0,0,128,128,C
3-PA,1926,0,126,0,0,126,T
3-PA,1927,123,0,0,0,123,A
3-PA,1928,123,0,0,0,123,A
3-PA,1929,0,0,123,0,123,G
3-PA,1930,0,122,0,0,122,T
3-PA,1931,0,0,0,122,122,C
3-PA,1932,119,0,0,0,119,A
3-PA,1933,0,1,119,0,120,G
3-PA,1934,1,119,0,0,120,T
3-PA,1935,123,0,0,0,123,A
3-PA,1936,0,123,0,0,123,T
3-PA,1937,0,122,0,0,122,T
3-PA,1938,0,1,0,122,123,C
3-PA,1939,122,0,0,0,122,A
3-PA,1940,122,0,0,0,122,A
3-PA,1941,0,122,0,0,122,T
3-PA,1942,117,0,0,0,117,A
3-PA,1943,0,0,119,0,119,G
3-PA,1944,0,0,0,114,114,C
3-PA,1945,0,0,0,113,113,C
3-PA,1946,0,111,0,0,111,T
3-PA,1947,0,0,115,0,115,G
3-PA,1948,0,114,0,1,115,T
3-PA,1949,116,0,0,0,116,A
3-PA,1950,0,116,0,0,116,T
3-PA,1951,0,0,116,0,116,G
3-PA,1952,0,0,0,118,118,C
3-PA,1953,118,0,0,0,118,A
3-PA,1954,0,116,0,0,116,T
3-PA,1955,0,0,0,114,114,C
3-PA,1956,111,0,1,0,112,A
3-PA,1957,0,1,0,111,112,C
3-PA,1958,0,0,0,112,112,C
3-PA,1959,112,0,0,0,112,A
3-PA,1960,0,0,0,116,116,C
3-PA,1961,114,0,0,0,114,A
3-PA,1962,115,0,0,0,115,A
3-PA,1963,0,115,0,0,115,T
3-PA,1964,0,115,0,0,115,T
3-PA,1965,0,0,115,0,115,G
3-PA,1966,0,0,114,0,114,G
3-PA,1967,114,0,0,0,114,A
3-PA,1968,114,0,0,0,114,A
3-PA,1969,0,0,113,0,113,G
3-PA,1970,0,0,116,0,116,G
3-PA,1971,115,0,0,0,115,A
3-PA,1972,0,115,0,0,115,T
3-PA,1973,0,115,0,0,115,T
3-PA,1974,0,115,0,0,115,T
3-PA,1975,1,113,0,0,114,T
3-PA,1976,0,1,0,114,115,C
3-PA,1977,115,0,0,0,115,A
3-PA,1978,0,0,114,0,114,G
3-PA,1979,0,0,0,113,113,C
3-PA,1980,0,0,110,0,110,G
3-PA,1981,0,0,112,0,112,G
3-PA,1982,112,0,0,0,112,A
3-PA,1983,0,0,112,0,112,G
3-PA,1984,0,111,0,0,111,T
3-PA,1985,0,0,0,113,113,C
3-PA,1986,113,0,0,0,113,A
3-PA,1987,112,0,1,0,113,A
3-PA,1988,0,0,114,0,114,G
3-PA,1989,113,0,0,0,113,A
3-PA,1990,113,0,0,0,113,A
3-PA,1991,111,0,0,0,111,A
3-PA,1992,109,1,0,0,110,A
3-PA,1993,0,0,0,110,110,C
3-PA,1994,0,106,0,1,107,T
3-PA,1995,1,0,107,0,108,G
3-PA,1996,0,0,0,108,108,C
3-PA,1997,0,108,0,0,108,T
3-PA,1998,1,0,0,107,108,C
3-PA,1999,0,0,0,108,108,C
3-PA,2000,0,109,0,0,109,T
3-PA,2001,0,109,0,0,109,T
3-PA,2002,0,0,109,0,109,G
3-PA,2003,0,109,0,0,109,T
3-PA,2004,0,105,0,0,105,T
3-PA,2005,0,0,106,0,106,G
3-PA,2006,0,105,1,0,106,T
3-PA,2007,0,104,0,0,104,T
3-PA,2008,0,0,0,106,106,C
3-PA,2009,104,0,0,0,104,A
3-PA,2010,0,0,105,0,105,G
3-PA,2011,0,0,105,0,105,G
3-PA,2012,0,0,0,105,105,C
3-PA,2013,0,105,0,0,105,T
3-PA,2014,0,0,0,106,106,C
3-PA,2015,0,106,0,0,106,T
3-PA,2016,0,107,0,0,107,T
3-PA,2017,108,0,0,0,108,A
3-PA,2018,0,0,108,0,108,G
3-PA,2019,0,0,105,0,105,G
3-PA,2020,0,0,105,0,105,G
3-PA,2021,106,0,0,0,106,A
3-PA,2022,0,0,0,106,106,C
3-PA,2023,102,0,0,0,102,A
3-PA,2024,104,0,0,0,104,A
3-PA,2025,0,0,0,107,107,C
3-PA,2026,0,0,0,107,107,C
3-PA,2027,0,104,0,1,105,T
3-PA,2028,0,0,0,106,106,C
3-PA,2029,0,0,106,0,106,G
3-PA,2030,105,0,0,0,105,A
3-PA,2031,106,0,0,0,106,A
3-PA,2032,0,0,0,106,106,C
3-PA,2033,0,0,0,100,100,C
3-PA,2034,0,97,0,0,97,T
3-PA,2035,0,0,97,0,97,G
3-PA,2036,0,0,97,0,97,G
3-PA,2037,0,0,97,0,97,G
3-PA,2038,96,0,0,0,96,A
3-PA,2039,0,0,0,96,96,C
3-PA,2040,0,0,0,93,93,C
3-PA,2041,0,89,0,0,89,T
3-PA,2042,0,90,0,0,90,T
3-PA,2043,0,89,0,0,89,T
3-PA,2044,0,0,92,0,92,G
3-PA,2045,93,0,0,0,93,A
3-PA,2046,0,93,0,0,93,T
3-PA,2047,0,0,0,94,94,C
3-PA,2048,0,89,0,0,89,T
3-PA,2049,0,90,0,0,90,T
3-PA,2050,0,0,89,0,89,G
3-PA,2051,0,0,90,0,90,G
3-PA,2052,0,0,90,0,90,G
3-PA,2053,0,0,91,0,91,G
3-PA,2054,0,0,88,0,88,G
3-PA,2055,0,0,88,0,88,G
3-PA,2056,0,0,0,88,88,C
3-PA,2057,0,88,0,0,88,T
3-PA,2058,90,0,0,0,90,A
3-PA,2059,0,89,0,0,89,T
3-PA,2060,89,0,0,0,89,A
3-PA,2061,0,89,0,0,89,T
3-PA,2062,0,0,87,0,87,G
3-PA,2063,86,0,1,0,87,A
3-PA,2064,86,0,0,0,86,A
3-PA,2065,0,0,87,0,87,G
3-PA,2066,0,0,0,88,88,C
3-PA,2067,80,0,0,0,80,A
3-PA,2068,83,0,0,0,83,A
3-PA,2069,0,82,0,0,82,T
3-PA,2070,0,82,0,0,82,T
3-PA,2071,0,0,82,0,82,G
3-PA,2072,82,0,0,0,82,A
3-PA,2073,0,0,82,0,82,G
3-PA,2074,0,0,81,0,81,G
3-PA,2075,78,0,0,0,78,A
3-PA,2076,0,0,79,0,79,G
3-PA,2077,0,68,0,0,68,T
3-PA,2078,0,0,69,0,69,G
3-PA,2079,0,0,0,69,69,C
3-PA,2080,0,0,0,69,69,C
3-PA,2081,0,67,0,0,67,T
3-PA,2082,0,0,69,0,69,G
3-PA,2083,71,0,0,0,71,A
3-PA,2084,0,70,0,0,70,T
3-PA,2085,0,69,0,0,69,T
3-PA,2086,70,0,0,0,70,A
3-PA,2087,69,0,1,0,70,A
3-PA,2088,0,69,0,0,69,T
3-PA,2089,0,0,69,0,69,G
3-PA,2090,69,0,0,0,69,A
3-PA,2091,0,68,0,0,68,T
3-PA,2092,0,0,0,69,69,C
3-PA,2093,1,0,0,67,68,C
3-PA,2094,0,0,0,67,67,C
3-PA,2095,0,67,0,0,67,T
3-PA,2096,0,0,67,0,67,G
3-PA,2097,0,0,67,0,67,G
3-PA,2098,0,0,67,0,67,G
3-PA,2099,0,65,0,0,65,T
3-PA,2100,0,59,0,0,59,T
3-PA,2101,0,58,0,0,58,T
3-PA,2102,0,58,0,0,58,T
3-PA,2103,0,0,59,0,59,G
3-PA,2104,0,0,0,58,58,C
3-PA,2105,1,56,0,0,57,T
3-PA,2106,0,0,0,57,57,C
3-PA,2107,56,0,0,0,56,A
3-PA,2108,55,0,0,0,55,A
3-PA,2109,0,55,0,0,55,T
3-PA,2110,0,0,55,0,55,G
3-PA,2111,0,0,0,55,55,C
3-PA,2112,0,0,57,0,57,G
3-PA,2113,0,56,0,0,56,T
3-PA,2114,0,0,0,56,56,C
3-PA,2115,0,56,0,0,56,T
3-PA,2116,0,56,0,0,56,T
3-PA,2117,0,0,55,0,55,G
3-PA,2118,0,0,56,0,56,G
3-PA,2119,0,55,0,0,55,T
3-PA,2120,0,55,0,0,55,T
3-PA,2121,0,0,0,54,54,C
3-PA,2122,53,0,0,0,53,A
3-PA,2123,54,0,0,0,54,A
3-PA,2124,0,0,0,54,54,C
3-PA,2125,0,54,0,0,54,T
3-PA,2126,0,0,0,55,55,C
3-PA,2127,0,0,0,54,54,C
3-PA,2128,0,54,0,0,54,T
3-PA,2129,0,54,0,0,54,T
3-PA,2130,1,0,0,53,54,C
3-PA,2131,0,0,0,54,54,C
3-PA,2132,0,52,0,0,52,T
3-PA,2133,0,0,51,0,51,G
3-PA,2134,52,0,0,0,52,A
3-PA,2135,0,0,0,50,50,C
3-PA,2136,46,0,0,0,46,A
3-PA,2137,0,0,0,45,45,C
3-PA,2138,46,0,0,0,46,A
3-PA,2139,0,45,0,0,45,T
3-PA,2140,0,0,45,0,45,G
3-PA,2141,0,0,0,45,45,C
3-PA,2142,44,0,0,0,44,A
3-PA,2143,0,43,0,0,43,T
3-PA,2144,0,41,0,0,41,T
3-PA,2145,40,0,0,0,40,A
3-PA,2146,40,0,0,0,40,A
3-PA,2147,40,0,0,0,40,A
3-PA,2148,39,0,0,0,39,A
3-PA,2149,0,38,0,0,38,T
3-PA,2150,33,0,0,0,33,A
3-PA,2151,0,0,33,0,33,G
4-HA,1,276,0,0,0,276,A
4-HA,2,0,279,0,0,279,T
4-HA,3,0,0,288,0,288,G
4-HA,4,288,0,0,0,288,A
4-HA,5,291,0,0,0,291,A
4-HA,6,0,0,316,0,316,G
4-HA,7,315,0,1,0,316,A
4-HA,8,0,0,0,344,344,C
4-HA,9,0,348,0,0,348,T
4-HA,10,364,0,0,0,364,A
4-HA,11,0,377,0,0,377,T
4-HA,12,1,0,0,376,377,C
4-HA,13,378,0,1,0,379,A
4-HA,14,0,377,0,1,378,T
4-HA,15,0,378,0,0,378,T
4-HA,16,0,0,412,0,412,G
4-HA,17,0,0,0,412,412,C
4-HA,18,0,413,0,0,413,T
4-HA,19,0,414,0,0,414,T
4-HA,20,0,414,0,0,414,T
4-HA,21,0,1,437,0,438,G
4-HA,22,439,0,0,0,439,A
4-HA,23,0,1,463,0,464,G
4-HA,24,0,0,0,465,465,C
4-HA,25,0,465,0,1,466,T
4-HA,26,497,0,0,0,497,A
4-HA,27,0,0,0,507,507,C
4-HA,28,515,0,1,0,516,A
4-HA,29,0,547,0,1,548,T
4-HA,30,0,545,0,0,545,T
4-HA,31,1,0,0,547,548,C
4-HA,32,0,550,0,0,550,T
4-HA,33,564,0,0,0,564,A
4-HA,34,0,568,0,0,568,T
4-HA,35,0,2,573,0,575,G
4-HA,36,0,569,0,1,570,T
4-HA,37,0,0,0,572,572,C
4-HA,38,0,569,0,1,570,T
4-HA,39,1,0,572,0,573,G
4-HA,40,0,0,574,0,574,G
4-HA,41,0,574,0,0,574,T
4-HA,42,0,572,0,0,572,T
4-HA,43,0,574,0,0,574,T
4-HA,44,0,573,0,0,573,T
4-HA,45,0,0,0,571,571,C
4-HA,46,1,1,567,0,569,G
4-HA,47,0,0,1,576,577,C
4-HA,48,0,573,0,1,574,T
4-HA,49,1,0,0,578,579,C
4-HA,50,581,0,0,0,581,A
4-HA,51,580,0,0,0,580,A
4-HA,52,581,0,0,0,581,A
4-HA,53,582,0,0,0,582,A
4-HA,54,583,0,0,0,583,A
4-HA,55,0,0,0,585,585,C
4-HA,56,0,584,0,0,584,T
4-HA,57,0,589,0,0,589,T
4-HA,58,0,0,0,587,587,C
4-HA,59,0,1,0,589,590,C
4-HA,60,0,585,1,1,587,T
4-HA,61,0,1,595,0,596,G
4-HA,62,0,0,598,0,598,G
4-HA,63,600,0,0,0,600,A
4-HA,64,605,0,0,0,605,A
4-HA,65,604,0,0,0,604,A
4-HA,66,0,613,0,0,613,T
4-HA,67,1,3,612,0,616,G
4-HA,68,618,0,1,0,619,A
4-HA,69,0,0,0,624,624,C
4-HA,70,623,0,1,0,624,A
4-HA,71,624,0,0,0,624,A
4-HA,72,0,0,0,635,635,C
4-HA,73,632,0,0,0,632,A
4-HA,74,1,0,632,0,633,G
4-HA,75,0,0,0,629,629,C
4-HA,76,631,1,1,0,633,A
4-HA,77,0,0,0,654,654,C
4-HA,78,0,1,655,0,656,G
4-HA,79,1,0,659,0,660,G
4-HA,80,0,0,0,663,663,C
4-HA,81,659,0,1,0,660,A
4-HA,82,669,0,0,0,669,A
4-HA,83,0,0,0,678,678,C
4-HA,84,0,1,686,0,687,G
4-HA,85,2,0,0,689,691,C
4-HA,86,0,681,0,3,684,T
4-HA,87,0,0,702,0,702,G
4-HA,88,0,698,0,0,698,T
4-HA,89,0,1,733,0,734,G
4-HA,90,1,0,0,749,750,C
4-HA,91,0,0,0,760,760,C
4-HA,92,0,747,0,2,749,T
4-HA,93,0,750,0,0,750,T
4-HA,94,0,3,745,0,748,G
4-HA,95,0,2,754,0,756,G
4-HA,96,0,1,763,0,764,G
4-HA,97,1,1,0,762,764,C
4-HA,98,755,0,0,0,755,A
4-HA,99,0,0,0,770,770,C
4-HA,100,1,0,0,756,757,C
4-HA,101,830,0,0,0,830,A
4-HA,102,1,829,0,1,831,T
4-HA,103,0,0,833,0,833,G
4-HA,104,1,1,0,832,834,C
4-HA,105,823,0,1,0,824,A
4-HA,106,0,0,894,0,894,G
4-HA,107,0,894,0,0,894,T
4-HA,108,902,0,0,0,902,A
4-HA,109,0,0,0,900,900,C
4-HA,110,1,0,0,878,879,C
4-HA,111,884,0,0,0,884,A
4-HA,112,880,0,0,0,880,A
4-HA,113,881,0,1,0,882,A
4-HA,114,0,1,0,887,888,C
4-HA,115,1,1,865,0,867,G
4-HA,116,0,0,879,0,879,G
4-HA,117,876,0,1,0,877,A
4-HA,118,882,0,0,0,882,A
4-HA,119,1,0,0,883,884,C
4-HA,120,2,3,874,0,879,G
4-HA,121,0,1,872,0,873,G
4-HA,122,0,913,0,0,913,T
4-HA,123,921,0,1,0,922,A
4-HA,124,0,0,923,0,923,G
4-HA,125,0,914,0,1,915,T
4-HA,126,3,0,917,0,920,G
4-HA,127,916,0,0,0,916,A
4-HA,128,921,0,0,0,921,A
4-HA,129,916,0,2,1,919,A
4-HA,130,898,0,0,0,898,A
4-HA,131,0,0,0,912,912,C
4-HA,132,903,0,0,0,903,A
4-HA,133,905,0,0,0,905,A
4-HA,134,0,899,0,1,900,T
4-HA,135,2,1,0,898,901,C
4-HA,136,902,0,0,0,902,A
4-HA,137,0,0,0,911,911,C
4-HA,138,0,1,908,0,909,G
4-HA,139,909,0,1,0,910,A
4-HA,140,902,0,1,0,903,A
4-HA,141,0,902,0,0,902,T
4-HA,142,0,4,901,0,905,G
4-HA,143,907,1,2,0,910,A
4-HA,144,1,0,0,906,907,C
4-HA,145,2,1,0,903,906,C
4-HA,146,913,0,1,0,914,A
4-HA,147,917,0,0,0,917,A
4-HA,148,917,0,0,0,917,A
4-HA,149,0,919,0,0,919,T
4-HA,150,0,918,0,0,918,T
4-HA,151,0,2,924,0,926,G
4-HA,152,921,0,0,0,921,A
4-HA,153,919,0,1,0,920,A
4-HA,154,1,0,927,0,928,G
4-HA,155,0,931,0,0,931,T
4-HA,156,0,970,0,0,970,T
4-HA,157,974,0,1,1,976,A
4-HA,158,0,0,0,981,981,C
4-HA,159,0,980,0,1,981,T
4-HA,160,979,0,0,0,979,A
4-HA,161,999,0,1,0,1000,A
4-HA,162,0,1000,0,0,1000,T
4-HA,163,1,0,1000,0,1001,G
4-HA,164,0,0,0,1041,1041,C
4-HA,165,0,1031,0,0,1031,T
4-HA,166,1043,0,0,0,1043,A
4-HA,167,0,1,0,1042,1043,C
4-HA,168,0,1035,0,2,1037,T
4-HA,169,0,3,1039,0,1042,G
4-HA,170,1029,0,0,0,1029,A
4-HA,171,1,0,1031,0,1032,G
4-HA,172,1,1,0,1033,1035,C
4-HA,173,0,997,0,0,997,T
4-HA,174,0,1,1026,0,1027,G
4-HA,175,1,1,1037,0,1039,G
4-HA,176,1,1038,0,2,1041,T
4-HA,177,0,1045,0,1,1046,T
4-HA,178,3,0,0,1039,1042,C
4-HA,179,1038,0,0,0,1038,A
4-HA,180,0,0,1043,0,1043,G
4-HA,181,1044,0,1,0,1045,A
4-HA,182,0,0,1067,0,1067,G
4-HA,183,1,1062,0,0,1063,T
4-HA,184,0,1052,0,0,1052,T
4-HA,185,3,0,0,1058,1061,C
4-HA,186,1,1,0,1063,1065,C
4-HA,187,0,1060,0,1,1061,T
4-HA,188,2,0,0,1063,1065,C
4-HA,189,1058,0,1,0,1059,A
4-HA,190,1062,0,0,1,1063,A
4-HA,191,0,1,0,1069,1070,C
4-HA,192,1051,0,0,1,1052,A
4-HA,193,0,0,1076,0,1076,G
4-HA,194,1,1,1079,0,1081,G
4-HA,195,1,1075,0,0,1076,T
4-HA,196,0,0,1075,0,1075,G
4-HA,197,1072,0,1,0,1073,A
4-HA,198,1080,0,2,0,1082,A
4-HA,199,1119,1,0,0,1120,A
4-HA,200,1,1103,0,0,1104,T
4-HA,201,1116,1,1,0,1118,A
4-HA,202,0,1105,0,0,1105,T
4-HA,203,0,0,1103,0,1103,G
4-HA,204,0,0,1,1105,1106,C
4-HA,205,1,1,1103,0,1105,G
4-HA,206,1110,1,1,0,1112,A
4-HA,207,0,0,0,1109,1109,C
4-HA,208,1095,0,0,0,1095,A
4-HA,209,1,0,1169,0,1170,G
4-HA,210,2,1163,0,2,1167,T
4-HA,211,1,0,0,1181,1182,C
4-HA,212,1,0,0,1186,1187,C
4-HA,213,0,1174,0,3,1177,T
4-HA,214,3,0,0,1200,1203,C
4-HA,215,1205,0,0,0,1205,A
4-HA,216,0,1203,0,3,1206,T
4-HA,217,1,1,0,1209,1211,C
4-HA,218,1153,0,1,0,1154,A
4-HA,219,1,2,1157,0,1160,G
4-HA,220,1147,0,2,0,1149,A
4-HA,221,0,1149,0,1,1150,T
4-HA,222,4,0,0,1145,1149,C
4-HA,223,2,1,0,1134,1137,C
4-HA,224,1,1134,0,0,1135,T
4-HA,225,0,1134,0,0,1134,T
4-HA,226,0,0,1136,0,1136,G
4-HA,227,1135,0,1,0,1136,A
4-HA,228,0,1130,0,1,1131,T
4-HA,229,3,0,1130,0,1133,G
4-HA,230,0,0,1136,0,1136,G
4-HA,231,1127,1,2,0,1130,A
4-HA,232,1134,0,1,0,1135,A
4-HA,233,1133,0,0,0,1133,A
4-HA,234,1142,0,0,0,1142,A
4-HA,235,1142,0,1,0,1143,A
4-HA,236,1138,0,0,0,1138,A
4-HA,237,0,0,0,1145,1145,C
4-HA,238,0,1134,0,0,1134,T
4-HA,239,0,2,1136,0,1138,G
4-HA,240,0,0,0,1136,1136,C
4-HA,241,1134,0,3,0,1137,A
4-HA,242,0,0,0,1175,1175,C
4-HA,243,1175,0,0,0,1175,A
4-HA,244,0,0,0,1337,1337,C
4-HA,245,0,1332,0,0,1332,T
4-HA,246,1364,0,0,0,1364,A
4-HA,247,1362,0,2,0,1364,A
4-HA,248,0,1368,0,0,1368,T
4-HA,249,1365,1,1,0,1367,A
4-HA,250,1,0,1370,0,1371,G
4-HA,251,1344,0,0,0,1344,A
4-HA,252,1,1314,0,0,1315,T
4-HA,253,0,3,1244,0,1247,G
4-HA,254,0,0,0,1254,1254,C
4-HA,255,0,1241,0,1,1242,T
4-HA,256,2,0,0,1334,1336,C
4-HA,257,0,1336,0,0,1336,T
4-HA,258,1367,0,0,0,1367,A
4-HA,259,0,1360,0,2,1362,T
4-HA,260,0,1357,0,1,1358,T
4-HA,261,0,3,1365,0,1368,G
4-HA,262,0,4,1355,0,1359,G
4-HA,263,2,1,1351,0,1354,G
4-HA,264,1335,0,1,0,1336,A
4-HA,265,0,2,1315,0,1317,G
4-HA,266,1288,0,0,0,1288,A
4-HA,267,0,0,0,1342,1342,C
4-HA,268,1,1,0,1357,1359,C
4-HA,269,5,1,0,1353,1359,C
4-HA,270,0,1352,1,4,1357,T
4-HA,271,1,0,0,1372,1373,C
4-HA,272,1373,0,0,3,1376,A
4-HA,273,0,0,1439,0,1439,G
4-HA,274,0,1437,0,3,1440,T
4-HA,275,0,4,1437,1,1442,G
4-HA,276,0,1391,0,0,1391,T
4-HA,277,1,0,1381,0,1382,G
4-HA,278,1375,5,1,0,1381,A
4-HA,279,0,1380,1,1,1382,T
4-HA,280,0,4,1371,0,1375,G
4-HA,281,0,1,1375,0,1376,G
4-HA,282,0,0,0,1343,1343,C
4-HA,283,0,1340,0,3,1343,T
4-HA,284,0,1337,0,1,1338,T
4-HA,285,1,0,0,1338,1339,C
4-HA,286,1,0,0,1341,1342,C
4-HA,287,1339,0,0,1,1340,A
4-HA,288,1342,0,0,0,1342,A
4-HA,289,1341,0,1,0,1342,A
4-HA,290,1354,0,0,0,1354,A
4-HA,291,1,1352,0,2,1355,T
4-HA,292,1349,0,1,1,1351,A
4-HA,293,1355,0,2,0,1357,A
4-HA,294,1,3,1358,0,1362,G
4-HA,295,1368,0,0,0,1368,A
4-HA,296,1368,0,0,0,1368,A
4-HA,297,1367,0,0,0,1367,A
4-HA,298,0,1373,0,0,1373,T
4-HA,299,1,0,1368,0,1369,G
4-HA,300,0,5,1360,0,1365,G
4-HA,301,0,2,1362,0,1364,G
4-HA,302,1362,1,0,0,1363,A
4-HA,303,1,0,0,1371,1372,C
4-HA,304,1,0,0,1365,1366,C
4-HA,305,1,1372,0,3,1376,T
4-HA,306,0,1376,0,3,1379,T
4-HA,307,1,1379,0,2,1382,T
4-HA,308,0,1391,0,1,1392,T
4-HA,309,0,1392,0,0,1392,T
4-HA,310,1,1,1398,1,1401,G
4-HA,311,0,1399,0,1,1400,T
4-HA,312,0,1384,0,1,1385,T
4-HA,313,3,5,1375,0,1383,G
4-HA,314,1371,0,0,0,1371,A
4-HA,315,1380,0,2,0,1382,A
4-HA,316,0,0,0,1380,1380,C
4-HA,317,0,1,1370,1,1372,G
4-HA,318,0,0,0,1398,1398,C
4-HA,319,1390,0,2,0,1392,A
4-HA,320,0,0,1401,0,1401,G
4-HA,321,1,0,0,1394,1395,C
4-HA,322,1397,0,0,0,1397,A
4-HA,323,1401,0,0,0,1401,A
4-HA,324,1397,1,2,0,1400,A
4-HA,325,1,1,1447,0,1449,G
4-HA,326,0,1,0,1451,1452,C
4-HA,327,4,0,0,1435,1439,C
4-HA,328,0,1432,0,2,1434,T
4-HA,329,1425,0,2,0,1427,A
4-HA,330,0,1,0,1447,1448,C
4-HA,331,1440,0,2,1,1443,A
4-HA,332,1,0,1444,0,1445,G
4-HA,333,0,0,0,1438,1438,C
4-HA,334,1396,0,0,0,1396,A
4-HA,335,1405,0,0,0,1405,A
4-HA,336,0,0,0,1466,1466,C
4-HA,337,0,1467,0,1,1468,T
4-HA,338,0,0,1468,0,1468,G
4-HA,339,2,1448,0,4,1454,T
4-HA,340,0,1448,1,3,1452,T
4-HA,341,1450,1,2,0,1453,A
4-HA,342,0,0,0,1559,1559,C
4-HA,343,4,0,0,1563,1567,C
4-HA,344,3,0,0,1587,1590,C
4-HA,345,0,1511,0,2,1513,T
4-HA,346,0,1521,0,0,1521,T
4-HA,347,1526,0,0,0,1526,A
4-HA,348,1,1527,0,0,1528,T
4-HA,349,0,3,1524,0,1527,G
4-HA,350,1516,0,1,1,1518,A
4-HA,351,0,1411,0,2,1413,T
4-HA,352,0,2,1426,0,1428,G
4-HA,353,0,1382,0,0,1382,T
4-HA,354,0,0,1372,0,1372,G
4-HA,355,0,1,0,1375,1376,C
4-HA,356,0,0,0,1381,1381,C
4-HA,357,4,2,1403,0,1409,G
4-HA,358,1,1,1432,0,1434,G
4-HA,359,1432,0,0,0,1432,A
4-HA,360,0,1430,0,2,1432,T
4-HA,361,0,1401,0,1,1402,T
4-HA,362,1414,0,2,0,1416,A
4-HA,363,0,1410,0,2,1412,T
4-HA,364,0,0,1413,0,1413,G
4-HA,365,0,0,0,1413,1413,C
4-HA,366,2,1,0,1394,1397,C
4-HA,367,1,1391,0,3,1395,T
4-HA,368,4,0,0,1464,1468,C
4-HA,369,1,0,0,1479,1480,C
4-HA,370,0,0,0,1488,1488,C
4-HA,371,0,1480,0,1,1481,T
4-HA,372,1,1486,0,0,1487,T
4-HA,373,1483,0,0,0,1483,A
4-HA,374,1,2,1506,0,1509,G
4-HA,375,0,0,1513,0,1513,G
4-HA,376,0,1491,0,2,1493,T
4-HA,377,6,2,0,1456,1464,C
4-HA,378,1444,0,1,0,1445,A
4-HA,379,0,2,0,1470,1472,C
4-HA,380,1,1469,0,0,1470,T
4-HA,381,1471,1,0,0,1472,A
4-HA,382,1,1,1469,0,1471,G
4-HA,383,0,1449,0,0,1449,T
4-HA,384,0,1439,0,1,1440,T
4-HA,385,0,0,1449,0,1449,G
4-HA,386,0,0,1,1454,1455,C
4-HA,387,1,0,0,1451,1452,C
4-HA,388,0,1432,0,2,1434,T
4-HA,389,2,0,0,1436,1438,C
4-HA,390,1484,0,0,0,1484,A
4-HA,391,0,1483,0,0,1483,T
4-HA,392,2,0,0,1480,1482,C
4-HA,393,2,2,0,1477,1481,C
4-HA,394,1,2,1460,0,1463,G
4-HA,395,2,1,1466,0,1469,G
4-HA,396,0,0,0,1472,1472,C
4-HA,397,1487,0,0,0,1487,A
4-HA,398,0,2,0,1505,1507,C
4-HA,399,1474,0,1,0,1475,A
4-HA,400,0,0,0,1478,1478,C
4-HA,401,0,1471,0,1,1472,T
4-HA,402,0,2,1490,0,1492,G
4-HA,403,0,0,1500,0,1500,G
4-HA,404,1497,0,3,0,1500,A
4-HA,405,0,0,1515,0,1515,G
4-HA,406,0,1502,1,2,1505,T
4-HA,407,0,1492,0,1,1493,T
4-HA,408,0,1491,0,1,1492,T
4-HA,409,1484,0,1,0,1485,A
4-HA,410,1487,0,0,0,1487,A
4-HA,411,0,0,0,1496,1496,C
4-HA,412,1465,0,1,1,1467,A
4-HA,413,1466,1,0,0,1467,A
4-HA,414,0,1449,0,1,1450,T
4-HA,415,1,7,1438,0,1446,G
4-HA,416,1442,0,2,0,1444,A
4-HA,417,1448,0,0,0,1448,A
4-HA,418,1449,0,3,0,1452,A
4-HA,419,0,0,1450,0,1450,G
4-HA,420,0,0,0,1459,1459,C
4-HA,421,0,1450,1,1,1452,T
4-HA,422,0,1458,0,1,1459,T
4-HA,423,2,0,0,1473,1475,C
4-HA,424,1481,0,0,0,1481,A
4-HA,425,1485,0,0,0,1485,A
4-HA,426,0,1484,0,0,1484,T
4-HA,427,0,1474,0,3,1477,T
4-HA,428,1,3,1496,0,1500,G
4-HA,429,0,3,1522,0,1525,G
4-HA,430,1524,0,2,0,1526,A
4-HA,431,0,0,0,1526,1526,C
4-HA,432,0,1507,1,1,1509,T
4-HA,433,2,1,1510,0,1513,G
4-HA,434,0,1,1523,0,1524,G
4-HA,435,1519,0,2,0,1521,A
4-HA,436,1,0,1525,0,1526,G
4-HA,437,0,1490,0,2,1492,T
4-HA,438,4,1,0,1463,1468,C
4-HA,439,1481,0,0,0,1481,A
4-HA,440,0,2,0,1487,1489,C
4-HA,441,0,1486,0,1,1487,T
4-HA,442,4,1,0,1486,1491,C
4-HA,443,1483,0,0,0,1483,A
4-HA,444,1493,0,1,0,1494,A
4-HA,445,1491,1,1,0,1493,A
4-HA,446,1492,0,1,0,1493,A
4-HA,447,1,2,0,1491,1494,C
4-HA,448,0,2,1467,0,1469,G
4-HA,449,0,3,1489,0,1492,G
4-HA,450,1483,0,2,0,1485,A
4-HA,451,1486,0,0,1,1487,A
4-HA,452,0,0,0,1490,1490,C
4-HA,453,1479,0,1,1,1481,A
4-HA,454,1493,1,3,0,1497,A
4-HA,455,0,0,1505,0,1505,G
4-HA,456,0,0,0,1505,1505,C
4-HA,457,0,1488,0,6,1494,T
4-HA,458,4,0,0,1489,1493,C
4-HA,459,0,1483,1,2,1486,T
4-HA,460,0,1,1487,0,1488,G
4-HA,461,0,0,0,1489,1489,C
4-HA,462,1,1482,0,2,1485,T
4-HA,463,0,1517,0,1,1518,T
4-HA,464,0,1,1537,0,1538,G
4-HA,465,0,1,0,1553,1554,C
4-HA,466,1554,0,2,0,1556,A
4-HA,467,0,1545,0,0,1545,T
4-HA,468,1535,0,2,0,1537,A
4-HA,469,1518,1,2,0,1521,A
4-HA,470,0,0,1525,0,1525,G
4-HA,471,0,2,1522,0,1524,G
4-HA,472,1468,0,1,0,1469,A
4-HA,473,1,1,1449,0,1451,G
4-HA,474,1444,0,2,0,1446,A
4-HA,475,0,1479,1,1,1481,T
4-HA,476,2,0,0,1489,1491,C
4-HA,477,0,1486,0,0,1486,T
4-HA,478,1489,0,0,0,1489,A
4-HA,479,1480,0,0,0,1480,A
4-HA,480,1467,1,0,0,1468,A
4-HA,481,1472,0,0,0,1472,A
4-HA,482,1467,2,0,1,1470,A
4-HA,483,0,0,0,1480,1480,C
4-HA,484,1440,0,0,1,1441,A
4-HA,485,0,0,1453,0,1453,G
4-HA,486,2,1443,0,2,1447,T
4-HA,487,0,1457,0,0,1457,T
4-HA,488,0,1460,1,1,1462,T
4-HA,489,3,0,0,1484,1487,C
4-HA,490,0,1486,0,1,1487,T
4-HA,491,0,1490,1,1,1492,T
4-HA,492,0,1490,0,1,1491,T
4-HA,493,1480,1,2,0,1483,A
4-HA,494,0,0,1483,0,1483,G
4-HA,495,0,1480,0,0,1480,T
4-HA,496,1474,0,0,1,1475,A
4-HA,497,0,4,1469,0,1473,G
4-HA,498,1452,0,1,0,1453,A
4-HA,499,0,1451,0,1,1452,T
4-HA,500,0,1442,0,0,1442,T
4-HA,501,0,4,1477,0,1481,G
4-HA,502,1477,0,0,0,1477,A
4-HA,503,1481,0,1,0,1482,A
4-HA,504,0,1482,0,0,1482,T
4-HA,505,1,1462,0,0,1463,T
4-HA,506,0,0,1477,0,1477,G
4-HA,507,0,0,1468,0,1468,G
4-HA,508,1,1470,1,2,1474,T
4-HA,509,0,1466,0,2,1468,T
4-HA,510,0,7,1440,0,1447,G
4-HA,511,1447,0,5,0,1452,A
4-HA,512,1,0,0,1442,1443,C
4-HA,513,2,0,0,1437,1439,C
4-HA,514,2,0,0,1468,1470,C
4-HA,515,1463,0,0,0,1463,A
4-HA,516,0,0,0,1479,1479,C
4-HA,517,2,1467,1,3,1473,T
4-HA,518,1,1475,1,0,1477,T
4-HA,519,1474,0,1,0,1475,A
4-HA,520,1467,0,0,0,1467,A
4-HA,521,1468,0,0,0,1468,A
4-HA,522,1,0,0,1414,1415,C
4-HA,523,0,1448,0,2,1450,T
4-HA,524,0,1450,0,0,1450,T
4-HA,525,1,1,0,1466,1468,C
4-HA,526,1468,0,1,0,1469,A
4-HA,527,1470,0,0,0,1470,A
4-HA,528,1469,0,0,0,1469,A
4-HA,529,0,1466,0,0,1466,T
4-HA,530,1484,0,0,0,1484,A
4-HA,531,0,1,0,1483,1484,C
4-HA,532,3,1,0,1446,1450,C
4-HA,533,2,1,0,1447,1450,C
4-HA,534,1443,0,1,0,1444,A
4-HA,535,0,0,1523,0,1523,G
4-HA,536,0,0,0,1527,1527,C
4-HA,537,1522,0,0,0,1522,A
4-HA,538,0,1512,0,2,1514,T
4-HA,539,1,1499,0,1,1501,T
4-HA,540,0,3,1541,0,1544,G
4-HA,541,1546,0,1,0,1547,A
4-HA,542,1548,0,1,0,1549,A
4-HA,543,2,2,0,1553,1557,C
4-HA,544,2,0,1497,0,1499,G
4-HA,545,0,1492,0,2,1494,T
4-HA,546,2,5,1494,0,1501,G
4-HA,547,1496,1,4,1,1502,A
4-HA,548,0,0,1,1501,1502,C
4-HA,549,0,1430,0,1,1431,T
4-HA,550,1460,0,0,0,1460,A
4-HA,551,0,1457,0,0,1457,T
4-HA,552,2,1,1470,0,1473,G
4-HA,553,0,2,1,1468,1471,C
4-HA,554,1,1,0,1445,1447,C
4-HA,555,1444,0,0,0,1444,A
4-HA,556,1445,0,1,0,1446,A
4-HA,557,1457,1,1,0,1459,A
4-HA,558,0,0,0,1466,1466,C
4-HA,559,1431,0,0,0,1431,A
4-HA,560,1430,1,0,0,1431,A
4-HA,561,1,1418,0,0,1419,T
4-HA,562,0,4,1420,0,1424,G
4-HA,563,1421,0,0,0,1421,A
4-HA,564,1418,0,2,0,1420,A
4-HA,565,1,0,0,1386,1387,C
4-HA,566,1397,0,0,0,1397,A
4-HA,567,1405,0,0,0,1405,A
4-HA,568,0,1399,1,1,1401,T
4-HA,569,2,1398,1,0,1401,T
4-HA,570,1,1403,1,0,1405,T
4-HA,571,0,3,1401,0,1404,G
4-HA,572,1407,2,0,0,1409,A
4-HA,573,1,0,0,1408,1409,C
4-HA,574,1411,0,1,0,1412,A
4-HA,575,1412,1,0,0,1413,A
4-HA,576,1424,0,2,0,1426,A
4-HA,577,0,1436,0,1,1437,T
4-HA,578,0,1436,0,0,1436,T
4-HA,579,0,0,1449,0,1449,G
4-HA,580,0,1444,0,1,1445,T
4-HA,581,1448,0,1,0,1449,A
4-HA,582,0,1,0,1482,1483,C
4-HA,583,1472,0,0,0,1472,A
4-HA,584,0,1491,0,0,1491,T
4-HA,585,0,1465,0,0,1465,T
4-HA,586,0,1456,0,0,1456,T
4-HA,587,0,5,1438,0,1443,G
4-HA,588,0,1,1434,0,1435,G
4-HA,589,1,4,1431,0,1436,G
4-HA,590,0,1,1438,1,1440,G
4-HA,591,0,1,1409,0,1410,G
4-HA,592,1,2,1445,0,1448,G
4-HA,593,0,1416,0,1,1417,T
4-HA,594,0,1422,0,4,1426,T
4-HA,595,5,0,0,1424,1429,C
4-HA,596,1433,0,1,0,1434,A
4-HA,597,0,0,0,1443,1443,C
4-HA,598,2,0,1,1439,1442,C
4-HA,599,1434,0,1,0,1435,A
4-HA,600,1,1,0,1441,1443,C
4-HA,601,0,0,0,1422,1422,C
4-HA,602,0,2,0,1405,1407,C
4-HA,603,1,1,1408,0,1410,G
4-HA,604,0,3,1434,0,1437,G
4-HA,605,0,0,1440,0,1440,G
4-HA,606,1,1426,0,0,1427,T
4-HA,607,1426,0,1,0,1427,A
4-HA,608,0,2,0,1418,1420,C
4-HA,609,0,2,1406,0,1408,G
4-HA,610,0,4,1433,0,1437,G
4-HA,611,1439,1,0,0,1440,A
4-HA,612,0,0,0,1435,1435,C
4-HA,613,1389,0,1,0,1390,A
4-HA,614,1391,0,0,0,1391,A
4-HA,615,1384,0,1,0,1385,A
4-HA,616,0,3,1405,0,1408,G
4-HA,617,1411,0,2,0,1413,A
4-HA,618,1,1,0,1407,1409,C
4-HA,619,4,0,0,1375,1379,C
4-HA,620,1385,1,0,0,1386,A
4-HA,621,1388,0,1,0,1389,A
4-HA,622,1402,1,0,0,1403,A
4-HA,623,0,1400,0,0,1400,T
4-HA,624,1,0,0,1415,1416,C
4-HA,625,2,1348,0,3,1353,T
4-HA,626,0,1346,0,3,1349,T
4-HA,627,2,0,0,1351,1353,C
4-HA,628,1,0,0,1361,1362,C
4-HA,629,0,1358,0,2,1360,T
4-HA,630,1,0,1372,0,1373,G
4-HA,631,0,1351,0,1,1352,T
4-HA,632,1367,0,0,0,1367,A
4-HA,633,1,1349,0,1,1351,T
4-HA,634,1,1,1356,0,1358,G
4-HA,635,0,0,0,1363,1363,C
4-HA,636,0,1358,0,4,1362,T
4-HA,637,1,0,0,1362,1363,C
4-HA,638,1361,0,0,1,1362,A
4-HA,639,1357,0,2,0,1359,A
4-HA,640,1,0,1362,0,1363,G
4-HA,641,0,0,0,1366,1366,C
4-HA,642,1364,0,0,0,1364,A
4-HA,643,0,1348,0,1,1349,T
4-HA,644,1,0,0,1348,1349,C
4-HA,645,1351,1,0,0,1352,A
4-HA,646,1,0,1368,0,1369,G
4-HA,647,0,3,1363,0,1366,G
4-HA,648,1371,0,1,0,1372,A
4-HA,649,1351,0,3,0,1354,A
4-HA,650,0,7,1387,0,1394,G
4-HA,651,1397,1,0,0,1398,A
4-HA,652,1419,0,0,0,1419,A
4-HA,653,0,1431,0,0,1431,T
4-HA,654,2,0,0,1430,1432,C
4-HA,655,1413,0,0,0,1413,A
4-HA,656,0,5,0,1407,1412,C
4-HA,657,1411,0,0,0,1411,A
4-HA,658,3,0,1436,0,1439,G
4-HA,659,0,1413,0,0,1413,T
4-HA,660,3,0,0,1420,1423,C
4-HA,661,0,1400,1,1,1402,T
4-HA,662,1,0,0,1430,1431,C
4-HA,663,0,1439,0,1,1440,T
4-HA,664,1452,0,0,0,1452,A
4-HA,665,0,0,0,1446,1446,C
4-HA,666,1,0,0,1448,1449,C
4-HA,667,1419,0,0,0,1419,A
4-HA,668,1425,0,0,0,1425,A
4-HA,669,1419,0,2,0,1421,A
4-HA,670,1424,0,1,0,1425,A
4-HA,671,0,0,1420,0,1420,G
4-HA,672,1387,0,0,0,1387,A
4-HA,673,1389,0,1,0,1390,A
4-HA,674,1,0,1395,0,1396,G
4-HA,675,0,0,0,1387,1387,C
4-HA,676,2,0,0,1395,1397,C
4-HA,677,1403,1,2,0,1406,A
4-HA,678,1400,6,5,0,1411,A
4-HA,679,0,0,0,1413,1413,C
4-HA,680,1409,0,0,0,1409,A
4-HA,681,1408,0,0,6,1414,A
4-HA,682,1411,0,0,0,1411,A
4-HA,683,0,2,0,1438,1440,C
4-HA,684,0,1431,0,0,1431,T
4-HA,685,0,0,1434,0,1434,G
4-HA,686,0,1425,1,0,1426,T
4-HA,687,1425,0,2,0,1427,A
4-HA,688,1426,1,0,0,1427,A
4-HA,689,0,1421,0,1,1422,T
4-HA,690,0,0,0,1417,1417,C
4-HA,691,1,2,0,1412,1415,C
4-HA,692,1,0,0,1401,1402,C
4-HA,693,0,0,1403,0,1403,G
4-HA,694,1395,0,0,0,1395,A
4-HA,695,1399,0,0,0,1399,A
4-HA,696,0,1400,0,0,1400,T
4-HA,697,1405,0,0,0,1405,A
4-HA,698,0,1401,0,0,1401,T
4-HA,699,3,1,0,1392,1396,C
4-HA,700,0,1,1388,0,1389,G
4-HA,701,0,1,1426,0,1427,G
4-HA,702,1428,0,0,0,1428,A
4-HA,703,1,1441,0,2,1444,T
4-HA,704,5,1,0,1440,1446,C
4-HA,705,0,1438,0,2,1440,T
4-HA,706,1437,1,1,0,1439,A
4-HA,707,0,4,1445,0,1449,G
4-HA,708,1457,0,2,0,1459,A
4-HA,709,0,2,0,1452,1454,C
4-HA,710,0,1,0,1399,1400,C
4-HA,711,1,0,0,1402,1403,C
4-HA,712,1400,1,1,0,1402,A
4-HA,713,0,0,1508,0,1508,G
4-HA,714,1502,0,0,0,1502,A
4-HA,715,1,1,1521,0,1523,G
4-HA,716,0,1512,0,0,1512,T
4-HA,717,1497,0,0,0,1497,A
4-HA,718,1498,1,1,0,1500,A
4-HA,719,1,1,1525,0,1527,G
4-HA,720,0,0,1535,0,1535,G
4-HA,721,1522,1,0,0,1523,A
4-HA,722,1406,0,0,0,1406,A
4-HA,723,0,1400,0,1,1401,T
4-HA,724,1412,1,0,0,1413,A
4-HA,725,0,1402,0,0,1402,T
4-HA,726,1,0,0,1412,1413,C
4-HA,727,2,1,0,1409,1412,C
4-HA,728,1,1,2,1377,1381,C
4-HA,729,0,1364,0,0,1364,T
4-HA,730,1369,0,0,0,1369,A
4-HA,731,0,0,1372,0,1372,G
4-HA,732,0,1,0,1367,1368,C
4-HA,733,1332,0,1,0,1333,A
4-HA,734,2,2,1371,0,1375,G
4-HA,735,1354,0,0,0,1354,A
4-HA,736,1356,0,0,0,1356,A
4-HA,737,0,1360,0,0,1360,T
4-HA,738,1352,0,1,1,1354,A
4-HA,739,1357,0,2,1,1360,A
4-HA,740,0,0,1358,0,1358,G
4-HA,741,0,0,0,1362,1362,C
4-HA,742,1366,0,0,1,1367,A
4-HA,743,1,1330,0,3,1334,T
4-HA,744,2,1,0,1425,1428,C
4-HA,745,1,1419,0,0,1420,T
4-HA,746,1434,0,0,0,1434,A
4-HA,747,1,1434,0,0,1435,T
4-HA,748,0,1419,0,1,1420,T
4-HA,749,0,0,1434,0,1434,G
4-HA,750,1,3,1430,0,1434,G
4-HA,751,1434,1,0,0,1435,A
4-HA,752,1,0,0,1428,1429,C
4-HA,753,1338,0,1,0,1339,A
4-HA,754,1370,0,0,0,1370,A
4-HA,755,0,1431,0,0,1431,T
4-HA,756,1433,0,0,0,1433,A
4-HA,757,0,0,1446,0,1446,G
4-HA,758,1,1426,0,0,1427,T
4-HA,759,1426,0,0,2,1428,A
4-HA,760,1430,1,0,0,1431,A
4-HA,761,1437,0,0,0,1437,A
4-HA,762,1445,0,1,0,1446,A
4-HA,763,0,0,0,1446,1446,C
4-HA,764,1,1,0,1364,1366,C
4-HA,765,1,2,1364,0,1367,G
4-HA,766,0,1,1369,0,1370,G
4-HA,767,0,0,1382,0,1382,G
4-HA,768,1379,1,2,0,1382,A
4-HA,769,0,2,1379,0,1381,G
4-HA,770,1383,0,2,0,1385,A
4-HA,771,0,0,0,1385,1385,C
4-HA,772,1382,0,1,0,1383,A
4-HA,773,0,1384,0,0,1384,T
4-HA,774,1388,0,2,0,1390,A
4-HA,775,1,1,0,1403,1405,C
4-HA,776,0,1389,0,2,1391,T
4-HA,777,1,1392,0,0,1393,T
4-HA,778,0,1401,0,0,1401,T
4-HA,779,0,1395,0,1,1396,T
4-HA,780,2,3,1397,0,1402,G
4-HA,781,1395,1,1,0,1397,A
4-HA,782,1,1395,0,2,1398,T
4-HA,783,0,1412,1,0,1413,T
4-HA,784,1398,0,0,1,1399,A
4-HA,785,1395,0,2,2,1399,A
4-HA,786,0,1,0,1408,1409,C
4-HA,787,1398,0,1,1,1400,A
4-HA,788,0,0,1446,0,1446,G
4-HA,789,0,0,0,1441,1441,C
4-HA,790,1437,0,0,0,1437,A
4-HA,791,0,0,0,1438,1438,C
4-HA,792,1427,0,5,0,1432,A
4-HA,793,1,2,1445,0,1448,G
4-HA,794,1,0,1439,0,1440,G
4-HA,795,0,5,1479,0,1484,G
4-HA,796,1475,0,2,0,1477,A
4-HA,797,1468,0,0,0,1468,A
4-HA,798,0,1462,0,3,1465,T
4-HA,799,2,0,0,1462,1464,C
4-HA,800,1,1461,0,1,1463,T
4-HA,801,1470,0,0,1,1471,A
4-HA,802,1458,0,0,0,1458,A
4-HA,803,0,1454,0,0,1454,T
4-HA,804,0,1403,0,0,1403,T
4-HA,805,1,0,1410,0,1411,G
4-HA,806,1,1,0,1419,1421,C
4-HA,807,0,1436,0,6,1442,T
4-HA,808,2,0,0,1475,1477,C
4-HA,809,0,0,0,1469,1469,C
4-HA,810,0,1469,0,1,1470,T
4-HA,811,1474,0,2,0,1476,A
4-HA,812,1,0,1476,0,1477,G
4-HA,813,0,1,1480,0,1481,G
4-HA,814,0,2,1476,0,1478,G
4-HA,815,1,0,1463,0,1464,G
4-HA,816,1,1426,0,2,1429,T
4-HA,817,0,1412,0,0,1412,T
4-HA,818,1416,1,0,0,1417,A
4-HA,819,1,0,0,1429,1430,C
4-HA,820,0,1425,0,2,1427,T
4-HA,821,0,1425,0,0,1425,T
4-HA,822,1,0,0,1424,1425,C
4-HA,823,1404,0,1,2,1407,A
4-HA,824,1405,1,2,0,1408,A
4-HA,825,1415,0,0,0,1415,A
4-HA,826,1415,2,2,0,1419,A
4-HA,827,0,1418,0,0,1418,T
4-HA,828,1403,1,1,0,1405,A
4-HA,829,0,1,0,1401,1402,C
4-HA,830,1,1,1394,0,1396,G
4-HA,831,1396,0,1,0,1397,A
4-HA,832,1399,0,0,0,1399,A
4-HA,833,0,0,1413,0,1413,G
4-HA,834,0,1404,1,1,1406,T
4-HA,835,2,2,1411,0,1415,G
4-HA,836,0,0,1413,0,1413,G
4-HA,837,0,2,1416,0,1418,G
4-HA,838,1421,0,0,0,1421,A
4-HA,839,1414,0,2,0,1416,A
4-HA,840,1412,1,0,0,1413,A
4-HA,841,1410,1,5,0,1416,A
4-HA,842,0,0,1432,0,1432,G
4-HA,843,0,1,0,1431,1432,C
4-HA,844,1,1418,0,0,1419,T
4-HA,845,0,2,0,1418,1420,C
4-HA,846,1428,0,0,0,1428,A
4-HA,847,1434,1,1,0,1436,A
4-HA,848,0,1438,1,0,1439,T
4-HA,849,1444,0,1,0,1445,A
4-HA,850,1443,0,1,1,1445,A
4-HA,851,0,1404,0,2,1406,T
4-HA,852,1,4,1402,0,1407,G
4-HA,853,1390,0,1,0,1391,A
4-HA,854,0,1,1422,0,1423,G
4-HA,855,1421,0,3,0,1424,A
4-HA,856,1,1412,0,0,1413,T
4-HA,857,1,0,0,1431,1432,C
4-HA,858,1421,0,2,0,1423,A
4-HA,859,0,0,1443,0,1443,G
4-HA,860,1440,0,0,0,1440,A
4-HA,861,1,1435,0,0,1436,T
4-HA,862,3,0,1428,0,1431,G
4-HA,863,0,2,0,1395,1397,C
4-HA,864,1398,0,0,0,1398,A
4-HA,865,0,0,0,1427,1427,C
4-HA,866,4,0,0,1401,1405,C
4-HA,867,6,1,0,1405,1412,C
4-HA,868,1386,0,0,0,1386,A
4-HA,869,0,1380,0,1,1381,T
4-HA,870,0,1373,1,2,1376,T
4-HA,871,0,3,1388,0,1391,G
4-HA,872,0,3,1378,0,1381,G
4-HA,873,0,2,0,1382,1384,C
4-HA,874,1361,0,0,0,1361,A
4-HA,875,1359,0,2,0,1361,A
4-HA,876,1378,0,1,0,1379,A
4-HA,877,0,1375,0,1,1376,T
4-HA,878,0,0,1383,0,1383,G
4-HA,879,1,0,0,1379,1380,C
4-HA,880,1365,0,0,0,1365,A
4-HA,881,1401,0,1,0,1402,A
4-HA,882,1,1396,0,0,1397,T
4-HA,883,1,1401,0,1,1403,T
4-HA,884,0,0,0,1401,1401,C
4-HA,885,1,1368,0,1,1370,T
4-HA,886,0,4,1378,0,1382,G
4-HA,887,1381,1,0,0,1382,A
4-HA,888,1385,0,5,0,1390,A
4-HA,889,0,1385,0,1,1386,T
4-HA,890,0,0,1363,0,1363,G
4-HA,891,0,0,0,1367,1367,C
4-HA,892,1366,0,1,0,1367,A
4-HA,893,1,1363,0,2,1366,T
4-HA,894,0,0,1,1366,1367,C
4-HA,895,1352,0,2,0,1354,A
4-HA,896,1,0,0,1387,1388,C
4-HA,897,1,1377,0,0,1378,T
4-HA,898,2,1,0,1381,1384,C
4-HA,899,4,0,0,1374,1378,C
4-HA,900,1385,0,0,0,1385,A
4-HA,901,1382,0,0,0,1382,A
4-HA,902,1382,0,0,0,1382,A
4-HA,903,0,1328,0,0,1328,T
4-HA,904,0,1,1337,0,1338,G
4-HA,905,1,0,1333,0,1334,G
4-HA,906,1339,0,1,0,1340,A
4-HA,907,1328,1,3,0,1332,A
4-HA,908,1,0,1333,0,1334,G
4-HA,909,0,2,0,1307,1309,C
4-HA,910,1286,1,0,0,1287,A
4-HA,911,0,1282,0,4,1286,T
4-HA,912,0,1281,0,1,1282,T
4-HA,913,1,0,0,1322,1323,C
4-HA,914,0,0,0,1307,1307,C
4-HA,915,1,0,0,1310,1311,C
4-HA,916,1309,0,2,0,1311,A
4-HA,917,1329,0,0,3,1332,A
4-HA,918,0,1340,1,1,1342,T
4-HA,919,0,4,1338,0,1342,G
4-HA,920,1339,0,1,0,1340,A
4-HA,921,1,0,0,1337,1338,C
4-HA,922,1283,0,0,0,1283,A
4-HA,923,1289,0,1,0,1290,A
4-HA,924,1285,0,0,0,1285,A
4-HA,925,0,1,0,1290,1291,C
4-HA,926,3,0,0,1266,1269,C
4-HA,927,1246,0,0,1,1247,A
4-HA,928,0,1245,0,1,1246,T
4-HA,929,0,1243,1,1,1245,T
4-HA,930,4,0,0,1250,1254,C
4-HA,931,2,1,0,1245,1248,C
4-HA,932,1243,0,0,0,1243,A
4-HA,933,1243,0,0,0,1243,A
4-HA,934,1230,0,1,0,1231,A
4-HA,935,1242,0,1,0,1243,A
4-HA,936,0,1233,0,0,1233,T
4-HA,937,1,0,1240,0,1241,G
4-HA,938,0,1240,0,1,1241,T
4-HA,939,1245,0,1,0,1246,A
4-HA,940,1247,0,0,0,1247,A
4-HA,941,1243,0,2,1,1246,A
4-HA,942,0,0,0,1246,1246,C
4-HA,943,1220,1,2,0,1223,A
4-HA,944,0,1,1225,0,1226,G
4-HA,945,0,0,1227,0,1227,G
4-HA,946,1233,0,1,0,1234,A
4-HA,947,0,1226,0,0,1226,T
4-HA,948,4,1,1,1227,1233,C
4-HA,949,1235,0,2,0,1237,A
4-HA,950,1,1,0,1263,1265,C
4-HA,951,1259,1,1,0,1261,A
4-HA,952,0,1290,1,0,1291,T
4-HA,953,1249,0,1,0,1250,A
4-HA,954,0,0,0,1233,1233,C
4-HA,955,1,1,1193,0,1195,G
4-HA,956,0,1,1191,0,1192,G
4-HA,957,0,0,1184,0,1184,G
4-HA,958,0,1,1183,0,1184,G
4-HA,959,0,0,0,1135,1135,C
4-HA,960,0,1,0,1132,1133,C
4-HA,961,0,1098,0,2,1100,T
4-HA,962,0,0,1166,0,1166,G
4-HA,963,0,1158,0,1,1159,T
4-HA,964,2,1,0,1162,1165,C
4-HA,965,3,0,0,1158,1161,C
4-HA,966,1,0,0,1150,1151,C
4-HA,967,1139,0,2,0,1141,A
4-HA,968,0,0,1153,0,1153,G
4-HA,969,1153,0,0,0,1153,A
4-HA,970,0,1150,1,0,1151,T
4-HA,971,1014,0,1,0,1015,A
4-HA,972,0,988,0,1,989,T
4-HA,973,0,0,992,0,992,G
4-HA,974,2,984,0,1,987,T
4-HA,975,0,963,0,0,963,T
4-HA,976,968,2,0,0,970,A
4-HA,977,956,0,0,0,956,A
4-HA,978,0,1,958,0,959,G
4-HA,979,0,1,0,954,955,C
4-HA,980,928,0,0,0,928,A
4-HA,981,924,0,2,0,926,A
4-HA,982,915,0,0,0,915,A
4-HA,983,913,0,1,0,914,A
4-HA,984,0,0,0,913,913,C
4-HA,985,893,0,2,0,895,A
4-HA,986,0,0,1,905,906,C
4-HA,987,0,887,0,0,887,T
4-HA,988,2,0,0,891,893,C
4-HA,989,0,891,0,1,892,T
4-HA,990,1,2,891,0,894,G
4-HA,991,890,0,0,0,890,A
4-HA,992,889,0,0,0,889,A
4-HA,993,894,0,0,0,894,A
4-HA,994,0,877,0,1,878,T
4-HA,995,0,865,0,1,866,T
4-HA,996,1,2,867,0,870,G
4-HA,997,0,0,871,0,871,G
4-HA,998,1,1,0,874,876,C
4-HA,999,868,0,1,0,869,A
4-HA,1000,869,0,2,0,871,A
4-HA,1001,1,1,0,867,869,C
4-HA,1002,871,0,0,0,871,A
4-HA,1003,1,1,872,0,874,G
4-HA,1004,0,0,865,0,865,G
4-HA,1005,0,1,859,0,860,G
4-HA,1006,859,0,0,0,859,A
4-HA,1007,0,847,0,0,847,T
4-HA,1008,1,0,849,0,850,G
4-HA,1009,1,1,0,847,849,C
4-HA,1010,0,1,845,0,846,G
4-HA,1011,853,2,0,0,855,A
4-HA,1012,831,0,1,0,832,A
4-HA,1013,837,0,0,0,837,A
4-HA,1014,0,823,0,0,823,T
4-HA,1015,1,0,831,0,832,G
4-HA,1016,0,826,0,0,826,T
4-HA,1017,819,1,1,0,821,A
4-HA,1018,0,1,0,814,815,C
4-HA,1019,0,1,0,803,804,C
4-HA,1020,780,0,0,0,780,A
4-HA,1021,1,1,779,0,781,G
4-HA,1022,761,0,0,0,761,A
4-HA,1023,0,0,765,0,765,G
4-HA,1024,738,0,0,0,738,A
4-HA,1025,735,0,0,0,735,A
4-HA,1026,736,0,0,0,736,A
4-HA,1027,0,0,0,735,735,C
4-HA,1028,735,0,0,0,735,A
4-HA,1029,745,0,1,0,746,A
4-HA,1030,737,0,2,0,739,A
4-HA,1031,0,0,0,744,744,C
4-HA,1032,0,736,0,0,736,T
4-HA,1033,725,0,1,0,726,A
4-HA,1034,1,1,728,0,730,G
4-HA,1035,719,0,1,0,720,A
4-HA,1036,0,0,733,0,733,G
4-HA,1037,0,0,729,0,729,G
4-HA,1038,0,0,0,698,698,C
4-HA,1039,697,0,1,0,698,A
4-HA,1040,2,690,0,1,693,T
4-HA,1041,697,0,0,0,697,A
4-HA,1042,1,694,0,0,695,T
4-HA,1043,0,689,0,0,689,T
4-HA,1044,1,693,0,0,694,T
4-HA,1045,2,1,648,0,651,G
4-HA,1046,0,0,652,0,652,G
4-HA,1047,0,0,0,651,651,C
4-HA,1048,0,0,647,0,647,G
4-HA,1049,0,0,0,634,634,C
4-HA,1050,626,0,0,0,626,A
4-HA,1051,630,0,0,0,630,A
4-HA,1052,0,627,0,0,627,T
4-HA,1053,1,0,0,628,629,C
4-HA,1054,0,0,630,0,630,G
4-HA,1055,0,0,0,625,625,C
4-HA,1056,1,0,623,0,624,G
4-HA,1057,1,0,630,0,631,G
4-HA,1058,1,0,629,0,630,G
4-HA,1059,0,630,0,1,631,T
4-HA,1060,0,616,0,0,616,T
4-HA,1061,0,618,0,1,619,T
4-HA,1062,0,0,0,611,611,C
4-HA,1063,614,0,0,0,614,A
4-HA,1064,0,614,0,0,614,T
4-HA,1065,611,0,0,0,611,A
4-HA,1066,0,1,617,0,618,G
4-HA,1067,577,0,2,0,579,A
4-HA,1068,579,0,0,0,579,A
4-HA,1069,583,0,0,0,583,A
4-HA,1070,584,0,0,0,584,A
4-HA,1071,0,574,0,2,576,T
4-HA,1072,0,1,577,0,578,G
4-HA,1073,0,0,575,0,575,G
4-HA,1074,0,569,0,0,569,T
4-HA,1075,0,542,0,0,542,T
4-HA,1076,0,0,543,1,544,G
4-HA,1077,0,0,546,0,546,G
4-HA,1078,0,0,546,0,546,G
4-HA,1079,525,0,3,0,528,A
4-HA,1080,0,0,526,0,526,G
4-HA,1081,0,0,495,0,495,G
4-HA,1082,0,1,497,0,498,G
4-HA,1083,493,0,1,0,494,A
4-HA,1084,495,1,1,0,497,A
4-HA,1085,0,500,0,0,500,T
4-HA,1086,0,0,496,0,496,G
4-HA,1087,0,0,504,0,504,G
4-HA,1088,1,493,0,0,494,T
4-HA,1089,0,0,495,0,495,G
4-HA,1090,0,1,495,0,496,G
4-HA,1091,486,0,0,0,486,A
4-HA,1092,1,483,0,0,484,T
4-HA,1093,0,1,482,0,483,G
4-HA,1094,0,0,492,0,492,G
4-HA,1095,0,480,0,0,480,T
4-HA,1096,0,473,0,0,473,T
4-HA,1097,0,0,473,0,473,G
4-HA,1098,0,0,485,0,485,G
4-HA,1099,0,482,0,0,482,T
4-HA,1100,484,0,0,0,484,A
4-HA,1101,0,0,0,467,467,C
4-HA,1102,0,0,471,0,471,G
4-HA,1103,0,0,488,0,488,G
4-HA,1104,0,484,0,2,486,T
4-HA,1105,0,488,0,1,489,T
4-HA,1106,1,485,0,0,486,T
4-HA,1107,1,0,0,479,480,C
4-HA,1108,479,1,1,0,481,A
4-HA,1109,0,0,481,0,481,G
4-HA,1110,0,0,480,0,480,G
4-HA,1111,0,0,0,479,479,C
4-HA,1112,464,0,1,0,465,A
4-HA,1113,0,468,0,0,468,T
4-HA,1114,1,0,0,470,471,C
4-HA,1115,472,0,0,0,472,A
4-HA,1116,470,0,0,0,470,A
4-HA,1117,467,0,0,0,467,A
4-HA,1118,470,0,0,0,470,A
4-HA,1119,0,471,0,0,471,T
4-HA,1120,0,469,0,0,469,T
4-HA,1121,2,0,0,470,472,C
4-HA,1122,0,467,0,0,467,T
4-HA,1123,0,1,469,0,470,G
4-HA,1124,468,0,1,0,469,A
4-HA,1125,0,0,470,0,470,G
4-HA,1126,0,1,469,0,470,G
4-HA,1127,0,0,475,0,475,G
4-HA,1128,474,0,0,0,474,A
4-HA,1129,471,0,0,0,471,A
4-HA,1130,0,1,464,0,465,G
4-HA,1131,471,0,0,0,471,A
4-HA,1132,0,0,478,0,478,G
4-HA,1133,0,2,475,0,477,G
4-HA,1134,475,0,3,0,478,A
4-HA,1135,0,0,0,477,477,C
4-HA,1136,472,0,1,0,473,A
4-HA,1137,472,0,1,0,473,A
4-HA,1138,0,0,474,0,474,G
4-HA,1139,0,1,0,477,478,C
4-HA,1140,466,0,1,0,467,A
4-HA,1141,1,0,466,0,467,G
4-HA,1142,0,0,0,466,466,C
4-HA,1143,467,0,0,0,467,A
4-HA,1144,0,0,471,0,471,G
4-HA,1145,470,0,0,0,470,A
4-HA,1146,0,485,0,1,486,T
4-HA,1147,0,0,0,492,492,C
4-HA,1148,0,488,0,2,490,T
4-HA,1149,2,0,0,494,496,C
4-HA,1150,494,0,1,0,495,A
4-HA,1151,495,0,0,0,495,A
4-HA,1152,494,0,1,1,496,A
4-HA,1153,478,0,1,0,479,A
4-HA,1154,0,0,481,0,481,G
4-HA,1155,0,0,0,462,462,C
4-HA,1156,461,0,0,0,461,A
4-HA,1157,0,0,0,462,462,C
4-HA,1158,0,454,0,0,454,T
4-HA,1159,2,0,0,456,458,C
4-HA,1160,457,0,1,0,458,A
4-HA,1161,468,0,0,0,468,A
4-HA,1162,0,0,466,0,466,G
4-HA,1163,0,0,0,462,462,C
4-HA,1164,461,0,0,0,461,A
4-HA,1165,0,0,465,0,465,G
4-HA,1166,0,0,0,448,448,C
4-HA,1167,446,0,0,0,446,A
4-HA,1168,446,0,0,0,446,A
4-HA,1169,0,445,0,0,445,T
4-HA,1170,0,0,0,434,434,C
4-HA,1171,0,2,434,0,436,G
4-HA,1172,436,0,0,0,436,A
4-HA,1173,0,434,0,0,434,T
4-HA,1174,2,1,0,426,429,C
4-HA,1175,428,0,1,0,429,A
4-HA,1176,440,0,0,1,441,A
4-HA,1177,445,0,0,0,445,A
4-HA,1178,0,443,0,0,443,T
4-HA,1179,0,0,0,444,444,C
4-HA,1180,436,0,0,0,436,A
4-HA,1181,442,0,0,0,442,A
4-HA,1182,0,442,0,0,442,T
4-HA,1183,0,0,441,0,441,G
4-HA,1184,0,0,438,0,438,G
4-HA,1185,0,0,438,0,438,G
4-HA,1186,446,0,0,0,446,A
4-HA,1187,444,0,1,0,445,A
4-HA,1188,0,0,456,0,456,G
4-HA,1189,0,0,0,458,458,C
4-HA,1190,0,450,0,0,450,T
4-HA,1191,0,2,472,0,474,G
4-HA,1192,472,1,0,0,473,A
4-HA,1193,474,0,1,0,475,A
4-HA,1194,0,474,0,0,474,T
4-HA,1195,466,0,0,0,466,A
4-HA,1196,0,0,465,0,465,G
4-HA,1197,426,0,0,0,426,A
4-HA,1198,0,429,0,0,429,T
4-HA,1199,0,430,0,0,430,T
4-HA,1200,0,1,430,0,431,G
4-HA,1201,427,0,0,0,427,A
4-HA,1202,0,429,0,0,429,T
4-HA,1203,0,0,0,432,432,C
4-HA,1204,0,0,432,0,432,G
4-HA,1205,0,0,436,0,436,G
4-HA,1206,0,1,436,0,437,G
4-HA,1207,432,1,0,0,433,A
4-HA,1208,434,0,1,0,435,A
4-HA,1209,435,0,0,0,435,A
4-HA,1210,434,0,0,0,434,A
4-HA,1211,0,0,0,435,435,C
4-HA,1212,2,0,0,429,431,C
4-HA,1213,429,0,0,0,429,A
4-HA,1214,427,0,0,0,427,A
4-HA,1215,0,0,0,427,427,C
4-HA,1216,0,2,428,0,430,G
4-HA,1217,430,0,0,0,430,A
4-HA,1218,0,0,427,0,427,G
4-HA,1219,427,1,0,0,428,A
4-HA,1220,426,0,1,0,427,A
4-HA,1221,427,0,0,0,427,A
4-HA,1222,0,426,0,0,426,T
4-HA,1223,0,425,0,2,427,T
4-HA,1224,0,0,0,427,427,C
4-HA,1225,0,0,0,426,426,C
4-HA,1226,427,0,0,0,427,A
4-HA,1227,1,425,0,0,426,T
4-HA,1228,0,0,0,426,426,C
4-HA,1229,423,0,0,0,423,A
4-HA,1230,0,0,427,0,427,G
4-HA,1231,426,0,0,0,426,A
4-HA,1232,0,425,0,0,425,T
4-HA,1233,0,420,0,0,420,T
4-HA,1234,0,0,426,0,426,G
4-HA,1235,423,0,1,0,424,A
4-HA,1236,424,0,1,0,425,A
4-HA,1237,427,0,0,0,427,A
4-HA,1238,423,1,0,0,424,A
4-HA,1239,421,0,1,0,422,A
4-HA,1240,1,2,417,0,420,G
4-HA,1241,414,0,1,0,415,A
4-HA,1242,416,0,0,0,416,A
4-HA,1243,0,413,0,1,414,T
4-HA,1244,0,413,0,0,413,T
4-HA,1245,0,0,0,413,413,C
4-HA,1246,0,413,0,0,413,T
4-HA,1247,0,0,0,409,409,C
4-HA,1248,409,0,0,0,409,A
4-HA,1249,0,0,409,0,409,G
4-HA,1250,409,0,2,0,411,A
4-HA,1251,410,0,1,0,411,A
4-HA,1252,0,0,410,0,410,G
4-HA,1253,1,409,0,0,410,T
4-HA,1254,2,1,0,405,408,C
4-HA,1255,0,1,408,0,409,G
4-HA,1256,409,0,0,0,409,A
4-HA,1257,407,0,1,0,408,A
4-HA,1258,0,1,409,0,410,G
4-HA,1259,0,0,413,0,413,G
4-HA,1260,1,1,410,0,412,G
4-HA,1261,403,0,0,0,403,A
4-HA,1262,0,1,403,0,404,G
4-HA,1263,403,0,1,0,404,A
4-HA,1264,431,0,0,0,431,A
4-HA,1265,0,432,0,0,432,T
4-HA,1266,0,432,0,0,432,T
4-HA,1267,2,0,0,429,431,C
4-HA,1268,414,0,3,0,417,A
4-HA,1269,1,1,414,0,416,G
4-HA,1270,1,3,410,0,414,G
4-HA,1271,415,0,0,0,415,A
4-HA,1272,1,1,0,412,414,C
4-HA,1273,0,0,0,376,376,C
4-HA,1274,0,371,0,0,371,T
4-HA,1275,0,353,0,17,370,T
4-HA,1276,0,1,372,0,373,G
4-HA,1277,371,1,0,0,372,A
4-HA,1278,0,0,375,0,375,G
4-HA,1279,370,0,0,0,370,A
4-HA,1280,326,0,0,0,326,A
4-HA,1281,324,0,0,0,324,A
4-HA,1282,0,315,0,0,315,T
4-HA,1283,318,0,1,0,319,A
4-HA,1284,0,317,0,0,317,T
4-HA,1285,1,0,321,0,322,G
4-HA,1286,0,322,0,0,322,T
4-HA,1287,0,306,0,0,306,T
4-HA,1288,0,0,307,0,307,G
4-HA,1289,300,0,0,0,300,A
4-HA,1290,0,1,302,0,303,G
4-HA,1291,0,0,301,0,301,G
4-HA,1292,297,0,0,0,297,A
4-HA,1293,0,0,0,307,307,C
4-HA,1294,300,0,0,0,300,A
4-HA,1295,1,0,0,297,298,C
4-HA,1296,0,297,0,1,298,T
4-HA,1297,311,1,0,0,312,A
4-HA,1298,315,0,0,0,315,A
4-HA,1299,316,0,0,0,316,A
4-HA,1300,321,0,0,0,321,A
4-HA,1301,0,321,0,0,321,T
4-HA,1302,310,0,0,0,310,A
4-HA,1303,0,0,312,0,312,G
4-HA,1304,300,0,1,0,301,A
4-HA,1305,0,303,0,0,303,T
4-HA,1306,1,0,0,298,299,C
4-HA,1307,0,293,0,0,293,T
4-HA,1308,1,0,0,298,299,C
4-HA,1309,0,300,0,0,300,T
4-HA,1310,0,0,303,0,303,G
4-HA,1311,0,0,311,0,311,G
4-HA,1312,0,310,0,0,310,T
4-HA,1313,0,0,0,310,310,C
4-HA,1314,314,0,1,0,315,A
4-HA,1315,0,315,0,0,315,T
4-HA,1316,314,0,1,0,315,A
4-HA,1317,1,0,0,312,313,C
4-HA,1318,304,0,0,0,304,A
4-HA,1319,310,0,0,0,310,A
4-HA,1320,0,0,0,301,301,C
4-HA,1321,0,0,300,0,300,G
4-HA,1322,0,0,0,301,301,C
4-HA,1323,0,0,296,0,296,G
4-HA,1324,0,0,295,0,295,G
4-HA,1325,293,0,0,0,293,A
4-HA,1326,0,0,299,0,299,G
4-HA,1327,0,0,0,300,300,C
4-HA,1328,0,299,0,0,299,T
4-HA,1329,0,301,0,1,302,T
4-HA,1330,0,0,0,299,299,C
4-HA,1331,0,303,0,0,303,T
4-HA,1332,0,304,0,0,304,T
4-HA,1333,0,0,300,0,300,G
4-HA,1334,0,296,0,0,296,T
4-HA,1335,0,288,0,1,289,T
4-HA,1336,0,1,300,0,301,G
4-HA,1337,0,0,0,301,301,C
4-HA,1338,0,0,0,296,296,C
4-HA,1339,2,0,0,298,300,C
4-HA,1340,0,302,0,0,302,T
4-HA,1341,0,1,307,0,308,G
4-HA,1342,0,1,310,0,311,G
4-HA,1343,314,0,0,0,314,A
4-HA,1344,0,0,315,0,315,G
4-HA,1345,310,0,0,0,310,A
4-HA,1346,310,0,0,0,310,A
4-HA,1347,0,1,0,312,313,C
4-HA,1348,0,1,0,306,307,C
4-HA,1349,306,0,0,0,306,A
4-HA,1350,315,0,0,0,315,A
4-HA,1351,0,0,0,316,316,C
4-HA,1352,315,1,0,0,316,A
4-HA,1353,1,316,0,0,317,T
4-HA,1354,316,0,0,0,316,A
4-HA,1355,0,0,0,321,321,C
4-HA,1356,321,0,0,0,321,A
4-HA,1357,323,0,0,0,323,A
4-HA,1358,0,321,0,0,321,T
4-HA,1359,0,306,0,0,306,T
4-HA,1360,0,0,311,0,311,G
4-HA,1361,311,0,0,0,311,A
4-HA,1362,0,311,0,0,311,T
4-HA,1363,0,0,0,313,313,C
4-HA,1364,0,309,0,0,309,T
4-HA,1365,311,0,0,0,311,A
4-HA,1366,310,0,0,0,310,A
4-HA,1367,0,0,0,310,310,C
4-HA,1368,0,303,0,1,304,T
4-HA,1369,0,1,303,0,304,G
4-HA,1370,308,0,0,0,308,A
4-HA,1371,0,0,0,307,307,C
4-HA,1372,0,308,0,1,309,T
4-HA,1373,1,0,0,308,309,C
4-HA,1374,303,0,1,0,304,A
4-HA,1375,1,0,307,0,308,G
4-HA,1376,306,0,0,0,306,A
4-HA,1377,308,0,0,0,308,A
4-HA,1378,307,0,0,0,307,A
4-HA,1379,0,307,0,0,307,T
4-HA,1380,0,1,310,0,311,G
4-HA,1381,310,0,0,0,310,A
4-HA,1382,309,0,2,0,311,A
4-HA,1383,0,0,0,311,311,C
4-HA,1384,307,0,0,0,307,A
4-HA,1385,310,0,0,0,310,A
4-HA,1386,308,0,0,0,308,A
4-HA,1387,1,0,0,308,309,C
4-HA,1388,0,303,0,0,303,T
4-HA,1389,0,0,304,0,304,G
4-HA,1390,0,299,0,1,300,T
4-HA,1391,0,301,0,0,301,T
4-HA,1392,0,302,0,0,302,T
4-HA,1393,0,0,302,1,303,G
4-HA,1394,305,0,0,0,305,A
4-HA,1395,304,0,0,0,304,A
4-HA,1396,304,0,0,0,304,A
4-HA,1397,305,0,0,0,305,A
4-HA,1398,303,0,0,0,303,A
4-HA,1399,302,0,1,0,303,A
4-HA,1400,0,0,0,305,305,C
4-HA,1401,305,0,0,0,305,A
4-HA,1402,305,0,0,0,305,A
4-HA,1403,305,0,0,0,305,A
4-HA,1404,2,0,307,0,309,G
4-HA,1405,308,0,0,0,308,A
4-HA,1406,308,1,0,0,309,A
4-HA,1407,0,0,308,0,308,G
4-HA,1408,0,0,0,307,307,C
4-HA,1409,309,0,0,0,309,A
4-HA,1410,311,0,1,0,312,A
4-HA,1411,0,0,0,313,313,C
4-HA,1412,0,309,0,0,309,T
4-HA,1413,0,0,314,0,314,G
4-HA,1414,311,0,0,0,311,A
4-HA,1415,0,0,313,0,313,G
4-HA,1416,1,0,316,0,317,G
4-HA,1417,0,1,315,0,316,G
4-HA,1418,318,0,0,0,318,A
4-HA,1419,315,0,1,0,316,A
4-HA,1420,316,0,0,0,316,A
4-HA,1421,317,0,1,0,318,A
4-HA,1422,0,321,0,0,321,T
4-HA,1423,0,0,319,0,319,G
4-HA,1424,0,0,0,317,317,C
4-HA,1425,1,311,0,0,312,T
4-HA,1426,0,1,313,0,314,G
4-HA,1427,313,0,0,0,313,A
4-HA,1428,0,0,333,0,333,G
4-HA,1429,0,0,338,0,338,G
4-HA,1430,336,0,0,0,336,A
4-HA,1431,0,336,0,0,336,T
4-HA,1432,336,0,0,0,336,A
4-HA,1433,0,336,0,0,336,T
4-HA,1434,0,1,339,0,340,G
4-HA,1435,0,1,341,0,342,G
4-HA,1436,0,0,340,0,340,G
4-HA,1437,1,1,0,314,316,C
4-HA,1438,312,0,0,0,312,A
4-HA,1439,310,0,0,0,310,A
4-HA,1440,0,312,0,0,312,T
4-HA,1441,0,0,314,0,314,G
4-HA,1442,0,0,315,0,315,G
4-HA,1443,0,308,0,1,309,T
4-HA,1444,0,299,0,0,299,T
4-HA,1445,0,0,302,0,302,G
4-HA,1446,0,307,0,1,308,T
4-HA,1447,0,308,0,0,308,T
4-HA,1448,0,307,0,0,307,T
4-HA,1449,0,0,0,309,309,C
4-HA,1450,309,0,0,0,309,A
4-HA,1451,313,0,0,0,313,A
4-HA,1452,314,1,0,0,315,A
4-HA,1453,316,0,0,0,316,A
4-HA,1454,0,314,0,0,314,T
4-HA,1455,312,0,0,0,312,A
4-HA,1456,0,315,0,0,315,T
4-HA,1457,313,0,1,0,314,A
4-HA,1458,0,0,0,318,318,C
4-HA,1459,0,0,0,318,318,C
4-HA,1460,318,0,0,0,318,A
4-HA,1461,0,0,0,320,320,C
4-HA,1462,317,0,0,0,317,A
4-HA,1463,321,0,0,0,321,A
4-HA,1464,322,0,0,0,322,A
4-HA,1465,0,322,0,0,322,T
4-HA,1466,0,0,324,0,324,G
4-HA,1467,0,318,0,0,318,T
4-HA,1468,0,2,321,0,323,G
4-HA,1469,321,0,1,0,322,A
4-HA,1470,1,0,0,319,320,C
4-HA,1471,318,0,0,0,318,A
4-HA,1472,317,0,0,0,317,A
4-HA,1473,0,321,0,0,321,T
4-HA,1474,0,0,323,0,323,G
4-HA,1475,0,0,0,322,322,C
4-HA,1476,0,1,0,321,322,C
4-HA,1477,0,317,0,0,317,T
4-HA,1478,0,0,332,0,332,G
4-HA,1479,0,0,0,332,332,C
4-HA,1480,333,0,0,0,333,A
4-HA,1481,0,330,0,0,330,T
4-HA,1482,317,0,0,0,317,A
4-HA,1483,0,0,318,0,318,G
4-HA,1484,0,1,315,0,316,G
4-HA,1485,312,0,2,0,314,A
4-HA,1486,0,315,0,0,315,T
4-HA,1487,1,0,0,299,300,C
4-HA,1488,300,0,0,0,300,A
4-HA,1489,302,0,0,0,302,A
4-HA,1490,0,301,1,0,302,T
4-HA,1491,0,0,0,301,301,C
4-HA,1492,294,0,0,0,294,A
4-HA,1493,1,0,294,0,295,G
4-HA,1494,295,0,0,0,295,A
4-HA,1495,294,0,0,0,294,A
4-HA,1496,296,0,0,0,296,A
4-HA,1497,0,292,0,0,292,T
4-HA,1498,0,0,291,0,291,G
4-HA,1499,0,2,291,0,293,G
4-HA,1500,292,0,0,0,292,A
4-HA,1501,294,0,0,0,294,A
4-HA,1502,0,0,0,293,293,C
4-HA,1503,0,290,0,0,290,T
4-HA,1504,0,290,0,0,290,T
4-HA,1505,291,0,0,0,291,A
4-HA,1506,0,291,0,0,291,T
4-HA,1507,0,0,290,0,290,G
4-HA,1508,290,0,0,0,290,A
4-HA,1509,0,0,0,290,290,C
4-HA,1510,0,0,0,283,283,C
4-HA,1511,281,0,1,0,282,A
4-HA,1512,0,0,0,292,292,C
4-HA,1513,0,1,296,0,297,G
4-HA,1514,310,0,0,0,310,A
4-HA,1515,0,311,0,0,311,T
4-HA,1516,0,0,320,0,320,G
4-HA,1517,0,316,0,0,316,T
4-HA,1518,325,0,0,0,325,A
4-HA,1519,0,324,0,0,324,T
4-HA,1520,322,0,1,0,323,A
4-HA,1521,0,0,0,322,322,C
4-HA,1522,277,0,0,0,277,A
4-HA,1523,0,0,279,0,279,G
4-HA,1524,256,0,0,0,256,A
4-HA,1525,0,0,251,0,251,G
4-HA,1526,249,0,0,0,249,A
4-HA,1527,0,231,0,0,231,T
4-HA,1528,0,0,231,0,231,G
4-HA,1529,231,0,1,0,232,A
4-HA,1530,231,0,1,0,232,A
4-HA,1531,0,0,238,0,238,G
4-HA,1532,0,0,0,231,231,C
4-HA,1533,231,0,0,0,231,A
4-HA,1534,0,229,0,0,229,T
4-HA,1535,0,230,0,0,230,T
4-HA,1536,231,0,0,0,231,A
4-HA,1537,230,0,0,0,230,A
4-HA,1538,230,0,0,1,231,A
4-HA,1539,0,0,0,231,231,C
4-HA,1540,216,0,0,0,216,A
4-HA,1541,216,0,0,0,216,A
4-HA,1542,0,0,0,216,216,C
4-HA,1543,0,0,0,216,216,C
4-HA,1544,0,1,215,0,216,G
4-HA,1545,0,0,221,0,221,G
4-HA,1546,0,220,0,0,220,T
4-HA,1547,0,218,0,1,219,T
4-HA,1548,0,216,0,0,216,T
4-HA,1549,0,1,0,219,220,C
4-HA,1550,219,0,1,0,220,A
4-HA,1551,0,0,227,0,227,G
4-HA,1552,226,0,0,0,226,A
4-HA,1553,0,223,0,1,224,T
4-HA,1554,1,0,0,219,220,C
4-HA,1555,219,0,0,0,219,A
4-HA,1556,219,0,0,0,219,A
4-HA,1557,0,2,213,0,215,G
4-HA,1558,0,0,218,0,218,G
4-HA,1559,0,0,218,0,218,G
4-HA,1560,210,0,0,0,210,A
4-HA,1561,0,0,211,0,211,G
4-HA,1562,0,210,0,0,210,T
4-HA,1563,0,211,0,0,211,T
4-HA,1564,0,1,213,0,214,G
4-HA,1565,212,0,0,0,212,A
4-HA,1566,1,0,212,0,213,G
4-HA,1567,0,0,0,211,211,C
4-HA,1568,0,209,0,0,209,T
4-HA,1569,0,0,210,0,210,G
4-HA,1570,209,0,0,1,210,A
4-HA,1571,209,0,0,0,209,A
4-HA,1572,0,0,209,0,209,G
4-HA,1573,0,206,0,0,206,T
4-HA,1574,1,0,0,205,206,C
4-HA,1575,202,0,0,0,202,A
4-HA,1576,0,0,202,0,202,G
4-HA,1577,1,0,199,1,201,G
4-HA,1578,0,0,192,0,192,G
4-HA,1579,0,198,0,1,199,T
4-HA,1580,200,0,0,0,200,A
4-HA,1581,0,0,0,197,197,C
4-HA,1582,199,0,0,0,199,A
4-HA,1583,198,0,1,0,199,A
4-HA,1584,197,0,0,0,197,A
4-HA,1585,0,0,198,0,198,G
4-HA,1586,191,1,0,0,192,A
4-HA,1587,0,187,0,0,187,T
4-HA,1588,0,185,0,0,185,T
4-HA,1589,0,0,186,0,186,G
4-HA,1590,0,1,182,0,183,G
4-HA,1591,182,0,1,0,183,A
4-HA,1592,0,184,0,0,184,T
4-HA,1593,0,0,0,183,183,C
4-HA,1594,0,0,0,179,179,C
4-HA,1595,0,176,0,0,176,T
4-HA,1596,177,0,0,0,177,A
4-HA,1597,0,177,0,0,177,T
4-HA,1598,0,0,179,0,179,G
4-HA,1599,0,2,179,0,181,G
4-HA,1600,177,0,0,0,177,A
4-HA,1601,0,177,0,0,177,T
4-HA,1602,0,178,0,0,178,T
4-HA,1603,0,176,0,0,176,T
4-HA,1604,0,0,0,177,177,C
4-HA,1605,0,0,0,174,174,C
4-HA,1606,0,170,0,0,170,T
4-HA,1607,0,171,0,0,171,T
4-HA,1608,0,171,0,0,171,T
4-HA,1609,0,0,172,0,172,G
4-HA,1610,0,0,0,172,172,C
4-HA,1611,0,0,0,172,172,C
4-HA,1612,170,0,0,0,170,A
4-HA,1613,0,170,0,0,170,T
4-HA,1614,174,0,0,0,174,A
4-HA,1615,0,174,0,0,174,T
4-HA,1616,0,0,0,172,172,C
4-HA,1617,172,0,0,0,172,A
4-HA,1618,0,170,0,0,170,T
4-HA,1619,1,0,171,0,172,G
4-HA,1620,0,171,0,0,171,T
4-HA,1621,0,167,0,0,167,T
4-HA,1622,0,166,0,0,166,T
4-HA,1623,0,163,0,0,163,T
4-HA,1624,0,162,0,0,162,T
4-HA,1625,0,163,0,0,163,T
4-HA,1626,0,0,163,0,163,G
4-HA,1627,0,0,0,163,163,C
4-HA,1628,0,160,0,0,160,T
4-HA,1629,0,157,0,1,158,T
4-HA,1630,0,159,0,0,159,T
4-HA,1631,0,0,161,0,161,G
4-HA,1632,0,160,0,1,161,T
4-HA,1633,0,0,162,0,162,G
4-HA,1634,0,162,0,0,162,T
4-HA,1635,0,155,0,0,155,T
4-HA,1636,0,0,158,0,158,G
4-HA,1637,0,0,0,157,157,C
4-HA,1638,1,156,0,0,157,T
4-HA,1639,0,157,0,0,157,T
4-HA,1640,0,147,0,0,147,T
4-HA,1641,0,0,147,0,147,G
4-HA,1642,0,147,0,0,147,T
4-HA,1643,0,146,0,0,146,T
4-HA,1644,0,0,145,0,145,G
4-HA,1645,0,0,144,0,144,G
4-HA,1646,0,0,145,0,145,G
4-HA,1647,0,0,145,0,145,G
4-HA,1648,0,141,0,0,141,T
4-HA,1649,0,141,0,0,141,T
4-HA,1650,0,0,0,138,138,C
4-HA,1651,135,0,0,0,135,A
4-HA,1652,0,135,1,0,136,T
4-HA,1653,0,0,0,135,135,C
4-HA,1654,133,0,0,0,133,A
4-HA,1655,0,128,0,0,128,T
4-HA,1656,0,0,128,0,128,G
4-HA,1657,0,126,0,0,126,T
4-HA,1658,0,0,125,0,125,G
4-HA,1659,0,0,122,0,122,G
4-HA,1660,0,0,122,0,122,G
4-HA,1661,0,0,0,117,117,C
4-HA,1662,0,0,0,114,114,C
4-HA,1663,0,104,0,0,104,T
4-HA,1664,0,0,105,0,105,G
4-HA,1665,0,1,0,104,105,C
4-HA,1666,1,0,0,104,105,C
4-HA,1667,103,0,0,0,103,A
4-HA,1668,103,0,0,0,103,A
4-HA,1669,102,0,0,0,102,A
4-HA,1670,102,0,0,0,102,A
4-HA,1671,101,0,0,0,101,A
4-HA,1672,0,0,102,0,102,G
4-HA,1673,0,0,100,0,100,G
4-HA,1674,0,0,0,100,100,C
4-HA,1675,99,0,0,0,99,A
4-HA,1676,101,0,0,0,101,A
4-HA,1677,0,0,0,102,102,C
4-HA,1678,102,0,0,0,102,A
4-HA,1679,0,101,0,0,101,T
4-HA,1680,0,100,0,0,100,T
4-HA,1681,100,0,0,0,100,A
4-HA,1682,0,1,99,0,100,G
4-HA,1683,0,0,99,0,99,G
4-HA,1684,0,92,0,0,92,T
4-HA,1685,0,1,82,0,83,G
4-HA,1686,0,0,0,81,81,C
4-HA,1687,81,0,0,0,81,A
4-HA,1688,80,0,0,0,80,A
4-HA,1689,0,0,0,80,80,C
4-HA,1690,81,0,0,0,81,A
4-HA,1691,0,77,0,0,77,T
4-HA,1692,0,73,0,0,73,T
4-HA,1693,0,73,0,0,73,T
4-HA,1694,0,0,72,0,72,G
4-HA,1695,0,0,0,73,73,C
4-HA,1696,72,0,0,0,72,A
4-HA,1697,0,67,0,0,67,T
4-HA,1698,0,63,0,0,63,T
4-HA,1699,0,63,0,0,63,T
4-HA,1700,0,0,63,0,63,G
4-HA,1701,57,0,0,0,57,A
5-NP,1,410,0,0,0,410,A
5-NP,2,0,414,0,0,414,T
5-NP,3,0,0,413,0,413,G
5-NP,4,0,0,416,0,416,G
5-NP,5,1,1,0,416,418,C
5-NP,6,0,0,425,1,426,G
5-NP,7,0,456,0,1,457,T
5-NP,8,0,0,0,462,462,C
5-NP,9,0,0,0,467,467,C
5-NP,10,1,0,0,467,468,C
5-NP,11,467,0,2,0,469,A
5-NP,12,470,0,0,0,470,A
5-NP,13,0,0,472,0,472,G
5-NP,14,0,0,488,0,488,G
5-NP,15,0,0,0,487,487,C
5-NP,16,492,0,0,0,492,A
5-NP,17,0,0,0,503,503,C
5-NP,18,0,0,0,503,503,C
5-NP,19,508,0,0,0,508,A
5-NP,20,507,0,0,0,507,A
5-NP,21,512,0,0,0,512,A
5-NP,22,0,1,0,511,512,C
5-NP,23,0,1,511,0,512,G
5-NP,24,0,0,559,0,559,G
5-NP,25,0,560,0,1,561,T
5-NP,26,1,0,0,620,621,C
5-NP,27,0,621,0,0,621,T
5-NP,28,0,629,0,0,629,T
5-NP,29,630,0,0,0,630,A
5-NP,30,0,628,1,0,629,T
5-NP,31,0,2,633,0,635,G
5-NP,32,635,0,1,0,636,A
5-NP,33,622,0,1,0,623,A
5-NP,34,0,0,0,627,627,C
5-NP,35,617,0,0,0,617,A
5-NP,36,0,0,672,0,672,G
5-NP,37,668,0,0,0,668,A
5-NP,38,0,668,0,0,668,T
5-NP,39,0,0,672,1,673,G
5-NP,40,1,1,673,0,675,G
5-NP,41,676,0,1,0,677,A
5-NP,42,678,0,1,0,679,A
5-NP,43,678,1,1,0,680,A
5-NP,44,0,0,0,703,703,C
5-NP,45,0,692,0,0,692,T
5-NP,46,0,2,702,0,704,G
5-NP,47,699,0,0,1,700,A
5-NP,48,0,700,1,0,701,T
5-NP,49,0,1,701,0,702,G
5-NP,50,0,1,707,0,708,G
5-NP,51,0,2,704,0,706,G
5-NP,52,0,0,711,0,711,G
5-NP,53,707,1,1,0,709,A
5-NP,54,0,709,0,0,709,T
5-NP,55,0,0,0,713,713,C
5-NP,56,0,0,717,0,717,G
5-NP,57,0,0,0,726,726,C
5-NP,58,0,1,0,727,728,C
5-NP,59,726,1,0,0,727,A
5-NP,60,0,0,738,0,738,G
5-NP,61,736,0,0,0,736,A
5-NP,62,749,0,1,0,750,A
5-NP,63,0,747,1,1,749,T
5-NP,64,0,0,750,0,750,G
5-NP,65,0,0,0,754,754,C
5-NP,66,750,0,0,0,750,A
5-NP,67,772,0,0,0,772,A
5-NP,68,1,0,0,771,772,C
5-NP,69,0,769,0,0,769,T
5-NP,70,0,1,770,0,771,G
5-NP,71,778,0,0,0,778,A
5-NP,72,0,1,821,0,822,G
5-NP,73,817,0,0,0,817,A
5-NP,74,0,814,1,0,815,T
5-NP,75,0,818,1,0,819,T
5-NP,76,813,1,0,0,814,A
5-NP,77,0,0,818,0,818,G
5-NP,78,2,1,810,0,813,G
5-NP,79,1,1,815,0,817,G
5-NP,80,0,0,0,807,807,C
5-NP,81,797,0,1,0,798,A
5-NP,82,0,797,0,0,797,T
5-NP,83,1,0,0,798,799,C
5-NP,84,0,0,0,797,797,C
5-NP,85,0,0,808,0,808,G
5-NP,86,0,809,0,0,809,T
5-NP,87,1,0,0,807,808,C
5-NP,88,0,0,808,0,808,G
5-NP,89,0,0,810,0,810,G
5-NP,90,0,0,819,0,819,G
5-NP,91,817,0,0,0,817,A
5-NP,92,819,1,0,0,820,A
5-NP,93,0,0,827,0,827,G
5-NP,94,819,0,2,0,821,A
5-NP,95,1,831,0,0,832,T
5-NP,96,1,2,836,0,839,G
5-NP,97,835,1,3,0,839,A
5-NP,98,0,839,1,0,840,T
5-NP,99,1,834,0,0,835,T
5-NP,100,1,0,835,0,836,G
5-NP,101,832,0,1,0,833,A
5-NP,102,1,831,0,0,832,T
5-NP,103,0,2,823,0,825,G
5-NP,104,0,0,824,0,824,G
5-NP,105,1,4,812,0,817,G
5-NP,106,855,1,1,0,857,A
5-NP,107,0,856,0,0,856,T
5-NP,108,0,858,0,0,858,T
5-NP,109,2,0,863,0,865,G
5-NP,110,0,0,866,0,866,G
5-NP,111,0,2,867,0,869,G
5-NP,112,862,1,1,0,864,A
5-NP,113,0,0,864,0,864,G
5-NP,114,854,0,0,0,854,A
5-NP,115,0,868,0,0,868,T
5-NP,116,0,871,0,0,871,T
5-NP,117,5,0,0,874,879,C
5-NP,118,1,869,0,1,871,T
5-NP,119,888,1,1,0,890,A
5-NP,120,1,0,0,891,892,C
5-NP,121,914,0,0,0,914,A
5-NP,122,0,916,0,1,917,T
5-NP,123,1,0,0,913,914,C
5-NP,124,1,1,0,918,920,C
5-NP,125,923,0,0,0,923,A
5-NP,126,944,1,0,0,945,A
5-NP,127,944,0,0,0,944,A
5-NP,128,0,941,0,0,941,T
5-NP,129,1,0,942,0,943,G
5-NP,130,0,932,0,1,933,T
5-NP,131,0,0,940,0,940,G
5-NP,132,0,1,0,938,939,C
5-NP,133,936,0,0,0,936,A
5-NP,134,0,0,0,934,934,C
5-NP,135,0,924,0,1,925,T
5-NP,136,0,1,965,0,966,G
5-NP,137,981,0,2,0,983,A
5-NP,138,993,0,3,0,996,A
5-NP,139,0,1,0,1008,1009,C
5-NP,140,0,1003,0,0,1003,T
5-NP,141,0,1004,0,0,1004,T
5-NP,142,1005,1,0,1,1007,A
5-NP,143,1006,0,1,0,1007,A
5-NP,144,1008,0,1,0,1009,A
5-NP,145,0,1,0,1014,1015,C
5-NP,146,0,977,0,0,977,T
5-NP,147,0,1,0,980,981,C
5-NP,148,961,0,0,0,961,A
5-NP,149,0,0,979,0,979,G
5-NP,150,0,978,0,0,978,T
5-NP,151,0,4,987,0,991,G
5-NP,152,1000,0,1,0,1001,A
5-NP,153,0,1002,0,0,1002,T
5-NP,154,2,1,0,1016,1019,C
5-NP,155,1022,0,2,0,1024,A
5-NP,156,1,1018,0,0,1019,T
5-NP,157,1,1,1017,0,1019,G
5-NP,158,1013,0,0,0,1013,A
5-NP,159,1008,0,4,0,1012,A
5-NP,160,0,1,1006,0,1007,G
5-NP,161,0,1,999,0,1000,G
5-NP,162,0,0,1001,0,1001,G
5-NP,163,1,0,0,996,997,C
5-NP,164,1,1,1001,0,1003,G
5-NP,165,1,0,1009,0,1010,G
5-NP,166,0,1005,0,3,1008,T
5-NP,167,0,1008,0,2,1010,T
5-NP,168,0,3,1008,0,1011,G
5-NP,169,1136,0,0,0,1136,A
5-NP,170,0,1136,0,1,1137,T
5-NP,171,1,0,0,1134,1135,C
5-NP,172,0,0,0,1137,1137,C
5-NP,173,1132,0,1,0,1133,A
5-NP,174,0,3,1132,1,1136,G
5-NP,175,1134,0,2,0,1136,A
5-NP,176,1134,0,1,1,1136,A
5-NP,177,0,0,0,1139,1139,C
5-NP,178,1080,0,0,0,1080,A
5-NP,179,0,0,1094,0,1094,G
5-NP,180,0,0,0,1090,1090,C
5-NP,181,0,1092,0,0,1092,T
5-NP,182,0,1099,0,0,1099,T
5-NP,183,0,1,1092,0,1093,G
5-NP,184,1102,1,1,0,1104,A
5-NP,185,0,0,0,1113,1113,C
5-NP,186,1107,0,1,0,1108,A
5-NP,187,1116,0,0,0,1116,A
5-NP,188,0,1105,0,0,1105,T
5-NP,189,1103,1,0,0,1104,A
5-NP,190,0,3,1111,0,1114,G
5-NP,191,1103,1,1,0,1105,A
5-NP,192,0,4,1113,0,1117,G
5-NP,193,1108,0,0,0,1108,A
5-NP,194,1120,0,0,0,1120,A
5-NP,195,1118,0,1,1,1120,A
5-NP,196,1118,0,1,0,1119,A
5-NP,197,1,1122,0,0,1123,T
5-NP,198,0,2,1120,0,1122,G
5-NP,199,0,2,1116,1,1119,G
5-NP,200,0,1105,0,1,1106,T
5-NP,201,1083,0,2,0,1085,A
5-NP,202,0,0,0,1093,1093,C
5-NP,203,0,1092,0,0,1092,T
5-NP,204,1,0,0,1098,1099,C
5-NP,205,0,1088,0,1,1089,T
5-NP,206,1,1,0,1091,1093,C
5-NP,207,0,4,1073,0,1077,G
5-NP,208,0,0,1078,0,1078,G
5-NP,209,0,0,0,1078,1078,C
5-NP,210,0,1077,0,0,1077,T
5-NP,211,0,1078,0,0,1078,T
5-NP,212,0,1073,1,0,1074,T
5-NP,213,0,1078,0,2,1080,T
5-NP,214,0,0,1084,0,1084,G
5-NP,215,1080,0,1,2,1083,A
5-NP,216,0,1083,0,0,1083,T
5-NP,217,1,1,1082,0,1084,G
5-NP,218,1080,0,3,0,1083,A
5-NP,219,1080,0,0,0,1080,A
5-NP,220,1082,0,0,0,1082,A
5-NP,221,0,0,1084,0,1084,G
5-NP,222,1084,0,0,0,1084,A
5-NP,223,1082,0,0,0,1082,A
5-NP,224,1,0,1088,0,1089,G
5-NP,225,1,0,1116,0,1117,G
5-NP,226,1118,0,0,0,1118,A
5-NP,227,1123,0,1,0,1124,A
5-NP,228,0,1128,0,0,1128,T
5-NP,229,1124,0,1,0,1125,A
5-NP,230,1121,0,0,0,1121,A
5-NP,231,1136,0,0,0,1136,A
5-NP,232,1,1135,0,0,1136,T
5-NP,233,1136,0,0,0,1136,A
5-NP,234,0,0,0,1126,1126,C
5-NP,235,0,0,0,1105,1105,C
5-NP,236,0,1089,1,0,1090,T
5-NP,237,0,0,1100,0,1100,G
5-NP,238,1,1,1105,0,1107,G
5-NP,239,1111,0,0,0,1111,A
5-NP,240,1108,1,0,0,1109,A
5-NP,241,1,3,1114,0,1118,G
5-NP,242,1112,1,0,0,1113,A
5-NP,243,1110,0,2,0,1112,A
5-NP,244,0,0,0,1114,1114,C
5-NP,245,1112,0,1,0,1113,A
5-NP,246,0,1,0,1142,1143,C
5-NP,247,1,0,0,1123,1124,C
5-NP,248,4,0,0,1118,1122,C
5-NP,249,1,0,0,1125,1126,C
5-NP,250,1113,0,0,0,1113,A
5-NP,251,0,2,1116,0,1118,G
5-NP,252,2,0,0,1111,1113,C
5-NP,253,0,0,1113,0,1113,G
5-NP,254,0,2,0,1112,1114,C
5-NP,255,1,0,1093,0,1094,G
5-NP,256,0,1,1106,0,1107,G
5-NP,257,1,0,1100,0,1101,G
5-NP,258,0,1,1107,0,1108,G
5-NP,259,1104,0,2,0,1106,A
5-NP,260,1106,0,0,0,1106,A
5-NP,261,1103,0,2,0,1105,A
5-NP,262,0,1,1107,0,1108,G
5-NP,263,1105,1,1,0,1107,A
5-NP,264,0,1097,0,0,1097,T
5-NP,265,2,1,0,1089,1092,C
5-NP,266,2,2,0,1086,1090,C
5-NP,267,1,1,0,1098,1100,C
5-NP,268,1101,0,0,0,1101,A
5-NP,269,1098,0,0,1,1099,A
5-NP,270,0,2,1102,0,1104,G
5-NP,271,1094,0,0,0,1094,A
5-NP,272,1092,1,2,0,1095,A
5-NP,273,1093,0,1,0,1094,A
5-NP,274,1096,0,1,0,1097,A
5-NP,275,0,0,0,1091,1091,C
5-NP,276,0,1078,0,0,1078,T
5-NP,277,2,0,1073,0,1075,G
5-NP,278,0,2,1081,0,1083,G
5-NP,279,1,0,1082,0,1083,G
5-NP,280,1,0,1078,0,1079,G
5-NP,281,0,1,1084,0,1085,G
5-NP,282,0,0,1099,0,1099,G
5-NP,283,1,0,1,1170,1172,C
5-NP,284,0,0,0,1168,1168,C
5-NP,285,0,0,0,1179,1179,C
5-NP,286,1368,0,0,1,1369,A
5-NP,287,0,1376,0,1,1377,T
5-NP,288,1461,0,0,0,1461,A
5-NP,289,1,1465,0,0,1466,T
5-NP,290,1448,0,0,0,1448,A
5-NP,291,0,0,0,1462,1462,C
5-NP,292,1343,0,1,0,1344,A
5-NP,293,1,0,1363,0,1364,G
5-NP,294,0,1,1359,0,1360,G
5-NP,295,1211,0,0,0,1211,A
5-NP,296,0,2,1220,1,1223,G
5-NP,297,1160,0,1,0,1161,A
5-NP,298,0,0,1175,1,1176,G
5-NP,299,0,1178,0,1,1179,T
5-NP,300,1160,0,0,1,1161,A
5-NP,301,0,1,1162,0,1163,G
5-NP,302,1148,0,0,0,1148,A
5-NP,303,1,1146,0,1,1148,T
5-NP,304,0,1,1148,0,1149,G
5-NP,305,0,1,1149,0,1150,G
5-NP,306,1150,0,1,0,1151,A
5-NP,307,1141,0,1,0,1142,A
5-NP,308,1146,0,0,0,1146,A
5-NP,309,1150,0,0,0,1150,A
5-NP,310,0,1149,0,0,1149,T
5-NP,311,0,0,1152,0,1152,G
5-NP,312,0,1,1148,0,1149,G
5-NP,313,1152,0,0,0,1152,A
5-NP,314,0,1141,0,2,1143,T
5-NP,315,0,2,1141,0,1143,G
5-NP,316,1135,0,0,0,1135,A
5-NP,317,0,3,1135,0,1138,G
5-NP,318,0,0,1135,0,1135,G
5-NP,319,0,2,1138,0,1140,G
5-NP,320,1142,1,2,0,1145,A
5-NP,321,1141,0,3,0,1144,A
5-NP,322,0,0,0,1149,1149,C
5-NP,323,1,1146,0,1,1148,T
5-NP,324,0,0,0,1147,1147,C
5-NP,325,0,0,1156,1,1157,G
5-NP,326,1,1152,0,0,1153,T
5-NP,327,1,0,0,1153,1154,C
5-NP,328,2,0,0,1200,1202,C
5-NP,329,0,1183,1,3,1187,T
5-NP,330,0,1191,0,0,1191,T
5-NP,331,0,1188,0,1,1189,T
5-NP,332,1191,0,2,0,1193,A
5-NP,333,1,1188,0,0,1189,T
5-NP,334,0,3,1183,0,1186,G
5-NP,335,1187,0,3,0,1190,A
5-NP,336,0,0,0,1186,1186,C
5-NP,337,1156,0,0,0,1156,A
5-NP,338,1156,0,1,0,1157,A
5-NP,339,1152,0,2,0,1154,A
5-NP,340,0,0,1188,0,1188,G
5-NP,341,1185,0,0,0,1185,A
5-NP,342,1186,1,1,0,1188,A
5-NP,343,0,2,1222,0,1224,G
5-NP,344,1227,0,0,0,1227,A
5-NP,345,1221,1,0,1,1223,A
5-NP,346,1224,0,0,0,1224,A
5-NP,347,0,1224,0,0,1224,T
5-NP,348,1221,0,1,0,1222,A
5-NP,349,1206,0,0,0,1206,A
5-NP,350,0,1,1207,0,1208,G
5-NP,351,1,0,1210,0,1211,G
5-NP,352,0,0,0,1200,1200,C
5-NP,353,0,4,1199,0,1203,G
5-NP,354,1201,0,1,0,1202,A
5-NP,355,1211,0,0,0,1211,A
5-NP,356,0,1207,0,0,1207,T
5-NP,357,1,0,0,1210,1211,C
5-NP,358,0,1211,0,2,1213,T
5-NP,359,1,1,1205,0,1207,G
5-NP,360,1,1,1205,0,1207,G
5-NP,361,0,1,0,1210,1211,C
5-NP,362,1,0,1210,0,1211,G
5-NP,363,0,0,0,1205,1205,C
5-NP,364,2,0,0,1199,1201,C
5-NP,365,1209,0,0,0,1209,A
5-NP,366,1219,0,0,0,1219,A
5-NP,367,0,0,1240,0,1240,G
5-NP,368,0,0,0,1238,1238,C
5-NP,369,1,0,0,1242,1243,C
5-NP,370,1248,0,0,0,1248,A
5-NP,371,1262,0,3,0,1265,A
5-NP,372,0,0,0,1276,1276,C
5-NP,373,1275,1,1,0,1277,A
5-NP,374,1304,0,1,0,1305,A
5-NP,375,0,1295,0,0,1295,T
5-NP,376,1,2,1293,0,1296,G
5-NP,377,0,1,1293,0,1294,G
5-NP,378,0,1282,0,1,1283,T
5-NP,379,0,0,1283,0,1283,G
5-NP,380,1273,0,0,0,1273,A
5-NP,381,1,0,1294,0,1295,G
5-NP,382,1,0,1296,0,1297,G
5-NP,383,1306,0,0,0,1306,A
5-NP,384,0,1389,1,1,1391,T
5-NP,385,0,0,1398,0,1398,G
5-NP,386,0,1,0,1396,1397,C
5-NP,387,0,1398,0,0,1398,T
5-NP,388,1403,0,1,0,1404,A
5-NP,389,0,1,0,1421,1422,C
5-NP,390,1410,0,1,0,1411,A
5-NP,391,0,1407,0,3,1410,T
5-NP,392,2,1,0,1397,1400,C
5-NP,393,0,1326,0,1,1327,T
5-NP,394,1,1,1364,0,1366,G
5-NP,395,0,0,1394,0,1394,G
5-NP,396,1,1389,0,2,1392,T
5-NP,397,3,0,0,1391,1394,C
5-NP,398,0,1385,0,0,1385,T
5-NP,399,1393,0,0,0,1393,A
5-NP,400,1395,0,0,0,1395,A
5-NP,401,0,0,0,1408,1408,C
5-NP,402,0,1398,0,3,1401,T
5-NP,403,3,0,0,1395,1398,C
5-NP,404,1377,0,1,0,1378,A
5-NP,405,0,1,0,1423,1424,C
5-NP,406,1425,1,0,0,1426,A
5-NP,407,0,1433,0,0,1433,T
5-NP,408,1418,0,0,0,1418,A
5-NP,409,1420,0,3,0,1423,A
5-NP,410,0,1419,0,0,1419,T
5-NP,411,0,0,1430,0,1430,G
5-NP,412,1422,1,0,0,1423,A
5-NP,413,0,1407,0,1,1408,T
5-NP,414,0,1375,0,1,1376,T
5-NP,415,0,1381,0,0,1381,T
5-NP,416,0,2,1369,0,1371,G
5-NP,417,1,1,1369,1,1372,G
5-NP,418,0,0,1,1377,1378,C
5-NP,419,1369,0,0,0,1369,A
5-NP,420,0,1362,0,3,1365,T
5-NP,421,0,1362,0,0,1362,T
5-NP,422,1,0,0,1364,1365,C
5-NP,423,3,1,0,1364,1368,C
5-NP,424,1392,1,2,0,1395,A
5-NP,425,1397,0,0,0,1397,A
5-NP,426,0,1400,0,0,1400,T
5-NP,427,2,1396,0,0,1398,T
5-NP,428,0,1393,0,0,1393,T
5-NP,429,0,3,1404,0,1407,G
5-NP,430,1404,0,1,0,1405,A
5-NP,431,1411,0,0,0,1411,A
5-NP,432,0,1410,0,0,1410,T
5-NP,433,2,2,1398,0,1402,G
5-NP,434,1451,1,2,0,1454,A
5-NP,435,0,1455,0,1,1456,T
5-NP,436,0,0,1460,0,1460,G
5-NP,437,0,1,0,1484,1485,C
5-NP,438,1476,1,1,0,1478,A
5-NP,439,1536,0,1,1,1538,A
5-NP,440,0,0,0,1537,1537,C
5-NP,441,1558,0,0,0,1558,A
5-NP,442,0,1574,0,0,1574,T
5-NP,443,1531,0,1,0,1532,A
5-NP,444,1,1,0,1549,1551,C
5-NP,445,2,0,0,1541,1543,C
5-NP,446,1523,1,1,0,1525,A
5-NP,447,0,4,1532,0,1536,G
5-NP,448,1503,0,0,0,1503,A
5-NP,449,0,3,1498,0,1501,G
5-NP,450,1452,0,2,0,1454,A
5-NP,451,1501,0,1,0,1502,A
5-NP,452,0,0,0,1519,1519,C
5-NP,453,1513,1,0,0,1514,A
5-NP,454,1519,1,2,0,1522,A
5-NP,455,1,1,1521,0,1523,G
5-NP,456,1493,0,0,0,1493,A
5-NP,457,0,0,1503,0,1503,G
5-NP,458,0,0,0,1498,1498,C
5-NP,459,0,1491,0,1,1492,T
5-NP,460,1,0,0,1496,1497,C
5-NP,461,0,1486,0,0,1486,T
5-NP,462,1,1486,0,0,1487,T
5-NP,463,0,0,1493,0,1493,G
5-NP,464,0,1485,0,1,1486,T
5-NP,465,0,1483,0,1,1484,T
5-NP,466,6,0,0,1478,1484,C
5-NP,467,0,8,1479,0,1487,G
5-NP,468,1507,1,0,0,1508,A
5-NP,469,1508,0,0,0,1508,A
5-NP,470,0,0,1,1512,1513,C
5-NP,471,0,1503,0,0,1503,T
5-NP,472,1,0,1538,0,1539,G
5-NP,473,0,2,1540,0,1542,G
5-NP,474,1544,0,1,0,1545,A
5-NP,475,1542,0,2,0,1544,A
5-NP,476,0,1542,0,0,1542,T
5-NP,477,0,2,1536,0,1538,G
5-NP,478,0,4,1540,0,1544,G
5-NP,479,1559,0,1,0,1560,A
5-NP,480,0,1572,0,1,1573,T
5-NP,481,1,0,1,1565,1567,C
5-NP,482,0,0,0,1561,1561,C
5-NP,483,4,2,0,1569,1575,C
5-NP,484,1588,0,0,0,1588,A
5-NP,485,0,1,1601,0,1602,G
5-NP,486,1602,0,0,0,1602,A
5-NP,487,1595,0,1,0,1596,A
5-NP,488,0,1581,0,0,1581,T
5-NP,489,0,0,1588,0,1588,G
5-NP,490,0,1572,0,2,1574,T
5-NP,491,0,0,1576,0,1576,G
5-NP,492,1,0,0,1575,1576,C
5-NP,493,0,1563,0,3,1566,T
5-NP,494,4,1,1,1652,1658,C
5-NP,495,0,1647,0,2,1649,T
5-NP,496,0,0,0,1699,1699,C
5-NP,497,1,1688,2,2,1693,T
5-NP,498,0,3,1697,0,1700,G
5-NP,499,1713,0,3,0,1716,A
5-NP,500,0,1699,0,1,1700,T
5-NP,501,1,0,1703,0,1704,G
5-NP,502,0,0,0,1698,1698,C
5-NP,503,1632,0,2,0,1634,A
5-NP,504,0,2,1668,0,1670,G
5-NP,505,0,3,1633,0,1636,G
5-NP,506,1,2,1651,0,1654,G
5-NP,507,1,0,0,1645,1646,C
5-NP,508,1,1639,0,2,1642,T
5-NP,509,1,0,0,1648,1649,C
5-NP,510,0,4,1651,0,1655,G
5-NP,511,1678,0,2,0,1680,A
5-NP,512,0,0,0,1677,1677,C
5-NP,513,0,1645,0,1,1646,T
5-NP,514,3,0,0,1727,1730,C
5-NP,515,0,1717,0,2,1719,T
5-NP,516,3,0,0,1918,1921,C
5-NP,517,1,0,0,1923,1924,C
5-NP,518,5,0,0,1918,1923,C
5-NP,519,0,1917,0,3,1920,T
5-NP,520,1909,0,0,0,1909,A
5-NP,521,0,2,1903,0,1905,G
5-NP,522,1902,0,1,0,1903,A
5-NP,523,1836,0,1,0,1837,A
5-NP,524,0,5,1826,0,1831,G
5-NP,525,1,0,1772,0,1773,G
5-NP,526,0,1751,0,1,1752,T
5-NP,527,3,1,0,1750,1754,C
5-NP,528,3,2,0,1755,1760,C
5-NP,529,2,0,1756,0,1758,G
5-NP,530,1,1,1769,0,1771,G
5-NP,531,1765,1,2,0,1768,A
5-NP,532,0,0,1790,0,1790,G
5-NP,533,1,2,0,1783,1786,C
5-NP,534,0,1754,0,3,1757,T
5-NP,535,2,0,1762,0,1764,G
5-NP,536,0,0,1,1767,1768,C
5-NP,537,1761,3,3,0,1767,A
5-NP,538,0,0,1771,0,1771,G
5-NP,539,1,0,1767,0,1768,G
5-NP,540,0,1766,0,1,1767,T
5-NP,541,1,1,1745,0,1747,G
5-NP,542,0,2,0,1751,1753,C
5-NP,543,1,1745,0,4,1750,T
5-NP,544,2,1,1754,0,1757,G
5-NP,545,0,0,0,1754,1754,C
5-NP,546,1785,0,1,0,1786,A
5-NP,547,1,0,1826,0,1827,G
5-NP,548,0,1811,0,1,1812,T
5-NP,549,6,0,0,1809,1815,C
5-NP,550,1815,1,0,1,1817,A
5-NP,551,1820,1,0,0,1821,A
5-NP,552,1817,0,1,1,1819,A
5-NP,553,0,1,1829,0,1830,G
5-NP,554,0,3,1831,0,1834,G
5-NP,555,1815,0,2,1,1818,A
5-NP,556,1804,0,1,0,1805,A
5-NP,557,0,1798,0,0,1798,T
5-NP,558,2,1,0,1794,1797,C
5-NP,559,0,2,1796,0,1798,G
5-NP,560,0,0,1851,0,1851,G
5-NP,561,0,4,1849,0,1853,G
5-NP,562,1842,1,0,1,1844,A
5-NP,563,0,0,0,1852,1852,C
5-NP,564,1834,1,0,0,1835,A
5-NP,565,1875,0,0,0,1875,A
5-NP,566,0,1884,0,0,1884,T
5-NP,567,0,0,1894,0,1894,G
5-NP,568,0,1,1914,0,1915,G
5-NP,569,0,1858,0,1,1859,T
5-NP,570,0,0,1873,0,1873,G
5-NP,571,1869,0,0,0,1869,A
5-NP,572,1,1858,0,2,1861,T
5-NP,573,1,0,1865,0,1866,G
5-NP,574,0,5,1879,0,1884,G
5-NP,575,1886,0,1,0,1887,A
5-NP,576,1885,1,2,0,1888,A
5-NP,577,1,0,0,1876,1877,C
5-NP,578,0,1858,0,1,1859,T
5-NP,579,1853,0,1,0,1854,A
5-NP,580,1926,0,0,1,1927,A
5-NP,581,0,1925,0,1,1926,T
5-NP,582,2,1,0,1933,1936,C
5-NP,583,1869,0,0,1,1870,A
5-NP,584,0,3,1894,1,1898,G
5-NP,585,1895,0,0,0,1895,A
5-NP,586,1896,0,0,2,1898,A
5-NP,587,1,1892,0,1,1894,T
5-NP,588,2,1,1873,0,1876,G
5-NP,589,1,0,1894,0,1895,G
5-NP,590,0,1896,0,4,1900,T
5-NP,591,7,0,0,1891,1898,C
5-NP,592,1901,0,0,0,1901,A
5-NP,593,1902,0,1,0,1903,A
5-NP,594,1910,0,0,0,1910,A
5-NP,595,0,1,0,1904,1905,C
5-NP,596,4,1,1896,1,1902,G
5-NP,597,1,0,1917,1,1919,G
5-NP,598,0,2,1900,0,1902,G
5-NP,599,0,2,1902,0,1904,G
5-NP,600,1,4,1901,0,1906,G
5-NP,601,1902,0,3,0,1905,A
5-NP,602,0,1892,0,2,1894,T
5-NP,603,3,0,0,1901,1904,C
5-NP,604,1901,0,0,0,1901,A
5-NP,605,1903,1,1,0,1905,A
5-NP,606,0,0,0,1892,1892,C
5-NP,607,0,2,1873,0,1875,G
5-NP,608,1865,0,1,0,1866,A
5-NP,609,0,1861,0,0,1861,T
5-NP,610,3,1,1,1860,1865,C
5-NP,611,1,0,1868,0,1869,G
5-NP,612,1868,0,0,0,1868,A
5-NP,613,1872,0,1,0,1873,A
5-NP,614,1868,0,0,0,1868,A
5-NP,615,2,1895,1,1,1899,T
5-NP,616,0,1892,0,0,1892,T
5-NP,617,0,1884,0,0,1884,T
5-NP,618,1,1886,0,2,1889,T
5-NP,619,0,1897,0,1,1898,T
5-NP,620,0,2,1891,0,1893,G
5-NP,621,0,3,1896,0,1899,G
5-NP,622,1886,0,2,0,1888,A
5-NP,623,0,1,1905,0,1906,G
5-NP,624,1879,0,0,0,1879,A
5-NP,625,0,0,1965,0,1965,G
5-NP,626,0,0,1969,0,1969,G
5-NP,627,2,1965,0,1,1968,T
5-NP,628,0,1,1964,0,1965,G
5-NP,629,1969,0,1,0,1970,A
5-NP,630,0,3,1983,0,1986,G
5-NP,631,1989,0,0,2,1991,A
5-NP,632,1977,0,2,1,1980,A
5-NP,633,0,1978,0,0,1978,T
5-NP,634,1,4,1896,0,1901,G
5-NP,635,1,3,1883,0,1887,G
5-NP,636,1869,1,1,0,1871,A
5-NP,637,0,2,0,1873,1875,C
5-NP,638,0,4,1875,0,1879,G
5-NP,639,2,3,1903,0,1908,G
5-NP,640,1907,0,0,0,1907,A
5-NP,641,1903,2,1,0,1906,A
5-NP,642,1925,1,2,0,1928,A
5-NP,643,1930,1,2,1,1934,A
5-NP,644,0,0,0,1956,1956,C
5-NP,645,1949,0,0,0,1949,A
5-NP,646,1952,0,0,1,1953,A
5-NP,647,0,0,1950,0,1950,G
5-NP,648,1886,0,2,1,1889,A
5-NP,649,1903,0,0,0,1903,A
5-NP,650,0,0,1956,0,1956,G
5-NP,651,0,1948,0,0,1948,T
5-NP,652,0,0,2050,0,2050,G
5-NP,653,1,0,0,2037,2038,C
5-NP,654,0,2043,0,3,2046,T
5-NP,655,0,2050,0,0,2050,T
5-NP,656,2063,1,1,0,2065,A
5-NP,657,0,2065,0,1,2066,T
5-NP,658,1,0,2077,0,2078,G
5-NP,659,2014,0,2,0,2016,A
5-NP,660,0,5,2024,0,2029,G
5-NP,661,1908,0,3,0,1911,A
5-NP,662,0,3,1917,1,1921,G
5-NP,663,1910,1,1,0,1912,A
5-NP,664,1933,0,2,0,1935,A
5-NP,665,1,1923,0,2,1926,T
5-NP,666,1,1,1949,0,1951,G
5-NP,667,0,1928,0,3,1931,T
5-NP,668,1,0,1946,0,1947,G
5-NP,669,1,1,0,1937,1939,C
5-NP,670,1932,2,1,0,1935,A
5-NP,671,1937,0,2,1,1940,A
5-NP,672,0,2,0,1931,1933,C
5-NP,673,1909,0,0,0,1909,A
5-NP,674,0,1909,0,0,1909,T
5-NP,675,0,1881,0,3,1884,T
5-NP,676,1,0,0,1884,1885,C
5-NP,677,0,1875,0,0,1875,T
5-NP,678,0,1882,0,1,1883,T
5-NP,679,1889,0,0,0,1889,A
5-NP,680,1876,0,1,0,1877,A
5-NP,681,1877,0,2,0,1879,A
5-NP,682,0,3,1870,0,1873,G
5-NP,683,0,1,1869,0,1870,G
5-NP,684,1864,0,1,0,1865,A
5-NP,685,1862,0,0,0,1862,A
5-NP,686,1862,0,0,0,1862,A
5-NP,687,1883,0,0,0,1883,A
5-NP,688,1,1870,2,1,1874,T
5-NP,689,0,1865,0,1,1866,T
5-NP,690,0,1880,0,0,1880,T
5-NP,691,5,0,0,1877,1882,C
5-NP,692,1878,0,4,0,1882,A
5-NP,693,1888,0,0,1,1889,A
5-NP,694,1883,0,1,0,1884,A
5-NP,695,0,2,0,1897,1899,C
5-NP,696,1879,0,1,0,1880,A
5-NP,697,0,0,1918,0,1918,G
5-NP,698,0,1,0,1912,1913,C
5-NP,699,1,1910,0,0,1911,T
5-NP,700,2,2,1948,0,1952,G
5-NP,701,0,1,0,1941,1942,C
5-NP,702,1962,1,4,0,1967,A
5-NP,703,1,0,1,1963,1965,C
5-NP,704,1952,0,1,0,1953,A
5-NP,705,1950,1,6,0,1957,A
5-NP,706,1920,1,0,0,1921,A
5-NP,707,0,3,1983,0,1986,G
5-NP,708,1978,0,2,0,1980,A
5-NP,709,1,0,1990,0,1991,G
5-NP,710,1,0,0,1983,1984,C
5-NP,711,1983,0,0,0,1983,A
5-NP,712,2035,0,1,1,2037,A
5-NP,713,2,2035,0,0,2037,T
5-NP,714,0,4,2036,0,2040,G
5-NP,715,1,1,2060,0,2062,G
5-NP,716,0,1990,0,2,1992,T
5-NP,717,0,3,1987,0,1990,G
5-NP,718,0,4,2003,1,2008,G
5-NP,719,2004,0,1,0,2005,A
5-NP,720,0,1998,0,2,2000,T
5-NP,721,6,0,0,1943,1949,C
5-NP,722,1960,0,3,0,1963,A
5-NP,723,1981,0,3,1,1985,A
5-NP,724,0,1,1993,0,1994,G
5-NP,725,0,1975,0,1,1976,T
5-NP,726,0,3,1971,0,1974,G
5-NP,727,1942,2,2,0,1946,A
5-NP,728,0,0,1960,0,1960,G
5-NP,729,1957,0,4,0,1961,A
5-NP,730,3,2,1955,1,1961,G
5-NP,731,1946,0,4,0,1950,A
5-NP,732,1921,0,0,1,1922,A
5-NP,733,1926,0,2,1,1929,A
5-NP,734,0,0,1933,0,1933,G
5-NP,735,1,1920,0,0,1921,T
5-NP,736,2,0,0,1924,1926,C
5-NP,737,2,0,1914,0,1916,G
5-NP,738,0,1,1922,0,1923,G
5-NP,739,1921,0,1,0,1922,A
5-NP,740,1933,0,0,0,1933,A
5-NP,741,0,0,0,1925,1925,C
5-NP,742,0,1,0,1903,1904,C
5-NP,743,4,1,0,1915,1920,C
5-NP,744,1908,1,4,0,1913,A
5-NP,745,1,1,1916,0,1918,G
5-NP,746,1,2,1918,0,1921,G
5-NP,747,1917,0,0,0,1917,A
5-NP,748,1920,0,2,0,1922,A
5-NP,749,1917,0,0,0,1917,A
5-NP,750,0,0,0,1917,1917,C
5-NP,751,0,1,1916,0,1917,G
5-NP,752,2,0,0,1908,1910,C
5-NP,753,0,1905,0,1,1906,T
5-NP,754,0,2,1907,0,1909,G
5-NP,755,1901,0,1,0,1902,A
5-NP,756,1,6,1920,0,1927,G
5-NP,757,1944,2,1,0,1947,A
5-NP,758,0,1947,0,0,1947,T
5-NP,759,1,0,0,1907,1908,C
5-NP,760,2,2,1906,0,1910,G
5-NP,761,1912,1,1,0,1914,A
5-NP,762,1905,0,2,0,1907,A
5-NP,763,1,0,1906,1,1908,G
5-NP,764,1895,0,1,0,1896,A
5-NP,765,1,1,0,1826,1828,C
5-NP,766,2,1,1,1899,1903,C
5-NP,767,1,1899,0,8,1908,T
5-NP,768,5,0,0,1905,1910,C
5-NP,769,1914,0,0,0,1914,A
5-NP,770,0,1916,0,0,1916,T
5-NP,771,1911,0,2,0,1913,A
5-NP,772,0,1913,0,2,1915,T
5-NP,773,0,1902,0,1,1903,T
5-NP,774,1,1850,0,1,1852,T
5-NP,775,0,1830,1,1,1832,T
5-NP,776,0,1832,1,0,1833,T
5-NP,777,1837,1,1,1,1840,A
5-NP,778,1,0,1838,0,1839,G
5-NP,779,0,1,0,1838,1839,C
5-NP,780,1832,2,1,0,1835,A
5-NP,781,1824,0,0,0,1824,A
5-NP,782,0,0,1888,0,1888,G
5-NP,783,1888,0,0,0,1888,A
5-NP,784,0,1883,0,0,1883,T
5-NP,785,2,1,0,1892,1895,C
5-NP,786,0,1882,1,1,1884,T
5-NP,787,1,0,1936,0,1937,G
5-NP,788,2,1,0,1940,1943,C
5-NP,789,1948,0,0,0,1948,A
5-NP,790,1,1965,0,2,1968,T
5-NP,791,1,1892,0,0,1893,T
5-NP,792,0,5,1997,1,2003,G
5-NP,793,2035,0,0,0,2035,A
5-NP,794,1,2033,0,0,2034,T
5-NP,795,2037,0,2,0,2039,A
5-NP,796,0,1990,0,0,1990,T
5-NP,797,1,1975,0,0,1976,T
5-NP,798,0,4,1986,0,1990,G
5-NP,799,1966,0,3,0,1969,A
5-NP,800,1,1,1982,0,1984,G
5-NP,801,1867,0,1,0,1868,A
5-NP,802,1,1,1832,0,1834,G
5-NP,803,0,6,1851,0,1857,G
5-NP,804,1846,0,2,0,1848,A
5-NP,805,0,1845,0,1,1846,T
5-NP,806,4,1,0,1847,1852,C
5-NP,807,1840,0,0,0,1840,A
5-NP,808,0,0,1846,0,1846,G
5-NP,809,0,1832,0,2,1834,T
5-NP,810,1,1823,0,0,1824,T
5-NP,811,0,0,1825,0,1825,G
5-NP,812,1,1,0,1804,1806,C
5-NP,813,2,1800,0,2,1804,T
5-NP,814,8,0,0,1807,1815,C
5-NP,815,1813,0,1,0,1814,A
5-NP,816,0,0,0,1812,1812,C
5-NP,817,1811,0,0,0,1811,A
5-NP,818,1816,1,0,0,1817,A
5-NP,819,1825,0,0,0,1825,A
5-NP,820,0,1814,0,0,1814,T
5-NP,821,6,0,0,1816,1822,C
5-NP,822,1,1820,0,3,1824,T
5-NP,823,0,1825,0,0,1825,T
5-NP,824,0,1,1824,0,1825,G
5-NP,825,0,2,0,1824,1826,C
5-NP,826,1,0,0,1843,1844,C
5-NP,827,0,1838,0,0,1838,T
5-NP,828,1850,0,0,0,1850,A
5-NP,829,0,1,0,1846,1847,C
5-NP,830,3,1,0,1842,1846,C
5-NP,831,0,1834,0,3,1837,T
5-NP,832,3,0,1867,0,1870,G
5-NP,833,1,1,0,1857,1859,C
5-NP,834,2,0,1,1861,1864,C
5-NP,835,0,1838,0,3,1841,T
5-NP,836,0,0,1864,0,1864,G
5-NP,837,1,1846,0,1,1848,T
5-NP,838,1,1,1863,0,1865,G
5-NP,839,0,5,0,1866,1871,C
5-NP,840,2,0,1895,0,1897,G
5-NP,841,0,1868,0,0,1868,T
5-NP,842,1865,0,0,0,1865,A
5-NP,843,0,1861,0,2,1863,T
5-NP,844,0,2,1857,0,1859,G
5-NP,845,0,6,1916,0,1922,G
5-NP,846,1919,1,0,0,1920,A
5-NP,847,0,1,0,1891,1892,C
5-NP,848,0,0,1,1883,1884,C
5-NP,849,0,1849,0,2,1851,T
5-NP,850,0,0,1950,0,1950,G
5-NP,851,0,0,0,1949,1949,C
5-NP,852,1950,0,2,0,1952,A
5-NP,853,1,0,1985,0,1986,G
5-NP,854,0,1858,0,1,1859,T
5-NP,855,1946,0,0,0,1946,A
5-NP,856,0,1945,0,2,1947,T
5-NP,857,1,2,0,1923,1926,C
5-NP,858,2,0,0,1930,1932,C
5-NP,859,1799,1,0,0,1800,A
5-NP,860,0,0,1805,0,1805,G
5-NP,861,0,1797,0,1,1798,T
5-NP,862,0,1,1802,0,1803,G
5-NP,863,0,3,1790,0,1793,G
5-NP,864,2,1,1754,0,1757,G
5-NP,865,2,1756,0,1,1759,T
5-NP,866,1753,0,1,0,1754,A
5-NP,867,0,0,0,1746,1746,C
5-NP,868,3,3,1731,0,1737,G
5-NP,869,1731,0,1,0,1732,A
5-NP,870,1,0,0,1738,1739,C
5-NP,871,0,1666,0,1,1667,T
5-NP,872,0,1680,0,1,1681,T
5-NP,873,1,0,0,1675,1676,C
5-NP,874,1,2,1672,0,1675,G
5-NP,875,1678,0,0,0,1678,A
5-NP,876,1676,0,0,0,1676,A
5-NP,877,1680,0,0,0,1680,A
5-NP,878,1679,0,0,0,1679,A
5-NP,879,1673,0,1,0,1674,A
5-NP,880,0,1,1678,0,1679,G
5-NP,881,1670,1,2,0,1673,A
5-NP,882,1,2,1686,0,1689,G
5-NP,883,2,0,1693,0,1695,G
5-NP,884,0,3,1697,0,1700,G
5-NP,885,1704,1,1,0,1706,A
5-NP,886,1,1697,0,0,1698,T
5-NP,887,1703,0,1,0,1704,A
5-NP,888,0,1700,1,2,1703,T
5-NP,889,0,1711,0,0,1711,T
5-NP,890,2,1,0,1722,1725,C
5-NP,891,2,2,0,1708,1712,C
5-NP,892,0,1681,0,0,1681,T
5-NP,893,0,1683,0,0,1683,T
5-NP,894,2,2,1699,0,1703,G
5-NP,895,1,1,1708,1,1711,G
5-NP,896,0,1693,0,3,1696,T
5-NP,897,1,2,1686,0,1689,G
5-NP,898,1,0,1673,0,1674,G
5-NP,899,1,2,1732,0,1735,G
5-NP,900,1740,0,2,0,1742,A
5-NP,901,1739,0,0,0,1739,A
5-NP,902,0,1741,0,0,1741,T
5-NP,903,1710,0,2,0,1712,A
5-NP,904,1,3,1701,2,1707,G
5-NP,905,1689,0,2,0,1691,A
5-NP,906,0,0,0,1687,1687,C
5-NP,907,0,0,0,1673,1673,C
5-NP,908,2,0,0,1603,1605,C
5-NP,909,0,1615,0,3,1618,T
5-NP,910,0,1618,0,1,1619,T
5-NP,911,1,1617,0,2,1620,T
5-NP,912,3,1,1,1619,1624,C
5-NP,913,1613,0,2,0,1615,A
5-NP,914,1616,0,1,0,1617,A
5-NP,915,1616,0,1,1,1618,A
5-NP,916,0,0,0,1621,1621,C
5-NP,917,2,1568,0,0,1570,T
5-NP,918,1541,0,0,0,1541,A
5-NP,919,1,0,0,1553,1554,C
5-NP,920,1,1544,1,1,1547,T
5-NP,921,1,1546,0,3,1550,T
5-NP,922,1,0,0,1551,1552,C
5-NP,923,1547,0,1,0,1548,A
5-NP,924,1549,1,0,0,1550,A
5-NP,925,1541,0,0,0,1541,A
5-NP,926,1536,0,1,0,1537,A
5-NP,927,0,1534,0,0,1534,T
5-NP,928,1505,0,1,0,1506,A
5-NP,929,0,0,1516,0,1516,G
5-NP,930,1,0,0,1516,1517,C
5-NP,931,3,0,0,1532,1535,C
5-NP,932,1539,1,0,0,1540,A
5-NP,933,1543,0,0,0,1543,A
5-NP,934,1579,0,1,0,1580,A
5-NP,935,0,1585,0,0,1585,T
5-NP,936,1586,0,0,0,1586,A
5-NP,937,0,1586,0,1,1587,T
5-NP,938,1551,0,1,0,1552,A
5-NP,939,0,0,0,1554,1554,C
5-NP,940,1496,0,2,0,1498,A
5-NP,941,1,0,1526,0,1527,G
5-NP,942,0,0,0,1515,1515,C
5-NP,943,0,1469,0,0,1469,T
5-NP,944,0,1480,0,0,1480,T
5-NP,945,1477,0,2,0,1479,A
5-NP,946,1483,0,1,0,1484,A
5-NP,947,0,1477,0,1,1478,T
5-NP,948,2,1,0,1478,1481,C
5-NP,949,1401,0,2,0,1403,A
5-NP,950,0,1,1405,0,1406,G
5-NP,951,1406,1,0,0,1407,A
5-NP,952,0,0,0,1410,1410,C
5-NP,953,2,0,0,1398,1400,C
5-NP,954,0,1383,0,0,1383,T
5-NP,955,1389,0,0,0,1389,A
5-NP,956,1384,0,2,0,1386,A
5-NP,957,0,1,0,1391,1392,C
5-NP,958,0,3,1385,0,1388,G
5-NP,959,1348,0,0,0,1348,A
5-NP,960,0,3,1344,0,1347,G
5-NP,961,1338,0,2,0,1340,A
5-NP,962,1348,0,0,0,1348,A
5-NP,963,0,1342,0,1,1343,T
5-NP,964,2,1,0,1321,1324,C
5-NP,965,0,0,0,1319,1319,C
5-NP,966,1289,0,2,0,1291,A
5-NP,967,1,1,1290,0,1292,G
5-NP,968,0,0,0,1290,1290,C
5-NP,969,1298,0,1,0,1299,A
5-NP,970,0,0,0,1301,1301,C
5-NP,971,1276,1,1,0,1278,A
5-NP,972,1,0,0,1279,1280,C
5-NP,973,1279,1,0,0,1280,A
5-NP,974,1280,1,3,0,1284,A
5-NP,975,0,1,1286,0,1287,G
5-NP,976,1268,0,3,1,1272,A
5-NP,977,2,0,1273,0,1275,G
5-NP,978,0,1239,0,1,1240,T
5-NP,979,3,0,0,1234,1237,C
5-NP,980,1232,0,0,0,1232,A
5-NP,981,1,0,1234,0,1235,G
5-NP,982,0,0,0,1227,1227,C
5-NP,983,2,1196,0,2,1200,T
5-NP,984,1,0,1206,0,1207,G
5-NP,985,1,0,1209,0,1210,G
5-NP,986,0,1196,0,1,1197,T
5-NP,987,0,2,1205,0,1207,G
5-NP,988,0,1188,0,1,1189,T
5-NP,989,1,0,1185,0,1186,G
5-NP,990,2,2,1173,0,1177,G
5-NP,991,1158,0,3,0,1161,A
5-NP,992,2,1164,0,2,1168,T
5-NP,993,0,3,1094,0,1097,G
5-NP,994,1,0,1076,0,1077,G
5-NP,995,0,0,0,1071,1071,C
5-NP,996,1050,0,0,1,1051,A
5-NP,997,0,1047,2,2,1051,T
5-NP,998,0,0,1037,0,1037,G
5-NP,999,0,0,0,1041,1041,C
5-NP,1000,2,1,0,1040,1043,C
5-NP,1001,1043,1,0,0,1044,A
5-NP,1002,0,1037,0,2,1039,T
5-NP,1003,0,1015,0,0,1015,T
5-NP,1004,0,0,0,1017,1017,C
5-NP,1005,0,987,0,0,987,T
5-NP,1006,0,0,986,0,986,G
5-NP,1007,1,0,0,982,983,C
5-NP,1008,0,897,0,0,897,T
5-NP,1009,0,0,908,0,908,G
5-NP,1010,0,0,0,851,851,C
5-NP,1011,847,0,1,0,848,A
5-NP,1012,0,847,0,0,847,T
5-NP,1013,0,830,0,0,830,T
5-NP,1014,0,828,0,0,828,T
5-NP,1015,0,0,826,1,827,G
5-NP,1016,828,0,1,0,829,A
5-NP,1017,828,0,0,0,828,A
5-NP,1018,1,0,833,0,834,G
5-NP,1019,828,0,1,0,829,A
5-NP,1020,0,825,0,0,825,T
5-NP,1021,0,829,0,0,829,T
5-NP,1022,1,825,0,0,826,T
5-NP,1023,826,0,1,0,827,A
5-NP,1024,828,1,0,1,830,A
5-NP,1025,0,1,829,0,830,G
5-NP,1026,830,0,1,0,831,A
5-NP,1027,0,820,0,1,821,T
5-NP,1028,0,801,0,0,801,T
5-NP,1029,0,0,805,0,805,G
5-NP,1030,0,801,0,1,802,T
5-NP,1031,1,801,0,0,802,T
5-NP,1032,801,1,0,0,802,A
5-NP,1033,799,0,0,0,799,A
5-NP,1034,0,0,801,0,801,G
5-NP,1035,0,0,0,804,804,C
5-NP,1036,0,782,0,0,782,T
5-NP,1037,0,786,0,0,786,T
5-NP,1038,1,0,0,790,791,C
5-NP,1039,789,0,1,0,790,A
5-NP,1040,0,793,0,0,793,T
5-NP,1041,2,1,0,790,793,C
5-NP,1042,780,0,1,0,781,A
5-NP,1043,0,0,783,0,783,G
5-NP,1044,774,0,0,0,774,A
5-NP,1045,0,2,775,0,777,G
5-NP,1046,0,1,777,0,778,G
5-NP,1047,0,1,769,0,770,G
5-NP,1048,769,0,2,0,771,A
5-NP,1049,1,1,0,765,767,C
5-NP,1050,770,2,0,0,772,A
5-NP,1051,773,0,1,0,774,A
5-NP,1052,779,0,0,0,779,A
5-NP,1053,773,0,2,1,776,A
5-NP,1054,0,0,778,0,778,G
5-NP,1055,0,749,0,1,750,T
5-NP,1056,750,0,1,0,751,A
5-NP,1057,0,746,0,2,748,T
5-NP,1058,1,0,0,748,749,C
5-NP,1059,0,741,0,1,742,T
5-NP,1060,2,0,0,741,743,C
5-NP,1061,1,1,0,737,739,C
5-NP,1062,0,735,0,0,735,T
5-NP,1063,0,0,0,732,732,C
5-NP,1064,0,1,727,0,728,G
5-NP,1065,0,0,733,0,733,G
5-NP,1066,0,0,732,0,732,G
5-NP,1067,1,1,726,0,728,G
5-NP,1068,0,1,721,0,722,G
5-NP,1069,711,0,1,0,712,A
5-NP,1070,711,1,0,0,712,A
5-NP,1071,712,0,0,1,713,A
5-NP,1072,0,0,1,719,720,C
5-NP,1073,0,715,0,0,715,T
5-NP,1074,0,0,713,0,713,G
5-NP,1075,0,706,0,0,706,T
5-NP,1076,2,0,0,706,708,C
5-NP,1077,719,0,0,0,719,A
5-NP,1078,718,0,2,0,720,A
5-NP,1079,0,1,0,721,722,C
5-NP,1080,0,720,0,0,720,T
5-NP,1081,702,2,0,0,704,A
5-NP,1082,0,0,703,0,703,G
5-NP,1083,693,0,0,0,693,A
5-NP,1084,0,1,692,0,693,G
5-NP,1085,0,4,688,0,692,G
5-NP,1086,658,1,0,0,659,A
5-NP,1087,0,0,670,0,670,G
5-NP,1088,0,661,0,0,661,T
5-NP,1089,658,1,0,0,659,A
5-NP,1090,0,0,0,659,659,C
5-NP,1091,647,0,1,0,648,A
5-NP,1092,645,0,3,0,648,A
5-NP,1093,641,0,1,0,642,A
5-NP,1094,0,636,0,0,636,T
5-NP,1095,0,632,0,1,633,T
5-NP,1096,0,0,609,0,609,G
5-NP,1097,0,0,0,592,592,C
5-NP,1098,0,592,0,0,592,T
5-NP,1099,0,588,0,0,588,T
5-NP,1100,1,0,0,590,591,C
5-NP,1101,591,0,0,0,591,A
5-NP,1102,588,1,1,0,590,A
5-NP,1103,591,0,0,0,591,A
5-NP,1104,0,590,0,0,590,T
5-NP,1105,0,2,584,0,586,G
5-NP,1106,578,0,1,0,579,A
5-NP,1107,0,2,581,0,583,G
5-NP,1108,582,0,2,0,584,A
5-NP,1109,584,0,0,0,584,A
5-NP,1110,0,0,0,582,582,C
5-NP,1111,568,0,0,0,568,A
5-NP,1112,0,568,1,0,569,T
5-NP,1113,0,1,574,0,575,G
5-NP,1114,0,0,580,0,580,G
5-NP,1115,578,0,0,0,578,A
5-NP,1116,0,565,0,0,565,T
5-NP,1117,559,0,0,0,559,A
5-NP,1118,589,0,0,0,589,A
5-NP,1119,0,581,0,0,581,T
5-NP,1120,580,0,0,0,580,A
5-NP,1121,0,577,0,0,577,T
5-NP,1122,0,0,540,0,540,G
5-NP,1123,0,2,521,0,523,G
5-NP,1124,2,0,520,0,522,G
5-NP,1125,519,0,0,0,519,A
5-NP,1126,0,516,0,0,516,T
5-NP,1127,4,0,0,409,413,C
5-NP,1128,0,1,410,0,411,G
5-NP,1129,407,0,1,0,408,A
5-NP,1130,0,0,407,0,407,G
5-NP,1131,0,0,0,403,403,C
5-NP,1132,397,0,0,0,397,A
5-NP,1133,0,0,0,415,415,C
5-NP,1134,0,409,0,0,409,T
5-NP,1135,0,0,0,409,409,C
5-NP,1136,0,409,0,1,410,T
5-NP,1137,0,403,0,1,404,T
5-NP,1138,0,2,401,0,403,G
5-NP,1139,403,0,0,0,403,A
5-NP,1140,403,1,0,0,404,A
5-NP,1141,0,0,0,405,405,C
5-NP,1142,0,296,0,1,297,T
5-NP,1143,0,2,297,0,299,G
5-NP,1144,292,0,0,0,292,A
5-NP,1145,0,0,291,0,291,G
5-NP,1146,290,0,1,0,291,A
5-NP,1147,286,0,0,0,286,A
5-NP,1148,0,0,288,0,288,G
5-NP,1149,0,1,0,287,288,C
5-NP,1150,0,1,286,0,287,G
5-NP,1151,0,0,289,0,289,G
5-NP,1152,0,0,287,0,287,G
5-NP,1153,0,284,0,0,284,T
5-NP,1154,272,0,0,0,272,A
5-NP,1155,0,0,0,273,273,C
5-NP,1156,0,214,0,0,214,T
5-NP,1157,0,0,217,0,217,G
5-NP,1158,0,0,210,0,210,G
5-NP,1159,0,1,204,0,205,G
5-NP,1160,0,0,0,207,207,C
5-NP,1161,0,0,0,193,193,C
5-NP,1162,195,0,0,0,195,A
5-NP,1163,0,196,0,0,196,T
5-NP,1164,195,0,0,0,195,A
5-NP,1165,195,0,0,0,195,A
5-NP,1166,0,0,194,0,194,G
5-NP,1167,0,1,197,0,198,G
5-NP,1168,192,0,0,0,192,A
5-NP,1169,0,0,0,194,194,C
5-NP,1170,0,0,0,196,196,C
5-NP,1171,193,0,0,0,193,A
5-NP,1172,0,0,199,0,199,G
5-NP,1173,0,0,200,0,200,G
5-NP,1174,198,0,1,0,199,A
5-NP,1175,0,0,198,0,198,G
5-NP,1176,0,182,0,0,182,T
5-NP,1177,0,0,183,0,183,G
5-NP,1178,0,0,186,0,186,G
5-NP,1179,182,0,0,0,182,A
5-NP,1180,0,0,183,0,183,G
5-NP,1181,0,0,180,0,180,G
5-NP,1182,178,0,0,0,178,A
5-NP,1183,178,0,0,0,178,A
5-NP,1184,176,0,0,0,176,A
5-NP,1185,0,0,0,179,179,C
5-NP,1186,179,0,0,0,179,A
5-NP,1187,0,0,0,188,188,C
5-NP,1188,0,185,0,0,185,T
5-NP,1189,193,0,0,0,193,A
5-NP,1190,195,0,0,0,195,A
5-NP,1191,0,193,0,0,193,T
5-NP,1192,0,0,0,195,195,C
5-NP,1193,194,0,0,0,194,A
5-NP,1194,193,0,0,0,193,A
5-NP,1195,1,0,0,193,194,C
5-NP,1196,190,0,0,0,190,A
5-NP,1197,0,1,189,0,190,G
5-NP,1198,181,0,0,0,181,A
5-NP,1199,0,0,182,0,182,G
5-NP,1200,0,0,183,0,183,G
5-NP,1201,0,0,178,0,178,G
5-NP,1202,0,0,0,180,180,C
5-NP,1203,0,0,0,179,179,C
5-NP,1204,0,175,0,0,175,T
5-NP,1205,0,0,0,178,178,C
5-NP,1206,1,0,0,177,178,C
5-NP,1207,0,0,178,0,178,G
5-NP,1208,0,0,0,177,177,C
5-NP,1209,172,0,1,0,173,A
5-NP,1210,0,0,181,0,181,G
5-NP,1211,0,0,178,0,178,G
5-NP,1212,0,0,0,178,178,C
5-NP,1213,0,1,0,179,180,C
5-NP,1214,176,0,0,0,176,A
5-NP,1215,176,0,0,0,176,A
5-NP,1216,177,0,0,0,177,A
5-NP,1217,0,0,0,176,176,C
5-NP,1218,0,0,0,178,178,C
5-NP,1219,160,0,0,0,160,A
5-NP,1220,0,0,166,0,166,G
5-NP,1221,0,164,0,1,165,T
5-NP,1222,0,0,166,0,166,G
5-NP,1223,0,164,0,0,164,T
5-NP,1224,0,0,166,0,166,G
5-NP,1225,0,0,0,165,165,C
5-NP,1226,163,0,0,0,163,A
5-NP,1227,0,0,159,0,159,G
5-NP,1228,0,0,0,163,163,C
5-NP,1229,0,0,0,165,165,C
5-NP,1230,0,165,0,0,165,T
5-NP,1231,163,0,0,0,163,A
5-NP,1232,0,0,0,162,162,C
5-NP,1233,0,0,162,0,162,G
5-NP,1234,0,163,0,0,163,T
5-NP,1235,0,162,0,0,162,T
5-NP,1236,0,159,0,0,159,T
5-NP,1237,0,154,0,0,154,T
5-NP,1238,1,0,0,154,155,C
5-NP,1239,1,152,0,0,153,T
5-NP,1240,0,0,161,0,161,G
5-NP,1241,0,160,0,0,160,T
5-NP,1242,160,0,0,0,160,A
5-NP,1243,0,0,0,160,160,C
5-NP,1244,160,0,0,0,160,A
5-NP,1245,160,0,1,0,161,A
5-NP,1246,161,0,0,0,161,A
5-NP,1247,0,0,162,0,162,G
5-NP,1248,159,0,0,0,159,A
5-NP,1249,154,0,0,0,154,A
5-NP,1250,155,0,0,0,155,A
5-NP,1251,0,0,0,156,156,C
5-NP,1252,0,0,0,154,154,C
5-NP,1253,0,156,0,0,156,T
5-NP,1254,0,0,0,155,155,C
5-NP,1255,0,0,0,155,155,C
5-NP,1256,1,0,0,155,156,C
5-NP,1257,157,0,0,0,157,A
5-NP,1258,0,158,0,0,158,T
5-NP,1259,0,158,0,0,158,T
5-NP,1260,0,158,0,0,158,T
5-NP,1261,0,0,159,0,159,G
5-NP,1262,158,0,1,0,159,A
5-NP,1263,158,0,0,0,158,A
5-NP,1264,159,0,0,0,159,A
5-NP,1265,157,0,2,0,159,A
5-NP,1266,0,0,160,0,160,G
5-NP,1267,0,159,0,0,159,T
5-NP,1268,0,0,0,159,159,C
5-NP,1269,159,0,0,0,159,A
5-NP,1270,160,0,0,0,160,A
5-NP,1271,0,0,0,160,160,C
5-NP,1272,1,0,0,159,160,C
5-NP,1273,161,0,0,0,161,A
5-NP,1274,0,162,0,0,162,T
5-NP,1275,0,0,0,161,161,C
5-NP,1276,159,0,0,0,159,A
5-NP,1277,0,161,0,0,161,T
5-NP,1278,1,0,161,0,162,G
5-NP,1279,0,0,163,0,163,G
5-NP,1280,0,0,0,163,163,C
5-NP,1281,160,0,0,0,160,A
5-NP,1282,0,0,159,0,159,G
5-NP,1283,0,0,0,160,160,C
5-NP,1284,161,0,0,0,161,A
5-NP,1285,0,161,0,1,162,T
5-NP,1286,0,160,0,0,160,T
5-NP,1287,0,0,0,161,161,C
5-NP,1288,160,0,0,0,160,A
5-NP,1289,0,0,0,160,160,C
5-NP,1290,0,160,0,0,160,T
5-NP,1291,0,1,163,0,164,G
5-NP,1292,0,0,165,0,165,G
5-NP,1293,163,0,1,0,164,A
5-NP,1294,165,0,0,0,165,A
5-NP,1295,166,0,0,0,166,A
5-NP,1296,0,164,0,0,164,T
5-NP,1297,163,0,1,0,164,A
5-NP,1298,0,0,0,162,162,C
5-NP,1299,0,0,161,0,161,G
5-NP,1300,0,0,164,0,164,G
5-NP,1301,158,0,1,0,159,A
5-NP,1302,0,0,159,0,159,G
5-NP,1303,0,0,159,0,159,G
5-NP,1304,0,0,160,0,160,G
5-NP,1305,160,0,0,0,160,A
5-NP,1306,159,0,0,0,159,A
5-NP,1307,0,1,158,0,159,G
5-NP,1308,158,0,0,0,158,A
5-NP,1309,160,0,0,0,160,A
5-NP,1310,0,0,0,162,162,C
5-NP,1311,0,159,0,0,159,T
5-NP,1312,0,161,0,0,161,T
5-NP,1313,0,0,0,161,161,C
5-NP,1314,159,0,1,0,160,A
5-NP,1315,0,0,160,0,160,G
5-NP,1316,160,0,0,0,160,A
5-NP,1317,0,0,0,162,162,C
5-NP,1318,162,0,0,0,162,A
5-NP,1319,0,159,0,0,159,T
5-NP,1320,0,0,160,0,160,G
5-NP,1321,157,0,0,0,157,A
5-NP,1322,0,0,158,0,158,G
5-NP,1323,0,0,158,0,158,G
5-NP,1324,0,0,157,0,157,G
5-NP,1325,0,0,0,158,158,C
5-NP,1326,158,0,0,0,158,A
5-NP,1327,0,1,156,0,157,G
5-NP,1328,157,0,0,0,157,A
5-NP,1329,159,0,0,0,159,A
5-NP,1330,159,0,0,0,159,A
5-NP,1331,0,159,0,1,160,T
5-NP,1332,0,0,0,160,160,C
5-NP,1333,159,0,0,0,159,A
5-NP,1334,0,159,0,0,159,T
5-NP,1335,159,0,0,0,159,A
5-NP,1336,158,0,0,0,158,A
5-NP,1337,0,0,160,0,160,G
5-NP,1338,158,0,1,0,159,A
5-NP,1339,160,0,0,0,160,A
5-NP,1340,0,159,0,0,159,T
5-NP,1341,0,1,157,0,158,G
5-NP,1342,158,0,0,0,158,A
5-NP,1343,0,158,0,0,158,T
5-NP,1344,0,0,159,0,159,G
5-NP,1345,0,0,159,0,159,G
5-NP,1346,156,0,0,0,156,A
5-NP,1347,157,0,0,0,157,A
5-NP,1348,154,0,0,0,154,A
5-NP,1349,0,0,156,0,156,G
5-NP,1350,0,156,0,0,156,T
5-NP,1351,0,0,156,0,156,G
5-NP,1352,1,0,0,154,155,C
5-NP,1353,155,0,0,0,155,A
5-NP,1354,155,0,0,0,155,A
5-NP,1355,152,0,0,0,152,A
5-NP,1356,155,0,0,0,155,A
5-NP,1357,0,0,0,154,154,C
5-NP,1358,0,0,0,151,151,C
5-NP,1359,151,0,0,0,151,A
5-NP,1360,0,0,153,0,153,G
5-NP,1361,153,0,0,0,153,A
5-NP,1362,153,0,0,0,153,A
5-NP,1363,0,0,153,0,153,G
5-NP,1364,152,0,0,0,152,A
5-NP,1365,143,0,0,0,143,A
5-NP,1366,0,0,143,0,143,G
5-NP,1367,0,142,0,0,142,T
5-NP,1368,0,0,143,0,143,G
5-NP,1369,0,142,0,0,142,T
5-NP,1370,0,2,0,139,141,C
5-NP,1371,142,0,0,0,142,A
5-NP,1372,0,145,0,0,145,T
5-NP,1373,0,145,0,0,145,T
5-NP,1374,1,0,0,142,143,C
5-NP,1375,1,0,0,140,141,C
5-NP,1376,2,0,139,0,141,G
5-NP,1377,0,1,141,0,142,G
5-NP,1378,0,1,141,0,142,G
5-NP,1379,0,0,142,0,142,G
5-NP,1380,0,0,141,0,141,G
5-NP,1381,135,0,1,0,136,A
5-NP,1382,0,0,136,0,136,G
5-NP,1383,0,0,136,0,136,G
5-NP,1384,0,0,136,0,136,G
5-NP,1385,1,0,136,0,137,G
5-NP,1386,136,0,0,0,136,A
5-NP,1387,0,0,136,0,136,G
5-NP,1388,0,136,0,0,136,T
5-NP,1389,0,0,0,136,136,C
5-NP,1390,0,139,0,0,139,T
5-NP,1391,0,139,0,0,139,T
5-NP,1392,0,0,0,139,139,C
5-NP,1393,0,0,139,0,139,G
5-NP,1394,138,0,0,0,138,A
5-NP,1395,0,0,140,0,140,G
5-NP,1396,0,0,0,137,137,C
5-NP,1397,0,137,0,0,137,T
5-NP,1398,0,0,0,138,138,C
5-NP,1399,0,137,0,1,138,T
5-NP,1400,1,0,0,137,138,C
5-NP,1401,138,0,0,0,138,A
5-NP,1402,0,0,138,0,138,G
5-NP,1403,139,0,0,0,139,A
5-NP,1404,0,0,0,138,138,C
5-NP,1405,0,0,137,0,137,G
5-NP,1406,133,0,1,0,134,A
5-NP,1407,0,0,133,0,133,G
5-NP,1408,132,0,0,0,132,A
5-NP,1409,132,0,0,0,132,A
5-NP,1410,0,0,131,0,131,G
5-NP,1411,0,1,129,0,130,G
5-NP,1412,0,0,0,130,130,C
5-NP,1413,130,0,0,0,130,A
5-NP,1414,130,0,0,0,130,A
5-NP,1415,0,0,0,129,129,C
5-NP,1416,0,0,129,0,129,G
5-NP,1417,127,0,0,0,127,A
5-NP,1418,127,0,0,1,128,A
5-NP,1419,0,0,0,128,128,C
5-NP,1420,0,0,0,127,127,C
5-NP,1421,1,1,0,125,127,C
5-NP,1422,0,1,126,0,127,G
5-NP,1423,127,0,0,0,127,A
5-NP,1424,0,127,0,0,127,T
5-NP,1425,0,0,0,126,126,C
5-NP,1426,0,0,126,0,126,G
5-NP,1427,0,125,0,0,125,T
5-NP,1428,0,0,125,0,125,G
5-NP,1429,0,0,0,122,122,C
5-NP,1430,0,0,0,124,124,C
5-NP,1431,0,0,0,124,124,C
5-NP,1432,0,117,0,0,117,T
5-NP,1433,0,0,0,121,121,C
5-NP,1434,0,120,0,1,121,T
5-NP,1435,0,119,1,0,120,T
5-NP,1436,0,121,0,0,121,T
5-NP,1437,0,121,0,0,121,T
5-NP,1438,1,0,121,0,122,G
5-NP,1439,122,0,0,0,122,A
5-NP,1440,0,121,0,0,121,T
5-NP,1441,116,1,0,0,117,A
5-NP,1442,0,102,0,0,102,T
5-NP,1443,0,1,104,0,105,G
5-NP,1444,102,0,1,0,103,A
5-NP,1445,0,0,103,0,103,G
5-NP,1446,0,104,0,0,104,T
5-NP,1447,101,0,0,0,101,A
5-NP,1448,100,0,1,0,101,A
5-NP,1449,0,100,0,0,100,T
5-NP,1450,0,0,100,0,100,G
5-NP,1451,100,0,0,0,100,A
5-NP,1452,88,0,0,0,88,A
5-NP,1453,0,0,88,0,88,G
5-NP,1454,0,0,84,0,84,G
5-NP,1455,84,0,0,0,84,A
5-NP,1456,0,82,0,1,83,T
5-NP,1457,0,0,0,84,84,C
5-NP,1458,0,83,0,0,83,T
5-NP,1459,0,82,0,0,82,T
5-NP,1460,83,0,0,0,83,A
5-NP,1461,0,83,0,0,83,T
5-NP,1462,0,81,0,0,81,T
5-NP,1463,0,80,0,0,80,T
5-NP,1464,1,0,0,78,79,C
5-NP,1465,0,75,0,0,75,T
5-NP,1466,0,75,0,0,75,T
5-NP,1467,0,0,0,75,75,C
5-NP,1468,0,0,72,0,72,G
5-NP,1469,0,1,70,0,71,G
5-NP,1470,72,0,0,0,72,A
5-NP,1471,0,0,72,0,72,G
5-NP,1472,70,0,0,0,70,A
5-NP,1473,0,0,0,70,70,C
5-NP,1474,67,0,0,0,67,A
5-NP,1475,67,0,0,0,67,A
5-NP,1476,0,67,0,0,67,T
5-NP,1477,0,0,67,0,67,G
5-NP,1478,0,0,0,66,66,C
5-NP,1479,65,0,0,0,65,A
5-NP,1480,0,0,65,0,65,G
5-NP,1481,65,0,0,0,65,A
5-NP,1482,62,0,0,0,62,A
5-NP,1483,0,0,62,0,62,G
5-NP,1484,36,0,0,0,36,A
5-NP,1485,0,0,36,0,36,G
5-NP,1486,0,34,0,0,34,T
5-NP,1487,34,0,0,0,34,A
5-NP,1488,0,33,0,0,33,T
5-NP,1489,0,0,33,0,33,G
5-NP,1490,33,0,0,0,33,A
5-NP,1491,0,0,0,33,33,C
5-NP,1492,22,0,0,0,22,A
5-NP,1493,22,0,0,0,22,A
5-NP,1494,0,14,0,0,14,T
5-NP,1495,0,14,0,0,14,T
5-NP,1496,14,0,0,0,14,A
5-NP,1497,13,0,0,0,13,A
6-NA,1,82,0,0,0,82,A
6-NA,2,0,82,0,0,82,T
6-NA,3,0,0,82,0,82,G
6-NA,4,82,0,1,0,83,A
6-NA,5,91,0,0,0,91,A
6-NA,6,0,91,0,0,91,T
6-NA,7,0,0,0,91,91,C
6-NA,8,0,0,0,92,92,C
6-NA,9,93,0,0,0,93,A
6-NA,10,99,0,0,0,99,A
6-NA,11,98,0,0,0,98,A
6-NA,12,0,101,0,0,101,T
6-NA,13,0,0,0,101,101,C
6-NA,14,101,0,0,0,101,A
6-NA,15,103,0,0,0,103,A
6-NA,16,103,0,0,0,103,A
6-NA,17,111,0,1,0,112,A
6-NA,18,0,0,127,0,127,G
6-NA,19,131,0,0,0,131,A
6-NA,20,0,132,0,0,132,T
6-NA,21,132,0,0,0,132,A
6-NA,22,134,0,0,0,134,A
6-NA,23,0,134,0,0,134,T
6-NA,24,135,0,0,0,135,A
6-NA,25,136,0,0,0,136,A
6-NA,26,0,0,0,139,139,C
6-NA,27,0,1,141,0,142,G
6-NA,28,141,1,0,0,142,A
6-NA,29,0,143,0,0,143,T
6-NA,30,0,143,1,0,144,T
6-NA,31,0,0,146,0,146,G
6-NA,32,0,0,162,0,162,G
6-NA,33,0,0,0,160,160,C
6-NA,34,1,158,0,2,161,T
6-NA,35,0,0,0,172,172,C
6-NA,36,0,173,0,0,173,T
6-NA,37,0,0,177,1,178,G
6-NA,38,0,180,0,0,180,T
6-NA,39,0,178,0,1,179,T
6-NA,40,0,186,0,0,186,T
6-NA,41,0,0,0,187,187,C
6-NA,42,0,188,0,0,188,T
6-NA,43,0,0,0,189,189,C
6-NA,44,0,188,0,1,189,T
6-NA,45,0,0,0,191,191,C
6-NA,46,192,0,0,0,192,A
6-NA,47,0,0,0,199,199,C
6-NA,48,0,0,0,201,201,C
6-NA,49,201,0,0,0,201,A
6-NA,50,0,202,0,0,202,T
6-NA,51,0,206,0,0,206,T
6-NA,52,0,209,0,0,209,T
6-NA,53,0,0,0,214,214,C
6-NA,54,0,1,0,214,215,C
6-NA,55,220,0,1,0,221,A
6-NA,56,0,0,0,237,237,C
6-NA,57,238,0,0,0,238,A
6-NA,58,253,0,1,0,254,A
6-NA,59,0,252,0,1,253,T
6-NA,60,264,0,0,0,264,A
6-NA,61,0,266,0,0,266,T
6-NA,62,0,0,266,0,266,G
6-NA,63,0,0,0,266,266,C
6-NA,64,0,265,0,0,265,T
6-NA,65,0,274,0,0,274,T
6-NA,66,0,0,0,274,274,C
6-NA,67,0,271,0,1,272,T
6-NA,68,0,272,0,0,272,T
6-NA,69,0,0,0,269,269,C
6-NA,70,269,0,0,0,269,A
6-NA,71,0,269,0,1,270,T
6-NA,72,0,0,269,0,269,G
6-NA,73,0,0,0,270,270,C
6-NA,74,270,0,0,0,270,A
6-NA,75,270,0,0,0,270,A
6-NA,76,270,0,0,0,270,A
6-NA,77,0,279,0,0,279,T
6-NA,78,0,278,0,0,278,T
6-NA,79,0,0,278,0,278,G
6-NA,80,0,0,0,278,278,C
6-NA,81,0,0,0,282,282,C
6-NA,82,279,0,0,0,279,A
6-NA,83,0,283,0,0,283,T
6-NA,84,0,0,0,319,319,C
6-NA,85,0,319,1,0,320,T
6-NA,86,0,320,0,0,320,T
6-NA,87,0,0,326,0,326,G
6-NA,88,328,0,0,0,328,A
6-NA,89,0,331,0,1,332,T
6-NA,90,331,0,0,0,331,A
6-NA,91,329,1,0,0,330,A
6-NA,92,0,0,0,370,370,C
6-NA,93,0,368,0,0,368,T
6-NA,94,381,0,0,0,381,A
6-NA,95,0,0,0,401,401,C
6-NA,96,0,400,0,0,400,T
6-NA,97,0,0,403,0,403,G
6-NA,98,0,405,0,0,405,T
6-NA,99,406,0,0,0,406,A
6-NA,100,404,0,1,0,405,A
6-NA,101,0,0,0,401,401,C
6-NA,102,394,0,0,0,394,A
6-NA,103,0,395,0,0,395,T
6-NA,104,0,387,0,0,387,T
6-NA,105,1,0,384,0,385,G
6-NA,106,0,0,0,388,388,C
6-NA,107,395,0,0,0,395,A
6-NA,108,1,395,0,0,396,T
6-NA,109,0,393,0,1,394,T
6-NA,110,0,394,0,0,394,T
6-NA,111,0,0,0,393,393,C
6-NA,112,394,0,0,0,394,A
6-NA,113,395,0,1,0,396,A
6-NA,114,0,1,391,0,392,G
6-NA,115,0,0,0,398,398,C
6-NA,116,393,0,0,0,393,A
6-NA,117,405,1,0,0,406,A
6-NA,118,0,412,0,0,412,T
6-NA,119,409,0,2,0,411,A
6-NA,120,0,412,0,0,412,T
6-NA,121,0,3,424,1,428,G
6-NA,122,425,0,0,0,425,A
6-NA,123,436,0,0,0,436,A
6-NA,124,0,437,0,0,437,T
6-NA,125,0,435,0,0,435,T
6-NA,126,1,0,0,433,434,C
6-NA,127,430,0,0,0,430,A
6-NA,128,432,1,0,0,433,A
6-NA,129,0,0,0,434,434,C
6-NA,130,0,429,0,4,433,T
6-NA,131,1,0,0,432,433,C
6-NA,132,0,0,0,433,433,C
6-NA,133,0,0,0,439,439,C
6-NA,134,0,0,0,440,440,C
6-NA,135,2,0,0,439,441,C
6-NA,136,0,0,0,443,443,C
6-NA,137,0,0,0,443,443,C
6-NA,138,441,0,0,0,441,A
6-NA,139,439,0,1,0,440,A
6-NA,140,440,0,0,0,440,A
6-NA,141,0,0,0,457,457,C
6-NA,142,452,0,0,0,452,A
6-NA,143,454,0,2,0,456,A
6-NA,144,0,0,0,458,458,C
6-NA,145,0,0,0,456,456,C
6-NA,146,471,0,0,0,471,A
6-NA,147,475,0,0,0,475,A
6-NA,148,0,0,483,0,483,G
6-NA,149,0,486,0,0,486,T
6-NA,150,0,0,485,1,486,G
6-NA,151,493,1,0,0,494,A
6-NA,152,0,493,0,1,494,T
6-NA,153,0,0,493,0,493,G
6-NA,154,1,1,0,493,495,C
6-NA,155,0,494,0,0,494,T
6-NA,156,0,0,534,0,534,G
6-NA,157,0,530,0,1,531,T
6-NA,158,0,0,531,0,531,G
6-NA,159,0,531,0,1,532,T
6-NA,160,0,3,529,0,532,G
6-NA,161,533,0,2,0,535,A
6-NA,162,539,0,1,0,540,A
6-NA,163,1,1,0,536,538,C
6-NA,164,3,1,0,535,539,C
6-NA,165,524,0,1,0,525,A
6-NA,166,530,0,0,0,530,A
6-NA,167,0,1,1,559,561,C
6-NA,168,558,0,0,0,558,A
6-NA,169,562,0,0,0,562,A
6-NA,170,0,564,0,0,564,T
6-NA,171,560,0,1,0,561,A
6-NA,172,563,0,1,0,564,A
6-NA,173,0,562,0,0,562,T
6-NA,174,558,0,0,0,558,A
6-NA,175,0,0,563,0,563,G
6-NA,176,551,0,0,0,551,A
6-NA,177,554,0,0,0,554,A
6-NA,178,546,0,0,0,546,A
6-NA,179,0,1,545,0,546,G
6-NA,180,551,0,3,0,554,A
6-NA,181,558,0,0,0,558,A
6-NA,182,579,0,3,0,582,A
6-NA,183,0,0,0,586,586,C
6-NA,184,588,0,0,0,588,A
6-NA,185,0,595,0,0,595,T
6-NA,186,596,0,0,0,596,A
6-NA,187,603,0,1,0,604,A
6-NA,188,0,0,0,614,614,C
6-NA,189,606,2,0,0,608,A
6-NA,190,0,2,624,0,626,G
6-NA,191,617,0,2,0,619,A
6-NA,192,0,0,622,0,622,G
6-NA,193,626,0,1,0,627,A
6-NA,194,0,653,0,0,653,T
6-NA,195,647,0,1,0,648,A
6-NA,196,0,0,660,0,660,G
6-NA,197,0,647,0,0,647,T
6-NA,198,0,0,667,0,667,G
6-NA,199,0,659,0,0,659,T
6-NA,200,656,0,0,0,656,A
6-NA,201,0,653,0,2,655,T
6-NA,202,1,0,0,655,656,C
6-NA,203,0,641,0,0,641,T
6-NA,204,1,3,662,0,666,G
6-NA,205,666,1,0,0,667,A
6-NA,206,0,0,0,666,666,C
6-NA,207,0,0,0,664,664,C
6-NA,208,653,0,0,0,653,A
6-NA,209,658,0,0,0,658,A
6-NA,210,0,0,0,662,662,C
6-NA,211,662,0,0,0,662,A
6-NA,212,0,0,0,684,684,C
6-NA,213,3,0,0,671,674,C
6-NA,214,704,0,1,0,705,A
6-NA,215,1,0,0,727,728,C
6-NA,216,1,0,0,731,732,C
6-NA,217,736,0,0,0,736,A
6-NA,218,0,733,0,1,734,T
6-NA,219,728,0,1,0,729,A
6-NA,220,1,1,732,0,734,G
6-NA,221,719,0,0,0,719,A
6-NA,222,0,1,734,0,735,G
6-NA,223,729,0,0,0,729,A
6-NA,224,727,0,0,0,727,A
6-NA,225,1,2,725,0,728,G
6-NA,226,0,2,728,0,730,G
6-NA,227,732,0,0,0,732,A
6-NA,228,727,0,1,0,728,A
6-NA,229,728,1,0,0,729,A
6-NA,230,0,730,0,0,730,T
6-NA,231,731,0,0,0,731,A
6-NA,232,0,731,0,0,731,T
6-NA,233,2,0,726,0,728,G
6-NA,234,0,1,0,731,732,C
6-NA,235,1,0,0,723,724,C
6-NA,236,0,0,0,733,733,C
6-NA,237,0,0,0,731,731,C
6-NA,238,737,0,0,0,737,A
6-NA,239,751,0,0,0,751,A
6-NA,240,746,0,0,0,746,A
6-NA,241,0,0,1,749,750,C
6-NA,242,0,748,0,0,748,T
6-NA,243,743,0,1,0,744,A
6-NA,244,0,0,749,0,749,G
6-NA,245,0,0,0,748,748,C
6-NA,246,748,0,1,0,749,A
6-NA,247,0,2,757,0,759,G
6-NA,248,751,1,0,0,752,A
6-NA,249,767,0,1,0,768,A
6-NA,250,0,768,0,0,768,T
6-NA,251,767,1,2,0,770,A
6-NA,252,0,0,0,772,772,C
6-NA,253,766,0,0,2,768,A
6-NA,254,0,2,766,0,768,G
6-NA,255,761,0,0,0,761,A
6-NA,256,758,1,0,0,759,A
6-NA,257,758,1,0,1,760,A
6-NA,258,0,738,0,0,738,T
6-NA,259,0,732,0,0,732,T
6-NA,260,0,1,735,0,736,G
6-NA,261,0,0,735,1,736,G
6-NA,262,0,740,0,0,740,T
6-NA,263,1,1,0,738,740,C
6-NA,264,735,0,1,1,737,A
6-NA,265,738,0,0,1,739,A
6-NA,266,737,0,1,0,738,A
6-NA,267,0,0,740,0,740,G
6-NA,268,0,1,0,739,740,C
6-NA,269,0,0,0,735,735,C
6-NA,270,0,0,740,0,740,G
6-NA,271,0,0,0,742,742,C
6-NA,272,746,0,0,0,746,A
6-NA,273,756,0,0,0,756,A
6-NA,274,0,753,0,0,753,T
6-NA,275,0,0,758,0,758,G
6-NA,276,0,755,0,1,756,T
6-NA,277,0,3,752,0,755,G
6-NA,278,770,0,2,0,772,A
6-NA,279,0,1,0,779,780,C
6-NA,280,801,0,0,1,802,A
6-NA,281,0,816,0,0,816,T
6-NA,282,0,809,0,0,809,T
6-NA,283,811,0,2,0,813,A
6-NA,284,0,0,0,812,812,C
6-NA,285,802,0,0,0,802,A
6-NA,286,0,1,801,0,802,G
6-NA,287,0,0,789,0,789,G
6-NA,288,0,0,763,0,763,G
6-NA,289,1,793,0,1,795,T
6-NA,290,0,792,0,1,793,T
6-NA,291,0,798,0,0,798,T
6-NA,292,0,1,798,0,799,G
6-NA,293,0,0,1,791,792,C
6-NA,294,799,0,1,0,800,A
6-NA,295,0,0,0,801,801,C
6-NA,296,1,0,0,795,796,C
6-NA,297,0,788,0,0,788,T
6-NA,298,0,789,0,1,790,T
6-NA,299,0,792,0,0,792,T
6-NA,300,0,796,0,0,796,T
6-NA,301,0,804,0,0,804,T
6-NA,302,0,0,0,807,807,C
6-NA,303,1,802,0,0,803,T
6-NA,304,800,0,1,0,801,A
6-NA,305,798,0,0,0,798,A
6-NA,306,0,4,804,0,808,G
6-NA,307,0,3,805,0,808,G
6-NA,308,803,0,0,0,803,A
6-NA,309,0,0,0,804,804,C
6-NA,310,800,1,1,0,802,A
6-NA,311,799,0,0,0,799,A
6-NA,312,0,794,1,0,795,T
6-NA,313,0,801,0,0,801,T
6-NA,314,1,0,0,818,819,C
6-NA,315,0,0,819,0,819,G
6-NA,316,818,0,0,1,819,A
6-NA,317,0,817,0,0,817,T
6-NA,318,0,821,0,0,821,T
6-NA,319,816,0,0,1,817,A
6-NA,320,0,1,819,0,820,G
6-NA,321,0,0,820,0,820,G
6-NA,322,1,0,0,814,815,C
6-NA,323,0,806,0,1,807,T
6-NA,324,0,808,1,0,809,T
6-NA,325,1,809,0,1,811,T
6-NA,326,1,0,0,811,812,C
6-NA,327,2,1,0,806,809,C
6-NA,328,0,0,810,0,810,G
6-NA,329,0,0,0,814,814,C
6-NA,330,0,801,0,1,802,T
6-NA,331,0,0,828,0,828,G
6-NA,332,0,0,828,0,828,G
6-NA,333,0,823,0,1,824,T
6-NA,334,0,0,826,0,826,G
6-NA,335,0,2,824,0,826,G
6-NA,336,0,1,823,0,824,G
6-NA,337,0,0,826,0,826,G
6-NA,338,826,0,1,0,827,A
6-NA,339,0,0,0,837,837,C
6-NA,340,817,0,2,0,819,A
6-NA,341,0,816,0,1,817,T
6-NA,342,0,0,0,816,816,C
6-NA,343,0,812,0,0,812,T
6-NA,344,0,1,816,0,817,G
6-NA,345,0,0,812,0,812,G
6-NA,346,0,1,817,0,818,G
6-NA,347,0,820,0,0,820,T
6-NA,348,0,0,809,0,809,G
6-NA,349,809,1,0,0,810,A
6-NA,350,1,1,0,829,831,C
6-NA,351,828,0,0,0,828,A
6-NA,352,832,1,0,0,833,A
6-NA,353,1,2,835,0,838,G
6-NA,354,833,0,0,0,833,A
6-NA,355,0,1,836,1,838,G
6-NA,356,844,0,0,0,844,A
6-NA,357,861,0,1,0,862,A
6-NA,358,0,1,0,915,916,C
6-NA,359,1,1,0,924,926,C
6-NA,360,1,917,1,2,921,T
6-NA,361,0,921,1,0,922,T
6-NA,362,919,0,1,1,921,A
6-NA,363,0,919,0,0,919,T
6-NA,364,1,1,934,0,936,G
6-NA,365,0,930,0,3,933,T
6-NA,366,0,0,934,0,934,G
6-NA,367,0,910,0,1,911,T
6-NA,368,1,1,0,905,907,C
6-NA,369,909,1,1,2,913,A
6-NA,370,0,917,0,0,917,T
6-NA,371,0,1,917,0,918,G
6-NA,372,0,1,0,915,916,C
6-NA,373,0,1,910,0,911,G
6-NA,374,975,0,0,0,975,A
6-NA,375,0,986,0,0,986,T
6-NA,376,5,0,0,992,997,C
6-NA,377,1,0,0,999,1000,C
6-NA,378,0,994,0,1,995,T
6-NA,379,0,1,1000,0,1001,G
6-NA,380,1001,0,1,0,1002,A
6-NA,381,0,1,1,1004,1006,C
6-NA,382,1002,0,2,0,1004,A
6-NA,383,975,0,1,0,976,A
6-NA,384,2,0,1004,0,1006,G
6-NA,385,0,1001,0,0,1001,T
6-NA,386,0,0,1009,0,1009,G
6-NA,387,0,999,0,1,1000,T
6-NA,388,0,994,0,1,995,T
6-NA,389,994,0,0,0,994,A
6-NA,390,0,993,0,0,993,T
6-NA,391,0,0,0,1003,1003,C
6-NA,392,1000,0,0,0,1000,A
6-NA,393,995,0,1,0,996,A
6-NA,394,1,988,1,0,990,T
6-NA,395,0,985,0,1,986,T
6-NA,396,0,986,0,1,987,T
6-NA,397,0,2,992,0,994,G
6-NA,398,0,1,0,1039,1040,C
6-NA,399,2,1,0,1035,1038,C
6-NA,400,3,0,0,1038,1041,C
6-NA,401,0,1037,0,0,1037,T
6-NA,402,0,1036,0,2,1038,T
6-NA,403,1,1,1046,0,1048,G
6-NA,404,0,1,1045,0,1046,G
6-NA,405,1056,0,1,0,1057,A
6-NA,406,0,0,0,1055,1055,C
6-NA,407,1028,0,0,0,1028,A
6-NA,408,0,4,1049,0,1053,G
6-NA,409,0,1,1045,1,1047,G
6-NA,410,3,2,1062,0,1067,G
6-NA,411,1073,0,3,0,1076,A
6-NA,412,1063,0,0,0,1063,A
6-NA,413,0,0,0,1063,1063,C
6-NA,414,1020,0,0,0,1020,A
6-NA,415,1090,0,1,1,1092,A
6-NA,416,0,0,0,1095,1095,C
6-NA,417,1087,0,1,0,1088,A
6-NA,418,1,0,0,1091,1092,C
6-NA,419,0,1078,0,0,1078,T
6-NA,420,1083,0,2,0,1085,A
6-NA,421,1080,0,2,0,1082,A
6-NA,422,1088,0,1,0,1089,A
6-NA,423,0,0,0,1091,1091,C
6-NA,424,1017,0,1,0,1018,A
6-NA,425,1025,0,0,0,1025,A
6-NA,426,0,1,0,1021,1022,C
6-NA,427,0,0,1009,0,1009,G
6-NA,428,0,1005,0,0,1005,T
6-NA,429,989,1,0,0,990,A
6-NA,430,0,0,0,1001,1001,C
6-NA,431,1002,0,0,0,1002,A
6-NA,432,0,1007,0,0,1007,T
6-NA,433,0,1011,0,0,1011,T
6-NA,434,3,1,0,1035,1039,C
6-NA,435,1059,0,1,0,1060,A
6-NA,436,1068,0,1,0,1069,A
6-NA,437,1067,0,1,0,1068,A
6-NA,438,0,1067,0,1,1068,T
6-NA,439,1049,0,0,0,1049,A
6-NA,440,1080,0,2,0,1082,A
6-NA,441,0,0,0,1085,1085,C
6-NA,442,1087,0,0,0,1087,A
6-NA,443,0,0,0,1100,1100,C
6-NA,444,1053,1,2,0,1056,A
6-NA,445,1,0,1227,0,1228,G
6-NA,446,0,1226,0,1,1227,T
6-NA,447,1244,0,1,0,1245,A
6-NA,448,0,0,0,1246,1246,C
6-NA,449,1,2,1233,0,1236,G
6-NA,450,0,1289,0,0,1289,T
6-NA,451,0,2,1283,0,1285,G
6-NA,452,1287,2,0,0,1289,A
6-NA,453,0,1301,0,0,1301,T
6-NA,454,1190,0,0,0,1190,A
6-NA,455,0,0,1192,0,1192,G
6-NA,456,0,2,1187,0,1189,G
6-NA,457,1190,0,0,0,1190,A
6-NA,458,0,0,0,1204,1204,C
6-NA,459,3,1,0,1166,1170,C
6-NA,460,0,0,0,1180,1180,C
6-NA,461,3,0,0,1174,1177,C
6-NA,462,1,1187,0,1,1189,T
6-NA,463,0,1202,0,0,1202,T
6-NA,464,1202,0,0,0,1202,A
6-NA,465,0,1200,0,1,1201,T
6-NA,466,0,2,0,1193,1195,C
6-NA,467,0,1,1187,1,1189,G
6-NA,468,1,3,1184,0,1188,G
6-NA,469,1188,0,0,0,1188,A
6-NA,470,0,1,0,1200,1201,C
6-NA,471,2,0,0,1188,1190,C
6-NA,472,0,1,0,1260,1261,C
6-NA,473,0,1259,0,2,1261,T
6-NA,474,1283,0,0,0,1283,A
6-NA,475,0,1284,0,0,1284,T
6-NA,476,0,1286,0,0,1286,T
6-NA,477,0,1,1285,0,1286,G
6-NA,478,1281,0,1,0,1282,A
6-NA,479,0,1272,0,1,1273,T
6-NA,480,0,3,1270,0,1273,G
6-NA,481,1227,0,0,0,1227,A
6-NA,482,1232,0,2,0,1234,A
6-NA,483,0,1223,0,1,1224,T
6-NA,484,0,2,1241,0,1243,G
6-NA,485,1269,1,1,0,1271,A
6-NA,486,1,1,1283,0,1285,G
6-NA,487,0,1283,0,1,1284,T
6-NA,488,0,1274,0,1,1275,T
6-NA,489,1279,1,1,0,1281,A
6-NA,490,0,0,1284,0,1284,G
6-NA,491,1,0,1283,0,1284,G
6-NA,492,0,1278,0,2,1280,T
6-NA,493,0,0,1276,0,1276,G
6-NA,494,0,1252,0,0,1252,T
6-NA,495,0,1240,0,4,1244,T
6-NA,496,2,0,0,1254,1256,C
6-NA,497,2,0,0,1270,1272,C
6-NA,498,0,1259,0,4,1263,T
6-NA,499,0,1261,0,0,1261,T
6-NA,500,0,1258,0,3,1261,T
6-NA,501,0,1260,0,2,1262,T
6-NA,502,3,1,0,1256,1260,C
6-NA,503,1259,0,0,0,1259,A
6-NA,504,1,1284,0,0,1285,T
6-NA,505,0,0,0,1287,1287,C
6-NA,506,0,1263,0,0,1263,T
6-NA,507,1,2,1259,0,1262,G
6-NA,508,1,2,1251,0,1254,G
6-NA,509,1,0,1255,0,1256,G
6-NA,510,0,6,1256,0,1262,G
6-NA,511,1253,0,3,0,1256,A
6-NA,512,0,0,0,1275,1275,C
6-NA,513,0,0,0,1254,1254,C
6-NA,514,1270,1,0,0,1271,A
6-NA,515,1272,0,2,0,1274,A
6-NA,516,0,0,1275,0,1275,G
6-NA,517,1,0,0,1279,1280,C
6-NA,518,1277,0,0,0,1277,A
6-NA,519,1286,1,0,0,1287,A
6-NA,520,1,0,1294,0,1295,G
6-NA,521,1,1284,0,0,1285,T
6-NA,522,0,0,1333,0,1333,G
6-NA,523,0,1319,0,1,1320,T
6-NA,524,0,0,1351,0,1351,G
6-NA,525,1,0,0,1349,1350,C
6-NA,526,1346,0,1,0,1347,A
6-NA,527,0,1365,0,0,1365,T
6-NA,528,1336,0,1,0,1337,A
6-NA,529,0,1,1371,0,1372,G
6-NA,530,1,0,0,1369,1370,C
6-NA,531,1337,0,1,0,1338,A
6-NA,532,0,1337,0,0,1337,T
6-NA,533,0,4,1301,0,1305,G
6-NA,534,0,0,1374,0,1374,G
6-NA,535,0,1383,0,1,1384,T
6-NA,536,2,0,0,1373,1375,C
6-NA,537,1,0,0,1386,1387,C
6-NA,538,1376,0,1,0,1377,A
6-NA,539,0,0,1410,0,1410,G
6-NA,540,2,0,0,1410,1412,C
6-NA,541,0,1409,0,1,1410,T
6-NA,542,1,1,0,1411,1413,C
6-NA,543,1370,0,0,0,1370,A
6-NA,544,1376,1,1,0,1378,A
6-NA,545,0,0,1384,0,1384,G
6-NA,546,0,1423,0,0,1423,T
6-NA,547,0,1416,0,3,1419,T
6-NA,548,0,0,1414,0,1414,G
6-NA,549,0,1409,0,5,1414,T
6-NA,550,5,1,0,1401,1407,C
6-NA,551,1413,0,2,0,1415,A
6-NA,552,0,2,0,1422,1424,C
6-NA,553,0,2,1418,0,1420,G
6-NA,554,1438,0,1,0,1439,A
6-NA,555,1,1439,0,1,1441,T
6-NA,556,1,0,1464,0,1465,G
6-NA,557,0,0,1466,0,1466,G
6-NA,558,1458,0,6,0,1464,A
6-NA,559,1465,0,1,1,1467,A
6-NA,560,1486,0,0,0,1486,A
6-NA,561,1488,0,1,0,1489,A
6-NA,562,0,1,1511,0,1512,G
6-NA,563,0,0,0,1509,1509,C
6-NA,564,1501,1,3,0,1505,A
6-NA,565,1,1499,0,0,1500,T
6-NA,566,0,1,1508,0,1509,G
6-NA,567,0,0,1522,0,1522,G
6-NA,568,0,0,0,1529,1529,C
6-NA,569,0,1517,0,5,1522,T
6-NA,570,1,0,1526,1,1528,G
6-NA,571,0,1,0,1517,1518,C
6-NA,572,1527,0,0,0,1527,A
6-NA,573,0,1574,0,0,1574,T
6-NA,574,0,0,1576,0,1576,G
6-NA,575,0,1578,1,1,1580,T
6-NA,576,0,1609,0,2,1611,T
6-NA,577,0,1604,0,3,1607,T
6-NA,578,0,0,1702,0,1702,G
6-NA,579,0,1698,0,1,1699,T
6-NA,580,1702,0,0,0,1702,A
6-NA,581,0,1701,0,0,1701,T
6-NA,582,1680,0,1,1,1682,A
6-NA,583,1689,1,0,0,1690,A
6-NA,584,0,0,0,1679,1679,C
6-NA,585,1,0,1667,1,1669,G
6-NA,586,0,2,1680,0,1682,G
6-NA,587,0,3,1647,0,1650,G
6-NA,588,0,3,1657,0,1660,G
6-NA,589,1,1,1662,0,1664,G
6-NA,590,1660,1,2,0,1663,A
6-NA,591,0,1664,0,1,1665,T
6-NA,592,2,3,1656,0,1661,G
6-NA,593,1668,0,5,0,1673,A
6-NA,594,0,1676,0,1,1677,T
6-NA,595,1674,0,0,0,1674,A
6-NA,596,1729,0,1,0,1730,A
6-NA,597,1730,0,1,0,1731,A
6-NA,598,1732,0,1,1,1734,A
6-NA,599,1740,1,0,0,1741,A
6-NA,600,0,1744,1,0,1745,T
6-NA,601,2,1,1744,1,1748,G
6-NA,602,0,1,0,1733,1734,C
6-NA,603,1739,0,0,0,1739,A
6-NA,604,1740,0,2,0,1742,A
6-NA,605,0,0,0,1759,1759,C
6-NA,606,0,1760,0,2,1762,T
6-NA,607,0,0,1769,0,1769,G
6-NA,608,0,1,0,1765,1766,C
6-NA,609,0,1768,0,1,1769,T
6-NA,610,1769,0,3,0,1772,A
6-NA,611,1,1,1775,0,1777,G
6-NA,612,0,0,0,1776,1776,C
6-NA,613,0,1773,0,7,1780,T
6-NA,614,0,1776,0,2,1778,T
6-NA,615,3,1,0,1800,1804,C
6-NA,616,1804,1,2,0,1807,A
6-NA,617,0,1804,0,3,1807,T
6-NA,618,1,1806,0,1,1808,T
6-NA,619,0,1814,1,0,1815,T
6-NA,620,1818,2,0,0,1820,A
6-NA,621,0,0,0,1833,1833,C
6-NA,622,1832,0,0,0,1832,A
6-NA,623,1837,0,1,1,1839,A
6-NA,624,0,1826,0,0,1826,T
6-NA,625,0,0,1824,0,1824,G
6-NA,626,0,1,1820,0,1821,G
6-NA,627,0,2,1815,0,1817,G
6-NA,628,1805,1,1,1,1808,A
6-NA,629,1,0,1844,0,1845,G
6-NA,630,0,1,1854,0,1855,G
6-NA,631,0,1,0,2002,2003,C
6-NA,632,1,1999,0,3,2003,T
6-NA,633,0,2013,0,0,2013,T
6-NA,634,1,0,2027,0,2028,G
6-NA,635,1,2023,0,1,2025,T
6-NA,636,2042,0,3,0,2045,A
6-NA,637,0,0,2050,1,2051,G
6-NA,638,2027,0,0,0,2027,A
6-NA,639,0,2033,0,1,2034,T
6-NA,640,1871,0,1,0,1872,A
6-NA,641,2,0,1866,0,1868,G
6-NA,642,0,1808,0,2,1810,T
6-NA,643,0,1,1767,0,1768,G
6-NA,644,0,1832,0,0,1832,T
6-NA,645,0,1830,0,0,1830,T
6-NA,646,3,1,1853,0,1857,G
6-NA,647,0,1847,0,3,1850,T
6-NA,648,0,1845,1,3,1849,T
6-NA,649,0,1846,0,1,1847,T
6-NA,650,3,0,0,1817,1820,C
6-NA,651,1814,0,3,1,1818,A
6-NA,652,0,1809,0,0,1809,T
6-NA,653,0,1,1804,0,1805,G
6-NA,654,1,1,1910,1,1913,G
6-NA,655,0,1880,0,1,1881,T
6-NA,656,4,0,0,1864,1868,C
6-NA,657,1,0,0,1859,1860,C
6-NA,658,1874,0,1,0,1875,A
6-NA,659,1883,1,0,0,1884,A
6-NA,660,1884,0,1,0,1885,A
6-NA,661,0,2,1890,0,1892,G
6-NA,662,1884,0,2,0,1886,A
6-NA,663,1804,1,0,0,1805,A
6-NA,664,1810,0,2,0,1812,A
6-NA,665,0,1809,0,1,1810,T
6-NA,666,3,0,0,1863,1866,C
6-NA,667,0,0,0,1860,1860,C
6-NA,668,1,1841,0,5,1847,T
6-NA,669,1,0,0,1856,1857,C
6-NA,670,1847,1,2,0,1850,A
6-NA,671,1,1,1862,0,1864,G
6-NA,672,0,5,1857,0,1862,G
6-NA,673,1923,0,1,0,1924,A
6-NA,674,1,2,0,1918,1921,C
6-NA,675,2,1,0,1893,1896,C
6-NA,676,1,1,1,1892,1895,C
6-NA,677,1898,1,0,0,1899,A
6-NA,678,0,0,1907,0,1907,G
6-NA,679,3,2,1901,0,1906,G
6-NA,680,1903,3,0,0,1906,A
6-NA,681,1,0,1921,0,1922,G
6-NA,682,0,1883,0,3,1886,T
6-NA,683,6,1,0,1881,1888,C
6-NA,684,1878,1,3,0,1882,A
6-NA,685,1,3,1898,0,1902,G
6-NA,686,1896,1,2,1,1900,A
6-NA,687,1896,0,1,0,1897,A
6-NA,688,0,1886,0,2,1888,T
6-NA,689,0,1,1903,0,1904,G
6-NA,690,1,0,0,1902,1903,C
6-NA,691,1,0,1914,0,1915,G
6-NA,692,0,1912,0,2,1914,T
6-NA,693,0,1913,0,2,1915,T
6-NA,694,0,1903,0,0,1903,T
6-NA,695,2,0,1920,0,1922,G
6-NA,696,0,1920,0,2,1922,T
6-NA,697,1925,0,1,0,1926,A
6-NA,698,1,1917,0,1,1919,T
6-NA,699,3,0,1,1917,1921,C
6-NA,700,1913,1,1,0,1915,A
6-NA,701,1917,0,0,1,1918,A
6-NA,702,1,1915,0,0,1916,T
6-NA,703,0,1,1917,0,1918,G
6-NA,704,1,6,1917,0,1924,G
6-NA,705,1947,0,3,0,1950,A
6-NA,706,1955,0,1,0,1956,A
6-NA,707,3,1,0,1968,1972,C
6-NA,708,1,1957,0,3,1961,T
6-NA,709,0,1962,0,1,1963,T
6-NA,710,1,1,2039,0,2041,G
6-NA,711,1,2039,0,2,2042,T
6-NA,712,2034,1,2,0,2037,A
6-NA,713,0,0,0,2079,2079,C
6-NA,714,2003,0,0,0,2003,A
6-NA,715,2,0,2147,0,2149,G
6-NA,716,0,2136,0,0,2136,T
6-NA,717,2200,0,0,0,2200,A
6-NA,718,0,3,2203,0,2206,G
6-NA,719,0,2156,0,2,2158,T
6-NA,720,2156,0,2,1,2159,A
6-NA,721,2158,1,0,0,2159,A
6-NA,722,0,2141,0,0,2141,T
6-NA,723,1,9,2139,0,2149,G
6-NA,724,2091,0,2,0,2093,A
6-NA,725,0,1,0,2105,2106,C
6-NA,726,1,2048,0,1,2050,T
6-NA,727,3,1,2052,0,2056,G
6-NA,728,2046,0,3,1,2050,A
6-NA,729,0,2052,0,2,2054,T
6-NA,730,4,3,2049,0,2056,G
6-NA,731,1,2,2037,0,2040,G
6-NA,732,3,3,2034,0,2040,G
6-NA,733,2017,0,5,0,2022,A
6-NA,734,0,0,2025,1,2026,G
6-NA,735,1,2013,0,0,2014,T
6-NA,736,1,0,2025,0,2026,G
6-NA,737,1,0,0,2043,2044,C
6-NA,738,2,2031,0,1,2034,T
6-NA,739,0,2039,0,1,2040,T
6-NA,740,4,2,0,2032,2038,C
6-NA,741,2034,2,1,0,2037,A
6-NA,742,0,0,2051,0,2051,G
6-NA,743,0,1,2045,0,2046,G
6-NA,744,2044,0,1,0,2045,A
6-NA,745,2027,0,1,0,2028,A
6-NA,746,2013,0,2,0,2015,A
6-NA,747,2017,2,6,0,2025,A
6-NA,748,1,0,2038,0,2039,G
6-NA,749,0,0,3,2034,2037,C
6-NA,750,0,2030,0,2,2032,T
6-NA,751,1,2,2030,0,2033,G
6-NA,752,2030,0,0,0,2030,A
6-NA,753,0,2054,0,0,2054,T
6-NA,754,2059,0,1,0,2060,A
6-NA,755,0,1,0,2140,2141,C
6-NA,756,0,2128,0,1,2129,T
6-NA,757,2124,0,3,0,2127,A
6-NA,758,2119,0,2,0,2121,A
6-NA,759,2121,0,1,0,2122,A
6-NA,760,2166,0,0,0,2166,A
6-NA,761,0,2168,0,0,2168,T
6-NA,762,2167,0,0,0,2167,A
6-NA,763,0,1,0,2178,2179,C
6-NA,764,0,2085,0,1,2086,T
6-NA,765,2107,1,1,0,2109,A
6-NA,766,0,2094,0,3,2097,T
6-NA,767,0,2167,0,1,2168,T
6-NA,768,3,0,0,2171,2174,C
6-NA,769,2133,1,1,0,2135,A
6-NA,770,0,2133,0,1,2134,T
6-NA,771,0,2120,0,1,2121,T
6-NA,772,2,2,2124,0,2128,G
6-NA,773,2106,0,2,0,2108,A
6-NA,774,0,1,2115,0,2116,G
6-NA,775,0,1,2104,1,2106,G
6-NA,776,2041,0,2,0,2043,A
6-NA,777,0,4,2065,0,2069,G
6-NA,778,0,4,2066,0,2070,G
6-NA,779,0,1,2076,0,2077,G
6-NA,780,0,0,2077,1,2078,G
6-NA,781,2059,0,2,0,2061,A
6-NA,782,2072,1,1,0,2074,A
6-NA,783,2061,1,0,0,2062,A
6-NA,784,2066,0,0,0,2066,A
6-NA,785,1,2072,0,0,2073,T
6-NA,786,5,3,0,2045,2053,C
6-NA,787,1,1,2066,0,2068,G
6-NA,788,0,2062,0,0,2062,T
6-NA,789,0,2055,1,6,2062,T
6-NA,790,8,0,0,2060,2068,C
6-NA,791,2055,0,1,0,2056,A
6-NA,792,1,2192,0,1,2194,T
6-NA,793,2190,1,1,0,2192,A
6-NA,794,0,2,0,2202,2204,C
6-NA,795,1,2200,1,1,2203,T
6-NA,796,2188,0,0,0,2188,A
6-NA,797,1,1,2190,0,2192,G
6-NA,798,2,0,1,2182,2185,C
6-NA,799,2181,2,2,0,2185,A
6-NA,800,0,2,0,2191,2193,C
6-NA,801,2077,1,1,0,2079,A
6-NA,802,0,2332,0,1,2333,T
6-NA,803,2,2322,0,2,2326,T
6-NA,804,0,0,2448,0,2448,G
6-NA,805,1,2435,0,1,2437,T
6-NA,806,5,0,0,2429,2434,C
6-NA,807,2435,1,2,0,2438,A
6-NA,808,0,2,2445,0,2447,G
6-NA,809,2,1,2441,0,2444,G
6-NA,810,2440,0,0,0,2440,A
6-NA,811,2405,2,1,0,2408,A
6-NA,812,0,0,2440,0,2440,G
6-NA,813,0,2302,0,0,2302,T
6-NA,814,1,2,2313,0,2316,G
6-NA,815,1,0,0,2313,2314,C
6-NA,816,0,2308,0,0,2308,T
6-NA,817,3,1,1,2311,2316,C
6-NA,818,2293,0,2,0,2295,A
6-NA,819,0,0,2305,0,2305,G
6-NA,820,0,0,0,2308,2308,C
6-NA,821,2301,0,0,0,2301,A
6-NA,822,0,2308,0,0,2308,T
6-NA,823,0,0,2353,0,2353,G
6-NA,824,1,2350,0,2,2353,T
6-NA,825,5,4,0,2338,2347,C
6-NA,826,1,2,2345,0,2348,G
6-NA,827,2338,0,0,0,2338,A
6-NA,828,0,2,2329,0,2331,G
6-NA,829,1,2,2337,0,2340,G
6-NA,830,2316,1,2,0,2319,A
6-NA,831,0,0,2346,0,2346,G
6-NA,832,0,2278,0,1,2279,T
6-NA,833,1,0,2291,0,2292,G
6-NA,834,0,0,0,2315,2315,C
6-NA,835,0,2304,0,2,2306,T
6-NA,836,5,0,0,2311,2316,C
6-NA,837,1,1,0,2315,2317,C
6-NA,838,1,2311,0,2,2314,T
6-NA,839,1,1,2322,0,2324,G
6-NA,840,0,0,0,2301,2301,C
6-NA,841,2,2281,0,6,2289,T
6-NA,842,2304,2,0,0,2306,A
6-NA,843,0,2265,0,1,2266,T
6-NA,844,1,0,0,2269,2270,C
6-NA,845,0,1,0,2265,2266,C
6-NA,846,0,2247,0,1,2248,T
6-NA,847,0,2,1,2258,2261,C
6-NA,848,1,1,2257,0,2259,G
6-NA,849,2272,0,2,0,2274,A
6-NA,850,0,2267,0,4,2271,T
6-NA,851,2269,0,0,0,2269,A
6-NA,852,0,2267,0,0,2267,T
6-NA,853,1,0,3,2251,2255,C
6-NA,854,5,0,0,2246,2251,C
6-NA,855,1,2216,0,5,2222,T
6-NA,856,2,4,2222,0,2228,G
6-NA,857,2,0,2237,0,2239,G
6-NA,858,0,2259,0,1,2260,T
6-NA,859,1,2,2260,0,2263,G
6-NA,860,0,2239,0,2,2241,T
6-NA,861,7,1,0,2235,2243,C
6-NA,862,2246,0,0,0,2246,A
6-NA,863,0,0,2254,1,2255,G
6-NA,864,2251,2,2,0,2255,A
6-NA,865,0,2232,0,0,2232,T
6-NA,866,0,0,2230,0,2230,G
6-NA,867,0,2191,0,2,2193,T
6-NA,868,1,1,2190,2,2194,G
6-NA,869,2,2189,0,4,2195,T
6-NA,870,3,1,0,2191,2195,C
6-NA,871,0,2189,0,5,2194,T
6-NA,872,4,1,2193,0,2198,G
6-NA,873,0,1,0,2194,2195,C
6-NA,874,2193,0,1,0,2194,A
6-NA,875,0,2,2193,0,2195,G
6-NA,876,2147,0,2,0,2149,A
6-NA,877,1,3,2147,2,2153,G
6-NA,878,2146,0,1,0,2147,A
6-NA,879,2,2,0,2150,2154,C
6-NA,880,2149,0,1,0,2150,A
6-NA,881,2150,2,2,1,2155,A
6-NA,882,1,1,0,2201,2203,C
6-NA,883,0,2199,0,1,2200,T
6-NA,884,0,2,2205,0,2207,G
6-NA,885,0,4,2200,0,2204,G
6-NA,886,2190,0,3,1,2194,A
6-NA,887,2190,0,0,0,2190,A
6-NA,888,2140,0,2,1,2143,A
6-NA,889,0,2,2142,0,2144,G
6-NA,890,0,4,2115,0,2119,G
6-NA,891,2000,1,0,0,2001,A
6-NA,892,0,2055,0,1,2056,T
6-NA,893,4,0,0,2064,2068,C
6-NA,894,2,0,0,2104,2106,C
6-NA,895,2106,0,1,0,2107,A
6-NA,896,2100,2,2,1,2105,A
6-NA,897,0,2101,0,0,2101,T
6-NA,898,2039,0,1,1,2041,A
6-NA,899,0,0,2025,0,2025,G
6-NA,900,0,0,2015,0,2015,G
6-NA,901,2,0,0,2011,2013,C
6-NA,902,1,1,0,1991,1993,C
6-NA,903,2,1,0,1939,1942,C
6-NA,904,1945,0,0,0,1945,A
6-NA,905,0,1956,0,2,1958,T
6-NA,906,1,0,0,1959,1960,C
6-NA,907,0,0,1960,0,1960,G
6-NA,908,0,1947,0,1,1948,T
6-NA,909,1917,0,0,1,1918,A
6-NA,910,0,2,1948,0,1950,G
6-NA,911,1952,0,2,0,1954,A
6-NA,912,0,1945,0,1,1946,T
6-NA,913,1922,0,0,1,1923,A
6-NA,914,0,1896,0,0,1896,T
6-NA,915,1897,0,1,0,1898,A
6-NA,916,1887,0,2,0,1889,A
6-NA,917,1916,0,0,1,1917,A
6-NA,918,1,0,0,1947,1948,C
6-NA,919,1887,1,1,0,1889,A
6-NA,920,0,1886,0,0,1886,T
6-NA,921,1869,0,2,0,1871,A
6-NA,922,1873,0,1,0,1874,A
6-NA,923,1875,0,1,0,1876,A
6-NA,924,0,1,1886,0,1887,G
6-NA,925,0,3,1915,0,1918,G
6-NA,926,1858,0,1,0,1859,A
6-NA,927,0,1826,1,2,1829,T
6-NA,928,6,0,0,1825,1831,C
6-NA,929,1840,0,0,0,1840,A
6-NA,930,1,1843,0,0,1844,T
6-NA,931,1838,1,3,0,1842,A
6-NA,932,1,1,1846,0,1848,G
6-NA,933,0,0,0,1814,1814,C
6-NA,934,1768,1,0,0,1769,A
6-NA,935,1,1655,1,1,1658,T
6-NA,936,1,1659,0,1,1661,T
6-NA,937,0,2,1660,0,1662,G
6-NA,938,0,1668,0,1,1669,T
6-NA,939,6,1,0,1621,1628,C
6-NA,940,1,1711,0,3,1715,T
6-NA,941,3,0,0,1719,1722,C
6-NA,942,3,0,0,1730,1733,C
6-NA,943,1739,1,1,0,1741,A
6-NA,944,1,1,1761,0,1763,G
6-NA,945,0,1756,0,1,1757,T
6-NA,946,1,1663,0,0,1664,T
6-NA,947,1663,0,1,0,1664,A
6-NA,948,0,1613,0,0,1613,T
6-NA,949,0,0,1615,0,1615,G
6-NA,950,0,1570,0,4,1574,T
6-NA,951,1,0,1581,0,1582,G
6-NA,952,0,1528,0,2,1530,T
6-NA,953,2,0,1547,0,1549,G
6-NA,954,0,1546,0,1,1547,T
6-NA,955,0,1538,2,0,1540,T
6-NA,956,4,1,0,1533,1538,C
6-NA,957,1526,0,2,0,1528,A
6-NA,958,1,4,1542,1,1548,G
6-NA,959,0,4,1546,0,1550,G
6-NA,960,1527,0,0,0,1527,A
6-NA,961,0,0,0,1539,1539,C
6-NA,962,0,1477,0,1,1478,T
6-NA,963,1,1480,0,0,1481,T
6-NA,964,0,0,1522,0,1522,G
6-NA,965,0,1520,0,1,1521,T
6-NA,966,0,1519,0,3,1522,T
6-NA,967,4,0,1505,0,1509,G
6-NA,968,0,1,1500,0,1501,G
6-NA,969,1503,0,0,0,1503,A
6-NA,970,1,3,1502,0,1506,G
6-NA,971,1503,0,0,0,1503,A
6-NA,972,1,0,0,1499,1500,C
6-NA,973,1470,0,0,0,1470,A
6-NA,974,1,1,0,1475,1477,C
6-NA,975,1473,0,0,1,1474,A
6-NA,976,0,1,1,1478,1480,C
6-NA,977,2,0,0,1468,1470,C
6-NA,978,1,2,0,1478,1481,C
6-NA,979,1477,0,1,0,1478,A
6-NA,980,1,2,1482,0,1485,G
6-NA,981,1485,0,1,0,1486,A
6-NA,982,1492,0,0,0,1492,A
6-NA,983,1483,1,2,0,1486,A
6-NA,984,1479,0,0,0,1479,A
6-NA,985,1480,0,2,0,1482,A
6-NA,986,1484,1,0,0,1485,A
6-NA,987,0,1,0,1484,1485,C
6-NA,988,3,5,1474,0,1482,G
6-NA,989,1475,0,0,0,1475,A
6-NA,990,0,0,0,1474,1474,C
6-NA,991,1469,1,0,0,1470,A
6-NA,992,1,0,1480,0,1481,G
6-NA,993,0,1,0,1526,1527,C
6-NA,994,0,1518,0,2,1520,T
6-NA,995,1,1,0,1510,1512,C
6-NA,996,2,0,0,1521,1523,C
6-NA,997,1527,0,1,0,1528,A
6-NA,998,0,0,1540,0,1540,G
6-NA,999,1,1,0,1534,1536,C
6-NA,1000,1526,2,0,0,1528,A
6-NA,1001,0,0,1529,0,1529,G
6-NA,1002,0,1470,0,1,1471,T
6-NA,1003,1471,0,0,0,1471,A
6-NA,1004,0,0,1474,0,1474,G
6-NA,1005,0,2,0,1465,1467,C
6-NA,1006,1,0,1,1476,1478,C
6-NA,1007,1450,0,1,0,1451,A
6-NA,1008,0,1450,0,2,1452,T
6-NA,1009,0,1435,0,0,1435,T
6-NA,1010,0,0,1464,0,1464,G
6-NA,1011,0,1456,0,2,1458,T
6-NA,1012,0,1458,0,1,1459,T
6-NA,1013,1,1451,0,2,1454,T
6-NA,1014,0,2,1445,0,1447,G
6-NA,1015,0,0,1460,0,1460,G
6-NA,1016,1457,0,1,0,1458,A
6-NA,1017,1,1482,0,1,1484,T
6-NA,1018,4,1,0,1480,1485,C
6-NA,1019,1,0,0,1473,1474,C
6-NA,1020,1,1467,0,0,1468,T
6-NA,1021,1455,0,19,0,1474,A
6-NA,1022,1473,1,0,0,1474,A
6-NA,1023,0,0,0,1503,1503,C
6-NA,1024,1483,0,0,0,1483,A
6-NA,1025,1494,0,0,0,1494,A
6-NA,1026,0,1483,0,0,1483,T
6-NA,1027,0,2,1480,1,1483,G
6-NA,1028,1464,3,2,0,1469,A
6-NA,1029,1,0,1424,0,1425,G
6-NA,1030,1,3,1451,0,1455,G
6-NA,1031,1451,0,3,0,1454,A
6-NA,1032,1458,0,0,0,1458,A
6-NA,1033,0,1,1468,0,1469,G
6-NA,1034,1,0,1471,0,1472,G
6-NA,1035,0,1461,0,1,1462,T
6-NA,1036,2,5,1461,0,1468,G
6-NA,1037,0,0,1495,0,1495,G
6-NA,1038,0,1485,0,0,1485,T
6-NA,1039,6,1,0,1474,1481,C
6-NA,1040,1482,1,0,0,1483,A
6-NA,1041,1,1476,1,0,1478,T
6-NA,1042,0,1,1474,0,1475,G
6-NA,1043,1,3,1458,0,1462,G
6-NA,1044,1,1,1425,0,1427,G
6-NA,1045,0,0,1492,0,1492,G
6-NA,1046,0,1486,1,0,1487,T
6-NA,1047,0,2,1492,0,1494,G
6-NA,1048,1485,1,1,0,1487,A
6-NA,1049,1491,0,0,0,1491,A
6-NA,1050,1492,0,1,0,1493,A
6-NA,1051,0,0,1496,0,1496,G
6-NA,1052,0,1,1494,1,1496,G
6-NA,1053,0,0,0,1487,1487,C
6-NA,1054,1,1448,0,2,1451,T
6-NA,1055,1,0,1448,0,1449,G
6-NA,1056,0,1,1452,0,1453,G
6-NA,1057,0,0,1464,0,1464,G
6-NA,1058,0,0,0,1466,1466,C
6-NA,1059,4,0,0,1457,1461,C
6-NA,1060,0,1441,0,3,1444,T
6-NA,1061,0,1445,0,1,1446,T
6-NA,1062,0,1444,0,1,1445,T
6-NA,1063,1,4,1448,0,1453,G
6-NA,1064,1448,0,1,0,1449,A
6-NA,1065,0,1446,0,0,1446,T
6-NA,1066,0,1,1422,0,1423,G
6-NA,1067,1409,0,4,0,1413,A
6-NA,1068,1,1414,0,0,1415,T
6-NA,1069,1,0,1411,0,1412,G
6-NA,1070,0,0,1435,1,1436,G
6-NA,1071,1429,0,0,0,1429,A
6-NA,1072,1425,0,2,0,1427,A
6-NA,1073,1432,0,0,0,1432,A
6-NA,1074,0,1430,0,1,1431,T
6-NA,1075,0,4,1430,0,1434,G
6-NA,1076,1430,0,2,0,1432,A
6-NA,1077,0,1,0,1427,1428,C
6-NA,1078,0,0,1434,0,1434,G
6-NA,1079,1,1403,0,1,1405,T
6-NA,1080,1,0,1405,0,1406,G
6-NA,1081,0,1411,0,2,1413,T
6-NA,1082,0,0,1412,0,1412,G
6-NA,1083,0,0,1425,0,1425,G
6-NA,1084,1409,1,1,0,1411,A
6-NA,1085,0,1410,1,0,1411,T
6-NA,1086,0,2,1404,0,1406,G
6-NA,1087,1,1,1403,0,1405,G
6-NA,1088,1,2,1405,0,1408,G
6-NA,1089,1398,0,4,1,1403,A
6-NA,1090,1393,0,1,1,1395,A
6-NA,1091,1,2,1397,0,1400,G
6-NA,1092,1388,0,0,0,1388,A
6-NA,1093,1388,0,0,0,1388,A
6-NA,1094,0,1,0,1381,1382,C
6-NA,1095,0,3,1371,0,1374,G
6-NA,1096,1367,1,0,0,1368,A
6-NA,1097,0,1347,0,1,1348,T
6-NA,1098,3,2,0,1341,1346,C
6-NA,1099,1338,0,2,0,1340,A
6-NA,1100,0,2,1336,0,1338,G
6-NA,1101,0,0,0,1338,1338,C
6-NA,1102,0,3,1335,0,1338,G
6-NA,1103,1335,0,0,0,1335,A
6-NA,1104,1,1,1333,0,1335,G
6-NA,1105,1335,0,0,0,1335,A
6-NA,1106,1338,0,1,0,1339,A
6-NA,1107,0,0,1350,0,1350,G
6-NA,1108,0,1341,0,1,1342,T
6-NA,1109,3,0,0,1332,1335,C
6-NA,1110,1337,0,2,0,1339,A
6-NA,1111,0,1,0,1374,1375,C
6-NA,1112,0,0,1373,1,1374,G
6-NA,1113,3,1,0,1369,1373,C
6-NA,1114,0,1357,0,0,1357,T
6-NA,1115,0,1361,0,2,1363,T
6-NA,1116,1332,0,4,0,1336,A
6-NA,1117,1,1,1367,0,1369,G
6-NA,1118,0,0,1366,0,1366,G
6-NA,1119,0,1,1393,0,1394,G
6-NA,1120,0,1297,0,0,1297,T
6-NA,1121,1285,0,2,0,1287,A
6-NA,1122,0,1286,1,0,1287,T
6-NA,1123,0,1,1282,0,1283,G
6-NA,1124,1283,0,1,0,1284,A
6-NA,1125,1285,0,1,0,1286,A
6-NA,1126,1223,0,3,0,1226,A
6-NA,1127,0,0,0,1204,1204,C
6-NA,1128,0,2,0,1126,1128,C
6-NA,1129,0,1000,0,2,1002,T
6-NA,1130,1,998,0,0,999,T
6-NA,1131,1,0,0,995,996,C
6-NA,1132,1001,0,0,0,1001,A
6-NA,1133,1001,0,0,0,1001,A
6-NA,1134,996,1,1,0,998,A
6-NA,1135,0,0,1009,0,1009,G
6-NA,1136,1,994,0,2,997,T
6-NA,1137,6,0,0,988,994,C
6-NA,1138,1013,1,0,0,1014,A
6-NA,1139,0,1015,1,0,1016,T
6-NA,1140,0,1017,0,0,1017,T
6-NA,1141,0,0,1015,0,1015,G
6-NA,1142,1014,0,0,0,1014,A
6-NA,1143,1019,0,1,0,1020,A
6-NA,1144,0,2,1035,0,1037,G
6-NA,1145,0,0,1031,0,1031,G
6-NA,1146,1,0,0,1029,1030,C
6-NA,1147,0,987,0,3,990,T
6-NA,1148,0,0,995,0,995,G
6-NA,1149,0,1,1014,0,1015,G
6-NA,1150,1,1014,0,1,1016,T
6-NA,1151,2,0,0,1009,1011,C
6-NA,1152,2,0,0,999,1001,C
6-NA,1153,1001,0,1,0,1002,A
6-NA,1154,1013,0,0,0,1013,A
6-NA,1155,0,0,0,1018,1018,C
6-NA,1156,0,0,0,990,990,C
6-NA,1157,2,3,0,978,983,C
6-NA,1158,0,922,0,0,922,T
6-NA,1159,924,1,0,0,925,A
6-NA,1160,921,1,0,0,922,A
6-NA,1161,1,0,929,0,930,G
6-NA,1162,0,923,0,1,924,T
6-NA,1163,4,0,0,915,919,C
6-NA,1164,1,0,0,901,902,C
6-NA,1165,899,1,0,0,900,A
6-NA,1166,898,0,1,0,899,A
6-NA,1167,898,0,0,0,898,A
6-NA,1168,0,900,0,0,900,T
6-NA,1169,0,895,0,0,895,T
6-NA,1170,0,0,894,0,894,G
6-NA,1171,1,1,0,896,898,C
6-NA,1172,892,0,1,0,893,A
6-NA,1173,1,1,895,0,897,G
6-NA,1174,892,1,2,0,895,A
6-NA,1175,0,917,0,0,917,T
6-NA,1176,915,0,0,0,915,A
6-NA,1177,913,0,1,0,914,A
6-NA,1178,910,0,1,0,911,A
6-NA,1179,1,912,0,0,913,T
6-NA,1180,898,0,1,0,899,A
6-NA,1181,0,1,902,0,903,G
6-NA,1182,0,0,901,0,901,G
6-NA,1183,0,1,0,893,894,C
6-NA,1184,868,0,0,0,868,A
6-NA,1185,873,2,1,0,876,A
6-NA,1186,0,1,884,0,885,G
6-NA,1187,1,882,0,3,886,T
6-NA,1188,5,0,0,879,884,C
6-NA,1189,885,0,2,0,887,A
6-NA,1190,0,884,0,0,884,T
6-NA,1191,883,0,1,0,884,A
6-NA,1192,0,0,887,0,887,G
6-NA,1193,0,881,0,1,882,T
6-NA,1194,0,849,0,0,849,T
6-NA,1195,0,1,837,0,838,G
6-NA,1196,839,0,0,0,839,A
6-NA,1197,0,0,1,835,836,C
6-NA,1198,824,0,0,0,824,A
6-NA,1199,0,0,835,0,835,G
6-NA,1200,817,1,1,0,819,A
6-NA,1201,0,1,854,0,855,G
6-NA,1202,1,0,855,0,856,G
6-NA,1203,0,852,1,1,854,T
6-NA,1204,849,0,0,0,849,A
6-NA,1205,845,0,2,1,848,A
6-NA,1206,0,850,0,0,850,T
6-NA,1207,848,0,3,0,851,A
6-NA,1208,0,1,836,0,837,G
6-NA,1209,0,0,818,0,818,G
6-NA,1210,1,730,0,0,731,T
6-NA,1211,3,0,1,722,726,C
6-NA,1212,0,0,0,734,734,C
6-NA,1213,1,2,730,0,733,G
6-NA,1214,0,0,736,0,736,G
6-NA,1215,0,735,0,1,736,T
6-NA,1216,0,732,0,0,732,T
6-NA,1217,727,0,1,0,728,A
6-NA,1218,0,723,0,0,723,T
6-NA,1219,0,722,0,0,722,T
6-NA,1220,2,0,0,722,724,C
6-NA,1221,0,697,0,1,698,T
6-NA,1222,2,0,696,0,698,G
6-NA,1223,0,0,702,0,702,G
6-NA,1224,0,703,0,0,703,T
6-NA,1225,704,0,1,0,705,A
6-NA,1226,0,693,0,0,693,T
6-NA,1227,0,691,0,0,691,T
6-NA,1228,0,689,0,1,690,T
6-NA,1229,0,690,0,0,690,T
6-NA,1230,1,1,0,687,689,C
6-NA,1231,0,682,1,0,683,T
6-NA,1232,4,0,0,688,692,C
6-NA,1233,1,686,0,0,687,T
6-NA,1234,0,0,703,0,703,G
6-NA,1235,0,702,0,1,703,T
6-NA,1236,0,695,0,1,696,T
6-NA,1237,0,3,693,0,696,G
6-NA,1238,689,1,1,0,691,A
6-NA,1239,692,0,1,0,693,A
6-NA,1240,0,1,707,0,708,G
6-NA,1241,2,0,707,0,709,G
6-NA,1242,0,1,0,705,706,C
6-NA,1243,689,0,0,0,689,A
6-NA,1244,690,0,0,0,690,A
6-NA,1245,696,0,0,0,696,A
6-NA,1246,697,0,1,0,698,A
6-NA,1247,0,1,697,0,698,G
6-NA,1248,0,1,0,696,697,C
6-NA,1249,0,689,0,0,689,T
6-NA,1250,0,0,691,0,691,G
6-NA,1251,0,0,0,692,692,C
6-NA,1252,692,0,1,0,693,A
6-NA,1253,0,690,0,1,691,T
6-NA,1254,0,0,0,684,684,C
6-NA,1255,680,0,0,0,680,A
6-NA,1256,682,0,0,0,682,A
6-NA,1257,0,679,0,0,679,T
6-NA,1258,1,0,0,681,682,C
6-NA,1259,0,0,673,0,673,G
6-NA,1260,1,0,686,0,687,G
6-NA,1261,0,686,1,0,687,T
6-NA,1262,0,0,687,0,687,G
6-NA,1263,0,0,0,699,699,C
6-NA,1264,0,695,1,1,697,T
6-NA,1265,0,705,0,0,705,T
6-NA,1266,0,704,0,1,705,T
6-NA,1267,0,709,0,0,709,T
6-NA,1268,711,0,0,0,711,A
6-NA,1269,1,678,0,0,679,T
6-NA,1270,1,0,680,0,681,G
6-NA,1271,0,671,1,0,672,T
6-NA,1272,0,0,667,0,667,G
6-NA,1273,0,2,670,0,672,G
6-NA,1274,654,0,0,0,654,A
6-NA,1275,0,0,661,0,661,G
6-NA,1276,1,660,0,0,661,T
6-NA,1277,0,656,0,0,656,T
6-NA,1278,0,3,657,0,660,G
6-NA,1279,658,0,2,0,660,A
6-NA,1280,0,659,0,0,659,T
6-NA,1281,653,0,0,0,653,A
6-NA,1282,639,0,0,0,639,A
6-NA,1283,0,0,641,0,641,G
6-NA,1284,0,2,626,0,628,G
6-NA,1285,0,0,620,0,620,G
6-NA,1286,0,0,618,0,618,G
6-NA,1287,606,0,0,0,606,A
6-NA,1288,602,0,4,0,606,A
6-NA,1289,0,1,611,0,612,G
6-NA,1290,610,0,0,0,610,A
6-NA,1291,605,0,1,0,606,A
6-NA,1292,604,0,0,1,605,A
6-NA,1293,598,0,0,0,598,A
6-NA,1294,0,1,597,0,598,G
6-NA,1295,591,0,1,0,592,A
6-NA,1296,0,0,592,1,593,G
6-NA,1297,1,1,592,0,594,G
6-NA,1298,586,0,1,0,587,A
6-NA,1299,585,0,0,0,585,A
6-NA,1300,583,0,1,0,584,A
6-NA,1301,0,0,0,586,586,C
6-NA,1302,0,582,0,0,582,T
6-NA,1303,0,1,581,0,582,G
6-NA,1304,578,0,0,0,578,A
6-NA,1305,577,0,2,0,579,A
6-NA,1306,0,0,580,0,580,G
6-NA,1307,0,573,0,2,575,T
6-NA,1308,1,0,0,576,577,C
6-NA,1309,0,574,0,1,575,T
6-NA,1310,0,569,0,0,569,T
6-NA,1311,0,0,570,0,570,G
6-NA,1312,0,563,0,3,566,T
6-NA,1313,1,0,564,0,565,G
6-NA,1314,0,2,560,0,562,G
6-NA,1315,560,0,1,0,561,A
6-NA,1316,0,1,0,563,564,C
6-NA,1317,0,0,0,547,547,C
6-NA,1318,0,543,0,2,545,T
6-NA,1319,0,0,0,548,548,C
6-NA,1320,551,1,0,0,552,A
6-NA,1321,552,0,1,0,553,A
6-NA,1322,552,0,0,0,552,A
6-NA,1323,0,0,0,560,560,C
6-NA,1324,544,0,0,0,544,A
6-NA,1325,0,1,548,0,549,G
6-NA,1326,0,543,0,0,543,T
6-NA,1327,548,0,0,0,548,A
6-NA,1328,0,543,0,0,543,T
6-NA,1329,0,537,0,0,537,T
6-NA,1330,0,0,538,0,538,G
6-NA,1331,0,538,0,0,538,T
6-NA,1332,0,508,0,1,509,T
6-NA,1333,0,0,512,0,512,G
6-NA,1334,0,465,0,0,465,T
6-NA,1335,0,0,470,0,470,G
6-NA,1336,0,467,0,2,469,T
6-NA,1337,0,462,0,0,462,T
6-NA,1338,0,462,0,0,462,T
6-NA,1339,0,448,0,0,448,T
6-NA,1340,0,0,449,0,449,G
6-NA,1341,1,449,0,0,450,T
6-NA,1342,0,0,446,0,446,G
6-NA,1343,1,0,441,0,442,G
6-NA,1344,0,0,0,434,434,C
6-NA,1345,437,0,0,0,437,A
6-NA,1346,1,0,0,442,443,C
6-NA,1347,0,0,0,440,440,C
6-NA,1348,0,437,0,0,437,T
6-NA,1349,0,0,0,440,440,C
6-NA,1350,438,0,1,0,439,A
6-NA,1351,0,0,441,0,441,G
6-NA,1352,0,0,439,1,440,G
6-NA,1353,0,441,0,0,441,T
6-NA,1354,441,0,0,0,441,A
6-NA,1355,0,0,0,422,422,C
6-NA,1356,421,0,1,0,422,A
6-NA,1357,0,419,0,1,420,T
6-NA,1358,404,0,2,0,406,A
6-NA,1359,0,408,0,0,408,T
6-NA,1360,0,0,380,0,380,G
6-NA,1361,0,1,371,0,372,G
6-NA,1362,372,1,0,0,373,A
6-NA,1363,368,0,1,0,369,A
6-NA,1364,0,0,0,365,365,C
6-NA,1365,311,0,0,0,311,A
6-NA,1366,0,0,310,0,310,G
6-NA,1367,0,0,312,0,312,G
6-NA,1368,0,0,0,311,311,C
6-NA,1369,0,310,0,0,310,T
6-NA,1370,0,0,0,298,298,C
6-NA,1371,299,0,0,0,299,A
6-NA,1372,0,299,0,0,299,T
6-NA,1373,0,2,297,0,299,G
6-NA,1374,0,0,299,0,299,G
6-NA,1375,0,1,0,288,289,C
6-NA,1376,0,0,0,285,285,C
6-NA,1377,0,270,0,0,270,T
6-NA,1378,0,0,270,0,270,G
6-NA,1379,271,0,0,0,271,A
6-NA,1380,0,269,0,0,269,T
6-NA,1381,0,0,268,0,268,G
6-NA,1382,0,1,265,0,266,G
6-NA,1383,0,0,257,0,257,G
6-NA,1384,0,0,257,1,258,G
6-NA,1385,0,0,0,251,251,C
6-NA,1386,0,0,250,0,250,G
6-NA,1387,0,1,247,0,248,G
6-NA,1388,245,0,0,0,245,A
6-NA,1389,0,0,0,243,243,C
6-NA,1390,243,0,0,0,243,A
6-NA,1391,0,244,0,0,244,T
6-NA,1392,1,0,0,240,241,C
6-NA,1393,241,0,0,0,241,A
6-NA,1394,241,0,0,0,241,A
6-NA,1395,0,241,0,0,241,T
6-NA,1396,0,0,0,237,237,C
6-NA,1397,0,229,0,0,229,T
6-NA,1398,0,0,0,205,205,C
6-NA,1399,205,0,0,0,205,A
6-NA,1400,0,204,0,0,204,T
6-NA,1401,0,0,204,0,204,G
6-NA,1402,0,0,0,201,201,C
6-NA,1403,2,0,0,197,199,C
6-NA,1404,0,189,0,0,189,T
6-NA,1405,189,0,0,0,189,A
6-NA,1406,0,188,0,1,189,T
6-NA,1407,186,0,1,0,187,A
6-NA,1408,0,186,0,0,186,T
6-NA,1409,171,0,0,0,171,A
6-NA,1410,164,0,0,0,164,A
7-M,1,26,0,0,0,26,A
7-M,2,0,27,0,0,27,T
7-M,3,0,0,27,0,27,G
7-M,4,27,0,0,0,27,A
7-M,5,0,0,34,0,34,G
7-M,6,0,0,0,35,35,C
7-M,7,0,0,0,37,37,C
7-M,8,0,44,0,0,44,T
7-M,9,0,43,0,1,44,T
7-M,10,0,0,0,44,44,C
7-M,11,0,44,0,0,44,T
7-M,12,44,0,0,0,44,A
7-M,13,44,0,0,0,44,A
7-M,14,0,0,0,44,44,C
7-M,15,0,0,0,44,44,C
7-M,16,0,0,44,0,44,G
7-M,17,44,0,0,0,44,A
7-M,18,0,0,45,0,45,G
7-M,19,0,0,47,0,47,G
7-M,20,0,47,0,0,47,T
7-M,21,0,0,0,47,47,C
7-M,22,0,0,47,0,47,G
7-M,23,48,0,0,0,48,A
7-M,24,49,0,0,0,49,A
7-M,25,49,0,0,0,49,A
7-M,26,0,0,0,55,55,C
7-M,27,0,0,55,0,55,G
7-M,28,0,56,0,0,56,T
7-M,29,57,0,0,0,57,A
7-M,30,0,56,0,1,57,T
7-M,31,0,0,60,0,60,G
7-M,32,0,59,0,0,59,T
7-M,33,0,66,0,0,66,T
7-M,34,0,0,0,67,67,C
7-M,35,0,66,0,0,66,T
7-M,36,0,0,0,69,69,C
7-M,37,0,69,0,0,69,T
7-M,38,0,0,0,74,74,C
7-M,39,0,74,0,0,74,T
7-M,40,73,0,0,0,73,A
7-M,41,0,73,0,0,73,T
7-M,42,0,0,0,73,73,C
7-M,43,0,0,73,0,73,G
7-M,44,0,76,0,0,76,T
7-M,45,0,76,0,0,76,T
7-M,46,0,0,0,76,76,C
7-M,47,0,0,0,78,78,C
7-M,48,77,0,1,0,78,A
7-M,49,0,78,0,0,78,T
7-M,50,0,0,1,77,78,C
7-M,51,78,0,0,0,78,A
7-M,52,0,0,78,0,78,G
7-M,53,0,1,77,0,78,G
7-M,54,0,0,0,78,78,C
7-M,55,0,0,0,78,78,C
7-M,56,0,0,0,79,79,C
7-M,57,1,0,0,85,86,C
7-M,58,0,0,0,85,85,C
7-M,59,0,86,0,0,86,T
7-M,60,0,0,0,87,87,C
7-M,61,87,0,0,0,87,A
7-M,62,89,0,0,0,89,A
7-M,63,90,0,0,0,90,A
7-M,64,0,0,94,0,94,G
7-M,65,0,0,0,94,94,C
7-M,66,0,0,0,92,92,C
7-M,67,0,2,90,0,92,G
7-M,68,93,0,0,0,93,A
7-M,69,0,0,93,0,93,G
7-M,70,93,0,0,0,93,A
7-M,71,0,93,0,0,93,T
7-M,72,0,0,0,93,93,C
7-M,73,0,0,92,0,92,G
7-M,74,0,0,0,93,93,C
7-M,75,0,0,94,0,94,G
7-M,76,0,0,0,94,94,C
7-M,77,94,0,0,0,94,A
7-M,78,0,0,95,0,95,G
7-M,79,95,0,0,0,95,A
7-M,80,0,0,101,0,101,G
7-M,81,101,0,0,0,101,A
7-M,82,0,0,0,101,101,C
7-M,83,0,101,0,0,101,T
7-M,84,0,101,0,0,101,T
7-M,85,0,0,100,0,100,G
7-M,86,103,0,0,0,103,A
7-M,87,103,0,0,0,103,A
7-M,88,0,0,103,0,103,G
7-M,89,99,0,0,0,99,A
7-M,90,0,100,0,0,100,T
7-M,91,0,0,99,0,99,G
7-M,92,0,98,0,0,98,T
7-M,93,0,0,0,99,99,C
7-M,94,0,98,0,1,99,T
7-M,95,0,98,0,1,99,T
7-M,96,0,99,0,0,99,T
7-M,97,0,0,98,0,98,G
7-M,98,0,0,0,99,99,C
7-M,99,0,99,0,0,99,T
7-M,100,0,0,99,0,99,G
7-M,101,0,0,95,1,96,G
7-M,102,0,0,103,0,103,G
7-M,103,102,0,0,0,102,A
7-M,104,103,0,0,0,103,A
7-M,105,105,0,0,0,105,A
7-M,106,105,0,0,0,105,A
7-M,107,108,0,0,0,108,A
7-M,108,0,0,0,110,110,C
7-M,109,110,0,0,0,110,A
7-M,110,0,0,0,110,110,C
7-M,111,109,0,0,0,109,A
7-M,112,0,0,110,0,110,G
7-M,113,110,0,0,0,110,A
7-M,114,0,111,0,0,111,T
7-M,115,0,0,0,112,112,C
7-M,116,0,112,0,0,112,T
7-M,117,0,112,0,0,112,T
7-M,118,0,0,112,0,112,G
7-M,119,112,0,0,0,112,A
7-M,120,0,0,112,0,112,G
7-M,121,0,0,110,0,110,G
7-M,122,0,0,0,107,107,C
7-M,123,0,104,0,1,105,T
7-M,124,0,0,0,115,115,C
7-M,125,0,115,0,0,115,T
7-M,126,0,0,0,117,117,C
7-M,127,116,0,0,0,116,A
7-M,128,0,117,0,1,118,T
7-M,129,0,0,118,0,118,G
7-M,130,0,0,118,0,118,G
7-M,131,119,0,0,0,119,A
7-M,132,118,0,1,0,119,A
7-M,133,0,116,0,0,116,T
7-M,134,0,0,122,0,122,G
7-M,135,0,0,131,0,131,G
7-M,136,0,0,0,132,132,C
7-M,137,0,131,0,0,131,T
7-M,138,132,0,0,0,132,A
7-M,139,131,0,1,0,132,A
7-M,140,135,0,0,0,135,A
7-M,141,0,0,135,0,135,G
7-M,142,134,0,0,0,134,A
7-M,143,0,0,0,133,133,C
7-M,144,129,0,0,0,129,A
7-M,145,129,0,0,0,129,A
7-M,146,0,0,134,0,134,G
7-M,147,134,0,0,0,134,A
7-M,148,0,1,0,134,135,C
7-M,149,2,0,0,133,135,C
7-M,150,135,0,0,0,135,A
7-M,151,140,0,0,0,140,A
7-M,152,0,139,0,0,139,T
7-M,153,0,140,0,0,140,T
7-M,154,0,0,0,140,140,C
7-M,155,0,140,0,0,140,T
7-M,156,0,0,141,0,141,G
7-M,157,0,141,0,0,141,T
7-M,158,0,0,0,141,141,C
7-M,159,139,1,0,0,140,A
7-M,160,0,0,0,145,145,C
7-M,161,0,0,0,145,145,C
7-M,162,0,142,0,0,142,T
7-M,163,0,0,0,144,144,C
7-M,164,0,143,0,0,143,T
7-M,165,0,0,148,0,148,G
7-M,166,147,0,0,0,147,A
7-M,167,0,0,0,147,147,C
7-M,168,0,149,0,0,149,T
7-M,169,147,1,0,0,148,A
7-M,170,147,0,0,0,147,A
7-M,171,1,0,148,0,149,G
7-M,172,1,0,148,0,149,G
7-M,173,0,0,147,0,147,G
7-M,174,0,1,145,0,146,G
7-M,175,152,0,0,0,152,A
7-M,176,0,151,0,0,151,T
7-M,177,0,151,0,0,151,T
7-M,178,0,151,0,0,151,T
7-M,179,0,151,0,0,151,T
7-M,180,0,0,151,0,151,G
7-M,181,0,0,151,0,151,G
7-M,182,0,0,150,0,150,G
7-M,183,0,0,150,0,150,G
7-M,184,0,150,0,0,150,T
7-M,185,0,150,0,0,150,T
7-M,186,0,149,0,0,149,T
7-M,187,0,0,156,0,156,G
7-M,188,0,156,0,0,156,T
7-M,189,0,0,160,0,160,G
7-M,190,0,159,0,0,159,T
7-M,191,0,159,0,0,159,T
7-M,192,0,0,0,158,158,C
7-M,193,159,0,0,0,159,A
7-M,194,0,0,0,163,163,C
7-M,195,0,0,163,0,163,G
7-M,196,0,0,0,163,163,C
7-M,197,0,162,0,0,162,T
7-M,198,1,0,0,169,170,C
7-M,199,170,0,0,0,170,A
7-M,200,0,0,0,172,172,C
7-M,201,1,0,0,170,171,C
7-M,202,0,0,173,0,173,G
7-M,203,0,178,0,0,178,T
7-M,204,1,0,177,0,178,G
7-M,205,0,1,0,176,177,C
7-M,206,0,0,0,175,175,C
7-M,207,1,0,0,176,177,C
7-M,208,172,0,1,0,173,A
7-M,209,0,0,173,0,173,G
7-M,210,0,172,0,0,172,T
7-M,211,0,0,177,0,177,G
7-M,212,177,0,0,0,177,A
7-M,213,0,0,177,0,177,G
7-M,214,0,0,0,177,177,C
7-M,215,0,0,180,0,180,G
7-M,216,179,0,0,0,179,A
7-M,217,0,1,179,0,180,G
7-M,218,0,0,181,0,181,G
7-M,219,180,0,2,0,182,A
7-M,220,0,0,0,186,186,C
7-M,221,0,185,0,0,185,T
7-M,222,0,0,186,0,186,G
7-M,223,0,0,0,184,184,C
7-M,224,185,0,0,0,185,A
7-M,225,0,0,189,0,189,G
7-M,226,0,0,0,188,188,C
7-M,227,0,0,188,0,188,G
7-M,228,0,188,0,0,188,T
7-M,229,186,0,0,0,186,A
7-M,230,0,0,185,1,186,G
7-M,231,186,0,0,0,186,A
7-M,232,0,0,0,187,187,C
7-M,233,0,0,186,0,186,G
7-M,234,1,0,0,186,187,C
7-M,235,0,180,1,0,181,T
7-M,236,0,179,0,0,179,T
7-M,237,0,179,0,0,179,T
7-M,238,0,0,184,0,184,G
7-M,239,0,185,0,0,185,T
7-M,240,0,0,0,186,186,C
7-M,241,0,0,0,186,186,C
7-M,242,187,0,0,0,187,A
7-M,243,187,0,0,0,187,A
7-M,244,186,0,0,0,186,A
7-M,245,187,0,0,0,187,A
7-M,246,0,187,0,0,187,T
7-M,247,0,0,183,0,183,G
7-M,248,0,0,0,183,183,C
7-M,249,0,0,0,184,184,C
7-M,250,0,0,0,186,186,C
7-M,251,0,186,0,0,186,T
7-M,252,0,0,0,197,197,C
7-M,253,197,0,0,0,197,A
7-M,254,198,0,0,0,198,A
7-M,255,0,198,0,0,198,T
7-M,256,0,0,198,0,198,G
7-M,257,0,0,199,0,199,G
7-M,258,0,0,202,0,202,G
7-M,259,200,0,0,0,200,A
7-M,260,200,0,0,0,200,A
7-M,261,0,193,0,0,193,T
7-M,262,0,0,192,0,192,G
7-M,263,0,0,193,0,193,G
7-M,264,189,0,0,0,189,A
7-M,265,0,1,187,0,188,G
7-M,266,187,0,0,0,187,A
7-M,267,0,0,0,184,184,C
7-M,268,0,0,0,195,195,C
7-M,269,0,0,0,195,195,C
7-M,270,195,0,0,0,195,A
7-M,271,196,0,0,0,196,A
7-M,272,196,0,0,0,196,A
7-M,273,0,196,0,0,196,T
7-M,274,203,0,0,0,203,A
7-M,275,203,0,0,0,203,A
7-M,276,0,0,0,200,200,C
7-M,277,199,0,0,0,199,A
7-M,278,0,200,0,0,200,T
7-M,279,0,0,207,0,207,G
7-M,280,0,2,205,0,207,G
7-M,281,205,0,1,0,206,A
7-M,282,0,0,0,206,206,C
7-M,283,202,0,0,0,202,A
7-M,284,203,0,1,0,204,A
7-M,285,202,0,2,0,204,A
7-M,286,0,0,205,0,205,G
7-M,287,0,0,0,205,205,C
7-M,288,203,0,0,0,203,A
7-M,289,0,0,204,0,204,G
7-M,290,0,201,0,2,203,T
7-M,291,0,204,0,0,204,T
7-M,292,205,0,0,0,205,A
7-M,293,204,1,0,0,205,A
7-M,294,205,0,0,0,205,A
7-M,295,0,0,0,215,215,C
7-M,296,0,214,0,0,214,T
7-M,297,0,0,233,0,233,G
7-M,298,0,232,0,0,232,T
7-M,299,233,0,0,0,233,A
7-M,300,0,233,0,0,233,T
7-M,301,229,1,0,0,230,A
7-M,302,0,0,231,0,231,G
7-M,303,0,0,228,0,228,G
7-M,304,226,0,0,0,226,A
7-M,305,225,0,0,0,225,A
7-M,306,220,0,0,0,220,A
7-M,307,0,0,0,220,220,C
7-M,308,0,221,0,0,221,T
7-M,309,0,221,0,0,221,T
7-M,310,221,0,0,0,221,A
7-M,311,221,0,0,0,221,A
7-M,312,0,0,221,0,221,G
7-M,313,216,0,0,0,216,A
7-M,314,0,0,215,0,215,G
7-M,315,206,0,0,0,206,A
7-M,316,0,1,209,0,210,G
7-M,317,212,0,0,0,212,A
7-M,318,0,1,213,0,214,G
7-M,319,214,0,0,0,214,A
7-M,320,0,211,0,0,211,T
7-M,321,213,0,0,0,213,A
7-M,322,213,0,0,0,213,A
7-M,323,0,0,0,215,215,C
7-M,324,0,0,216,0,216,G
7-M,325,0,211,0,2,213,T
7-M,326,0,209,0,0,209,T
7-M,327,1,0,0,204,205,C
7-M,328,0,0,0,210,210,C
7-M,329,210,0,0,0,210,A
7-M,330,0,208,0,0,208,T
7-M,331,0,0,210,0,210,G
7-M,332,0,0,212,0,212,G
7-M,333,0,1,210,0,211,G
7-M,334,0,0,211,0,211,G
7-M,335,0,0,0,212,212,C
7-M,336,0,0,0,208,208,C
7-M,337,210,0,0,0,210,A
7-M,338,209,0,1,0,210,A
7-M,339,210,0,0,0,210,A
7-M,340,0,0,214,0,214,G
7-M,341,214,0,0,0,214,A
7-M,342,212,0,0,0,212,A
7-M,343,214,0,0,0,214,A
7-M,344,0,215,0,0,215,T
7-M,345,212,0,2,0,214,A
7-M,346,0,0,217,0,217,G
7-M,347,0,0,0,216,216,C
7-M,348,0,216,0,0,216,T
7-M,349,0,0,1,217,218,C
7-M,350,0,216,0,0,216,T
7-M,351,0,0,0,221,221,C
7-M,352,219,0,0,0,219,A
7-M,353,0,0,221,0,221,G
7-M,354,0,220,0,0,220,T
7-M,355,0,222,0,0,222,T
7-M,356,223,0,0,0,223,A
7-M,357,0,222,0,0,222,T
7-M,358,1,221,0,0,222,T
7-M,359,0,0,0,222,222,C
7-M,360,0,213,0,0,213,T
7-M,361,0,0,215,0,215,G
7-M,362,0,0,0,214,214,C
7-M,363,0,214,0,0,214,T
7-M,364,0,0,214,0,214,G
7-M,365,0,0,213,0,213,G
7-M,366,0,213,0,0,213,T
7-M,367,0,0,211,0,211,G
7-M,368,0,0,0,212,212,C
7-M,369,213,0,0,0,213,A
7-M,370,0,0,0,216,216,C
7-M,371,0,214,0,0,214,T
7-M,372,0,216,0,0,216,T
7-M,373,1,0,215,0,216,G
7-M,374,0,0,0,215,215,C
7-M,375,0,0,0,217,217,C
7-M,376,216,0,0,0,216,A
7-M,377,0,0,217,0,217,G
7-M,378,0,217,0,0,217,T
7-M,379,0,218,0,0,218,T
7-M,380,0,0,217,0,217,G
7-M,381,0,214,0,0,214,T
7-M,382,220,0,0,0,220,A
7-M,383,0,220,0,0,220,T
7-M,384,0,0,220,0,220,G
7-M,385,0,0,221,0,221,G
7-M,386,0,0,218,0,218,G
7-M,387,1,0,0,214,215,C
7-M,388,0,0,0,216,216,C
7-M,389,0,212,0,0,212,T
7-M,390,0,0,1,214,215,C
7-M,391,223,0,1,0,224,A
7-M,392,0,226,0,0,226,T
7-M,393,229,0,0,0,229,A
7-M,394,0,232,0,0,232,T
7-M,395,227,0,0,0,227,A
7-M,396,0,0,0,238,238,C
7-M,397,229,0,0,0,229,A
7-M,398,232,0,0,0,232,A
7-M,399,0,230,0,0,230,T
7-M,400,223,0,0,0,223,A
7-M,401,0,0,222,0,222,G
7-M,402,0,1,214,0,215,G
7-M,403,216,0,0,0,216,A
7-M,404,0,217,1,0,218,T
7-M,405,0,0,208,0,208,G
7-M,406,0,0,207,0,207,G
7-M,407,0,0,209,0,209,G
7-M,408,0,0,208,0,208,G
7-M,409,0,0,210,0,210,G
7-M,410,0,0,0,209,209,C
7-M,411,0,206,0,0,206,T
7-M,412,0,0,206,0,206,G
7-M,413,0,206,0,0,206,T
7-M,414,207,0,0,0,207,A
7-M,415,206,0,0,0,206,A
7-M,416,0,0,0,205,205,C
7-M,417,1,0,0,201,202,C
7-M,418,197,0,1,0,198,A
7-M,419,0,0,0,201,201,C
7-M,420,0,200,0,0,200,T
7-M,421,0,1,202,0,203,G
7-M,422,202,0,0,0,202,A
7-M,423,202,0,0,0,202,A
7-M,424,0,0,204,0,204,G
7-M,425,0,200,0,0,200,T
7-M,426,0,0,199,0,199,G
7-M,427,0,0,201,0,201,G
7-M,428,0,1,0,200,201,C
7-M,429,201,0,1,0,202,A
7-M,430,0,200,0,0,200,T
7-M,431,0,200,0,0,200,T
7-M,432,0,202,0,0,202,T
7-M,433,0,0,209,0,209,G
7-M,434,0,0,211,0,211,G
7-M,435,0,0,0,210,210,C
7-M,436,0,0,0,212,212,C
7-M,437,0,210,0,1,211,T
7-M,438,0,0,220,0,220,G
7-M,439,0,0,222,0,222,G
7-M,440,0,222,0,0,222,T
7-M,441,224,0,0,0,224,A
7-M,442,0,220,0,0,220,T
7-M,443,0,0,228,0,228,G
7-M,444,0,226,0,2,228,T
7-M,445,0,0,227,0,227,G
7-M,446,0,0,0,228,228,C
7-M,447,215,0,0,0,215,A
7-M,448,214,0,0,0,214,A
7-M,449,0,0,0,218,218,C
7-M,450,216,0,0,0,216,A
7-M,451,0,219,0,0,219,T
7-M,452,0,0,210,0,210,G
7-M,453,0,207,0,0,207,T
7-M,454,0,0,207,0,207,G
7-M,455,206,0,1,0,207,A
7-M,456,0,0,207,0,207,G
7-M,457,0,0,0,207,207,C
7-M,458,199,0,0,0,199,A
7-M,459,0,0,201,0,201,G
7-M,460,201,0,0,0,201,A
7-M,461,0,201,0,0,201,T
7-M,462,0,200,0,1,201,T
7-M,463,0,0,201,0,201,G
7-M,464,0,0,0,202,202,C
7-M,465,0,202,0,0,202,T
7-M,466,0,0,202,0,202,G
7-M,467,203,0,0,0,203,A
7-M,468,0,0,0,212,212,C
7-M,469,0,210,0,0,210,T
7-M,470,1,0,0,209,210,C
7-M,471,0,0,0,209,209,C
7-M,472,0,0,0,210,210,C
7-M,473,209,0,0,0,209,A
7-M,474,0,0,214,0,214,G
7-M,475,0,0,0,212,212,C
7-M,476,213,0,0,0,213,A
7-M,477,0,0,0,213,213,C
7-M,478,201,0,0,0,201,A
7-M,479,0,0,204,0,204,G
7-M,480,0,0,204,0,204,G
7-M,481,0,203,0,0,203,T
7-M,482,0,0,0,213,213,C
7-M,483,0,208,0,0,208,T
7-M,484,0,0,0,211,211,C
7-M,485,210,0,0,0,210,A
7-M,486,0,211,0,0,211,T
7-M,487,210,0,1,0,211,A
7-M,488,0,0,210,0,210,G
7-M,489,0,0,209,0,209,G
7-M,490,0,0,0,209,209,C
7-M,491,202,0,0,0,202,A
7-M,492,0,0,199,0,199,G
7-M,493,198,0,0,0,198,A
7-M,494,0,200,0,0,200,T
7-M,495,0,0,201,0,201,G
7-M,496,0,0,201,0,201,G
7-M,497,0,201,0,0,201,T
7-M,498,0,1,199,1,201,G
7-M,499,0,1,199,0,200,G
7-M,500,0,0,0,202,202,C
7-M,501,202,0,0,0,202,A
7-M,502,201,0,0,0,201,A
7-M,503,0,0,0,204,204,C
7-M,504,203,0,0,0,203,A
7-M,505,202,0,0,0,202,A
7-M,506,0,0,0,203,203,C
7-M,507,0,0,0,204,204,C
7-M,508,203,0,0,0,203,A
7-M,509,206,0,0,0,206,A
7-M,510,0,205,0,0,205,T
7-M,511,0,0,0,206,206,C
7-M,512,1,0,0,195,196,C
7-M,513,195,1,0,0,196,A
7-M,514,0,194,0,0,194,T
7-M,515,0,194,0,0,194,T
7-M,516,195,0,0,0,195,A
7-M,517,193,0,1,0,194,A
7-M,518,0,197,0,0,197,T
7-M,519,196,0,0,0,196,A
7-M,520,195,0,0,0,195,A
7-M,521,194,0,0,0,194,A
7-M,522,193,0,0,0,193,A
7-M,523,0,1,0,194,195,C
7-M,524,194,0,0,0,194,A
7-M,525,0,195,0,0,195,T
7-M,526,0,0,194,0,194,G
7-M,527,194,0,0,0,194,A
7-M,528,0,0,194,1,195,G
7-M,529,194,0,1,0,195,A
7-M,530,194,1,0,0,195,A
7-M,531,0,0,0,194,194,C
7-M,532,190,0,0,0,190,A
7-M,533,0,1,191,0,192,G
7-M,534,192,0,0,0,192,A
7-M,535,193,0,0,0,193,A
7-M,536,0,193,0,0,193,T
7-M,537,0,1,188,0,189,G
7-M,538,0,0,187,0,187,G
7-M,539,0,187,0,0,187,T
7-M,540,0,184,0,0,184,T
7-M,541,0,193,0,0,193,T
7-M,542,0,193,0,0,193,T
7-M,543,0,0,194,0,194,G
7-M,544,0,0,195,0,195,G
7-M,545,0,0,0,193,193,C
7-M,546,0,0,0,194,194,C
7-M,547,189,0,0,0,189,A
7-M,548,0,0,196,0,196,G
7-M,549,0,0,0,195,195,C
7-M,550,196,0,0,0,196,A
7-M,551,0,0,0,202,202,C
7-M,552,0,201,0,1,202,T
7-M,553,202,0,0,0,202,A
7-M,554,0,0,0,203,203,C
7-M,555,202,0,0,0,202,A
7-M,556,0,0,204,0,204,G
7-M,557,0,0,0,198,198,C
7-M,558,0,195,0,0,195,T
7-M,559,193,0,0,0,193,A
7-M,560,190,1,0,0,191,A
7-M,561,0,0,192,0,192,G
7-M,562,0,0,195,0,195,G
7-M,563,0,0,0,198,198,C
7-M,564,0,179,0,0,179,T
7-M,565,179,0,0,0,179,A
7-M,566,0,179,0,0,179,T
7-M,567,0,0,179,0,179,G
7-M,568,0,0,180,0,180,G
7-M,569,173,0,0,0,173,A
7-M,570,0,0,179,0,179,G
7-M,571,0,0,0,176,176,C
7-M,572,175,0,0,0,175,A
7-M,573,175,0,0,0,175,A
7-M,574,173,0,1,0,174,A
7-M,575,0,179,0,0,179,T
7-M,576,0,0,181,0,181,G
7-M,577,0,0,179,0,179,G
7-M,578,0,0,0,180,180,C
7-M,579,0,178,0,0,178,T
7-M,580,0,0,178,0,178,G
7-M,581,0,0,179,0,179,G
7-M,582,181,0,0,0,181,A
7-M,583,0,179,0,0,179,T
7-M,584,0,0,0,177,177,C
7-M,585,179,0,0,0,179,A
7-M,586,179,0,1,0,180,A
7-M,587,0,1,179,0,180,G
7-M,588,0,180,0,0,180,T
7-M,589,0,0,179,0,179,G
7-M,590,179,0,0,0,179,A
7-M,591,177,0,0,0,177,A
7-M,592,0,0,0,178,178,C
7-M,593,178,0,0,0,178,A
7-M,594,0,0,179,0,179,G
7-M,595,0,0,176,0,176,G
7-M,596,1,0,0,178,179,C
7-M,597,174,0,1,0,175,A
7-M,598,0,1,174,0,175,G
7-M,599,0,1,0,173,174,C
7-M,600,1,0,174,0,175,G
7-M,601,0,0,174,0,174,G
7-M,602,173,0,0,0,173,A
7-M,603,0,1,174,0,175,G
7-M,604,1,0,174,0,175,G
7-M,605,0,1,0,174,175,C
7-M,606,0,0,0,176,176,C
7-M,607,173,0,0,0,173,A
7-M,608,0,172,0,0,172,T
7-M,609,0,0,173,0,173,G
7-M,610,0,0,174,0,174,G
7-M,611,172,0,0,0,172,A
7-M,612,0,0,171,0,171,G
7-M,613,166,0,0,0,166,A
7-M,614,0,171,0,0,171,T
7-M,615,0,170,0,0,170,T
7-M,616,0,0,172,0,172,G
7-M,617,0,0,0,170,170,C
7-M,618,0,172,0,0,172,T
7-M,619,171,0,0,0,171,A
7-M,620,0,0,171,0,171,G
7-M,621,0,170,0,0,170,T
7-M,622,0,0,0,169,169,C
7-M,623,166,0,0,0,166,A
7-M,624,0,0,167,0,167,G
7-M,625,0,0,168,0,168,G
7-M,626,0,0,0,168,168,C
7-M,627,0,1,0,167,168,C
7-M,628,166,1,0,0,167,A
7-M,629,0,1,167,0,168,G
7-M,630,0,0,169,0,169,G
7-M,631,0,1,0,169,170,C
7-M,632,169,0,0,0,169,A
7-M,633,0,0,173,0,173,G
7-M,634,173,0,0,0,173,A
7-M,635,0,172,0,0,172,T
7-M,636,1,0,171,0,172,G
7-M,637,1,0,174,0,175,G
7-M,638,0,170,0,0,170,T
7-M,639,1,0,167,0,168,G
7-M,640,0,0,0,170,170,C
7-M,641,168,1,2,0,171,A
7-M,642,0,0,174,0,174,G
7-M,643,0,0,171,0,171,G
7-M,644,0,1,0,172,173,C
7-M,645,170,0,0,0,170,A
7-M,646,170,0,0,0,170,A
7-M,647,0,170,0,0,170,T
7-M,648,0,1,169,0,170,G
7-M,649,168,0,0,0,168,A
7-M,650,0,0,171,0,171,G
7-M,651,165,0,0,0,165,A
7-M,652,0,0,164,0,164,G
7-M,653,0,0,0,169,169,C
7-M,654,1,0,0,174,175,C
7-M,655,175,0,2,0,177,A
7-M,656,0,177,0,0,177,T
7-M,657,0,178,0,0,178,T
7-M,658,0,0,178,0,178,G
7-M,659,0,0,178,0,178,G
7-M,660,0,1,179,0,180,G
7-M,661,179,0,0,0,179,A
7-M,662,0,0,0,176,176,C
7-M,663,0,172,0,0,172,T
7-M,664,1,0,0,174,175,C
7-M,665,175,0,0,0,175,A
7-M,666,0,181,0,0,181,T
7-M,667,0,0,0,182,182,C
7-M,668,0,0,0,181,181,C
7-M,669,0,182,0,0,182,T
7-M,670,181,0,0,0,181,A
7-M,671,0,0,183,0,183,G
7-M,672,0,186,0,0,186,T
7-M,673,0,183,0,0,183,T
7-M,674,0,1,0,182,183,C
7-M,675,0,0,0,176,176,C
7-M,676,176,0,0,0,176,A
7-M,677,0,0,179,0,179,G
7-M,678,0,179,0,0,179,T
7-M,679,177,0,0,0,177,A
7-M,680,0,0,0,178,178,C
7-M,681,0,162,1,0,163,T
7-M,682,0,0,173,0,173,G
7-M,683,0,0,173,0,173,G
7-M,684,0,173,0,0,173,T
7-M,685,0,168,0,0,168,T
7-M,686,0,170,0,0,170,T
7-M,687,168,0,0,0,168,A
7-M,688,170,0,1,0,171,A
7-M,689,0,1,173,0,174,G
7-M,690,167,0,0,0,167,A
7-M,691,0,0,166,0,166,G
7-M,692,158,0,0,0,158,A
7-M,693,0,156,0,2,158,T
7-M,694,0,1,156,0,157,G
7-M,695,159,0,0,0,159,A
7-M,696,0,159,0,0,159,T
7-M,697,0,0,0,159,159,C
7-M,698,0,155,0,0,155,T
7-M,699,0,156,0,0,156,T
7-M,700,0,0,0,156,156,C
7-M,701,0,155,0,0,155,T
7-M,702,0,155,0,0,155,T
7-M,703,0,0,153,0,153,G
7-M,704,154,0,0,0,154,A
7-M,705,154,0,0,0,154,A
7-M,706,157,0,0,0,157,A
7-M,707,158,0,0,0,158,A
7-M,708,0,159,0,0,159,T
7-M,709,0,157,1,0,158,T
7-M,710,0,161,0,0,161,T
7-M,711,0,1,160,0,161,G
7-M,712,0,0,0,159,159,C
7-M,713,160,0,0,0,160,A
7-M,714,0,0,161,0,161,G
7-M,715,161,0,0,0,161,A
7-M,716,0,0,0,168,168,C
7-M,717,1,0,0,166,167,C
7-M,718,0,167,0,0,167,T
7-M,719,166,0,0,0,166,A
7-M,720,0,169,0,0,169,T
7-M,721,0,0,0,169,169,C
7-M,722,168,0,0,0,168,A
7-M,723,0,0,168,0,168,G
7-M,724,168,0,0,0,168,A
7-M,725,163,0,0,0,163,A
7-M,726,162,0,0,0,162,A
7-M,727,0,0,0,166,166,C
7-M,728,0,0,166,0,166,G
7-M,729,164,0,1,0,165,A
7-M,730,164,0,0,0,164,A
7-M,731,0,164,0,0,164,T
7-M,732,0,0,164,0,164,G
7-M,733,0,0,167,0,167,G
7-M,734,1,0,164,0,165,G
7-M,735,0,0,167,0,167,G
7-M,736,0,0,168,0,168,G
7-M,737,0,168,0,0,168,T
7-M,738,0,0,168,0,168,G
7-M,739,0,0,0,168,168,C
7-M,740,166,0,1,0,167,A
7-M,741,0,0,168,0,168,G
7-M,742,167,0,0,1,168,A
7-M,743,0,167,0,0,167,T
7-M,744,0,0,167,0,167,G
7-M,745,0,0,0,165,165,C
7-M,746,165,0,0,0,165,A
7-M,747,165,0,0,0,165,A
7-M,748,0,0,0,165,165,C
7-M,749,0,0,166,0,166,G
7-M,750,166,0,0,0,166,A
7-M,751,0,164,0,0,164,T
7-M,752,0,163,0,0,163,T
7-M,753,0,0,0,164,164,C
7-M,754,163,0,0,0,163,A
7-M,755,162,0,0,0,162,A
7-M,756,0,0,163,0,163,G
7-M,757,0,159,0,1,160,T
7-M,758,0,1,158,0,159,G
7-M,759,155,0,1,0,156,A
7-M,760,0,0,0,157,157,C
7-M,761,0,0,0,156,156,C
7-M,762,1,0,0,154,155,C
7-M,763,0,0,156,0,156,G
7-M,764,0,0,0,156,156,C
7-M,765,0,155,0,1,156,T
7-M,766,0,155,0,0,155,T
7-M,767,0,0,156,0,156,G
7-M,768,0,155,0,0,155,T
7-M,769,0,157,0,0,157,T
7-M,770,0,0,156,0,156,G
7-M,771,0,155,0,0,155,T
7-M,772,0,154,0,0,154,T
7-M,773,0,0,155,0,155,G
7-M,774,0,0,0,153,153,C
7-M,775,0,0,0,154,154,C
7-M,776,0,0,154,0,154,G
7-M,777,1,0,0,151,152,C
7-M,778,0,0,152,0,152,G
7-M,779,153,0,0,0,153,A
7-M,780,151,0,0,0,151,A
7-M,781,0,153,0,0,153,T
7-M,782,153,0,0,0,153,A
7-M,783,0,156,0,0,156,T
7-M,784,0,0,0,158,158,C
7-M,785,157,0,0,0,157,A
7-M,786,0,158,0,0,158,T
7-M,787,0,158,0,0,158,T
7-M,788,0,0,159,0,159,G
7-M,789,0,0,157,0,157,G
7-M,790,0,0,157,0,157,G
7-M,791,158,1,0,0,159,A
7-M,792,0,154,0,0,154,T
7-M,793,0,0,0,154,154,C
7-M,794,0,156,0,0,156,T
7-M,795,0,155,0,0,155,T
7-M,796,0,0,158,0,158,G
7-M,797,0,0,0,158,158,C
7-M,798,159,0,0,0,159,A
7-M,799,0,0,0,159,159,C
7-M,800,0,154,0,0,154,T
7-M,801,0,155,0,0,155,T
7-M,802,0,0,155,0,155,G
7-M,803,160,0,0,0,160,A
7-M,804,0,160,0,0,160,T
7-M,805,156,0,0,0,156,A
7-M,806,0,156,0,0,156,T
7-M,807,0,156,0,0,156,T
7-M,808,0,0,158,0,158,G
7-M,809,0,156,0,0,156,T
7-M,810,0,0,156,0,156,G
7-M,811,0,0,155,0,155,G
7-M,812,153,0,0,0,153,A
7-M,813,0,154,0,1,155,T
7-M,814,0,155,0,0,155,T
7-M,815,0,0,0,154,154,C
7-M,816,1,153,0,1,155,T
7-M,817,0,154,0,0,154,T
7-M,818,0,0,154,0,154,G
7-M,819,153,0,0,0,153,A
7-M,820,0,153,0,0,153,T
7-M,821,0,0,0,151,151,C
7-M,822,0,0,150,0,150,G
7-M,823,0,150,0,0,150,T
7-M,824,1,0,0,149,150,C
7-M,825,0,147,0,1,148,T
7-M,826,0,151,0,0,151,T
7-M,827,1,149,0,0,150,T
7-M,828,0,151,0,0,151,T
7-M,829,0,151,0,0,151,T
7-M,830,0,151,0,0,151,T
7-M,831,0,151,0,0,151,T
7-M,832,0,0,0,151,151,C
7-M,833,149,0,0,0,149,A
7-M,834,149,0,0,0,149,A
7-M,835,149,0,0,0,149,A
7-M,836,0,149,0,0,149,T
7-M,837,0,0,150,0,150,G
7-M,838,0,0,0,150,150,C
7-M,839,0,0,150,0,150,G
7-M,840,0,153,0,0,153,T
7-M,841,1,0,0,153,154,C
7-M,842,0,152,0,0,152,T
7-M,843,153,0,0,0,153,A
7-M,844,0,152,0,0,152,T
7-M,845,0,0,0,152,152,C
7-M,846,0,0,150,0,150,G
7-M,847,150,0,0,0,150,A
7-M,848,0,0,0,151,151,C
7-M,849,0,147,0,0,147,T
7-M,850,0,0,0,150,150,C
7-M,851,0,148,0,0,148,T
7-M,852,0,148,0,0,148,T
7-M,853,0,0,0,148,148,C
7-M,854,148,0,0,0,148,A
7-M,855,147,0,0,0,147,A
7-M,856,147,0,0,0,147,A
7-M,857,0,0,0,147,147,C
7-M,858,145,0,0,0,145,A
7-M,859,0,0,0,138,138,C
7-M,860,0,0,134,0,134,G
7-M,861,0,0,139,0,139,G
7-M,862,0,0,0,140,140,C
7-M,863,0,0,0,141,141,C
7-M,864,0,139,0,1,140,T
7-M,865,0,141,0,0,141,T
7-M,866,140,0,0,0,140,A
7-M,867,141,0,0,0,141,A
7-M,868,140,0,0,0,140,A
7-M,869,138,0,0,0,138,A
7-M,870,0,0,138,0,138,G
7-M,871,115,0,0,0,115,A
7-M,872,0,1,113,0,114,G
7-M,873,0,0,114,0,114,G
7-M,874,0,0,0,115,115,C
7-M,875,0,0,0,113,113,C
7-M,876,0,0,0,114,114,C
7-M,877,0,114,0,0,114,T
7-M,878,0,115,0,0,115,T
7-M,879,0,0,0,114,114,C
7-M,880,0,115,0,0,115,T
7-M,881,115,0,0,0,115,A
7-M,882,0,0,0,115,115,C
7-M,883,0,0,111,0,111,G
7-M,884,0,0,111,0,111,G
7-M,885,107,0,0,0,107,A
7-M,886,108,0,0,0,108,A
7-M,887,0,0,104,0,104,G
7-M,888,0,0,105,0,105,G
7-M,889,104,0,0,0,104,A
7-M,890,0,0,104,0,104,G
7-M,891,0,104,0,0,104,T
7-M,892,105,0,0,0,105,A
7-M,893,0,0,0,105,105,C
7-M,894,0,0,0,104,104,C
7-M,895,0,101,0,0,101,T
7-M,896,0,0,101,0,101,G
7-M,897,99,0,0,0,99,A
7-M,898,0,0,100,0,100,G
7-M,899,0,96,0,0,96,T
7-M,900,1,0,0,93,94,C
7-M,901,0,90,0,0,90,T
7-M,902,92,0,0,0,92,A
7-M,903,0,91,0,0,91,T
7-M,904,0,0,92,0,92,G
7-M,905,91,0,0,0,91,A
7-M,906,0,0,90,0,90,G
7-M,907,0,0,80,0,80,G
7-M,908,0,0,79,0,79,G
7-M,909,78,0,0,0,78,A
7-M,910,78,0,0,0,78,A
7-M,911,0,0,77,0,77,G
7-M,912,77,0,0,0,77,A
7-M,913,77,0,0,0,77,A
7-M,914,0,76,0,0,76,T
7-M,915,76,0,0,0,76,A
7-M,916,0,75,0,0,75,T
7-M,917,2,0,0,71,73,C
7-M,918,0,0,77,0,77,G
7-M,919,77,0,0,0,77,A
7-M,920,76,0,0,0,76,A
7-M,921,76,0,0,0,76,A
7-M,922,0,0,76,0,76,G
7-M,923,0,0,77,0,77,G
7-M,924,77,0,0,0,77,A
7-M,925,76,0,0,0,76,A
7-M,926,0,0,0,75,75,C
7-M,927,75,0,0,0,75,A
7-M,928,0,0,77,0,77,G
7-M,929,0,0,0,77,77,C
7-M,930,77,0,0,0,77,A
7-M,931,0,0,76,0,76,G
7-M,932,74,0,0,0,74,A
7-M,933,74,0,0,0,74,A
7-M,934,0,74,0,0,74,T
7-M,935,0,0,69,0,69,G
7-M,936,0,0,0,69,69,C
7-M,937,0,68,0,0,68,T
7-M,938,0,0,68,0,68,G
7-M,939,0,68,0,0,68,T
7-M,940,0,0,66,0,66,G
7-M,941,0,0,66,0,66,G
7-M,942,65,0,0,0,65,A
7-M,943,0,65,0,0,65,T
7-M,944,0,0,60,0,60,G
7-M,945,0,0,0,59,59,C
7-M,946,0,58,0,0,58,T
7-M,947,0,0,58,0,58,G
7-M,948,58,0,0,0,58,A
7-M,949,0,0,0,58,58,C
7-M,950,0,0,57,0,57,G
7-M,951,55,0,0,0,55,A
7-M,952,0,0,0,55,55,C
7-M,953,53,0,0,0,53,A
7-M,954,0,0,53,0,53,G
7-M,955,0,52,0,0,52,T
7-M,956,0,0,0,54,54,C
7-M,957,54,0,0,0,54,A
7-M,958,0,53,0,0,53,T
7-M,959,0,53,0,0,53,T
7-M,960,0,53,0,0,53,T
7-M,961,0,51,0,0,51,T
7-M,962,0,0,51,0,51,G
7-M,963,0,45,0,1,46,T
7-M,964,0,0,0,46,46,C
7-M,965,43,0,0,0,43,A
7-M,966,0,0,43,0,43,G
7-M,967,0,0,0,43,43,C
7-M,968,43,0,0,0,43,A
7-M,969,0,43,0,0,43,T
7-M,970,41,0,0,0,41,A
7-M,971,0,0,41,0,41,G
7-M,972,40,0,0,0,40,A
7-M,973,0,0,40,0,40,G
7-M,974,0,39,0,0,39,T
7-M,975,0,27,0,0,27,T
7-M,976,0,0,27,0,27,G
7-M,977,0,0,27,0,27,G
7-M,978,26,0,0,0,26,A
7-M,979,0,0,26,0,26,G
7-M,980,0,17,0,0,17,T
7-M,981,16,0,0,0,16,A
7-M,982,15,0,0,0,15,A
8-NS,1,62,0,0,0,62,A
8-NS,2,0,63,0,0,63,T
8-NS,3,0,0,70,0,70,G
8-NS,4,0,0,73,0,73,G
8-NS,5,84,0,1,0,85,A
8-NS,6,0,166,0,0,166,T
8-NS,7,0,166,0,0,166,T
8-NS,8,1,0,0,174,175,C
8-NS,9,0,0,0,176,176,C
8-NS,10,176,0,0,0,176,A
8-NS,11,177,0,0,0,177,A
8-NS,12,0,0,0,178,178,C
8-NS,13,177,0,1,0,178,A
8-NS,14,0,0,0,180,180,C
8-NS,15,0,180,0,0,180,T
8-NS,16,0,0,200,0,200,G
8-NS,17,0,200,0,0,200,T
8-NS,18,0,0,204,0,204,G
8-NS,19,0,204,0,1,205,T
8-NS,20,0,0,0,205,205,C
8-NS,21,204,0,0,0,204,A
8-NS,22,205,0,0,0,205,A
8-NS,23,0,0,207,0,207,G
8-NS,24,1,213,0,0,214,T
8-NS,25,0,212,0,0,212,T
8-NS,26,0,212,0,0,212,T
8-NS,27,0,0,0,213,213,C
8-NS,28,0,0,0,213,213,C
8-NS,29,212,1,0,0,213,A
8-NS,30,0,1,215,0,216,G
8-NS,31,0,0,216,0,216,G
8-NS,32,0,215,0,0,215,T
8-NS,33,215,0,0,0,215,A
8-NS,34,0,0,217,0,217,G
8-NS,35,217,0,0,0,217,A
8-NS,36,0,218,0,0,218,T
8-NS,37,0,219,0,0,219,T
8-NS,38,0,0,221,0,221,G
8-NS,39,0,0,0,220,220,C
8-NS,40,0,221,0,0,221,T
8-NS,41,0,221,0,0,221,T
8-NS,42,0,220,0,1,221,T
8-NS,43,0,0,0,226,226,C
8-NS,44,0,224,0,0,224,T
8-NS,45,0,225,0,0,225,T
8-NS,46,0,225,0,0,225,T
8-NS,47,0,1,226,0,227,G
8-NS,48,0,0,229,0,229,G
8-NS,49,0,0,0,226,226,C
8-NS,50,228,0,0,0,228,A
8-NS,51,0,227,0,0,227,T
8-NS,52,228,0,0,0,228,A
8-NS,53,0,246,0,0,246,T
8-NS,54,1,0,0,247,248,C
8-NS,55,1,0,0,247,248,C
8-NS,56,0,0,246,0,246,G
8-NS,57,0,244,0,1,245,T
8-NS,58,248,0,0,0,248,A
8-NS,59,248,0,0,0,248,A
8-NS,60,251,0,0,0,251,A
8-NS,61,0,0,0,251,251,C
8-NS,62,246,0,0,0,246,A
8-NS,63,247,0,1,0,248,A
8-NS,64,0,0,261,0,261,G
8-NS,65,0,264,0,0,264,T
8-NS,66,0,263,0,0,263,T
8-NS,67,0,0,265,0,265,G
8-NS,68,0,264,0,0,264,T
8-NS,69,264,0,0,0,264,A
8-NS,70,0,1,268,0,269,G
8-NS,71,281,0,0,0,281,A
8-NS,72,0,1,0,282,283,C
8-NS,73,0,0,0,280,280,C
8-NS,74,281,0,0,0,281,A
8-NS,75,284,0,0,0,284,A
8-NS,76,0,1,298,0,299,G
8-NS,77,300,0,0,0,300,A
8-NS,78,301,0,0,0,301,A
8-NS,79,0,0,0,303,303,C
8-NS,80,0,292,0,0,292,T
8-NS,81,0,2,295,0,297,G
8-NS,82,296,0,0,0,296,A
8-NS,83,0,0,302,0,302,G
8-NS,84,0,303,0,0,303,T
8-NS,85,0,0,301,0,301,G
8-NS,86,302,0,0,0,302,A
8-NS,87,0,299,0,0,299,T
8-NS,88,0,0,304,0,304,G
8-NS,89,0,0,0,309,309,C
8-NS,90,0,0,0,308,308,C
8-NS,91,0,0,0,308,308,C
8-NS,92,0,0,0,307,307,C
8-NS,93,308,0,0,0,308,A
8-NS,94,0,313,0,0,313,T
8-NS,95,0,317,0,0,317,T
8-NS,96,0,0,0,315,315,C
8-NS,97,0,0,0,318,318,C
8-NS,98,0,316,0,1,317,T
8-NS,99,0,314,0,1,315,T
8-NS,100,0,1,312,0,313,G
8-NS,101,314,0,0,0,314,A
8-NS,102,0,314,0,0,314,T
8-NS,103,0,0,0,314,314,C
8-NS,104,0,0,313,0,313,G
8-NS,105,0,0,316,0,316,G
8-NS,106,0,0,0,316,316,C
8-NS,107,0,315,0,1,316,T
8-NS,108,0,315,0,0,315,T
8-NS,109,0,0,0,317,317,C
8-NS,110,0,0,318,0,318,G
8-NS,111,0,2,0,316,318,C
8-NS,112,0,0,0,317,317,C
8-NS,113,0,2,314,2,318,G
8-NS,114,318,0,0,0,318,A
8-NS,115,0,0,328,0,328,G
8-NS,116,329,0,0,0,329,A
8-NS,117,0,328,0,1,329,T
8-NS,118,0,0,0,327,327,C
8-NS,119,329,0,0,0,329,A
8-NS,120,0,0,329,0,329,G
8-NS,121,329,0,0,0,329,A
8-NS,122,0,0,324,0,324,G
8-NS,123,0,0,327,0,327,G
8-NS,124,0,329,0,0,329,T
8-NS,125,1,0,0,349,350,C
8-NS,126,0,0,0,349,349,C
8-NS,127,0,0,0,351,351,C
8-NS,128,0,351,0,0,351,T
8-NS,129,350,0,1,0,351,A
8-NS,130,348,0,2,0,350,A
8-NS,131,0,1,355,0,356,G
8-NS,132,0,2,356,0,358,G
8-NS,133,0,0,358,0,358,G
8-NS,134,0,1,351,0,352,G
8-NS,135,353,0,0,0,353,A
8-NS,136,352,0,1,0,353,A
8-NS,137,0,0,354,0,354,G
8-NS,138,361,0,1,0,362,A
8-NS,139,0,0,370,0,370,G
8-NS,140,0,0,370,0,370,G
8-NS,141,1,0,0,368,369,C
8-NS,142,371,0,0,0,371,A
8-NS,143,371,0,0,0,371,A
8-NS,144,0,373,0,0,373,T
8-NS,145,376,0,0,0,376,A
8-NS,146,0,0,0,380,380,C
8-NS,147,0,371,0,2,373,T
8-NS,148,0,0,0,371,371,C
8-NS,149,0,371,0,0,371,T
8-NS,150,1,0,0,374,375,C
8-NS,151,0,2,376,0,378,G
8-NS,152,0,0,398,0,398,G
8-NS,153,0,400,0,0,400,T
8-NS,154,1,0,0,401,402,C
8-NS,155,0,400,0,0,400,T
8-NS,156,408,0,0,1,409,A
8-NS,157,0,1,408,0,409,G
8-NS,158,409,0,1,0,410,A
8-NS,159,0,1,0,422,423,C
8-NS,160,419,0,0,0,419,A
8-NS,161,0,409,0,0,409,T
8-NS,162,1,0,0,405,406,C
8-NS,163,405,0,0,0,405,A
8-NS,164,405,0,1,0,406,A
8-NS,165,405,0,0,0,405,A
8-NS,166,0,0,407,0,407,G
8-NS,167,0,1,0,407,408,C
8-NS,168,399,0,0,0,399,A
8-NS,169,0,0,401,0,401,G
8-NS,170,0,0,0,401,401,C
8-NS,171,1,0,0,401,402,C
8-NS,172,402,1,0,0,403,A
8-NS,173,0,0,0,416,416,C
8-NS,174,0,0,0,418,418,C
8-NS,175,1,0,0,418,419,C
8-NS,176,423,0,0,0,423,A
8-NS,177,0,425,0,0,425,T
8-NS,178,0,0,426,0,426,G
8-NS,179,0,425,0,1,426,T
8-NS,180,0,424,0,0,424,T
8-NS,181,0,1,425,1,427,G
8-NS,182,0,0,424,0,424,G
8-NS,183,426,0,1,0,427,A
8-NS,184,426,0,0,0,426,A
8-NS,185,422,0,1,0,423,A
8-NS,186,0,0,424,0,424,G
8-NS,187,0,0,0,425,425,C
8-NS,188,425,0,0,0,425,A
8-NS,189,424,0,0,0,424,A
8-NS,190,422,0,0,0,422,A
8-NS,191,0,425,0,0,425,T
8-NS,192,0,424,0,0,424,T
8-NS,193,0,0,430,1,431,G
8-NS,194,0,432,0,0,432,T
8-NS,195,432,0,0,0,432,A
8-NS,196,0,0,433,0,433,G
8-NS,197,432,0,0,0,432,A
8-NS,198,429,0,0,0,429,A
8-NS,199,432,0,0,0,432,A
8-NS,200,425,0,1,0,426,A
8-NS,201,0,1,428,0,429,G
8-NS,202,419,0,1,0,420,A
8-NS,203,0,419,0,0,419,T
8-NS,204,0,420,0,0,420,T
8-NS,205,1,0,0,419,420,C
8-NS,206,0,422,0,0,422,T
8-NS,207,0,0,422,0,422,G
8-NS,208,420,0,0,0,420,A
8-NS,209,421,0,0,0,421,A
8-NS,210,415,1,1,0,417,A
8-NS,211,0,0,416,0,416,G
8-NS,212,415,0,0,0,415,A
8-NS,213,415,0,0,0,415,A
8-NS,214,0,1,420,0,421,G
8-NS,215,426,0,0,0,426,A
8-NS,216,426,1,1,0,428,A
8-NS,217,0,424,0,0,424,T
8-NS,218,0,0,0,428,428,C
8-NS,219,0,428,0,1,429,T
8-NS,220,0,0,433,0,433,G
8-NS,221,434,0,0,0,434,A
8-NS,222,0,433,0,0,433,T
8-NS,223,0,0,433,0,433,G
8-NS,224,428,0,1,0,429,A
8-NS,225,1,1,427,0,429,G
8-NS,226,1,0,427,0,428,G
8-NS,227,0,0,0,425,425,C
8-NS,228,425,0,0,0,425,A
8-NS,229,0,1,0,440,441,C
8-NS,230,0,440,0,0,440,T
8-NS,231,0,443,0,1,444,T
8-NS,232,444,0,0,0,444,A
8-NS,233,445,0,0,0,445,A
8-NS,234,445,0,0,0,445,A
8-NS,235,443,0,2,0,445,A
8-NS,236,0,441,0,0,441,T
8-NS,237,0,2,439,0,441,G
8-NS,238,439,0,1,0,440,A
8-NS,239,1,0,0,436,437,C
8-NS,240,1,0,0,431,432,C
8-NS,241,434,0,0,0,434,A
8-NS,242,0,433,0,0,433,T
8-NS,243,0,1,442,0,443,G
8-NS,244,0,0,445,0,445,G
8-NS,245,0,445,0,1,446,T
8-NS,246,4,1,0,475,480,C
8-NS,247,0,478,0,0,478,T
8-NS,248,2,0,0,477,479,C
8-NS,249,0,0,0,480,480,C
8-NS,250,481,0,2,0,483,A
8-NS,251,0,0,0,483,483,C
8-NS,252,470,0,0,0,470,A
8-NS,253,0,2,1,472,475,C
8-NS,254,0,0,0,470,470,C
8-NS,255,0,445,0,1,446,T
8-NS,256,0,0,450,0,450,G
8-NS,257,0,0,0,443,443,C
8-NS,258,0,439,0,1,440,T
8-NS,259,0,445,0,0,445,T
8-NS,260,0,2,0,442,444,C
8-NS,261,0,0,445,0,445,G
8-NS,262,0,0,0,444,444,C
8-NS,263,0,2,442,0,444,G
8-NS,264,466,0,0,0,466,A
8-NS,265,0,465,0,0,465,T
8-NS,266,472,0,0,0,472,A
8-NS,267,1,0,0,471,472,C
8-NS,268,471,0,0,0,471,A
8-NS,269,0,480,0,0,480,T
8-NS,270,477,0,0,0,477,A
8-NS,271,481,0,0,0,481,A
8-NS,272,0,0,0,480,480,C
8-NS,273,0,464,0,0,464,T
8-NS,274,0,3,464,0,467,G
8-NS,275,455,0,0,0,455,A
8-NS,276,0,0,0,454,454,C
8-NS,277,453,0,2,0,455,A
8-NS,278,0,448,0,1,449,T
8-NS,279,0,2,447,0,449,G
8-NS,280,448,0,1,0,449,A
8-NS,281,0,0,0,463,463,C
8-NS,282,0,460,0,1,461,T
8-NS,283,459,1,0,0,460,A
8-NS,284,0,461,0,0,461,T
8-NS,285,0,458,0,0,458,T
8-NS,286,1,1,457,0,459,G
8-NS,287,454,0,0,0,454,A
8-NS,288,1,0,452,0,453,G
8-NS,289,0,1,449,0,450,G
8-NS,290,443,0,0,0,443,A
8-NS,291,440,0,0,0,440,A
8-NS,292,0,433,0,0,433,T
8-NS,293,1,436,0,0,437,T
8-NS,294,1,0,446,0,447,G
8-NS,295,0,445,0,1,446,T
8-NS,296,2,0,0,444,446,C
8-NS,297,439,0,3,0,442,A
8-NS,298,443,0,0,0,443,A
8-NS,299,0,0,443,0,443,G
8-NS,300,443,0,0,0,443,A
8-NS,301,441,0,0,0,441,A
8-NS,302,442,0,0,0,442,A
8-NS,303,0,0,0,441,441,C
8-NS,304,0,432,0,0,432,T
8-NS,305,0,2,430,0,432,G
8-NS,306,0,1,441,0,442,G
8-NS,307,0,442,0,1,443,T
8-NS,308,0,440,0,0,440,T
8-NS,309,1,0,0,435,436,C
8-NS,310,436,0,0,0,436,A
8-NS,311,0,437,0,0,437,T
8-NS,312,1,1,438,0,440,G
8-NS,313,0,0,0,446,446,C
8-NS,314,0,444,0,0,444,T
8-NS,315,434,0,0,0,434,A
8-NS,316,440,0,0,0,440,A
8-NS,317,0,442,0,1,443,T
8-NS,318,0,0,441,0,441,G
8-NS,319,0,0,0,438,438,C
8-NS,320,1,0,0,429,430,C
8-NS,321,0,0,0,431,431,C
8-NS,322,433,0,0,0,433,A
8-NS,323,431,0,0,0,431,A
8-NS,324,0,0,432,0,432,G
8-NS,325,0,0,0,433,433,C
8-NS,326,427,0,1,0,428,A
8-NS,327,0,0,433,0,433,G
8-NS,328,429,1,1,0,431,A
8-NS,329,430,1,0,0,431,A
8-NS,330,432,0,0,0,432,A
8-NS,331,428,0,1,0,429,A
8-NS,332,0,434,0,0,434,T
8-NS,333,1,0,435,0,436,G
8-NS,334,0,0,437,0,437,G
8-NS,335,439,0,0,0,439,A
8-NS,336,430,0,1,0,431,A
8-NS,337,0,3,428,0,431,G
8-NS,338,1,1,446,0,448,G
8-NS,339,451,0,0,0,451,A
8-NS,340,1,0,0,448,449,C
8-NS,341,0,0,0,447,447,C
8-NS,342,0,378,0,69,447,T
8-NS,343,0,0,0,457,457,C
8-NS,344,0,455,0,1,456,T
8-NS,345,0,457,0,0,457,T
8-NS,346,0,457,0,0,457,T
8-NS,347,0,0,437,0,437,G
8-NS,348,0,1,0,437,438,C
8-NS,349,435,0,0,0,435,A
8-NS,350,0,434,0,1,435,T
8-NS,351,1,1,0,436,438,C
8-NS,352,439,0,0,0,439,A
8-NS,353,0,0,446,0,446,G
8-NS,354,443,0,0,1,444,A
8-NS,355,445,0,0,0,445,A
8-NS,356,0,445,0,0,445,T
8-NS,357,0,1,443,0,444,G
8-NS,358,4,1,445,0,450,G
8-NS,359,452,0,0,0,452,A
8-NS,360,0,0,0,452,452,C
8-NS,361,0,0,0,449,449,C
8-NS,362,438,0,0,0,438,A
8-NS,363,0,0,440,0,440,G
8-NS,364,0,0,439,0,439,G
8-NS,365,0,0,0,440,440,C
8-NS,366,436,1,0,0,437,A
8-NS,367,443,0,0,0,443,A
8-NS,368,0,442,0,0,442,T
8-NS,369,1,0,0,442,443,C
8-NS,370,443,0,0,0,443,A
8-NS,371,0,440,0,0,440,T
8-NS,372,0,1,434,0,435,G
8-NS,373,0,0,437,0,437,G
8-NS,374,429,1,1,0,431,A
8-NS,375,0,0,437,0,437,G
8-NS,376,432,0,0,0,432,A
8-NS,377,433,0,0,0,433,A
8-NS,378,433,0,0,0,433,A
8-NS,379,434,0,0,0,434,A
8-NS,380,435,0,0,0,435,A
8-NS,381,0,0,0,433,433,C
8-NS,382,436,0,0,0,436,A
8-NS,383,0,435,0,0,435,T
8-NS,384,3,0,0,428,431,C
8-NS,385,433,0,0,0,433,A
8-NS,386,0,432,0,0,432,T
8-NS,387,0,0,435,0,435,G
8-NS,388,0,435,0,0,435,T
8-NS,389,0,430,0,0,430,T
8-NS,390,0,0,430,0,430,G
8-NS,391,433,0,0,0,433,A
8-NS,392,433,0,1,0,434,A
8-NS,393,432,0,0,0,432,A
8-NS,394,0,0,437,0,437,G
8-NS,395,0,0,0,434,434,C
8-NS,396,0,1,433,0,434,G
8-NS,397,436,0,0,0,436,A
8-NS,398,437,0,0,0,437,A
8-NS,399,0,434,0,0,434,T
8-NS,400,0,434,0,5,439,T
8-NS,401,0,439,0,1,440,T
8-NS,402,0,0,0,439,439,C
8-NS,403,434,0,0,0,434,A
8-NS,404,0,0,434,0,434,G
8-NS,405,0,435,0,1,436,T
8-NS,406,0,0,436,0,436,G
8-NS,407,0,437,0,0,437,T
8-NS,408,0,1,437,0,438,G
8-NS,409,438,0,0,0,438,A
8-NS,410,0,435,1,0,436,T
8-NS,411,0,437,0,0,437,T
8-NS,412,0,434,0,1,435,T
8-NS,413,0,439,0,0,439,T
8-NS,414,0,437,0,0,437,T
8-NS,415,1,1,432,0,434,G
8-NS,416,432,0,2,0,434,A
8-NS,417,0,1,0,431,432,C
8-NS,418,2,0,0,427,429,C
8-NS,419,1,0,432,0,433,G
8-NS,420,459,1,1,0,461,A
8-NS,421,0,0,0,469,469,C
8-NS,422,1,465,0,1,467,T
8-NS,423,472,0,0,0,472,A
8-NS,424,0,1,470,0,471,G
8-NS,425,467,0,1,0,468,A
8-NS,426,0,1,470,0,471,G
8-NS,427,472,0,0,0,472,A
8-NS,428,0,0,0,485,485,C
8-NS,429,0,0,0,465,465,C
8-NS,430,450,0,0,0,450,A
8-NS,431,0,478,0,0,478,T
8-NS,432,474,0,0,0,474,A
8-NS,433,0,0,515,0,515,G
8-NS,434,0,509,0,1,510,T
8-NS,435,511,0,0,0,511,A
8-NS,436,0,511,0,0,511,T
8-NS,437,0,492,0,0,492,T
8-NS,438,516,0,0,0,516,A
8-NS,439,0,1,0,513,514,C
8-NS,440,0,477,0,1,478,T
8-NS,441,480,0,0,0,480,A
8-NS,442,441,0,0,0,441,A
8-NS,443,0,1,443,0,444,G
8-NS,444,1,0,438,0,439,G
8-NS,445,1,0,440,0,441,G
8-NS,446,0,0,0,439,439,C
8-NS,447,0,430,1,1,432,T
8-NS,448,0,433,0,0,433,T
8-NS,449,1,437,0,0,438,T
8-NS,450,0,0,0,441,441,C
8-NS,451,442,0,0,0,442,A
8-NS,452,0,0,0,444,444,C
8-NS,453,0,0,0,443,443,C
8-NS,454,0,0,444,0,444,G
8-NS,455,442,0,0,0,442,A
8-NS,456,445,0,0,0,445,A
8-NS,457,0,0,444,0,444,G
8-NS,458,442,0,0,0,442,A
8-NS,459,0,1,444,0,445,G
8-NS,460,0,0,441,0,441,G
8-NS,461,0,0,448,0,448,G
8-NS,462,449,0,1,0,450,A
8-NS,463,0,0,450,0,450,G
8-NS,464,0,0,0,448,448,C
8-NS,465,448,0,0,0,448,A
8-NS,466,447,0,1,0,448,A
8-NS,467,0,447,1,0,448,T
8-NS,468,0,447,1,0,448,T
8-NS,469,0,0,448,0,448,G
8-NS,470,1,439,1,0,441,T
8-NS,471,0,439,1,0,440,T
8-NS,472,1,1,439,0,441,G
8-NS,473,0,0,440,0,440,G
8-NS,474,0,0,0,441,441,C
8-NS,475,0,0,439,0,439,G
8-NS,476,438,0,0,0,438,A
8-NS,477,439,0,0,0,439,A
8-NS,478,446,0,0,0,446,A
8-NS,479,0,450,0,0,450,T
8-NS,480,2,0,0,448,450,C
8-NS,481,0,451,0,0,451,T
8-NS,482,1,0,0,448,449,C
8-NS,483,451,0,1,0,452,A
8-NS,484,1,0,0,456,457,C
8-NS,485,1,0,0,457,458,C
8-NS,486,454,0,1,0,455,A
8-NS,487,0,453,1,0,454,T
8-NS,488,0,450,0,1,451,T
8-NS,489,0,0,448,0,448,G
8-NS,490,0,0,0,451,451,C
8-NS,491,1,1,0,448,450,C
8-NS,492,0,449,0,1,450,T
8-NS,493,0,446,0,0,446,T
8-NS,494,0,0,0,450,450,C
8-NS,495,0,449,0,0,449,T
8-NS,496,0,452,0,0,452,T
8-NS,497,0,453,0,1,454,T
8-NS,498,0,456,0,0,456,T
8-NS,499,0,0,0,456,456,C
8-NS,500,1,0,0,453,454,C
8-NS,501,450,0,2,0,452,A
8-NS,502,1,0,455,0,456,G
8-NS,503,0,1,450,0,451,G
8-NS,504,457,0,0,0,457,A
8-NS,505,0,0,0,457,457,C
8-NS,506,457,0,0,0,457,A
8-NS,507,0,458,0,0,458,T
8-NS,508,457,0,1,0,458,A
8-NS,509,0,0,0,493,493,C
8-NS,510,0,491,0,1,492,T
8-NS,511,487,0,0,0,487,A
8-NS,512,0,484,0,0,484,T
8-NS,513,0,468,0,0,468,T
8-NS,514,0,0,468,0,468,G
8-NS,515,458,0,0,0,458,A
8-NS,516,0,0,459,0,459,G
8-NS,517,0,0,458,0,458,G
8-NS,518,416,0,0,0,416,A
8-NS,519,0,412,0,0,412,T
8-NS,520,0,0,417,0,417,G
8-NS,521,0,415,0,0,415,T
8-NS,522,2,0,0,416,418,C
8-NS,523,417,0,0,0,417,A
8-NS,524,415,1,0,0,416,A
8-NS,525,415,0,0,0,415,A
8-NS,526,415,0,0,0,415,A
8-NS,527,420,0,0,0,420,A
8-NS,528,0,422,0,0,422,T
8-NS,529,0,0,419,0,419,G
8-NS,530,0,0,0,423,423,C
8-NS,531,421,0,0,0,421,A
8-NS,532,422,0,0,0,422,A
8-NS,533,0,422,0,0,422,T
8-NS,534,0,423,0,0,423,T
8-NS,535,0,0,422,0,422,G
8-NS,536,0,1,416,0,417,G
8-NS,537,0,0,421,0,421,G
8-NS,538,0,0,427,0,427,G
8-NS,539,0,419,0,1,420,T
8-NS,540,0,0,0,426,426,C
8-NS,541,0,0,0,424,424,C
8-NS,542,0,420,0,1,421,T
8-NS,543,0,0,0,428,428,C
8-NS,544,429,0,0,0,429,A
8-NS,545,0,430,0,0,430,T
8-NS,546,0,0,0,431,431,C
8-NS,547,2,0,425,0,427,G
8-NS,548,0,1,427,0,428,G
8-NS,549,424,0,0,0,424,A
8-NS,550,0,0,426,0,426,G
8-NS,551,0,3,423,1,427,G
8-NS,552,416,0,0,0,416,A
8-NS,553,0,0,0,420,420,C
8-NS,554,1,418,0,0,419,T
8-NS,555,0,422,0,0,422,T
8-NS,556,0,1,421,0,422,G
8-NS,557,417,0,1,0,418,A
8-NS,558,421,0,0,0,421,A
8-NS,559,0,417,0,0,417,T
8-NS,560,0,0,409,0,409,G
8-NS,561,0,1,411,0,412,G
8-NS,562,410,0,0,0,410,A
8-NS,563,414,0,1,0,415,A
8-NS,564,0,440,0,0,440,T
8-NS,565,0,0,442,0,442,G
8-NS,566,444,0,1,0,445,A
8-NS,567,0,444,0,0,444,T
8-NS,568,441,0,1,0,442,A
8-NS,569,445,1,1,0,447,A
8-NS,570,0,0,0,441,441,C
8-NS,571,435,0,0,0,435,A
8-NS,572,1,0,0,436,437,C
8-NS,573,404,0,0,0,404,A
8-NS,574,0,0,411,0,411,G
8-NS,575,0,409,0,0,409,T
8-NS,576,0,408,0,0,408,T
8-NS,577,1,0,0,405,406,C
8-NS,578,1,1,405,0,407,G
8-NS,579,402,0,2,0,404,A
8-NS,580,1,0,406,0,407,G
8-NS,581,1,404,0,0,405,T
8-NS,582,0,0,0,407,407,C
8-NS,583,0,400,0,0,400,T
8-NS,584,0,0,0,402,402,C
8-NS,585,0,406,0,0,406,T
8-NS,586,407,0,1,0,408,A
8-NS,587,406,0,0,0,406,A
8-NS,588,407,0,0,0,407,A
8-NS,589,409,0,0,0,409,A
8-NS,590,411,0,0,0,411,A
8-NS,591,0,409,0,0,409,T
8-NS,592,0,0,0,411,411,C
8-NS,593,0,408,0,0,408,T
8-NS,594,407,0,1,0,408,A
8-NS,595,0,0,0,408,408,C
8-NS,596,408,0,0,0,408,A
8-NS,597,0,2,407,0,409,G
8-NS,598,400,0,1,0,401,A
8-NS,599,0,0,405,0,405,G
8-NS,600,407,0,1,0,408,A
8-NS,601,0,407,0,0,407,T
8-NS,602,0,408,0,0,408,T
8-NS,603,1,0,0,408,409,C
8-NS,604,0,0,406,0,406,G
8-NS,605,0,0,0,406,406,C
8-NS,606,0,405,0,1,406,T
8-NS,607,0,408,0,0,408,T
8-NS,608,0,4,396,0,400,G
8-NS,609,0,0,405,0,405,G
8-NS,610,405,0,0,0,405,A
8-NS,611,0,2,402,0,404,G
8-NS,612,400,0,1,0,401,A
8-NS,613,399,0,0,0,399,A
8-NS,614,0,0,403,0,403,G
8-NS,615,0,1,0,405,406,C
8-NS,616,408,1,0,0,409,A
8-NS,617,0,0,411,0,411,G
8-NS,618,0,410,0,0,410,T
8-NS,619,409,0,0,0,409,A
8-NS,620,407,0,0,0,407,A
8-NS,621,0,410,0,0,410,T
8-NS,622,0,0,410,0,410,G
8-NS,623,388,0,0,0,388,A
8-NS,624,0,2,393,0,395,G
8-NS,625,392,0,0,0,392,A
8-NS,626,381,0,0,0,381,A
8-NS,627,0,379,0,1,380,T
8-NS,628,0,0,373,0,373,G
8-NS,629,0,0,373,0,373,G
8-NS,630,0,1,371,0,372,G
8-NS,631,0,1,371,0,372,G
8-NS,632,0,0,374,0,374,G
8-NS,633,365,0,0,0,365,A
8-NS,634,0,348,0,1,349,T
8-NS,635,1,0,0,362,363,C
8-NS,636,0,361,0,1,362,T
8-NS,637,0,0,0,361,361,C
8-NS,638,0,0,0,366,366,C
8-NS,639,367,0,0,0,367,A
8-NS,640,0,0,0,366,366,C
8-NS,641,0,360,0,1,361,T
8-NS,642,0,359,0,0,359,T
8-NS,643,356,0,0,0,356,A
8-NS,644,0,0,0,355,355,C
8-NS,645,0,350,0,1,351,T
8-NS,646,0,0,0,347,347,C
8-NS,647,0,0,0,345,345,C
8-NS,648,348,0,0,0,348,A
8-NS,649,349,0,0,0,349,A
8-NS,650,349,0,0,0,349,A
8-NS,651,351,0,0,0,351,A
8-NS,652,0,0,0,352,352,C
8-NS,653,335,0,0,0,335,A
8-NS,654,0,0,335,0,335,G
8-NS,655,335,0,2,0,337,A
8-NS,656,333,0,1,0,334,A
8-NS,657,336,1,1,0,338,A
8-NS,658,0,0,0,334,334,C
8-NS,659,0,1,335,0,336,G
8-NS,660,0,0,331,0,331,G
8-NS,661,0,0,333,0,333,G
8-NS,662,332,0,1,0,333,A
8-NS,663,332,0,1,0,333,A
8-NS,664,334,0,0,0,334,A
8-NS,665,0,332,0,0,332,T
8-NS,666,0,0,335,0,335,G
8-NS,667,0,0,336,0,336,G
8-NS,668,0,2,0,331,333,C
8-NS,669,0,0,333,0,333,G
8-NS,670,332,0,0,0,332,A
8-NS,671,0,0,332,0,332,G
8-NS,672,330,0,1,0,331,A
8-NS,673,331,0,0,0,331,A
8-NS,674,0,1,0,331,332,C
8-NS,675,323,0,0,0,323,A
8-NS,676,0,0,322,0,322,G
8-NS,677,0,0,0,320,320,C
8-NS,678,0,321,0,1,322,T
8-NS,679,321,0,0,0,321,A
8-NS,680,0,1,314,0,315,G
8-NS,681,0,0,317,0,317,G
8-NS,682,0,315,0,2,317,T
8-NS,683,0,0,0,308,308,C
8-NS,684,302,0,0,0,302,A
8-NS,685,303,0,0,0,303,A
8-NS,686,303,0,0,0,303,A
8-NS,687,304,0,0,0,304,A
8-NS,688,0,0,304,0,304,G
8-NS,689,0,293,0,1,294,T
8-NS,690,0,295,0,0,295,T
8-NS,691,0,295,0,0,295,T
8-NS,692,1,0,292,0,293,G
8-NS,693,293,0,0,0,293,A
8-NS,694,294,0,0,0,294,A
8-NS,695,0,0,294,0,294,G
8-NS,696,291,0,1,0,292,A
8-NS,697,0,0,299,0,299,G
8-NS,698,300,0,0,0,300,A
8-NS,699,0,301,0,0,301,T
8-NS,700,300,0,0,0,300,A
8-NS,701,300,0,0,0,300,A
8-NS,702,0,0,300,0,300,G
8-NS,703,286,0,0,0,286,A
8-NS,704,0,287,0,0,287,T
8-NS,705,0,0,286,0,286,G
8-NS,706,0,0,288,0,288,G
8-NS,707,0,0,0,287,287,C
8-NS,708,0,285,0,0,285,T
8-NS,709,284,0,0,0,284,A
8-NS,710,284,0,0,0,284,A
8-NS,711,0,285,0,0,285,T
8-NS,712,0,286,0,0,286,T
8-NS,713,0,0,286,0,286,G
8-NS,714,284,1,1,0,286,A
8-NS,715,286,0,1,0,287,A
8-NS,716,0,0,288,0,288,G
8-NS,717,288,0,0,0,288,A
8-NS,718,283,0,1,0,284,A
8-NS,719,0,0,288,0,288,G
8-NS,720,0,273,0,0,273,T
8-NS,721,0,0,272,0,272,G
8-NS,722,267,0,2,0,269,A
8-NS,723,0,0,270,0,270,G
8-NS,724,270,0,0,0,270,A
8-NS,725,0,0,0,269,269,C
8-NS,726,269,0,0,0,269,A
8-NS,727,0,0,0,269,269,C
8-NS,728,246,0,1,0,247,A
8-NS,729,0,0,254,0,254,G
8-NS,730,254,0,1,0,255,A
8-NS,731,0,253,1,0,254,T
8-NS,732,0,249,0,0,249,T
8-NS,733,249,0,0,0,249,A
8-NS,734,249,0,0,0,249,A
8-NS,735,246,1,0,0,247,A
8-NS,736,248,0,0,0,248,A
8-NS,737,245,0,0,0,245,A
8-NS,738,0,0,0,236,236,C
8-NS,739,219,0,0,0,219,A
8-NS,740,217,0,0,0,217,A
8-NS,741,0,0,0,219,219,C
8-NS,742,0,217,0,0,217,T
8-NS,743,0,0,221,0,221,G
8-NS,744,221,0,0,0,221,A
8-NS,745,220,0,1,0,221,A
8-NS,746,221,0,0,0,221,A
8-NS,747,218,0,0,1,219,A
8-NS,748,0,218,0,0,218,T
8-NS,749,215,0,0,0,215,A
8-NS,750,0,0,220,0,220,G
8-NS,751,0,0,0,220,220,C
8-NS,752,1,213,0,0,214,T
8-NS,753,0,215,0,0,215,T
8-NS,754,0,213,0,0,213,T
8-NS,755,0,0,213,0,213,G
8-NS,756,212,0,0,0,212,A
8-NS,757,212,0,1,0,213,A
8-NS,758,0,0,0,213,213,C
8-NS,759,206,0,0,0,206,A
8-NS,760,210,0,0,0,210,A
8-NS,761,211,0,0,0,211,A
8-NS,762,0,210,0,0,210,T
8-NS,763,211,0,0,0,211,A
8-NS,764,206,0,0,0,206,A
8-NS,765,0,0,0,206,206,C
8-NS,766,204,1,0,0,205,A
8-NS,767,0,201,0,1,202,T
8-NS,768,0,202,0,0,202,T
8-NS,769,0,0,0,199,199,C
8-NS,770,198,0,1,0,199,A
8-NS,771,0,199,0,0,199,T
8-NS,772,0,0,199,0,199,G
8-NS,773,0,0,0,198,198,C
8-NS,774,196,0,0,0,196,A
8-NS,775,196,0,0,0,196,A
8-NS,776,1,0,195,0,196,G
8-NS,777,0,0,0,200,200,C
8-NS,778,197,0,0,0,197,A
8-NS,779,0,196,0,1,197,T
8-NS,780,0,197,0,0,197,T
8-NS,781,196,0,1,0,197,A
8-NS,782,0,0,0,196,196,C
8-NS,783,194,0,0,0,194,A
8-NS,784,192,0,0,0,192,A
8-NS,785,0,0,0,191,191,C
8-NS,786,0,169,0,0,169,T
8-NS,787,0,0,168,0,168,G
8-NS,788,0,0,0,165,165,C
8-NS,789,0,159,0,0,159,T
8-NS,790,0,0,160,0,160,G
8-NS,791,0,160,0,0,160,T
8-NS,792,0,160,0,0,160,T
8-NS,793,0,159,0,1,160,T
8-NS,794,0,0,158,0,158,G
8-NS,795,159,0,0,0,159,A
8-NS,796,157,0,1,0,158,A
8-NS,797,0,0,158,0,158,G
8-NS,798,0,158,0,0,158,T
8-NS,799,0,0,154,0,154,G
8-NS,800,1,0,152,0,153,G
8-NS,801,152,0,1,0,153,A
8-NS,802,152,0,0,1,153,A
8-NS,803,0,0,0,153,153,C
8-NS,804,149,0,0,0,149,A
8-NS,805,0,0,150,0,150,G
8-NS,806,0,1,148,0,149,G
8-NS,807,149,0,0,0,149,A
8-NS,808,0,0,149,0,149,G
8-NS,809,129,0,0,0,129,A
8-NS,810,0,128,0,0,128,T
8-NS,811,128,0,0,0,128,A
8-NS,812,128,0,0,0,128,A
8-NS,813,0,1,127,0,128,G
8-NS,814,113,0,0,0,113,A
8-NS,815,113,0,0,0,113,A
8-NS,816,0,0,0,112,112,C
8-NS,817,0,95,0,0,95,T
8-NS,818,0,93,0,0,93,T
8-NS,819,0,93,0,0,93,T
8-NS,820,0,0,0,93,93,C
8-NS,821,0,88,0,0,88,T
8-NS,822,0,0,0,88,88,C
8-NS,823,86,0,0,0,86,A
8-NS,824,0,84,0,0,84,T
8-NS,825,0,83,0,0,83,T
8-NS,826,0,83,0,0,83,T
8-NS,827,0,0,0,83,83,C
8-NS,828,82,0,0,0,82,A
8-NS,829,0,0,82,0,82,G
8-NS,830,0,0,0,82,82,C
8-NS,831,0,79,0,0,79,T
8-NS,832,0,79,0,0,79,T
8-NS,833,76,0,0,0,76,A
8-NS,834,0,76,0,0,76,T
8-NS,835,0,76,0,0,76,T
8-NS,836,0,75,0,0,75,T
8-NS,837,73,0,0,0,73,A
8-NS,838,72,0,0,0,72,A
8-NS,839,0,71,0,0,71,T
8-NS,840,0,0,69,0,69,G
8-NS,841,68,0,0,0,68,A
8-NS,842,0,65,0,0,65,T
8-NS,843,64,0,0,0,64,A
8-NS,844,64,0,0,0,64,A
8-NS,845,63,0,1,0,64,A
8-NS,846,64,0,0,0,64,A
8-NS,847,63,0,0,0,63,A
8-NS,848,62,0,0,0,62,A
8-NS,849,0,0,0,62,62,C
8-NS,850,54,0,0,0,54,A
8-NS,851,0,0,0,54,54,C
8-NS,852,0,0,0,52,52,C
8-NS,853,1,0,0,52,53,C
8-NS,854,0,45,0,0,45,T
8-NS,855,0,43,0,0,43,T
8-NS,856,0,0,43,0,43,G
8-NS,857,0,43,0,0,43,T
8-NS,858,0,43,0,0,43,T
8-NS,859,0,43,0,0,43,T
8-NS,860,0,0,0,18,18,C
8-NS,861,0,11,0,0,11,T
8-NS,862,11,0,0,0,11,A
8-NS,863,0,0,0,11,11,C
