Gene,Position,A,T,G,C,Coverage,Consensus
1-PB2,1,161,0,0,0,161,A
1-PB2,2,0,161,0,0,161,T
1-PB2,3,0,0,164,0,164,G
1-PB2,4,0,0,164,0,164,G
1-PB2,5,164,0,0,0,164,A
1-PB2,6,163,0,0,0,163,A
1-PB2,7,163,0,1,0,164,A
1-PB2,8,0,0,184,0,184,G
1-PB2,9,188,0,0,0,188,A
1-PB2,10,188,0,0,0,188,A
1-PB2,11,0,193,0,0,193,T
1-PB2,12,193,0,1,0,194,A
1-PB2,13,193,0,0,0,193,A
1-PB2,14,194,0,0,0,194,A
1-PB2,15,194,0,0,0,194,A
1-PB2,16,0,0,208,0,208,G
1-PB2,17,207,0,0,0,207,A
1-PB2,18,208,0,0,0,208,A
1-PB2,19,0,0,0,212,212,C
1-PB2,20,0,212,0,0,212,T
1-PB2,21,215,0,0,0,215,A
1-PB2,22,0,1,0,214,215,C
1-PB2,23,1,0,214,0,215,G
1-PB2,24,0,0,220,0,220,G
1-PB2,25,218,0,0,0,218,A
1-PB2,26,226,0,0,0,226,A
1-PB2,27,0,229,0,0,229,T
1-PB2,28,0,0,0,231,231,C
1-PB2,29,0,231,0,0,231,T
1-PB2,30,0,1,235,0,236,G
1-PB2,31,237,0,0,0,237,A
1-PB2,32,0,238,0,0,238,T
1-PB2,33,0,0,237,0,237,G
1-PB2,34,0,240,0,0,240,T
1-PB2,35,0,0,0,239,239,C
1-PB2,36,0,0,239,0,239,G
1-PB2,37,0,0,0,238,238,C
1-PB2,38,240,0,0,0,240,A
1-PB2,39,0,0,248,0,248,G
1-PB2,40,0,249,0,1,250,T
1-PB2,41,1,0,0,249,250,C
1-PB2,42,0,249,0,1,250,T
1-PB2,43,1,0,0,250,251,C
1-PB2,44,0,0,249,0,249,G
1-PB2,45,0,0,0,252,252,C
1-PB2,46,250,0,0,0,250,A
1-PB2,47,0,0,0,253,253,C
1-PB2,48,0,253,0,0,253,T
1-PB2,49,0,0,0,262,262,C
1-PB2,50,0,0,264,0,264,G
1-PB2,51,0,0,0,267,267,C
1-PB2,52,0,0,267,0,267,G
1-PB2,53,265,0,0,0,265,A
1-PB2,54,0,0,266,0,266,G
1-PB2,55,271,0,1,0,272,A
1-PB2,56,0,272,0,1,273,T
1-PB2,57,273,0,0,0,273,A
1-PB2,58,0,0,0,270,270,C
1-PB2,59,0,271,0,0,271,T
1-PB2,60,0,0,276,0,276,G
1-PB2,61,277,0,0,0,277,A
1-PB2,62,0,0,0,277,277,C
1-PB2,63,277,0,0,0,277,A
1-PB2,64,277,0,0,0,277,A
1-PB2,65,279,0,0,0,279,A
1-PB2,66,284,0,0,0,284,A
1-PB2,67,284,0,0,0,284,A
1-PB2,68,0,0,0,287,287,C
1-PB2,69,0,0,0,287,287,C
1-PB2,70,291,0,0,0,291,A
1-PB2,71,0,0,0,298,298,C
1-PB2,72,297,0,0,0,297,A
1-PB2,73,1,0,302,1,304,G
1-PB2,74,0,301,1,0,302,T
1-PB2,75,0,0,307,0,307,G
1-PB2,76,0,0,315,0,315,G
1-PB2,77,316,1,1,0,318,A
1-PB2,78,0,0,0,329,329,C
1-PB2,79,1,1,0,324,326,C
1-PB2,80,329,1,0,0,330,A
1-PB2,81,0,327,0,0,327,T
1-PB2,82,327,0,0,0,327,A
1-PB2,83,0,327,0,0,327,T
1-PB2,84,0,0,328,0,328,G
1-PB2,85,1,0,330,0,331,G
1-PB2,86,1,0,0,329,330,C
1-PB2,87,0,0,0,323,323,C
1-PB2,88,326,0,0,0,326,A
1-PB2,89,0,349,0,0,349,T
1-PB2,90,353,0,0,0,353,A
1-PB2,91,363,0,0,0,363,A
1-PB2,92,0,360,0,0,360,T
1-PB2,93,1,364,0,0,365,T
1-PB2,94,368,1,0,0,369,A
1-PB2,95,369,0,0,0,369,A
1-PB2,96,0,0,382,0,382,G
1-PB2,97,379,0,0,2,381,A
1-PB2,98,375,0,0,0,375,A
1-PB2,99,0,0,384,0,384,G
1-PB2,100,0,378,0,0,378,T
1-PB2,101,382,0,0,0,382,A
1-PB2,102,0,0,0,385,385,C
1-PB2,103,381,0,0,0,381,A
1-PB2,104,0,0,0,392,392,C
1-PB2,105,392,0,1,0,393,A
1-PB2,106,0,392,0,0,392,T
1-PB2,107,0,0,0,396,396,C
1-PB2,108,0,0,395,0,395,G
1-PB2,109,0,1,393,0,394,G
1-PB2,110,0,0,394,0,394,G
1-PB2,111,0,1,396,0,397,G
1-PB2,112,394,0,1,0,395,A
1-PB2,113,0,0,394,0,394,G
1-PB2,114,397,0,0,0,397,A
1-PB2,115,0,1,0,401,402,C
1-PB2,116,401,0,1,0,402,A
1-PB2,117,0,0,404,0,404,G
1-PB2,118,0,0,415,0,415,G
1-PB2,119,417,0,1,0,418,A
1-PB2,120,414,0,1,0,415,A
1-PB2,121,419,0,0,0,419,A
1-PB2,122,416,0,1,0,417,A
1-PB2,123,0,0,419,0,419,G
1-PB2,124,416,0,0,0,416,A
1-PB2,125,417,0,0,0,417,A
1-PB2,126,2,1,0,417,420,C
1-PB2,127,0,1,0,417,418,C
1-PB2,128,1,0,0,418,419,C
1-PB2,129,0,0,420,0,420,G
1-PB2,130,0,420,0,1,421,T
1-PB2,131,0,0,0,419,419,C
1-PB2,132,425,0,0,0,425,A
1-PB2,133,0,0,0,429,429,C
1-PB2,134,0,429,0,0,429,T
1-PB2,135,0,428,0,0,428,T
1-PB2,136,428,0,0,0,428,A
1-PB2,137,0,0,431,0,431,G
1-PB2,138,0,0,432,0,432,G
1-PB2,139,430,0,1,0,431,A
1-PB2,140,0,431,0,0,431,T
1-PB2,141,0,0,435,0,435,G
1-PB2,142,440,0,0,0,440,A
1-PB2,143,439,0,0,0,439,A
1-PB2,144,439,0,1,0,440,A
1-PB2,145,0,439,0,0,439,T
1-PB2,146,1,0,440,0,441,G
1-PB2,147,0,0,445,0,445,G
1-PB2,148,446,0,0,0,446,A
1-PB2,149,0,447,0,1,448,T
1-PB2,150,0,0,447,0,447,G
1-PB2,151,442,0,2,0,444,A
1-PB2,152,0,443,0,1,444,T
1-PB2,153,0,0,443,0,443,G
1-PB2,154,0,0,446,0,446,G
1-PB2,155,1,0,0,446,447,C
1-PB2,156,442,0,0,0,442,A
1-PB2,157,448,0,0,0,448,A
1-PB2,158,1,449,0,0,450,T
1-PB2,159,0,0,462,1,463,G
1-PB2,160,459,0,1,1,461,A
1-PB2,161,457,0,2,0,459,A
1-PB2,162,460,0,0,0,460,A
1-PB2,163,0,464,0,0,464,T
1-PB2,164,463,0,0,0,463,A
1-PB2,165,0,1,0,467,468,C
1-PB2,166,1,0,0,464,465,C
1-PB2,167,0,1,0,468,469,C
1-PB2,168,465,0,0,0,465,A
1-PB2,169,464,0,0,0,464,A
1-PB2,170,0,463,0,1,464,T
1-PB2,171,1,0,0,464,465,C
1-PB2,172,463,0,0,0,463,A
1-PB2,173,0,0,0,471,471,C
1-PB2,174,0,464,0,1,465,T
1-PB2,175,0,0,466,0,466,G
1-PB2,176,0,0,0,464,464,C
1-PB2,177,0,462,0,0,462,T
1-PB2,178,0,0,465,0,465,G
1-PB2,179,465,0,0,0,465,A
1-PB2,180,0,0,0,468,468,C
1-PB2,181,466,0,1,0,467,A
1-PB2,182,462,0,0,0,462,A
1-PB2,183,459,0,1,0,460,A
1-PB2,184,464,0,0,0,464,A
1-PB2,185,0,0,466,0,466,G
1-PB2,186,0,0,464,0,464,G
1-PB2,187,463,0,0,0,463,A
1-PB2,188,0,465,0,0,465,T
1-PB2,189,456,0,2,0,458,A
1-PB2,190,466,0,0,0,466,A
1-PB2,191,0,0,0,471,471,C
1-PB2,192,471,0,0,0,471,A
1-PB2,193,0,0,474,0,474,G
1-PB2,194,470,0,0,0,470,A
1-PB2,195,469,0,0,0,469,A
1-PB2,196,468,0,2,0,470,A
1-PB2,197,0,473,0,0,473,T
1-PB2,198,0,0,473,0,473,G
1-PB2,199,0,0,475,0,475,G
1-PB2,200,0,473,0,0,473,T
1-PB2,201,0,470,0,0,470,T
1-PB2,202,1,0,0,470,471,C
1-PB2,203,1,1,0,469,471,C
1-PB2,204,0,0,473,0,473,G
1-PB2,205,0,0,474,0,474,G
1-PB2,206,468,0,1,0,469,A
1-PB2,207,0,0,472,0,472,G
1-PB2,208,464,0,0,0,464,A
1-PB2,209,0,0,473,0,473,G
1-PB2,210,472,1,0,0,473,A
1-PB2,211,471,0,1,0,472,A
1-PB2,212,473,0,1,0,474,A
1-PB2,213,0,471,0,1,472,T
1-PB2,214,1,0,473,0,474,G
1-PB2,215,477,0,2,0,479,A
1-PB2,216,475,0,2,0,477,A
1-PB2,217,0,0,0,474,474,C
1-PB2,218,473,0,1,0,474,A
1-PB2,219,472,0,1,0,473,A
1-PB2,220,0,0,487,0,487,G
1-PB2,221,0,0,493,0,493,G
1-PB2,222,494,0,0,0,494,A
1-PB2,223,0,0,0,494,494,C
1-PB2,224,493,0,0,0,493,A
1-PB2,225,495,0,0,0,495,A
1-PB2,226,496,0,0,0,496,A
1-PB2,227,0,0,0,492,492,C
1-PB2,228,0,0,0,475,475,C
1-PB2,229,1,0,0,518,519,C
1-PB2,230,0,517,0,1,518,T
1-PB2,231,524,0,0,0,524,A
1-PB2,232,0,523,0,0,523,T
1-PB2,233,0,0,528,0,528,G
1-PB2,234,1,1,538,0,540,G
1-PB2,235,510,0,0,0,510,A
1-PB2,236,0,0,514,0,514,G
1-PB2,237,0,509,0,0,509,T
1-PB2,238,510,0,0,0,510,A
1-PB2,239,510,1,0,0,511,A
1-PB2,240,512,0,0,0,512,A
1-PB2,241,509,0,0,0,509,A
1-PB2,242,0,506,0,0,506,T
1-PB2,243,0,0,506,0,506,G
1-PB2,244,498,0,0,0,498,A
1-PB2,245,0,0,501,0,501,G
1-PB2,246,0,497,0,0,497,T
1-PB2,247,0,0,497,0,497,G
1-PB2,248,502,0,0,0,502,A
1-PB2,249,0,507,0,0,507,T
1-PB2,250,0,0,507,0,507,G
1-PB2,251,0,0,0,505,505,C
1-PB2,252,0,498,0,2,500,T
1-PB2,253,1,0,512,0,513,G
1-PB2,254,0,1,510,0,511,G
1-PB2,255,518,0,0,0,518,A
1-PB2,256,0,519,0,0,519,T
1-PB2,257,0,0,0,518,518,C
1-PB2,258,518,0,0,0,518,A
1-PB2,259,0,1,532,0,533,G
1-PB2,260,535,0,0,0,535,A
1-PB2,261,0,534,0,0,534,T
1-PB2,262,528,0,0,0,528,A
1-PB2,263,0,0,543,0,543,G
1-PB2,264,537,0,2,1,540,A
1-PB2,265,0,0,549,0,549,G
1-PB2,266,0,543,0,2,545,T
1-PB2,267,1,0,539,0,540,G
1-PB2,268,536,0,0,0,536,A
1-PB2,269,1,536,0,1,538,T
1-PB2,270,0,0,547,0,547,G
1-PB2,271,0,0,552,0,552,G
1-PB2,272,0,548,0,1,549,T
1-PB2,273,548,0,0,0,548,A
1-PB2,274,0,542,0,1,543,T
1-PB2,275,1,0,0,539,540,C
1-PB2,276,548,0,0,0,548,A
1-PB2,277,0,0,0,564,564,C
1-PB2,278,0,0,0,563,563,C
1-PB2,279,0,553,0,0,553,T
1-PB2,280,0,554,0,1,555,T
1-PB2,281,0,556,0,0,556,T
1-PB2,282,0,1,558,0,559,G
1-PB2,283,0,0,558,0,558,G
1-PB2,284,0,0,1,556,557,C
1-PB2,285,0,549,1,2,552,T
1-PB2,286,1,0,553,0,554,G
1-PB2,287,0,551,0,0,551,T
1-PB2,288,552,0,0,0,552,A
1-PB2,289,553,0,1,0,554,A
1-PB2,290,0,0,0,554,554,C
1-PB2,291,549,0,0,0,549,A
1-PB2,292,0,548,0,0,548,T
1-PB2,293,0,0,542,0,542,G
1-PB2,294,0,0,554,0,554,G
1-PB2,295,0,548,0,1,549,T
1-PB2,296,1,0,546,0,547,G
1-PB2,297,0,0,555,0,555,G
1-PB2,298,556,0,1,0,557,A
1-PB2,299,557,0,0,0,557,A
1-PB2,300,1,554,0,1,556,T
1-PB2,301,552,0,1,0,553,A
1-PB2,302,0,1,558,0,559,G
1-PB2,303,556,0,0,0,556,A
1-PB2,304,554,0,1,0,555,A
1-PB2,305,554,1,0,0,555,A
1-PB2,306,0,547,0,0,547,T
1-PB2,307,0,2,548,0,550,G
1-PB2,308,0,0,553,0,553,G
1-PB2,309,548,1,0,0,549,A
1-PB2,310,1,0,0,548,549,C
1-PB2,311,1,0,0,546,547,C
1-PB2,312,0,0,0,545,545,C
1-PB2,313,0,0,545,1,546,G
1-PB2,314,0,543,0,2,545,T
1-PB2,315,0,0,562,0,562,G
1-PB2,316,566,0,0,0,566,A
1-PB2,317,0,0,0,567,567,C
1-PB2,318,569,1,0,0,570,A
1-PB2,319,566,0,1,0,567,A
1-PB2,320,0,0,577,0,577,G
1-PB2,321,0,574,0,0,574,T
1-PB2,322,573,0,0,0,573,A
1-PB2,323,0,1,0,569,570,C
1-PB2,324,0,0,558,0,558,G
1-PB2,325,0,0,580,0,580,G
1-PB2,326,0,578,0,1,579,T
1-PB2,327,0,0,0,582,582,C
1-PB2,328,0,0,0,583,583,C
1-PB2,329,577,0,1,0,578,A
1-PB2,330,0,576,0,2,578,T
1-PB2,331,0,580,0,0,580,T
1-PB2,332,608,0,1,1,610,A
1-PB2,333,0,0,0,613,613,C
1-PB2,334,1,0,0,600,601,C
1-PB2,335,1,0,0,599,600,C
1-PB2,336,589,0,0,1,590,A
1-PB2,337,588,0,1,1,590,A
1-PB2,338,589,1,0,0,590,A
1-PB2,339,589,0,1,0,590,A
1-PB2,340,0,0,601,0,601,G
1-PB2,341,0,580,0,0,580,T
1-PB2,342,0,1,595,0,596,G
1-PB2,343,0,596,0,0,596,T
1-PB2,344,596,0,0,1,597,A
1-PB2,345,0,0,0,595,595,C
1-PB2,346,591,1,0,0,592,A
1-PB2,347,593,0,0,0,593,A
1-PB2,348,0,0,598,0,598,G
1-PB2,349,594,0,1,0,595,A
1-PB2,350,0,0,0,595,595,C
1-PB2,351,0,581,0,1,582,T
1-PB2,352,0,587,0,1,588,T
1-PB2,353,588,0,0,0,588,A
1-PB2,354,0,585,0,1,586,T
1-PB2,355,0,587,0,0,587,T
1-PB2,356,0,586,0,0,586,T
1-PB2,357,0,0,0,587,587,C
1-PB2,358,0,0,586,1,587,G
1-PB2,359,582,0,1,1,584,A
1-PB2,360,0,0,0,587,587,C
1-PB2,361,579,0,0,0,579,A
1-PB2,362,577,0,0,0,577,A
1-PB2,363,575,0,1,0,576,A
1-PB2,364,0,2,582,0,584,G
1-PB2,365,0,585,0,0,585,T
1-PB2,366,1,0,1,580,582,C
1-PB2,367,0,0,585,0,585,G
1-PB2,368,581,0,1,1,583,A
1-PB2,369,579,0,1,1,581,A
1-PB2,370,580,0,2,0,582,A
1-PB2,371,0,1,603,0,604,G
1-PB2,372,0,0,610,0,610,G
1-PB2,373,0,603,0,0,603,T
1-PB2,374,0,603,1,0,604,T
1-PB2,375,601,0,0,1,602,A
1-PB2,376,597,0,1,1,599,A
1-PB2,377,601,0,0,1,602,A
1-PB2,378,607,0,1,1,609,A
1-PB2,379,0,0,0,615,615,C
1-PB2,380,594,0,0,1,595,A
1-PB2,381,0,593,0,0,593,T
1-PB2,382,0,1,591,0,592,G
1-PB2,383,0,1,590,0,591,G
1-PB2,384,589,0,1,1,591,A
1-PB2,385,593,0,0,0,593,A
1-PB2,386,0,0,0,606,606,C
1-PB2,387,0,1,0,607,608,C
1-PB2,388,1,600,0,2,603,T
1-PB2,389,0,605,0,1,606,T
1-PB2,390,0,604,0,1,605,T
1-PB2,391,0,0,604,1,605,G
1-PB2,392,0,2,604,0,606,G
1-PB2,393,0,0,0,605,605,C
1-PB2,394,0,0,0,600,600,C
1-PB2,395,0,2,0,598,600,C
1-PB2,396,0,581,0,1,582,T
1-PB2,397,3,0,585,0,588,G
1-PB2,398,0,588,0,1,589,T
1-PB2,399,0,586,0,2,588,T
1-PB2,400,1,0,0,591,592,C
1-PB2,401,583,0,0,0,583,A
1-PB2,402,0,586,0,0,586,T
1-PB2,403,0,582,0,0,582,T
1-PB2,404,0,583,0,0,583,T
1-PB2,405,0,581,0,0,581,T
1-PB2,406,571,0,0,0,571,A
1-PB2,407,0,0,576,0,576,G
1-PB2,408,577,0,0,0,577,A
1-PB2,409,576,0,0,0,576,A
1-PB2,410,576,0,0,0,576,A
1-PB2,411,0,575,0,0,575,T
1-PB2,412,574,0,3,0,577,A
1-PB2,413,573,0,0,0,573,A
1-PB2,414,578,0,0,0,578,A
1-PB2,415,0,0,580,0,580,G
1-PB2,416,0,580,0,0,580,T
1-PB2,417,0,0,1,581,582,C
1-PB2,418,584,0,1,0,585,A
1-PB2,419,585,1,0,0,586,A
1-PB2,420,0,0,587,0,587,G
1-PB2,421,589,0,0,0,589,A
1-PB2,422,0,587,0,0,587,T
1-PB2,423,588,1,0,0,589,A
1-PB2,424,1,1,0,588,590,C
1-PB2,425,1,0,588,1,590,G
1-PB2,426,0,0,0,595,595,C
1-PB2,427,590,0,1,0,591,A
1-PB2,428,0,0,604,0,604,G
1-PB2,429,601,0,0,0,601,A
1-PB2,430,602,0,0,0,602,A
1-PB2,431,0,0,608,0,608,G
1-PB2,432,596,0,2,0,598,A
1-PB2,433,0,0,601,0,601,G
1-PB2,434,0,601,0,0,601,T
1-PB2,435,600,0,0,0,600,A
1-PB2,436,0,0,603,0,603,G
1-PB2,437,612,0,0,0,612,A
1-PB2,438,0,0,0,632,632,C
1-PB2,439,623,0,0,0,623,A
1-PB2,440,0,614,0,0,614,T
1-PB2,441,611,0,1,0,612,A
1-PB2,442,612,0,1,0,613,A
1-PB2,443,615,0,2,1,618,A
1-PB2,444,0,0,0,624,624,C
1-PB2,445,0,0,0,614,614,C
1-PB2,446,0,0,0,612,612,C
1-PB2,447,0,577,0,1,578,T
1-PB2,448,0,1,581,0,582,G
1-PB2,449,1,0,584,0,585,G
1-PB2,450,0,586,0,0,586,T
1-PB2,451,1,0,0,585,586,C
1-PB2,452,595,0,0,0,595,A
1-PB2,453,0,600,0,0,600,T
1-PB2,454,0,0,604,0,604,G
1-PB2,455,0,0,0,604,604,C
1-PB2,456,600,0,1,0,601,A
1-PB2,457,0,0,607,0,607,G
1-PB2,458,597,1,0,0,598,A
1-PB2,459,0,0,0,606,606,C
1-PB2,460,0,0,0,605,605,C
1-PB2,461,1,598,0,0,599,T
1-PB2,462,0,0,0,597,597,C
1-PB2,463,589,0,0,0,589,A
1-PB2,464,0,0,601,0,601,G
1-PB2,465,0,600,0,0,600,T
1-PB2,466,0,0,601,0,601,G
1-PB2,467,0,0,0,601,601,C
1-PB2,468,0,1,0,589,590,C
1-PB2,469,594,0,0,0,594,A
1-PB2,470,590,0,0,0,590,A
1-PB2,471,587,0,1,0,588,A
1-PB2,472,0,0,590,0,590,G
1-PB2,473,578,0,1,0,579,A
1-PB2,474,0,0,586,0,586,G
1-PB2,475,0,1,588,0,589,G
1-PB2,476,0,0,0,586,586,C
1-PB2,477,583,0,3,0,586,A
1-PB2,478,0,0,0,588,588,C
1-PB2,479,588,0,0,0,588,A
1-PB2,480,601,0,0,0,601,A
1-PB2,481,1,1,605,0,607,G
1-PB2,482,619,0,0,0,619,A
1-PB2,483,0,613,0,0,613,T
1-PB2,484,1,0,614,0,615,G
1-PB2,485,0,610,0,0,610,T
1-PB2,486,610,0,1,0,611,A
1-PB2,487,609,0,0,1,610,A
1-PB2,488,0,608,0,0,608,T
1-PB2,489,0,0,0,566,566,C
1-PB2,490,575,0,0,0,575,A
1-PB2,491,0,577,0,1,578,T
1-PB2,492,1,1,577,0,579,G
1-PB2,493,0,1,579,0,580,G
1-PB2,494,581,0,0,0,581,A
1-PB2,495,576,0,1,0,577,A
1-PB2,496,0,1,574,0,575,G
1-PB2,497,0,576,0,2,578,T
1-PB2,498,0,575,0,0,575,T
1-PB2,499,1,0,583,0,584,G
1-PB2,500,0,582,0,0,582,T
1-PB2,501,0,580,0,0,580,T
1-PB2,502,0,582,0,0,582,T
1-PB2,503,0,580,0,0,580,T
1-PB2,504,0,581,0,2,583,T
1-PB2,505,0,0,0,582,582,C
1-PB2,506,0,0,0,582,582,C
1-PB2,507,0,0,0,583,583,C
1-PB2,508,578,1,0,0,579,A
1-PB2,509,581,0,0,0,581,A
1-PB2,510,0,584,0,0,584,T
1-PB2,511,0,0,583,0,583,G
1-PB2,512,579,0,0,0,579,A
1-PB2,513,581,0,2,0,583,A
1-PB2,514,0,0,586,0,586,G
1-PB2,515,0,578,0,1,579,T
1-PB2,516,0,0,582,0,582,G
1-PB2,517,0,0,579,0,579,G
1-PB2,518,0,1,572,0,573,G
1-PB2,519,584,0,0,0,584,A
1-PB2,520,0,0,581,0,581,G
1-PB2,521,0,0,0,578,578,C
1-PB2,522,0,0,0,582,582,C
1-PB2,523,577,0,2,0,579,A
1-PB2,524,0,0,589,1,590,G
1-PB2,525,0,0,592,0,592,G
1-PB2,526,594,0,0,0,594,A
1-PB2,527,0,595,0,0,595,T
1-PB2,528,594,0,0,0,594,A
1-PB2,529,1,1,0,594,596,C
1-PB2,530,0,588,0,0,588,T
1-PB2,531,588,0,0,0,588,A
1-PB2,532,584,0,0,0,584,A
1-PB2,533,0,0,0,587,587,C
1-PB2,534,576,0,0,0,576,A
1-PB2,535,0,570,0,2,572,T
1-PB2,536,0,0,0,573,573,C
1-PB2,537,570,0,1,0,571,A
1-PB2,538,0,0,575,0,575,G
1-PB2,539,572,0,0,0,572,A
1-PB2,540,572,0,0,0,572,A
1-PB2,541,0,571,0,0,571,T
1-PB2,542,1,0,0,559,560,C
1-PB2,543,563,0,0,0,563,A
1-PB2,544,0,0,0,564,564,C
1-PB2,545,568,0,0,0,568,A
1-PB2,546,568,0,1,2,571,A
1-PB2,547,0,568,0,0,568,T
1-PB2,548,0,566,0,0,566,T
1-PB2,549,570,0,0,0,570,A
1-PB2,550,571,0,0,0,571,A
1-PB2,551,0,0,0,572,572,C
1-PB2,552,569,0,0,0,569,A
1-PB2,553,563,0,0,0,563,A
1-PB2,554,0,565,0,0,565,T
1-PB2,555,565,1,0,0,566,A
1-PB2,556,566,0,0,0,566,A
1-PB2,557,0,0,0,567,567,C
1-PB2,558,0,563,0,0,563,T
1-PB2,559,561,0,0,0,561,A
1-PB2,560,554,0,0,0,554,A
1-PB2,561,554,0,0,0,554,A
1-PB2,562,0,1,555,0,556,G
1-PB2,563,537,0,1,0,538,A
1-PB2,564,0,0,542,0,542,G
1-PB2,565,540,0,0,0,540,A
1-PB2,566,540,0,0,0,540,A
1-PB2,567,543,0,0,0,543,A
1-PB2,568,543,0,0,0,543,A
1-PB2,569,545,0,1,0,546,A
1-PB2,570,543,1,2,0,546,A
1-PB2,571,0,0,546,0,546,G
1-PB2,572,547,0,0,0,547,A
1-PB2,573,540,0,0,0,540,A
1-PB2,574,1,2,540,0,543,G
1-PB2,575,541,0,0,0,541,A
1-PB2,576,542,0,1,0,543,A
1-PB2,577,0,0,0,548,548,C
1-PB2,578,0,546,0,2,548,T
1-PB2,579,1,0,0,548,549,C
1-PB2,580,1,0,0,545,546,C
1-PB2,581,0,0,547,0,547,G
1-PB2,582,547,0,0,0,547,A
1-PB2,583,0,0,547,0,547,G
1-PB2,584,543,0,0,0,543,A
1-PB2,585,0,544,0,0,544,T
1-PB2,586,0,539,0,0,539,T
1-PB2,587,1,1,537,0,539,G
1-PB2,588,0,0,0,540,540,C
1-PB2,589,541,1,0,0,542,A
1-PB2,590,541,0,0,0,541,A
1-PB2,591,544,0,0,0,544,A
1-PB2,592,549,0,0,0,549,A
1-PB2,593,0,549,0,0,549,T
1-PB2,594,0,547,0,0,547,T
1-PB2,595,0,549,0,0,549,T
1-PB2,596,1,0,0,546,547,C
1-PB2,597,0,549,0,0,549,T
1-PB2,598,0,0,0,570,570,C
1-PB2,599,0,0,0,571,571,C
1-PB2,600,0,0,0,596,596,C
1-PB2,601,0,590,0,0,590,T
1-PB2,602,0,591,0,1,592,T
1-PB2,603,0,0,595,0,595,G
1-PB2,604,596,0,0,0,596,A
1-PB2,605,0,649,0,0,649,T
1-PB2,606,0,0,657,0,657,G
1-PB2,607,0,0,702,0,702,G
1-PB2,608,0,711,0,0,711,T
1-PB2,609,0,701,0,2,703,T
1-PB2,610,0,1,726,0,727,G
1-PB2,611,0,0,0,733,733,C
1-PB2,612,741,1,0,0,742,A
1-PB2,613,0,742,0,0,742,T
1-PB2,614,749,0,0,0,749,A
1-PB2,615,0,0,0,778,778,C
1-PB2,616,836,0,0,2,838,A
1-PB2,617,0,853,0,1,854,T
1-PB2,618,0,0,879,0,879,G
1-PB2,619,0,875,0,1,876,T
1-PB2,620,0,875,0,0,875,T
1-PB2,621,875,0,0,0,875,A
1-PB2,622,0,0,878,0,878,G
1-PB2,623,879,0,0,0,879,A
1-PB2,624,0,0,891,0,891,G
1-PB2,625,852,1,1,0,854,A
1-PB2,626,0,0,860,0,860,G
1-PB2,627,840,1,2,0,843,A
1-PB2,628,1,0,848,0,849,G
1-PB2,629,854,1,0,0,855,A
1-PB2,630,853,0,0,0,853,A
1-PB2,631,0,0,0,857,857,C
1-PB2,632,0,853,0,0,853,T
1-PB2,633,0,849,0,0,849,T
1-PB2,634,1,1,847,0,849,G
1-PB2,635,0,849,0,0,849,T
1-PB2,636,848,0,1,0,849,A
1-PB2,637,0,1,0,846,847,C
1-PB2,638,0,0,841,0,841,G
1-PB2,639,839,0,2,1,842,A
1-PB2,640,841,0,0,1,842,A
1-PB2,641,851,0,0,1,852,A
1-PB2,642,851,0,0,1,852,A
1-PB2,643,852,1,1,0,854,A
1-PB2,644,0,0,0,853,853,C
1-PB2,645,850,0,0,1,851,A
1-PB2,646,852,0,0,1,853,A
1-PB2,647,0,1,852,0,853,G
1-PB2,648,858,0,0,0,858,A
1-PB2,649,0,857,0,2,859,T
1-PB2,650,0,857,0,0,857,T
1-PB2,651,0,858,0,0,858,T
1-PB2,652,1,1,0,857,859,C
1-PB2,653,1,856,0,0,857,T
1-PB2,654,0,0,0,859,859,C
1-PB2,655,2,0,1,855,858,C
1-PB2,656,3,1,0,856,860,C
1-PB2,657,859,1,0,0,860,A
1-PB2,658,0,1,863,0,864,G
1-PB2,659,0,864,0,0,864,T
1-PB2,660,1,863,0,0,864,T
1-PB2,661,0,1,861,0,862,G
1-PB2,662,0,0,0,860,860,C
1-PB2,663,0,858,0,0,858,T
1-PB2,664,0,0,860,0,860,G
1-PB2,665,2,0,857,0,859,G
1-PB2,666,0,2,0,856,858,C
1-PB2,667,0,0,864,0,864,G
1-PB2,668,0,1,871,0,872,G
1-PB2,669,870,0,3,0,873,A
1-PB2,670,877,0,0,0,877,A
1-PB2,671,0,1,0,875,876,C
1-PB2,672,879,0,0,0,879,A
1-PB2,673,880,0,0,0,880,A
1-PB2,674,0,0,907,0,907,G
1-PB2,675,2,0,0,916,918,C
1-PB2,676,917,0,1,0,918,A
1-PB2,677,0,0,1094,0,1094,G
1-PB2,678,0,1095,0,0,1095,T
1-PB2,679,1100,0,0,0,1100,A
1-PB2,680,1,1096,0,0,1097,T
1-PB2,681,1096,0,0,0,1096,A
1-PB2,682,0,1094,0,0,1094,T
1-PB2,683,1066,0,0,0,1066,A
1-PB2,684,0,0,0,1075,1075,C
1-PB2,685,1028,0,0,0,1028,A
1-PB2,686,0,978,0,0,978,T
1-PB2,687,0,936,0,0,936,T
1-PB2,688,0,1,933,0,934,G
1-PB2,689,930,0,1,0,931,A
1-PB2,690,928,0,1,0,929,A
1-PB2,691,0,0,943,0,943,G
1-PB2,692,0,936,0,0,936,T
1-PB2,693,1,927,0,0,928,T
1-PB2,694,0,928,1,0,929,T
1-PB2,695,0,933,0,0,933,T
1-PB2,696,936,0,0,0,936,A
1-PB2,697,0,2,0,939,941,C
1-PB2,698,938,0,0,0,938,A
1-PB2,699,0,936,0,2,938,T
1-PB2,700,0,931,0,0,931,T
1-PB2,701,0,931,0,0,931,T
1-PB2,702,1,2,939,0,942,G
1-PB2,703,943,1,0,0,944,A
1-PB2,704,0,1,0,950,951,C
1-PB2,705,0,943,0,0,943,T
1-PB2,706,1,0,0,942,943,C
1-PB2,707,935,0,0,1,936,A
1-PB2,708,0,0,926,1,927,G
1-PB2,709,0,1,938,0,939,G
1-PB2,710,1,1,937,0,939,G
1-PB2,711,935,0,0,0,935,A
1-PB2,712,942,0,0,0,942,A
1-PB2,713,0,2,0,939,941,C
1-PB2,714,1,0,946,0,947,G
1-PB2,715,0,946,0,1,947,T
1-PB2,716,0,0,948,0,948,G
1-PB2,717,0,939,0,2,941,T
1-PB2,718,0,940,0,0,940,T
1-PB2,719,0,2,939,0,941,G
1-PB2,720,0,0,942,0,942,G
1-PB2,721,0,0,946,0,946,G
1-PB2,722,944,0,0,0,944,A
1-PB2,723,937,0,0,0,937,A
1-PB2,724,0,0,1,964,965,C
1-PB2,725,959,0,0,0,959,A
1-PB2,726,974,0,2,0,976,A
1-PB2,727,977,1,0,0,978,A
1-PB2,728,0,981,0,0,981,T
1-PB2,729,0,0,1001,0,1001,G
1-PB2,730,0,993,0,0,993,T
1-PB2,731,990,0,0,0,990,A
1-PB2,732,0,0,0,994,994,C
1-PB2,733,972,0,0,0,972,A
1-PB2,734,0,1,0,973,974,C
1-PB2,735,0,941,0,1,942,T
1-PB2,736,1,0,0,999,1000,C
1-PB2,737,0,1,1,998,1000,C
1-PB2,738,1008,0,0,0,1008,A
1-PB2,739,1,0,1015,0,1016,G
1-PB2,740,0,0,1044,0,1044,G
1-PB2,741,1,1038,0,1,1040,T
1-PB2,742,1,1,1036,0,1038,G
1-PB2,743,0,0,1009,0,1009,G
1-PB2,744,1001,0,4,0,1005,A
1-PB2,745,1,0,1009,0,1010,G
1-PB2,746,0,1,1007,0,1008,G
1-PB2,747,976,1,1,0,978,A
1-PB2,748,0,0,988,0,988,G
1-PB2,749,0,952,0,1,953,T
1-PB2,750,0,1,956,0,957,G
1-PB2,751,960,0,1,0,961,A
1-PB2,752,0,1,959,0,960,G
1-PB2,753,1,0,964,0,965,G
1-PB2,754,959,0,1,0,960,A
1-PB2,755,962,0,1,0,963,A
1-PB2,756,0,959,0,0,959,T
1-PB2,757,0,0,961,0,961,G
1-PB2,758,962,0,0,0,962,A
1-PB2,759,1,0,0,955,956,C
1-PB2,760,1,0,956,0,957,G
1-PB2,761,966,0,1,0,967,A
1-PB2,762,0,965,0,1,966,T
1-PB2,763,0,0,969,0,969,G
1-PB2,764,0,965,0,2,967,T
1-PB2,765,0,965,1,1,967,T
1-PB2,766,0,2,973,0,975,G
1-PB2,767,975,1,0,0,976,A
1-PB2,768,0,2,0,971,973,C
1-PB2,769,0,0,0,969,969,C
1-PB2,770,956,1,0,0,957,A
1-PB2,771,958,0,0,1,959,A
1-PB2,772,968,0,0,0,968,A
1-PB2,773,0,0,995,0,995,G
1-PB2,774,0,0,0,994,994,C
1-PB2,775,3,0,0,986,989,C
1-PB2,776,0,994,0,1,995,T
1-PB2,777,1002,0,0,0,1002,A
1-PB2,778,1006,0,0,0,1006,A
1-PB2,779,0,1005,0,0,1005,T
1-PB2,780,0,1002,0,0,1002,T
1-PB2,781,992,0,0,0,992,A
1-PB2,782,1,975,0,0,976,T
1-PB2,783,0,970,0,2,972,T
1-PB2,784,0,0,962,0,962,G
1-PB2,785,0,0,0,963,963,C
1-PB2,786,2,1,965,0,968,G
1-PB2,787,0,0,980,0,980,G
1-PB2,788,0,1,0,979,980,C
1-PB2,789,0,0,0,989,989,C
1-PB2,790,986,0,0,0,986,A
1-PB2,791,0,0,998,0,998,G
1-PB2,792,0,5,1000,0,1005,G
1-PB2,793,1003,0,1,0,1004,A
1-PB2,794,1011,0,0,0,1011,A
1-PB2,795,0,0,0,1012,1012,C
1-PB2,796,1001,0,0,0,1001,A
1-PB2,797,0,1006,0,0,1006,T
1-PB2,798,1016,0,0,0,1016,A
1-PB2,799,1,0,1022,0,1023,G
1-PB2,800,0,998,0,1,999,T
1-PB2,801,995,0,0,0,995,A
1-PB2,802,994,0,0,0,994,A
1-PB2,803,0,1,994,0,995,G
1-PB2,804,993,0,0,0,993,A
1-PB2,805,977,0,0,0,977,A
1-PB2,806,0,1,976,0,977,G
1-PB2,807,951,0,1,0,952,A
1-PB2,808,0,0,954,0,954,G
1-PB2,809,0,0,0,952,952,C
1-PB2,810,0,0,2,948,950,C
1-PB2,811,1,0,949,0,950,G
1-PB2,812,0,0,0,954,954,C
1-PB2,813,959,0,0,0,959,A
1-PB2,814,0,0,1042,0,1042,G
1-PB2,815,0,1040,0,0,1040,T
1-PB2,816,1040,0,0,0,1040,A
1-PB2,817,0,1035,0,0,1035,T
1-PB2,818,0,0,0,1040,1040,C
1-PB2,819,1040,0,0,0,1040,A
1-PB2,820,0,0,1037,0,1037,G
1-PB2,821,0,0,0,1040,1040,C
1-PB2,822,1015,0,0,0,1015,A
1-PB2,823,0,0,1008,0,1008,G
1-PB2,824,1013,0,0,0,1013,A
1-PB2,825,0,1010,0,0,1010,T
1-PB2,826,0,0,0,1014,1014,C
1-PB2,827,0,0,0,1023,1023,C
1-PB2,828,1029,0,0,0,1029,A
1-PB2,829,0,0,0,1031,1031,C
1-PB2,830,0,1028,0,1,1029,T
1-PB2,831,1032,0,1,0,1033,A
1-PB2,832,0,0,1029,0,1029,G
1-PB2,833,0,0,0,1026,1026,C
1-PB2,834,1026,0,0,0,1026,A
1-PB2,835,0,1023,0,0,1023,T
1-PB2,836,0,0,0,1027,1027,C
1-PB2,837,0,1023,0,1,1024,T
1-PB2,838,0,1044,0,0,1044,T
1-PB2,839,1,1048,0,0,1049,T
1-PB2,840,1047,1,0,0,1048,A
1-PB2,841,0,1050,0,0,1050,T
1-PB2,842,0,1044,0,5,1049,T
1-PB2,843,0,0,1047,0,1047,G
1-PB2,844,0,1,1047,0,1048,G
1-PB2,845,1033,0,0,0,1033,A
1-PB2,846,0,0,1036,0,1036,G
1-PB2,847,1022,0,1,0,1023,A
1-PB2,848,0,1010,0,2,1012,T
1-PB2,849,0,0,1022,0,1022,G
1-PB2,850,0,1020,0,2,1022,T
1-PB2,851,0,1,1022,0,1023,G
1-PB2,852,0,1,0,1024,1025,C
1-PB2,853,0,0,0,1021,1021,C
1-PB2,854,1015,1,0,0,1016,A
1-PB2,855,0,0,0,1017,1017,C
1-PB2,856,1007,0,2,0,1009,A
1-PB2,857,1,0,1021,0,1022,G
1-PB2,858,0,1,0,1011,1012,C
1-PB2,859,1006,0,1,0,1007,A
1-PB2,860,0,0,0,1007,1007,C
1-PB2,861,1006,0,0,0,1006,A
1-PB2,862,0,0,0,1014,1014,C
1-PB2,863,1012,1,0,0,1013,A
1-PB2,864,1013,0,0,0,1013,A
1-PB2,865,1009,0,0,0,1009,A
1-PB2,866,0,988,0,0,988,T
1-PB2,867,0,987,0,1,988,T
1-PB2,868,0,0,981,0,981,G
1-PB2,869,0,0,982,0,982,G
1-PB2,870,0,2,0,981,983,C
1-PB2,871,0,1,963,1,965,G
1-PB2,872,1,0,967,0,968,G
1-PB2,873,963,0,0,0,963,A
1-PB2,874,982,0,0,0,982,A
1-PB2,875,0,0,0,986,986,C
1-PB2,876,985,0,1,0,986,A
1-PB2,877,983,1,3,0,987,A
1-PB2,878,1,1,986,0,988,G
1-PB2,879,0,1,982,0,983,G
1-PB2,880,985,0,3,0,988,A
1-PB2,881,0,951,0,1,952,T
1-PB2,882,0,1,951,0,952,G
1-PB2,883,0,0,951,0,951,G
1-PB2,884,0,949,0,3,952,T
1-PB2,885,0,2,950,0,952,G
1-PB2,886,1,0,950,0,951,G
1-PB2,887,942,0,2,0,944,A
1-PB2,888,0,0,0,942,942,C
1-PB2,889,929,0,0,0,929,A
1-PB2,890,0,1032,0,1,1033,T
1-PB2,891,0,1017,0,1,1018,T
1-PB2,892,0,0,0,1013,1013,C
1-PB2,893,0,980,0,2,982,T
1-PB2,894,0,982,0,0,982,T
1-PB2,895,982,0,0,0,982,A
1-PB2,896,0,1,981,0,982,G
1-PB2,897,976,0,2,0,978,A
1-PB2,898,0,0,0,978,978,C
1-PB2,899,788,1,1,0,790,A
1-PB2,900,0,2,794,0,796,G
1-PB2,901,787,0,3,1,791,A
1-PB2,902,791,0,2,0,793,A
1-PB2,903,1,0,0,791,792,C
1-PB2,904,0,0,0,790,790,C
1-PB2,905,1,0,0,784,785,C
1-PB2,906,0,1,787,0,788,G
1-PB2,907,791,0,0,0,791,A
1-PB2,908,0,0,0,794,794,C
1-PB2,909,0,783,0,1,784,T
1-PB2,910,0,1,794,0,795,G
1-PB2,911,792,0,1,0,793,A
1-PB2,912,789,0,4,0,793,A
1-PB2,913,1,0,799,0,800,G
1-PB2,914,795,0,0,0,795,A
1-PB2,915,797,0,0,0,797,A
1-PB2,916,1,0,0,795,796,C
1-PB2,917,792,0,1,0,793,A
1-PB2,918,801,0,0,0,801,A
1-PB2,919,0,0,810,0,810,G
1-PB2,920,2,0,0,811,813,C
1-PB2,921,0,804,0,0,804,T
1-PB2,922,0,0,817,0,817,G
1-PB2,923,0,815,0,0,815,T
1-PB2,924,0,0,829,0,829,G
1-PB2,925,0,0,848,0,848,G
1-PB2,926,850,0,1,0,851,A
1-PB2,927,0,849,0,0,849,T
1-PB2,928,847,0,0,0,847,A
1-PB2,929,0,835,0,1,836,T
1-PB2,930,852,1,2,0,855,A
1-PB2,931,0,837,1,0,838,T
1-PB2,932,0,0,836,0,836,G
1-PB2,933,0,0,0,827,827,C
1-PB2,934,797,0,1,0,798,A
1-PB2,935,797,0,0,0,797,A
1-PB2,936,0,1,794,0,795,G
1-PB2,937,0,0,797,0,797,G
1-PB2,938,0,0,0,799,799,C
1-PB2,939,0,782,0,0,782,T
1-PB2,940,1,0,784,0,785,G
1-PB2,941,0,1,0,786,787,C
1-PB2,942,787,0,0,0,787,A
1-PB2,943,790,0,1,0,791,A
1-PB2,944,0,791,0,0,791,T
1-PB2,945,0,1,790,0,791,G
1-PB2,946,0,0,795,0,795,G
1-PB2,947,0,0,789,0,789,G
1-PB2,948,788,0,2,0,790,A
1-PB2,949,1,781,1,0,783,T
1-PB2,950,0,785,0,0,785,T
1-PB2,951,0,0,790,0,790,G
1-PB2,952,790,0,0,0,790,A
1-PB2,953,0,1,793,0,794,G
1-PB2,954,784,1,1,0,786,A
1-PB2,955,781,0,0,0,781,A
1-PB2,956,0,775,0,0,775,T
1-PB2,957,0,0,0,779,779,C
1-PB2,958,778,0,0,0,778,A
1-PB2,959,1,1,784,0,786,G
1-PB2,960,0,0,0,783,783,C
1-PB2,961,0,778,0,1,779,T
1-PB2,962,2,1,0,774,777,C
1-PB2,963,774,1,1,0,776,A
1-PB2,964,0,789,0,0,789,T
1-PB2,965,0,0,0,790,790,C
1-PB2,966,0,0,0,797,797,C
1-PB2,967,1,793,1,1,796,T
1-PB2,968,0,785,0,4,789,T
1-PB2,969,1,0,0,793,794,C
1-PB2,970,792,0,2,1,795,A
1-PB2,971,0,0,800,0,800,G
1-PB2,972,0,3,0,799,802,C
1-PB2,973,0,788,0,1,789,T
1-PB2,974,0,789,0,0,789,T
1-PB2,975,0,784,0,1,785,T
1-PB2,976,1,1,787,0,789,G
1-PB2,977,0,0,787,0,787,G
1-PB2,978,0,786,0,1,787,T
1-PB2,979,0,1,791,0,792,G
1-PB2,980,0,1,777,0,778,G
1-PB2,981,0,2,784,0,786,G
1-PB2,982,0,781,0,0,781,T
1-PB2,983,0,777,0,1,778,T
1-PB2,984,0,781,0,0,781,T
1-PB2,985,781,0,0,1,782,A
1-PB2,986,1,1,0,781,783,C
1-PB2,987,787,0,0,0,787,A
1-PB2,988,0,780,0,1,781,T
1-PB2,989,0,765,1,0,766,T
1-PB2,990,0,768,0,0,768,T
1-PB2,991,765,0,1,0,766,A
1-PB2,992,767,0,0,0,767,A
1-PB2,993,764,0,0,1,765,A
1-PB2,994,763,1,0,1,765,A
1-PB2,995,0,1,768,0,769,G
1-PB2,996,760,0,3,1,764,A
1-PB2,997,767,0,0,1,768,A
1-PB2,998,0,0,0,768,768,C
1-PB2,999,763,1,1,0,765,A
1-PB2,1000,762,0,2,1,765,A
1-PB2,1001,0,1,763,0,764,G
1-PB2,1002,1,0,0,761,762,C
1-PB2,1003,1,1,758,0,760,G
1-PB2,1004,1,1,769,0,771,G
1-PB2,1005,2,0,768,0,770,G
1-PB2,1006,0,769,0,1,770,T
1-PB2,1007,0,0,0,770,770,C
1-PB2,1008,769,0,0,0,769,A
1-PB2,1009,0,763,1,2,766,T
1-PB2,1010,0,1,0,767,768,C
1-PB2,1011,764,0,0,0,764,A
1-PB2,1012,0,0,775,0,775,G
1-PB2,1013,0,772,0,0,772,T
1-PB2,1014,0,0,0,776,776,C
1-PB2,1015,775,0,1,0,776,A
1-PB2,1016,781,0,0,0,781,A
1-PB2,1017,780,0,0,0,780,A
1-PB2,1018,778,0,0,0,778,A
1-PB2,1019,785,0,0,0,785,A
1-PB2,1020,784,0,2,0,786,A
1-PB2,1021,0,0,790,0,790,G
1-PB2,1022,781,0,0,0,781,A
1-PB2,1023,782,0,0,0,782,A
1-PB2,1024,1,0,780,0,781,G
1-PB2,1025,779,0,0,0,779,A
1-PB2,1026,747,0,2,0,749,A
1-PB2,1027,0,1,749,0,750,G
1-PB2,1028,746,0,0,0,746,A
1-PB2,1029,0,0,747,0,747,G
1-PB2,1030,0,0,760,0,760,G
1-PB2,1031,0,756,1,0,757,T
1-PB2,1032,0,0,767,0,767,G
1-PB2,1033,0,0,0,771,771,C
1-PB2,1034,0,764,1,1,766,T
1-PB2,1035,0,768,1,0,769,T
1-PB2,1036,769,0,0,0,769,A
1-PB2,1037,2,0,0,766,768,C
1-PB2,1038,761,0,1,0,762,A
1-PB2,1039,0,2,761,0,763,G
1-PB2,1040,1,0,764,0,765,G
1-PB2,1041,0,0,0,758,758,C
1-PB2,1042,745,1,0,0,746,A
1-PB2,1043,755,1,0,0,756,A
1-PB2,1044,2,756,0,0,758,T
1-PB2,1045,1,3,0,765,769,C
1-PB2,1046,0,767,1,0,768,T
1-PB2,1047,1,1,0,769,771,C
1-PB2,1048,1,0,1,771,773,C
1-PB2,1049,773,0,0,0,773,A
1-PB2,1050,771,0,0,0,771,A
1-PB2,1051,772,0,0,0,772,A
1-PB2,1052,0,0,0,780,780,C
1-PB2,1053,757,0,0,0,757,A
1-PB2,1054,0,741,1,0,742,T
1-PB2,1055,0,710,1,0,711,T
1-PB2,1056,0,0,712,0,712,G
1-PB2,1057,710,2,0,0,712,A
1-PB2,1058,0,0,702,0,702,G
1-PB2,1059,735,0,0,0,735,A
1-PB2,1060,734,0,0,0,734,A
1-PB2,1061,0,739,0,0,739,T
1-PB2,1062,741,0,0,0,741,A
1-PB2,1063,741,0,2,0,743,A
1-PB2,1064,0,0,761,0,761,G
1-PB2,1065,744,0,1,0,745,A
1-PB2,1066,0,0,772,0,772,G
1-PB2,1067,1,745,0,0,746,T
1-PB2,1068,748,0,1,0,749,A
1-PB2,1069,0,1,0,761,762,C
1-PB2,1070,757,0,1,0,758,A
1-PB2,1071,0,756,1,1,758,T
1-PB2,1072,0,0,758,0,758,G
1-PB2,1073,736,0,1,0,737,A
1-PB2,1074,0,0,744,0,744,G
1-PB2,1075,1,2,725,0,728,G
1-PB2,1076,2,1,752,0,755,G
1-PB2,1077,0,2,751,0,753,G
1-PB2,1078,2,730,1,0,733,T
1-PB2,1079,730,0,1,0,731,A
1-PB2,1080,0,729,0,0,729,T
1-PB2,1081,0,1,731,0,732,G
1-PB2,1082,732,0,1,0,733,A
1-PB2,1083,0,0,727,0,727,G
1-PB2,1084,0,0,723,0,723,G
1-PB2,1085,673,1,0,0,674,A
1-PB2,1086,0,0,697,0,697,G
1-PB2,1087,0,695,1,1,697,T
1-PB2,1088,0,715,1,0,716,T
1-PB2,1089,0,1,0,716,717,C
1-PB2,1090,718,1,1,0,720,A
1-PB2,1091,0,1,0,718,719,C
1-PB2,1092,719,0,0,0,719,A
1-PB2,1093,732,0,0,0,732,A
1-PB2,1094,0,729,0,0,729,T
1-PB2,1095,1,0,719,0,720,G
1-PB2,1096,1,0,721,1,723,G
1-PB2,1097,0,698,1,2,701,T
1-PB2,1098,0,0,702,0,702,G
1-PB2,1099,0,0,704,0,704,G
1-PB2,1100,0,0,708,0,708,G
1-PB2,1101,0,0,713,0,713,G
1-PB2,1102,711,0,0,0,711,A
1-PB2,1103,710,0,2,0,712,A
1-PB2,1104,710,0,0,0,710,A
1-PB2,1105,696,1,3,0,700,A
1-PB2,1106,0,0,709,0,709,G
1-PB2,1107,702,0,0,0,702,A
1-PB2,1108,1,0,705,0,706,G
1-PB2,1109,0,0,0,706,706,C
1-PB2,1110,705,0,0,0,705,A
1-PB2,1111,706,0,0,0,706,A
1-PB2,1112,0,0,0,716,716,C
1-PB2,1113,717,0,0,0,717,A
1-PB2,1114,0,0,728,0,728,G
1-PB2,1115,0,0,0,724,724,C
1-PB2,1116,0,721,0,1,722,T
1-PB2,1117,747,0,0,0,747,A
1-PB2,1118,0,744,0,0,744,T
1-PB2,1119,747,0,0,0,747,A
1-PB2,1120,0,0,0,746,746,C
1-PB2,1121,0,712,0,0,712,T
1-PB2,1122,716,0,1,0,717,A
1-PB2,1123,711,0,0,0,711,A
1-PB2,1124,0,0,714,0,714,G
1-PB2,1125,712,0,0,0,712,A
1-PB2,1126,698,0,0,0,698,A
1-PB2,1127,696,0,1,0,697,A
1-PB2,1128,695,0,0,0,695,A
1-PB2,1129,0,0,702,0,702,G
1-PB2,1130,1,0,0,702,703,C
1-PB2,1131,702,0,0,0,702,A
1-PB2,1132,705,0,0,0,705,A
1-PB2,1133,0,1,0,706,707,C
1-PB2,1134,0,0,0,710,710,C
1-PB2,1135,713,0,0,0,713,A
1-PB2,1136,0,0,715,0,715,G
1-PB2,1137,710,0,2,0,712,A
1-PB2,1138,709,0,0,0,709,A
1-PB2,1139,0,0,710,0,710,G
1-PB2,1140,714,0,0,0,714,A
1-PB2,1141,0,710,0,0,710,T
1-PB2,1142,0,703,1,0,704,T
1-PB2,1143,0,1,710,0,711,G
1-PB2,1144,0,0,720,0,720,G
1-PB2,1145,0,713,0,3,716,T
1-PB2,1146,0,713,0,0,713,T
1-PB2,1147,0,0,0,714,714,C
1-PB2,1148,709,1,0,0,710,A
1-PB2,1149,711,0,0,0,711,A
1-PB2,1150,0,0,0,760,760,C
1-PB2,1151,0,755,0,0,755,T
1-PB2,1152,1,0,0,764,765,C
1-PB2,1153,749,0,1,0,750,A
1-PB2,1154,0,754,0,0,754,T
1-PB2,1155,753,0,0,0,753,A
1-PB2,1156,0,0,755,0,755,G
1-PB2,1157,1,725,0,2,728,T
1-PB2,1158,1,0,737,0,738,G
1-PB2,1159,718,0,0,0,718,A
1-PB2,1160,0,0,727,0,727,G
1-PB2,1161,0,720,0,0,720,T
1-PB2,1162,0,0,723,0,723,G
1-PB2,1163,1,0,732,0,733,G
1-PB2,1164,727,1,2,0,730,A
1-PB2,1165,721,1,4,0,726,A
1-PB2,1166,0,0,728,0,728,G
1-PB2,1167,722,0,0,0,722,A
1-PB2,1168,0,1,721,0,722,G
1-PB2,1169,716,0,1,0,717,A
1-PB2,1170,1,1,0,716,718,C
1-PB2,1171,0,0,717,0,717,G
1-PB2,1172,714,0,0,0,714,A
1-PB2,1173,710,1,4,0,715,A
1-PB2,1174,0,0,0,714,714,C
1-PB2,1175,712,0,1,0,713,A
1-PB2,1176,2,0,753,0,755,G
1-PB2,1177,0,750,0,0,750,T
1-PB2,1178,0,1,0,750,751,C
1-PB2,1179,752,0,2,0,754,A
1-PB2,1180,753,0,0,0,753,A
1-PB2,1181,1,753,0,0,754,T
1-PB2,1182,754,0,0,0,754,A
1-PB2,1183,1,1,750,0,752,G
1-PB2,1184,0,0,0,744,744,C
1-PB2,1185,1,0,0,722,723,C
1-PB2,1186,0,0,723,0,723,G
1-PB2,1187,726,0,0,0,726,A
1-PB2,1188,726,0,0,0,726,A
1-PB2,1189,0,0,733,0,733,G
1-PB2,1190,0,0,0,755,755,C
1-PB2,1191,752,0,0,0,752,A
1-PB2,1192,747,0,0,0,747,A
1-PB2,1193,0,746,0,1,747,T
1-PB2,1194,753,0,0,0,753,A
1-PB2,1195,763,0,0,0,763,A
1-PB2,1196,0,761,0,0,761,T
1-PB2,1197,0,0,0,752,752,C
1-PB2,1198,0,0,751,0,751,G
1-PB2,1199,0,730,0,2,732,T
1-PB2,1200,1,0,730,0,731,G
1-PB2,1201,1,0,734,0,735,G
1-PB2,1202,0,0,0,735,735,C
1-PB2,1203,0,0,0,739,739,C
1-PB2,1204,735,0,1,0,736,A
1-PB2,1205,0,735,0,0,735,T
1-PB2,1206,0,0,733,0,733,G
1-PB2,1207,0,1,746,0,747,G
1-PB2,1208,0,736,0,0,736,T
1-PB2,1209,0,0,738,0,738,G
1-PB2,1210,1,721,1,1,724,T
1-PB2,1211,2,716,0,4,722,T
1-PB2,1212,0,724,0,0,724,T
1-PB2,1213,0,725,1,0,726,T
1-PB2,1214,0,1,0,735,736,C
1-PB2,1215,741,0,0,0,741,A
1-PB2,1216,0,0,0,776,776,C
1-PB2,1217,774,0,0,1,775,A
1-PB2,1218,785,0,0,0,785,A
1-PB2,1219,0,0,789,0,789,G
1-PB2,1220,784,0,2,0,786,A
1-PB2,1221,755,0,27,0,782,A
1-PB2,1222,0,0,793,0,793,G
1-PB2,1223,793,0,0,0,793,A
1-PB2,1224,1,789,0,1,791,T
1-PB2,1225,1,781,0,1,783,T
1-PB2,1226,1,0,778,0,779,G
1-PB2,1227,0,0,0,770,770,C
1-PB2,1228,778,0,1,0,779,A
1-PB2,1229,0,786,0,1,787,T
1-PB2,1230,1,0,818,0,819,G
1-PB2,1231,820,1,3,0,824,A
1-PB2,1232,0,830,0,0,830,T
1-PB2,1233,826,0,0,0,826,A
1-PB2,1234,827,0,0,0,827,A
1-PB2,1235,823,0,3,0,826,A
1-PB2,1236,828,0,0,0,828,A
1-PB2,1237,0,0,829,0,829,G
1-PB2,1238,0,0,0,841,841,C
1-PB2,1239,865,0,0,0,865,A
1-PB2,1240,0,0,900,0,900,G
1-PB2,1241,0,898,0,0,898,T
1-PB2,1242,0,902,0,0,902,T
1-PB2,1243,901,0,0,0,901,A
1-PB2,1244,0,0,909,0,909,G
1-PB2,1245,904,0,1,1,906,A
1-PB2,1246,0,0,902,0,902,G
1-PB2,1247,1,0,900,0,901,G
1-PB2,1248,0,863,0,0,863,T
1-PB2,1249,1,0,872,0,873,G
1-PB2,1250,877,0,0,0,877,A
1-PB2,1251,0,1,0,879,880,C
1-PB2,1252,3,0,0,874,877,C
1-PB2,1253,0,850,0,3,853,T
1-PB2,1254,0,0,856,1,857,G
1-PB2,1255,855,0,0,0,855,A
1-PB2,1256,854,0,0,0,854,A
1-PB2,1257,0,851,0,1,852,T
1-PB2,1258,0,863,0,1,864,T
1-PB2,1259,0,867,0,0,867,T
1-PB2,1260,0,1,0,865,866,C
1-PB2,1261,1,0,867,0,868,G
1-PB2,1262,2,865,0,2,869,T
1-PB2,1263,1,1,1,862,865,C
1-PB2,1264,868,0,1,0,869,A
1-PB2,1265,870,0,1,0,871,A
1-PB2,1266,0,0,0,869,869,C
1-PB2,1267,866,0,0,0,866,A
1-PB2,1268,0,1,879,0,880,G
1-PB2,1269,876,0,1,0,877,A
1-PB2,1270,0,0,879,0,879,G
1-PB2,1271,0,0,0,877,877,C
1-PB2,1272,877,0,0,0,877,A
1-PB2,1273,884,0,0,0,884,A
1-PB2,1274,885,0,1,0,886,A
1-PB2,1275,0,885,0,0,885,T
1-PB2,1276,0,0,0,885,885,C
1-PB2,1277,874,0,1,0,875,A
1-PB2,1278,0,0,880,0,880,G
1-PB2,1279,0,0,0,884,884,C
1-PB2,1280,0,0,886,0,886,G
1-PB2,1281,0,0,925,0,925,G
1-PB2,1282,0,916,0,0,916,T
1-PB2,1283,0,920,0,0,920,T
1-PB2,1284,0,2,919,0,921,G
1-PB2,1285,922,1,1,0,924,A
1-PB2,1286,937,0,0,0,937,A
1-PB2,1287,0,0,0,940,940,C
1-PB2,1288,1,0,1,929,931,C
1-PB2,1289,0,0,1,931,932,C
1-PB2,1290,0,0,0,909,909,C
1-PB2,1291,916,0,0,0,916,A
1-PB2,1292,1,914,1,2,918,T
1-PB2,1293,0,0,917,1,918,G
1-PB2,1294,0,0,0,923,923,C
1-PB2,1295,919,1,0,0,920,A
1-PB2,1296,0,913,0,1,914,T
1-PB2,1297,2,1,0,910,913,C
1-PB2,1298,908,0,0,0,908,A
1-PB2,1299,0,1,931,0,932,G
1-PB2,1300,0,1,0,933,934,C
1-PB2,1301,0,921,0,1,922,T
1-PB2,1302,0,921,4,0,925,T
1-PB2,1303,0,921,0,1,922,T
1-PB2,1304,0,924,0,0,924,T
1-PB2,1305,923,0,0,0,923,A
1-PB2,1306,924,1,1,0,926,A
1-PB2,1307,1,0,925,0,926,G
1-PB2,1308,0,1,920,0,921,G
1-PB2,1309,0,0,0,906,906,C
1-PB2,1310,902,0,1,0,903,A
1-PB2,1311,0,902,0,0,902,T
1-PB2,1312,0,902,0,2,904,T
1-PB2,1313,0,897,0,2,899,T
1-PB2,1314,0,905,0,1,906,T
1-PB2,1315,1,0,0,906,907,C
1-PB2,1316,905,0,0,0,905,A
1-PB2,1317,0,3,900,0,903,G
1-PB2,1318,899,0,0,0,899,A
1-PB2,1319,898,0,0,0,898,A
1-PB2,1320,902,0,0,0,902,A
1-PB2,1321,0,1,898,0,899,G
1-PB2,1322,901,0,3,0,904,A
1-PB2,1323,0,904,0,0,904,T
1-PB2,1324,1,0,903,0,904,G
1-PB2,1325,0,1,0,907,908,C
1-PB2,1326,0,0,907,0,907,G
1-PB2,1327,907,1,0,0,908,A
1-PB2,1328,910,1,0,0,911,A
1-PB2,1329,907,0,2,1,910,A
1-PB2,1330,0,0,909,0,909,G
1-PB2,1331,0,902,1,0,903,T
1-PB2,1332,0,0,900,0,900,G
1-PB2,1333,0,0,0,900,900,C
1-PB2,1334,1,895,0,2,898,T
1-PB2,1335,0,892,0,1,893,T
1-PB2,1336,0,893,0,0,893,T
1-PB2,1337,0,898,0,0,898,T
1-PB2,1338,0,897,0,0,897,T
1-PB2,1339,0,0,0,898,898,C
1-PB2,1340,898,0,0,0,898,A
1-PB2,1341,897,1,0,1,899,A
1-PB2,1342,898,1,0,1,900,A
1-PB2,1343,898,0,0,1,899,A
1-PB2,1344,0,898,0,0,898,T
1-PB2,1345,0,898,0,0,898,T
1-PB2,1346,0,0,899,0,899,G
1-PB2,1347,0,0,902,0,902,G
1-PB2,1348,0,1,899,0,900,G
1-PB2,1349,0,1,911,0,912,G
1-PB2,1350,910,0,0,0,910,A
1-PB2,1351,0,0,927,0,927,G
1-PB2,1352,0,928,0,0,928,T
1-PB2,1353,0,926,1,0,927,T
1-PB2,1354,1,0,927,1,929,G
1-PB2,1355,925,1,2,0,928,A
1-PB2,1356,932,1,1,0,934,A
1-PB2,1357,0,1,0,958,959,C
1-PB2,1358,948,0,0,1,949,A
1-PB2,1359,0,0,0,971,971,C
1-PB2,1360,957,0,1,0,958,A
1-PB2,1361,0,963,0,2,965,T
1-PB2,1362,2,1,0,961,964,C
1-PB2,1363,1,0,963,0,964,G
1-PB2,1364,968,0,0,0,968,A
1-PB2,1365,0,0,0,966,966,C
1-PB2,1366,942,0,1,0,943,A
1-PB2,1367,0,0,961,0,961,G
1-PB2,1368,1,936,2,1,940,T
1-PB2,1369,1,0,956,0,957,G
1-PB2,1370,0,949,0,2,951,T
1-PB2,1371,0,2,953,0,955,G
1-PB2,1372,956,0,0,0,956,A
1-PB2,1373,0,949,0,1,950,T
1-PB2,1374,0,0,950,0,950,G
1-PB2,1375,0,0,947,0,947,G
1-PB2,1376,0,0,940,0,940,G
1-PB2,1377,938,0,0,0,938,A
1-PB2,1378,925,0,2,0,927,A
1-PB2,1379,0,931,0,0,931,T
1-PB2,1380,0,1,941,0,942,G
1-PB2,1381,943,0,0,0,943,A
1-PB2,1382,0,946,0,0,946,T
1-PB2,1383,0,943,0,0,943,T
1-PB2,1384,0,0,942,0,942,G
1-PB2,1385,0,2,956,0,958,G
1-PB2,1386,947,0,2,0,949,A
1-PB2,1387,1,0,957,0,958,G
1-PB2,1388,1,944,0,0,945,T
1-PB2,1389,940,0,0,0,940,A
1-PB2,1390,0,940,0,0,940,T
1-PB2,1391,0,936,0,1,937,T
1-PB2,1392,949,0,0,0,949,A
1-PB2,1393,1,2,0,949,952,C
1-PB2,1394,0,1,0,929,930,C
1-PB2,1395,923,1,1,0,925,A
1-PB2,1396,0,1,930,0,931,G
1-PB2,1397,947,0,0,0,947,A
1-PB2,1398,0,940,0,1,941,T
1-PB2,1399,942,0,0,0,942,A
1-PB2,1400,0,932,0,0,932,T
1-PB2,1401,0,1,928,0,929,G
1-PB2,1402,931,0,1,0,932,A
1-PB2,1403,0,0,0,930,930,C
1-PB2,1404,0,918,0,1,919,T
1-PB2,1405,1,1,0,917,919,C
1-PB2,1406,1,1,1,908,911,C
1-PB2,1407,911,0,1,0,912,A
1-PB2,1408,909,0,0,0,909,A
1-PB2,1409,1,0,935,0,936,G
1-PB2,1410,0,0,0,926,926,C
1-PB2,1411,928,0,2,0,930,A
1-PB2,1412,0,1,0,927,928,C
1-PB2,1413,922,1,2,0,925,A
1-PB2,1414,0,1,924,0,925,G
1-PB2,1415,919,0,2,0,921,A
1-PB2,1416,0,0,928,1,929,G
1-PB2,1417,932,0,1,0,933,A
1-PB2,1418,1,911,0,1,913,T
1-PB2,1419,1,0,927,0,928,G
1-PB2,1420,0,924,0,3,927,T
1-PB2,1421,1,1,0,924,926,C
1-PB2,1422,928,0,2,0,930,A
1-PB2,1423,928,0,0,0,928,A
1-PB2,1424,0,927,1,0,928,T
1-PB2,1425,1,2,924,0,927,G
1-PB2,1426,909,1,2,0,912,A
1-PB2,1427,0,0,920,0,920,G
1-PB2,1428,907,0,1,0,908,A
1-PB2,1429,0,0,909,0,909,G
1-PB2,1430,0,1,957,0,958,G
1-PB2,1431,956,0,0,0,956,A
1-PB2,1432,959,0,1,0,960,A
1-PB2,1433,1,952,1,0,954,T
1-PB2,1434,957,0,0,0,957,A
1-PB2,1435,958,0,0,0,958,A
1-PB2,1436,0,1,953,0,954,G
1-PB2,1437,950,0,2,0,952,A
1-PB2,1438,0,0,952,0,952,G
1-PB2,1439,0,889,1,0,890,T
1-PB2,1440,1,0,0,894,895,C
1-PB2,1441,894,0,1,0,895,A
1-PB2,1442,1,0,909,0,910,G
1-PB2,1443,0,0,0,931,931,C
1-PB2,1444,933,0,0,0,933,A
1-PB2,1445,937,0,0,0,937,A
1-PB2,1446,932,0,2,0,934,A
1-PB2,1447,930,0,0,0,930,A
1-PB2,1448,0,932,0,0,932,T
1-PB2,1449,1,2,928,0,931,G
1-PB2,1450,0,0,931,1,932,G
1-PB2,1451,0,0,938,1,939,G
1-PB2,1452,0,930,0,0,930,T
1-PB2,1453,0,0,929,0,929,G
1-PB2,1454,0,923,1,0,924,T
1-PB2,1455,0,0,931,0,931,G
1-PB2,1456,0,0,947,1,948,G
1-PB2,1457,946,0,0,0,946,A
1-PB2,1458,0,948,0,0,948,T
1-PB2,1459,0,1,953,1,955,G
1-PB2,1460,950,0,1,0,951,A
1-PB2,1461,953,0,1,0,954,A
1-PB2,1462,0,956,1,0,957,T
1-PB2,1463,954,0,0,0,954,A
1-PB2,1464,1,0,0,1029,1030,C
1-PB2,1465,0,1000,0,1,1001,T
1-PB2,1466,2,0,0,1015,1017,C
1-PB2,1467,0,0,0,1014,1014,C
1-PB2,1468,1017,0,0,0,1017,A
1-PB2,1469,1,0,1045,0,1046,G
1-PB2,1470,0,1042,0,0,1042,T
1-PB2,1471,1053,0,1,0,1054,A
1-PB2,1472,0,0,0,1060,1060,C
1-PB2,1473,972,0,0,0,972,A
1-PB2,1474,0,0,979,0,979,G
1-PB2,1475,967,0,2,1,970,A
1-PB2,1476,0,0,976,0,976,G
1-PB2,1477,945,1,1,0,947,A
1-PB2,1478,0,1,931,0,932,G
1-PB2,1479,0,0,925,0,925,G
1-PB2,1480,0,0,926,0,926,G
1-PB2,1481,0,907,2,2,911,T
1-PB2,1482,0,2,908,0,910,G
1-PB2,1483,2,0,912,0,914,G
1-PB2,1484,0,911,0,0,911,T
1-PB2,1485,0,0,932,0,932,G
1-PB2,1486,0,0,935,0,935,G
1-PB2,1487,0,914,0,1,915,T
1-PB2,1488,0,910,0,3,913,T
1-PB2,1489,912,0,1,0,913,A
1-PB2,1490,1,0,918,0,919,G
1-PB2,1491,0,0,0,916,916,C
1-PB2,1492,918,0,0,1,919,A
1-PB2,1493,0,920,0,0,920,T
1-PB2,1494,0,872,0,0,872,T
1-PB2,1495,0,2,873,0,875,G
1-PB2,1496,871,0,0,0,871,A
1-PB2,1497,0,871,0,0,871,T
1-PB2,1498,1,1,0,872,874,C
1-PB2,1499,0,0,864,0,864,G
1-PB2,1500,0,0,882,0,882,G
1-PB2,1501,0,883,0,0,883,T
1-PB2,1502,0,878,0,2,880,T
1-PB2,1503,0,879,0,1,880,T
1-PB2,1504,0,880,0,1,881,T
1-PB2,1505,0,881,0,0,881,T
1-PB2,1506,0,0,882,0,882,G
1-PB2,1507,874,2,0,0,876,A
1-PB2,1508,0,0,879,0,879,G
1-PB2,1509,854,0,2,0,856,A
1-PB2,1510,0,0,864,0,864,G
1-PB2,1511,0,866,0,0,866,T
1-PB2,1512,0,866,0,0,866,T
1-PB2,1513,2,2,0,861,865,C
1-PB2,1514,0,0,872,0,872,G
1-PB2,1515,869,0,3,0,872,A
1-PB2,1516,1,0,874,0,875,G
1-PB2,1517,870,0,3,0,873,A
1-PB2,1518,1,0,0,873,874,C
1-PB2,1519,1,0,0,862,863,C
1-PB2,1520,853,0,1,0,854,A
1-PB2,1521,856,0,0,0,856,A
1-PB2,1522,1,0,0,859,860,C
1-PB2,1523,0,0,861,0,861,G
1-PB2,1524,0,858,0,0,858,T
1-PB2,1525,0,0,856,0,856,G
1-PB2,1526,0,1,862,0,863,G
1-PB2,1527,1,2,856,0,859,G
1-PB2,1528,858,0,2,0,860,A
1-PB2,1529,861,0,0,0,861,A
1-PB2,1530,0,838,0,0,838,T
1-PB2,1531,0,0,875,0,875,G
1-PB2,1532,2,870,0,1,873,T
1-PB2,1533,872,0,0,0,872,A
1-PB2,1534,0,875,0,0,875,T
1-PB2,1535,0,861,0,0,861,T
1-PB2,1536,876,0,0,0,876,A
1-PB2,1537,0,870,0,0,870,T
1-PB2,1538,0,867,0,0,867,T
1-PB2,1539,866,0,0,0,866,A
1-PB2,1540,0,778,0,1,779,T
1-PB2,1541,1,0,0,790,791,C
1-PB2,1542,0,786,0,0,786,T
1-PB2,1543,1,0,0,791,792,C
1-PB2,1544,0,0,0,790,790,C
1-PB2,1545,0,766,0,2,768,T
1-PB2,1546,0,1,772,0,773,G
1-PB2,1547,769,0,1,0,770,A
1-PB2,1548,0,0,774,0,774,G
1-PB2,1549,0,0,771,0,771,G
1-PB2,1550,712,0,0,0,712,A
1-PB2,1551,1,1,714,0,716,G
1-PB2,1552,0,0,714,0,714,G
1-PB2,1553,0,679,0,0,679,T
1-PB2,1554,2,0,0,680,682,C
1-PB2,1555,678,0,1,0,679,A
1-PB2,1556,0,0,689,0,689,G
1-PB2,1557,0,685,0,0,685,T
1-PB2,1558,0,0,687,0,687,G
1-PB2,1559,690,0,1,0,691,A
1-PB2,1560,671,0,2,0,673,A
1-PB2,1561,672,0,0,2,674,A
1-PB2,1562,0,0,0,675,675,C
1-PB2,1563,664,0,1,0,665,A
1-PB2,1564,1,1,0,665,667,C
1-PB2,1565,641,1,0,0,642,A
1-PB2,1566,0,0,643,0,643,G
1-PB2,1567,0,1,637,1,639,G
1-PB2,1568,0,0,653,0,653,G
1-PB2,1569,649,0,1,0,650,A
1-PB2,1570,641,0,0,0,641,A
1-PB2,1571,0,0,0,649,649,C
1-PB2,1572,0,643,0,0,643,T
1-PB2,1573,0,0,644,0,644,G
1-PB2,1574,641,0,1,0,642,A
1-PB2,1575,0,0,643,0,643,G
1-PB2,1576,625,0,2,0,627,A
1-PB2,1577,1,0,609,0,610,G
1-PB2,1578,611,0,2,0,613,A
1-PB2,1579,0,1,0,611,612,C
1-PB2,1580,0,593,1,0,594,T
1-PB2,1581,0,0,607,0,607,G
1-PB2,1582,605,0,1,0,606,A
1-PB2,1583,0,1,0,616,617,C
1-PB2,1584,611,0,3,0,614,A
1-PB2,1585,613,0,0,0,613,A
1-PB2,1586,0,613,0,0,613,T
1-PB2,1587,615,0,0,0,615,A
1-PB2,1588,615,0,0,0,615,A
1-PB2,1589,0,0,0,620,620,C
1-PB2,1590,0,593,0,0,593,T
1-PB2,1591,0,584,0,0,584,T
1-PB2,1592,584,0,1,0,585,A
1-PB2,1593,0,584,0,1,585,T
1-PB2,1594,0,582,1,0,583,T
1-PB2,1595,0,0,0,584,584,C
1-PB2,1596,549,0,0,0,549,A
1-PB2,1597,1,546,0,0,547,T
1-PB2,1598,0,0,0,531,531,C
1-PB2,1599,0,0,529,0,529,G
1-PB2,1600,0,534,0,1,535,T
1-PB2,1601,0,0,0,527,527,C
1-PB2,1602,0,0,527,0,527,G
1-PB2,1603,528,0,0,0,528,A
1-PB2,1604,0,526,0,0,526,T
1-PB2,1605,0,1,521,0,522,G
1-PB2,1606,524,0,0,0,524,A
1-PB2,1607,0,521,0,0,521,T
1-PB2,1608,0,0,522,0,522,G
1-PB2,1609,0,511,0,0,511,T
1-PB2,1610,0,1,507,0,508,G
1-PB2,1611,1,0,507,0,508,G
1-PB2,1612,0,0,512,0,512,G
1-PB2,1613,504,0,0,0,504,A
1-PB2,1614,0,0,511,0,511,G
1-PB2,1615,493,0,0,0,493,A
1-PB2,1616,0,485,0,0,485,T
1-PB2,1617,0,473,0,0,473,T
1-PB2,1618,470,0,0,0,470,A
1-PB2,1619,468,0,0,0,468,A
1-PB2,1620,0,0,0,464,464,C
1-PB2,1621,1,0,455,0,456,G
1-PB2,1622,0,0,464,0,464,G
1-PB2,1623,0,443,0,0,443,T
1-PB2,1624,1,0,0,443,444,C
1-PB2,1625,1,0,0,444,445,C
1-PB2,1626,0,423,0,0,423,T
1-PB2,1627,0,0,426,0,426,G
1-PB2,1628,425,0,0,0,425,A
1-PB2,1629,0,0,427,0,427,G
1-PB2,1630,0,427,0,0,427,T
1-PB2,1631,2,0,0,399,401,C
1-PB2,1632,0,0,400,0,400,G
1-PB2,1633,1,0,406,0,407,G
1-PB2,1634,0,405,0,1,406,T
1-PB2,1635,0,408,0,0,408,T
1-PB2,1636,0,408,0,0,408,T
1-PB2,1637,0,410,0,0,410,T
1-PB2,1638,0,0,413,0,413,G
1-PB2,1639,0,0,416,0,416,G
1-PB2,1640,0,416,0,0,416,T
1-PB2,1641,2,1,0,414,417,C
1-PB2,1642,410,1,0,0,411,A
1-PB2,1643,420,0,0,0,420,A
1-PB2,1644,0,420,0,0,420,T
1-PB2,1645,423,0,0,0,423,A
1-PB2,1646,1,0,0,434,435,C
1-PB2,1647,0,0,0,424,424,C
1-PB2,1648,0,420,0,1,421,T
1-PB2,1649,423,0,0,0,423,A
1-PB2,1650,0,419,0,1,420,T
1-PB2,1651,0,1,0,425,426,C
1-PB2,1652,408,0,0,0,408,A
1-PB2,1653,405,0,0,1,406,A
1-PB2,1654,0,407,0,0,407,T
1-PB2,1655,0,1,397,0,398,G
1-PB2,1656,0,1,395,0,396,G
1-PB2,1657,392,0,0,0,392,A
1-PB2,1658,1,384,0,0,385,T
1-PB2,1659,0,0,0,386,386,C
1-PB2,1660,387,0,0,0,387,A
1-PB2,1661,0,384,0,0,384,T
1-PB2,1662,0,0,0,387,387,C
1-PB2,1663,386,0,1,0,387,A
1-PB2,1664,0,0,389,0,389,G
1-PB2,1665,389,0,0,0,389,A
1-PB2,1666,389,0,1,0,390,A
1-PB2,1667,391,0,0,0,391,A
1-PB2,1668,0,389,0,0,389,T
1-PB2,1669,0,390,0,0,390,T
1-PB2,1670,0,0,387,0,387,G
1-PB2,1671,0,1,386,0,387,G
1-PB2,1672,0,0,383,0,383,G
1-PB2,1673,384,0,1,0,385,A
1-PB2,1674,384,0,0,0,384,A
1-PB2,1675,0,1,387,0,388,G
1-PB2,1676,0,0,0,388,388,C
1-PB2,1677,0,386,0,0,386,T
1-PB2,1678,0,0,392,0,392,G
1-PB2,1679,0,389,0,0,389,T
1-PB2,1680,1,0,0,390,391,C
1-PB2,1681,389,0,1,0,390,A
1-PB2,1682,390,0,0,0,390,A
1-PB2,1683,393,0,0,0,393,A
1-PB2,1684,390,0,0,0,390,A
1-PB2,1685,0,392,0,0,392,T
1-PB2,1686,0,382,0,0,382,T
1-PB2,1687,0,0,0,378,378,C
1-PB2,1688,378,0,0,0,378,A
1-PB2,1689,378,0,0,0,378,A
1-PB2,1690,0,380,0,1,381,T
1-PB2,1691,0,0,376,0,376,G
1-PB2,1692,0,0,385,0,385,G
1-PB2,1693,1,389,0,1,391,T
1-PB2,1694,2,0,0,394,396,C
1-PB2,1695,0,398,0,0,398,T
1-PB2,1696,0,0,0,395,395,C
1-PB2,1697,397,0,0,0,397,A
1-PB2,1698,0,0,396,0,396,G
1-PB2,1699,399,0,0,0,399,A
1-PB2,1700,403,0,0,0,403,A
1-PB2,1701,0,401,0,0,401,T
1-PB2,1702,1,0,0,390,391,C
1-PB2,1703,0,0,0,371,371,C
1-PB2,1704,0,371,0,1,372,T
1-PB2,1705,0,0,373,0,373,G
1-PB2,1706,0,0,0,375,375,C
1-PB2,1707,376,0,0,0,376,A
1-PB2,1708,388,0,1,0,389,A
1-PB2,1709,0,389,0,0,389,T
1-PB2,1710,0,0,398,0,398,G
1-PB2,1711,0,398,0,0,398,T
1-PB2,1712,0,388,0,0,388,T
1-PB2,1713,0,0,394,0,394,G
1-PB2,1714,0,393,0,1,394,T
1-PB2,1715,391,0,0,0,391,A
1-PB2,1716,0,0,0,391,391,C
1-PB2,1717,389,0,0,0,389,A
1-PB2,1718,395,0,0,0,395,A
1-PB2,1719,0,0,0,394,394,C
1-PB2,1720,389,0,0,0,389,A
1-PB2,1721,390,0,0,0,390,A
1-PB2,1722,388,0,0,0,388,A
1-PB2,1723,388,0,0,0,388,A
1-PB2,1724,0,388,0,0,388,T
1-PB2,1725,0,0,386,0,386,G
1-PB2,1726,0,0,387,0,387,G
1-PB2,1727,385,0,0,0,385,A
1-PB2,1728,387,0,0,1,388,A
1-PB2,1729,0,388,0,0,388,T
1-PB2,1730,0,384,0,0,384,T
1-PB2,1731,0,385,0,1,386,T
1-PB2,1732,0,3,381,0,384,G
1-PB2,1733,387,0,0,0,387,A
1-PB2,1734,387,0,0,0,387,A
1-PB2,1735,0,0,0,385,385,C
1-PB2,1736,0,0,0,370,370,C
1-PB2,1737,378,0,0,0,378,A
1-PB2,1738,0,381,0,0,381,T
1-PB2,1739,0,379,0,0,379,T
1-PB2,1740,0,382,0,0,382,T
1-PB2,1741,0,1,0,378,379,C
1-PB2,1742,381,0,1,0,382,A
1-PB2,1743,377,0,0,1,378,A
1-PB2,1744,0,379,0,0,379,T
1-PB2,1745,0,0,0,385,385,C
1-PB2,1746,0,379,0,0,379,T
1-PB2,1747,0,377,0,0,377,T
1-PB2,1748,0,381,0,0,381,T
1-PB2,1749,382,0,0,0,382,A
1-PB2,1750,0,0,385,0,385,G
1-PB2,1751,0,384,0,0,384,T
1-PB2,1752,0,1,0,387,388,C
1-PB2,1753,0,0,0,385,385,C
1-PB2,1754,0,0,0,384,384,C
1-PB2,1755,0,0,0,385,385,C
1-PB2,1756,385,0,0,1,386,A
1-PB2,1757,385,0,0,0,385,A
1-PB2,1758,0,0,390,0,390,G
1-PB2,1759,0,0,389,0,389,G
1-PB2,1760,0,0,0,390,390,C
1-PB2,1761,0,0,1,390,391,C
1-PB2,1762,392,0,1,0,393,A
1-PB2,1763,0,400,0,0,400,T
1-PB2,1764,0,400,0,0,400,T
1-PB2,1765,398,0,1,0,399,A
1-PB2,1766,0,0,400,0,400,G
1-PB2,1767,391,0,1,0,392,A
1-PB2,1768,407,0,0,0,407,A
1-PB2,1769,0,0,408,0,408,G
1-PB2,1770,0,0,0,410,410,C
1-PB2,1771,0,0,0,409,409,C
1-PB2,1772,405,0,1,0,406,A
1-PB2,1773,408,0,1,0,409,A
1-PB2,1774,0,408,0,0,408,T
1-PB2,1775,407,0,0,0,407,A
1-PB2,1776,1,0,0,407,408,C
1-PB2,1777,386,0,0,0,386,A
1-PB2,1778,0,0,387,0,387,G
1-PB2,1779,0,376,0,0,376,T
1-PB2,1780,0,0,378,0,378,G
1-PB2,1781,1,0,376,0,377,G
1-PB2,1782,0,0,378,0,378,G
1-PB2,1783,1,375,0,0,376,T
1-PB2,1784,1,372,0,0,373,T
1-PB2,1785,0,371,0,1,372,T
1-PB2,1786,0,0,377,0,377,G
1-PB2,1787,0,377,0,0,377,T
1-PB2,1788,1,0,0,375,376,C
1-PB2,1789,369,1,0,0,370,A
1-PB2,1790,0,0,366,0,366,G
1-PB2,1791,368,0,0,0,368,A
1-PB2,1792,366,0,0,0,366,A
1-PB2,1793,0,0,0,368,368,C
1-PB2,1794,0,361,0,0,361,T
1-PB2,1795,0,0,0,368,368,C
1-PB2,1796,1,369,0,0,370,T
1-PB2,1797,372,0,0,0,372,A
1-PB2,1798,0,373,0,0,373,T
1-PB2,1799,0,370,0,0,370,T
1-PB2,1800,1,0,0,370,371,C
1-PB2,1801,0,1,0,367,368,C
1-PB2,1802,368,0,0,0,368,A
1-PB2,1803,370,0,0,0,370,A
1-PB2,1804,0,0,0,370,370,C
1-PB2,1805,363,0,0,0,363,A
1-PB2,1806,366,0,1,0,367,A
1-PB2,1807,365,0,0,0,365,A
1-PB2,1808,0,365,0,1,366,T
1-PB2,1809,0,0,367,0,367,G
1-PB2,1810,364,0,1,0,365,A
1-PB2,1811,0,0,367,0,367,G
1-PB2,1812,366,0,0,0,366,A
1-PB2,1813,0,0,364,0,364,G
1-PB2,1814,362,0,1,0,363,A
1-PB2,1815,0,0,0,359,359,C
1-PB2,1816,0,0,361,0,361,G
1-PB2,1817,0,363,0,0,363,T
1-PB2,1818,364,0,1,0,365,A
1-PB2,1819,0,0,0,364,364,C
1-PB2,1820,0,364,1,0,365,T
1-PB2,1821,0,364,0,0,364,T
1-PB2,1822,0,0,363,0,363,G
1-PB2,1823,0,0,359,0,359,G
1-PB2,1824,0,1,359,0,360,G
1-PB2,1825,360,0,0,0,360,A
1-PB2,1826,0,0,0,361,361,C
1-PB2,1827,366,0,0,0,366,A
1-PB2,1828,0,370,0,0,370,T
1-PB2,1829,0,370,0,0,370,T
1-PB2,1830,0,373,0,0,373,T
1-PB2,1831,0,0,373,0,373,G
1-PB2,1832,370,0,0,0,370,A
1-PB2,1833,0,1,0,373,374,C
1-PB2,1834,373,0,1,0,374,A
1-PB2,1835,0,0,1,372,373,C
1-PB2,1836,1,0,0,365,366,C
1-PB2,1837,367,0,0,0,367,A
1-PB2,1838,0,0,0,372,372,C
1-PB2,1839,0,0,0,370,370,C
1-PB2,1840,0,0,0,370,370,C
1-PB2,1841,372,0,0,0,372,A
1-PB2,1842,0,0,375,0,375,G
1-PB2,1843,377,0,0,0,377,A
1-PB2,1844,0,393,0,0,393,T
1-PB2,1845,392,0,0,0,392,A
1-PB2,1846,391,0,0,0,391,A
1-PB2,1847,0,390,0,0,390,T
1-PB2,1848,388,0,0,0,388,A
1-PB2,1849,383,1,1,0,385,A
1-PB2,1850,380,0,1,0,381,A
1-PB2,1851,0,0,385,0,385,G
1-PB2,1852,0,0,0,393,393,C
1-PB2,1853,0,384,0,0,384,T
1-PB2,1854,0,377,0,0,377,T
1-PB2,1855,0,2,0,380,382,C
1-PB2,1856,0,381,0,0,381,T
1-PB2,1857,0,0,0,385,385,C
1-PB2,1858,1,0,0,386,387,C
1-PB2,1859,0,0,0,385,385,C
1-PB2,1860,0,0,0,378,378,C
1-PB2,1861,0,382,0,1,383,T
1-PB2,1862,0,383,0,0,383,T
1-PB2,1863,0,384,0,1,385,T
1-PB2,1864,0,0,386,0,386,G
1-PB2,1865,1,1,0,384,386,C
1-PB2,1866,386,0,0,0,386,A
1-PB2,1867,0,0,388,0,388,G
1-PB2,1868,0,0,0,384,384,C
1-PB2,1869,0,380,0,0,380,T
1-PB2,1870,0,0,380,0,380,G
1-PB2,1871,0,1,0,380,381,C
1-PB2,1872,0,379,0,0,379,T
1-PB2,1873,1,0,0,379,380,C
1-PB2,1874,0,0,0,383,383,C
1-PB2,1875,384,0,0,0,384,A
1-PB2,1876,2,0,0,383,385,C
1-PB2,1877,1,1,0,383,385,C
1-PB2,1878,385,0,0,0,385,A
1-PB2,1879,380,0,1,0,381,A
1-PB2,1880,383,0,0,0,383,A
1-PB2,1881,0,0,383,0,383,G
1-PB2,1882,0,0,0,386,386,C
1-PB2,1883,380,0,0,0,380,A
1-PB2,1884,383,0,0,0,383,A
1-PB2,1885,382,0,0,0,382,A
1-PB2,1886,0,0,388,0,388,G
1-PB2,1887,0,0,0,388,388,C
1-PB2,1888,383,0,0,0,383,A
1-PB2,1889,0,0,384,0,384,G
1-PB2,1890,377,0,1,0,378,A
1-PB2,1891,382,0,0,0,382,A
1-PB2,1892,0,383,0,0,383,T
1-PB2,1893,1,0,378,0,379,G
1-PB2,1894,0,0,0,381,381,C
1-PB2,1895,375,0,1,0,376,A
1-PB2,1896,0,0,376,0,376,G
1-PB2,1897,0,375,0,1,376,T
1-PB2,1898,0,391,0,0,391,T
1-PB2,1899,0,0,0,389,389,C
1-PB2,1900,0,384,0,0,384,T
1-PB2,1901,1,1,0,385,387,C
1-PB2,1902,0,387,0,1,388,T
1-PB2,1903,0,384,0,0,384,T
1-PB2,1904,0,1,0,383,384,C
1-PB2,1905,377,0,0,0,377,A
1-PB2,1906,0,1,0,378,379,C
1-PB2,1907,0,367,0,1,368,T
1-PB2,1908,0,1,371,0,372,G
1-PB2,1909,367,0,0,0,367,A
1-PB2,1910,9,0,0,366,375,C
1-PB2,1911,0,370,0,0,370,T
1-PB2,1912,1,0,369,0,370,G
1-PB2,1913,0,369,0,1,370,T
1-PB2,1914,0,1,376,0,377,G
1-PB2,1915,373,0,0,0,373,A
1-PB2,1916,381,0,0,0,381,A
1-PB2,1917,0,377,0,0,377,T
1-PB2,1918,0,0,378,0,378,G
1-PB2,1919,0,367,0,0,367,T
1-PB2,1920,366,0,0,0,366,A
1-PB2,1921,364,0,0,0,364,A
1-PB2,1922,0,1,366,0,367,G
1-PB2,1923,0,0,365,0,365,G
1-PB2,1924,0,0,366,0,366,G
1-PB2,1925,0,0,367,0,367,G
1-PB2,1926,365,0,0,0,365,A
1-PB2,1927,0,364,0,0,364,T
1-PB2,1928,0,0,0,361,361,C
1-PB2,1929,364,0,0,0,364,A
1-PB2,1930,0,0,365,0,365,G
1-PB2,1931,0,0,364,0,364,G
1-PB2,1932,0,0,363,0,363,G
1-PB2,1933,360,0,0,0,360,A
1-PB2,1934,0,352,0,0,352,T
1-PB2,1935,0,0,352,0,352,G
1-PB2,1936,347,0,0,0,347,A
1-PB2,1937,0,0,356,0,356,G
1-PB2,1938,356,0,0,0,356,A
1-PB2,1939,349,1,1,0,351,A
1-PB2,1940,0,352,0,1,353,T
1-PB2,1941,347,1,0,0,348,A
1-PB2,1942,0,0,0,354,354,C
1-PB2,1943,0,349,0,1,350,T
1-PB2,1944,0,348,0,1,349,T
1-PB2,1945,0,0,351,0,351,G
1-PB2,1946,1,344,0,0,345,T
1-PB2,1947,344,0,0,0,344,A
1-PB2,1948,341,0,1,0,342,A
1-PB2,1949,0,2,337,0,339,G
1-PB2,1950,0,1,340,0,341,G
1-PB2,1951,0,1,336,0,337,G
1-PB2,1952,0,0,334,0,334,G
1-PB2,1953,0,1,0,333,334,C
1-PB2,1954,330,0,0,0,330,A
1-PB2,1955,339,0,0,0,339,A
1-PB2,1956,0,339,0,0,339,T
1-PB2,1957,0,338,0,0,338,T
1-PB2,1958,0,0,0,348,348,C
1-PB2,1959,0,341,0,0,341,T
1-PB2,1960,0,0,0,346,346,C
1-PB2,1961,0,0,0,346,346,C
1-PB2,1962,0,347,0,0,347,T
1-PB2,1963,0,1,355,0,356,G
1-PB2,1964,0,345,0,0,345,T
1-PB2,1965,345,0,0,1,346,A
1-PB2,1966,0,344,0,0,344,T
1-PB2,1967,0,334,0,0,334,T
1-PB2,1968,0,0,0,335,335,C
1-PB2,1969,331,0,0,1,332,A
1-PB2,1970,334,0,0,0,334,A
1-PB2,1971,0,0,0,334,334,C
1-PB2,1972,0,324,0,1,325,T
1-PB2,1973,329,0,0,0,329,A
1-PB2,1974,1,1,0,330,332,C
1-PB2,1975,331,0,0,0,331,A
1-PB2,1976,330,0,0,0,330,A
1-PB2,1977,0,0,0,329,329,C
1-PB2,1978,326,0,1,0,327,A
1-PB2,1979,322,0,1,0,323,A
1-PB2,1980,0,0,323,0,323,G
1-PB2,1981,321,0,0,0,321,A
1-PB2,1982,0,0,0,323,323,C
1-PB2,1983,0,0,0,312,312,C
1-PB2,1984,313,0,0,0,313,A
1-PB2,1985,0,0,0,330,330,C
1-PB2,1986,0,330,0,0,330,T
1-PB2,1987,329,0,0,0,329,A
1-PB2,1988,330,0,0,0,330,A
1-PB2,1989,325,1,0,0,326,A
1-PB2,1990,327,0,0,0,327,A
1-PB2,1991,0,0,327,0,327,G
1-PB2,1992,327,0,0,0,327,A
1-PB2,1993,0,0,0,326,326,C
1-PB2,1994,0,319,0,0,319,T
1-PB2,1995,320,0,0,0,320,A
1-PB2,1996,320,0,0,0,320,A
1-PB2,1997,1,0,0,318,319,C
1-PB2,1998,318,0,1,0,319,A
1-PB2,1999,320,0,0,0,320,A
1-PB2,2000,0,317,0,0,317,T
1-PB2,2001,0,310,0,0,310,T
1-PB2,2002,0,0,0,315,315,C
1-PB2,2003,0,313,0,0,313,T
1-PB2,2004,0,0,0,316,316,C
1-PB2,2005,0,0,314,0,314,G
1-PB2,2006,0,0,316,0,316,G
1-PB2,2007,316,0,0,0,316,A
1-PB2,2008,312,1,0,0,313,A
1-PB2,2009,313,0,0,0,313,A
1-PB2,2010,314,0,1,0,315,A
1-PB2,2011,0,0,315,0,315,G
1-PB2,2012,315,0,0,0,315,A
1-PB2,2013,0,315,0,0,315,T
1-PB2,2014,0,0,312,0,312,G
1-PB2,2015,0,0,0,311,311,C
1-PB2,2016,0,0,0,312,312,C
1-PB2,2017,0,0,313,0,313,G
1-PB2,2018,0,0,313,0,313,G
1-PB2,2019,0,0,0,312,312,C
1-PB2,2020,313,0,0,0,313,A
1-PB2,2021,0,1,0,318,319,C
1-PB2,2022,0,320,0,0,320,T
1-PB2,2023,0,318,0,0,318,T
1-PB2,2024,0,320,0,0,320,T
1-PB2,2025,321,0,0,0,321,A
1-PB2,2026,323,0,0,0,323,A
1-PB2,2027,0,323,0,0,323,T
1-PB2,2028,0,322,0,0,322,T
1-PB2,2029,0,0,323,0,323,G
1-PB2,2030,312,0,1,0,313,A
1-PB2,2031,312,0,0,0,312,A
1-PB2,2032,0,0,313,0,313,G
1-PB2,2033,316,0,0,0,316,A
1-PB2,2034,0,0,0,315,315,C
1-PB2,2035,0,0,0,310,310,C
1-PB2,2036,0,0,1,313,314,C
1-PB2,2037,311,0,1,0,312,A
1-PB2,2038,0,0,317,0,317,G
1-PB2,2039,317,0,0,0,317,A
1-PB2,2040,0,316,0,0,316,T
1-PB2,2041,0,0,315,0,315,G
1-PB2,2042,313,0,0,0,313,A
1-PB2,2043,313,0,0,0,313,A
1-PB2,2044,313,0,1,0,314,A
1-PB2,2045,0,0,311,0,311,G
1-PB2,2046,0,0,0,311,311,C
1-PB2,2047,304,0,0,0,304,A
1-PB2,2048,0,0,0,305,305,C
1-PB2,2049,308,0,0,0,308,A
1-PB2,2050,0,306,0,0,306,T
1-PB2,2051,0,0,0,311,311,C
1-PB2,2052,0,0,0,312,312,C
1-PB2,2053,1,1,311,0,313,G
1-PB2,2054,0,0,314,0,314,G
1-PB2,2055,307,0,2,0,309,A
1-PB2,2056,0,0,316,0,316,G
1-PB2,2057,0,312,0,0,312,T
1-PB2,2058,0,0,312,0,312,G
1-PB2,2059,0,0,310,0,310,G
1-PB2,2060,300,1,0,0,301,A
1-PB2,2061,0,0,302,0,302,G
1-PB2,2062,0,298,0,0,298,T
1-PB2,2063,0,0,0,298,298,C
1-PB2,2064,0,0,0,298,298,C
1-PB2,2065,0,0,298,0,298,G
1-PB2,2066,0,0,0,296,296,C
1-PB2,2067,0,0,0,297,297,C
1-PB2,2068,0,0,302,0,302,G
1-PB2,2069,0,295,0,0,295,T
1-PB2,2070,0,0,0,301,301,C
1-PB2,2071,0,301,0,0,301,T
1-PB2,2072,0,301,0,0,301,T
1-PB2,2073,0,1,300,0,301,G
1-PB2,2074,299,0,1,0,300,A
1-PB2,2075,0,0,301,0,301,G
1-PB2,2076,300,0,0,0,300,A
1-PB2,2077,0,0,292,0,292,G
1-PB2,2078,0,0,291,0,291,G
1-PB2,2079,0,0,288,0,288,G
1-PB2,2080,0,283,0,1,284,T
1-PB2,2081,0,286,0,0,286,T
1-PB2,2082,0,287,0,0,287,T
1-PB2,2083,0,0,0,287,287,C
1-PB2,2084,0,288,0,0,288,T
1-PB2,2085,1,1,0,289,291,C
1-PB2,2086,292,0,0,0,292,A
1-PB2,2087,0,288,0,0,288,T
1-PB2,2088,0,290,0,0,290,T
1-PB2,2089,292,0,0,0,292,A
1-PB2,2090,0,292,0,0,292,T
1-PB2,2091,286,0,0,0,286,A
1-PB2,2092,0,0,288,0,288,G
1-PB2,2093,0,0,288,0,288,G
1-PB2,2094,0,268,0,0,268,T
1-PB2,2095,267,0,0,0,267,A
1-PB2,2096,266,0,0,0,266,A
1-PB2,2097,0,1,265,0,266,G
1-PB2,2098,0,2,266,0,268,G
1-PB2,2099,266,0,0,0,266,A
1-PB2,2100,261,1,0,0,262,A
1-PB2,2101,0,1,262,0,263,G
1-PB2,2102,256,0,2,1,259,A
1-PB2,2103,0,1,0,259,260,C
1-PB2,2104,252,1,0,0,253,A
1-PB2,2105,0,1,252,0,253,G
1-PB2,2106,250,0,0,1,251,A
1-PB2,2107,247,0,0,1,248,A
1-PB2,2108,0,0,248,0,248,G
1-PB2,2109,0,0,245,0,245,G
1-PB2,2110,0,247,0,0,247,T
1-PB2,2111,247,0,0,0,247,A
1-PB2,2112,0,1,0,245,246,C
1-PB2,2113,0,0,245,0,245,G
1-PB2,2114,0,0,247,0,247,G
1-PB2,2115,247,0,0,0,247,A
1-PB2,2116,0,0,0,245,245,C
1-PB2,2117,0,0,0,245,245,C
1-PB2,2118,235,0,0,0,235,A
1-PB2,2119,0,0,245,0,245,G
1-PB2,2120,0,0,0,245,245,C
1-PB2,2121,242,0,0,0,242,A
1-PB2,2122,0,243,0,0,243,T
1-PB2,2123,0,231,0,0,231,T
1-PB2,2124,230,0,0,0,230,A
1-PB2,2125,229,0,0,1,230,A
1-PB2,2126,0,0,231,0,231,G
1-PB2,2127,0,1,0,227,228,C
1-PB2,2128,207,1,0,0,208,A
1-PB2,2129,0,218,0,0,218,T
1-PB2,2130,0,0,1,216,217,C
1-PB2,2131,217,0,0,0,217,A
1-PB2,2132,216,0,1,0,217,A
1-PB2,2133,0,217,0,0,217,T
1-PB2,2134,0,0,218,0,218,G
1-PB2,2135,217,0,0,0,217,A
1-PB2,2136,219,0,0,0,219,A
1-PB2,2137,0,0,0,222,222,C
1-PB2,2138,0,204,0,0,204,T
1-PB2,2139,0,0,214,0,214,G
1-PB2,2140,213,0,0,0,213,A
1-PB2,2141,0,0,213,0,213,G
1-PB2,2142,0,214,0,0,214,T
1-PB2,2143,212,0,0,0,212,A
1-PB2,2144,214,0,0,0,214,A
1-PB2,2145,0,0,0,213,213,C
1-PB2,2146,0,0,0,211,211,C
1-PB2,2147,0,209,0,0,209,T
1-PB2,2148,0,207,0,0,207,T
1-PB2,2149,0,1,206,0,207,G
1-PB2,2150,0,0,0,206,206,C
1-PB2,2151,206,0,0,0,206,A
1-PB2,2152,206,0,0,0,206,A
1-PB2,2153,205,0,0,0,205,A
1-PB2,2154,201,0,1,0,202,A
1-PB2,2155,0,0,200,0,200,G
1-PB2,2156,0,0,200,0,200,G
1-PB2,2157,0,0,199,0,199,G
1-PB2,2158,0,0,201,0,201,G
1-PB2,2159,198,0,0,0,198,A
1-PB2,2160,200,0,0,0,200,A
1-PB2,2161,199,0,0,0,199,A
1-PB2,2162,200,0,0,0,200,A
1-PB2,2163,0,0,201,0,201,G
1-PB2,2164,0,0,201,0,201,G
1-PB2,2165,0,0,0,200,200,C
1-PB2,2166,0,197,0,1,198,T
1-PB2,2167,195,0,0,0,195,A
1-PB2,2168,195,0,0,0,195,A
1-PB2,2169,0,194,0,0,194,T
1-PB2,2170,0,0,197,0,197,G
1-PB2,2171,0,190,0,0,190,T
1-PB2,2172,0,0,188,0,188,G
1-PB2,2173,0,0,0,187,187,C
1-PB2,2174,0,187,0,0,187,T
1-PB2,2175,187,0,0,0,187,A
1-PB2,2176,188,0,0,0,188,A
1-PB2,2177,0,186,0,0,186,T
1-PB2,2178,0,0,0,188,188,C
1-PB2,2179,0,0,183,0,183,G
1-PB2,2180,0,0,181,0,181,G
1-PB2,2181,1,0,179,1,181,G
1-PB2,2182,0,0,0,182,182,C
1-PB2,2183,182,0,0,0,182,A
1-PB2,2184,181,0,0,0,181,A
1-PB2,2185,0,0,183,0,183,G
1-PB2,2186,0,0,183,0,183,G
1-PB2,2187,183,0,0,0,183,A
1-PB2,2188,0,0,178,0,178,G
1-PB2,2189,171,0,0,0,171,A
1-PB2,2190,0,0,0,171,171,C
1-PB2,2191,0,0,173,0,173,G
1-PB2,2192,0,172,0,0,172,T
1-PB2,2193,1,0,171,0,172,G
1-PB2,2194,0,0,174,0,174,G
1-PB2,2195,0,168,0,0,168,T
1-PB2,2196,0,0,168,0,168,G
1-PB2,2197,0,167,0,0,167,T
1-PB2,2198,0,167,0,0,167,T
1-PB2,2199,0,0,167,0,167,G
1-PB2,2200,0,0,166,0,166,G
1-PB2,2201,0,166,0,0,166,T
1-PB2,2202,166,0,0,0,166,A
1-PB2,2203,157,0,0,0,157,A
1-PB2,2204,0,156,0,0,156,T
1-PB2,2205,0,1,153,0,154,G
1-PB2,2206,154,0,0,0,154,A
1-PB2,2207,154,0,0,0,154,A
1-PB2,2208,154,0,0,0,154,A
1-PB2,2209,0,0,0,153,153,C
1-PB2,2210,0,0,153,0,153,G
1-PB2,2211,151,1,0,0,152,A
1-PB2,2212,153,0,0,0,153,A
1-PB2,2213,154,0,0,0,154,A
1-PB2,2214,153,0,1,0,154,A
1-PB2,2215,0,0,0,154,154,C
1-PB2,2216,0,0,152,0,152,G
1-PB2,2217,0,0,148,0,148,G
1-PB2,2218,0,0,151,0,151,G
1-PB2,2219,149,0,0,0,149,A
1-PB2,2220,0,0,0,150,150,C
1-PB2,2221,0,148,0,0,148,T
1-PB2,2222,0,0,0,150,150,C
1-PB2,2223,0,150,0,0,150,T
1-PB2,2224,148,0,1,0,149,A
1-PB2,2225,0,0,149,0,149,G
1-PB2,2226,0,0,0,149,149,C
1-PB2,2227,149,0,0,0,149,A
1-PB2,2228,0,149,0,0,149,T
1-PB2,2229,144,0,0,0,144,A
1-PB2,2230,0,0,0,144,144,C
1-PB2,2231,0,127,0,0,127,T
1-PB2,2232,0,126,0,0,126,T
1-PB2,2233,124,0,0,0,124,A
1-PB2,2234,0,0,0,124,124,C
1-PB2,2235,0,120,0,0,120,T
1-PB2,2236,0,0,120,0,120,G
1-PB2,2237,113,0,1,0,114,A
1-PB2,2238,0,0,0,114,114,C
1-PB2,2239,109,0,0,0,109,A
1-PB2,2240,0,0,110,0,110,G
1-PB2,2241,0,0,0,110,110,C
1-PB2,2242,0,0,0,110,110,C
1-PB2,2243,108,0,0,0,108,A
1-PB2,2244,0,0,108,0,108,G
1-PB2,2245,106,0,0,0,106,A
1-PB2,2246,0,0,0,106,106,C
1-PB2,2247,100,0,0,0,100,A
1-PB2,2248,0,0,101,0,101,G
1-PB2,2249,0,0,0,98,98,C
1-PB2,2250,0,0,97,0,97,G
1-PB2,2251,97,0,0,0,97,A
1-PB2,2252,0,0,0,97,97,C
1-PB2,2253,0,0,0,94,94,C
1-PB2,2254,94,0,0,0,94,A
1-PB2,2255,94,0,0,0,94,A
1-PB2,2256,94,0,0,0,94,A
1-PB2,2257,93,0,0,0,93,A
1-PB2,2258,0,0,93,0,93,G
1-PB2,2259,94,0,0,0,94,A
1-PB2,2260,94,0,0,0,94,A
1-PB2,2261,0,94,0,0,94,T
1-PB2,2262,0,94,0,0,94,T
1-PB2,2263,0,0,0,94,94,C
1-PB2,2264,0,0,90,0,90,G
1-PB2,2265,0,0,90,0,90,G
1-PB2,2266,90,0,0,0,90,A
1-PB2,2267,0,83,0,0,83,T
1-PB2,2268,0,0,83,0,83,G
1-PB2,2269,0,0,82,0,82,G
1-PB2,2270,0,0,0,82,82,C
1-PB2,2271,0,0,0,81,81,C
1-PB2,2272,80,0,0,0,80,A
1-PB2,2273,0,80,0,0,80,T
1-PB2,2274,0,0,0,78,78,C
1-PB2,2275,78,0,0,0,78,A
1-PB2,2276,78,0,0,0,78,A
1-PB2,2277,0,78,0,0,78,T
1-PB2,2278,0,70,0,0,70,T
1-PB2,2279,66,0,0,0,66,A
1-PB2,2280,66,0,0,0,66,A
2-PB1,1,114,0,0,0,114,A
2-PB1,2,0,114,0,0,114,T
2-PB1,3,0,0,115,0,115,G
2-PB1,4,0,0,121,0,121,G
2-PB1,5,132,0,0,0,132,A
2-PB1,6,0,140,0,0,140,T
2-PB1,7,0,0,142,0,142,G
2-PB1,8,0,141,0,1,142,T
2-PB1,9,0,0,0,154,154,C
2-PB1,10,156,0,0,0,156,A
2-PB1,11,162,0,0,0,162,A
2-PB1,12,0,163,0,0,163,T
2-PB1,13,0,0,0,164,164,C
2-PB1,14,0,0,0,171,171,C
2-PB1,15,0,0,170,0,170,G
2-PB1,16,188,0,0,0,188,A
2-PB1,17,0,0,0,192,192,C
2-PB1,18,0,191,0,1,192,T
2-PB1,19,0,0,0,229,229,C
2-PB1,20,0,229,0,0,229,T
2-PB1,21,234,0,0,0,234,A
2-PB1,22,0,0,0,233,233,C
2-PB1,23,0,234,0,0,234,T
2-PB1,24,0,0,260,0,260,G
2-PB1,25,0,263,0,0,263,T
2-PB1,26,0,263,0,0,263,T
2-PB1,27,0,0,0,261,261,C
2-PB1,28,0,0,0,262,262,C
2-PB1,29,0,307,0,0,307,T
2-PB1,30,310,0,0,0,310,A
2-PB1,31,309,0,0,0,309,A
2-PB1,32,310,0,0,0,310,A
2-PB1,33,0,0,311,0,311,G
2-PB1,34,0,0,314,0,314,G
2-PB1,35,0,318,0,0,318,T
2-PB1,36,0,318,0,0,318,T
2-PB1,37,0,0,0,318,318,C
2-PB1,38,0,0,0,319,319,C
2-PB1,39,316,0,0,0,316,A
2-PB1,40,0,0,320,0,320,G
2-PB1,41,0,1,0,321,322,C
2-PB1,42,0,0,325,0,325,G
2-PB1,43,0,0,0,326,326,C
2-PB1,44,326,0,0,0,326,A
2-PB1,45,326,0,0,0,326,A
2-PB1,46,326,0,0,0,326,A
2-PB1,47,333,0,0,0,333,A
2-PB1,48,0,332,0,0,332,T
2-PB1,49,0,0,362,0,362,G
2-PB1,50,0,1,0,363,364,C
2-PB1,51,0,0,0,366,366,C
2-PB1,52,366,0,0,0,366,A
2-PB1,53,0,367,0,0,367,T
2-PB1,54,385,0,0,0,385,A
2-PB1,55,386,0,1,0,387,A
2-PB1,56,0,0,410,1,411,G
2-PB1,57,0,1,0,411,412,C
2-PB1,58,411,1,1,0,413,A
2-PB1,59,0,0,0,432,432,C
2-PB1,60,430,0,1,0,431,A
2-PB1,61,453,0,0,0,453,A
2-PB1,62,0,0,0,455,455,C
2-PB1,63,459,0,0,0,459,A
2-PB1,64,0,466,0,0,466,T
2-PB1,65,0,465,0,0,465,T
2-PB1,66,0,0,0,582,582,C
2-PB1,67,0,0,0,584,584,C
2-PB1,68,0,0,0,587,587,C
2-PB1,69,0,596,0,2,598,T
2-PB1,70,0,598,0,0,598,T
2-PB1,71,639,0,0,0,639,A
2-PB1,72,0,646,0,0,646,T
2-PB1,73,650,0,0,0,650,A
2-PB1,74,0,0,0,654,654,C
2-PB1,75,0,641,0,0,641,T
2-PB1,76,1,1,649,0,651,G
2-PB1,77,0,0,654,0,654,G
2-PB1,78,649,0,0,0,649,A
2-PB1,79,0,1,651,0,652,G
2-PB1,80,655,0,0,0,655,A
2-PB1,81,0,654,0,1,655,T
2-PB1,82,1,0,0,689,690,C
2-PB1,83,0,0,0,692,692,C
2-PB1,84,0,693,0,0,693,T
2-PB1,85,0,0,1,737,738,C
2-PB1,86,0,0,0,743,743,C
2-PB1,87,746,0,0,1,747,A
2-PB1,88,0,746,0,0,746,T
2-PB1,89,746,0,0,0,746,A
2-PB1,90,0,0,0,749,749,C
2-PB1,91,738,0,0,0,738,A
2-PB1,92,2,0,765,0,767,G
2-PB1,93,0,0,0,773,773,C
2-PB1,94,1,0,0,770,771,C
2-PB1,95,772,0,0,0,772,A
2-PB1,96,0,775,0,0,775,T
2-PB1,97,1,0,775,0,776,G
2-PB1,98,0,1,813,0,814,G
2-PB1,99,817,0,1,0,818,A
2-PB1,100,820,0,0,0,820,A
2-PB1,101,1,0,0,824,825,C
2-PB1,102,816,0,2,0,818,A
2-PB1,103,0,0,836,0,836,G
2-PB1,104,0,0,849,0,849,G
2-PB1,105,851,0,0,0,851,A
2-PB1,106,855,0,0,0,855,A
2-PB1,107,0,0,0,861,861,C
2-PB1,108,862,0,0,0,862,A
2-PB1,109,0,0,952,0,952,G
2-PB1,110,0,2,951,0,953,G
2-PB1,111,0,0,969,0,969,G
2-PB1,112,0,969,0,0,969,T
2-PB1,113,965,0,0,0,965,A
2-PB1,114,0,0,0,975,975,C
2-PB1,115,1005,0,1,0,1006,A
2-PB1,116,0,0,0,1042,1042,C
2-PB1,117,0,1,0,1037,1038,C
2-PB1,118,1010,0,2,0,1012,A
2-PB1,119,0,1015,0,0,1015,T
2-PB1,120,0,1,1018,0,1019,G
2-PB1,121,1,2,1020,0,1023,G
2-PB1,122,1024,0,1,0,1025,A
2-PB1,123,0,1,0,1024,1025,C
2-PB1,124,1011,0,0,0,1011,A
2-PB1,125,0,1,0,1033,1034,C
2-PB1,126,1033,0,0,0,1033,A
2-PB1,127,1,0,1047,0,1048,G
2-PB1,128,0,1044,0,0,1044,T
2-PB1,129,0,0,0,1078,1078,C
2-PB1,130,1077,0,1,0,1078,A
2-PB1,131,1089,1,2,0,1092,A
2-PB1,132,0,0,0,1092,1092,C
2-PB1,133,1090,0,0,0,1090,A
2-PB1,134,0,1,1099,0,1100,G
2-PB1,135,1094,0,1,0,1095,A
2-PB1,136,1092,0,2,1,1095,A
2-PB1,137,0,1,0,1098,1099,C
2-PB1,138,1084,0,1,0,1085,A
2-PB1,139,0,0,0,1083,1083,C
2-PB1,140,1082,0,0,0,1082,A
2-PB1,141,0,1073,0,1,1074,T
2-PB1,142,1,1,0,1165,1167,C
2-PB1,143,1168,1,2,0,1171,A
2-PB1,144,1181,1,0,0,1182,A
2-PB1,145,0,1199,0,0,1199,T
2-PB1,146,1230,0,0,0,1230,A
2-PB1,147,0,1233,0,0,1233,T
2-PB1,148,0,1214,0,1,1215,T
2-PB1,149,0,0,0,1217,1217,C
2-PB1,150,1199,0,1,0,1200,A
2-PB1,151,0,0,1198,1,1199,G
2-PB1,152,1196,0,1,0,1197,A
2-PB1,153,0,2,1195,0,1197,G
2-PB1,154,1181,0,2,0,1183,A
2-PB1,155,0,0,1171,0,1171,G
2-PB1,156,0,0,1172,0,1172,G
2-PB1,157,0,1,1204,0,1205,G
2-PB1,158,2,0,1197,1,1200,G
2-PB1,159,0,0,1204,0,1204,G
2-PB1,160,1206,0,0,0,1206,A
2-PB1,161,1207,0,2,0,1209,A
2-PB1,162,0,0,1221,0,1221,G
2-PB1,163,0,1214,0,0,1214,T
2-PB1,164,0,0,1216,0,1216,G
2-PB1,165,0,1,1215,0,1216,G
2-PB1,166,1211,1,1,0,1213,A
2-PB1,167,0,1,0,1217,1218,C
2-PB1,168,0,0,1221,0,1221,G
2-PB1,169,1229,0,0,0,1229,A
2-PB1,170,0,1,0,1238,1239,C
2-PB1,171,1234,0,0,0,1234,A
2-PB1,172,1234,0,0,0,1234,A
2-PB1,173,1240,0,1,0,1241,A
2-PB1,174,0,1263,0,0,1263,T
2-PB1,175,1263,0,0,0,1263,A
2-PB1,176,0,0,1,1264,1265,C
2-PB1,177,1254,0,0,0,1254,A
2-PB1,178,0,1,1257,0,1258,G
2-PB1,179,1252,0,0,0,1252,A
2-PB1,180,1260,1,0,0,1261,A
2-PB1,181,1261,0,0,0,1261,A
2-PB1,182,0,0,0,1269,1269,C
2-PB1,183,0,1260,0,0,1260,T
2-PB1,184,0,0,1261,0,1261,G
2-PB1,185,0,2,1255,1,1258,G
2-PB1,186,0,3,1251,0,1254,G
2-PB1,187,2,0,1257,0,1259,G
2-PB1,188,0,0,0,1254,1254,C
2-PB1,189,1256,0,0,0,1256,A
2-PB1,190,2,0,0,1298,1300,C
2-PB1,191,0,0,0,1290,1290,C
2-PB1,192,2,0,0,1292,1294,C
2-PB1,193,1,0,0,1294,1295,C
2-PB1,194,1294,0,1,0,1295,A
2-PB1,195,1307,0,0,0,1307,A
2-PB1,196,0,0,0,1310,1310,C
2-PB1,197,1,1302,1,0,1304,T
2-PB1,198,0,0,0,1315,1315,C
2-PB1,199,1282,0,0,0,1282,A
2-PB1,200,1300,0,1,0,1301,A
2-PB1,201,0,0,0,1304,1304,C
2-PB1,202,2,1,0,1299,1302,C
2-PB1,203,1,0,0,1302,1303,C
2-PB1,204,1299,0,2,0,1301,A
2-PB1,205,1303,0,0,0,1303,A
2-PB1,206,0,1305,0,0,1305,T
2-PB1,207,0,1305,0,1,1306,T
2-PB1,208,1,0,1305,0,1306,G
2-PB1,209,1299,0,1,0,1300,A
2-PB1,210,0,1294,0,3,1297,T
2-PB1,211,1,2,1297,0,1300,G
2-PB1,212,0,0,1318,0,1318,G
2-PB1,213,1325,0,1,0,1326,A
2-PB1,214,0,1,0,1338,1339,C
2-PB1,215,0,0,0,1334,1334,C
2-PB1,216,1333,0,0,0,1333,A
2-PB1,217,0,0,0,1355,1355,C
2-PB1,218,0,1356,0,0,1356,T
2-PB1,219,1360,2,0,0,1362,A
2-PB1,220,0,0,0,1374,1374,C
2-PB1,221,0,1,0,1367,1368,C
2-PB1,222,0,1348,0,0,1348,T
2-PB1,223,1,0,1355,0,1356,G
2-PB1,224,1353,0,0,0,1353,A
2-PB1,225,0,3,1362,0,1365,G
2-PB1,226,0,0,1356,0,1356,G
2-PB1,227,1357,1,0,1,1359,A
2-PB1,228,0,1352,0,0,1352,T
2-PB1,229,1328,0,1,1,1330,A
2-PB1,230,1333,1,0,0,1334,A
2-PB1,231,0,1334,0,0,1334,T
2-PB1,232,0,0,1333,0,1333,G
2-PB1,233,1337,0,0,1,1338,A
2-PB1,234,1323,0,3,0,1326,A
2-PB1,235,0,0,0,1327,1327,C
2-PB1,236,0,1,0,1308,1309,C
2-PB1,237,1306,0,0,0,1306,A
2-PB1,238,1311,0,1,0,1312,A
2-PB1,239,0,0,1315,0,1315,G
2-PB1,240,0,1314,0,1,1315,T
2-PB1,241,0,1,1315,0,1316,G
2-PB1,242,0,0,1337,0,1337,G
2-PB1,243,1334,0,1,0,1335,A
2-PB1,244,0,1330,0,0,1330,T
2-PB1,245,1332,0,2,0,1334,A
2-PB1,246,0,1371,0,0,1371,T
2-PB1,247,1,0,1376,0,1377,G
2-PB1,248,0,2,0,1381,1383,C
2-PB1,249,1378,1,2,0,1381,A
2-PB1,250,0,0,0,1427,1427,C
2-PB1,251,1399,0,0,0,1399,A
2-PB1,252,1418,0,1,0,1419,A
2-PB1,253,1419,0,1,0,1420,A
2-PB1,254,0,1,0,1420,1421,C
2-PB1,255,1394,1,0,0,1395,A
2-PB1,256,0,2,1410,0,1412,G
2-PB1,257,1407,0,2,0,1409,A
2-PB1,258,0,1,0,1410,1411,C
2-PB1,259,0,1373,1,1,1375,T
2-PB1,260,0,0,1396,0,1396,G
2-PB1,261,0,1376,0,1,1377,T
2-PB1,262,0,1,1430,0,1431,G
2-PB1,263,0,1426,1,1,1428,T
2-PB1,264,3,1,1,1424,1429,C
2-PB1,265,0,0,0,1426,1426,C
2-PB1,266,0,1420,0,0,1420,T
2-PB1,267,0,1,1412,0,1413,G
2-PB1,268,0,2,1415,0,1417,G
2-PB1,269,1393,0,0,1,1394,A
2-PB1,270,0,0,1418,0,1418,G
2-PB1,271,0,1,1384,0,1385,G
2-PB1,272,0,0,0,1394,1394,C
2-PB1,273,2,1379,0,1,1382,T
2-PB1,274,1387,0,0,0,1387,A
2-PB1,275,0,1383,0,2,1385,T
2-PB1,276,0,1,1383,0,1384,G
2-PB1,277,1,0,1383,0,1384,G
2-PB1,278,0,2,0,1382,1384,C
2-PB1,279,0,1,0,1374,1375,C
2-PB1,280,0,1365,0,0,1365,T
2-PB1,281,0,1420,0,0,1420,T
2-PB1,282,0,0,0,1423,1423,C
2-PB1,283,1,0,0,1420,1421,C
2-PB1,284,0,1420,0,2,1422,T
2-PB1,285,0,1423,0,1,1424,T
2-PB1,286,0,0,1433,0,1433,G
2-PB1,287,1428,2,2,1,1433,A
2-PB1,288,1429,0,2,1,1432,A
2-PB1,289,0,0,1432,0,1432,G
2-PB1,290,1382,0,1,1,1384,A
2-PB1,291,1395,0,0,1,1396,A
2-PB1,292,0,1396,0,0,1396,T
2-PB1,293,0,1,0,1393,1394,C
2-PB1,294,0,0,0,1391,1391,C
2-PB1,295,2,0,0,1376,1378,C
2-PB1,296,1381,0,2,0,1383,A
2-PB1,297,0,1,0,1385,1386,C
2-PB1,298,2,1,0,1382,1385,C
2-PB1,299,1,0,0,1386,1387,C
2-PB1,300,1374,0,2,0,1376,A
2-PB1,301,0,0,1381,0,1381,G
2-PB1,302,0,0,1392,0,1392,G
2-PB1,303,0,1386,0,0,1386,T
2-PB1,304,1409,1,1,1,1412,A
2-PB1,305,0,1406,0,0,1406,T
2-PB1,306,1,1,0,1404,1406,C
2-PB1,307,0,1411,0,2,1413,T
2-PB1,308,0,1409,0,1,1410,T
2-PB1,309,1,1405,0,0,1406,T
2-PB1,310,1,2,1401,0,1404,G
2-PB1,311,1386,0,1,0,1387,A
2-PB1,312,0,2,1389,0,1391,G
2-PB1,313,1377,0,1,0,1378,A
2-PB1,314,1381,1,0,0,1382,A
2-PB1,315,0,0,0,1394,1394,C
2-PB1,316,0,1379,0,1,1380,T
2-PB1,317,2,0,0,1385,1387,C
2-PB1,318,1385,0,0,0,1385,A
2-PB1,319,0,1388,0,0,1388,T
2-PB1,320,0,1,1391,0,1392,G
2-PB1,321,0,0,0,1409,1409,C
2-PB1,322,1,0,0,1415,1416,C
2-PB1,323,0,1402,0,2,1404,T
2-PB1,324,0,1396,0,0,1396,T
2-PB1,325,0,0,1400,0,1400,G
2-PB1,326,1405,0,0,0,1405,A
2-PB1,327,1410,0,1,0,1411,A
2-PB1,328,1404,1,1,0,1406,A
2-PB1,329,0,0,0,1416,1416,C
2-PB1,330,1385,0,1,0,1386,A
2-PB1,331,1392,1,0,0,1393,A
2-PB1,332,0,1394,0,0,1394,T
2-PB1,333,1,0,1391,0,1392,G
2-PB1,334,0,1,1390,0,1391,G
2-PB1,335,1376,0,1,0,1377,A
2-PB1,336,1370,0,2,0,1372,A
2-PB1,337,0,0,1375,0,1375,G
2-PB1,338,0,0,0,1377,1377,C
2-PB1,339,1,0,0,1362,1363,C
2-PB1,340,1,0,1382,0,1383,G
2-PB1,341,1,1371,0,2,1374,T
2-PB1,342,0,1382,0,0,1382,T
2-PB1,343,1,0,0,1390,1391,C
2-PB1,344,1395,0,1,0,1396,A
2-PB1,345,1407,0,2,0,1409,A
2-PB1,346,0,2,0,1407,1409,C
2-PB1,347,1416,0,0,0,1416,A
2-PB1,348,0,0,1423,0,1423,G
2-PB1,349,1395,2,1,0,1398,A
2-PB1,350,0,0,0,1396,1396,C
2-PB1,351,1396,0,0,0,1396,A
2-PB1,352,1405,0,2,0,1407,A
2-PB1,353,0,2,1416,0,1418,G
2-PB1,354,1,0,1407,0,1408,G
2-PB1,355,0,0,1408,0,1408,G
2-PB1,356,0,1393,0,0,1393,T
2-PB1,357,0,1,1391,0,1392,G
2-PB1,358,1,1,1385,0,1387,G
2-PB1,359,1388,0,5,0,1393,A
2-PB1,360,0,0,0,1397,1397,C
2-PB1,361,1372,1,0,0,1373,A
2-PB1,362,1399,0,0,0,1399,A
2-PB1,363,1396,0,0,0,1396,A
2-PB1,364,0,0,0,1399,1399,C
2-PB1,365,0,1396,0,0,1396,T
2-PB1,366,1400,0,1,0,1401,A
2-PB1,367,1407,0,1,0,1408,A
2-PB1,368,0,0,0,1412,1412,C
2-PB1,369,1,0,0,1405,1406,C
2-PB1,370,0,1,0,1405,1406,C
2-PB1,371,1375,0,1,0,1376,A
2-PB1,372,1372,0,0,0,1372,A
2-PB1,373,0,0,1376,0,1376,G
2-PB1,374,0,0,1376,0,1376,G
2-PB1,375,0,1372,0,1,1373,T
2-PB1,376,1,2,0,1361,1364,C
2-PB1,377,1,1,1363,0,1365,G
2-PB1,378,0,0,0,1361,1361,C
2-PB1,379,0,0,0,1368,1368,C
2-PB1,380,1368,0,0,0,1368,A
2-PB1,381,0,0,1388,0,1388,G
2-PB1,382,1409,0,0,0,1409,A
2-PB1,383,0,1,0,1409,1410,C
2-PB1,384,0,1401,0,1,1402,T
2-PB1,385,1,1397,0,0,1398,T
2-PB1,386,1399,0,0,0,1399,A
2-PB1,387,0,1404,0,1,1405,T
2-PB1,388,0,0,1405,0,1405,G
2-PB1,389,1402,0,0,0,1402,A
2-PB1,390,0,1378,0,0,1378,T
2-PB1,391,0,1336,0,0,1336,T
2-PB1,392,0,0,1336,0,1336,G
2-PB1,393,0,0,1335,0,1335,G
2-PB1,394,1339,0,0,0,1339,A
2-PB1,395,0,0,0,1338,1338,C
2-PB1,396,1327,0,0,0,1327,A
2-PB1,397,0,1321,0,1,1322,T
2-PB1,398,0,1337,0,0,1337,T
2-PB1,399,1341,0,3,0,1344,A
2-PB1,400,1343,0,1,0,1344,A
2-PB1,401,1341,1,2,0,1344,A
2-PB1,402,0,0,0,1346,1346,C
2-PB1,403,1302,0,1,0,1303,A
2-PB1,404,0,1,1305,0,1306,G
2-PB1,405,1303,0,1,0,1304,A
2-PB1,406,1307,0,1,0,1308,A
2-PB1,407,1308,0,0,0,1308,A
2-PB1,408,1,1297,0,0,1298,T
2-PB1,409,0,0,0,1301,1301,C
2-PB1,410,1299,0,0,0,1299,A
2-PB1,411,1301,0,2,0,1303,A
2-PB1,412,0,0,0,1296,1296,C
2-PB1,413,1,0,0,1287,1288,C
2-PB1,414,2,0,1286,0,1288,G
2-PB1,415,1,0,1284,0,1285,G
2-PB1,416,0,0,0,1291,1291,C
2-PB1,417,1289,0,1,0,1290,A
2-PB1,418,0,0,1288,0,1288,G
2-PB1,419,0,0,0,1296,1296,C
2-PB1,420,1294,1,2,0,1297,A
2-PB1,421,1303,0,0,0,1303,A
2-PB1,422,0,0,0,1305,1305,C
2-PB1,423,0,1305,0,0,1305,T
2-PB1,424,2,0,1342,0,1344,G
2-PB1,425,0,0,0,1341,1341,C
2-PB1,426,1335,1,1,0,1337,A
2-PB1,427,0,1332,0,0,1332,T
2-PB1,428,0,1330,1,0,1331,T
2-PB1,429,1383,1,2,0,1386,A
2-PB1,430,0,0,1381,0,1381,G
2-PB1,431,0,0,0,1378,1378,C
2-PB1,432,1,0,0,1379,1380,C
2-PB1,433,1335,0,0,0,1335,A
2-PB1,434,1344,0,0,0,1344,A
2-PB1,435,0,1,0,1352,1353,C
2-PB1,436,1353,0,0,0,1353,A
2-PB1,437,1,0,0,1402,1403,C
2-PB1,438,0,1,0,1305,1306,C
2-PB1,439,1305,0,0,0,1305,A
2-PB1,440,2,1299,0,2,1303,T
2-PB1,441,1305,0,0,0,1305,A
2-PB1,442,0,0,1307,0,1307,G
2-PB1,443,1292,0,1,1,1294,A
2-PB1,444,1274,1,2,0,1277,A
2-PB1,445,0,1,1286,0,1287,G
2-PB1,446,0,1228,0,1,1229,T
2-PB1,447,0,1228,0,0,1228,T
2-PB1,448,0,1220,0,1,1221,T
2-PB1,449,0,1227,0,0,1227,T
2-PB1,450,0,1229,0,0,1229,T
2-PB1,451,1230,1,0,0,1231,A
2-PB1,452,0,0,1234,0,1234,G
2-PB1,453,1224,0,1,0,1225,A
2-PB1,454,0,1220,0,0,1220,T
2-PB1,455,1,0,0,1203,1204,C
2-PB1,456,0,2,1204,0,1206,G
2-PB1,457,1208,0,0,0,1208,A
2-PB1,458,1207,0,0,0,1207,A
2-PB1,459,0,1,0,1210,1211,C
2-PB1,460,0,0,1215,0,1215,G
2-PB1,461,0,0,1266,0,1266,G
2-PB1,462,1266,0,0,0,1266,A
2-PB1,463,0,1261,0,0,1261,T
2-PB1,464,0,1265,0,1,1266,T
2-PB1,465,1264,0,4,0,1268,A
2-PB1,466,1265,0,0,0,1265,A
2-PB1,467,0,1,0,1269,1270,C
2-PB1,468,1268,0,0,0,1268,A
2-PB1,469,1,0,1271,0,1272,G
2-PB1,470,0,0,0,1218,1218,C
2-PB1,471,0,1218,0,1,1219,T
2-PB1,472,1217,0,0,0,1217,A
2-PB1,473,1214,0,2,0,1216,A
2-PB1,474,0,1217,0,0,1217,T
2-PB1,475,1,2,1218,1,1222,G
2-PB1,476,1207,1,1,0,1209,A
2-PB1,477,1212,0,0,0,1212,A
2-PB1,478,1,1182,0,0,1183,T
2-PB1,479,1,0,0,1184,1185,C
2-PB1,480,1176,0,1,0,1177,A
2-PB1,481,0,1,1176,0,1177,G
2-PB1,482,1,0,1175,0,1176,G
2-PB1,483,1172,0,2,0,1174,A
2-PB1,484,1158,0,0,0,1158,A
2-PB1,485,1,0,1220,0,1221,G
2-PB1,486,1,0,1218,0,1219,G
2-PB1,487,0,0,0,1218,1218,C
2-PB1,488,0,1216,0,1,1217,T
2-PB1,489,1215,0,1,0,1216,A
2-PB1,490,1214,0,0,0,1214,A
2-PB1,491,0,1215,0,0,1215,T
2-PB1,492,1216,0,1,0,1217,A
2-PB1,493,1,0,1218,0,1219,G
2-PB1,494,1128,0,0,0,1128,A
2-PB1,495,0,1118,0,1,1119,T
2-PB1,496,0,1120,0,1,1121,T
2-PB1,497,0,1115,0,1,1116,T
2-PB1,498,0,0,0,1160,1160,C
2-PB1,499,2,1,0,1155,1158,C
2-PB1,500,0,1154,0,1,1155,T
2-PB1,501,0,0,0,1153,1153,C
2-PB1,502,1155,0,0,0,1155,A
2-PB1,503,1158,0,0,0,1158,A
2-PB1,504,0,3,1160,0,1163,G
2-PB1,505,0,0,1171,0,1171,G
2-PB1,506,1169,1,0,0,1170,A
2-PB1,507,0,1131,0,0,1131,T
2-PB1,508,0,0,1138,0,1138,G
2-PB1,509,1,1132,0,0,1133,T
2-PB1,510,0,1,1148,0,1149,G
2-PB1,511,1148,1,1,0,1150,A
2-PB1,512,0,1147,0,1,1148,T
2-PB1,513,0,0,1145,0,1145,G
2-PB1,514,0,2,1139,0,1141,G
2-PB1,515,1141,0,1,0,1142,A
2-PB1,516,1142,0,0,0,1142,A
2-PB1,517,0,1134,0,0,1134,T
2-PB1,518,0,1,0,1135,1136,C
2-PB1,519,1122,2,0,0,1124,A
2-PB1,520,1125,0,0,0,1125,A
2-PB1,521,0,1124,0,0,1124,T
2-PB1,522,0,0,1137,0,1137,G
2-PB1,523,0,2,1138,0,1140,G
2-PB1,524,1136,1,0,0,1137,A
2-PB1,525,0,1137,0,1,1138,T
2-PB1,526,1140,0,0,0,1140,A
2-PB1,527,1140,0,0,0,1140,A
2-PB1,528,1135,0,0,0,1135,A
2-PB1,529,0,0,1148,0,1148,G
2-PB1,530,1144,0,1,0,1145,A
2-PB1,531,0,1,1128,0,1129,G
2-PB1,532,0,0,1119,0,1119,G
2-PB1,533,1113,0,1,0,1114,A
2-PB1,534,1114,0,0,0,1114,A
2-PB1,535,1116,0,2,0,1118,A
2-PB1,536,0,1113,0,1,1114,T
2-PB1,537,0,2,1132,0,1134,G
2-PB1,538,0,0,1132,0,1132,G
2-PB1,539,1119,0,0,0,1119,A
2-PB1,540,0,1,1127,0,1128,G
2-PB1,541,1111,1,1,0,1113,A
2-PB1,542,0,1134,0,0,1134,T
2-PB1,543,1135,0,0,0,1135,A
2-PB1,544,1149,0,0,0,1149,A
2-PB1,545,2,1,0,1146,1149,C
2-PB1,546,1122,0,0,0,1122,A
2-PB1,547,1119,0,2,0,1121,A
2-PB1,548,1,0,0,1117,1118,C
2-PB1,549,1109,0,1,0,1110,A
2-PB1,550,0,0,0,1112,1112,C
2-PB1,551,1088,2,0,0,1090,A
2-PB1,552,0,0,0,1101,1101,C
2-PB1,553,0,1086,0,2,1088,T
2-PB1,554,0,1090,0,0,1090,T
2-PB1,555,0,1088,0,1,1089,T
2-PB1,556,0,0,0,1089,1089,C
2-PB1,557,1090,0,0,0,1090,A
2-PB1,558,1092,0,0,0,1092,A
2-PB1,559,1091,0,1,0,1092,A
2-PB1,560,0,0,1106,0,1106,G
2-PB1,561,1089,1,4,0,1094,A
2-PB1,562,1093,0,0,0,1093,A
2-PB1,563,1099,0,0,0,1099,A
2-PB1,564,1097,0,0,0,1097,A
2-PB1,565,1097,0,1,0,1098,A
2-PB1,566,0,0,1104,0,1104,G
2-PB1,567,0,0,1104,1,1105,G
2-PB1,568,1091,0,2,0,1093,A
2-PB1,569,0,0,1114,0,1114,G
2-PB1,570,1108,0,0,0,1108,A
2-PB1,571,0,0,1133,0,1133,G
2-PB1,572,0,1133,0,0,1133,T
2-PB1,573,1129,0,1,0,1130,A
2-PB1,574,1129,0,2,0,1131,A
2-PB1,575,0,0,1135,0,1135,G
2-PB1,576,0,1,1139,0,1140,G
2-PB1,577,0,0,1145,0,1145,G
2-PB1,578,1116,0,2,0,1118,A
2-PB1,579,0,1,0,1119,1120,C
2-PB1,580,1085,0,0,0,1085,A
2-PB1,581,1088,1,1,0,1090,A
2-PB1,582,0,0,0,1086,1086,C
2-PB1,583,1085,0,1,0,1086,A
2-PB1,584,0,1073,0,0,1073,T
2-PB1,585,2,3,1066,0,1071,G
2-PB1,586,1072,1,1,0,1074,A
2-PB1,587,0,1,0,1072,1073,C
2-PB1,588,1,0,0,1064,1065,C
2-PB1,589,1071,0,1,0,1072,A
2-PB1,590,1078,0,0,0,1078,A
2-PB1,591,0,0,1086,0,1086,G
2-PB1,592,1086,0,0,0,1086,A
2-PB1,593,1086,1,0,0,1087,A
2-PB1,594,1077,1,1,0,1079,A
2-PB1,595,1074,0,1,0,1075,A
2-PB1,596,0,1078,0,2,1080,T
2-PB1,597,0,1,1083,0,1084,G
2-PB1,598,1,0,1084,0,1085,G
2-PB1,599,0,1075,0,2,1077,T
2-PB1,600,1,0,0,1076,1077,C
2-PB1,601,1082,0,0,0,1082,A
2-PB1,602,0,0,0,1124,1124,C
2-PB1,603,1139,0,0,0,1139,A
2-PB1,604,0,0,0,1145,1145,C
2-PB1,605,1140,0,0,0,1140,A
2-PB1,606,1172,0,0,0,1172,A
2-PB1,607,1164,0,0,0,1164,A
2-PB1,608,0,1,1181,0,1182,G
2-PB1,609,58,1,1067,0,1126,G
2-PB1,610,1168,1,0,0,1169,A
2-PB1,611,0,0,0,1188,1188,C
2-PB1,612,1191,0,1,0,1192,A
2-PB1,613,1196,0,0,0,1196,A
2-PB1,614,0,1191,0,1,1192,T
2-PB1,615,1183,0,0,0,1183,A
2-PB1,616,0,2,1185,0,1187,G
2-PB1,617,1,1,1141,0,1143,G
2-PB1,618,2,0,1138,1,1141,G
2-PB1,619,1141,0,1,0,1142,A
2-PB1,620,1126,0,3,0,1129,A
2-PB1,621,0,0,1138,1,1139,G
2-PB1,622,1131,0,2,0,1133,A
2-PB1,623,1133,0,1,1,1135,A
2-PB1,624,1133,0,1,0,1134,A
2-PB1,625,1133,1,1,0,1135,A
2-PB1,626,1143,0,1,0,1144,A
2-PB1,627,1143,0,2,0,1145,A
2-PB1,628,0,0,0,1145,1145,C
2-PB1,629,1143,0,0,0,1143,A
2-PB1,630,1141,1,1,0,1143,A
2-PB1,631,1132,0,1,0,1133,A
2-PB1,632,1,1,1150,0,1152,G
2-PB1,633,1149,0,1,0,1150,A
2-PB1,634,0,0,1182,0,1182,G
2-PB1,635,0,1164,0,0,1164,T
2-PB1,636,0,1,1282,0,1283,G
2-PB1,637,1281,1,1,0,1283,A
2-PB1,638,1280,0,1,0,1281,A
2-PB1,639,0,1309,0,0,1309,T
2-PB1,640,1312,0,1,0,1313,A
2-PB1,641,1304,0,1,0,1305,A
2-PB1,642,0,0,1304,0,1304,G
2-PB1,643,1267,0,1,0,1268,A
2-PB1,644,0,0,1272,0,1272,G
2-PB1,645,1192,0,1,0,1193,A
2-PB1,646,0,0,1198,0,1198,G
2-PB1,647,0,1,1195,0,1196,G
2-PB1,648,0,0,0,1191,1191,C
2-PB1,649,0,1192,0,0,1192,T
2-PB1,650,1221,0,0,0,1221,A
2-PB1,651,0,1,0,1264,1265,C
2-PB1,652,1,1,0,1264,1266,C
2-PB1,653,0,1277,0,2,1279,T
2-PB1,654,1297,0,0,0,1297,A
2-PB1,655,1297,0,0,0,1297,A
2-PB1,656,0,1294,0,0,1294,T
2-PB1,657,1293,0,0,0,1293,A
2-PB1,658,1290,0,0,0,1290,A
2-PB1,659,0,0,1295,0,1295,G
2-PB1,660,1234,0,1,0,1235,A
2-PB1,661,0,0,1251,0,1251,G
2-PB1,662,0,0,0,1257,1257,C
2-PB1,663,0,1228,0,2,1230,T
2-PB1,664,1,1228,0,1,1230,T
2-PB1,665,0,1235,0,1,1236,T
2-PB1,666,0,1,1234,0,1235,G
2-PB1,667,1249,0,1,0,1250,A
2-PB1,668,0,0,0,1254,1254,C
2-PB1,669,1241,0,0,0,1241,A
2-PB1,670,1,1233,0,2,1236,T
2-PB1,671,0,1223,0,2,1225,T
2-PB1,672,0,2,1234,0,1236,G
2-PB1,673,1231,0,2,0,1233,A
2-PB1,674,1236,0,1,0,1237,A
2-PB1,675,0,0,0,1239,1239,C
2-PB1,676,1230,0,0,0,1230,A
2-PB1,677,0,2,0,1229,1231,C
2-PB1,678,0,0,1230,0,1230,G
2-PB1,679,1235,0,1,0,1236,A
2-PB1,680,0,1251,0,0,1251,T
2-PB1,681,0,1,1260,0,1261,G
2-PB1,682,1264,0,2,0,1266,A
2-PB1,683,0,0,0,1269,1269,C
2-PB1,684,3,0,0,1268,1271,C
2-PB1,685,1272,0,0,0,1272,A
2-PB1,686,1270,4,0,1,1275,A
2-PB1,687,1271,0,1,0,1272,A
2-PB1,688,0,0,1307,0,1307,G
2-PB1,689,1314,0,1,0,1315,A
2-PB1,690,0,1295,0,0,1295,T
2-PB1,691,1,0,1297,1,1299,G
2-PB1,692,0,0,0,1294,1294,C
2-PB1,693,1288,0,3,0,1291,A
2-PB1,694,0,0,1296,0,1296,G
2-PB1,695,1286,0,1,0,1287,A
2-PB1,696,1,1,1287,0,1289,G
2-PB1,697,1264,0,1,0,1265,A
2-PB1,698,1,0,1262,0,1263,G
2-PB1,699,1250,0,3,0,1253,A
2-PB1,700,0,1,1254,0,1255,G
2-PB1,701,0,1,1257,0,1258,G
2-PB1,702,2,2,0,1250,1254,C
2-PB1,703,1249,0,0,0,1249,A
2-PB1,704,1251,0,0,0,1251,A
2-PB1,705,1258,0,1,0,1259,A
2-PB1,706,0,1258,0,0,1258,T
2-PB1,707,0,1251,0,0,1251,T
2-PB1,708,1253,0,0,0,1253,A
2-PB1,709,1254,0,0,0,1254,A
2-PB1,710,1255,0,1,0,1256,A
2-PB1,711,1257,0,0,0,1257,A
2-PB1,712,1256,0,1,0,1257,A
2-PB1,713,1,0,1260,0,1261,G
2-PB1,714,1247,0,0,0,1247,A
2-PB1,715,1246,0,0,0,1246,A
2-PB1,716,0,0,1262,0,1262,G
2-PB1,717,1,0,1270,0,1271,G
2-PB1,718,0,0,1272,0,1272,G
2-PB1,719,1,0,0,1277,1278,C
2-PB1,720,0,1269,0,0,1269,T
2-PB1,721,1272,0,0,0,1272,A
2-PB1,722,0,1285,0,1,1286,T
2-PB1,723,0,1283,1,0,1284,T
2-PB1,724,1,0,1292,0,1293,G
2-PB1,725,0,0,0,1282,1282,C
2-PB1,726,1253,0,1,0,1254,A
2-PB1,727,1252,0,2,0,1254,A
2-PB1,728,0,1,0,1247,1248,C
2-PB1,729,1251,0,0,0,1251,A
2-PB1,730,0,0,0,1246,1246,C
2-PB1,731,1,2,0,1231,1234,C
2-PB1,732,0,1,0,1237,1238,C
2-PB1,733,1,1,1232,0,1234,G
2-PB1,734,1,0,1235,0,1236,G
2-PB1,735,0,0,1239,0,1239,G
2-PB1,736,1237,0,2,0,1239,A
2-PB1,737,0,1230,0,1,1231,T
2-PB1,738,0,0,1234,0,1234,G
2-PB1,739,1,1,0,1226,1228,C
2-PB1,740,1244,0,0,0,1244,A
2-PB1,741,1259,0,0,0,1259,A
2-PB1,742,1272,0,1,0,1273,A
2-PB1,743,0,1267,1,2,1270,T
2-PB1,744,0,1268,0,0,1268,T
2-PB1,745,1249,0,0,0,1249,A
2-PB1,746,0,1,1252,0,1253,G
2-PB1,747,1236,0,3,0,1239,A
2-PB1,748,0,2,1242,0,1244,G
2-PB1,749,0,2,1222,0,1224,G
2-PB1,750,0,0,1244,0,1244,G
2-PB1,751,0,1237,0,0,1237,T
2-PB1,752,1,1235,0,0,1236,T
2-PB1,753,1,2,0,1235,1238,C
2-PB1,754,0,0,1244,0,1244,G
2-PB1,755,0,1243,0,1,1244,T
2-PB1,756,2,0,1242,0,1244,G
2-PB1,757,0,1242,0,0,1242,T
2-PB1,758,1240,0,1,0,1241,A
2-PB1,759,0,0,0,1238,1238,C
2-PB1,760,0,1184,0,2,1186,T
2-PB1,761,0,1189,1,0,1190,T
2-PB1,762,0,0,0,1181,1181,C
2-PB1,763,2,0,1170,0,1172,G
2-PB1,764,0,1170,0,1,1171,T
2-PB1,765,0,1167,0,0,1167,T
2-PB1,766,0,0,1168,0,1168,G
2-PB1,767,1171,0,0,0,1171,A
2-PB1,768,1166,0,0,0,1166,A
2-PB1,769,1170,0,1,0,1171,A
2-PB1,770,0,0,0,1175,1175,C
2-PB1,771,0,1160,0,1,1161,T
2-PB1,772,0,1160,0,1,1161,T
2-PB1,773,0,1167,0,1,1168,T
2-PB1,774,1177,0,0,2,1179,A
2-PB1,775,0,0,1180,0,1180,G
2-PB1,776,1,0,0,1182,1183,C
2-PB1,777,0,1180,0,0,1180,T
2-PB1,778,1169,0,0,0,1169,A
2-PB1,779,0,0,1166,0,1166,G
2-PB1,780,1169,0,0,0,1169,A
2-PB1,781,1166,0,2,0,1168,A
2-PB1,782,0,1,1169,1,1171,G
2-PB1,783,0,0,0,1161,1161,C
2-PB1,784,1160,0,0,0,1160,A
2-PB1,785,0,1154,0,0,1154,T
2-PB1,786,0,1155,0,1,1156,T
2-PB1,787,0,1161,0,0,1161,T
2-PB1,788,0,0,1162,0,1162,G
2-PB1,789,0,2,0,1156,1158,C
2-PB1,790,0,0,1160,0,1160,G
2-PB1,791,1154,0,1,0,1155,A
2-PB1,792,1145,0,0,0,1145,A
2-PB1,793,1143,0,2,0,1145,A
2-PB1,794,1161,0,5,0,1166,A
2-PB1,795,0,0,1175,0,1175,G
2-PB1,796,0,0,0,1179,1179,C
2-PB1,797,0,1179,0,1,1180,T
2-PB1,798,1,1178,1,0,1180,T
2-PB1,799,1,1,1174,1,1177,G
2-PB1,800,1176,0,1,0,1177,A
2-PB1,801,1181,0,1,0,1182,A
2-PB1,802,0,0,0,1184,1184,C
2-PB1,803,1143,0,0,0,1143,A
2-PB1,804,1,0,1209,0,1210,G
2-PB1,805,0,1198,0,0,1198,T
2-PB1,806,0,0,0,1202,1202,C
2-PB1,807,0,1197,0,0,1197,T
2-PB1,808,0,0,1200,0,1200,G
2-PB1,809,0,0,1201,0,1201,G
2-PB1,810,1200,0,0,0,1200,A
2-PB1,811,0,0,0,1199,1199,C
2-PB1,812,0,1167,0,0,1167,T
2-PB1,813,0,1096,0,4,1100,T
2-PB1,814,0,0,0,1097,1097,C
2-PB1,815,0,1,0,1090,1091,C
2-PB1,816,0,2,1096,0,1098,G
2-PB1,817,0,0,1103,0,1103,G
2-PB1,818,0,1094,0,0,1094,T
2-PB1,819,0,1092,0,0,1092,T
2-PB1,820,0,1,1087,0,1088,G
2-PB1,821,0,0,1094,0,1094,G
2-PB1,822,0,1,1099,0,1100,G
2-PB1,823,0,1,1096,0,1097,G
2-PB1,824,0,1,1101,0,1102,G
2-PB1,825,0,1098,0,0,1098,T
2-PB1,826,1090,0,0,0,1090,A
2-PB1,827,1096,0,0,0,1096,A
2-PB1,828,1,1096,0,0,1097,T
2-PB1,829,0,0,1097,0,1097,G
2-PB1,830,1088,0,1,0,1089,A
2-PB1,831,1079,0,0,1,1080,A
2-PB1,832,1082,0,0,0,1082,A
2-PB1,833,1077,0,1,1,1079,A
2-PB1,834,0,0,1077,0,1077,G
2-PB1,835,1073,0,0,0,1073,A
2-PB1,836,1071,0,1,0,1072,A
2-PB1,837,0,0,1072,0,1072,G
2-PB1,838,2,0,1065,0,1067,G
2-PB1,839,0,0,0,1068,1068,C
2-PB1,840,0,0,0,1057,1057,C
2-PB1,841,1067,0,0,0,1067,A
2-PB1,842,1066,0,0,0,1066,A
2-PB1,843,1063,1,0,0,1064,A
2-PB1,844,0,0,0,1065,1065,C
2-PB1,845,0,1063,0,0,1063,T
2-PB1,846,0,0,1072,0,1072,G
2-PB1,847,1,1,1070,0,1072,G
2-PB1,848,0,0,0,1067,1067,C
2-PB1,849,1072,0,1,0,1073,A
2-PB1,850,1071,0,0,0,1071,A
2-PB1,851,1077,0,0,0,1077,A
2-PB1,852,0,1078,0,0,1078,T
2-PB1,853,0,0,1075,0,1075,G
2-PB1,854,0,1073,0,0,1073,T
2-PB1,855,0,1041,1,1,1043,T
2-PB1,856,0,0,1047,0,1047,G
2-PB1,857,0,1041,0,2,1043,T
2-PB1,858,1,1,1038,0,1040,G
2-PB1,859,1043,0,0,0,1043,A
2-PB1,860,0,2,1049,0,1051,G
2-PB1,861,1046,0,0,0,1046,A
2-PB1,862,1038,0,0,0,1038,A
2-PB1,863,1038,0,0,0,1038,A
2-PB1,864,1040,0,0,1,1041,A
2-PB1,865,1042,0,0,0,1042,A
2-PB1,866,0,1038,0,0,1038,T
2-PB1,867,0,1,1036,1,1038,G
2-PB1,868,1036,0,0,0,1036,A
2-PB1,869,1,1017,0,1,1019,T
2-PB1,870,0,2,1023,0,1025,G
2-PB1,871,1023,1,1,0,1025,A
2-PB1,872,0,0,0,1027,1027,C
2-PB1,873,0,1021,0,0,1021,T
2-PB1,874,1022,0,0,0,1022,A
2-PB1,875,1035,0,0,0,1035,A
2-PB1,876,0,1030,0,2,1032,T
2-PB1,877,0,1039,0,1,1040,T
2-PB1,878,2,0,0,1044,1046,C
2-PB1,879,1037,0,0,0,1037,A
2-PB1,880,0,0,0,1039,1039,C
2-PB1,881,1027,0,1,0,1028,A
2-PB1,882,1023,0,5,0,1028,A
2-PB1,883,0,3,1025,1,1029,G
2-PB1,884,1041,0,1,0,1042,A
2-PB1,885,0,0,0,1040,1040,C
2-PB1,886,1036,0,0,0,1036,A
2-PB1,887,0,0,0,1036,1036,C
2-PB1,888,1017,0,2,0,1019,A
2-PB1,889,0,1,1021,0,1022,G
2-PB1,890,1016,0,2,0,1018,A
2-PB1,891,0,0,1019,0,1019,G
2-PB1,892,0,0,0,1018,1018,C
2-PB1,893,0,979,0,0,979,T
2-PB1,894,1,986,1,0,988,T
2-PB1,895,0,986,0,0,986,T
2-PB1,896,0,0,1,983,984,C
2-PB1,897,0,981,0,2,983,T
2-PB1,898,1,978,0,0,979,T
2-PB1,899,0,981,0,0,981,T
2-PB1,900,0,0,0,980,980,C
2-PB1,901,977,2,0,0,979,A
2-PB1,902,1,0,0,983,984,C
2-PB1,903,970,2,1,0,973,A
2-PB1,904,977,1,0,0,978,A
2-PB1,905,0,986,0,0,986,T
2-PB1,906,0,0,0,994,994,C
2-PB1,907,995,0,0,1,996,A
2-PB1,908,0,0,1,1002,1003,C
2-PB1,909,0,992,1,2,995,T
2-PB1,910,0,2,997,0,999,G
2-PB1,911,0,2,996,0,998,G
2-PB1,912,0,0,1022,0,1022,G
2-PB1,913,0,0,1022,0,1022,G
2-PB1,914,1001,0,0,0,1001,A
2-PB1,915,0,0,0,954,954,C
2-PB1,916,966,0,0,0,966,A
2-PB1,917,1016,0,0,0,1016,A
2-PB1,918,0,0,0,1020,1020,C
2-PB1,919,1021,0,0,1,1022,A
2-PB1,920,2,0,0,1019,1021,C
2-PB1,921,0,957,0,2,959,T
2-PB1,922,965,0,0,0,965,A
2-PB1,923,964,0,0,0,964,A
2-PB1,924,0,0,968,0,968,G
2-PB1,925,0,966,0,0,966,T
2-PB1,926,0,1,893,0,894,G
2-PB1,927,0,0,885,0,885,G
2-PB1,928,880,0,1,0,881,A
2-PB1,929,879,0,1,0,880,A
2-PB1,930,0,880,0,0,880,T
2-PB1,931,1,1,877,0,879,G
2-PB1,932,876,0,1,0,877,A
2-PB1,933,867,0,0,0,867,A
2-PB1,934,864,1,0,0,865,A
2-PB1,935,871,1,0,0,872,A
2-PB1,936,0,874,0,0,874,T
2-PB1,937,0,1,0,871,872,C
2-PB1,938,873,0,0,0,873,A
2-PB1,939,871,1,0,0,872,A
2-PB1,940,870,0,0,0,870,A
2-PB1,941,873,0,0,0,873,A
2-PB1,942,0,0,0,871,871,C
2-PB1,943,0,0,0,860,860,C
2-PB1,944,2,1,0,852,855,C
2-PB1,945,1,852,0,0,853,T
2-PB1,946,0,0,0,855,855,C
2-PB1,947,0,1,854,0,855,G
2-PB1,948,856,0,0,0,856,A
2-PB1,949,853,0,0,0,853,A
2-PB1,950,1,850,0,1,852,T
2-PB1,951,0,1,850,0,851,G
2-PB1,952,0,840,1,1,842,T
2-PB1,953,1,837,1,0,839,T
2-PB1,954,0,840,0,0,840,T
2-PB1,955,0,841,0,0,841,T
2-PB1,956,0,838,0,0,838,T
2-PB1,957,0,0,838,0,838,G
2-PB1,958,1,0,838,0,839,G
2-PB1,959,0,0,0,836,836,C
2-PB1,960,0,1,823,0,824,G
2-PB1,961,822,0,0,0,822,A
2-PB1,962,0,834,0,0,834,T
2-PB1,963,0,0,849,0,849,G
2-PB1,964,865,0,1,0,866,A
2-PB1,965,0,868,0,0,868,T
2-PB1,966,0,864,0,1,865,T
2-PB1,967,860,0,4,0,864,A
2-PB1,968,0,0,0,864,864,C
2-PB1,969,863,0,4,0,867,A
2-PB1,970,1,861,0,0,862,T
2-PB1,971,807,0,0,0,807,A
2-PB1,972,0,0,0,802,802,C
2-PB1,973,714,0,0,0,714,A
2-PB1,974,0,705,0,0,705,T
2-PB1,975,1,0,0,703,704,C
2-PB1,976,693,0,0,0,693,A
2-PB1,977,0,0,0,693,693,C
2-PB1,978,680,0,0,0,680,A
2-PB1,979,681,0,0,0,681,A
2-PB1,980,678,0,0,0,678,A
2-PB1,981,0,0,638,0,638,G
2-PB1,982,656,1,0,0,657,A
2-PB1,983,654,1,0,0,655,A
2-PB1,984,0,654,0,1,655,T
2-PB1,985,0,0,0,657,657,C
2-PB1,986,644,1,0,0,645,A
2-PB1,987,649,0,0,0,649,A
2-PB1,988,0,0,0,650,650,C
2-PB1,989,1,0,0,649,650,C
2-PB1,990,0,578,0,0,578,T
2-PB1,991,0,0,581,0,581,G
2-PB1,992,580,0,1,0,581,A
2-PB1,993,0,0,580,0,580,G
2-PB1,994,0,576,0,0,576,T
2-PB1,995,0,0,555,0,555,G
2-PB1,996,1,0,574,0,575,G
2-PB1,997,0,563,0,1,564,T
2-PB1,998,0,563,0,0,563,T
2-PB1,999,1,0,0,564,565,C
2-PB1,1000,551,0,0,0,551,A
2-PB1,1001,0,1,558,0,559,G
2-PB1,1002,558,0,0,0,558,A
2-PB1,1003,559,0,0,0,559,A
2-PB1,1004,552,0,0,0,552,A
2-PB1,1005,0,0,0,479,479,C
2-PB1,1006,473,0,0,0,473,A
2-PB1,1007,0,472,0,0,472,T
2-PB1,1008,0,0,0,470,470,C
2-PB1,1009,0,0,0,476,476,C
2-PB1,1010,0,437,0,0,437,T
2-PB1,1011,0,0,438,0,438,G
2-PB1,1012,434,0,0,0,434,A
2-PB1,1013,0,0,435,0,435,G
2-PB1,1014,0,0,0,427,427,C
2-PB1,1015,408,0,0,0,408,A
2-PB1,1016,0,405,0,2,407,T
2-PB1,1017,1,0,0,406,407,C
2-PB1,1018,0,0,405,2,407,G
2-PB1,1019,0,0,0,425,425,C
2-PB1,1020,428,0,0,0,428,A
2-PB1,1021,0,0,0,440,440,C
2-PB1,1022,0,0,0,442,442,C
2-PB1,1023,443,0,1,0,444,A
2-PB1,1024,448,0,2,0,450,A
2-PB1,1025,0,450,0,0,450,T
2-PB1,1026,448,0,0,0,448,A
2-PB1,1027,447,0,0,0,447,A
2-PB1,1028,0,429,0,0,429,T
2-PB1,1029,0,0,431,0,431,G
2-PB1,1030,0,429,0,0,429,T
2-PB1,1031,0,421,0,0,421,T
2-PB1,1032,0,0,1,423,424,C
2-PB1,1033,0,423,0,0,423,T
2-PB1,1034,1,0,0,423,424,C
2-PB1,1035,423,0,1,0,424,A
2-PB1,1036,425,0,1,1,427,A
2-PB1,1037,425,0,1,0,426,A
2-PB1,1038,0,0,0,427,427,C
2-PB1,1039,427,0,0,0,427,A
2-PB1,1040,428,0,0,0,428,A
2-PB1,1041,428,1,0,0,429,A
2-PB1,1042,429,1,1,0,431,A
2-PB1,1043,0,431,0,0,431,T
2-PB1,1044,0,0,430,0,430,G
2-PB1,1045,1,1,425,0,427,G
2-PB1,1046,0,0,0,429,429,C
2-PB1,1047,430,0,0,0,430,A
2-PB1,1048,431,0,1,0,432,A
2-PB1,1049,0,0,432,0,432,G
2-PB1,1050,429,0,0,0,429,A
2-PB1,1051,0,427,0,0,427,T
2-PB1,1052,0,434,0,0,434,T
2-PB1,1053,0,1,436,1,438,G
2-PB1,1054,0,0,439,0,439,G
2-PB1,1055,0,0,446,0,446,G
2-PB1,1056,447,0,1,0,448,A
2-PB1,1057,444,0,1,0,445,A
2-PB1,1058,441,0,0,0,441,A
2-PB1,1059,436,0,0,0,436,A
2-PB1,1060,0,1,448,0,449,G
2-PB1,1061,0,1,448,0,449,G
2-PB1,1062,447,0,0,0,447,A
2-PB1,1063,0,442,0,1,443,T
2-PB1,1064,445,0,1,0,446,A
2-PB1,1065,0,0,0,446,446,C
2-PB1,1066,451,0,0,0,451,A
2-PB1,1067,0,447,0,0,447,T
2-PB1,1068,0,0,448,0,448,G
2-PB1,1069,0,433,0,0,433,T
2-PB1,1070,1,432,0,0,433,T
2-PB1,1071,1,0,0,428,429,C
2-PB1,1072,0,0,431,0,431,G
2-PB1,1073,430,0,0,0,430,A
2-PB1,1074,0,0,445,0,445,G
2-PB1,1075,438,0,0,0,438,A
2-PB1,1076,0,0,444,0,444,G
2-PB1,1077,0,446,0,0,446,T
2-PB1,1078,446,0,0,0,446,A
2-PB1,1079,445,0,0,0,445,A
2-PB1,1080,0,0,447,0,447,G
2-PB1,1081,444,0,2,0,446,A
2-PB1,1082,0,0,453,0,453,G
2-PB1,1083,441,0,0,0,441,A
2-PB1,1084,447,0,0,0,447,A
2-PB1,1085,0,444,0,0,444,T
2-PB1,1086,0,0,444,0,444,G
2-PB1,1087,441,0,1,0,442,A
2-PB1,1088,437,0,2,0,439,A
2-PB1,1089,0,0,435,0,435,G
2-PB1,1090,1,0,0,436,437,C
2-PB1,1091,0,435,0,0,435,T
2-PB1,1092,0,0,0,435,435,C
2-PB1,1093,0,1,0,436,437,C
2-PB1,1094,0,0,440,0,440,G
2-PB1,1095,0,0,443,0,443,G
2-PB1,1096,445,0,0,0,445,A
2-PB1,1097,0,1,0,451,452,C
2-PB1,1098,449,0,1,0,450,A
2-PB1,1099,0,0,0,455,455,C
2-PB1,1100,454,0,0,0,454,A
2-PB1,1101,453,0,1,0,454,A
2-PB1,1102,454,0,2,0,456,A
2-PB1,1103,0,455,0,0,455,T
2-PB1,1104,458,0,0,0,458,A
2-PB1,1105,0,0,0,458,458,C
2-PB1,1106,0,1,0,455,456,C
2-PB1,1107,0,448,0,2,450,T
2-PB1,1108,0,0,454,0,454,G
2-PB1,1109,0,0,0,456,456,C
2-PB1,1110,456,0,0,0,456,A
2-PB1,1111,0,1,454,0,455,G
2-PB1,1112,452,0,0,0,452,A
2-PB1,1113,451,0,0,0,451,A
2-PB1,1114,448,1,1,0,450,A
2-PB1,1115,0,449,0,0,449,T
2-PB1,1116,0,0,452,0,452,G
2-PB1,1117,1,0,0,449,450,C
2-PB1,1118,0,451,0,0,451,T
2-PB1,1119,452,1,0,0,453,A
2-PB1,1120,0,0,453,0,453,G
2-PB1,1121,0,0,0,452,452,C
2-PB1,1122,448,0,1,0,449,A
2-PB1,1123,452,0,0,0,452,A
2-PB1,1124,0,0,448,0,448,G
2-PB1,1125,1,0,0,449,450,C
2-PB1,1126,446,0,0,0,446,A
2-PB1,1127,0,459,0,0,459,T
2-PB1,1128,0,461,0,0,461,T
2-PB1,1129,0,0,474,0,474,G
2-PB1,1130,475,1,0,0,476,A
2-PB1,1131,0,0,0,471,471,C
2-PB1,1132,0,0,0,475,475,C
2-PB1,1133,0,469,0,0,469,T
2-PB1,1134,0,0,475,0,475,G
2-PB1,1135,475,0,2,0,477,A
2-PB1,1136,475,0,1,0,476,A
2-PB1,1137,0,0,480,0,480,G
2-PB1,1138,0,473,1,0,474,T
2-PB1,1139,476,1,0,0,477,A
2-PB1,1140,0,477,0,0,477,T
2-PB1,1141,0,476,0,0,476,T
2-PB1,1142,0,474,0,0,474,T
2-PB1,1143,0,0,0,465,465,C
2-PB1,1144,469,0,0,0,469,A
2-PB1,1145,468,0,0,0,468,A
2-PB1,1146,1,464,0,0,465,T
2-PB1,1147,0,1,467,0,468,G
2-PB1,1148,463,1,0,0,464,A
2-PB1,1149,465,0,0,0,465,A
2-PB1,1150,0,466,0,0,466,T
2-PB1,1151,0,0,0,466,466,C
2-PB1,1152,465,0,1,0,466,A
2-PB1,1153,467,0,0,0,467,A
2-PB1,1154,0,0,0,468,468,C
2-PB1,1155,469,0,0,0,469,A
2-PB1,1156,464,0,0,0,464,A
2-PB1,1157,0,0,460,0,460,G
2-PB1,1158,0,0,470,0,470,G
2-PB1,1159,468,0,1,0,469,A
2-PB1,1160,471,0,1,0,472,A
2-PB1,1161,0,0,469,0,469,G
2-PB1,1162,470,0,1,0,471,A
2-PB1,1163,471,0,0,0,471,A
2-PB1,1164,472,0,0,0,472,A
2-PB1,1165,470,0,1,0,471,A
2-PB1,1166,0,471,0,0,471,T
2-PB1,1167,0,467,0,0,467,T
2-PB1,1168,0,1,468,0,469,G
2-PB1,1169,472,0,0,0,472,A
2-PB1,1170,0,0,471,0,471,G
2-PB1,1171,467,1,1,0,469,A
2-PB1,1172,476,0,0,0,476,A
2-PB1,1173,478,0,0,0,478,A
2-PB1,1174,478,0,0,0,478,A
2-PB1,1175,0,477,0,0,477,T
2-PB1,1176,479,0,0,0,479,A
2-PB1,1177,477,0,2,0,479,A
2-PB1,1178,0,1,478,0,479,G
2-PB1,1179,0,0,480,0,480,G
2-PB1,1180,0,0,0,476,476,C
2-PB1,1181,0,0,0,471,471,C
2-PB1,1182,0,466,0,2,468,T
2-PB1,1183,0,0,0,535,535,C
2-PB1,1184,0,538,0,1,539,T
2-PB1,1185,0,539,0,0,539,T
2-PB1,1186,0,0,0,542,542,C
2-PB1,1187,0,544,0,0,544,T
2-PB1,1188,545,0,1,0,546,A
2-PB1,1189,548,0,1,0,549,A
2-PB1,1190,0,546,0,0,546,T
2-PB1,1191,542,0,0,0,542,A
2-PB1,1192,0,0,528,0,528,G
2-PB1,1193,486,0,0,0,486,A
2-PB1,1194,0,485,0,0,485,T
2-PB1,1195,0,0,483,0,483,G
2-PB1,1196,0,0,490,0,490,G
2-PB1,1197,0,1,0,484,485,C
2-PB1,1198,487,1,1,0,489,A
2-PB1,1199,0,0,0,488,488,C
2-PB1,1200,472,0,0,0,472,A
2-PB1,1201,1,0,486,0,487,G
2-PB1,1202,1,0,0,481,482,C
2-PB1,1203,487,0,1,0,488,A
2-PB1,1204,0,494,0,1,495,T
2-PB1,1205,1,0,0,493,494,C
2-PB1,1206,499,0,0,0,499,A
2-PB1,1207,1,498,0,0,499,T
2-PB1,1208,1,494,0,0,495,T
2-PB1,1209,0,0,492,0,492,G
2-PB1,1210,473,0,1,0,474,A
2-PB1,1211,0,0,485,0,485,G
2-PB1,1212,1,0,0,486,487,C
2-PB1,1213,0,0,0,483,483,C
2-PB1,1214,0,0,0,500,500,C
2-PB1,1215,0,499,0,0,499,T
2-PB1,1216,0,0,606,0,606,G
2-PB1,1217,0,0,639,0,639,G
2-PB1,1218,640,0,0,0,640,A
2-PB1,1219,689,0,0,0,689,A
2-PB1,1220,0,682,0,0,682,T
2-PB1,1221,0,1,709,0,710,G
2-PB1,1222,722,0,0,0,722,A
2-PB1,1223,0,731,0,0,731,T
2-PB1,1224,0,0,736,1,737,G
2-PB1,1225,727,0,0,1,728,A
2-PB1,1226,0,723,0,0,723,T
2-PB1,1227,0,0,723,0,723,G
2-PB1,1228,0,1,746,0,747,G
2-PB1,1229,1,0,748,0,749,G
2-PB1,1230,0,0,0,751,751,C
2-PB1,1231,755,0,0,0,755,A
2-PB1,1232,0,765,0,0,765,T
2-PB1,1233,1,0,797,0,798,G
2-PB1,1234,0,794,0,4,798,T
2-PB1,1235,0,804,0,0,804,T
2-PB1,1236,0,0,0,812,812,C
2-PB1,1237,808,0,0,0,808,A
2-PB1,1238,807,0,1,0,808,A
2-PB1,1239,0,0,0,811,811,C
2-PB1,1240,818,0,0,1,819,A
2-PB1,1241,0,824,0,1,825,T
2-PB1,1242,0,0,864,0,864,G
2-PB1,1243,0,0,0,865,865,C
2-PB1,1244,0,864,0,0,864,T
2-PB1,1245,881,0,0,0,881,A
2-PB1,1246,882,0,0,0,882,A
2-PB1,1247,0,0,902,0,902,G
2-PB1,1248,0,901,0,1,902,T
2-PB1,1249,901,0,0,0,901,A
2-PB1,1250,0,0,0,906,906,C
2-PB1,1251,0,0,901,0,901,G
2-PB1,1252,0,0,990,0,990,G
2-PB1,1253,0,992,0,0,992,T
2-PB1,1254,0,990,0,1,991,T
2-PB1,1255,0,994,0,0,994,T
2-PB1,1256,0,985,1,0,986,T
2-PB1,1257,986,1,2,0,989,A
2-PB1,1258,0,0,988,0,988,G
2-PB1,1259,0,0,988,0,988,G
2-PB1,1260,976,0,1,0,977,A
2-PB1,1261,0,0,967,0,967,G
2-PB1,1262,0,993,0,2,995,T
2-PB1,1263,0,1,0,994,995,C
2-PB1,1264,1,991,0,1,993,T
2-PB1,1265,0,0,0,995,995,C
2-PB1,1266,0,0,997,0,997,G
2-PB1,1267,1044,0,0,0,1044,A
2-PB1,1268,0,1042,0,1,1043,T
2-PB1,1269,1059,0,0,0,1059,A
2-PB1,1270,0,0,0,1057,1057,C
2-PB1,1271,0,1039,0,3,1042,T
2-PB1,1272,2,0,1044,0,1046,G
2-PB1,1273,1044,0,0,1,1045,A
2-PB1,1274,1071,0,0,0,1071,A
2-PB1,1275,1,1070,0,1,1072,T
2-PB1,1276,0,0,0,1053,1053,C
2-PB1,1277,0,1048,0,2,1050,T
2-PB1,1278,0,1047,0,1,1048,T
2-PB1,1279,0,1,1047,0,1048,G
2-PB1,1280,0,0,1052,0,1052,G
2-PB1,1281,1050,1,2,0,1053,A
2-PB1,1282,0,1,0,1055,1056,C
2-PB1,1283,1044,0,0,0,1044,A
2-PB1,1284,1050,0,1,0,1051,A
2-PB1,1285,1065,0,0,0,1065,A
2-PB1,1286,1063,1,3,0,1067,A
2-PB1,1287,0,1,1095,0,1096,G
2-PB1,1288,1097,0,1,0,1098,A
2-PB1,1289,1095,0,1,0,1096,A
2-PB1,1290,1095,0,1,0,1096,A
2-PB1,1291,0,1096,0,0,1096,T
2-PB1,1292,1100,0,0,0,1100,A
2-PB1,1293,1,0,0,1143,1144,C
2-PB1,1294,1133,0,2,0,1135,A
2-PB1,1295,0,0,0,1140,1140,C
2-PB1,1296,0,1,0,1128,1129,C
2-PB1,1297,1125,0,1,0,1126,A
2-PB1,1298,1146,0,0,1,1147,A
2-PB1,1299,0,0,1178,0,1178,G
2-PB1,1300,1206,0,1,0,1207,A
2-PB1,1301,0,0,0,1216,1216,C
2-PB1,1302,1191,0,0,0,1191,A
2-PB1,1303,1233,0,3,1,1237,A
2-PB1,1304,0,1,0,1238,1239,C
2-PB1,1305,1259,0,2,0,1261,A
2-PB1,1306,0,1268,0,0,1268,T
2-PB1,1307,1261,0,0,0,1261,A
2-PB1,1308,0,1,0,1278,1279,C
2-PB1,1309,0,1248,0,0,1248,T
2-PB1,1310,0,1,1271,0,1272,G
2-PB1,1311,0,0,1269,0,1269,G
2-PB1,1312,0,1255,0,0,1255,T
2-PB1,1313,1,1,1252,0,1254,G
2-PB1,1314,0,1,1248,0,1249,G
2-PB1,1315,1,1,1250,0,1252,G
2-PB1,1316,1246,1,1,0,1248,A
2-PB1,1317,0,1236,0,2,1238,T
2-PB1,1318,1,0,1239,0,1240,G
2-PB1,1319,1,0,1240,0,1241,G
2-PB1,1320,1,1,1245,0,1247,G
2-PB1,1321,0,0,0,1261,1261,C
2-PB1,1322,0,1248,0,5,1253,T
2-PB1,1323,0,0,0,1267,1267,C
2-PB1,1324,1,1,0,1263,1265,C
2-PB1,1325,1264,1,0,0,1265,A
2-PB1,1326,1261,0,1,0,1262,A
2-PB1,1327,0,1264,0,0,1264,T
2-PB1,1328,1,0,0,1266,1267,C
2-PB1,1329,1,1,1,1260,1263,C
2-PB1,1330,0,1252,0,1,1253,T
2-PB1,1331,0,0,0,1256,1256,C
2-PB1,1332,0,1,0,1250,1251,C
2-PB1,1333,0,2,1250,0,1252,G
2-PB1,1334,1250,0,0,0,1250,A
2-PB1,1335,0,2,0,1251,1253,C
2-PB1,1336,0,1,1251,0,1252,G
2-PB1,1337,1272,0,0,0,1272,A
2-PB1,1338,0,1269,0,0,1269,T
2-PB1,1339,0,1273,0,0,1273,T
2-PB1,1340,0,1270,0,0,1270,T
2-PB1,1341,0,1274,0,1,1275,T
2-PB1,1342,0,0,1277,0,1277,G
2-PB1,1343,0,2,0,1286,1288,C
2-PB1,1344,0,1,0,1285,1286,C
2-PB1,1345,2,0,0,1327,1329,C
2-PB1,1346,0,1315,0,3,1318,T
2-PB1,1347,0,1,0,1367,1368,C
2-PB1,1348,1377,0,1,0,1378,A
2-PB1,1349,0,1386,0,1,1387,T
2-PB1,1350,1386,0,0,0,1386,A
2-PB1,1351,0,1,1405,0,1406,G
2-PB1,1352,0,1390,1,0,1391,T
2-PB1,1353,0,3,1398,0,1401,G
2-PB1,1354,1362,0,0,0,1362,A
2-PB1,1355,1360,0,1,0,1361,A
2-PB1,1356,0,1339,0,0,1339,T
2-PB1,1357,0,0,1343,0,1343,G
2-PB1,1358,0,0,0,1359,1359,C
2-PB1,1359,1359,0,1,0,1360,A
2-PB1,1360,0,0,0,1355,1355,C
2-PB1,1361,2,0,0,1356,1358,C
2-PB1,1362,1352,0,0,0,1352,A
2-PB1,1363,1354,0,1,1,1356,A
2-PB1,1364,1347,0,0,1,1348,A
2-PB1,1365,0,1327,0,1,1328,T
2-PB1,1366,2,0,0,1366,1368,C
2-PB1,1367,1367,1,0,0,1368,A
2-PB1,1368,0,1368,0,0,1368,T
2-PB1,1369,0,0,1371,0,1371,G
2-PB1,1370,1368,0,4,0,1372,A
2-PB1,1371,1,0,1379,0,1380,G
2-PB1,1372,1,1,1386,0,1388,G
2-PB1,1373,0,0,1393,1,1394,G
2-PB1,1374,1384,0,1,0,1385,A
2-PB1,1375,1401,0,1,0,1402,A
2-PB1,1376,0,1409,0,3,1412,T
2-PB1,1377,1413,0,0,0,1413,A
2-PB1,1378,0,0,0,1418,1418,C
2-PB1,1379,1422,0,2,0,1424,A
2-PB1,1380,1422,0,4,0,1426,A
2-PB1,1381,0,0,1427,0,1427,G
2-PB1,1382,0,0,0,1418,1418,C
2-PB1,1383,1410,0,1,0,1411,A
2-PB1,1384,1,0,1440,0,1441,G
2-PB1,1385,0,1,1441,0,1442,G
2-PB1,1386,1436,0,1,0,1437,A
2-PB1,1387,2,2,1449,0,1453,G
2-PB1,1388,0,1437,0,1,1438,T
2-PB1,1389,0,0,1468,0,1468,G
2-PB1,1390,0,2,1473,0,1475,G
2-PB1,1391,1472,0,2,0,1474,A
2-PB1,1392,0,1477,0,0,1477,T
2-PB1,1393,1470,0,0,0,1470,A
2-PB1,1394,0,2,1477,0,1479,G
2-PB1,1395,1508,0,0,0,1508,A
2-PB1,1396,0,1511,0,1,1512,T
2-PB1,1397,0,1504,0,2,1506,T
2-PB1,1398,1,1,1,1577,1580,C
2-PB1,1399,0,1571,0,2,1573,T
2-PB1,1400,1568,2,0,0,1570,A
2-PB1,1401,0,0,0,1572,1572,C
2-PB1,1402,1549,0,1,0,1550,A
2-PB1,1403,1,1,1553,1,1556,G
2-PB1,1404,0,0,1544,0,1544,G
2-PB1,1405,1561,0,3,0,1564,A
2-PB1,1406,0,0,0,1557,1557,C
2-PB1,1407,1,0,0,1534,1535,C
2-PB1,1408,1,1524,0,4,1529,T
2-PB1,1409,0,0,1529,1,1530,G
2-PB1,1410,0,1,0,1527,1528,C
2-PB1,1411,1530,0,1,0,1531,A
2-PB1,1412,1541,0,2,0,1543,A
2-PB1,1413,0,1,1549,0,1550,G
2-PB1,1414,0,1540,0,0,1540,T
2-PB1,1415,0,1542,0,0,1542,T
2-PB1,1416,1528,0,0,0,1528,A
2-PB1,1417,0,0,1529,0,1529,G
2-PB1,1418,1,1525,0,1,1527,T
2-PB1,1419,1,2,1516,0,1519,G
2-PB1,1420,0,0,1522,0,1522,G
2-PB1,1421,2,2,1535,0,1539,G
2-PB1,1422,1535,1,2,0,1538,A
2-PB1,1423,1542,0,0,0,1542,A
2-PB1,1424,1,1534,1,0,1536,T
2-PB1,1425,0,0,0,1546,1546,C
2-PB1,1426,1544,1,0,0,1545,A
2-PB1,1427,1541,1,3,1,1546,A
2-PB1,1428,1,0,0,1543,1544,C
2-PB1,1429,1541,0,1,0,1542,A
2-PB1,1430,0,1522,0,0,1522,T
2-PB1,1431,1,0,1520,0,1521,G
2-PB1,1432,1523,0,0,0,1523,A
2-PB1,1433,2,0,1527,0,1529,G
2-PB1,1434,0,0,0,1527,1527,C
2-PB1,1435,1526,0,1,0,1527,A
2-PB1,1436,1527,0,0,0,1527,A
2-PB1,1437,1528,0,0,0,1528,A
2-PB1,1438,1535,0,0,0,1535,A
2-PB1,1439,1534,0,1,0,1535,A
2-PB1,1440,0,0,1542,0,1542,G
2-PB1,1441,1524,0,3,0,1527,A
2-PB1,1442,1522,0,4,0,1526,A
2-PB1,1443,1,0,1575,0,1576,G
2-PB1,1444,0,1572,0,2,1574,T
2-PB1,1445,3,0,1,1580,1584,C
2-PB1,1446,3,1,0,1586,1590,C
2-PB1,1447,0,1587,0,3,1590,T
2-PB1,1448,1620,0,0,0,1620,A
2-PB1,1449,1,1617,0,0,1618,T
2-PB1,1450,1616,0,1,0,1617,A
2-PB1,1451,0,1619,0,0,1619,T
2-PB1,1452,1598,0,0,1,1599,A
2-PB1,1453,1602,0,0,0,1602,A
2-PB1,1454,1599,0,0,0,1599,A
2-PB1,1455,1,1600,0,1,1602,T
2-PB1,1456,1589,0,0,0,1589,A
2-PB1,1457,1594,1,0,0,1595,A
2-PB1,1458,1610,0,0,0,1610,A
2-PB1,1459,1605,0,4,1,1610,A
2-PB1,1460,0,0,0,1611,1611,C
2-PB1,1461,1544,0,1,0,1545,A
2-PB1,1462,4,1,1542,0,1547,G
2-PB1,1463,0,3,1541,0,1544,G
2-PB1,1464,1,3,1544,0,1548,G
2-PB1,1465,1547,1,0,0,1548,A
2-PB1,1466,1,0,0,1562,1563,C
2-PB1,1467,1554,0,1,0,1555,A
2-PB1,1468,0,1561,0,0,1561,T
2-PB1,1469,0,1566,0,0,1566,T
2-PB1,1470,0,1568,0,0,1568,T
2-PB1,1471,0,1,1565,0,1566,G
2-PB1,1472,1564,0,2,0,1566,A
2-PB1,1473,1571,0,1,0,1572,A
2-PB1,1474,0,1569,0,1,1570,T
2-PB1,1475,0,1539,0,0,1539,T
2-PB1,1476,1,0,0,1551,1552,C
2-PB1,1477,1540,0,0,0,1540,A
2-PB1,1478,1,0,0,1538,1539,C
2-PB1,1479,0,1534,0,1,1535,T
2-PB1,1480,1549,0,0,1,1550,A
2-PB1,1481,0,0,1547,0,1547,G
2-PB1,1482,0,0,0,1552,1552,C
2-PB1,1483,0,1539,0,4,1543,T
2-PB1,1484,0,1552,0,1,1553,T
2-PB1,1485,0,1552,0,1,1553,T
2-PB1,1486,0,1548,0,1,1549,T
2-PB1,1487,0,1545,1,3,1549,T
2-PB1,1488,0,1546,0,0,1546,T
2-PB1,1489,0,1544,0,0,1544,T
2-PB1,1490,1542,1,2,0,1545,A
2-PB1,1491,0,1546,0,0,1546,T
2-PB1,1492,0,0,0,1546,1546,C
2-PB1,1493,2,0,1551,0,1553,G
2-PB1,1494,1602,0,1,0,1603,A
2-PB1,1495,1,1604,0,0,1605,T
2-PB1,1496,1613,0,0,0,1613,A
2-PB1,1497,0,1621,0,0,1621,T
2-PB1,1498,2,2,1617,0,1621,G
2-PB1,1499,0,0,1624,0,1624,G
2-PB1,1500,1623,0,1,0,1624,A
2-PB1,1501,1,1615,0,0,1616,T
2-PB1,1502,0,1611,0,1,1612,T
2-PB1,1503,0,1575,0,1,1576,T
2-PB1,1504,0,0,1580,0,1580,G
2-PB1,1505,0,1578,0,0,1578,T
2-PB1,1506,2,0,1568,0,1570,G
2-PB1,1507,3,0,1570,0,1573,G
2-PB1,1508,0,0,0,1567,1567,C
2-PB1,1509,0,1564,0,1,1565,T
2-PB1,1510,1564,0,0,0,1564,A
2-PB1,1511,1580,0,0,0,1580,A
2-PB1,1512,0,1587,0,0,1587,T
2-PB1,1513,1,1583,0,0,1584,T
2-PB1,1514,0,1585,0,0,1585,T
2-PB1,1515,1,1583,0,0,1584,T
2-PB1,1516,1581,0,1,0,1582,A
2-PB1,1517,0,0,1593,0,1593,G
2-PB1,1518,0,0,0,1595,1595,C
2-PB1,1519,1588,1,1,0,1590,A
2-PB1,1520,0,1578,0,0,1578,T
2-PB1,1521,0,1,1559,0,1560,G
2-PB1,1522,0,2,1573,1,1576,G
2-PB1,1523,1571,0,2,0,1573,A
2-PB1,1524,1,0,1578,0,1579,G
2-PB1,1525,0,2,0,1572,1574,C
2-PB1,1526,0,1558,0,0,1558,T
2-PB1,1527,2,1,1562,0,1565,G
2-PB1,1528,0,0,0,1561,1561,C
2-PB1,1529,1,0,0,1553,1554,C
2-PB1,1530,0,1,0,1562,1563,C
2-PB1,1531,1528,0,1,1,1530,A
2-PB1,1532,0,0,1647,0,1647,G
2-PB1,1533,0,1638,0,1,1639,T
2-PB1,1534,0,1649,0,1,1650,T
2-PB1,1535,0,1645,0,0,1645,T
2-PB1,1536,0,1625,0,1,1626,T
2-PB1,1537,0,0,1621,1,1622,G
2-PB1,1538,0,2,1618,0,1620,G
2-PB1,1539,1620,0,0,0,1620,A
2-PB1,1540,0,0,1617,0,1617,G
2-PB1,1541,0,1515,0,2,1517,T
2-PB1,1542,0,1,1573,0,1574,G
2-PB1,1543,0,1575,0,1,1576,T
2-PB1,1544,0,1,0,1571,1572,C
2-PB1,1545,0,1575,0,2,1577,T
2-PB1,1546,4,0,1575,0,1579,G
2-PB1,1547,0,2,1601,0,1603,G
2-PB1,1548,1600,0,0,0,1600,A
2-PB1,1549,1601,0,3,0,1604,A
2-PB1,1550,0,1601,0,0,1601,T
2-PB1,1551,1528,0,0,0,1528,A
2-PB1,1552,1524,1,0,0,1525,A
2-PB1,1553,1522,0,2,1,1525,A
2-PB1,1554,0,0,0,1529,1529,C
2-PB1,1555,0,1,1521,0,1522,G
2-PB1,1556,1506,0,0,0,1506,A
2-PB1,1557,0,0,1505,0,1505,G
2-PB1,1558,0,1500,0,0,1500,T
2-PB1,1559,1,0,0,1509,1510,C
2-PB1,1560,1501,0,2,0,1503,A
2-PB1,1561,0,0,1530,0,1530,G
2-PB1,1562,0,2,0,1528,1530,C
2-PB1,1563,0,1529,0,1,1530,T
2-PB1,1564,0,0,1569,0,1569,G
2-PB1,1565,1564,0,2,0,1566,A
2-PB1,1566,0,1566,0,1,1567,T
2-PB1,1567,1569,0,2,0,1571,A
2-PB1,1568,0,1560,0,1,1561,T
2-PB1,1569,1,1,1562,0,1564,G
2-PB1,1570,1521,1,3,0,1525,A
2-PB1,1571,0,0,1552,0,1552,G
2-PB1,1572,2,1,0,1555,1558,C
2-PB1,1573,1497,0,0,0,1497,A
2-PB1,1574,0,1487,0,0,1487,T
2-PB1,1575,0,1495,0,0,1495,T
2-PB1,1576,0,0,1509,0,1509,G
2-PB1,1577,0,1,1571,0,1572,G
2-PB1,1578,1545,0,5,0,1550,A
2-PB1,1579,1,0,1551,0,1552,G
2-PB1,1580,0,1517,0,0,1517,T
2-PB1,1581,1512,0,0,0,1512,A
2-PB1,1582,1510,0,1,0,1511,A
2-PB1,1583,0,0,0,1521,1521,C
2-PB1,1584,1513,1,0,0,1514,A
2-PB1,1585,0,0,1556,0,1556,G
2-PB1,1586,1,1425,0,2,1428,T
2-PB1,1587,0,1,1439,0,1440,G
2-PB1,1588,1457,2,1,0,1460,A
2-PB1,1589,1,1460,0,0,1461,T
2-PB1,1590,1460,0,0,0,1460,A
2-PB1,1591,1461,0,1,0,1462,A
2-PB1,1592,1433,0,10,0,1443,A
2-PB1,1593,0,0,1462,0,1462,G
2-PB1,1594,1416,0,1,0,1417,A
2-PB1,1595,1419,0,0,0,1419,A
2-PB1,1596,0,0,0,1418,1418,C
2-PB1,1597,1374,1,0,0,1375,A
2-PB1,1598,1387,0,1,1,1389,A
2-PB1,1599,0,0,0,1401,1401,C
2-PB1,1600,1419,0,0,0,1419,A
2-PB1,1601,0,1414,1,0,1415,T
2-PB1,1602,1,4,1403,1,1409,G
2-PB1,1603,1411,0,2,0,1413,A
2-PB1,1604,0,1411,0,0,1411,T
2-PB1,1605,1403,0,0,1,1404,A
2-PB1,1606,1409,0,0,0,1409,A
2-PB1,1607,1416,0,1,0,1417,A
2-PB1,1608,0,1,0,1423,1424,C
2-PB1,1609,1398,0,0,0,1398,A
2-PB1,1610,1391,0,0,0,1391,A
2-PB1,1611,0,1375,0,1,1376,T
2-PB1,1612,0,2,1379,0,1381,G
2-PB1,1613,1409,1,0,0,1410,A
2-PB1,1614,0,1,1,1422,1424,C
2-PB1,1615,1,0,0,1411,1412,C
2-PB1,1616,1,1395,0,1,1397,T
2-PB1,1617,0,1363,0,1,1364,T
2-PB1,1618,0,1,1363,0,1364,G
2-PB1,1619,0,0,1366,0,1366,G
2-PB1,1620,1374,0,2,0,1376,A
2-PB1,1621,0,0,0,1368,1368,C
2-PB1,1622,0,0,0,1354,1354,C
2-PB1,1623,1343,0,0,0,1343,A
2-PB1,1624,1,0,1348,0,1349,G
2-PB1,1625,0,0,0,1353,1353,C
2-PB1,1626,1352,0,1,0,1353,A
2-PB1,1627,1352,1,2,0,1355,A
2-PB1,1628,0,2,0,1351,1353,C
2-PB1,1629,1343,0,0,0,1343,A
2-PB1,1630,1,0,1367,0,1368,G
2-PB1,1631,0,0,0,1366,1366,C
2-PB1,1632,2,0,0,1371,1373,C
2-PB1,1633,0,0,0,1369,1369,C
2-PB1,1634,1364,0,0,0,1364,A
2-PB1,1635,1360,0,0,1,1361,A
2-PB1,1636,1363,0,1,0,1364,A
2-PB1,1637,0,1363,0,0,1363,T
2-PB1,1638,0,1,1354,0,1355,G
2-PB1,1639,1,0,1342,0,1343,G
2-PB1,1640,0,0,0,1330,1330,C
2-PB1,1641,0,1328,0,0,1328,T
2-PB1,1642,0,0,0,1370,1370,C
2-PB1,1643,2,1368,0,2,1372,T
2-PB1,1644,2,0,0,1367,1369,C
2-PB1,1645,0,0,0,1374,1374,C
2-PB1,1646,1378,0,1,0,1379,A
2-PB1,1647,1380,0,0,0,1380,A
2-PB1,1648,1,1370,0,2,1373,T
2-PB1,1649,0,1358,0,0,1358,T
2-PB1,1650,0,1,1364,0,1365,G
2-PB1,1651,0,1335,0,3,1338,T
2-PB1,1652,0,1330,0,0,1330,T
2-PB1,1653,2,2,0,1326,1330,C
2-PB1,1654,1330,0,0,0,1330,A
2-PB1,1655,0,1329,0,1,1330,T
2-PB1,1656,0,0,0,1332,1332,C
2-PB1,1657,1334,0,1,0,1335,A
2-PB1,1658,1327,2,1,0,1330,A
2-PB1,1659,1331,0,3,0,1334,A
2-PB1,1660,0,0,1364,0,1364,G
2-PB1,1661,1366,0,0,1,1367,A
2-PB1,1662,1,1365,0,1,1367,T
2-PB1,1663,0,1365,0,0,1365,T
2-PB1,1664,1368,0,2,0,1370,A
2-PB1,1665,0,2,0,1392,1394,C
2-PB1,1666,1383,0,2,0,1385,A
2-PB1,1667,1,0,1397,0,1398,G
2-PB1,1668,1387,0,1,0,1388,A
2-PB1,1669,0,1402,0,0,1402,T
2-PB1,1670,1416,0,0,0,1416,A
2-PB1,1671,0,0,0,1503,1503,C
2-PB1,1672,1521,0,3,0,1524,A
2-PB1,1673,0,0,0,1612,1612,C
2-PB1,1674,1579,0,1,0,1580,A
2-PB1,1675,0,1591,0,0,1591,T
2-PB1,1676,1578,0,0,0,1578,A
2-PB1,1677,0,1573,0,0,1573,T
2-PB1,1678,1544,0,1,0,1545,A
2-PB1,1679,0,0,1547,1,1548,G
2-PB1,1680,0,1,1533,0,1534,G
2-PB1,1681,1,1446,0,3,1450,T
2-PB1,1682,5,0,1424,0,1429,G
2-PB1,1683,0,0,0,1481,1481,C
2-PB1,1684,0,0,0,1472,1472,C
2-PB1,1685,1485,0,1,0,1486,A
2-PB1,1686,0,1484,0,1,1485,T
2-PB1,1687,1493,0,0,0,1493,A
2-PB1,1688,1,0,1497,0,1498,G
2-PB1,1689,1456,0,1,0,1457,A
2-PB1,1690,0,2,1469,0,1471,G
2-PB1,1691,0,1,1464,1,1466,G
2-PB1,1692,1417,0,0,0,1417,A
2-PB1,1693,1,4,1414,1,1420,G
2-PB1,1694,1410,0,4,0,1414,A
2-PB1,1695,0,0,0,1414,1414,C
2-PB1,1696,1422,0,1,0,1423,A
2-PB1,1697,0,0,1,1439,1440,C
2-PB1,1698,1444,0,1,0,1445,A
2-PB1,1699,0,1,0,1443,1444,C
2-PB1,1700,1439,0,0,0,1439,A
2-PB1,1701,1444,0,1,0,1445,A
2-PB1,1702,1458,0,0,1,1459,A
2-PB1,1703,0,1452,0,1,1453,T
2-PB1,1704,1,0,0,1455,1456,C
2-PB1,1705,1,0,0,1453,1454,C
2-PB1,1706,1438,0,1,0,1439,A
2-PB1,1707,0,1,1444,0,1445,G
2-PB1,1708,1446,1,0,0,1447,A
2-PB1,1709,0,0,0,1452,1452,C
2-PB1,1710,0,2,1443,0,1445,G
2-PB1,1711,1443,0,3,1,1447,A
2-PB1,1712,1,0,1448,0,1449,G
2-PB1,1713,1446,0,2,1,1449,A
2-PB1,1714,1445,0,5,0,1450,A
2-PB1,1715,2,0,1459,0,1461,G
2-PB1,1716,1457,0,0,1,1458,A
2-PB1,1717,0,1451,0,2,1453,T
2-PB1,1718,1,0,0,1446,1447,C
2-PB1,1719,1451,0,0,0,1451,A
2-PB1,1720,0,1449,1,0,1450,T
2-PB1,1721,0,1451,0,0,1451,T
2-PB1,1722,0,1,0,1446,1447,C
2-PB1,1723,0,0,1449,0,1449,G
2-PB1,1724,1434,1,1,0,1436,A
2-PB1,1725,0,0,1444,0,1444,G
2-PB1,1726,1430,1,2,0,1433,A
2-PB1,1727,0,1493,0,0,1493,T
2-PB1,1728,1495,0,1,0,1496,A
2-PB1,1729,1497,0,0,1,1498,A
2-PB1,1730,1501,0,1,0,1502,A
2-PB1,1731,0,1,1500,0,1501,G
2-PB1,1732,1498,0,0,0,1498,A
2-PB1,1733,1462,1,1,0,1464,A
2-PB1,1734,0,0,1470,0,1470,G
2-PB1,1735,0,0,0,1481,1481,C
2-PB1,1736,0,1458,0,0,1458,T
2-PB1,1737,0,0,1466,0,1466,G
2-PB1,1738,2,1460,0,1,1463,T
2-PB1,1739,0,2,1456,1,1459,G
2-PB1,1740,0,0,1466,0,1466,G
2-PB1,1741,0,3,1484,0,1487,G
2-PB1,1742,1492,0,2,0,1494,A
2-PB1,1743,0,1479,0,0,1479,T
2-PB1,1744,2,0,0,1474,1476,C
2-PB1,1745,1476,0,0,0,1476,A
2-PB1,1746,1482,0,2,0,1484,A
2-PB1,1747,1488,2,2,0,1492,A
2-PB1,1748,1,1,0,1484,1486,C
2-PB1,1749,0,0,0,1482,1482,C
2-PB1,1750,0,0,1,1481,1482,C
2-PB1,1751,1485,0,0,0,1485,A
2-PB1,1752,1511,0,2,0,1513,A
2-PB1,1753,0,1511,0,0,1511,T
2-PB1,1754,0,0,0,1515,1515,C
2-PB1,1755,1505,0,0,0,1505,A
2-PB1,1756,1500,0,2,0,1502,A
2-PB1,1757,1,2,1518,0,1521,G
2-PB1,1758,0,0,1517,0,1517,G
2-PB1,1759,1,0,1518,0,1519,G
2-PB1,1760,0,0,0,1520,1520,C
2-PB1,1761,1509,0,2,0,1511,A
2-PB1,1762,0,2,1550,0,1552,G
2-PB1,1763,0,0,1565,1,1566,G
2-PB1,1764,1567,0,2,0,1569,A
2-PB1,1765,0,0,0,1584,1584,C
2-PB1,1766,0,1558,0,1,1559,T
2-PB1,1767,1594,1,0,0,1595,A
2-PB1,1768,0,1594,0,1,1595,T
2-PB1,1769,0,1592,1,2,1595,T
2-PB1,1770,0,0,1591,0,1591,G
2-PB1,1771,0,0,1601,0,1601,G
2-PB1,1772,0,1589,0,1,1590,T
2-PB1,1773,1596,0,0,1,1597,A
2-PB1,1774,0,1563,0,4,1567,T
2-PB1,1775,2,1,0,1570,1573,C
2-PB1,1776,1549,3,1,0,1553,A
2-PB1,1777,1,0,1568,0,1569,G
2-PB1,1778,1567,0,2,0,1569,A
2-PB1,1779,0,1556,0,1,1557,T
2-PB1,1780,0,2,1502,0,1504,G
2-PB1,1781,0,2,1499,0,1501,G
2-PB1,1782,0,1,1499,0,1500,G
2-PB1,1783,1,1,1500,0,1502,G
2-PB1,1784,0,2,1507,0,1509,G
2-PB1,1785,1501,0,1,0,1502,A
2-PB1,1786,1,1,0,1494,1496,C
2-PB1,1787,1,0,0,1492,1493,C
2-PB1,1788,1495,0,0,0,1495,A
2-PB1,1789,1585,0,0,0,1585,A
2-PB1,1790,1597,0,0,0,1597,A
2-PB1,1791,0,0,0,1627,1627,C
2-PB1,1792,0,1612,0,3,1615,T
2-PB1,1793,0,1607,0,0,1607,T
2-PB1,1794,1621,0,1,0,1622,A
2-PB1,1795,0,1617,0,1,1618,T
2-PB1,1796,1626,0,0,0,1626,A
2-PB1,1797,0,0,0,1625,1625,C
2-PB1,1798,1500,0,2,0,1502,A
2-PB1,1799,1500,0,0,0,1500,A
2-PB1,1800,0,1457,0,0,1457,T
2-PB1,1801,1477,0,1,0,1478,A
2-PB1,1802,0,1480,0,1,1481,T
2-PB1,1803,1,1,0,1470,1472,C
2-PB1,1804,2,3,0,1466,1471,C
2-PB1,1805,3,0,1465,0,1468,G
2-PB1,1806,0,0,1473,1,1474,G
2-PB1,1807,1474,0,0,0,1474,A
2-PB1,1808,1464,0,3,1,1468,A
2-PB1,1809,0,1467,0,0,1467,T
2-PB1,1810,1,1,1,1470,1473,C
2-PB1,1811,0,1467,0,2,1469,T
2-PB1,1812,1,1475,0,0,1476,T
2-PB1,1813,2,0,0,1474,1476,C
2-PB1,1814,1471,0,4,0,1475,A
2-PB1,1815,1,0,0,1481,1482,C
2-PB1,1816,1476,1,0,1,1478,A
2-PB1,1817,0,1579,0,2,1581,T
2-PB1,1818,1,0,0,1581,1582,C
2-PB1,1819,1,0,1,1582,1584,C
2-PB1,1820,0,0,0,1592,1592,C
2-PB1,1821,0,1587,0,3,1590,T
2-PB1,1822,1,0,1585,0,1586,G
2-PB1,1823,1591,0,0,0,1591,A
2-PB1,1824,1585,0,2,0,1587,A
2-PB1,1825,0,1,1587,0,1588,G
2-PB1,1826,0,1501,0,2,1503,T
2-PB1,1827,0,0,0,1504,1504,C
2-PB1,1828,0,1480,0,0,1480,T
2-PB1,1829,0,0,1511,0,1511,G
2-PB1,1830,0,2,0,1509,1511,C
2-PB1,1831,0,1509,0,1,1510,T
2-PB1,1832,0,1510,0,1,1511,T
2-PB1,1833,1511,0,1,0,1512,A
2-PB1,1834,1508,0,1,0,1509,A
2-PB1,1835,1509,0,0,0,1509,A
2-PB1,1836,1463,0,3,0,1466,A
2-PB1,1837,0,1484,0,1,1485,T
2-PB1,1838,0,1,1486,0,1487,G
2-PB1,1839,0,1,1484,0,1485,G
2-PB1,1840,0,0,1481,0,1481,G
2-PB1,1841,1478,0,2,2,1482,A
2-PB1,1842,0,0,1490,0,1490,G
2-PB1,1843,0,0,0,1488,1488,C
2-PB1,1844,0,1487,0,0,1487,T
2-PB1,1845,0,1,1489,0,1490,G
2-PB1,1846,1489,0,2,0,1491,A
2-PB1,1847,0,1493,0,0,1493,T
2-PB1,1848,2,0,1488,0,1490,G
2-PB1,1849,2,0,1495,0,1497,G
2-PB1,1850,1496,0,0,0,1496,A
2-PB1,1851,0,1492,0,0,1492,T
2-PB1,1852,0,1,1490,0,1491,G
2-PB1,1853,1486,0,0,0,1486,A
2-PB1,1854,0,0,1503,0,1503,G
2-PB1,1855,1499,0,1,1,1501,A
2-PB1,1856,1500,0,0,0,1500,A
2-PB1,1857,1,1492,0,0,1493,T
2-PB1,1858,0,1487,0,0,1487,T
2-PB1,1859,1487,0,0,0,1487,A
2-PB1,1860,0,1491,0,0,1491,T
2-PB1,1861,0,0,0,1494,1494,C
2-PB1,1862,0,2,1488,0,1490,G
2-PB1,1863,0,1,1480,0,1481,G
2-PB1,1864,0,0,1478,1,1479,G
2-PB1,1865,1,1,1470,0,1472,G
2-PB1,1866,1469,0,2,0,1471,A
2-PB1,1867,1471,0,3,0,1474,A
2-PB1,1868,1,3,1476,0,1480,G
2-PB1,1869,1502,0,2,0,1504,A
2-PB1,1870,0,0,0,1511,1511,C
2-PB1,1871,0,1500,1,1,1502,T
2-PB1,1872,2,1527,0,0,1529,T
2-PB1,1873,0,1531,0,0,1531,T
2-PB1,1874,0,0,1540,0,1540,G
2-PB1,1875,0,1542,0,0,1542,T
2-PB1,1876,1528,0,3,0,1531,A
2-PB1,1877,1528,0,0,1,1529,A
2-PB1,1878,1,1508,0,0,1509,T
2-PB1,1879,1,0,0,1512,1513,C
2-PB1,1880,2,0,0,1504,1506,C
2-PB1,1881,1,0,0,1497,1498,C
2-PB1,1882,1,1,0,1498,1500,C
2-PB1,1883,0,1489,0,4,1493,T
2-PB1,1884,1,2,1485,0,1488,G
2-PB1,1885,1487,0,0,0,1487,A
2-PB1,1886,1494,0,0,0,1494,A
2-PB1,1887,0,1491,0,0,1491,T
2-PB1,1888,0,2,1,1477,1480,C
2-PB1,1889,3,1,0,1469,1473,C
2-PB1,1890,0,0,0,1473,1473,C
2-PB1,1891,0,1467,0,4,1471,T
2-PB1,1892,0,1470,0,0,1470,T
2-PB1,1893,0,1468,0,0,1468,T
2-PB1,1894,0,0,1467,0,1467,G
2-PB1,1895,0,1465,0,0,1465,T
2-PB1,1896,2,0,0,1461,1463,C
2-PB1,1897,1448,0,1,0,1449,A
2-PB1,1898,0,0,1469,0,1469,G
2-PB1,1899,0,0,0,1466,1466,C
2-PB1,1900,0,1,1,1468,1470,C
2-PB1,1901,1470,0,0,0,1470,A
2-PB1,1902,0,1472,0,0,1472,T
2-PB1,1903,1470,0,0,0,1470,A
2-PB1,1904,1469,1,1,0,1471,A
2-PB1,1905,1467,0,1,0,1468,A
2-PB1,1906,0,1,1482,0,1483,G
2-PB1,1907,1444,0,0,0,1444,A
2-PB1,1908,1450,1,0,0,1451,A
2-PB1,1909,1451,0,0,0,1451,A
2-PB1,1910,0,1452,0,2,1454,T
2-PB1,1911,0,1450,0,0,1450,T
2-PB1,1912,0,3,1445,0,1448,G
2-PB1,1913,1432,1,4,0,1437,A
2-PB1,1914,0,1,1452,0,1453,G
2-PB1,1915,0,1436,0,1,1437,T
2-PB1,1916,0,0,0,1446,1446,C
2-PB1,1917,0,1436,0,0,1436,T
2-PB1,1918,0,0,1466,0,1466,G
2-PB1,1919,0,1464,0,1,1465,T
2-PB1,1920,1488,0,0,0,1488,A
2-PB1,1921,1485,0,1,0,1486,A
2-PB1,1922,1487,0,1,0,1488,A
2-PB1,1923,0,1,0,1495,1496,C
2-PB1,1924,1470,1,0,0,1471,A
2-PB1,1925,1501,0,0,0,1501,A
2-PB1,1926,0,1495,0,1,1496,T
2-PB1,1927,0,0,1465,0,1465,G
2-PB1,1928,0,1,0,1474,1475,C
2-PB1,1929,0,1451,0,2,1453,T
2-PB1,1930,3,1,1484,0,1488,G
2-PB1,1931,0,1485,0,4,1489,T
2-PB1,1932,1503,0,2,1,1506,A
2-PB1,1933,1,0,1505,0,1506,G
2-PB1,1934,0,1466,0,0,1466,T
2-PB1,1935,1459,0,0,0,1459,A
2-PB1,1936,1458,0,0,0,1458,A
2-PB1,1937,0,1455,0,1,1456,T
2-PB1,1938,2,0,1449,0,1451,G
2-PB1,1939,0,1,0,1419,1420,C
2-PB1,1940,1,0,0,1402,1403,C
2-PB1,1941,1385,0,0,0,1385,A
2-PB1,1942,1,0,1398,0,1399,G
2-PB1,1943,1,0,1,1406,1408,C
2-PB1,1944,1,0,0,1411,1412,C
2-PB1,1945,0,0,0,1407,1407,C
2-PB1,1946,1411,0,0,0,1411,A
2-PB1,1947,1,1411,0,0,1412,T
2-PB1,1948,0,1,1412,0,1413,G
2-PB1,1949,0,0,1421,0,1421,G
2-PB1,1950,0,1417,1,1,1419,T
2-PB1,1951,2,0,0,1368,1370,C
2-PB1,1952,0,0,0,1352,1352,C
2-PB1,1953,0,1350,0,1,1351,T
2-PB1,1954,0,0,1373,0,1373,G
2-PB1,1955,1,0,0,1371,1372,C
2-PB1,1956,0,1,0,1373,1374,C
2-PB1,1957,1371,1,1,0,1373,A
2-PB1,1958,1369,0,0,0,1369,A
2-PB1,1959,1362,0,0,0,1362,A
2-PB1,1960,1370,0,1,0,1371,A
2-PB1,1961,0,1,1391,0,1392,G
2-PB1,1962,0,1362,0,0,1362,T
2-PB1,1963,1354,1,2,0,1357,A
2-PB1,1964,0,1356,0,1,1357,T
2-PB1,1965,0,0,1354,0,1354,G
2-PB1,1966,0,1,1378,0,1379,G
2-PB1,1967,1372,1,0,0,1373,A
2-PB1,1968,1383,0,0,0,1383,A
2-PB1,1969,0,1377,0,0,1377,T
2-PB1,1970,1355,0,0,0,1355,A
2-PB1,1971,0,1349,0,1,1350,T
2-PB1,1972,0,1,1341,0,1342,G
2-PB1,1973,1345,0,0,0,1345,A
2-PB1,1974,1,1334,0,3,1338,T
2-PB1,1975,0,0,1308,1,1309,G
2-PB1,1976,0,2,0,1306,1308,C
2-PB1,1977,0,0,1,1296,1297,C
2-PB1,1978,0,0,1299,0,1299,G
2-PB1,1979,0,1298,0,0,1298,T
2-PB1,1980,0,1291,0,5,1296,T
2-PB1,1981,0,1,1298,0,1299,G
2-PB1,1982,1,0,0,1312,1313,C
2-PB1,1983,1314,0,0,0,1314,A
2-PB1,1984,1323,0,0,0,1323,A
2-PB1,1985,0,0,0,1326,1326,C
2-PB1,1986,0,1315,0,3,1318,T
2-PB1,1987,1319,0,2,0,1321,A
2-PB1,1988,0,0,0,1320,1320,C
2-PB1,1989,1318,0,2,0,1320,A
2-PB1,1990,0,2,0,1319,1321,C
2-PB1,1991,1283,2,1,0,1286,A
2-PB1,1992,0,1,0,1381,1382,C
2-PB1,1993,0,1362,0,1,1363,T
2-PB1,1994,1,0,1,1361,1363,C
2-PB1,1995,0,1,0,1357,1358,C
2-PB1,1996,2,1354,0,2,1358,T
2-PB1,1997,0,0,1361,0,1361,G
2-PB1,1998,0,2,1352,0,1354,G
2-PB1,1999,1355,0,1,0,1356,A
2-PB1,2000,0,1351,0,0,1351,T
2-PB1,2001,0,1207,0,1,1208,T
2-PB1,2002,1,0,0,1222,1223,C
2-PB1,2003,0,0,0,1222,1222,C
2-PB1,2004,3,1,1,1220,1225,C
2-PB1,2005,1227,1,0,0,1228,A
2-PB1,2006,1222,0,2,0,1224,A
2-PB1,2007,0,0,1224,0,1224,G
2-PB1,2008,1217,0,3,0,1220,A
2-PB1,2009,0,1,1214,0,1215,G
2-PB1,2010,0,1,1215,0,1216,G
2-PB1,2011,1193,0,0,0,1193,A
2-PB1,2012,1195,0,3,0,1198,A
2-PB1,2013,0,1,0,1186,1187,C
2-PB1,2014,0,0,0,1187,1187,C
2-PB1,2015,0,0,1207,0,1207,G
2-PB1,2016,1,0,0,1204,1205,C
2-PB1,2017,0,1201,0,0,1201,T
2-PB1,2018,0,0,0,1211,1211,C
2-PB1,2019,0,1202,0,0,1202,T
2-PB1,2020,1275,0,0,0,1275,A
2-PB1,2021,1,1267,0,0,1268,T
2-PB1,2022,0,1267,0,1,1268,T
2-PB1,2023,1,0,0,1268,1269,C
2-PB1,2024,0,1229,0,1,1230,T
2-PB1,2025,1234,0,1,0,1235,A
2-PB1,2026,1231,1,0,0,1232,A
2-PB1,2027,1232,0,1,0,1233,A
2-PB1,2028,0,0,0,1235,1235,C
2-PB1,2029,1141,1,0,0,1142,A
2-PB1,2030,0,0,0,1139,1139,C
2-PB1,2031,1121,0,1,1,1123,A
2-PB1,2032,1133,0,1,1,1135,A
2-PB1,2033,1,1,1137,0,1139,G
2-PB1,2034,0,0,0,1136,1136,C
2-PB1,2035,1,0,0,1140,1141,C
2-PB1,2036,1132,1,0,0,1133,A
2-PB1,2037,1132,0,0,0,1132,A
2-PB1,2038,1132,0,0,0,1132,A
2-PB1,2039,0,2,1141,0,1143,G
2-PB1,2040,0,1,1142,0,1143,G
2-PB1,2041,1,0,1123,0,1124,G
2-PB1,2042,0,1,1118,0,1119,G
2-PB1,2043,1120,0,1,0,1121,A
2-PB1,2044,1121,1,1,0,1123,A
2-PB1,2045,0,1123,1,1,1125,T
2-PB1,2046,0,1127,0,0,1127,T
2-PB1,2047,1,0,0,1132,1133,C
2-PB1,2048,0,1121,0,2,1123,T
2-PB1,2049,0,1119,0,0,1119,T
2-PB1,2050,0,0,1117,0,1117,G
2-PB1,2051,1113,0,1,0,1114,A
2-PB1,2052,0,0,1120,0,1120,G
2-PB1,2053,0,0,1120,0,1120,G
2-PB1,2054,1114,1,0,1,1116,A
2-PB1,2055,0,1108,0,0,1108,T
2-PB1,2056,1,0,1115,0,1116,G
2-PB1,2057,1116,0,1,0,1117,A
2-PB1,2058,1112,0,1,0,1113,A
2-PB1,2059,0,0,0,1118,1118,C
2-PB1,2060,1103,0,0,0,1103,A
2-PB1,2061,0,0,1110,0,1110,G
2-PB1,2062,1102,0,1,0,1103,A
2-PB1,2063,0,1100,0,1,1101,T
2-PB1,2064,0,0,1105,0,1105,G
2-PB1,2065,0,1113,0,2,1115,T
2-PB1,2066,1114,0,2,0,1116,A
2-PB1,2067,0,0,0,1108,1108,C
2-PB1,2068,2,1,0,1106,1109,C
2-PB1,2069,1099,0,1,1,1101,A
2-PB1,2070,0,0,1092,0,1092,G
2-PB1,2071,1082,0,0,0,1082,A
2-PB1,2072,1075,1,0,1,1077,A
2-PB1,2073,0,0,1084,0,1084,G
2-PB1,2074,0,1021,0,3,1024,T
2-PB1,2075,1,0,1024,0,1025,G
2-PB1,2076,0,0,0,1025,1025,C
2-PB1,2077,0,1026,0,2,1028,T
2-PB1,2078,0,0,1027,0,1027,G
2-PB1,2079,0,1,1,1022,1024,C
2-PB1,2080,1024,0,0,0,1024,A
2-PB1,2081,1020,0,1,0,1021,A
2-PB1,2082,0,0,0,1009,1009,C
2-PB1,2083,0,1008,0,0,1008,T
2-PB1,2084,0,999,0,0,999,T
2-PB1,2085,0,0,995,0,995,G
2-PB1,2086,0,994,0,1,995,T
2-PB1,2087,0,991,0,1,992,T
2-PB1,2088,1,1,0,990,992,C
2-PB1,2089,0,1,996,0,997,G
2-PB1,2090,996,0,0,0,996,A
2-PB1,2091,0,0,995,0,995,G
2-PB1,2092,995,0,1,0,996,A
2-PB1,2093,994,0,0,0,994,A
2-PB1,2094,999,0,0,0,999,A
2-PB1,2095,1,992,0,0,993,T
2-PB1,2096,0,996,0,0,996,T
2-PB1,2097,0,998,0,0,998,T
2-PB1,2098,0,993,0,0,993,T
2-PB1,2099,0,990,1,1,992,T
2-PB1,2100,1,0,0,999,1000,C
2-PB1,2101,2,0,0,999,1001,C
2-PB1,2102,1,1,0,1005,1007,C
2-PB1,2103,0,999,0,3,1002,T
2-PB1,2104,1007,0,1,0,1008,A
2-PB1,2105,0,0,1010,0,1010,G
2-PB1,2106,0,1007,0,1,1008,T
2-PB1,2107,1009,0,1,1,1011,A
2-PB1,2108,0,0,1014,0,1014,G
2-PB1,2109,0,1000,0,1,1001,T
2-PB1,2110,0,1023,0,1,1024,T
2-PB1,2111,1,0,0,1030,1031,C
2-PB1,2112,1052,0,0,0,1052,A
2-PB1,2113,0,1052,0,1,1053,T
2-PB1,2114,1048,0,1,0,1049,A
2-PB1,2115,0,1049,0,0,1049,T
2-PB1,2116,1022,0,0,0,1022,A
2-PB1,2117,0,0,1018,0,1018,G
2-PB1,2118,0,0,1012,0,1012,G
2-PB1,2119,918,1,1,0,920,A
2-PB1,2120,0,0,914,0,914,G
2-PB1,2121,853,0,1,0,854,A
2-PB1,2122,0,1,0,850,851,C
2-PB1,2123,0,1,0,811,812,C
2-PB1,2124,0,0,814,0,814,G
2-PB1,2125,816,0,0,0,816,A
2-PB1,2126,0,813,0,1,814,T
2-PB1,2127,0,813,0,0,813,T
2-PB1,2128,0,0,813,0,813,G
2-PB1,2129,0,0,809,0,809,G
2-PB1,2130,810,0,1,0,811,A
2-PB1,2131,809,0,0,0,809,A
2-PB1,2132,0,807,0,1,808,T
2-PB1,2133,0,805,0,0,805,T
2-PB1,2134,0,802,0,1,803,T
2-PB1,2135,0,0,0,804,804,C
2-PB1,2136,0,805,0,0,805,T
2-PB1,2137,798,0,2,0,800,A
2-PB1,2138,2,0,800,0,802,G
2-PB1,2139,0,0,0,801,801,C
2-PB1,2140,801,0,0,0,801,A
2-PB1,2141,0,802,0,1,803,T
2-PB1,2142,0,1,787,0,788,G
2-PB1,2143,0,0,802,0,802,G
2-PB1,2144,0,796,1,0,797,T
2-PB1,2145,0,0,795,0,795,G
2-PB1,2146,0,0,795,0,795,G
2-PB1,2147,785,0,1,0,786,A
2-PB1,2148,0,0,784,0,784,G
2-PB1,2149,0,0,786,0,786,G
2-PB1,2150,0,1,1,777,779,C
2-PB1,2151,0,1,0,778,779,C
2-PB1,2152,718,0,1,0,719,A
2-PB1,2153,0,716,0,0,716,T
2-PB1,2154,0,0,720,0,720,G
2-PB1,2155,0,0,726,0,726,G
2-PB1,2156,0,708,0,1,709,T
2-PB1,2157,0,0,716,0,716,G
2-PB1,2158,0,698,0,0,698,T
2-PB1,2159,0,0,1,689,690,C
2-PB1,2160,0,688,0,0,688,T
2-PB1,2161,679,0,0,0,679,A
2-PB1,2162,0,0,678,0,678,G
2-PB1,2163,0,0,662,0,662,G
2-PB1,2164,0,1,659,0,660,G
2-PB1,2165,0,0,0,650,650,C
2-PB1,2166,1,0,0,619,620,C
2-PB1,2167,0,0,0,611,611,C
2-PB1,2168,0,0,609,0,609,G
2-PB1,2169,0,0,612,0,612,G
2-PB1,2170,612,1,0,0,613,A
2-PB1,2171,0,612,0,0,612,T
2-PB1,2172,0,596,0,0,596,T
2-PB1,2173,0,0,591,0,591,G
2-PB1,2174,586,1,1,0,588,A
2-PB1,2175,0,589,0,0,589,T
2-PB1,2176,0,0,588,0,588,G
2-PB1,2177,0,0,0,588,588,C
2-PB1,2178,0,0,0,587,587,C
2-PB1,2179,582,0,0,0,582,A
2-PB1,2180,0,0,581,0,581,G
2-PB1,2181,582,0,0,0,582,A
2-PB1,2182,583,0,0,0,583,A
2-PB1,2183,0,584,0,0,584,T
2-PB1,2184,0,572,0,0,572,T
2-PB1,2185,0,0,571,0,571,G
2-PB1,2186,567,0,2,0,569,A
2-PB1,2187,0,0,0,570,570,C
2-PB1,2188,0,568,0,0,568,T
2-PB1,2189,0,564,0,0,564,T
2-PB1,2190,0,0,0,564,564,C
2-PB1,2191,0,0,565,0,565,G
2-PB1,2192,563,0,0,0,563,A
2-PB1,2193,0,1,552,0,553,G
2-PB1,2194,0,555,0,0,555,T
2-PB1,2195,2,0,0,555,557,C
2-PB1,2196,0,554,0,1,555,T
2-PB1,2197,0,0,557,0,557,G
2-PB1,2198,0,1,555,0,556,G
2-PB1,2199,557,0,0,0,557,A
2-PB1,2200,524,0,0,0,524,A
2-PB1,2201,0,0,530,0,530,G
2-PB1,2202,0,1,530,0,531,G
2-PB1,2203,532,0,0,0,532,A
2-PB1,2204,0,526,0,0,526,T
2-PB1,2205,1,530,0,0,531,T
2-PB1,2206,530,0,0,0,530,A
2-PB1,2207,528,0,0,0,528,A
2-PB1,2208,0,0,528,0,528,G
2-PB1,2209,524,0,2,0,526,A
2-PB1,2210,498,0,1,0,499,A
2-PB1,2211,1,0,462,0,463,G
2-PB1,2212,0,0,460,0,460,G
2-PB1,2213,459,0,0,0,459,A
2-PB1,2214,454,0,3,0,457,A
2-PB1,2215,0,0,458,0,458,G
2-PB1,2216,427,1,0,0,428,A
2-PB1,2217,0,0,428,0,428,G
2-PB1,2218,0,414,0,0,414,T
2-PB1,2219,0,413,0,0,413,T
2-PB1,2220,1,1,0,412,414,C
2-PB1,2221,0,397,0,0,397,T
2-PB1,2222,1,0,1,395,397,C
2-PB1,2223,1,396,0,0,397,T
2-PB1,2224,0,0,395,0,395,G
2-PB1,2225,382,0,0,0,382,A
2-PB1,2226,0,0,374,0,374,G
2-PB1,2227,370,0,0,0,370,A
2-PB1,2228,0,358,0,0,358,T
2-PB1,2229,0,0,0,350,350,C
2-PB1,2230,351,0,1,0,352,A
2-PB1,2231,0,349,1,0,350,T
2-PB1,2232,0,0,349,0,349,G
2-PB1,2233,348,0,1,0,349,A
2-PB1,2234,347,0,0,0,347,A
2-PB1,2235,0,0,343,0,343,G
2-PB1,2236,335,0,0,0,335,A
2-PB1,2237,0,332,0,0,332,T
2-PB1,2238,0,0,0,323,323,C
2-PB1,2239,0,301,0,0,301,T
2-PB1,2240,0,0,301,0,301,G
2-PB1,2241,0,297,0,1,298,T
2-PB1,2242,0,297,1,1,299,T
2-PB1,2243,1,0,0,296,297,C
2-PB1,2244,0,0,0,281,281,C
2-PB1,2245,279,0,0,0,279,A
2-PB1,2246,1,0,0,277,278,C
2-PB1,2247,0,1,0,257,258,C
2-PB1,2248,256,0,0,0,256,A
2-PB1,2249,1,243,0,1,245,T
2-PB1,2250,0,235,0,0,235,T
2-PB1,2251,0,0,235,0,235,G
2-PB1,2252,235,0,0,0,235,A
2-PB1,2253,235,0,0,0,235,A
2-PB1,2254,0,0,234,0,234,G
2-PB1,2255,211,0,0,0,211,A
2-PB1,2256,211,0,0,0,211,A
2-PB1,2257,0,0,0,208,208,C
2-PB1,2258,0,201,0,0,201,T
2-PB1,2259,1,0,0,201,202,C
2-PB1,2260,198,0,0,0,198,A
2-PB1,2261,0,0,198,0,198,G
2-PB1,2262,198,0,0,0,198,A
2-PB1,2263,0,0,0,192,192,C
2-PB1,2264,0,0,192,0,192,G
2-PB1,2265,0,0,191,0,191,G
2-PB1,2266,0,0,0,191,191,C
2-PB1,2267,190,0,1,0,191,A
2-PB1,2268,190,0,0,0,190,A
2-PB1,2269,189,0,0,0,189,A
2-PB1,2270,187,0,0,0,187,A
2-PB1,2271,185,0,0,0,185,A
2-PB1,2272,0,180,0,0,180,T
2-PB1,2273,167,0,0,0,167,A
2-PB1,2274,167,0,0,0,167,A
3-PA,1,107,0,0,0,107,A
3-PA,2,0,107,0,0,107,T
3-PA,3,0,0,116,0,116,G
3-PA,4,0,0,117,0,117,G
3-PA,5,116,0,0,0,116,A
3-PA,6,115,0,1,0,116,A
3-PA,7,1,0,115,0,116,G
3-PA,8,127,0,0,0,127,A
3-PA,9,0,128,0,0,128,T
3-PA,10,0,128,0,0,128,T
3-PA,11,0,133,0,0,133,T
3-PA,12,0,133,0,0,133,T
3-PA,13,0,0,136,0,136,G
3-PA,14,0,136,0,0,136,T
3-PA,15,0,1,136,0,137,G
3-PA,16,0,0,0,138,138,C
3-PA,17,0,0,138,0,138,G
3-PA,18,148,1,2,1,152,A
3-PA,19,0,0,0,152,152,C
3-PA,20,153,0,0,0,153,A
3-PA,21,154,0,0,0,154,A
3-PA,22,0,160,0,1,161,T
3-PA,23,0,0,193,0,193,G
3-PA,24,0,0,0,199,199,C
3-PA,25,0,196,0,1,197,T
3-PA,26,0,198,0,0,198,T
3-PA,27,1,0,0,197,198,C
3-PA,28,203,0,0,0,203,A
3-PA,29,204,0,1,0,205,A
3-PA,30,0,1,0,207,208,C
3-PA,31,0,0,0,209,209,C
3-PA,32,0,1,0,206,207,C
3-PA,33,1,0,211,0,212,G
3-PA,34,212,0,0,0,212,A
3-PA,35,0,213,0,0,213,T
3-PA,36,0,0,214,0,214,G
3-PA,37,216,0,0,0,216,A
3-PA,38,1,218,0,0,219,T
3-PA,39,0,217,0,2,219,T
3-PA,40,0,0,218,0,218,G
3-PA,41,0,219,0,0,219,T
3-PA,42,0,0,0,219,219,C
3-PA,43,1,0,218,0,219,G
3-PA,44,220,0,0,0,220,A
3-PA,45,220,0,0,0,220,A
3-PA,46,0,0,0,220,220,C
3-PA,47,1,220,0,0,221,T
3-PA,48,0,221,0,0,221,T
3-PA,49,0,0,221,0,221,G
3-PA,50,0,0,0,224,224,C
3-PA,51,224,0,0,0,224,A
3-PA,52,0,0,224,0,224,G
3-PA,53,224,0,0,0,224,A
3-PA,54,224,0,0,0,224,A
3-PA,55,224,0,0,0,224,A
3-PA,56,224,0,0,0,224,A
3-PA,57,224,0,0,0,224,A
3-PA,58,0,0,226,0,226,G
3-PA,59,0,0,0,236,236,C
3-PA,60,237,0,0,0,237,A
3-PA,61,251,0,0,0,251,A
3-PA,62,0,254,0,0,254,T
3-PA,63,0,0,261,0,261,G
3-PA,64,261,0,0,0,261,A
3-PA,65,263,0,0,0,263,A
3-PA,66,266,0,2,0,268,A
3-PA,67,0,0,287,0,287,G
3-PA,68,307,0,0,0,307,A
3-PA,69,0,0,355,0,355,G
3-PA,70,0,353,0,1,354,T
3-PA,71,357,0,0,0,357,A
3-PA,72,0,357,0,0,357,T
3-PA,73,1,1,355,0,357,G
3-PA,74,1,2,357,0,360,G
3-PA,75,0,0,360,0,360,G
3-PA,76,0,0,358,0,358,G
3-PA,77,355,0,0,0,355,A
3-PA,78,0,0,350,0,350,G
3-PA,79,0,0,357,0,357,G
3-PA,80,355,0,0,0,355,A
3-PA,81,0,360,0,0,360,T
3-PA,82,0,0,0,358,358,C
3-PA,83,0,359,0,0,359,T
3-PA,84,0,0,359,0,359,G
3-PA,85,360,0,0,0,360,A
3-PA,86,360,0,0,0,360,A
3-PA,87,360,0,0,0,360,A
3-PA,88,362,0,0,0,362,A
3-PA,89,0,361,0,0,361,T
3-PA,90,0,359,0,0,359,T
3-PA,91,0,0,359,0,359,G
3-PA,92,360,0,1,0,361,A
3-PA,93,360,0,0,0,360,A
3-PA,94,359,0,1,0,360,A
3-PA,95,0,0,0,361,361,C
3-PA,96,363,0,0,0,363,A
3-PA,97,364,0,0,0,364,A
3-PA,98,366,0,1,0,367,A
3-PA,99,1,1,0,370,372,C
3-PA,100,371,0,0,0,371,A
3-PA,101,374,0,0,0,374,A
3-PA,102,377,0,1,0,378,A
3-PA,103,0,378,0,0,378,T
3-PA,104,0,379,0,0,379,T
3-PA,105,0,375,0,1,376,T
3-PA,106,0,0,379,0,379,G
3-PA,107,0,1,0,381,382,C
3-PA,108,381,0,2,0,383,A
3-PA,109,0,0,397,0,397,G
3-PA,110,0,0,0,398,398,C
3-PA,111,417,0,0,0,417,A
3-PA,112,426,0,0,0,426,A
3-PA,113,0,430,0,0,430,T
3-PA,114,443,0,0,0,443,A
3-PA,115,0,444,0,0,444,T
3-PA,116,0,0,450,0,450,G
3-PA,117,0,0,0,449,449,C
3-PA,118,448,0,0,0,448,A
3-PA,119,0,0,0,454,454,C
3-PA,120,0,450,0,1,451,T
3-PA,121,1,0,0,577,578,C
3-PA,122,592,0,0,0,592,A
3-PA,123,0,0,0,598,598,C
3-PA,124,0,598,0,0,598,T
3-PA,125,0,597,0,1,598,T
3-PA,126,0,0,600,0,600,G
3-PA,127,0,0,604,0,604,G
3-PA,128,602,0,2,0,604,A
3-PA,129,0,1,620,0,621,G
3-PA,130,0,0,620,0,620,G
3-PA,131,1,603,0,1,605,T
3-PA,132,0,0,621,0,621,G
3-PA,133,0,622,0,0,622,T
3-PA,134,0,0,634,0,634,G
3-PA,135,0,637,0,0,637,T
3-PA,136,0,635,0,0,635,T
3-PA,137,0,635,0,0,635,T
3-PA,138,1,0,0,640,641,C
3-PA,139,641,1,0,0,642,A
3-PA,140,0,644,0,0,644,T
3-PA,141,0,0,659,0,659,G
3-PA,142,0,654,0,0,654,T
3-PA,143,662,0,0,0,662,A
3-PA,144,0,661,0,1,662,T
3-PA,145,0,659,0,1,660,T
3-PA,146,0,0,0,665,665,C
3-PA,147,664,0,0,0,664,A
3-PA,148,0,0,673,0,673,G
3-PA,149,671,0,2,0,673,A
3-PA,150,0,670,0,0,670,T
3-PA,151,2,665,0,1,668,T
3-PA,152,0,666,0,1,667,T
3-PA,153,0,0,0,665,665,C
3-PA,154,0,0,0,683,683,C
3-PA,155,685,0,0,0,685,A
3-PA,156,0,687,0,0,687,T
3-PA,157,0,681,0,1,682,T
3-PA,158,0,689,0,0,689,T
3-PA,159,0,0,0,689,689,C
3-PA,160,684,0,4,0,688,A
3-PA,161,0,714,0,0,714,T
3-PA,162,2,2,0,712,716,C
3-PA,163,715,0,0,0,715,A
3-PA,164,717,0,0,0,717,A
3-PA,165,0,715,0,0,715,T
3-PA,166,0,2,747,0,749,G
3-PA,167,750,0,0,0,750,A
3-PA,168,747,0,1,0,748,A
3-PA,169,0,0,0,748,748,C
3-PA,170,745,0,0,0,745,A
3-PA,171,754,0,1,0,755,A
3-PA,172,0,1,753,0,754,G
3-PA,173,1,0,751,0,752,G
3-PA,174,0,0,0,759,759,C
3-PA,175,0,1,759,0,760,G
3-PA,176,796,0,1,0,797,A
3-PA,177,804,0,0,0,804,A
3-PA,178,0,806,0,0,806,T
3-PA,179,0,0,0,819,819,C
3-PA,180,817,0,0,0,817,A
3-PA,181,822,0,1,0,823,A
3-PA,182,0,826,0,0,826,T
3-PA,183,827,0,0,0,827,A
3-PA,184,2,0,850,0,852,G
3-PA,185,0,851,0,2,853,T
3-PA,186,0,0,856,0,856,G
3-PA,187,0,0,859,0,859,G
3-PA,188,0,857,0,0,857,T
3-PA,189,855,0,0,0,855,A
3-PA,190,0,1,858,0,859,G
3-PA,191,862,0,1,0,863,A
3-PA,192,866,0,0,0,866,A
3-PA,193,0,0,0,867,867,C
3-PA,194,0,860,0,0,860,T
3-PA,195,0,854,0,0,854,T
3-PA,196,0,0,858,0,858,G
3-PA,197,856,0,0,0,856,A
3-PA,198,0,0,0,857,857,C
3-PA,199,0,0,851,0,851,G
3-PA,200,880,0,0,0,880,A
3-PA,201,0,887,0,2,889,T
3-PA,202,0,0,0,892,892,C
3-PA,203,0,0,0,900,900,C
3-PA,204,902,1,0,0,903,A
3-PA,205,902,0,0,0,902,A
3-PA,206,903,0,0,0,903,A
3-PA,207,1,900,0,0,901,T
3-PA,208,0,0,906,0,906,G
3-PA,209,0,0,0,903,903,C
3-PA,210,893,0,1,0,894,A
3-PA,211,0,0,0,922,922,C
3-PA,212,0,919,0,0,919,T
3-PA,213,1,0,1021,0,1022,G
3-PA,214,0,1022,0,1,1023,T
3-PA,215,1,1019,0,1,1021,T
3-PA,216,1018,2,1,1,1022,A
3-PA,217,1023,0,0,0,1023,A
3-PA,218,1022,0,1,0,1023,A
3-PA,219,1,1,1025,0,1027,G
3-PA,220,0,1,0,1015,1016,C
3-PA,221,1010,0,0,0,1010,A
3-PA,222,0,0,0,1009,1009,C
3-PA,223,964,1,0,0,965,A
3-PA,224,0,0,1005,0,1005,G
3-PA,225,1002,1,1,0,1004,A
3-PA,226,0,998,0,0,998,T
3-PA,227,0,1002,0,0,1002,T
3-PA,228,0,1003,0,2,1005,T
3-PA,229,0,0,1008,0,1008,G
3-PA,230,1009,0,0,0,1009,A
3-PA,231,1005,1,3,0,1009,A
3-PA,232,1008,0,1,0,1009,A
3-PA,233,0,987,0,0,987,T
3-PA,234,979,0,0,0,979,A
3-PA,235,992,0,0,0,992,A
3-PA,236,0,991,0,0,991,T
3-PA,237,0,1,0,996,997,C
3-PA,238,0,0,992,0,992,G
3-PA,239,995,0,0,0,995,A
3-PA,240,0,3,997,0,1000,G
3-PA,241,0,1,1015,0,1016,G
3-PA,242,0,1,1012,0,1013,G
3-PA,243,0,1,1019,0,1020,G
3-PA,244,1015,0,0,0,1015,A
3-PA,245,0,1,1017,0,1018,G
3-PA,246,1049,0,0,0,1049,A
3-PA,247,0,1,1054,0,1055,G
3-PA,248,1052,0,1,0,1053,A
3-PA,249,0,0,0,1056,1056,C
3-PA,250,1044,0,2,0,1046,A
3-PA,251,2,1,1062,0,1065,G
3-PA,252,1066,0,1,0,1067,A
3-PA,253,1076,0,1,0,1077,A
3-PA,254,0,0,0,1076,1076,C
3-PA,255,1049,0,0,0,1049,A
3-PA,256,1047,0,0,0,1047,A
3-PA,257,0,1050,0,0,1050,T
3-PA,258,1,1,1085,0,1087,G
3-PA,259,1,0,1088,0,1089,G
3-PA,260,0,0,0,1085,1085,C
3-PA,261,0,0,0,1087,1087,C
3-PA,262,0,1086,0,0,1086,T
3-PA,263,0,0,1129,0,1129,G
3-PA,264,1,0,1128,0,1129,G
3-PA,265,1127,0,4,0,1131,A
3-PA,266,0,0,0,1135,1135,C
3-PA,267,1110,0,1,0,1111,A
3-PA,268,0,0,1248,0,1248,G
3-PA,269,0,1248,1,0,1249,T
3-PA,270,1270,0,0,0,1270,A
3-PA,271,1,0,1272,0,1273,G
3-PA,272,0,1265,0,0,1265,T
3-PA,273,1268,0,0,1,1269,A
3-PA,274,1270,0,0,1,1271,A
3-PA,275,1265,0,1,1,1267,A
3-PA,276,0,0,0,1282,1282,C
3-PA,277,1203,0,0,0,1203,A
3-PA,278,0,1,1224,0,1225,G
3-PA,279,0,1219,0,1,1220,T
3-PA,280,1231,0,0,0,1231,A
3-PA,281,0,1227,0,1,1228,T
3-PA,282,0,0,0,1247,1247,C
3-PA,283,0,1249,0,0,1249,T
3-PA,284,1,0,1244,0,1245,G
3-PA,285,0,0,0,1245,1245,C
3-PA,286,1240,0,2,0,1242,A
3-PA,287,1234,0,5,0,1239,A
3-PA,288,0,0,0,1240,1240,C
3-PA,289,1232,0,0,0,1232,A
3-PA,290,0,2,0,1286,1288,C
3-PA,291,0,1274,0,1,1275,T
3-PA,292,1279,0,0,0,1279,A
3-PA,293,0,0,0,1279,1279,C
3-PA,294,1,1271,0,1,1273,T
3-PA,295,0,0,1275,0,1275,G
3-PA,296,1,0,1272,0,1273,G
3-PA,297,1267,0,0,0,1267,A
3-PA,298,0,0,1266,0,1266,G
3-PA,299,0,0,0,1229,1229,C
3-PA,300,0,1223,0,1,1224,T
3-PA,301,0,0,1218,0,1218,G
3-PA,302,0,0,1218,0,1218,G
3-PA,303,0,0,1215,1,1216,G
3-PA,304,1214,0,2,1,1217,A
3-PA,305,1214,0,0,0,1214,A
3-PA,306,1219,0,1,0,1220,A
3-PA,307,0,1,0,1223,1224,C
3-PA,308,1,1,0,1224,1226,C
3-PA,309,0,0,1224,0,1224,G
3-PA,310,1219,0,1,0,1220,A
3-PA,311,1220,0,1,0,1221,A
3-PA,312,0,0,1229,0,1229,G
3-PA,313,0,1226,0,0,1226,T
3-PA,314,0,1228,0,0,1228,T
3-PA,315,0,1226,0,1,1227,T
3-PA,316,1,1,0,1227,1229,C
3-PA,317,0,1232,0,1,1233,T
3-PA,318,1234,0,0,0,1234,A
3-PA,319,0,0,0,1228,1228,C
3-PA,320,0,0,0,1232,1232,C
3-PA,321,1227,0,0,1,1228,A
3-PA,322,0,0,1249,0,1249,G
3-PA,323,1246,0,2,0,1248,A
3-PA,324,0,1247,0,0,1247,T
3-PA,325,0,1249,0,1,1250,T
3-PA,326,0,1249,0,0,1249,T
3-PA,327,1,0,1256,0,1257,G
3-PA,328,0,1257,1,0,1258,T
3-PA,329,1256,1,0,0,1257,A
3-PA,330,0,1256,0,1,1257,T
3-PA,331,0,0,1244,2,1246,G
3-PA,332,1289,0,0,0,1289,A
3-PA,333,0,1281,0,1,1282,T
3-PA,334,2,1281,0,0,1283,T
3-PA,335,1280,1,2,0,1283,A
3-PA,336,1,2,0,1277,1280,C
3-PA,337,1283,0,1,0,1284,A
3-PA,338,1279,0,2,0,1281,A
3-PA,339,1,0,1283,0,1284,G
3-PA,340,0,0,1285,0,1285,G
3-PA,341,1235,0,0,0,1235,A
3-PA,342,0,0,1246,0,1246,G
3-PA,343,1246,0,0,0,1246,A
3-PA,344,1239,0,2,0,1241,A
3-PA,345,0,0,0,1243,1243,C
3-PA,346,1224,0,0,0,1224,A
3-PA,347,0,1,1231,0,1232,G
3-PA,348,1230,0,1,0,1231,A
3-PA,349,0,1210,1,1,1212,T
3-PA,350,0,1209,0,0,1209,T
3-PA,351,0,1,0,1191,1192,C
3-PA,352,1193,0,1,0,1194,A
3-PA,353,0,1190,0,1,1191,T
3-PA,354,0,0,0,1189,1189,C
3-PA,355,1,1,1190,0,1192,G
3-PA,356,1189,1,0,0,1190,A
3-PA,357,1188,0,2,0,1190,A
3-PA,358,1186,0,1,1,1188,A
3-PA,359,0,1188,0,0,1188,T
3-PA,360,1,1186,0,1,1188,T
3-PA,361,0,1,1186,0,1187,G
3-PA,362,1,1,1186,0,1188,G
3-PA,363,0,0,1191,0,1191,G
3-PA,364,0,0,1197,0,1197,G
3-PA,365,0,1179,0,1,1180,T
3-PA,366,0,1,1195,0,1196,G
3-PA,367,1195,1,2,0,1198,A
3-PA,368,0,2,0,1194,1196,C
3-PA,369,1203,0,0,0,1203,A
3-PA,370,1199,0,1,1,1201,A
3-PA,371,0,1,1226,0,1227,G
3-PA,372,0,0,1226,0,1226,G
3-PA,373,1220,0,2,0,1222,A
3-PA,374,0,0,1229,0,1229,G
3-PA,375,1217,0,1,0,1218,A
3-PA,376,0,1,1218,0,1219,G
3-PA,377,1205,0,3,0,1208,A
3-PA,378,1204,0,1,0,1205,A
3-PA,379,0,0,1232,0,1232,G
3-PA,380,0,1207,0,0,1207,T
3-PA,381,1,1,0,1215,1217,C
3-PA,382,2,0,0,1213,1215,C
3-PA,383,1218,0,1,0,1219,A
3-PA,384,0,0,0,1243,1243,C
3-PA,385,1272,0,0,0,1272,A
3-PA,386,1,1291,0,0,1292,T
3-PA,387,1326,0,0,0,1326,A
3-PA,388,1,1292,0,1,1294,T
3-PA,389,1291,0,1,0,1292,A
3-PA,390,0,1272,1,0,1273,T
3-PA,391,0,1268,0,0,1268,T
3-PA,392,1312,0,1,0,1313,A
3-PA,393,0,0,0,1304,1304,C
3-PA,394,0,1,0,1262,1263,C
3-PA,395,0,1233,0,4,1237,T
3-PA,396,0,1214,0,2,1216,T
3-PA,397,0,1,1218,0,1219,G
3-PA,398,1209,0,3,0,1212,A
3-PA,399,0,0,1142,0,1142,G
3-PA,400,1146,0,1,0,1147,A
3-PA,401,1145,0,2,0,1147,A
3-PA,402,0,0,1163,0,1163,G
3-PA,403,0,0,1162,0,1162,G
3-PA,404,0,1,0,1163,1164,C
3-PA,405,1,2,0,1161,1164,C
3-PA,406,1166,1,1,0,1168,A
3-PA,407,1168,1,1,0,1170,A
3-PA,408,1,1165,0,1,1167,T
3-PA,409,1169,0,2,0,1171,A
3-PA,410,1170,0,1,0,1171,A
3-PA,411,0,0,1175,0,1175,G
3-PA,412,1166,0,0,0,1166,A
3-PA,413,0,1164,0,1,1165,T
3-PA,414,0,1163,0,0,1163,T
3-PA,415,1166,0,1,0,1167,A
3-PA,416,1168,0,1,0,1169,A
3-PA,417,1172,0,1,0,1173,A
3-PA,418,1,1176,0,0,1177,T
3-PA,419,0,0,0,1179,1179,C
3-PA,420,1,1148,0,2,1151,T
3-PA,421,0,1,1155,0,1156,G
3-PA,422,1154,0,1,0,1155,A
3-PA,423,1,0,1161,0,1162,G
3-PA,424,1162,0,0,0,1162,A
3-PA,425,1163,0,1,0,1164,A
3-PA,426,0,1,0,1161,1162,C
3-PA,427,1156,0,1,0,1157,A
3-PA,428,0,2,0,1164,1166,C
3-PA,429,1164,0,0,0,1164,A
3-PA,430,0,0,0,1177,1177,C
3-PA,431,1167,0,2,0,1169,A
3-PA,432,0,1,0,1184,1185,C
3-PA,433,1180,0,0,0,1180,A
3-PA,434,0,1164,0,0,1164,T
3-PA,435,0,1159,0,0,1159,T
3-PA,436,1,0,0,1164,1165,C
3-PA,437,1161,0,2,0,1163,A
3-PA,438,0,0,0,1169,1169,C
3-PA,439,1156,0,0,0,1156,A
3-PA,440,0,1155,0,0,1155,T
3-PA,441,0,1126,0,2,1128,T
3-PA,442,0,1137,0,0,1137,T
3-PA,443,0,1138,0,0,1138,T
3-PA,444,0,0,0,1141,1141,C
3-PA,445,1,1133,0,1,1135,T
3-PA,446,0,1,0,1137,1138,C
3-PA,447,1138,0,0,0,1138,A
3-PA,448,0,1137,0,0,1137,T
3-PA,449,1,1140,0,0,1141,T
3-PA,450,2,0,0,1146,1148,C
3-PA,451,1135,1,0,0,1136,A
3-PA,452,0,0,0,1143,1143,C
3-PA,453,0,1143,0,0,1143,T
3-PA,454,0,0,1141,0,1141,G
3-PA,455,0,0,1140,0,1140,G
3-PA,456,1125,1,0,0,1126,A
3-PA,457,0,2,1143,0,1145,G
3-PA,458,1145,0,2,0,1147,A
3-PA,459,0,0,1162,0,1162,G
3-PA,460,1,0,1162,0,1163,G
3-PA,461,1150,0,0,0,1150,A
3-PA,462,1154,0,0,0,1154,A
3-PA,463,1136,0,1,1,1138,A
3-PA,464,0,1122,0,0,1122,T
3-PA,465,0,0,1123,0,1123,G
3-PA,466,0,0,1115,1,1116,G
3-PA,467,2,1,0,1119,1122,C
3-PA,468,0,1,0,1115,1116,C
3-PA,469,1110,0,0,1,1111,A
3-PA,470,0,0,0,1118,1118,C
3-PA,471,1118,1,0,0,1119,A
3-PA,472,1119,0,1,0,1120,A
3-PA,473,1116,0,0,0,1116,A
3-PA,474,0,0,1124,0,1124,G
3-PA,475,2,0,1122,0,1124,G
3-PA,476,1,0,0,1123,1124,C
3-PA,477,1122,0,2,0,1124,A
3-PA,478,0,3,1126,0,1129,G
3-PA,479,1130,0,2,0,1132,A
3-PA,480,0,1,0,1137,1138,C
3-PA,481,0,1139,0,0,1139,T
3-PA,482,1133,0,1,0,1134,A
3-PA,483,0,0,1,1127,1128,C
3-PA,484,1121,0,0,0,1121,A
3-PA,485,0,1,0,1123,1124,C
3-PA,486,1,1090,0,2,1093,T
3-PA,487,0,0,0,1107,1107,C
3-PA,488,0,1105,0,0,1105,T
3-PA,489,1,0,0,1089,1090,C
3-PA,490,0,2,1089,0,1091,G
3-PA,491,1087,0,1,0,1088,A
3-PA,492,0,0,1,1084,1085,C
3-PA,493,1,0,1085,0,1086,G
3-PA,494,1073,0,3,0,1076,A
3-PA,495,0,1,1082,0,1083,G
3-PA,496,0,0,1080,0,1080,G
3-PA,497,1076,0,1,0,1077,A
3-PA,498,1075,0,4,0,1079,A
3-PA,499,1080,0,1,0,1081,A
3-PA,500,1,0,1079,0,1080,G
3-PA,501,0,0,0,1078,1078,C
3-PA,502,1072,0,1,0,1073,A
3-PA,503,0,0,1084,0,1084,G
3-PA,504,0,0,1088,0,1088,G
3-PA,505,1,0,1088,0,1089,G
3-PA,506,1,0,0,1087,1088,C
3-PA,507,1,1077,0,0,1078,T
3-PA,508,1076,1,1,0,1078,A
3-PA,509,0,0,1095,0,1095,G
3-PA,510,0,2,1132,0,1134,G
3-PA,511,1141,0,1,0,1142,A
3-PA,512,0,1115,0,0,1115,T
3-PA,513,0,1099,0,1,1100,T
3-PA,514,1094,0,0,0,1094,A
3-PA,515,1103,0,1,0,1104,A
3-PA,516,0,5,1105,0,1110,G
3-PA,517,1100,0,0,0,1100,A
3-PA,518,1,0,0,1103,1104,C
3-PA,519,1,0,0,1022,1023,C
3-PA,520,1015,0,1,0,1016,A
3-PA,521,0,0,1020,0,1020,G
3-PA,522,0,0,1021,0,1021,G
3-PA,523,0,0,0,1022,1022,C
3-PA,524,0,987,2,1,990,T
3-PA,525,0,1,999,0,1000,G
3-PA,526,0,996,1,0,997,T
3-PA,527,0,998,0,0,998,T
3-PA,528,0,1000,0,0,1000,T
3-PA,529,996,0,1,0,997,A
3-PA,530,0,0,0,1024,1024,C
3-PA,531,1,0,0,1007,1008,C
3-PA,532,1001,0,1,0,1002,A
3-PA,533,0,994,0,0,994,T
3-PA,534,967,0,1,0,968,A
3-PA,535,973,0,0,0,973,A
3-PA,536,0,2,979,0,981,G
3-PA,537,983,0,0,0,983,A
3-PA,538,0,0,0,982,982,C
3-PA,539,951,0,0,0,951,A
3-PA,540,948,0,0,0,948,A
3-PA,541,1,0,949,0,950,G
3-PA,542,952,0,0,0,952,A
3-PA,543,951,0,0,0,951,A
3-PA,544,940,0,1,0,941,A
3-PA,545,0,915,0,0,915,T
3-PA,546,0,0,929,0,929,G
3-PA,547,0,0,930,0,930,G
3-PA,548,0,0,0,923,923,C
3-PA,549,1,0,0,928,929,C
3-PA,550,924,0,1,0,925,A
3-PA,551,939,0,1,0,940,A
3-PA,552,0,0,0,940,940,C
3-PA,553,936,0,0,0,936,A
3-PA,554,0,0,935,0,935,G
3-PA,555,913,0,4,0,917,A
3-PA,556,0,0,941,0,941,G
3-PA,557,0,0,946,0,946,G
3-PA,558,0,0,1,935,936,C
3-PA,559,0,0,0,936,936,C
3-PA,560,0,899,0,1,900,T
3-PA,561,893,0,2,0,895,A
3-PA,562,0,908,0,1,909,T
3-PA,563,0,0,908,0,908,G
3-PA,564,0,0,910,0,910,G
3-PA,565,0,1,886,0,887,G
3-PA,566,867,0,0,0,867,A
3-PA,567,1,860,0,0,861,T
3-PA,568,0,852,0,0,852,T
3-PA,569,0,0,0,922,922,C
3-PA,570,0,0,0,912,912,C
3-PA,571,0,893,0,0,893,T
3-PA,572,1,891,0,0,892,T
3-PA,573,0,889,0,0,889,T
3-PA,574,0,0,0,890,890,C
3-PA,575,0,0,896,0,896,G
3-PA,576,0,893,0,1,894,T
3-PA,577,1,0,0,894,895,C
3-PA,578,870,0,0,0,870,A
3-PA,579,0,0,951,0,951,G
3-PA,580,0,951,0,1,952,T
3-PA,581,0,0,0,954,954,C
3-PA,582,0,1,0,956,957,C
3-PA,583,1,2,958,1,962,G
3-PA,584,958,0,0,3,961,A
3-PA,585,957,0,0,0,957,A
3-PA,586,960,1,1,0,962,A
3-PA,587,0,1,968,0,969,G
3-PA,588,934,0,2,0,936,A
3-PA,589,0,0,947,0,947,G
3-PA,590,1,0,946,0,947,G
3-PA,591,0,0,0,949,949,C
3-PA,592,0,0,948,0,948,G
3-PA,593,943,0,3,0,946,A
3-PA,594,952,0,1,0,953,A
3-PA,595,0,1,956,0,957,G
3-PA,596,952,1,0,0,953,A
3-PA,597,951,0,1,0,952,A
3-PA,598,951,0,0,0,951,A
3-PA,599,0,2,0,956,958,C
3-PA,600,957,0,0,0,957,A
3-PA,601,960,0,0,0,960,A
3-PA,602,0,960,0,0,960,T
3-PA,603,0,960,0,0,960,T
3-PA,604,0,1,953,0,954,G
3-PA,605,949,0,1,0,950,A
3-PA,606,951,0,0,0,951,A
3-PA,607,0,1,951,0,952,G
3-PA,608,946,0,2,0,948,A
3-PA,609,949,0,0,0,949,A
3-PA,610,948,0,0,1,949,A
3-PA,611,952,0,0,0,952,A
3-PA,612,953,0,0,0,953,A
3-PA,613,0,955,0,0,955,T
3-PA,614,0,952,1,0,953,T
3-PA,615,0,952,0,1,953,T
3-PA,616,0,0,953,0,953,G
3-PA,617,952,0,1,0,953,A
3-PA,618,951,0,0,0,951,A
3-PA,619,954,0,0,0,954,A
3-PA,620,0,972,1,0,973,T
3-PA,621,0,0,0,1038,1038,C
3-PA,622,1035,0,1,0,1036,A
3-PA,623,1,0,0,1047,1048,C
3-PA,624,1038,1,4,0,1043,A
3-PA,625,0,0,1055,1,1056,G
3-PA,626,0,2,1086,0,1088,G
3-PA,627,1104,0,0,0,1104,A
3-PA,628,1108,0,0,0,1108,A
3-PA,629,1,1,0,1112,1114,C
3-PA,630,0,1068,0,0,1068,T
3-PA,631,1148,0,0,0,1148,A
3-PA,632,0,1150,0,1,1151,T
3-PA,633,0,0,1176,0,1176,G
3-PA,634,0,1,0,1166,1167,C
3-PA,635,3,0,1153,0,1156,G
3-PA,636,0,1145,0,3,1148,T
3-PA,637,1142,0,1,0,1143,A
3-PA,638,0,1,1143,0,1144,G
3-PA,639,2,0,1141,0,1143,G
3-PA,640,0,0,0,1118,1118,C
3-PA,641,0,1102,0,0,1102,T
3-PA,642,1,1085,0,1,1087,T
3-PA,643,0,0,1086,0,1086,G
3-PA,644,0,0,0,1087,1087,C
3-PA,645,0,2,0,1087,1089,C
3-PA,646,0,2,1090,0,1092,G
3-PA,647,1096,1,3,0,1100,A
3-PA,648,0,2,0,1100,1102,C
3-PA,649,2,1,0,1098,1101,C
3-PA,650,1101,1,4,0,1106,A
3-PA,651,1111,0,0,0,1111,A
3-PA,652,1105,0,1,0,1106,A
3-PA,653,0,0,1130,0,1130,G
3-PA,654,0,1130,0,1,1131,T
3-PA,655,1,0,0,1131,1132,C
3-PA,656,0,1122,0,2,1124,T
3-PA,657,0,0,0,1132,1132,C
3-PA,658,0,0,0,1130,1130,C
3-PA,659,3,0,0,1128,1131,C
3-PA,660,1135,0,1,0,1136,A
3-PA,661,0,0,0,1139,1139,C
3-PA,662,1,1,0,1125,1127,C
3-PA,663,0,1,1130,1,1132,G
3-PA,664,1144,0,0,0,1144,A
3-PA,665,1139,0,2,0,1141,A
3-PA,666,0,1,0,1152,1153,C
3-PA,667,0,1144,0,1,1145,T
3-PA,668,0,1154,0,3,1157,T
3-PA,669,0,0,0,1172,1172,C
3-PA,670,2,1167,0,0,1169,T
3-PA,671,1,0,0,1170,1171,C
3-PA,672,2,1,0,1166,1169,C
3-PA,673,0,1157,0,0,1157,T
3-PA,674,2,0,1167,0,1169,G
3-PA,675,0,0,0,1163,1163,C
3-PA,676,0,1,0,1166,1167,C
3-PA,677,0,1159,0,0,1159,T
3-PA,678,0,1153,0,0,1153,T
3-PA,679,0,1,1155,0,1156,G
3-PA,680,1152,0,2,0,1154,A
3-PA,681,1,1,1161,0,1163,G
3-PA,682,1163,0,1,0,1164,A
3-PA,683,1164,0,1,0,1165,A
3-PA,684,1,1189,0,0,1190,T
3-PA,685,0,1189,0,0,1189,T
3-PA,686,0,1187,0,0,1187,T
3-PA,687,0,1191,0,0,1191,T
3-PA,688,1189,0,0,0,1189,A
3-PA,689,0,0,1193,0,1193,G
3-PA,690,1188,0,1,0,1189,A
3-PA,691,0,0,1224,0,1224,G
3-PA,692,0,0,0,1221,1221,C
3-PA,693,1,0,0,1219,1220,C
3-PA,694,0,1230,0,0,1230,T
3-PA,695,1258,1,1,0,1260,A
3-PA,696,0,1261,0,0,1261,T
3-PA,697,0,0,1267,0,1267,G
3-PA,698,0,1263,0,1,1264,T
3-PA,699,0,0,1273,1,1274,G
3-PA,700,0,2,1251,0,1253,G
3-PA,701,1246,0,3,1,1250,A
3-PA,702,0,1231,0,1,1232,T
3-PA,703,0,0,1216,0,1216,G
3-PA,704,0,1,1237,0,1238,G
3-PA,705,1239,0,1,0,1240,A
3-PA,706,0,1233,0,0,1233,T
3-PA,707,0,1236,0,0,1236,T
3-PA,708,0,0,0,1231,1231,C
3-PA,709,0,0,1238,0,1238,G
3-PA,710,1238,0,2,0,1240,A
3-PA,711,1240,0,1,0,1241,A
3-PA,712,0,0,0,1243,1243,C
3-PA,713,0,0,0,1204,1204,C
3-PA,714,0,0,1216,0,1216,G
3-PA,715,1211,1,0,0,1212,A
3-PA,716,1215,1,0,0,1216,A
3-PA,717,0,0,0,1225,1225,C
3-PA,718,1,1,1224,0,1226,G
3-PA,719,0,0,1261,0,1261,G
3-PA,720,0,0,0,1263,1263,C
3-PA,721,1,1248,0,4,1253,T
3-PA,722,0,0,1277,0,1277,G
3-PA,723,0,0,0,1275,1275,C
3-PA,724,1290,0,0,0,1290,A
3-PA,725,0,1289,0,1,1290,T
3-PA,726,0,1273,0,2,1275,T
3-PA,727,0,2,1272,0,1274,G
3-PA,728,1232,0,2,1,1235,A
3-PA,729,0,2,1246,0,1248,G
3-PA,730,0,0,1246,0,1246,G
3-PA,731,0,0,1237,0,1237,G
3-PA,732,1,0,0,1228,1229,C
3-PA,733,1218,0,0,0,1218,A
3-PA,734,1225,0,1,0,1226,A
3-PA,735,0,0,1238,0,1238,G
3-PA,736,1,1,0,1237,1239,C
3-PA,737,0,1237,0,4,1241,T
3-PA,738,1,1236,0,0,1237,T
3-PA,739,0,1242,0,2,1244,T
3-PA,740,0,0,0,1250,1250,C
3-PA,741,0,1248,0,2,1250,T
3-PA,742,0,0,0,1253,1253,C
3-PA,743,1245,0,0,0,1245,A
3-PA,744,1247,0,0,0,1247,A
3-PA,745,1245,0,0,1,1246,A
3-PA,746,0,1245,0,0,1245,T
3-PA,747,1,0,1296,0,1297,G
3-PA,748,0,1295,0,0,1295,T
3-PA,749,0,0,1,1306,1307,C
3-PA,750,1,0,0,1308,1309,C
3-PA,751,1305,0,2,1,1308,A
3-PA,752,1306,0,0,1,1307,A
3-PA,753,1307,0,1,0,1308,A
3-PA,754,0,0,1321,0,1321,G
3-PA,755,1314,0,1,0,1315,A
3-PA,756,1278,0,2,1,1281,A
3-PA,757,0,0,1292,0,1292,G
3-PA,758,0,1275,0,1,1276,T
3-PA,759,1,1,1270,0,1272,G
3-PA,760,1268,0,1,0,1269,A
3-PA,761,1266,0,0,0,1266,A
3-PA,762,0,1268,0,0,1268,T
3-PA,763,0,1,1265,0,1266,G
3-PA,764,0,0,0,1269,1269,C
3-PA,765,0,0,0,1273,1273,C
3-PA,766,1,2,0,1273,1276,C
3-PA,767,1275,0,1,0,1276,A
3-PA,768,1299,0,1,0,1300,A
3-PA,769,1301,1,1,0,1303,A
3-PA,770,0,1304,0,0,1304,T
3-PA,771,0,1300,0,1,1301,T
3-PA,772,2,0,1298,1,1301,G
3-PA,773,1289,0,2,0,1291,A
3-PA,774,1289,0,2,0,1291,A
3-PA,775,0,1,0,1289,1290,C
3-PA,776,1,0,0,1285,1286,C
3-PA,777,0,1261,0,2,1263,T
3-PA,778,0,1283,0,1,1284,T
3-PA,779,0,1279,0,0,1279,T
3-PA,780,0,1290,0,0,1290,T
3-PA,781,2,1,0,1296,1299,C
3-PA,782,0,1296,0,0,1296,T
3-PA,783,0,0,1301,0,1301,G
3-PA,784,1295,0,2,0,1297,A
3-PA,785,1302,0,2,1,1305,A
3-PA,786,0,2,1315,0,1317,G
3-PA,787,1284,0,1,0,1285,A
3-PA,788,0,0,0,1287,1287,C
3-PA,789,1269,1,1,0,1271,A
3-PA,790,1276,2,1,0,1279,A
3-PA,791,0,0,0,1387,1387,C
3-PA,792,1393,0,1,0,1394,A
3-PA,793,0,1,1,1392,1394,C
3-PA,794,1,0,0,1373,1374,C
3-PA,795,1370,0,0,0,1370,A
3-PA,796,1369,1,3,0,1373,A
3-PA,797,1,2,1370,0,1373,G
3-PA,798,1371,0,3,0,1374,A
3-PA,799,0,1,0,1366,1367,C
3-PA,800,0,1,0,1271,1272,C
3-PA,801,1267,0,1,0,1268,A
3-PA,802,1270,0,0,0,1270,A
3-PA,803,0,1270,0,0,1270,T
3-PA,804,0,0,0,1273,1273,C
3-PA,805,1264,0,0,0,1264,A
3-PA,806,1263,0,2,0,1265,A
3-PA,807,1261,0,2,0,1263,A
3-PA,808,0,0,0,1278,1278,C
3-PA,809,0,1264,0,0,1264,T
3-PA,810,1,1268,0,0,1269,T
3-PA,811,3,0,0,1274,1277,C
3-PA,812,0,1,0,1272,1273,C
3-PA,813,0,2,1280,0,1282,G
3-PA,814,1282,0,0,0,1282,A
3-PA,815,1290,0,0,0,1290,A
3-PA,816,0,1291,0,0,1291,T
3-PA,817,0,1,1273,0,1274,G
3-PA,818,1,0,1281,0,1282,G
3-PA,819,1277,1,1,0,1279,A
3-PA,820,0,2,0,1281,1283,C
3-PA,821,2,0,0,1281,1283,C
3-PA,822,0,1309,0,2,1311,T
3-PA,823,0,0,0,1336,1336,C
3-PA,824,0,1,0,1341,1342,C
3-PA,825,0,1337,0,0,1337,T
3-PA,826,0,1336,0,2,1338,T
3-PA,827,0,0,1385,0,1385,G
3-PA,828,1,1369,0,0,1370,T
3-PA,829,0,1366,0,0,1366,T
3-PA,830,1363,0,1,0,1364,A
3-PA,831,1,1312,0,2,1315,T
3-PA,832,1,1,0,1305,1307,C
3-PA,833,1279,0,1,0,1280,A
3-PA,834,2,2,1277,0,1281,G
3-PA,835,0,2,0,1274,1276,C
3-PA,836,1,0,1238,0,1239,G
3-PA,837,0,0,1268,0,1268,G
3-PA,838,0,1266,0,2,1268,T
3-PA,839,0,0,0,1270,1270,C
3-PA,840,0,1,0,1271,1272,C
3-PA,841,1278,0,2,0,1280,A
3-PA,842,1278,0,0,0,1278,A
3-PA,843,1282,0,0,1,1283,A
3-PA,844,0,1280,0,0,1280,T
3-PA,845,0,1275,0,0,1275,T
3-PA,846,1,0,0,1251,1252,C
3-PA,847,0,2,0,1250,1252,C
3-PA,848,0,1246,0,2,1248,T
3-PA,849,2,0,1,1250,1253,C
3-PA,850,0,0,0,1256,1256,C
3-PA,851,0,1252,0,1,1253,T
3-PA,852,0,1,1259,0,1260,G
3-PA,853,1255,2,0,0,1257,A
3-PA,854,0,1258,0,1,1259,T
3-PA,855,0,0,1242,1,1243,G
3-PA,856,1,0,1225,0,1226,G
3-PA,857,1229,0,0,0,1229,A
3-PA,858,0,1214,0,0,1214,T
3-PA,859,0,0,1215,0,1215,G
3-PA,860,0,0,0,1273,1273,C
3-PA,861,0,1259,0,3,1262,T
3-PA,862,0,1266,0,1,1267,T
3-PA,863,1,1266,0,2,1269,T
3-PA,864,1263,0,1,0,1264,A
3-PA,865,1269,0,1,0,1270,A
3-PA,866,1269,0,0,0,1269,A
3-PA,867,1270,0,2,1,1273,A
3-PA,868,0,1268,0,1,1269,T
3-PA,869,0,1154,0,0,1154,T
3-PA,870,0,1,1157,0,1158,G
3-PA,871,1156,0,1,0,1157,A
3-PA,872,0,0,1166,0,1166,G
3-PA,873,0,0,0,1163,1163,C
3-PA,874,1156,0,1,0,1157,A
3-PA,875,1,1170,0,1,1172,T
3-PA,876,0,1169,0,0,1169,T
3-PA,877,0,1,1161,1,1163,G
3-PA,878,1168,0,1,0,1169,A
3-PA,879,1160,0,5,0,1165,A
3-PA,880,0,0,1168,0,1168,G
3-PA,881,1148,0,0,0,1148,A
3-PA,882,0,1,1,1152,1154,C
3-PA,883,1,0,0,1151,1152,C
3-PA,884,1,1,0,1129,1131,C
3-PA,885,1117,0,2,0,1119,A
3-PA,886,1113,2,2,0,1117,A
3-PA,887,0,0,1122,0,1122,G
3-PA,888,0,1123,1,2,1126,T
3-PA,889,3,0,0,1119,1122,C
3-PA,890,1126,0,1,0,1127,A
3-PA,891,0,2,0,1118,1120,C
3-PA,892,1,1,1119,0,1121,G
3-PA,893,1133,0,1,0,1134,A
3-PA,894,1130,0,0,0,1130,A
3-PA,895,0,1,1179,0,1180,G
3-PA,896,1,0,1171,1,1173,G
3-PA,897,1173,0,0,0,1173,A
3-PA,898,1,0,1173,0,1174,G
3-PA,899,1165,0,5,0,1170,A
3-PA,900,1175,1,0,0,1176,A
3-PA,901,1,1,1180,0,1182,G
3-PA,902,1,0,1176,0,1177,G
3-PA,903,1,0,1180,0,1181,G
3-PA,904,1150,1,3,0,1154,A
3-PA,905,0,1153,0,0,1153,T
3-PA,906,0,0,0,1157,1157,C
3-PA,907,0,0,0,1235,1235,C
3-PA,908,1,1,0,1247,1249,C
3-PA,909,1256,0,0,0,1256,A
3-PA,910,0,1254,0,4,1258,T
3-PA,911,0,1260,0,1,1261,T
3-PA,912,1297,0,0,0,1297,A
3-PA,913,1,1294,0,0,1295,T
3-PA,914,1295,0,1,0,1296,A
3-PA,915,1,1296,0,1,1298,T
3-PA,916,0,0,1172,0,1172,G
3-PA,917,1169,0,0,0,1169,A
3-PA,918,0,1150,0,0,1150,T
3-PA,919,0,0,1159,1,1160,G
3-PA,920,2,1,0,1145,1148,C
3-PA,921,1,0,1152,0,1153,G
3-PA,922,1155,0,1,0,1156,A
3-PA,923,0,1151,0,1,1152,T
3-PA,924,2,0,0,1154,1156,C
3-PA,925,1154,0,0,0,1154,A
3-PA,926,1143,0,3,0,1146,A
3-PA,927,0,0,1155,0,1155,G
3-PA,928,0,1148,0,0,1148,T
3-PA,929,0,0,1156,0,1156,G
3-PA,930,0,1,0,1166,1167,C
3-PA,931,1162,0,1,0,1163,A
3-PA,932,0,1167,0,1,1168,T
3-PA,933,1169,0,0,0,1169,A
3-PA,934,1180,0,1,0,1181,A
3-PA,935,1178,0,1,0,1179,A
3-PA,936,1174,0,3,0,1177,A
3-PA,937,1172,0,1,2,1175,A
3-PA,938,1,1,0,1176,1178,C
3-PA,939,1172,1,0,0,1173,A
3-PA,940,0,1172,1,0,1173,T
3-PA,941,0,1174,1,0,1175,T
3-PA,942,2,0,0,1172,1174,C
3-PA,943,0,1161,0,1,1162,T
3-PA,944,1,1157,0,1,1159,T
3-PA,945,0,1159,0,1,1160,T
3-PA,946,0,1,1163,0,1164,G
3-PA,947,0,1,1163,0,1164,G
3-PA,948,1165,0,2,0,1167,A
3-PA,949,0,1165,0,0,1165,T
3-PA,950,0,1,1169,0,1170,G
3-PA,951,0,1,1184,0,1185,G
3-PA,952,1188,0,1,0,1189,A
3-PA,953,1185,0,1,0,1186,A
3-PA,954,1181,0,7,1,1189,A
3-PA,955,0,0,1202,0,1202,G
3-PA,956,1197,0,0,0,1197,A
3-PA,957,1308,0,3,0,1311,A
3-PA,958,0,0,0,1326,1326,C
3-PA,959,0,0,0,1328,1328,C
3-PA,960,0,1312,0,1,1313,T
3-PA,961,0,1330,0,1,1331,T
3-PA,962,1336,0,1,0,1337,A
3-PA,963,0,1338,0,0,1338,T
3-PA,964,1331,0,1,0,1332,A
3-PA,965,0,1349,0,0,1349,T
3-PA,966,1212,0,1,0,1213,A
3-PA,967,0,2,1225,0,1227,G
3-PA,968,0,1222,0,1,1223,T
3-PA,969,1,0,0,1215,1216,C
3-PA,970,1208,0,0,0,1208,A
3-PA,971,1207,0,1,0,1208,A
3-PA,972,1208,0,1,0,1209,A
3-PA,973,0,1,0,1213,1214,C
3-PA,974,0,1,0,1202,1203,C
3-PA,975,1184,0,1,0,1185,A
3-PA,976,1,0,0,1197,1198,C
3-PA,977,1196,0,0,0,1196,A
3-PA,978,0,0,0,1200,1200,C
3-PA,979,0,1,1201,0,1202,G
3-PA,980,1199,0,0,1,1200,A
3-PA,981,1201,0,1,0,1202,A
3-PA,982,1196,0,0,0,1196,A
3-PA,983,1197,0,2,0,1199,A
3-PA,984,0,0,1206,0,1206,G
3-PA,985,0,0,1192,0,1192,G
3-PA,986,1,1,1203,0,1205,G
3-PA,987,1199,0,2,0,1201,A
3-PA,988,1202,0,0,0,1202,A
3-PA,989,2,1199,0,1,1202,T
3-PA,990,1200,0,0,0,1200,A
3-PA,991,1203,0,0,0,1203,A
3-PA,992,1204,0,1,0,1205,A
3-PA,993,1,1194,1,0,1196,T
3-PA,994,0,1192,0,0,1192,T
3-PA,995,2,0,0,1199,1201,C
3-PA,996,1205,0,2,0,1207,A
3-PA,997,1206,0,0,0,1206,A
3-PA,998,1211,0,1,0,1212,A
3-PA,999,1,1208,0,0,1209,T
3-PA,1000,0,1218,0,0,1218,T
3-PA,1001,1220,0,1,0,1221,A
3-PA,1002,0,0,0,1222,1222,C
3-PA,1003,0,1,0,1222,1223,C
3-PA,1004,1,1210,0,2,1213,T
3-PA,1005,0,0,1213,0,1213,G
3-PA,1006,0,1,0,1215,1216,C
3-PA,1007,0,1211,0,1,1212,T
3-PA,1008,0,0,1229,0,1229,G
3-PA,1009,0,1229,0,1,1230,T
3-PA,1010,2,1,0,1235,1238,C
3-PA,1011,1237,0,2,0,1239,A
3-PA,1012,0,1241,0,0,1241,T
3-PA,1013,0,1,1239,0,1240,G
3-PA,1014,0,2,1237,0,1239,G
3-PA,1015,1235,0,1,0,1236,A
3-PA,1016,1253,0,2,0,1255,A
3-PA,1017,0,0,1254,0,1254,G
3-PA,1018,0,0,0,1257,1257,C
3-PA,1019,1255,1,1,0,1257,A
3-PA,1020,1259,0,3,0,1262,A
3-PA,1021,2,0,1271,0,1273,G
3-PA,1022,0,1276,0,0,1276,T
3-PA,1023,1268,0,1,0,1269,A
3-PA,1024,0,0,0,1274,1274,C
3-PA,1025,0,1252,1,4,1257,T
3-PA,1026,0,0,1261,0,1261,G
3-PA,1027,0,1251,0,2,1253,T
3-PA,1028,1,0,0,1252,1253,C
3-PA,1029,1247,0,3,0,1250,A
3-PA,1030,0,1,1270,0,1271,G
3-PA,1031,1265,0,0,0,1265,A
3-PA,1032,1266,0,1,0,1267,A
3-PA,1033,1,1269,0,1,1271,T
3-PA,1034,0,1265,0,0,1265,T
3-PA,1035,0,1,1262,0,1263,G
3-PA,1036,0,1,0,1255,1256,C
3-PA,1037,1249,2,4,0,1255,A
3-PA,1038,1,4,1251,0,1256,G
3-PA,1039,0,3,1242,0,1245,G
3-PA,1040,1247,0,1,0,1248,A
3-PA,1041,0,1,0,1247,1248,C
3-PA,1042,0,0,1227,0,1227,G
3-PA,1043,1,1251,0,0,1252,T
3-PA,1044,0,1252,0,0,1252,T
3-PA,1045,1,0,1258,0,1259,G
3-PA,1046,1261,1,1,0,1263,A
3-PA,1047,1258,0,0,1,1259,A
3-PA,1048,1262,0,0,1,1263,A
3-PA,1049,1261,0,1,0,1262,A
3-PA,1050,0,1257,0,0,1257,T
3-PA,1051,0,3,1258,0,1261,G
3-PA,1052,1254,0,2,0,1256,A
3-PA,1053,0,0,1266,0,1266,G
3-PA,1054,0,1,1267,0,1268,G
3-PA,1055,1265,1,0,0,1266,A
3-PA,1056,0,2,1266,0,1268,G
3-PA,1057,1273,0,1,0,1274,A
3-PA,1058,1264,0,1,0,1265,A
3-PA,1059,0,0,1267,1,1268,G
3-PA,1060,1,0,1255,0,1256,G
3-PA,1061,0,1293,1,4,1298,T
3-PA,1062,1,1303,0,1,1305,T
3-PA,1063,0,0,0,1302,1302,C
3-PA,1064,1,0,0,1302,1303,C
3-PA,1065,1298,0,1,0,1299,A
3-PA,1066,1296,1,1,0,1298,A
3-PA,1067,1,1,1312,0,1314,G
3-PA,1068,0,2,1335,0,1337,G
3-PA,1069,1315,1,0,0,1316,A
3-PA,1070,0,0,0,1328,1328,C
3-PA,1071,0,1322,0,0,1322,T
3-PA,1072,1325,0,0,0,1325,A
3-PA,1073,1323,0,0,0,1323,A
3-PA,1074,1322,0,2,0,1324,A
3-PA,1075,1322,0,1,1,1324,A
3-PA,1076,1317,0,1,0,1318,A
3-PA,1077,1,0,0,1315,1316,C
3-PA,1078,1306,1,0,0,1307,A
3-PA,1079,0,1298,1,1,1300,T
3-PA,1080,1,0,1310,0,1311,G
3-PA,1081,1312,0,1,1,1314,A
3-PA,1082,1315,0,1,0,1316,A
3-PA,1083,0,0,1327,0,1327,G
3-PA,1084,1323,1,0,0,1324,A
3-PA,1085,1326,0,0,0,1326,A
3-PA,1086,1322,0,1,0,1323,A
3-PA,1087,1315,1,4,0,1320,A
3-PA,1088,0,0,0,1329,1329,C
3-PA,1089,1,2,1318,0,1321,G
3-PA,1090,1325,0,0,0,1325,A
3-PA,1091,1,0,1327,0,1328,G
3-PA,1092,0,1318,0,0,1318,T
3-PA,1093,4,1,0,1339,1344,C
3-PA,1094,1344,0,0,0,1344,A
3-PA,1095,1360,0,0,0,1360,A
3-PA,1096,0,0,0,1357,1357,C
3-PA,1097,0,1353,0,2,1355,T
3-PA,1098,0,1,1378,0,1379,G
3-PA,1099,1367,0,2,0,1369,A
3-PA,1100,1376,0,0,0,1376,A
3-PA,1101,0,0,1373,0,1373,G
3-PA,1102,1,1345,0,2,1348,T
3-PA,1103,1,2,1345,0,1348,G
3-PA,1104,0,1,1335,0,1336,G
3-PA,1105,4,1,1333,0,1338,G
3-PA,1106,0,0,0,1343,1343,C
3-PA,1107,0,1333,0,1,1334,T
3-PA,1108,2,0,0,1328,1330,C
3-PA,1109,0,1338,0,0,1338,T
3-PA,1110,0,1347,0,1,1348,T
3-PA,1111,1,1,1383,0,1385,G
3-PA,1112,0,1,1400,0,1401,G
3-PA,1113,0,1405,0,1,1406,T
3-PA,1114,0,2,1403,0,1405,G
3-PA,1115,1397,0,2,0,1399,A
3-PA,1116,1426,1,1,0,1428,A
3-PA,1117,1422,0,0,0,1422,A
3-PA,1118,1431,0,1,1,1433,A
3-PA,1119,0,1,0,1431,1432,C
3-PA,1120,1420,0,0,0,1420,A
3-PA,1121,1,1420,1,1,1423,T
3-PA,1122,1,0,1423,0,1424,G
3-PA,1123,0,0,1452,0,1452,G
3-PA,1124,0,0,0,1454,1454,C
3-PA,1125,1460,0,0,2,1462,A
3-PA,1126,0,0,0,1466,1466,C
3-PA,1127,0,1,0,1474,1475,C
3-PA,1128,1515,0,3,1,1519,A
3-PA,1129,0,0,1542,0,1542,G
3-PA,1130,1541,0,1,1,1543,A
3-PA,1131,5,1,1557,0,1563,G
3-PA,1132,1572,0,1,0,1573,A
3-PA,1133,1583,1,0,0,1584,A
3-PA,1134,0,2,1587,0,1589,G
3-PA,1135,1,0,1583,0,1584,G
3-PA,1136,2,1575,0,0,1577,T
3-PA,1137,1572,0,0,0,1572,A
3-PA,1138,0,0,1577,0,1577,G
3-PA,1139,1582,2,0,0,1584,A
3-PA,1140,0,0,0,1593,1593,C
3-PA,1141,0,1568,0,0,1568,T
3-PA,1142,0,1565,0,1,1566,T
3-PA,1143,0,1569,0,0,1569,T
3-PA,1144,0,1,1573,0,1574,G
3-PA,1145,1570,0,2,0,1572,A
3-PA,1146,1575,0,0,0,1575,A
3-PA,1147,1573,0,1,0,1574,A
3-PA,1148,1560,0,2,0,1562,A
3-PA,1149,0,2,0,1589,1591,C
3-PA,1150,0,1577,0,1,1578,T
3-PA,1151,0,1,1591,0,1592,G
3-PA,1152,1,0,0,1595,1596,C
3-PA,1153,1589,0,1,0,1590,A
3-PA,1154,0,0,1590,0,1590,G
3-PA,1155,1583,0,1,0,1584,A
3-PA,1156,2,1,1683,0,1686,G
3-PA,1157,1694,0,1,0,1695,A
3-PA,1158,0,0,0,1686,1686,C
3-PA,1159,1684,1,2,0,1687,A
3-PA,1160,0,1673,0,2,1675,T
3-PA,1161,1677,0,2,0,1679,A
3-PA,1162,1675,1,3,0,1679,A
3-PA,1163,0,0,1678,0,1678,G
3-PA,1164,0,1,0,1672,1673,C
3-PA,1165,0,0,1645,0,1645,G
3-PA,1166,1696,0,1,0,1697,A
3-PA,1167,0,1683,0,0,1683,T
3-PA,1168,0,1681,1,0,1682,T
3-PA,1169,1,1687,0,0,1688,T
3-PA,1170,0,0,1693,1,1694,G
3-PA,1171,1702,0,1,0,1703,A
3-PA,1172,1694,1,2,0,1697,A
3-PA,1173,0,0,1710,0,1710,G
3-PA,1174,1,0,0,1750,1751,C
3-PA,1175,1732,0,0,0,1732,A
3-PA,1176,1870,1,0,0,1871,A
3-PA,1177,0,1871,0,1,1872,T
3-PA,1178,1877,0,0,0,1877,A
3-PA,1179,0,1881,2,2,1885,T
3-PA,1180,3,2,1885,1,1891,G
3-PA,1181,1909,1,1,1,1912,A
3-PA,1182,0,1912,0,0,1912,T
3-PA,1183,1865,0,1,0,1866,A
3-PA,1184,0,1,1865,0,1866,G
3-PA,1185,0,1811,0,0,1811,T
3-PA,1186,2,1,1808,0,1811,G
3-PA,1187,1812,1,1,0,1814,A
3-PA,1188,0,1,0,1803,1804,C
3-PA,1189,0,1,1799,0,1800,G
3-PA,1190,1816,1,0,0,1817,A
3-PA,1191,1814,3,3,1,1821,A
3-PA,1192,0,0,0,1844,1844,C
3-PA,1193,0,0,0,1833,1833,C
3-PA,1194,1,1822,1,5,1829,T
3-PA,1195,1,2,1893,1,1897,G
3-PA,1196,1892,0,0,0,1892,A
3-PA,1197,1899,0,0,0,1899,A
3-PA,1198,0,1893,1,1,1895,T
3-PA,1199,0,1887,0,0,1887,T
3-PA,1200,1881,0,1,0,1882,A
3-PA,1201,1864,0,0,0,1864,A
3-PA,1202,2,0,1865,0,1867,G
3-PA,1203,0,0,1874,0,1874,G
3-PA,1204,0,1845,0,3,1848,T
3-PA,1205,3,2,0,1844,1849,C
3-PA,1206,1853,0,1,0,1854,A
3-PA,1207,2,0,0,1914,1916,C
3-PA,1208,1,1906,1,3,1911,T
3-PA,1209,0,1916,1,1,1918,T
3-PA,1210,1,1916,1,2,1920,T
3-PA,1211,2,1,0,1918,1921,C
3-PA,1212,1921,1,1,0,1923,A
3-PA,1213,1918,2,1,0,1921,A
3-PA,1214,1,0,1950,0,1951,G
3-PA,1215,0,0,0,1952,1952,C
3-PA,1216,0,1904,0,2,1906,T
3-PA,1217,0,3,1958,2,1963,G
3-PA,1218,0,1,1965,0,1966,G
3-PA,1219,2003,0,3,0,2006,A
3-PA,1220,0,2019,1,0,2020,T
3-PA,1221,2023,0,1,0,2024,A
3-PA,1222,0,1,0,2038,2039,C
3-PA,1223,2008,0,2,0,2010,A
3-PA,1224,3,1,2024,0,2028,G
3-PA,1225,2021,0,3,0,2024,A
3-PA,1226,2000,0,0,0,2000,A
3-PA,1227,0,1979,1,2,1982,T
3-PA,1228,1,2,1993,0,1996,G
3-PA,1229,1982,0,5,0,1987,A
3-PA,1230,1,0,2009,1,2011,G
3-PA,1231,1,1997,0,2,2000,T
3-PA,1232,0,1996,0,0,1996,T
3-PA,1233,1,0,0,2035,2036,C
3-PA,1234,2047,0,3,0,2050,A
3-PA,1235,2052,1,3,0,2056,A
3-PA,1236,0,1,0,2052,2053,C
3-PA,1237,2046,0,1,1,2048,A
3-PA,1238,2046,0,1,0,2047,A
3-PA,1239,0,0,2036,0,2036,G
3-PA,1240,0,2,2062,1,2065,G
3-PA,1241,0,1,0,2070,2071,C
3-PA,1242,1,1,0,2058,2060,C
3-PA,1243,0,2049,1,2,2052,T
3-PA,1244,1,0,2067,0,2068,G
3-PA,1245,0,2063,0,1,2064,T
3-PA,1246,0,1,2092,0,2093,G
3-PA,1247,2087,0,2,0,2089,A
3-PA,1248,1,0,2090,0,2091,G
3-PA,1249,1,0,0,2081,2082,C
3-PA,1250,0,2058,0,3,2061,T
3-PA,1251,2135,0,1,0,2136,A
3-PA,1252,2138,1,2,0,2141,A
3-PA,1253,0,0,0,2146,2146,C
3-PA,1254,0,2120,0,2,2122,T
3-PA,1255,0,2,2137,0,2139,G
3-PA,1256,2131,0,1,0,2132,A
3-PA,1257,1,2129,0,1,2131,T
3-PA,1258,0,2136,0,0,2136,T
3-PA,1259,6,0,0,2140,2146,C
3-PA,1260,2195,0,3,0,2198,A
3-PA,1261,0,2,2247,0,2249,G
3-PA,1262,1,2234,0,2,2237,T
3-PA,1263,1,1,1,2238,2241,C
3-PA,1264,0,2232,0,2,2234,T
3-PA,1265,1,0,2320,0,2321,G
3-PA,1266,0,3,2325,0,2328,G
3-PA,1267,2332,1,2,0,2335,A
3-PA,1268,0,2335,0,0,2335,T
3-PA,1269,2256,0,1,0,2257,A
3-PA,1270,0,2,2253,0,2255,G
3-PA,1271,2233,1,4,0,2238,A
3-PA,1272,0,0,2246,0,2246,G
3-PA,1273,1,0,0,2240,2241,C
3-PA,1274,0,2206,0,2,2208,T
3-PA,1275,1,1,0,2206,2208,C
3-PA,1276,0,2,2210,0,2212,G
3-PA,1277,2208,0,3,0,2211,A
3-PA,1278,0,2215,0,0,2215,T
3-PA,1279,0,1,2211,0,2212,G
3-PA,1280,2235,0,2,0,2237,A
3-PA,1281,2232,0,3,0,2235,A
3-PA,1282,2247,0,3,0,2250,A
3-PA,1283,1,2243,0,0,2244,T
3-PA,1284,0,2244,0,0,2244,T
3-PA,1285,0,1,2268,0,2269,G
3-PA,1286,3,1,2261,0,2265,G
3-PA,1287,2259,0,3,0,2262,A
3-PA,1288,1,0,2262,0,2263,G
3-PA,1289,2235,0,2,1,2238,A
3-PA,1290,0,2,2257,0,2259,G
3-PA,1291,0,2,2265,0,2267,G
3-PA,1292,2286,0,2,1,2289,A
3-PA,1293,1,2,0,2290,2293,C
3-PA,1294,0,0,2279,0,2279,G
3-PA,1295,0,2281,0,0,2281,T
3-PA,1296,2293,0,1,0,2294,A
3-PA,1297,0,1,2307,0,2308,G
3-PA,1298,0,1,0,2331,2332,C
3-PA,1299,1,2,0,2308,2311,C
3-PA,1300,2,0,0,2307,2309,C
3-PA,1301,2,1,0,2306,2309,C
3-PA,1302,2313,1,1,0,2315,A
3-PA,1303,2389,0,0,0,2389,A
3-PA,1304,0,2388,0,0,2388,T
3-PA,1305,0,2380,0,0,2380,T
3-PA,1306,1,3,2371,0,2375,G
3-PA,1307,2331,0,1,0,2332,A
3-PA,1308,0,0,2332,1,2333,G
3-PA,1309,0,2,0,2332,2334,C
3-PA,1310,2321,2,1,0,2324,A
3-PA,1311,0,0,0,2377,2377,C
3-PA,1312,2332,0,1,0,2333,A
3-PA,1313,0,2375,1,2,2378,T
3-PA,1314,0,2375,0,5,2380,T
3-PA,1315,0,1,2384,0,2385,G
3-PA,1316,0,1,0,2379,2380,C
3-PA,1317,2377,2,2,0,2381,A
3-PA,1318,2380,0,5,0,2385,A
3-PA,1319,1,0,2380,0,2381,G
3-PA,1320,0,0,0,2384,2384,C
3-PA,1321,2382,0,1,0,2383,A
3-PA,1322,0,2347,0,0,2347,T
3-PA,1323,1,1,2347,0,2349,G
3-PA,1324,2333,1,6,0,2340,A
3-PA,1325,0,0,2351,0,2351,G
3-PA,1326,2350,1,2,0,2353,A
3-PA,1327,2347,0,2,0,2349,A
3-PA,1328,0,0,2348,0,2348,G
3-PA,1329,0,4,2361,0,2365,G
3-PA,1330,2360,0,3,1,2364,A
3-PA,1331,2362,0,0,0,2362,A
3-PA,1332,0,2366,0,0,2366,T
3-PA,1333,0,2368,0,2,2370,T
3-PA,1334,2387,0,0,0,2387,A
3-PA,1335,1,2386,1,1,2389,T
3-PA,1336,0,2385,1,1,2387,T
3-PA,1337,1,2384,0,0,2385,T
3-PA,1338,0,0,0,2370,2370,C
3-PA,1339,2356,1,4,0,2361,A
3-PA,1340,0,2,0,2410,2412,C
3-PA,1341,2402,0,0,0,2402,A
3-PA,1342,0,1,2434,0,2435,G
3-PA,1343,0,0,0,2436,2436,C
3-PA,1344,2426,0,1,0,2427,A
3-PA,1345,0,0,2437,0,2437,G
3-PA,1346,2426,0,4,0,2430,A
3-PA,1347,0,1,2454,0,2455,G
3-PA,1348,2,0,2460,0,2462,G
3-PA,1349,1,2400,0,3,2404,T
3-PA,1350,0,1,2441,0,2442,G
3-PA,1351,0,2428,0,3,2431,T
3-PA,1352,1,2,0,2424,2427,C
3-PA,1353,1,0,0,2444,2445,C
3-PA,1354,1,0,0,2449,2450,C
3-PA,1355,2471,1,2,0,2474,A
3-PA,1356,0,2491,0,1,2492,T
3-PA,1357,0,2486,0,4,2490,T
3-PA,1358,1,0,2499,0,2500,G
3-PA,1359,2,2466,0,1,2469,T
3-PA,1360,2445,0,0,0,2445,A
3-PA,1361,0,1,2443,0,2444,G
3-PA,1362,2390,1,5,0,2396,A
3-PA,1363,1,1,2394,0,2396,G
3-PA,1364,0,0,0,2385,2385,C
3-PA,1365,0,1,0,2364,2365,C
3-PA,1366,2402,0,2,0,2404,A
3-PA,1367,0,1,0,2404,2405,C
3-PA,1368,1,2391,2,0,2394,T
3-PA,1369,1,2,2390,1,2394,G
3-PA,1370,2385,0,3,0,2388,A
3-PA,1371,2352,1,1,0,2354,A
3-PA,1372,1,2414,0,0,2415,T
3-PA,1373,2430,1,2,0,2433,A
3-PA,1374,0,0,0,2459,2459,C
3-PA,1375,2418,0,2,0,2420,A
3-PA,1376,0,2450,0,0,2450,T
3-PA,1377,2449,0,0,0,2449,A
3-PA,1378,2486,0,0,0,2486,A
3-PA,1379,2,2495,0,0,2497,T
3-PA,1380,2,1,2459,0,2462,G
3-PA,1381,2452,0,1,0,2453,A
3-PA,1382,2419,0,1,0,2420,A
3-PA,1383,1,2,2409,0,2412,G
3-PA,1384,0,2,2399,0,2401,G
3-PA,1385,1,3,2393,0,2397,G
3-PA,1386,4,2,2388,0,2394,G
3-PA,1387,0,0,2399,0,2399,G
3-PA,1388,0,2322,0,2,2324,T
3-PA,1389,1,0,2315,0,2316,G
3-PA,1390,0,2381,0,1,2382,T
3-PA,1391,2425,0,0,0,2425,A
3-PA,1392,0,1,1,2583,2585,C
3-PA,1393,2542,1,1,0,2544,A
3-PA,1394,0,2520,0,0,2520,T
3-PA,1395,0,2496,0,0,2496,T
3-PA,1396,2487,1,1,0,2489,A
3-PA,1397,2528,1,4,0,2533,A
3-PA,1398,0,2,0,2528,2530,C
3-PA,1399,2476,0,1,0,2477,A
3-PA,1400,0,0,1,2481,2482,C
3-PA,1401,0,2297,0,0,2297,T
3-PA,1402,0,0,2370,0,2370,G
3-PA,1403,0,0,0,2362,2362,C
3-PA,1404,2,1,0,2363,2366,C
3-PA,1405,2,0,0,2366,2368,C
3-PA,1406,0,2323,0,2,2325,T
3-PA,1407,0,0,2394,0,2394,G
3-PA,1408,0,0,0,2391,2391,C
3-PA,1409,2,2385,0,3,2390,T
3-PA,1410,4,0,0,2450,2454,C
3-PA,1411,2372,2,1,0,2375,A
3-PA,1412,2397,0,1,0,2398,A
3-PA,1413,0,2402,0,0,2402,T
3-PA,1414,1,1,2396,0,2398,G
3-PA,1415,0,0,0,2395,2395,C
3-PA,1416,2350,1,0,0,2351,A
3-PA,1417,0,2341,0,4,2345,T
3-PA,1418,1,0,0,2336,2337,C
3-PA,1419,2,1,0,2364,2367,C
3-PA,1420,1,2271,0,3,2275,T
3-PA,1421,0,0,2322,0,2322,G
3-PA,1422,0,2314,0,2,2316,T
3-PA,1423,2,0,2313,0,2315,G
3-PA,1424,0,2,0,2316,2318,C
3-PA,1425,2284,0,1,3,2288,A
3-PA,1426,0,0,2312,0,2312,G
3-PA,1427,2,0,0,2306,2308,C
3-PA,1428,2285,1,3,1,2290,A
3-PA,1429,2286,0,1,0,2287,A
3-PA,1430,0,2232,0,2,2234,T
3-PA,1431,1,1,2235,1,2238,G
3-PA,1432,1,1,2237,1,2240,G
3-PA,1433,2239,0,2,0,2241,A
3-PA,1434,0,1,0,2232,2233,C
3-PA,1435,0,1,2215,0,2216,G
3-PA,1436,2255,0,0,0,2255,A
3-PA,1437,1,2248,1,0,2250,T
3-PA,1438,0,2250,0,2,2252,T
3-PA,1439,0,2244,0,1,2245,T
3-PA,1440,0,2246,0,0,2246,T
3-PA,1441,1,1,0,2256,2258,C
3-PA,1442,2255,0,1,0,2256,A
3-PA,1443,2265,0,3,0,2268,A
3-PA,1444,0,1,0,2268,2269,C
3-PA,1445,0,2229,0,3,2232,T
3-PA,1446,2232,0,1,0,2233,A
3-PA,1447,2233,0,0,0,2233,A
3-PA,1448,0,2230,0,2,2232,T
3-PA,1449,1,2232,0,1,2234,T
3-PA,1450,0,0,0,2239,2239,C
3-PA,1451,2,1,0,2229,2232,C
3-PA,1452,0,1,0,2229,2230,C
3-PA,1453,2229,0,0,0,2229,A
3-PA,1454,1,2253,0,3,2257,T
3-PA,1455,0,2,2258,0,2260,G
3-PA,1456,2261,0,0,0,2261,A
3-PA,1457,1,2243,0,2,2246,T
3-PA,1458,2235,0,4,0,2239,A
3-PA,1459,2242,0,3,0,2245,A
3-PA,1460,0,0,2245,1,2246,G
3-PA,1461,0,0,0,2244,2244,C
3-PA,1462,2230,0,3,1,2234,A
3-PA,1463,2185,0,2,0,2187,A
3-PA,1464,0,0,2260,0,2260,G
3-PA,1465,0,2259,0,0,2259,T
3-PA,1466,0,0,2250,0,2250,G
3-PA,1467,1,1,0,2242,2244,C
3-PA,1468,2230,0,5,0,2235,A
3-PA,1469,2,1,2264,0,2267,G
3-PA,1470,2265,0,3,0,2268,A
3-PA,1471,2285,0,2,1,2288,A
3-PA,1472,0,0,0,2287,2287,C
3-PA,1473,0,2249,0,3,2252,T
3-PA,1474,2265,0,0,0,2265,A
3-PA,1475,2263,0,0,0,2263,A
3-PA,1476,2260,0,2,1,2263,A
3-PA,1477,0,0,2271,0,2271,G
3-PA,1478,2193,0,0,0,2193,A
3-PA,1479,0,1,2192,0,2193,G
3-PA,1480,0,0,2155,0,2155,G
3-PA,1481,1,0,2153,0,2154,G
3-PA,1482,2138,0,3,0,2141,A
3-PA,1483,2111,1,3,0,2115,A
3-PA,1484,1,1,2120,0,2122,G
3-PA,1485,0,1,2130,0,2131,G
3-PA,1486,1,0,0,2132,2133,C
3-PA,1487,1,2,2127,0,2130,G
3-PA,1488,2120,0,1,0,2121,A
3-PA,1489,2126,0,0,0,2126,A
3-PA,1490,2121,0,1,0,2122,A
3-PA,1491,2127,0,1,0,2128,A
3-PA,1492,2122,0,6,1,2129,A
3-PA,1493,2,1,0,2126,2129,C
3-PA,1494,1,1,0,2124,2126,C
3-PA,1495,2129,0,0,0,2129,A
3-PA,1496,2155,0,0,0,2155,A
3-PA,1497,0,2151,0,0,2151,T
3-PA,1498,1,2154,0,2,2157,T
3-PA,1499,0,2168,0,0,2168,T
3-PA,1500,2168,0,1,0,2169,A
3-PA,1501,0,2163,0,0,2163,T
3-PA,1502,2158,1,2,0,2161,A
3-PA,1503,1,2151,1,1,2154,T
3-PA,1504,1,2,2134,1,2138,G
3-PA,1505,1,0,2116,0,2117,G
3-PA,1506,2123,0,0,0,2123,A
3-PA,1507,1,2116,0,0,2117,T
3-PA,1508,1,2099,2,1,2103,T
3-PA,1509,2,1,0,2099,2102,C
3-PA,1510,2108,0,3,0,2111,A
3-PA,1511,1,2123,0,1,2125,T
3-PA,1512,2,1,0,2122,2125,C
3-PA,1513,2119,0,3,0,2122,A
3-PA,1514,0,2093,0,0,2093,T
3-PA,1515,2085,0,0,0,2085,A
3-PA,1516,2086,0,1,0,2087,A
3-PA,1517,2075,1,4,0,2080,A
3-PA,1518,1,1,2093,0,2095,G
3-PA,1519,0,0,2063,2,2065,G
3-PA,1520,0,2,2049,0,2051,G
3-PA,1521,2037,1,1,0,2039,A
3-PA,1522,2027,0,1,1,2029,A
3-PA,1523,1,0,2036,0,2037,G
3-PA,1524,2033,0,0,0,2033,A
3-PA,1525,0,2028,0,1,2029,T
3-PA,1526,0,0,0,2032,2032,C
3-PA,1527,0,2008,0,1,2009,T
3-PA,1528,1,0,1,2061,2063,C
3-PA,1529,2060,0,0,0,2060,A
3-PA,1530,0,2056,2,0,2058,T
3-PA,1531,1,2061,0,0,2062,T
3-PA,1532,0,2048,0,0,2048,T
3-PA,1533,2042,0,0,0,2042,A
3-PA,1534,2042,1,1,0,2044,A
3-PA,1535,0,1,2045,0,2046,G
3-PA,1536,0,2,2067,0,2069,G
3-PA,1537,1971,0,0,0,1971,A
3-PA,1538,1974,0,0,0,1974,A
3-PA,1539,0,1977,1,1,1979,T
3-PA,1540,0,2,1988,0,1990,G
3-PA,1541,2024,0,4,0,2028,A
3-PA,1542,0,4,0,2026,2030,C
3-PA,1543,2024,0,2,0,2026,A
3-PA,1544,1,0,0,2021,2022,C
3-PA,1545,1961,0,3,0,1964,A
3-PA,1546,1,2,1982,0,1985,G
3-PA,1547,1968,1,4,0,1973,A
3-PA,1548,1,2,0,1965,1968,C
3-PA,1549,1,0,1953,0,1954,G
3-PA,1550,0,1866,1,5,1872,T
3-PA,1551,2,1,1873,0,1876,G
3-PA,1552,0,1,1875,0,1876,G
3-PA,1553,0,1878,0,1,1879,T
3-PA,1554,1878,0,0,0,1878,A
3-PA,1555,1859,0,0,0,1859,A
3-PA,1556,1858,0,1,0,1859,A
3-PA,1557,0,1857,0,0,1857,T
3-PA,1558,0,1842,1,0,1843,T
3-PA,1559,1,1839,0,0,1840,T
3-PA,1560,0,1820,0,1,1821,T
3-PA,1561,0,0,1820,1,1821,G
3-PA,1562,0,1799,1,3,1803,T
3-PA,1563,1,0,1806,1,1808,G
3-PA,1564,1791,1,3,0,1795,A
3-PA,1565,0,1,1792,1,1794,G
3-PA,1566,2,0,1,1789,1792,C
3-PA,1567,1791,0,0,0,1791,A
3-PA,1568,0,1790,0,0,1790,T
3-PA,1569,0,0,1784,0,1784,G
3-PA,1570,0,0,1804,0,1804,G
3-PA,1571,1805,0,2,0,1807,A
3-PA,1572,0,0,1816,0,1816,G
3-PA,1573,1,1789,0,4,1794,T
3-PA,1574,0,1775,0,5,1780,T
3-PA,1575,0,1789,0,0,1789,T
3-PA,1576,0,1794,0,0,1794,T
3-PA,1577,0,0,1,1794,1795,C
3-PA,1578,1,1777,1,3,1782,T
3-PA,1579,0,0,0,1778,1778,C
3-PA,1580,0,1749,0,4,1753,T
3-PA,1581,1,2,0,1740,1743,C
3-PA,1582,1747,1,0,0,1748,A
3-PA,1583,1,0,0,1745,1746,C
3-PA,1584,1,1721,0,0,1722,T
3-PA,1585,0,4,1723,0,1727,G
3-PA,1586,1731,0,1,0,1732,A
3-PA,1587,0,1,0,1740,1741,C
3-PA,1588,1,1,0,1741,1743,C
3-PA,1589,3,1,0,1715,1719,C
3-PA,1590,0,0,1719,0,1719,G
3-PA,1591,1712,0,1,0,1713,A
3-PA,1592,0,2,1718,0,1720,G
3-PA,1593,1719,0,0,1,1720,A
3-PA,1594,0,0,0,1696,1696,C
3-PA,1595,0,1685,0,1,1686,T
3-PA,1596,0,1647,0,0,1647,T
3-PA,1597,0,2,1652,1,1655,G
3-PA,1598,1644,1,4,0,1649,A
3-PA,1599,0,1,1653,0,1654,G
3-PA,1600,1,0,1,1645,1647,C
3-PA,1601,0,4,0,1620,1624,C
3-PA,1602,1645,0,4,0,1649,A
3-PA,1603,0,0,0,1649,1649,C
3-PA,1604,1646,2,1,0,1649,A
3-PA,1605,0,1649,1,0,1650,T
3-PA,1606,1638,0,1,1,1640,A
3-PA,1607,1637,0,0,1,1638,A
3-PA,1608,1641,0,0,0,1641,A
3-PA,1609,0,1634,0,1,1635,T
3-PA,1610,0,1,1637,0,1638,G
3-PA,1611,0,0,1574,0,1574,G
3-PA,1612,0,1,1574,0,1575,G
3-PA,1613,1553,0,4,0,1557,A
3-PA,1614,0,0,1585,0,1585,G
3-PA,1615,1572,0,0,0,1572,A
3-PA,1616,1561,2,2,0,1565,A
3-PA,1617,1573,0,1,0,1574,A
3-PA,1618,0,1576,0,0,1576,T
3-PA,1619,1577,0,0,0,1577,A
3-PA,1620,1,1,0,1571,1573,C
3-PA,1621,0,1263,0,1,1264,T
3-PA,1622,0,0,1266,0,1266,G
3-PA,1623,0,1144,0,0,1144,T
3-PA,1624,1,0,1178,0,1179,G
3-PA,1625,0,1169,1,0,1170,T
3-PA,1626,1,0,0,1122,1123,C
3-PA,1627,2,0,0,1115,1117,C
3-PA,1628,0,1108,0,1,1109,T
3-PA,1629,1,1107,0,0,1108,T
3-PA,1630,0,0,1108,0,1108,G
3-PA,1631,1117,0,0,0,1117,A
3-PA,1632,0,0,1125,1,1126,G
3-PA,1633,1078,0,1,0,1079,A
3-PA,1634,0,1078,0,0,1078,T
3-PA,1635,1066,0,1,0,1067,A
3-PA,1636,0,0,1087,0,1087,G
3-PA,1637,0,0,1091,0,1091,G
3-PA,1638,1081,1,0,0,1082,A
3-PA,1639,0,0,1088,0,1088,G
3-PA,1640,1073,0,0,0,1073,A
3-PA,1641,0,1068,0,0,1068,T
3-PA,1642,1079,0,1,0,1080,A
3-PA,1643,0,1081,0,0,1081,T
3-PA,1644,0,0,1091,0,1091,G
3-PA,1645,0,1069,0,3,1072,T
3-PA,1646,0,1067,0,1,1068,T
3-PA,1647,1085,1,2,0,1088,A
3-PA,1648,0,0,0,1089,1089,C
3-PA,1649,0,1080,0,0,1080,T
3-PA,1650,1086,0,0,0,1086,A
3-PA,1651,1068,0,1,1,1070,A
3-PA,1652,0,1,1073,0,1074,G
3-PA,1653,1065,0,0,0,1065,A
3-PA,1654,1051,0,0,0,1051,A
3-PA,1655,0,0,1032,0,1032,G
3-PA,1656,0,1044,0,0,1044,T
3-PA,1657,0,2,1053,0,1055,G
3-PA,1658,1,1,0,1055,1057,C
3-PA,1659,1,1,0,1053,1055,C
3-PA,1660,1056,0,1,0,1057,A
3-PA,1661,0,1051,0,1,1052,T
3-PA,1662,1050,0,0,0,1050,A
3-PA,1663,0,0,1054,0,1054,G
3-PA,1664,2,0,1049,0,1051,G
3-PA,1665,0,0,0,1049,1049,C
3-PA,1666,1,2,0,1037,1040,C
3-PA,1667,1042,0,0,0,1042,A
3-PA,1668,1044,0,0,0,1044,A
3-PA,1669,1040,0,1,0,1041,A
3-PA,1670,0,1044,0,0,1044,T
3-PA,1671,0,1044,0,0,1044,T
3-PA,1672,0,1037,0,0,1037,T
3-PA,1673,0,0,0,1044,1044,C
3-PA,1674,1027,0,2,0,1029,A
3-PA,1675,1041,0,0,0,1041,A
3-PA,1676,1,1,1044,0,1046,G
3-PA,1677,1,0,1052,0,1053,G
3-PA,1678,1,0,0,1049,1050,C
3-PA,1679,1,0,0,1038,1039,C
3-PA,1680,1038,0,1,0,1039,A
3-PA,1681,1069,1,0,0,1070,A
3-PA,1682,0,1070,0,1,1071,T
3-PA,1683,1,0,1122,1,1124,G
3-PA,1684,0,1118,0,1,1119,T
3-PA,1685,0,1182,0,0,1182,T
3-PA,1686,0,0,0,1192,1192,C
3-PA,1687,0,1185,0,1,1186,T
3-PA,1688,0,1188,0,0,1188,T
3-PA,1689,1116,0,0,0,1116,A
3-PA,1690,0,1131,0,0,1131,T
3-PA,1691,1135,0,0,0,1135,A
3-PA,1692,1,1146,0,0,1147,T
3-PA,1693,0,0,1151,0,1151,G
3-PA,1694,0,1083,1,0,1084,T
3-PA,1695,0,0,1083,0,1083,G
3-PA,1696,1077,0,4,0,1081,A
3-PA,1697,1,0,1083,0,1084,G
3-PA,1698,0,0,1094,0,1094,G
3-PA,1699,1092,0,0,0,1092,A
3-PA,1700,0,0,0,1090,1090,C
3-PA,1701,1084,0,2,0,1086,A
3-PA,1702,1085,0,0,0,1085,A
3-PA,1703,1082,1,2,0,1085,A
3-PA,1704,0,0,0,1078,1078,C
3-PA,1705,0,0,1082,0,1082,G
3-PA,1706,0,0,1090,0,1090,G
3-PA,1707,1078,0,1,0,1079,A
3-PA,1708,1083,0,0,0,1083,A
3-PA,1709,0,0,0,1099,1099,C
3-PA,1710,1096,0,0,0,1096,A
3-PA,1711,0,1096,0,0,1096,T
3-PA,1712,0,0,0,1097,1097,C
3-PA,1713,1091,0,0,1,1092,A
3-PA,1714,1092,1,1,0,1094,A
3-PA,1715,1072,0,3,0,1075,A
3-PA,1716,0,0,1077,0,1077,G
3-PA,1717,2,0,1082,0,1084,G
3-PA,1718,0,1073,0,2,1075,T
3-PA,1719,0,0,0,1072,1072,C
3-PA,1720,1073,1,1,0,1075,A
3-PA,1721,1075,0,1,0,1076,A
3-PA,1722,1074,0,0,0,1074,A
3-PA,1723,1077,0,0,0,1077,A
3-PA,1724,0,1080,0,0,1080,T
3-PA,1725,0,1,1082,0,1083,G
3-PA,1726,1077,0,0,0,1077,A
3-PA,1727,1076,0,1,0,1077,A
3-PA,1728,1080,0,1,0,1081,A
3-PA,1729,0,1081,0,0,1081,T
3-PA,1730,0,0,1082,0,1082,G
3-PA,1731,0,0,1082,0,1082,G
3-PA,1732,1,0,1078,0,1079,G
3-PA,1733,0,1,1096,0,1097,G
3-PA,1734,1079,0,0,0,1079,A
3-PA,1735,1082,0,0,0,1082,A
3-PA,1736,0,1084,0,0,1084,T
3-PA,1737,0,2,1085,0,1087,G
3-PA,1738,0,1,1095,0,1096,G
3-PA,1739,1083,0,1,0,1084,A
3-PA,1740,1,0,1093,0,1094,G
3-PA,1741,1089,0,0,0,1089,A
3-PA,1742,0,1072,0,0,1072,T
3-PA,1743,0,1,1072,1,1074,G
3-PA,1744,1066,0,3,0,1069,A
3-PA,1745,1,0,1075,0,1076,G
3-PA,1746,1076,0,3,0,1079,A
3-PA,1747,0,1,0,1068,1069,C
3-PA,1748,1,1,1067,0,1069,G
3-PA,1749,0,1060,0,1,1061,T
3-PA,1750,0,1052,0,2,1054,T
3-PA,1751,0,0,1062,0,1062,G
3-PA,1752,1,3,0,1056,1060,C
3-PA,1753,0,0,0,1066,1066,C
3-PA,1754,0,1063,0,3,1066,T
3-PA,1755,3,0,0,1082,1085,C
3-PA,1756,0,0,0,1086,1086,C
3-PA,1757,0,1087,0,1,1088,T
3-PA,1758,0,1088,0,0,1088,T
3-PA,1759,0,0,0,1092,1092,C
3-PA,1760,1079,0,0,0,1079,A
3-PA,1761,0,0,1081,0,1081,G
3-PA,1762,0,1075,1,1,1077,T
3-PA,1763,0,0,0,1082,1082,C
3-PA,1764,1063,0,0,0,1063,A
3-PA,1765,0,2,0,1097,1099,C
3-PA,1766,0,1098,0,0,1098,T
3-PA,1767,0,0,0,1104,1104,C
3-PA,1768,1,1,0,1098,1100,C
3-PA,1769,1097,0,3,0,1100,A
3-PA,1770,0,0,1103,0,1103,G
3-PA,1771,0,1,0,1106,1107,C
3-PA,1772,1103,0,0,0,1103,A
3-PA,1773,1,1,1111,0,1113,G
3-PA,1774,1074,0,1,0,1075,A
3-PA,1775,0,1072,0,0,1072,T
3-PA,1776,4,0,1,1060,1065,C
3-PA,1777,0,0,1064,0,1064,G
3-PA,1778,1062,0,0,0,1062,A
3-PA,1779,0,1,1065,0,1066,G
3-PA,1780,1062,0,3,0,1065,A
3-PA,1781,1,0,1075,0,1076,G
3-PA,1782,0,0,0,1066,1066,C
3-PA,1783,1065,0,2,1,1068,A
3-PA,1784,0,1069,0,0,1069,T
3-PA,1785,0,2,1082,0,1084,G
3-PA,1786,1087,0,1,0,1088,A
3-PA,1787,0,1081,0,1,1082,T
3-PA,1788,0,1082,0,0,1082,T
3-PA,1789,0,1,1080,0,1081,G
3-PA,1790,1074,0,0,0,1074,A
3-PA,1791,1076,0,0,0,1076,A
3-PA,1792,0,0,1076,0,1076,G
3-PA,1793,0,0,0,1071,1071,C
3-PA,1794,0,2,0,1058,1060,C
3-PA,1795,0,0,1060,0,1060,G
3-PA,1796,1059,0,0,0,1059,A
3-PA,1797,1,0,1066,0,1067,G
3-PA,1798,0,1064,0,0,1064,T
3-PA,1799,1,0,0,1061,1062,C
3-PA,1800,0,0,0,1062,1062,C
3-PA,1801,0,1054,0,2,1056,T
3-PA,1802,0,0,0,1064,1064,C
3-PA,1803,0,0,1070,0,1070,G
3-PA,1804,0,0,1107,0,1107,G
3-PA,1805,0,1107,0,0,1107,T
3-PA,1806,0,1102,0,0,1102,T
3-PA,1807,1099,0,0,0,1099,A
3-PA,1808,1099,0,1,0,1100,A
3-PA,1809,1098,1,0,1,1100,A
3-PA,1810,1,0,1119,0,1120,G
3-PA,1811,1105,0,2,0,1107,A
3-PA,1812,0,0,1107,0,1107,G
3-PA,1813,1059,0,0,0,1059,A
3-PA,1814,1064,0,0,0,1064,A
3-PA,1815,1064,0,2,0,1066,A
3-PA,1816,0,0,1075,0,1075,G
3-PA,1817,1075,0,2,0,1077,A
3-PA,1818,0,1,0,1077,1078,C
3-PA,1819,1061,0,1,0,1062,A
3-PA,1820,0,1060,0,0,1060,T
3-PA,1821,0,1,1059,0,1060,G
3-PA,1822,1082,0,0,0,1082,A
3-PA,1823,0,1,0,1079,1080,C
3-PA,1824,2,1,0,1079,1082,C
3-PA,1825,1072,0,1,0,1073,A
3-PA,1826,1072,0,0,0,1072,A
3-PA,1827,1068,0,3,0,1071,A
3-PA,1828,0,0,1079,0,1079,G
3-PA,1829,1074,0,2,0,1076,A
3-PA,1830,0,0,1079,0,1079,G
3-PA,1831,0,1063,0,0,1063,T
3-PA,1832,0,1063,0,0,1063,T
3-PA,1833,0,1060,0,0,1060,T
3-PA,1834,0,1059,0,1,1060,T
3-PA,1835,1,1061,1,0,1063,T
3-PA,1836,0,1062,1,0,1063,T
3-PA,1837,1,0,1061,0,1062,G
3-PA,1838,1054,0,0,0,1054,A
3-PA,1839,1,4,1060,0,1065,G
3-PA,1840,1058,1,0,1,1060,A
3-PA,1841,1058,0,0,1,1059,A
3-PA,1842,1,1063,0,3,1067,T
3-PA,1843,1063,1,1,0,1065,A
3-PA,1844,1088,0,1,0,1089,A
3-PA,1845,1098,0,0,0,1098,A
3-PA,1846,0,1095,1,0,1096,T
3-PA,1847,1,0,1,1094,1096,C
3-PA,1848,1087,0,0,0,1087,A
3-PA,1849,0,0,1090,0,1090,G
3-PA,1850,1085,1,0,0,1086,A
3-PA,1851,1089,1,2,0,1092,A
3-PA,1852,1,0,1100,0,1101,G
3-PA,1853,0,0,0,1075,1075,C
3-PA,1854,1069,0,0,0,1069,A
3-PA,1855,0,1058,2,0,1060,T
3-PA,1856,0,0,1062,0,1062,G
3-PA,1857,0,0,1069,0,1069,G
3-PA,1858,0,0,0,1057,1057,C
3-PA,1859,1,0,0,1086,1087,C
3-PA,1860,3,0,1,1087,1091,C
3-PA,1861,1094,0,0,0,1094,A
3-PA,1862,0,1095,1,0,1096,T
3-PA,1863,0,1098,0,0,1098,T
3-PA,1864,0,0,1095,0,1095,G
3-PA,1865,0,0,1097,0,1097,G
3-PA,1866,0,0,1093,0,1093,G
3-PA,1867,0,1,1093,0,1094,G
3-PA,1868,1030,0,3,0,1033,A
3-PA,1869,0,0,1048,0,1048,G
3-PA,1870,1,1033,0,0,1034,T
3-PA,1871,1,0,0,1047,1048,C
3-PA,1872,2,1,0,1088,1091,C
3-PA,1873,1,1,0,1082,1084,C
3-PA,1874,1,0,0,1083,1084,C
3-PA,1875,3,0,0,1082,1085,C
3-PA,1876,1085,0,1,0,1086,A
3-PA,1877,1087,0,1,0,1088,A
3-PA,1878,0,1,1087,0,1088,G
3-PA,1879,0,0,1077,0,1077,G
3-PA,1880,0,0,1073,0,1073,G
3-PA,1881,968,0,1,0,969,A
3-PA,1882,0,0,978,0,978,G
3-PA,1883,0,977,0,2,979,T
3-PA,1884,0,1,980,0,981,G
3-PA,1885,0,0,986,0,986,G
3-PA,1886,984,1,0,0,985,A
3-PA,1887,981,0,2,0,983,A
3-PA,1888,1,0,979,0,980,G
3-PA,1889,975,0,0,1,976,A
3-PA,1890,969,0,0,0,969,A
3-PA,1891,0,1,959,0,960,G
3-PA,1892,0,1,961,0,962,G
3-PA,1893,0,962,0,3,965,T
3-PA,1894,0,953,0,1,954,T
3-PA,1895,1,0,0,961,962,C
3-PA,1896,0,0,0,959,959,C
3-PA,1897,961,0,0,0,961,A
3-PA,1898,1,960,1,0,962,T
3-PA,1899,0,956,1,1,958,T
3-PA,1900,0,3,958,0,961,G
3-PA,1901,0,1,955,0,956,G
3-PA,1902,0,1,958,0,959,G
3-PA,1903,959,0,2,0,961,A
3-PA,1904,955,0,0,1,956,A
3-PA,1905,954,0,0,0,954,A
3-PA,1906,0,0,967,0,967,G
3-PA,1907,0,960,0,1,961,T
3-PA,1908,1,0,0,980,981,C
3-PA,1909,0,975,0,0,975,T
3-PA,1910,0,0,980,0,980,G
3-PA,1911,1,981,0,0,982,T
3-PA,1912,979,2,1,0,982,A
3-PA,1913,0,0,985,0,985,G
3-PA,1914,0,0,975,0,975,G
3-PA,1915,935,0,3,0,938,A
3-PA,1916,0,1,0,936,937,C
3-PA,1917,0,904,0,1,905,T
3-PA,1918,0,0,0,961,961,C
3-PA,1919,0,956,0,2,958,T
3-PA,1920,957,0,0,0,957,A
3-PA,1921,0,955,0,2,957,T
3-PA,1922,0,954,1,0,955,T
3-PA,1923,1,1,959,0,961,G
3-PA,1924,0,0,961,0,961,G
3-PA,1925,0,0,0,958,958,C
3-PA,1926,0,959,0,2,961,T
3-PA,1927,895,0,0,0,895,A
3-PA,1928,897,0,1,0,898,A
3-PA,1929,0,0,905,0,905,G
3-PA,1930,0,903,0,0,903,T
3-PA,1931,1,1,0,900,902,C
3-PA,1932,881,0,0,0,881,A
3-PA,1933,0,0,909,0,909,G
3-PA,1934,1,908,0,0,909,T
3-PA,1935,941,0,0,0,941,A
3-PA,1936,0,941,0,1,942,T
3-PA,1937,0,937,0,0,937,T
3-PA,1938,0,0,0,935,935,C
3-PA,1939,929,0,0,0,929,A
3-PA,1940,929,0,2,0,931,A
3-PA,1941,0,929,0,0,929,T
3-PA,1942,894,0,0,0,894,A
3-PA,1943,0,0,903,0,903,G
3-PA,1944,0,0,0,885,885,C
3-PA,1945,0,1,0,886,887,C
3-PA,1946,2,867,0,2,871,T
3-PA,1947,1,0,884,0,885,G
3-PA,1948,0,886,0,0,886,T
3-PA,1949,891,0,0,0,891,A
3-PA,1950,0,890,0,1,891,T
3-PA,1951,0,0,878,0,878,G
3-PA,1952,1,0,0,877,878,C
3-PA,1953,864,0,0,0,864,A
3-PA,1954,0,859,0,1,860,T
3-PA,1955,0,0,0,858,858,C
3-PA,1956,841,0,0,0,841,A
3-PA,1957,0,2,0,848,850,C
3-PA,1958,0,0,0,844,844,C
3-PA,1959,846,0,0,0,846,A
3-PA,1960,0,0,0,850,850,C
3-PA,1961,835,0,0,0,835,A
3-PA,1962,840,0,0,0,840,A
3-PA,1963,0,838,0,1,839,T
3-PA,1964,0,833,1,0,834,T
3-PA,1965,0,0,834,0,834,G
3-PA,1966,0,1,826,0,827,G
3-PA,1967,823,0,0,0,823,A
3-PA,1968,823,0,3,0,826,A
3-PA,1969,0,0,819,0,819,G
3-PA,1970,0,0,827,0,827,G
3-PA,1971,823,0,0,0,823,A
3-PA,1972,1,817,0,1,819,T
3-PA,1973,0,821,0,1,822,T
3-PA,1974,0,816,1,1,818,T
3-PA,1975,0,820,0,0,820,T
3-PA,1976,1,1,0,820,822,C
3-PA,1977,820,0,1,0,821,A
3-PA,1978,0,0,822,0,822,G
3-PA,1979,0,0,0,813,813,C
3-PA,1980,0,1,812,0,813,G
3-PA,1981,0,0,810,0,810,G
3-PA,1982,810,0,0,0,810,A
3-PA,1983,0,0,824,0,824,G
3-PA,1984,0,823,0,0,823,T
3-PA,1985,0,0,0,830,830,C
3-PA,1986,827,0,0,1,828,A
3-PA,1987,828,0,1,0,829,A
3-PA,1988,0,0,834,0,834,G
3-PA,1989,830,0,1,0,831,A
3-PA,1990,831,0,0,0,831,A
3-PA,1991,827,0,2,0,829,A
3-PA,1992,815,0,1,0,816,A
3-PA,1993,0,0,0,813,813,C
3-PA,1994,1,794,0,1,796,T
3-PA,1995,0,0,796,0,796,G
3-PA,1996,0,0,0,790,790,C
3-PA,1997,1,790,0,2,793,T
3-PA,1998,1,0,0,799,800,C
3-PA,1999,0,0,0,793,793,C
3-PA,2000,0,800,0,2,802,T
3-PA,2001,0,798,0,1,799,T
3-PA,2002,1,0,803,0,804,G
3-PA,2003,1,802,0,0,803,T
3-PA,2004,0,795,0,0,795,T
3-PA,2005,0,0,800,0,800,G
3-PA,2006,0,797,0,0,797,T
3-PA,2007,0,793,0,1,794,T
3-PA,2008,0,1,0,793,794,C
3-PA,2009,784,0,0,0,784,A
3-PA,2010,0,0,791,0,791,G
3-PA,2011,1,0,785,0,786,G
3-PA,2012,0,2,0,794,796,C
3-PA,2013,0,792,0,0,792,T
3-PA,2014,1,0,0,801,802,C
3-PA,2015,0,803,0,0,803,T
3-PA,2016,0,802,0,0,802,T
3-PA,2017,799,0,3,0,802,A
3-PA,2018,0,1,804,0,805,G
3-PA,2019,0,0,794,0,794,G
3-PA,2020,0,0,788,0,788,G
3-PA,2021,775,0,0,0,775,A
3-PA,2022,0,0,0,778,778,C
3-PA,2023,743,0,0,0,743,A
3-PA,2024,746,0,2,0,748,A
3-PA,2025,0,0,0,754,754,C
3-PA,2026,0,0,0,751,751,C
3-PA,2027,0,751,0,1,752,T
3-PA,2028,1,2,0,738,741,C
3-PA,2029,0,0,747,0,747,G
3-PA,2030,746,0,0,0,746,A
3-PA,2031,749,0,2,0,751,A
3-PA,2032,0,0,0,750,750,C
3-PA,2033,1,0,0,731,732,C
3-PA,2034,0,714,0,2,716,T
3-PA,2035,1,0,715,0,716,G
3-PA,2036,1,0,713,0,714,G
3-PA,2037,0,0,715,0,715,G
3-PA,2038,716,1,1,0,718,A
3-PA,2039,0,1,0,717,718,C
3-PA,2040,1,0,0,718,719,C
3-PA,2041,0,715,0,1,716,T
3-PA,2042,1,710,0,1,712,T
3-PA,2043,0,717,0,0,717,T
3-PA,2044,0,0,720,0,720,G
3-PA,2045,719,0,1,0,720,A
3-PA,2046,0,718,0,0,718,T
3-PA,2047,0,0,0,716,716,C
3-PA,2048,0,695,0,2,697,T
3-PA,2049,0,697,0,0,697,T
3-PA,2050,0,1,698,0,699,G
3-PA,2051,0,1,694,0,695,G
3-PA,2052,0,1,692,0,693,G
3-PA,2053,0,0,697,0,697,G
3-PA,2054,0,0,692,0,692,G
3-PA,2055,0,0,690,0,690,G
3-PA,2056,0,0,0,688,688,C
3-PA,2057,0,688,0,0,688,T
3-PA,2058,703,0,0,0,703,A
3-PA,2059,0,703,0,0,703,T
3-PA,2060,702,0,0,0,702,A
3-PA,2061,0,702,0,0,702,T
3-PA,2062,0,0,673,0,673,G
3-PA,2063,668,0,0,1,669,A
3-PA,2064,661,1,1,0,663,A
3-PA,2065,0,0,662,0,662,G
3-PA,2066,0,0,0,673,673,C
3-PA,2067,624,0,0,0,624,A
3-PA,2068,634,0,1,0,635,A
3-PA,2069,0,636,0,0,636,T
3-PA,2070,0,638,0,0,638,T
3-PA,2071,0,0,638,0,638,G
3-PA,2072,634,0,0,1,635,A
3-PA,2073,0,0,634,0,634,G
3-PA,2074,0,0,631,0,631,G
3-PA,2075,596,0,0,0,596,A
3-PA,2076,0,1,606,0,607,G
3-PA,2077,0,572,0,1,573,T
3-PA,2078,0,1,570,0,571,G
3-PA,2079,1,0,0,568,569,C
3-PA,2080,0,0,0,570,570,C
3-PA,2081,0,566,0,1,567,T
3-PA,2082,0,0,571,0,571,G
3-PA,2083,572,0,0,0,572,A
3-PA,2084,0,567,0,0,567,T
3-PA,2085,1,554,0,0,555,T
3-PA,2086,549,0,0,0,549,A
3-PA,2087,548,0,0,0,548,A
3-PA,2088,0,544,0,0,544,T
3-PA,2089,0,0,546,0,546,G
3-PA,2090,543,0,0,0,543,A
3-PA,2091,0,531,0,1,532,T
3-PA,2092,1,0,1,531,533,C
3-PA,2093,0,0,0,526,526,C
3-PA,2094,0,0,0,525,525,C
3-PA,2095,0,523,0,1,524,T
3-PA,2096,0,0,525,0,525,G
3-PA,2097,0,0,522,0,522,G
3-PA,2098,0,1,524,0,525,G
3-PA,2099,0,520,0,1,521,T
3-PA,2100,0,502,0,0,502,T
3-PA,2101,1,502,0,0,503,T
3-PA,2102,0,495,0,0,495,T
3-PA,2103,0,0,495,0,495,G
3-PA,2104,0,0,0,495,495,C
3-PA,2105,0,491,0,0,491,T
3-PA,2106,0,0,0,490,490,C
3-PA,2107,476,0,0,0,476,A
3-PA,2108,476,0,0,0,476,A
3-PA,2109,0,475,0,0,475,T
3-PA,2110,0,0,473,0,473,G
3-PA,2111,1,0,0,472,473,C
3-PA,2112,0,0,458,0,458,G
3-PA,2113,0,458,0,0,458,T
3-PA,2114,0,0,0,459,459,C
3-PA,2115,0,456,0,1,457,T
3-PA,2116,0,456,0,0,456,T
3-PA,2117,0,0,454,0,454,G
3-PA,2118,0,0,454,0,454,G
3-PA,2119,0,455,0,0,455,T
3-PA,2120,0,453,0,0,453,T
3-PA,2121,0,0,0,444,444,C
3-PA,2122,438,0,0,0,438,A
3-PA,2123,437,0,0,0,437,A
3-PA,2124,1,0,0,437,438,C
3-PA,2125,0,431,0,0,431,T
3-PA,2126,0,0,0,433,433,C
3-PA,2127,1,0,0,419,420,C
3-PA,2128,0,417,0,0,417,T
3-PA,2129,0,417,0,0,417,T
3-PA,2130,0,0,0,417,417,C
3-PA,2131,0,0,0,416,416,C
3-PA,2132,0,406,0,0,406,T
3-PA,2133,0,0,405,0,405,G
3-PA,2134,403,0,1,0,404,A
3-PA,2135,0,0,0,400,400,C
3-PA,2136,387,0,1,0,388,A
3-PA,2137,0,0,0,375,375,C
3-PA,2138,369,0,0,0,369,A
3-PA,2139,1,363,0,0,364,T
3-PA,2140,0,0,367,0,367,G
3-PA,2141,2,0,0,360,362,C
3-PA,2142,351,0,0,0,351,A
3-PA,2143,0,350,0,0,350,T
3-PA,2144,0,341,1,0,342,T
3-PA,2145,340,0,0,0,340,A
3-PA,2146,338,0,0,0,338,A
3-PA,2147,336,0,0,0,336,A
3-PA,2148,335,0,1,0,336,A
3-PA,2149,0,332,0,0,332,T
3-PA,2150,262,0,0,0,262,A
3-PA,2151,0,0,263,0,263,G
4-HA,1,264,0,0,0,264,A
4-HA,2,0,264,0,0,264,T
4-HA,3,0,0,267,0,267,G
4-HA,4,268,0,0,0,268,A
4-HA,5,268,0,2,0,270,A
4-HA,6,0,0,299,0,299,G
4-HA,7,298,0,0,0,298,A
4-HA,8,0,0,0,324,324,C
4-HA,9,0,324,0,0,324,T
4-HA,10,332,0,0,0,332,A
4-HA,11,0,341,0,0,341,T
4-HA,12,0,0,0,344,344,C
4-HA,13,344,0,0,0,344,A
4-HA,14,0,344,0,1,345,T
4-HA,15,0,345,0,0,345,T
4-HA,16,0,0,384,0,384,G
4-HA,17,0,0,0,385,385,C
4-HA,18,0,385,0,0,385,T
4-HA,19,0,386,0,0,386,T
4-HA,20,0,387,0,0,387,T
4-HA,21,1,0,411,0,412,G
4-HA,22,413,0,0,0,413,A
4-HA,23,0,0,425,0,425,G
4-HA,24,0,0,0,428,428,C
4-HA,25,0,429,0,0,429,T
4-HA,26,459,0,0,0,459,A
4-HA,27,0,0,0,464,464,C
4-HA,28,469,0,0,0,469,A
4-HA,29,0,496,1,1,498,T
4-HA,30,0,495,0,1,496,T
4-HA,31,0,0,0,499,499,C
4-HA,32,0,497,0,0,497,T
4-HA,33,508,0,0,0,508,A
4-HA,34,0,506,0,1,507,T
4-HA,35,0,0,507,0,507,G
4-HA,36,0,507,0,0,507,T
4-HA,37,0,0,0,508,508,C
4-HA,38,0,506,0,0,506,T
4-HA,39,0,0,508,0,508,G
4-HA,40,0,0,507,0,507,G
4-HA,41,1,506,0,1,508,T
4-HA,42,0,508,0,0,508,T
4-HA,43,0,507,0,1,508,T
4-HA,44,0,507,0,0,507,T
4-HA,45,0,0,0,507,507,C
4-HA,46,0,0,507,0,507,G
4-HA,47,0,0,0,514,514,C
4-HA,48,1,509,0,2,512,T
4-HA,49,0,0,0,516,516,C
4-HA,50,516,0,0,0,516,A
4-HA,51,518,0,0,0,518,A
4-HA,52,518,0,0,0,518,A
4-HA,53,517,0,1,0,518,A
4-HA,54,519,0,0,0,519,A
4-HA,55,0,0,0,522,522,C
4-HA,56,0,521,0,0,521,T
4-HA,57,0,520,0,0,520,T
4-HA,58,0,1,0,520,521,C
4-HA,59,2,0,0,520,522,C
4-HA,60,0,521,0,0,521,T
4-HA,61,0,0,532,0,532,G
4-HA,62,1,0,531,0,532,G
4-HA,63,532,0,0,0,532,A
4-HA,64,545,0,0,0,545,A
4-HA,65,541,0,0,0,541,A
4-HA,66,0,552,0,0,552,T
4-HA,67,0,0,554,0,554,G
4-HA,68,555,0,0,0,555,A
4-HA,69,0,0,0,559,559,C
4-HA,70,555,0,0,0,555,A
4-HA,71,555,0,0,0,555,A
4-HA,72,0,1,0,568,569,C
4-HA,73,567,0,0,0,567,A
4-HA,74,0,0,573,0,573,G
4-HA,75,0,0,0,569,569,C
4-HA,76,568,0,0,0,568,A
4-HA,77,0,0,0,593,593,C
4-HA,78,1,1,590,0,592,G
4-HA,79,0,0,596,0,596,G
4-HA,80,0,0,0,599,599,C
4-HA,81,598,0,0,0,598,A
4-HA,82,609,0,0,0,609,A
4-HA,83,1,1,0,611,613,C
4-HA,84,1,0,622,0,623,G
4-HA,85,0,1,0,625,626,C
4-HA,86,0,615,0,1,616,T
4-HA,87,0,0,617,0,617,G
4-HA,88,0,618,0,0,618,T
4-HA,89,0,0,637,0,637,G
4-HA,90,0,0,0,652,652,C
4-HA,91,0,0,0,661,661,C
4-HA,92,0,659,0,1,660,T
4-HA,93,0,658,0,0,658,T
4-HA,94,0,3,657,0,660,G
4-HA,95,0,1,659,0,660,G
4-HA,96,0,0,670,0,670,G
4-HA,97,0,0,0,669,669,C
4-HA,98,662,0,0,0,662,A
4-HA,99,0,0,0,668,668,C
4-HA,100,0,0,0,665,665,C
4-HA,101,713,0,0,0,713,A
4-HA,102,0,716,0,0,716,T
4-HA,103,0,0,717,0,717,G
4-HA,104,2,0,0,715,717,C
4-HA,105,708,1,0,0,709,A
4-HA,106,0,0,763,0,763,G
4-HA,107,0,765,0,0,765,T
4-HA,108,771,0,1,0,772,A
4-HA,109,1,0,0,768,769,C
4-HA,110,0,0,0,756,756,C
4-HA,111,766,0,0,0,766,A
4-HA,112,764,0,0,0,764,A
4-HA,113,767,0,0,0,767,A
4-HA,114,0,0,0,772,772,C
4-HA,115,0,0,760,0,760,G
4-HA,116,0,0,770,0,770,G
4-HA,117,770,0,1,0,771,A
4-HA,118,773,0,0,0,773,A
4-HA,119,0,1,0,771,772,C
4-HA,120,1,1,768,0,770,G
4-HA,121,1,0,767,0,768,G
4-HA,122,0,806,0,0,806,T
4-HA,123,811,0,1,0,812,A
4-HA,124,1,0,811,0,812,G
4-HA,125,1,809,0,1,811,T
4-HA,126,0,0,814,0,814,G
4-HA,127,816,1,0,0,817,A
4-HA,128,815,0,1,0,816,A
4-HA,129,812,0,2,0,814,A
4-HA,130,810,0,1,0,811,A
4-HA,131,0,1,0,819,820,C
4-HA,132,814,0,1,0,815,A
4-HA,133,817,0,1,0,818,A
4-HA,134,0,817,0,0,817,T
4-HA,135,0,0,0,818,818,C
4-HA,136,821,0,0,0,821,A
4-HA,137,0,0,0,822,822,C
4-HA,138,0,2,819,0,821,G
4-HA,139,820,0,0,0,820,A
4-HA,140,817,0,2,0,819,A
4-HA,141,0,821,0,0,821,T
4-HA,142,0,3,815,0,818,G
4-HA,143,826,0,2,0,828,A
4-HA,144,0,0,0,829,829,C
4-HA,145,0,1,0,826,827,C
4-HA,146,835,0,2,0,837,A
4-HA,147,847,0,0,0,847,A
4-HA,148,845,1,0,0,846,A
4-HA,149,0,848,0,0,848,T
4-HA,150,0,849,0,0,849,T
4-HA,151,0,0,858,1,859,G
4-HA,152,854,1,1,0,856,A
4-HA,153,854,0,3,0,857,A
4-HA,154,0,0,864,0,864,G
4-HA,155,1,853,0,0,854,T
4-HA,156,0,893,0,0,893,T
4-HA,157,896,0,0,0,896,A
4-HA,158,0,0,0,896,896,C
4-HA,159,0,899,0,1,900,T
4-HA,160,901,0,0,0,901,A
4-HA,161,918,0,0,0,918,A
4-HA,162,0,916,0,1,917,T
4-HA,163,1,0,919,0,920,G
4-HA,164,0,0,0,967,967,C
4-HA,165,0,955,0,0,955,T
4-HA,166,959,0,0,0,959,A
4-HA,167,0,0,0,960,960,C
4-HA,168,1,955,0,0,956,T
4-HA,169,0,0,962,0,962,G
4-HA,170,957,0,0,0,957,A
4-HA,171,0,0,954,0,954,G
4-HA,172,0,1,0,959,960,C
4-HA,173,0,949,0,0,949,T
4-HA,174,0,0,972,0,972,G
4-HA,175,1,1,990,0,992,G
4-HA,176,0,993,0,2,995,T
4-HA,177,0,993,0,2,995,T
4-HA,178,0,0,0,995,995,C
4-HA,179,992,0,1,0,993,A
4-HA,180,0,0,1001,0,1001,G
4-HA,181,1000,0,0,0,1000,A
4-HA,182,0,0,1028,0,1028,G
4-HA,183,0,1024,0,0,1024,T
4-HA,184,0,1007,0,0,1007,T
4-HA,185,1,0,0,1019,1020,C
4-HA,186,0,0,0,1019,1019,C
4-HA,187,0,1016,0,1,1017,T
4-HA,188,0,0,0,1024,1024,C
4-HA,189,1022,1,0,0,1023,A
4-HA,190,1023,0,0,0,1023,A
4-HA,191,0,0,0,1027,1027,C
4-HA,192,1012,0,0,0,1012,A
4-HA,193,0,0,1040,0,1040,G
4-HA,194,0,0,1045,0,1045,G
4-HA,195,0,1043,0,0,1043,T
4-HA,196,0,0,1049,0,1049,G
4-HA,197,1047,0,1,0,1048,A
4-HA,198,1047,0,1,0,1048,A
4-HA,199,1069,0,1,1,1071,A
4-HA,200,0,1063,0,0,1063,T
4-HA,201,1069,1,1,0,1071,A
4-HA,202,0,1059,0,1,1060,T
4-HA,203,0,0,1060,0,1060,G
4-HA,204,0,0,0,1070,1070,C
4-HA,205,1,0,1066,0,1067,G
4-HA,206,1074,0,1,0,1075,A
4-HA,207,0,0,0,1073,1073,C
4-HA,208,1054,0,0,0,1054,A
4-HA,209,0,0,1097,0,1097,G
4-HA,210,0,1092,0,0,1092,T
4-HA,211,0,0,0,1115,1115,C
4-HA,212,0,1,0,1110,1111,C
4-HA,213,1,1108,0,3,1112,T
4-HA,214,0,0,0,1133,1133,C
4-HA,215,1132,1,0,0,1133,A
4-HA,216,1,1129,0,4,1134,T
4-HA,217,0,2,0,1131,1133,C
4-HA,218,1088,0,1,0,1089,A
4-HA,219,1,0,1092,0,1093,G
4-HA,220,1082,0,3,0,1085,A
4-HA,221,0,1085,0,1,1086,T
4-HA,222,0,0,0,1086,1086,C
4-HA,223,0,0,0,1075,1075,C
4-HA,224,0,1072,0,0,1072,T
4-HA,225,0,1068,1,1,1070,T
4-HA,226,0,1,1071,0,1072,G
4-HA,227,1072,1,0,0,1073,A
4-HA,228,1,1069,0,0,1070,T
4-HA,229,0,1,1073,0,1074,G
4-HA,230,0,0,1076,0,1076,G
4-HA,231,1069,0,3,0,1072,A
4-HA,232,1070,0,0,1,1071,A
4-HA,233,1071,0,1,0,1072,A
4-HA,234,1081,0,0,0,1081,A
4-HA,235,1082,0,1,1,1084,A
4-HA,236,1081,0,1,0,1082,A
4-HA,237,0,0,0,1087,1087,C
4-HA,238,0,1081,0,0,1081,T
4-HA,239,0,0,1083,0,1083,G
4-HA,240,0,1,0,1082,1083,C
4-HA,241,1082,0,1,0,1083,A
4-HA,242,0,0,0,1142,1142,C
4-HA,243,1142,0,1,0,1143,A
4-HA,244,0,0,0,1272,1272,C
4-HA,245,0,1271,0,1,1272,T
4-HA,246,1292,0,0,0,1292,A
4-HA,247,1295,0,1,0,1296,A
4-HA,248,0,1299,0,1,1300,T
4-HA,249,1302,0,1,0,1303,A
4-HA,250,0,0,1305,0,1305,G
4-HA,251,1281,1,0,0,1282,A
4-HA,252,0,1261,0,1,1262,T
4-HA,253,0,0,1191,0,1191,G
4-HA,254,0,0,0,1196,1196,C
4-HA,255,0,1193,0,1,1194,T
4-HA,256,0,0,0,1253,1253,C
4-HA,257,0,1250,0,0,1250,T
4-HA,258,1277,0,0,0,1277,A
4-HA,259,0,1277,1,0,1278,T
4-HA,260,0,1270,1,1,1272,T
4-HA,261,1,2,1279,0,1282,G
4-HA,262,3,1,1268,2,1274,G
4-HA,263,2,3,1275,0,1280,G
4-HA,264,1272,0,1,0,1273,A
4-HA,265,0,0,1269,0,1269,G
4-HA,266,1244,1,4,0,1249,A
4-HA,267,0,0,0,1331,1331,C
4-HA,268,1,0,0,1342,1343,C
4-HA,269,3,0,0,1340,1343,C
4-HA,270,0,1345,0,4,1349,T
4-HA,271,2,0,0,1378,1380,C
4-HA,272,1377,1,1,0,1379,A
4-HA,273,0,1,1459,0,1460,G
4-HA,274,0,1456,0,0,1456,T
4-HA,275,1,9,1456,0,1466,G
4-HA,276,0,1418,1,0,1419,T
4-HA,277,0,2,1415,0,1417,G
4-HA,278,1406,9,1,0,1416,A
4-HA,279,0,1413,0,1,1414,T
4-HA,280,0,0,1401,0,1401,G
4-HA,281,0,0,1396,0,1396,G
4-HA,282,0,0,0,1374,1374,C
4-HA,283,0,1371,0,1,1372,T
4-HA,284,0,1371,0,1,1372,T
4-HA,285,2,1,0,1365,1368,C
4-HA,286,0,4,0,1358,1362,C
4-HA,287,1377,1,0,0,1378,A
4-HA,288,1376,0,2,0,1378,A
4-HA,289,1377,0,0,1,1378,A
4-HA,290,1380,0,0,0,1380,A
4-HA,291,1,1384,0,1,1386,T
4-HA,292,1384,0,0,0,1384,A
4-HA,293,1382,0,4,0,1386,A
4-HA,294,0,2,1388,0,1390,G
4-HA,295,1396,0,0,0,1396,A
4-HA,296,1398,0,0,0,1398,A
4-HA,297,1397,0,1,0,1398,A
4-HA,298,0,1401,0,0,1401,T
4-HA,299,1,0,1400,0,1401,G
4-HA,300,1,1,1394,0,1396,G
4-HA,301,0,0,1392,0,1392,G
4-HA,302,1394,0,1,0,1395,A
4-HA,303,0,0,0,1401,1401,C
4-HA,304,0,0,0,1401,1401,C
4-HA,305,0,1414,0,2,1416,T
4-HA,306,1,1416,0,3,1420,T
4-HA,307,1,1411,0,0,1412,T
4-HA,308,0,1421,0,0,1421,T
4-HA,309,0,1420,0,2,1422,T
4-HA,310,0,0,1428,0,1428,G
4-HA,311,0,1424,0,3,1427,T
4-HA,312,0,1414,0,2,1416,T
4-HA,313,2,1,1415,0,1418,G
4-HA,314,1408,0,1,0,1409,A
4-HA,315,1414,0,0,0,1414,A
4-HA,316,0,0,0,1415,1415,C
4-HA,317,0,0,1408,0,1408,G
4-HA,318,0,0,0,1430,1430,C
4-HA,319,1426,0,0,0,1426,A
4-HA,320,1,0,1441,0,1442,G
4-HA,321,0,1,0,1441,1442,C
4-HA,322,1443,0,2,0,1445,A
4-HA,323,1441,1,2,0,1444,A
4-HA,324,1447,0,0,0,1447,A
4-HA,325,0,0,1505,0,1505,G
4-HA,326,0,1,1,1504,1506,C
4-HA,327,1,0,0,1497,1498,C
4-HA,328,0,1502,0,0,1502,T
4-HA,329,1501,0,2,1,1504,A
4-HA,330,0,3,0,1513,1516,C
4-HA,331,1508,0,0,0,1508,A
4-HA,332,0,0,1514,0,1514,G
4-HA,333,1,2,0,1507,1510,C
4-HA,334,1490,0,0,0,1490,A
4-HA,335,1510,0,1,0,1511,A
4-HA,336,0,0,0,1587,1587,C
4-HA,337,0,1582,0,0,1582,T
4-HA,338,0,0,1587,0,1587,G
4-HA,339,0,1573,0,1,1574,T
4-HA,340,0,1577,0,0,1577,T
4-HA,341,1576,0,1,0,1577,A
4-HA,342,0,0,0,1683,1683,C
4-HA,343,1,0,0,1689,1690,C
4-HA,344,0,2,0,1725,1727,C
4-HA,345,0,1677,0,2,1679,T
4-HA,346,0,1680,0,1,1681,T
4-HA,347,1679,0,0,0,1679,A
4-HA,348,1,1677,1,0,1679,T
4-HA,349,0,1,1677,0,1678,G
4-HA,350,1672,0,2,0,1674,A
4-HA,351,0,1569,0,2,1571,T
4-HA,352,1,0,1590,0,1591,G
4-HA,353,0,1558,0,0,1558,T
4-HA,354,0,0,1557,0,1557,G
4-HA,355,1,2,0,1553,1556,C
4-HA,356,0,3,0,1555,1558,C
4-HA,357,2,0,1581,0,1583,G
4-HA,358,0,1,1611,0,1612,G
4-HA,359,1608,0,1,0,1609,A
4-HA,360,0,1612,0,0,1612,T
4-HA,361,0,1597,0,1,1598,T
4-HA,362,1604,0,1,0,1605,A
4-HA,363,0,1606,0,0,1606,T
4-HA,364,1,1,1603,0,1605,G
4-HA,365,0,2,0,1603,1605,C
4-HA,366,1,3,1,1580,1585,C
4-HA,367,0,1592,0,2,1594,T
4-HA,368,2,0,0,1654,1656,C
4-HA,369,0,0,0,1665,1665,C
4-HA,370,0,0,0,1670,1670,C
4-HA,371,0,1658,0,2,1660,T
4-HA,372,0,1655,0,2,1657,T
4-HA,373,1656,1,0,1,1658,A
4-HA,374,1,1,1694,0,1696,G
4-HA,375,0,0,1699,0,1699,G
4-HA,376,1,1683,0,0,1684,T
4-HA,377,1,0,0,1655,1656,C
4-HA,378,1651,0,1,0,1652,A
4-HA,379,0,0,0,1680,1680,C
4-HA,380,0,1682,0,0,1682,T
4-HA,381,1685,0,0,0,1685,A
4-HA,382,3,0,1681,0,1684,G
4-HA,383,0,1661,0,1,1662,T
4-HA,384,0,1653,0,3,1656,T
4-HA,385,0,0,1668,0,1668,G
4-HA,386,1,0,0,1670,1671,C
4-HA,387,1,0,0,1666,1667,C
4-HA,388,0,1655,1,2,1658,T
4-HA,389,2,0,0,1663,1665,C
4-HA,390,1707,1,1,0,1709,A
4-HA,391,0,1703,0,1,1704,T
4-HA,392,1,0,0,1706,1707,C
4-HA,393,0,0,0,1710,1710,C
4-HA,394,1,1,1691,0,1693,G
4-HA,395,0,1,1691,0,1692,G
4-HA,396,0,0,0,1702,1702,C
4-HA,397,1722,0,2,0,1724,A
4-HA,398,0,2,1,1736,1739,C
4-HA,399,1721,0,1,0,1722,A
4-HA,400,0,0,0,1733,1733,C
4-HA,401,1,1727,0,0,1728,T
4-HA,402,0,1,1734,0,1735,G
4-HA,403,0,1,1746,0,1747,G
4-HA,404,1738,0,4,0,1742,A
4-HA,405,0,0,1766,0,1766,G
4-HA,406,0,1754,0,0,1754,T
4-HA,407,1,1739,0,0,1740,T
4-HA,408,0,1736,0,2,1738,T
4-HA,409,1728,0,0,0,1728,A
4-HA,410,1736,0,0,0,1736,A
4-HA,411,0,0,0,1751,1751,C
4-HA,412,1726,1,1,0,1728,A
4-HA,413,1730,0,2,0,1732,A
4-HA,414,1,1717,0,1,1719,T
4-HA,415,0,1,1719,0,1720,G
4-HA,416,1711,0,2,0,1713,A
4-HA,417,1708,5,2,0,1715,A
4-HA,418,1709,2,4,1,1716,A
4-HA,419,0,0,1724,0,1724,G
4-HA,420,0,0,0,1733,1733,C
4-HA,421,0,1723,0,3,1726,T
4-HA,422,0,1721,0,1,1722,T
4-HA,423,0,0,0,1743,1743,C
4-HA,424,1744,0,1,1,1746,A
4-HA,425,1750,0,2,0,1752,A
4-HA,426,1,1747,0,2,1750,T
4-HA,427,0,1747,0,0,1747,T
4-HA,428,0,1,1787,0,1788,G
4-HA,429,0,1,1788,0,1789,G
4-HA,430,1788,0,2,0,1790,A
4-HA,431,0,0,1,1792,1793,C
4-HA,432,0,1778,0,0,1778,T
4-HA,433,0,0,1784,0,1784,G
4-HA,434,1,0,1787,0,1788,G
4-HA,435,1786,0,3,0,1789,A
4-HA,436,0,0,1795,0,1795,G
4-HA,437,0,1762,0,3,1765,T
4-HA,438,1,1,0,1755,1757,C
4-HA,439,1780,1,1,0,1782,A
4-HA,440,0,0,0,1786,1786,C
4-HA,441,0,1781,0,3,1784,T
4-HA,442,1,0,0,1783,1784,C
4-HA,443,1784,0,0,0,1784,A
4-HA,444,1792,0,0,0,1792,A
4-HA,445,1793,0,1,0,1794,A
4-HA,446,1795,0,1,0,1796,A
4-HA,447,1,1,0,1799,1801,C
4-HA,448,1,1,1798,0,1800,G
4-HA,449,1,2,1827,0,1830,G
4-HA,450,1828,0,0,0,1828,A
4-HA,451,1825,0,1,0,1826,A
4-HA,452,0,1,0,1828,1829,C
4-HA,453,1814,0,1,1,1816,A
4-HA,454,1834,0,0,0,1834,A
4-HA,455,0,1,1857,1,1859,G
4-HA,456,1,0,0,1863,1864,C
4-HA,457,0,1846,0,2,1848,T
4-HA,458,1,1,0,1851,1853,C
4-HA,459,0,1850,0,0,1850,T
4-HA,460,0,0,1859,0,1859,G
4-HA,461,0,0,0,1862,1862,C
4-HA,462,0,1853,0,2,1855,T
4-HA,463,0,1913,0,1,1914,T
4-HA,464,1,0,1937,0,1938,G
4-HA,465,0,0,0,1951,1951,C
4-HA,466,1953,0,0,0,1953,A
4-HA,467,0,1941,0,0,1941,T
4-HA,468,1933,0,0,0,1933,A
4-HA,469,1928,0,2,1,1931,A
4-HA,470,0,1,1932,0,1933,G
4-HA,471,1,1,1933,0,1935,G
4-HA,472,1891,0,1,0,1892,A
4-HA,473,0,0,1868,0,1868,G
4-HA,474,1857,0,2,0,1859,A
4-HA,475,1,1916,0,1,1918,T
4-HA,476,1,0,0,1927,1928,C
4-HA,477,0,1931,0,0,1931,T
4-HA,478,1930,0,0,0,1930,A
4-HA,479,1926,0,0,0,1926,A
4-HA,480,1910,1,0,1,1912,A
4-HA,481,1918,0,0,1,1919,A
4-HA,482,1923,0,0,1,1924,A
4-HA,483,1,0,0,1929,1930,C
4-HA,484,1877,0,0,0,1877,A
4-HA,485,0,0,1888,0,1888,G
4-HA,486,0,1881,0,2,1883,T
4-HA,487,0,1906,0,0,1906,T
4-HA,488,1,1906,0,2,1909,T
4-HA,489,0,1,0,1968,1969,C
4-HA,490,0,1965,0,3,1968,T
4-HA,491,1,1971,0,0,1972,T
4-HA,492,0,1969,0,1,1970,T
4-HA,493,1959,0,4,0,1963,A
4-HA,494,0,0,1969,0,1969,G
4-HA,495,1,1963,0,0,1964,T
4-HA,496,1947,0,0,0,1947,A
4-HA,497,0,0,1961,0,1961,G
4-HA,498,1937,0,0,0,1937,A
4-HA,499,0,1937,0,0,1937,T
4-HA,500,0,1930,0,1,1931,T
4-HA,501,0,3,1967,0,1970,G
4-HA,502,1966,0,1,0,1967,A
4-HA,503,1968,0,0,0,1968,A
4-HA,504,1,1965,0,0,1966,T
4-HA,505,0,1944,0,3,1947,T
4-HA,506,0,0,1963,0,1963,G
4-HA,507,1,0,1956,0,1957,G
4-HA,508,1,1960,0,2,1963,T
4-HA,509,0,1959,0,0,1959,T
4-HA,510,0,5,1929,0,1934,G
4-HA,511,1937,1,2,0,1940,A
4-HA,512,0,0,1,1934,1935,C
4-HA,513,1,0,0,1936,1937,C
4-HA,514,2,0,0,1956,1958,C
4-HA,515,1954,0,2,0,1956,A
4-HA,516,0,0,0,1968,1968,C
4-HA,517,0,1965,1,0,1966,T
4-HA,518,0,1966,0,0,1966,T
4-HA,519,1967,0,0,0,1967,A
4-HA,520,1961,0,0,0,1961,A
4-HA,521,1954,0,3,1,1958,A
4-HA,522,0,1,0,1913,1914,C
4-HA,523,0,1964,0,0,1964,T
4-HA,524,0,1965,0,1,1966,T
4-HA,525,2,0,0,1986,1988,C
4-HA,526,1984,0,2,0,1986,A
4-HA,527,1984,1,0,0,1985,A
4-HA,528,1988,0,0,0,1988,A
4-HA,529,0,1987,0,2,1989,T
4-HA,530,2004,2,1,0,2007,A
4-HA,531,0,1,0,2007,2008,C
4-HA,532,2,1,0,1956,1959,C
4-HA,533,1,0,0,1955,1956,C
4-HA,534,1938,0,3,0,1941,A
4-HA,535,0,0,2041,0,2041,G
4-HA,536,1,0,0,2052,2053,C
4-HA,537,2046,0,0,0,2046,A
4-HA,538,0,2046,0,0,2046,T
4-HA,539,1,2027,0,0,2028,T
4-HA,540,0,1,2070,0,2071,G
4-HA,541,2075,0,4,0,2079,A
4-HA,542,2076,0,1,0,2077,A
4-HA,543,0,1,0,2072,2073,C
4-HA,544,0,0,2010,0,2010,G
4-HA,545,1,2027,0,2,2030,T
4-HA,546,0,0,2034,0,2034,G
4-HA,547,2031,0,3,0,2034,A
4-HA,548,0,0,0,2036,2036,C
4-HA,549,0,1980,0,1,1981,T
4-HA,550,2017,1,1,0,2019,A
4-HA,551,1,2010,0,2,2013,T
4-HA,552,0,1,2028,0,2029,G
4-HA,553,1,1,1,2022,2025,C
4-HA,554,1,2,0,2006,2009,C
4-HA,555,2008,0,1,0,2009,A
4-HA,556,2013,0,0,0,2013,A
4-HA,557,2042,0,4,0,2046,A
4-HA,558,0,2,0,2043,2045,C
4-HA,559,2022,0,0,0,2022,A
4-HA,560,2021,0,0,1,2022,A
4-HA,561,0,2006,0,1,2007,T
4-HA,562,1,4,2003,0,2008,G
4-HA,563,2006,2,1,1,2010,A
4-HA,564,2006,1,2,1,2010,A
4-HA,565,0,1,0,1991,1992,C
4-HA,566,2001,1,1,0,2003,A
4-HA,567,2017,0,0,0,2017,A
4-HA,568,3,2016,0,0,2019,T
4-HA,569,0,2013,0,0,2013,T
4-HA,570,1,2021,0,0,2022,T
4-HA,571,0,3,2019,0,2022,G
4-HA,572,2021,0,3,0,2024,A
4-HA,573,0,2,0,2024,2026,C
4-HA,574,2021,1,0,0,2022,A
4-HA,575,2023,1,0,0,2024,A
4-HA,576,2052,0,0,0,2052,A
4-HA,577,0,2066,0,0,2066,T
4-HA,578,2,2053,0,0,2055,T
4-HA,579,0,0,2069,0,2069,G
4-HA,580,0,2067,0,1,2068,T
4-HA,581,2074,0,2,0,2076,A
4-HA,582,1,0,0,2124,2125,C
4-HA,583,2128,0,0,0,2128,A
4-HA,584,0,2151,0,2,2153,T
4-HA,585,0,2121,0,1,2122,T
4-HA,586,2,2116,0,1,2119,T
4-HA,587,0,1,2105,1,2107,G
4-HA,588,2,3,2099,0,2104,G
4-HA,589,1,1,2106,0,2108,G
4-HA,590,1,2,2105,0,2108,G
4-HA,591,1,3,2057,0,2061,G
4-HA,592,0,1,2094,1,2096,G
4-HA,593,1,2073,0,1,2075,T
4-HA,594,0,2079,0,3,2082,T
4-HA,595,2,0,0,2087,2089,C
4-HA,596,2088,0,3,0,2091,A
4-HA,597,1,1,0,2097,2099,C
4-HA,598,2,0,1,2095,2098,C
4-HA,599,2094,1,1,0,2096,A
4-HA,600,1,2,0,2108,2111,C
4-HA,601,3,1,0,2078,2082,C
4-HA,602,2,1,1,2067,2071,C
4-HA,603,0,2,2075,0,2077,G
4-HA,604,1,0,2108,0,2109,G
4-HA,605,0,5,2111,1,2117,G
4-HA,606,0,2105,0,2,2107,T
4-HA,607,2104,0,0,0,2104,A
4-HA,608,0,5,0,2087,2092,C
4-HA,609,4,0,2065,0,2069,G
4-HA,610,1,2,2096,0,2099,G
4-HA,611,2106,1,3,0,2110,A
4-HA,612,0,1,0,2102,2103,C
4-HA,613,2049,0,0,0,2049,A
4-HA,614,2050,0,0,0,2050,A
4-HA,615,2040,0,4,0,2044,A
4-HA,616,0,3,2087,0,2090,G
4-HA,617,2097,0,0,0,2097,A
4-HA,618,0,0,0,2093,2093,C
4-HA,619,4,1,0,2060,2065,C
4-HA,620,2066,0,1,0,2067,A
4-HA,621,2063,0,0,0,2063,A
4-HA,622,2091,0,2,0,2093,A
4-HA,623,0,2089,0,2,2091,T
4-HA,624,0,1,0,2095,2096,C
4-HA,625,2,1974,0,3,1979,T
4-HA,626,0,1969,1,1,1971,T
4-HA,627,2,1,0,1989,1992,C
4-HA,628,1,0,0,1990,1991,C
4-HA,629,1,1981,1,4,1987,T
4-HA,630,0,1,2001,0,2002,G
4-HA,631,1,1976,0,1,1978,T
4-HA,632,1985,1,2,0,1988,A
4-HA,633,0,1976,0,1,1977,T
4-HA,634,0,1,1978,0,1979,G
4-HA,635,1,0,0,1970,1971,C
4-HA,636,0,1962,0,3,1965,T
4-HA,637,2,3,1,1962,1968,C
4-HA,638,1971,0,5,0,1976,A
4-HA,639,1957,0,3,0,1960,A
4-HA,640,0,0,1975,0,1975,G
4-HA,641,1,1,0,1982,1984,C
4-HA,642,1980,1,2,0,1983,A
4-HA,643,0,1972,0,2,1974,T
4-HA,644,0,2,0,1973,1975,C
4-HA,645,1970,1,4,0,1975,A
4-HA,646,1,0,1998,0,1999,G
4-HA,647,0,1,1998,0,1999,G
4-HA,648,2004,0,0,0,2004,A
4-HA,649,1985,0,3,0,1988,A
4-HA,650,2,3,2034,0,2039,G
4-HA,651,2038,0,2,1,2041,A
4-HA,652,2066,2,1,0,2069,A
4-HA,653,0,2080,0,1,2081,T
4-HA,654,3,2,0,2071,2076,C
4-HA,655,2058,0,2,0,2060,A
4-HA,656,0,0,0,2059,2059,C
4-HA,657,2053,0,1,0,2054,A
4-HA,658,2,0,2078,0,2080,G
4-HA,659,1,2037,1,1,2040,T
4-HA,660,2,0,0,2040,2042,C
4-HA,661,1,2019,0,1,2021,T
4-HA,662,2,0,0,2067,2069,C
4-HA,663,1,2068,0,1,2070,T
4-HA,664,2087,0,0,0,2087,A
4-HA,665,1,0,0,2087,2088,C
4-HA,666,0,1,0,2085,2086,C
4-HA,667,2054,0,1,0,2055,A
4-HA,668,2058,0,0,0,2058,A
4-HA,669,2049,0,0,1,2050,A
4-HA,670,2043,0,3,1,2047,A
4-HA,671,0,0,2060,0,2060,G
4-HA,672,2024,0,1,1,2026,A
4-HA,673,2022,0,0,1,2023,A
4-HA,674,4,0,2018,0,2022,G
4-HA,675,1,2,0,2015,2018,C
4-HA,676,0,0,0,2025,2025,C
4-HA,677,2019,0,2,1,2022,A
4-HA,678,2023,8,0,1,2032,A
4-HA,679,1,0,0,2030,2031,C
4-HA,680,2026,0,1,1,2028,A
4-HA,681,2024,0,0,9,2033,A
4-HA,682,2021,2,1,0,2024,A
4-HA,683,0,0,0,2074,2074,C
4-HA,684,0,2061,0,1,2062,T
4-HA,685,0,0,2072,0,2072,G
4-HA,686,0,2066,0,5,2071,T
4-HA,687,2063,0,1,1,2065,A
4-HA,688,2069,0,0,1,2070,A
4-HA,689,0,2063,0,1,2064,T
4-HA,690,2,0,0,2074,2076,C
4-HA,691,2,1,0,2067,2070,C
4-HA,692,1,0,0,2051,2052,C
4-HA,693,1,0,2051,0,2052,G
4-HA,694,2053,0,0,0,2053,A
4-HA,695,2050,0,1,0,2051,A
4-HA,696,0,2053,0,1,2054,T
4-HA,697,2052,0,0,0,2052,A
4-HA,698,0,2047,0,0,2047,T
4-HA,699,1,0,0,2031,2032,C
4-HA,700,1,1,2029,0,2031,G
4-HA,701,0,1,2075,0,2076,G
4-HA,702,2082,1,2,0,2085,A
4-HA,703,1,2100,0,0,2101,T
4-HA,704,3,1,0,2098,2102,C
4-HA,705,1,2092,0,2,2095,T
4-HA,706,2096,0,1,0,2097,A
4-HA,707,2,1,2105,0,2108,G
4-HA,708,2119,0,1,1,2121,A
4-HA,709,0,1,0,2105,2106,C
4-HA,710,1,0,0,2051,2052,C
4-HA,711,1,1,0,2062,2064,C
4-HA,712,2050,0,0,1,2051,A
4-HA,713,1,0,2170,0,2171,G
4-HA,714,2171,0,3,0,2174,A
4-HA,715,2,0,2192,0,2194,G
4-HA,716,0,2170,0,2,2172,T
4-HA,717,2163,0,1,0,2164,A
4-HA,718,2159,1,2,0,2162,A
4-HA,719,1,2,2191,1,2195,G
4-HA,720,2,0,2210,0,2212,G
4-HA,721,2186,0,0,0,2186,A
4-HA,722,2031,0,1,1,2033,A
4-HA,723,1,2022,0,3,2026,T
4-HA,724,2013,1,3,1,2018,A
4-HA,725,0,2013,1,1,2015,T
4-HA,726,1,1,1,2031,2034,C
4-HA,727,0,0,0,2033,2033,C
4-HA,728,1,0,0,1979,1980,C
4-HA,729,1,1959,0,1,1961,T
4-HA,730,1966,1,1,0,1968,A
4-HA,731,0,0,1973,0,1973,G
4-HA,732,0,1,1,1963,1965,C
4-HA,733,1930,1,2,0,1933,A
4-HA,734,0,0,1983,0,1983,G
4-HA,735,1959,0,2,0,1961,A
4-HA,736,1966,0,1,0,1967,A
4-HA,737,0,1969,0,0,1969,T
4-HA,738,1962,0,0,2,1964,A
4-HA,739,1974,1,1,1,1977,A
4-HA,740,1,0,1970,0,1971,G
4-HA,741,2,2,0,1974,1978,C
4-HA,742,1977,0,0,1,1978,A
4-HA,743,0,1925,1,1,1927,T
4-HA,744,1,2,0,2014,2017,C
4-HA,745,0,2018,0,0,2018,T
4-HA,746,2013,3,2,0,2018,A
4-HA,747,1,2015,0,1,2017,T
4-HA,748,0,2004,0,0,2004,T
4-HA,749,1,0,2017,0,2018,G
4-HA,750,0,3,1999,0,2002,G
4-HA,751,2000,0,2,1,2003,A
4-HA,752,2,1,0,2000,2003,C
4-HA,753,1878,0,1,0,1879,A
4-HA,754,1916,0,1,0,1917,A
4-HA,755,0,1992,0,1,1993,T
4-HA,756,2009,0,0,0,2009,A
4-HA,757,0,0,2019,0,2019,G
4-HA,758,0,1995,0,0,1995,T
4-HA,759,1995,0,0,0,1995,A
4-HA,760,1994,0,0,0,1994,A
4-HA,761,2002,0,1,0,2003,A
4-HA,762,2011,0,4,0,2015,A
4-HA,763,1,0,0,2018,2019,C
4-HA,764,1,2,0,1924,1927,C
4-HA,765,1,2,1922,0,1925,G
4-HA,766,0,0,1930,0,1930,G
4-HA,767,0,0,1934,0,1934,G
4-HA,768,1936,0,1,0,1937,A
4-HA,769,1,1,1939,0,1941,G
4-HA,770,1952,0,0,1,1953,A
4-HA,771,0,1,0,1953,1954,C
4-HA,772,1947,0,0,0,1947,A
4-HA,773,0,1947,1,0,1948,T
4-HA,774,1956,0,1,0,1957,A
4-HA,775,0,0,0,1984,1984,C
4-HA,776,0,1975,0,4,1979,T
4-HA,777,0,1983,1,1,1985,T
4-HA,778,0,1990,0,2,1992,T
4-HA,779,0,1977,0,0,1977,T
4-HA,780,1,1,1995,0,1997,G
4-HA,781,1987,0,1,2,1990,A
4-HA,782,0,1991,0,3,1994,T
4-HA,783,0,2011,0,4,2015,T
4-HA,784,1993,0,1,0,1994,A
4-HA,785,2006,0,0,0,2006,A
4-HA,786,0,1,0,2022,2023,C
4-HA,787,2007,0,2,0,2009,A
4-HA,788,1,0,2059,0,2060,G
4-HA,789,2,1,0,2036,2039,C
4-HA,790,2042,0,1,0,2043,A
4-HA,791,0,0,0,2048,2048,C
4-HA,792,2029,0,1,0,2030,A
4-HA,793,1,1,2044,0,2046,G
4-HA,794,2,3,2038,0,2043,G
4-HA,795,1,0,2079,0,2080,G
4-HA,796,2075,0,3,0,2078,A
4-HA,797,2070,0,3,0,2073,A
4-HA,798,1,2063,0,2,2066,T
4-HA,799,1,2,0,2072,2075,C
4-HA,800,1,2077,0,0,2078,T
4-HA,801,2075,0,0,0,2075,A
4-HA,802,2062,0,0,0,2062,A
4-HA,803,0,2054,0,2,2056,T
4-HA,804,0,2001,0,2,2003,T
4-HA,805,0,0,2009,0,2009,G
4-HA,806,0,0,1,2018,2019,C
4-HA,807,0,2037,0,5,2042,T
4-HA,808,4,1,0,2067,2072,C
4-HA,809,0,3,0,2077,2080,C
4-HA,810,0,2070,0,1,2071,T
4-HA,811,2071,0,1,0,2072,A
4-HA,812,0,0,2070,0,2070,G
4-HA,813,0,3,2086,0,2089,G
4-HA,814,0,1,2083,0,2084,G
4-HA,815,1,0,2062,0,2063,G
4-HA,816,1,2016,0,1,2018,T
4-HA,817,0,2004,0,2,2006,T
4-HA,818,2001,0,3,0,2004,A
4-HA,819,0,2,0,2019,2021,C
4-HA,820,0,2020,0,1,2021,T
4-HA,821,1,2021,0,1,2023,T
4-HA,822,1,1,0,2010,2012,C
4-HA,823,2000,0,1,1,2002,A
4-HA,824,2006,0,1,0,2007,A
4-HA,825,2009,0,0,0,2009,A
4-HA,826,2014,0,0,0,2014,A
4-HA,827,0,2014,0,1,2015,T
4-HA,828,1986,0,0,0,1986,A
4-HA,829,0,2,0,1984,1986,C
4-HA,830,1,0,1976,0,1977,G
4-HA,831,1970,1,1,1,1973,A
4-HA,832,1975,0,2,0,1977,A
4-HA,833,2,0,1992,0,1994,G
4-HA,834,0,1989,0,1,1990,T
4-HA,835,2,1,1988,0,1991,G
4-HA,836,0,0,1998,0,1998,G
4-HA,837,1,1,2000,1,2003,G
4-HA,838,1997,0,2,0,1999,A
4-HA,839,2000,0,1,0,2001,A
4-HA,840,2001,0,2,0,2003,A
4-HA,841,1991,0,4,1,1996,A
4-HA,842,0,0,2032,0,2032,G
4-HA,843,0,0,0,2023,2023,C
4-HA,844,1,1994,1,6,2002,T
4-HA,845,2,1,0,2017,2020,C
4-HA,846,2014,1,1,0,2016,A
4-HA,847,2019,0,1,0,2020,A
4-HA,848,0,2015,0,0,2015,T
4-HA,849,2021,0,0,0,2021,A
4-HA,850,2018,0,0,0,2018,A
4-HA,851,0,1970,0,1,1971,T
4-HA,852,1,2,1972,0,1975,G
4-HA,853,1947,0,0,0,1947,A
4-HA,854,0,1,1984,0,1985,G
4-HA,855,1981,1,0,0,1982,A
4-HA,856,0,1964,1,0,1965,T
4-HA,857,5,2,0,1973,1980,C
4-HA,858,1968,0,1,0,1969,A
4-HA,859,1,0,1990,0,1991,G
4-HA,860,1999,1,1,0,2001,A
4-HA,861,0,1986,0,1,1987,T
4-HA,862,0,0,1977,0,1977,G
4-HA,863,0,2,0,1948,1950,C
4-HA,864,1949,4,2,0,1955,A
4-HA,865,1,1,0,1973,1975,C
4-HA,866,0,0,0,1949,1949,C
4-HA,867,1,0,0,1946,1947,C
4-HA,868,1926,1,0,0,1927,A
4-HA,869,0,1910,0,2,1912,T
4-HA,870,1,1909,0,2,1912,T
4-HA,871,1,0,1938,0,1939,G
4-HA,872,1,1,1928,1,1931,G
4-HA,873,2,0,0,1928,1930,C
4-HA,874,1901,0,0,0,1901,A
4-HA,875,1897,0,1,0,1898,A
4-HA,876,1922,0,4,0,1926,A
4-HA,877,1,1927,0,1,1929,T
4-HA,878,0,0,1931,0,1931,G
4-HA,879,0,1,0,1925,1926,C
4-HA,880,1911,0,0,0,1911,A
4-HA,881,1948,0,0,0,1948,A
4-HA,882,0,1946,0,0,1946,T
4-HA,883,0,1947,0,1,1948,T
4-HA,884,0,1,0,1956,1957,C
4-HA,885,1,1907,0,1,1909,T
4-HA,886,1,0,1922,0,1923,G
4-HA,887,1920,0,0,0,1920,A
4-HA,888,1930,1,0,0,1931,A
4-HA,889,0,1927,0,1,1928,T
4-HA,890,1,0,1899,0,1900,G
4-HA,891,0,0,0,1904,1904,C
4-HA,892,1895,0,1,0,1896,A
4-HA,893,2,1893,0,0,1895,T
4-HA,894,0,0,0,1892,1892,C
4-HA,895,1881,0,1,0,1882,A
4-HA,896,0,0,0,1946,1946,C
4-HA,897,0,1935,0,1,1936,T
4-HA,898,1,0,0,1938,1939,C
4-HA,899,0,1,0,1925,1926,C
4-HA,900,1941,0,0,0,1941,A
4-HA,901,1938,0,0,0,1938,A
4-HA,902,1930,1,2,1,1934,A
4-HA,903,0,1865,0,0,1865,T
4-HA,904,0,3,1870,0,1873,G
4-HA,905,0,0,1882,1,1883,G
4-HA,906,1881,0,2,0,1883,A
4-HA,907,1874,1,4,0,1879,A
4-HA,908,0,0,1881,1,1882,G
4-HA,909,0,2,1,1847,1850,C
4-HA,910,1834,0,0,0,1834,A
4-HA,911,0,1832,0,1,1833,T
4-HA,912,0,1824,0,1,1825,T
4-HA,913,2,1,0,1862,1865,C
4-HA,914,1,1,0,1859,1861,C
4-HA,915,2,1,0,1850,1853,C
4-HA,916,1854,1,1,0,1856,A
4-HA,917,1865,1,0,4,1870,A
4-HA,918,0,1891,0,1,1892,T
4-HA,919,1,0,1891,0,1892,G
4-HA,920,1889,0,0,0,1889,A
4-HA,921,0,0,0,1887,1887,C
4-HA,922,1845,0,0,0,1845,A
4-HA,923,1852,0,1,0,1853,A
4-HA,924,1851,0,1,0,1852,A
4-HA,925,0,0,0,1861,1861,C
4-HA,926,2,1,0,1830,1833,C
4-HA,927,1800,0,1,0,1801,A
4-HA,928,1,1797,0,1,1799,T
4-HA,929,3,1795,0,0,1798,T
4-HA,930,2,3,0,1801,1806,C
4-HA,931,0,3,0,1802,1805,C
4-HA,932,1805,0,0,0,1805,A
4-HA,933,1798,0,1,0,1799,A
4-HA,934,1789,1,1,0,1791,A
4-HA,935,1819,0,0,0,1819,A
4-HA,936,0,1807,0,2,1809,T
4-HA,937,0,0,1813,0,1813,G
4-HA,938,1,1808,0,1,1810,T
4-HA,939,1818,0,0,0,1818,A
4-HA,940,1815,0,2,0,1817,A
4-HA,941,1818,0,1,0,1819,A
4-HA,942,0,0,0,1826,1826,C
4-HA,943,1800,0,0,0,1800,A
4-HA,944,0,2,1810,0,1812,G
4-HA,945,0,1,1809,0,1810,G
4-HA,946,1840,1,3,0,1844,A
4-HA,947,0,1832,0,0,1832,T
4-HA,948,2,0,0,1842,1844,C
4-HA,949,1843,0,6,0,1849,A
4-HA,950,0,1,0,1892,1893,C
4-HA,951,1888,0,2,0,1890,A
4-HA,952,0,1935,0,0,1935,T
4-HA,953,1881,0,0,0,1881,A
4-HA,954,0,2,0,1862,1864,C
4-HA,955,0,1,1815,0,1816,G
4-HA,956,1,1,1817,1,1820,G
4-HA,957,0,0,1810,0,1810,G
4-HA,958,0,0,1814,0,1814,G
4-HA,959,0,1,0,1757,1758,C
4-HA,960,2,0,0,1750,1752,C
4-HA,961,0,1706,0,2,1708,T
4-HA,962,2,1,1832,0,1835,G
4-HA,963,1,1836,0,2,1839,T
4-HA,964,1,1,0,1854,1856,C
4-HA,965,1,0,1,1841,1843,C
4-HA,966,1,3,0,1831,1835,C
4-HA,967,1821,1,2,0,1824,A
4-HA,968,1,1,1834,0,1836,G
4-HA,969,1834,0,0,1,1835,A
4-HA,970,0,1828,1,0,1829,T
4-HA,971,1662,0,2,0,1664,A
4-HA,972,0,1641,0,0,1641,T
4-HA,973,0,0,1650,0,1650,G
4-HA,974,0,1641,0,1,1642,T
4-HA,975,0,1616,0,2,1618,T
4-HA,976,1628,1,2,0,1631,A
4-HA,977,1609,0,1,0,1610,A
4-HA,978,0,8,1623,0,1631,G
4-HA,979,0,1,0,1626,1627,C
4-HA,980,1595,0,0,1,1596,A
4-HA,981,1591,0,1,1,1593,A
4-HA,982,1581,1,2,0,1584,A
4-HA,983,1587,0,0,0,1587,A
4-HA,984,0,0,0,1591,1591,C
4-HA,985,1561,0,0,1,1562,A
4-HA,986,0,0,0,1581,1581,C
4-HA,987,0,1541,0,0,1541,T
4-HA,988,0,0,0,1546,1546,C
4-HA,989,0,1544,0,2,1546,T
4-HA,990,0,0,1550,0,1550,G
4-HA,991,1543,0,0,1,1544,A
4-HA,992,1545,1,2,1,1549,A
4-HA,993,1545,0,2,0,1547,A
4-HA,994,0,1531,1,0,1532,T
4-HA,995,0,1510,1,1,1512,T
4-HA,996,0,0,1533,0,1533,G
4-HA,997,0,0,1530,0,1530,G
4-HA,998,0,0,0,1530,1530,C
4-HA,999,1519,0,0,0,1519,A
4-HA,1000,1519,0,0,0,1519,A
4-HA,1001,0,2,0,1516,1518,C
4-HA,1002,1518,0,0,0,1518,A
4-HA,1003,0,1,1529,0,1530,G
4-HA,1004,0,1,1521,0,1522,G
4-HA,1005,0,1,1516,0,1517,G
4-HA,1006,1515,0,1,0,1516,A
4-HA,1007,0,1500,0,2,1502,T
4-HA,1008,1,0,1505,0,1506,G
4-HA,1009,0,1,0,1499,1500,C
4-HA,1010,0,0,1504,0,1504,G
4-HA,1011,1519,0,0,0,1519,A
4-HA,1012,1492,0,0,0,1492,A
4-HA,1013,1507,0,0,0,1507,A
4-HA,1014,1,1487,0,0,1488,T
4-HA,1015,0,0,1509,0,1509,G
4-HA,1016,0,1512,0,0,1512,T
4-HA,1017,1507,0,3,0,1510,A
4-HA,1018,0,2,0,1507,1509,C
4-HA,1019,1,7,0,1496,1504,C
4-HA,1020,1470,0,3,0,1473,A
4-HA,1021,0,2,1473,0,1475,G
4-HA,1022,1453,0,0,0,1453,A
4-HA,1023,0,0,1470,0,1470,G
4-HA,1024,1432,0,0,0,1432,A
4-HA,1025,1432,0,1,0,1433,A
4-HA,1026,1434,0,1,0,1435,A
4-HA,1027,1,0,0,1433,1434,C
4-HA,1028,1425,0,0,0,1425,A
4-HA,1029,1446,0,0,0,1446,A
4-HA,1030,1439,2,0,0,1441,A
4-HA,1031,1,0,0,1448,1449,C
4-HA,1032,0,1434,0,1,1435,T
4-HA,1033,1419,0,0,0,1419,A
4-HA,1034,0,0,1428,0,1428,G
4-HA,1035,1417,0,2,0,1419,A
4-HA,1036,1,1,1443,0,1445,G
4-HA,1037,2,0,1444,0,1446,G
4-HA,1038,0,1,0,1407,1408,C
4-HA,1039,1404,0,1,0,1405,A
4-HA,1040,0,1391,0,0,1391,T
4-HA,1041,1394,0,2,0,1396,A
4-HA,1042,0,1390,0,0,1390,T
4-HA,1043,0,1385,0,0,1385,T
4-HA,1044,0,1380,0,0,1380,T
4-HA,1045,0,1,1328,0,1329,G
4-HA,1046,1,1,1325,0,1327,G
4-HA,1047,2,1,0,1315,1318,C
4-HA,1048,1,1,1323,0,1325,G
4-HA,1049,0,0,0,1316,1316,C
4-HA,1050,1311,0,0,0,1311,A
4-HA,1051,1320,0,0,0,1320,A
4-HA,1052,0,1318,0,1,1319,T
4-HA,1053,1,0,0,1311,1312,C
4-HA,1054,0,0,1319,0,1319,G
4-HA,1055,0,0,0,1313,1313,C
4-HA,1056,2,1,1310,0,1313,G
4-HA,1057,0,2,1312,0,1314,G
4-HA,1058,1,0,1314,0,1315,G
4-HA,1059,0,1316,0,1,1317,T
4-HA,1060,0,1297,0,0,1297,T
4-HA,1061,0,1294,0,3,1297,T
4-HA,1062,2,2,0,1295,1299,C
4-HA,1063,1303,0,1,0,1304,A
4-HA,1064,0,1306,0,1,1307,T
4-HA,1065,1301,0,0,0,1301,A
4-HA,1066,0,0,1306,0,1306,G
4-HA,1067,1260,0,0,0,1260,A
4-HA,1068,1258,0,2,1,1261,A
4-HA,1069,1262,0,1,0,1263,A
4-HA,1070,1270,2,0,0,1272,A
4-HA,1071,1,1260,0,0,1261,T
4-HA,1072,0,1,1274,0,1275,G
4-HA,1073,0,0,1276,0,1276,G
4-HA,1074,0,1261,0,1,1262,T
4-HA,1075,0,1229,0,0,1229,T
4-HA,1076,0,2,1231,0,1233,G
4-HA,1077,1,1,1221,0,1223,G
4-HA,1078,0,4,1225,0,1229,G
4-HA,1079,1200,0,2,0,1202,A
4-HA,1080,0,2,1197,0,1199,G
4-HA,1081,1,0,1163,0,1164,G
4-HA,1082,2,2,1159,1,1164,G
4-HA,1083,1154,0,2,0,1156,A
4-HA,1084,1166,0,1,0,1167,A
4-HA,1085,0,1167,0,0,1167,T
4-HA,1086,0,0,1168,0,1168,G
4-HA,1087,0,0,1181,0,1181,G
4-HA,1088,0,1174,0,0,1174,T
4-HA,1089,0,0,1175,0,1175,G
4-HA,1090,0,2,1165,0,1167,G
4-HA,1091,1149,0,0,0,1149,A
4-HA,1092,0,1150,0,1,1151,T
4-HA,1093,0,3,1168,0,1171,G
4-HA,1094,0,0,1185,0,1185,G
4-HA,1095,0,1164,0,1,1165,T
4-HA,1096,0,1140,0,0,1140,T
4-HA,1097,1,3,1133,1,1138,G
4-HA,1098,0,0,1156,0,1156,G
4-HA,1099,0,1153,0,2,1155,T
4-HA,1100,1156,0,1,0,1157,A
4-HA,1101,1,2,0,1104,1107,C
4-HA,1102,0,0,1116,0,1116,G
4-HA,1103,1,1,1143,0,1145,G
4-HA,1104,0,1145,0,1,1146,T
4-HA,1105,0,1142,0,0,1142,T
4-HA,1106,0,1141,0,0,1141,T
4-HA,1107,1,1,0,1126,1128,C
4-HA,1108,1122,0,2,0,1124,A
4-HA,1109,1,0,1122,0,1123,G
4-HA,1110,0,1,1123,0,1124,G
4-HA,1111,0,0,0,1118,1118,C
4-HA,1112,1077,0,1,0,1078,A
4-HA,1113,0,1080,0,0,1080,T
4-HA,1114,0,0,0,1085,1085,C
4-HA,1115,1087,0,0,0,1087,A
4-HA,1116,1088,0,0,1,1089,A
4-HA,1117,1084,1,2,0,1087,A
4-HA,1118,1096,0,0,0,1096,A
4-HA,1119,0,1088,1,0,1089,T
4-HA,1120,0,1087,0,0,1087,T
4-HA,1121,0,1,0,1095,1096,C
4-HA,1122,0,1083,0,0,1083,T
4-HA,1123,1,0,1085,0,1086,G
4-HA,1124,1084,0,0,0,1084,A
4-HA,1125,1,1,1089,0,1091,G
4-HA,1126,1,0,1096,0,1097,G
4-HA,1127,0,0,1098,0,1098,G
4-HA,1128,1092,0,1,0,1093,A
4-HA,1129,1092,0,1,0,1093,A
4-HA,1130,1,1,1082,0,1084,G
4-HA,1131,1098,0,0,0,1098,A
4-HA,1132,0,0,1109,0,1109,G
4-HA,1133,1,0,1113,0,1114,G
4-HA,1134,1113,0,1,0,1114,A
4-HA,1135,0,0,1,1113,1114,C
4-HA,1136,1099,0,0,0,1099,A
4-HA,1137,1097,1,4,0,1102,A
4-HA,1138,0,0,1104,0,1104,G
4-HA,1139,0,0,0,1104,1104,C
4-HA,1140,1095,0,0,0,1095,A
4-HA,1141,0,0,1090,0,1090,G
4-HA,1142,0,1,0,1083,1084,C
4-HA,1143,1080,0,2,0,1082,A
4-HA,1144,1,0,1091,0,1092,G
4-HA,1145,1082,0,1,0,1083,A
4-HA,1146,0,1094,0,1,1095,T
4-HA,1147,1,0,0,1103,1104,C
4-HA,1148,1,1089,0,2,1092,T
4-HA,1149,1,0,0,1106,1107,C
4-HA,1150,1105,0,0,0,1105,A
4-HA,1151,1103,0,1,0,1104,A
4-HA,1152,1105,0,0,0,1105,A
4-HA,1153,1086,0,1,0,1087,A
4-HA,1154,0,0,1087,0,1087,G
4-HA,1155,1,1,0,1064,1066,C
4-HA,1156,1062,0,1,0,1063,A
4-HA,1157,0,2,0,1077,1079,C
4-HA,1158,0,1074,0,0,1074,T
4-HA,1159,0,0,0,1075,1075,C
4-HA,1160,1073,0,1,0,1074,A
4-HA,1161,1080,0,1,0,1081,A
4-HA,1162,0,0,1086,0,1086,G
4-HA,1163,0,0,0,1083,1083,C
4-HA,1164,1079,0,0,0,1079,A
4-HA,1165,0,1,1083,0,1084,G
4-HA,1166,0,0,0,1062,1062,C
4-HA,1167,1062,0,0,0,1062,A
4-HA,1168,1063,0,0,0,1063,A
4-HA,1169,0,1059,0,0,1059,T
4-HA,1170,0,1,0,1047,1048,C
4-HA,1171,0,2,1054,0,1056,G
4-HA,1172,1046,0,1,0,1047,A
4-HA,1173,1,1045,0,1,1047,T
4-HA,1174,3,0,0,1046,1049,C
4-HA,1175,1039,0,1,0,1040,A
4-HA,1176,1064,0,0,0,1064,A
4-HA,1177,1062,0,0,0,1062,A
4-HA,1178,0,1069,0,0,1069,T
4-HA,1179,1,0,0,1069,1070,C
4-HA,1180,1056,0,0,0,1056,A
4-HA,1181,1057,0,0,0,1057,A
4-HA,1182,0,1053,0,1,1054,T
4-HA,1183,0,0,1058,0,1058,G
4-HA,1184,0,0,1050,0,1050,G
4-HA,1185,0,0,1043,0,1043,G
4-HA,1186,1045,0,0,0,1045,A
4-HA,1187,1045,0,2,0,1047,A
4-HA,1188,0,0,1061,0,1061,G
4-HA,1189,0,1,0,1056,1057,C
4-HA,1190,0,1056,0,1,1057,T
4-HA,1191,1,0,1091,0,1092,G
4-HA,1192,1090,1,1,0,1092,A
4-HA,1193,1091,0,1,0,1092,A
4-HA,1194,0,1091,0,0,1091,T
4-HA,1195,1068,0,1,0,1069,A
4-HA,1196,0,1,1066,0,1067,G
4-HA,1197,966,0,2,0,968,A
4-HA,1198,0,971,0,0,971,T
4-HA,1199,0,971,0,0,971,T
4-HA,1200,0,0,980,0,980,G
4-HA,1201,974,0,1,0,975,A
4-HA,1202,1,975,0,0,976,T
4-HA,1203,0,1,0,979,980,C
4-HA,1204,2,0,974,1,977,G
4-HA,1205,1,1,973,0,975,G
4-HA,1206,0,2,978,0,980,G
4-HA,1207,977,1,1,0,979,A
4-HA,1208,984,0,0,0,984,A
4-HA,1209,980,0,1,0,981,A
4-HA,1210,981,1,0,1,983,A
4-HA,1211,1,0,0,985,986,C
4-HA,1212,1,1,0,980,982,C
4-HA,1213,979,1,0,0,980,A
4-HA,1214,976,0,1,0,977,A
4-HA,1215,0,0,0,982,982,C
4-HA,1216,0,0,986,0,986,G
4-HA,1217,987,0,0,0,987,A
4-HA,1218,1,2,983,0,986,G
4-HA,1219,983,0,0,2,985,A
4-HA,1220,987,0,0,0,987,A
4-HA,1221,988,0,1,0,989,A
4-HA,1222,0,990,0,0,990,T
4-HA,1223,1,979,0,2,982,T
4-HA,1224,0,1,0,986,987,C
4-HA,1225,1,0,0,980,981,C
4-HA,1226,980,0,1,0,981,A
4-HA,1227,0,977,0,2,979,T
4-HA,1228,0,0,0,983,983,C
4-HA,1229,972,0,0,0,972,A
4-HA,1230,0,0,982,0,982,G
4-HA,1231,979,0,1,0,980,A
4-HA,1232,0,979,0,0,979,T
4-HA,1233,0,978,0,0,978,T
4-HA,1234,0,0,986,0,986,G
4-HA,1235,982,0,1,0,983,A
4-HA,1236,985,0,1,0,986,A
4-HA,1237,984,0,5,0,989,A
4-HA,1238,988,0,0,0,988,A
4-HA,1239,975,0,4,1,980,A
4-HA,1240,0,0,980,0,980,G
4-HA,1241,973,0,2,0,975,A
4-HA,1242,974,0,1,0,975,A
4-HA,1243,0,958,0,1,959,T
4-HA,1244,0,962,0,1,963,T
4-HA,1245,0,0,0,966,966,C
4-HA,1246,0,960,1,1,962,T
4-HA,1247,0,0,0,960,960,C
4-HA,1248,963,0,0,0,963,A
4-HA,1249,1,0,959,0,960,G
4-HA,1250,957,0,0,0,957,A
4-HA,1251,954,0,0,1,955,A
4-HA,1252,1,0,962,0,963,G
4-HA,1253,0,956,1,1,958,T
4-HA,1254,1,0,0,956,957,C
4-HA,1255,1,0,957,0,958,G
4-HA,1256,957,0,0,0,957,A
4-HA,1257,957,0,1,0,958,A
4-HA,1258,1,0,959,0,960,G
4-HA,1259,0,3,962,0,965,G
4-HA,1260,1,2,966,0,969,G
4-HA,1261,952,0,2,0,954,A
4-HA,1262,0,0,958,0,958,G
4-HA,1263,956,0,1,0,957,A
4-HA,1264,1007,0,1,0,1008,A
4-HA,1265,0,1012,0,0,1012,T
4-HA,1266,0,1006,0,0,1006,T
4-HA,1267,0,1,0,1003,1004,C
4-HA,1268,982,0,1,0,983,A
4-HA,1269,0,0,981,0,981,G
4-HA,1270,1,1,979,0,981,G
4-HA,1271,977,1,0,0,978,A
4-HA,1272,1,1,0,971,973,C
4-HA,1273,1,0,0,894,895,C
4-HA,1274,0,892,0,0,892,T
4-HA,1275,0,869,0,21,890,T
4-HA,1276,0,0,896,0,896,G
4-HA,1277,893,0,1,0,894,A
4-HA,1278,0,0,913,0,913,G
4-HA,1279,890,0,0,0,890,A
4-HA,1280,787,0,0,0,787,A
4-HA,1281,780,0,0,0,780,A
4-HA,1282,0,772,0,1,773,T
4-HA,1283,784,0,1,0,785,A
4-HA,1284,2,777,0,1,780,T
4-HA,1285,1,1,783,0,785,G
4-HA,1286,0,783,0,0,783,T
4-HA,1287,0,756,0,1,757,T
4-HA,1288,0,0,759,0,759,G
4-HA,1289,752,1,0,0,753,A
4-HA,1290,0,1,753,0,754,G
4-HA,1291,0,0,751,0,751,G
4-HA,1292,742,0,0,0,742,A
4-HA,1293,0,0,0,771,771,C
4-HA,1294,761,0,0,0,761,A
4-HA,1295,0,0,0,758,758,C
4-HA,1296,0,753,0,0,753,T
4-HA,1297,799,0,0,0,799,A
4-HA,1298,809,0,0,0,809,A
4-HA,1299,812,0,0,0,812,A
4-HA,1300,814,0,2,0,816,A
4-HA,1301,1,811,0,0,812,T
4-HA,1302,773,1,0,0,774,A
4-HA,1303,0,0,782,0,782,G
4-HA,1304,753,0,1,0,754,A
4-HA,1305,0,759,0,2,761,T
4-HA,1306,0,0,0,758,758,C
4-HA,1307,1,737,0,2,740,T
4-HA,1308,0,0,0,755,755,C
4-HA,1309,0,758,0,0,758,T
4-HA,1310,0,0,765,0,765,G
4-HA,1311,0,0,777,0,777,G
4-HA,1312,0,770,0,2,772,T
4-HA,1313,1,0,0,774,775,C
4-HA,1314,772,1,0,0,773,A
4-HA,1315,0,775,0,0,775,T
4-HA,1316,774,0,0,0,774,A
4-HA,1317,0,0,0,769,769,C
4-HA,1318,758,1,1,0,760,A
4-HA,1319,766,0,1,0,767,A
4-HA,1320,1,0,0,748,749,C
4-HA,1321,0,0,750,0,750,G
4-HA,1322,0,0,0,749,749,C
4-HA,1323,2,1,743,0,746,G
4-HA,1324,0,1,745,0,746,G
4-HA,1325,747,0,0,1,748,A
4-HA,1326,0,0,755,0,755,G
4-HA,1327,0,0,0,756,756,C
4-HA,1328,0,751,0,2,753,T
4-HA,1329,0,761,0,1,762,T
4-HA,1330,0,0,0,762,762,C
4-HA,1331,0,767,0,0,767,T
4-HA,1332,0,762,0,1,763,T
4-HA,1333,2,0,763,0,765,G
4-HA,1334,0,759,0,2,761,T
4-HA,1335,0,742,0,1,743,T
4-HA,1336,0,0,756,0,756,G
4-HA,1337,0,0,0,751,751,C
4-HA,1338,0,0,0,747,747,C
4-HA,1339,0,0,0,753,753,C
4-HA,1340,0,751,0,1,752,T
4-HA,1341,0,0,760,0,760,G
4-HA,1342,0,0,761,0,761,G
4-HA,1343,762,0,0,0,762,A
4-HA,1344,0,3,759,0,762,G
4-HA,1345,752,0,0,0,752,A
4-HA,1346,755,0,2,0,757,A
4-HA,1347,0,0,0,765,765,C
4-HA,1348,0,0,0,763,763,C
4-HA,1349,759,0,0,0,759,A
4-HA,1350,786,0,1,0,787,A
4-HA,1351,0,1,0,792,793,C
4-HA,1352,796,0,1,0,797,A
4-HA,1353,0,797,0,0,797,T
4-HA,1354,794,0,0,0,794,A
4-HA,1355,0,0,0,813,813,C
4-HA,1356,800,0,0,0,800,A
4-HA,1357,800,0,0,1,801,A
4-HA,1358,0,799,1,0,800,T
4-HA,1359,0,776,0,0,776,T
4-HA,1360,0,1,779,0,780,G
4-HA,1361,782,0,0,0,782,A
4-HA,1362,0,785,0,0,785,T
4-HA,1363,0,1,0,785,786,C
4-HA,1364,0,770,0,1,771,T
4-HA,1365,775,0,0,0,775,A
4-HA,1366,775,0,0,0,775,A
4-HA,1367,0,0,0,775,775,C
4-HA,1368,0,768,0,1,769,T
4-HA,1369,0,2,762,0,764,G
4-HA,1370,765,1,1,0,767,A
4-HA,1371,0,0,0,767,767,C
4-HA,1372,0,767,0,0,767,T
4-HA,1373,0,0,0,766,766,C
4-HA,1374,768,0,0,0,768,A
4-HA,1375,0,1,779,0,780,G
4-HA,1376,779,0,0,0,779,A
4-HA,1377,779,0,1,0,780,A
4-HA,1378,777,0,0,0,777,A
4-HA,1379,0,778,0,1,779,T
4-HA,1380,0,0,788,0,788,G
4-HA,1381,788,0,0,0,788,A
4-HA,1382,789,0,1,0,790,A
4-HA,1383,0,0,0,789,789,C
4-HA,1384,775,0,0,0,775,A
4-HA,1385,775,0,2,0,777,A
4-HA,1386,778,1,0,0,779,A
4-HA,1387,0,0,0,779,779,C
4-HA,1388,0,766,0,1,767,T
4-HA,1389,0,0,770,0,770,G
4-HA,1390,0,757,0,0,757,T
4-HA,1391,0,759,0,1,760,T
4-HA,1392,0,759,0,0,759,T
4-HA,1393,0,0,760,0,760,G
4-HA,1394,755,0,2,0,757,A
4-HA,1395,760,0,0,0,760,A
4-HA,1396,755,1,1,0,757,A
4-HA,1397,756,0,0,1,757,A
4-HA,1398,750,0,0,0,750,A
4-HA,1399,748,1,0,0,749,A
4-HA,1400,0,2,0,748,750,C
4-HA,1401,750,0,1,1,752,A
4-HA,1402,749,1,1,0,751,A
4-HA,1403,749,0,3,0,752,A
4-HA,1404,0,2,754,0,756,G
4-HA,1405,754,0,2,1,757,A
4-HA,1406,753,0,0,1,754,A
4-HA,1407,0,0,754,0,754,G
4-HA,1408,0,0,0,754,754,C
4-HA,1409,749,0,0,0,749,A
4-HA,1410,759,0,0,0,759,A
4-HA,1411,0,0,0,758,758,C
4-HA,1412,1,754,0,0,755,T
4-HA,1413,0,0,758,0,758,G
4-HA,1414,751,0,0,0,751,A
4-HA,1415,0,0,762,0,762,G
4-HA,1416,0,0,763,0,763,G
4-HA,1417,1,2,763,0,766,G
4-HA,1418,761,0,2,0,763,A
4-HA,1419,761,0,0,0,761,A
4-HA,1420,756,0,1,0,757,A
4-HA,1421,774,0,0,0,774,A
4-HA,1422,0,769,0,1,770,T
4-HA,1423,0,0,773,0,773,G
4-HA,1424,0,0,0,775,775,C
4-HA,1425,1,761,0,0,762,T
4-HA,1426,1,1,764,0,766,G
4-HA,1427,763,0,1,0,764,A
4-HA,1428,0,1,795,0,796,G
4-HA,1429,0,1,799,0,800,G
4-HA,1430,793,0,0,0,793,A
4-HA,1431,0,791,0,1,792,T
4-HA,1432,788,0,1,0,789,A
4-HA,1433,0,786,0,0,786,T
4-HA,1434,1,0,791,0,792,G
4-HA,1435,1,0,795,0,796,G
4-HA,1436,0,0,794,0,794,G
4-HA,1437,0,0,0,757,757,C
4-HA,1438,737,1,0,0,738,A
4-HA,1439,737,0,2,0,739,A
4-HA,1440,0,734,0,0,734,T
4-HA,1441,0,0,742,0,742,G
4-HA,1442,0,0,740,0,740,G
4-HA,1443,0,724,0,0,724,T
4-HA,1444,0,715,0,0,715,T
4-HA,1445,0,1,717,0,718,G
4-HA,1446,0,722,0,1,723,T
4-HA,1447,0,724,0,0,724,T
4-HA,1448,0,722,1,0,723,T
4-HA,1449,1,0,0,720,721,C
4-HA,1450,718,0,1,0,719,A
4-HA,1451,719,0,0,0,719,A
4-HA,1452,717,0,1,0,718,A
4-HA,1453,722,0,1,1,724,A
4-HA,1454,0,724,0,0,724,T
4-HA,1455,718,0,0,0,718,A
4-HA,1456,0,720,0,0,720,T
4-HA,1457,717,1,0,0,718,A
4-HA,1458,1,0,0,723,724,C
4-HA,1459,0,0,0,721,721,C
4-HA,1460,716,0,1,0,717,A
4-HA,1461,0,0,0,723,723,C
4-HA,1462,718,0,0,1,719,A
4-HA,1463,718,0,2,0,720,A
4-HA,1464,720,1,0,0,721,A
4-HA,1465,0,717,0,0,717,T
4-HA,1466,0,0,722,0,722,G
4-HA,1467,0,712,0,1,713,T
4-HA,1468,0,0,717,0,717,G
4-HA,1469,716,0,1,0,717,A
4-HA,1470,1,0,0,717,718,C
4-HA,1471,704,0,0,0,704,A
4-HA,1472,708,0,0,0,708,A
4-HA,1473,0,706,0,0,706,T
4-HA,1474,0,0,708,0,708,G
4-HA,1475,1,0,0,707,708,C
4-HA,1476,1,0,0,705,706,C
4-HA,1477,2,700,0,0,702,T
4-HA,1478,0,0,723,0,723,G
4-HA,1479,1,0,0,724,725,C
4-HA,1480,724,0,1,0,725,A
4-HA,1481,0,725,1,0,726,T
4-HA,1482,704,0,0,0,704,A
4-HA,1483,0,0,700,0,700,G
4-HA,1484,0,0,698,0,698,G
4-HA,1485,698,0,0,1,699,A
4-HA,1486,0,697,0,1,698,T
4-HA,1487,1,0,0,662,663,C
4-HA,1488,668,1,0,0,669,A
4-HA,1489,676,0,0,0,676,A
4-HA,1490,0,676,0,0,676,T
4-HA,1491,0,1,0,674,675,C
4-HA,1492,657,0,1,0,658,A
4-HA,1493,0,0,659,0,659,G
4-HA,1494,657,0,0,0,657,A
4-HA,1495,657,0,2,0,659,A
4-HA,1496,660,0,1,0,661,A
4-HA,1497,0,658,0,0,658,T
4-HA,1498,0,0,657,0,657,G
4-HA,1499,0,0,657,0,657,G
4-HA,1500,613,41,0,0,654,A
4-HA,1501,662,0,0,0,662,A
4-HA,1502,0,1,0,661,662,C
4-HA,1503,0,655,0,2,657,T
4-HA,1504,0,656,0,0,656,T
4-HA,1505,652,0,0,0,652,A
4-HA,1506,0,652,0,0,652,T
4-HA,1507,1,4,644,0,649,G
4-HA,1508,651,0,1,0,652,A
4-HA,1509,2,0,0,649,651,C
4-HA,1510,0,0,0,645,645,C
4-HA,1511,641,0,0,0,641,A
4-HA,1512,0,0,0,649,649,C
4-HA,1513,0,0,665,0,665,G
4-HA,1514,674,0,0,0,674,A
4-HA,1515,0,677,0,2,679,T
4-HA,1516,0,0,707,0,707,G
4-HA,1517,0,703,1,0,704,T
4-HA,1518,730,1,1,0,732,A
4-HA,1519,0,732,0,0,732,T
4-HA,1520,733,0,0,0,733,A
4-HA,1521,0,0,0,732,732,C
4-HA,1522,657,0,0,0,657,A
4-HA,1523,0,2,661,0,663,G
4-HA,1524,620,0,1,1,622,A
4-HA,1525,1,0,608,0,609,G
4-HA,1526,605,0,1,0,606,A
4-HA,1527,0,553,0,0,553,T
4-HA,1528,0,0,553,0,553,G
4-HA,1529,553,0,0,0,553,A
4-HA,1530,545,0,3,0,548,A
4-HA,1531,0,0,559,0,559,G
4-HA,1532,0,0,0,547,547,C
4-HA,1533,543,0,0,0,543,A
4-HA,1534,0,544,0,0,544,T
4-HA,1535,0,541,0,0,541,T
4-HA,1536,542,0,0,0,542,A
4-HA,1537,542,0,0,0,542,A
4-HA,1538,540,0,0,0,540,A
4-HA,1539,0,0,0,542,542,C
4-HA,1540,527,0,0,0,527,A
4-HA,1541,528,0,0,0,528,A
4-HA,1542,0,0,0,527,527,C
4-HA,1543,0,0,0,522,522,C
4-HA,1544,0,0,526,0,526,G
4-HA,1545,0,0,533,0,533,G
4-HA,1546,0,534,0,0,534,T
4-HA,1547,0,533,0,0,533,T
4-HA,1548,0,524,0,0,524,T
4-HA,1549,0,1,0,522,523,C
4-HA,1550,528,0,0,0,528,A
4-HA,1551,0,0,533,0,533,G
4-HA,1552,530,0,1,0,531,A
4-HA,1553,0,530,0,0,530,T
4-HA,1554,0,0,0,519,519,C
4-HA,1555,520,0,0,0,520,A
4-HA,1556,521,1,0,0,522,A
4-HA,1557,0,2,519,0,521,G
4-HA,1558,0,0,520,0,520,G
4-HA,1559,0,1,519,0,520,G
4-HA,1560,501,1,1,0,503,A
4-HA,1561,0,0,512,0,512,G
4-HA,1562,0,510,0,1,511,T
4-HA,1563,0,511,0,0,511,T
4-HA,1564,0,1,516,0,517,G
4-HA,1565,514,1,0,0,515,A
4-HA,1566,0,0,515,0,515,G
4-HA,1567,0,0,0,516,516,C
4-HA,1568,0,511,0,1,512,T
4-HA,1569,0,0,513,0,513,G
4-HA,1570,512,0,0,0,512,A
4-HA,1571,515,0,0,0,515,A
4-HA,1572,0,0,516,0,516,G
4-HA,1573,0,507,0,0,507,T
4-HA,1574,0,0,0,507,507,C
4-HA,1575,501,0,0,0,501,A
4-HA,1576,0,0,501,0,501,G
4-HA,1577,0,0,500,0,500,G
4-HA,1578,1,0,494,0,495,G
4-HA,1579,0,508,0,1,509,T
4-HA,1580,509,0,1,0,510,A
4-HA,1581,0,0,0,508,508,C
4-HA,1582,509,0,1,0,510,A
4-HA,1583,506,0,0,0,506,A
4-HA,1584,510,0,0,0,510,A
4-HA,1585,0,0,517,0,517,G
4-HA,1586,498,0,0,0,498,A
4-HA,1587,0,477,0,1,478,T
4-HA,1588,0,471,0,1,472,T
4-HA,1589,0,0,473,0,473,G
4-HA,1590,0,0,473,0,473,G
4-HA,1591,466,1,1,0,468,A
4-HA,1592,0,469,0,0,469,T
4-HA,1593,0,0,0,466,466,C
4-HA,1594,0,0,0,459,459,C
4-HA,1595,0,453,0,0,453,T
4-HA,1596,454,0,0,0,454,A
4-HA,1597,0,454,0,0,454,T
4-HA,1598,0,0,451,0,451,G
4-HA,1599,1,0,453,0,454,G
4-HA,1600,440,0,0,0,440,A
4-HA,1601,1,434,0,0,435,T
4-HA,1602,0,429,0,1,430,T
4-HA,1603,0,427,0,0,427,T
4-HA,1604,2,0,0,427,429,C
4-HA,1605,0,0,0,426,426,C
4-HA,1606,0,417,0,1,418,T
4-HA,1607,0,417,0,0,417,T
4-HA,1608,0,416,0,2,418,T
4-HA,1609,0,0,417,0,417,G
4-HA,1610,0,0,0,413,413,C
4-HA,1611,0,0,0,416,416,C
4-HA,1612,410,0,0,0,410,A
4-HA,1613,0,408,0,0,408,T
4-HA,1614,409,0,0,0,409,A
4-HA,1615,0,407,0,1,408,T
4-HA,1616,0,0,0,406,406,C
4-HA,1617,405,0,0,0,405,A
4-HA,1618,0,397,0,0,397,T
4-HA,1619,0,0,400,0,400,G
4-HA,1620,0,398,0,0,398,T
4-HA,1621,0,384,0,0,384,T
4-HA,1622,0,385,0,0,385,T
4-HA,1623,0,378,0,0,378,T
4-HA,1624,0,379,0,0,379,T
4-HA,1625,0,378,0,0,378,T
4-HA,1626,0,0,380,0,380,G
4-HA,1627,0,0,0,379,379,C
4-HA,1628,0,368,0,0,368,T
4-HA,1629,0,367,0,0,367,T
4-HA,1630,0,368,0,0,368,T
4-HA,1631,0,0,369,0,369,G
4-HA,1632,0,369,0,2,371,T
4-HA,1633,1,0,369,0,370,G
4-HA,1634,0,371,0,0,371,T
4-HA,1635,0,362,0,0,362,T
4-HA,1636,0,0,364,0,364,G
4-HA,1637,0,0,0,362,362,C
4-HA,1638,0,362,0,1,363,T
4-HA,1639,0,360,0,0,360,T
4-HA,1640,0,340,0,0,340,T
4-HA,1641,0,0,342,0,342,G
4-HA,1642,0,342,0,0,342,T
4-HA,1643,0,344,0,0,344,T
4-HA,1644,0,0,342,1,343,G
4-HA,1645,0,0,333,0,333,G
4-HA,1646,0,0,333,0,333,G
4-HA,1647,0,0,334,0,334,G
4-HA,1648,0,319,0,1,320,T
4-HA,1649,0,317,0,0,317,T
4-HA,1650,0,1,1,313,315,C
4-HA,1651,309,0,0,0,309,A
4-HA,1652,0,310,0,0,310,T
4-HA,1653,0,1,1,307,309,C
4-HA,1654,301,0,0,0,301,A
4-HA,1655,0,290,0,0,290,T
4-HA,1656,0,0,288,0,288,G
4-HA,1657,0,281,0,1,282,T
4-HA,1658,0,0,280,0,280,G
4-HA,1659,0,0,274,0,274,G
4-HA,1660,0,0,271,0,271,G
4-HA,1661,0,0,0,262,262,C
4-HA,1662,0,0,0,252,252,C
4-HA,1663,0,239,0,1,240,T
4-HA,1664,0,0,240,0,240,G
4-HA,1665,0,0,0,238,238,C
4-HA,1666,0,0,0,240,240,C
4-HA,1667,239,0,0,0,239,A
4-HA,1668,238,0,0,0,238,A
4-HA,1669,237,0,0,0,237,A
4-HA,1670,238,0,0,0,238,A
4-HA,1671,236,0,0,0,236,A
4-HA,1672,0,0,235,0,235,G
4-HA,1673,1,0,220,0,221,G
4-HA,1674,0,0,0,220,220,C
4-HA,1675,218,0,0,0,218,A
4-HA,1676,219,0,0,0,219,A
4-HA,1677,0,0,0,219,219,C
4-HA,1678,219,0,0,0,219,A
4-HA,1679,0,219,0,0,219,T
4-HA,1680,0,218,0,0,218,T
4-HA,1681,213,0,1,0,214,A
4-HA,1682,0,0,212,0,212,G
4-HA,1683,0,0,211,0,211,G
4-HA,1684,0,198,0,0,198,T
4-HA,1685,0,0,188,0,188,G
4-HA,1686,0,0,0,182,182,C
4-HA,1687,176,0,0,0,176,A
4-HA,1688,175,0,0,0,175,A
4-HA,1689,0,0,0,175,175,C
4-HA,1690,170,0,1,0,171,A
4-HA,1691,0,165,0,0,165,T
4-HA,1692,0,149,0,0,149,T
4-HA,1693,0,149,0,0,149,T
4-HA,1694,1,0,148,0,149,G
4-HA,1695,0,0,0,148,148,C
4-HA,1696,148,0,0,0,148,A
4-HA,1697,0,135,0,0,135,T
4-HA,1698,0,130,0,0,130,T
4-HA,1699,0,121,0,0,121,T
4-HA,1700,0,0,121,0,121,G
4-HA,1701,117,0,0,0,117,A
5-NP,1,786,0,0,0,786,A
5-NP,2,0,790,0,0,790,T
5-NP,3,0,0,790,0,790,G
5-NP,4,0,0,792,0,792,G
5-NP,5,0,0,0,796,796,C
5-NP,6,0,0,811,0,811,G
5-NP,7,0,848,0,2,850,T
5-NP,8,0,0,0,862,862,C
5-NP,9,0,0,0,863,863,C
5-NP,10,0,0,1,861,862,C
5-NP,11,863,0,2,0,865,A
5-NP,12,866,0,0,0,866,A
5-NP,13,0,2,868,0,870,G
5-NP,14,0,1,904,0,905,G
5-NP,15,1,1,0,904,906,C
5-NP,16,917,0,0,0,917,A
5-NP,17,0,0,0,921,921,C
5-NP,18,0,0,0,919,919,C
5-NP,19,927,0,0,0,927,A
5-NP,20,924,0,0,0,924,A
5-NP,21,923,0,2,0,925,A
5-NP,22,0,1,0,929,930,C
5-NP,23,0,0,927,0,927,G
5-NP,24,0,0,1029,0,1029,G
5-NP,25,0,1026,0,1,1027,T
5-NP,26,0,0,0,1110,1110,C
5-NP,27,1,1107,1,0,1109,T
5-NP,28,0,1124,0,0,1124,T
5-NP,29,1126,0,0,0,1126,A
5-NP,30,1,1125,0,0,1126,T
5-NP,31,1,2,1136,0,1139,G
5-NP,32,1135,0,1,0,1136,A
5-NP,33,1119,0,2,0,1121,A
5-NP,34,0,0,0,1127,1127,C
5-NP,35,1108,0,1,0,1109,A
5-NP,36,0,0,1194,0,1194,G
5-NP,37,1195,0,1,0,1196,A
5-NP,38,2,1195,0,1,1198,T
5-NP,39,0,0,1201,0,1201,G
5-NP,40,0,4,1198,0,1202,G
5-NP,41,1201,0,3,0,1204,A
5-NP,42,1209,0,1,0,1210,A
5-NP,43,1214,0,1,0,1215,A
5-NP,44,0,0,0,1252,1252,C
5-NP,45,0,1235,0,2,1237,T
5-NP,46,0,1,1249,0,1250,G
5-NP,47,1247,1,0,0,1248,A
5-NP,48,0,1248,1,0,1249,T
5-NP,49,0,2,1246,0,1248,G
5-NP,50,0,2,1257,0,1259,G
5-NP,51,0,1,1256,0,1257,G
5-NP,52,0,0,1261,0,1261,G
5-NP,53,1257,0,0,0,1257,A
5-NP,54,0,1255,0,0,1255,T
5-NP,55,1,1,0,1259,1261,C
5-NP,56,0,0,1264,0,1264,G
5-NP,57,0,0,0,1280,1280,C
5-NP,58,0,0,0,1282,1282,C
5-NP,59,1275,0,1,0,1276,A
5-NP,60,0,2,1297,0,1299,G
5-NP,61,1297,0,0,0,1297,A
5-NP,62,1314,0,0,0,1314,A
5-NP,63,0,1313,0,1,1314,T
5-NP,64,1,0,1316,0,1317,G
5-NP,65,1,1,1,1329,1332,C
5-NP,66,1330,0,0,1,1331,A
5-NP,67,1351,0,0,0,1351,A
5-NP,68,0,0,0,1352,1352,C
5-NP,69,0,1343,0,0,1343,T
5-NP,70,0,1,1355,0,1356,G
5-NP,71,1374,0,1,0,1375,A
5-NP,72,0,1,1457,0,1458,G
5-NP,73,1452,0,0,0,1452,A
5-NP,74,0,1446,0,0,1446,T
5-NP,75,0,1452,0,0,1452,T
5-NP,76,1443,0,2,0,1445,A
5-NP,77,2,1,1452,0,1455,G
5-NP,78,0,0,1455,1,1456,G
5-NP,79,1,1,1453,0,1455,G
5-NP,80,0,1,0,1446,1447,C
5-NP,81,1431,0,0,1,1432,A
5-NP,82,0,1435,0,0,1435,T
5-NP,83,1,1,0,1437,1439,C
5-NP,84,2,0,0,1439,1441,C
5-NP,85,0,0,1459,0,1459,G
5-NP,86,1,1455,0,0,1456,T
5-NP,87,0,0,0,1456,1456,C
5-NP,88,1,2,1455,0,1458,G
5-NP,89,0,0,1461,0,1461,G
5-NP,90,1,2,1462,1,1466,G
5-NP,91,1453,0,1,0,1454,A
5-NP,92,1460,0,1,0,1461,A
5-NP,93,0,0,1464,0,1464,G
5-NP,94,1458,0,0,0,1458,A
5-NP,95,0,1472,0,0,1472,T
5-NP,96,0,0,1487,0,1487,G
5-NP,97,1491,0,2,0,1493,A
5-NP,98,0,1498,0,0,1498,T
5-NP,99,0,1490,0,1,1491,T
5-NP,100,0,1,1501,0,1502,G
5-NP,101,1502,1,0,0,1503,A
5-NP,102,0,1497,0,1,1498,T
5-NP,103,2,3,1494,0,1499,G
5-NP,104,0,1,1491,0,1492,G
5-NP,105,0,0,1480,1,1481,G
5-NP,106,1566,0,0,0,1566,A
5-NP,107,0,1564,0,0,1564,T
5-NP,108,0,1566,0,1,1567,T
5-NP,109,0,3,1580,0,1583,G
5-NP,110,1,2,1591,0,1594,G
5-NP,111,0,1,1594,0,1595,G
5-NP,112,1585,0,2,0,1587,A
5-NP,113,0,1,1588,0,1589,G
5-NP,114,1593,0,0,0,1593,A
5-NP,115,0,1622,0,0,1622,T
5-NP,116,0,1620,0,1,1621,T
5-NP,117,0,0,0,1631,1631,C
5-NP,118,0,1626,0,1,1627,T
5-NP,119,1643,0,1,0,1644,A
5-NP,120,0,1,0,1649,1650,C
5-NP,121,1685,0,2,0,1687,A
5-NP,122,0,1699,0,0,1699,T
5-NP,123,1,0,0,1689,1690,C
5-NP,124,0,0,1,1697,1698,C
5-NP,125,1701,1,1,0,1703,A
5-NP,126,1725,0,1,0,1726,A
5-NP,127,1722,1,2,0,1725,A
5-NP,128,0,1718,0,0,1718,T
5-NP,129,0,0,1718,0,1718,G
5-NP,130,0,1691,0,5,1696,T
5-NP,131,0,0,1705,0,1705,G
5-NP,132,0,0,1,1712,1713,C
5-NP,133,1702,0,1,0,1703,A
5-NP,134,0,0,0,1710,1710,C
5-NP,135,0,1692,0,1,1693,T
5-NP,136,0,2,1744,0,1746,G
5-NP,137,1771,0,0,0,1771,A
5-NP,138,1788,0,0,0,1788,A
5-NP,139,0,0,0,1817,1817,C
5-NP,140,0,1805,1,1,1807,T
5-NP,141,0,1813,0,0,1813,T
5-NP,142,1807,0,0,0,1807,A
5-NP,143,1804,1,0,0,1805,A
5-NP,144,0,0,1751,0,1751,G
5-NP,145,0,0,0,1780,1780,C
5-NP,146,0,1772,0,1,1773,T
5-NP,147,1,0,0,1799,1800,C
5-NP,148,1793,1,1,0,1795,A
5-NP,149,0,0,1831,0,1831,G
5-NP,150,0,1828,0,0,1828,T
5-NP,151,1,0,1849,0,1850,G
5-NP,152,1866,0,4,0,1870,A
5-NP,153,0,1866,0,0,1866,T
5-NP,154,0,0,0,1888,1888,C
5-NP,155,1891,1,2,0,1894,A
5-NP,156,0,1893,1,2,1896,T
5-NP,157,0,1,1897,0,1898,G
5-NP,158,1880,1,3,0,1884,A
5-NP,159,1874,0,6,1,1881,A
5-NP,160,0,1,1883,0,1884,G
5-NP,161,0,0,1865,0,1865,G
5-NP,162,0,1,1871,0,1872,G
5-NP,163,0,0,0,1871,1871,C
5-NP,164,1,1,1882,0,1884,G
5-NP,165,0,0,1889,0,1889,G
5-NP,166,0,1887,0,0,1887,T
5-NP,167,2,1884,0,2,1888,T
5-NP,168,0,4,1889,0,1893,G
5-NP,169,2055,0,0,0,2055,A
5-NP,170,0,2042,0,1,2043,T
5-NP,171,3,1,0,2045,2049,C
5-NP,172,0,1,0,2047,2048,C
5-NP,173,2042,0,1,0,2043,A
5-NP,174,0,2,2048,0,2050,G
5-NP,175,2045,1,1,0,2047,A
5-NP,176,2042,0,5,0,2047,A
5-NP,177,0,0,0,2052,2052,C
5-NP,178,1957,0,1,0,1958,A
5-NP,179,1,0,1975,0,1976,G
5-NP,180,0,1,0,1970,1971,C
5-NP,181,2,1965,0,2,1969,T
5-NP,182,1,1979,0,0,1980,T
5-NP,183,0,3,1973,1,1977,G
5-NP,184,1982,0,6,1,1989,A
5-NP,185,0,0,0,1994,1994,C
5-NP,186,1986,0,0,0,1986,A
5-NP,187,2000,2,0,0,2002,A
5-NP,188,0,1991,0,0,1991,T
5-NP,189,1994,1,1,0,1996,A
5-NP,190,0,1,2009,1,2011,G
5-NP,191,1984,0,5,0,1989,A
5-NP,192,0,0,2008,0,2008,G
5-NP,193,1992,0,1,0,1993,A
5-NP,194,2035,0,1,0,2036,A
5-NP,195,2036,1,1,0,2038,A
5-NP,196,2089,0,1,0,2090,A
5-NP,197,0,2089,0,0,2089,T
5-NP,198,0,5,2081,0,2086,G
5-NP,199,0,1,2081,1,2083,G
5-NP,200,1,2075,0,1,2077,T
5-NP,201,2046,0,3,0,2049,A
5-NP,202,0,0,0,2068,2068,C
5-NP,203,1,2070,1,3,2075,T
5-NP,204,1,0,0,2104,2105,C
5-NP,205,2,2058,0,5,2065,T
5-NP,206,0,0,1,2087,2088,C
5-NP,207,1,2088,0,0,2089,T
5-NP,208,0,0,2105,0,2105,G
5-NP,209,2,0,0,2108,2110,C
5-NP,210,0,2091,1,1,2093,T
5-NP,211,0,2091,0,2,2093,T
5-NP,212,0,2101,0,2,2103,T
5-NP,213,0,2087,0,2,2089,T
5-NP,214,0,0,2102,0,2102,G
5-NP,215,2081,0,2,9,2092,A
5-NP,216,0,2087,0,0,2087,T
5-NP,217,0,1,2085,0,2086,G
5-NP,218,2077,2,1,0,2080,A
5-NP,219,2085,0,0,0,2085,A
5-NP,220,2075,0,5,0,2080,A
5-NP,221,0,4,2084,0,2088,G
5-NP,222,2090,1,1,0,2092,A
5-NP,223,2088,0,3,0,2091,A
5-NP,224,0,2,2111,0,2113,G
5-NP,225,1,2,2164,1,2168,G
5-NP,226,2167,0,1,0,2168,A
5-NP,227,2187,0,3,0,2190,A
5-NP,228,0,2186,0,1,2187,T
5-NP,229,2188,0,0,0,2188,A
5-NP,230,2176,0,1,0,2177,A
5-NP,231,2179,0,3,0,2182,A
5-NP,232,1,2181,0,0,2182,T
5-NP,233,2196,0,0,0,2196,A
5-NP,234,0,0,0,2185,2185,C
5-NP,235,0,0,0,2135,2135,C
5-NP,236,0,2129,0,1,2130,T
5-NP,237,1,1,2133,1,2136,G
5-NP,238,0,0,2159,1,2160,G
5-NP,239,2158,0,1,0,2159,A
5-NP,240,2157,0,0,0,2157,A
5-NP,241,0,0,2193,0,2193,G
5-NP,242,2169,0,2,0,2171,A
5-NP,243,2164,1,2,0,2167,A
5-NP,244,0,0,0,2171,2171,C
5-NP,245,2166,0,0,0,2166,A
5-NP,246,0,0,0,2211,2211,C
5-NP,247,0,0,0,2185,2185,C
5-NP,248,3,3,0,2189,2195,C
5-NP,249,2,0,0,2190,2192,C
5-NP,250,2174,0,2,0,2176,A
5-NP,251,0,0,2181,0,2181,G
5-NP,252,0,2,0,2172,2174,C
5-NP,253,1,0,2180,0,2181,G
5-NP,254,1,0,0,2178,2179,C
5-NP,255,0,2,2160,0,2162,G
5-NP,256,2,1,2177,0,2180,G
5-NP,257,0,1,2173,0,2174,G
5-NP,258,2,0,2187,0,2189,G
5-NP,259,2183,1,1,0,2185,A
5-NP,260,2179,0,3,0,2182,A
5-NP,261,2180,1,2,0,2183,A
5-NP,262,0,0,2190,0,2190,G
5-NP,263,2187,1,0,0,2188,A
5-NP,264,0,2173,0,0,2173,T
5-NP,265,1,0,0,2166,2167,C
5-NP,266,0,0,0,2166,2166,C
5-NP,267,0,1,0,2172,2173,C
5-NP,268,2184,0,0,0,2184,A
5-NP,269,2186,1,0,0,2187,A
5-NP,270,0,1,2193,0,2194,G
5-NP,271,2187,0,1,0,2188,A
5-NP,272,2191,0,0,1,2192,A
5-NP,273,2196,0,0,0,2196,A
5-NP,274,2193,0,2,0,2195,A
5-NP,275,1,1,0,2200,2202,C
5-NP,276,0,2180,1,0,2181,T
5-NP,277,0,1,2182,0,2183,G
5-NP,278,0,1,2194,0,2195,G
5-NP,279,1,1,2183,1,2186,G
5-NP,280,0,2,2188,0,2190,G
5-NP,281,0,1,2200,0,2201,G
5-NP,282,0,0,2227,0,2227,G
5-NP,283,1,0,0,2370,2371,C
5-NP,284,1,3,0,2368,2372,C
5-NP,285,1,2,0,2384,2387,C
5-NP,286,2660,1,0,1,2662,A
5-NP,287,0,2667,0,1,2668,T
5-NP,288,2803,1,2,0,2806,A
5-NP,289,1,2802,0,0,2803,T
5-NP,290,2787,0,3,0,2790,A
5-NP,291,1,0,0,2809,2810,C
5-NP,292,2579,1,1,0,2581,A
5-NP,293,1,0,2611,0,2612,G
5-NP,294,1,5,2601,0,2607,G
5-NP,295,2356,0,1,0,2357,A
5-NP,296,0,3,2369,0,2372,G
5-NP,297,2275,0,5,0,2280,A
5-NP,298,0,0,2307,0,2307,G
5-NP,299,1,2299,0,0,2300,T
5-NP,300,2283,0,4,0,2287,A
5-NP,301,2,1,2291,0,2294,G
5-NP,302,2257,0,4,0,2261,A
5-NP,303,0,2263,0,1,2264,T
5-NP,304,0,1,2252,1,2254,G
5-NP,305,1,3,2257,0,2261,G
5-NP,306,2250,1,2,0,2253,A
5-NP,307,2245,1,1,1,2248,A
5-NP,308,2245,0,1,0,2246,A
5-NP,309,2257,1,0,0,2258,A
5-NP,310,0,2256,0,0,2256,T
5-NP,311,0,1,2278,1,2280,G
5-NP,312,0,2,2272,0,2274,G
5-NP,313,2281,1,1,0,2283,A
5-NP,314,1,2264,0,0,2265,T
5-NP,315,0,0,2272,0,2272,G
5-NP,316,2273,0,1,1,2275,A
5-NP,317,2,0,2271,0,2273,G
5-NP,318,1,1,2264,1,2267,G
5-NP,319,0,1,2273,0,2274,G
5-NP,320,2275,0,3,0,2278,A
5-NP,321,2273,0,1,0,2274,A
5-NP,322,0,0,0,2280,2280,C
5-NP,323,0,2278,0,1,2279,T
5-NP,324,5,0,0,2287,2292,C
5-NP,325,2,0,2292,0,2294,G
5-NP,326,0,2298,0,0,2298,T
5-NP,327,1,0,0,2302,2303,C
5-NP,328,2,0,0,2403,2405,C
5-NP,329,0,2400,0,1,2401,T
5-NP,330,1,2406,0,1,2408,T
5-NP,331,0,2400,1,1,2402,T
5-NP,332,2410,1,1,0,2412,A
5-NP,333,0,2396,0,2,2398,T
5-NP,334,0,1,2398,0,2399,G
5-NP,335,2407,0,3,0,2410,A
5-NP,336,0,0,0,2406,2406,C
5-NP,337,2372,0,1,0,2373,A
5-NP,338,2377,0,1,0,2378,A
5-NP,339,2382,0,1,0,2383,A
5-NP,340,1,0,2424,0,2425,G
5-NP,341,2426,0,0,0,2426,A
5-NP,342,2426,0,6,0,2432,A
5-NP,343,1,1,2499,0,2501,G
5-NP,344,2504,0,2,0,2506,A
5-NP,345,2503,0,3,0,2506,A
5-NP,346,2511,0,0,0,2511,A
5-NP,347,0,2509,0,1,2510,T
5-NP,348,2497,0,2,0,2499,A
5-NP,349,2466,0,0,0,2466,A
5-NP,350,1,1,2480,0,2482,G
5-NP,351,0,1,2477,0,2478,G
5-NP,352,1,0,0,2449,2450,C
5-NP,353,0,1,2440,1,2442,G
5-NP,354,2458,0,0,1,2459,A
5-NP,355,2471,0,0,0,2471,A
5-NP,356,0,2470,0,0,2470,T
5-NP,357,1,0,0,2473,2474,C
5-NP,358,0,2472,0,1,2473,T
5-NP,359,0,1,2470,0,2471,G
5-NP,360,0,0,2477,0,2477,G
5-NP,361,0,1,2,2469,2472,C
5-NP,362,0,0,2471,0,2471,G
5-NP,363,1,0,0,2469,2470,C
5-NP,364,0,0,0,2465,2465,C
5-NP,365,2469,0,2,0,2471,A
5-NP,366,2476,2,2,0,2480,A
5-NP,367,2,0,2503,0,2505,G
5-NP,368,0,1,0,2504,2505,C
5-NP,369,3,0,0,2529,2532,C
5-NP,370,2531,0,3,0,2534,A
5-NP,371,2558,1,0,1,2560,A
5-NP,372,0,2,0,2571,2573,C
5-NP,373,2579,0,0,0,2579,A
5-NP,374,2611,0,1,0,2612,A
5-NP,375,0,2602,0,0,2602,T
5-NP,376,1,1,2623,1,2626,G
5-NP,377,0,0,2633,0,2633,G
5-NP,378,0,2587,0,1,2588,T
5-NP,379,0,0,2592,0,2592,G
5-NP,380,2570,0,3,0,2573,A
5-NP,381,1,0,2606,0,2607,G
5-NP,382,1,1,2603,0,2605,G
5-NP,383,2600,1,2,0,2603,A
5-NP,384,1,2712,0,2,2715,T
5-NP,385,0,0,2720,0,2720,G
5-NP,386,1,1,0,2720,2722,C
5-NP,387,0,2719,0,5,2724,T
5-NP,388,2725,0,3,0,2728,A
5-NP,389,1,0,0,2756,2757,C
5-NP,390,2741,0,1,0,2742,A
5-NP,391,0,2728,0,2,2730,T
5-NP,392,1,0,0,2710,2711,C
5-NP,393,0,2599,0,2,2601,T
5-NP,394,1,1,2653,0,2655,G
5-NP,395,2,0,2687,0,2689,G
5-NP,396,0,2681,0,5,2686,T
5-NP,397,4,0,0,2683,2687,C
5-NP,398,0,2662,0,3,2665,T
5-NP,399,2679,0,1,0,2680,A
5-NP,400,2680,0,4,0,2684,A
5-NP,401,0,0,0,2694,2694,C
5-NP,402,1,2684,0,7,2692,T
5-NP,403,1,0,1,2706,2708,C
5-NP,404,2671,0,3,0,2674,A
5-NP,405,1,1,0,2747,2749,C
5-NP,406,2754,0,1,0,2755,A
5-NP,407,0,2759,0,1,2760,T
5-NP,408,2730,0,4,0,2734,A
5-NP,409,2740,2,2,0,2744,A
5-NP,410,0,2743,0,1,2744,T
5-NP,411,1,0,2772,0,2773,G
5-NP,412,2754,1,1,0,2756,A
5-NP,413,0,2730,0,2,2732,T
5-NP,414,0,2685,0,2,2687,T
5-NP,415,1,2685,0,4,2690,T
5-NP,416,1,2,2674,0,2677,G
5-NP,417,4,0,2686,0,2690,G
5-NP,418,0,0,0,2690,2690,C
5-NP,419,2671,0,1,0,2672,A
5-NP,420,0,2658,0,1,2659,T
5-NP,421,0,2647,2,2,2651,T
5-NP,422,3,0,1,2647,2651,C
5-NP,423,1,1,0,2655,2657,C
5-NP,424,2688,0,1,0,2689,A
5-NP,425,2688,0,2,1,2691,A
5-NP,426,0,2684,0,0,2684,T
5-NP,427,0,2686,0,0,2686,T
5-NP,428,0,2679,0,2,2681,T
5-NP,429,0,1,2703,1,2705,G
5-NP,430,2708,1,0,0,2709,A
5-NP,431,2702,0,3,0,2705,A
5-NP,432,0,2724,0,0,2724,T
5-NP,433,0,1,2683,0,2684,G
5-NP,434,2741,1,2,1,2745,A
5-NP,435,0,2748,0,0,2748,T
5-NP,436,0,0,2759,0,2759,G
5-NP,437,0,0,0,2799,2799,C
5-NP,438,2787,0,2,0,2789,A
5-NP,439,2867,1,2,1,2871,A
5-NP,440,0,0,0,2867,2867,C
5-NP,441,2891,1,1,1,2894,A
5-NP,442,0,2945,0,1,2946,T
5-NP,443,2889,0,1,0,2890,A
5-NP,444,0,3,0,2931,2934,C
5-NP,445,4,2,0,2925,2931,C
5-NP,446,2865,0,2,0,2867,A
5-NP,447,0,0,2894,1,2895,G
5-NP,448,2825,1,4,0,2830,A
5-NP,449,1,0,2875,0,2876,G
5-NP,450,1,0,2862,0,2863,G
5-NP,451,2837,0,2,1,2840,A
5-NP,452,0,0,0,2853,2853,C
5-NP,453,2815,1,4,0,2820,A
5-NP,454,2821,0,2,0,2823,A
5-NP,455,0,1,2825,1,2827,G
5-NP,456,2801,0,2,0,2803,A
5-NP,457,0,1,2805,0,2806,G
5-NP,458,2,0,1,2787,2790,C
5-NP,459,0,2764,0,4,2768,T
5-NP,460,1,1,0,2772,2774,C
5-NP,461,0,2770,0,3,2773,T
5-NP,462,0,2780,0,0,2780,T
5-NP,463,0,1,2786,0,2787,G
5-NP,464,0,2777,0,1,2778,T
5-NP,465,1,2785,0,0,2786,T
5-NP,466,2,2,0,2770,2774,C
5-NP,467,3,2,2762,0,2767,G
5-NP,468,2807,0,0,0,2807,A
5-NP,469,2808,1,3,0,2812,A
5-NP,470,1,0,0,2822,2823,C
5-NP,471,0,2822,0,2,2824,T
5-NP,472,2,2,2853,0,2857,G
5-NP,473,0,1,2866,0,2867,G
5-NP,474,2860,2,2,0,2864,A
5-NP,475,2868,0,2,0,2870,A
5-NP,476,1,2869,0,1,2871,T
5-NP,477,0,5,2851,0,2856,G
5-NP,478,0,1,2859,0,2860,G
5-NP,479,2871,0,6,0,2877,A
5-NP,480,0,2899,0,1,2900,T
5-NP,481,1,1,0,2892,2894,C
5-NP,482,3,0,0,2892,2895,C
5-NP,483,1,1,1,2902,2905,C
5-NP,484,2924,2,2,0,2928,A
5-NP,485,0,3,2936,0,2939,G
5-NP,486,2926,0,2,0,2928,A
5-NP,487,2916,0,0,0,2916,A
5-NP,488,0,2895,0,0,2895,T
5-NP,489,1,1,2902,0,2904,G
5-NP,490,1,2881,0,2,2884,T
5-NP,491,1,0,2888,0,2889,G
5-NP,492,0,0,1,2890,2891,C
5-NP,493,0,2881,0,1,2882,T
5-NP,494,1,2,0,3023,3026,C
5-NP,495,0,3013,0,1,3014,T
5-NP,496,2,0,0,3107,3109,C
5-NP,497,2,3094,0,8,3104,T
5-NP,498,1,1,3096,0,3098,G
5-NP,499,3108,0,3,0,3111,A
5-NP,500,0,3090,0,1,3091,T
5-NP,501,1,0,3098,1,3100,G
5-NP,502,0,2,1,3090,3093,C
5-NP,503,2989,0,2,0,2991,A
5-NP,504,0,4,3062,0,3066,G
5-NP,505,0,3,3013,0,3016,G
5-NP,506,0,0,3040,0,3040,G
5-NP,507,0,4,0,3027,3031,C
5-NP,508,0,3016,0,5,3021,T
5-NP,509,2,2,0,3018,3022,C
5-NP,510,0,2,3030,0,3032,G
5-NP,511,3067,0,1,0,3068,A
5-NP,512,0,0,0,3070,3070,C
5-NP,513,2,3003,0,3,3008,T
5-NP,514,1,0,0,3112,3113,C
5-NP,515,1,3093,0,4,3098,T
5-NP,516,0,2,0,3432,3434,C
5-NP,517,2,0,1,3437,3440,C
5-NP,518,1,1,1,3441,3444,C
5-NP,519,1,3438,0,5,3444,T
5-NP,520,3420,0,1,0,3421,A
5-NP,521,0,0,3421,0,3421,G
5-NP,522,3417,1,2,0,3420,A
5-NP,523,3315,0,1,0,3316,A
5-NP,524,1,2,3322,0,3325,G
5-NP,525,0,2,3248,0,3250,G
5-NP,526,0,3212,0,2,3214,T
5-NP,527,3,1,1,3203,3208,C
5-NP,528,1,3,1,3216,3221,C
5-NP,529,1,0,3218,1,3220,G
5-NP,530,2,4,3232,0,3238,G
5-NP,531,3230,0,2,0,3232,A
5-NP,532,1,0,3253,0,3254,G
5-NP,533,0,1,1,3256,3258,C
5-NP,534,0,3199,0,5,3204,T
5-NP,535,1,2,3198,0,3201,G
5-NP,536,0,2,0,3219,3221,C
5-NP,537,3210,1,7,0,3218,A
5-NP,538,2,1,3226,0,3229,G
5-NP,539,2,1,3242,0,3245,G
5-NP,540,0,3242,0,3,3245,T
5-NP,541,0,1,3218,0,3219,G
5-NP,542,0,0,0,3225,3225,C
5-NP,543,1,3226,0,5,3232,T
5-NP,544,4,1,3228,0,3233,G
5-NP,545,0,0,0,3232,3232,C
5-NP,546,3258,0,6,0,3264,A
5-NP,547,1,0,3303,0,3304,G
5-NP,548,0,3270,0,5,3275,T
5-NP,549,2,0,2,3280,3284,C
5-NP,550,3280,0,0,0,3280,A
5-NP,551,3275,2,2,0,3279,A
5-NP,552,3273,1,7,1,3282,A
5-NP,553,0,0,3292,0,3292,G
5-NP,554,0,5,3308,0,3313,G
5-NP,555,3282,0,0,0,3282,A
5-NP,556,3268,0,1,0,3269,A
5-NP,557,0,3268,0,0,3268,T
5-NP,558,2,1,0,3262,3265,C
5-NP,559,1,1,3270,0,3272,G
5-NP,560,0,4,3346,0,3350,G
5-NP,561,2,2,3361,0,3365,G
5-NP,562,3355,1,0,0,3356,A
5-NP,563,1,3,1,3346,3351,C
5-NP,564,3321,3,2,0,3326,A
5-NP,565,3379,0,7,0,3386,A
5-NP,566,0,3394,1,1,3396,T
5-NP,567,0,1,3402,0,3403,G
5-NP,568,2,0,3427,0,3429,G
5-NP,569,0,3336,0,3,3339,T
5-NP,570,0,5,3346,0,3351,G
5-NP,571,3345,1,1,0,3347,A
5-NP,572,0,3342,0,2,3344,T
5-NP,573,0,1,3340,1,3342,G
5-NP,574,0,1,3410,0,3411,G
5-NP,575,3404,0,5,0,3409,A
5-NP,576,3409,1,1,0,3411,A
5-NP,577,0,3,0,3392,3395,C
5-NP,578,0,3354,0,0,3354,T
5-NP,579,3346,0,2,1,3349,A
5-NP,580,3470,0,2,0,3472,A
5-NP,581,2,3474,0,2,3478,T
5-NP,582,0,2,0,3486,3488,C
5-NP,583,3381,0,0,0,3381,A
5-NP,584,1,3,3428,0,3432,G
5-NP,585,3418,2,3,0,3423,A
5-NP,586,3425,0,2,0,3427,A
5-NP,587,1,3404,0,4,3409,T
5-NP,588,0,1,3388,0,3389,G
5-NP,589,4,1,3412,1,3418,G
5-NP,590,3,3416,0,4,3423,T
5-NP,591,2,0,0,3421,3423,C
5-NP,592,3423,0,2,0,3425,A
5-NP,593,3417,0,0,0,3417,A
5-NP,594,3419,0,3,0,3422,A
5-NP,595,0,2,0,3426,3428,C
5-NP,596,1,1,3414,0,3416,G
5-NP,597,0,4,3419,0,3423,G
5-NP,598,4,4,3385,0,3393,G
5-NP,599,2,3,3405,0,3410,G
5-NP,600,2,2,3408,0,3412,G
5-NP,601,3398,1,2,0,3401,A
5-NP,602,1,3381,0,3,3385,T
5-NP,603,2,1,0,3381,3384,C
5-NP,604,3389,0,3,0,3392,A
5-NP,605,3388,2,3,0,3393,A
5-NP,606,0,2,0,3361,3363,C
5-NP,607,1,1,3363,0,3365,G
5-NP,608,3358,2,2,0,3362,A
5-NP,609,0,3352,0,0,3352,T
5-NP,610,1,5,0,3348,3354,C
5-NP,611,0,1,3360,0,3361,G
5-NP,612,3360,1,1,0,3362,A
5-NP,613,3350,0,0,0,3350,A
5-NP,614,3358,1,1,1,3361,A
5-NP,615,0,3392,1,0,3393,T
5-NP,616,0,3385,0,2,3387,T
5-NP,617,0,3387,0,0,3387,T
5-NP,618,0,3402,0,0,3402,T
5-NP,619,0,3404,0,2,3406,T
5-NP,620,0,2,3406,0,3408,G
5-NP,621,0,1,3403,0,3404,G
5-NP,622,3393,1,4,0,3398,A
5-NP,623,0,2,3409,0,3411,G
5-NP,624,3356,2,1,0,3359,A
5-NP,625,1,1,3476,0,3478,G
5-NP,626,3,1,3493,0,3497,G
5-NP,627,1,3487,0,4,3492,T
5-NP,628,1,1,3488,0,3490,G
5-NP,629,3487,0,6,0,3493,A
5-NP,630,1,3,3510,0,3514,G
5-NP,631,3502,1,4,0,3507,A
5-NP,632,3495,0,2,0,3497,A
5-NP,633,0,3499,0,0,3499,T
5-NP,634,0,0,3397,0,3397,G
5-NP,635,2,0,3375,0,3377,G
5-NP,636,3348,0,9,0,3357,A
5-NP,637,2,2,0,3354,3358,C
5-NP,638,1,1,3370,0,3372,G
5-NP,639,0,1,3406,0,3407,G
5-NP,640,3401,0,1,0,3402,A
5-NP,641,3404,0,0,0,3404,A
5-NP,642,3425,0,3,0,3428,A
5-NP,643,3432,0,2,3,3437,A
5-NP,644,1,2,0,3450,3453,C
5-NP,645,3443,0,4,0,3447,A
5-NP,646,3445,1,3,0,3449,A
5-NP,647,0,0,3449,0,3449,G
5-NP,648,3348,0,6,0,3354,A
5-NP,649,3359,1,2,0,3362,A
5-NP,650,1,1,3445,0,3447,G
5-NP,651,0,3437,1,0,3438,T
5-NP,652,0,0,3592,0,3592,G
5-NP,653,1,0,0,3561,3562,C
5-NP,654,1,3557,1,4,3563,T
5-NP,655,0,3573,1,1,3575,T
5-NP,656,3624,0,0,0,3624,A
5-NP,657,2,3621,1,0,3624,T
5-NP,658,0,3,3632,0,3635,G
5-NP,659,3535,1,10,0,3546,A
5-NP,660,0,5,3560,0,3565,G
5-NP,661,3369,0,6,1,3376,A
5-NP,662,1,1,3385,0,3387,G
5-NP,663,3370,1,1,0,3372,A
5-NP,664,3394,0,0,0,3394,A
5-NP,665,0,3361,1,1,3363,T
5-NP,666,1,0,3402,0,3403,G
5-NP,667,3,3383,1,0,3387,T
5-NP,668,2,1,3395,0,3398,G
5-NP,669,4,2,0,3377,3383,C
5-NP,670,3383,2,1,0,3386,A
5-NP,671,3381,0,3,1,3385,A
5-NP,672,1,0,0,3383,3384,C
5-NP,673,3344,0,2,0,3346,A
5-NP,674,1,3350,1,3,3355,T
5-NP,675,1,3316,2,2,3321,T
5-NP,676,2,0,0,3336,3338,C
5-NP,677,5,3329,0,2,3336,T
5-NP,678,0,3330,0,1,3331,T
5-NP,679,3333,1,1,0,3335,A
5-NP,680,3328,0,0,0,3328,A
5-NP,681,3324,1,2,0,3327,A
5-NP,682,0,3,3330,0,3333,G
5-NP,683,0,2,3328,1,3331,G
5-NP,684,3298,2,2,1,3303,A
5-NP,685,3298,0,3,0,3301,A
5-NP,686,3304,0,2,0,3306,A
5-NP,687,3327,1,1,0,3329,A
5-NP,688,1,3318,0,0,3319,T
5-NP,689,0,3316,0,1,3317,T
5-NP,690,0,3335,0,1,3336,T
5-NP,691,1,2,0,3331,3334,C
5-NP,692,3332,1,2,0,3335,A
5-NP,693,3335,0,0,0,3335,A
5-NP,694,3336,1,1,0,3338,A
5-NP,695,0,2,0,3372,3374,C
5-NP,696,3323,1,1,0,3325,A
5-NP,697,0,1,3376,0,3377,G
5-NP,698,0,0,1,3369,3370,C
5-NP,699,0,3371,0,2,3373,T
5-NP,700,0,1,3423,1,3425,G
5-NP,701,0,3,1,3410,3414,C
5-NP,702,3438,0,7,0,3445,A
5-NP,703,0,0,0,3452,3452,C
5-NP,704,3429,1,2,0,3432,A
5-NP,705,3438,0,2,0,3440,A
5-NP,706,3369,0,6,1,3376,A
5-NP,707,1,1,3472,0,3474,G
5-NP,708,3467,1,4,0,3472,A
5-NP,709,0,1,3477,0,3478,G
5-NP,710,1,2,0,3470,3473,C
5-NP,711,3467,0,1,0,3468,A
5-NP,712,3534,2,1,0,3537,A
5-NP,713,3,3526,0,2,3531,T
5-NP,714,1,2,3547,0,3550,G
5-NP,715,1,1,3562,0,3564,G
5-NP,716,2,3449,0,6,3457,T
5-NP,717,2,4,3457,0,3463,G
5-NP,718,1,0,3469,0,3470,G
5-NP,719,3471,0,3,0,3474,A
5-NP,720,3,3458,0,1,3462,T
5-NP,721,1,2,0,3374,3377,C
5-NP,722,3391,0,1,0,3392,A
5-NP,723,3394,1,0,0,3395,A
5-NP,724,1,0,3404,0,3405,G
5-NP,725,0,3376,0,1,3377,T
5-NP,726,2,2,3377,1,3382,G
5-NP,727,3328,1,6,0,3335,A
5-NP,728,1,3,3343,0,3347,G
5-NP,729,3347,0,5,0,3352,A
5-NP,730,0,0,3352,0,3352,G
5-NP,731,3330,0,2,1,3333,A
5-NP,732,3280,0,2,1,3283,A
5-NP,733,3284,0,4,1,3289,A
5-NP,734,0,0,3297,0,3297,G
5-NP,735,0,3286,0,1,3287,T
5-NP,736,3,0,0,3282,3285,C
5-NP,737,1,2,3270,1,3274,G
5-NP,738,0,2,3277,0,3279,G
5-NP,739,3273,0,4,1,3278,A
5-NP,740,3286,0,0,0,3286,A
5-NP,741,0,0,0,3284,3284,C
5-NP,742,0,1,0,3266,3267,C
5-NP,743,1,2,1,3278,3282,C
5-NP,744,3269,0,3,2,3274,A
5-NP,745,1,2,3276,0,3279,G
5-NP,746,0,1,3279,0,3280,G
5-NP,747,3260,2,1,2,3265,A
5-NP,748,3267,0,2,1,3270,A
5-NP,749,3255,0,3,0,3258,A
5-NP,750,3,0,0,3267,3270,C
5-NP,751,1,0,3268,0,3269,G
5-NP,752,1,0,0,3266,3267,C
5-NP,753,1,3251,1,3,3256,T
5-NP,754,0,2,3261,0,3263,G
5-NP,755,3252,0,2,0,3254,A
5-NP,756,1,1,3289,0,3291,G
5-NP,757,3311,2,3,2,3318,A
5-NP,758,1,3318,0,1,3320,T
5-NP,759,5,2,0,3292,3299,C
5-NP,760,1,2,3298,0,3301,G
5-NP,761,3296,0,0,1,3297,A
5-NP,762,3294,2,1,0,3297,A
5-NP,763,0,0,3284,0,3284,G
5-NP,764,3279,0,1,1,3281,A
5-NP,765,0,1,0,3181,3182,C
5-NP,766,4,1,0,3261,3266,C
5-NP,767,1,3273,0,4,3278,T
5-NP,768,1,1,0,3294,3296,C
5-NP,769,3302,1,3,2,3308,A
5-NP,770,0,3302,0,0,3302,T
5-NP,771,3308,1,1,1,3311,A
5-NP,772,0,3297,0,1,3298,T
5-NP,773,0,3272,0,3,3275,T
5-NP,774,0,3195,0,0,3195,T
5-NP,775,0,3167,2,0,3169,T
5-NP,776,0,3170,1,1,3172,T
5-NP,777,3166,2,0,0,3168,A
5-NP,778,1,1,3167,0,3169,G
5-NP,779,0,1,0,3166,3167,C
5-NP,780,3151,1,0,0,3152,A
5-NP,781,3140,0,0,0,3140,A
5-NP,782,0,3,3215,0,3218,G
5-NP,783,3214,0,0,0,3214,A
5-NP,784,0,3211,0,0,3211,T
5-NP,785,1,1,0,3221,3223,C
5-NP,786,0,3220,0,2,3222,T
5-NP,787,1,0,3290,0,3291,G
5-NP,788,0,2,1,3293,3296,C
5-NP,789,3300,0,1,0,3301,A
5-NP,790,1,3316,0,1,3318,T
5-NP,791,0,3212,0,0,3212,T
5-NP,792,0,0,3370,1,3371,G
5-NP,793,3410,0,1,0,3411,A
5-NP,794,1,3408,0,3,3412,T
5-NP,795,3409,1,2,0,3412,A
5-NP,796,0,3323,1,2,3326,T
5-NP,797,0,3299,1,1,3301,T
5-NP,798,0,1,3314,0,3315,G
5-NP,799,3263,0,1,0,3264,A
5-NP,800,0,0,3283,0,3283,G
5-NP,801,3093,0,2,0,3095,A
5-NP,802,1,0,3054,0,3055,G
5-NP,803,0,1,3089,1,3091,G
5-NP,804,3081,0,0,0,3081,A
5-NP,805,0,3080,0,3,3083,T
5-NP,806,3,0,0,3084,3087,C
5-NP,807,3063,1,1,0,3065,A
5-NP,808,0,0,3072,0,3072,G
5-NP,809,0,3057,0,0,3057,T
5-NP,810,0,3030,0,2,3032,T
5-NP,811,0,0,3026,0,3026,G
5-NP,812,0,0,0,2987,2987,C
5-NP,813,1,2989,0,1,2991,T
5-NP,814,2,1,0,2999,3002,C
5-NP,815,3006,1,0,0,3007,A
5-NP,816,0,2,0,2997,2999,C
5-NP,817,2999,0,2,1,3002,A
5-NP,818,3013,0,0,0,3013,A
5-NP,819,3007,1,0,0,3008,A
5-NP,820,0,3003,0,0,3003,T
5-NP,821,0,0,0,3002,3002,C
5-NP,822,1,2990,1,4,2996,T
5-NP,823,0,2978,0,5,2983,T
5-NP,824,1,0,2997,1,2999,G
5-NP,825,0,1,0,2983,2984,C
5-NP,826,1,0,1,3030,3032,C
5-NP,827,1,3012,0,5,3018,T
5-NP,828,3027,1,1,0,3029,A
5-NP,829,0,0,0,3017,3017,C
5-NP,830,1,1,0,3012,3014,C
5-NP,831,2,3006,0,2,3010,T
5-NP,832,0,0,3045,0,3045,G
5-NP,833,0,1,0,3044,3045,C
5-NP,834,1,1,0,3040,3042,C
5-NP,835,0,2997,0,2,2999,T
5-NP,836,3,1,3020,0,3024,G
5-NP,837,1,2999,0,2,3002,T
5-NP,838,0,1,3017,0,3018,G
5-NP,839,3,3,0,3019,3025,C
5-NP,840,2,0,3065,0,3067,G
5-NP,841,1,3019,0,2,3022,T
5-NP,842,3014,0,2,1,3017,A
5-NP,843,0,3018,0,0,3018,T
5-NP,844,0,2,3014,0,3016,G
5-NP,845,1,0,3074,0,3075,G
5-NP,846,3069,2,5,0,3076,A
5-NP,847,0,1,0,3028,3029,C
5-NP,848,2,0,0,3023,3025,C
5-NP,849,0,2967,0,3,2970,T
5-NP,850,0,1,3085,0,3086,G
5-NP,851,3,1,0,3079,3083,C
5-NP,852,3080,0,3,1,3084,A
5-NP,853,1,0,3124,0,3125,G
5-NP,854,1,2971,0,1,2973,T
5-NP,855,3050,0,4,0,3054,A
5-NP,856,0,3042,0,1,3043,T
5-NP,857,2,1,0,3024,3027,C
5-NP,858,3,0,0,3032,3035,C
5-NP,859,2842,1,1,0,2844,A
5-NP,860,1,0,2853,0,2854,G
5-NP,861,1,2836,2,1,2840,T
5-NP,862,1,3,2854,0,2858,G
5-NP,863,0,1,2844,0,2845,G
5-NP,864,1,0,2785,0,2786,G
5-NP,865,0,2774,0,3,2777,T
5-NP,866,2772,0,0,0,2772,A
5-NP,867,0,0,0,2775,2775,C
5-NP,868,0,3,2759,0,2762,G
5-NP,869,2745,0,1,0,2746,A
5-NP,870,1,0,0,2742,2743,C
5-NP,871,0,2652,1,3,2656,T
5-NP,872,0,2648,0,3,2651,T
5-NP,873,0,0,0,2648,2648,C
5-NP,874,2,1,2647,0,2650,G
5-NP,875,2650,0,0,0,2650,A
5-NP,876,2644,1,2,1,2648,A
5-NP,877,2651,0,0,0,2651,A
5-NP,878,2644,0,1,0,2645,A
5-NP,879,2636,0,4,0,2640,A
5-NP,880,0,0,2652,0,2652,G
5-NP,881,2638,0,4,0,2642,A
5-NP,882,0,2,2656,0,2658,G
5-NP,883,0,0,2665,0,2665,G
5-NP,884,1,1,2677,0,2679,G
5-NP,885,2682,1,3,0,2686,A
5-NP,886,1,2679,0,3,2683,T
5-NP,887,2688,0,1,0,2689,A
5-NP,888,0,2682,1,0,2683,T
5-NP,889,0,2675,0,0,2675,T
5-NP,890,4,1,0,2685,2690,C
5-NP,891,1,0,0,2652,2653,C
5-NP,892,0,2612,0,1,2613,T
5-NP,893,0,2609,0,0,2609,T
5-NP,894,0,1,2627,0,2628,G
5-NP,895,0,1,2635,0,2636,G
5-NP,896,2,2613,0,3,2618,T
5-NP,897,0,1,2608,0,2609,G
5-NP,898,1,1,2579,0,2581,G
5-NP,899,0,0,2659,0,2659,G
5-NP,900,2666,0,0,0,2666,A
5-NP,901,2666,0,1,0,2667,A
5-NP,902,0,2669,0,0,2669,T
5-NP,903,2604,1,3,0,2608,A
5-NP,904,0,0,2607,1,2608,G
5-NP,905,2588,2,2,0,2592,A
5-NP,906,0,0,1,2583,2584,C
5-NP,907,1,0,1,2562,2564,C
5-NP,908,1,0,0,2437,2438,C
5-NP,909,1,2441,1,3,2446,T
5-NP,910,1,2446,0,1,2448,T
5-NP,911,2,2444,1,1,2448,T
5-NP,912,1,0,0,2448,2449,C
5-NP,913,2441,0,1,0,2442,A
5-NP,914,2443,1,0,0,2444,A
5-NP,915,2439,0,1,0,2440,A
5-NP,916,0,0,0,2441,2441,C
5-NP,917,0,2363,0,1,2364,T
5-NP,918,2342,0,1,0,2343,A
5-NP,919,0,0,0,2362,2362,C
5-NP,920,1,2352,0,2,2355,T
5-NP,921,1,2356,0,1,2358,T
5-NP,922,3,0,0,2357,2360,C
5-NP,923,2351,0,0,0,2351,A
5-NP,924,2356,0,1,0,2357,A
5-NP,925,2341,1,0,0,2342,A
5-NP,926,2342,0,0,0,2342,A
5-NP,927,0,2316,0,0,2316,T
5-NP,928,2237,1,3,0,2241,A
5-NP,929,1,0,2261,1,2263,G
5-NP,930,0,0,0,2271,2271,C
5-NP,931,1,0,0,2282,2283,C
5-NP,932,2283,0,1,0,2284,A
5-NP,933,2289,0,0,0,2289,A
5-NP,934,2340,1,1,0,2342,A
5-NP,935,0,2351,0,0,2351,T
5-NP,936,2356,0,1,0,2357,A
5-NP,937,1,2356,0,1,2358,T
5-NP,938,2283,1,1,0,2285,A
5-NP,939,0,0,0,2293,2293,C
5-NP,940,2196,0,1,0,2197,A
5-NP,941,0,0,2233,0,2233,G
5-NP,942,0,0,0,2223,2223,C
5-NP,943,0,2113,1,2,2116,T
5-NP,944,0,2114,0,1,2115,T
5-NP,945,2108,0,0,0,2108,A
5-NP,946,2109,1,1,0,2111,A
5-NP,947,0,2111,0,1,2112,T
5-NP,948,1,1,1,2103,2106,C
5-NP,949,2006,0,0,0,2006,A
5-NP,950,0,0,2011,0,2011,G
5-NP,951,2009,0,2,0,2011,A
5-NP,952,0,0,0,2018,2018,C
5-NP,953,1,1,0,1978,1980,C
5-NP,954,1,1942,0,2,1945,T
5-NP,955,1956,0,1,0,1957,A
5-NP,956,1958,0,1,0,1959,A
5-NP,957,0,0,0,1966,1966,C
5-NP,958,1,2,1960,0,1963,G
5-NP,959,1912,0,1,0,1913,A
5-NP,960,0,0,1918,0,1918,G
5-NP,961,1895,0,0,0,1895,A
5-NP,962,1903,0,1,0,1904,A
5-NP,963,0,1896,0,1,1897,T
5-NP,964,0,0,1,1879,1880,C
5-NP,965,2,1,0,1877,1880,C
5-NP,966,1829,1,2,0,1832,A
5-NP,967,0,0,1840,0,1840,G
5-NP,968,1,2,0,1836,1839,C
5-NP,969,1843,0,2,0,1845,A
5-NP,970,2,1,0,1844,1847,C
5-NP,971,1808,1,3,0,1812,A
5-NP,972,0,0,0,1819,1819,C
5-NP,973,1816,0,0,0,1816,A
5-NP,974,1818,1,2,0,1821,A
5-NP,975,1,1,1820,0,1822,G
5-NP,976,1778,0,3,0,1781,A
5-NP,977,0,0,1782,0,1782,G
5-NP,978,2,1731,0,2,1735,T
5-NP,979,1,0,0,1727,1728,C
5-NP,980,1713,0,1,0,1714,A
5-NP,981,0,0,1703,0,1703,G
5-NP,982,3,0,0,1699,1702,C
5-NP,983,1,1676,0,2,1679,T
5-NP,984,1,1,1674,0,1676,G
5-NP,985,1,0,1672,0,1673,G
5-NP,986,1,1644,0,1,1646,T
5-NP,987,0,0,1648,0,1648,G
5-NP,988,0,1607,0,3,1610,T
5-NP,989,0,0,1612,0,1612,G
5-NP,990,1,1,1604,0,1606,G
5-NP,991,1589,0,0,0,1589,A
5-NP,992,0,1592,1,0,1593,T
5-NP,993,0,1,1514,0,1515,G
5-NP,994,1,2,1490,0,1493,G
5-NP,995,0,1,0,1485,1486,C
5-NP,996,1457,0,0,0,1457,A
5-NP,997,1,1453,2,1,1457,T
5-NP,998,1,2,1436,0,1439,G
5-NP,999,1,2,0,1441,1444,C
5-NP,1000,3,0,0,1445,1448,C
5-NP,1001,1432,0,0,0,1432,A
5-NP,1002,0,1419,0,1,1420,T
5-NP,1003,0,1384,0,0,1384,T
5-NP,1004,1,0,0,1383,1384,C
5-NP,1005,0,1341,1,1,1343,T
5-NP,1006,0,0,1344,0,1344,G
5-NP,1007,1,0,0,1337,1338,C
5-NP,1008,0,1228,0,1,1229,T
5-NP,1009,0,0,1232,0,1232,G
5-NP,1010,0,0,0,1167,1167,C
5-NP,1011,1162,0,1,0,1163,A
5-NP,1012,0,1162,0,1,1163,T
5-NP,1013,0,1134,0,0,1134,T
5-NP,1014,0,1133,0,2,1135,T
5-NP,1015,0,0,1131,0,1131,G
5-NP,1016,1127,0,2,0,1129,A
5-NP,1017,1130,0,1,0,1131,A
5-NP,1018,0,0,1138,0,1138,G
5-NP,1019,1140,1,1,0,1142,A
5-NP,1020,0,1130,0,0,1130,T
5-NP,1021,0,1129,0,1,1130,T
5-NP,1022,0,1129,0,1,1130,T
5-NP,1023,1128,0,1,0,1129,A
5-NP,1024,1128,0,0,0,1128,A
5-NP,1025,0,0,1131,0,1131,G
5-NP,1026,1124,0,1,0,1125,A
5-NP,1027,0,1116,0,0,1116,T
5-NP,1028,0,1085,0,1,1086,T
5-NP,1029,0,0,1093,0,1093,G
5-NP,1030,1,1090,0,0,1091,T
5-NP,1031,0,1091,0,0,1091,T
5-NP,1032,1090,0,1,0,1091,A
5-NP,1033,1082,0,0,0,1082,A
5-NP,1034,0,0,1083,0,1083,G
5-NP,1035,0,0,0,1086,1086,C
5-NP,1036,0,1061,0,0,1061,T
5-NP,1037,0,1058,0,0,1058,T
5-NP,1038,1,0,0,1059,1060,C
5-NP,1039,1061,0,1,0,1062,A
5-NP,1040,0,1061,0,0,1061,T
5-NP,1041,0,0,0,1061,1061,C
5-NP,1042,1052,0,0,0,1052,A
5-NP,1043,0,0,1052,0,1052,G
5-NP,1044,1037,0,4,0,1041,A
5-NP,1045,0,1,1042,0,1043,G
5-NP,1046,1,0,1034,0,1035,G
5-NP,1047,0,1,1026,0,1027,G
5-NP,1048,1023,0,1,0,1024,A
5-NP,1049,1,0,0,1026,1027,C
5-NP,1050,1026,0,0,0,1026,A
5-NP,1051,1031,0,0,0,1031,A
5-NP,1052,1030,0,1,0,1031,A
5-NP,1053,1030,0,2,0,1032,A
5-NP,1054,0,1,1038,0,1039,G
5-NP,1055,0,1005,0,0,1005,T
5-NP,1056,998,0,1,0,999,A
5-NP,1057,0,996,0,1,997,T
5-NP,1058,1,0,0,993,994,C
5-NP,1059,0,989,0,1,990,T
5-NP,1060,0,0,0,994,994,C
5-NP,1061,0,0,0,983,983,C
5-NP,1062,0,974,1,0,975,T
5-NP,1063,0,0,0,972,972,C
5-NP,1064,1,2,964,0,967,G
5-NP,1065,0,0,970,1,971,G
5-NP,1066,0,0,970,0,970,G
5-NP,1067,0,0,963,0,963,G
5-NP,1068,1,0,966,0,967,G
5-NP,1069,950,0,2,0,952,A
5-NP,1070,953,0,0,0,953,A
5-NP,1071,954,0,1,0,955,A
5-NP,1072,0,0,0,957,957,C
5-NP,1073,0,948,0,0,948,T
5-NP,1074,0,0,953,0,953,G
5-NP,1075,0,942,0,0,942,T
5-NP,1076,1,0,1,940,942,C
5-NP,1077,947,0,0,0,947,A
5-NP,1078,951,0,0,0,951,A
5-NP,1079,0,0,0,953,953,C
5-NP,1080,0,953,0,0,953,T
5-NP,1081,926,0,1,0,927,A
5-NP,1082,0,1,929,0,930,G
5-NP,1083,904,1,1,0,906,A
5-NP,1084,0,1,901,0,902,G
5-NP,1085,0,0,899,0,899,G
5-NP,1086,859,0,1,0,860,A
5-NP,1087,0,0,871,0,871,G
5-NP,1088,0,856,0,0,856,T
5-NP,1089,853,0,3,0,856,A
5-NP,1090,0,0,0,856,856,C
5-NP,1091,846,0,0,0,846,A
5-NP,1092,847,0,0,0,847,A
5-NP,1093,834,0,0,0,834,A
5-NP,1094,0,825,0,0,825,T
5-NP,1095,1,822,0,0,823,T
5-NP,1096,0,0,796,0,796,G
5-NP,1097,0,0,0,789,789,C
5-NP,1098,0,786,0,1,787,T
5-NP,1099,0,787,0,1,788,T
5-NP,1100,1,0,0,787,788,C
5-NP,1101,788,0,1,0,789,A
5-NP,1102,795,0,0,0,795,A
5-NP,1103,794,0,0,0,794,A
5-NP,1104,0,796,0,0,796,T
5-NP,1105,0,0,794,0,794,G
5-NP,1106,776,0,0,0,776,A
5-NP,1107,0,2,774,0,776,G
5-NP,1108,779,0,0,0,779,A
5-NP,1109,778,0,1,0,779,A
5-NP,1110,0,1,0,778,779,C
5-NP,1111,775,0,0,0,775,A
5-NP,1112,1,772,0,0,773,T
5-NP,1113,0,0,781,0,781,G
5-NP,1114,1,1,780,0,782,G
5-NP,1115,779,0,1,0,780,A
5-NP,1116,0,758,0,0,758,T
5-NP,1117,746,0,0,0,746,A
5-NP,1118,771,0,1,0,772,A
5-NP,1119,0,754,0,0,754,T
5-NP,1120,755,0,0,0,755,A
5-NP,1121,0,752,0,0,752,T
5-NP,1122,1,0,670,0,671,G
5-NP,1123,1,2,654,0,657,G
5-NP,1124,0,1,656,0,657,G
5-NP,1125,658,0,0,0,658,A
5-NP,1126,1,653,0,0,654,T
5-NP,1127,1,0,0,498,499,C
5-NP,1128,1,0,496,0,497,G
5-NP,1129,497,0,1,0,498,A
5-NP,1130,0,0,498,0,498,G
5-NP,1131,0,0,0,498,498,C
5-NP,1132,486,0,0,0,486,A
5-NP,1133,0,0,0,503,503,C
5-NP,1134,0,494,0,1,495,T
5-NP,1135,1,0,0,494,495,C
5-NP,1136,0,496,0,0,496,T
5-NP,1137,0,489,0,1,490,T
5-NP,1138,0,0,490,0,490,G
5-NP,1139,488,0,0,0,488,A
5-NP,1140,488,0,0,0,488,A
5-NP,1141,0,0,0,488,488,C
5-NP,1142,0,360,1,0,361,T
5-NP,1143,0,0,364,0,364,G
5-NP,1144,349,0,0,0,349,A
5-NP,1145,0,0,350,0,350,G
5-NP,1146,348,0,0,0,348,A
5-NP,1147,341,0,0,0,341,A
5-NP,1148,0,0,342,0,342,G
5-NP,1149,0,0,0,330,330,C
5-NP,1150,0,1,326,0,327,G
5-NP,1151,0,0,326,0,326,G
5-NP,1152,0,0,313,0,313,G
5-NP,1153,0,307,0,0,307,T
5-NP,1154,299,0,0,0,299,A
5-NP,1155,0,1,0,298,299,C
5-NP,1156,0,225,0,0,225,T
5-NP,1157,0,0,218,0,218,G
5-NP,1158,0,0,212,0,212,G
5-NP,1159,1,1,204,0,206,G
5-NP,1160,0,0,0,206,206,C
5-NP,1161,0,0,0,181,181,C
5-NP,1162,181,0,0,0,181,A
5-NP,1163,0,180,1,0,181,T
5-NP,1164,181,0,0,0,181,A
5-NP,1165,179,0,0,0,179,A
5-NP,1166,0,0,177,0,177,G
5-NP,1167,0,0,178,0,178,G
5-NP,1168,174,0,1,0,175,A
5-NP,1169,0,0,0,175,175,C
5-NP,1170,0,0,0,175,175,C
5-NP,1171,175,0,0,0,175,A
5-NP,1172,0,0,181,0,181,G
5-NP,1173,0,0,180,0,180,G
5-NP,1174,180,0,0,0,180,A
5-NP,1175,0,0,180,0,180,G
5-NP,1176,0,171,0,0,171,T
5-NP,1177,0,0,172,0,172,G
5-NP,1178,0,0,172,0,172,G
5-NP,1179,172,0,0,0,172,A
5-NP,1180,0,0,173,0,173,G
5-NP,1181,0,0,171,0,171,G
5-NP,1182,172,0,0,0,172,A
5-NP,1183,172,0,0,0,172,A
5-NP,1184,170,0,1,0,171,A
5-NP,1185,0,0,0,170,170,C
5-NP,1186,169,0,0,0,169,A
5-NP,1187,1,0,0,170,171,C
5-NP,1188,0,169,0,0,169,T
5-NP,1189,174,0,0,0,174,A
5-NP,1190,175,0,0,0,175,A
5-NP,1191,0,174,0,0,174,T
5-NP,1192,0,0,0,175,175,C
5-NP,1193,174,0,0,0,174,A
5-NP,1194,175,0,0,0,175,A
5-NP,1195,0,0,0,174,174,C
5-NP,1196,169,0,0,0,169,A
5-NP,1197,0,0,169,0,169,G
5-NP,1198,167,0,0,0,167,A
5-NP,1199,0,0,168,0,168,G
5-NP,1200,0,1,167,0,168,G
5-NP,1201,0,0,166,0,166,G
5-NP,1202,0,0,0,166,166,C
5-NP,1203,0,0,0,163,163,C
5-NP,1204,0,160,0,0,160,T
5-NP,1205,0,0,0,163,163,C
5-NP,1206,0,0,0,163,163,C
5-NP,1207,0,0,163,0,163,G
5-NP,1208,0,0,0,163,163,C
5-NP,1209,161,0,0,0,161,A
5-NP,1210,0,0,166,0,166,G
5-NP,1211,0,0,167,0,167,G
5-NP,1212,1,0,0,169,170,C
5-NP,1213,0,0,0,171,171,C
5-NP,1214,169,0,0,0,169,A
5-NP,1215,169,0,0,0,169,A
5-NP,1216,168,0,1,0,169,A
5-NP,1217,0,0,0,169,169,C
5-NP,1218,0,0,0,169,169,C
5-NP,1219,142,0,0,0,142,A
5-NP,1220,0,0,147,0,147,G
5-NP,1221,0,145,0,0,145,T
5-NP,1222,0,0,150,0,150,G
5-NP,1223,0,149,0,0,149,T
5-NP,1224,0,0,149,0,149,G
5-NP,1225,0,0,0,149,149,C
5-NP,1226,150,0,0,0,150,A
5-NP,1227,153,0,0,0,153,A
5-NP,1228,0,0,0,152,152,C
5-NP,1229,0,0,0,151,151,C
5-NP,1230,0,150,0,0,150,T
5-NP,1231,149,0,0,0,149,A
5-NP,1232,0,0,0,149,149,C
5-NP,1233,0,0,151,0,151,G
5-NP,1234,0,150,0,0,150,T
5-NP,1235,0,150,0,0,150,T
5-NP,1236,0,147,0,0,147,T
5-NP,1237,0,148,0,0,148,T
5-NP,1238,0,0,0,149,149,C
5-NP,1239,0,147,0,1,148,T
5-NP,1240,0,0,149,0,149,G
5-NP,1241,0,150,0,0,150,T
5-NP,1242,150,0,0,0,150,A
5-NP,1243,0,0,0,151,151,C
5-NP,1244,147,0,0,0,147,A
5-NP,1245,148,0,0,0,148,A
5-NP,1246,147,0,1,0,148,A
5-NP,1247,0,0,148,0,148,G
5-NP,1248,149,0,0,0,149,A
5-NP,1249,144,0,0,0,144,A
5-NP,1250,144,0,2,0,146,A
5-NP,1251,0,1,0,145,146,C
5-NP,1252,0,0,0,141,141,C
5-NP,1253,0,140,0,0,140,T
5-NP,1254,0,0,0,137,137,C
5-NP,1255,0,0,0,140,140,C
5-NP,1256,0,0,0,139,139,C
5-NP,1257,139,0,0,0,139,A
5-NP,1258,0,140,0,0,140,T
5-NP,1259,0,140,0,0,140,T
5-NP,1260,0,140,0,0,140,T
5-NP,1261,0,0,140,0,140,G
5-NP,1262,140,0,0,0,140,A
5-NP,1263,140,0,0,0,140,A
5-NP,1264,139,0,0,0,139,A
5-NP,1265,139,0,0,0,139,A
5-NP,1266,0,0,143,0,143,G
5-NP,1267,0,143,0,0,143,T
5-NP,1268,0,0,0,144,144,C
5-NP,1269,143,0,1,0,144,A
5-NP,1270,145,0,0,0,145,A
5-NP,1271,0,0,0,147,147,C
5-NP,1272,0,0,0,146,146,C
5-NP,1273,147,0,0,0,147,A
5-NP,1274,0,146,0,0,146,T
5-NP,1275,0,0,0,144,144,C
5-NP,1276,144,0,0,0,144,A
5-NP,1277,0,145,0,0,145,T
5-NP,1278,0,0,145,0,145,G
5-NP,1279,0,0,145,0,145,G
5-NP,1280,0,1,0,144,145,C
5-NP,1281,141,0,0,0,141,A
5-NP,1282,0,0,142,0,142,G
5-NP,1283,0,0,0,141,141,C
5-NP,1284,142,0,1,0,143,A
5-NP,1285,0,144,0,0,144,T
5-NP,1286,0,144,0,0,144,T
5-NP,1287,0,0,0,143,143,C
5-NP,1288,142,0,1,0,143,A
5-NP,1289,0,0,0,144,144,C
5-NP,1290,0,143,0,0,143,T
5-NP,1291,1,0,143,0,144,G
5-NP,1292,0,0,145,0,145,G
5-NP,1293,147,0,0,0,147,A
5-NP,1294,146,0,0,0,146,A
5-NP,1295,145,0,1,0,146,A
5-NP,1296,0,147,0,0,147,T
5-NP,1297,147,0,0,0,147,A
5-NP,1298,0,0,0,144,144,C
5-NP,1299,0,0,141,0,141,G
5-NP,1300,1,0,139,0,140,G
5-NP,1301,137,0,0,0,137,A
5-NP,1302,0,0,137,0,137,G
5-NP,1303,0,0,138,0,138,G
5-NP,1304,0,0,139,0,139,G
5-NP,1305,139,0,0,0,139,A
5-NP,1306,139,0,0,0,139,A
5-NP,1307,0,0,139,0,139,G
5-NP,1308,139,0,0,0,139,A
5-NP,1309,139,0,0,0,139,A
5-NP,1310,0,0,0,138,138,C
5-NP,1311,0,134,0,0,134,T
5-NP,1312,0,133,0,0,133,T
5-NP,1313,0,0,0,134,134,C
5-NP,1314,133,0,1,0,134,A
5-NP,1315,0,0,135,0,135,G
5-NP,1316,134,0,0,0,134,A
5-NP,1317,0,0,0,133,133,C
5-NP,1318,134,0,0,0,134,A
5-NP,1319,0,132,0,0,132,T
5-NP,1320,0,0,132,0,132,G
5-NP,1321,129,0,0,0,129,A
5-NP,1322,0,0,129,0,129,G
5-NP,1323,0,0,129,0,129,G
5-NP,1324,0,0,129,0,129,G
5-NP,1325,0,0,0,129,129,C
5-NP,1326,129,0,0,0,129,A
5-NP,1327,0,0,129,0,129,G
5-NP,1328,128,0,0,0,128,A
5-NP,1329,129,0,0,0,129,A
5-NP,1330,129,0,0,0,129,A
5-NP,1331,0,129,0,0,129,T
5-NP,1332,0,0,0,127,127,C
5-NP,1333,128,0,0,0,128,A
5-NP,1334,0,128,0,0,128,T
5-NP,1335,128,0,0,0,128,A
5-NP,1336,127,0,0,0,127,A
5-NP,1337,0,0,127,0,127,G
5-NP,1338,126,0,0,0,126,A
5-NP,1339,126,0,0,0,126,A
5-NP,1340,0,125,0,0,125,T
5-NP,1341,0,0,123,0,123,G
5-NP,1342,122,0,0,0,122,A
5-NP,1343,0,122,0,0,122,T
5-NP,1344,0,0,122,0,122,G
5-NP,1345,0,0,123,0,123,G
5-NP,1346,122,0,0,0,122,A
5-NP,1347,122,0,0,0,122,A
5-NP,1348,119,0,0,0,119,A
5-NP,1349,0,0,119,0,119,G
5-NP,1350,0,119,0,0,119,T
5-NP,1351,0,0,119,0,119,G
5-NP,1352,0,0,0,119,119,C
5-NP,1353,118,0,0,0,118,A
5-NP,1354,118,0,1,0,119,A
5-NP,1355,119,0,0,0,119,A
5-NP,1356,119,0,1,0,120,A
5-NP,1357,0,0,0,120,120,C
5-NP,1358,0,1,0,115,116,C
5-NP,1359,113,0,0,0,113,A
5-NP,1360,0,0,113,0,113,G
5-NP,1361,112,1,0,0,113,A
5-NP,1362,113,0,0,0,113,A
5-NP,1363,0,0,111,0,111,G
5-NP,1364,109,0,0,0,109,A
5-NP,1365,108,0,0,0,108,A
5-NP,1366,0,0,108,0,108,G
5-NP,1367,0,107,0,0,107,T
5-NP,1368,0,0,108,0,108,G
5-NP,1369,0,105,0,1,106,T
5-NP,1370,0,0,0,106,106,C
5-NP,1371,106,0,0,0,106,A
5-NP,1372,0,108,0,0,108,T
5-NP,1373,0,106,0,1,107,T
5-NP,1374,1,0,0,106,107,C
5-NP,1375,0,0,0,107,107,C
5-NP,1376,0,1,106,0,107,G
5-NP,1377,0,0,106,0,106,G
5-NP,1378,0,0,105,0,105,G
5-NP,1379,0,0,107,0,107,G
5-NP,1380,0,0,107,0,107,G
5-NP,1381,104,0,0,0,104,A
5-NP,1382,0,0,107,0,107,G
5-NP,1383,0,0,106,0,106,G
5-NP,1384,0,0,107,0,107,G
5-NP,1385,1,0,103,0,104,G
5-NP,1386,105,0,0,0,105,A
5-NP,1387,0,0,105,0,105,G
5-NP,1388,0,104,0,0,104,T
5-NP,1389,0,0,0,104,104,C
5-NP,1390,0,103,0,0,103,T
5-NP,1391,0,103,0,0,103,T
5-NP,1392,0,0,0,103,103,C
5-NP,1393,0,0,104,0,104,G
5-NP,1394,103,0,0,0,103,A
5-NP,1395,0,0,103,0,103,G
5-NP,1396,0,0,0,101,101,C
5-NP,1397,0,100,0,0,100,T
5-NP,1398,0,0,0,101,101,C
5-NP,1399,0,100,0,0,100,T
5-NP,1400,0,0,0,99,99,C
5-NP,1401,100,0,0,0,100,A
5-NP,1402,0,0,100,0,100,G
5-NP,1403,100,0,0,0,100,A
5-NP,1404,0,1,0,99,100,C
5-NP,1405,0,0,99,0,99,G
5-NP,1406,99,0,0,0,99,A
5-NP,1407,0,1,97,0,98,G
5-NP,1408,98,0,0,0,98,A
5-NP,1409,96,0,0,0,96,A
5-NP,1410,0,0,96,0,96,G
5-NP,1411,0,0,93,0,93,G
5-NP,1412,0,0,0,92,92,C
5-NP,1413,92,0,0,0,92,A
5-NP,1414,93,0,0,0,93,A
5-NP,1415,0,0,0,92,92,C
5-NP,1416,0,0,92,0,92,G
5-NP,1417,92,0,0,0,92,A
5-NP,1418,93,0,0,0,93,A
5-NP,1419,0,0,0,93,93,C
5-NP,1420,0,0,0,93,93,C
5-NP,1421,0,0,0,91,91,C
5-NP,1422,0,1,91,0,92,G
5-NP,1423,91,0,1,0,92,A
5-NP,1424,0,92,0,0,92,T
5-NP,1425,0,0,0,90,90,C
5-NP,1426,1,0,89,0,90,G
5-NP,1427,0,90,0,0,90,T
5-NP,1428,0,0,89,0,89,G
5-NP,1429,0,0,0,88,88,C
5-NP,1430,0,0,0,87,87,C
5-NP,1431,0,0,0,87,87,C
5-NP,1432,0,88,0,0,88,T
5-NP,1433,0,0,0,88,88,C
5-NP,1434,0,90,0,0,90,T
5-NP,1435,0,87,1,0,88,T
5-NP,1436,0,88,1,0,89,T
5-NP,1437,0,90,0,0,90,T
5-NP,1438,0,1,90,0,91,G
5-NP,1439,91,0,0,0,91,A
5-NP,1440,0,92,0,0,92,T
5-NP,1441,89,0,0,0,89,A
5-NP,1442,0,77,0,0,77,T
5-NP,1443,0,0,78,0,78,G
5-NP,1444,77,0,1,0,78,A
5-NP,1445,0,0,79,0,79,G
5-NP,1446,0,79,0,0,79,T
5-NP,1447,74,0,0,0,74,A
5-NP,1448,75,0,0,0,75,A
5-NP,1449,0,74,0,0,74,T
5-NP,1450,0,0,75,0,75,G
5-NP,1451,75,0,0,0,75,A
5-NP,1452,70,0,0,0,70,A
5-NP,1453,0,0,69,0,69,G
5-NP,1454,0,0,65,0,65,G
5-NP,1455,65,0,0,0,65,A
5-NP,1456,0,64,0,0,64,T
5-NP,1457,0,0,0,64,64,C
5-NP,1458,0,61,0,0,61,T
5-NP,1459,0,62,0,0,62,T
5-NP,1460,62,0,0,0,62,A
5-NP,1461,1,61,0,0,62,T
5-NP,1462,1,59,0,0,60,T
5-NP,1463,0,61,0,0,61,T
5-NP,1464,1,0,0,58,59,C
5-NP,1465,0,53,0,0,53,T
5-NP,1466,0,53,0,0,53,T
5-NP,1467,0,0,0,54,54,C
5-NP,1468,0,0,53,0,53,G
5-NP,1469,0,0,53,0,53,G
5-NP,1470,53,0,0,0,53,A
5-NP,1471,0,0,52,0,52,G
5-NP,1472,51,0,0,0,51,A
5-NP,1473,0,0,0,51,51,C
5-NP,1474,48,0,0,0,48,A
5-NP,1475,48,0,0,0,48,A
5-NP,1476,0,48,0,0,48,T
5-NP,1477,0,0,47,0,47,G
5-NP,1478,0,0,0,47,47,C
5-NP,1479,45,0,0,0,45,A
5-NP,1480,0,0,45,0,45,G
5-NP,1481,44,0,0,1,45,A
5-NP,1482,44,0,0,0,44,A
5-NP,1483,0,0,43,0,43,G
5-NP,1484,33,0,0,0,33,A
5-NP,1485,0,0,32,0,32,G
5-NP,1486,0,26,0,0,26,T
5-NP,1487,25,0,0,0,25,A
5-NP,1488,0,23,0,0,23,T
5-NP,1489,0,0,23,0,23,G
5-NP,1490,23,0,0,0,23,A
5-NP,1491,0,0,0,22,22,C
5-NP,1492,13,0,0,0,13,A
5-NP,1493,13,0,0,0,13,A
5-NP,1494,0,8,0,0,8,T
5-NP,1495,0,8,0,0,8,T
5-NP,1496,6,0,0,0,6,A
5-NP,1497,6,0,0,0,6,A
6-NA,1,173,0,0,0,173,A
6-NA,2,0,180,0,0,180,T
6-NA,3,0,0,182,0,182,G
6-NA,4,183,0,1,0,184,A
6-NA,5,189,0,0,0,189,A
6-NA,6,0,190,0,0,190,T
6-NA,7,0,4,0,186,190,C
6-NA,8,0,0,0,190,190,C
6-NA,9,189,0,1,0,190,A
6-NA,10,193,1,0,0,194,A
6-NA,11,194,0,0,0,194,A
6-NA,12,0,200,0,0,200,T
6-NA,13,0,0,0,204,204,C
6-NA,14,201,0,0,0,201,A
6-NA,15,208,0,0,0,208,A
6-NA,16,208,0,0,0,208,A
6-NA,17,221,0,0,0,221,A
6-NA,18,0,0,249,0,249,G
6-NA,19,256,1,0,0,257,A
6-NA,20,0,261,0,0,261,T
6-NA,21,264,0,0,0,264,A
6-NA,22,268,0,0,0,268,A
6-NA,23,0,269,0,0,269,T
6-NA,24,270,0,0,0,270,A
6-NA,25,275,0,0,0,275,A
6-NA,26,0,0,0,290,290,C
6-NA,27,0,0,294,0,294,G
6-NA,28,295,0,0,0,295,A
6-NA,29,0,295,0,0,295,T
6-NA,30,0,295,0,0,295,T
6-NA,31,0,0,300,0,300,G
6-NA,32,0,0,311,0,311,G
6-NA,33,0,0,0,313,313,C
6-NA,34,0,311,0,1,312,T
6-NA,35,0,0,0,327,327,C
6-NA,36,0,326,0,1,327,T
6-NA,37,0,0,344,0,344,G
6-NA,38,0,344,0,0,344,T
6-NA,39,0,343,0,1,344,T
6-NA,40,0,355,0,0,355,T
6-NA,41,0,1,0,358,359,C
6-NA,42,0,360,0,0,360,T
6-NA,43,0,0,0,361,361,C
6-NA,44,0,364,0,0,364,T
6-NA,45,0,0,0,373,373,C
6-NA,46,372,1,0,0,373,A
6-NA,47,0,0,0,395,395,C
6-NA,48,0,0,0,393,393,C
6-NA,49,394,0,0,0,394,A
6-NA,50,0,403,0,0,403,T
6-NA,51,0,407,0,0,407,T
6-NA,52,0,408,0,0,408,T
6-NA,53,0,0,0,424,424,C
6-NA,54,0,1,0,424,425,C
6-NA,55,430,0,0,0,430,A
6-NA,56,0,1,0,442,443,C
6-NA,57,443,0,0,0,443,A
6-NA,58,469,0,0,0,469,A
6-NA,59,0,469,0,0,469,T
6-NA,60,496,1,0,0,497,A
6-NA,61,0,497,0,0,497,T
6-NA,62,0,0,500,0,500,G
6-NA,63,0,0,0,501,501,C
6-NA,64,0,498,0,3,501,T
6-NA,65,0,517,0,0,517,T
6-NA,66,0,0,0,516,516,C
6-NA,67,0,514,0,0,514,T
6-NA,68,0,516,0,0,516,T
6-NA,69,1,0,0,512,513,C
6-NA,70,512,1,0,0,513,A
6-NA,71,1,513,0,0,514,T
6-NA,72,0,0,511,0,511,G
6-NA,73,0,0,0,517,517,C
6-NA,74,513,0,0,0,513,A
6-NA,75,516,0,1,0,517,A
6-NA,76,519,0,0,0,519,A
6-NA,77,1,525,0,1,527,T
6-NA,78,0,526,0,1,527,T
6-NA,79,1,0,528,0,529,G
6-NA,80,0,0,0,531,531,C
6-NA,81,0,0,0,531,531,C
6-NA,82,533,0,0,0,533,A
6-NA,83,0,534,0,0,534,T
6-NA,84,0,0,0,567,567,C
6-NA,85,1,567,0,2,570,T
6-NA,86,0,573,0,0,573,T
6-NA,87,0,0,585,0,585,G
6-NA,88,585,0,0,0,585,A
6-NA,89,0,589,0,0,589,T
6-NA,90,589,0,0,0,589,A
6-NA,91,586,0,0,0,586,A
6-NA,92,0,0,0,672,672,C
6-NA,93,0,669,0,0,669,T
6-NA,94,680,0,0,0,680,A
6-NA,95,0,0,0,715,715,C
6-NA,96,0,712,0,0,712,T
6-NA,97,0,0,726,0,726,G
6-NA,98,0,725,0,1,726,T
6-NA,99,726,0,0,0,726,A
6-NA,100,734,0,1,0,735,A
6-NA,101,0,0,0,729,729,C
6-NA,102,727,1,0,0,728,A
6-NA,103,0,762,0,0,762,T
6-NA,104,0,755,0,0,755,T
6-NA,105,0,0,753,0,753,G
6-NA,106,0,0,0,749,749,C
6-NA,107,757,0,0,0,757,A
6-NA,108,0,763,0,0,763,T
6-NA,109,0,763,0,0,763,T
6-NA,110,0,763,0,0,763,T
6-NA,111,1,0,0,762,763,C
6-NA,112,764,0,0,0,764,A
6-NA,113,760,0,5,0,765,A
6-NA,114,1,0,764,0,765,G
6-NA,115,0,0,0,767,767,C
6-NA,116,755,0,2,0,757,A
6-NA,117,782,0,1,0,783,A
6-NA,118,0,794,0,0,794,T
6-NA,119,794,0,0,0,794,A
6-NA,120,0,793,0,0,793,T
6-NA,121,0,1,814,0,815,G
6-NA,122,810,0,2,0,812,A
6-NA,123,834,0,0,0,834,A
6-NA,124,0,831,0,0,831,T
6-NA,125,0,835,0,0,835,T
6-NA,126,0,0,0,838,838,C
6-NA,127,830,0,2,1,833,A
6-NA,128,841,6,1,0,848,A
6-NA,129,0,0,0,848,848,C
6-NA,130,1,844,0,1,846,T
6-NA,131,0,0,0,848,848,C
6-NA,132,1,0,0,851,852,C
6-NA,133,0,0,0,866,866,C
6-NA,134,0,0,1,868,869,C
6-NA,135,2,0,0,868,870,C
6-NA,136,1,1,0,877,879,C
6-NA,137,1,1,0,878,880,C
6-NA,138,881,1,0,1,883,A
6-NA,139,886,0,0,0,886,A
6-NA,140,885,0,1,1,887,A
6-NA,141,0,1,1,905,907,C
6-NA,142,893,0,1,0,894,A
6-NA,143,911,0,0,0,911,A
6-NA,144,0,0,0,914,914,C
6-NA,145,1,0,0,910,911,C
6-NA,146,939,0,0,0,939,A
6-NA,147,940,0,2,0,942,A
6-NA,148,0,0,961,0,961,G
6-NA,149,0,961,0,1,962,T
6-NA,150,0,0,959,0,959,G
6-NA,151,971,0,1,0,972,A
6-NA,152,0,966,0,0,966,T
6-NA,153,0,0,968,0,968,G
6-NA,154,1,0,0,968,969,C
6-NA,155,0,963,0,1,964,T
6-NA,156,0,0,1007,0,1007,G
6-NA,157,0,1004,0,1,1005,T
6-NA,158,0,0,999,0,999,G
6-NA,159,0,1011,0,0,1011,T
6-NA,160,0,1,1003,0,1004,G
6-NA,161,1006,0,1,0,1007,A
6-NA,162,1014,0,1,1,1016,A
6-NA,163,7,0,0,1007,1014,C
6-NA,164,0,0,0,1012,1012,C
6-NA,165,992,1,0,0,993,A
6-NA,166,992,0,1,0,993,A
6-NA,167,0,0,0,1039,1039,C
6-NA,168,1045,1,0,0,1046,A
6-NA,169,1066,0,0,0,1066,A
6-NA,170,0,1070,0,1,1071,T
6-NA,171,1065,0,1,0,1066,A
6-NA,172,1066,0,0,0,1066,A
6-NA,173,0,1069,0,0,1069,T
6-NA,174,1059,0,1,0,1060,A
6-NA,175,0,1,1072,0,1073,G
6-NA,176,1050,0,0,0,1050,A
6-NA,177,1059,0,0,0,1059,A
6-NA,178,1072,0,1,0,1073,A
6-NA,179,0,1,1076,0,1077,G
6-NA,180,1098,1,1,0,1100,A
6-NA,181,1102,0,1,0,1103,A
6-NA,182,1138,0,2,1,1141,A
6-NA,183,0,0,0,1143,1143,C
6-NA,184,1146,0,0,0,1146,A
6-NA,185,0,1164,0,1,1165,T
6-NA,186,1178,0,0,1,1179,A
6-NA,187,1182,0,2,0,1184,A
6-NA,188,0,1,0,1199,1200,C
6-NA,189,1191,0,0,0,1191,A
6-NA,190,0,0,1232,0,1232,G
6-NA,191,1211,0,2,0,1213,A
6-NA,192,1,0,1212,0,1213,G
6-NA,193,1208,1,2,0,1211,A
6-NA,194,0,1256,0,0,1256,T
6-NA,195,1250,0,1,0,1251,A
6-NA,196,0,0,1271,0,1271,G
6-NA,197,1,1266,0,1,1268,T
6-NA,198,0,0,1298,0,1298,G
6-NA,199,0,1287,0,1,1288,T
6-NA,200,1288,0,1,0,1289,A
6-NA,201,1,1283,0,0,1284,T
6-NA,202,1,0,0,1287,1288,C
6-NA,203,1,1276,0,2,1279,T
6-NA,204,0,2,1303,0,1305,G
6-NA,205,1296,2,0,0,1298,A
6-NA,206,0,0,0,1295,1295,C
6-NA,207,0,0,0,1297,1297,C
6-NA,208,1292,0,0,0,1292,A
6-NA,209,1297,0,0,0,1297,A
6-NA,210,0,0,0,1312,1312,C
6-NA,211,1308,0,3,0,1311,A
6-NA,212,0,0,1,1338,1339,C
6-NA,213,0,0,1,1329,1330,C
6-NA,214,1358,0,4,0,1362,A
6-NA,215,0,0,0,1412,1412,C
6-NA,216,0,0,0,1412,1412,C
6-NA,217,1416,0,1,1,1418,A
6-NA,218,0,1416,0,1,1417,T
6-NA,219,1417,2,0,0,1419,A
6-NA,220,1,1,1414,0,1416,G
6-NA,221,1398,4,0,0,1402,A
6-NA,222,0,0,1428,0,1428,G
6-NA,223,1408,0,2,0,1410,A
6-NA,224,1402,0,1,0,1403,A
6-NA,225,0,1,1405,0,1406,G
6-NA,226,1,2,1409,0,1412,G
6-NA,227,1409,1,1,0,1411,A
6-NA,228,1413,0,0,0,1413,A
6-NA,229,1418,1,0,0,1419,A
6-NA,230,0,1415,0,0,1415,T
6-NA,231,1411,0,0,0,1411,A
6-NA,232,1,1401,0,1,1403,T
6-NA,233,1,1,1403,0,1405,G
6-NA,234,0,0,1,1411,1412,C
6-NA,235,1,0,1,1400,1402,C
6-NA,236,1,0,0,1407,1408,C
6-NA,237,0,0,0,1411,1411,C
6-NA,238,1413,0,0,0,1413,A
6-NA,239,1431,0,0,0,1431,A
6-NA,240,1432,1,0,0,1433,A
6-NA,241,0,0,0,1437,1437,C
6-NA,242,1,1429,0,2,1432,T
6-NA,243,1425,0,0,1,1426,A
6-NA,244,1,1,1430,0,1432,G
6-NA,245,0,0,0,1432,1432,C
6-NA,246,1433,0,1,0,1434,A
6-NA,247,1,0,1450,0,1451,G
6-NA,248,1438,1,1,0,1440,A
6-NA,249,1477,0,0,0,1477,A
6-NA,250,0,1479,0,0,1479,T
6-NA,251,1483,0,1,0,1484,A
6-NA,252,0,0,0,1478,1478,C
6-NA,253,1476,0,1,0,1477,A
6-NA,254,0,1,1481,0,1482,G
6-NA,255,1479,1,0,0,1480,A
6-NA,256,1466,1,1,0,1468,A
6-NA,257,1469,1,0,0,1470,A
6-NA,258,0,1446,0,0,1446,T
6-NA,259,0,1442,0,0,1442,T
6-NA,260,0,0,1454,0,1454,G
6-NA,261,1,0,1448,0,1449,G
6-NA,262,0,1447,0,3,1450,T
6-NA,263,0,0,0,1454,1454,C
6-NA,264,1450,0,0,0,1450,A
6-NA,265,1455,0,0,0,1455,A
6-NA,266,1444,1,2,0,1447,A
6-NA,267,0,0,1448,0,1448,G
6-NA,268,0,2,0,1451,1453,C
6-NA,269,3,0,0,1448,1451,C
6-NA,270,1,0,1453,0,1454,G
6-NA,271,2,0,0,1455,1457,C
6-NA,272,1465,0,0,0,1465,A
6-NA,273,1487,0,1,0,1488,A
6-NA,274,0,1480,0,0,1480,T
6-NA,275,0,0,1490,0,1490,G
6-NA,276,0,1478,0,1,1479,T
6-NA,277,0,1,1479,0,1480,G
6-NA,278,1513,0,2,0,1515,A
6-NA,279,0,1,0,1539,1540,C
6-NA,280,1566,1,1,0,1568,A
6-NA,281,0,1572,0,0,1572,T
6-NA,282,0,1567,0,0,1567,T
6-NA,283,1572,0,0,0,1572,A
6-NA,284,0,2,0,1562,1564,C
6-NA,285,1556,0,1,0,1557,A
6-NA,286,0,2,1557,0,1559,G
6-NA,287,0,0,1546,0,1546,G
6-NA,288,0,0,1506,0,1506,G
6-NA,289,0,1550,0,1,1551,T
6-NA,290,1,1549,0,0,1550,T
6-NA,291,1,1552,0,0,1553,T
6-NA,292,0,1,1552,0,1553,G
6-NA,293,0,1,0,1546,1547,C
6-NA,294,1557,0,1,0,1558,A
6-NA,295,0,0,0,1555,1555,C
6-NA,296,0,0,0,1543,1543,C
6-NA,297,1,1525,1,4,1531,T
6-NA,298,0,1533,0,1,1534,T
6-NA,299,0,1537,1,2,1540,T
6-NA,300,0,1544,0,0,1544,T
6-NA,301,0,1575,0,0,1575,T
6-NA,302,2,1,0,1580,1583,C
6-NA,303,0,1579,0,2,1581,T
6-NA,304,1576,0,0,0,1576,A
6-NA,305,1568,0,2,0,1570,A
6-NA,306,1,1,1577,0,1579,G
6-NA,307,1,1,1574,1,1577,G
6-NA,308,1575,0,2,0,1577,A
6-NA,309,0,0,0,1580,1580,C
6-NA,310,1568,0,1,0,1569,A
6-NA,311,1571,0,0,0,1571,A
6-NA,312,0,1567,0,1,1568,T
6-NA,313,0,1569,0,0,1569,T
6-NA,314,1,0,0,1586,1587,C
6-NA,315,1,1,1581,0,1583,G
6-NA,316,1583,0,0,0,1583,A
6-NA,317,1,1579,1,0,1581,T
6-NA,318,0,1577,0,1,1578,T
6-NA,319,1573,1,1,0,1575,A
6-NA,320,1,2,1580,0,1583,G
6-NA,321,2,0,1580,0,1582,G
6-NA,322,0,1,0,1586,1587,C
6-NA,323,0,1558,1,2,1561,T
6-NA,324,0,1565,0,1,1566,T
6-NA,325,0,1568,0,0,1568,T
6-NA,326,0,1,0,1573,1574,C
6-NA,327,0,0,0,1575,1575,C
6-NA,328,1,0,1570,0,1571,G
6-NA,329,0,0,0,1582,1582,C
6-NA,330,0,1575,0,2,1577,T
6-NA,331,0,0,1604,0,1604,G
6-NA,332,0,0,1604,0,1604,G
6-NA,333,0,1602,0,1,1603,T
6-NA,334,3,0,1603,0,1606,G
6-NA,335,0,3,1602,0,1605,G
6-NA,336,1,2,1609,1,1613,G
6-NA,337,0,0,1619,0,1619,G
6-NA,338,1618,0,1,0,1619,A
6-NA,339,0,0,0,1629,1629,C
6-NA,340,1614,0,0,1,1615,A
6-NA,341,0,1606,0,0,1606,T
6-NA,342,2,0,0,1611,1613,C
6-NA,343,0,1611,0,0,1611,T
6-NA,344,2,0,1614,0,1616,G
6-NA,345,0,0,1617,0,1617,G
6-NA,346,1,0,1629,0,1630,G
6-NA,347,0,1625,1,1,1627,T
6-NA,348,0,3,1611,0,1614,G
6-NA,349,1609,1,1,0,1611,A
6-NA,350,0,1,0,1637,1638,C
6-NA,351,1636,1,0,0,1637,A
6-NA,352,1642,0,0,0,1642,A
6-NA,353,0,0,1644,0,1644,G
6-NA,354,1640,0,2,0,1642,A
6-NA,355,0,0,1653,0,1653,G
6-NA,356,1656,1,0,0,1657,A
6-NA,357,1693,0,1,0,1694,A
6-NA,358,1,0,0,1817,1818,C
6-NA,359,2,0,0,1849,1851,C
6-NA,360,0,1850,1,0,1851,T
6-NA,361,1,1848,0,0,1849,T
6-NA,362,1855,0,0,0,1855,A
6-NA,363,1,1851,0,1,1853,T
6-NA,364,0,0,1885,0,1885,G
6-NA,365,1,1874,0,2,1877,T
6-NA,366,1,1,1879,0,1881,G
6-NA,367,1,1848,0,2,1851,T
6-NA,368,3,0,0,1828,1831,C
6-NA,369,1834,0,3,2,1839,A
6-NA,370,0,1841,0,1,1842,T
6-NA,371,0,0,1837,0,1837,G
6-NA,372,0,1,0,1837,1838,C
6-NA,373,0,1,1830,0,1831,G
6-NA,374,1918,0,1,0,1919,A
6-NA,375,0,1935,0,1,1936,T
6-NA,376,1,0,0,1947,1948,C
6-NA,377,1,0,1,1948,1950,C
6-NA,378,0,1936,2,6,1944,T
6-NA,379,0,2,1960,0,1962,G
6-NA,380,1961,1,3,0,1965,A
6-NA,381,1,0,0,1961,1962,C
6-NA,382,1962,0,0,0,1962,A
6-NA,383,1921,0,0,0,1921,A
6-NA,384,0,0,1991,0,1991,G
6-NA,385,1,1975,0,0,1976,T
6-NA,386,1,0,1990,0,1991,G
6-NA,387,0,1969,0,1,1970,T
6-NA,388,0,1969,0,0,1969,T
6-NA,389,1969,0,1,1,1971,A
6-NA,390,1,1966,0,0,1967,T
6-NA,391,0,2,0,1983,1985,C
6-NA,392,1977,0,0,0,1977,A
6-NA,393,1965,0,1,0,1966,A
6-NA,394,0,1962,1,1,1964,T
6-NA,395,0,1956,1,0,1957,T
6-NA,396,0,1959,0,1,1960,T
6-NA,397,0,3,1959,0,1962,G
6-NA,398,0,1,0,2019,2020,C
6-NA,399,1,1,1,2011,2014,C
6-NA,400,1,1,0,2012,2014,C
6-NA,401,0,2010,0,5,2015,T
6-NA,402,1,2011,1,0,2013,T
6-NA,403,1,0,2036,0,2037,G
6-NA,404,2,1,2036,0,2039,G
6-NA,405,2043,0,3,0,2046,A
6-NA,406,0,2,0,2051,2053,C
6-NA,407,1999,1,1,0,2001,A
6-NA,408,0,3,2032,0,2035,G
6-NA,409,0,0,2033,0,2033,G
6-NA,410,2,2,2075,0,2079,G
6-NA,411,2093,0,2,0,2095,A
6-NA,412,2078,0,2,0,2080,A
6-NA,413,0,1,0,2081,2082,C
6-NA,414,1970,0,3,0,1973,A
6-NA,415,2128,0,3,0,2131,A
6-NA,416,1,0,0,2140,2141,C
6-NA,417,2114,1,0,0,2115,A
6-NA,418,0,0,0,2129,2129,C
6-NA,419,0,2078,1,0,2079,T
6-NA,420,2096,1,0,0,2097,A
6-NA,421,2086,0,2,0,2088,A
6-NA,422,2098,0,2,0,2100,A
6-NA,423,0,0,0,2104,2104,C
6-NA,424,1975,0,1,0,1976,A
6-NA,425,1983,0,3,1,1987,A
6-NA,426,0,1,0,1979,1980,C
6-NA,427,1,0,1960,0,1961,G
6-NA,428,0,1955,0,0,1955,T
6-NA,429,1937,0,1,0,1938,A
6-NA,430,0,0,0,1958,1958,C
6-NA,431,1961,0,0,0,1961,A
6-NA,432,0,1964,0,3,1967,T
6-NA,433,0,1964,0,1,1965,T
6-NA,434,1,0,0,2025,2026,C
6-NA,435,2076,1,0,0,2077,A
6-NA,436,2091,1,0,0,2092,A
6-NA,437,2092,0,1,0,2093,A
6-NA,438,0,2092,1,0,2093,T
6-NA,439,2063,0,1,0,2064,A
6-NA,440,2122,0,1,0,2123,A
6-NA,441,0,0,1,2130,2131,C
6-NA,442,2124,0,5,1,2130,A
6-NA,443,0,2,0,2151,2153,C
6-NA,444,2084,0,0,0,2084,A
6-NA,445,1,0,2378,0,2379,G
6-NA,446,0,2370,0,0,2370,T
6-NA,447,2390,0,3,0,2393,A
6-NA,448,0,0,0,2405,2405,C
6-NA,449,3,0,2384,0,2387,G
6-NA,450,0,2472,0,3,2475,T
6-NA,451,0,1,2475,0,2476,G
6-NA,452,2472,0,2,0,2474,A
6-NA,453,1,2477,0,3,2481,T
6-NA,454,2317,2,1,0,2320,A
6-NA,455,1,1,2318,0,2320,G
6-NA,456,2,1,2309,0,2312,G
6-NA,457,2319,1,1,0,2321,A
6-NA,458,1,1,0,2350,2352,C
6-NA,459,3,1,0,2312,2316,C
6-NA,460,3,2,0,2330,2335,C
6-NA,461,1,3,0,2338,2342,C
6-NA,462,0,2349,0,1,2350,T
6-NA,463,0,2380,0,2,2382,T
6-NA,464,2389,1,1,0,2391,A
6-NA,465,0,2387,1,1,2389,T
6-NA,466,0,1,1,2388,2390,C
6-NA,467,1,0,2368,0,2369,G
6-NA,468,0,3,2370,0,2373,G
6-NA,469,2361,2,6,0,2369,A
6-NA,470,1,0,0,2374,2375,C
6-NA,471,3,0,0,2368,2371,C
6-NA,472,2,0,0,2485,2487,C
6-NA,473,0,2482,0,4,2486,T
6-NA,474,2515,1,1,0,2517,A
6-NA,475,0,2516,0,1,2517,T
6-NA,476,1,2517,0,2,2520,T
6-NA,477,0,1,2518,0,2519,G
6-NA,478,2514,0,2,0,2516,A
6-NA,479,0,2509,0,1,2510,T
6-NA,480,1,1,2511,0,2513,G
6-NA,481,2440,0,2,0,2442,A
6-NA,482,2450,0,0,0,2450,A
6-NA,483,0,2439,1,0,2440,T
6-NA,484,0,2,2474,0,2476,G
6-NA,485,2503,0,1,1,2505,A
6-NA,486,2,0,2524,0,2526,G
6-NA,487,0,2518,0,3,2521,T
6-NA,488,1,2514,0,3,2518,T
6-NA,489,2520,0,1,0,2521,A
6-NA,490,1,0,2524,0,2525,G
6-NA,491,1,1,2530,0,2532,G
6-NA,492,1,2533,0,2,2536,T
6-NA,493,0,0,2530,0,2530,G
6-NA,494,0,2504,0,3,2507,T
6-NA,495,0,2491,0,6,2497,T
6-NA,496,2,1,0,2521,2524,C
6-NA,497,1,1,0,2539,2541,C
6-NA,498,0,2531,0,2,2533,T
6-NA,499,0,2529,0,4,2533,T
6-NA,500,1,2527,0,1,2529,T
6-NA,501,0,2532,1,3,2536,T
6-NA,502,1,0,0,2543,2544,C
6-NA,503,2540,0,1,0,2541,A
6-NA,504,0,2588,0,4,2592,T
6-NA,505,2,1,0,2583,2586,C
6-NA,506,0,2567,0,3,2570,T
6-NA,507,0,3,2566,0,2569,G
6-NA,508,2,4,2550,1,2557,G
6-NA,509,2,1,2556,0,2559,G
6-NA,510,0,1,2590,0,2591,G
6-NA,511,2576,1,2,0,2579,A
6-NA,512,0,1,0,2586,2587,C
6-NA,513,1,1,0,2533,2535,C
6-NA,514,2572,1,1,0,2574,A
6-NA,515,2575,0,1,0,2576,A
6-NA,516,0,0,2574,1,2575,G
6-NA,517,0,2,0,2575,2577,C
6-NA,518,2568,2,2,0,2572,A
6-NA,519,2586,0,4,0,2590,A
6-NA,520,0,0,2598,0,2598,G
6-NA,521,0,2581,0,2,2583,T
6-NA,522,0,2,2644,0,2646,G
6-NA,523,1,2623,0,1,2625,T
6-NA,524,0,1,2699,0,2700,G
6-NA,525,0,3,0,2694,2697,C
6-NA,526,2694,0,0,0,2694,A
6-NA,527,0,2706,0,1,2707,T
6-NA,528,2664,1,0,0,2665,A
6-NA,529,0,0,2738,0,2738,G
6-NA,530,0,2,0,2730,2732,C
6-NA,531,2682,0,1,1,2684,A
6-NA,532,0,2672,0,5,2677,T
6-NA,533,0,0,2628,0,2628,G
6-NA,534,0,0,2793,0,2793,G
6-NA,535,2,2785,0,6,2793,T
6-NA,536,1,0,0,2776,2777,C
6-NA,537,1,1,0,2793,2795,C
6-NA,538,2757,0,0,0,2757,A
6-NA,539,1,0,2810,0,2811,G
6-NA,540,0,0,0,2818,2818,C
6-NA,541,1,2810,0,5,2816,T
6-NA,542,2,1,0,2813,2816,C
6-NA,543,2772,2,0,0,2774,A
6-NA,544,2796,0,0,0,2796,A
6-NA,545,0,0,2801,0,2801,G
6-NA,546,1,2869,1,0,2871,T
6-NA,547,0,2856,0,1,2857,T
6-NA,548,2,0,2854,1,2857,G
6-NA,549,1,2851,0,3,2855,T
6-NA,550,2,3,0,2844,2849,C
6-NA,551,2853,1,1,0,2855,A
6-NA,552,2,2,1,2870,2875,C
6-NA,553,3,2,2856,1,2862,G
6-NA,554,2887,0,0,0,2887,A
6-NA,555,1,2887,1,5,2894,T
6-NA,556,4,2,2924,0,2930,G
6-NA,557,2,4,2942,0,2948,G
6-NA,558,2944,0,3,0,2947,A
6-NA,559,2943,0,1,0,2944,A
6-NA,560,2968,0,3,0,2971,A
6-NA,561,2961,1,3,0,2965,A
6-NA,562,0,0,2990,0,2990,G
6-NA,563,0,2,0,2976,2978,C
6-NA,564,2973,0,3,1,2977,A
6-NA,565,1,2968,0,2,2971,T
6-NA,566,1,0,2984,0,2985,G
6-NA,567,0,0,3000,0,3000,G
6-NA,568,2,1,0,3010,3013,C
6-NA,569,0,3002,0,3,3005,T
6-NA,570,0,1,3011,0,3012,G
6-NA,571,0,2,0,2993,2995,C
6-NA,572,3002,0,4,0,3006,A
6-NA,573,0,3082,0,1,3083,T
6-NA,574,2,0,3082,0,3084,G
6-NA,575,0,3081,0,1,3082,T
6-NA,576,0,3101,0,4,3105,T
6-NA,577,1,3099,0,2,3102,T
6-NA,578,0,2,3183,0,3185,G
6-NA,579,0,3187,0,4,3191,T
6-NA,580,3195,1,1,0,3197,A
6-NA,581,0,3201,0,3,3204,T
6-NA,582,3153,0,1,0,3154,A
6-NA,583,3159,0,5,0,3164,A
6-NA,584,0,1,0,3153,3154,C
6-NA,585,1,1,3133,0,3135,G
6-NA,586,1,1,3130,0,3132,G
6-NA,587,0,2,3111,0,3113,G
6-NA,588,3075,0,4,0,3079,A
6-NA,589,0,0,3108,0,3108,G
6-NA,590,3103,0,7,1,3111,A
6-NA,591,0,3123,0,0,3123,T
6-NA,592,0,2,3135,0,3137,G
6-NA,593,3136,1,2,0,3139,A
6-NA,594,1,3147,0,0,3148,T
6-NA,595,3137,1,0,1,3139,A
6-NA,596,3242,0,0,0,3242,A
6-NA,597,3246,1,1,0,3248,A
6-NA,598,3248,0,2,0,3250,A
6-NA,599,3257,1,1,1,3260,A
6-NA,600,0,3248,0,0,3248,T
6-NA,601,1,0,3250,2,3253,G
6-NA,602,1,3,0,3252,3256,C
6-NA,603,3250,0,3,0,3253,A
6-NA,604,3252,2,3,0,3257,A
6-NA,605,0,1,0,3291,3292,C
6-NA,606,0,3283,0,1,3284,T
6-NA,607,0,0,3292,0,3292,G
6-NA,608,1,0,0,3292,3293,C
6-NA,609,1,3297,0,0,3298,T
6-NA,610,3300,0,2,0,3302,A
6-NA,611,0,1,3303,0,3304,G
6-NA,612,0,1,0,3325,3326,C
6-NA,613,1,3319,0,3,3323,T
6-NA,614,2,3307,3,2,3314,T
6-NA,615,3,0,0,3327,3330,C
6-NA,616,3338,0,2,0,3340,A
6-NA,617,1,3341,0,0,3342,T
6-NA,618,1,3336,0,1,3338,T
6-NA,619,0,3350,0,0,3350,T
6-NA,620,3357,2,3,0,3362,A
6-NA,621,0,1,0,3397,3398,C
6-NA,622,3374,0,1,0,3375,A
6-NA,623,3388,1,2,0,3391,A
6-NA,624,0,3387,0,2,3389,T
6-NA,625,1,3,3369,0,3373,G
6-NA,626,1,2,3366,0,3369,G
6-NA,627,0,1,3374,0,3375,G
6-NA,628,3357,1,3,0,3361,A
6-NA,629,1,0,3409,0,3410,G
6-NA,630,1,1,3429,0,3431,G
6-NA,631,2,1,1,3608,3612,C
6-NA,632,0,3609,1,2,3612,T
6-NA,633,0,3629,1,1,3631,T
6-NA,634,2,0,3659,0,3661,G
6-NA,635,1,3658,0,3,3662,T
6-NA,636,3716,0,2,0,3718,A
6-NA,637,2,1,3729,0,3732,G
6-NA,638,3675,0,4,0,3679,A
6-NA,639,0,3691,0,1,3692,T
6-NA,640,3470,1,2,1,3474,A
6-NA,641,1,2,3479,0,3482,G
6-NA,642,1,3388,0,1,3390,T
6-NA,643,2,0,3327,0,3329,G
6-NA,644,0,3443,0,2,3445,T
6-NA,645,1,3436,0,2,3439,T
6-NA,646,5,0,3472,0,3477,G
6-NA,647,2,3464,0,5,3471,T
6-NA,648,0,3473,0,1,3474,T
6-NA,649,0,3470,0,10,3480,T
6-NA,650,3,1,0,3429,3433,C
6-NA,651,3421,0,3,6,3430,A
6-NA,652,0,3424,0,1,3425,T
6-NA,653,0,2,3424,0,3426,G
6-NA,654,0,0,3577,0,3577,G
6-NA,655,0,3482,0,3,3485,T
6-NA,656,4,0,0,3446,3450,C
6-NA,657,5,0,0,3443,3448,C
6-NA,658,3463,1,2,1,3467,A
6-NA,659,3485,0,2,0,3487,A
6-NA,660,3491,0,1,1,3493,A
6-NA,661,2,0,3503,0,3505,G
6-NA,662,3503,0,0,0,3503,A
6-NA,663,3406,0,1,0,3407,A
6-NA,664,3398,1,2,0,3401,A
6-NA,665,2,3408,0,0,3410,T
6-NA,666,3,1,0,3486,3490,C
6-NA,667,0,1,1,3476,3478,C
6-NA,668,0,3477,0,2,3479,T
6-NA,669,0,0,1,3482,3483,C
6-NA,670,3465,3,7,2,3477,A
6-NA,671,1,0,3489,0,3490,G
6-NA,672,0,2,3487,0,3489,G
6-NA,673,3549,1,4,0,3554,A
6-NA,674,0,1,0,3550,3551,C
6-NA,675,1,1,2,3499,3503,C
6-NA,676,0,0,0,3509,3509,C
6-NA,677,3514,1,1,0,3516,A
6-NA,678,0,1,3522,0,3523,G
6-NA,679,4,0,3521,0,3525,G
6-NA,680,3503,3,4,0,3510,A
6-NA,681,0,0,3546,0,3546,G
6-NA,682,0,3493,0,3,3496,T
6-NA,683,6,1,1,3497,3505,C
6-NA,684,3489,2,5,1,3497,A
6-NA,685,1,1,3514,0,3516,G
6-NA,686,3508,0,1,0,3509,A
6-NA,687,3510,2,1,0,3513,A
6-NA,688,0,3515,1,1,3517,T
6-NA,689,1,0,3523,0,3524,G
6-NA,690,0,1,0,3510,3511,C
6-NA,691,1,0,3540,0,3541,G
6-NA,692,2,3523,1,1,3527,T
6-NA,693,1,3531,1,1,3534,T
6-NA,694,0,3522,0,0,3522,T
6-NA,695,2,0,3546,1,3549,G
6-NA,696,2,3560,0,4,3566,T
6-NA,697,3565,0,1,0,3566,A
6-NA,698,2,3554,0,2,3558,T
6-NA,699,2,1,0,3570,3573,C
6-NA,700,3553,0,1,0,3554,A
6-NA,701,3556,0,0,0,3556,A
6-NA,702,2,3544,1,1,3548,T
6-NA,703,1,3,3544,1,3549,G
6-NA,704,0,1,3553,0,3554,G
6-NA,705,3603,0,2,0,3605,A
6-NA,706,3604,1,3,0,3608,A
6-NA,707,0,0,0,3628,3628,C
6-NA,708,0,3638,0,5,3643,T
6-NA,709,1,3648,0,1,3650,T
6-NA,710,1,0,3741,0,3742,G
6-NA,711,0,3748,0,0,3748,T
6-NA,712,3738,0,6,1,3745,A
6-NA,713,0,2,0,3792,3794,C
6-NA,714,3679,1,3,1,3684,A
6-NA,715,0,0,3891,0,3891,G
6-NA,716,2,3864,0,0,3866,T
6-NA,717,4026,0,2,0,4028,A
6-NA,718,3,0,4055,0,4058,G
6-NA,719,1,3983,0,0,3984,T
6-NA,720,3979,3,0,0,3982,A
6-NA,721,3978,1,1,0,3980,A
6-NA,722,1,3966,0,1,3968,T
6-NA,723,0,5,3972,1,3978,G
6-NA,724,3873,0,2,0,3875,A
6-NA,725,0,2,0,3893,3895,C
6-NA,726,1,3783,0,2,3786,T
6-NA,727,2,0,3801,0,3803,G
6-NA,728,3796,0,2,0,3798,A
6-NA,729,0,3803,0,3,3806,T
6-NA,730,0,2,3804,0,3806,G
6-NA,731,2,1,3776,0,3779,G
6-NA,732,3,1,3780,0,3784,G
6-NA,733,3736,1,4,2,3743,A
6-NA,734,1,0,3742,0,3743,G
6-NA,735,1,3718,0,1,3720,T
6-NA,736,1,2,3733,0,3736,G
6-NA,737,1,0,0,3756,3757,C
6-NA,738,0,3741,0,4,3745,T
6-NA,739,0,3744,0,2,3746,T
6-NA,740,0,0,0,3750,3750,C
6-NA,741,3744,0,6,0,3750,A
6-NA,742,1,1,3771,0,3773,G
6-NA,743,0,1,3773,0,3774,G
6-NA,744,3766,1,3,0,3770,A
6-NA,745,3738,0,4,0,3742,A
6-NA,746,3719,0,2,1,3722,A
6-NA,747,3727,2,4,0,3733,A
6-NA,748,1,0,3753,0,3754,G
6-NA,749,1,1,2,3751,3755,C
6-NA,750,0,3737,1,1,3739,T
6-NA,751,0,0,3741,0,3741,G
6-NA,752,3726,0,4,0,3730,A
6-NA,753,2,3755,0,1,3758,T
6-NA,754,3758,0,3,0,3761,A
6-NA,755,3,1,0,3923,3927,C
6-NA,756,1,3899,1,0,3901,T
6-NA,757,3899,0,1,0,3900,A
6-NA,758,3891,0,0,1,3892,A
6-NA,759,3894,0,1,0,3895,A
6-NA,760,3972,3,0,0,3975,A
6-NA,761,0,3971,0,1,3972,T
6-NA,762,3978,2,2,0,3982,A
6-NA,763,0,1,0,3990,3991,C
6-NA,764,0,3822,0,3,3825,T
6-NA,765,3869,1,3,0,3873,A
6-NA,766,0,3849,0,6,3855,T
6-NA,767,0,3986,1,3,3990,T
6-NA,768,5,2,0,4015,4022,C
6-NA,769,3931,0,1,3,3935,A
6-NA,770,0,3940,0,3,3943,T
6-NA,771,0,3926,1,4,3931,T
6-NA,772,1,1,3944,0,3946,G
6-NA,773,3906,1,6,0,3913,A
6-NA,774,2,0,3914,0,3916,G
6-NA,775,0,4,3898,0,3902,G
6-NA,776,3742,1,5,1,3749,A
6-NA,777,0,2,3811,0,3813,G
6-NA,778,2,3,3801,0,3806,G
6-NA,779,1,3,3810,0,3814,G
6-NA,780,1,2,3820,1,3824,G
6-NA,781,3804,1,5,0,3810,A
6-NA,782,3813,1,1,0,3815,A
6-NA,783,3808,1,3,0,3812,A
6-NA,784,3823,1,1,0,3825,A
6-NA,785,0,3825,0,0,3825,T
6-NA,786,5,1,0,3766,3772,C
6-NA,787,5,0,3788,0,3793,G
6-NA,788,1,3779,0,0,3780,T
6-NA,789,0,3772,0,0,3772,T
6-NA,790,3,0,0,3774,3777,C
6-NA,791,3767,1,2,0,3770,A
6-NA,792,0,3969,0,2,3971,T
6-NA,793,3961,0,2,1,3964,A
6-NA,794,0,0,0,3969,3969,C
6-NA,795,0,3950,0,4,3954,T
6-NA,796,3947,0,1,0,3948,A
6-NA,797,0,1,3940,0,3941,G
6-NA,798,0,3,0,3935,3938,C
6-NA,799,3943,2,1,0,3946,A
6-NA,800,0,4,0,3952,3956,C
6-NA,801,3777,0,1,1,3779,A
6-NA,802,0,4453,0,0,4453,T
6-NA,803,0,4432,0,0,4432,T
6-NA,804,1,0,4634,0,4635,G
6-NA,805,1,4616,0,7,4624,T
6-NA,806,4,6,0,4605,4615,C
6-NA,807,4606,0,9,0,4615,A
6-NA,808,3,2,4622,0,4627,G
6-NA,809,0,2,4632,0,4634,G
6-NA,810,4630,2,0,0,4632,A
6-NA,811,4564,1,2,0,4567,A
6-NA,812,1,1,4594,0,4596,G
6-NA,813,1,4377,0,2,4380,T
6-NA,814,1,0,4412,0,4413,G
6-NA,815,0,1,0,4403,4404,C
6-NA,816,0,4388,0,9,4397,T
6-NA,817,0,1,1,4403,4405,C
6-NA,818,4380,0,1,0,4381,A
6-NA,819,2,0,4394,0,4396,G
6-NA,820,0,1,2,4382,4385,C
6-NA,821,4366,0,4,0,4370,A
6-NA,822,0,4369,1,1,4371,T
6-NA,823,2,0,4421,1,4424,G
6-NA,824,0,4427,1,1,4429,T
6-NA,825,6,1,1,4414,4422,C
6-NA,826,0,0,4434,0,4434,G
6-NA,827,4414,1,4,0,4419,A
6-NA,828,2,1,4408,0,4411,G
6-NA,829,0,2,4402,2,4406,G
6-NA,830,4403,0,0,0,4403,A
6-NA,831,4298,1,5,0,4304,A
6-NA,832,0,4343,0,0,4343,T
6-NA,833,0,2,4354,0,4356,G
6-NA,834,3,2,0,4395,4400,C
6-NA,835,0,4364,1,9,4374,T
6-NA,836,3,4,1,4382,4390,C
6-NA,837,1,0,0,4400,4401,C
6-NA,838,0,4390,1,2,4393,T
6-NA,839,2,1,4404,0,4407,G
6-NA,840,0,3,1,4393,4397,C
6-NA,841,1,4385,0,1,4387,T
6-NA,842,4405,1,3,0,4409,A
6-NA,843,3,4351,0,0,4354,T
6-NA,844,1,1,0,4368,4370,C
6-NA,845,1,0,0,4327,4328,C
6-NA,846,0,4339,1,4,4344,T
6-NA,847,1,2,0,4345,4348,C
6-NA,848,1,0,4343,0,4344,G
6-NA,849,4373,0,2,0,4375,A
6-NA,850,0,4362,0,7,4369,T
6-NA,851,4363,1,0,0,4364,A
6-NA,852,2,4356,0,1,4359,T
6-NA,853,3,2,5,4327,4337,C
6-NA,854,3,1,0,4323,4327,C
6-NA,855,1,4282,1,4,4288,T
6-NA,856,3,1,4282,1,4287,G
6-NA,857,0,0,4311,0,4311,G
6-NA,858,0,4326,1,3,4330,T
6-NA,859,1,1,4332,0,4334,G
6-NA,860,0,4310,0,3,4313,T
6-NA,861,2,0,0,4308,4310,C
6-NA,862,4306,0,1,0,4307,A
6-NA,863,0,2,4302,0,4304,G
6-NA,864,4289,7,3,0,4299,A
6-NA,865,2,4256,0,0,4258,T
6-NA,866,0,0,4260,0,4260,G
6-NA,867,0,4175,0,0,4175,T
6-NA,868,0,1,4168,6,4175,G
6-NA,869,0,4168,0,4,4172,T
6-NA,870,2,0,0,4175,4177,C
6-NA,871,1,4162,0,8,4171,T
6-NA,872,2,0,4172,0,4174,G
6-NA,873,1,1,0,4171,4173,C
6-NA,874,4170,2,2,0,4174,A
6-NA,875,2,1,4170,1,4174,G
6-NA,876,4107,1,4,0,4112,A
6-NA,877,0,3,4107,4,4114,G
6-NA,878,4108,0,2,1,4111,A
6-NA,879,3,3,0,4129,4135,C
6-NA,880,4132,0,3,0,4135,A
6-NA,881,4137,3,3,0,4143,A
6-NA,882,2,1,0,4231,4234,C
6-NA,883,0,4227,0,4,4231,T
6-NA,884,1,0,4239,0,4240,G
6-NA,885,1,1,4229,2,4233,G
6-NA,886,4206,0,6,1,4213,A
6-NA,887,4207,1,1,0,4209,A
6-NA,888,4138,0,8,1,4147,A
6-NA,889,0,2,4145,1,4148,G
6-NA,890,0,4,4089,0,4093,G
6-NA,891,3949,1,8,0,3958,A
6-NA,892,1,4023,0,2,4026,T
6-NA,893,2,3,0,4029,4034,C
6-NA,894,3,4,0,4081,4088,C
6-NA,895,4093,0,2,0,4095,A
6-NA,896,4097,1,2,0,4100,A
6-NA,897,0,4098,0,0,4098,T
6-NA,898,4000,1,3,0,4004,A
6-NA,899,1,2,3981,0,3984,G
6-NA,900,1,2,3977,0,3980,G
6-NA,901,3,2,0,3978,3983,C
6-NA,902,0,0,0,3973,3973,C
6-NA,903,3,2,1,3862,3868,C
6-NA,904,3882,1,2,0,3885,A
6-NA,905,2,3899,0,2,3903,T
6-NA,906,3,2,0,3897,3902,C
6-NA,907,1,0,3908,0,3909,G
6-NA,908,2,3886,0,1,3889,T
6-NA,909,3832,0,2,0,3834,A
6-NA,910,1,3,3878,0,3882,G
6-NA,911,3877,1,5,0,3883,A
6-NA,912,0,3895,0,1,3896,T
6-NA,913,3841,1,3,0,3845,A
6-NA,914,1,3803,0,1,3805,T
6-NA,915,3794,0,1,0,3795,A
6-NA,916,3784,1,1,0,3786,A
6-NA,917,3840,1,1,0,3842,A
6-NA,918,1,1,1,3881,3884,C
6-NA,919,3771,0,1,0,3772,A
6-NA,920,1,3756,0,0,3757,T
6-NA,921,3721,0,2,0,3723,A
6-NA,922,3718,1,0,0,3719,A
6-NA,923,3709,1,4,1,3715,A
6-NA,924,1,2,3745,0,3748,G
6-NA,925,0,2,3785,0,3787,G
6-NA,926,3664,1,6,0,3671,A
6-NA,927,2,3640,0,2,3644,T
6-NA,928,2,0,0,3652,3654,C
6-NA,929,3670,0,2,0,3672,A
6-NA,930,1,3667,1,7,3676,T
6-NA,931,3661,0,5,0,3666,A
6-NA,932,1,2,3692,0,3695,G
6-NA,933,3,0,0,3640,3643,C
6-NA,934,3555,0,2,1,3558,A
6-NA,935,1,3375,1,4,3381,T
6-NA,936,0,3392,1,1,3394,T
6-NA,937,1,1,3387,0,3389,G
6-NA,938,0,3388,0,2,3390,T
6-NA,939,2,4,0,3336,3342,C
6-NA,940,1,3497,1,4,3503,T
6-NA,941,1,0,0,3532,3533,C
6-NA,942,1,1,0,3550,3552,C
6-NA,943,3597,0,2,0,3599,A
6-NA,944,0,0,3642,0,3642,G
6-NA,945,1,3637,0,3,3641,T
6-NA,946,0,3498,1,0,3499,T
6-NA,947,3496,1,1,0,3498,A
6-NA,948,0,3392,0,1,3393,T
6-NA,949,0,1,3397,0,3398,G
6-NA,950,0,3282,1,2,3285,T
6-NA,951,1,0,3293,0,3294,G
6-NA,952,1,3181,0,1,3183,T
6-NA,953,1,1,3197,1,3200,G
6-NA,954,0,3191,0,2,3193,T
6-NA,955,0,3181,0,1,3182,T
6-NA,956,4,1,0,3182,3187,C
6-NA,957,3161,1,3,0,3165,A
6-NA,958,0,0,3172,0,3172,G
6-NA,959,0,4,3163,0,3167,G
6-NA,960,3127,0,4,0,3131,A
6-NA,961,0,0,0,3140,3140,C
6-NA,962,1,3033,0,1,3035,T
6-NA,963,0,3040,0,0,3040,T
6-NA,964,1,0,3102,0,3103,G
6-NA,965,0,3097,1,0,3098,T
6-NA,966,0,3096,0,3,3099,T
6-NA,967,0,1,3062,0,3063,G
6-NA,968,1,1,3046,0,3048,G
6-NA,969,3050,1,7,1,3059,A
6-NA,970,0,1,3060,1,3062,G
6-NA,971,3052,0,2,0,3054,A
6-NA,972,0,1,0,3055,3056,C
6-NA,973,3009,0,4,1,3014,A
6-NA,974,1,0,0,3020,3021,C
6-NA,975,3005,1,4,3,3013,A
6-NA,976,1,1,0,3014,3016,C
6-NA,977,2,0,0,3001,3003,C
6-NA,978,1,0,0,3009,3010,C
6-NA,979,3005,1,0,1,3007,A
6-NA,980,1,0,3012,0,3013,G
6-NA,981,3003,0,1,1,3005,A
6-NA,982,3012,0,1,1,3014,A
6-NA,983,3005,2,2,1,3010,A
6-NA,984,3007,0,2,1,3010,A
6-NA,985,2998,1,4,1,3004,A
6-NA,986,3003,0,1,1,3005,A
6-NA,987,0,0,0,3009,3009,C
6-NA,988,2,3,2999,0,3004,G
6-NA,989,2994,2,2,0,2998,A
6-NA,990,0,2,0,2998,3000,C
6-NA,991,2985,0,1,0,2986,A
6-NA,992,1,0,3000,1,3002,G
6-NA,993,0,1,0,3110,3111,C
6-NA,994,0,3100,0,4,3104,T
6-NA,995,1,0,0,3112,3113,C
6-NA,996,1,1,0,3118,3120,C
6-NA,997,3113,0,6,1,3120,A
6-NA,998,1,0,3130,0,3131,G
6-NA,999,1,2,0,3118,3121,C
6-NA,1000,3110,3,0,0,3113,A
6-NA,1001,1,0,3122,0,3123,G
6-NA,1002,0,2947,0,0,2947,T
6-NA,1003,1,0,2936,0,2937,G
6-NA,1004,0,2,2954,0,2956,G
6-NA,1005,1,0,0,2961,2962,C
6-NA,1006,5,2,0,2963,2970,C
6-NA,1007,2949,1,0,1,2951,A
6-NA,1008,0,2950,0,0,2950,T
6-NA,1009,0,2937,0,1,2938,T
6-NA,1010,0,0,2983,0,2983,G
6-NA,1011,0,2964,0,2,2966,T
6-NA,1012,0,2960,1,2,2963,T
6-NA,1013,2,2963,0,0,2965,T
6-NA,1014,3,0,2955,0,2958,G
6-NA,1015,0,1,2980,0,2981,G
6-NA,1016,2974,0,3,0,2977,A
6-NA,1017,0,2981,0,2,2983,T
6-NA,1018,1,1,0,2983,2985,C
6-NA,1019,4,1,0,2959,2964,C
6-NA,1020,1,2950,0,7,2958,T
6-NA,1021,2954,0,11,1,2966,A
6-NA,1022,2961,1,3,0,2965,A
6-NA,1023,0,0,0,3006,3006,C
6-NA,1024,2959,1,0,0,2960,A
6-NA,1025,2962,0,0,0,2962,A
6-NA,1026,0,2948,0,1,2949,T
6-NA,1027,0,1,2951,0,2952,G
6-NA,1028,2930,4,0,0,2934,A
6-NA,1029,0,1,2864,0,2865,G
6-NA,1030,2,3,2904,1,2910,G
6-NA,1031,2917,0,1,0,2918,A
6-NA,1032,2913,0,5,0,2918,A
6-NA,1033,0,4,2919,0,2923,G
6-NA,1034,0,0,2930,0,2930,G
6-NA,1035,1,2898,0,3,2902,T
6-NA,1036,1,1,2904,1,2907,G
6-NA,1037,1,1,2948,0,2950,G
6-NA,1038,1,2919,0,3,2923,T
6-NA,1039,3,3,0,2922,2928,C
6-NA,1040,2933,0,0,0,2933,A
6-NA,1041,0,2920,0,0,2920,T
6-NA,1042,0,1,2906,0,2907,G
6-NA,1043,0,1,2892,0,2893,G
6-NA,1044,1,1,2826,0,2828,G
6-NA,1045,1,1,2894,0,2896,G
6-NA,1046,0,2896,0,4,2900,T
6-NA,1047,0,2,2903,0,2905,G
6-NA,1048,2897,0,3,0,2900,A
6-NA,1049,2900,0,3,0,2903,A
6-NA,1050,2907,0,4,0,2911,A
6-NA,1051,0,0,2924,0,2924,G
6-NA,1052,1,1,2904,0,2906,G
6-NA,1053,0,0,0,2893,2893,C
6-NA,1054,1,2820,0,2,2823,T
6-NA,1055,1,1,2821,2,2825,G
6-NA,1056,0,0,2833,0,2833,G
6-NA,1057,0,1,2849,0,2850,G
6-NA,1058,0,1,0,2841,2842,C
6-NA,1059,0,0,0,2840,2840,C
6-NA,1060,0,2801,0,9,2810,T
6-NA,1061,0,2804,1,2,2807,T
6-NA,1062,1,2810,0,0,2811,T
6-NA,1063,1,1,2824,0,2826,G
6-NA,1064,2821,0,0,0,2821,A
6-NA,1065,2,2802,0,0,2804,T
6-NA,1066,0,1,2789,0,2790,G
6-NA,1067,2765,0,4,1,2770,A
6-NA,1068,1,2774,0,1,2776,T
6-NA,1069,0,0,2782,0,2782,G
6-NA,1070,0,1,2810,0,2811,G
6-NA,1071,2807,0,3,0,2810,A
6-NA,1072,2809,0,1,0,2810,A
6-NA,1073,2806,0,1,0,2807,A
6-NA,1074,0,2814,1,0,2815,T
6-NA,1075,1,2,2820,1,2824,G
6-NA,1076,2820,0,3,1,2824,A
6-NA,1077,0,2,1,2812,2815,C
6-NA,1078,1,1,2813,1,2816,G
6-NA,1079,1,2765,0,1,2767,T
6-NA,1080,2,0,2778,0,2780,G
6-NA,1081,0,2777,2,0,2779,T
6-NA,1082,0,0,2778,1,2779,G
6-NA,1083,0,1,2784,0,2785,G
6-NA,1084,2777,2,0,0,2779,A
6-NA,1085,1,2772,0,2,2775,T
6-NA,1086,1,1,2762,0,2764,G
6-NA,1087,1,1,2757,0,2759,G
6-NA,1088,0,0,2762,0,2762,G
6-NA,1089,2754,1,2,0,2757,A
6-NA,1090,2745,0,3,0,2748,A
6-NA,1091,1,0,2748,0,2749,G
6-NA,1092,2719,1,0,0,2720,A
6-NA,1093,2718,0,4,0,2722,A
6-NA,1094,0,0,0,2716,2716,C
6-NA,1095,1,0,2701,0,2702,G
6-NA,1096,2695,0,1,0,2696,A
6-NA,1097,1,2662,1,2,2666,T
6-NA,1098,1,1,0,2670,2672,C
6-NA,1099,2664,0,7,0,2671,A
6-NA,1100,0,0,2676,0,2676,G
6-NA,1101,0,3,0,2662,2665,C
6-NA,1102,0,1,2669,0,2670,G
6-NA,1103,2662,0,6,0,2668,A
6-NA,1104,1,1,2666,0,2668,G
6-NA,1105,2667,0,1,0,2668,A
6-NA,1106,2667,2,1,0,2670,A
6-NA,1107,1,0,2664,0,2665,G
6-NA,1108,0,2650,1,2,2653,T
6-NA,1109,1,2,0,2631,2634,C
6-NA,1110,2603,0,0,0,2603,A
6-NA,1111,1,1,0,2599,2601,C
6-NA,1112,0,0,2602,0,2602,G
6-NA,1113,1,2597,1,0,2599,T
6-NA,1114,0,2669,0,1,2670,T
6-NA,1115,0,2678,0,0,2678,T
6-NA,1116,2672,1,1,0,2674,A
6-NA,1117,0,1,2702,0,2703,G
6-NA,1118,1,1,2691,1,2694,G
6-NA,1119,2,1,2733,0,2736,G
6-NA,1120,0,2642,1,1,2644,T
6-NA,1121,2638,1,0,0,2639,A
6-NA,1122,0,2640,0,0,2640,T
6-NA,1123,0,1,2636,0,2637,G
6-NA,1124,2638,1,0,0,2639,A
6-NA,1125,2633,1,0,0,2634,A
6-NA,1126,2602,0,4,0,2606,A
6-NA,1127,2,1,0,2566,2569,C
6-NA,1128,1,0,0,2416,2417,C
6-NA,1129,1,1871,0,2,1874,T
6-NA,1130,0,1866,0,2,1868,T
6-NA,1131,0,0,0,1870,1870,C
6-NA,1132,1873,0,1,1,1875,A
6-NA,1133,1868,0,2,0,1870,A
6-NA,1134,1870,0,2,0,1872,A
6-NA,1135,0,0,1887,0,1887,G
6-NA,1136,0,1858,0,1,1859,T
6-NA,1137,2,1,0,1862,1865,C
6-NA,1138,1889,0,0,0,1889,A
6-NA,1139,0,1885,1,0,1886,T
6-NA,1140,0,1887,2,2,1891,T
6-NA,1141,1,0,1887,0,1888,G
6-NA,1142,1884,0,1,1,1886,A
6-NA,1143,1880,1,4,0,1885,A
6-NA,1144,0,0,1886,0,1886,G
6-NA,1145,0,0,1881,1,1882,G
6-NA,1146,0,0,0,1873,1873,C
6-NA,1147,0,1828,1,2,1831,T
6-NA,1148,0,0,1849,0,1849,G
6-NA,1149,1,0,1876,0,1877,G
6-NA,1150,1,1874,1,1,1877,T
6-NA,1151,2,0,0,1867,1869,C
6-NA,1152,1,1,0,1866,1868,C
6-NA,1153,1861,1,4,0,1866,A
6-NA,1154,1873,0,0,0,1873,A
6-NA,1155,0,1,0,1870,1871,C
6-NA,1156,3,0,0,1811,1814,C
6-NA,1157,1,1,0,1782,1784,C
6-NA,1158,0,1693,0,1,1694,T
6-NA,1159,1693,0,1,0,1694,A
6-NA,1160,1689,0,3,0,1692,A
6-NA,1161,0,2,1708,0,1710,G
6-NA,1162,0,1699,0,4,1703,T
6-NA,1163,3,0,0,1693,1696,C
6-NA,1164,2,3,0,1668,1673,C
6-NA,1165,1670,0,0,0,1670,A
6-NA,1166,1670,0,1,0,1671,A
6-NA,1167,1669,0,0,0,1669,A
6-NA,1168,0,1668,0,0,1668,T
6-NA,1169,0,1667,0,0,1667,T
6-NA,1170,0,0,1662,0,1662,G
6-NA,1171,0,1,0,1651,1652,C
6-NA,1172,1647,0,2,0,1649,A
6-NA,1173,0,0,1663,0,1663,G
6-NA,1174,1657,0,0,0,1657,A
6-NA,1175,0,1673,0,1,1674,T
6-NA,1176,1678,0,0,0,1678,A
6-NA,1177,1675,0,0,0,1675,A
6-NA,1178,1675,0,4,0,1679,A
6-NA,1179,0,1673,0,0,1673,T
6-NA,1180,1665,1,2,0,1668,A
6-NA,1181,0,0,1669,0,1669,G
6-NA,1182,0,2,1654,0,1656,G
6-NA,1183,1,1,0,1654,1656,C
6-NA,1184,1597,1,0,0,1598,A
6-NA,1185,1616,1,1,0,1618,A
6-NA,1186,1,1,1625,0,1627,G
6-NA,1187,0,1621,0,1,1622,T
6-NA,1188,1,0,0,1619,1620,C
6-NA,1189,1630,0,0,0,1630,A
6-NA,1190,0,1629,0,0,1629,T
6-NA,1191,1634,1,0,0,1635,A
6-NA,1192,0,0,1636,0,1636,G
6-NA,1193,0,1635,0,0,1635,T
6-NA,1194,0,1592,0,3,1595,T
6-NA,1195,1,1,1575,0,1577,G
6-NA,1196,1568,0,1,0,1569,A
6-NA,1197,0,1,0,1567,1568,C
6-NA,1198,1536,1,3,0,1540,A
6-NA,1199,0,0,1550,0,1550,G
6-NA,1200,1523,0,4,0,1527,A
6-NA,1201,1,2,1577,0,1580,G
6-NA,1202,0,0,1581,0,1581,G
6-NA,1203,0,1564,0,1,1565,T
6-NA,1204,1558,0,2,0,1560,A
6-NA,1205,1560,0,1,0,1561,A
6-NA,1206,0,1557,0,0,1557,T
6-NA,1207,1555,0,4,0,1559,A
6-NA,1208,0,1,1533,0,1534,G
6-NA,1209,1,0,1505,0,1506,G
6-NA,1210,2,1346,0,1,1349,T
6-NA,1211,1,1,0,1334,1336,C
6-NA,1212,1,2,0,1332,1335,C
6-NA,1213,1,4,1332,1,1338,G
6-NA,1214,0,0,1339,0,1339,G
6-NA,1215,0,1336,0,0,1336,T
6-NA,1216,1,1334,0,1,1336,T
6-NA,1217,1327,0,0,0,1327,A
6-NA,1218,0,1300,0,2,1302,T
6-NA,1219,1,1301,0,1,1303,T
6-NA,1220,0,0,0,1307,1307,C
6-NA,1221,0,1255,0,1,1256,T
6-NA,1222,0,0,1256,0,1256,G
6-NA,1223,2,0,1256,0,1258,G
6-NA,1224,0,1253,0,1,1254,T
6-NA,1225,1253,0,0,0,1253,A
6-NA,1226,0,1235,0,0,1235,T
6-NA,1227,0,1226,0,2,1228,T
6-NA,1228,0,1230,0,2,1232,T
6-NA,1229,0,1237,0,1,1238,T
6-NA,1230,1,0,0,1239,1240,C
6-NA,1231,0,1205,0,2,1207,T
6-NA,1232,1,0,0,1214,1215,C
6-NA,1233,0,1207,0,0,1207,T
6-NA,1234,0,0,1225,0,1225,G
6-NA,1235,1,1219,0,4,1224,T
6-NA,1236,0,1211,0,1,1212,T
6-NA,1237,0,0,1213,0,1213,G
6-NA,1238,1208,0,1,0,1209,A
6-NA,1239,1204,1,1,0,1206,A
6-NA,1240,0,0,1218,0,1218,G
6-NA,1241,0,0,1216,0,1216,G
6-NA,1242,0,1,0,1216,1217,C
6-NA,1243,1202,0,0,0,1202,A
6-NA,1244,1197,0,0,0,1197,A
6-NA,1245,1200,1,1,0,1202,A
6-NA,1246,1204,0,2,1,1207,A
6-NA,1247,1,0,1204,0,1205,G
6-NA,1248,0,1,0,1200,1201,C
6-NA,1249,0,1188,0,0,1188,T
6-NA,1250,0,0,1197,0,1197,G
6-NA,1251,0,1,0,1192,1193,C
6-NA,1252,1199,0,2,0,1201,A
6-NA,1253,0,1194,0,0,1194,T
6-NA,1254,0,0,0,1190,1190,C
6-NA,1255,1188,0,0,0,1188,A
6-NA,1256,1188,1,0,0,1189,A
6-NA,1257,0,1185,0,1,1186,T
6-NA,1258,0,0,0,1185,1185,C
6-NA,1259,1,0,1171,0,1172,G
6-NA,1260,0,0,1194,1,1195,G
6-NA,1261,0,1187,0,0,1187,T
6-NA,1262,1,0,1195,0,1196,G
6-NA,1263,0,1,0,1196,1197,C
6-NA,1264,0,1189,0,3,1192,T
6-NA,1265,0,1198,0,2,1200,T
6-NA,1266,0,1200,0,0,1200,T
6-NA,1267,0,1207,1,0,1208,T
6-NA,1268,1212,0,0,0,1212,A
6-NA,1269,1,1162,1,1,1165,T
6-NA,1270,0,0,1167,0,1167,G
6-NA,1271,0,1140,0,1,1141,T
6-NA,1272,0,1,1137,0,1138,G
6-NA,1273,1,2,1150,0,1153,G
6-NA,1274,1121,0,0,0,1121,A
6-NA,1275,0,0,1131,0,1131,G
6-NA,1276,0,1128,0,2,1130,T
6-NA,1277,0,1120,0,2,1122,T
6-NA,1278,0,0,1123,0,1123,G
6-NA,1279,1117,0,2,0,1119,A
6-NA,1280,0,1117,1,2,1120,T
6-NA,1281,1112,0,0,0,1112,A
6-NA,1282,1077,0,1,0,1078,A
6-NA,1283,0,0,1082,0,1082,G
6-NA,1284,1,0,1059,0,1060,G
6-NA,1285,1,0,1054,0,1055,G
6-NA,1286,0,0,1053,0,1053,G
6-NA,1287,1032,1,1,0,1034,A
6-NA,1288,1037,0,0,0,1037,A
6-NA,1289,0,1,1040,0,1041,G
6-NA,1290,1039,0,0,0,1039,A
6-NA,1291,1040,0,0,0,1040,A
6-NA,1292,1027,0,0,0,1027,A
6-NA,1293,1001,0,2,0,1003,A
6-NA,1294,0,1,1002,0,1003,G
6-NA,1295,992,2,0,0,994,A
6-NA,1296,1,1,992,0,994,G
6-NA,1297,1,2,990,0,993,G
6-NA,1298,976,0,0,0,976,A
6-NA,1299,979,0,0,0,979,A
6-NA,1300,980,0,1,0,981,A
6-NA,1301,0,0,0,984,984,C
6-NA,1302,0,979,0,0,979,T
6-NA,1303,0,0,981,0,981,G
6-NA,1304,974,0,2,0,976,A
6-NA,1305,978,0,1,0,979,A
6-NA,1306,0,0,980,0,980,G
6-NA,1307,0,976,0,1,977,T
6-NA,1308,2,0,0,986,988,C
6-NA,1309,0,980,1,1,982,T
6-NA,1310,0,971,0,0,971,T
6-NA,1311,0,0,971,0,971,G
6-NA,1312,0,966,1,0,967,T
6-NA,1313,0,1,967,0,968,G
6-NA,1314,0,1,963,0,964,G
6-NA,1315,962,0,2,0,964,A
6-NA,1316,0,1,0,968,969,C
6-NA,1317,0,1,0,935,936,C
6-NA,1318,1,935,0,1,937,T
6-NA,1319,2,1,0,934,937,C
6-NA,1320,944,0,0,0,944,A
6-NA,1321,945,0,1,0,946,A
6-NA,1322,946,0,1,0,947,A
6-NA,1323,0,0,0,954,954,C
6-NA,1324,921,1,0,0,922,A
6-NA,1325,1,0,921,0,922,G
6-NA,1326,0,906,0,0,906,T
6-NA,1327,902,0,2,0,904,A
6-NA,1328,1,903,0,1,905,T
6-NA,1329,0,882,0,1,883,T
6-NA,1330,2,0,888,0,890,G
6-NA,1331,0,889,0,0,889,T
6-NA,1332,0,832,0,2,834,T
6-NA,1333,0,0,835,0,835,G
6-NA,1334,0,757,0,0,757,T
6-NA,1335,0,0,760,0,760,G
6-NA,1336,0,753,0,0,753,T
6-NA,1337,0,743,1,0,744,T
6-NA,1338,0,742,1,0,743,T
6-NA,1339,0,724,0,0,724,T
6-NA,1340,1,0,723,0,724,G
6-NA,1341,0,725,0,0,725,T
6-NA,1342,0,0,721,0,721,G
6-NA,1343,0,0,724,0,724,G
6-NA,1344,0,0,0,710,710,C
6-NA,1345,707,0,0,0,707,A
6-NA,1346,0,0,0,711,711,C
6-NA,1347,0,1,0,711,712,C
6-NA,1348,0,711,0,0,711,T
6-NA,1349,0,0,0,714,714,C
6-NA,1350,711,0,1,0,712,A
6-NA,1351,0,0,717,0,717,G
6-NA,1352,0,0,718,0,718,G
6-NA,1353,0,714,0,0,714,T
6-NA,1354,709,0,2,0,711,A
6-NA,1355,0,1,0,680,681,C
6-NA,1356,679,0,0,0,679,A
6-NA,1357,0,677,0,0,677,T
6-NA,1358,659,0,1,0,660,A
6-NA,1359,0,657,0,0,657,T
6-NA,1360,0,0,599,0,599,G
6-NA,1361,0,0,597,0,597,G
6-NA,1362,591,0,0,0,591,A
6-NA,1363,584,0,1,0,585,A
6-NA,1364,0,0,0,581,581,C
6-NA,1365,457,0,1,0,458,A
6-NA,1366,0,0,458,0,458,G
6-NA,1367,0,0,457,0,457,G
6-NA,1368,0,0,0,460,460,C
6-NA,1369,0,454,0,0,454,T
6-NA,1370,1,0,0,440,441,C
6-NA,1371,439,0,0,0,439,A
6-NA,1372,0,437,0,0,437,T
6-NA,1373,0,1,437,0,438,G
6-NA,1374,0,0,438,0,438,G
6-NA,1375,0,1,0,416,417,C
6-NA,1376,1,0,0,412,413,C
6-NA,1377,0,387,0,0,387,T
6-NA,1378,1,0,387,0,388,G
6-NA,1379,388,0,0,0,388,A
6-NA,1380,0,386,0,1,387,T
6-NA,1381,1,1,379,1,382,G
6-NA,1382,0,0,376,0,376,G
6-NA,1383,0,0,361,0,361,G
6-NA,1384,0,0,361,0,361,G
6-NA,1385,0,0,0,359,359,C
6-NA,1386,0,0,357,0,357,G
6-NA,1387,0,0,356,0,356,G
6-NA,1388,351,0,0,0,351,A
6-NA,1389,0,0,0,347,347,C
6-NA,1390,347,0,0,0,347,A
6-NA,1391,0,343,0,0,343,T
6-NA,1392,2,0,0,337,339,C
6-NA,1393,332,0,0,1,333,A
6-NA,1394,331,0,2,0,333,A
6-NA,1395,0,332,0,1,333,T
6-NA,1396,0,0,0,328,328,C
6-NA,1397,0,316,0,0,316,T
6-NA,1398,0,0,0,275,275,C
6-NA,1399,272,0,0,0,272,A
6-NA,1400,0,272,0,0,272,T
6-NA,1401,1,0,271,0,272,G
6-NA,1402,0,0,0,269,269,C
6-NA,1403,1,0,0,265,266,C
6-NA,1404,0,242,0,0,242,T
6-NA,1405,243,0,0,0,243,A
6-NA,1406,0,242,0,0,242,T
6-NA,1407,239,0,0,0,239,A
6-NA,1408,0,238,0,0,238,T
6-NA,1409,217,0,0,0,217,A
6-NA,1410,210,0,0,0,210,A
7-M,1,86,0,0,0,86,A
7-M,2,0,86,0,0,86,T
7-M,3,0,0,87,0,87,G
7-M,4,88,0,0,0,88,A
7-M,5,0,0,93,0,93,G
7-M,6,0,0,0,98,98,C
7-M,7,0,0,0,101,101,C
7-M,8,1,122,0,0,123,T
7-M,9,0,122,0,0,122,T
7-M,10,0,0,0,123,123,C
7-M,11,0,122,0,0,122,T
7-M,12,124,0,0,0,124,A
7-M,13,127,0,0,0,127,A
7-M,14,0,0,0,129,129,C
7-M,15,0,0,0,129,129,C
7-M,16,0,0,129,0,129,G
7-M,17,129,0,0,0,129,A
7-M,18,0,0,129,0,129,G
7-M,19,0,0,132,0,132,G
7-M,20,0,133,0,0,133,T
7-M,21,0,1,0,130,131,C
7-M,22,0,0,133,0,133,G
7-M,23,140,0,0,0,140,A
7-M,24,142,0,0,0,142,A
7-M,25,144,0,0,0,144,A
7-M,26,0,0,0,160,160,C
7-M,27,0,0,163,0,163,G
7-M,28,0,165,0,0,165,T
7-M,29,167,0,0,0,167,A
7-M,30,0,170,0,0,170,T
7-M,31,0,0,179,0,179,G
7-M,32,0,179,0,0,179,T
7-M,33,0,199,0,0,199,T
7-M,34,0,0,0,209,209,C
7-M,35,0,211,0,0,211,T
7-M,36,0,0,0,223,223,C
7-M,37,0,220,0,1,221,T
7-M,38,0,0,0,238,238,C
7-M,39,0,238,0,0,238,T
7-M,40,237,0,1,0,238,A
7-M,41,0,238,0,0,238,T
7-M,42,0,0,0,238,238,C
7-M,43,0,0,238,0,238,G
7-M,44,0,243,0,0,243,T
7-M,45,0,241,0,0,241,T
7-M,46,0,0,0,252,252,C
7-M,47,0,0,0,259,259,C
7-M,48,257,0,0,0,257,A
7-M,49,0,259,0,0,259,T
7-M,50,0,0,0,258,258,C
7-M,51,260,0,0,0,260,A
7-M,52,0,0,261,0,261,G
7-M,53,1,0,262,0,263,G
7-M,54,0,0,0,262,262,C
7-M,55,0,1,0,261,262,C
7-M,56,1,0,0,265,266,C
7-M,57,0,0,0,273,273,C
7-M,58,0,0,0,275,275,C
7-M,59,0,274,0,1,275,T
7-M,60,0,0,0,275,275,C
7-M,61,275,0,0,0,275,A
7-M,62,274,1,0,0,275,A
7-M,63,279,0,0,0,279,A
7-M,64,0,0,283,0,283,G
7-M,65,0,0,0,284,284,C
7-M,66,0,0,0,281,281,C
7-M,67,0,0,282,0,282,G
7-M,68,281,0,0,0,281,A
7-M,69,0,1,281,0,282,G
7-M,70,281,0,0,0,281,A
7-M,71,0,281,0,1,282,T
7-M,72,0,1,0,280,281,C
7-M,73,0,0,283,0,283,G
7-M,74,0,0,0,283,283,C
7-M,75,0,0,285,0,285,G
7-M,76,0,0,0,285,285,C
7-M,77,283,0,1,0,284,A
7-M,78,0,0,286,0,286,G
7-M,79,284,0,0,0,284,A
7-M,80,0,0,315,0,315,G
7-M,81,317,0,0,0,317,A
7-M,82,0,0,0,317,317,C
7-M,83,0,319,0,1,320,T
7-M,84,0,319,0,0,319,T
7-M,85,0,0,321,0,321,G
7-M,86,323,0,0,0,323,A
7-M,87,323,0,0,0,323,A
7-M,88,0,0,322,0,322,G
7-M,89,317,0,0,0,317,A
7-M,90,0,321,0,0,321,T
7-M,91,0,0,324,0,324,G
7-M,92,0,326,0,0,326,T
7-M,93,0,0,0,326,326,C
7-M,94,0,325,0,0,325,T
7-M,95,0,327,0,0,327,T
7-M,96,1,326,0,0,327,T
7-M,97,0,0,326,0,326,G
7-M,98,0,0,0,326,326,C
7-M,99,0,326,0,0,326,T
7-M,100,0,0,328,0,328,G
7-M,101,0,0,328,0,328,G
7-M,102,0,1,334,0,335,G
7-M,103,334,0,1,0,335,A
7-M,104,334,1,0,0,335,A
7-M,105,337,0,0,0,337,A
7-M,106,335,0,1,0,336,A
7-M,107,340,0,0,0,340,A
7-M,108,0,0,0,347,347,C
7-M,109,346,0,0,0,346,A
7-M,110,0,0,0,348,348,C
7-M,111,344,0,0,0,344,A
7-M,112,0,0,358,0,358,G
7-M,113,364,0,1,0,365,A
7-M,114,0,376,0,0,376,T
7-M,115,0,0,0,376,376,C
7-M,116,0,375,0,0,375,T
7-M,117,0,376,0,0,376,T
7-M,118,0,0,375,0,375,G
7-M,119,376,0,0,0,376,A
7-M,120,0,1,375,0,376,G
7-M,121,0,0,377,0,377,G
7-M,122,0,0,0,381,381,C
7-M,123,0,379,0,0,379,T
7-M,124,0,1,0,414,415,C
7-M,125,0,417,0,1,418,T
7-M,126,1,0,0,419,420,C
7-M,127,418,0,2,0,420,A
7-M,128,1,419,0,0,420,T
7-M,129,1,0,420,0,421,G
7-M,130,0,0,423,0,423,G
7-M,131,423,2,0,0,425,A
7-M,132,423,0,0,0,423,A
7-M,133,0,414,0,0,414,T
7-M,134,0,0,426,0,426,G
7-M,135,0,0,445,0,445,G
7-M,136,0,0,0,448,448,C
7-M,137,0,448,0,0,448,T
7-M,138,449,0,0,0,449,A
7-M,139,446,0,0,0,446,A
7-M,140,452,0,1,0,453,A
7-M,141,0,0,464,0,464,G
7-M,142,463,0,1,0,464,A
7-M,143,0,0,0,462,462,C
7-M,144,460,0,0,0,460,A
7-M,145,457,0,3,0,460,A
7-M,146,0,1,465,0,466,G
7-M,147,465,1,2,0,468,A
7-M,148,0,0,0,467,467,C
7-M,149,0,0,0,466,466,C
7-M,150,465,0,0,0,465,A
7-M,151,468,0,0,0,468,A
7-M,152,0,468,0,0,468,T
7-M,153,0,468,0,0,468,T
7-M,154,0,0,0,466,466,C
7-M,155,0,472,0,0,472,T
7-M,156,0,0,473,0,473,G
7-M,157,0,470,0,2,472,T
7-M,158,1,0,0,470,471,C
7-M,159,471,0,0,0,471,A
7-M,160,0,0,0,487,487,C
7-M,161,0,0,0,487,487,C
7-M,162,0,485,0,0,485,T
7-M,163,0,0,0,487,487,C
7-M,164,0,485,0,0,485,T
7-M,165,0,0,509,0,509,G
7-M,166,507,0,0,0,507,A
7-M,167,0,0,0,509,509,C
7-M,168,0,509,0,0,509,T
7-M,169,505,0,0,0,505,A
7-M,170,504,0,1,0,505,A
7-M,171,0,0,509,0,509,G
7-M,172,0,0,510,0,510,G
7-M,173,0,1,509,0,510,G
7-M,174,0,0,511,1,512,G
7-M,175,526,0,1,0,527,A
7-M,176,1,526,0,0,527,T
7-M,177,0,526,0,0,526,T
7-M,178,0,528,0,1,529,T
7-M,179,0,528,0,0,528,T
7-M,180,0,0,529,0,529,G
7-M,181,0,0,528,0,528,G
7-M,182,0,1,530,0,531,G
7-M,183,1,0,532,0,533,G
7-M,184,0,523,0,0,523,T
7-M,185,0,526,0,0,526,T
7-M,186,0,525,0,1,526,T
7-M,187,0,0,536,0,536,G
7-M,188,0,538,0,0,538,T
7-M,189,1,0,537,0,538,G
7-M,190,0,536,0,0,536,T
7-M,191,0,533,0,0,533,T
7-M,192,0,0,0,538,538,C
7-M,193,538,0,1,0,539,A
7-M,194,0,1,0,554,555,C
7-M,195,0,0,554,0,554,G
7-M,196,0,1,0,553,554,C
7-M,197,0,548,0,0,548,T
7-M,198,0,0,0,559,559,C
7-M,199,557,0,1,0,558,A
7-M,200,0,0,0,565,565,C
7-M,201,1,0,0,561,562,C
7-M,202,0,0,565,0,565,G
7-M,203,0,573,0,0,573,T
7-M,204,0,0,576,0,576,G
7-M,205,0,3,0,574,577,C
7-M,206,0,0,0,577,577,C
7-M,207,0,1,0,575,576,C
7-M,208,568,1,1,0,570,A
7-M,209,0,0,570,0,570,G
7-M,210,0,574,0,0,574,T
7-M,211,0,1,574,0,575,G
7-M,212,579,0,1,0,580,A
7-M,213,0,0,583,0,583,G
7-M,214,0,1,0,581,582,C
7-M,215,1,0,583,0,584,G
7-M,216,580,0,0,0,580,A
7-M,217,0,0,587,0,587,G
7-M,218,0,0,591,0,591,G
7-M,219,589,0,1,0,590,A
7-M,220,0,0,0,601,601,C
7-M,221,0,600,0,0,600,T
7-M,222,0,0,599,0,599,G
7-M,223,0,1,0,600,601,C
7-M,224,598,0,1,0,599,A
7-M,225,0,0,611,0,611,G
7-M,226,0,0,0,611,611,C
7-M,227,0,0,616,0,616,G
7-M,228,0,617,0,0,617,T
7-M,229,610,0,1,0,611,A
7-M,230,0,0,611,0,611,G
7-M,231,608,0,1,0,609,A
7-M,232,0,1,0,609,610,C
7-M,233,1,0,615,0,616,G
7-M,234,0,0,0,608,608,C
7-M,235,0,601,0,0,601,T
7-M,236,0,601,0,0,601,T
7-M,237,0,599,0,0,599,T
7-M,238,0,0,617,0,617,G
7-M,239,0,620,0,1,621,T
7-M,240,0,0,0,621,621,C
7-M,241,0,1,0,618,619,C
7-M,242,618,1,0,0,619,A
7-M,243,617,0,1,0,618,A
7-M,244,619,0,0,0,619,A
7-M,245,617,0,0,0,617,A
7-M,246,0,620,0,0,620,T
7-M,247,1,0,616,0,617,G
7-M,248,0,0,0,616,616,C
7-M,249,0,0,0,614,614,C
7-M,250,0,0,0,617,617,C
7-M,251,0,621,0,0,621,T
7-M,252,1,0,0,631,632,C
7-M,253,631,0,1,0,632,A
7-M,254,639,0,1,0,640,A
7-M,255,0,644,0,0,644,T
7-M,256,1,0,648,0,649,G
7-M,257,0,0,654,0,654,G
7-M,258,0,0,657,0,657,G
7-M,259,657,1,0,1,659,A
7-M,260,658,0,0,0,658,A
7-M,261,1,644,0,1,646,T
7-M,262,1,0,644,0,645,G
7-M,263,0,0,642,0,642,G
7-M,264,641,0,1,0,642,A
7-M,265,0,0,641,0,641,G
7-M,266,637,0,0,0,637,A
7-M,267,0,0,0,629,629,C
7-M,268,0,0,0,652,652,C
7-M,269,0,0,0,657,657,C
7-M,270,662,0,0,0,662,A
7-M,271,665,0,0,0,665,A
7-M,272,664,0,0,0,664,A
7-M,273,0,669,0,1,670,T
7-M,274,685,0,0,0,685,A
7-M,275,689,0,0,0,689,A
7-M,276,1,0,0,678,679,C
7-M,277,676,0,0,0,676,A
7-M,278,0,675,0,0,675,T
7-M,279,0,0,683,0,683,G
7-M,280,0,1,684,1,686,G
7-M,281,685,0,0,0,685,A
7-M,282,0,0,0,683,683,C
7-M,283,672,0,0,0,672,A
7-M,284,675,1,0,0,676,A
7-M,285,671,0,2,0,673,A
7-M,286,0,1,678,0,679,G
7-M,287,0,0,0,685,685,C
7-M,288,675,0,1,0,676,A
7-M,289,0,0,694,0,694,G
7-M,290,0,690,0,0,690,T
7-M,291,1,689,0,0,690,T
7-M,292,696,0,0,0,696,A
7-M,293,693,0,1,0,694,A
7-M,294,697,0,0,0,697,A
7-M,295,0,0,0,708,708,C
7-M,296,0,692,0,0,692,T
7-M,297,0,1,743,0,744,G
7-M,298,1,739,0,0,740,T
7-M,299,744,0,0,0,744,A
7-M,300,0,744,0,1,745,T
7-M,301,738,0,1,0,739,A
7-M,302,0,0,742,0,742,G
7-M,303,0,0,740,0,740,G
7-M,304,728,0,1,0,729,A
7-M,305,730,0,0,0,730,A
7-M,306,698,1,1,0,700,A
7-M,307,0,0,0,706,706,C
7-M,308,0,702,0,0,702,T
7-M,309,0,705,0,0,705,T
7-M,310,704,0,0,0,704,A
7-M,311,704,0,0,0,704,A
7-M,312,0,2,704,0,706,G
7-M,313,700,0,0,0,700,A
7-M,314,0,1,700,0,701,G
7-M,315,673,0,1,0,674,A
7-M,316,0,1,686,0,687,G
7-M,317,686,0,3,0,689,A
7-M,318,0,0,701,0,701,G
7-M,319,706,0,0,0,706,A
7-M,320,0,702,0,0,702,T
7-M,321,703,0,0,0,703,A
7-M,322,706,0,0,1,707,A
7-M,323,1,0,0,711,712,C
7-M,324,0,0,713,0,713,G
7-M,325,0,707,0,1,708,T
7-M,326,0,711,0,0,711,T
7-M,327,1,0,0,714,715,C
7-M,328,0,0,0,706,706,C
7-M,329,706,0,0,0,706,A
7-M,330,0,705,0,1,706,T
7-M,331,0,2,701,0,703,G
7-M,332,0,1,693,0,694,G
7-M,333,0,0,694,0,694,G
7-M,334,1,0,704,0,705,G
7-M,335,0,0,0,700,700,C
7-M,336,1,0,0,695,696,C
7-M,337,701,0,0,0,701,A
7-M,338,705,0,0,0,705,A
7-M,339,704,0,2,0,706,A
7-M,340,0,0,709,1,710,G
7-M,341,711,0,1,0,712,A
7-M,342,701,0,0,0,701,A
7-M,343,703,0,0,1,704,A
7-M,344,0,703,0,0,703,T
7-M,345,700,0,0,0,700,A
7-M,346,0,0,708,0,708,G
7-M,347,0,1,0,703,704,C
7-M,348,0,699,0,1,700,T
7-M,349,2,0,0,695,697,C
7-M,350,0,696,0,2,698,T
7-M,351,0,1,0,720,721,C
7-M,352,722,0,0,0,722,A
7-M,353,0,0,718,0,718,G
7-M,354,0,713,0,1,714,T
7-M,355,0,721,0,0,721,T
7-M,356,722,0,0,0,722,A
7-M,357,0,722,1,0,723,T
7-M,358,0,721,0,1,722,T
7-M,359,0,0,0,724,724,C
7-M,360,0,698,0,0,698,T
7-M,361,0,0,705,0,705,G
7-M,362,0,0,0,702,702,C
7-M,363,0,697,0,0,697,T
7-M,364,0,0,696,1,697,G
7-M,365,0,0,696,0,696,G
7-M,366,0,696,0,1,697,T
7-M,367,0,0,697,0,697,G
7-M,368,0,0,1,692,693,C
7-M,369,696,0,0,0,696,A
7-M,370,1,0,0,698,699,C
7-M,371,1,694,0,1,696,T
7-M,372,1,710,0,0,711,T
7-M,373,1,0,710,0,711,G
7-M,374,0,0,0,712,712,C
7-M,375,0,0,0,711,711,C
7-M,376,707,0,1,0,708,A
7-M,377,0,0,718,0,718,G
7-M,378,0,719,0,1,720,T
7-M,379,0,714,0,0,714,T
7-M,380,0,0,714,0,714,G
7-M,381,0,700,0,1,701,T
7-M,382,715,1,1,0,717,A
7-M,383,0,717,0,0,717,T
7-M,384,0,0,716,0,716,G
7-M,385,0,0,715,0,715,G
7-M,386,0,0,719,0,719,G
7-M,387,0,0,0,724,724,C
7-M,388,0,0,0,730,730,C
7-M,389,0,712,0,2,714,T
7-M,390,1,0,0,728,729,C
7-M,391,757,0,0,0,757,A
7-M,392,0,758,0,0,758,T
7-M,393,788,0,0,0,788,A
7-M,394,0,780,0,0,780,T
7-M,395,775,0,0,0,775,A
7-M,396,0,0,0,811,811,C
7-M,397,779,0,0,0,779,A
7-M,398,783,0,1,0,784,A
7-M,399,0,778,0,0,778,T
7-M,400,740,1,1,0,742,A
7-M,401,0,0,750,0,750,G
7-M,402,0,0,735,0,735,G
7-M,403,730,0,0,0,730,A
7-M,404,0,722,0,0,722,T
7-M,405,0,0,676,0,676,G
7-M,406,1,0,678,0,679,G
7-M,407,1,0,677,0,678,G
7-M,408,0,1,682,0,683,G
7-M,409,0,0,683,0,683,G
7-M,410,0,0,0,677,677,C
7-M,411,0,667,0,2,669,T
7-M,412,0,0,668,0,668,G
7-M,413,0,670,0,0,670,T
7-M,414,673,0,0,0,673,A
7-M,415,672,0,0,0,672,A
7-M,416,0,0,0,673,673,C
7-M,417,0,0,0,665,665,C
7-M,418,662,0,0,0,662,A
7-M,419,0,1,1,659,661,C
7-M,420,0,659,0,0,659,T
7-M,421,0,0,662,0,662,G
7-M,422,659,0,0,0,659,A
7-M,423,657,0,0,0,657,A
7-M,424,0,0,659,0,659,G
7-M,425,0,652,0,0,652,T
7-M,426,1,1,648,0,650,G
7-M,427,0,0,655,0,655,G
7-M,428,0,1,0,653,654,C
7-M,429,657,0,0,0,657,A
7-M,430,0,649,0,1,650,T
7-M,431,0,650,0,0,650,T
7-M,432,0,648,0,0,648,T
7-M,433,1,1,661,0,663,G
7-M,434,0,0,665,0,665,G
7-M,435,0,0,0,665,665,C
7-M,436,1,0,0,663,664,C
7-M,437,0,658,0,2,660,T
7-M,438,0,0,694,0,694,G
7-M,439,0,0,696,1,697,G
7-M,440,0,697,0,0,697,T
7-M,441,700,0,0,0,700,A
7-M,442,0,672,0,0,672,T
7-M,443,0,0,680,0,680,G
7-M,444,0,684,0,0,684,T
7-M,445,0,0,683,0,683,G
7-M,446,0,0,0,682,682,C
7-M,447,665,0,0,0,665,A
7-M,448,664,0,1,0,665,A
7-M,449,0,1,0,670,671,C
7-M,450,673,0,0,0,673,A
7-M,451,0,678,0,0,678,T
7-M,452,0,1,666,0,667,G
7-M,453,0,656,0,0,656,T
7-M,454,0,1,655,0,656,G
7-M,455,652,0,1,0,653,A
7-M,456,0,0,659,0,659,G
7-M,457,0,2,0,657,659,C
7-M,458,648,0,1,0,649,A
7-M,459,0,3,650,0,653,G
7-M,460,650,1,0,0,651,A
7-M,461,0,651,0,0,651,T
7-M,462,0,650,0,0,650,T
7-M,463,0,0,651,0,651,G
7-M,464,0,0,0,651,651,C
7-M,465,0,647,0,0,647,T
7-M,466,0,0,647,0,647,G
7-M,467,645,1,0,0,646,A
7-M,468,0,0,0,673,673,C
7-M,469,0,673,0,1,674,T
7-M,470,1,0,0,678,679,C
7-M,471,0,0,0,679,679,C
7-M,472,1,0,0,675,676,C
7-M,473,676,0,0,0,676,A
7-M,474,0,0,688,0,688,G
7-M,475,0,0,0,686,686,C
7-M,476,687,0,0,0,687,A
7-M,477,0,0,0,685,685,C
7-M,478,644,0,0,0,644,A
7-M,479,0,1,660,0,661,G
7-M,480,1,0,661,0,662,G
7-M,481,0,663,0,0,663,T
7-M,482,0,0,0,679,679,C
7-M,483,0,670,0,1,671,T
7-M,484,1,1,0,675,677,C
7-M,485,669,1,0,0,670,A
7-M,486,0,674,0,0,674,T
7-M,487,672,0,1,0,673,A
7-M,488,0,0,655,0,655,G
7-M,489,0,0,647,0,647,G
7-M,490,0,0,0,646,646,C
7-M,491,627,0,0,0,627,A
7-M,492,0,1,621,1,623,G
7-M,493,624,0,0,0,624,A
7-M,494,0,627,0,0,627,T
7-M,495,0,0,627,0,627,G
7-M,496,0,0,623,0,623,G
7-M,497,0,621,0,0,621,T
7-M,498,0,0,622,0,622,G
7-M,499,1,0,620,0,621,G
7-M,500,0,0,0,625,625,C
7-M,501,623,0,0,0,623,A
7-M,502,623,0,1,0,624,A
7-M,503,0,0,0,634,634,C
7-M,504,637,0,0,0,637,A
7-M,505,636,0,1,0,637,A
7-M,506,0,0,0,636,636,C
7-M,507,1,0,0,633,634,C
7-M,508,632,0,0,0,632,A
7-M,509,632,0,1,0,633,A
7-M,510,0,633,0,1,634,T
7-M,511,0,0,0,634,634,C
7-M,512,0,0,0,625,625,C
7-M,513,619,0,0,0,619,A
7-M,514,0,616,0,1,617,T
7-M,515,0,619,0,0,619,T
7-M,516,624,0,0,0,624,A
7-M,517,624,0,0,0,624,A
7-M,518,0,623,0,0,623,T
7-M,519,614,0,0,0,614,A
7-M,520,615,0,0,0,615,A
7-M,521,606,0,0,0,606,A
7-M,522,613,0,0,0,613,A
7-M,523,0,1,0,622,623,C
7-M,524,624,0,1,0,625,A
7-M,525,0,624,0,0,624,T
7-M,526,0,1,621,0,622,G
7-M,527,621,0,2,0,623,A
7-M,528,0,1,626,0,627,G
7-M,529,622,0,0,0,622,A
7-M,530,621,0,0,0,621,A
7-M,531,0,0,0,625,625,C
7-M,532,607,0,0,0,607,A
7-M,533,0,0,616,0,616,G
7-M,534,611,1,0,0,612,A
7-M,535,608,0,2,0,610,A
7-M,536,0,611,0,1,612,T
7-M,537,0,0,605,0,605,G
7-M,538,0,0,602,0,602,G
7-M,539,1,599,0,0,600,T
7-M,540,0,586,0,0,586,T
7-M,541,1,596,0,0,597,T
7-M,542,0,596,0,1,597,T
7-M,543,1,0,597,0,598,G
7-M,544,0,0,598,0,598,G
7-M,545,0,0,0,601,601,C
7-M,546,4,1,0,595,600,C
7-M,547,587,1,0,0,588,A
7-M,548,0,1,604,0,605,G
7-M,549,1,0,0,602,603,C
7-M,550,606,0,0,0,606,A
7-M,551,0,0,0,618,618,C
7-M,552,0,608,0,0,608,T
7-M,553,612,0,0,0,612,A
7-M,554,0,1,0,614,615,C
7-M,555,627,0,2,0,629,A
7-M,556,0,0,639,0,639,G
7-M,557,0,0,0,616,616,C
7-M,558,0,610,0,0,610,T
7-M,559,610,0,1,0,611,A
7-M,560,599,0,1,0,600,A
7-M,561,1,0,611,0,612,G
7-M,562,0,0,613,0,613,G
7-M,563,0,0,0,612,612,C
7-M,564,0,587,0,1,588,T
7-M,565,586,0,0,0,586,A
7-M,566,0,586,0,0,586,T
7-M,567,0,1,585,0,586,G
7-M,568,0,0,589,0,589,G
7-M,569,572,1,1,0,574,A
7-M,570,0,1,577,0,578,G
7-M,571,1,0,0,565,566,C
7-M,572,565,0,0,0,565,A
7-M,573,565,0,0,0,565,A
7-M,574,564,0,0,0,564,A
7-M,575,0,575,0,0,575,T
7-M,576,0,0,576,0,576,G
7-M,577,0,0,570,0,570,G
7-M,578,0,0,0,567,567,C
7-M,579,0,565,0,0,565,T
7-M,580,0,1,568,0,569,G
7-M,581,0,0,572,1,573,G
7-M,582,573,0,0,0,573,A
7-M,583,0,570,0,1,571,T
7-M,584,0,0,0,560,560,C
7-M,585,562,0,0,0,562,A
7-M,586,565,0,1,0,566,A
7-M,587,0,0,569,0,569,G
7-M,588,1,569,0,0,570,T
7-M,589,0,0,570,0,570,G
7-M,590,558,0,1,0,559,A
7-M,591,555,0,0,0,555,A
7-M,592,0,1,0,553,554,C
7-M,593,555,0,2,0,557,A
7-M,594,1,0,559,0,560,G
7-M,595,0,0,556,0,556,G
7-M,596,0,0,0,553,553,C
7-M,597,552,0,0,0,552,A
7-M,598,0,0,553,0,553,G
7-M,599,0,1,0,548,549,C
7-M,600,0,0,551,0,551,G
7-M,601,0,0,549,0,549,G
7-M,602,546,0,0,0,546,A
7-M,603,0,0,551,0,551,G
7-M,604,0,0,554,0,554,G
7-M,605,2,0,0,555,557,C
7-M,606,2,1,0,554,557,C
7-M,607,553,0,1,0,554,A
7-M,608,0,553,0,0,553,T
7-M,609,0,2,553,1,556,G
7-M,610,0,0,554,0,554,G
7-M,611,553,0,0,0,553,A
7-M,612,1,0,556,0,557,G
7-M,613,548,0,0,0,548,A
7-M,614,0,555,0,0,555,T
7-M,615,0,556,0,0,556,T
7-M,616,0,0,555,0,555,G
7-M,617,0,1,0,549,550,C
7-M,618,0,551,0,0,551,T
7-M,619,556,0,0,0,556,A
7-M,620,0,0,555,0,555,G
7-M,621,0,556,0,0,556,T
7-M,622,0,0,0,555,555,C
7-M,623,537,0,1,0,538,A
7-M,624,0,0,548,0,548,G
7-M,625,0,0,547,0,547,G
7-M,626,1,0,0,548,549,C
7-M,627,0,0,0,551,551,C
7-M,628,551,0,0,0,551,A
7-M,629,1,1,561,0,563,G
7-M,630,0,0,561,0,561,G
7-M,631,0,0,0,561,561,C
7-M,632,559,0,0,0,559,A
7-M,633,1,0,555,0,556,G
7-M,634,551,0,1,0,552,A
7-M,635,0,552,0,0,552,T
7-M,636,1,0,553,0,554,G
7-M,637,0,1,567,0,568,G
7-M,638,0,562,0,0,562,T
7-M,639,1,0,559,0,560,G
7-M,640,0,0,0,560,560,C
7-M,641,559,0,0,0,559,A
7-M,642,0,0,572,0,572,G
7-M,643,0,0,568,0,568,G
7-M,644,0,0,0,567,567,C
7-M,645,567,0,0,0,567,A
7-M,646,556,0,0,0,556,A
7-M,647,0,551,0,1,552,T
7-M,648,0,1,551,0,552,G
7-M,649,551,0,0,0,551,A
7-M,650,0,0,549,0,549,G
7-M,651,539,0,1,0,540,A
7-M,652,0,0,546,0,546,G
7-M,653,0,0,0,542,542,C
7-M,654,0,0,0,548,548,C
7-M,655,544,0,0,0,544,A
7-M,656,0,542,0,0,542,T
7-M,657,0,542,0,2,544,T
7-M,658,0,0,544,0,544,G
7-M,659,0,0,547,0,547,G
7-M,660,0,0,544,0,544,G
7-M,661,545,0,0,0,545,A
7-M,662,0,0,0,541,541,C
7-M,663,0,521,0,0,521,T
7-M,664,1,0,0,524,525,C
7-M,665,529,0,0,0,529,A
7-M,666,0,542,0,0,542,T
7-M,667,0,1,0,545,546,C
7-M,668,0,0,0,546,546,C
7-M,669,0,545,0,0,545,T
7-M,670,543,0,0,0,543,A
7-M,671,0,0,549,0,549,G
7-M,672,0,581,0,0,581,T
7-M,673,0,573,0,1,574,T
7-M,674,0,0,0,569,569,C
7-M,675,1,0,0,559,560,C
7-M,676,554,0,0,0,554,A
7-M,677,0,0,562,0,562,G
7-M,678,0,562,0,0,562,T
7-M,679,560,0,0,0,560,A
7-M,680,0,0,0,559,559,C
7-M,681,0,527,0,0,527,T
7-M,682,0,0,542,0,542,G
7-M,683,0,0,544,0,544,G
7-M,684,0,541,0,0,541,T
7-M,685,0,535,0,0,535,T
7-M,686,0,547,0,0,547,T
7-M,687,546,0,0,0,546,A
7-M,688,543,0,1,0,544,A
7-M,689,0,0,545,0,545,G
7-M,690,539,0,0,0,539,A
7-M,691,0,0,531,0,531,G
7-M,692,511,0,0,0,511,A
7-M,693,0,504,0,1,505,T
7-M,694,0,0,506,0,506,G
7-M,695,504,0,0,0,504,A
7-M,696,1,502,0,0,503,T
7-M,697,0,0,0,504,504,C
7-M,698,0,493,0,0,493,T
7-M,699,0,500,0,0,500,T
7-M,700,0,0,0,504,504,C
7-M,701,0,501,0,1,502,T
7-M,702,0,504,0,0,504,T
7-M,703,0,0,504,0,504,G
7-M,704,503,0,1,0,504,A
7-M,705,503,1,0,0,504,A
7-M,706,504,0,1,0,505,A
7-M,707,504,0,1,0,505,A
7-M,708,1,499,1,1,502,T
7-M,709,0,504,0,0,504,T
7-M,710,0,503,0,0,503,T
7-M,711,0,0,506,0,506,G
7-M,712,0,0,0,506,506,C
7-M,713,506,0,0,0,506,A
7-M,714,0,0,506,0,506,G
7-M,715,506,0,0,0,506,A
7-M,716,0,0,0,515,515,C
7-M,717,0,0,0,514,514,C
7-M,718,0,512,0,0,512,T
7-M,719,518,0,0,0,518,A
7-M,720,0,517,0,1,518,T
7-M,721,1,0,0,518,519,C
7-M,722,518,0,0,0,518,A
7-M,723,0,0,520,0,520,G
7-M,724,518,0,0,0,518,A
7-M,725,494,0,3,0,497,A
7-M,726,497,0,2,0,499,A
7-M,727,0,0,0,491,491,C
7-M,728,0,0,493,0,493,G
7-M,729,490,0,0,0,490,A
7-M,730,491,0,1,0,492,A
7-M,731,0,490,0,0,490,T
7-M,732,0,0,488,0,488,G
7-M,733,0,0,493,0,493,G
7-M,734,1,0,492,0,493,G
7-M,735,0,0,490,0,490,G
7-M,736,0,0,495,0,495,G
7-M,737,0,484,0,2,486,T
7-M,738,0,0,484,0,484,G
7-M,739,0,0,0,485,485,C
7-M,740,486,0,0,0,486,A
7-M,741,0,0,488,0,488,G
7-M,742,481,1,0,0,482,A
7-M,743,0,483,0,0,483,T
7-M,744,0,0,483,0,483,G
7-M,745,0,0,0,473,473,C
7-M,746,470,0,1,0,471,A
7-M,747,471,0,0,0,471,A
7-M,748,0,0,0,474,474,C
7-M,749,0,0,473,0,473,G
7-M,750,474,0,0,0,474,A
7-M,751,0,472,0,0,472,T
7-M,752,0,474,0,0,474,T
7-M,753,0,1,0,477,478,C
7-M,754,465,0,0,0,465,A
7-M,755,463,0,1,1,465,A
7-M,756,1,0,465,0,466,G
7-M,757,1,458,0,0,459,T
7-M,758,0,0,457,0,457,G
7-M,759,452,0,0,0,452,A
7-M,760,0,0,0,453,453,C
7-M,761,0,0,0,452,452,C
7-M,762,0,0,0,452,452,C
7-M,763,1,0,454,0,455,G
7-M,764,0,1,0,453,454,C
7-M,765,0,447,0,2,449,T
7-M,766,0,452,0,0,452,T
7-M,767,0,0,454,0,454,G
7-M,768,0,454,0,0,454,T
7-M,769,0,452,0,0,452,T
7-M,770,0,0,449,0,449,G
7-M,771,0,443,0,1,444,T
7-M,772,1,437,0,0,438,T
7-M,773,0,0,439,0,439,G
7-M,774,0,0,0,437,437,C
7-M,775,2,1,0,433,436,C
7-M,776,0,0,437,0,437,G
7-M,777,0,0,0,435,435,C
7-M,778,0,0,442,0,442,G
7-M,779,441,1,0,0,442,A
7-M,780,445,0,0,0,445,A
7-M,781,0,444,0,1,445,T
7-M,782,446,0,0,0,446,A
7-M,783,0,448,0,1,449,T
7-M,784,0,0,0,454,454,C
7-M,785,454,0,0,0,454,A
7-M,786,0,452,0,1,453,T
7-M,787,0,448,0,0,448,T
7-M,788,0,0,448,0,448,G
7-M,789,0,0,446,0,446,G
7-M,790,0,0,446,0,446,G
7-M,791,437,0,1,0,438,A
7-M,792,0,439,0,0,439,T
7-M,793,0,0,0,425,425,C
7-M,794,0,424,1,0,425,T
7-M,795,1,424,0,0,425,T
7-M,796,0,0,424,0,424,G
7-M,797,0,1,0,426,427,C
7-M,798,424,0,0,0,424,A
7-M,799,0,0,0,425,425,C
7-M,800,0,413,0,1,414,T
7-M,801,0,416,0,0,416,T
7-M,802,0,0,417,0,417,G
7-M,803,420,0,1,0,421,A
7-M,804,0,422,0,0,422,T
7-M,805,410,0,0,0,410,A
7-M,806,0,410,0,0,410,T
7-M,807,0,402,0,0,402,T
7-M,808,0,0,406,0,406,G
7-M,809,0,403,0,0,403,T
7-M,810,1,0,400,0,401,G
7-M,811,0,0,400,0,400,G
7-M,812,388,0,0,0,388,A
7-M,813,0,388,0,0,388,T
7-M,814,0,386,0,0,386,T
7-M,815,0,0,0,385,385,C
7-M,816,0,383,0,1,384,T
7-M,817,0,383,0,0,383,T
7-M,818,0,0,384,0,384,G
7-M,819,383,0,0,0,383,A
7-M,820,1,382,0,0,383,T
7-M,821,1,0,0,379,380,C
7-M,822,0,0,380,0,380,G
7-M,823,0,377,0,0,377,T
7-M,824,0,0,0,378,378,C
7-M,825,0,378,0,1,379,T
7-M,826,0,378,0,0,378,T
7-M,827,0,380,0,0,380,T
7-M,828,0,380,0,0,380,T
7-M,829,0,380,0,1,381,T
7-M,830,0,380,0,0,380,T
7-M,831,0,379,0,1,380,T
7-M,832,0,0,0,381,381,C
7-M,833,378,0,0,0,378,A
7-M,834,377,0,0,0,377,A
7-M,835,377,0,0,0,377,A
7-M,836,0,376,0,0,376,T
7-M,837,0,0,376,0,376,G
7-M,838,0,0,0,375,375,C
7-M,839,0,0,374,0,374,G
7-M,840,0,380,0,1,381,T
7-M,841,0,0,0,381,381,C
7-M,842,1,381,0,0,382,T
7-M,843,380,0,1,0,381,A
7-M,844,0,380,0,0,380,T
7-M,845,0,0,0,378,378,C
7-M,846,3,1,373,0,377,G
7-M,847,372,0,0,0,372,A
7-M,848,0,0,0,372,372,C
7-M,849,0,364,0,0,364,T
7-M,850,0,0,0,372,372,C
7-M,851,0,370,0,1,371,T
7-M,852,1,368,0,0,369,T
7-M,853,0,0,0,369,369,C
7-M,854,367,0,0,0,367,A
7-M,855,367,0,0,1,368,A
7-M,856,366,0,1,0,367,A
7-M,857,0,0,0,365,365,C
7-M,858,365,0,0,0,365,A
7-M,859,0,0,0,350,350,C
7-M,860,0,0,347,0,347,G
7-M,861,0,0,360,0,360,G
7-M,862,0,0,0,363,363,C
7-M,863,0,0,0,361,361,C
7-M,864,0,357,0,1,358,T
7-M,865,0,359,0,0,359,T
7-M,866,358,0,1,0,359,A
7-M,867,357,0,0,0,357,A
7-M,868,358,0,0,0,358,A
7-M,869,356,0,1,0,357,A
7-M,870,0,0,352,0,352,G
7-M,871,301,0,0,0,301,A
7-M,872,0,1,300,0,301,G
7-M,873,0,0,302,0,302,G
7-M,874,1,0,0,298,299,C
7-M,875,0,0,0,302,302,C
7-M,876,0,0,0,299,299,C
7-M,877,0,297,0,0,297,T
7-M,878,0,299,0,0,299,T
7-M,879,0,0,0,299,299,C
7-M,880,0,298,0,0,298,T
7-M,881,300,0,0,0,300,A
7-M,882,0,0,0,298,298,C
7-M,883,0,0,291,0,291,G
7-M,884,0,0,289,0,289,G
7-M,885,281,0,0,0,281,A
7-M,886,279,0,0,0,279,A
7-M,887,0,0,280,0,280,G
7-M,888,0,0,275,0,275,G
7-M,889,273,0,0,0,273,A
7-M,890,0,0,276,0,276,G
7-M,891,0,272,0,0,272,T
7-M,892,273,0,0,0,273,A
7-M,893,0,0,0,270,270,C
7-M,894,1,0,0,266,267,C
7-M,895,0,268,0,1,269,T
7-M,896,0,0,269,0,269,G
7-M,897,262,0,0,0,262,A
7-M,898,0,0,268,0,268,G
7-M,899,0,259,0,0,259,T
7-M,900,0,0,0,260,260,C
7-M,901,0,253,0,0,253,T
7-M,902,252,0,0,0,252,A
7-M,903,0,252,0,0,252,T
7-M,904,0,0,252,0,252,G
7-M,905,242,1,0,0,243,A
7-M,906,0,0,242,0,242,G
7-M,907,0,0,215,0,215,G
7-M,908,0,0,213,0,213,G
7-M,909,211,0,0,0,211,A
7-M,910,211,0,0,0,211,A
7-M,911,0,1,210,0,211,G
7-M,912,210,0,0,0,210,A
7-M,913,211,0,0,0,211,A
7-M,914,0,210,0,0,210,T
7-M,915,209,0,0,0,209,A
7-M,916,0,209,0,0,209,T
7-M,917,1,1,0,202,204,C
7-M,918,0,0,204,0,204,G
7-M,919,202,0,1,0,203,A
7-M,920,200,0,0,0,200,A
7-M,921,201,0,0,0,201,A
7-M,922,0,0,199,0,199,G
7-M,923,0,0,203,0,203,G
7-M,924,199,0,0,0,199,A
7-M,925,198,0,0,0,198,A
7-M,926,0,0,0,198,198,C
7-M,927,196,0,1,0,197,A
7-M,928,0,0,197,0,197,G
7-M,929,0,0,1,196,197,C
7-M,930,196,0,0,0,196,A
7-M,931,0,0,195,0,195,G
7-M,932,189,0,0,0,189,A
7-M,933,191,0,0,0,191,A
7-M,934,0,191,0,0,191,T
7-M,935,0,0,185,0,185,G
7-M,936,0,0,0,184,184,C
7-M,937,0,174,0,0,174,T
7-M,938,0,0,174,0,174,G
7-M,939,0,174,0,0,174,T
7-M,940,0,0,173,0,173,G
7-M,941,0,0,174,0,174,G
7-M,942,165,0,1,0,166,A
7-M,943,0,166,0,0,166,T
7-M,944,0,0,161,0,161,G
7-M,945,0,0,0,159,159,C
7-M,946,0,152,0,1,153,T
7-M,947,0,0,152,0,152,G
7-M,948,153,0,0,0,153,A
7-M,949,0,1,0,149,150,C
7-M,950,0,0,148,0,148,G
7-M,951,145,0,1,0,146,A
7-M,952,0,0,0,145,145,C
7-M,953,138,0,0,0,138,A
7-M,954,0,0,138,0,138,G
7-M,955,0,138,0,0,138,T
7-M,956,1,0,1,135,137,C
7-M,957,137,0,0,0,137,A
7-M,958,0,137,0,0,137,T
7-M,959,0,137,0,0,137,T
7-M,960,0,136,0,0,136,T
7-M,961,0,135,0,0,135,T
7-M,962,0,0,135,0,135,G
7-M,963,0,124,0,0,124,T
7-M,964,0,0,0,124,124,C
7-M,965,118,0,0,0,118,A
7-M,966,0,0,118,0,118,G
7-M,967,0,0,0,118,118,C
7-M,968,117,0,0,0,117,A
7-M,969,0,117,0,0,117,T
7-M,970,114,0,0,0,114,A
7-M,971,0,0,114,0,114,G
7-M,972,111,0,0,0,111,A
7-M,973,0,0,110,0,110,G
7-M,974,0,109,0,0,109,T
7-M,975,0,73,0,0,73,T
7-M,976,0,0,73,0,73,G
7-M,977,0,0,73,0,73,G
7-M,978,72,0,0,0,72,A
7-M,979,0,0,72,0,72,G
7-M,980,0,50,0,0,50,T
7-M,981,50,0,0,0,50,A
7-M,982,49,0,0,0,49,A
8-NS,1,91,0,0,0,91,A
8-NS,2,0,91,0,0,91,T
8-NS,3,0,0,96,0,96,G
8-NS,4,0,0,104,0,104,G
8-NS,5,117,0,0,0,117,A
8-NS,6,0,198,0,0,198,T
8-NS,7,0,198,0,0,198,T
8-NS,8,0,0,0,202,202,C
8-NS,9,1,0,0,201,202,C
8-NS,10,203,0,0,0,203,A
8-NS,11,205,0,0,0,205,A
8-NS,12,0,0,0,204,204,C
8-NS,13,205,0,0,0,205,A
8-NS,14,0,0,0,206,206,C
8-NS,15,0,205,0,1,206,T
8-NS,16,0,0,226,0,226,G
8-NS,17,0,227,0,0,227,T
8-NS,18,0,0,227,0,227,G
8-NS,19,0,225,0,1,226,T
8-NS,20,1,0,0,225,226,C
8-NS,21,227,0,0,0,227,A
8-NS,22,228,0,0,0,228,A
8-NS,23,0,0,231,0,231,G
8-NS,24,0,238,0,1,239,T
8-NS,25,0,237,0,0,237,T
8-NS,26,0,239,0,1,240,T
8-NS,27,0,0,0,241,241,C
8-NS,28,0,0,0,241,241,C
8-NS,29,240,0,0,0,240,A
8-NS,30,0,0,243,0,243,G
8-NS,31,0,0,243,0,243,G
8-NS,32,0,244,0,0,244,T
8-NS,33,245,0,0,0,245,A
8-NS,34,0,0,246,0,246,G
8-NS,35,246,0,0,0,246,A
8-NS,36,0,245,0,1,246,T
8-NS,37,0,246,0,0,246,T
8-NS,38,0,0,249,0,249,G
8-NS,39,0,0,0,251,251,C
8-NS,40,0,250,0,1,251,T
8-NS,41,1,250,0,0,251,T
8-NS,42,0,251,0,1,252,T
8-NS,43,0,0,0,256,256,C
8-NS,44,0,256,0,1,257,T
8-NS,45,0,257,0,0,257,T
8-NS,46,0,257,0,0,257,T
8-NS,47,0,1,259,0,260,G
8-NS,48,0,0,261,0,261,G
8-NS,49,0,1,0,260,261,C
8-NS,50,260,0,1,0,261,A
8-NS,51,0,261,0,0,261,T
8-NS,52,262,0,0,0,262,A
8-NS,53,0,280,0,0,280,T
8-NS,54,1,0,0,281,282,C
8-NS,55,1,0,0,281,282,C
8-NS,56,0,0,281,0,281,G
8-NS,57,0,281,0,0,281,T
8-NS,58,284,0,0,0,284,A
8-NS,59,289,0,0,0,289,A
8-NS,60,289,0,0,0,289,A
8-NS,61,0,0,0,291,291,C
8-NS,62,288,0,0,0,288,A
8-NS,63,290,0,0,0,290,A
8-NS,64,0,0,310,0,310,G
8-NS,65,0,314,0,0,314,T
8-NS,66,0,313,0,1,314,T
8-NS,67,0,0,314,0,314,G
8-NS,68,0,314,0,0,314,T
8-NS,69,314,0,0,0,314,A
8-NS,70,0,0,318,0,318,G
8-NS,71,333,0,0,0,333,A
8-NS,72,0,0,0,334,334,C
8-NS,73,1,1,0,328,330,C
8-NS,74,331,0,1,0,332,A
8-NS,75,333,1,0,0,334,A
8-NS,76,0,0,344,0,344,G
8-NS,77,344,0,0,0,344,A
8-NS,78,345,0,0,0,345,A
8-NS,79,0,0,0,346,346,C
8-NS,80,0,344,0,0,344,T
8-NS,81,0,0,350,0,350,G
8-NS,82,350,0,0,0,350,A
8-NS,83,0,0,357,0,357,G
8-NS,84,0,355,0,1,356,T
8-NS,85,0,1,351,0,352,G
8-NS,86,351,0,1,0,352,A
8-NS,87,1,349,0,0,350,T
8-NS,88,0,0,352,0,352,G
8-NS,89,0,0,0,356,356,C
8-NS,90,0,0,0,358,358,C
8-NS,91,0,0,0,360,360,C
8-NS,92,0,0,0,357,357,C
8-NS,93,359,0,0,0,359,A
8-NS,94,0,362,0,0,362,T
8-NS,95,0,370,0,0,370,T
8-NS,96,0,0,0,370,370,C
8-NS,97,0,0,0,367,367,C
8-NS,98,0,366,0,1,367,T
8-NS,99,0,365,0,1,366,T
8-NS,100,0,1,365,0,366,G
8-NS,101,367,0,0,0,367,A
8-NS,102,0,366,0,0,366,T
8-NS,103,0,1,0,366,367,C
8-NS,104,0,0,366,0,366,G
8-NS,105,1,0,364,0,365,G
8-NS,106,0,0,0,365,365,C
8-NS,107,0,366,0,0,366,T
8-NS,108,0,367,0,0,367,T
8-NS,109,1,0,0,365,366,C
8-NS,110,0,0,365,0,365,G
8-NS,111,0,0,0,367,367,C
8-NS,112,0,0,0,365,365,C
8-NS,113,0,1,366,0,367,G
8-NS,114,365,0,0,0,365,A
8-NS,115,0,0,387,0,387,G
8-NS,116,385,0,0,0,385,A
8-NS,117,0,385,0,0,385,T
8-NS,118,0,0,0,386,386,C
8-NS,119,385,0,1,0,386,A
8-NS,120,0,0,386,0,386,G
8-NS,121,384,0,1,0,385,A
8-NS,122,0,0,388,1,389,G
8-NS,123,0,0,392,0,392,G
8-NS,124,1,394,0,1,396,T
8-NS,125,0,1,0,415,416,C
8-NS,126,0,0,0,416,416,C
8-NS,127,0,0,0,421,421,C
8-NS,128,0,421,0,0,421,T
8-NS,129,422,0,0,0,422,A
8-NS,130,419,0,0,0,419,A
8-NS,131,0,0,425,0,425,G
8-NS,132,0,1,424,0,425,G
8-NS,133,1,1,423,0,425,G
8-NS,134,0,0,414,0,414,G
8-NS,135,411,1,1,0,413,A
8-NS,136,413,0,1,0,414,A
8-NS,137,0,0,413,0,413,G
8-NS,138,421,0,0,0,421,A
8-NS,139,0,0,427,0,427,G
8-NS,140,0,0,427,0,427,G
8-NS,141,0,0,0,425,425,C
8-NS,142,427,0,0,0,427,A
8-NS,143,427,0,1,0,428,A
8-NS,144,0,427,0,0,427,T
8-NS,145,430,0,1,0,431,A
8-NS,146,0,0,0,434,434,C
8-NS,147,0,430,1,1,432,T
8-NS,148,0,0,0,432,432,C
8-NS,149,0,428,0,1,429,T
8-NS,150,1,1,0,428,430,C
8-NS,151,0,0,432,0,432,G
8-NS,152,0,0,444,0,444,G
8-NS,153,0,446,0,0,446,T
8-NS,154,1,0,0,443,444,C
8-NS,155,0,440,0,0,440,T
8-NS,156,442,0,0,0,442,A
8-NS,157,0,0,440,0,440,G
8-NS,158,439,0,0,0,439,A
8-NS,159,0,0,0,446,446,C
8-NS,160,445,0,0,0,445,A
8-NS,161,0,435,0,0,435,T
8-NS,162,0,0,0,437,437,C
8-NS,163,437,0,0,0,437,A
8-NS,164,433,0,0,1,434,A
8-NS,165,433,0,0,0,433,A
8-NS,166,0,0,436,0,436,G
8-NS,167,0,0,0,435,435,C
8-NS,168,432,0,0,0,432,A
8-NS,169,0,0,435,0,435,G
8-NS,170,0,0,0,435,435,C
8-NS,171,2,0,0,433,435,C
8-NS,172,436,0,0,0,436,A
8-NS,173,0,0,0,440,440,C
8-NS,174,0,0,1,442,443,C
8-NS,175,1,0,0,444,445,C
8-NS,176,450,0,0,0,450,A
8-NS,177,0,452,0,0,452,T
8-NS,178,0,0,454,0,454,G
8-NS,179,0,450,0,0,450,T
8-NS,180,0,449,0,0,449,T
8-NS,181,0,0,451,0,451,G
8-NS,182,0,0,452,0,452,G
8-NS,183,448,0,1,0,449,A
8-NS,184,448,0,0,0,448,A
8-NS,185,444,0,0,0,444,A
8-NS,186,0,1,443,0,444,G
8-NS,187,0,0,0,444,444,C
8-NS,188,445,0,0,0,445,A
8-NS,189,443,0,0,0,443,A
8-NS,190,444,0,0,0,444,A
8-NS,191,0,448,0,0,448,T
8-NS,192,0,443,0,1,444,T
8-NS,193,0,0,456,0,456,G
8-NS,194,0,455,0,0,455,T
8-NS,195,454,0,0,0,454,A
8-NS,196,0,0,454,0,454,G
8-NS,197,451,0,0,0,451,A
8-NS,198,454,0,0,0,454,A
8-NS,199,455,0,0,0,455,A
8-NS,200,454,0,0,0,454,A
8-NS,201,0,0,458,0,458,G
8-NS,202,444,0,0,0,444,A
8-NS,203,0,438,0,0,438,T
8-NS,204,0,443,0,0,443,T
8-NS,205,0,0,0,441,441,C
8-NS,206,0,441,0,1,442,T
8-NS,207,0,0,443,0,443,G
8-NS,208,444,0,0,0,444,A
8-NS,209,443,0,0,0,443,A
8-NS,210,439,0,1,0,440,A
8-NS,211,0,0,439,0,439,G
8-NS,212,436,0,2,0,438,A
8-NS,213,442,0,0,0,442,A
8-NS,214,0,0,443,0,443,G
8-NS,215,444,0,1,0,445,A
8-NS,216,450,0,0,0,450,A
8-NS,217,0,453,0,0,453,T
8-NS,218,0,0,0,455,455,C
8-NS,219,1,453,0,0,454,T
8-NS,220,0,0,457,0,457,G
8-NS,221,457,0,0,0,457,A
8-NS,222,0,454,0,2,456,T
8-NS,223,0,0,452,0,452,G
8-NS,224,449,0,1,0,450,A
8-NS,225,0,0,448,0,448,G
8-NS,226,0,0,449,0,449,G
8-NS,227,0,0,0,458,458,C
8-NS,228,457,0,0,0,457,A
8-NS,229,0,0,0,467,467,C
8-NS,230,0,467,0,0,467,T
8-NS,231,0,457,1,10,468,T
8-NS,232,471,0,0,0,471,A
8-NS,233,469,0,0,0,469,A
8-NS,234,472,1,0,0,473,A
8-NS,235,471,0,1,0,472,A
8-NS,236,0,471,0,0,471,T
8-NS,237,0,3,471,0,474,G
8-NS,238,475,2,0,0,477,A
8-NS,239,0,0,0,475,475,C
8-NS,240,0,0,0,472,472,C
8-NS,241,472,0,0,0,472,A
8-NS,242,0,472,0,1,473,T
8-NS,243,0,0,477,0,477,G
8-NS,244,1,0,483,0,484,G
8-NS,245,2,483,0,1,486,T
8-NS,246,0,0,0,508,508,C
8-NS,247,0,506,0,1,507,T
8-NS,248,0,0,0,514,514,C
8-NS,249,0,2,0,508,510,C
8-NS,250,512,0,1,0,513,A
8-NS,251,0,0,0,521,521,C
8-NS,252,513,0,3,0,516,A
8-NS,253,0,0,0,535,535,C
8-NS,254,3,1,0,527,531,C
8-NS,255,0,507,0,1,508,T
8-NS,256,0,0,507,0,507,G
8-NS,257,0,0,0,507,507,C
8-NS,258,0,503,0,0,503,T
8-NS,259,0,504,0,0,504,T
8-NS,260,0,3,1,495,499,C
8-NS,261,0,0,503,0,503,G
8-NS,262,0,0,0,501,501,C
8-NS,263,0,1,501,0,502,G
8-NS,264,526,0,0,0,526,A
8-NS,265,1,519,0,1,521,T
8-NS,266,542,0,0,0,542,A
8-NS,267,0,1,0,542,543,C
8-NS,268,541,0,0,0,541,A
8-NS,269,0,556,0,0,556,T
8-NS,270,552,0,0,0,552,A
8-NS,271,558,0,0,0,558,A
8-NS,272,0,0,0,557,557,C
8-NS,273,0,546,0,0,546,T
8-NS,274,0,0,553,0,553,G
8-NS,275,548,0,0,0,548,A
8-NS,276,0,0,0,548,548,C
8-NS,277,549,0,1,0,550,A
8-NS,278,0,544,0,0,544,T
8-NS,279,0,1,546,0,547,G
8-NS,280,545,1,1,0,547,A
8-NS,281,0,0,0,570,570,C
8-NS,282,0,568,0,1,569,T
8-NS,283,577,1,0,0,578,A
8-NS,284,0,575,0,0,575,T
8-NS,285,1,577,0,0,578,T
8-NS,286,0,0,578,0,578,G
8-NS,287,576,0,0,0,576,A
8-NS,288,0,1,575,0,576,G
8-NS,289,0,0,581,0,581,G
8-NS,290,567,0,0,0,567,A
8-NS,291,568,0,0,0,568,A
8-NS,292,0,559,0,1,560,T
8-NS,293,0,558,0,0,558,T
8-NS,294,0,0,563,0,563,G
8-NS,295,0,563,0,0,563,T
8-NS,296,1,0,0,561,562,C
8-NS,297,561,0,0,0,561,A
8-NS,298,563,0,0,0,563,A
8-NS,299,2,1,562,0,565,G
8-NS,300,570,1,0,0,571,A
8-NS,301,572,0,0,0,572,A
8-NS,302,571,0,0,0,571,A
8-NS,303,0,0,0,569,569,C
8-NS,304,0,566,0,1,567,T
8-NS,305,0,0,577,0,577,G
8-NS,306,0,0,581,0,581,G
8-NS,307,0,581,0,1,582,T
8-NS,308,0,581,0,0,581,T
8-NS,309,2,0,0,578,580,C
8-NS,310,580,0,0,0,580,A
8-NS,311,0,590,0,0,590,T
8-NS,312,0,0,593,0,593,G
8-NS,313,1,0,0,593,594,C
8-NS,314,0,587,0,2,589,T
8-NS,315,581,0,2,0,583,A
8-NS,316,595,0,0,0,595,A
8-NS,317,0,595,0,0,595,T
8-NS,318,0,0,594,0,594,G
8-NS,319,0,0,0,594,594,C
8-NS,320,0,0,0,584,584,C
8-NS,321,0,0,0,592,592,C
8-NS,322,589,0,1,0,590,A
8-NS,323,588,0,0,0,588,A
8-NS,324,0,0,591,0,591,G
8-NS,325,0,0,0,588,588,C
8-NS,326,588,0,2,0,590,A
8-NS,327,0,0,596,0,596,G
8-NS,328,594,0,0,0,594,A
8-NS,329,594,0,0,0,594,A
8-NS,330,594,0,0,0,594,A
8-NS,331,591,0,0,0,591,A
8-NS,332,0,596,0,0,596,T
8-NS,333,0,0,598,0,598,G
8-NS,334,0,0,593,1,594,G
8-NS,335,594,0,1,0,595,A
8-NS,336,590,0,0,0,590,A
8-NS,337,0,0,590,0,590,G
8-NS,338,0,1,588,0,589,G
8-NS,339,594,0,0,0,594,A
8-NS,340,0,0,0,592,592,C
8-NS,341,0,0,0,591,591,C
8-NS,342,0,587,0,0,587,T
8-NS,343,0,0,0,597,597,C
8-NS,344,0,593,1,1,595,T
8-NS,345,0,598,0,0,598,T
8-NS,346,0,597,0,0,597,T
8-NS,347,0,0,599,0,599,G
8-NS,348,0,0,0,602,602,C
8-NS,349,600,0,0,0,600,A
8-NS,350,0,598,0,1,599,T
8-NS,351,0,2,0,598,600,C
8-NS,352,598,1,0,0,599,A
8-NS,353,0,0,620,0,620,G
8-NS,354,615,0,0,0,615,A
8-NS,355,614,1,0,1,616,A
8-NS,356,0,617,0,0,617,T
8-NS,357,0,0,609,0,609,G
8-NS,358,3,1,606,0,610,G
8-NS,359,612,0,0,0,612,A
8-NS,360,0,0,0,613,613,C
8-NS,361,0,0,0,600,600,C
8-NS,362,598,0,1,0,599,A
8-NS,363,0,0,609,0,609,G
8-NS,364,0,0,606,0,606,G
8-NS,365,1,0,0,609,610,C
8-NS,366,602,1,0,0,603,A
8-NS,367,612,0,0,0,612,A
8-NS,368,0,610,0,0,610,T
8-NS,369,0,0,0,612,612,C
8-NS,370,609,0,0,0,609,A
8-NS,371,0,606,0,0,606,T
8-NS,372,0,0,600,0,600,G
8-NS,373,0,1,602,0,603,G
8-NS,374,601,0,0,0,601,A
8-NS,375,0,0,607,0,607,G
8-NS,376,601,1,0,0,602,A
8-NS,377,599,0,1,0,600,A
8-NS,378,603,0,0,0,603,A
8-NS,379,603,0,0,0,603,A
8-NS,380,606,0,0,0,606,A
8-NS,381,0,1,0,607,608,C
8-NS,382,608,0,0,0,608,A
8-NS,383,0,605,0,1,606,T
8-NS,384,1,0,0,594,595,C
8-NS,385,594,0,1,0,595,A
8-NS,386,0,597,0,1,598,T
8-NS,387,0,0,597,0,597,G
8-NS,388,0,595,1,1,597,T
8-NS,389,0,591,0,0,591,T
8-NS,390,0,1,587,0,588,G
8-NS,391,584,0,0,0,584,A
8-NS,392,589,0,1,0,590,A
8-NS,393,592,0,0,0,592,A
8-NS,394,0,0,594,0,594,G
8-NS,395,0,0,0,583,583,C
8-NS,396,0,1,580,0,581,G
8-NS,397,581,0,0,0,581,A
8-NS,398,581,0,0,0,581,A
8-NS,399,0,582,0,0,582,T
8-NS,400,0,579,0,3,582,T
8-NS,401,0,583,0,1,584,T
8-NS,402,0,0,0,584,584,C
8-NS,403,575,0,2,0,577,A
8-NS,404,0,0,579,0,579,G
8-NS,405,0,580,0,0,580,T
8-NS,406,0,0,579,0,579,G
8-NS,407,0,579,0,0,579,T
8-NS,408,1,1,577,0,579,G
8-NS,409,582,0,0,0,582,A
8-NS,410,0,580,0,0,580,T
8-NS,411,0,581,0,0,581,T
8-NS,412,0,579,0,0,579,T
8-NS,413,0,580,0,0,580,T
8-NS,414,0,578,0,0,578,T
8-NS,415,1,0,573,0,574,G
8-NS,416,577,0,0,0,577,A
8-NS,417,0,0,0,575,575,C
8-NS,418,0,0,0,573,573,C
8-NS,419,0,0,573,0,573,G
8-NS,420,596,0,0,0,596,A
8-NS,421,0,0,0,603,603,C
8-NS,422,0,602,0,0,602,T
8-NS,423,602,0,0,0,602,A
8-NS,424,0,0,604,0,604,G
8-NS,425,603,0,1,0,604,A
8-NS,426,2,0,606,0,608,G
8-NS,427,607,1,1,0,609,A
8-NS,428,0,0,0,628,628,C
8-NS,429,0,0,0,615,615,C
8-NS,430,600,0,1,0,601,A
8-NS,431,0,625,0,0,625,T
8-NS,432,622,1,0,0,623,A
8-NS,433,0,0,669,0,669,G
8-NS,434,0,668,0,1,669,T
8-NS,435,661,0,0,0,661,A
8-NS,436,0,657,1,0,658,T
8-NS,437,0,641,0,0,641,T
8-NS,438,660,0,0,0,660,A
8-NS,439,0,0,0,662,662,C
8-NS,440,0,634,0,0,634,T
8-NS,441,634,0,0,0,634,A
8-NS,442,571,0,0,0,571,A
8-NS,443,0,1,573,0,574,G
8-NS,444,0,1,572,0,573,G
8-NS,445,1,0,576,0,577,G
8-NS,446,0,0,0,570,570,C
8-NS,447,0,557,0,0,557,T
8-NS,448,0,556,0,1,557,T
8-NS,449,0,556,0,1,557,T
8-NS,450,0,0,0,559,559,C
8-NS,451,562,0,0,0,562,A
8-NS,452,0,0,0,561,561,C
8-NS,453,0,0,0,560,560,C
8-NS,454,1,0,561,0,562,G
8-NS,455,561,0,0,0,561,A
8-NS,456,556,1,0,0,557,A
8-NS,457,0,0,565,0,565,G
8-NS,458,557,0,0,0,557,A
8-NS,459,0,1,558,0,559,G
8-NS,460,0,0,557,0,557,G
8-NS,461,0,0,555,0,555,G
8-NS,462,551,0,1,0,552,A
8-NS,463,0,0,553,0,553,G
8-NS,464,0,0,0,547,547,C
8-NS,465,548,0,0,0,548,A
8-NS,466,546,0,0,0,546,A
8-NS,467,0,547,0,0,547,T
8-NS,468,0,544,0,0,544,T
8-NS,469,0,0,545,0,545,G
8-NS,470,0,536,0,0,536,T
8-NS,471,0,535,0,0,535,T
8-NS,472,0,1,528,0,529,G
8-NS,473,0,0,534,0,534,G
8-NS,474,1,0,0,534,535,C
8-NS,475,0,0,535,0,535,G
8-NS,476,535,0,0,0,535,A
8-NS,477,539,0,0,0,539,A
8-NS,478,543,0,0,0,543,A
8-NS,479,0,543,0,0,543,T
8-NS,480,1,0,0,543,544,C
8-NS,481,0,540,0,1,541,T
8-NS,482,0,0,0,542,542,C
8-NS,483,543,0,0,0,543,A
8-NS,484,0,0,0,541,541,C
8-NS,485,0,0,0,541,541,C
8-NS,486,540,0,0,0,540,A
8-NS,487,0,539,0,0,539,T
8-NS,488,0,530,0,0,530,T
8-NS,489,0,0,533,0,533,G
8-NS,490,1,0,0,528,529,C
8-NS,491,0,0,0,532,532,C
8-NS,492,1,530,0,1,532,T
8-NS,493,0,531,0,1,532,T
8-NS,494,1,0,0,532,533,C
8-NS,495,0,531,0,0,531,T
8-NS,496,0,533,0,0,533,T
8-NS,497,0,540,0,0,540,T
8-NS,498,0,535,0,0,535,T
8-NS,499,0,0,0,538,538,C
8-NS,500,0,0,0,538,538,C
8-NS,501,539,0,1,0,540,A
8-NS,502,0,0,546,0,546,G
8-NS,503,0,0,541,0,541,G
8-NS,504,544,0,0,0,544,A
8-NS,505,1,0,0,543,544,C
8-NS,506,552,0,0,0,552,A
8-NS,507,0,554,0,0,554,T
8-NS,508,555,0,0,0,555,A
8-NS,509,0,1,0,587,588,C
8-NS,510,0,585,0,1,586,T
8-NS,511,580,0,0,0,580,A
8-NS,512,0,578,0,1,579,T
8-NS,513,0,558,0,1,559,T
8-NS,514,0,0,562,0,562,G
8-NS,515,533,0,2,0,535,A
8-NS,516,0,1,533,0,534,G
8-NS,517,0,0,531,0,531,G
8-NS,518,486,0,1,0,487,A
8-NS,519,0,488,0,0,488,T
8-NS,520,0,0,498,0,498,G
8-NS,521,0,498,0,0,498,T
8-NS,522,1,0,0,499,500,C
8-NS,523,499,0,0,0,499,A
8-NS,524,500,0,1,0,501,A
8-NS,525,500,0,0,0,500,A
8-NS,526,498,0,0,0,498,A
8-NS,527,499,1,0,0,500,A
8-NS,528,0,498,0,0,498,T
8-NS,529,0,0,497,0,497,G
8-NS,530,0,0,0,495,495,C
8-NS,531,497,0,1,0,498,A
8-NS,532,500,0,0,0,500,A
8-NS,533,0,499,0,0,499,T
8-NS,534,0,501,0,0,501,T
8-NS,535,0,0,500,0,500,G
8-NS,536,0,0,495,0,495,G
8-NS,537,1,0,496,0,497,G
8-NS,538,0,0,498,0,498,G
8-NS,539,1,483,0,1,485,T
8-NS,540,0,0,0,490,490,C
8-NS,541,1,0,0,489,490,C
8-NS,542,0,486,0,0,486,T
8-NS,543,1,0,0,491,492,C
8-NS,544,492,0,0,0,492,A
8-NS,545,0,490,0,0,490,T
8-NS,546,0,1,0,489,490,C
8-NS,547,0,0,486,0,486,G
8-NS,548,0,0,487,0,487,G
8-NS,549,481,0,1,0,482,A
8-NS,550,0,0,481,0,481,G
8-NS,551,0,1,488,0,489,G
8-NS,552,485,0,0,0,485,A
8-NS,553,0,0,0,493,493,C
8-NS,554,0,488,0,0,488,T
8-NS,555,0,487,0,0,487,T
8-NS,556,0,0,485,0,485,G
8-NS,557,488,0,0,0,488,A
8-NS,558,486,0,1,0,487,A
8-NS,559,0,487,0,0,487,T
8-NS,560,0,0,479,0,479,G
8-NS,561,0,0,482,0,482,G
8-NS,562,475,0,0,0,475,A
8-NS,563,479,0,0,0,479,A
8-NS,564,0,498,0,0,498,T
8-NS,565,0,1,499,0,500,G
8-NS,566,502,0,0,0,502,A
8-NS,567,0,501,0,1,502,T
8-NS,568,499,0,1,0,500,A
8-NS,569,502,0,0,0,502,A
8-NS,570,0,0,0,498,498,C
8-NS,571,490,0,1,0,491,A
8-NS,572,0,1,0,490,491,C
8-NS,573,452,0,0,0,452,A
8-NS,574,0,0,461,0,461,G
8-NS,575,0,460,0,0,460,T
8-NS,576,0,461,0,0,461,T
8-NS,577,2,1,0,455,458,C
8-NS,578,0,0,459,0,459,G
8-NS,579,460,0,0,0,460,A
8-NS,580,0,0,460,0,460,G
8-NS,581,0,454,0,1,455,T
8-NS,582,0,0,0,461,461,C
8-NS,583,0,453,0,1,454,T
8-NS,584,1,0,0,457,458,C
8-NS,585,0,458,0,2,460,T
8-NS,586,461,0,0,0,461,A
8-NS,587,461,0,0,0,461,A
8-NS,588,461,0,0,0,461,A
8-NS,589,462,0,0,0,462,A
8-NS,590,462,0,0,0,462,A
8-NS,591,0,459,0,0,459,T
8-NS,592,0,0,0,461,461,C
8-NS,593,0,455,0,0,455,T
8-NS,594,456,0,0,0,456,A
8-NS,595,0,0,0,455,455,C
8-NS,596,454,0,0,0,454,A
8-NS,597,0,0,454,0,454,G
8-NS,598,447,0,0,0,447,A
8-NS,599,1,0,449,0,450,G
8-NS,600,456,0,0,0,456,A
8-NS,601,0,452,0,1,453,T
8-NS,602,0,454,0,1,455,T
8-NS,603,0,1,0,452,453,C
8-NS,604,0,0,454,1,455,G
8-NS,605,0,0,0,452,452,C
8-NS,606,0,452,0,0,452,T
8-NS,607,0,455,0,0,455,T
8-NS,608,0,0,443,0,443,G
8-NS,609,0,0,442,0,442,G
8-NS,610,443,0,0,0,443,A
8-NS,611,0,1,442,0,443,G
8-NS,612,442,0,1,0,443,A
8-NS,613,440,0,0,0,440,A
8-NS,614,0,0,447,0,447,G
8-NS,615,0,0,0,448,448,C
8-NS,616,450,0,0,0,450,A
8-NS,617,0,0,456,0,456,G
8-NS,618,0,454,0,0,454,T
8-NS,619,456,0,0,0,456,A
8-NS,620,456,0,0,0,456,A
8-NS,621,0,453,0,0,453,T
8-NS,622,0,0,455,0,455,G
8-NS,623,444,1,0,0,445,A
8-NS,624,0,2,449,0,451,G
8-NS,625,447,0,1,0,448,A
8-NS,626,436,0,0,0,436,A
8-NS,627,0,435,0,0,435,T
8-NS,628,1,0,430,0,431,G
8-NS,629,0,0,433,0,433,G
8-NS,630,0,0,429,0,429,G
8-NS,631,0,0,429,0,429,G
8-NS,632,1,0,427,0,428,G
8-NS,633,417,0,0,0,417,A
8-NS,634,0,395,0,0,395,T
8-NS,635,0,0,0,399,399,C
8-NS,636,0,396,0,1,397,T
8-NS,637,1,0,0,399,400,C
8-NS,638,0,0,0,402,402,C
8-NS,639,400,0,0,0,400,A
8-NS,640,0,0,0,398,398,C
8-NS,641,0,390,0,0,390,T
8-NS,642,0,391,0,0,391,T
8-NS,643,387,0,0,0,387,A
8-NS,644,0,0,1,387,388,C
8-NS,645,0,385,0,2,387,T
8-NS,646,2,1,0,384,387,C
8-NS,647,0,1,0,380,381,C
8-NS,648,379,0,0,0,379,A
8-NS,649,380,0,0,0,380,A
8-NS,650,381,0,0,0,381,A
8-NS,651,382,0,0,0,382,A
8-NS,652,0,0,0,381,381,C
8-NS,653,366,0,0,0,366,A
8-NS,654,0,0,365,0,365,G
8-NS,655,365,0,0,0,365,A
8-NS,656,364,0,0,0,364,A
8-NS,657,363,0,1,0,364,A
8-NS,658,0,0,0,364,364,C
8-NS,659,0,1,362,0,363,G
8-NS,660,0,0,365,0,365,G
8-NS,661,0,1,363,0,364,G
8-NS,662,364,0,0,0,364,A
8-NS,663,362,0,0,0,362,A
8-NS,664,361,0,0,0,361,A
8-NS,665,0,360,0,0,360,T
8-NS,666,0,0,365,0,365,G
8-NS,667,0,0,364,0,364,G
8-NS,668,0,1,0,360,361,C
8-NS,669,0,0,361,0,361,G
8-NS,670,356,0,0,0,356,A
8-NS,671,0,0,356,0,356,G
8-NS,672,357,0,0,0,357,A
8-NS,673,356,0,0,0,356,A
8-NS,674,0,0,0,357,357,C
8-NS,675,347,0,1,0,348,A
8-NS,676,0,0,346,0,346,G
8-NS,677,0,0,0,347,347,C
8-NS,678,0,346,0,0,346,T
8-NS,679,346,0,0,0,346,A
8-NS,680,0,0,343,0,343,G
8-NS,681,0,0,344,0,344,G
8-NS,682,1,342,0,0,343,T
8-NS,683,0,0,0,334,334,C
8-NS,684,337,0,0,0,337,A
8-NS,685,335,0,1,0,336,A
8-NS,686,338,0,0,0,338,A
8-NS,687,339,0,1,0,340,A
8-NS,688,0,0,340,0,340,G
8-NS,689,0,329,1,2,332,T
8-NS,690,0,330,0,0,330,T
8-NS,691,0,334,0,0,334,T
8-NS,692,0,0,335,0,335,G
8-NS,693,335,0,0,0,335,A
8-NS,694,335,0,0,0,335,A
8-NS,695,0,0,335,0,335,G
8-NS,696,328,0,0,0,328,A
8-NS,697,0,0,330,0,330,G
8-NS,698,329,0,1,0,330,A
8-NS,699,0,331,0,0,331,T
8-NS,700,330,0,0,0,330,A
8-NS,701,329,0,0,0,329,A
8-NS,702,0,1,328,0,329,G
8-NS,703,306,0,0,0,306,A
8-NS,704,0,306,0,0,306,T
8-NS,705,0,0,306,0,306,G
8-NS,706,0,0,307,0,307,G
8-NS,707,0,0,0,307,307,C
8-NS,708,0,307,0,0,307,T
8-NS,709,307,0,0,0,307,A
8-NS,710,306,0,0,0,306,A
8-NS,711,0,307,0,0,307,T
8-NS,712,0,307,0,0,307,T
8-NS,713,0,0,307,0,307,G
8-NS,714,299,0,1,0,300,A
8-NS,715,299,0,0,0,299,A
8-NS,716,0,0,299,0,299,G
8-NS,717,296,0,0,0,296,A
8-NS,718,293,0,1,0,294,A
8-NS,719,0,0,294,0,294,G
8-NS,720,1,288,0,1,290,T
8-NS,721,0,0,292,0,292,G
8-NS,722,286,0,1,0,287,A
8-NS,723,0,0,288,0,288,G
8-NS,724,287,0,1,0,288,A
8-NS,725,0,0,0,287,287,C
8-NS,726,281,0,1,0,282,A
8-NS,727,0,1,0,281,282,C
8-NS,728,270,0,0,0,270,A
8-NS,729,0,0,275,0,275,G
8-NS,730,274,0,0,0,274,A
8-NS,731,0,272,0,1,273,T
8-NS,732,0,274,0,0,274,T
8-NS,733,270,1,0,0,271,A
8-NS,734,271,0,0,0,271,A
8-NS,735,270,0,0,0,270,A
8-NS,736,270,0,0,0,270,A
8-NS,737,270,0,0,0,270,A
8-NS,738,0,0,0,258,258,C
8-NS,739,247,0,0,0,247,A
8-NS,740,248,0,1,0,249,A
8-NS,741,0,0,0,248,248,C
8-NS,742,0,247,0,1,248,T
8-NS,743,0,0,248,0,248,G
8-NS,744,247,0,0,0,247,A
8-NS,745,249,0,0,0,249,A
8-NS,746,248,0,0,0,248,A
8-NS,747,247,0,0,0,247,A
8-NS,748,0,245,0,0,245,T
8-NS,749,243,0,0,0,243,A
8-NS,750,0,0,246,0,246,G
8-NS,751,0,0,0,247,247,C
8-NS,752,0,237,0,1,238,T
8-NS,753,0,237,0,0,237,T
8-NS,754,0,233,0,0,233,T
8-NS,755,0,0,238,0,238,G
8-NS,756,237,0,0,0,237,A
8-NS,757,238,0,0,0,238,A
8-NS,758,1,0,0,237,238,C
8-NS,759,234,0,0,0,234,A
8-NS,760,234,0,1,0,235,A
8-NS,761,236,0,0,0,236,A
8-NS,762,0,236,0,0,236,T
8-NS,763,235,0,0,0,235,A
8-NS,764,231,0,1,0,232,A
8-NS,765,0,0,0,231,231,C
8-NS,766,228,1,0,0,229,A
8-NS,767,0,225,0,0,225,T
8-NS,768,0,219,0,0,219,T
8-NS,769,0,0,0,218,218,C
8-NS,770,216,0,0,0,216,A
8-NS,771,0,215,0,0,215,T
8-NS,772,0,0,215,0,215,G
8-NS,773,0,0,0,211,211,C
8-NS,774,205,0,0,0,205,A
8-NS,775,204,0,0,0,204,A
8-NS,776,0,0,203,0,203,G
8-NS,777,0,0,0,207,207,C
8-NS,778,204,0,0,0,204,A
8-NS,779,0,204,0,0,204,T
8-NS,780,0,203,0,0,203,T
8-NS,781,202,0,1,0,203,A
8-NS,782,0,0,0,203,203,C
8-NS,783,199,0,0,0,199,A
8-NS,784,198,0,0,0,198,A
8-NS,785,0,0,0,198,198,C
8-NS,786,0,169,0,0,169,T
8-NS,787,0,0,169,0,169,G
8-NS,788,0,0,0,166,166,C
8-NS,789,0,162,0,0,162,T
8-NS,790,0,0,164,0,164,G
8-NS,791,2,159,0,1,162,T
8-NS,792,0,161,0,1,162,T
8-NS,793,0,161,0,0,161,T
8-NS,794,0,0,160,0,160,G
8-NS,795,161,0,0,0,161,A
8-NS,796,159,0,0,0,159,A
8-NS,797,0,0,158,0,158,G
8-NS,798,0,158,0,0,158,T
8-NS,799,0,0,154,0,154,G
8-NS,800,0,0,153,0,153,G
8-NS,801,152,0,1,0,153,A
8-NS,802,153,0,0,0,153,A
8-NS,803,0,0,0,151,151,C
8-NS,804,150,0,0,0,150,A
8-NS,805,0,0,150,0,150,G
8-NS,806,0,0,149,0,149,G
8-NS,807,147,0,0,0,147,A
8-NS,808,0,0,146,0,146,G
8-NS,809,124,0,0,0,124,A
8-NS,810,0,124,0,0,124,T
8-NS,811,124,0,0,0,124,A
8-NS,812,123,0,1,0,124,A
8-NS,813,0,0,124,0,124,G
8-NS,814,114,0,1,0,115,A
8-NS,815,115,0,0,0,115,A
8-NS,816,0,0,0,112,112,C
8-NS,817,0,92,0,0,92,T
8-NS,818,0,88,0,0,88,T
8-NS,819,0,88,0,0,88,T
8-NS,820,0,0,0,88,88,C
8-NS,821,0,79,0,1,80,T
8-NS,822,0,0,0,78,78,C
8-NS,823,74,0,0,0,74,A
8-NS,824,0,74,0,0,74,T
8-NS,825,0,74,0,0,74,T
8-NS,826,0,74,0,0,74,T
8-NS,827,0,0,0,74,74,C
8-NS,828,72,0,0,0,72,A
8-NS,829,0,0,72,0,72,G
8-NS,830,0,0,0,72,72,C
8-NS,831,0,64,0,0,64,T
8-NS,832,0,64,0,0,64,T
8-NS,833,64,0,0,0,64,A
8-NS,834,0,64,0,0,64,T
8-NS,835,0,64,0,0,64,T
8-NS,836,0,64,0,0,64,T
8-NS,837,61,0,0,0,61,A
8-NS,838,60,0,1,0,61,A
8-NS,839,0,61,0,0,61,T
8-NS,840,0,0,61,0,61,G
8-NS,841,59,0,0,0,59,A
8-NS,842,0,54,0,0,54,T
8-NS,843,53,0,0,0,53,A
8-NS,844,53,0,0,0,53,A
8-NS,845,52,0,0,0,52,A
8-NS,846,53,0,0,0,53,A
8-NS,847,53,0,0,0,53,A
8-NS,848,53,0,0,0,53,A
8-NS,849,0,0,0,53,53,C
8-NS,850,46,0,0,0,46,A
8-NS,851,0,0,0,46,46,C
8-NS,852,0,0,0,43,43,C
8-NS,853,0,0,0,41,41,C
8-NS,854,0,40,0,0,40,T
8-NS,855,0,38,0,0,38,T
8-NS,856,0,0,38,0,38,G
8-NS,857,0,36,0,0,36,T
8-NS,858,0,36,0,0,36,T
8-NS,859,0,34,0,0,34,T
8-NS,860,0,0,0,10,10,C
8-NS,861,0,8,0,0,8,T
8-NS,862,7,0,0,0,7,A
8-NS,863,0,0,0,7,7,C
